$	$	dollar
+	+	+
<	&lt;	<
=	=	=
ab	b	ab
abad	世纪	the century
abadi	永恒	eternal
abang	哥哥	older brother
abarai	阿巴拉伊	abarai
abbas	方丈	abbas
abbasiyah	阿巴斯利亚	abbasid
abbasiyyah	阿巴西耶	abbasiyyah
abc	b c	abc
abdi	仆人	servant
abdul	阿卜杜勒	abdul
abdullah	阿卜杜拉	abdullah
abdulmalik	阿卜杜勒马利克	abdul-malik
abdurrahman	阿卜杜拉赫曼	abdurrahman
abendanon	阿本达农	abendanon
abi	阿比	abi
abidin	阿比丁	abidin
abiotik	非生物	abiotic
abjad	字母	alphabet
abnormal	异常	abnormal
aborsi	流产	abortion
abortion	流产	abortion
abortus	流产	abortion
about	关于	about
abraham	亚伯拉罕	abraham
abri	阿布里	military
absolut	绝对	absolute
abstrak	抽象	abstract
abstraksi	抽象	abstraction
abu	灰	[name]
abuabu	灰色	gray
abul	阿布尔	abul
ac	空调	ac
acak	随机	random
acara	事件	occasion
acaraacara	事件	occasions
accelerator	加速器	accelerator
access	访问	access
account	帐户	account
accountant	会计	accountant
accountants	会计师	accountants
accounting	会计	accounting
ace	高手	ace
aceh	ace	aceh
achmad	艾哈迈德	achmad
acid	酸	acid
act	法案	act
acuan	参考	reference
ad	广告	ad
ada	有	there is
adalah	是	is
adam	亚当	adam
adams	亚当斯	adams
adanya	是	there is
adaptasi	适应	adaption
adaptif	适应性	adaptive
adapun	至于	as for
adat	习俗	tradition
address	地址	address
adegan	现场	scene
adi	阿迪	adi
adidas	阿迪达斯	adidas
adik	姐姐	sister
adiknya	他的弟弟	his/her younger brother/sister
adiktif	上瘾的	addictive
adil	只是	fair
adipati	公爵	duke
administrasi	管理	administration
administratif	行政的	administrative
administrator	管理员	administrator
adobe	土坯	adobe
adolf	阿道夫	adolf
adsl	adsl	adsl
adu	阿杜	compete
advokat	主张	advocate
aedes	伊蚊	aedes
aero	航空	aero
aerobik	有氧运动	aerobic
affan	阿凡	affan
affandi	安凡迪	affandi
afrika	非洲	africaans
ag	g	ag
agak	有些	rather
agama	宗教	religion
agamaagama	宗教	religions
agar	以便	so that
agen	代理人	vector
agency	机构	agency
agenda	议程	agenda
ageng	ng	ageng
agnes	阿格尼斯	[people name]
agraris	耕种的	agricultural
agresi	侵略	aggression
agresif	好斗的	aggressive
agrikultur	农业	agriculture
agung	大	majestic
agus	阿古斯	agus
agustus	八月	august
ah	啊	ah
ahli	专家	expert
ahlul	专家	ahlul
ahmad	艾哈迈德	ahmad
aidit	帮帮我	aidit
aids	艾滋病	aids
air	水	water
airbus	空客	airbus
airlangga	艾尔兰加	airlangga
airlines	航空公司	airlines
aizen	艾森	aizen
ajaib	精彩	miraculous
ajang	事件	the pageant
ajar	教	teaching
ajaran	教s	teachings
ajarannya	他的教s	teaching
ajax	阿贾克斯	ajax
aji	阿吉	aji
akademi	学院	academic
akademik	学术的	academic
akademis	学术的	academic
akal	原因	intelligence
akan	将	will
akar	根	root
akarakar	阿卡拉卡尔	source
akatsuki	赤月	akatsuki
akbar	盛大	akbar
akhir	结束	end
akhirakhir	结束	of late
akhiran	后缀	suffix
akhirnya	终于	at last
akibat	后果	effect
akibatnya	结果是	consequently
akrab	熟悉的	familiar
aksara	脚本	alphabet letter
akses	访问	access
aksi	行动	action
akson	轴突	axon
akta	契据	deed
aktif	活跃的	active
akting	演戏	acting
aktiva	资产	asset
aktivasi	激活	activation
aktivator	活化剂	activator
aktivis	活动家	activist
aktivitas	活动	activity
aktivitasaktivitas	活动	activities
aktivitasnya	其活动	its activity
aktor	演员	actor
aktris	演员	actress
aku	我	i
akumulasi	积累	accumulation
akun	帐户	account
akuntan	会计	accountant
akuntansi	会计	accounting
akurasi	准确性	accurate
akurat	准确	accurate
akustik	声学的	acoustics
akut	一世	acute
al	人	[people name]
ala	翼	a la
alakbar	阿拉克巴尔	al-akbar
alam	自然	nature
alamat	地址	address
alamatalamat	地址地址	addresses
alami	自然	natural
alamiah	自然	natural
alan	阿兰	alan
alas	基座	pedestal
alasan	原因	reasons
alasannya	原因	reason
alat	工具	equipment
alatalat	工具	tools
albania	阿尔巴尼亚	the country name albania
albert	阿尔伯特	albert
alberto	阿尔贝托	alberto
album	专辑	album
albumnya	专辑	album
aldo	奥尔多	aldo
alel	等位基因	allele
alergi	过敏	allergy
alex	亚历克斯	alex
alexander	亚历山大	alexander
alexandria	亚历山大	alexandria
alfred	阿尔弗雷德	alfred
alga	海藻	algae
algoritma	算法	algorithm
ali	阿里	ali
aliansi	联盟	alliance
alias	别名	alias
alien	一个外星人	alien
align	对齐	align
alih	过度	shift
alimam	阿里am	al-imam
aliran	类型	flow
aliranaliran	流	streams
aljabar	代数	algebra
aljazair	阿尔及利亚	[name]
alkali	碱	alkali
alkana	烷烃	alkanes
alkil	烷基	alkyl
alkimia	炼金术	alchemy
alkitab	圣经	holy bible
alkohol	醇	alcohol
allah	神	god
allen	艾伦	alien
almarhum	晚了	the deceased
alokasi	分配	allocation
alpen	阿尔卑斯山	alps
alpha	α	alpha
alquran	古兰经	quran
also	也	also
alternatif	另类	alternative
alu	杵	alu
aluminium	铝	aluminium
alumni	校友	alumni
alunalun	阿鲁纳伦	town square
alur	情节	plot
alveolata	肺泡	alveolata
alwi	阿尔维	alwi
alzheimer	老年痴呆症	alzheimer's
am	上午	am
amal	慈善机构	charity
aman	安全	safe
amanat	授权	message
amanda	阿曼达	amanda
amandemen	修正案	amendment
amat	非常	very
amati	观察	observe
amatir	业余	amateur
ambang	阈	threshold
ambarawa	安巴拉瓦	ambarawa
ambil	采取	take
ambon	安汶	ambon
amdal	阿姆达尔	environmental impact analysis
america	美国	america
american	美国的	american
amerika	美国	america
ami	艾米	ami
amien	阿门	amien
amik	阿米克	amice
amin	阿门	amin
aminah	阿米娜	aminah
amino	氨基	amino
amir	阿米尔	amir
amonia	氨	ammonia
ampel	安佩尔	ampel
ampera	安培拉	[name]
amsterdam	阿姆斯特丹	amsterdam
an	一个	es
anaerobik	厌氧的	anaerobic
anak	儿童	child
anakanak	孩子们	children
anakanaknya	他的孩子们	the kids
anaknya	他的儿子	his son
anal	肛门的	anal
analis	分析员	analyst
analisis	分析	analysis
analog	类比	analog
anang	淑女	anang
anarki	无政府状态	anarchy
anarkisme	无政府主义	anarchism
anatomi	解剖学	anatomy
anbu	安布	anbu
ancaman	威胁	threat
ancelotti	安切洛蒂	ancelotti
ancient	古	ancient
ancol	安科尔	ancol
and	和	and
anda	您	you
andalan	支柱	mainstay
andalannya	旗舰店	flagship
andesit	安山岩	andesite
andi	和我	andi
andil	分享	take part
andorra	安道尔	andorra
andrea	安德里亚	andrea
andrew	安德鲁	andrew
android	安卓	android
aneh	奇怪	weird
aneka	各种	various
anemia	贫血	anemia
angel	天使	angel
angeles	天使	angeles
anggapan	假定	assumption
anggaran	预算	charter
anggota	会员	member
anggotaanggota	成员	members
anggotaanggotanya	其成员	members
anggotanya	其成员	its members
anggrek	兰花	orchids
anggun	优美	elegant
anggur	葡萄	grape
angin	风	wind
angiospermae	被子植物	angiosperms
angka	数	number
angkaangka	数字	rates
angkasa	空间	sky
angkat	电梯	lift
angkatan	力	force
angklung	昂隆	angklung
angkor	吴哥	angkor
angkutan	运输	load
angola	安哥拉	angola
angsa	鹅	goose
animalia	动物界	animalia
animasi	动画	animation
anime	动漫	anime
animisme	万物有灵论	animism
anjing	狗	dog
anna	安娜	anna
anoa	阿诺阿	anoa
anorganik	无机的	inorganic
antar	交货	inter-
antara	其中	between
antaranya	其中	them
antarbintang	星际	interstellar
antariksa	空间	outer space
antariksawan	宇航员	astronaut
antarmuka	接口	interface
antasari	安塔萨里	antasari
antena	天线	antenna
anthropologi	人类学	anthropology
anti	抗	anti
antibiotik	抗生素类	antibiotic
antibodi	抗体	antibody
antigen	抗原	antigen
antik	古董	antique
antioksidan	抗氧化剂	antioxidant
antiretrovirus	抗逆转录病毒	antiretrovirus
antivirus	反病毒	antivirus
anton	安东	anton
antonio	安东尼奥	a person's name
antropologi	人类学	anthropology
anugerah	礼品	gift from god
anus	肛门	anus
anwar	安瓦尔	anwar
apa	什么	what
apaapa	任何东西	at all
apabila	如果	when
apakah	是	whether
apalagi	而且	moreover
apapun	任何	anything / whatever
aparat	仪器	officer
apartheid	种族隔离	apartheid
apbn	国家预算	country budget
apel	苹果	apple
apem	顶点	apem
api	火	fire
aplikasi	应用	application
apollo	阿波罗	apollo
apoptosis	凋亡	apoptosis
app	该应用程序	pornographic laws
apple	苹果	apple
applications	应用领域	applications
april	四月	april
aprilia	杏子	aprilia
apung	浮力的	float
ar	ar	god
arab	阿拉伯	direction
arabia	阿拉伯	arabia
arabisrael	阿拉伯糖	arab-israel
arafat	阿拉法特	arafat
arah	方向	direction
arahan	指令	direction
arai	荒井	arai
arang	木炭	charcoal
aras	水平	never heard of it
arca	雕像	statue
ardilla	阿迪利亚	ardilla
area	区域	area
areal	区域	area
arena	竞技场	arena
argentina	阿根廷	argentina
argumen	论点	argument
argumentasi	论证	argumentation
ari	阿里	ari
ariel	阿里尔	ariel
arif	明智的	wise
arifin	阿里芬	arifin
aristoteles	亚里士多德	aristoteles
aritmatika	算术	arithmetic
arjuna	阿朱那	arjuna
arkeolog	考古学家	archeology
arkeologi	考古学	archeology
armada	舰队	fleet
armenia	亚美尼亚	armenia
armijn	阿米金	armijn
arnold	阿诺德	arnold
aroma	香味	scent
aromatik	芳香	aromatic
arpanet	阿帕网	arpanet
arrancar	阿兰卡	arrancar
arsip	档案	archives
arsitek	建筑师	architect
arsitektur	建筑	architecture
art	艺术	art
artefak	文物	artifacts
arteri	动脉	artery
artha	阿尔萨	artha
arthropoda	节肢动物	arthropod
arthur	亚瑟	arthur
arti	含义	meaning
artian	含义	meaning
artikel	文章	article
artileri	炮兵	artillery
artinya	那意味着	that is
artis	艺术家	artist
artist	艺术家	artist
artistik	艺术的	artistical
aru	阿鲁	aru
arus	当前	current
arwah	精神	spirit
arya	阿里亚	arya
as	我们	united state
as$	作为$	us$
asal	起源	origin
asalkan	提供	as long as
asalnya	起源	source
asalusul	起源	origin
asam	酸	acid
asamasam	酸酸	sour
asambasa	阿桑巴萨	acid alkali
asap	抽烟	smoke
asas	原理	principle
asasi	基本的	basic
asean	东盟	asean
aseksual	无性	asexual
aset	资产	asset
asetat	醋酸盐	acetate
asetilkoa	乙ko	acetyl-coa
asia	亚洲	asia
asian	亚洲人	asian
asih	爱	compassion
asilasi	酰化	acvlation
asimilasi	同化	assimilation
asin	咸	salt
asing	国外	strange
asisten	助理	assistant
asli	原版的	original
aslinya	原本的	original
asma	哮喘	asthma
asmara	浪漫	romance
asoka	阿育王	asoka
asosiasi	协会	association
aspek	方面	aspect
aspekaspek	的方面	aspects
aspirasi	抱负	aspiration
asrama	宿舍	dormitory
assayyid	y	assayyid
astana	阿斯塔纳	cemetery
astenosfer	软流圈	asthenosphere
asteroid	小行星	asteroid
astrofisika	天体物理学	astrophysics
astronom	天文学家	astronomers
astronomi	天文学	astronomy
astronomical	天文	astronomical
astronomis	天文	astronomical
asuhan	关心	nurture
asuma	阿苏玛	asuma
asumsi	假设	assumption
asupan	录取	intake
asuransi	保险	insurance
atap	屋顶	roof
atas	上	senior
atasnya	之上	above it
atau	要么	or
ataupun	要么	or
athena	雅典娜	athena
atlantik	大西洋	atlantic
atlantis	亚特兰蒂斯	atlantis
atlas	地图集	atlas
atlet	运动员	athlete
atletik	竞技	athletic
atma	atma	atma
atmosfer	大气层	atmosphere
atmosfernya	它的气氛	its atmosphere
atom	原子	atom
atomatom	原子原子	atoms
atraksi	吸引力	attraction
atribut	属性	attribute
aturan	规则	rule
aturanaturan	规则	rules
au	au	air force
audio	音讯	audio
audit	审计	audit
auditing	审核	auditing
aura	光环	aura
aurora	极光	aurora
aus	累死了	aus
australia	澳大利亚	australia
australian	澳洲人	australian
austrasia	澳洲	austrasia
austria	奥地利	austria
austronesia	澳洲	austronesia
autentikasi	认证方式	authentication
autism	自闭症	autism
autisme	自闭症	autism
autotrof	自养	autotroph
av	影音	av
awak	船员	you
awal	早	early
awalan	字首	prefix
awalnya	原来	initially
awam	躺下	layman
awan	云	cloud
award	奖	award
awards	奖项	awards
ayah	父亲	dad
ayahnya	她的父亲	his father
ayam	鸡	chicken
ayat	段	verse
ayatayat	经文	verses
ayu	阿玉	ayu
ayunan	摇摆	swing
azerbaijan	阿塞拜疆	azerbaijan
azhar	阿扎尔	azhar
aziz	阿齐兹	aziz
ba	ba	ba
bab	章节	chapter
babad	编年史	[name]
babak	半	part
babi	猪	pig
babilonia	巴比伦	babylonia
babirusa	猪鹿	hog deer
baby	宝宝	baby
baca	继续阅读	read
bacaan	阅读	literature
back	背部	back
bacteria	菌	bacteria
badai	风暴	storm
badak	犀牛	hippo
badan	身体	body
badanbadan	身体代理	figures
badannya	他的身体	his body
badaruddin	巴达鲁丁	badaruddin
baduga	巴杜加	baduga
badung	巴东	naughty
baduy	巴杜伊	baduy
bagaikan	喜欢	like
bagaimana	怎么样	how
bagaimanapun	然而	however
bagansiapiapi	bagapiapiapi	bagansiapiapi
bagawan	好人	bagawan
baghdad	巴格达	baghdad
bagi	对于	for
bagian	部分	part of
bagianbagian	部分	the parts
bagimu	为了你	to you
baginda	ire	king
baginya	为了他	for him
bagus	非常好	good
bahagia	快乐	happy
bahan	配料	material
bahanbahan	材料	materials
bahari	航海的	maritime
bahasa	语言	language
bahasabahasa	语言	languages
bahasan	讨论区	discussion
bahaya	危险	danger
bahkan	甚至	even
bahu	肩	shoulder
bahwa	那	that
baik	好	kind
bait	对联	stanza
baja	钢	steel
bajak	犁	plow
baju	衣服	clothes
bakal	将	will
bakar	烧了它	fuel
bakat	天赋	talent
bakau	红树	mangrove
bakmi	面条	bakmi
bakn	巴肯	bakn
bakrie	巴克里	bakrie
baksa	被迫	baksa
bakteri	菌	battery
bakti	孝顺	service
baku	生的	raw
bala	增援	troops
balada	民谣	ballad
balado	巴拉多	indonesian food (very hot and spicy)
balai	大厅	hall
balap	竞速	race
balapan	种族	race
balas	回复	reply
balasan	回复	retaliate
bali	里岛	bali
balik	背后	feedback
balikpapan	巴厘巴板	balikpapan
baling-baling	螺旋桨	propeller
ball	球	ball
balok	光束	beam
balon	气球	balloon
bambang	邦邦	bambang
bambu	竹	bamboo
ban	累	tire
band	乐队	band
banda	班达	banda
bandar	书呆子	city
bandara	飞机场	airport
banding	上诉	compare
bandingkan	比较一下	compare
bandung	万隆	bandung
bang	bang	bang
bangga	骄傲	proud
bangka	放屁	farts
bangkai	体	carrion
bangkalan	邦加兰	bangkalan
bangkit	升起	rise
bangkitnya	崛起	rise
bangkok	曼谷	bangkok
bangladesh	孟加拉国	bangladesh
bangsa	国家	nation
bangsabangsa	国家	nations
bangsawan	贵族	nobleman
bangun	醒来	wake up
bangunan	建造	building
bangunanbangunan	建筑物	buildings
bani	巴尼	dynasty
banjar	班贾尔	banjar
banjarmasin	班贾尔马辛	a city in borneo
banjir	洪水	flood
bank	银行	bank
bankai	班凯	bankai
bankbank	银行	banks
banten	提供	offerings
banteng	公牛	bull
bantu	帮忙	help
bantuan	帮帮我	help
bantul	班图尔	bantul
banyak	很多	many
banyaknya	许多	most
banyumas	女巫	banyumas
banyuwangi	banyuwangi	banyuwangi
bapak	先生	father
bara	烬	ore
barakuda	梭子鱼	barracuda
barang	产品	goods
barangbarang	产品	items
barangkali	也许	perhaps
barangsiapa	谁	whoever
barat	西方	west
barcelona	巴塞罗纳	barcelona
baris	线	line
barisan	排队	line
barito	巴里托	barito
baru	新	new
barubaru	最近	recently
barulah	只有那时	then
barunya	他的新	new
barus	现在	champor
basa	基地	base
basah	湿	wet
basal	浮肿	basal
base	基础	base
baseball	棒球	baseball
basic	基本的	basic
basis	基础	base
basket	篮球	basket
basuki	basuki	basuki
bata	砖	brick
batak	巴塔克	batak
batam	巴淡	batam
batang	茎	rod
batara	神	batara
batas	限制	boundary
batasan	边界	restriction
batasbatas	边界	border
batavia	巴达维亚	jakarta
baterai	电池	battery
batik	蜡染	batik
batin	内	[name]
bats	蝙蝠	bats
batu	结石	stone
batuan	岩石	rock
batubara	煤	coal
batubatu	石头	rocks
batuk	咳嗽	shape
batutulis	我写	batutulis
bau	闻	odor
bawaan	默认	natural
bawah	下	under
bawahan	下属	subordinate
bawahnya	下	below it
bawang	洋葱	onion
bayangan	阴影	shadows
bayar	工资	pay
bayaran	付款	mercenary
bayern	巴伐利亚	bayern
bayi	宝宝	baby
bayu	巴渝	bayu
bb	bb	bb (adult site in kaskus web forum)
bbc	英国广播公司	bbc
bbm	bbm	fuel oil
bc	公元前	before century
be	是	be
bea	客户职责	customs
beagle	小猎犬	beagle
beasiswa	奖学金	scholarship
beat	击败	beat
beban	加载	load
bebas	免费的	free
bebatuan	石头	the rocks
bebek	鸭	duck
beberapa	一些	few
becak	黄包车	becak
beda	不同的	different
bedah	外科	surgery
bee	蜜蜂	bee
begitu	所以	so
beijing	北京	beijing
bekas	前任的	ex
bekasi	贝卡西	bekasi
bekerja	工作	work
bekerjasama	合作	working together
beku	冷冻的	frozen
bela	防守	defense
beladiri	自我防备	martial art
belah	分裂	split
belahan	半球	fragment
belajar	学习	study
belaka	仅仅	mere
belakang	背部	behind
belakangan	后来	later
belakangnya	在他后面	behind
belanda	荷兰	netherlands
belanja	购物	shopping
belas	怜悯	mercy
belasan	一打	a dozen
belerang	硫	sulfur
belgia	比利时	belgium
beli	购买	buy
beliau	他	he
belitung	勿里洞	belitung
bell	钟	bell
bella	贝拉	bella
belum	还没	not yet
ben	本	ben
benang	纱	strain
benar	正确	right
benarbenar	真正地	really
bencana	灾害	disaster
bench	板凳	bench
benci	讨厌	hate
benda	宾语	thing
bendabenda	对象	thing
bendera	旗	flag
bendungan	坝	dam
bengawan	高贵	bengawan
benggala	孟加拉	bengal
bengkulu	本库鲁	bengkulu
bening	明确	clear
bensin	汽油	gasoline
bentang	跨度	landscape
benteng	城堡	castle
bentuk	形成	form
bentukan	编队	shape
bentukbentuk	形状	forms
bentuknya	形状	it shapes
benturan	碰撞	impact
benua	大陆	continent
benuaq	中国大陆	benuaq
benyamin	本那明	benyamin
bepergian	旅行	travel
berabadabad	几个世纪	centuries
beracun	有毒	poisonous
berada	在...上	be
beradab	文明的	civilized
beradaptasi	适应	adapt
beragam	多样的	diverse
beragama	宗教的	religion
berakar	根	rooted
berakhir	结果	end
berakhirnya	结局	ended
berakibat	造成	impacted
beraksi	在行动	action
beralih	开关	switch
beraliran	翅	genre
berambut	头发的	hairy
beranak	有孩子	have child
beraneka	各种	a wide
beranggapan	假设	assume
beranggotakan	有成员	member
berangkat	走开	go
berangsurangsur	逐渐	gradually fade
berani	勇敢	brave
beranjak	移动	move
berapa	多少钱	how much
berapi	火热	volcano
berarti	意思是	mean
beras	白饭	rice
berasal	起源	come from
berasosiasi	关联	associated
berat	重量	heavy
beratnya	重量	its weight
beraturan	定期	regular
berau	贝劳	berau
berawal	开始了	begins
berbagai	各种	various
berbagi	分享它	share
berbahan	由...制成	made
berbahasa	说话	language
berbahaya	危险的	dangerous
berbakat	有才华的	gifted
berbalik	转过身	turnaround
berbanding	相比下	versus
berbangsa	国家	have nation
berbaring	躺下	lie
berbasis	基于	based
berbatasan	接壤	neighbor
berbau	闻到	smell
berbayar	已付	paid
berbeda	不同	different
berbedabeda	不同	different
berbentuk	成形	shape
berbicara	说出来	speaking
berbiji	种子	have seed
berbuat	做	do
berbuka	快断	end of fasting
berbulu	毛茸茸	hairy
berbunga	开花	flowered
berbunyi	读	sound
berburu	狩猎	hunt
bercabang	分支	branched
bercahaya	辉光	luminous
bercampur	混合的	mixed
bercerai	离婚了	divorce
bercerita	讲故事	story
bercinta	做爱	to make love
bercitacita	向往	aim
bercocok	农业	farming
bercorak	图案化的	have the design of
berdagang	贸易	trade
berdaging	肉质的	fleshy
berdampak	产生影响	impact
berdampingan	并排	side by side
berdarah	血腥	bleeding
berdasar	有基础	based on
berdasarkan	基于	on the basis of
berdaulat	君主	independent
berdaun	绿叶	leaf
berdaya	授权	with power
berdebat	辩论	debate
berdekatan	紧靠在一起	adjacent
berdiam	留	stay
berdiameter	在直径上	diameter
berdiri	站起来	founded
berdirinya	建立	founded
berdoa	祈祷	pray
berdosa	犯罪的	have sin
berdua	都	both
bereaksi	反应	react
beredar	流通	circulating
berekor	尾巴的	tailed
berenang	游泳的	swim
berencana	计划	planned
berenergi	充满活力	energy
bereproduksi	复制	reproduce
berevolusi	发展	evolve
berfikir	思维	thinking
berfirman	说过	said
berfokus	专注	focusing
berfungsi	功能	function
bergabung	加入	join
berganda	多	multiple
berganti	更改	change
bergantian	交替	alternately
bergantung	依靠	depend
bergaya	时尚的	stylish
bergelar	有一个标题	crowned as
bergerak	移动	move
bergeser	转移	shift
berguna	有用	useful
berhadapan	面对面	facing
berhak	有权	have a right
berhala	偶像	idols
berharap	希望	hopeful
berharga	有价值	precious
berhasil	它有效	succeed
berhenti	停止	stop
berhubungan	有关	associated
beribadah	崇拜	prayed
beribukota	首都	has its capital
berikatan	绑在一起	bind
beriklim	温带的	temperate
berikut	以下	following
berikutnya	下一个	next
beriman	有信心	faith
berinteraksi	互动	interact
berisi	包含	contains
berisikan	包含	co-ordinate
berisiko	有风险	at risk
beristirahat	休息	break
berita	新闻	news
beritaberita	有消息	news
berjalan	步行	walking
berjalannya	过去了	go
berjanji	答应我	promise
berjarak	距离	distance
berjasa	有功的	to be deserving
berjenis	流形	diversiform
berjiwa	灵魂的	spirited
berjuang	斗争	struggle
berjudul	标题	entitled
berjumlah	的数量	amount
berkaitan	有关	related
berkala	定期地	periodical
berkalikali	很多次	many times
berkas	文件	file
berkaspramuka	侦查文件	file : scout
berkat	谢谢	blessing
berkata	说过	say
berkebangsaan	国籍	nationality
berkebudayaan	养成的	cultured
berkecepatan	速度	speed
berkedudukan	住所	domiciled
berkekuatan	强大	have power
berkelana	徘徊	wandering
berkelanjutan	可持续的	sustainable
berkeley	伯克利	berkeley
berkeliling	四处转转	travel
berkelompok	在群组里	group
berkembang	发展	flourish
berkembangnya	它的发展	growing
berkenaan	关于	respect
berkepanjangan	延长的	prolonged
berkisah	讲故事	story
berkisar	范围	range
berkompetisi	竞争	compete
berkomunikasi	通信	communicate
berkonsentrasi	浓缩	concentrated
berkontribusi	有助于	contributing
berkualitas	质量	quality
berkuasa	当权的	in charge
berkuda	骑马	mounted
berkulit	皮肤	skinned
berkumpul	聚一聚	gather
berkunjung	来访	visit
berkurang	减少	reduced
berkurangnya	减少	reduced
berlainan	不同	different
berlaku	适用的	apply
berlakunya	制定	the entitled
berlalu	通过了	over
berlandaskan	基于	based on
berlangganan	订阅	subscribe
berlangsung	发生	hold
berlangsungnya	继续	ongoing
berlanjut	继续	continuous
berlapis	分层的	layered
berlari	跑	run
berlatar	组	have background
berlatih	实践	training
berlawanan	相反	against
berlayar	航行	ship
berlebih	过多	excess
berlebihan	夸张的	excessive
berlian	钻石	diamond
berlin	柏林	berlin
berlindung	掩盖	shelter
berlokasi	位置便利	located
bermacam	品种	various
bermacammacam	多种	diverse
bermain	玩过	play
bermakna	有意义的	have a meaning
bermaksud	故意的	intend
bermanfaat	有帮助的	useful
bermassa	质量	mass
bermasyarakat	善于交际	in society
bermesin	引擎	engined
bermigrasi	迁移	imigrate
berminat	有兴趣	interested
bermotor	电动的	motorised
bermuara	归结为	empty
bermuatan	带电	charged
bermuda	百慕大	bermuda
bermukim	定居	settled
bermula	开始了	started
bermunculan	弹出	popping up
bermutu	质量	have quality
bernada	倾斜	tone
bernafaskan	呼吸	breath
bernama	命名	named
bernapas	呼吸	breath
berniat	打算	intend
bernilai	价值	worth
bernuansa	细微的	nuanced
bernyanyi	唱	sing
berolahraga	行使	sporting
beroperasi	操作	operate
berorientasi	定向的	oriented
berotasi	旋转	rotate
berpakaian	穿好衣服	berbakaian
berpartisipasi	参与在	participate/join
berpasangan	成对	paired
berpegang	坚持，稍等	hold
berpendapat	争论	argue
berpenduduk	填充	inhabited
berpengalaman	有经验的	experienced
berpengaruh	生效	influential
berperan	扮演一个角色	acted as
berperang	在战争中	war
berperilaku	表现	behave
berperioda	有一段	have period
berpidato	发表演讲	giying spech
berpikir	认为	think
berpindah	移动	transfer
berpindahpindah	四处走走	keep moving from place to place
berpisah	分开	separated
berpotensi	潜在地	have potential
berpuasa	快速	fasting
berpurapura	假装	pretend
berpusat	居中	centered
berputar	旋转	spinning
berputra	有一个儿子	have son
bersabda	说过	said
bersahabat	友好	friendly
bersaing	竞争	compete
bersalah	有罪	fault
bersalin	产假	maternity
bersama	一起	with
bersamaan	一起	simultaneously
bersamasama	一起	together
bersangkutan	关心	relevant
bersatu	团结	united
bersaudara	兄弟姐妹	brothers
bersayap	翅	winged
bersedia	准备	ready
bersejarah	历史性	historic
bersekolah	上学	school
bersekutu	盟友	align
bersel	蜂窝状的	celled
bersemangat	兴奋	spirited
bersemayam	居住	reside
bersembunyi	隐藏	hide
bersenjata	武装的	armed
bersepakat	同意	agreed
bersiap	准备	get ready
bersifat	是	is
bersih	清洁	clean
bersikap	表现	be
bersinar	闪耀	shine
bersinyal	发信号	wifi
berskala	规模	have scale
berstatus	状态	status
bersumber	采购	sourced
bertabrakan	碰撞	collide
bertahan	持续	survive
bertahap	逐渐	gradually
bertahuntahun	很多年	years
bertajuk	标题	named
bertambah	增加	increase
bertambahnya	增加	increasing
bertanding	竞争	compete
bertanggung	要负责任	responsible
bertanggungjawab	负责	be responsible
bertanya	问	ask
bertapa	被监禁	meditating
bertarung	战斗	battle
bertekad	决心	determined
bertekanan	加压的	pressure
berteman	做朋友	make friends
bertempat	安置	located
bertempur	战斗	battle
bertemu	遇到	meet
bertentangan	矛盾的	contradict
bertepatan	重合	coincide
bertindak	法案	do
bertingkat	分级的	leveled
bertitik	点缀	have a point
bertiup	吹	blow
bertolak	推开	in contrast
bertopik	存根	themes
bertubuh	浓郁的	bodied
bertugas	当班	on duty
bertujuan	瞄准	aim
bertukar	交换	change
bertulang	加强型	bony
bertuliskan	它读	reads
bertumbuh	增长	growing
bertumpu	休息	focus
berturutturut	连续的	consecutive
berubah	更改	change
berubahnya	更改	changes
berubahubah	更改	changing
berujung	小费	ended into
berukuran	大小	sized
berulang	一遍又一遍	repeated
berulangulang	一遍又一遍	repeated
berumur	老龄化	age
berundak	上楼梯	with staircase
berupa	以...的形式	such as
berupaya	努力	attempt
berurutan	为了	consecutive
berusaha	企图	try
berusia	老龄化	age
bervariasi	变化	varies
berwarna	有色	colored
berwenang	授权的	authorities
berwujud	有形	in appearance
besar	大	big
besaran	规模	scale
besarbesaran	ia	massive
besarnya	幅度	amount
beserta	随着	also
besi	铁	steel
besinyal	发信号	hotspot
beta	贝塔	beta
betapa	怎么样	how
betawi	贝塔维	betawi
betina	女	female
beton	具体	concrete
bhagawadgita	巴哈吉吉塔	bhagawadgita
bhakti	奉献	bhakti
bharata	巴拉塔	bharata
bharatayuddha	婆罗浮陀	bharatayuddha
bhinneka	多样性	diversity
bhre	h	bhre
bi	双	bi
biak	乘	cud
biara	修道院	monastery
biarkan	随它去	let
biasa	普通	ordinary
biasanya	通常	usually
biawak	监控蜥蜴	lizard
biaya	成本	cost
bibir	唇	lips
bibit	种子	seed
bicara	说	talk
bidadari	天使	angel
bidang	领域	field
bidangbidang	领域	fields
big	大	big
bijak	明智的	wise
bijaksana	明智的	wise
biji	种子	seeds
bijibiji	种子	seeds
bijinya	种子	its seed
bijuu	碧珠	world of naruto
biksu	僧	monk
bila	什么时候	when
bilang	说	say
bilangan	数	numbers
bilik	隔间	chamber
bill	法案	bill
bima	比马	bima
bimbingan	指导	guidance
bin	箱子	bin
bina	建立	building
binatang	那个动物	animal
biner	二元	binary
bintan	民丹岛	bintan
bintang	星	star
bintangbintang	星星	stars
binti	宾特	daughter
bintik	斑点	spot
bioetika	生物伦理学	bioethical
biografi	传	biography
biokimia	生物化学	biochemistry
biola	小提琴	violin
biologi	生物学	biology
biologis	生物	biological
bios	bios	bios
biosintesis	生物合成	biosynthesis
bioskop	电影	cinema
bioteknologi	生物技术	biotechnology
biotik	生物的	biotic
bir	啤酒	beer
birma	缅甸	burma
biro	局	bureau
birokrasi	官僚	bureaucracy
biru	蓝色	blue
bisa	可以	can
bisnis	商业	business
bit	一点	bit
bizantium	拜占庭	byzantium
bj	j	b.j.
bksap	bksap	abbreviation
blackberry	黑莓	blackberry
bleach	漂白	bleach
blitar	双语	blitar
block	块	block
blog	博客	blog
blok	块	aligned
blood	血液	blood
blora	布洛拉	name of a city in java island
blue	蓝色	blue
bni	bni	bank negara indonesia (bank of indonesia)
bob	鲍勃	bob
bodoh	笨	stupid
body	身体	body
boediono	boediono	boediono
boeing	波音	boeing
bogor	茂物	bogor
bojonegoro	bojonegoro	bojonegoro
bola	球	ball
bolakbalik	来来回回	bolakbalik
boleh	可以	may
bolivia	玻利维亚	bolivia
bolu	海绵	cake
bom	炸弹	bomb
bonang	邦南	bonang
bonaparte	波拿巴	bonaparte
bondowoso	邦多沃索	bondowoso
bone	骨	bone
boneka	娃娃	puppet
bonjol	滚花	bonjol
books	图书	books
boot	开机	boot
borneo	婆罗洲	borneo
borobudur	婆罗浮屠	borobudur
botani	植物学	botany
botol	瓶子	bottle
bpd	每天	bank pembangunan daerah (bank name)
bpk	每次点击费用	bpk
bpupki	bpupki	bpupki
brahma	梵	brahma
brahman	婆罗门	brahman
brahmana	婆罗门	brahmin
bram	布拉姆	bram
brantas	黑雁	brantas
brasil	巴西	brazil
brawijaya	brawijaya	brawijaya
brebes	bes	brebes
bridge	桥	bridge
brigadir	准将	brigadier
brigjen	布里根	brigjen
britain	英国	britain
britania	英国	britain
britannica	大不列颠	britannica
british	英国人	british
broadband	宽频	broadband
broadcast	广播	broadcast
bromo	布罗莫	bromo
bronkodilator	支气管扩张剂	bronchodilator
brown	棕色	brown
browser	浏览器	browser
brunei	文莱	brunei
bruto	毛	gross
bsd	bsd	bsd
bsi	bsi	bsi
bu	夫人	ma'am
buah	水果	fruit
buahbuah	水果	fruits
buahbuahan	水果	fruits
buahnya	水果	fruit
buana	地球	buana
buang	抛弃	disposal
buangan	流放	waste
buat	创造	create
buatan	人工的	made in
buaya	鳄鱼	alligator
bubar	分散	scatter
bubat	布巴特	bubat
bubuh	炖	affix
bubuk	粉末	powder
bubur	稀饭	porridge
budak	奴隶	slave
budaya	文化	culture
budayanya	文化	culture
buddha	佛	buddha
buddhisme	佛教	buddhism
budha	佛	buddha
budi	心神	moral
budidaya	耕种	cultivation
budiman	亲	dar reader
bugis	武吉士	bugis
bujur	经度	square
buka	打开	open
bukaan	光圈	aperture
bukan	不	not
bukanlah	它不是	not
bukannya	代替	instead of
bukhari	布哈里	bukhari
bukit	爬坡道	hill
bukittinggi	武吉丁宜	bukittinggi
bukti	证明	evidence
buktibukti	证明	evidence
buku	书	book
bukubuku	图书	books
bukunya	这本书	book
bulan	月	month
bulanan	每月一次	monthly
bulanbulan	月	months
bulat	回合	circle
bulatan	圈	sphere
buleleng	布雷伦	buleleng
buletin	通报	bulletin
bulgaria	保加利亚	bulgarian
bulir	耳朵	ear (corn)
bulu	毛皮	hair
buluh	芦苇	bamboo
bumbu	调味料	seasoning
bumi	地球	earth
bumn	奔	bumn
bunaken	布纳肯	bunaken
buncis	豆	bean
bunda	母亲	mother
bundar	回合	oval
bung	花花公子	fella
bunga	花	flower
bungsu	最年轻的	youngest
buni	布尼	buni
bunshin	文信	(i believe this is japanese)
bunuh	杀了它	kill
bunyi	声音	sound
bupati	摄政	regent
burma	缅甸	burma
bursa	股票交易	exchange
buruan	猎物	prey
buruh	劳工	laborer
buruk	坏	ugly
burung	鸟	bird
burungburung	鸟	birds
bus	公交车	bus
busana	时尚	dress
busby	巴斯比	busby
business	商业	business
busur	弧	arc
but	但	but
buta	盲	blind
butir	项目	item
butiran	颗粒	grain
buton	布顿	buton
buwono	布沃诺	buwono
by	由	by
byakuya	白aku	byakuya
byasa	asa	byasa
byzantium	拜占庭	byzantium
c	c	c
c++	++	c++
ca	钙	ca
cabai	辣椒	chilli
cabang	科	branch
cabangcabang	分支机构	branches of
cabe	辣椒	chilli
cacar	天花	smallpox
cacat	有缺陷的	disability
cacing	虫	worms
cadangan	保留	reserve
cafe	咖啡店	cafe
cagar	储备	preserve
cahaya	光	light
cair	液体	liquid
cairan	体液	fluid
cak	ak	cak
cakar	爪	claw
cakra	脉轮	chakra
cakram	碟片	disk
cakung	卡贡	cakung
cakupan	范围	scope
california	加利福尼亚州	california
calon	候选人	candidate
calvin	加尔文	calvin
cambridge	剑桥	cambridge
camp	营	camp
campak	麻疹	measles
campur	混合	mix
campuran	混合	mixed
can	能够	can
canada	加拿大	canada
cancer	癌症	cancer
candi	寺庙	temple
candicandi	candicandi	temples
canggih	复杂的	advanced
cangkang	贝壳	shell
cantik	漂亮的	beautiful
cap	邮票	brand
cape	累	cape
capital	首都	capital
caplak	蜱	flea
cara	道路	how
caracara	道路	ways
caranya	怎么样	technique
card	卡	card
cari	寻找	search
carl	卡尔	carl
carlo	卡洛	carlo
case	案件	case
cassini	卡西尼号	cassini
castro	卡斯特罗	castro
cat	涂料	paint
catatan	一张纸条	note
catatancatatan	笔记	notes
catatannya	笔记	note
catur	棋	chess
cd	光盘	cd
cd+	cd +	cd+
cdc	cdc	cdc
cdma	光盘	cdma
cdrom	光盘	cd-rom
cedera	受伤	injured
ceko	捷克文	czech
cekungan	盆地	basin
celah	一个沟	hole
celana	裤子	pants
cell	细胞	cell
celsius	摄氏温度	celsius
cemaran	污染	pollutant
cemerlang	辉煌	brilliant
cendana	檀香	sandalwood
cendekiawan	知识分子	intellectual
cenderung	趋向	tend
cengkeh	丁香	clove
centauri	半人马座	centauri
center	中央	center
center|px	中心| px	center pixel
central	中央	central
cepat	快	fast
cerah	亮	bright
cerdas	智能	intelligent
ceres	蜡膜	ceres
ceria	快乐	cheerful
cerita	故事	story
ceritacerita	评书	stories
ceritanya	故事	story
cermat	小心	accurate
cermin	镜子	mirror
certified	认证的	certified
cetak	打印	print
cetakan	打印	print
cewek	女孩	girl
ch	ch	ch
chad	乍得	chad
chairil	chairil	chairil
chakra	脉轮	chakra
champion	冠军	champion
champions	冠军	champions
chandra	钱德拉	chandra
change	更改	change
channel	渠道	channel
chapter	章节	chapter
charles	查尔斯	charles
charlie	查理	charlie
charon	卡龙	charon
chart	图表	chart
che	车	che
chelsea	切尔西	chelsea
chester	切斯特	chestor
chi	志	chi
chicago	芝加哥	chicago
chidori	千鸟	chidori
chikungunya	基孔肯雅	chikunguya
chili	智利	chili
china	中国	china
chip	芯片	chip
chiyo	千代	chiyo
choh	h	choh
choice	选择	choice
chola	胆	chola
chouji	uji治	chouji
chris	克里斯	chris
christ	基督	christ
christian	基督教	christian
chunin	春宁	[name]
chuunin	春宁	chuunin
ci	词	ci
cia	中央情报局	cia
ciamis	恰米斯	ciamis
cianjur	前朱尔	cianjur
cicero	西塞罗	[name]
cikal	先行者	embryo
cilacap	cilacap	cilacap
cilegon	西莱贡	cilegon
cilik	儿童	small
cilincing	记账	cilincing
ciliwung	七里翁	ciliwung
cimahi	奇马希	cimahi
cina	中国	china
cincin	环	ring
cincincincin	戒指	rings
cinema	电影	cinema
cinta	爱	love
cintanya	他的爱	his love
cipta	创建	idea
ciptaan	创建	creation
ciptaannya	他的创作	his creation
ciputra	西普拉	ciputra
circuit	电路	circuit
cirebon	井里汶	cirebon
ciri	特性	characteristic
ciriciri	特征	characteristics
ciricirinya	其特点	character traits
cita	心神	taste
citacita	野心	joy
citacitanya	他的视野	his goal
citarum	西塔鲁姆	citarum
citra	图片	image
city	市	city
civil	民事的	civil
clan	氏族	clan
classic	经典	classic
claude	克劳德	claude
climate	气候	climate
clinton	克林顿	clinton
club	俱乐部	club
cmos	cmos	cmos
co	合作	co
coal	煤	coal
coba	试试看	try
cocok	适当	appropriate
cocos	可可	cocos islands
code	码	code
cokelat	巧克力	brown
coklat	巧克力	chocolate
collection	采集	collection
college	学院	college
columbia	哥伦比亚	columbia
com	com	com
common	共同	common
communication	通讯	communication
computer	电脑	computer
conan	柯南	conan
condong	倾斜	skew
conflict	冲突	conflict
constitution	宪法	constitution
contoh	例	example
contohcontoh	例	examples
contohnya	例	for example
control	控制	control
convention	惯例	convention
corak	样式	design
corporation	公司	corporation
council	议会	council
court	法庭	court
cover	覆盖	cover
cowok	家伙	guy
cpa	每次转化费用	cpa
cpu	中央处理器	cpu
critias	犯罪	critias
crocodylus	鳄	crocodylus
cs	cs	cs
cu	cu	cu
cuaca	天气	weather
cucu	孙子	grandchild
cuka	尖酸刻薄	vinegar
cukai	消费税	duty
cukup	足够	enough
cula	喇叭	horn
cullen	卡伦	cullen
culture	文化	culture
cuma	只要	just
cup	杯子	cup
curah	雨量	rainfall
curam	陡	steep
curug	瀑布	waterfall
cut	切	cut
cuti	带薪休假	furlough
cyanobacteria	蓝细菌	cyanobacteria
da	da	da
dada	胸部	chest
dadu	骰子	dice
daendels	丹德尔斯	daendels
daerah	该地区	region
daerahdaerah	区域	areas where there
daerahnya	该地区	its area
daftar	清单	list
dagang	贸易	trading
daging	肉	meat
daha	达哈	daha
dahlan	达兰	dahlan
dahsyat	可怕	fierce
dahulu	第一	ago
dahulunya	之前	formely
dai	dai	proselytizer
dajal	达哈尔	dajal
dajjal	敌基督者	dajjal
dakwah	宣传	religious preaching
dalam	在	inside
dalamnya	在里面	it
dalang	up	mastermind
dalem	宫殿	i
dalglish	达格利什	dalglish
dalil	命题	theorem
dam	大坝	dam
damai	和平	peace
dampak	影响	impact
dampaknya	影响	impact
dan	和	and
dana	基金	funds
danatau	和或	and/or
danau	湖	lake
dangdut	当当	dangdut
dangkal	浅	superficial
daniel	丹尼尔	daniel
danum	达纳姆	danum
danzo	丹佐	danzo
danzou	丹邹	danzou
dapat	可以	can
dapatkan	得到它	retrieve
dapatlah	得到它了	it can be
dapur	厨房	kitchen
dara	处女	virgin
darah	血液	blood
darahnya	血液	his blood
darat	土地	land
daratan	大陆	land
dari	从	from
daring	线上	daring
darinya	从他身上	from it
daripada	的	instead
darma	达玛	dharma
darul	达鲁尔	darul
darurat	紧急情况	emergency
darussalam	达鲁萨兰国	darussalam
darwin	达尔文	darwin
das	达斯	das
dasar	基础	base
dasarata	基础	dasarata
dasardasar	基本的	basics
dasarnya	基本上	essentially
dasawarsa	十年	ten years
data	数据	data
database	数据库	database
datadata	数据	data
datang	来	welcome
datanglah	来吧	come
datangnya	即将到来的	arrive
datar	平面	flat
dataran	平淡	plain
datuk	祖细胞	datuk
daud	ud	david (as the name)
daulah	道拉	state
daun	叶	leaf
daur	周期	recycle
dave	戴夫	dave
david	大卫	david
davis	戴维斯	davis
dawai	弦	wire
daya	功率	resource
dayak	大雅	dayak
dayang	宫廷小姐	ladies
dc	直流电	dc
de	德	de
debat	辩论	debate
debu	灰尘	dust
debut	登场	debut
dec	十月	dec
default	默认	default
definisi	定义	definition
defisiensi	不足	deficiency
defisit	赤字	deficit
degradasi	降解	degradation
deidara	代达拉	deidara
deimon	恶魔	deimon
dek	甲板	dek
dekade	十年	decade
dekat	关	close
dekatnya	附近	close
dekisugi	赤杉	dekisugi
dekker	德克	dekker
deklarasi	宣言	decleration
deklinasi	磁偏角	dekinasi
dekomposisi	分解	decomposition
dekrit	法令	decree
del	德尔	not indonesian
delapan	八	eight
delegasi	代表团	delegation
deli	熟食店	deli
delta	三角洲	delta
demak	所以	demak
demam	发热	fever
demensia	痴呆	dementia
demi	清酒	to
demikian	从而	nevertheless
demografi	人口统计	demography
demokrasi	民主	democratization
demokrat	民主党人	democratic
demokratik	民主的	democratic
demokratis	民主的	democratic
demonstrasi	示范	demonstration
den	窝	and
dendam	复仇	grudge
dengan	与	with
dengannya	用它	with
dengue	登革热	dengue
denmark	丹麦	denmark
denominasi	面值	denomination
denpasar	登巴萨	a main city in bali
densitas	密度	density
depan	面前	front
depannya	它的前面	front
departemen	部	department
department	部	department
depok	德波	depok
depresi	萧条	depression
deputi	副	deputy
der	德尔	der
derainbow	彩虹	de'rainbow
derajat	水平	degree
deras	重	swift
derby	德比	derby
deret	行	row
deretan	行	row
derivatif	衍生物	derivative
desa	村	village
desain	该设计	design
desakan	坚持	pressure
desanya	村庄	his/her village
desember	十二月	december
deskripsi	描述	description
deskriptif	描述性的	descriptive
desktop	桌面	desktop
detail	细节	detail
deteksi	检测	detection
detektif	侦探	detective
detik	秒	second
detil	详情	detail
deuterium	氘	deuterium
development	发展	development
device	设备	alat
devisa	外汇交易	foreign exchange
dewa	神	god
dewadewa	德瓦德瓦	gods
dewadewi	神	gods and goddesses
dewan	板	hall
dewantara	杜旺塔拉	dewantara
dewasa	成人	adult
dewata	神	gods
dewi	女神	dewi
dgn	与	with
dhamma	达摩	dhamma
dharma	法	dharma
dharmasraya	佛法	dharmasraya
dhien	ien	dhien
di	在	at
dia	他	he/she
diabadikan	永存	used
diabaikan	被忽略	ignored
diabetes	糖尿病	diabetes
diadakan	保持	held
diadaptasi	改编	adapted
diadopsi	被采纳	adopted
diafragma	光圈	diaphragm
diagnosa	诊断	diagnosis
diagnosis	诊断	diagnose
diagram	图	diagram
diajak	被邀请	invited
diajarkan	教导	taught
diajukan	已提交	proposed
diakhiri	已终止	ended
diakibatkan	造成	resulted
diakses	已访问	accessible
diakui	公认的	recognized
dialah	他是	he is
dialami	有经验的	experienced
dialek	方言	dialect
dialihkan	转入	redirected
dialog	对话	dialogue
dialup	拨号	dial-up
diam	闭嘴	silent
diamati	观测到的	observed
diambil	被拿走	taken
diamdiam	悄悄	quietly
diameter	直径	diameter
dian	ian	dian
diancam	受到威胁	threatened
dianggap	被认为	considered
dianggapnya	考虑过	considered
diangkat	被任命	promoted
dianjurkan	推荐的	suggested
diantara	之间	amongst
diantaranya	其中	there is/are
dianut	被拥抱	followed
diapit	侧翼	flanked
diaplikasikan	已应用	applied
diarahkan	指导的	directed
diare	腹泻	diarrhea
diartikan	被解释	meant
diasingkan	放逐	exiled
diasosiasikan	被关联	associated
diatas	以上	above
diatasi	克服	overcome
diatomik	双原子的	diatomic
diatur	规范的	set
diawali	开始了	started
diawasi	监督的	supervised
dibaca	被阅读	read
dibagi	分为	divided
dibagibagi	分享	divided
dibahas	讨论过的	covered
dibakar	烧光了	burned
dibalik	倒转	reversed
dibanding	比较	compared to
dibandingkan	比较	comparing
dibangun	被建	built
dibangunnya	建造它	build
dibantu	辅助的	helped
dibatalkan	取消	cancelled
dibatasi	受限制的	limited
dibawa	携带的	were taken
dibawah	下面	under
dibawakan	带来了	brought
dibayar	得到报酬	be paid
dibayarkan	支付	paid
dibebaskan	释放	released
dibedakan	被区分	distinguished
dibeli	买了	be bought
dibenarkan	有道理的	justified
dibentuk	成立了	formed
dibentuknya	形成的	formed
diberhentikan	被解雇	sacked
diberi	被给予	given
diberikan	被给予	given
diberlakukan	强制执行	imposed
diberlakukannya	制定	enactment
dibesarkan	带大	zoomed
dibiarkan	被孤立	allowed
dibiayai	有资金	financed
dibicarakan	讨论过	be discussed
dibintangi	主演	starred
dibuahi	受精	be fertilized
dibuang	丢弃的	discarded
dibuat	被制造	made on
dibuatnya	做好了	created by him
dibubarkan	溶解	be dissolved
dibudidayakan	耕种的	cultivated
dibuka	开了	open
dibuktikan	证明的	evidenced
dibungkus	包起来	wrapped
dibunuh	被杀害	discarded
dibutuhkan	需要	needed
dicabut	被撤销	extracted
dicampur	混合的	mixed
dicantumkan	被包括在内	included
dicapai	实现	achieved
dicari	寻找	sought
dicatat	记下	note
dicegah	预防	prevented
diceritakan	被告知	narrated
dicerna	可消化的	digested
dicetak	打印出来	produced
dicetuskan	已触发	triggered
diciptakan	被创建	created
dicirikan	特色的	characterized
dicky	dic	dicky
dicoba	受审	try
dictionary	字典	dictionary
diculik	被绑架	kidnapped
didaerah	在那地区	in the area
didaftarkan	注册	registered
didalam	在里面	inside
didalamnya	在里面	inside
didampingi	伴随着	accompanied
didanai	有资金	funded
didapat	得到了	obtained
didapati	被发现	founded
didapatkan	获得	obtained
didasari	基于	based on
didasarkan	基于	based on
didatangkan	带入	imported
didaur	回收的	recycled
didefinisikan	被定义为	defined
didengar	被听到	listened
diderita	受苦	suffered
didesain	设计的	designed
dideskripsikan	描述	described
dideteksi	检测到	detected
didih	煮	boiling
didik	学生们	educate
didirikan	已建立	founded
didistribusikan	分散式	distribute
didokumentasikan	记录	documented
didominasi	占主导地位	dominated
didorong	推	pushed
diduduki	占据	occupied
diduga	据称	expected
didukung	支持的	be supported
die	死	die
diedarkan	已发行	distributed
dieksekusi	被执行	executed
diekspresikan	表达	expressed
dien	en	deen
dieng	eng	dieng
diesel	柴油机	diesel
diet	饮食	diet
diferensial	微分	differential
diferensiasi	差异化	differentiation
difokuskan	专注	focused
difusi	扩散	diffusion
digabungkan	合并的	combined
digambarkan	图为	illustrated
diganggu	被打扰	disturbed
diganti	已取代	replaced
digantikan	已取代	replaced by
digelar	保持	held
digemari	偏爱	favored
digerakkan	感动	driven
digit	数字	digit
digital	数字	digital
digolongkan	分类	categorize
digunakan	用过的	be used
digunakannya	用它	used
dihadang	受阻	intercepted
dihadapi	面临	faced
dihadiri	参加	attended
dihancurkan	被毁	destroyed
dihapus	已删除	erased
dihapuskan	废除	abolished
diharapkan	是期待	expected
dihargai	重视	valued
diharuskan	是必要的	be required
dihasilkan	产生的	produced
dihentikan	停下来	stopped
dihiasi	装饰的	decorated
dihidupkan	打开	turned on
dihilangkan	被淘汰	removed
dihindari	避免	be avoided
dihisap	吸入	inhaled
dihitung	算了	be calculated
dihormati	尊敬的	respected
dihubungkan	被连接	connected
dihukum	受到惩罚	sentenced
dihuni	可居住的	inhabited
diidentifikasi	被识别	identified
diikat	绑	bound
diikuti	跟着	followed by
diimplementasikan	已实施	implemented
diinduksi	诱发的	induced
diingat	被记住	remembered
diinginkan	是可取的	wanted
diintegrasikan	集成	integrated
diiringi	伴随	accompanied
diisi	填写	filled
diizinkan	允许的	permitted
dijadikan	制作	be
dijaga	警惕	protected
dijajah	被殖民	colonized
dijalankan	跑	run
dijamin	保证的	guaranteed
dijatuhkan	掉落	dropped
dijelaskan	解释	explained
dijual	特价	sold
dijuluki	绰号	dubbed
dijumpai	发现	found
dikabarkan	传闻	reported
dikaitkan	被链接	associated
dikaji	研究过	studied
dikalahkan	被击败了	destroyed
dikalangan	其中	among
dikarenakan	由于	because
dikaruniai	有福	endowed
dikatakan	说过	said
dikategorikan	归类为	categorized
dikelilingi	被包围	surrounded
dikelola	管理	managed
dikelompokkan	分组	grouped
dikeluarkan	发行	be taken out
dikeluarkannya	它被释放了	issued
dikembalikan	回	be returned
dikembangkan	发达	developed
dikemudian	后来	in the future
dikemukakan	提出	proposed
dikenai	服从	given
dikenakan	破旧的	subject to
dikenal	已知的	known
dikenali	被认可	known
dikendalikan	被控制	controlled
dikepalai	领导	headed by
dikeringkan	干涸	to be drained or dried out
dikerjakan	做完了	done
diketahui	已知的	known
diketuai	主持	led by
dikhususkan	献身	devoted
dikirim	已运送	sent
dikirimkan	已运送	sent
dikisahkan	告诉	storied
diklaim	声称	claimed
diklasifikasikan	分类	classified
diklat	训练	training
dikombinasikan	合并的	in combination with
dikompilasi	已编译	compiled
dikonsumsi	已消耗	consumed
dikontrol	受控	control
dikonversi	已转换	converted
dikotil	双子叶植物	magnoliopsida
dikritik	被批评	criticized
dikuasai	压倒	controlled
dikumpulkan	集	collected
dikunjungi	参观过	visited
dikurangi	减少	reduced
dikutip	引	cited
dilacak	已追踪	tracked
dilafazkan	明显的	pronounciated
dilahirkan	出生于	born
dilaksanakan	保持	executed
dilakukan	做完了	do
dilakukannya	他是这样的	do
dilalui	通过	be passed
dilambangkan	象征性的	denoted
dilanda	遭受打击	stricken
dilangsungkan	举行	on
dilanjutkan	下一个	passed on
dilantik	发誓	inaugurated
dilapisi	涂层的	coated
dilaporkan	已报告	reported
dilarang	禁止的	prohibited
dilatih	被训练	trained
dilayani	送达	served
dilengkapi	装备	complete
dilepas	可拆卸	released
dilepaskan	已发布	let go
diletakkan	布置	placed
dilewati	绕过	skipping
dilihat	看过	seen
dilindungi	受保护的	protected
dilintasi	越过	crossed
diluar	外	outside
diluncurkan	发射了	launched
dilupakan	被遗忘	forgotten
dimainkan	玩过	be played
dimakamkan	埋葬	buried
dimakan	吃过	be eaten
dimaksud	提到	mentioned
dimaksudkan	意向的	meant
dimana	在哪里	where
dimanfaatkan	使用	be used
dimasukkan	被输入	included
dimenangkan	韩元	be won
dimengerti	可以理解的	understood
dimensi	尺寸	dimention
dimiliki	拥有的	owned by
dimilikinya	它有	it have
diminta	要求的	requested
diminum	喝醉了	drank
dimodifikasi	改性	modified
dimuat	已加载	loaded
dimulai	开始	started
dimulainya	开始	started
dimungkinkan	可能	possible
dimusnahkan	灭	destroyed
dinamai	而得名	named
dinamakan	命名	named
dinamika	动力学	dynamics
dinamis	动态	dynamic
dinas	服务	service
dinasti	王朝	dynasty
dinding	壁	wall
dingin	冷	cold
dini	早	early
dinikmati	喜欢	enjoyed
dinilai	额定的	rated
dinobatkan	加冕	crowned
dinyanyikan	唱	sing
dinyatakan	陈述	mentioned
dioda	二极管	diode
diode	二极管	diode
dioksida	二氧化碳	dioxide
diolah	处理	treated
dioperasikan	操作于	operated
dipahami	明白的	understood
dipakai	破旧的	used
dipaksa	被迫	forced
dipaksakan	被迫	forced
dipanaskan	热起来	heated
dipancarkan	发射	emitted
dipandang	看过	regarded
dipanggil	被呼入	called
dipantau	受监控	monitored
dipasang	已安装	assembled
dipasarkan	上市	marketed
dipastikan	已确认	ascertained
dipecah	分解	broken
dipecahkan	解决了	solved
dipecat	被解雇	fired
dipegang	保持	held
dipelajari	研究过	be learned
dipelihara	保持	maintained
dipelopori	率先的	pioneered
dipeluk	拥抱	obeyed
dipengaruhi	影响的	influenced
dipenuhi	完成	filled
diperankan	玩过	played by
diperbaharui	更新	renewed
diperbaiki	修好了	repair
diperbesar	扩大的	zoomed
diperbolehkan	允许的	allowed
dipercaya	可信赖的	believed
dipercayai	被信任	believed
dipercepat	加速的	be accelerated
diperdagangkan	交易	traded
diperdebatkan	辩论	arguably
dipergunakan	使用	used
diperhatikan	提防	examined
diperhitungkan	被计算	calculated
diperiksa	已检查	be examined
diperingati	被纪念	commemorated
diperintah	治理	ordered
diperintahkan	订购	ordered
diperkenalkan	被介绍了	introduced
diperkirakan	估计的	estimated
diperkuat	加强	supported
diperlakukan	处理过的	treated
diperlihatkan	显示	shown
diperluas	扩大了	expanded
diperlukan	是必须的	needed
diperoleh	获得了	obtained
diperolehnya	获得	obtained
dipersembahkan	提出了	sponsored
dipersiapkan	做好准备	prepared for
dipertahankan	保持	maintained
dipertimbangkan	被考虑	considered
dipertuan	在主	di-pertuan
diperuntukkan	意向的	decided
dipicu	已触发	caused
dipilih	已选	chosed
dipimpin	发光二极管	led
dipindahkan	转入	transfer
dipisahkan	分开的	separated
diplomasi	外交	diplomacy
diplomatik	外交	diplomatic
dipol	偶极子	dipole
diponegoro	双峰五郎	diponegoro
dipopulerkan	普及	popularized
dipotong	隔断	cut
dipraktikkan	练习过	practiced
diprediksi	预料到的	predicted
diproduksi	生产的	produced
diproses	处理	processed
dipublikasikan	已发表	published
dipukul	殴打	struck
dipungut	集	collected
diputar	旋转的	played
diputuskan	决定了	decided
diragukan	怀疑	doubted
diraih	韩元	reached
dirancang	被设计	planing
dirasakan	毡	perceived
dirawat	处理过的	treated
dirayakan	被庆祝	celebrated
direbut	没收	seized
directory	目录	directory
direkam	已记录	recorded
direkomendasikan	推荐的	recommended
direkrut	招募	recruited
direksi	导演	director
direktorat	首长级	directorate
direktori	目录	directory
direktur	导向器	director
direncanakan	计划	planned
diresmikan	就职典礼	legalize
diri	自我	self
dirilis	已发布	released
dirintis	率先	pioneered
dirinya	本人	him/her self
diriwayatkan	叙述	reported
dirugikan	受到伤害	disadvantaged
dirujuk	提到	cdc initially did not own a formal name for this disease; that aids was referred by the name of the associated diseases, for example, is lymphadenopathy. are also widely referred to a literary language based on malay roots (where indonesian is one tueunannya). as a level of analysis is often referred to as unit-level state level, because the level of analysis is put an explanation at the state level, not the international system.
dirumuskan	制定的	defined
disaat	在这一刻	when
disadari	实现的	realized
disahkan	认可	validated
disain	设计	design
disajikan	送达	served
disaksikan	目击者	witnessed
disamakan	比喻	equated
disambut	受到欢迎	welcomed
disampaikan	被交付	spoken
disamping	除了	beside
disana	在那里	there
disangka	推定	expected
disarankan	推荐的	suggested
disatukan	放在一起	united
disease	疾病	disease
diseases	疾病	diseases
disebabkan	造成	caused
disebarkan	扩散;传播开	spread
disebut	叫	called
disebutkan	提到	mentioned
disebutsebut	提到	is described
disederhanakan	简化的	simplified
disediakan	提供	be prepare
disekitar	周围	around
diselamatkan	被保存	be redeemed
diselenggarakan	保持	held
diselesaikan	解决	finished
diseluruh	始终	throughout
disempurnakan	完善的	perfected
disengaja	故意的	intentional
disepakati	同意;打勾	agreed
diserahkan	翻过来	submitted
diserang	被攻击	be invaded
diserap	被吸收	absorbed
disertai	伴随	followed by
disertakan	包括在内	included
disesuaikan	已调整	adjusted
disetujui	已批准	agreed
disfungsi	功能障碍	dysfunction
disiarkan	广播	broadcast
disimpan	已保存	stored
disimpulkan	结论	concluded
disingkat	缩写的	abbreviated
disini	这里	here
disintesis	合成的	synthesized
disiplin	学科	discipline
disk	磁盘	disc
diskografi	唱片	discography
diskriminan	判别式	determinant
diskriminasi	歧视	discrimination
diskusi	讨论区	discussion
displasia	不典型增生	dysplasia
display	显示	display
disponsori	赞助	sponsored
distribusi	分配	distribution
distrik	区	district
distro	发行版	distributions
disukai	首选	liked
disuruh	告诉	instructed
disusul	超越	followed by
disusun	安排	regulated
ditafsirkan	解释的	interpreted
ditahan	等候接听	held
ditaklukkan	被征服	conquered
ditambah	加上它	plus
ditambahkan	添加	added
ditampilkan	显示	shown
ditanam	种植	be planted
ditandai	被标记	be marked
ditandatangani	签字	signed
ditangani	处理	handled
ditangkap	被逮捕了	arrested
ditarik	拔出	pulled
ditarikan	跳舞	danced
ditawarkan	提供	offered
ditayangkan	播出	aired
ditegaskan	已确认	confirmed
ditekan	压	suppressed
ditekankan	强调	emphasized
ditelan	吞下	swallowed
diteliti	研究过	studied
ditelusuri	被追踪	traced
ditempati	占据	placed
ditempatkan	放置	placed
ditempuh	旅行	taken
ditemui	遇到	found
ditemukan	被找到	founded
ditemukannya	找到了	founded
ditentang	反对的	opposed
ditentukan	决心	determined
diterangkan	解释	explained
diterapkan	已应用	applied
diterbitkan	已出版	published
diterima	已收到	received
diterjemahkan	已翻译	translated
diteruskan	传递	forwarded
ditetapkan	组	set
ditimbulkan	被施加	caused
ditinggalkan	被排除在外	be abandoned
ditingkatkan	改善的	upgrade
ditinjau	已审查	looked
ditjen	总干事	directorate general
ditolak	被拒绝	rejected
ditonton	看过	watched
ditransmisikan	已传送	transmitted
dituangkan	倒了	poured
dituduh	被指控	accused
ditugaskan	已分配	assigned
dituju	领导	destination
ditujukan	已解决	objective
ditularkan	已传送	infected
ditulis	写下来	written
dituliskan	写下来	written
ditunjuk	被任命	pointed
ditunjukkan	显示	shown
dituntut	起诉	claim
diturunkan	降级	lowered
ditutup	关闭	close
ditutupi	掩盖	covered
dituturkan	说	spoken
diubah	变了	changed
diucapkan	说话	pronounced
diuji	经过测试	test
diukur	被测量	measured
diumumkan	被宣布	announced
diundang	被邀请	be invited
diunduh	已下载	downloaded
diungkapkan	被披露	expressions
diuraikan	描述	outlined
diurus	被照顾	managed by
diusahakan	努力的	done
diusir	踢出	expelled
diusulkan	提议的	suggested
divisi	师	division
diwajibkan	需要	required
diwakili	代表	represented
diwariskan	遗赠	inherited
diwarnai	有色	colored
diwujudkan	体现	be realized
diy	y	diy
diyakini	相信	believed
djakarta	雅加达	jakarta
djoko	乔科	djoko
dki	dki	special region
dkk	等	et al
dll	等	etc
dmasiv	dmasiv	d'masiv
dna	脱氧核糖核酸	dna
dns	域名系统	dns
do	做	do
doa	祷告	pray
dodol	笨	dodol
dog	狗	dog
dogs	小狗	dogs
dokter	医生	doctor
doktor	博士学位	doctor
doktrin	教义	the doctrine of
dokumen	文献	document
dokumendokumen	文献	documents
dokumentasi	文件资料	documentation
dolar	美元	dollars
dolly	多莉	dolly
domain	域	domain
domba	羊	sheep
domestik	国内	domestic
domestikasi	驯化	domestication
dominan	优势	dominant
dominasi	统治	domination
don	不要	don
donald	唐纳德	donald
dong	请	dong
dongeng	童话	fairytale
donor	捐赠者	donor
dont	别	dont
door	门	door
doraemon	ra啦a梦	doraemon
dorami	多拉米	dorami
dorong	推	thrust
dorongan	鼓励	urge
dos	多斯	dos
dosa	罪	sin
dosen	讲师	lecturer
dosis	剂量	dosage
douglas	道格拉斯	douglas
douwes	杜威	douwes
down	下	down
download	下载它	download
dpd	dpd	dpd
dpr	dpr	dpr
dprd	dprd	dprd
dprmpr	dprmpr	dpr/mpr
dr	博士	dr
draco	德拉科	draco
drainase	引流	thumb | left | 200px | investment concrete and pvc pipe to improve drainage systems in penugaran boribudur second in 1973, fenced halama temple, maintaining and repairing drainage systems mempebaiki floor and shower. due to the limited budget, this restoration was only focused on cleaning and stone sculpture, van erp did not solve the problem of drainage and water system.
dram	德拉姆	dram
drama	戏剧	drama
dramatis	戏剧性	dramatic
drastis	剧烈的	drastic
dream	梦想	dream
dretarastra	德雷塔拉斯特拉	dretarastra
drive	驱动器	drive
driver	司机	driver
drona	德罗纳	drona
dropadi	dropadi	dropadi
drs	博士	drs
drum	鼓	drum
dsb	等等	etc
dsl	等等	dsl
dtp	dtp	dtp
du	杜	du
dua	二	two
duduk	坐	sit
duet	二重唱	duet
dufan	杜凡	abbreviation of dunia fantasi (= fantasy world)
dugaan	推测	the alleged
duka	丧	grief
duke	公爵	duke
dukun	萨满祭司	shaman
dukungan	背书	support
dulu	过去	ago
dulunya	以前是	in the past
dumbledore	邓布利多	dumbledore
dunia	世界	world
duo	二人	two
dur	杜尔	dur
durasi	持续时间	duration
duren	榴莲	duren
duri	荆棘	thorn
durian	榴莲	durian
duryodana	杜里奥丹	duryodana
dusun	村	village
duta	大使	embassy
dvd	dvd	dvd
dwi	双	dwi
dx	dx	dx
dynamic	动态	dynamic
e	ë	e
earl	伯爵	earl
early	早	early
eclipse	日食	eclipse
economic	经济	economic
economics	经济学	economics
economy	经济	ecnonomy
ed	编	ed
edaran	圆	orbit
edisi	版	edition
edison	爱迪生	edison
edition	版	edition
editor	编辑	editor
education	教育	education
edward	爱德华	edward
efek	影响	effect
efektif	有效	effective
efektivitas	效力	effectiveness
efesien	有效率的	efficient
effendi	芬迪	effendi
efisien	有效率的	efficient
efisiensi	效率	efficiency
ego	自我	ego
eiffel	埃菲尔铁塔	eiffel
einstein	爱因斯坦	einstein
ejaan	拼写	spelling
ejakulasi	射精	ejaculation
ekliptika	黄道的	ecliptic
ekologi	生态	ecology
ekonom	经济学家	economist
ekonomi	经济	economi
ekonominya	它的经济	economy
ekonomis	经济	economic
ekor	尾巴	tail
ekosistem	生态系统	ecosystem
eksekusi	执行	execution
eksekutif	行政人员	executive
eksentrisitas	偏心率	eccentricity
eksis	存在	exist
eksistensi	存在	existence
eksklusif	独家	exclusive
ekskresi	排泄	excretion
ekspansi	扩张	expansion
ekspatriat	外籍人士	expatriate
ekspedisi	远征	the expedition
eksperimen	实验	experiment
eksperimental	实验性的	experimental
eksplisit	显性的	explicite
eksploitasi	开发	exploitation
eksplorasi	勘探	exploration
ekspor	出口	export
eksportir	出口商	exporter
eksposisi	博览会	exposition
ekspresi	表达	expression
eksternal	外部	external
ekstra	额外	extra
ekstraksi	萃取	extraction
ekstraselular	细胞外	extracellular
ekstrem	极端	extreme
ekuator	赤道	equator
elang	鹰	eagle
elder	长老	elder
electron	电子	electron
electronic	电子	electronic
electronics	电子产品	electronics
elektrik	电的	electrical
elektrode	电极	electrode
elektrokimia	电化学	electro-breaking
elektrolisis	电解	electrolysis
elektrolit	电解质	electrolyte
elektromagnetik	电磁	electromagnetic
elektron	电子	electron
elektronegativitas	电负性	electronegativity
elektronelektron	电子	elektronelektron
elektronik	电子	electronics
elektronika	电子产品	electronics
elektrostatik	静电的	electrostatic
elemen	元件	element
elemenelemen	元素	elements
elex	埃莱克斯	elex
elips	椭圆	eclipse
elit	精英	elite
elizabeth	伊丽莎白	elizabeth
email	电子邮件	email
emansipasi	解放	emancipation
emas	金币	gold
embarkasi	登船	embarkation
embrio	胚	embryo
emirat	酋长国	emirates
emisi	发射	emission
emiten	发行人	issuer
emosi	情感	emotion
emosional	情感的	emotional
empat	四	four
empedu	胆汁	gall
empekempek	empekempek	empek-empek
empire	帝国	empire
empiris	经验	empirical
enak	美味的	good
enam	六	six
encer	流鼻涕	watery
encyclopedia	百科全书	encyclopedia
end	结束	end
endapan	沉淀	sediment
endemik	地方性的	endemic
endokrin	内分泌	endocrine
endoplasma	内质	endoplasmic
endositosis	内吞作用	endocytosis
energi	能源	energy
energinya	它的能量	its energy
energy	能源	energy
engels	英格	engels
enggan	不情愿	wont
engine	发动机	engine
engineering	工程	engineering
england	英国	england
ensiklopedi	百科全书	encyclopedia
ensiklopedia	百科全书	encyclopedia
entah	不知何故	either
enterprise	企业	enterpirse
entertainment	娱乐	entertainment
entitas	实体	entities
entri	条目	entry
entropi	熵	entropy
environmental	环境的	environmental
enzim	酵素	enzyme
enzimenzim	酵素	enzymes
eosen	始新世	eocene
epidermis	表皮	cuticle
epik	史诗	epic
episode	插曲	episode
eps	eps	eps
era	时代	era
erat	紧紧	close
erectus	直立	erectus
ereksi	勃起	erection
eric	埃里克	eric
eris	埃里斯	eris
eritrosit	红细胞	erythrocyte
eropa	欧洲	europe
erosi	侵蚀	erosion
erotik	好色之徒	erotic
erupsi	喷发	eruption
erwin	欧文	erwin
es	冰	ice
esa	一	one
esem	埃塞姆	esem
esensial	必要	essential
espada	埃斯帕达	espada
estetika	美学	aesthetics
estrogen	雌激素	estrogen
et	等	et
etanol	乙醇	ethanol
ethernet	乙太网路	ethernet
ethiopia	埃塞俄比亚	ethiopia
etik	伦理	ethics
etika	伦理	ethics
etimologi	词源	etymology
etnik	种族	ethnic
etnis	种族	ethnic
eukariota	真核生物	eukariota
eukariotik	真核生物	eukaryotic
eurasia	欧亚大陆	eurasia
euro	欧元	euro
european	欧洲人	european
evaluasi	评价	evaluation
event	事件	event
evil	邪恶	evil
evolusi	演化	evolution
evolusioner	进化的	evolutionary
evolution	演化	evolution
ex	前	former
excel	擅长	excel
explorer	探险家	features contained in windows me (like internet explorer 5.5, windows media player 7.0, and microsoft direct 7.1) can even be obtained for free from the windows update site, except for system restore. in addition, windows vista also offers a version of microsoft internet explorer more secure, and windows media player new version (version 11). at this time he was in harmony with the internet explorer 7 and mozilla firefox and camino (as most of the design of yahoo!)features contained in windows me (like internet explorer 5.5, windows media player 7.0, and microsoft direct 7.1) can even be obtained for free from the windows update site, except for system restore. in addition, windows vista also offers a version of microsoft internet explorer more secure, and windows media player new version (version 11). at this time he was in harmony with the internet explorer 7 and mozilla firefox and camino (as most of the design of yahoo!) features contained in windows me (like internet explorer 5.5, windows media player 7.0, and microsoft direct 7.1) can even be obtained for free from the windows update site, except for system restore. in addition, windows vista also offers a version of microsoft internet explorer more secure, and windows media player new version (version 11). at this time he was in harmony with the internet explorer 7 and mozilla firefox and camino (as most of the design of yahoo!) features contained in windows me (like internet explorer 5.5, windows media player 7.0, and microsoft direct 7.1) can even be obtained for free from the windows update site, except for system restore. in addition, windows vista also offers a version of microsoft internet explorer more secure, and windows media player new version (version 11). at this time he was in harmony with the internet explorer 7 and mozilla firefox and camino (as most of the design of yahoo!)
express	表达	express
eyeshield	眼罩	eyeshield
f	f	f
fa	f a	fa
facebook	脸书	facebook
factbook	资料手册	factbook
facto	事实	facto
factor	因子	factor
fagosit	吞噬细胞	phagocytes
fair	公平	fair
faiz	法伊兹	faiz
fajar	黎明	dawn
fakir	较差的	poor
fakta	事实	fact
faktor	因子	factor
faktorfaktor	因素	factors
fakultas	学院	facuty
fall	秋季	fall
fals	虚假	fals
falsafah	哲学	philosophy
famili	家庭	family
fanatik	狂热的	fanatic
fans	球迷	fans
fantasi	幻想	fantasy
farmasi	药店	pharmacy
farrel	法雷尔	farrel
fase	相	phase
fashion	时尚	fashion
fasilitas	便利设施	facilities
fatah	法塔赫	fatah
fatahillah	法塔希拉	fatahillah
fatal	致命	fatal
fatimah	法蒂玛	fatimah
fatmawati	法特马瓦蒂	fatmawati
fatwa	法特瓦	decree
fauna	动物群	fauna
favorit	喜爱	favourite
fbi	联邦调查局	fbi
fe	fe	iron
featuring	特色	featuring
februari	二月	february
federal	联邦	federal
federasi	联邦	federation
federation	联邦	federation
female	女	female
fenol	苯酚	fenol
fenomena	现象	phenomena
fenotipe	表型	phenotype
feodal	封建	feudak
ferdinand	费迪南德	ferdinand
ferguson	弗格森	ferguson
fermentasi	发酵	fermentation
festival	节	festival
fet	脚	fet
fibrosis	纤维化	fibrosis
fidel	菲德尔	fidel
field	领域	field
fifa	国际足联	fifa
figur	数字	figure
fiksasi	固定	fixation
fiksi	小说	fiction
fiktif	虚拟	fictitious
filamen	灯丝	filaments
file	文件	file
filecandi	filecandi	file:temple
filipina	菲律宾	phillipines
film	电影	film
filmfilm	电影	films
filmografi	电影摄影	filmography
filosofi	哲学	philosophy
filosofis	哲学的	philosophical
filsafat	哲学	philosophy
filsuf	哲学家	philosopher
filter	过滤	filter
filum	门	phyla
final	决赛	final
financial	金融	financial
finansial	金融	financial
finlandia	芬兰	finland
firefox	火狐	firefox
firewall	防火墙	bridge between local network and the internet
firman	这个单词	commandment
first	第一	first
fisi	裂变	fusion
fisik	物理	physical
fisika	物理	physics
fisikawan	物理学家	physicist
fisiknya	身体	the physical
fisiologi	生理	physiology
fisiologis	生理	fsiologis
fiskal	财	fiscal
fitri	菲特里	fitr
fitur	功能	features
fiturfitur	特征	features
fleksibel	灵活	flexible
floem	韧皮部	fhloem
flogiston	弗洛吉斯顿	phlogiston
floppy	软盘的	floppy
flora	菌群	plants
flores	弗洛雷斯	flores
flu	流感	flu
fluida	体液	fluid
fluks	通量	flux
flying	飞行	flying
fm	调频	fm
fmfm	调频	fm
fokus	焦点	focus
fonem	音素	phoneme
food	餐饮	food
for	对于	for
forest	森林	forest
form	形成	form
formal	正式	formal
formasi	编队	formation
format	格式	format
formula	式	formula
fort	堡	fort
forum	论坛	forum
fosfat	磷酸盐	phosphate
fosfolipid	磷脂	phospholipid
fosfor	磷	phosphorus
fosforilasi	磷酸化	phosphorylation
fosil	化石	fossil
foto	照片	photo
fotofoto	正在拍照	photos
fotografer	摄影家	photographer
fotografi	摄影	photography
fotokimia	光化学	photochemistry
foton	光子	photon
fotosfer	光球	photosphere
fotosintesis	光合作用	photosyntesis
fotosistem	光系统	photosystem
foundation	基础	foundation
frac	压裂	frac out of
fragmen	分段	fragment
fraksi	分数	fraction
fraktur	断裂	fracture
frame	框架	frame
france	法国	france
francis	弗朗西斯	francis
francisco	弗朗西斯科	francisco
frank	坦率	frank
frankia	法兰克	frankia
frans	法兰	frans
frasa	短语	phrase
fred	弗雷德	fred
frederick	弗雷德里克	frederick
free	自由	free
freedom	自由	freedom
frekuensi	频率	frequency
french	法国人	french
freud	弗洛伊德	[people name]
friedrich	弗里德里希	friedrich
from	从	from
ftp	ftp	ftp
full	充分	full
fundamental	基本的	fundamental
fungi	菌类	fungus
fungsi	功能	function
fungsifungsi	功能	functions
fungsinya	它的功能	functions
fungsional	功能性	functional
fusi	融合	fusion
futsal	五人制足球	futsal
fx	外汇	fx
g	g	g
ga	ga	ga
gaara	加拉	gaara
gabah	粮食	unhulled rice
gabungan	合并的	alliance
gabus	软木	cork
gadang	加当	large sieve
gading	象牙	ivory
gadis	女孩	girl
gadjah	粗暴的	gadjah
gagal	失败了	fail
gagasan	理念	idea
gagasangagasan	想法想法	ideasideas
gaib	神奇	magical
gairah	热情	ecstasy
gajah	象	gajah
gaji	薪水	salary
galaksi	星系	galaxy
galaksigalaksi	星系	galaxies
galeri	画廊	gallery
galileo	伽利略	galileo
galuh	伤心	galuh
gam	游戏	gam
gambang	木琴	xylophone
gambar	图片	picture
gambaran	图片	picture
gambargambar	图片	images
gambir	甘比尔	gambir
gambut	泥炭	turf
game	游戏	game
gamelan	加美兰	gamelan
games	游戏	games
gamma	伽玛	gamma
gamping	酸橙	limestone
ganas	恶性的	fierce
ganda	双	handicap
gandum	小麦	wheat
gandut	荒芜	gandut
ganesha	象头神	ganesha
gang	胡同	gang
gangga	恒河	gangga
ganggang	海藻	alga
gangguan	破坏	disturbance
ganja	大麻	pot
ganti	过度	change
gantinya	代替	instead
gantung	悬挂式	dangle
gapura	门	gate
garaa	加拉	gaara
garam	盐	salt
garden	花园	garden
garis	线	line
garisgaris	线	lines
garuda	鹰航	eagle
garut	葛根	garut
gas	加油站	gas
gasgas	煤气	gasses
gates	盖茨	gates
gateway	门户	gateway
gautama	豪达摩	gautama
gawang	球门柱	goal frame
gaya	样式	style
gayo	加约	gayo
gaza	加沙	gaza
gdp	国内生产总值	gdp
gede	大的	gede
gedung	建造	building
gedunggedung	建造	buildings
gejala	症状	symptom
gejalagejala	症状	symptoms
gejolak	动荡	turbulence
gelang	手镯	bracelet
gelanggang	竞技场	arena
gelap	暗	dark
gelar	学位	title
gelas	玻璃	glass
gelatik	鹪	wasp
gelembung	气泡	bubble
gelgel	凝胶	gelgel
gelombang	波	wave
gelora	浪涌	enthusiasm
geluh	壤土	loam
gemar	喜欢	love
gembira	快乐	glad
gemilang	辉煌	brilliant
gempa	地震	earthquake
gemuk	脂肪	fat
gen	基因	gene
genangan	水坑	flooding
gencatan	停止	cessation
gendang	鼓	drum
general	一般	general
generasi	代	generation
generator	发电机	generator
genetik	遗传的	genetic
genetika	遗传学	genetic
geng	帮派	gang
genggam	手持式	handful
genin	genin	genin
genjutsu	玄术	genjutsu
genom	基因组	genome
genre	类型	genre
genus	属	genus
geografer	地理学家	geographer
geografi	地理	geography
geografis	地域	geographic
geologi	地质学	geology
geologis	地质学	geologist
geometri	几何	geometry
geomorfologi	地貌学	geomorphology
george	乔治	george
georgia	佐治亚州	georgia
gerak	运动	motion
gerakan	运动	movements
gerakangerakan	移回	movements
gerakannya	他的动作	movement
gerbang	门	gate
gereja	教会	church
gerhana	日食	eclipse
gerilya	游击队	guerrilla
gesek	轻扫	friction
gesekan	摩擦	friction
get	得到	get
getah	树液	rubber
getaran	振动	vibration
getsuga	uga	getsuga
gigi	齿	teeth, tooth
gigih	持久的	persistent
gigitan	咬	bite
gila	疯了	crazy
gilbreth	吉尔布雷斯	gilbreth
gilirannya	转	turn
ginjal	肾	kidney
giovanni	乔万尼	giovanni
giral	吉拉尔	deposit paper
giri	女孩	giri
giribangun	吉里班根	giribangun
gitar	吉他	guitar
giuseppe	朱塞佩	giuseppe
gizi	营养	nutrient
glikogen	糖原	glycogen
glikolisis	糖酵解	glycolisis
glikoprotein	糖蛋白	glycoprotein
gliserol	甘油	glycerol
global	全球	global
globalisasi	全球化	globalization
globe	地球	globe
glosarium	词汇表	glossary
glukagon	胰高血糖素	glucagon
glukosa	葡萄糖	glucose
gmail	gmail	gmail
gnb	gn	nam
gnu	牛羚	gnu
go	走	go
goa	洞穴	cave
gohan	悟饭	gohan
goku	悟空	goku
gol	目标	goal
gold	金	gold
golden	金色的	periode
golf	高尔夫球	golf
golkar	戈尔卡	golkar
golongan	组	group
gong	锣	gong
google	谷歌	google
gordon	高登	gordon
goreng	油炸	fried
goresan	从头开始	scratch
gosip	八卦	gossip
gotong	互助	carry
government	政府	government
gowa	高娃	gowa
gp	gp	gp
gprs	gprs	gprs
gps	全球定位系统	gps
gradien	梯度	gradient
grafik	图表	graph
grafis	图形	graphical
graha	格拉哈	graha
gram	公克	gram
grand	盛大	grand
gratis	免费的	free
gravitasi	重力	gravitation
gresik	格雷西克	gresik
grimmjow	格林莫	grimmjow
ground	地面	ground
group	组	group
grup	组	group
gua	洞穴	cave
guatemala	危地马拉	guatemala
gubernur	总督	governor
gudang	仓库	warehouse
guevara	格瓦拉	guevara
gugur	秋季	died; musim gugur = fall
gugus	组	cluster
gugusan	簇	cluster
gui	gui	graphical user interface
guide	指南	guide
guido	圭多	guido
guinea	几内亚	guinea
gula	糖	sugar
gulai	咖喱	gulai
gulma	杂草	weed
gulungan	滚	rolls
guna	使用	use
gunakan	采用	use
gunawan	古纳万	gunawan
gunung	山	mountain
gununggunung	火山	mountains
gurindam	古林丹	gurindam
guru	老师	teacher
guruh	雷	thunder
gurun	沙漠	desert
gurunya	老师	his/her teacher
gus	古斯	gus
gusti	摔角	gusti
gutawa	古塔瓦	name
guy	家伙	guy
h+	h +	h+
ha	哈	ha
haart	哈特	haart
habibie	哈比比	habibie
habis	用完了	entirely
habitat	栖息地	habitat
hadapan	之前	the presence of the
hadi	哈迪	hadi
hadiah	礼物	gift
hadir	现在	stand
hadirnya	出勤率	the presence
hadis	圣训	hadith
hadist	圣训	hadiths
hadits	圣训	hadith
hai	你好	hai
haid	经期	menstruation
hajar	殴打	hajar
haji	朝圣	hajj
hak	对	right
hakhak	权利	rights
hakikat	本质	nature
hakim	法官	judge
haku	哈库	haku
hal	事情	case
halaman	页	yard
halhal	东西	matters
halim	你好	halim
hall	大厅	hall
halloween	万圣节	halloween
halnya	案子	as
halo	你好	halo
halus	光滑	soft
ham	火腿	human rights
hama	害虫	pest
hamas	哈马斯	[people name]
hamba	仆人	servant
hambatan	抵抗性	obstacle
hamengku	哈曼库	hamengku
hamengkubuwono	hamengkubuwono	hamengkubuwono
hamid	哈米德	hamid
hamil	孕	pregnant
hamka	哈姆卡	name
hampir	几乎	almost
hamzah	哈姆扎	hamzah
han	han	han
hancur	被毁	destroyed
handal	可靠	reliable
hang	挂	hang
hangat	暖	warm
hantu	鬼	ghost
hanya	只要	only
hanyalah	只要	only
hanyutan	冲走	drift
hara	养分	nutrient
harafiah	文字	literally
haram	哈兰	forbidden
harapan	希望	dream
hardware	硬件	hardware
harfiah	从字面上看	literal
harga	价钱	price
hari	天	day
harian	日常	daily
harihari	天	days
harimau	虎	tiger
harinya	那天	day
harmoni	和谐	harmony
harold	哈罗德	harold
harry	哈里	harry
hart	哈特	hart
harta	宝藏	material
harum	香	fragrant
harun	哈伦	harun
haruno	春野	haruno
harus	必须	must
haruslah	一定是	be
harvard	哈佛大学	harvard
hasan	哈桑	hasan
hasanuddin	哈桑丁	hasanuddin
hasil	结果	result
hasilhasil	结果	the results
hasilnya	结果	the result
hasrat	欲望	desire
hastinapura	hastinapura	[people name]
hasyim	哈辛	hasyim
hata	a	hata
hatake	仇恨	hatake
hati	心	heart
hatihati	小心	carefully
hatinya	他的心	heart
hatta	八田	hatta
haumea	豪美亚	haumea
hawa	天气	weather
hawaii	夏威夷	hawaii
hayam	哈亚姆	hayam
hayat	生活	life
hayati	生物	biological
he	他	he
health	健康	kesehatan
heart	心	heart
hebat	大	great
heinrich	亨利	heinrich
helen	海伦	helen
helikopter	直升机	helicopter
heliopause	绝经	heliopause
helios	太阳神	helios
heliosfer	日球	heliosphere
helium	氦	helium
hemoglobin	血红蛋白	hemoglobin
hendak	想要	intend
hendaknya	应该	must be
henry	亨利	henry
hentai	无尽的	hentai
hepatitis	肝炎	hepatitis
hepatosit	肝细胞	hepatocyte
herakles	伊拉克利翁	hercules
herbert	赫伯特	herbert
herman	赫尔曼	herman
hermione	赫敏	hermione
heroin	海洛因	heroin
herpes	疱疹	herpes
herschel	赫歇尔	herschel
hesiodos	黑西多斯	hesiodus
het	t	het
heterogen	异质	heterogeneous
heterotrof	异养菌	heterotroph
hewan	动物	animal
hewanhewan	动物	animals
hg	汞	hg
hi	你好	hi
hias	装饰	ornamental
hiasan	装饰	decoration
hib	希伯	hib
hibrida	杂种	hybrid
hiburan	娱乐	entertainment
hidan	希丹	hidan
hidayat	hidayat	hidayat
hidayatullah	hidayatullah	hidayatullah
hidrida	氢化物	hybrids
hidrogen	氢	hydrogen
hidrografi	水文	hydrography
hidrokarbon	碳氢化合物	hydrocarbons
hidroksida	氢氧化物	hydroxide
hidrologi	水文	hydrology
hidung	鼻子	nose
hidup	生活	live
hidupnya	他的生命	life
hierarki	等级制	heirarchy
hijau	绿色	green
hijrah	迁移	migrate
hijriyah	希耶里亚	hijri calendar
hikayat	佐贺	saga
hikmah	智慧	benefits that can be taken
hikmat	智慧	wisdom
hilal	希拉尔	hilal
hilang	丢失	disappear
hilangnya	消失	gone
hilir	下游的	downstream
himalaya	喜马拉雅山	himalaya
himne	赞美诗	hymn
himpunan	集合	the set
hinata	日向	hinata
hindia	印度人	indies
hindiabelanda	荷兰东印度群岛	dutch east indies
hindu	印度教	hindu
hindubuddha	印度教佛陀	hindu/buddha
hinduisme	印度教	hinduism
hingga	至	till
hipertensi	高血压	hypertension
hipotesis	假设	hypothesis
hirarki	等级制	hierarchy
hirata	平田	hirata
hiruma	平沼	hiruma
his	他的	his
hisab	清算	calculation
histologi	组织学	histology
historis	历史的	historical
hitam	黑色	black
hitler	希特勒	[people name]
hits	命中	hits
hitsugaya	人谷屋	hitsugaya
hitungan	计数	count
hiu	鲨鱼	shark
hiv	艾滋病病毒	hiv
hivaids	hiv爱滋病	hiv/aids
ho	浩	ho
hobi	爱好	hobby
hogwarts	霍格沃茨	hogwarts
hokage	火影	hokage
hollow	空心的	hollow
hollywood	好莱坞	hollywood
holocaust	大屠杀	holocaust
home	家	home
homeros	荷姆罗斯	homer
homo	同性恋者	homo
homogen	同质	homogeneous
homonim	同音异义词	homonym
honda	本田	honda
hong	红	hong
hongaria	匈牙利	hungary
hooke	胡克	hooke
horcrux	horcrux	horcrux
horizontal	水平的	horizontal
hormat	尊重	respect
hormon	激素	hormone
horor	恐怖	horror
hortikultura	园艺学	horticulture
hospital	医院	hospital
host	主人	host
hosthost	主机	hosts
hotel	旅馆	hotel
house	屋	house
how	怎么样	how
howard	霍华德	howard
hp	生命值	handphone
http	http	http
hubble	哈勃	hubble
hubungan	关系	connection
hubungannya	关系	relationship
hueco	韦科	hueco
hujan	雨	rain
hukum	法	law
hukuman	惩罚	penalty
hukumhukum	法律	laws
hulu	上游的	upstream
humor	幽默	humor
huruf	字母	letter
husada	ada田	husada
husain	侯赛因	husain
hutama	羽多摩	hutama
hutan	森林	forest
hutang	债务	debt
hutanhutan	森林	forest
hyang	香	hyang
hybrid	杂种	hybrid
hydrogen	氢	hydrogen
hyuga	日向	hyuga
i	一世	i
ia	他是	he
iain	爱因	iain
ialah	是	is
ian	ian	ian
ibadah	崇拜	worship
iban	伊班	iban
iblis	魔鬼	devil
ibm	ibm	ibm
ibn	伊本	ibn
ibnu	伊卜努	ibn
ibrahim	易卜拉欣	ibrahim
ibrani	希伯来语	hebrew
ibu	母亲	mother
ibukota	首都	capital
ibukotanya	首都	capital city
ibunya	她妈妈	his mother
ichigo	一护	ichigo
id	id	id
ida	伊达	ida
ide	理念	idea
idea	理念	idea
ideal	理想	ideal
ideide	ideide	ideas
identifier	识别码	identifier
identifikasi	鉴定	identification
identik	相同	identical
identitas	身份	identity
ideologi	思想	ideology
idola	偶像	idol
idris	艾德里斯	idris
idul	开斋节	eid-ul
ieee	ee	ieee
ii	ii	ii
iii	iii	iii
ijo	绿色	green
ika	伊卡	ika
ikal	卷曲	curly
ikan	鱼	fish
ikari	ika	[people name]
ikat	束	tie
ikatan	键	tie
ikatanikatan	粘接	ikatanikatan
ikip	iki	ikip
iklan	广告	advertise
iklim	气候	climate
ikon	图标	icon
iktiologi	伊克蒂奥洛吉	ichthyology
ikut	来吧	follow
il	il	il
ilegal	非法	illegal
iliad	ilia	iliad
ilir	ir	ilir
illinois	伊利诺伊州	illinois
illuminati	照度	illuminati
ilmiah	科学的	scientific
ilmu	科学	knowledge
ilmuilmu	你的知识	knowledge
ilmuwan	科学家	scientist
ilusi	错觉	illution
ilustrasi	插图	illustration
im	即时通讯	im
image	图片	image
images	图片	images
imam	牧师	imam
iman	信仰	faith
imbalan	奖励	reward
imf	国际货币基金组织	imf
imida	亚美达	imida
imigran	移民	immigrant
imigrasi	移民	immigration
imlek	中国新年	chinese new year
imperialis	帝国主义	imperialist
imperialisme	帝国主义	imperialism
imperium	帝国	empire
impian	梦想	dream
implementasi	实作	implementation
implikasi	含意	implication
implisit	隐含的	implicit
impor	进口	import
importir	进口商	importer
impresionisme	印象派	impressionism
improvisasi	即兴创作	improvisation
impuls	冲动	impulse
imun	免疫的	immune
imunisasi	免疫	immunization
imunitas	免疫	immunity
imunologi	免疫学	immunology
in	在	in
inang	主办	wet nurse
inc	公司	incorporation
indah	美丽的	beautiful
indeks	指数	index
independen	独立	independent
indera	感	sense
index	指数	index
india	印度	india
indian	印度人	indians
indikasi	指示	indication
indikator	指示符	indicator
indische	顽疾	indische
individu	个人	individual
individual	个人	individually
indo	印度	indo
indochina	印度支那	indochina
indonesia	印尼	indonesia
indonesian	印度尼西亚	indonesian
indosat	印度支	indosat
indosiar	do	indosiar
indra	感官	indra
indragiri	英德拉吉里	indragiri
indramayu	因德拉马尤	indramayu
induk	父母	parent
induknya	它的父母	its parent
induksi	感应	induction
industri	行业	industry
industrial	产业	industrial
industrialisasi	工业化	industrialization
industry	行业	industry
infeksi	感染	the infection
infiks	中缀	infix
inflasi	通货膨胀	inflation
influenza	流感	influenza
info	资讯	info
informal	非正式的	informal
informasi	信息	information
informatika	信息学	informatics
infra	下层	infra
inframerah	红外线	infra-red
infrastruktur	基础设施	infrastructure
ing	ing	ing
ingat	记得	remember
ingatan	记忆	memory
inggris	英语	england
ingin	想	want
inhibisi	抑制	inhibition
inhibitor	抑制剂	inhibitor
ini	这个	this
inilah	就是这个	this
inisiatif	倡议	intiative
injil	福音	gospel
inkubasi	孵化	incubation
ino	创能	ino
inovasi	革新	innovation
input	输入	input
insan	人	human being
insang	鳃	gill
insentif	激励	insensitive
insiden	事件	incident
insinyur	工程师	engineer
inspeksi	检查	inspection
inspektur	检查员	inspector
inspirasi	灵感	inspiration
instalasi	安装	installation
instan	瞬间	instant
instansi	机构	institute
institusi	机构	institution
institut	研究所	institute
instruksi	指示	instruction
instrumen	仪器	instrument
insulin	胰岛素	insulin
intan	钻石	diamond
integral	积分	integral
integrasi	积分	integration
intel	英特尔	intel
intelektual	知识分子	intelectual
intelijen	情报	intelligence
intensif	密集的	intensive
intensitas	强度	intensity
inter	间	inter
interaksi	相互作用	interaction
interaktif	互动	interactive
interest	利益	bunga
interface	接口	interface
interior	内饰	interior
internal	内部	internal
internasional	国际的	international
international	国际的	international
internet	互联网	internet
interpretasi	解释	interpretation
interpreter	口译员	interpreter
interval	间隔	interval
intervensi	介入	intervention
inti	核心	core
intifada	起义	intifada
intinya	重点	core
intranet	内联网	intranet
intraselular	细胞内	intracellular
intrinsik	固有	intrinsic
introduction	介绍	introduction
invasi	侵入	invation
invertebrata	无脊椎动物	invertebrate
investasi	投资	investment
investigasi	调查	investigation
investor	投资者	investor
io	io	i/o
ion	离子	ion
ionik	离子的	ionic
ionisasi	电离	ionization
ionosfer	电离层	ionosphere
ip	ip	internet protocol
ipcc	ipcc	ipcc
ipv	ipv	ipv
ir	ir	ir
irak	伊拉克	irak
irama	韵律	rhyme
iran	伊朗	iran
iri	羡慕	jealous
irian	妒	irian
irigasi	灌溉	irrigation
iris	切片	iris
iritasi	刺激	irritation
irlandia	爱尔兰	ireland
iruka	iruka	iruka
is	是	is
isa	伊萨	isa
isaac	艾萨克	isaac
isbn	伊斯本	isbn
ishida	石田	ishida
isi	内容	content
isinya	其内容	the content
iskandar	伊斯坎达	iskandar
islam	伊斯兰教	islam
islami	伊斯兰教	islamic
ismail	伊斯梅尔	ismail
iso	iso	iso
isolasi	绝缘	isolation
isotop	同位素	isotope
isp	互联网服务提供商	isp
israel	以色列	israel
isshin	一心	isshin
istana	宫	castle
isteri	妻子	wife (wives)
istiadat	海关	culture
istilah	术语	the term
istilahistilah	术语	terms
istimewa	特别	treatment
istirahat	打破	break
istri	妻子	wife
istrinya	他的老婆	his wife
isu	问题	issue
isuisu	问题	issues
isyarat	手势	cue
ita	伊塔	ita
itachi	itachi	itachi
italia	意大利	italia
itanium	钛	itanium
itb	itb	bit (bandung institute of technology)
its	它的	its
itu	那	it
itulah	那是	that
iupac	尤帕克	iupac
iv	iv	four
iwan	我要	iwan
ix	ix	ix
izin	允许	license
jabatan	位置	position
jabatannya	他的位置	position
jack	插口	jack
jackson	杰克逊	jackson
jacob	雅各布	jacob
jacobin	雅各宾	jacobin
jadi	所以	so
jadwal	时间表	schedule
jafar	贾法尔	ja'far
jagung	玉米	corn
jahat	邪恶的	bad
jahe	生姜	ginger
jaipongan	斋浦尔	jaipongan
jaja	贾贾	jaja
jajahan	殖民地	colony
jajak	轮询	poll or survey
jajaran	队伍	range
jaka	贾卡	bachelor
jakarta	雅加达	jakarta
jaksa	检察官	prosecutor
jalan	街	road
jalanan	街道	street
jalanjalan	路	roads
jalannya	方式	process
jalur	车道	lane
jam	小时	hour
jamaah	朝圣者	pigrims
jamak	复数	plural
jamal	贾马尔	jamal
jamaluddin	贾玛鲁丁	jamaluddin
jambi	詹比	jambi
jambu	番石榴	guava
james	詹姆士	james
jaminan	保证	warranty
jamur	蘑菇	mushroom
jan	简	jan
janda	寡妇	widow
jang	张	which
jangan	不要	do not
jangka	期	period
jangkauan	范围	reach
janin	胎儿	embryo
janji	诺言	appointment
jantan	男	male
jantung	心	heart
januari	一月	january
japan	日本	japan
japonica	粳稻	japonica
jarak	距离	distance
jaraknya	距离	the distance is
jarang	很少	seldom
jari	手指	finger
jarijari	手指	radius
jaring	互联网	net
jaringan	网络	network
jaringanjaringan	网络	mesh network
jarum	针	needle. jarum jam = hour hand
jas	适合	coat
jasa	服务	services
jasanya	他的服务	services
jasmani	物理	physical
jasminum	茉莉	jasminum
jati	柚木	teak
jatinegara	贾廷加拉	jatinegara
jatuh	摔倒	falls
jatuhnya	秋天	the fall
jauh	远	far
java	爪哇	java
jawa	爪哇	java
jawab	回答	answer
jawaban	答案	answer
jawatan	服务	service
jawi	牛	java
jaya	胜利的	jaya
jayakarta	雅加达	jakarta
jayakatwang	贾卡旺	jayakatwang
jazirah	半岛	peninsula
jazz	爵士乐	jazz
jean	吉恩	jean
jejak	脚印	trail
jejaring	网络	networking
jelas	清除	real
jembatan	桥	bridge
jember	詹伯	jember
jenang	珍南	porridge
jenar	杰纳尔	jenar
jenazah	尸体	corpse
jend	詹德	general
jendela	窗口	window
jenderal	一般	general as in military
jendral	一般	general
jenis	类型	kind
jenisjenis	类型	type of species
jenisnya	类型	its kind
jenius	天才	genius
jenjang	水平	ladder
jenuh	饱和的	saturated
jepang	日本	japan
jepara	杰帕拉	jepara
jerami	稻草	straw
jerawat	青春痘	acne
jerman	德语	german
jersey	球衣	jersey
jeruk	橙子	orange
jet	喷射	jet
jibril	加布里埃尔	gabriel
jihad	圣战	jihad
jika	如果	if
jilid	体积	volume
jimbron	金布龙	jimbron
jimly	吉米利	jimly
jimmy	吉米	jimmy
jin	金恩	genie
jinak	良性	benign
jinchuuriki	金chu里	jinchuuriki
jingga	橙子	orange
jinta	金塔	jinta
jiraiya	吉来耶	jiraiya
jitu	说正确	sharp
jiwa	灵魂	life
jl	l	street
joe	乔	joe
johann	约翰	johann
johannes	约翰尼斯	johannes
john	约翰	john
johor	柔佛州	johor
jombang	孟邦	jombang
jones	琼斯	jones
jong	钟	jong
jonggrang	钟格朗	jonggrang
jonin	乔宁	jonin
joseph	约瑟夫	joseph
journal	日记	journal
jr	r	junior
jual	卖	sell
juan	an	juan
juanda	胡安达	juanda
juara	冠军	winner
jubah	披风	robe
judul	标题	title
juga	太	also
jujur	诚实	fair
juli	七月	july
julia	朱莉娅	julia
julukan	昵称	nickname
jumat	星期五	friday
jumlah	量	total
jumlahnya	数量	amount
jump	跳	jump
junction	交界处	junction
jung	荣	jung
juni	六月	june
junior	初级	junior
jupe	朱佩	jupe
jupiter	木星	jupiter
jurang	深渊	cliff
juri	陪审团	jury
jurnal	日记	journal
jurnalis	记者	journalist
juru	口译员	interpreter
jurus	样式	martial art
jurusan	专业	department
justru	恰好	it is precisely
jusuf	朱苏夫	jusuf
juta	百万	million
jutaan	百万	miillions
jutsu	柔术	jutsu
juventus	尤文图斯	juventus
k	ķ	k
ka	k a	ka
kab	摄政	regency
kabah	天房	ka'bah
kabar	新闻	news
kabel	电缆	cable
kabinet	内阁	cabinet
kabupaten	地区	regency
kabupatenkota	卡布帕滕科塔	regency
kabur	逃跑	escape
kabut	多雾路段	fog
kabuto	卡布托	kabuto
kaca	玻璃	glass
kacang	花生	peanut
kacau	搞砸了	messy
kadal	蜥蜴	lizard
kadang	有时	sometimes
kadangkadang	有时	sometimes
kadangkala	有时	sometimes
kadar	内容	content
kadensa	卡登萨	cadenza
kadipaten	公国	duchy
kadiri	出席	kadiri
kadmium	镉	cadmium
kafe	咖啡店	cafe
kafir	异教徒	infidel
kage	卡格	kage
kagebunshin	景本院	kagebunshin
kaget	惊讶的	shocked
kahuripan	服从	kahuripan
kai	kai	kai
kaidah	规则	principle
kain	布	cloth
kairo	开罗	cairo
kaisar	皇帝	emperor
kaitan	连接	tie
kaitannya	关系	in relation
kajian	研究	review
kakak	哥哥	older brother
kakaknya	她的弟弟	his brother
kakashi	卡卡西	kakashi
kakawin	卡卡温	kakawin
kakek	祖父	snicker
kakeknya	他的祖父	his/her grandfather
kaki	脚	foot
kakinya	他的脚	feet
kaku	死板的	rigid
kakuzu	角津	kakuzu
kala	时间	time
kalah	失去	lost
kalangan	界	the
kalapa	随你	kelapa
kalasan	卡拉桑	kalasan
kalau	如果	if
kalender	日历	calendar
kali	时间	time
kalian	你们	you
kaliber	口径	caliber
kalijaga	守护	kalijaga
kalimantan	加里曼丹	kalimantan
kalimat	句子	sentence
kalinya	时间	times
kalium	钾盐	potassium
kalkulator	计算器	calculator
kalkulus	结石	calculus
kalsium	钙	calcium
kamar	房间	room
kambing	山羊	goat
kamboja	柬埔寨	kamboja
kamera	相机	camera
kami	我们	we
kamis	星期四	thursday
kampanye	运动	campaign
kampar	坎帕尔	kampar
kampung	村	village
kampus	校园	campus
kamu	您	you
kamus	字典	dictionary
kanada	加拿大	canada
kanakkanak	儿童	children
kanal	运河	canal
kanan	对的	right
kancah	现场	arena
kandang	笼	cage
kandidat	候选人	candidate
kandung	生物	biological
kandungan	子宫	content
kang	炕	kang
kanji	淀粉	japanese letter
kanker	癌症	cancer
kanton	广州	canton
kantong	袋	bag
kantor	办公室	ofice
kantorkantor	办公室	offices
kantung	袋	bag
kapak	斧头	ax
kapal	船	ship
kapalkapal	船	ships
kapan	什么时候	when
kapang	模子	mold
kapas	棉	cotton
kapasitas	容量	capacity
kapiler	毛细血管	kaplier
kapita	人均	capita
kapital	首都	capital
kapitalis	资本家	capitalist
kapitalisme	资本主义	capitalism
kapitan	卡皮坦	lieutenant
kapsid	衣壳	capsid
kapsul	胶囊	capsule
kapten	队长	captain
kapuas	卡普亚斯	kapuas
kapur	粉笔	chalk
kara	卡拉	alone
karakter	字符	character
karakteristik	特点	characteristic
karakterkarakter	人物	characters
karakura	卡拉仓	karakura
karang	珊瑚	the reef
karangan	文章	article
karangasem	卡朗阿森	karangasem
karat	锈	corrosive
karavan	大篷车	caravan
karawang	卡拉旺	falkirk
karbida	碳化物	carbide
karbohidrat	糖类	carbohydrate
karboksil	羧基	carboxyl
karbon	碳	carbon
karbonat	碳酸盐	karbonat
karbondioksida	二氧化碳	carbon dioxide
kardiovaskular	心血管的	cardiovascular
karena	因为	because
karenanya	因此	because of that
karesidenan	居留权	residency
karet	橡胶	rubber
karibia	加勒比海	caribia
karier	事业	career
kariernya	他的事业	his career
karin	卡林	karin
karl	卡尔	karl
karma	业力	karma
karna	因为	karna
karnivora	食肉动物	carnivore
karno	卡诺	karno
karo	卡罗	karo
karsinogen	致癌物	carcinogen
karsinoma	癌	carcinoma
kartanegara	卡塔尼加拉	kartanegara
kartika	卡蒂卡	kartika
kartini	卡蒂尼	kartini
kartu	卡	card
kartun	动画片	cartoon
karya	创建	work
karyakarya	工作	works
karyakaryanya	他的工作	his works
karyanya	他的工作	his work
karyawan	员工	employee
kas	现金	cash
kasar	粗	rough
kasat	无形	visible
kaset	卡带	cassette
kasih	爱	love
kaskus	卡斯库斯	kaskus
kaskuser	kaskuser	kaskuser
kaspia	里海	caspia
kasta	种姓	caste
kasus	案件	case
kasuskasus	案件	cases
kata	这个单词	word
katai	侏儒	small
katak	青蛙	toad
katakan	说出来	say
katakata	话	the words
katalis	催化剂	catalysis
katalog	目录	catalog
katanya	他说	he said
kategori	类别	category
kategoriaktris	类别	category : actress
kategorialumni	类别	alumni category
kategorianatomi	分类解剖	anatomy category
kategorianime	分类法	category:anime
kategoriartikel	类别文章	catergory:article
kategoribahasa	语言类别	category:language
kategoridaftar	列出类别	category:list
kategoriekonomi	经济类别	category economy
kategorifilm	电影类别	category:film
kategorigrup	组类别	group category
kategoriindonesia	印尼类别	category : indonesia
kategorimanga	g	category
kategorinegara	国家类别	nation category
kategoripenyakit	疾病类别	category:diseases
kategoripenyanyi	演唱类别	singer category
kategoriperang	战争类别	category:war
kategoriperangkat	设备类别	category ware
kategoriplanet	行星类别	category : planet
kategorisejarah	历史类别	history category
kategorisistem	分类系统	category:system
kategoritokoh	分类图	category:figure
kation	阳离子	cation
katode	阴极	cathode
katolik	天主教徒	catholic
katup	阀	valve
kau	您	you
kaum	民间	society
kawah	火山口	crater
kawan	朋友	friend
kawanan	牛群	group
kawankawannya	朋友	his friends
kawasan	区域	region
kawasankawasan	区域	regions
kawat	线	wire
kawi	卡维	kawi
kawin	伴侣	marry
kaya	丰富	rich
kayu	木	wood
kazekage	风影	a character's name
kbbi	kbbi	indonesian dictionary
kd	d	kd
ke	至	to
keadaan	情况	situation
keadilan	正义	justice
keagamaan	宗教的	religion
keahlian	专长	keahliam
keajaiban	奇迹	miracle
keamanan	安全	security
keanekaragaman	多样性	diversity
keanggotaan	会员资格	membership
keasaman	酸度	acidity
keatas	到顶部	up
kebahagiaan	幸福	happiness
kebaikan	类	goodness
kebakaran	火	fire
kebal	免疫的	immune
kebalikan	相反	the opposite
kebanggaan	自豪	pride
kebangkitan	复活	raise
kebangsaan	国籍	nationality
kebanyakan	最重要的	mostly
kebayoran	凯巴约兰	kebayoran
kebebasan	自由	freedom
kebenaran	真相	truth
kebenarannya	真相	truth
kebencian	仇恨	hatred
keberadaan	存在	location
keberadaannya	它的存在	its/his/her existence
keberagaman	多样性	diversity
keberanian	勇敢	braveness
keberatan	心神	objection
keberhasilan	成功	success
kebersamaan	团结	togetherness
kebersihan	清洁度	hygiene
keberuntungan	运气	lucky
kebesaran	伟大	glory
kebetulan	巧合	accidental
kebiasaan	习惯	habbit
kebidanan	助产	midwifery
kebijakan	政策	policy
kebijakankebijakan	政策	policies
kebijaksanaan	智慧	wisdom
kebingungan	混乱	confusion
kebocoran	泄漏	leakage
kebon	科邦	kebon
kebudayaan	文化	culture
kebugaran	适合度	health
kebumian	地球	terrestrial
kebun	花园	garden
kebutuhan	需要	need
kecak	奇卡	kecak
kecakapan	技能	proficiency
kecamatan	分地区	sub-district
kecambah	豆芽	shoot
kecelakaan	事故	accident
kecenderungan	趋势	trend
kecepatan	速度	speed
kecepatannya	它的速度	speed
kecerdasan	情报	intelligence
kecewa	失望的	disappointed
kecil	小	small
kecilnya	它很小	little
kecuali	除了	except
kedah	吉打	kedah
kedalam	进入	into
kedalaman	深度	depth
kedamaian	和平	peacefulness
kedatangan	到达	arrival
kedaulatan	主权	sovereignty
kedekatan	接近	distance
kedelai	黄豆	soybean
kedelapan	第八	eighth
kediaman	住宅	residence
kedinasan	服务	service
kediri	克迪里	kediri
kedokteran	医疗	medical
kedu	科杜	kedu
kedua	第二	second
keduanya	都	both
kedudukan	位置	position
kedudukannya	他的位置	position
kedutaan	大使馆	embassy
keemasan	金色的	golden
keempat	第四	fourth
keenam	第六	sixth
keesokan	明天	next
kegagalan	失败	failure
keganasan	恶性肿瘤	fierceness
kegelapan	黑暗	darkness
kegiatan	活动	activity
kegiatankegiatan	活动	activities
kegiatannya	其活动	activities
kegunaan	易用性	function
kehabisan	用完	exhausted
kehadiran	存在	presence
kehakiman	司法机关	judiciary
kehamilan	怀孕	pregnancy
kehancuran	破坏	destroy
keharusan	必须	requirement
kehendak	将	will
kehidupan	生活	life
kehidupannya	他的生命	life
kehilangan	失去	lost
kehormatan	荣誉	honor
kehutanan	林业	forestry
keilmuan	科学	scientific knowledge
keindahan	美女	aesthetics
keinginan	欲望	desire
keinginannya	他的愿望	desire
keistimewaan	特权	distinction
kejadian	事件	incident
kejadiankejadian	事件	events
kejahatan	犯罪	criminal act
kejaksaan	律师	chancellor
kejam	残忍	cruel
kejatuhan	掉出来	fall
kejayaan	荣耀	glory
kejayaannya	它的荣耀	its glory
kejuaraan	锦标赛	championship
kejutan	吃惊	surprise
kekacauan	混沌	chaos
kekaisaran	帝国	empire
kekal	永恒	eternal
kekalahan	打败	the defeate of
kekasih	情人	lover
kekayaan	财富	wealth
kekayaannya	他的财富	property
kekebalan	免疫	immunity
kekejaman	残酷	cruelty
kekekalan	永恒	eternity
kekeluargaan	亲属关系	kinship
kekerabatan	亲属关系	family
kekerasan	暴力	violence
kekeringan	干旱	drought
kekhalifahan	哈里发	the caliphate
kekhasan	特点	peculiarity
kekhawatiran	烦恼	worries
kekosongan	空虚	void
kekristenan	基督教	christianity
kekuasaan	功率	authority
kekuasaannya	他的力量	his control
kekuatan	功率	force
kekuatankekuatan	长处	powers
kekuatannya	它的力量	strength
kekuningan	淡黄色	yellowish
kekurangan	缺乏	lack
kelabu	灰色	gray
kelahiran	出生	birth
kelahirannya	他的出生	his birth
kelainan	异常	deviation
kelak	后来	later
kelakuan	行为	behavior
kelamin	性别	gender
kelancaran	光滑度	continuity
kelangkaan	缺乏	scarcity
kelangsungan	连续性	continuity
kelanjutan	延续	continuation
kelantan	基兰丹	place
kelapa	椰子	coconut
kelaparan	挨饿	famine
kelarutan	溶解度	solvation
kelas	类	class
kelaskelas	班级	classes
kelautan	海洋的	marine
kelebihan	多余的	advantages
kelelahan	疲劳	fatigue
kelemahan	弱点	weakness
kelembaban	湿度	humidity
kelembapan	湿度	humidity
kelengkapan	完整性	completeness
kelenjar	腺	gland
kelenteng	寺庙	temple
kelihatan	可见	looks like
kelihatannya	它似乎	looks like
keliling	周围	travelling
kelima	第五	fifth
kelinci	兔子	rabbit
keliru	错误	wrong
kelompok	组	group
kelompokkelompok	团体	the group
kelompoknya	他的小组	his group
kelopak	花瓣	sheath
keluar	出口	go out
keluaran	输出	output
keluarga	家庭	family
keluarganya	他的家庭	his/her family
keluarnya	排出	discharge
keluhan	抱怨	complaint
kelurahan	村办	village
kelvin	开尔文	kelvin
kemacetan	拥塞	stagnation
kemaharajaan	帝国	kingdom
kemajuan	进展	progress
kemakmuran	繁荣	prosperity
kemampuan	能力	ability
kemampuannya	他的能力	ability
kemandirian	独立	autonomic
kemang	克芒	kemang
kemanusiaan	人性	humanity
kemarahan	愤怒	anger
kemarau	干	dry
kemasyarakatan	社会的	civic
kematian	死	death
kematiannya	他的过世	his death
kemayoran	凯马约兰	kemayoran
kembali	背部	back
kembalinya	返回	the return of
kembang	花	flower
kembar	双胞胎	twin
kemenangan	胜利	victory
kementerian	部	ministry
kementrian	部	ministry
kemerahan	带红色	redish
kemerdekaan	独立	freedom
kemerdekaannya	它的独立性	freedom
kemih	尿路	urine
kemiringan	坡	tilt
kemiripan	相似	similiarity
kemiskinan	贫穷	poverty
kemitraan	合伙	partnership
kemudahan	缓解	ease
kemudian	然后	then
kemunculan	紧急情况	emerging
kemunduran	挫折	setbacks
kemungkinan	可能性	possibility
ken	ken	ken
kena	击中	hit
kenaikan	增加	increase
kenal	知道	known
kenampakan	出现	appearence
kenangan	回忆	memory
kencana	肯卡纳	kencana
kencang	紧	toned
kencing	小便	pee
kendala	障碍物	constraint
kendali	控制	control
kendaraan	车辆	vehicles
kendati	尽管	although
kenegaraan	国家地位	state
kenikmatan	享受	enjoyment
kenneth	肯尼斯	kenneth
kenny	肯尼	kenny
kental	厚	thick
kentang	土豆	potato
kenya	肯尼亚	kenya
kenyataan	现实	reality
kenyataannya	事实	fact
kep	基普	archipelago
kepada	至	to
kepadanya	给他	to him
kepadatan	密度	density
kepahlawanan	英雄主义	heroism
kepala	头	head
kepalanya	他的头	head
kepanduan	侦察	scouting
kepastian	肯定	certainty
kepemilikan	所有权	ownership
kepemimpinan	领导	leadership
kepemimpinannya	他的领导	leadership
kependekan	短缺	abbreviation
kependudukan	人口	civil
kepentingan	兴趣爱好	interest
kepentingannya	它的重要性	interests
keperawatan	护理	nursery
kepercayaan	信任	religion
keperluan	必要性	need
keping	芯片	chip
kepolisian	警察	police
kepompong	茧	cocoon
kepopuleran	人气	popularity
keppres	总统令	presidential decree no.
kepramukaan	侦察	scouting
kepresidenan	总统职位	presidency
kepribadian	个性	character
kepuasan	满足	satisfaction
kepulauan	岛	archipelago
kepunahan	灭绝	extinction
kepustakaan	文献	literature
keputihan	白带	whitish
keputusan	决定	decision
kera	猴	monkeys
kerabat	一个亲戚	relatives
keracunan	中毒	poisoned
keragaman	多样性	diversity
kerah	领	collar
kerajaan	王国	kingdom
kerajaankerajaan	皇家王国	kingdom
kerajaannya	他的王国	its government
kerajinan	工艺	craft
kerak	脆皮	crust
kerakyatan	民粹主义者	populist
keramik	陶瓷	ceramic
kerang	蛤	clam
kerangka	构架	framework
keranjang	篮	basket
kerap	经常	often
kerapatan	密度	density
keras	硬	hard
keraton	宫	palace
kerbau	水牛	buffalo
kerdil	侏儒	dwarf
kereta	火车	wagon
kerikil	砾石	pebble
kerinci	详情	kerinci
kering	干	dry
keringat	汗	sweat
keripik	筹码	chips
keris	克里斯	kris
kerja	工作	work
kerjanya	有用	work
kerjasama	合作	teamwork
kernel	内核	kernel
kerohanian	灵性	spirituality
keroncong	克龙聪	keroncong
kertabhumi	tab	kertabhumi
kertajaya	克雅塔雅	kertajaya
kertanagara	克塔纳加拉	kertanegara
kertanegara	国家	kertanegara
kertas	纸	paper
kerugian	失利	loss
kerumitan	复杂	difficulty
keruntuhan	坍方	downfall
kerupuk	饼干	crackers
kerusakan	损伤	damage
kerusuhan	动荡	unrest
kesadaran	意识	awareness
kesaksian	见证	witness
kesal	懊恼	annoyed
kesalahan	错误	fault
kesamaan	相似	common
kesan	印象	impression
kesatria	骑士	warrior
kesatuan	统一	unity
kesedihan	悲伤	grief
kesehatan	健康	health
keseimbangan	平衡	balance
kesejahteraan	福利	welfare
keselamatan	安全	safety
keseluruh	对所有人	throughout
keseluruhan	整个	whole
kesembilan	第九	ninth
kesempatan	机会	chance
kesemuanya	他们全部	all
kesenangan	享受	hobby
kesenian	艺术	art
kesenjangan	差距	gap
kesepakatan	成交	agreement
kesetaraan	平等	equality
kesetiaan	忠诚	fidelity
kesetimbangan	平衡	balance
kesimpulan	结论	conclusion
kestabilan	稳定性	stability
kesuburan	生育能力	fertility
kesuksesan	成功	succeed
kesulitan	麻烦	difficulty
kesultanan	帝国	kingdom
kesusastraan	文献	literature
ketahanan	耐力	endurance
ketahui	知道	know
ketakutan	惊吓	scared
ketan	糯米饭	sticky rice
ketapang	吉打邦	ketapang
ketat	严格	tight
ketatanegaraan	国家行政	constitutional
ketebalan	厚度	thickness
ketegangan	张力	tension
ketentuan	规定	clause
ketepatan	准确性	accuracy
keterampilan	技能专长	skills
keterangan	信息	information
keterbatasan	局限性	limitation
ketergantungan	依赖	dependency
keterkaitan	联动	linkage
keterlibatan	参与	involvement
ketersediaan	可用性	availability
ketertarikan	利益	interest
ketertiban	订购	dicipline
ketetapan	法令	resolution
ketiadaan	虚无	absence
ketidak	没有	lack of
ketidakmampuan	无力	inability
ketidakpastian	不确定	uncertainty
ketidakpuasan	不满意	lack of satisfaction
ketidakseimbangan	不平衡	imbalance
ketidakstabilan	不稳定	instability
ketiga	第三	third
ketiganya	三个都	these three
ketika	什么时候	when
ketimbang	而不是	than
ketinggalan	落后	out of date
ketinggian	高度	height
ketoprak	ketoprak	ketoprak
ketua	主席	leader
ketuhanan	神	trust in god
ketujuh	第七	seventh
ketuk	敲	knock
keturunan	后代	descent
keturunannya	他的后代	his / her lineage
keuangan	金融	monetary
keunggulan	卓越	advantages
keunikan	独特性	uniqueness
keuntungan	利润	profit
keutuhan	整体性	unity
kevin	凯文	kevin
kewajiban	义务	obligation
kewajibannya	它的义务	obligations
kewalahan	不知所措	overwhelmed
kewarganegaraan	国籍	nationality
kewenangan	权威	authority
keyakinan	置信度	confidence
keynes	凯恩斯	keynes
khadijah	卡迪亚	khadija
khalayak	听众	public
khalifah	哈里发	caliph
khan	可汗	khan
khas	典型	typical
khasnya	典型	unique
khatulistiwa	赤道	equator
khawatir	担心	concerned
khilafah	希拉法	caliphate
khmer	高棉	khmer
khusus	特别	specific
khususnya	特别	in particular
ki	ki	ki
kiai	基爱	kiai
kiamat	末日	doomsday
kian	越来越多	more
kiba	木场	kiba
kicauan	rp	chirp
kidal	左撇子	kidal
kids	孩子们	kids
kijang	鹿	deer
kilang	炼油厂	refinery
kilometer	公里	kilometer
kim	金	kim
kimia	化学	chemical
kimiawan	化学家	chemists
kimiawi	化学的	chemical
kinabalu	京那巴鲁	kinabalu
kinerja	表演	performance
kinetik	动力学的	kinetic
kinetika	动力学	kinetics
king	国王	king
kini	现在	now
kiong	ong	kiong
kipas	风扇	fan
kira	认为	guess
kirakira	大约	approximately
kiri	剩下	now
kirigakure	基里加库雷	kirigakure
kirinya	剩下	his/her left
kisah	故事	tale
kisahkisah	故事	story
kisame	kisame	kisame
kisaran	范围	range
kisuke	喜介	kisuke
kita	我们	we
kitab	书	holy book
kitabkitab	图书	books
klaim	要求	claim
klan	氏族	clan
klasifikasi	分类	classification
klasik	经典	classical
klaten	克拉登	klaten
klien	客户	client
klik	点击	click
klimatologi	气候学	climatology
klinik	诊所	clinic
klinis	临床	clinical
klip	夹	clip
klitoris	阴蒂	clitoris
klon	克隆	clone
klorida	氯化物	chloride
klorin	氯	chlorine
klorofil	叶绿素	chlorophyll
kloroplas	叶绿体	chloroplast
klub	俱乐部	club
klungkung	功隆	klungkung
kluster	簇	cluster
km	公里	kilometer
knowledge	知识	knowledge
ko	ko	ko
koalisi	联盟	coalition
koch	科赫	koch
kode	码	code
kodifikasi	编纂	codification
kodok	青蛙	frog
koefisien	系数	coefficient
koenzim	辅酶	coenzyme
kofaktor	辅因子	cofactor
kognitif	认知的	cognitive
koh	h	koh
koin	硬币	coin
kok	真	cock
kokain	可卡因	cocaine
kokoh	坚固	solid
kolaborasi	合作	collaboration
kolam	池子	pond
koleksi	采集	collection
kolektif	集体	collective
kolektor	集电极	collector
kolesterol	胆固醇	cholesterol
koloid	胶体	colloid
kolom	柱	column
kolombia	哥伦比亚	columbia
kolonel	上校	colonel
koloni	殖民地	colony
kolonial	殖民	colonial
kolonialisme	殖民主义	colonialism
kolonisasi	殖民化	colonoization
koma	昏迷	coma
komandan	指挥官	commando
komando	命令	command
kombinasi	组合	combination
komedi	喜剧	comedy
komentar	评论	comment
komering	科默林	komering
komersial	商业的	comercial
komersil	商业的	comercial
komet	彗星	comet
komik	可笑的	comics
komisaris	专员	commissioner
komisi	佣金	commission
komite	委员会	committee
komitmen	承诺	commitment
komoditas	商品	commodities
komoditi	商品	commodity
komodo	科莫多巨蜥	komodo dragon
komparatif	比较	comparative
kompas	罗盘	compass
kompatibilitas	兼容性	compatibility
kompensasi	补偿金	compensation
kompetensi	权限	competency
kompetisi	竞争	competition
kompetitif	竞争的	competitive
kompilasi	汇编	compilation
komplek	复杂	complex
kompleks	复杂	complex
kompleksitas	复杂	complexity
komplemen	补充	complement
komplikasi	并发症	complication
komponen	零件	component
komponenkomponen	零件	components
kompos	堆肥	compost
komposisi	组成	composition
komposisinya	其组成	its composition
kompromi	妥协	compromise
komputasi	计算	computation
komputer	电脑	computer
komputerkomputer	电脑	computers
komputindo	komputindo	komputindo
komunikasi	通讯	communication
komunis	共产	communist
komunisme	共产主义	communism
komunitas	社区	community
kondensasi	缩合	condensation
kondisi	健康）状况	condition
kondisikondisi	条件	conditions
kondom	避孕套	condom
konduktivitas	电导率	conductivity
koneksi	连接	connection
konfederasi	联盟	confederation
konferensi	会议	conference
konfigurasi	组态	configuration
konflik	冲突	conflict
konfrontasi	对抗	confrontation
kong	孔	kong
konghucu	孔子	confucius
kongo	孔戈	congo
kongres	国会	conggress
konkret	具体	concrete
konoha	木叶	konoha
konohagakure	konohagakure	konohagakure
konon	据推测	reputedly
konsekuensi	后果	consequence
konsensus	共识	consensus
konsentrasi	浓度	concentration
konsep	概念	concept
konsepkonsep	概念	concepts
konsepsi	概念	concept
konser	音乐会	concert
konservasi	保护	conservation
konservatif	保守	conservative
konsil	议会	council
konsili	议会	council
konsisten	一致的	consistent
konsonan	辅音	consonant
konspirasi	阴谋	conspiracy
konstan	不变	constant
konstanta	一个常数	constant
konstituante	组分	constitutional assembly
konstitusi	宪法	the constitution of the
konstitusional	宪政的	constitutional
konstruksi	施工	construction
konsultan	顾问	consultant
konsultasi	咨询服务	consultation
konsumen	消费者	consumer
konsumsi	消费	consume
kontak	联系	contact
konteks	语境	context
kontemporer	当代的	contemporary
konten	内容	content
kontes	比赛	contest
kontra	计数器	contra
kontrak	合同	contract
kontraksi	收缩	contraction
kontras	对比	contrast
kontribusi	贡献	contribution
kontributor	贡献者	contributor
kontrol	控制	control
kontroversi	争议	controversy
kontroversial	有争议的	controversial
konveksi	对流	convection
konvektif	对流	convective
konvensi	惯例	convention
konvensional	常规	conventional
konversi	转换	conversion
koordinasi	协调	coordination
koordinat	坐标	coordinate
koordinator	协调员	coordinator
koperasi	合作社	cooperative
kopi	咖啡	coffee
koran	报纸	newspaper
korawa	科拉瓦	korawa
korban	受害者	victim
korea	韩国	korea
koreksi	更正	correction
koreografi	编舞	choreograph
koridor	走廊	corridor
korona	电晕	corona
korosif	腐蚀性的	corosive
korporasi	公司	corporation
korps	兵团	corps
korteks	皮层	cortex
korupsi	腐败	corruption
kosa	词汇	vocabulary
kosakata	词汇	vocabulary
kosmik	宇宙的	cosmic
kosmogoni	宇宙的	cosmogony
kosmologi	宇宙学	cosmology
kosong	空白	idle
kostum	服装	costume
kota	城市	city
kotak	盒子	box
kotakota	城市	cities
kotamadya	自治市	city
kotanya	城市	city
kotor	脏	gross
kotoran	污垢	feces
kovalen	共价	covalent
kpk	千千	kpk
krakatau	克拉卡托	krakatoa
krama	举止	ethic
kramat	克拉玛特	kramat
kraton	宫殿	kraton
kreativitas	创造力	creativity
kredit	信用	credit
kresna	克里希纳	krishna
kreta	克雷塔	crete
kri	克里	kri
kriminal	刑事	criminal
krisdayanti	克里斯达坦蒂	krisdayanti
krisis	危机	crisis
kristal	水晶	crystal
kristen	基督教	christian
kristiani	基督教	christian
kristus	基督	christ
kriteria	标准	criteria
kritik	评论家	critics
kritikus	评论家	critics
kritis	危急	critical
kroasia	克罗地亚	croatia
kromosom	染色体	cromosom
kronik	慢性的	chronic
kronis	慢性的	chronic
kronologi	年表	chronology
kronologis	按时间顺序	chronology
kronos	克朗诺斯	kronos
ksatria	骑士	knight
ktt	tt	hlc (high level conference)
ku	我的	i
kuadrat	广场	quadratic
kuah	酱	gravy / soup
kuala	瓜拉	kuala
kualifikasi	资质	qualification
kualitas	质量	quality
kualitatif	定性的	qualitative
kuantitas	数量	quantity
kuantitatif	定量的	quantitative
kuantum	量子	quantum
kuark	夸克	quarks
kuasa	功率	authorization
kuat	强大	storng
kuatnya	强大	strength
kuba	古巴	cuba
kubah	圆顶	dome
kubu	据点	stronghold
kubur	墓	tomb
kuburan	坟墓	tomb
kuchiki	库奇基	[people name]
kuchiyose	草千岁	summoning
kucing	猫	cat
kuda	马	horse
kudeta	政变	coup d'etat
kudus	圣	kudus
kue	蛋糕	cake
kuhp	kuhp	criminal law book
kuil	寺庙	temple
kuiper	库珀	kuiper
kuliah	大学	lecture
kuliner	烹饪	culinary
kulit	皮肤	skin
kulitnya	皮	her/his skin
kulon	库隆	kulon
kultivar	品种	cultivar
kultur	文化	culture
kultus	邪教	cult
kuman	细菌	germ
kumpulan	组	group
kuna	库纳	ancient
kunci	键	key
kundang	昆当	kundang
kuning	黄色	yellow
kuningan	黄铜	brass
kunjungan	访问	visit
kuno	古	ancient
kunti	昆蒂	kunti
kuntilanak	昆蒂拉纳克	kuntilanak
kupang	古邦	kupang
kupon	优惠券	coupon
kupukupu	蝴蝶	butterfly
kurang	减	less
kurangnya	缺乏	lack of
kurenai	库雷奈	kurenai
kurikulum	课程	curriculum
kurita	栗田	kurita
kurniawan	库尔尼万	kurniawan
kurosaki	黑崎	kurosaki
kursi	椅子	chair
kuru	库鲁	kuru
kurukshetra	库鲁克舍特拉	cemetery
kurun	期	period
kurung	括号	parenthesis
kurva	曲线	curve
kushina	库希纳	kushina
kusuma	草间	kusuma
kuta	库塔	[place name]
kutai	古泰	[kingdom name]
kutipan	引用	quotes
kutu	跳蚤	flea
kutub	极	pole
kutukan	诅咒	curse
kuwait	科威特	kuwait
kyai	牧师	kyai
kyoto	京都	kyoto
kyubi	九壁	kyubi
kyuubi	久比	kyuubi
l	升	l
la	啦啦	la
laba	利润	profit
label	标签	label
laboratorium	实验室	laboratory
labu	南瓜	flask
lada	胡椒	pepper
ladang	领域	field
lagi	再次	again
lagu	歌曲	the song
lagulagu	再次歌	songs
lagunya	这首歌	the song
lah	h	are
lahan	土地	land
lahir	天生的	born
lahirlah	出生	born
lahirnya	他的出生	born
lain	其他	other
lainlain	等等	other
lainnya	另一个	other
laju	率	pace
lakilaki	男	male
laksamana	上将	admiral
lakshmana	lakshmana	lakshmana
laktat	乳酸盐	milk acid
laku	行为	behavior
lakukan	做吧	do
lalu	然后	traffic
lalunya	过去	past
lama	长	old
lamanya	永远	duration
lambang	符号	symbol
lambat	慢一点	late
lambung	胃	stomach
lamongan	拉蒙根	lamongan
lampau	过去	past
lampu	灯	lamp
lampung	楠榜	lampung
lan	lan	lan
lancar	顺利	smooth
landasan	基础	base
langgam	样式	langgam
langit	天空	sky
langka	罕见	rare
langkah	步	step
langkahlangkah	脚步	steps
langkan	壁架	temple fender
langsung	生活	directly
lanjut	继续	further
lanjutan	高级	advanced
lanka	兰卡	sri lanka
lantai	地板	floor
lantas	所以	then
laos	老挝	laos
lapangan	领域	field
lapar	饥饿	hungry
lapindo	拉平多	lapindo
lapis	层	layer
lapisan	层	layer
lapisanlapisan	涂层	layers
laporan	报告	report
laptop	笔记本电脑	laptop
larangan	禁止	forbidden
lari	跑	run
laris	需求	popular
larut	晚了	soluble
larutan	解	aqueous solution
larva	幼虫	flyblow
laser	激光	laser
laskar	不规则的	soldier
last	持续	last
lastri	lastri	lastri
latar	背景	background
latihan	实践	training
latin	拉丁	latin
laun	逐渐	gradually
laura	劳拉	laura
laut	海	sea
lautan	海	sea
lautnya	海	its sea
lava	岩浆	lava
lavey	拉维	lavey
lavoisier	拉瓦西耶	lavoisier
lawan	对手	oppose
lawang	锤	mace
lawannya	他的对手	his/her opponent
layak	值得	appropriate
layaknya	像	as if
layanan	服务	service
layang	立交桥	high
layar	屏幕	screen
lazim	流行	customarily
lazimnya	通常	typically
lc	lc	l/c
lebah	蜜蜂	bee
lebak	勒巴克	lebak
lebanon	黎巴嫩	lebanon
lebar	宽	width
lebaran	开斋节	widths
lebarnya	宽	width
lebat	重	heavy
lebih	更多	more than
lebur	融化了	melting
ledakan	爆炸	explosion
lee	李	lee
legal	法律	legal
legenda	传说	legend
legendaris	传奇的	legendary
legislasi	立法	legislative
legislatif	立法	legislative
legitimasi	合法性	legitimacy
leher	颈部	the neck
leibniz	莱布尼兹	leibniz
leiden	莱顿	leiden
lelah	累	tired
lelaki	男子	male
lelang	拍卖	auction
leluhur	祖先	ancestor
lemah	弱	weak
lemak	脂肪	fat
lemas	跛行	weak
lembaga	机构	institute
lembagalembaga	机构	institutes
lembah	谷	valley
lembap	dan	humid
lembar	片	piece
lembaran	片	sheet
lembut	柔软的	soft
lempeng	碟子	plate
lempengan	平板	a plate
lempenglempeng	盘子	plates
lencana	徽章	badge
lendir	黏液	mucus
lengan	臂	arms
lengkap	完成	complete
lengkung	弯曲	curved
lensa	镜片	lens
lenyap	消失了	vanished
leonardo	列昂纳多	leonardo
leopold	利奥波德	leopold
lepas	自由	freelance
lereng	坡	slope
lestari	可持续的	lestari
leste	莱斯特	leste
letak	那个地点	placed
letaknya	它的位置	its location
letkol	上校	liutenant colonel
letnan	中尉	lieutenant
letusan	喷发	eruption
leukemia	白血病	leukemia
leukosit	白细胞	leukocytes
leuser	勒瑟	leuser
leusina	leusina	leusina (a type of amino acid)
level	水平	level
lewat	通过	late
lewis	刘易斯	lewis
lhokseumawe	lhokseumawe	lhokseumawe
lia	利亚	lia
liang	发情	burrow
liar	野性的	wild
liat	看到	clay
liberal	自由派	liberal
liberalisme	自由主义	liberalism
libur	假日	holiday
libya	利比亚	libya
lidah	舌	tongue
life	生活	life
lift	电梯	elevator
liga	联盟	league
light	光	light
lihat	看到	see
likeur	像	liqueur
likuiditas	流动性	liquidity
lilin	蜡烛	candle
lilitan	卷积	bind
lily	百合	lily
lima	五	five
limbah	浪费	waste
limfosit	淋巴细胞	lymphocytes
limit	限制	limit
lincoln	林肯	lincoln
lindung	受保护的	reservation
line	线	line
linear	线性地	linear
lingga	阴茎	lingam
linggarjati	林加加蒂	linggarjati
lingkar	周	circumference
lingkaran	圈	circle
lingkungan	环境	environment
lingkungannya	它的环境	environment
lingkup	范围	scope
linguistik	语言学	linguistics
link	链接	link
linkin	连接蛋白	linkin
lintang	纬度	latitude
lintas	交叉	latitude
lintasan	轨迹	trajectory
linux	linux	linux
lion	狮子	lion
liontin	吊坠	pendant
lipat	可折	fold
lipid	脂质	lipid
liputan	覆盖范围	coverage
lirik	歌词	lyric
lisa	丽莎	lisa
lisan	口服	spoken
lisensi	执照	license
lisosom	溶酶体	lysosomes
list	清单	list
listrik	电力	electricity
litani	连弹	litania
literatur	文献	literature
litosfer	岩石圈	lithosphere
little	小	little
liur	唾液	saliva
live	生活	live
liver	肝	liver
liverpool	利物浦	liverpool
lobus	叶	lobe
local	本地	local
locke	洛克	locke
log	日志	login
logam	金属	metal
logaritma	对数	logarithm
logat	口音	accent
logika	逻辑	logic
logis	合乎逻辑的	logical
logistik	后勤	logistics
logo	徽标	logo
lokal	本地	local
lokasi	那个地点	location
lokasinya	那个地点	its location
lolos	摆脱	saved from
lomba	比赛	lomba
lombok	辣椒	lombok
lompat	跳	jump
lompatan	飞跃	jump
london	伦敦	london
long	长	long
longgar	疏松	loose
longsor	雪崩	avalanche
lonjong	椭圆	oval
lontong	年糕	lontong
lorong	走廊	tunnel
los	洛斯	los
louis	路易斯	louis
low	低	low
luapan	溢出	flood
luar	外面	outside
luarnya	外	outside
luas	广泛的	wide
luasnya	宽度	extent
lubang	孔	hole
luhur	升华	noble
luka	伤口	wound
lukaluka	卢卡卢卡	injured
lukis	绘画	paint
lukisan	涂料	painting
lulus	已毕业	pass
lulusan	毕业	graduate
lumajang	差不多	town
lumbalumba	海豚	dolphin
lumbung	谷仓	barn
luminositas	亮度	luminosity
lumpur	泥	mud
lumut	苔藓	alga
luna	露娜	luna
lunak	柔软的	soft
lung	肺	lung
lupa	忘了	forget
lupus	狼疮	lupus
lurus	直行	straight
lutut	膝盖	knee
luwu	灵活	luwu
lyon	里昂	lyon
m	米	m
ma	嘛	ma
maaf	抱歉	sorry
mac	苹果电脑	mac
macam	各种各样的	sort
macammacam	杂	various
macan	虎	tiger
macintosh	麦金托什	macintosh
macro	巨集	macro
mada	马达	mada
madara	马达拉	madara
made	制作	from (japanese word)
madinah	麦地那	madina
madiun	麦迪恩	madison
madrid	马德里	madrid
madu	蜜糖	honey
madura	马杜拉	madura
maeda	前田	maeda
magelang	马格朗	magelang
magnesium	镁	magnesium
magnet	磁	magnet
magnetik	磁性	magnetic
magnetosfer	磁层	magnetosphere
magnitudo	大小	magnitude
maha	玛哈	great
mahabharata	摩ha婆罗多	mahabharata
mahal	昂贵	expensive
mahar	嫁妆	bride price
maharaja	大君	king
mahasiswa	大学生	college student
mahayana	大乘	mahayana
mahdi	马赫迪	mahdi
mahir	精通	skillful
mahkamah	法庭	law court
mahkota	王冠	crown
mahluk	生物	being
mahmud	马穆德	praised
mail	邮件	mail
main	玩	play
majalah	杂志	magazine
majalahmajalah	杂志杂志	magazines
majalengka	马贾伦卡	majalengka
majapahit	马贾帕希特	majapahit
majas	修辞格	metaphor
majelis	部件	assembly
majemuk	复合	plural
maju	上	better
maka	然后	then
makam	墓	tomb
makan	吃	eating
makanan	餐饮	food
makanannya	食物	its food
makassar	望加锡	makassar
makhluk	生物	creature
makhluknya	他的生物	the creature
maki	真木	maki (japanese word)
makin	越来越多	increasingly
makkah	马卡	[place name]
makmur	繁荣	prosper
makna	意思	meaning
makro	巨集	macro
makrofaga	巨噬细胞	macrofaga
maksimal	最大	maximum
maksimum	最大	maximum
maksud	意思	intention
maksudnya	那意味着什么	meaning
mal	商场	mall
malah	代替	even
malaikat	天使	angel
malaka	马六甲	malacca
malakh	马拉赫	malakh
malam	晚	night
malang	较差的	malang
malaria	疟疾	malaria
malaya	马来亚	malaya
malaysia	马来西亚	malaysia
malayu	马来语	malay
maldini	马尔蒂尼	maldini
malik	马利克	malik
malin	马林	malin
mall	购物中心	mall
mallaby	马拉比	mallaby
malta	马耳他	malta
malu	害羞	shy
maluku	我的耻辱	maluku
mama	妈妈	mama
mamalia	哺乳动物	mammals
mamori	毛森	mamori
mampu	能够	able
mana	哪里	where
manado	万鸦老	manado
management	管理	management
manager	经理	manager
manajemen	管理	management
manajer	经理	manager
manakala	什么时候	when
manamana	am	anywhere (or everywhere)
manapun	任何	wherever
mancanegara	外国	foreign
manchester	曼彻斯特	manchester
mandailing	曼达灵	mandailing
mandala	曼陀罗	arena
mandar	曼达语	mandar
mandarin	普通话	mandarin
mandat	授权	mandate
mandela	曼德拉	mandela
mandi	浴	shower
mandiri	独立	independent
manfaat	好处	benefit
manga	漫画	mango
mangekyou	万ge	mangekyou
mangga	芒果	mango
mangkuk	碗	bowl
mangsa	猎物	prey
mangsanya	它的猎物	prey
mangunkusumo	mangunkusumo	mangunkusumo
manifestasi	表现	manifestation
manik	珠子	bead
manila	马尼拉	manila
manipulasi	操纵	manipulation
manis	甜	sweet
manisan	脯	sweets
mantan	前	former
mantap	大	perfect
mantel	涂层	coat
manual	手册	manual
manufaktur	制造	manufactur
manusia	人的	human
many	许多	many
mao	毛	mao
maps	地图	maps
marah	愤怒	angry
march	行军	march
marco	马可	marco
maret	游行	march
marga	氏族	clan
maria	玛利亚	maria
marie	玛丽	marie
mario	马里奥	mario
maritim	海上	maritime
mark	标记	mark
markas	总部	headquarter
market	市场	market
marketing	行销	marketing
maroko	摩洛哥	morocco
mars	火星	mars
marshall	马歇尔	marshall
marshanda	马山达	marshanda
martin	马丁	martin
marwan	马万	marwan
marx	马克思	marx
marxis	马西斯	marxist
marxisme	马克思主义	marxism
mary	玛丽	mary
marzuki	马祖基	marzuki
mas	先生	bro
masa	真	era
masak	厨师	cook
masakan	厨师	food
masalah	问题	problem
masalahmasalah	问题	problems
masamasa	年龄	period
masanya	他的时间	his time
masehi	马斯	advent
masih	仍然	still
masing	分别	each
masingmasing	每	each
masjid	清真寺	mosque
mask	面具	mask
maskapai	航空公司	company
maslow	马斯洛	maslow
massa	质量	mass
massal	质量	mass
massanya	它的质量	mass
master	大师	master
masturbasi	自慰	masturbate
masuk	输入	entry
masukan	输入	input
masuknya	入口	entry
masyarakat	上市	society
masyarakatnya	人民	citizens
masyumi	正美	masyumi
mata	眼睛	currency
matahari	太阳	sun
matamata	眼睛	spy
matang	成熟	ripe
matanya	他的眼睛	eye
mataram	马塔兰	mataram
matematika	数学	mathematics
matematikawan	数学家	mathematician
matematis	数学的	mathematical
materi	理论	material
material	材料	material
materiil	材料	material
materimateri	材料	materials
mati	死	die
matius	死	matthew
matriks	矩阵	matrix
matsumoto	松本	matsumoto
matt	马特	matt
mau	想要	would
maulana	毛拉纳	maulana
maupun	以及	as well as
maut	死亡	death
mawar	玫瑰	rose
max	最大值	max
maxwell	麦克斯韦	maxwell
may	可以	may
maya	玛雅人	maya
mayat	尸体	corpse
mayjen	市长	major general
mayor	重大的	major
mayoritas	多数	majority
mazhab	学派	sect
mb	兆字节	megabytes
medali	奖牌	medal
medan	领域	field
medang	棉当	medang
media	媒体	media
medical	医疗	medical
medik	医疗	medical
medika	医学	medical
medis	医疗	medical
mediterania	地中海	mediterranean
medium	介质	medium
mega	兆	mega
megah	华丽的	majestic
megawati	megawati	megawati
mei	可以	may
meitantei	meitantei	detective
meja	表	table
mekanik	机械	mechanic
mekanika	机械师	mechanics
mekanis	机械	mechanical
mekanisme	机制	mechanism
mekkah	麦加	mecca
meksiko	墨西哥	mexico
melacak	跟踪	track
melahirkan	生	give birth
melainkan	但	but
melaka	马六甲	melaka
melaksanakan	在做	carry on
melakukan	去做	do
melakukannya	做吧	do
melalui	通过	through
melambangkan	象征	represent
melampaui	超越	exceed
melancarkan	发射	do
melanda	打击	hit
melanggar	分手	infringe
melanjutkan	继续	continue
melantik	就职典礼	inaugurate
melaporkan	报告	report
melarang	禁止	forbid
melarikan	跑	run
melarutkan	解散它	dissolving
melati	茉莉花	jasmine
melatih	培养	train
melawan	反对	attack
melayani	服务	serve
melayu	马来语	malay
melebihi	超过	over
melebur	合并	smelt
meledak	爆炸	explode
melekat	附于	connected to
melemah	减弱	weaker
melemahkan	削弱	weaken
melempar	扔	throw
melemparkan	被抛	throw
melengkapi	完成	complete
melengkung	弯曲	curve
melepas	脱掉	release
melepaskan	松手	release
melestarikan	养护	preserve
meletakkan	放	put
meletus	爆发	explode
melewati	打通	through
melibatkan	参与	involve
melihat	看	see
melihatnya	看见	see it
melilit	包起来	wrapped
melimpah	溢出	overflow
melindungi	保护	protect
melingkar	圆	encircle
melingkupi	覆盖	include
melintang	横	crosswise
melintas	经过	drift
melintasi	跨越	traverse
meliputi	盖子	including
mellitus	思维	mellitus
mello	梅洛	mello
melodi	旋律	melody
meloloskan	摆脱	slip
melompat	跳	jump
meluas	广泛	spread
meluaskan	扩大	expand
melucuti	撤防	disarm
melukai	受伤	hurt
melukis	涂料	paint
meluncurkan	发射	launch
melupakan	忘记	forget
memacu	刺激	increase
memadai	充足	adequate
memadukan	保险丝	combine
memahami	了解	understand
memainkan	玩	play
memajukan	预先	promote
memakai	穿	use
memakan	吃饱	consuming
memaksa	迫使	force
memanah	射箭	archery
memancarkan	辐射	to pour out
memancing	钓鱼	fish
memandang	看着	look
memanfaatkan	从中获利	use
memang	确实	indeed
memanggil	呼叫	call
memanggilnya	给她打电话	call him/her
memangsa	捕食	prey
memanipulasi	操纵	manipulate
memanjang	纵向	longwise
memantau	监控	observe
memantulkan	反映	reflect
memasak	厨师	cook
memasang	建造	mount
memastikan	确保	make sure
memasukan	放入	insert
memasuki	输入	enter
memasukkan	输入	insert
mematahkan	打破	break
mematikan	关掉	turn off
membaca	读	read
membagi	划分	share
membahas	讨论	discuss
membahayakan	危害	endanger
membaik	好转	get better
membakar	烧伤	burn
membalas	回复	retaliate
membandingkan	比较	compare
membangkitkan	唤醒	awaken
membangun	建立	build
membantah	争论	argue
membantu	帮帮我	help
membantunya	帮助她	help it
membatalkan	取消	cancelled
membatasi	限制	limit
membawa	带来	carry
membawakan	带来	bring
membawanya	随身携带	bring
membayangkan	想像	imagine
membayar	工资	paying
membebaskan	释放	free
membedakan	区分	differentiate
membedakannya	区分它	distinguish it
membeku	冻结	freezing
membela	防守	defend
membelah	分裂	split
membeli	购买	buy
membenarkan	证明	justified
membenci	讨厌	hate
membendung	干	suppress
membentang	拉长的	stretch
membentuk	来形成	create
memberantas	根除	wipe out
memberi	给	give
memberikan	发出	provide
memberinya	给他	giving/give
memberitahu	告诉你	to inform
memberitahukan	告诉	inform
memberlakukan	制定	impose
memberontak	反叛	rebel
membersihkan	清洁	clean up
membesar	放大	sizing
membiarkan	让	let
membiayai	金融	fund
membicarakan	谈论	discuss
membidangi	服务	in charge
membina	建立	develop
membingungkan	令人困惑	confuse
membintangi	主演	starring in
membolehkan	允许	allow
membran	膜	membrane
membuahi	施肥	fertilize
membuahkan	生产	resulted
membuang	扔掉	waste
membuat	使	make
membuatnya	做了	make it
membubarkan	分散	dissolve
membujuk	说服	persuade
membuka	打开	open
membuktikan	证明	show
membungkus	包裹	wrap
membunuh	杀	kill
membunuhnya	杀了他	kill
memburu	追捕	hunt
memburuk	恶化	worsen
membutuhkan	需要	need
memecah	打破	break
memecahkan	解决	solve
memegang	坚持	hold
memelihara	保持	preserve
memeluk	拥抱	embrace
memenangi	韩元	win
memenangkan	赢得	win
memengaruhi	去影响	affect
mementingkan	重视	prioritize
memenuhi	履行	fulfil
memerangi	对抗	fight against
memeriksa	校验	examined
memerintah	统治	command
memerintahkan	指导	command
memerlukan	需要	need
memetakan	地图	map
memfasilitasi	促进	facilitate
memfokuskan	焦点	focus to
memicu	触发器	trigger
memikirkan	想一想	thinking
memilih	选择	choose
memiliki	有一个	own
memilki	有	have
memimpin	铅	lead
memindahkan	移动	redirect
meminjam	借	borrow
meminjamkan	借	borrow
meminta	问	ask
meminum	喝了	have a bite
memisahkan	分离	separate
memodifikasi	修改	modify
memohon	乞讨	appeal
memompa	抽水机	pump
memonitor	监控	monitoring
memopulerkan	推广	hitting
memori	记忆	memory
memory	记忆	memory
memotong	切	cutting
mempelajari	学习	study
mempengaruhi	影响	affect
memperbaiki	修理	repair
memperbanyak	乘	multiply
memperbesar	放大	increase
memperbolehkan	允许	allow
memperburuk	恶化	worsen
mempercayai	信任	believe
mempercepat	加速	hasten
memperebutkan	争取	fight for
mempergunakan	采用	use
memperhatikan	注意	observing
memperhitungkan	考虑到	take into account
memperingati	纪念	commemorate
memperingatkan	警告	warn
memperjelas	澄清	clarify
memperjuangkan	为...而战	to fight for
memperkaya	丰富	enrich
memperkenalkan	介绍	introducing
memperkirakan	估计	estimating
memperkuat	加强	strengthen
memperlambat	慢一点	slow down
memperlihatkan	以显示	show
memperluas	扩大	expand
mempermudah	简化	ease
memperoleh	获得	retrieve
memperpanjang	延伸	extend
mempersiapkan	准备	prepare
mempertahankan	保持	hold
mempertanyakan	质疑	questioned
mempertimbangkan	考虑	considering
memprediksi	预测	predict
memprediksikan	预测	predict
memproduksi	生产	produce
memproklamasikan	宣布	proclaim
mempromosikan	促进	promote
memproses	处理	process
mempublikasikan	发布	publicize
mempunyai	有	has
memuaskan	满意的	satisfy
memuat	加载	load
memudahkan	轻松一点	ease
memuja	崇拜	worship
memuji	赞美	praise
memukul	击中	hit
memulai	开始	started
memuliakan	荣耀	respect
memulihkan	恢复	restore
memuncak	达到顶峰	peaked
memunculkan	培养	create
memungkinkan	使成为可能	make it possible
memusatkan	浓缩	concentrate
memusnahkan	消灭	destroyed
memutuskan	决定	decide
men	男装	men
menabrak	撞上	hit
menafsirkan	解释	interpret
menahan	憋	defend
menaiki	爬上了	climb
menaikkan	提高	increase
menaklukkan	征服	conquer
menakutkan	害怕	scary
menamai	命名	name the
menamakan	名称	call
menambah	加	increase
menambahkan	加	add
menampakkan	揭示	reveal
menampilkan	显示	featuring
menampung	容纳	receive
menanam	厂	plant
menanamkan	嵌入	plant
menandai	标记掉	tag
menandakan	表示	indicate
menandatangani	标志	signing
menang	赢得	win
menangani	处理	handle
menanggapi	响应	respond
menangis	哭	cry
menangkap	抓住	catch
menantang	具有挑战性的	challenge
menantu	女婿	son in law
menanyakan	问	ask
menara	塔	tower
menari	舞蹈	dance
menarik	有趣	interesting
menaruh	放	put
menawarkan	提供	provide
mencabut	撤消	pull
mencair	熔化	melting
mencakup	盖子	include
mencampurkan	混合	mixed
mencapai	达到	reach
mencari	寻找	search
mencatat	做笔记	note
mencegah	避免	prevent
menceritakan	告诉	recount
mencerminkan	反映	reflect
mencerna	消化	digest
mencetak	打印	print
mencintai	爱	love
menciptakan	创建	create
mencoba	尝试	try
mencolok	引人注目	significance
mencuci	洗	wash
mencukupi	足够	suffice
mencuri	偷	steal
mendadak	突然的	sudden
mendahului	超过	precede
mendalam	深	in-depth
mendalami	深化	explore
mendapat	得到了	get
mendapati	找	find
mendapatkan	得到了	get
mendarat	登陆	landed
mendasar	基本的	fundamental
mendasari	底层	underlie
mendatang	未来	upcoming
mendatangi	来吧	approach
mendatangkan	带进	bring in
mendefinisikan	限定	define
mendekati	接近	approach
mendel	胀	mendel
mendengar	听	hear
mendengarkan	听	listening
menderita	患	suffering
mendesak	紧急	urgent
mendeskripsikan	描述	describe
mendeteksi	检测	detect
mendiami	居住于	inhabit
mendidik	教育	educate
mendirikan	建立	establish
mendistribusikan	分发	distribute
mendominasi	支配	dominate
mendorong	推	push
menduduki	占据	living
menduga	猜到了	guess
mendukung	支持	support
mendut	门多特	mendut
menegakkan	坚持	established
menegaskan	确认	assert
menekan	推	press
menekankan	注重	pressing
menelan	吞	swallow
meneliti	研究中	do some research
menelusuri	搜索	browse
menembak	射击	shoot
menembus	穿透	break
menempati	占据	occupy
menempatkan	放	put
menempel	坚持下去	attach
menempuh	通过	take
menemui	见面	meet
menemukan	找	meet
menenangkan	舒缓	calm
menendang	踢	kick
menengah	中间	middle
menentang	反对	against
menentukan	确定	decide
menerangkan	说明	explain
menerapkan	应用	apply
menerbitkan	问题	publish
menerima	接收	receive
menerjang	崩溃	run into
menerjemahkan	翻译	translate
menerus	连续地	continuous
meneruskan	继续	continue
menetap	留	to stay
menetapkan	组	settle
menetas	孵化	hatch
menewaskan	被杀	defeat
mengabaikan	忽视	ignore
mengacu	指	refer
mengadakan	穿上	make
mengadopsi	采纳	adopt
mengadu	告密者	complain
mengagumkan	很棒	awesome
mengajak	邀请	to invite
mengajar	教	teaching
mengajarkan	教	teach
mengajukan	文件	propose
mengakhiri	结束	ended
mengakibatkan	造成	caused
mengakses	访问	access
mengaktifkan	启用	activate
mengaktivasi	启用	activate
mengaku	承认	admit
mengakui	确认	recognize
mengalahkan	击败	beat
mengalahkannya	打败他	beat
mengalami	去体验	suffer
mengalihkan	转移	shift
mengalir	流动	flow
mengalirkan	排水	flow
mengamankan	安全	preserve
mengamati	观察	observe
mengambil	采取	take
mengamuk	横冲直撞	raging
menganalisis	分析	analyze
mengancam	威胁	threaten
mengandalkan	依靠	rely
mengandung	包含	pregnant
menganggap	假设	assume
menganggapnya	考虑一下	assume
mengangkat	电梯	appoint
mengangkut	运输	transport
menganjurkan	推荐	suggest
mengantar	放下	deliver
mengantarkan	交付	bring
menganut	坚持	follow
mengapa	为什么	why
mengarah	导致	lead to
mengarahkan	指导	directed
mengatakan	说	saying
mengatasi	解决	overcome
mengatur	组	set
mengawali	开始	started
mengawasi	看守	supervise
mengecil	缩小	decline
mengedari	流通	circle around
mengejar	追逐	to chase
mengejutkan	令人震惊的	surprise
mengekspresikan	表达	express
mengelilingi	周围	circle
mengelola	管理	manage
mengelompokkan	分组	group
mengeluarkan	隐秘	release
mengeluh	抱怨	complained
mengembalikan	恢复	return
mengemban	携带	carry out
mengembang	膨胀	develop
mengembangkan	发展	develop
mengemukakan	提出	propose
mengenai	关于	about
mengenakan	穿	wear
mengenal	知道	know
mengenali	认识	recognize
mengenalkan	介绍	introduced
mengenang	回忆	recall
mengendalikan	控制	control
mengendarai	骑在	ride
mengerahkan	发挥	mobilize
mengerikan	可怕	horrifying
mengerjakan	做	perform
mengerti	了解	understand
mengesahkan	授权	authorize
mengesankan	令人印象深刻	detected
mengetahui	会心	knowing
mengevaluasi	评估	evaluate
menggabungkan	结合	combine
menggali	挖	dig
menggambar	画	draw
menggambarkan	说明	draw
mengganggu	干扰	disturbing
mengganti	更换	change
menggantikan	更换	replace
menggelar	推出	held
menggerakkan	移动	move
menggigit	咬	biting
menggiring	铅	dribbling
menggunakan	采用	using
menggunakannya	用它	using it
menghabisi	玩完	finish
menghabiskan	花	finishing
menghadap	面对	facing
menghadapi	正视	face
menghadiri	出席	attends
menghalangi	妨碍	hinder
menghambat	抑制	obstruct
menghancurkan	破坏	destroyed
menghantarkan	交付	deliver
menghapus	去掉	remove
menghapuskan	消除	eliminate
mengharapkan	期望	expect
menghargai	欣赏	respect
mengharuskan	要求	require
menghasilkan	生产	bring in
menghemat	救	save
menghendaki	将	wish
menghentikan	停	stop
menghibur	娱乐性	entertain
menghidupkan	打开	revive
menghilang	消失	disappear
menghilangkan	摆脱	get rid of
menghimpun	收集	accumulate
menghina	侮辱	insult
menghindari	避免	avoid
menghitung	计算	count
menghormati	尊重	respect
menghubungkan	连接	connect
menghuni	居住于	inhabit
mengidentifikasi	识别	identify
mengidentifikasikan	确定	identify
mengijinkan	允许	permit
mengikat	捆绑	tie
mengikuti	跟随	following
mengimpor	进口	import
menginap	过夜	sleep
mengindikasikan	表明	indicates
menginduksi	诱导	induce
menginfeksi	感染	infect
mengingat	记住	bearing in mind the
mengingatkan	提醒	remind
menginginkan	想	wanted
menginvasi	入侵	invaded
mengira	认为	counting
mengirim	发送	send
mengirimkan	发送	send
mengisahkan	叙事	tell a story
mengisi	填	fill
mengitari	周围	rounded
mengizinkan	允许	allow
mengkaji	研究	review
mengklaim	要求	claim
mengklasifikasikan	分类	classified
mengkritik	批评	criticize
mengobati	对待	treating
mengolah	处理	process
mengonsumsi	消耗	consume
mengontrol	控制	control
mengoperasikan	操作	operate
mengorbankan	牺牲	sacrifice
mengorbit	绕轨道	orbit
menguap	蒸发	vaporize
menguasai	支配	control
menguat	加强	strenghened
menguatkan	加强	reinforce
mengubah	更改	change
mengubahnya	更改	translate into
mengucapkan	说	say
menguji	测试	test
mengukur	测量	measure
mengulang	重复	repeat
mengumpulkan	收集	collect
mengumumkan	宣布	announce
mengundang	邀请	invite
mengundurkan	退后	retired
mengungkap	揭露	reveal
mengungkapkan	显露	reveal
mengungsi	撤离	evacuate
mengunjungi	访问	visit
menguntungkan	有利可图	profitable
menguraikan	解码	elaborate
mengurangi	降低	decrease
mengurus	照顾	handle
mengurusi	照顾	handle
mengusir	驱除	drive away
mengusulkan	提出	suggested
mengusung	携带	carrying
mengutamakan	优先	prioritize
mengutip	报价	quote
mengutus	代表	dispatched
menikah	已婚	marry
menikahi	已婚	marrying
menikmati	请享用	enjoy
menilai	率	assess
menimbulkan	会发生	make
menimpa	覆写	hit
meninggal	死了	died
meninggalkan	离开	leave
meninggalnya	他的过世	death
meningkat	增加	increase
meningkatkan	升级	increase
meningkatnya	增加	increasing
menipu	傻子	cheats
meniru	模拟	imitate
menit	分钟	minutes
menjabat	送达	served
menjadi	成为	be
menjadikan	使	making
menjadikannya	做了	making
menjaga	保持	to guard
menjahit	缝制	sew
menjalani	经历	undergo
menjalankan	跑	carry on
menjalin	编织	establish
menjamin	确保	ensure
menjangkau	达到	reach out
menjanjikan	有希望	promise
menjatuhkan	下降	bring down
menjauh	远离	away
menjauhi	远离	avoid
menjawab	回答	answer
menjelajahi	探索	browse
menjelang	接近	near
menjelaskan	说明	explain
menjemput	拾起	pick up
menjual	卖	sell
menjuarai	赢得	win
menjumpai	碰到	meet
menjunjung	坚持	upheld the
menko	协调部长	menko
menolak	拒绝	refuse
menolong	帮帮我	help
menonjol	站出来	stand out
menonjolkan	强调	obtrude
menonton	看	watch
menopang	支撑	shore
menopause	绝经	menopause
menstruasi	经期	menstrual
mentah	生的	crude
mental	精神上	mental
mentawai	menawai	mentawai
menteng	门腾	menteng
menteri	部长	minister
menterimenteri	部长	ministers
menu	菜单	menu
menuai	收割	reap
menuju	前往	into
menular	传染性	spread
menulis	写	write
menuliskan	写	write
menumbuhkan	增长	grow
menunggu	等候	menunggu
menunjang	支持	support
menunjuk	指向	appoint
menunjukan	显示	indicate
menunjukkan	以显示	pointed
menuntut	起诉	sue
menurun	减少了	decline
menurunkan	降低	reduce
menurunnya	下降	declining
menurut	根据	according to
menurutnya	据他介绍	he think
menutup	关	close
menutupi	覆盖	close
menuturkan	说过	spoken
menyadari	意识到	realize
menyaingi	对手	rival
menyajikan	当下	serve
menyaksikan	看过	watch
menyala	点亮	afire
menyalakan	打开	ight up
menyalin	复制	copied
menyalurkan	渠道	distribute
menyamar	变相	masquerade
menyambut	欢迎	welcome
menyampaikan	交付	send
menyangkut	它涉及	involve
menyanyi	唱	sing
menyanyikan	唱	sing
menyarankan	推荐	suggest
menyatakan	陈述	state
menyatu	合并	fused
menyatukan	团结	unify
menyebabkan	原因	caused
menyebabkannya	造成它	caused
menyebar	传播	spreading
menyebarkan	传播	spread
menyebut	大喊	mentioned
menyebutkan	提	mention
menyebutnya	称它为	call it
menyediakan	提供	provide
menyegel	密封	sealed
menyelamatkan	救	save
menyelenggarakan	组织	perform
menyelesaikan	完成	finish
menyelidiki	调查	explore
menyeluruh	彻底	comprehensive
menyembah	崇拜	worship
menyembuhkan	治愈	heal
menyembunyikan	隐藏	hide
menyempurnakan	完善	perfect
menyenangkan	多开心	fun
menyentuh	触摸	touch
menyerah	放弃	surrender
menyerahkan	翻	submit
menyerang	攻击	attack
menyerangnya	攻击他	attack him/her
menyerap	吸收	absorb
menyertai	随同	follow
menyertakan	括	include
menyerukan	要求	call
menyerupai	类似于	like
menyesuaikan	调整	adjust
menyetujui	批准	approve
menyiapkan	设定	to complete
menyiarkan	广播	broadcast
menyimpan	救	saving
menyimpulkan	得出结论	conclude
menyinggung	得罪	mention
menyingkirkan	摆脱	elimination
menyisakan	离开	leave
menyokong	支持	support
menyukai	喜欢	like
menyulitkan	复杂化	complicate
menyumbang	捐	contribute
menyumbangkan	捐	donate
menyuruh	下令	order
menyusul	跟进	catch up
menyusun	安排	arrange
menyusut	收缩	decrease
meragukan	怀疑	doubt
merah	红色的	in red
meraih	达到	reach
merak	孔雀	merak
meramalkan	预料到的	predict
merambah	渗透	reach
merambat	传播	spreading
merancang	来设计	planning
merangsang	刺激	stimulate
merantau	跑题	wandering
meranti	梅兰蒂	shorea
merapi	默拉皮	trim
merasa	感觉	feel
merasakan	感觉	feel
merata	相等	to everyone
merawat	照顾	to  look after
merayakan	庆祝	celebrate
merdeka	独立	freedom
merebak	传播	spreading
merebut	抢占	fight for
meredam	马弗	muffle
merek	牌	brand
mereka	他们	them
merekam	记录	recording
merekrut	招募	recruit
merencanakan	计划	planning
merendahkan	贬低	humbling
merepresentasikan	代表	represent
merespon	响应	respond
merger	合并	merger
meriam	大炮	cannon
merilis	释放	release
merkuri	汞	mercury
merkurius	汞	mercury
merokok	抽烟	smoking
merosot	退化	decline
merpati	鸽子	pigeon
merugikan	有害	prejudicial
merujuk	指	refer
merumuskan	制定	formulate
merupakan	是一个	constitute
merusak	毁了	ruin
mesin	机	machine
mesinmesin	机	machines
mesir	埃及	egypt
mesjid	清真寺	mosque
meski	虽然	although
meskipun	虽然	even though
messenger	信使	messenger
mesti	必须	must
metabolisme	代谢	metabolism
metal	金属	metal
metamorfosis	变态	metamorphosis
metana	甲烷	methane
metanol	甲醇	methanol
metastasis	转移	metastatic
meteor	流星	meteor
meteorologi	气象学家	meteorology
meter	米	meter
metionina	蛋氨酸	methionine
metoda	方法	method
metode	方法	method
metodemetode	方法	methods
metodologi	方法	methodology
metro	地铁	metro
metropolitan	大都市	metropolitan
mewah	豪华	luxurious
mewajibkan	义务	require
mewakili	代表	represent
mewarisi	继承	inherit
mewariskan	遗赠	bequeath
mewujudkan	实现	create
meyakini	相信	believe
meyakinkan	令人信服	convince
mh	h	mh
mhc	h	mhc
mi	mi	noodle
michael	迈克尔	michael
microscope	显微镜	microscope
microsoft	微软	microsoft
middle	中间	middle
mie	面条	noodle
migrasi	移民	migration
mike	麦克风	mike
mikro	微	micro
mikroba	微生物	microbe
mikrobiologi	微生物学	microbiology
mikroorganisme	微生物	microorganism
mikroprosesor	微处理器	microprocessor
mikroskop	显微镜	microscope
mikroskopik	微观的	microscopic
mil	英里	miles
milan	米兰	milan
milenium	千年	millennium
miliar	十亿	billion
milik	属于	asset
miliki	有	have
miliknya	他的	his possession
milisi	民兵	militia
militer	军事	military
milton	米尔顿	milton
mimpi	梦想	dream
minahasa	水早	minahasa
minang	美南	minang
minangkabau	minangkabau	minangkabau
minat	利息	interest
minato	港区	minato
mineral	矿物	mineral
ming	ming	ming
minggu	星期日	week
mingguan	每周	weekly
mini	微型	mini
minimal	最小的	minimum
minimum	最低	minimum
mining	矿业	mining
minor	次要	minor
minoritas	少数民族	minority
minta	要求	ask
minum	喝	drink
minuman	饮料	drink
minyak	油	oil
miring	斜	tilt
mirip	类似	similar
misa	质量	mass
misal	例	for instance
misalkan	例如	for example
misalnya	例如	for example
mischa	米沙	mischa
misi	任务	mission
misil	导弹	missile
misionaris	传教士	missionaries
miskin	较差的	poor
mission	任务	mission
misteri	神秘	mystery
misterius	神秘	mysterious
mistik	神秘	mystical
mistisisme	神秘主义	mysticism
mitokondria	线粒体	mitochondrion
mitologi	神话	mythology
mitos	神话	myth
mitra	伙伴	partner
mk	k	law cart constitution
mm	毫米	mm
mobil	汽车	car
mobile	移动	mobile
mobilitas	流动性	mobility
mochtar	mochtar	mochtar
modal	首都	capital
mode	模式	mode
model	模型	model
modelmodel	楷模	models
modem	调制解调器	modem
modern	现代	modern
modernisasi	现代化	modernization
modifikasi	修改	modification
modus	模式	mode
moh	h	mohammad
mohamad	穆罕默德	mohamad
mohammad	穆罕默德	mohammad
mojokerto	mojokerto	mojokerto
molekul	分子	molecule
molekular	分子	molecular
molekuler	分子	molecular
molekulmolekul	分子	molecules
momen	当下	a moment of
momentum	动量	momentum
monarki	君主制	monarchy
monas	莫纳斯	national monument
moneter	货币	monetary
money	钱	money
mongol	蒙古人	mongols
mongolia	蒙古	mongolia
monica	莫妮卡	monica
monitor	显示器	monitor
monograf	专着	monographs
monoksida	一氧化碳	monoxide
monopoli	垄断	monopoly
monosakarida	单糖	monosaccharide
monoteisme	一神教	monotheism
monster	怪物	monster
monsun	季风	monsoon
monta	蒙塔	monta
monumen	纪念碑	monument
monyet	猴	monkey
moon	月亮	moon
moral	道德	moral
more	更多	more
morfem	词素	morpheme
morfin	吗啡	morphine
morfologi	形态学	morphology
morgan	摩根	morgan
motif	动机	motif
motivasi	动机	motivation
motogp	摩托车	motogp
motor	摩托车	motor
movie	电影	movie
moyang	祖先	ancestor
moza	莫扎	moza
mozart	莫扎特	mozart
mozilla	mozilla	mozilla
mpr	mpr	mpr
mprdpr	mprdpr	mpr-dpr
mprs	mprs	mprs
mpu	处理器	superior
mr	先生	mr
mrna	姆纳	mrna
ms	多发性硬化症	m.s.
msdos	msdos	ms-dos
mtv	音乐电视	mtv
mu	您的	mu
mual	恶心	nausea
muara	河口	estuary
muat	装载	fit
muatan	费用	content
muawiyah	muawiyah	muawiyah
muda	年轻	young
mudah	简单	easy
mudra	手印	mudra
mufakat	共识	agreement (consensus)
muhammad	穆罕默德	muhammad
muhammadiyah	穆罕默迪亚	muhammadiyah
muka	预先	surface
mula	开始	beginning
mulai	开始	start
mulamula	第一	at first
mulanya	首先	beginning
mulia	高贵	noble
multi	多	multi
multikulturalisme	多元文化主义	multiculturalism
multimedia	多媒体	multimedia
multinasional	跨国	multinational
multiplatinum	多铂	multi-platinum
mulut	嘴巴	mouth
mulutnya	他的嘴	his/her mouth
muncul	出现	appear
muncullah	出现了	appeared
munculnya	出现	emerging
mundo	蒙多	mundo
mundur	退缩	to retreat
mungkin	也许	maybe
muntah	呕吐	vomiting
murah	便宜的	cheap
murid	学生	student
muridmurid	学生们	students
muridmuridnya	学生们	his students
muridnya	他的学生	students
murni	纯	pure
musa	穆萨	moses
musafir	旅客	traveler
museum	博物馆	museum
mushaf	穆沙夫	arabic word
musi	慕斯	musi
musibah	灾害	disaster
music	音乐	music
musica	音乐	musica
musik	音乐	music
musiknya	音乐	music
musim	季节	season
musiman	季节性的	seasonal
musisi	音乐家	musician
muslim	穆斯林	muslim
muslimin	穆斯林	muslims
musnah	被毁	extinct
mustafa	穆斯塔法	mustafa
mustahil	不可能	impossible
musuh	敌人	enemy
musuhnya	他的敌人	enemy
musyawarah	讨论区	discussion
mutagen	诱变剂	mutagen
mutakhir	最新	current
mutasi	突变	mutation
mutiara	珍珠	pearl
mutlak	绝对	absolute
mutu	质量	quality
muzik	音乐	muzik
my	我的	my
myanmar	缅甸	burma
myth	神话	myth
münchen	慕尼黑	munchen
n	ñ	n
na	呐	na
nabati	蔬菜	vegetable
nabi	预言家	prophet
nada	音	tone
nafsu	情欲	lust
naga	龙	dragon
nagarakretagama	长gar	negarakretagama
nagari	长gar	nagari
nagato	长门	nagato
nahdlatul	纳德拉图尔	a party's name, adapted from arabic
naik	骑	increase
naiknya	崛起	rise
nakal	淘气	naughty
nakula	纳库尔	nakula
nama	名称	name
namanama	是什么名字	names
namanya	名字	his name is
name	名称	name
namek	名字	namek
namikaze	南风	namikaze
nampak	出现	sen
nampaknya	它似乎	looks like
namun	然而	however
nan	nan	nan
nanti	后来	later
nantinya	后来	eventually
napas	呼吸	breath
napoleon	拿破仑	napoleon
nara	奈良	nara
narasi	叙述	narration
narkoba	毒品	drugs
narkotika	毒品	drugs
naruto	火影忍者	naruto
nasa	美国航空航天局	nasa
nasabah	顾客	customer
nasi	白饭	rice
nasib	缘分	fate
nasihat	忠告	advice
nasional	国民	national
nasionalis	民族主义者	nationalist
nasionalisme	民族主义	nationalism
naskah	剧本	manuscript
naskahnaskah	脚本	manuscript
nasution	纳苏	nasution
nat	t	network address translation
natal	圣诞	christmas
nation	国家	nation
national	国民	national
natrium	钠	natrium
natsir	纳西尔	natsir
natural	自然	natural
naturalis	自然主义者	naturalistt
navigasi	导航	navigation
nazi	纳粹	nazi
near	近	near
nebula	星云	nebula
negara	国家	country
negaranegara	国家	countries
negaranya	国家	his/her country
negatif	负	negative
negeri	国家	country
negerinegeri	国家	states
negerinya	国家	its country
negosiasi	谈判	negotiation
neji	内治	neji
nelayan	渔民	fisherman
nelson	纳尔逊	nelson
nenek	祖母	grandmother
neoklasik	新古典主义	neoclassical
neoliberal	新自由主义	neoliberal
neoliberalisme	新自由主义	neo-liberalism
neptunus	海王星	neptune
neraca	平衡	balance
neraka	地狱	hell
net	净	net
netral	中立的	neutral
network	网络	network
networks	网路	networks
neumann	纽曼	neumann
neuron	神经元	neuron
neutrofil	中性粒细胞	neutrophils
neutron	中子	neutron
newton	牛顿	newton
ngawi	恩加维	ngawi
ngetop	流行	popular
ngurah	伍拉	ngurah
nh	h	nh
ni	你	ni
niaga	商业	commerce
nias	尼亚斯	nias
niat	意向	intention
nic	尼克	nic
nica	尼卡	nica
nigeria	奈及利亚	nigeria
nike	耐克	nike
nikel	镍	nickel
nikita	尼基塔	nikita
nikmat	一个忙	pleasant
nil	零	nile river
nilai	得分了	value
nilainilai	价值观	values
nilainya	它的价值	its value
ninja	忍者	ninja
ninjutsu	忍术	ninjutsu
nirkabel	无线地	wireless
nitrat	硝酸盐	nitrate
nitrogen	氮	nitrogen
no	没有	no
nobel	诺贝尔奖	nobel
nobita	大雄	nobita
noda	弄脏	stain
node	节点	node
nol	零	zero
nominal	名义上的	nominal
nominasi	提名	nomination
nomor	数	number
non	非	non
nonblok	不结盟	non-block
nong	农农	nong
nonlogam	非金属	non-metal
noor	努尔	noor
norma	规范	norm
normal	正常	normal
normalnya	一般	normally
norman	诺曼	normand
normanorma	规范	norms
normatif	规范的	normative
north	北	north
norwegia	挪威	norway
notasi	符号	notation
nova	新星	nova
novel	小说	novel
november	十一月	november
nox	诺克斯	nox
nt	nt	nt
ntb	ntb	ntb
ntt	恩特	ntt (nusa tenggara timor) = east nusa tenggara
nu	怒	nu
nuansa	细微差别	nuance
nugini	努吉尼	new guinea
nugroho	努格罗霍	nugroho
nukleat	有核的	nucleic
nukleus	核	nucleus
nuklir	核	nuclear
numerik	数字	numerical
nurani	良心	conscience
nusa	家园	homeland
nusantara	群岛	archipelago
nutrien	养分	nutrient
nutrisi	营养	nutrition
nv	nv	nv (proper noun - maybe dutch)
nvram	nvram	nvram
ny	ny	ny
nya	她的	his/her/its
nyai	ai	nyai
nyak	ak	nyak
nyaman	舒服的	comfortable
nyamuk	蚊子	mosquito
nyanyian	歌曲	the singing
nyaris	几乎	almost
nyata	真实	real
nyawa	生活	life
nyeri	痛	pain
nyi	yi	nyi
o	ø	o
obama	奥巴马	obama
obat	药品	medicine
obatobatan	毒品	medicine
obesitas	肥胖	obesity
obito	小ito	obito
objek	物体	object
objekobjek	对象对象	pbjects
objektif	目的	objective
obligasi	键	bonds
observasi	观察	observation
observatorium	天文台	observatory
obyek	宾语	object
ocean	海洋	ocean
of	的	of
off	关	off
office	办公室	office
official	官方	official
ogan	奥甘	ogan
oh	哦	oh
ohm	欧姆	ohm
oil	油	oil
oksida	氧化物	oxide
oksidasi	氧化	oxidation
oksidatif	氧化	oxidative
oksigen	氧	oxygen
oktet	八位位组	octal
oktober	十月	october
olah	虽然	process
olahraga	体育	sport
old	旧	old
oleh	通过	from
olehnya	由他	from her
olimpiade	奥林匹克	olympic games
olympus	奥林巴斯	olympus
oma	奥马	oma
ombak	波浪	wave
on	上	on
oncom	oncom	oncom
ongkos	费用	cost
online	在线	online
oort	麦汁	oort
opak	不透明	opak
opec	欧佩克	opec
opera	歌剧	opera
operasi	操作	operations
operasional	操作	operational
operating	操作	operating
operator	算子	operator
opini	意见	opinion
opium	鸦片	opium
oportunistik	机会主义的	opportunistic
oposisi	反对	the opposition
oppie	oppie	oppie
opsi	选项	option
optik	光学	optical
optika	光学	optics
optimal	最佳	optimal
or	要么	or
oral	口服	oral
orang	人	person
orangorang	人	the people
orangtua	父母	parents
orangtuanya	他的家长	his/her parents
orangutan	猩猩	orangutan
oranye	橙子	orange
orbit	轨道	orbit
orbital	轨道	orbital
orbitnya	它的轨道	its orbit
orde	订购	order
order	订购	order
ordo	订购	ordo
organ	器官	organ
organel	细胞器	organelle
organik	有机	organic
organisasi	组织	organization
organisasiorganisasi	组织	organization
organisme	生物	organism
organization	组织	organization
orgasme	性高潮	orgasm
oriental	东方的	oriental
orientasi	取向	orientation
original	原版的	original
orihime	乙姬	orihime
orkes	乐队	orkes
ornamen	装饰	ornament
orochimaru	orochimaru	orochimaru
ortodoks	正统	orthodox
os	操作系统	operating system
osing	ing	osing
osis	学生会	school organizations
oslo	奥斯陆	oslo
osmosis	渗透作用	osmosis
ost	ost	ost
osteoporosis	骨质疏松	osteoporosis
otak	脑	brain
otomatis	自动	automatic
otomotif	汽车行业	automotive
otonom	自主性	autonomous
otonomi	自治	autonomy
otoritas	权威	authority
otot	肌肉	muscle
ottoman	脚凳	ottoman
our	我们的	our
out	出	out
outdoor	户外	outdoor
output	输出	output
oval	椭圆	oval
ovarium	子房	ovarian
ovum	卵子	ovum
oxford	牛津	oxford
ozawa	小泽	ozawa
ozon	臭氧	ozone
p	p	p
pabrik	厂	factory
pacar	女朋友	girlfriend
pacific	太平洋的	pacific
pacitan	帕西坦	pacitan
packet	包	package
pacu	跑道	race
pacuan	种族	race
pada	在	on
padahal	即使	whereas
padang	围场	field
padanya	在他身上	him/her
padat	固体	solid
padatan	固体	solid
padepokan	隐居	residence
paderi	僧	paderi
padi	白饭	rice
padri	帕德里	priestpriest
paduan	合金	blend
pagar	围栏	fence
pagaruyung	帕加鲁永	[place name]
page	页	page
pagi	早上	morning
paham	了解	concept
pahit	苦	bitter
pahlawan	英雄	hero
pain	痛	pain
pajajaran	教学	pajajaran
pajak	税	tax
pajang	显示	shelf
pak	先生	mr.
pakai	采用	wear
pakaian	衣服	clothing
pakan	饲料	feed
pakar	专家	experts
paket	包	packet
paketpaket	包	packages
pakistan	巴基斯坦	pakistan
pakpak	先生	pakpak
paksa	被迫	forced
paku	钉	nail
pakualaman	指甲	paku alam
pakuan	蕨类	pakuan
pakubuwono	爆料园	pakubuwono
pala	肉豆蔻	nutmeg
palangka	帕朗卡	palangka
palembang	巨港	palembang
palestina	巴勒斯坦	palestine
palestine	巴勒斯坦	palestine
palestinian	巴勒斯坦	palestinian
pali	帕里	pali
paling	最	most
pallu	帕卢	pallu
palsu	假	fake
palu	锤子	palu
palung	槽	riverbed
paman	叔叔	uncle
pamannya	他的叔叔	his/her uncle
pameran	展览	gallery
pamungkas	最终	pamungkas
panah	箭头	arrow
panas	热	hot
panasonic	松下	panasonic
panca	五	five
pancaran	辉光	emission
pancasila	潘卡西拉	pancasila
pandai	聪明	clever
pandang	观点看法	look
pandangan	视图	view
pandangannya	他的看法	opinion
pandeglang	潘德朗	pandeglang
pandu	侦察	pandu
panduan	指南	guide
pane	窗格	pane
panel	面板	panel
panen	收获	harvest
pangan	餐饮	food
pangeran	王子	prince
panggang	烤	roasted
panggilan	呼叫	call
panggung	阶段	stage
pangkal	基础	base
pangkalan	基础	base
pangkalpinang	茎的根部	pangkalpinang
pangkat	秩	the rank
panglima	总司令	commander
panitia	委员会	committee
panjalu	长	penjalu
panjang	长	long
panjangnya	长度	length
panji	旗帜	banner
pankreas	胰腺	pancreas
pantai	海滩	beach
pantas	适当	appropriate
panthera	豹	panthera
panti	屋	house
pantun	押韵	poem
paolo	保罗	paolo
papan	板	board
paparan	接触	exposure
papua	巴布亚	papua
para	帕拉	[plural nouns] 's / 'es
parade	游行	parade
paradigma	范例	paradigm
paragraf	段	paragraph
paraguay	巴拉圭	paraguay
parah	严重的	the worst
paralel	平行	parallel
parameter	参数	parameter
parang	弯刀	cleaver
pararaton	巴拉顿	pararaton
parasit	寄生虫	parasite
pariaman	贱民	pariaman
parikesit	模仿	parikshit
paripurna	全体会议	plenary
paris	巴黎	paris
parit	战es	trench
pariwisata	旅游	tourism
park	公园	park
parkir	停车处	parking
parlemen	议会	parliament
parlementer	议会	parliamentary
parman	帕尔曼	it's man's name
parsial	部分的	partial
partai	派对	party
partaipartai	派对	parties
partikel	粒子	particle
partikelpartikel	颗粒制品	particles
partisi	划分	partition
partisipasi	参与	the participation of the
partner	伙伴	partner
paru	肺	lung
paruh	喙	beak
paruparu	肺	lung
parwa	帕瓦	parwa
pas	正好	suitable
pasai	帕赛	pasai
pasal	文章	article
pasang	安装它	tide
pasangan	一对	couple
pasangannya	他的伴侣	partner
pasar	市场	market
pasaran	市场	market
pasca	发布	post
pascal	帕斯卡	pascal
pasien	患者	patient
pasif	被动的	passive
pasifik	太平洋地区	pacific
pasir	砂	sand
paskah	复活节	easter
pasokan	供应	supply
pass	通过	pass
passer	过客	passer
pasteur	巴斯德	pasteur
pasti	当然	for sure
pasukan	军队	supply
pasukannya	他的军队	his troops
pasukanpasukan	部队	soldiers
pasundan	帕桑丹	pasundan
pasuruan	帕苏鲁安	pasuruan
patah	破碎	patah
patahan	故障	fracture
paten	专利	patent
pati	淀粉	suicide
patih	总督	patih
patogen	病原	pathogens
patologi	病理	pathology
patrick	帕特里克	patrick
patroli	巡逻	patrol
pattimura	帕蒂村	pattimura
patung	雕像	sculpture
patungpatung	塑像	statues
paul	保罗	paul
paus	鲸鱼	whale
pawai	游行	parade
payah	瘸	effort
payudara	乳房	breast
payung	雨伞	umbrella
pbb	联合国	united nation
pc	个人电脑	pc
pci	pci	pci
pda	pda	pda
pdb	pdb	gdp
pdf	pdf格式	portable document format
pdi	pdi	pdi
pdip	pdip	one of political party in indonesia
pdrb	pdrb	regional gdp
pebisnis	商人	businessman
pecah	破碎	break
pecahan	分片	fragment
pecahnya	破损	break
pecel	佩塞尔	pecel
pecinta	情人	a lover
pedagang	交易者	merchant
pedagogi	教育学	pedagogy
pedalaman	内陆	inland
pedang	剑	sword
pedangnya	剑	his/her sword
pedas	辣的	spicy
pedesaan	乡村	rural
pedoman	指导方针	guidance
peduli	关心	care
pegangan	处理	grip
pegawai	雇员	employee
pegunungan	山	the mountains
pein	in	pein
pejabat	官方	official
pejuang	战士	warrior
peka	敏感	sensitive
pekalongan	北加浪岸	acting
pekan	周	week
pekanbaru	北干巴鲁	pekanbaru
pekat	集中	concentrated
pekerja	工人	workers
pekerjaan	职业	job
pekerjaannya	他的工作	job
pelabuhan	港口	harbor
peladen	服务器	server
pelajar	学生	student
pelajaran	本课	lesson
pelaksana	执行者	executive
pelaksanaan	实作	implementation
pelaksanaannya	实施	implementation
pelaku	犯罪者	doer
pelanggan	顾客	customer
pelanggaran	违反	violation
pelangi	彩虹	rainbow
pelaporan	报告	reporting
pelarangan	禁令	ban
pelarian	逃逸	fugitive
pelarut	溶剂	solvent
pelataran	法庭	courtyard
pelatih	培训师	trainer
pelatihan	培训	training
pelaut	水手	sailor
pelayan	服务员	servant
pelayanan	服务	service
pelayaran	巡航	shipping
pelbagai	各种	various
pelengkap	补充	complement
pelepah	中肋	midrib
pelepasan	释放	release
pelestarian	保存	conservation
peliharaan	宠物	pet
pelindung	保护者	protector
pelita	灯	light
pelopor	先锋	pioneer
peluang	机会	chance
pelukis	画家	painter
peluncuran	发射	launching
peluru	子弹	bullet
peluruhan	衰变	disintegration
pemahaman	理解	comprehension
pemain	播放器	player
pemakai	用户	user
pemakaian	用法	usage
pemakaman	葬礼	funeral
pemakan	食者	eater
pemanasan	热身	warming
pemancar	发射机	transmitter
pemandangan	风景	view
pemandian	浴场	bathing place
pemanfaatan	利用率	usage
pemangsa	捕食者	predator
pemasangan	安装	mounting
pemasaran	行销	marketing
pemasok	供应商	supplier
pemasukan	收入	permasukan
pembaca	读者	reader
pembacaan	阅读	reading
pembagian	师	allocation
pembaharuan	续约	renewal
pembahasan	讨论区	discussion
pembakaran	燃烧	combustion
pembalap	赛车手	racer
pembalasan	报复	retaliation
pembangkit	发电机	generator
pembangunan	发展	development
pembantaian	屠宰	slaughter
pembantu	女佣	assistant
pembaruan	续约	enewal
pembatas	定界符	divider
pembatasan	限制	restriction
pembawa	载体	carrier
pembayaran	付款	payment
pembebasan	拯救	liberation
pembedahan	手术	surgery
pembela	辩护律师	defender
pembelahan	师	division
pembelajaran	学习	expenditure
pembeli	买方	buyer
pembelian	采购	purchase
pembentuk	前者	forming
pembentukan	编队	formation
pembentukannya	它的形成	its forming
pemberantasan	根除	the eradication of
pemberdayaan	授权	empowerment
pemberhentian	解雇	release
pemberi	给予者	giver
pemberian	给予	given
pemberontak	反叛	rebel
pemberontakan	叛乱	rebellion
pembersihan	打扫	cleaning
pembesaran	放大	enlargement
pembiayaan	筹资	financing
pembicara	扬声器	discussion
pembicaraan	会谈	conversation
pembinaan	教练	development
pemblokiran	阻塞	blockage
pembuahan	概念	fertilize
pembuangan	处置	disposal
pembuat	制作者	maker
pembuatan	制造	manufacture
pembuatannya	制作	production
pembubaran	解散	dismissal
pembuka	开瓶器	opening
pembukaan	开场	opening
pembuktian	证明	proving
pembuluh	船只	vessel
pembungkus	包装	wrapper
pembunuh	杀手	murder
pembunuhan	谋杀	murder
pemburu	猎人	hunter
pemecahan	解决	solving
pemegang	持有人	the holder of the
pemekaran	师	expansion
pemeliharaan	保养	maintenance
pemeluk	拥抱	adherent
pemenang	优胜者	winner
pemencaran	分散	distribution
pemenuhan	履行	fullfill
pemeran	演员	player
pemerataan	均等分配	equity
pemeriksa	考官	examiner
pemeriksaan	检查	inspection
pemerintah	政府	government
pemerintahan	政府	government
pemerintahannya	他的政府	his/her governance
pemetaan	映射	mapping
pemikir	思想家	thinker
pemikiran	思想	thought
pemikiranpemikiran	思想	ideas
pemilahan	分类	sorting
pemilih	选择者	voter
pemilihan	选举	election
pemilik	所有者	owner
pemiliknya	主人	owner
pemilu	选举	election
pemimpi	梦想家	dreamer
pemimpin	领导	leader
pemimpinnya	它的领导者	its leader
pemindahan	清除	transfer
pemindai	扫描仪	scanner
pemisah	分隔器	divider
pemisahan	分离	dissociation
pemodelan	造型	modeling
pemotongan	切割	cut
pempek	彭佩克	pempek
pemrogram	程序员	programmers
pemrograman	程式设计	programming
pemrosesan	处理中	processing
pemuda	年轻人	youngster
pemugaran	恢复	restoration
pemujaan	崇拜	cult
pemukiman	沉降	settlement
pemula	初学者	starter
pemuliaan	配种	breeding
pemulihan	复苏	recovery
pemungutan	采集	voting
penafsiran	解释	the interpretation of the
penakluk	征服者	conqueror
penaklukan	征服	conquest
penalaran	推理	reasoning
penalti	罚款	penalty
penamaan	命名	naming
penambahan	加成	the addition
penampakan	瞄准	appearing
penampilan	出现	appearance
penampilannya	他的外表	his/her appearance
penampungan	庇护	shelter
penanaman	种植	planting
penanda	记号笔	marker
penandatanganan	签字	signing
penang	槟城	penang
penanganan	处理	handling
penanggalan	日历	calendar
penanggulangan	对策	prevention
penangkapan	逮捕	capture
penangkaran	囚禁	breeding
penari	舞蹈家	dancer
penarikan	退出	withdrawal
penasehat	顾问	adviser
penasihat	顾问	advisor
penataan	安排	structuring
penataran	升级	upgrading
penawaran	提供	offer
pencabutan	撤销	revocation
pencaharian	生计	livelihoods
pencak	彭卡	martial art
pencampuran	混合	mixing
pencapaian	成就	achievement
pencari	搜索者	search
pencarian	搜索	search
pencatatan	记录	recording
pencegahan	预防	prevention
pencemar	污染者	pollutant
pencemaran	污染	contamination
pencerahan	启示	enlightenment
pencerap	吸收剂	receptor
pencernaan	消化	digestion
pencetak	打印机	printer
pencetus	鼻祖	trigger
pencipta	创作者	creator
penciptaan	创建	creation
penculikan	绑架	kidapping
pendaftar	登记人	registrar
pendaftaran	注册	registration
pendahuluan	初步	preface
pendakian	攀登	climb
pendamping	伴侣	assistance
pendapat	意见	opinion
pendapatan	收入	income
pendarahan	流血的	bleeding
pendaratan	降落	landing
pendatang	来者	newcomer
pendek	短	short
pendekar	战士	warrior
pendekatan	方法	approach
pendengaran	听力	hearing
penderita	患者	patient
penderitaan	痛苦	suffering
pendet	pendet	pendet
pendeta	牧师	priest
pendidikan	教育	education
pendidikannya	他的学历	his/her education
pendinginan	冷却下来	cooling
pendiri	开国元勋	founder
pendirian	建立	the establishment of
pendorong	助推器	booster
penduduk	人口	population
pendudukan	占用	settlement
penduduknya	它的居民	residents
pendukung	支持者	support
pendukungnya	它的支持者	supporter(s)
penebangan	测井	deforestation
penegak	执行者	enforcement
penegakan	强制执行	enforcement
penekanan	重点	pressure
peneliti	研究者	researcher
penelitian	研究	research
penelitiannya	他的研究	its research
penembakan	射击	shooting
penempatan	放置	placement
penemu	发明者	the innovator
penemuan	发明	invention
penemuannya	他的发现	his discoveries
penemuanpenemuan	发现	discoveries
penentangan	反对	resistance
penentu	行列式	determinant
penentuan	判定	deciding
penerangan	灯光	lighting
penerapan	应用	implementation
penerbangan	飞行	flying
penerbit	发布者	publisher
penerbitan	出版	publishing
penerima	接收者	receiver
penerimaan	接待处	admission
penerjemah	译者	translator
penerjemahan	翻译	translation
penerus	接班人	continuer
penetapan	建立	confirmation
penetrasi	渗透	penetration
pengabdian	奉献	dedication
pengacara	律师	lawyer
pengadaan	采购	procurement
pengadilan	法庭	justice
pengajar	老师	faculty
pengajaran	教学	teaching
pengakuan	承认	admission
pengalaman	经验	experiance
pengalamatan	寻址	addressing
pengalihan	导流	redirects
pengamalan	实践	practice
pengamat	观察者	observer
pengamatan	观察	observation
pengambil	接受者	taker
pengambilan	服用	deprivation
pengangguran	失业	unemployment
pengangkatan	约定	appointment
pengangkut	载体	carrier
pengangkutan	运输	transportation
pengantar	介绍	sender
pengantin	新娘和新郎	bride
penganut	追随者	follower
pengarang	作者	writer
pengaruh	影响	influence
pengaruhnya	效果	its effect
pengasingan	流亡	exile
pengatur	调节器	regulator
pengaturan	设定值	setting
pengawal	保镖	guard
pengawas	主管	control
pengawasan	监督	observation
pengeboman	轰炸	bombardment
pengeboran	钻孔	drilling
pengecualian	例外	exception
pengejaran	追求	pursuit
pengekspor	出口商	exporter
pengelola	经理	administrator
pengelolaan	管理	management
pengelompokan	分组	classification
pengeluaran	开支	expense
pengembalian	返回	taking
pengembang	开发人员	developers
pengembangan	发展	development
pengenalan	介绍	introduction
pengendali	控制器	controllers
pengendalian	控制	control
pengendapan	沉积	sedimentation
pengertian	定义	understanding
pengesahan	背书	signing
pengetahuan	知识	knowledge
penggabungan	合并	merger
penggalian	挖掘	excavation
penggambaran	描写	depiction
pengganti	替代品	substitute
penggantian	替代	reimbursement
penggemar	风扇	fans
penggemarnya	他的粉丝	fans
penggerak	动子	motivator
penggolongan	分类	classification
pengguguran	流产	abortion
pengguna	用户	user
penggunaan	采用	usage
penggunaannya	它的使用	applying
penggunanya	它的用户	its use
penghalang	屏障	barrier
penghambat	抑制剂	obstacle
penghancuran	破坏	annihilation
penghapusan	清除	removal
penghargaan	升值	appreciation
penghasil	生产者	generator
penghasilan	收入	income
penghentian	终止	termination
penghitungan	计算	calculation
penghormatan	贡	tribute
penghubung	连接器	connector
penghujan	雨	rainy
penghujung	结束	end
penghulu	负责人	elder
penghuni	乘员	resident
pengikat	黏合剂	bounder
pengikatan	捆绑	pengikatan
pengikut	追随者	follower
pengikutnya	追随者	follower
penginderaan	感测	sensing
pengirim	发件人	sender
pengiriman	交货	delivery
pengisi	填料	filler
pengkajian	评定	review
pengkhianatan	背叛	betrayal
penglihatan	视力	vision
pengobatan	治疗	treatment
pengolah	处理器	processing
pengolahan	处理中	processing
pengomposan	堆肥	composting
pengorbanan	牺牲	sacrifice
pengorganisasian	整理	organizing
penguapan	蒸发	evaporation
penguasa	统治者	ruler
penguasaan	精通	mastery
penguat	助推器	fortification
pengubahan	改造	conversion
pengucapan	发音	pronunciation
pengujian	测试	testing
pengukur	量具	gauge
pengukuran	测量	measurment
pengulangan	重复	repetition
pengumpul	集电极	gatherer
pengumpulan	采集	collection
pengumuman	公告	announcement
pengunduran	辞职	resign
pengungkapan	披露	disclosure
pengungsi	难民	refugee
pengungsian	庇护	refuge
pengunjung	访客	visitor
penguraian	分解	decomposition
pengurangan	减法	reduction
pengurus	看守人	administrator
pengurusan	安排	management
pengusaha	商人	businessman
penilaian	评定	evaluation
penimbunan	积	stockpiling
penindasan	压迫	oppression
peninggalan	遗迹	heritage
peningkatan	增强	increasing
penis	阴茎	penis
penjabaran	说明	explanation
penjaga	安全	guard
penjahat	小人	thug
penjajah	侵略者	colonizer
penjajahan	殖民主义	colonialism
penjara	监狱	prison
penjelajah	探险者	explorer
penjelajahan	勘探	exploration
penjelasan	说明	clarifying
penjelmaan	化身	incarnation
penjual	卖方	seller
penjualan	打折	selling
penjumlahan	加成	addition
penjuru	过度	corner
penolakan	拒绝	rejection
penonton	听众	audience
pensiun	养老金	retire
pentaeritritol	季戊四醇	pentaeritritol
pentas	阶段	stage
penting	重要的	important
pentingnya	重要性	importance
penuh	充分	full
penukaran	交换	onsite
penularan	传播	infection
penulis	作者	writer
penulisan	写作	writing
penumpang	乘客	passenger
penumpukan	建立	buildup
penunjang	支持	supporter
penunjuk	指针	indicator
penurunan	减少	declination
penutup	闭幕	closing
penutur	扬声器	speaker
penyair	诗人	poet
penyajian	介绍	presentation
penyakit	疾病	disease
penyakitpenyakit	疾病	diseases
penyalahgunaan	滥用	misuse
penyaluran	分配	distribution
penyambutan	接待处	welcome
penyampaian	交货	sending
penyangga	缓冲	buffer
penyanyi	歌手	singer
penyatuan	联盟	unity
penyebab	原因	cause
penyebabnya	原因	cause
penyebar	吊具	spreader
penyebaran	传播	spreading
penyebutan	提到	spelling
penyederhanaan	简化	simplification
penyedia	提供者	provider
penyediaan	规定	appropriation
penyelamat	救主	rescuer
penyelamatan	拯救	rescue
penyelenggara	组织者	organizers
penyelenggaraan	实作	implementation
penyelesaian	沉降	completion
penyelidik	研究者	investigator
penyelidikan	调查	investigation
penyembuhan	康复	recovery
penyempitan	缩小	narrowing
penyempurnaan	改善	the consummation
penyerahan	投降	handover
penyerang	攻击者	attacker
penyerangan	攻击	invasion
penyerapan	吸收	absorbing
penyerbukan	授粉	pollenation
penyertaan	包含	participation
penyesuaian	调整	adjustment
penyiar	播音员	poet
penyiaran	广播	broadcast
penyidikan	调查	investigation
penyihir	巫婆	wizard
penyimpanan	存储	storing
penyimpangan	偏差	deviation
penyokong	支持者	support
penyuluhan	辅导	counseling
penyusun	编译器	compositor
penyusunan	起草	preparation
penyusunnya	其成分	the composer
peoples	人们	human
pepagan	异教徒	pepagan
peperangan	战争	war
pepes	佩佩斯	pepes
pepohonan	树	trees
peptidoglikan	肽聚糖	peptidoglycan
per	每	per
peradaban	文明	civilization
peradangan	炎	inflammation
peradilan	正义	justice
perahu	船	ship
perairan	水域	water
perak	银	perak
peralatan	设备	equipment
peralihan	切换	transition
peramban	浏览器	browser
peran	角色	role
peranan	角色	part
perancang	设计师	designer
perancangan	设计	design
perancis	法国	france
perang	战争	war
perangkat	设备	device
perangko	邮票	stamp
perantara	中介	intermediate
perantau	游牧民族	wanderer
perantauan	海外	migration
peranti	设备	device
perasaan	感觉	feeling
peraturan	规则	rules
perawan	处女	virgin
perawatan	关心	put
perawi	解说员	narrators
perayaan	庆典	celebration
perbaikan	改善	repair
perbandingan	比	comparison
perbankan	银行业	banking
perbanyakan	传播	increase
perbatasan	边界	boundary
perbedaan	区别	difference
perbedaannya	区别	differences
perbelanjaan	购物	shopping
perbendaharaan	国库	treasury
perbuatan	契据	deed
perbudakan	奴隶制	slavery
perbukitan	山丘	hills
percakapan	会话	conversation
percaya	相信	believe
percepatan	加速	acceleration
perceraian	离婚	divorce
percintaan	浪漫	romance
percobaan	试用	trial
perdagangan	贸易	trading
perdamaian	和平	peace
perdana	主要	prime
perdarahan	流血的	bleeding
perdata	民事的	civil
perdebatan	辩论	debate
perebutan	为..战斗	struggle
peredaran	循环	distribution
perekam	录音机	recording instrument
perekonomian	经济	economy
perempuan	女人	woman
perempuannya	那位女孩	girls
perenang	游泳者	swimmer
perencanaan	规划	planning
perez	佩雷斯	perez
performa	表演	performance
pergantian	代换	substitution
pergaulan	协会	friendship
pergelangan	腕	wrist
pergerakan	运动	the movement of
pergeseran	转移	shift
pergi	走	go
perguruan	学院	teaching
perhatian	注意	attention
perhatiannya	他的注意力	the attention
perhatikan	请注意	note
perhiasan	首饰	jewelry
perhimpunan	协会	association
perhitungan	计算	calculation
perhubungan	运输	nexus
peri	仙女	faerie
peribadatan	崇拜	liturgy
perihelion	近日点	perihelion
perikanan	渔业	fishery
perilaku	行为	behavior
perimbangan	平衡	balance
perindustrian	行业	industry
peringatan	警告	memorial
peringkat	排名	rank
perintah	命令	command
perintis	先锋	pioneer
periode	期	period
periodik	周期性的	periodic
perisai	屏蔽	shield
peristiwa	事件	news
peristiwaperistiwa	大事记	occurance
perjalanan	旅行	travel
perjalanannya	他的旅程	journey
perjan	约	agency company
perjanjian	协议	agreement
perjuangan	斗争	a battle
perkampungan	村	settlement
perkantoran	办公空间	office complex
perkapita	人均	per capita
perkara	案件	case
perkataan	话	words
perkawinan	婚姻	marriage
perkebunan	种植园	plantation
perkecualian	一个例外	exception to the rule
perkelahian	斗争	fighting
perkembangan	发展	growth
perkembangannya	它的发展	development
perkiraan	估计	estimate
perkotaan	市区	urban
perkumpulan	协会	association
perlahan	慢慢地	slow
perlahanlahan	慢慢地	slow
perlakuan	治疗	treatment
perlawanan	抵抗性	resistance
perlengkapan	设备	equipment
perlindungan	保护	protection
perlombaan	种族	race
perlu	需要	need
perluasan	扩张	expansion
permainan	游戏	game
permanen	常驻	permanent
permasalahan	问题	a problem
permata	宝石	jewel
permen	糖果	candy
permintaan	请求	request
permohonan	恳求	request
permukaan	表面	surface
permukaannya	它的表面	surface
permukiman	沉降	settlement
permulaan	开始	beginning
permusyawaratan	咨询服务	deliberation
pernah	曾经	ever
pernapasan	呼吸	respiratory
perniagaan	商业	commerce
pernikahan	婚礼	marriage
pernyataan	声明	statement
perolehan	取得	vote
perombakan	改组	reformation
perorangan	个人	individual
perpaduan	融合	blend
perpajakan	税收	taxation
perpanjangan	延期	extension
perpecahan	分裂	disunity
perpindahan	移位	migration
perpustakaan	图书馆	library
pers	人	press
persada	家园	persada
persahabatan	友谊	friendship
persaingan	竞争	competition
persalinan	劳工	childbirths
persamaan	方程	equation
persatuan	统一	unity
persaudaraan	兄弟会	brotherhood
persebaran	扩散;传播开	distribution
persediaan	股票	stock
persegi	广场	square
persekutuan	合伙	fellowship
perselisihan	争议	argument
persemakmuran	联邦	commonwealth
persembahan	产品	offerings
persen	百分	percent
persenjataan	武器	armament
persentase	百分比	percentage
perseorangan	个人	individual
persepsi	知觉	perception
perserikatan	联盟	union
persero	公司	public company
perseroan	公司	company
persetujuan	认可	approval
persia	波斯	persia
persiapan	制备	preparation
persidangan	法官	trial
persija	persija	persija
persilangan	交叉	crossing
persis	究竟	similiar
persoalan	问题	problem
personal	个人	personal
personel	人员	personal
perspektif	透视	perspective
persyaratan	要求	same strict
pertahanan	防御	defense
pertama	第一	first
pertamanya	首先	his/her/its first
pertamatama	首先	first of all
pertambahan	增生	increase
pertambangan	矿业	mining
pertamina	毛毡	pertamina
pertandingan	竞争	match
pertanggungjawaban	责任	responsibility
pertanian	农业	agriculture
pertanyaan	题	question
pertapa	苦行者	hermit
pertarungan	斗争	battle
pertempuran	战斗	battle
pertemuan	会议	converging
pertengahan	中	middle
pertentangan	争夺	conflict
pertikaian	内	conflict
pertimbangan	考虑	consideration
pertiwi	祖国	earth
pertolongan	帮帮我	help
pertukaran	交换	exchange
pertumbuhan	成长	growth
pertumbuhannya	它的成长	growth
pertunjukan	显示	show
pertunjukkan	演出	show
perubahan	更改	modification
perubahanperubahan	变化	changes
perum	公共公司	housing
perumahan	住房	housing
perumusan	公式	formulation
perundangundangan	立法	legislation
perundingan	谈判	negotiation
perunggu	青铜	bronze
perusahaan	公司	company
perusahaanperusahaan	公司	companies
perusakan	破坏行为	vandalism
perut	胃	stomatch
perwakilan	代表	representation
perwara	perwara	ancillary
perwira	特派员	officer
perwujudan	体现	embodiment
pesaing	竞争者	competitors
pesan	信息	a message
pesantren	寄宿学校	islamic boarding school
pesat	迅速地	rapid
pesawat	飞机	airplane
peserta	参加者	participant
pesisir	海岸	strand
pesta	派对	party
peta	地图	map
petani	农民	farmers
peter	彼得	peter
peternakan	畜牧业	farm
peterpan	探险家	peterpan
peti	胸部	box
petinggi	更高的人	top officials
petir	闪电	lightning
petrus	彼得鲁斯	petrus
petualangan	冒险	adventure
petugas	军官	officer
petunjuk	线索	guide
peuyeum	eu	peuyeum
pewaris	继承人	an heir
pewarisan	遗产	inherit
pewarnaan	着色	colouration
pewayangan	木偶戏	puppet
peziarah	朝圣者	visitor
pgri	pgri	pgri
ph	ph值	ph
phase	相	phase
philip	菲利普	philip
phobos	恐惧症	phobos
phoenix	凤凰	phoenix
photo	照片	photo
photoshop	的photoshop	photoshop
php	的php	php
physical	物理	physical
pi	pi	pi
piagam	宪章	charter
piaget	皮亚吉特	piaget
piala	杯	trophy
piano	钢琴	piano
piccolo	短笛	piccolo
pictures	图片	pictures
pidana	刑事	criminal
pidato	言语	speech
piece	片	piece
pierre	皮埃尔	pierre
pigmen	颜料	pigment
pihak	派对	party
pihakpihak	那些政党，那些派对	authorities
pikir	认为	thinking
pikiran	心神	mind
pilar	柱	pillar
pilih	选择	choose
pilihan	选择	option
pilot	飞行员	pilot
pilpres	总统选举	presidential election
pimpinan	领导	command
pinang	槟榔	areca palm
pindah	移动	move
pindang	煮沸	pindang
ping	ping	ping
pinggang	腰部	waist
pinggir	边缘	edge
pinggiran	边缘	skirt
pinggul	臀部	hip
pingsan	晕倒	fainting
pinjaman	贷款	loan
pintar	聪明	smart
pintu	门	door
pipa	管	pipe
pippin	皮平	pippin
piramida	金字塔	pyramid
piranti	设备	device
pires	海盗	pires
piring	盘子	piring
piringan	磁碟	disc
piruvat	丙酮酸	pyruvate
pisang	香蕉	banana
pisau	刀	knife
pita	胶带	ribbon
piutang	应收账款	accounts receivable
pkb	千字节	pkb
pki	ki	communist party
pks	包	mcc
planet	星球	planet
planetplanet	行星	planets
plantae	植物	plants
plasma	等离子体	plasma
plasmodium	疟原虫	plasmodium
plastik	塑胶的	plastic
platform	该平台	platform
platinum	铂	platinum
plato	高原	plato
playboy	花花公子	playboy
plaza	广场	plaza
plot	剧情	plot
pluit	哨	whistle
plus	加	plus
pluto	冥王星	pluto
pm	下午	post mortem (pm)
pn	pn	public sector school
pni	pni	pni
pocong	宝聪	pocong
pohon	树	tree
pohonpohon	树	trees
poin	点数	points
point	点	point
pokok	校长	main
pola	模式	pattern
polandia	波兰	poland
polapola	波拉波拉	patterns
polar	极性	polar
polemik	争论性的	polemic
polimer	聚合物	polymer
polio	脊髓灰质炎	polio
polisakarida	多糖	polysaccharide
polisi	警察	policy
politeknik	理工学院	polytechnic
politics	政治	politics
politik	政治	politic
politiknya	它的政治	politic
politikus	政治家	plotician
politis	政治	politically correct
politisi	政治家	politicians
polo	马球	polo
polri	警察	polri
polusi	污染	pollution
pompa	抽水机	pump
pondasi	基础	foundation
pondok	山寨	hut
pong	ong	pong
pongo	蓬戈	pongo
ponorogo	ponorogo	ponorogo
ponsel	手机	cellphone
pontianak	蓬蒂亚纳克	vampire
pop	流行音乐	pop
popular	流行	popular
popularitas	人气	popularity
populasi	人口	population
populasinya	它的人口	the population
populer	流行	popular
porifera	rif	sponge
poripori	多孔的	pores
porno	色情	porn
pornoaksi	色情动作	porno action
pornografi	色情	pornography
porong	俯卧撑	porong
poros	轴	axis
porsi	一部分	portion
portal	门户网站	portal
portland	波特兰	portland
portofolio	作品集	portfolio
portugal	葡萄牙	portugal
portugis	葡萄牙语	portuguese
pos	发布	mail
poseidon	波塞冬	poseidon
posisi	位置	position
posisinya	它的位置	position
positif	正	positive
post	发布	post
poster	海报	poster
potensi	效力	potential
potensial	潜在	potential
potong	切	cut
potongan	片	piece
potret	人像	portrait
potter	波特	potter
power	功率	power
powerpoint	微软幻灯片软件	powerpoint
pp	pp	pp
ppki	ki	ppki
ppp	ppp	ppp
pra	预先	pre-
prabu	普拉布	king
prajurit	士兵	soldier
prakiraan	预报	forecasts
praktek	实践	practice
prakteknya	实践	the practice
praktik	实践	practice
praktis	实际的	practical
praktisi	执业者	practitioner
prambanan	巴兰班南	prambanan
pramuka	侦察	scout
pranala	链接	link
prancis	法文	french
prasarana	基础设施	infrastructure
prasasti	题词	stone tablet
prasejarah	史前	prehistoric
pratama	普拉塔玛	first class
predator	捕食者	predator
predikat	谓语	predicate
prediksi	预测	prediction
prefiks	字首	prefix
premium	保费	premium
presentasi	介绍	presentation
presenter	演讲者	presenter
presiden	主席	president
presidensial	总统	presidential
presipitasi	沉淀	precipitation
presisi	精确	precision
press	按	press
prestasi	成就	achievement
prestise	声望	prestige
pria	男装	man
priangan	男子	priangan
pribadi	个人	personal
pribadinya	他的个性	personal
pribumi	原住民	native
price	价钱	price
priestley	普里斯特利	priestly
prima	主要	prime
primata	灵长类动物	primate
primer	主	primer
primitif	原始	primitive
prinsip	原理	principle
prinsipprinsip	原则	principles
printer	打印机	printer
priok	ok	priok
prioritas	优先	priority
privasi	隐私	privacy
privat	私人的	private
private	私人的	private
privatisasi	私有化	privatization
pro	亲	pro
probabilitas	机率	probability
problem	问题	problem
probolinggo	前进	probolinggo
prodip	产品	diploma study
production	生产	production
produk	产品	product
produkproduk	产品展示	products
produksi	生产	production
produksinya	它的生产	its production
produktif	生产性的	productive
produktivitas	生产率	productivity
produsen	生产者	producer
produser	生产者	produser
prof	教授	professor
profesi	职业	profession
profesional	专业的	profesional
profesor	教授	professor
professional	专业的	professional
profil	轮廓	profile
profile	轮廓	profile
progo	前进	progo
program	程序	program
programmer	程序员	programmer
programprogram	程式	software
progresif	进步	progressive
project	项目	project
prokariota	原核生物	prokaryotes
proklamasi	公告	proclamation
proliferasi	增殖	proliferation
prominensa	突出	prominence
promosi	晋升	promotion
propaganda	宣传	propaganda
properti	属性	property
propinsi	省	province
proporsi	比例	proportion
prosa	散文	prose
prosedur	程序	procedure
proses	处理	process
prosesor	处理器	processor
prosesproses	处理	processes
protease	蛋白酶	protease
protein	蛋白	protein
proteksi	保护	protection
protes	抗议	protest
protestan	新教	protestant
protista	原教徒	protists
protocol	协议	protocol
protokol	协议	protocol
proton	质子	proton
protozoa	原生动物	protozoa
provider	提供者	provider
provinsi	省	province
provinsiprovinsi	省份	province
provokatus	挑衅	provokatus
proxemiks	代理人	proxemiks
proyek	项目	project
proyekproyek	专案	proyekproyek
proyeksi	投影	projection
ps	ps	ps
psikologi	心理学	psychology
psikologis	心理	psychological
psikotropika	精神的	psychotropic
pssi	pssi	pssi
pt	pt	pt
puas	满意	satisfied
puasa	禁食	the fast
public	上市	public
publik	上市	public
publikasi	出版物	publication
pucuk	芽	tip
puisi	诗歌	poem
pujangga	诗人	poet
pukul	时	clock
pukulan	吹	blow
pula	也	also
pulang	回家	go home
pulau	岛	island
pulaupulau	岛岛	islands
pulih	恢复	recover
pulo	普洛	island
puluh	二十	twenty
puluhan	许多	tens of
pun	甚至	also
punah	灭绝的	extinct
punca	茎	punca
puncak	高峰	top
puncaknya	高峰	climax
punggung	背部	back
pungutan	征收	the levy
punk	朋克	punk
punya	有	has
pupuk	肥料	fertilizer
pura	寺庙	pretend
purba	古	ancient
purbakala	古	ancient
puri	城堡	castle
purn	n	veteran
purnama	满月	full moon
purnawarman	退休的	purnawarman
purwakarta	普瓦卡塔	purwakata
pusaka	传家宝	heirloom
pusat	中央	center
pusatpusat	中心	central
pusing	头晕	dizziness
pustaka	参考文献	book
putaran	回合	turn
putera	儿子	son
puteranya	他的儿子	his/her son
puteri	女儿	daughter
putih	白色	white
putik	雌蕊	pistil
putra	儿子	son
putranya	他的儿子	his/her son
putri	公主	putri
putu	普图	putu
putus	打破	off
putusan	决定	decision
px|bendera	px |标志	flag
pygmaeus	侏儒	pygmaeus
qadir	卡迪尔	qadir
qatar	卡塔尔	qatar
qs	s	qs
quebec	魁北克	quebec
query	查询	query
quraisy	夸里什	the quraish
quran	古兰经	quran
r	[r	r
ra	拉	ra
rabies	狂犬病	rabies
rabu	星期三	wednesday
racun	毒	poison
radang	炎	inflammation
radar	雷达	radar
raden	拉登	raden
radiasi	辐射	radiation
radikal	基	radical
radin	弧度	radin
radio	无线电	radio
radioaktif	放射性的	radioactive
radius	半径	radius
raffa	拉法	raffa
raffles	抽奖	raffles
raga	身体	body
ragam	品种	range
ragi	酵母	yeast
rahang	颚	jaw
rahasia	秘密	secret
rahim	子宫	uterus
rahman	拉曼	rahman
rahmat	恩典	blessing
rai	莱	rai
raja	国王	king
raja-udang	国王虾	kingfisher bird
rajanya	国王	king
rajaraja	拉贾拉贾	kings
rajasa	拉贾萨	rajasa
rajin	勤奋	diligent
raket	球拍	racket
rakeyan	拉基扬	rakeyan
rakryan	拉克里安	rakryan
raksa	汞	mercury
raksasa	巨人	giant
rakyat	人	people
rakyatnya	它的人	his/her people
ram	内存	ram
rama	喇嘛	rama
ramadan	斋月	ramadan
ramadhan	斋月	ramadhan
ramah	友好	friendly
ramai	挤	busy
ramayana	罗摩衍那	ramayana
rambut	头发	hair
rambutnya	她的头发	hair
ramuan	药水	concoction
ranah	境界	sphere
rancangan	草稿	design
randai	兰代	randai
rangga	阶梯	rangga
rangka	订购	frame
rangkaian	套房	series
rangkap	双	double
rangsangan	刺激	stimulus
rantai	链	chain
rantau	海外	rantau
rapat	会议	close
rapatan	紧紧	density
rapi	整齐	organised
rara	拉拉	rare
ras	种族	race
rasa	味道	feel
rasanya	味道	its taste
rasengan	拉森甘	rasengan
rasi	星座	constellation
rasio	比	ratio
rasional	合理的	rational
rasul	使徒	prophet
rasulullah	拉苏拉	the prophet
rata	平的	flat; rata-rata = average
ratapan	哭	wailing
ratarata	平均	average
rating	评分	rating
ratna	拉特纳	ratna
ratu	女王	queen
ratus	百	hundred
ratusan	几百	hunderds
raw	生的	raw
rawa	沼泽	swamp
rawan	易于	vilnerable
rawana	rawana	rawana
rawat	关心	treat
ray	射线	ray
raya	高速公路	great
rcti	rcti	rcti
re	回覆	re
reagan	里根	reagan
reaksi	反应	reaction
reaktan	反应物	reactant
reaktif	反应性	reactive
real	真实	real
realitas	现实	reality
rebab	小提琴	fiddle
rebo	重播	rebo
receiver	接收者	receiver
record	记录	record
red	红色	red
redaksi	编辑	editorial
redoks	氧化还原	redox
reduksi	减少	reduction
redup	暗淡	dim
referendum	公投	referendum
referensi	参考	referent
refleks	反射	reflex
refleksi	反射	reflection
reformasi	改革	reformation
regenerasi	再生	regeneration
regional	区域性	regional
register	寄存器	register
registrasi	注册	registration
regu	球队	group
regulasi	规	regulation
reguler	定期	regular
rehabilitasi	复原	rehabilitation
reinkarnasi	投胎	reincarnation
rekaman	记录	recording
rekan	同事	colleague
rekannya	他的伴侣	colleague
rekayasa	操纵	engineering
rekomendasi	建议	recommendation
rekonstruksi	重建	reconstruction
rekor	记录	record
rekreasi	娱乐	reaction
reksa	相互的	mutual
reksadana	共同基金	mutual fund
rektum	直肠	rectum
rel	轨	rail
rela	愿意	willingly
relasi	关系	relation
relatif	相对	relative
relativitas	相对论	relativity
relevan	相关的	relevant
relief	救济	relief
religi	宗教的	religion
religius	宗教的	religious
relung	利基市场	niche
rem	制动	brake
remaja	一个青少年	teenager
rembang	亮	rembang
remote	遥控器	remote
rempahrempah	草药和香料	spices
renaisans	再生	renaissance
renalis	肾炎	renal
renang	游泳的	swim
rencana	计划	plan
rencananya	计划	the plan
rencong	仁聪	rencong
rendah	低	low
rendahnya	低点	low
rendra	伦德拉	rendra
rengasdengklok	伦加登克洛克	rengasdengklok
renji	仁济	renji
rentan	易感的	vulnerable
rentang	范围	range
reog	雷格	reog
replika	复制品	replication
replikasi	复制	replication
report	报告	report
representasi	表示	represented
reproduksi	再生产	reproduction
reptil	爬虫	reptile
republik	共和国	republic
republika	共和国	republika
reputasi	声誉	reputation
reruntuhan	残骸	ruins
resep	食谱	prescription
reseptor	受体	receptor
resi	收据	resi
residen	居民	resident
residentie	居民	residency
residu	残渣	residue
resiko	风险	the risk
resistansi	抵抗性	resistance
resistor	电阻器	resistor
resmi	官方	official
resminya	官方	official
resolusi	解析度	resolution
resolver	解析器	resolver
resonansi	谐振	resonance
resource	资源	resource
respirasi	呼吸	respiration
respon	响应	respond
respons	响应	response
restoran	餐厅	restaurant
retikulum	课程	reticulum
retina	视网膜	retina
rev	转速	rev
reverse	逆转	reverse
revisi	修订版	revition
revolusi	革命	revolution
revolusioner	革命的	revolutionary
revolution	革命	revolution
rezim	政权	regime
rezky	雷兹基	rezky
rfc	射频	rfc
rhodes	罗得岛	rhodes
rhoma	罗马	dj
ri	ri	republic indonesia
riau	廖	riau
ribosom	核糖体	ribosome
ribu	千	thousand
ribuan	千	thousands
ricardo	里卡多	ricardo
rice	白饭	rice
richard	理查德	richard
ricky	瑞奇	ricky
right	对	right
riil	真实	real
riku	里库	riku
rilis	释放	release
rima	韵	rhyme
rimba	丛林	forest
rin	in	rin
rinci	详细	detailed
rincian	细节	detail
rindu	小姐	longing
ring	环	hoop
ringan	光	mild
ringkas	简洁	simple
ringkasan	摘要	summary
rintangan	障碍物	problem
rio	里约	rio
ris	里斯	indonesia union republic
risalah	论文	treatise
riset	研究	research
risiko	风险	the risk of
ritual	仪式	ritual
rival	竞争对手	rival
riwayat	历史	profile
rizal	里扎尔	rizal
rna	核糖核酸	rna
robert	罗伯特	robert
roberto	罗伯托	roberto
robin	知更鸟	robin
robot	机器人	robot
rock	岩石	rock
roda	车轮	wheel
roger	罗杰	roger
roh	精神	spirit
rohani	精神	spiritual
rokan	罗坎	rokan
roket	火箭	rocket
rokok	香烟	cigarette
rom	只读存储器	rom
roma	罗马	rome
roman	浪漫	romance
romantis	浪漫	romantic
romawi	罗曼	roman
rombongan	群组	group
ron	罗恩	ron
ronald	罗纳德	ronald
ronaldo	罗纳尔多	ronaldo
rongga	腔	cavity
root	根	root
rosa	罗莎	rosa
rose	玫瑰	rose
roses	玫瑰花	roses
rossi	罗西	rossi
roswell	罗斯威尔	roswell
rotan	藤	rattan
rotasi	回转	rotation
roti	面包	bread
rotterdam	鹿特丹	rotterdam
router	路由器	router
routing	路由	routing
routledge	劳特利奇	routledge
rowling	划船	rowling
roy	罗伊	roy
royal	皇家的	royal
royong	互相合作	javanese word
rp	rp	idr
rrc	rc	prc (people's republic of china)
rri	ri	republic of indonesia
rs	rs	hospital
rsi	si	rsi
rss	rss	really simple syndication
rsu	su	rsu
rsud	医院	rh (regional hospital)
ruam	皮疹	rash
ruang	房间	room
ruangan	房间	room
ruangruang	空间	spaces
ruas	分割	section
rubah	狐狸	fox
rugby	橄榄球	rugby
rugi	损失	loss
rujak	沙拉	salad
rujukan	参考	reference
rukun	相处得好	pillars
rumah	屋	house
rumahan	家	home
rumahnya	她的家	home
rumahrumah	房屋	houses
rumania	罗马尼亚	romania
rumit	复杂	complex
rumpun	团块	cluster
rumput	草	grass
rumus	式	formula
rumusan	公式	formula
runnerup	亚军	runner-up
runtuh	坍方	collapse
runtuhnya	坍方	the collapse of
rupa	相似	form
rupadhatu	鲁帕达图	the realm of intangibles
rupanya	显然地	apparently
rupiah	印尼盾	rupee
rups	卢比	agm
rusa	鹿	deer
rusak	破碎	broken
rusaknya	伤害	broken
rusia	俄国	russia
russia	俄国	russian
rusuk	侧	rib
rute	路线	route
rutin	常规	routine
ruu	u	legislative draft
ryan	瑞安	ryan
ryuzaki	龙崎	ryuzaki
s	s	s
sa	sa	sa
saat	什么时候	second
saatsaat	时刻	moment
sabah	沙巴	sabah
sabana	大草原	savannah
sabit	镰刀	sickle
sabtu	周六	saturday
sabuk	带	belt
sabun	肥皂	soap
sacchi	萨基	sacchi
sadar	意识到	realize
sadewa	萨德瓦	sadewa
saga	佐贺	saga
sage	智者	sage
sagu	西米	sago
sah	合法	valid
sahabat	友人	close friend
sahabatnya	他最好的朋友	his/her friend
saham	股票	stocks
sahamnya	它的股份	its shares
sahara	撒哈拉沙漠	sahara
sai	赛	sai
said	说过	said
sailendra	塞伦德拉	sailendra
saingan	对手	rival
sains	科学	science
saja	只要	only
sajak	韵	rhyme
sajaksajak	单独	poems
saka	坂	legacy
sakit	生病	ill
saksi	见证	witness
sakti	魔法	milky way
sakura	樱花	sakura
sakuraba	樱庭	sakuraba
salah	是错的	wrong
salak	吠	salak
salam	问候	regards
salat	礼拜	pray
saleh	敬虔的	saleh
salemba	salemba	salemba
salib	交叉	cross
salim	萨利姆	salim
salinan	复制	copy
saling	彼此	mutual
salju	雪	snow
saluran	渠道	gutter
salzburg	萨尔茨堡	salzburg
sam	山姆	scrolled
sama	相同	same
saman	萨满	saman
samarinda	三马林达	samarinda
samasama	别客气	equally
sambal	辣椒酱	chili sauce
sambas	桑巴斯	sambas
sambil	而	while
sambungan	连接	connection
sambutan	欢迎	welcome
samosir	沙摩西	samosir
sampah	垃圾	waste
sampai	至	to
sampel	例子	sample
samping	侧	beside
sampingan	侧	side
sampul	覆盖	cover
samudera	海洋	ocean
samudra	海洋	the ocean
samuel	塞缪尔	samuel
san	san	san
sana	那里	there
sanad	萨纳德	sanad
sanadnya	他的萨纳德	sanad
sanak	亲戚们	relative
sandang	服装	clothing
sandi	密码	code
sandiwara	戏剧	play
sandra	人质	sandra
sanfotsi	sanfotsi	sanfotsi (proper noun)
sang	的	the
sangat	非常	very
sangatlah	真	very
sanggup	能够	able
sanghyang	山阳	sang hyang
sangkar	笼	square
sangkuriang	桑库里昂	sangkuriang
sani	萨尼	sani
sanjaya	sanjaya	sanjaya
sanksi	罚款	sanction
sannin	三宁	sannin
sanskerta	梵文	sanskrit
santa	圣诞老人	saint
santo	圣	santo
sanusi	萨努西	sanusi
sapi	牛	cow
sapu	扫帚	broom
saraf	神经	nerve
sarah	莎拉	sarah
saran	建议	advice
sarana	手段	tool
sarang	巢	nest
sarawak	砂拉越	sarawak
sarekat	sarekat	si
sari	纱丽	pollen
sarjana	单身汉	scholar
sartika	萨尔蒂卡	sartika
sarung	围裙	holsters
sarutobi	猿猴	sarutobi
sasaran	目标	target
sasori	萨索里	sasori
sastra	文献	literature
sastrawan	作家	writer
sasuke	佐助	sasuke
sate	沙爹	satay
satelit	卫星	satellite
satelitsatelit	卫星照明	satellites
satria	骑士	knight
satu	一	one
satuan	单元	unit
satunya	只有一个	one of
satupun	任何人	even one
saturnus	土星	saturn
satusatunya	唯一的	the one and only
satwa	动物	animal
satya	沙爹	satya
saudara	兄弟	brother
saudaranya	他的兄弟	his brother
saudarasaudaranya	他的兄弟	his brothers
saudi	沙特	saudi
saus	酱	sauce
saw	愿他安息	saw
sawah	稻田	farm
sawit	棕榈油	palm oil
saya	我	i
sayang	亲	alas
sayangnya	不幸	unfortunately
sayap	翅膀	wing
sayembara	比赛	contest
sayur	蔬菜	vegetable
sayuran	蔬菜	vegetable
sayyid	赛义德	sayyid
sby	斯比	sby
school	学校	school
science	科学	science
sciences	科学	sciences
scientific	科学的	scientific
scipio	西皮奥	scipio
scott	史考特	scott
sctv	电视	sctv
sd	标清	elementary school
sda	sda	ns (natural resources)
se	se	one
searah	在同一方向	same direction
search	搜索	search
season	季节	season
sebab	因为	because
sebabnya	为什么	effects
sebagai	如	as
sebagaimana	照原样	such as
sebagainya	所以	so on
sebagian	部分地	part
sebaikbaiknya	最好的	better
sebaiknya	应该	it is best to
sebaliknya	除此以外	otherwise
sebanding	可比	proportional
sebanyak	尽可能多	as much as
sebaran	分配	distribution
sebatas	有限	limited
sebelah	下一个	side
sebelas	十一	eleven
sebelum	之前	before
sebelumnya	以前	previously
sebenarnya	事实上	in fact
sebentar	短暂地	for a while
seberang	对面	across
seberapa	多少	how
sebesar	的	in the amount of
sebetulnya	其实	actually
sebuah	一个	a
sebulan	一个月	a month
sebut	称它为	mentioned
sebutan	指定	term
secara	以某种方式	as
second	第二	second
secret	秘密	secret
security	安全	security
sedang	在	middling
sedangkan	而	while
sedemikian	这样	such
sederhana	简单	simple
sedih	伤心的	sad
sedikit	一点	few
sedikitnya	至少	at least
sedimen	沉淀	sediment
sedna	塞德娜	sedna
sedunia	世界	worldwide
seekor	一	a
segala	所有	all
segar	新鲜	fresh
segel	密封	seal
segenap	所有	all
segera	立即	immediately
segi	方面	facet
segitiga	三角形	triangle
segmen	分割	segments
sego	世高	sego
sehari	一天	one day
seharihari	日常	everyday
seharusnya	应该	supposed
sehat	健康	healthy
sehingga	这样	untill
sehubungan	在连接	in relation
seimbang	均衡	balanced
seiring	沿	as
seiyu	声优	seiyu
sejahtera	繁荣	prosper
sejajar	平行	aligned
sejak	以来	since
sejalan	排队	in step
sejarah	历史	history
sejarahnya	它的历史	its history
sejarawan	历史学家	historian
sejati	真正	true
sejauh	至今	as long as
sejenis	一种	kinds of
sejuk	凉	mild cool
sejumlah	一个号码	a number of
sekadar	只是	just
sekali	一次	once
sekaligus	立刻	at once
sekalipun	虽然	even though
sekarang	现在	now
sekarat	垂死	dying
sekedar	只是	just
sekeliling	周围	around
sekelompok	一堆	group
seketika	瞬间	immediately
sekian	就这样	as much as this
sekilas	一眼	glance
sekitar	周围	around
sekitarnya	周围	surroundings
sekolah	学校	school
sekolahnya	学校	school
sekolahsekolah	学校	schools
sekresi	分泌	secretion
sekretari	秘书	secretary
sekretariat	秘书处	secretariat
sekretaris	秘书	secretary
seks	性爱	sex
seksi	性感的	sexy
seksual	性的	sexual
seksualitas	性欲	sexuality
sekte	教派	sect
sektor	部门	sector
sekuler	世俗	secular
sekumpulan	一堆	set
sekunder	次要的	secondary
sekurangkurangnya	至少	at least
sekutu	盟友	the allies
sel	细胞	cell
selain	除了	apart from
selaku	和我一样	as
selalu	总是	always
selam	潜水	dive
selama	中	during
selamanya	永远	forever
selamat	恭喜	congratulations
selandia	新西兰	zealand
selangor	高昂	selangor
selanjutnya	下一个	further
selaput	膜	membrane
selat	海峡	strait
selatan	南	south
selatpanjang	南朗	town
seleksi	选择	selection
selektif	可选择的	selective
selepas	后	after
selera	味道	taste
selesai	做完了	finish
seljuk	僵硬	seljuk
selling	卖	selling
selnya	他的牢房	cell
selsel	selsel	cells
seluas	区域	area of
selubung	鞘	veil
selular	蜂窝状	cellular
seluler	蜂窝状的	cellular
selulosa	纤维素	cellulose
seluruh	遍	the whole
seluruhnya	在所有	all
sem	学期	sem
semacam	有点	sort of
semak	衬套	bush
semakin	越来越多	more
semangat	振作起来	spirit
semanggi	三叶草	clover
semantik	语义学	semantic
semar	三宝	semar
semarang	三宝垄	semarang
semasa	中	during
semata	只要	only
sematamata	气孔	solely
sembahyang	祷告	pray
sembarang	只是任何	random
sembilan	九	nine
semboyan	座右铭	motto
sembuh	痊愈	recover
semburan	爆发	spray
semen	水泥	cement
semenanjung	半岛	peninsula
semenjak	以来	since
sementara	而	while
semeru	塞梅鲁	semeru
semesta	宇宙	universal
semi	半	semi
semikonduktor	半导体	semiconductor
seminar	研讨会	seminar
seminggu	一周	a week
semisal	如	such as
sempat	有机会	have time
sempit	狭窄	narrow
sempurna	完善	perfect
semu	伪的	apparent
semua	所有	all
semuanya	所有	all
semula	开始	originally
semusim	一个赛季	seasonal
semut	蚂蚁	ant
sena	塞纳	sena
senam	体操	calisthenics
senang	快乐	easy
senantiasa	总是	always
senar	弦	strings
senat	参议院	senate
senator	参议员	senator
senayan	塞纳延	senayan
sendi	关节	joints
sendiri	一个人	alone
sendirian	单独	alone
sendirinya	本身	alone
senen	星期一	monday
seng	锌	zinc
sengaja	故意	deliberately
sengit	激烈	fierce
sengketa	争议	controversy
seni	艺术	art
seniman	艺术家	artist
senin	星期一	monday
senior	资深的	senior
senja	黄昏	twilight
senjata	武器	weapon
sensasi	感觉	sensation
sensitif	敏感	sensitive
sensor	传感器	censor
sensus	人口普查	census
sentra	中心	center
sentral	中央	central
sentuhan	触摸	touch
senyawa	复合	compound
senyawasenyawa	复合	compounds
seolaholah	仿佛	as if
seorang	一个	a
seoul	汉城	seoul
sepak	足球	soccer
sepakat	同意	agreed
sepanjang	只要	along
separuh	半	half
sepasang	对	pair
sepatu	鞋子	shoe
sepeda	自行车	bicycle
sepeninggal	离开后	sepeninggal
sepenuhnya	充分地	fully
seperempat	四分之一	one quarter
seperti	如	such as
sepertiga	三分之一	a third
sepertinya	看起来像	it looks like
sepihak	单方面	unilateral
september	九月	september
sepuluh	十	ten
sepupu	表姐	cousin
sepupunya	他的表亲	his/her cousin
seputar	周围	about
serabut	纤维	fiber
serafim	六翼天使	the seraphim
seragam	制服	uniform
seram	幽灵般的	seram
serambi	门廊	room
serang	攻击	attack
serangan	攻击	attack
seranganserangan	攻击	attacks
serangga	昆虫	insect
serangkaian	一系列	series
serapan	摄取	absorption
serasah	垃圾	some kind of grass that cover the forest
serat	纤维	fiber
seratus	百	hundred
serba	总而言之	completely
serbia	塞尔维亚	serbia
serbuk	粉末	powder
serdadu	士兵	soldier
serentak	同时	simultaneous
seri	系列	series
serial	连载	serial
seribu	千	many
series	系列	series
serigala	狼	wolf
serikat	联盟	union
sering	经常	always
seringkali	经常	always
serius	认真地	serious
serpihan	碎片	flakes
serpong	塞尔邦	serpong
serta	和	and
sertifikasi	认证	certificate
sertifikat	证书	certificate
serum	血清	serum
serupa	类似	similar
server	服务器	server
service	服务	service
services	服务	services
serviks	宫颈	cervix
servis	服务	servicing
sesaat	时刻	awhile
sesak	挤	crowded
sesama	同伴	a fellow
sesekali	偶尔	occasionally
seseorang	某人	someone
sesepuh	长者	elders
sesi	会议	session
sesuai	相应	appropriate
sesuatu	某事	something
sesudah	后	after
sesudahnya	然后	subsequent
sesungguhnya	真	real
set	组	set
setahun	一年	a year
setan	魔鬼	devil
setara	等于	equivalent
setelah	之后	after
setelahnya	之后	the following
setempat	本地	one place
setengah	半	half
seterusnya	依此类推	so forth
setia	忠诚	loyal
setiap	每一个	every
setidaknya	至少	at least
setinggi	高达	as high as
setingkat	一级	evel
setting	设置	setting
setuju	同意	agree
seumur	同龄	lifetime
seusai	后	after
seven	七	seven
sevenfold	七倍	sevenfold
sewa	出租	rent
sewaktu	什么时候	while
sewaktuwaktu	任何时候	anytime
sewu	世屋	sewu
sex	性别	sex
sh	sh	ll.b
shadows	阴影	shadows
shah	h	shah
shankly	小腿	shankly
sharingan	共享	sharingan
sharp	尖锐	sharp
shell	贝壳	shell
shikamaru	鹿丸	shikamaru
shin	胫	shin
shinichi	新一	shinichi
shinigami	shinigami	death god
shino	筱野	shino
shinobi	忍比	shinobi
shinta	新田	name
shinto	神道	shinto
shireen	郡	shireen
shizuka	静香	shizuka
show	显示	show
shukaku	我的淑子	shukaku
shuriken	手里剑	shuriken
si	si	the
siaga	支持	standby
siak	锡克	siak
siam	暹	siam
siang	中午	daylight
sianida	氰化物	cyanide
siap	准备	ready
siapa	who	who
siapapun	任何人	anyone
siaran	广播	broadcast
siberia	西伯利亚	siberia
sibuk	忙	busy
sidang	试用	session
sidoarjo	西多阿茹	sodiarjo
sierra	塞拉	sierra
sifat	性质	character
sifatnya	它的性质	its nature
sifatsifat	性质	properties
signifikan	重大	significant
sihir	魔法	magic
sikap	态度	attitude
sikapnya	他的态度	his attitude
siklon	气旋	cyclone
siklus	周期	cycle
sila	请	precept
silang	交叉	cross
silat	西拉特	martial art
silek	silek	martial art
silikat	硅酸盐	silicate
silikon	硅	silicon
silinder	圆筒	cylinder
siliwangi	斯里旺吉	siliwangi
silsilah	家谱	pedigree
siluman	隐身	invisible
simalungun	西马伦贡	simalungun
simbiosis	共生	symbiosis
simbol	符号	symbol
simbolik	象征性的	symbolic
simbolsimbol	符号	symbols
simetri	对称	symmetry
simetris	对称的	symmetric
simfoni	交响乐	symphony
simon	西蒙	simon
simpanan	存款	saving
simpanse	黑猩猩	chimpanzee
simpati	同情	sympathy
simtoma	症状	symptom
simulasi	模拟	simulation
sina	新浪网	[people name]
sinar	射线	beam
sinarx	x射线	x ray
sindiran	影射	satire
sindrom	综合症	syndrome
sinemart	电影	sinemart
sinetron	肥皂剧	soap operas
singa	狮子	lion
singapura	新加坡	singapore
singel	单	singles
singer	歌手	singer
singgah	停下来	stop by
singhasari	辛哈萨里	singhasari
singkat	短	short
singkatan	缩写	abbreviation
singkatnya	简而言之	the short
singkawang	星卡旺	singkawang
singkong	木薯	cassava
single	单	single
sini	这里	here
sinonim	代名词	synonym
sinta	辛塔	sprott
sintaks	句法	syntax
sintesis	合成	synthesis
sintetis	合成的	synthetic
sinyal	信号	signal
sipil	民事的	civil
siprus	塞浦路斯	cyprus
sir	先生	sir
siregar	瑟尔加	siregar
sirih	槟榔	betel
sirius	天狼星	sirius
sirkuit	电路	circuit
sirkulasi	循环	circulation
sisa	其余的	residue
sisanya	其余的	the rest
sisasisa	西萨萨	leftovers
sisi	侧	side
sisinya	它的一面	side
sistem	系统	system
sistematik	系统的	systematic
sistematis	系统的	systematic
sistemik	系统的	systemic
siswa	学生	student
siswasiswi	学生们	students
sita	没收	sita
site	现场	site
siti	西提	siti
sitokina	细胞因子	sitokina
sitologi	细胞学	cytology
sitoplasma	细胞质	cytoplasm
sitoskeleton	细胞骨架	cytoskeleton
situ	那里	there
situasi	情况	situation
situbondo	西图邦多	situbondo
situs	网站	site
situssitus	现场	sites
siwa	湿婆	siwa
sjahrir	沙耶里尔	sjahrir
sk	sk	sk
skala	规模	scale
skandal	丑闻	scandal
skema	方案	scheme
skenario	情景	scenario
sketsa	草图	sketch
skor	得分了	score
skotlandia	苏格兰	scotland
sky	天空	sky
slamet	猛击	slamet
sleman	斯莱曼	sleman
slide	幻灯片	slide
slot	插槽	slot
slovenia	斯洛文尼亚	slovenia
sm	短信	bc
sma	中学	high school
smart	聪明	smart
smith	史密斯	smith
smp	初中	junior high school
sms	短信	sms
smu	mu	smu (high school)
sn	锡	sn
snape	斯内普	snape
so	所以	so
soal	题	about
social	社会的	social
society	社会	society
soebardjo	soebardjo	soebardjo
soedirman	苏迪曼	soedirman
soeharto	苏哈托	soeharto
soekarno	苏加诺	soekarno
soekarnohatta	soekarnohatta	soekarno-hatta
soekarnoputri	苏卡诺普特里	soekarnoputri
soewardi	苏瓦底	soewardi
software	软件	software
sokrates	渗透率	socrates
sol	溶胶	sole
solar	太阳能的	solar
solo	独奏	solo
solok	索罗克	solok
solusi	解决方案	solution
somalia	索马里	somalia
soneta	十四行诗	sonnet
songket	松果	songket
songo	松果	songo
sop	汤	soup
soppeng	索彭	soppeng
sore	下午	afternoon
sorga	天堂	heaven
sorong	塞到	sorong
sosial	社会的	social
sosialis	社会主义者	socialist
sosialisasi	社会化	socialization
sosialisme	社会主义	socialism
sosialnya	它的社会	his/her/its social
sosiologi	社会学	sociology
sosiologis	社会学的	sociological
sosok	数字	figure
soto	索托	soto
soundtrack	配乐	soundtrack
south	南	south
southeast	东南	southeast
southern	南部的	southern
soviet	苏联	soviet
spa	温泉	spa
space	空间	space
spacetoon	太空卡通	spacetoon
spanyol	西班牙文	spain
special	特别	special
species	种类	species
speed	速度	speed
spektrum	光谱	spectrum
spekulasi	投机	speculation
sperma	精子	sperm
spesial	特别	specials
spesialis	专家	specialist
spesialisasi	专业化	specialization
spesiasi	物种	specialization
spesies	种类	species
spesiesspesies	种类	species
spesifik	具体	specific
spesifikasi	规格	specifications
spesimen	样品	specimen
spin	旋转	spin
spiral	螺旋	spiral
spiritual	精神	spiritual
spons	海绵	sponge
sponsor	发起人	sponsor
spontan	自发	spontaneous
spora	孢子	spore
sql	sql	sql
square	广场	square
sri	斯里	sri
sriwijaya	斯里维贾亚	sriwijaya
ss	ss	ss
st	st	saint
stabil	稳定	stable
stabilisasi	稳定化	stabilization
stabilitas	稳定性	stability
stadion	体育场	stadium
stadium	体育场	stage
staf	员工	staff
stain	弄脏	stain
stambul	斯坦布尔	stambul
stamford	史丹福	stamford
stan	摊位	stand
standar	标准	standard
standard	标准	standard
standardisasi	标准化	standardization
stanford	斯坦福大学	stanford
stapala	斯塔帕拉	stapala
start	开始	start
stasiun	站	station
stateful	有状态的	stateful
station	站	station
statis	静态的	static
statistik	统计	statistic
statistika	统计	statistics
status	状态	status
statusnya	它的地位	status
stephen	斯蒂芬	stephen
steve	史蒂夫	steve
stie	斯蒂	stie
stigma	柱头	stigma
stkip	跳	stkip
stmik	m	stmik
story	故事	story
strata	水平	level
strategi	战略	strategy
strategis	战略	strategic
stratifikasi	分层	stratification
stratosfer	平流层	stratosphere
street	街	street
stres	压力大的	stress
stress	压力大的	stress
stroke	中风	stroke
stroma	基质	stroma
struktur	结构体	structure
struktural	结构的	structural
strukturnya	其结构	its structure
studi	学习	study
studies	学习	studies
studinya	他的书房	his studies
studio	工作室	studio
study	研究	study
stupa	佛塔	stupa
suaka	庇护	asylum
suami	丈夫	husband
suaminya	她的丈夫	her husband
suara	声音	vote
suaranya	他的声音	sound
suasana	大气层	environment
suatu	某事	a
sub	子	sub
subadra	苏哈德拉	subadra
subang	耳坠	eardrop
subbagian	小节	subsections
subduksi	俯冲	subduction
subinterval	子间隔	subinterval
subjek	主题	subject
subjektif	主观	subjective
subkultur	亚文化	sub-culture
subnet	子网	subnets
subsahara	撒哈拉沙漠	sub-saharan
subsidi	补贴	subsidy
subspesies	亚种	subspecies
substansi	物质	substance
substitusi	代换	substitute
substrat	基质	substract
subtipe	亚型	subtypes
subtropis	亚热带的	subtropical
subur	沃	fertile
subyek	学科	subject
subyektif	主观	subjective
suci	圣	sacred
sudah	已经	already
sudan	苏丹	sudan
sudirman	苏迪曼	sudirman
sudut	角	point of view
sufi	苏菲阶	sufi
sufyan	苏菲扬	sufyan
suharto	苏哈托	suharto
suhu	温度	temperatur
suhunya	温度	its temperature
suigetsu	水月	suigetsu
suite	套房	suite
suiton	suiton	suiton
suka	喜欢它	like
sukabumi	须文	sukabumi
sukar	硬	difficult
sukarela	志愿者	voluntary
sukarno	难	sukarno
sukses	成功	success
suksesi	演替	succession
suku	部落	tribe
sukusuku	我的部落	tribes
sulaiman	所罗门	solomon
sulawesi	苏拉威西	sulawesi
sulfat	硫酸盐	sulphate
sulfur	硫	sulfur
suling	长笛	flute
sulit	难	dificult
sultan	苏丹	sultan (small ruler)
sumatera	苏门答腊	sumatera
sumatra	苏门答腊	sumatra
sumbangan	捐款	donation
sumbawa	b洼	sumbawa
sumber	资源	source
sumberdaya	资源	resource
sumbernya	来源	its source
sumbersumber	资料来源	sources
sumbi	灯芯	sumbi
sumbu	轴	axis
sumedang	苏美当	sumedang
sumenep	苏门内普	sumenep
sumpah	誓言	oath
sumsum	骨髓	marrow
sumur	好	well
sun	太阳	sun
suna	苏那	suna
sunah	na那	sunnah
sunan	苏南	sunan
sunda	da田	sunda
sundagaluh	sundagaluh	sunda-galuh
suneo	顺野	japanese word
sungai	河	river
sungaisungai	河	river river
sungguh	真	indeed
sungguhsungguh	真正地	really
sungkar	分手	sungkar
sunnah	圣训	sunnah
sunni	逊尼派	sunni
sunter	落日	sunter
suntik	注射	injection
suntikan	注射	injection
sunting	编辑	edit
supaya	以便	so that
super	超	super
supernatural	超自然	supernatural
supernova	超新星	supernova
supersemar	超级	supersemar
suplai	供应	supply
support	支持	support
surabaya	泗水	surabaya
surakarta	苏拉卡塔	surakarta
surat	信	letter
suratsurat	信	letters
surawisesa	surawisesa	surawisesa
surel	电子邮件	email
surga	天堂	heaven
suriah	叙利亚	syria
suriname	苏里南	suriname
surut	后退	subside
survei	调查	survey
survey	调查	survey
surya	太阳	solar
susah	难	hard
susanoo	苏萨诺	susano'o
susilo	苏西洛	javanese name
suspensi	悬挂	suspension
susu	牛奶	milk
susunan	安排	structure
sutan	苏丹	sutan
sutera	丝	silk
sutomo	外友	sutomo
sutra	丝	silk
sutradara	导向器	director
suzuna	苏祖纳	suzuna
swami	斯瓦米	swami
swasta	私人的	private
swedia	瑞典	swedish
swimming	游泳的	swimming
swiss	瑞士	switzerland
switch	开关	switch
syafii	沙菲	syafi'i
syah	h	legitimate
syahadat	信条	islamic confession
syahrir	syahrir	syahrir
syaikh	谢赫	sheikh
syair	诗歌	poem
syara	赛拉	personality
syaraf	神经	nerve
syarat	健康）状况	requisites
syaratsyarat	需求	terms
syariah	伊斯兰教法	shariah
syariat	伊斯兰教法	sharia
syarif	谢里夫	syarif
sydney	悉尼	sydney
syeikh	谢赫	sheikh
syekh	谢赫	sheikh
syiah	什叶派	syi'ah
syok	休克	shock
syria	叙利亚	syria
systems	系统	systems
t	ť	t
ta	ta	ta
taala	塔拉	made
taat	听话	obedient
tabanan	塔巴南	tabanan
tabel	表	buffer
tablet	片剂	tablet
tabloid	小报	tabloid
tabrakan	崩溃	collision
tabu	忌讳	taboo
tabung	管	tube
tabungan	储蓄	saving
tadi	更早	last
tadinya	原为	previously
tafsir	解释	commentary
tahan	坚持，稍等	resistant
tahanan	囚犯	prisoner
tahap	步	phase
tahapan	阶段	stages
tahapantahapan	阶段阶段	stages
tahta	王座	throne
tahu	豆腐	know
tahun	年	year
tahunan	年度的	yearly
tahunnya	那一年	each year
tahuntahun	年份	year year
taijutsu	大柔术	taijutsu
taiwan	台湾	taiwan
tajam	尖锐	sharp
tak	不	not
takami	高见	takami
takdir	命运	destiny
takhta	王座	throne
taklukan	征服了	conquered
taksi	出租车	taxi
taksonomi	分类	taxonomy
taktik	策略	tactic
takus	塔库	takus
takut	害怕	fear
tali	绳	rope
talib	塔里布	talib
taman	花园	park
tambahan	额外	additional
tambak	池塘	fishpond
tambang	矿	mine
tambo	坦波	legend
tameng	屏蔽	shield
tamil	泰米尔语	tamil
tampak	看着	visible
tampaknya	它似乎	looks like
tampan	英俊	handsome
tampil	出现	perform
tampilan	显示	display
tamu	来宾	guest
tan	棕褐色	tan
tana	塔那	tana
tanah	泥	soil
tanahnya	那片土地	its land
tanam	种植	plant
tanaman	厂	plant
tanda	标志	mark
tandatanda	迹象	signs
tanduk	喇叭	horn
tangan	手	hand
tangannya	他的手	his/her hand
tangerang	坦格朗	tangerang
tangga	楼梯	house hold
tanggal	日期	date
tanggapan	响应	respond
tanggul	堤	embankment
tanggung	熊	responsibility
tangkai	茎	stalk
tangkap	抓住它	catch
tangkis	反击	badminton
tangkuban	唐库班	tangkuban
tani	农民	farmer
tanjung	岬	cape
tanjungpinang	丹戎槟榔	tanjungpinang
tanpa	没有	without
tantangan	挑战	challenge
tanzania	坦桑尼亚	tanzania
tap	轻拍	tap
tapak	脚印	footprint
tapanuli	塔帕努利	tapanuli
tape	胶带	tapai
tapi	但	but
tapis	但是s	filter
taraf	水平	level
tarakan	塔拉坎	tarakan
target	目标	target
tari	舞蹈	dance
tarian	舞蹈	dance
tarif	费率	fare
tarik	拉	pull
tarikan	拉	pull
tarikh	日期	dates
taruhan	打赌	betting
tarumanagara	塔鲁玛纳加拉	taruma kingdom
tarumanegara	国家	tarumanegara
tarusbawa	塔鲁斯巴瓦	tarusbawa (proper noun)
tas	袋	the bag
tasikmalaya	tasikmalaya	tasikmalaya
tasya	塔西亚	tasya
tata	系统	order
tatabahasa	语法	grammar
tatanan	订购	order
tau	知道	know
tawanan	囚犯	prisoner
tawar	无味的	fresh water
tawaran	投标	offers
tayang	播出	show
taylor	泰勒	taylor
tbk	tbk	(some sort of business word, maybe similar to inc., i don't know this)
tcpip	tcpip	tcpip
team	球队	team
teater	剧院	theater
tebakan	猜测	riddle
tebal	厚	thick
tebing	悬崖	cliff
tebu	甘蔗	cane
technology	技术	technology
tegak	直立	upright
tegal	tegal	tegal
tegangan	电压	pressure
tegas	断言的	assertive
teguh	公司	firm
teh	茶	tea
tehnik	技术	technique
tekad	判定	determination
tekanan	压力	pressure
teknik	技术	engineering
teknikteknik	技术	techniques
teknis	技术	technical
teknologi	技术	tachnology
teks	文本	text
tekstil	纺织品	textile
tektonik	构造的	tectonic
telaga	湖	lake
telah	曾经	already
telanjang	裸	naked
telapak	手掌	the palm
telekomunikasi	电讯	telecommunication
telepon	电话	phone
teleskop	望远镜	telescope
televisi	电视	television
telinga	耳	ear
teliti	彻底	careful
telkom	电信	telkom
telpon	电话	call
teluk	湾	gulf of
telur	鸡蛋	eggs
telurnya	鸡蛋	its egg
tema	主题	theme
teman	朋友	friend
temannya	她的朋友	his/her friend
temanteman	朋友们	friends
temantemannya	他的朋友们	his/her friends
temari	特马里	temari
tematema	主题	themes
tembaga	铜	copper
tembak	射击	shoot
tembakan	射击	shot
tembakau	烟草	tobacco
tembok	壁	wall
tembolok	快取	paunch
tempat	这个地方	place
tempatnya	这个地方	its place
tempattempat	地方	places
tempe	豆temp	fermented soy cake
temperatur	温度	the temperature of the
tempo	速度	tempo
tempoyak	tempoyak	[food name]
tempur	战斗	battle
temuan	发现	finding
temurun	遗传	generations
ten	十	about
tenaga	功率	force
tenang	冷静点	peace
tendangan	踢	kick
tengah	中间	middle
tengahan	中间	middle
tengahnya	中间	in middle
tengahtengah	中间	middle
tenggara	东南	southeast
tenggelam	下沉	sink
tengger	滕格尔	tengger
tenggorokan	喉	throat
tengkorak	头骨	skull
tenis	网球	tennis
tentang	关于	about
tentara	军队	soldier
tentaranya	军队	army
tentu	某些	certainly
tentunya	当然	of course
tenun	编织	textile
teologi	神学	technology
teorema	定理	theorem
teoretis	理论的	theoretical
teori	理论	theory
teorinya	理论	his/her theory
teoriteori	理论	theories
teoritis	理论的	theoretic
tepat	对	precise
tepatnya	究竟	exactly
tepi	边缘	side
tepian	壁架	shore
tepung	面粉	flour
terakhir	最后	last
terakhirnya	最后	his/her last
terancam	受到威胁	threaten
terang	光	bright
terangterangan	公然地	explicitly
terapan	已应用	applied
terapi	治疗	therapy
teras	阳台	terraced
terasa	感觉	feel
teratai	莲花	lotus
teratas	最佳	top
teratur	定期	regular
terbagi	分为	divided
terbaik	最好的	the best
terbakar	着火	burned
terbalik	上下翻转	reversed
terbang	飞	fly
terbanyak	最多	most
terbaru	最新的	latest
terbatas	有限	limited
terbawa	被带走	get carried away
terbebas	自由	free
terbenam	下去	set
terbentang	展开	lie
terbentuk	形成的	formed
terbentuklah	形成	formed
terbentuknya	它的成形	formed
terbesar	最大的	biggest
terbiasa	适应了	used to
terbit	已发表	rise
terbitan	问题	edition
terbuat	由...制成	made from
terbuka	打开	open
terbukti	证明的	proven
terbunuh	被杀	killed
terburuk	最坏的	worst
tercampur	混合	mixed
tercantum	列出	listed
tercapai	到达	reached
tercatat	已记录	registered
tercemar	受污	polluted
tercepat	最快的	the fastest
tercermin	反映的	reflected
tercipta	被创造	bakit
terciptanya	创建	the creation
terdaftar	注册	registered
terdahulu	预先	in the past
terdapat	有	contained
terdekat	最近的	nearest
terdengar	声音	heard
terdesak	按下	desperate
terdiri	由组成	consist
terduga	预期	expected
terelakkan	必然	inevitable
terencana	计划	planned
terendah	最低	lowest
terengganu	登嘉楼	terengganu
terfavorit	最喜欢的	most favorite
tergabung	合并	joined
terganggu	不安	disturbed
tergantung	这取决于	depend on
tergolong	分类	classified
terhadap	至	in the face of
terhambat	受到阻碍	hampered
terhenti	停滞不前	stopped
terhingga	有限	limited
terhubung	连接到它	connected
terikat	界	connected
terima	接受	receive
terinfeksi	已感染	infected
terinspirasi	受到启发	inspired
terintegrasi	集成	integrated
teripang	海参	trepanging
terisi	填充	unfilled
terisolasi	隔离的	isolated
teritori	领土	territory
teritorial	属地	territorial
terjadi	发生	happen
terjadilah	发生了	happen
terjadinya	发生	terjadinya
terjangkau	负担得起的	affordable
terjauh	最远	furthest
terjebak	卡住	trapped
terjemahan	翻译	translation
terjual	已卖出	sold
terjun	浸入	plunge
terkadang	有时	sometimes
terkait	相关	related
terkalahkan	打败	invincible
terkandung	包含	contained
terkecil	最小的	smallest
terkejut	惊讶的	shocked
terkemuka	领导	notable
terkena	暴露	affected
terkenal	著名	famous
terkendali	掌握之中	under control
terkesan	印象深刻	impressed
terkini	最新	latest / recent
terkonsentrasi	集中	concentrated
terkontrol	受控	control
terkuat	最强	strongest
terkumpul	集	collected
terlalu	也一样	too
terlambat	晚了	late
terlarang	禁止的	forbidden
terlarut	溶解	dissolved
terlatih	受过训练的	trained
terlebih	更是如此	especially
terlengkap	最完整	most complete
terlepas	而不管	escape
terletak	位于	located
terlibat	涉及	involved
terlihat	看过	look
terlindungi	受保护的	protected
terluar	最外层	outermost
terluas	最宽	the widest
terluka	受伤的	injured
termal	热的	thermal
termasuk	包含	including
terminal	终奌站	terminal
terminologi	术语	terminology
termionik	热电子的	thermionic
termodinamika	热力学	thermodynamics
termometer	温度计	thermometer
termosfer	热球	thermosphere
termuda	最年轻的	youngest
ternak	家畜	livestock
ternama	著名	famous
ternate	三生	ternate
ternyata	显然地	actually
teroksidasi	氧化的	oxidized
teror	恐怖	terror
terorganisasi	有组织的	organized
teroris	恐怖分子	terrorist
terorisme	恐怖主义	terrorism
terowongan	隧道	tunnel
terpadat	人口最多	densest
terpadu	集成	integrated
terpaksa	被迫	forced
terpanjang	最长的	longest
terpantau	受监控	observed
terpecah	分裂	shattered
terpencil	隔离的	isolated
terpengaruh	被影响	influenced
terpenting	最重要的	the most important
terperangkap	被困	stuck in
terperinci	详细	detailed
terpilih	已选	chosen
terpimpin	引导的	guided
terpisah	分离	distinct
terpisahkan	积分	separated
terpusat	居中	concentrated
terputus	断开连接	disconnected
tersambung	已连接	connected
tersangka	疑似	the usual suspects
tersebar	传播	scattered
tersebut	的	is
tersedia	可用的	available
tersedianya	可用性	available
tersegel	密封	sealed
tersembunyi	隐	hidden
tersendiri	单独	distinct
tersier	第三	tertiary
tersimpan	储存的	stored
tersisa	剩余的	remaining
tersukses	最成功的	successful
tersusun	安排	composed
tertanam	嵌入式的	planted
tertanggal	过时的	dated
tertangkap	赶上	caught
tertarik	有兴趣	interested
tertawa	笑	laugh
tertentu	某些	specific
tertib	有顺序地	orderly
tertinggal	被留下来	left behind
tertinggi	最高的	top level
tertua	最老的	oldest
tertulis	书面	written
tertutup	封闭的	enclosed
terungkap	显露	revealed
terurai	绎	decomposed into
terus	继续	continue
terusan	运河	canal
terusmenerus	连续地	continuous
terutama	特别	particularly
terutamanya	特别	particularly
terwujud	物化	materialized
tes	测试	test
test	测试	test
tetangga	邻居	neighbour
tetangganya	它的邻居	it neighbor
tetap	还是	still
tetapi	但	but
tetesan	水滴	droplets
tetua	长者	elder
teuku	uku	teuku
teungku	东姑	teungku
tewas	被杀害	died
texas	得克萨斯州	texas
text	文本	text
thai	泰国	thailand
thailand	泰国	thailand
thalib	塔利卜	thalib
thamrin	瑟姆林	thamrin
the	的	the
thebes	底比斯	thebes
their	其	their
theme	主题	theme
theogonia	神og	theogonia
theravada	上座部	theravada
third	第三	third
thomas	托马斯	thomas
thought	思想	thought
thumb|	拇指	thumb
thumb|px|peta	拇指| px |地图	peta = map
ti	ti	it
tiada	不见了	no
tiang	极	pole
tiap	每	each
tiaptiap	每次	each
tiba	到了	arrive
tibatiba	突然	suddenly
tibet	西藏	tibet
tidak	不	not
tidaklah	它不是	not
tidaknya	是否	not
tidore	提多尔	tidore
tidur	睡觉	sleep
tien	天恩	tien
tifa	蒂法	drum
tiga	三	three
tigris	底格里斯河	tigris
tikus	鼠	mouse
tilakoid	类囊体	tilacoide
tilu	蒂鲁	tilu
tim	球队	tim
timaeus	音调	timaeus
timah	铅	tin
timbal	铅	equal
timbul	出现	come up
timbulnya	紧急情况	emergence
times	次	times
timnas	国家队	national team
timor	东	timor
timorleste	东帝汶	timor leste
timtim	timtim	eastern east (east timor), [timtim]
timur	东	east
tindak	法案	act
tindakan	行动	action
tindakantindakan	行动	actions
tindih	叠加的	overlap
tinggal	生活	live
tinggi	高	high
tingginya	它的高度	high
tingkah	法案	behavior
tingkat	水平	level
tingkatan	层级	levels
tinju	拳击	boxing
tionghoa	中文	chinese
tiongkok	中国	china
tipe	类型	type
tipis	瘦	thin
tips	提示	tips
tipuan	一个恶作剧	trick
tiri	继父	step-
tiro	蒂罗	tiro
tiruan	仿制	imitation
titan	泰坦	titan
titanic	泰坦尼克号	titanic
titik	点	dot
titiktitik	点	dots
tjipto	吉普托	tjipto
tjokroaminoto	tjokroaminoto	tjokroaminoto
tk	k	tk
tni	tni	indonesia national army
toba	鸟羽	toba
tobi	托比	tobi
tokek	壁虎	gekko
toko	商店	shop
tokoh	数字	figure
tokohtokoh	图	figures
tokotoko	杂货店	shops
tokyo	东京	tokyo
tol	收费	highway
tolak	下降	push
toleransi	公差	toleration
tom	汤姆	tom
tomat	番茄	tomato
tombak	矛	lance
tombol	纽扣	knob
tongkat	棒	stick
tongkol	棒子	cob
tongkonan	通科南	tongkonan
tonjolan	凸	bulge
tony	托尼	tony
top	最佳	top
topeng	面具	mask
topi	帽子	hat
topik	话题	topic
topografi	地形	topography
topologi	拓扑结构	topology
toraja	toraja	toraja
total	总	total
tour	游览	tour
tousen	us	tousen
tower	塔	tower
town	镇	town
trade	贸易	trade
tradisi	传统	tradition
tradisional	传统的	traditional
tragedi	悲剧	tragedy
trans	反式	trans
transaksi	交易	transaction
transduksi	转导	transduction
transfer	传递	transfer
transformasi	转型	transformation
transformator	变压器	transformer
transfusi	输血	transfusion
transisi	过渡	transition
transistor	晶体管	transistor
transkripsi	抄写	transcription
transmigrasi	轮回	transmigration
transmisi	传播	transmission
transmission	传播	transmission
transmutasi	mut变	transmutation
transparan	透明	transparent
transparansi	透明度	transparent
transparency	透明度	transparency
transplantasi	移植	transplantation
transpor	运输	transport
transportasi	运输	trasnsport
trauma	外伤	trauma
treatment	治疗	treatment
tren	趋势	trend
tri	三	tri
triangle	三角形	triangle
trigliserida	甘油三酸酯	triglyceride
triliun	兆	billion
trimurti	特里恩	trine
trio	三重奏	trio
trisakti	特里萨克蒂	trisakti
tristan	特里斯坦	tristan
triton	特里顿	triton
triwulan	季刊	quarterly
trofi	奖杯	trophy
tropik	热带	tropical
tropika	热带	tropical
tropis	热带	tropical
troposfer	对流层	troposphere
trowulan	特罗兰	trowulan
troya	特洛亚	trojan
tsunade	海啸	tsunade
tsunami	海啸	tsunami
tua	旧	old
tuak	棕榈酒	tuak
tuan	先生	master
tuanku	我的君主	my lord
tuanya	老人	his old
tuban	大号	[place name]
tuberkulosis	结核	tuberculosis
tubrukan	碰撞	collision
tubuh	身体	body
tubuhnya	他的身体	his/her body
tubulus	小管	tubulus
tuduhan	指控	accusation
tugas	义务	duty
tugasnya	他的任务	his/her duty
tugastugas	任务	assignments
tugu	纪念碑	obelisk
tuhan	神	god
tujuan	目的地	the purpose of
tujuannya	其目的	goal
tujuantujuan	目的	goals
tujuh	七	seven
tukang	勤杂工	handyman
tukar	交换	exchange rates
tulang	骨	bone
tulis	写下来	write
tulisan	写作	the writings of
tulisannya	他的写作	his writing
tulisantulisan	写作	writings
tulungagung	土伦贡	tulungagung
tumapel	图马佩尔	tumapel
tumbuh	增长	grow
tumbuhan	厂	plant
tumbuhnya	成长	growth
tumbuhtumbuhan	植被	plants
tumbukan	碰撞	collision
tumor	瘤	tumor
tumpang	交叠	ride
tumpukan	一堆	stack
tunas	芽	sprout
tunduk	学科	submit
tunggal	单	single
tunisia	突尼斯人	tunisia
tuntutan	需要	claim
tur	旅途	tour
turis	游客	tourist
turki	火鸡	turkey as the country
turnamen	比赛	tournament
turun	下	down
turunan	衍生物	derivative
turunnya	下降	his descent
turut	参加	take part
tutorial	教程	tutorial
tutup	盖	close
tuturan	言语	speech
tv	电视	tv
tvri	电视	tvri
twilight	暮	twilight
twitter	推特	twitter
u	ü	u
uang	钱	money
uap	蒸汽	steam
ubi	红薯	yam
ucapan	言语	utterance
uchiha	内叶	uchiha
udang	虾	shrimp
udara	空气	air
ue	ue	ue
uefa	uefa	uefa
ufo	飞碟	u.f.o
ufos	ufos	ufos
ugm	嗯	ugm
ui	ui	indonesia university
uji	测试	test
ujian	考试	test
ujung	结束	ujung
ujungnya	小费	ends
uk	英国	united kingdom
ukiran	雕刻	engraving
ukraina	乌克兰	ukraine
ukur	测量	measuring
ukuran	尺寸	size
ukurannya	它的大小	size
ulama	牧师	muslim scholar
ulang	重启	repeat
ular	蛇	snake
ultraviolet	紫外线	ultraviolet
ulu	ulu	ulu
umar	乌玛	[name]
umat	人	race
umayyah	乌马耶	umayyad
ummat	乌玛	believer
umpan	饵	bait
umrah	乌拉	a pilgrimate visit
umum	一般	public
umumnya	通常	generally
umur	年龄	age
un	联合国	un
undang	邀请	law
undangan	邀请函	invitation
undangundang	宪法	law
under	下	under
underground	地下	underground
unesco	联合国教科文组织	unesco
unggas	家禽	fowl
unggul	优越	superior
ungkapan	表达	quotes
ungu	紫色	purple
uni	uni	union
unicast	单播	unicast
unidentified	身份不明	unidentified
unik	独特	unique
union	联盟	union
unit	那个单位	unit
united	联合的	united
unitunit	单元	units
universal	普遍	universal
universe	宇宙	universe
universitas	大学	university
university	大学	university
unix	unix	unix
unjuk	炫耀	show
unsur	元件	element
unsurunsur	元素	elements
untuk	对于	to
untukmu	为了你	for you
untung	利润	profit
untungnya	幸好	fortunately
unus	us	unus
upacara	仪式	ceremony
upah	工资	wage
upaya	努力	effort
upayaupaya	努力	efforts in
update	更新	update
upeti	贡	tribute
urahara	浦原	urahara
uraian	描述	description
uranian	乌拉尼语	uranian
uranium	铀	uranium
uranus	天王星	uranus
urat	静脉	muscle
urin	尿	urine
url	网址	url
uruguay	乌拉圭	uruguay
ururu	乌鲁鲁	ururu
urusan	事务	affairs
urut	序列	ordered
urutan	订购	ranking
us	我们	united states
us$	美元 $	us$
usa	美国	united state of america
usaha	努力	businesses
usahanya	他的努力	action
usahausaha	商业	efforts
user	用户	user
usia	年龄	age
usianya	她的年龄	age
uskup	主教	bishop
usul	建议	origin
usulan	提案	proposal
usus	肠	intestine
ut	ut	ut
utama	主要	main
utamanya	主要的	main
utan	乌坦	forest
utang	债务	debt
utara	北	north
utas	线	thread
uteri	子宫	uteri
uterus	子宫	uterus
utilitas	实用程序	utilities
utomo	友友	utomo
utsman	乌兹曼	utsman
utuh	完整	intact
utusan	信使	envoy
uu	u	law
uud	ud	basic laws
uut	ut	uut
uzumaki	uzumaki	uzumaki
v	v	five
vagina	阴道	vagina
vaksin	疫苗	vaccine
vaksinasi	预防接种	vaccination
vakum	真空	vacuum
vakuola	空泡	vacuole
valensi	价	valence
valentine	情人	valentine
vampir	吸血鬼	vegetarian
van	货车	van
variabel	变量	variable
varian	变体	variant
variasi	变异	variation
varietas	品种	variety
vatikan	教廷	vatican
vba	vba	vba
vegetasi	植被	vegetation
vektor	向量	vector
venezuela	委内瑞拉	venezuela
venus	金星	venus
vereeniging	凝视	vereeniging (hindia)
versi	版	version
versiversi	维西	version
versus	与	versus
vertebrata	脊椎动物	vertebrate
vertikal	垂直	vertical
vesikel	囊泡	vesicles
vestimentum	遗迹	vestments
veteran	老将	veteran
vga	vga	vga
vi	六	enam
via	通过	via
video	影片	video
vietnam	越南文	vietnam
view	视图	view
vihara	修道院	monastery
vii	七	vii
viii	八	eight
vinci	芬奇	vinci
violin	小提琴	violin
viral	病毒式的	viral
virtual	虚拟	virtual
virus	病毒	virus
visi	愿景	vision
vista	远景	vista
visual	视觉的	visual
vital	重要	vital
vitamin	维他命	vitamin
vitro	体外	in vitro
voc	挥发性有机物	dutch east india company
voice	语音	voice
vokal	声乐	vocals
vokalis	歌手	vocalist
vol	卷	volume
voldemort	伏地魔	voldemort
voli	排球	volley
volksraad	大众汽车	volksraad
volume	体积	volume
von	冯	von
voyager	航海家	voyager
vs	与	versus
vulkanik	火山	vulcanic
w	w	w
wabah	瘟疫	plague
wacana	话语	discourse
wadah	容器	container
waduk	水库	dam
wafat	死了	died
wafatnya	他的过世	death
wahana	车辆	the spacecraft
wahid	顶尖	single
wahyu	启示	revelation
wajah	面对	looks
wajahnya	他的脸	his/her face
wajar	合理的	reasonable
wajib	需要	obliged (required)
wajik	钻石	diamond
wajo	哇	wajo
wakil	副	vice
wakilwakil	副代表	representatives
waktu	时间	time
waktunya	截至日期	the time
walau	虽然	although
walaupun	虽然	although
wales	威尔士	wales
wali	监护人	guardian
walikota	市长	mayor
walisongo	瓦利桑加	walisongo
walk	步行	walk
wall	壁	wall
wallace	华莱士	wallace
wallacea	华莱士	the wallacea
walter	沃尔特	walter
wan	wan	wan
wangsa	屋	wangsa
wangsakerta	受访者	wangsakerta
wanita	女人	woman
war	战争	war
warga	公民	residents
warisan	遗产	legacy
warna	颜色	color
warnanya	颜色	its color
warnawarna	彩色	colors
warok	瓦罗克	warok
wartawan	记者	journalist
waru	u	waru
warung	店	tavern
was	原为	was
washington	华盛顿	washington
wasit	裁判	referee
wat	at	wat
watson	沃森	watson
wawancara	面试	interview
wawasan	洞察力	insight
way	道路	way
wayang	木偶	puppet
wealth	财富	wealth
weasley	韦斯莱	weasley
weber	韦伯	weber
website	网站	website
weda	威达	vedas
wedang	文当	drink (javanese word)
weekly	每周	weekly
wereng	飞虱	plant hopper
west	西方	west
western	西	western
wewenang	权威	the authority
wewenangnya	他的权威	its authority
what	什么	what
which	哪一个	which
who	who	who
widya	维迪亚	widya
wifi	无线上网	wi-fi
wijaya	维贾亚	victory
wiki	维基	wiki
wikimedia	维基媒体	wikimedia
wikipedia	维基百科	wikipedia
wikramawardhana	wikramawardhana	wikramawardhana
wilayah	该区域	region
wilayahnya	其领土	its region
wilayahwilayah	地区	regions
wilhelm	威廉	wilhelm
william	威廉	william
wilson	威尔逊	wilson
wimax	wimax	wimax
wina	淑女	wina
window	窗口	window
windows	视窗	windows
winkler	温克勒	winkler
wirabhumi	威拉布米	wirabhumi
wiracarita	震中	epic
wiranto	维兰托	wiranto
wisata	游览	tour
wisatawan	旅客	tourist
wishnu	毗湿奴	wishnu
wisnu	毗湿奴	visnu
with	与	sama
wong	哇	wong
works	作品	works
world	世界	world
worlds	世界	worlds
wright	赖特	wright
writer	作家	writer
wujud	形成	appearance
wujudnya	它的形式	his form
wuruk	乌鲁克	wuruk
www	万维网	www
x	x	x
xaverius	xaverius	xaverius
xi	xi	eleven
xml	xml文件	xml
xp	p	xp
xvi	十六	xvi
xx	xx	twenty
xxi	xi	xxi
y	ÿ	y
ya	是	ya
yagami	八神	yagami
yahoo	雅虎	yahoo
yahudi	犹太人	jewish
yahweh	耶和华	yahweh
yahya	是的	yahya
yaitu	那是	that is
yakin	当然	believe
yakni	那是	that is
yamaha	雅马哈	yamaha
yaman	也门	yaman
yamato	大和	yamato
yamin	雅敏	yamin
yang	那	the
yani	亚妮	yani
yanti	扬蒂	yanti
yatim	孤儿	vatim
yayasan	基础	foundation
yazid	亚兹德	yazid
year	年	year
yerusalem	耶路撒冷	jerusalem
yesus	耶稣	jesus
yg	杨	which
yogyakarta	日惹	yogyakarta
yohanes	约翰	yohanes
yondaime	音韵	yondaime
yordania	约旦	jordan
york	约克	york
yoruichi	悠一	yoruichi
you	您	you
youtube	youtube	youtube
yudhoyono	尤多约诺	yudhoyono
yudistira	尤迪斯蒂拉	yudistira
yugoslavia	南斯拉夫	yugoslavia
yunani	希腊	greek
yupiter	木星	jupiter
yusuf	优素福	yusuf
yuzu	柚子	yuzu
z	ž	z
zainal	zainal	zainal
zakat	扎卡特	charity
zaman	时代	era
zambia	赞比亚	zambia
zat	物质	substance
zatzat	物质	materials
zea	玉米	zea
zetsu	tsu	zetsu
zeus	宙斯	zeus
ziarah	朝圣	pilgrimage
zimbabwe	津巴布韦	zimbabwe
zodiak	生肖	zodiac
zona	区域	zone
zone	区	zone
zoologi	动物学	zoology
zuckerberg	扎克伯格	zuckerberg
zurnali	祖纳利	zurnali
 k	ķ	k
 km	公里	kilometer
 °c	°c	°c
 ×  km	×公里	x km
±	±	more or less
×	×	x
ƒ	ƒ	ƒ
ω	ω	majuscule
→	→	become
