+	+	plus sign
=	=	equal to
 °ซ  °ฟ 	° c ° f	เซลเซียส ฟาเรนไฮต์
 ซม	см	cm.
 −°ซ  °ฟ	- ° c ° f	thai letters
×	×	letter x
γ	γ	y
π	π	pi
กกกก	килограма	a thai letter repeated 4 times
กกกข	хор хор	4 thai alphabets - jibberish
กขขข	abc b	4 of thai letters
กขขขขขขข	a b a b b a b	abbbbbbb
กฎ	правило	law, rule
กฎของโคไซน์	закон за косинусите	law of cosines
กฎแห่งกรรม	карма	bad karma
กติกา	правилник	rule
กทม	банкок	agency
กนู	рицар	gnu - computer related acronym
กบ	жаба	frog
กบฏทหารนอกราชการ	военно въстание	coup de lat
กมล	лилия	kamon
กมลรัตน์	kamonrat	kamolrat - a surname
กรณีที่	случаят	case
กรมขุนอิศเรศรังสรรค์	кром хун исет рангсан	the convention of angels
กรมขุนเพ็ชรบูรณ์อินทราชัย	kromkhunpetchaboon-indachai	department of....
กรมข่าวทหารอากาศ	департамент на ввс news	communication department of the thai air force
กรมควบคุมโรค	отдел за контрол на заболяванията	department of disease control
กรมทหารราบที่	пехотен полк	infantry regiment
กรมรบพิเศษที่	отдел „специални сили“	special force group
กรมศิลปากร	катедра по изобразително изкуство	fine arts department
กรมหลวงนราธิวาสราชนครินทร์	krom luang narathiwatratchanakharin	krom ma loung naratifatrachanakarin - the name of a royal family member
กรมหลวงสงขลานครินทร์	kromluang songkhla nakarin	prince of songkla
กรมอุตุนิยมวิทยา	метеорологичен отдел	the meteorology department
กรรชัย	kanchai	kanchai
กรอง	филтър	screen
กระดูกค้อน	чукова кост	malleus, hammer bone
กระดูกต้นแขน	раменна кост	humerus
กระดูกฝ่ามือ	palms	metacapus
กระดูกสะบัก	скапула	scapula
กระดูกสะบ้า	патела	kneecap
กระทรวงกลาโหม	министерство на отбраната	defense ministry
กระทรวงการคลัง	министерство на финансите	ministry of finance
กระทรวงการต่างประเทศ	министерство на външните работи	ministry of foreign affairs
กระทรวงวัฒนธรรม	министерство на културата	ministry of culture
กระทรวงศึกษาธิการ	министерство на образованието	ministry of education
กระทรวงสาธารณสุข	министерство на общественото здраве	ministry of public health
กระทรวงอุตสาหกรรม	министерство на промишлеността	ministry of industry
กระทรวงเกษตรและสหกรณ์	министерство на земеделието и кооперациите	ministry of agriculture and cooperatives
กระทรวงเศรษฐการ	министерство на икономическите въпроси	ministry of commerce
กระทุ่มแบน	малка кошница	krathum baen district, samut songkram province
กระนวน	игрище	granuan - location in knon kan province
กระนั้น	въпреки това	however
กระบวนการสร้าง	процес на изграждане	anabolism
กระบวนการสร้างและสลาย	процес на създаване и разпадане	metabolism
กระบอง	пиратско знаме	club
กระบะทราย	кутия с пясък	litter box or sand box
กระบี่กระบอง	състезание с мечове	krabi krabong (swordplay)
กระรอก	катерица	squirrel
กระวนกระวาย	разтревожен, неспокоен	nervous
กระหม่อม	глава	fontanelle
กระเพาะอาหาร	стомах	stomach
กระแต	североамериканска катерица	wasp
กรับ	вдигни	wooden rhythm clappers
กรับพวง	изберете един куп	krap phuang
กรับเสภา	krapao	wooden rhythm clappers
กรัม	грам	gram
กรัยวิเชียร	kraiwichian	krivician - a surname
กรานาดา	гранада	granada
กริม	grimm	grim
กรี	сив	karee
กรุง	капитал	city
กรุงธนบุรี	тон бури	thonburi city
กรุงลอนดอน	лондон	london
กรุงศรีอยุธยา	аютая	sri ayuttaya city - former capital of thailand
กรุงเทพ	банкок	bangkok
กรุงเทพเชียงใหม่กรุงเทพ	банкок, чианг май, бангкок	bangkok changmai bangkok
กรุงเทพโพลล์	анкета в банкок	bangkok poll
กรุ๊ป	група	group
กลอง	барабан	drum
กลองมโหระทึก	голям барабан	big drum
กลองยาว	drum	tom-tom
กลองสองหน้า	двулицев барабан	glong songna
กลอน	стих	poem
กลอบูลิน	лъскав	globulin
กลาง	среден	in the middle
กลิ่น	мирис	odor
กลุ่มดาวกล้องจุลทรรศน์	съзвездия от микроскопи	microscopium
กลุ่มดาวนกทูแคน	тукан	tucana
กลุ่มดาวสิ่ว	длето	siu star
กลุ่มดาวเข็มทิศ	компас на съзвездието	pyxis constellation
กลุ่มดาวเตาหลอม	доменна пещ	fornax
กลุ่มดาวแมงป่อง	скорпион	scorpion constellation
กลุ่มดาวแมลงวัน	мухите	musca
กลุ่มที่	групата	group
กลุ่มแสงอุษา	usa light group	light at dawn
กลูคากอน	glucon	glucagon
กล่าวคือ	това ще рече	that is
กล้วยไม้ดาว	звездна орхидея	type of orchid that have slim petal like star
กล้องถ่ายภาพ	камера	camera
กล้ามเนื้อ	мускул	muscle
กวม	гуам	obscure
กวาง	елен	deer
กวิน	kawin	gwen - a name
กวี	поет	poet
กว่า	от	than
กองกลาง	полузащитникът	headquarter
กองการบินทหารเรือ	военноморска авиационна дивизия	the flying section of the navy
กองการศึกษา	отдел „образование“	education group
กองการเจ้าหน้าที่	отдел на персонала	division of personnel
กองกำลังกึ่งทหาร	полувоенни сили	armforces
กองคลัง	отдел „финанси“	division of finance
กองทัพ	армията	arm forces
กองทัพบกไทย	тайландска армия	thai army
กองทัพภาคที่	армия на региона	army area
กองทัพเรือ	военноморски флот	navy
กองทัพเรือไทย	тайландски флот	the royal thai navy
กองทัพแห่งความชอบธรรม	армия на правдата	army of the righteous
กองทัพไทย	тайландска армия	thai military forces
กองบิน	въздушни сили	air force
กองบินปีกหมุนที่	крило спининг	flight corp number __________
กองพลทหารม้าที่	кавалерийската бригада	cavalry division
กองพันทหารช่างที่	инженерната бригада	troop unit number ___________`
กอด	прегръдка	kord
กอนซาเลซ	гонзалес	gonzales - a name
กอร์ดอน	гордън	gordon
กอลมเบต์	гореме	glombet - a catholic priest
กอล์ฟ	голф	golf
กอล์ฟไมค์	голф микрофон	golf-mike
กะเหรี่ยง	карън	karen
กะโหลก	череп	skull
กะโหลกศีรษะ	череп	skull; cranium
กังหันชัยพัฒนา	турбина чайпатана	chaipattana's windmill
กันดั้ม	gundam	gundam - a cartoon
กันตัง	кантанг	kuntun in trung state
กันทรลักษ์	kantharalak	kuntaraluk - an area in thailand
กันฟอร์ม	форма	gun form
กันอริ	kanori	gan-ari
กันเอง	по взаимно съгласие	casual
กับนางสุจาริณี	с г-жа sucharinee	with mrs. sujarinee
กัมปูเชีย	kampuchia	kampuchea
กัมพูชา	камбоджа	cambodia
กัมพูชาประชาธิปไตย	демократична камбоджа	democratic kampuchea
กัมพูชาเป็นประเทศที่มีป่าไม้อุดมสมบูรณ์มากที่สุดหากเปรียบเทียบกับประเทศเพื่อนบ้าน	камбоджа е страната с най-изобилни гори в сравнение със съседните страни.	cambodia is the country with nice, healthy forests
กัมพูชาเป็นอดีตประเทศอาณานิคมของฝรั่งเศสในภูมิภาคเอเชียตะวันออกเฉียงใต้เพียงแค่ประเทศเดียวเท่านั้นที่มีการปกครองด้วยระบอบราชาธิปไตยภายใต้รัฐธรรมนูญ	камбоджа е единствената бивша френска колониална държава в югоизточна азия, която има монархия съгласно конституцията.	cambodia was a former french colony
กัมพูชาเป็นอาณานิคมของฝรั่งเศสมาตั้งแต่พศ	камбоджа е френска колония оттогава.	cambodia was a france colony from year
กัวเตมาลา	гватемала	guatemala
กานซู	гансу	honshu in china
กานต์	кан	kan
กานา	гана	ghana
กานามัยซิน	канамицин	kanamycin
กาบอง	габон	baton
กาพย์ฉบัง	епично стихотворение	poem
กาพย์สุรางคนางค์	стихотворение	gabsuranknang
กาม	разпуснат	lust
กาย	тяло	body
การ	най-	project
การกีฬา	спортен	sport
การขัดเกลาทางสังคม	социализация	socialization
การขับถ่าย	отделяне	excretion
การขับไล่	изгонване	discharge
การคมนาคม	транспорт	transportation department
การคลัง	финанси	public finance
การค้นพบ	откритието	discover
การค้า	търговията	marketing
การจัดการ	управлението	project
การจัดการคุณภาพ	управление на качеството	quality control
การจัดอันดับ	класиране	ranking
การจัดให้มี	осигуряване	putting together something
การจูบ	целувка	kissing
การชัก	конфискация	the act of pulling the flag wiht string up the pole
การดำเนินการ	операция	progression
การตอบรับ	обратна връзка	welcoming
การตั้งถิ่นฐาน	селище	start a project
การต่างประเทศ	външни работи	foreign affairs
การทำงานของ	работата на	function
การทำป่าไม้	горско стопанство	forestry
การท่องเที่ยว	туризъм	tourism
การท่าเรือ	пристанищен орган	port authority
การบริการ	обслужване	customer service
การบริหารการพัฒนา	управление на развитието	development
การบริหารการศึกษา	образователна администрация	educational administration
การบริหารจัดการ	управление	management
การบริหารราชการแผ่นดิน	държавна администрация	administration
การบินไทย	thai airways	thai airways
การปกครองท้องถิ่น	местно управление	local administration
การปกครองส่วนท้องถิ่น	местно управление	local government
การปกครองแบ่งออกเป็น	правилото е разделено на	administration
การปฏิรูประบบจัดเก็บภาษีเงินได้	реформа на системата за събиране на данък върху дохода	taxation reform
การปฏิรูปศาสนา	реформация	religious reformation
การปฏิวัติฝรั่งเศส	френската революция	french revolution
การปฏิวัติอุตสาหกรรม	индустриална революция	industrial revolution
การปฏิสนธิ	оплождане	fertilisation
การประมง	в областта на рибарството	fishery
การพัฒนา	развитието	development
การพัฒนาประชาธิปไตย	демократично развитие	democratic development
การพูด	говорещ	speaking
การยึดครองมะละกาของโปรตุเกสในปี	португалската окупация на мелака през годината	portugal took over malaga
การระบาดของไข้หวัดใหญ่สายพันธุ์ใหม่	новият щам на грипа	flu pandemic
การรักษาพยาบาล	медицинско лечение	nursing care
การร่วมเพศทางทวารหนัก	анално чукане	sodomy
การลดรูป	деформирайки	reduction
การละเล่นพื้นบ้าน	народни игри	local game
การวิจัย	изследване	researching
การวิเคราะห์	анализът	analysis
การศึกษา	образованието	study of, education
การสังคายนาครั้งที่	последната поръчка	the event of convention of monks
การสั่นพ้อง	резонанс	resonance
การสำเร็จความใคร่ด้วยตนเอง	онанизъм	masturbation
การสืบพันธุ์	репродукция	reproduction
การสื่อสาร	общуване	communications
การาจ	гараж	garage
การุณ	карун	karoon
การเต้นรำ	танцът	dance
การเพิ่มสิทธิประโยชน์แก่นักลงทุนต่างประเทศ	увеличаване на привилегиите за чуждестранните инвеститори	increase benefits for foreign investors
การเล่น	да играя	play
การแข่งขัน	състезанието	competition
การแบ่งพื้นที่	дял	land division
การใช้คำ	използване на word	terminology
การไฟฟ้าส่วนภูมิภาค	провинциален орган за електричество	distribution electric transformer
การไหว้	отношение	thai greeting
การ์ด	карта	guard
กาฬสินธุ์	каласин	katsin - a thai surname
กาเวน	гауейн	gawain
กาเหว่าที่บางเพลง	гарванът на някои песни	the cuckoo's song.
กำกับการแสดงโดย	режисиран от	produced by (movie)
กำกับโดยอภิชาติพงศ์	режисьор е aphichat pong	produced by apichartpong - a famous thai movie producer
กำมะถัน	сяра	sulfur
กำลังจะปรับเปลี่ยนเป็น	ще преминете към	is changing to
กำหนดตามสภาพภูมิศาสตร์	определя се от география	geography estimation
กำแพงเพชร	kamphaeng phet	kamphaeng phet
กำแพงเมืองจีน	великата стена	the great wall of china
กำแพงแสน	kamphaengsaen	kampangsaen (name of district)
กิจผลิต	производство	kitpalit (last name)
กิมป์	gimb	gimp - gnu image manipulation program
กิโลกรัม	килограма	kilogram
กิโลไบต์	kb	kilobyte
กิ่งแก้ว	kingkaew	kingkaeo
กิ้งกือ	стоножка	millipedes
กิ๊ก	kik	gig
กีฏวิทยา	ентомология	entomology
กีฬา	спорт	sports
กีฬาทางน้ำ	водни спортове	water sports
กีฬาแหลมทอง	laem thong sport	seap games
กุดจับ	мухъл	good jub - a place
กุลดิลก	kuldilok	kuldilok
กุลละวณิชย์	kulalawanit	kullawanich
กุหลาบ	роза	kularb (first name)
กุ้ง	скарида	shrimp
กุ้งต้ม	варени скариди	boiled shrimp
กูเกิล	google	google
ก็คือ	е	which is
ก็ใช้เป็น	използван като	utilize
ก่อตั้ง	основан	founded
ก่อตั้งโดย	основан от	make by
ก่อนที่	преди	before
ก่อนที่จะตกเป็นของฝรั่งเศสในเวลาต่อมา	преди да стане франция по-късно	belonging to france, under the control of france
ก่อนหน้านั้น	преди това	before
ก้อย	кутре	koi
ก้าน	стъбло	thorn
ก้านกล้วย	бананово стръкче	kankluai
ก๊าซธรรมชาติ	природен газ	natural gas
ก๎ล	подарък	magic
ขขขขขขขขขข	b b b b b b b	repeated letter from thai alphabet
ขณะทรงพระเยาว์	докато беше млад	having to do with the young prince or princess
ขณะที่	докато	while
ขนม	бонбони	dessert
ขนมกล้วย	банан	banana dessert
ขนมครก	knmcrk	kind of thai sweetmeat
ขนมปัง	хляб	bread
ขนมปังขิง	натруфен	gingerbread
ขนมเปียกปูน	ромб	a type of thai dessert with flour and sugar
ขนมไทย	тайландски десерт	thai dessert
ขนสัตว์	вълна	fur, animal hair
ขนอม	khanom	kanom - location in thailand
ขนาดหน้าตัก	размер на обиколката	length between both knees of buddha statue in posture of meditation
ขนาดใหญ่	голям размер	l
ขบวนการอ๊บอ๊บป่วนโลก	движението на земята	original name is keroro gunso
ขบวนรถสินค้า	влак	caravan of trucks
ขม	горчив	bitter taste
ขรรค์ชัย	хан чай	kanchai - a male's name
ขลุ่ยหลิบ	флейта	khlui lib
ขวด	бутилка	bottle
ขวัญ	дух	morale
ขวัญใจช่างภาพ	любим фотограф	miss photogenic
ขสมก	маса	an acronym consists of four thai letters
ของ	на	of
ของทุกปี	всяка година	every year
ของประเทศจีน	от китай	owned by china
ของมหาวิทยาลัย	от университета	of university
ของมัน	негов	their
ของร่างกาย	от тяло	of the body
ของสมเด็จฮุน	от сомдей хун	houssaine of cambodia
ของสิ่งมีชีวิต	от живи същества	living things
ของสุนทรภู่	от sunthorn phu	belong to soon thong pu (a thai legend)
ของเหลว	течност	liquid
ของโลก	на света	of world
ขอนแก่น	кхон каен	khon kan - an area in thailand
ขอบคุณที่รักกัน	благодаря ти, че ме обичаш	thank you for loving each other
ขอเช็ดน้ำตา	нека заличим сълзите	wipe the tears
ขอให้เด็กสมัยปฏิวัติของข้าพเจ้า	дано моите революционни деца	i hope that the children in my lifetime will ____________
ขั้นที่	стъпка	level
ขา	крак	leg
ขาย	продажба	sell
ขิง	джинджифил	ginger
ขิม	гайдата	kim - a thai musical instrument
ขีดเส้นใต้	подчертан	underline
ขี้ผึ้ง	восък	wax
ขึ้นเป็น	до	to
ขึ้นไป	нагоре	next one up
ขุขันธิน	хан тин	kukuntin
ขุนหาญ	хан	koonhan - a location in thailand
ข้อมูลทั่วไป	главна информация	general information
ข้อมูลประเทศเดนมาร์ก	дания информация	information on denmark
ข้อมูลปรากฏการณ์โลกร้อน	феномен на глобалното затопляне	global climate change
ข้อมูลปี	данни за годината	information from the year ________
ข้อมูลอื่นๆ	друга информация	other information
ข้อมูลโดย	данни от	information from
ข้อวิพากษ์วิจารณ์	критика	critique reports
ข้ามฉาก	отвъд сцената	sin(a)
ข้าวสาลี	пшеница	wheat
ข้าวหลาม	хао лам	bamboo rice
ข้าวเกรียบปากหม้อ	оризови бисквити	a thai snack
ข้าวเจ้า	оризище	white rice
ข้าวโพด	царевица	corn
ข้าหลวงกำกับราชการเมืองขุขันธ์คนที่	губернатор, губернатор на град хухан	government worker for ku khan city
ฃ	ฃ	a letter from thai alphabet
คงยิ่ง	много вероятно	kongying
คงเจริญ	вероятно просперира	khongcharoen
คณะครุศาสตร์	педагогически факултет	education department
คณะครุศาสตร์อุตสาหกรรม	факултет по индустриално образование	faculty of industrial education
คณะที่	факултет в	the current administration
คณะบัญชี	факултет по счетоводство	accounting department (major)
คณะปฏิรูปการปกครองแผ่นดิน	революционен комитет	national administrative reform council
คณะประมง	факултет по рибарство	fishery division of the college of farming and agriculture
คณะพยาบาลศาสตร์	факултет по медицинска сестра	nursing department
คณะมนุษย์ศาสตร์และสังคมศาสตร์	факултет по хуманитарни и социални науки	humanity department
คณะรัฐมนตรีคณะที่	шкаф	council of ministers
คณะวิทยาการจัดการ	факултет по наука за управление	management department
คณะวิศวกรรมศาสตร์	инженерен факултет	engineering department
คณะศิลปกรรมศาสตร์	факултет за изящни изкуства	faculty of fine arts
คณะสถาปัตยกรรมศาสตร์	архитектурен факултет	faculty of architecture
คณะสหเวชศาสตร์	факултет по съюзни здравни науки	อังกฤษ   faculty of allied health science
คณะสาธารณสุขศาสตร์	факултет по обществено здраве	faculty of public health
คณะเกษตร	селскостопански факултет	faculty of agriculture
คณะแพทยศาสตร์ศิริราชพยาบาล	медицински факултет мбал сирирай	faculty of medicine siriraj hospital
คณะแพทยศาสตร์โรงพยาบาลรามาธิบดี	медицински факултет, болница раматибоди	the staff of ramatippadee hospital
คณารศ	канара	kanaros - a surname
คนที่	човекът, който	person number __________________________
คนที่ไปช่วยรุ่นที่	хората, които помогнаха на поколението	volunteer group number __________
คนแคระ	джудже	dwarf
คนแรก	първият човек	first
คปค	година	3 thai letters
คม	остър	sharp
ครอคโคไดล์	крокодил	crocodile
ครอบครัว	семейство	family
ครั้งหนึ่ง	един път	once upon a time
คราประยูร	prayun	karaprayoon - a thai surname
คราม	индиго	indigo
คริส	крис	christ
คริสตี	кристи	christie - a female name
คริสต์ศาสนา	християнство	christainity
ครุฑ	garuda	garuda
ครู	учител	teacher
ครูพิเศษจอมป่วน	учител по тролове	kru pisat jom poun  - name of a story
คลอง	канал	canal
คลองสาน	хлонг сан	klongsan
คลองเตย	khlong toei	klongtoei
คลับ	клуб	club
คลาวิคอร์ด	клас	clavichord
คลิก	кликване	click
คลินิก	клиника	clinic
คลิป	клипс	clip
คลื่นสึนามิ	цунами	tsunami wave
ควอน	куон	kwon - a surname of a korean singer
ควอร์เตอร์	тримесечие	quarter
ความกว้าง	широчина	width
ความงาม	красотата	beauty
ความจำ	паметта	memory
ความต่างศักย์	потенциална разлика	potential difference in physics
ความถี่	честота	frequencies
ความนิยม	популярност	popular
ความบริสุทธิ์	чистота	purity
ความฝันอันสูงสุด	крайната мечта	the impossible dream
ความพอประมาณ	скромност	estimate
ความยากจน	бедност	poverty
ความยาว	дължината	length
ความยาวคลื่น	дължина на вълната	frequencies
ความยาวช่วงคลื่น	дължина на вълната	wave length
ความยาวเพลง	дължина на песента	the length of the song
ความรัก	любов	love
ความรู้	знанието	knowledge
ความสว่าง	яркост	illumination
ความสัมพันธ์กับประเทศไทย	отношения с тайланд	relationship with thailand
ความสัมพันธ์ระหว่างจีนกับอเมริกา	отношенията между китай и америка	relationship with china and the usa
ความสูง	височината	height
ความส่องสว่าง	яркост	luminance
ความหนาแน่นของประชากร	гъстота на населението	population density
ความหมาย	смисъла	meaning
ความหมายโดยพยัญชนะ	съгласен смисъл	definition that derived from translation from another language
ความเข้มของการส่องสว่าง	светлинен интензитет	luminous intensity
ความเข้าใจ	разбиране	understanding
ความเร่ง	ускорение	acceleration
ความโกรธ	гняв	anger
ความโน้มถ่วง	гравитация	gravity
ควินโต	куинто	quinto
ควีนซี่	кралица	quincy
คอ	врат	neck
คอนสตรัคชั่น	строителство	construction
คอนเวนชัน	конвенции	convention
คอนเสิร์ตประสานเสียงสามสถาบัน	концерт за хор на три института	chulalongkorn kasetsart thammasat choral concert
คอมพิวเตอร์ยุคที่	компютърна ера	_-generation computer (as in frist generation, second generation etc)
คอร์ด	акорд	chord
คอลลิงวูด	callingwood	collingwood
คอสตาริกา	коста рика	costa rica
คัง	kang	kan
คัชชินสกี	kutchinski	kaczyński
คัญทัพ	важна армия	main army.
คัทลียา	cattleya	kathaleeya (thai first name)
คันธวงศ์	kanthavong	kunntavong - a surname
คัพ	чаша	cup
คัมภีร์	библията	bible
คั่ว	печено	dry roasting
คาคาชิ	kakashi	cacashi
คางาริ	kagari	kagari
คาซัคสถาน	казахстан	kazakhstan
คาถาอัญเชิญ	заклинание	a magic spell
คาบ	период	frequency
คาบัคโรเน่	kabakhroone	kyabarrone
คาบูโตะ	kabuto	kabuto
คาปูชิโน่	капучино	cappuccino
คามิว	камуи	camus
คาราคุระ	karakura	karakura
คาร์ล	carl	karl
คาวทอง	fishyong	lizard tail
คาเมนไรเดอร์	камен конник	kamen rider
คาโรลัส	carolas	carolus linnaeus
คำขวัญวันเด็ก	слоганът за деня на детето	quote for kids day
คำถามข้อที่	въпрос номер	the question number_________
คำนวณ	изчисли	calculate
คำนาม	съществително	noun
คำพ้องรูป	синоними	hemonym
คำมั่นสัญญา	обещание	agreement
คำม่วง	хам муанг	kham muang
คำวิลัยศักดิ์	kamwilaisak	important words, magic words
คำศัพท์	лексика	word
คำสรรพนาม	местоимение	pronoun
คำสร้อย	дума	kumsoi - a country singer
คำสุดท้ายของวรรคที่	последната дума на параграфа	the last word (in a poem)
คำสุภาพ	учтива дума	formal
คำอธิบาย	описание	explanation
คำเมือง	градска дума	kum meuong - a location in chiang mai
คำแปล	превод	translation
คิง	цар	king
คิงส์	kings	kings
คิงส์คัพ	купа на краля	king's cup
คิงไลเนอร์	kingliner	kingliner
คิชิเนีย	kishinya	kishinia
คิด	мисля	thinking
คินนิคุแมน	kinnikuman	kinkiku man
คิมิฮิโระ	kimihiro	kimihiro
คิระ	кира	kira - japanese name
คิเคียว	kikyo	kikyo
คีตกวี	композитор	composer
คือประมาณ	е за	estimated to be
คือเพลง	песен ли е	is the song
คุณ	вие	you
คุณครูจอมเวท	учителят на магьосниците	magister
คุณปลื้ม	хун плуем	kunpleam
คุณหญิงโม	императрица мо	suranaree
คุณากร	вие	khunakon
คุราปิก้า	kurapika	kurapika
คุโรซึจิ	kurotsuji	kurochiji - a japanese word
คุ้มค่า	добра цена	worth the money spent on
คูกิมิยะ	kukimiya	kugimiya
คูคาคุ	куку	kukaku (japanese last name)
คูเรียม	curium	"chemical element ""curium"""
คูเวต	кувейт	kuwait
คู่กรรม	партньор	soul mate
ค่าความต้านทานตัวที่	стойността на съпротивлението, което	resistance value of the
ค่าจีดีพี	брутен вътрешен продукт	gdp - an economics term
ค่าใช้จ่าย	разходите	expense
ค่ำแล้ว	здрач	getting dark, at dusk
ค้างคาว	бухалка	bat
ฆ	хуан	a letter from thai alphabet
ฆ้อง	гонг	gong
ฆ้องวงใหญ่	голям гонг	a group of thai drum music
งดส่งเข้าประกวด	не е вход	enroll in the contest
งาน	работа	work, job
งานอดิเรก	хоби	hobby
งานเขียน	писания	writing, composition work
งานเทางามสัมพันธ์	връзка с дао нгам	public party
งานโมเสก	мозайка	mosaic
งามวงศ์วาน	нгамуонгуан	ngamwongwan
งู	змия	snake
งูอนาคอนดา	анаконда	anaconda snake
จดหมายอากาศ	въздушна поща	aerogram
จตรัง	транг	trang province (name of province in thailand)
จตุรงค์	chatuchak	jaturong - a surname of a comedian
จนกระทั่ง	до	until
จนกระทั่งปี	до годината	until the year
จนกระทั่งเมื่อปี	до миналата година	until the year
จนครปฐม	nakhon pathom	nakorn pratom state
จนมีคำกล่าวว่า	докато не беше казано това	said
จน่าน	mon	nan state
จบุรีรัมย์	buriram	burerum state
จมูก	нос	nose
จระเข้และแอลลิเกเตอร์	крокодил и алигатор	crocodile and alligator
จรัญญา	charanya	jarunya - a surname
จริยธรรม	етика	ethics
จริยศาสตร์	етика	ethics
จริยา	дама	jariya
จลำพูน	ламфун	jalumpoon - a place in thailand
จสตูล	сатун	stoul state
จสุราษฎร์ธานี	сурат тани	surat thani province
จอมบึง	подут	chom bueng
จอมพลถนอม	chom phon thanom	field marshal thanom
จอมพลสฤษดิ์	фелдмаршал сарит	field marshal sarit
จอมพลเรือ	корабен маршал	the general of the navy
จอมเทียน	jomtien	jom tien - a location in thailand
จอร์เจีย	грузия	georgia
จะต้องหาตัวแทนลงจากเวที	трябва да намерите представител, който да слезе от сцената	find a teammate to leave the stage, a unique game
จะเขียนว่า	ще каже	written as
จะเข้	цитра	jakhe
จะได้	ще вземе	results in
จักจั่น	цикада	chakkachan
จักรพรรดิเนอร์วา	император нирвана	emperor nerva
จักรพรรดิไททัส	император тит	titus (flavius vespa)
จักรพันธุ์	chakphan	chakrabhand
จักรวาลวิทยา	космология	cosmology
จังหวัด	провинция	province
จังหวัดกระบี่	провинция краби	krabee state
จังหวัดกาญจนบุรี	канчанабури	kanchanaburi province
จังหวัดกาฬสินธุ์	каласин	kalasin province
จังหวัดขอนแก่น	провинция хон каен	khon kaen province
จังหวัดคยองกี	провинция кьонги	the state of kyong gee
จังหวัดคยองซาง	провинция кьонсанг	kyongchang province
จังหวัดฉะเชิงเทรา	chachoengsao	chachoengsao province
จังหวัดชุมพร	chumphon	chumphon province
จังหวัดตราด	провинция трат	trat province
จังหวัดตาก	провинция так	tak province
จังหวัดนครปฐม	провинция накхон патом	nakhon pathom province
จังหวัดนครพนม	провинция накхон фаном	nakorn panom state
จังหวัดนครสวรรค์	провинция накхон саван	nakorn sawan province in thailand
จังหวัดน่าน	провинция нан	nan state in the north east of thailand
จังหวัดปัตตานี	провинция патани	pattani state
จังหวัดพระนครศรีอยุธยา	phra nakhon si ayutthaya	nakon sri ahyutthaya province
จังหวัดพังงา	провинция фанг нга	phang nga province
จังหวัดพิษณุโลก	провинция фитсанулок	pisanulok state
จังหวัดมหาสารคาม	провинция маха саракам	maha sarakham province
จังหวัดยโสธร	ясотон	yasothorn province (name of thai province)
จังหวัดระยอง	районг	rayong province
จังหวัดราชบุรี	ratchaburi	ratchaburi province
จังหวัดลำพูน	ламфун	lamphun province
จังหวัดสงขลา	songkhla	songkla province
จังหวัดสมุทรสงคราม	провинция самут сонгкрам	samut songkhram province
จังหวัดสิงห์บุรี	провинция синг бури	sing buri province
จังหวัดหนองบัวลำภู	провинция нонг буа ламфу	nong bua lamphu province
จังหวัดอุดรธานี	провинция удон тани	udon thani state
จังหวัดเชลลา	shella	chella city
จังหวัดเชียงราย	чианг рай	chianrai province
จังหวัดเชียงใหม่	провинция чианг май	chiang mai province
จังหวัดเพชรบุรี	провинция петчабури	petcharaburi state
จังหวัดเพชรบูรณ์	петчабун	petchabun province
จังหวัดเลย	провинция лоей	loei (name of thai province)
จังหวัดแพร่	phrae	prae state
จังหาร	junghan	changhan
จัดขึ้นเมื่อ	проведена на	occur on the date of _______________
จัดตั้งขึ้นโดย	създаден от	produced by
จัดอยู่ในภูมิภาค	организирани в региона	in region
จัดเมื่อวันที่	проведена на	็held on the date of ...
จัดโดย	подредени от	arrange by
จัน	чан	chan
จันทบุรี	chanthaburi	juntaburi state
จันทร	луна	chantorn
จันทรุปราคา	лунно затъмнение	lunar eclipse
จันทร์	понеделник	chan
จันทร์ภักดี	чан факди	juntapukdee - surname of a famous actor
จันทร์เกษ	чан кет	juntagaset - a surname
จาก	от	from
จากการพิสูจน์อายุโดยคาร์บอน	от доказателството за възрастта чрез въглерод	from the forensic carbon dating
จากภาษากรีก	от гръцки	greek language
จากละคร	от драмата	from drama
จากละครเรื่อง	от драмата	from the soap opera
จากสารานุกรมบริทานิกา	от encyclopaedia britannica	from printed information
จากอัลบั้ม	от албума	from the album
จากเรื่อง	от историята	from the story of ...
จากเว็บ	от мрежата	from the web
จากเว็บไซต์กระทรวงการต่างประเทศ	от уебсайта на министерството на външните работи	from the website of foreign department
จากเว็บไซต์กระทรวงต่างประเทศ	от уебсайта на министерството на външните работи	from the foreign government affairs website
จากโซล	от сеул	from soeul
จาติกวณิช	chatikavanij	chatikavanij
จามจุรี	chamchuri	jamjuri flower
จารีตประเพณี	традиция	tradition from the culture
จารุเสถียร	джару сатиен	charusathien
จาวตาลเชื่อม	jao tan weld	sweetened palm - a type of thai dessert
จำกัด	ltd.	limited
จำกัดมหาชน	ограничен	public limited
จำนวน	номер	amount
จำนวนประชากร	население	population
จำปาเทศ	чампа	a specific type of magnolia tree; similar michelia champaca
จำเริญ	просперират	jamroen
จิกะไบต์	jigtes	gigabyte
จิตรกร	художник	painter
จิตรกรรม	живопис	arts and craft or music
จิตวิทยา	психология	psychology
จิตใจ	ум	heart; feelings
จินตหรา	джинтара	jinnara - a female's name who is a singer
จิบูตี	джибути	ji bu dee event on june 27
จิบเบอเรลลิน	гиберелин	gibberellin
จิม	джим	jim
จิโอวานนี	джовани	giovanni
จี	джи	g
จีนตัวย่อ	опростен китайски	simplified chinese characters
จียอน	jiyeon	๋jiyeon (korean name)
จึงทรงพระกรุณาโปรดเกล้า	затова любезно наредени	be kind enough to
จึงเปิดโอกาสให้	затова даде възможност	open up opportunities
จึงใช้ธาตุหมอกและเมฆาได้	следователно можете да използвате елемента мъгла и облак	using magic with cloud and spells
จุกนมสีขุ่น	непрозрачен биберон	corrupted pacifier
จุดกึ่งกลาง	midpoint	midpoint
จุดจอมฟ้า	синя точка	zenith
จุลจอมเกล้าเจ้าอยู่หัว	vajiralongkorn	phra chunla chom klao chao yu hua
จุฬาลงกรณินทรวรางกูร	chulalongkorn nintharangrangkun	new title for the princess
จูล	джаул	joule
จูเซปเป	джузепе	giuseppe
จูเนียร์	младши	junior
จเชียงใหม่	чианг май	chiang mai province
จเพชรบุรี	печабури	pedchaburee province
จเพชรบูรณ์	петчабун	province pechaboon
จ๊กมก	jumkum	jokmok - a surname of a comedian
ฉ	f	ninth thai alphabet
ฉบับชั่วคราว	временна версия	special (temporary) edition
ฉบับวณิพก	цифри	begger version
ฉลอง	празнувам	celebrate
ฉลองพระชนมายุ	празнувайте 80-та година	celebrated birth anniversary of
ฉันรักคุณ	обичам те	i love you
ฉาบ	гипс	cymbal
ฉายเมื่อ	показва се на	aired
ฉิ่ง	чинел	small cup-shaped cymbals
ฉี่	пикая	qi
ชนะ	печеля	winning
ชนิด	тип	kind
ชนิดของเมฆ	облачен тип	types of clound
ชม	гледам	chom
ชมชื่น	комплимент	chomchuen
ชมพู	розов	rose apple
ชมพูทวีป	индия	south asia
ชมพู่	розова ябълка	syzygium
ชล	езера	chol (first name)
ชลธารวิทยา	chaloem wittaya	limnology
ชลบุรี	чон бури	cholburi state
ชลิต	chalit	chalit - a male's name
ชวนชื่น	привлекателен	choun cheen - a surname
ชอบ	като	chop
ชะนี	гибон	gibbon
ชะมด	мускус	anteater
ชะอวด	покажете	chaoud - location in thailand
ชะอำ	ча-ам	cha-am (name of thai district)
ชัชพล	chatchapon	chatchapol - a male's name
ชัย	победа	chai
ชัยชนะ	победа	chaichana
ชัยนาม	чай нам	chainam
ชัยบัญชา	чай банча	chaibancha
ชัยมงคล	chaimongkol	chaimongkol - a male's name
ชัยยุทธ	chaiyut	chaiyuth (first name)
ชั้น	клас	class
ชั้นที่	етаж	order
ชั้นประทวน	етаж	non-commissioned officer
ชั้นมหาวชิรมงกุฎ	crown maha wachira class	order of the king's jewels
ชั้นยศ	ранг	millitary rank
ชั้นสูงสุด	най-високо ниво	special class
ชา	чай	tea
ชากะ	shaka	shaka
ชาคริต	тревога	charkrit
ชาญชัย	chanchai	chanchai - a thai name
ชาตะ	да се родя	born
ชาติ	нация	nation
ชาย	мъжки пол	male
ชาร์ป	остър	sharp
ชาร์ล	чарлз	charles
ชาร์ลส	чарлз	charles
ชาลส์	чарлз	charles
ชาลี	чарли	charlie
ชาวนา	земеделски производител	farmer
ชาวไทย	тайландци	thai
ชาวไทยภูเขา	племе хълм	thai hill tribe
ชำนิ	chamni	chumni - a location in thailand
ชิคิกามิ	shikikami	shikigami
ชิงร้อย	състезавам се	ching roi
ชิงร้อยล้าน	състезавайте се за сто милиона	ching roi lan
ชิซุกะ	шизука	shizuka
ชิดจันทร์	chidchan	chidjun (a person's last name)
ชิน	свикнали	get used to
ชินวัตร	шинаватра	shinawatra
ชิริว	chiryu	cherew - a japanese character
ชิลี	чили	chilli
ชิโนะ	chino	shino
ชีพด็อก	овчарско куче	chief dog
ชีวนิชพันธ์	биологичен	chiwanitphan
ชีวประวัติ	биография	biography
ชีวมวล	биомасата	alternative (natural) power
ชีวสถิติ	биостатистика	biometry, biostatistics
ชื่อดัง	известен	famous
ชื่อนามสกุล	фамилно име	name-lastname
ชื่อภาษาญี่ปุ่น	японско име	japanese name
ชื่อภาษาอังกฤษ	английско име	english name
ชื่อยศภาษาไทย	тайландски ранг	thai title
ชื่ออัลบั้ม	име на албума	album name
ชื่ออื่น	други имена	synonym
ชื่อเก่าในวงการ	старо име в индустрията	old stage name
ชื่อเดิม	предишно име	old name
ชื่อเมือง	име на град	city's name
ชื่อเรื่อง	заглавието	the name of the story
ชื่อเล่น	прякор	nickname
ชุดแพนเค้ก	комплект палачинки	pancake
ชุติมา	chutima	chutima
ชุมชนออนไลน์ชาวจังหวัดสกลนคร	онлайн общност на sakon nakhon	sakon nakhon people online community
ชุมพลบุรี	chumphon buri	chompolburi area
ชุมแพ	chum phae	choompa - location in thailand
ชุมแสง	chum saeng	choomsang - a male's name
ชูมันน์	шуман	schumann
ชูศักดิ์	chusak	chusak
ชโย	браво	cheer; hurray
ชไนเดอร์	schneider	schneider
ช็อกโกแลต	шоколад	chocolate
ช่วงปี	годишен период	between year
ช่อง	канал	channel
ช่องเชิงเทิน	бойниците	machicolation
ช้อน	лъжица	spoon
ซ	° с	the eleventh letter of the thai alphabets
ซน	палав	crashing into
ซบที่อกฉัน	nestle в гърдите ми	cry in my arms
ซอมบี้	zombies	zombie
ซออู้	зоологическа градина	a woodwind thai instrument
ซันไชน์	слънчева светлина	sunshine
ซัลฟานิลาไมด์	сулфаниламид	salfanilamide
ซัลฟาไดอะซีน	сулфадиазин	sulfadiazine
ซัลเฟต	сулфат	sulphate
ซากดึกดำบรรพ์	вкаменелост	fossil
ซาคุโร่	sakuro	zakuro - a japanese character
ซาซางาวะ	sasagawa	sasangngawa - a japanese name
ซานกัลโล	сан гало	sangallo family
ซาบุซะ	sabuza	zabuza
ซาลาดิน	саладин	saladin
ซาอิ	sayi	chai - a japanese name
ซาโลมอน	саломон	salomon
ซิกนัส	cignus	signus
ซิงเกอร์	певец	sinder
ซิงเกิ้ล	singles	single
ซิทคอม	ситком	sitcom
ซินเดอเรลล่า	пепеляшка	cinderella
ซิมไฟลา	simphila	class symphyl
ซิโนไทย	китайско-тайски	sino-thai
ซี	° с	see
ซีซี	як	cc
ซีรีเบลลัม	serabellum	cerebellum
ซีลีเนียม	селен	selenium (chemical element)
ซีสต์	кисти	cyst
ซีเกมส์	sea игри	southeast asian game
ซีเจ	cj	cj
ซีเซียม	цезий	cesium
ซีเนม่า	кино	cinema
ซีแคนต์	сечащ	secant
ซีโร่	нула	zero
ซึง	който	feeling touched (by the music or movie)
ซึม	извора	absorb
ซึ่ง	който	because
ซึ่งประกอบด้วย	състояща се от	consists of
ซึ่งมี	което има	with
ซึ่งมีความหมายว่า	което означава	meaning
ซึ่งมีทั้งหมด	което има всичко	in total of
ซึ่งรู้จักกันว่า	което е известно като	called
ซึ่งเกิดจากปัจจัยภายนอก	причинява се от външни фактори	which is caused by external factors
ซึ่งเรียกว่า	което се нарича	called
ซึ่งแท้จริงแล้ว	в интерес на истината	real name
ซึ่งได้แก่	които са	such as
ซุง	дневник	sung
ซุน	слънце	son
ซุปเปอร์มาร์เก็ต	супермаркет	supermarket
ซุปเปอร์เซ็นเตอร์	супер център	super center
ซู	съдя	holding up high
ซูจี	сузи	fuji
ซูซูกิ	suzuki	suzuki brand
ซูรินาเม	суринам	suriname
ซูเปอร์เซ็นเตอร์	супер център	super center
ซ่อมแซม	ремонт	repair
ซ่าหริ่ม	бъди щастлив	a type of thai dessert
ซ้าย	наляво	left
ฌอง	джинсов плат	jean - french name
ญ	най-	a thai alphabet with a y sound
ฐานข้อมูล	базата данни	database
ฐานทัพ	временни войнишки жилища	armforce
ณภัทร	naphat	napat
ณรงค์	кампания	narong - a male's name
ณัฏฐธิดา	natthida	nattathida - a thai female actress
ณัฐวุฒิ	natthawut	nattawut
ด	м	a letter from thai alphabet
ดง	млечница	area, location
ดม	мирис	smell
ดรทรงศักดิ์	д-р сонгсак	doctor songsuk - a famous person
ดรนิพนธ์	д-р нипон	doctor nipon
ดรสาโรช	д-р сарой	dr. sarot
ดรสุชาติ	д-р сухарт	dr. suchart
ดราก้อน	дракон	dragon
ดราก้อนเควสต์	търсенето на дракони	dragon quest
ดวงพร	щастие	dwongpol
ดวงอาทิตย์	слънцето	sun
ดอก	цвете	flower
ดอกอ้อ	тръстиково цвете	dok aou
ดอกไม้	цвете	flower
ดอกไม้ประจำจังหวัด	провинциално цвете	state's flower
ดอตคอม	dot com	dotcom
ดอนเมือง	дон муеанг	don mueang
ดอยอินทนนท์	дой итанон	doi inthanon
ดอร์	врата	door
ดอลลาร์สหรัฐ	американски долар	united states dollar
ดอว์ขิ่นจี	довин джи	dorkingi
ดังนั้น	така	for that reason
ดังเช่น	като	such as
ดัชนีการพัฒนามนุษย์	индекс на човешкото развитие	human development index
ดัตช์	холандски	dutch
ดันแฮม	дънам	dunham, the mother of barrack obama
ดับเบิลยู	w.	letter w
ดา	da	da - a thai nickname
ดาบ	меч	sward
ดาบเขี้ยวฟ้าฟื้น	мечът на отмъщението	sky fang sword of revival
ดารา	звезда	star
ดารากร	актьор	darakon
ดาราคู่แรกของไทย	първата звезда в тайланд	first movie stars in thailand
ดาราจักร	галактика	planet in the solar system
ดาราศาสตร์รังสีเอ็กซ์	рентгенова астрономия	xray astronomy
ดาราหญิงไทยยอดนิยม	популярни тайландски женски знаменитости	famous actress
ดาวกระจาย	избухващи	star disperse
ดาวคาโนปุส	canapas	canopus star
ดาวพฤหัสบดี	юпитер	jupiter
ดาวพุธ	живак	mercury
ดาวยูเรนัส	уран	uranus
ดาวศุกร์	венера	venus
ดาวอาร์คตุรุส	арктур	arcturus
ดาวเคราะห์	планета	planet
ดาวเคราะห์แคระ	планета на джуджета	dwarf planet
ดาวเสาร์	сатурн	saturn
ดำรงค์	wimax	dumrong - a male's name
ดำรงตำแหน่ง	задръжте позиция	hold the title of
ดำรงอ่องตระกูล	damrong ong clan	dumrongongtrakul
ดำเนินสะดวก	дамноен садуак	damnoen saduak
ดิกชันนารี	речник	dictionary
ดิค	кур	dick - the name
ดิจิตอล	дигитален	digital
ดิน	почва	soil
ดินเซนฮอฟเฟอร์	дзен хофър	dientzenhofer - as in christoph or leonhard or johannes
ดินแดน	територия	territory
ดิว	роса	dew - a nickname
ดิวิชั่น	делене	division
ดิศ	диск	dis (thai first name)
ดิศกุล	diskun	disakul (last name)
ดิสนีย์	disney	disney
ดิสโพรเซียม	диспрозиев	dysprosium
ดี	добре	d.
ดีคอนสตรักทิวิสม์	донрак тавист	deconstructivism
ดีน	декан	religion (islamic term)
ดีบุก	калай	tin
ดีเวลลอปเมนท์	развитие	development
ดีเวลลอปเม้นท์	развитие	development
ดีเอ็นเอ	днк	dna
ดุสิต	dusit	dusit
ดูที่	погледни	see
ดูเพิ่มเติม	виж повече	see also
ดูเพิ่มเติมที่	вижте също	see more detail in
ดูเร็กซ์	durex	durex
ดูแล	грижа	take care
ด็อก	куче	dog
ด้วย	с	too, also, together, with
ด้วยเหตุนี้	поради тази причина	for this reason
ด้านการกีฬา	спортен	sports
ด้านการต่างประเทศ	външни работи	foreign affairs
ด้านการเกษตร	земеделски	agriculture
ด้านดนตรี	музика	in music
ด้านหน้า	преден	front
ด้านหลัง	гърба	backside
ด้านอ่าวไทย	страна на залива	gulf of thailand side
ต	о	a letter from thai alphabet with th sound
ตกรอบที่	елиминиран	did not make the cut
ตรงกับวันขึ้น	съвпада	on the date of
ตรงกับวันที่	дата на съвпадение	on the date of _______________
ตระกูล	клан	family
ตระกูลนารา	семейство нара	nara lineage
ตระกูลปาร์ค	клан парк	park family (korean last name)
ตระกูลยามานากะ	семейство яманака	yamanaka clan
ตระกูลอินุซึกะ	семейство инузука	inu-tsuka family
ตระกูลเซนจู	семейство сенджу	chen ju dynasty
ตรัง	транг	trung province
ตรางู	змия	snake brand
ตราด	трат	trad state
ตรานี้	този печат	this seal
ตราสัญลักษณ์	емблема	symbol
ตรึงใจ	fascinate	truengjai
ตรุษจีน	китайска нова година	chinese festival
ตลาด	пазар	market
ตลาดโลตัส	пазар на лотос	lotus market
ตอน	кога	edition number
ตะกร้อ	намордник	takraw
ตะกั่ว	водя	copper
ตะละภัฏ	talapat	talaput - a surname
ตะลุยอวกาศ	космически дабъл	space trek
ตะวันทอแสง	изгрев на слънце	tawanthosaeng
ตะวันออก	изток	east
ตะวันออกเฉียงเหนือ	североизток	east
ตันติเวชกุล	tantivejkul	tuntivetchakul - a surname
ตัว	тяло	body
ตัวพระ	главен герой	main character
ตัวยักษ์	гигант	giant
ตัวละคร	характерът	character
ตัวละครจากเรื่อง	героите от историята	soap opera based on a written story
ตัวลิง	маймуна	monkey
ตัวสะกด	правопис	final consonant
ตัวหาร	делител	divisor
ตัวอย่าง	пример	example
ตัวอย่างคำบาลี	пример pali	bali example words
ตัวอย่างคำประพันธ์	примерен стих	sample writing
ตัวอย่างต้นแบบแรก	пример за първи прототип	holotype
ตัวอย่างภาพยนตร์	трейлър на филм	movie trailer
ตัวอย่างเช่น	например	for example
ตัวเลขอย่างเป็นทางการ	официални номера	formally number
ตัวแปร	променлив	variable
ตั้งงี่สุ่น	танг ниджън	tang ngee soon
ตั้งอยู่ที่	намира се в	located
ตั้งอยู่เลขที่	намира се в	at house number
ตั๊กแตน	скакалец	grasshopper
ตา	око	ta (a person's name)
ตาคลี	takhli	ta-klee
ตามตัวสวมเครื่องประดับต่าง	докато носеше различни орнаменти	accessories
ตามตำราพรหมชาติฉบับหลวง	според кралския учебник на брама	by royal botanic manual/handbook
ตาระวา	тарава	square yard
ตาราง	маса	table
ตำนานวายุสลาตัน	легендата за буря	shippuden
ตำนานแฝงคำสอน	легендарни учения	tales
ตำบลกระเทียม	подрайон на чесън	garlic district
ตำบลกังแอน	област ганг ан	ung gan district
ตำบลตาเมียง	област та мюнг	tambon tameung
ตำบลนางแล	подрайон нанглае	nang lae province
ตำบลนาดี	подрайон нади	na dee district
ตำบลบ้านกง	подрайон бан конг	tambon bankong (name of the district)
ตำบลยะวึก	област ювак	tambon yawuek
ตำบลระแงง	район раханг	ra-ngang district
ตำบลสังขะ	sangkha	thambol sangka
ตำบลเมืองบัว	подрайон буа	muangbua district
ตำบลโพนครก	област phon nakhon	tambon poncrok
ตำบลไพรขลา	подрайон фрай хала	phrai khla subdistrict
ติณสูลานนท์	tinsulanon	thinasulanon
ติอามัต	tiamat	tiarmut
ตี๋ใหญ่	голям тройник	ti yai
ตึก	сграда	building
ตุรกี	турция	turkey
ตุลาคม	октомври	october
ตุ๊กแก	гущер	gecko
ตูน	карикатура	toon
ต่อกันด้วยพันธะ	продължете с облигации	linked by bond
ต่อจาก	продължете от	resulting from
ต่อมา	по късно	later
ต่อมาวันที่	следваща дата	later on the date
ต่อมาในปี	по-късно през годината	later in the year
ต่อมาในรัชกาลที่	по-късно през царуването	afterwards, in the reign of
ต่อมาในสมัยกรุงธนบุรีและกรุงรัตนโกสินทร์เขมรตกอยู่ภายใต้การควบคุมของจักรวรรดิสยามอย่างเข้มงวด	по-късно, в периодите тонбури и ратанакосин, кхмерът е бил под строг контрол на сиамската империя.	later in thonburi period and rattanakosin period
ต่าง	различно	different, various
ต่างๆ	различни	various, different
ต้น	начало	medication for multi-symptoms
ต้นตอจักรวาลวิทยา	космологичен произход	cosmogony
ต้นสกุล	род	clan
ถนน	път	street
ถนนคนเดิน	пешеходна улица	kon dern road
ถนนประชาธิปก	пътят на демокрацията	prachatiphok road
ถนนมิตรภาพ	пътят на приятелството	thanon mittraphap
ถนนสุขุมวิท	sukhumvit road	sukhumvit road
ถมิตรภาพ	приятелство	mittraphap road
ถวาย	оферта	presented (royal language)
ถึงกระนั้น	въпреки това	until
ถึงเดือนกรกฎาคม	за юли	starting july
ถ้วย	чаша	cup
ถ้อยคำ	думи	accent
ทดลอง	пробен период	experiment
ทนงศักดิ์	thanongsak	thanongsak
ทนาย	адвокат	lawyer
ทนายความ	адвокат	attorney
ทรงคล้ายทรงกลม	сферичен	spheroid
ทรงถือหุ้นจำนวน	негово височество притежава акции в	stock ownership
ทรงผนวช	негово височество	ordain
ทรงพระกรุณาโปรดเกล้าโปรดกระหม่อมให้	милостиво ме освети	gift (word for the king)
ทรงยี่สิบหน้า	двадесет лица	icosahedron
ทรงลูกบาศก์	куб	cube
ทรงสี่เหลี่ยมขนมเปียกปูน	ромб	rhombohedron shaped
ทรงสี่เหลี่ยมมุมฉาก	правоъгълник	triangular prism
ทรงห้าหน้า	пет лица	polyhedron
ทรงได้รับการทูลเกล้าฯ	получи негово величество краля	the king of thailand gives out ____ to people
ทรัพยากร	средство	wealth
ทรัพยากรน้ำ	водни ресурси	water resources
ทรัพย์วิจิตร	благосъстояние	sapwichit
ทรัพย์เพิ่ม	допълнителни активи	subpherm
ทรัมเป็ต	тромпет	trumpet
ทรีทูวัน	три към едно	three.two.one
ทวารหนัก	анус	anus
ทวีป	континент	continent
ทวีปอเมริกา	америка	america continent
ทวีปเอเชีย	азия	asia
ทวีวัฒน์	thawiwat	taweewan
ทว่า	но	however
ทศกัณฐ์	tosakan	ravana
ทศพล	tosapon	thotsaphon
ทหาร	войник	soldier
ทหารหน่วยอาเฟลันดราที่	войската афеландра	afelandra army
ทหารอากาศ	въздушни сили	air force man
ทอง	злато	gold
ทองขาว	бяло злато	thongkhao
ทองประสม	смесено злато	thongprasom
ทองผาภูมิ	thong pha phum	thong pha phum
ทองหยอด	златен лист	a type of thai dessert
ทองหล่อ	thonglor	gold
ทองเจือ	злато лачена	tong jea - a surname
ทองแดง	мед	copper
ทองใหญ่	голямо злато	tong yai - a name
ทอม	мъжко животно	tom
ทอมสัน	thomson	thomson
ทอมัส	томас	thomas
ทะเล	море	ocean, sea
ทะเลทราย	пустинен	dessert
ทะเลสาบ	лагуна	lake
ทักษะ	уменията	skill
ทัช	touch	touch
ทับ	slash	thon-rammana
ทัพเรือภาคที่	военноморски отдел	naval area command
ทัวร์คอนเสิร์ต	концертна обиколка	concert tour
ทั่วไป	общ	general
ทั้ง	и двете	all
ทั้งหมด	всичко	all
ทางทิศตะวันออก	изток	east
ทางทิศตะวันออกติดกับเวียดนาม	изток граничи с виетнам.	borders vietnam to the east
ทางทิศเหนือติดกับประเทศไทยและลาว	северът граничи с тайланд и лаос.	borders thailand and laos to the north
ทางน้ำ	воден път	by water
ทางรถไฟ	влака	rail
ทางหลวงพิเศษ	специална магистрала	motorway
ทางอากาศ	по въздух	by air
ทางไอทีวี	на itv	via itv ( a television station in thailand)
ทานากะ	танака	tanage - a japanese name
ทาร์ดิกราดา	tardikrada	tardigrada
ทาวเวอร์	кулата	tower
ทำงาน	работа	working
ทำนอง	мелодия	melody
ทำบุญตักบาตรฯ	заслуга и предлагане на храна на монасите	put food offerings into a buddhist monk's bowl
ทำหน้าที่	изпълнете задължението	task, function
ทำให้	марка	made
ทิฆัมพรธีรวงศ์	тикампорн тиравонг	timkamporntiravong (thai last name)
ทิพย์	thip	thip
ทิฟฟานี่	тензух	tiffany - female's name
ทิม	тим	tim
ทิวานนท์	tiwanon	thiwanon
ทิศตะวันตก	запад	west
ที	t	t.
ทีบีเอส	tbs	tbs
ทีมชาติไทย	национален отбор на тайланд	thai national team
ทีมใดที่จำนวนข้อที่ถูกน้อยกว่า	кой отбор има по-малък брой от	the team with the least correct answers
ทีวีอินไซด์	телевизор вътре	tv inside
ทีโอที	тот	tot
ที่จ่ายร้อยละ	това плаща процент	costing
ที่นี้	тук	here
ที่ประชาชนชอบมากที่สุด	кои хора харесват най-много	people's most favorite
ที่มา	източник	source
ที่มี	това има	possess
ที่มีชื่อว่า	на име	named
ที่สำคัญ	ключът	important
ที่หมายถึง	това означава	explanation
ที่อยู่อาศัย	жилище	residence
ที่เกิดขึ้น	това стана	appear
ที่โดดเด่นคือ	изключителното е	notable
ทุก	всеки	every
ทุกครั้ง	всеки път	every time
ทุติยจุลจอมเกล้าวิเศษ	съдове	tuthit julajomklawwiset - the title of those you received jewelry from the king
ทุ่งตะโก	тунг тако	thung tako district
ทุ่งสง	thung song	tong song or nakon sri thamarat state
ทุ่งใหญ่	тунг яй	tungyai
ทู	също	to
ทูล	инструмент	thun
ทเวนตี้	двадесет	twenty
ทโกมลบุตร	thakomolabutr	komolbut - a surname
ทไย	защо	thayai
ท่องอาณาจักรโฮ่งเหมียว	рецитирайте кралство хонг миао	traveling the kingdom of woof-meow
ท่าชนะ	поза	thachana
ท่านอิน	в	than in
ท่านอ่อง	ong	tan ong - a member of the royal family
ท่านอ้วน	дебелак	than uan
ท่าน้ำนนท์	брегова линия	nam non pier
ท่ายาง	гумен печат	tha yang
ท่าศาลา	tha sala	sala pier
ท่าอากาศยานเลย	летище лоей	loei airport
ท่าเรือ	порт	pier
ท่าไม้ตาย	заселник	deadly move
ท้องสนามหลวง	санам луанг	sanamloung - a landmark in thailand
ธกรุงไทย	krung thai bank	krung thai bank
ธกส	baac	bank for agriculture and agriculture
ธกสิกรไทย	банка касикорн	kasikornbank
ธง	флаг	flag
ธงชัย	thongchai	thongchai
ธงชาติ	национален флаг	national flag
ธงธง	флаг	thongthong
ธนบุรี	thonburi	thonburi province
ธนพร	thanaporn	thanaporn
ธนะรัชต์	thanarat	tanarat -a surname
ธนาคาร	банка	bank
ธนาคารกรุงศรีอยุธยา	банка на аюдхия	bank of ayudhya
ธนาคารกรุงไทย	krung thai bank	krung thai bank
ธนาคารทหารไทย	тайландска военна банка	tahanthai bank
ธนาคารทิสโก้	tisco bank	tisco bank
ธนาคารอิสลามแห่งประเทศไทย	ислямска банка на тайланд	islamic bank of thailand
ธนาคารเกษตร	земеделска банка	farmer's bank
ธนาคารเพื่อการพัฒนาแห่งเอเชีย	азиатска банка за развитие	patana asia bank
ธนาคารไทยพาณิชย์	търговска банка сиам	siam commercial bank
ธนิต	thanit	thanit
ธปท	bot	bot
ธรณินทราธิราช	tharawintharathirat	having to do with the king
ธรณีสัณฐานวิทยา	морфология на почвата	geomorphology
ธรรมนูญ	харта	law
ธรรมศักดิ์	thammasak	tamasak - surname of an elected prime minister
ธรรมศาสตร์	thammasat university	thammasat
ธรรมเมกขสถูป	дхарма мак ступа	dhamek stupa
ธานินทร์	thanin	tanin
ธารทิพย์	than thip	tarnthip (first name)
ธำมงรค์	thamrong	ring
ธิติกานต์	thitikan	thitikan
ธีม	темата	theme
ธีระ	тира	teera
ธีรเดช	thiradej	theeradej
ธุรกิจ	бизнес	business
ธุรกิจการบิน	авиационен бизнес	airline business
นก	птица	bird
นกกระจอก	врабче	sparrow
นกกระทา	пъдпъдък	quail
นกกระทุง	пеликан	pelican
นกกระเต็น	синьо рибарче	kingfisher
นกขมิ้น	канарче	oriole
นกน้อย	малка птица	noknoi
นกแก้ว	папагал	parot
นกแอร์	nok air	airline
นครนิวยอร์ก	ню йорк	new york city
นครปฐม	nakhon pathom	nakhon pathom
นครพนม	nakhon phanom	nakhon phanom
นครราชสีมา	нахон ратчасима	nakhon ratchasima
นครสวรรค์	накхон сауан	nakhon sawan
นครหลวงเวียงจันทน์	vientiane capital	vientiane
นที	приток	natee - a male's name
นปช	udd	three letter acronym
นพจินดา	noppachinda	noppajinda - a surname
นพดล	nopadon	noppadol - a male's name
นร	студент	the ancient and auspicious order of the nine gems
นราธิป	narathip	naratip - a male's name of a singer
นราธิวาส	narathiwat	narativat state
นวนิยาย	роман	story
นวรัตน์	nawarat	navaratna
นวล	слонова кост	noul -  a name
นอกจาก	освен това	other than, to exclude
นอกจากนี้	в допълнение	furthermore
นอกจากนี้แล้ว	освен това	besides
นอกเหนือจากนี้	различни от	moreover
นอนไม่หลับ	не мога да спя	insomnia
นอร์ส	старонорвежки	norse
นะงะซะกิ	нагасаки	nagasaki
นะโม	намо	namo
นักดนตรี	музикант	musician
นักบินของออร์บ	пилотът на орб	orb pilot
นักบินอวกาศ	астронавт	astronaut
นักปรัชญา	философ	philosophist
นักพากย์	гласов дубльор	voice actor
นักมวย	боксьор	boxer
นักร้อง	певецът	singer
นักร้องชายไทย	тайландски мъжки певци	thai male vocalist
นักร้องนักดนตรี	певец музикант	singer, musician
นักร้องเพลงไทยสากลชาย	международен мъжки тайландски певец	male thai pop singer
นักร้องเสียงหลัก	главен вокалист	lead singer
นักวิชาการ	академичен	i was in for.
นักวิทยาศาสตร์	ученият	scientist
นักศึกษาวิชาทหาร	военен студент	army reserve force students
นักสู้อันดับ	класиран боец	fighter rank
นักเขียน	писателят	writer
นักเขียนการ์ตูน	карикатурист	cartoonist
นักเต้นนำ	водещ танцьор	dancers
นักเศรษฐศาสตร์	икономист	economist
นักแต่งเพลง	композитор	songwriter
นักแสดง	актьорите	actor/actress
นักแสดงพิธีกร	актьор	presenter of the show
นักแสดงรับเชิญ	поканен актьор	guest star
นัดกับนัด	дата с	nut kab nut - a thai sitcom
นันทนาการ	развлечение	recreation
นันทนาคร	nanthanakorn	nantanakorn
นันทเสน	nanthasen	nanthasen
นันทไกร	nantakrai	nandhakrai
นับตั้งแต่เริ่มก่อตั้งจนถึงปัจจุบัน	от създаването до днес	from the foundation up to the present
นัยนา	око	naiyana
นั่นคือ	това е	that is
นั่นเอง	там	that is
นั้น	че	that
นา	поле	na
นากา	naga	naga
นากิ	наги	nagi
นาคหิรัญกนก	нак хиранканок	nakhirunkanok
นางงามจักรวาล	мис вселена	ms. universe
นางสาวสุวรรณ	госпожице суван	miss suwan
นางสุพรรณมัจฉา	г-жа суфан матча	mrs. supanmatja - a character in a thai legend
นางาโตะ	нагато	logo ontario.
นาดี	нади	na di
นาดูน	на дун	nadune (name of district)
นาทวี	nathawi	natavee district
นาทาล	родилен	"exactly: ""natal;""  proper name: natarle"
นาที	минута	minute
นานา	многоброен	nana
นามิ	нами	nami
นายกรัฐมนตรีของประเทศไทย	министър-председател на тайланд	prime minister of thailand
นายกรัฐมนตรีไทย	тайландски премиер	thai prime minister
นายกำพล	г-н кампон	kamphon
นายชลอ	г-н чало	chalo
นายชวน	г-н чуан	mr. chuan
นายชาญชัย	г-н чанчай	chanchai
นายณรงค์	г-н наронг	mr. narong - a male's name
นายดำรง	г-н дамронг	mr dumrong - a male's name
นายทวี	г-н thawee	mr.tawee
นายประกอบ	г-н асамблея	mr. prakob - a male's name
นายปรีชา	г-н приеча	mr.preecha
นายปรีดี	господин приди	pridi - a male's name
นายยงยุทธ	г-н йонгют	mr. yongyut - a male's name
นายศักดา	господин сакда	sakda
นายสมชัย	господин сомчай	mr. somchai
นายสมัคร	кандидат	mr. samak - a thai name
นายสวัสดิ์	господин сават	sawat
นายสุชาติ	г-н suchart	mr. suchat
นายสุนทร	г-н сунтхорн	mr. soontorn - a male's name
นายแพทย์	лекар	male doctor
นารูโตะ	наруто	naruto - a japanese cartoon
นาวาอากาศเอกหญิง	водещ на ескадрила	woman airforce captain
นาฬิกา	часовник	clock
นาโนเทคโนโลยี	нанотехнология	nanotechnology
นำกลับมาสร้างใหม่อีกครั้ง	върнати, за да създадете отново	remake (of an old movie)
นำแสดงโดย	в ролите	performed by
นำโดย	воден от	led by
นิกาย	секта	sect
นิกเกิล	никел	nickel
นิคมพัฒนา	ником фатана	nikhom phatthana
นิตยสารชีวจิต	хомеопатично списание	cheewajit magazine
นิตยสารเอเชียวีก	списание „азия седмица“	asiaweek magazine
นิตโย	nittayo	nittayo
นิทาน	приказка	tales
นิยม	популярен	niyom, name of a thai country music singer
นิยมจัดขึ้นในเดือน	популярни, проведени през месеца	usually held in the month of
นิยาม	дефинира	symbols
นิรมิต	мечта	niramit
นิรันดร์กุล	nirunkun	nirankun
นิรุกติศาสตร์	етимология	philology
นิลภิรมย์	nilphirom	nipinpirom - a surname
นิวคลีโอไทด์	нуклеотид	nucleotide
นิวยอร์ก	ню йорк	new york
นิวัฒน์	newwat	niwat
นิวเคลียร์	ядрен	nuclear
นิวเคลียส	ядро	nucleus
นิฮง	nihong	nippon or nikon, a japanese reading language
นิเทศศาสตรบัณฑิต	бакалавър на изкуствата	communication major graduates
นิ่ม	мек	pangolin
นิ่มสกุล	ним сакул	nimsakun
นีโอ	neo	neo
นี่คือ	това е	this is
นุช	радост	nucth
นเรศ	ноздрите	naret - a male's name
นโยบายทางการทูตของจีน	дипломатическа политика на китай	china;s foreign policies
น็อกซ์	нокс	left.
น้องครีม	крем nong	nong kreme - a nickname of someone in thai entertainment
น้องชาย	по-малък брат	brother
น้อยมาก	много малко	noimak
น้ำ	вода	water
น้ำค้าง	роса	namkhang
น้ำดื่ม	пия вода	beverages
น้ำท่วม	наводнение	flooding
น้ำฝน	дъждовна вода	rainwater
น้ำพอง	надуваем	nam pong in kon kan province
น้ำมะนาว	лимонов сок	lemonade
น้ำมัน	масло	oil
น้ำมันสน	разтварям в терпентин	oil of turpentine
น้ำยืน	постоянна вода	numyeen - location in ubolthani state
น้ำหนัก	тегло	weight
บทนมัสการนอบน้อมบูชาพระพุทธเจ้า	глави за смирено поклонение на господа буда	a prayer to the lord buddha
บทบาททางการเมือง	политическа роля	politic
บทสวดบาลีที่ขึ้นต้นด้วยอรหัง	палийско скандиране, което започва с архата	"pali mantra started with ""arhat"""
บทสวดสรภัญญะที่ขึ้นต้นด้วยธรรมมะคือ	песнопенията на сорапаня, които започват с дхарма, са	a buddhist prayer
บนบก	на земя	on land
บรมนาถชาติอาชาวศรัย	borommanachat achan sai	something has to do with the king - too obscure
บรมนาถบพิตร	боромат бофит	borommanatbophit
บรรณาธิการ	редактор	editor
บรรพชีวินวิทยา	палеонтология	paleontology
บราซิเลีย	бразилия	brazilian
บราเธอร์ส	братя	brothers
บริบาล	грижа	baribal - a famous soccer player
บริพัตร	храна	paribatra
บริวเวอรี่	пивоварна	brewery
บริสุทธิ์	чист	pure
บริหารธุรกิจ	бизнес администрация	business administration
บริเวณรอบทะเลสาบเขมร	около кхмерското езеро	area around the lake in cambodia
บริเวณเขตภูเขาทางภาคเหนือ	планински район на север	mountain in north of thailand
บรูไน	бруней	brunei
บลีช	белина	bleach
บลู	син	blue
บลูคอสมอส	син космос	blue cosmos
บลูเบอร์รี่	боровинка	blueberry
บวก	положителен	positive
บวม	подуване	swelling
บวร	божествен	bawon
บอมบ์	бомба	bomb
บอย	момче	boy
บอยซ์	boyz	boys
บอล	топката	ball
บอลด์วิน	болдуин	baldwin
บอส	шефът	boss
บังคลาเทศ	бангладеш	bangladesh
บังไค	bangkai	bankai
บัณฑิต	завършвам	bandit
บัณฑิตวิทยาลัยร่วมด้านพลังงานและสิ่งแวดล้อม	съвместно завършено училище по енергетика и околна среда	joint graduate school of energy and environment
บันทึก	рекорд	record
บันทึกการสร้างโลก	световен рекорд	genesis diary
บันทึกความทรงจำ	бележка	diary
บันเทิง	забавление	entertainment
บัว	лотос	lotus
บัวลอย	bualoy	kind of thai sweetmeat
บัวเชด	цвете лотус	cedric dubois.
บัวใหญ่	буа яй	big lotus
บาคคัส	бахус	bacchus
บาคุกันธาตุไฟ	бакугански огнен елемент	dragonoid
บาคุกันลูกน้องของนากา	бакуган, привърженик на нага	bakugan, minion of naga
บางกอกกล๊าส	чаша в банкок	bangkok glass
บางกอกน้อย	банкок ной	bangkok noi
บางครั้ง	понякога	sometimes
บางซื่อ	bang sue	bang see - a location in thailand
บางปะกอก	банг пакок	bang prakok - an area in bangkok
บางปะหัน	банг пахан	a district in ayutthaya province
บางพลัด	bangplad	bangplad
บางส่วน	някои	some
บางเขน	bangkhen	bang khen
บางแสน	bangsaen	bang saen
บางใหญ่	bang yai	bang yai - a location in thailand
บานไม่รู้โรย	амарант	gomphrena
บารอมิเตอร์	барометър	barometer
บารัก	барак	barack
บาร์	бар	bar
บาลี	пали	vatthu
บาอัล	ваал	baal - a demon in hebrew
บิน	летя	bin
บิล	законопроект	bill
บิ๊กซี	голям с	big c
บิ๊กซ้งซุปเปอร์สโตร์	голяма песен superstore	big song superstore
บี	б.	b
บีช	плажът	beach
บีบี	bb	bb
บีฟเค้ก	торта с говеждо месо	beef cake
บี้	разпада	flatten
บี้สุกฤษฎิ์	би сукрит	be- sukasit wisetkeaw - name of a singer
บุคคล	човек	person
บุคคลสำคัญ	важна личност	vip person, very important person
บุคลิกภาพ	индивидуалност	mannerism
บุช	храст	(george) bush
บุญค้ำ	заслуга	bunkham
บุญนะโชติ	bunnachot	bunachot - a surname
บุญนาค	заслуга	boon nak - a famous surname
บุณยเกตุ	bunyaket	boonyaket
บุตร	дете	son
บุษบา	цвете	busaba - a woman's name
บูมเมอแรง	бумеранг	boomerang
บ่อทอง	златно езерце	bothong
บ้านฉาง	бан чанг	bahn shang -a  location in thailand
บ้านปราสาท	къща замък	castle house
บ้านผือ	ban phue	ban phue
บ้านฝันดอตคอม	baan fan com	bahnfun.com
บ้านลาด	бан лад	ban lat
บ้านเขว้า	къща	bahn kaywah, an area in thailand
บ้านแพ้ว	къща	ban paw
บ้านโพธิ์	ban pho	bahn po - a location in thailand
ปจ	година	two letters acronym
ปช	плаж	two letters acronym
ปฏิทินช่อง	календар на канала	calendar
ปฏิภาณ	духовитост	male's name patipan
ปตท	ptt	three letters from thai alphabets
ปทานุกรม	лексикон	encyclopedia
ปทุมธานี	pathum thani	pathum thani
ปภ	сигурност	the order of the direkgunabhorn
ปภัสรา	papassara	papatsara
ปม	възелът	knot
ประกอบด้วย	включва	composed of
ประกอบไปด้วย	състои се от	included
ประการที่	номер	point
ประกาศิต	указ	command
ประกาศเป็นป่าสงวน	обявен за горски резерват	preserve area, the protected forest
ประจวบ	сблъсквам се	prachuap
ประจวบคีรีขันธ์	прачуап хири хан	prajoubkirikan state
ประจักษ์	манифест	mr. prajak
ประจำปี	годишен	annual
ประชากรประมาณ	прогнозно население	population about
ประชากรศาสตร์	демография	literature subject
ประดิษฐาน	място	placed
ประติมากรรม	скулптура	production of a play
ประติมากรรมไทย	тайландска скулптура	thai sculpture
ประตู	врата	gate
ประตูน้ำ	язовирна стена	pratunam
ประตูเสีย	счупена врата	broken door
ประทีป	лампа	continent
ประธาน	президент	president
ประธานกรรมการ	председател	chief executive officer
ประธานศาลฎีกา	председател на върховния съд	president of the supreme court
ประธานสภารัฐสภา	председател на парламента	speaker of parliament
ประธานาธิบดี	президент	president
ประมาณ	относно	about, estimated to be
ประมาณคศ	относно	christ year
ประมาณปี	около една година	approximately in the year
ประยงค์	prayong	prayong
ประวัติศาสตร์	история	history
ประวัติศาสตร์สเปน	испанска история	history of spain
ประวัติศาสตร์ไทย	тайландска история	history of thailand
ประสาท	нерв	castle
ประสิทธิภาพ	ефективност	efficiency
ประหยัด	спасяване	thrifty, cheap
ประเด็นที่	проблемът	point number
ประเทศ	страна	country
ประเทศกัมพูชา	камбоджа	cambodia
ประเทศซูดาน	судан	sudan
ประเทศทำการค้าขายกับต่างประเทศมากยิ่งขึ้น	страните, които извършват повече търговия с чужди страни	country that trades with other countries
ประเทศนอร์เวย์	норвегия	norway
ประเทศฝรั่งเศส	франция	france
ประเทศพม่า	мианмар	burma
ประเทศฟินแลนด์	финландия	finland
ประเทศภูฏาน	бутан	bhutan
ประเทศมาเลเซีย	малайзия	malaysia
ประเทศราช	кралска страна	vassal state
ประเทศลาว	лаос	laos
ประเทศสวีเดน	швеция	sweden
ประเทศสเปน	испания	spain
ประเทศอียิปต์	египет	egypt
ประเทศเกาหลี	корея	korea
ประเทศเกาหลีใต้	южна кореа	south korea
ประเทศเนปาล	непал	nepal
ประเทศเปรู	перу	peru
ประเทศเม็กซิโก	мексико	mexico
ประเทศเวียดนาม	виетнам	vietnam
ประเทศแคนาดา	канада	canada
ประเทศและดินแดน	държави и територии	natoin and territory
ประเทศไทย	тайланд	thailand
ประเพณีชักพระ	chak phra традиция	chak phra festival
ประเภท	категория	category
ประเภทของ	тип	type of
ประเภทรายการแข่งขันชิงรางวัลดีเด่น	категория награда изключителна конкуренция	award show for
ประโยค	изречение	sentence
ปรัชญา	философия	philosophy
ปรัชญาตะวันตก	западна философия	western philosophy
ปรากฏการณ์โลกร้อน	глобално затопляне	global warming
ปรากฏตัวตอนแรกในตอน	за първи път се появи в епизод	first appear in
ปรากฏตัวในตอน	появи се в	showing their presence
ปราจีนบุรี	прачин бури	prachin-buri
ปราบดาภิเษก	коронясаха	prapdapisek
ปราสาทเขาพระวิหาร	храм проповед вихере	kao pravihan ancient ruins
ปราโมทย์	ликуване	pramot
ปริญ	пе	parin
ปริญญา	степен	degree
ปริภูมิ	пространство	3 dimensions
ปริมาณการผลิต	обем на производство	capacity
ปริศนา	пъзели	puzzle
ปริ๊นซ์	принц	prince
ปรีดา	наслада	prida - a male's name
ปรีดี	pri	pridi
ปลา	риба	fish
ปลาบู่ทอง	golden goby	goldfish
ปลาปอมปาดัวร์	прическа помпадур	pompadour
ปลาย	край	at the end
ปลายคริสต์ศตวรรษที่	в края на 19 век	late century
ปลาในสกุลนี้เรียกว่า	рибата от този род се нарича	the fish in this family is called _________
ปลิงทะเล	морска краставица	sea cucumber
ปล่อย	пускане	release
ปวดข้อ	болки в ставите	joint pain
ปวันรัตน์	pawanrat	pavunnarat - a surname
ปวีณา	paweena	paweena
ปักกิ่ง	пекин	beijing
ปักธงชัย	пак тонг чай	pakthongchai
ปัจจุบัน	настояще	at present
ปัจจุบันนี้	в днешно време	presently
ปัจจุบันประเทศไทยมีภาพยนตร์ที่มุ่งสู่ตลาดโลก	в днешно време в тайланд има филми, насочени към световния пазар.	currently thailand has international movies
ปัจจุบันมีที่นั่งอยู่ในสภาผู้แทนราษฎร	в момента има място в камарата на представителите	presently have elected representatives
ปัจจุบันเลิกเขียนแล้ว	в момента вече не пиша	presently retired from writing
ปัญจาบ	пенджаб	panjab
ปัญโญภาส	panopas	panyopat - a surname
ปัน	дял	pan
ปั้น	мухъл	clay molding
ปั๊บ	внезапно	pup
ปาก	уста	mouth
ปากดี	добра уста	be talkative
ปากน้ำ	широко устие	samutpragan province in thailand
ปากีสถาน	пакистан	country of pakistan
ปากเกร็ด	пак крет	pak kret
ปากแม่น้ำสิงคโปร์	сингапурска уста	singapore river delta
ปาน	клеймо	pan - a thai name
ปานามา	панама	panama
ปานแร่	рождените белези	panrae
ปาย	pai	pai
ปาริชาต	parichat	tiger’s claw
ปารีส	париж	paris
ปาร์ค	парк	park
ปาสกาล	паскал	pascal - computer language or name
ปาเลสไตน์	палестина	palestine
ปิปเปอราซิลลิน	пайпер ацилин	piperacillin
ปิยะพงษ์	piyapong	piyapong
ปิ่นเกล้า	пинклао	pin glow - an area in thailand
ปีคศ	година	christain era
ปีจอโทศก	година на прасето	year of the dog
ปีที่	година	the year
ปีที่วางจำหน่าย	година на издаване	the year that the product was on the market
ปีพุทธศักราช	будистка година	buddhism year
ปีย์	година	pe - a thai music artist
ปีย์ชนิตว์	piyachit	peechanit
ปีเตอร์	петър	peter
ปี่กลาง	средна чанта	a thai woodwind instrument
ปืนพก	пистолет	handgun
ปืนพกกึ่งอัตโนมัติ	полуавтоматичен пистолет	semi-automatic pistol
ปืนใหญ่	оръдие	cannon
ปืนใหญ่กลางกระสุนวิถีโค้ง	криви на средни траектории на оръдието	cannon
ปืนไร้แรงสะท้อนถอยหลัง	пистолетът за откат	recoilless rifle
ปุณณกันต์	punnakan	bhunnagun
ปุตราจายา	путраджая	putrajaya
ปุ๋ย	тор	pui
ปู	рак	crab
ป่าชายหาด	плажна гора	beach forest
ป่าชายเลน	мангрова гора	mangrove forest
ป่าดิบแล้ง	суха вечнозелена гора	dry evergreen forest
ป่าเบญจพรรณ	смесена гора	mixed forest
ป่าโกงกาง	мангрова гора	mangrove
ป๊อป	поп	pop
ป๊อปปี้	мак	poppy
ผจญภัยเกาะมหาสมบัติ	приключение на остров съкровища	nobita's south sea adventure
ผดุง	поддържа	phadung
ผล	резултати	result
ผลการแข่งขัน	резултати от конкуренцията	result of competition
ผลงานหนังสือ	книжно портфолио	publication
ผลงานเพลง	музика	song production
ผลงานโฆษณา	реклама	marketing project
ผลประเสริฐ	отлични резултати	polpasert - last name of the 2nd wife of the thai prince
ผลผลิตพลอยได้	странични продукти	result, effects
ผลรวม	сума	summation
ผลสำรวจ	резултати от анкетата	survey results
ผิวขาว	бяла кожа	white
ผิวสี	цвят на кожата	skin color
ผี	призрак	ghost
ผีน่ารัก	сладък призрак	cute ghost
ผู้กำกับ	директор	producer
ผู้จัดการ	мениджър	manager
ผู้จัดการทีม	управител на отбор	manager
ผู้ชนะ	победителят	winner
ผู้ชาย	мъж	male, man
ผู้ช่วยศาสตราจารย์	асистент	assistant professor
ผู้ดำเนินรายการ	забавител	moderator
ผู้บริหาร	изпълнителен	manager
ผู้ผลิต	производителят	producer
ผู้ฝึกสอน	треньор	trainer
ผู้พิทักษ์แห่งพิรุณ	пазител на неприятностите	rain defender
ผู้พิทักษ์แห่งอรุณ	пазител на зората	guardian of the dawn.
ผู้ว่าการธนาคารแห่งประเทศไทย	управител на банката на тайланд	governor of the bank of thailand
ผู้ว่าราชการจังหวัด	губернатор	the governor of the city
ผู้สนับสนุน	поддръжник	supporter
ผู้อำนวยการ	директорът	superintendent
ผู้เล่น	играчите	player
ผู้เล่นชุด	задайте играч	team
ผู้ใหญ่	възрастен	adult
ผ่องศรี	phongsri	pongsri
ผ้าขาวม้า	препаска	a special thai cloth that men used to tie around their waists
ผ้าอนามัยโซฟี	санитарни салфетки софи	sofi sanitary napkin
ฝ	най-	a letter with ph sound
ฝอยทอง	мъх	foythong - a thai dessert
ฝิ่น	опиум	opium
ฝูงชนวุ่นวาย	хаотична тълпа	mob
ฝ่ามือ	длан	palm
ฝ่ายบริหาร	управление	executive branch
ฝ่าเท้า	подметка на стъпалото	sole of foot
ฝ่าแดนเขาวงกต	през лабиринта	in the boundaries of kao wonkut
ฝ้าย	памук	fai
พ	t	a thai alphabet
พงศ์ศิลป์พิพัฒน์	pongsilp phiphat	pongsinpipat
พงศ์เรืองรอง	pongrueangrong	"surname ""pong reuang-rong"""
พงษ์พานิช	pongpanich	phongphanit
พงษ์เพชร	фонг пет	phong phet
พงษ์ไพบูลย์	phongpaibun	pongphatboon
พจนานุกรมออนไลน์	онлайн речник	online dictionary
พญา	змия	phaya
พญามังราย	фая манграй	mangrai the great
พตท	■ площ	three letters acronym
พธม	th	people's alliance for democracy
พนมไพร	фаном фрай	phanom phrai
พบหลักฐานของมนุษย์ซึ่งมีอายุเก่าแก่ที่สุดถึงห้าแสนปี	намерени доказателства за хора, най-старите до петстотин хиляди години.	found an evidence of the the oldest human that lived in that area
พยัญชนะ	съгласна	consonant
พยัญชนะสะกดควบกล้ำ	съгласни	diphthong's consonant
พยางค์	сричка	syllable
พยาธิกำเนิด	патогенеза	pathogenesis
พยาธิวิทยา	патология	pathology
พยาบาล	медицинска сестра	nurse
พยายามชี้ให้สาธารณชนและนานาชาติ	опитвайки се да посочи публиката и международната	encourage to promote the people and international policies
พร	порнография	wishes
พรนารายณ์	narai	phonnarai
พรบ	акт	act
พรรคการเมืองใหม่	нова политическа партия	kan mai meung political party
พรรคชาติไทย	chart thai party	thai nation party
พรรคธรรมาธิปัตย์	thammathipat партия	tamatipat political party
พรรคประชาธรรม	прачатам парти	prachatam political party
พรรคภูมิใจไทย	партия phuea thai	bhumjaithai party
พรรคสม	уравнение страна	som rangsi political party
พรรคสังคมประชาธิปไตย	социалдемократическа партия	social democratic party
พรรคเพื่อแผ่นดิน	pheu thai party	puea pandin party
พรอุดมศักดิ์	phonudomsak	pornudomsak (last name)
พระคาถาชินบัญชร	заклинателен chinnabanchon	chinbanchon
พระจันทร์	луна	moon
พระจันทร์สีรุ้ง	дъгова луна	phrachan sirung
พระชนม์	живот	the father of the king
พระตำหนัก	дворец	the king's residence
พระที่นั่งจักรพรรดิพิมาน	дворецът на император фиман	chakraput piman hall
พระที่นั่งดุสิตมหาปราสาท	тронната зала на дусит маха прасат	phra thinang dusit maha prasat
พระที่นั่งบรมพิมาน	имение боромфиман	the king's seat
พระธรรมปิฎก	dhammapitaka	phra thampidok
พระธิดา	дъщеря	daughter
พระนคร	капитал	phra nakhon
พระนาม	име	name of the king
พระนามต้นราชสกุล	първо име	the first person in the dynasty
พระนารายณ์	вишну	narayana
พระบรมธาตุไชยา	мощите на буда	buddha's relics chaiya
พระบรมราชชนก	кралско покровителство	the king's sister
พระบรมราชินี	кралица	queen
พระบรมวงศานุวงศ์	кралски особи	members of the royal family
พระบาทสมเด็จพระนั่งเกล้าเจ้าอยู่หัว	крал нанг клао	jessadabodindra
พระบาทสมเด็จพระปกเกล้าเจ้าอยู่หัว	цар праджадипок	phrabat somdet phra poramintharamaha - 7th king of thailand
พระบาทสมเด็จพระปรเมนทรมหาอานันทมหิดล	негово величество цар бумубол адулядей маха анандамахидол	phra bat somdet phra poramentharamaha ananda mahidol
พระบาทสมเด็จพระพุทธยอดฟ้าจุฬาโลก	phra буда phra yot fa, chulalongkorn	king rama 1 of chakri monarchy (bangkok)
พระบาทสมเด็จพระเจ้าอยู่หัวภูมิพลอดุลยเดชทรงพระกรุณาโปรดเกล้าฯ	негово величество крал бумубол адулядей милостиво доволен	the current king of thailand
พระบาทสมเด็จพระเจ้าอยู่หัวอานันทมหิดล	цар ананда махидол	king ananda mahidol
พระบาทสมเด็จพระเจ้าอยู่หัวเสด็จฯ	негово величество краля	the current king
พระปกเกล้าเจ้าอยู่หัว	цар праджадипок	king rama vii
พระประแดง	phra pradaeng	prapadaeng
พระปรางค์สามยอด	пранг сам йот	prapang samyod
พระพรหมคุณาภรณ์	phra prom khunaporn	pra prhom kunaporn - a person in thailand
พระพันปีหลวง	милениум луанг	queen mother
พระพันวัสสาอัยยิกาเจ้า	хиляда буди	pra paunvatsaeyyigajao - name of a monk
พระพุทธชินราช	phra буда чинарат	phra buddha chinnarat
พระพุทธบาท	отпечатък на буда	phra phutthabat
พระพุทธศาสนา	будизъм	buddhism
พระมงกุฏเกล้าเจ้าอยู่หัว	цар рама iv	phra mongkut klao chao yu hua
พระมเหสี	съпруга	the wife of a king
พระยศขณะนั้น	по това време	the current title
พระยาชัยสุนทร	phraya chai soonthorn	praya chaisoontorn - first mayor of thailand
พระยาราม	фрая рам	prayaram - the governor of sukothai city (the ancient city of thailand)
พระยาวิเศษภักดี	фрая уисфакди	praya wiset pakdi -a  name of a head of state in the ancient time
พระยาสุนทรสงคราม	phraya sunthornsongkram	phraya sonthornsongkram (thai name)
พระยาไกรภักดีศรีนครลำดวน	фрая крайпхакди шринакхон ламдуан	phraya kraiphakdi sinakhon lamduan
พระราชกรณียกิจ	кралски задължения	royal duties
พระราชลัญจกรประจำพระองค์	царски печат	the king's body guard
พระราชวงศ์	кралско семейство	royal family
พระราชวรวงศ์เธอ	кралско семейство	the title of the princess
พระราชวังดุสิต	дворецът дусит	dusit palace
พระราชวังเดิม	оригинален дворец	phra racha wang derm
พระลอ	фра лор	phra lo
พระสมเด็จจิตรลดา	фра сомдей читралада	pra jitlada - something that was built by the king
พระสัมมาสัมพุทธเจ้า	господ буда	buddha
พระองค์เจ้าสิริวัณณวรีนารีรัตน์	врз принцеса siriwannawari wareerat	the name of one of the king's granddaughter
พระอังสาเบื้องซ้ายประดับเหรียญรัตนาภรณ์	благоприятен амулет на буда от лявата страна, украсен с монети от rattanaporn	diagonal sash for the princess
พระอัษฎามหาเจดีย์	фра асада маха чеди	(royal name/language)
พระอิศวร	шива	the god shiva
พระอิสริยยศ	кралско заглавие	given rank or honor by the monarchy
พระอุโบสถ	будистки храм	the temple
พระเกียรติยศ	чест	royal honour
พระเจ้าลูกยาเธอ	боже дете	the royal princess
พระเจ้าหลานเธอ	господи твоята племенница	hmh princess
พระโคตมพุทธเจ้า	буда амулет	pra kotomputtachao - another name of buddha
พรานกระต่าย	ловец	prankatai - an area in thai province
พราหมณ์	брамин	brahman
พริกหยวก	чушка	a type of thai pepper
พริกหวาน	чушка	sweet pepper
พริกไทย	пипер	thai pepper
พฤกษศาสตร์	ботаника	botany
พลตรี	въздушни сили	major general
พลตรีหญิง	женски ввс	a female officer
พลตำรวจเอก	полицейски генерал	police general
พลทหาร	войник	first class, enlisted men
พลศักดิ์	polsak	polsak
พลอย	скъпоценен камък	ploy
พลอสนธิ	polson junction	sonthi - a famous thai army officer
พลอากาศเอกหญิง	жена acm	air chief marshal
พลฯ	общ	private
พลังงานคลื่น	сила на вълната	wave power
พลังงานนิวเคลียร์	ядрената енергия	nuclear power
พลังงานลม	вятърната енергия	wind power
พลังงานไฟฟ้า	електроенергия	electrical energy
พลัส	плюс	plus
พลาซา	площад	plaza
พลาสติก	пластмасов	plastic
พลาสมา	плазма	plasma
พลเรือเอก	адмирал	admiral
พลเอกสนธิ	генерал сонти	sonthi - a thai army officer
พวกสัตว์ลำตัวกลม	животни с кръгло тяло	animals with no backbones
พศ	пт	b.e.
พอ	достатъчно	col.
พอตเตอร์	грънчар	potter
พอตเตอร์กับเจ้าชายเลือดผสม	потър и полукръвният принц	(harry) potter and the half-blood prince
พอยท์	точка	point
พอล	paul	paul
พัชรี	phachari	pacharee - a female's name
พัฒน์ชัย	phatchai	pattachai - a male's name, famous singer
พัทยาเหนือ	северна патая	north pattaya
พัทยาใต้	южна патая	south pattaya - in thailand
พัน	хиляда	pan
พันธมิตร	съюз	alliance
พันธุศาสตร์	генетика	genetic
พันธุ์พืช	растителни видове	seed
พันธุ์สุนัข	порода кучета	dogs
พันธเสน	връзка	panthasen (thai last name)
พับลิชชิ่ง	издаване	publishing
พัลซาร์	пулсар	pulsar
พากย์เป็น	озаглавен като	subtitle
พายุ	буря	storm
พารา	para	parasetamol - a drug
พารามีเซียม	parametric	paramecium
พาร์ค	парк	park
พาวเวอร์บาย	закупуване на мощност	power buy
พาเมล่า	памела	pamela
พิชัย	phichai	pichai
พิชิต	владей	phichit
พิณ	мандолина	harp
พิธีกรรายการ	домакин	host
พิบูลมังสาหาร	пибун мангсахан	pi bul mung sa har (province name)
พิพิธภัณฑสถานแห่งชาติ	национален музей	thailand meseum
พิพิธภัณฑ์	музей	museum
พิม	пим	type
พิมประภา	phimprapa	phimprapha
พิมพ์เล็ก	малък печат	small photo frame 1.4 cm x 2.1 cm x 0.5 cm thick
พิมลวรรณ	phimonwan	pimonvun - the name of a female anchor person
พิรุณ	дъжд	rain water
พิสุทธิ์	блестящ	pisut - a male's name
พิออจชา	чай от фион	piodcha
พิเศษนครกิจ	nakornkit special	pisetnakornkit - a surname
พีท	пийт	pete
พีระมิด	пирамида	pyramid
พีระศรี	phirasri	balcony
พีอีเอ	pia	pea
พี่น้อง	братя	siblings
พี่สาวของ	сестра	the sister of ____________
พึ่งสุนทร	разчитайте на sunthorn	puangsunthorn
พืช	растение	plants
พืชที่สำคัญคือ	важни са растенията	important plants are ...
พืชไม่มีท่อลำเลียง	растения без транспортьори	plants without tubelike structures
พื้นฐานทางเศรษฐกิจ	икономическа основа	base economics
พื้นที่มหาวิทยาลัย	университетска област	university area
พุฒตาล	putthan	puttan
พุทธคยา	бодх гая	bodh gaya
พุทธนิกายเถรวาท	теравадски будизъм	a sect of buddhist religion
พุทธศตวรรษที่	веков будист	buddhist era
พุทธศักราช	будистка ера	buddhist era
พุ่มพวง	жена	poompoang - surname of a famous actor
พู่กัน	четка за рисуване	pugun
พ่อขุนรามคำแหง	крал ракхамхаенг	the leader of sukothai empire
พ่อขุนศรีอินทราทิตย์	цар интхарат	po kun intarathip - the fist king of thailand
พ่อมด	магьосник	wizard
พ่ายแพ้ให้กับ	изгубен за	lose to
พ๎ร	добре дошли	wish
ฟง	фонг	fong - a chinese name
ฟรานซ์	франц	franz
ฟรีดริช	фридрих	friedrich
ฟรีด้อม	безплатно промъкване	freedom
ฟรีแวร์	freeware	freeware
ฟลายเวท	flyweight	flyweight
ฟลูวาสแตติน	fluvastin	fluvastatin - a drug
ฟอน	von	von - in german name
ฟอร์ด	брод	ford
ฟอสฟอรัส	фосфор	phosphorus
ฟอสเฟต	фосфат	phosphate
ฟังพระธรรมเทศนา	слушайте проповеди	listen to the gospel
ฟังเพลง	слушам музика	listen to music
ฟังไจ	слушайте хайме	fungi
ฟัน	зъби	tooth
ฟาง	слама	fhang
ฟาน	фургон	van - as in the surname
ฟิชเชอร์	рибар	fisher
ฟินแลนด์	финландия	finland
ฟิลิป	филип	philip
ฟิลิปปินส์	филипини	philippines
ฟิลิปีโน	филипински	filipino
ฟิวชัน	синтез	fusion
ฟิสิกส์ดาราศาสตร์	астрофизика	astrophysics
ฟิสิกส์อนุภาค	физика на частиците	physic particle
ฟีนิลคีโตนูเรีย	фенилкетонурия	phenylketonuria
ฟีฟ่าคลับเวิลด์คัพ	световно първенство по клуба на фифа	fifa world cup
ฟุตซอล	футзал	futsal
ฟุตบอล	футбол	football
ฟุตบอลอาเซียนเยาวชน	футбол на asean	asian youth soccer
ฟุตบอลเอเชียเยาวชน	азиатски младежки футбол	asian football club youth championship
ฟู	пълен	rise up
ฟูจิ	fuji	fuji
ฟูลส์	пълен	fools
ฟ้อน	танцувам	fon
ฟ้า	син	blue
ฟ้าร้อง	гръм	thunder
ฟ้าหลัว	изгрев	haze
ภมรมนตรี	бамамон монтри	pamornmontri
ภักดี	лоялен	pakdi
ภัณฑิลา	panthila	paktila - first name of a female actress
ภาคกลาง	централен регион	central thailand
ภาคคนแสดง	шоу	human version
ภาคตะวันตก	западен регион	west
ภาคตะวันออกเฉียงเหนือ	североизточен регион	northeast region
ภาคพิเศษ	специален	special program
ภาควิชาคณิตศาสตร์	катедра по математика	department of mathematics
ภาควิชาพยาธิวิทยา	отделение по патология	department of pathology
ภาควิชาฟิสิกส์	катедра по физика	physics
ภาควิชาวิศวกรรมเครื่องกล	катедра по машиностроене	engineering division
ภาควิชาวิศวกรรมไฟฟ้า	катедра &quot;електротехника&quot;	engineering department
ภาควิชาสูติศาสตร์และนรีเวชวิทยา	отделение по акушерство и гинекология	gynecology
ภาควิชาเทคโนโลยีอาหาร	катедра по хранителни технологии	faculty of food technology
ภาคเหนือ	север	northern region
ภาคใต้ตอนล่าง	долен южен регион	southern thailand
ภาพตรา	изображение на печат	coat of arms
ภาพถ่าย	снимка	photograph
ภาพพาโนรามา	панорама	panoramic image
ภาพพิมพ์	печат на изображение	lithography
ภาพยนตร์	кино	movie
ภาพยนตร์การ์ตูนไทย	тайландски анимационен филм	thai cartoon
ภาพยนตร์ชุดนี้	този филмов комплект	this series
ภาพยนตร์ตอน	епизод	version of the movie
ภาพยนตร์ลามก	гадни филми	porn movie
ภาพรวม	преглед	group of pictures
ภายหลัง	след	background
ภายหลังสงคราม	след войната	after the war
ภายใต้ความช่วยเหลือจากกองทุนการเงินระหว่างประเทศ	под помощта на международния валутен фонд	with the financial help, sponsored by
ภายในวงขอบเหรียญเบื้องบนมีข้อความว่า	в горната част на монетата има изявление, че	etching in the medal that ______________
ภารกิจ	мисия	business
ภาวะเศรษฐกิจของกัมพูชาหลังจากมีการเปลี่ยนแปลงการปกครองจากระบอบสังคมนิยมเป็นระบอบประชาธิปไตย	икономически условия на камбоджа след прехода от демократичен социализъм към демокрация	cambodia economy after political change
ภาษาญี่ปุ่น	японски	japanese language
ภาษาบาลี	пали	balese language
ภาษาสเปน	испански език	spanish language
ภาษาอังกฤษ	английски език	english language
ภาษาอีสาน	североизточен език	eastern thai language
ภาษาเกชัว	кечуа	quechua language
ภาษาเฉพาะอาชีพ	жаргон	jargon
ภาษาเบสิก	основен	basic programming lauguage
ภาษาเยอรมัน	немски	german language
ภาษาโคบอล	cobol	cobol programming language
ภิญโญ	все повече	pinyo - a female's name
ภิรมย์	приятен	philom
ภิรมย์ภักดี	фиром факди	pirompakdee
ภูกระดึง	phukradueng	phu kradueng
ภูกามยาว	фу кам яо	phu kamyao district
ภูธเนศ	bhutanet	putanet - a male's name
ภูพาน	фуфан	phu phan
ภูมิประเทศและภูมิอากาศ	топография и климат	geography and climate
ภูมิภาค	област	region
ภูมิรัตน์	bhumirat	poomirath
ภูหลวง	фу луанг	phu luang
ภูเขา	планина	mountain
ภูเขาน้ำแข็ง	айсберг	glacier
ภู่สว่าง	фоо саанг	poosawang - a surname
ม	m	a thai alphabet with an 'm' sound
มกราคม	януари	january
มจก	м	the most illustrious order of the royal house of chakri
มณฑลหูหนาน	хунан	hunan in china
มณีวรรณ	maniwan	maniwan
มด	мравка	ant
มดลูก	матка	uterus
มต้น	започвам	primary level of secondary school
มธ	ту	abbreviation for thammasat university
มธรรมศาสตร์	thammasat university	thammasat university
มน	кръгъл	two letters acronym
มนุษย์	мъж	human
มนุษย์กลายพันธุ์	mutant	human mutant
มนเรศวร	naresuan	naresuan university
มปท	nps	acronyms
มม	мм	mm
มมหิดล	университет махидол	mahidol university
มยุรา	паун	mayura - a female's name
มลายู	малайски	malayu
มวยปล้ำ	борба	wrestling
มสงขลานครินทร์	принцът на сонгкла	prince of songkla university
มหัพภาค	цялостен	a symbol used in thai writing
มหาชน	обществен	public company
มหาชัย	mahachai	mahachai - male's name
มหาบัณฑิต	майстор	graduates from college
มหาปรมาภรณ์ช้างเผือก	maha paramaporn chang phueak	highest class of the order of white elephant
มหาวชิรมงกุฎ	корона махаваджира	the biggest crown of the king
มหาวรรค	маха буда	mahavak - a buddhist priest
มหาวิทยาลัย	университет	university
มหาวิทยาลัยขอนแก่น	университет кхон каен	khon kaen university
มหาวิทยาลัยทักษิณ	университет таксин	thaksin university
มหาวิทยาลัยนเรศวร	университет наресуан	naresuan university
มหาวิทยาลัยบูรพา	университет бурафа	university
มหาวิทยาลัยปทุมธานี	университет pathum thani	pathumthani university
มหาวิทยาลัยพะเยา	университет фаяо	prayao university
มหาวิทยาลัยภูมินทร์พนมเปญ	университет фюмин, пном пен	university of phnom penh
มหาวิทยาลัยมหาจุฬาลงกรณราชวิทยาลัย	mahachulalongkornrajavidyalaya university	chulalongkorn university
มหาวิทยาลัยมหาสารคาม	университет маха саракам	mahasarakham university
มหาวิทยาลัยมหิดล	университет махидол	mahidol university
มหาวิทยาลัยรังสิต	университет рангсит	rangsit university
มหาวิทยาลัยราชภัฏบ้านสมเด็จเจ้าพระยา	bansomdejchaopraya университет в раджабхат	rajapak bahn somdej jao praya college
มหาวิทยาลัยราชภัฏสงขลา	сонгкхла раджабхат университет	songkhla rajabhat university
มหาวิทยาลัยราชภัฏสวนสุนันทา	университет суан сунанда раджабхат	suan sunandha rajabhat university
มหาวิทยาลัยราชภัฏอุตรดิตถ์	уттарадит раджабхат университет	uttaradit rajabhat university
มหาวิทยาลัยราชภัฏเทพสตรี	университет тепсатри раджабхат	thepsatri rajabhat university
มหาวิทยาลัยราชภัฏเลย	университет лоей раджабхат	loei rajabhat university
มหาวิทยาลัยวงษ์ชวลิตกุล	университет вонгхавалиткун	vongchavalitkul university
มหาวิทยาลัยศรีนครินทรวิโรฒ	университета сринахаринуиро	srinakarinvirot university
มหาวิทยาลัยศรีปทุม	университет срипатум	sripatum university
มหาวิทยาลัยศิลปากร	университет силпакорн	silapakorn university
มหาวิทยาลัยสุโขทัยธรรมาธิราช	sukhothai thammathirat open university	sukhothai thammathirat open university
มหาวิทยาลัยอีสาน	североизточен университет	issan univbersity
มหาวิทยาลัยอุบลราชธานี	университет ubon ratchathani	ubon ratchathani university
มหาวิทยาลัยอ๊อกซฟอร์ด	университета в оксфорд	university of oxford
มหาวิทยาลัยเกษตรศาสตร์	казецарт университет	kasetsart university
มหาวิทยาลัยเทคโนโลยีพระจอมเกล้าพระนครเหนือ	техническият университет на крал mongkut северен бангкок	king mongkut's university of technology.
มหาวิทยาลัยเทคโนโลยีราชมงคลกรุงเทพ	rajamangala university of technology krungthep	rajamangala university of technology krungthep
มหาวิทยาลัยเทคโนโลยีราชมงคลตะวันออก	раджамангала технологичен университет таван-ок	the eastern university of teachnology
มหาวิทยาลัยเทคโนโลยีราชมงคลธัญบุรี	техническият университет в раджамангала, тенябури	rajamangala university of technology thanyaburi
มหาวิทยาลัยเทคโนโลยีราชมงคลสุวรรณภูมิ	техническият университет в раджамангала suvarnabhumi	techonology university at rajamongkolsuwannapoom
มหาวิทยาลัยเทคโนโลยีราชมงคลอีสาน	технологическият университет в раджамангала исан	rajamangala university of technology isan
มหาวิทยาลัยเปิด	отворен университет	open university
มหาวิทยาลัยแม่โจ้	университета maejo	mae joe university
มหาวิทยาลัยแห่งแรกของประเทศไทย	първият университет в тайланд	first university of thailand
มองโกเลียใน	вътрешна монголия	mongolia
มอร์ริส	morris	morris
มอส	мъх	mos
มอสส์	мъх	moss
มอหาดใหญ่	мор хат яй	had yai city in southern thailand
มะขาม	тамаринд	tamarind
มะม่วงหิมพานต์	кашу	mango (anacardium occidentale)
มะริด	myeik	myeik
มะเร็ง	рак	cancer
มังกี้	маймуна	monkey
มังคุด	мангостан	mangosteen
มัจฉานุ	matcha	majjanu - the son of the giant in a thai legend.  majanu is half monkey and half fish.
มัชฌิมาปฏิปทา	среден път	the middle way
มัทนะพาธา	мутана фата	matthanaphatha
มัธยฐาน	медиана	mode (as in statistic)
มัธยมศึกษา	средно образование	junior high school
มัธยมศึกษาปีที่	9 клас	secondary school year
มันติคอร์	manticore	manticore
มัลเจร่า	malera	wonderweiss margera - a cartoon character
มากกว่า	над	more than
มากที่สุด	повечето	most abundant
มากิ	maki	magi osuki - the artist
มาครอส	macross	macross
มาจยาร์	mayar	magyar
มาจากภาษาละติน	от латиница	from latin root
มาซากิ	масаки	masaki
มาดริด	мадрид	madrid
มาตรฐาน	стандарт	standard
มาตรา	раздел	article
มานี	много	mani - a thai name
มายน์ส	mines	mine
มาริสา	мариса	marissa
มาริเบล	марибел	maribel
มาร์ช	блато	march
มาร์ติน	лястовица	martin
มาร์ตินีก	мартиника	martinique
มาร์แชล	маршал	marshall
มาลัยพร	малайско порно	malaiphon
มาลากุล	malakul	malakul
มาลี	мали	flower
มาสคาร่า	спирала за очи	mascara
มาเก๊า	макао	macao
มาเฟีย	мафия	mafia
มาเรีย	мария	maria
มาเลเซีย	малайзия	malaysia
มาเลเซียตะวันตก	западна малайзия	west malaysia
มิจิรุ	мичиру	mijiru
มิตร	приятелски настроен	mitr
มิตรชัย	mitchai	mitchai
มิตรเพชรา	приятелски настроен	mit pechara - two of famous actors in the old time
มิถุนายน	юни	june
มินต์	мента	mint
มิลจิ	milji	mulji
มิลตัน	милтън	milton
มิลฟีโอเล่	милфи оле	millefiore
มิลลิเมตร	мм.	millimeter
มิลินทจินดา	milinthinda	milinjinda - a surname of a singer
มิล่า	мила	mila
มิว	мяукане	mu
มิวฟิลโอเล่	муле фил оле	millefiore
มิวสิกวีดีโอ	музикален клип	music video
มิสทีน	mistine	mistine
มิฮอว์ค	mihawk	mihawk - surname of a character in a japanese movie
มิเกล	мигел	miguel
มิเชล	мишел	michelle
มิเตอร์	метър	meter
มิโร	миро	miro - name
มีขนาดใหญ่	голям	big
มีข้อความว่า	етикетирани	inscription reads
มีความยาว	имайте дължина	has length of
มีความหมายว่า	значение	meaning
มีจำนวน	имайте номер	have the amount of
มีฉายาว่า	с прякора	famous for...
มีชื่อว่า	на име	is called
มีชื่อเล่นว่า	наречен	nick name
มีด	нож	knife
มีดาบฟันวิญญาณ	с дух меч	have a sword to fight the ghost
มีทั้งสิ้น	всичко	own, available
มีทิวเขาล้อมรอบทางเหนือ	с планински вериги на север	surrounded by the mountains in the north
มีน	min	min - a nick name
มีนบุรี	мин бури	minburi province
มีนวิทยา	minology	ichthyology
มีนายกรัฐมนตรี	имайте премиер	have a prime minister
มีประวัติศาสตร์ยาวนาน	има дълга история	having a long history
มีพรมแดนทางทิศใต้จรดกับอ่าวไทย	граничи на юг с тайландския залив	having boundaries adjacent to the gulf of thailand
มีภูเขาล้อมรอบอยู่	заобиколен от планини	surrounded by mountains
มีลักษณะดังนี้	има следните характеристики	has following characteristics
มีลักษณะภูมิประเทศคล้ายชามหรืออ่าง	има функции като купа или леген	have topography like bowl or basin
มีลาภ	имайте цяло състояние	milap
มีล่า	имайте лов	mila
มีสูตรการคำนวณหาจำนวนฟัน	има формула за изчисляване на броя на зъбите.	dental formula
มีอยู่	съществувам	possess, present
มีอุณหภูมิเฉลี่ย	средна температура	average temperature
มีอุทยานแห่งชาติสำคัญหลายแห่ง	има много важни национални паркове.	has many important national parks
มีเดีย	средства	media
มีโคลซีน	със сцена на коул	meclozine
มือ	ръка	hand
มู	smooth	mu
มูลนิธิชัยพัฒนา	фондация чайпатана	chaipattana foundation
มูลนิธิอานันทมหิดล	фондация анандамахидол	the king's charities
มูลสาร	основи	munsan
มเชียงใหม่	чианг май	chaing mai university
มโนราห์	manohra	thai dance art
ม้า	кон	horse
ม้าม	далак	spleen
ย	най-	a thai alphabet with the y sound
ยกเว้น	с изключение	except
ยศ	ранг	rank
ยอด	елит	super, great
ยอดนักสืบจิ๋วโคนัน	детектив конан	conan the detective
ยอดเขาสูงที่สุดของกัมพูชาคือ	най-високият връх на камбоджа е	highest mountain in cambodia
ยอพระกลิ่น	йор фра клин	yorpaglin - name of a story
ยัง	да се	young
ยาขับปัสสาวะ	диуретичен	diuretic pills
ยาง	каучук	rubber, tire
ยางธรรมชาติ	естествен каучук	natural rubber
ยางามิ	yagami	yangami
ยานอนหลับ	приспивателни	sleeping pills
ยานอวกาศ	космически кораб	rocket ship
ยาบ้า	амфетамин	ya ba
ยาปฏิชีวนะ	антибиотици	antibiotic
ยามาโตะ	yamato	yamato - a japanese name
ยามาโมโตะ	ямамото	yamamoto
ยามเย็น	вечер	sundown, evening time
ยิ่งยง	yingyong	yingyong - a first name
ยิ่งลักษณ์	yingluck	yingluck
ยิ้มสู้	усмихни се	smile fight
ยีน	ген	gene
ยืนยง	търпя	(inthira) yeenyong - lead singer of budogun band
ยุคกลาง	средна възраст	middle age
ยุคก่อนประวัติศาสตร์	праисторическа епоха	prehistory
ยุคที่	ера	age
ยุคปัจจุบัน	модерни времена	present age
ยุคศตวรรษที่	вековна ера	century
ยุคสามก๊ก	ера на три царства	three kingdoms - the legend
ยุคอะซึกะ	ера асука	asuka period
ยุคอาณาจักรเหนือใต้	епоха на северното и южното кралство	north-south dynasty
ยุคเรเนสซองส์	възраждането	renaissance
ยุคเฮอัง	хейан ера	heian period of japan
ยุคโบราณ	древни времена	ancient history
ยุคโลหะ	метална епоха	metal age
ยุคใหม่	нова епоха	new age
ยุทธนาวี	битката на флота	naval battle
ยุวธิดา	млада дъщеря	yuwatidah
ยุ้ย	преувеличен	yui
ยู	u	u
ยูกิโอ	юкио	yu-gi-oh
ยูฟ่า	уефа	uefa
ยูริ	юри	yuri -  a japanese name
ยูโด	джудо	judo
ยูโรเพียม	европий	europium
ยูไนเต็ด	обединен	united
ย่านตาขาว	ян хао	yan ta khao
รณชัย	ronnachai	ronnachai
รณภพ	свят	ronapop
รณฤทธิ์	битка	ranariddh
รถด่วนสายทางช้างเผือก	млечният път експресен автобус	galactic express
รถประจำทางสาย	автобусна линия	bus number
รถยนต์อเนกประสงค์	многофункционална кола	automobile
รถลาก	рикша	pulled rickshaw
รถโดยสารประจำทาง	автобус	passenger bus
รถโดยสารประจำทางสาย	автобусна линия	bus
รถไฟฟ้าชานเมืองสายสีแดงอ่อน	предградие с червена светлина	rapid transit light red line
รถไฟฟ้ามหานคร	господин т	metropolitan rapid transit
รฟม	обратна осмоза	public transit
รวดเร็ว	бърз	rapid
รวม	да включва	total
รวมกับ	комбинирано с	add to
รวมทั้ง	включително	include
รวมทั้งประเทศที่ให้ความช่วยเหลืออื่นๆ	включително държави, които предоставят друга помощ	the countries that provided helps
รวมทั้งสิ้น	общо	result
รวมระยะทางทั้งสิ้น	общо разстояние	total distance
รศ	сътрудник	ratanakosin era
รหัส	код	code
รอก	макара	roack
รองประธานรัฐสภาคนที่หนึ่ง	първи вицепрезидент на парламента	an assistant head of a thai governmental committee
รองประธานสภาคนที่สอง	втори вицепрезидент на съвета	second vice chairman
รองเท้า	обувки	shoes
รอญับ	изчакайте	seventh month of the hijra calendar
รอบ	около	surrounding
รอบคอบ	внимателно	careful
รอบชิงชนะเลิศระดับประเทศ	национални финали	national final round
รอบที่	кръгъл	round
รอบเมือง	около града	around town
ระดับกระโดดสูง	висок скок	high jump  height
ระดับการกระโดดสูง	висок скок	high jump
ระดับปริญญาเอก	докторска степен	doctorate degree level
ระดับปริญญาโท	магистърска степен	master's degree
ระดับมัธยมศึกษา	вторично ниво	middle school level
ระดับอาชีวศึกษา	професионално ниво	vocational education
ระนอง	ранонг	ranong
ระนาด	ксилофон	ranad - a thai musical instrument
ระนาดทุ้ม	алто ксилофон	a type of thai musical instrument
ระนาดเอก	алт	ranad eg -  a thai musical instrument
ระบบ	система	system
ระบบกษัตริย์ของกัมพูชา	камбодска монархия	cambodian monarchy
ระบบรัฐสภา	парламентарна система	rajya sabha system of governing
ระบบสืบพันธุ์	репродуктивна система	reproductive system
ระบบสุริยะ	слънчева система	solar system
ระบบโครงกระดูก	скелетна система	skeletal system
ระบบใช้อำนาจเด็ดขาด	абсолютна система за захранване	despotism
ระยะ	фаза	phase
ระยะเวลา	продължителност	period
ระยะเวลาการดำรงตำแหน่ง	срок на обслужване	the term in the office
ระวิ	между	rawi
ระหว่างปี	през годината	between the year
ระหว่างสงครามโลกครั้งที่	по време на световната война	during wold war
ระเบียง	балкон	bhirasri
ระเบียบ	поръчка	regulation
ระโนด	мъртъв	ranode (name of district in thailand)
รักษาศีล	спазвайте предписанията	keep the precepts
รักษาสิ่งแวดล้อม	пазете околната среда	protect the environment
รักแห่งสยาม	любовта на сиам	love thailand
รังสิตคลอง	rangsit khlong	rangsit canal
รังสี	лъч	radiation
รังสีเอกซ์	рентгенов	xray
รังสีแกมมา	гама лъч	gamma ray
รัชกาลที่	reign	rama
รัชกาลสมเด็จพระจุลจอมเกล้าเจ้าอยู่หัว	царство на чулалонгкорн	king chula chomklao's reign
รัชดาภิเษก	ratchadaphisek	rajada pisek - a location in thailand
รัฐธรรมนูญแห่งราชอาณาจักรไทย	конституция на кралство тайланд	constitution of the kingdom of thailand
รัฐบาลไทย	тайландско правителство	thai government
รัฐบุรุษ	държавник	statesman
รัฐประหาร	преврат	coup d'état
รัฐประหารในประเทศไทย	преврат в тайланд	thailand's coup d'état
รัฐมนตรีว่าการกระทรวงคมนาคม	министър на транспорта	transportation secretary of thailand
รัฐวิสาหกิจ	държавно предприятие	financial situation of the country
รัฐวิสาหกิจไทย	тайландски държавни предприятия	thai state enterprise
รัฐสภา	парламент	parliament
รัฐสีมาคุณากรปิยชาติ	ратасима kunakornpiyachat	ratthasimakhunakonpiyachat
รัฐอิลลินอยส์	илинойс	state of illinois
รัฐเทกซัส	texas	state of texas
รัตนบุรี	rattanaburi	ratanaburi district - a location in thailand
รัตนาธิเบศร์	ратанатхибет	ratana thibet
รับบทโดย	изигран от	played by
รับพระราชทาน	приемам	receive
รัศมี	радиус	radius
รัสเซล	ръсел	russell
รากแก่น	основен корен	rakkan
รางวัลนักร้องยอดเยี่ยม	награда за най-добър певец	best singer award
รางวัลนักร้องไทยสากลชายยอดนิยม	популярна награда за мъжки международен певец на тайланд	best thai male singer award
รางวัลนาฏราช	награди на royal dancer	naktarath prize
รางวัลโนเบล	нобелова награда	nobel prize
รางวัลไนน์เอ็นเตอร์เทน	награда за девет забавления	nine entertain awards
ราชตระกูล	кралско семейство	royal family
ราชนาวี	военноморски флот	royal navy
ราชมังคลากีฬาสถาน	стадион раджамангала	rajamangala national stadium
ราชวงศ์จิ้นตะวันออก	източна династия джин	east jin dynasty
ราชวงศ์ชิง	династия цин	ching dynasty
ราชวงศ์ถัง	династия тан	tang dynasty
ราชวงศ์ทิพย์จักราธิวงศ์	кралското семейство, chakrathiwong	thipjaklatiwong dynasty
ราชวงศ์บ้านพลูหลวง	кралска къща на plu luang	ban phlu luang dynasty
ราชวงศ์พระร่วง	династия фра руанг	pra roung dynasty
ราชวงศ์หยวน	династия юан	yuan dynasty
ราชวงศ์อู่ทอง	династия u-thong	utong empire in ancient thailand
ราชสกุล	знаците	royal family members
ราชสีมา	ratchasima	ratchasima
ราชินิกุล	роднини на кралицата	relatives of the queen
ราบเป็นหน้ากลอง	бъдете обикновени	flattened like a drum (meaning to be defeated)
รามอินทรา	ramintra	ram inthra
รายการ	списък	show
รายการวันสำคัญทางพุทธศาสนา	списък на важните будистки дати	important days in buddhism
รายชื่อ	списък	list of the names
รายชื่อคำในภาษาไทยที่มักเขียนผิด	списък на тайландски думи, които често са написани неправилно	common misspelled thai words
รายชื่อภาพยนตร์ไทย	списък на тайландски филми	a list of thai movies
รายชื่อหุ่นยนต์ใน	списък на роботи в	name of robots
รายชื่ออธิการบดี	списък на канцлерите	list of presidents
รายชื่อเพลง	списък с песни	songs list
รายนามรองอธิการประจำวิทยาเขต	списък с имената на заместник-ректора на кампус	llist of deputy directors of the college
รายนามอธิการบดี	списък на президента	chancellor list
รายพระนามพระมหากษัตริย์ไทย	списък на тайландските крале	list of thai monarchs
รายะนาค	рая нак	rayanak
รายได้อื่น	други доходи	other wages, incomes
ราวพุทธศตวรรษที่	около века	about buddhist era
ราศีธนู	стрелец	sagittarius
รำพันพิลาป	вик	poem called rum pan pi lab
ริน	изливам	rin
ริมแม่น้ำเจ้าพระยา	река чао прая река	near chao praya river
ริวซากิ	ryuzaki	riusaki - from japanese story
ริเอะ	рие	rie tanaga - a japanese singer
รีสอร์ท	курорт	resort
รีเนียม	рений	rhenium
รุจิพรรณ	rujipan	pan - a name
รุ่ง	разсъмване	dawn
รุ่งสว่าง	разсъмване	rungsawang
รุ่งเพชร	rung petch	roongpetch - a female's name
รูดอล์ฟ	рудолф	rudolf
รูทีเนียม	рутений	ruthenium
รูปภาพ	изображение	picture
รูปร่าง	форма	body
รูปวรรณยุกต์	тонална форма	tones
รูปสามเหลี่ยมมุมป้าน	тъп триъгълник	obtuse
รูปสี่เหลี่ยมด้านขนาน	успоредник	a paralellogram
รูสเวลต์	рузвелт	roosevelt
ร็อดฟอร์ม	форма на пръчки	rock form
ร่วมแสดงกับ	изпълнете с	costarring
ร้องคู่กับ	пейте заедно с	sing a duet with
ร้องร่วมกับ	пейте с	featuring
ร้องโดย	изпята от	sung by
ร้อยตรี	втори лейтенант	second lieutenant
ร้านอาหาร	ресторант	restaurants
ฤดูกาล	сезонът	season
ฤดูฝน	дъждовният сезон	rainy season
ฤดูร้อน	горещ сезон	summer
ล	най-	a thai alphabet with an l sound
ลงวันที่	насрочено	on this date
ลพบุรี	lop buri	lopburi
ลอนดอน	лондон	london
ลอยกระทง	фестивалът лой кратонг	loy kratong festival
ลอร์ด	господ	lord
ละคร	драма	play
ละครชาตรี	чатри драма	lakorn-chatri
ละครวิทยุ	радио драма	soap opera broadcasted on the radio
ละครสั้น	кратка драма	short drama
ละครเพลง	музикален	stage musical theatre
ละครโทรทัศน์	сапунен сериал	television drama
ละติจูด	географска ширина	latitude
ลักษณะ	виж	characteristic
ลักษณะทั่วไป	основни характеристики	common characteristic
ลักษณะทางกายภาพ	физически характеристики	physical characteristics
ลักษณะภูมิอากาศ	климат	the type of climate
ลักษณะสำคัญ	важни характеристики	main characteristics
ลักเซมเบิร์ก	люксембург	luxembourg
ลัคนา	асцедент	ascendant
ลา	ла	goodbye
ลานจาตุรงคสันนิบาต	четириъгълник	lan jaturonsunnibat - an ancient place in india
ลามิวูดีน	lamiwoodine	lamivudine
ลายน้ำ	воден знак	watetmark
ลาว	лаос	lao
ลาออก	оставка	resign
ลำดับ	поръчка	order, sequence
ลำดับพระปฐมวงศ์ในพระบรมราชวงศ์จักรี	ред на генезиса в династията чакри	order of the kings
ลำดับพระมหากษัตริย์ไทย	орден на краля на тайланд	the order of the kings of thailand
ลำตัว	багажник	body
ลำลูกกา	лам лука ка	lumlookka - a location in thailand
ลำลูกกาคลอง	канал лам лука ка	lum luk kak klong
ลำไส้เล็ก	тънко черво	small intestine
ลิง	маймуна	monkey
ลิซท์	лист	(franz) liszt
ลิปปี	година на устните	rippi - a surname
ลิพิด	lipid	lipid
ลิฟวิ่งมอลล์	living mall	living mall
ลิเก	музикална народна драма	like
ลิเทียม	литий	lithium
ลีกคัพ	купа на лигата	league cup
ลีซอ	лису	lisu
ลีเมอร์	лемур	lemur
ลี้	ли	lee, a district in lumpoon province.
ลี้สุวรรณ	ли суван	lisuwan
ลุงบุญมีระลึกชาติ	чичо бунми припомни нацията	uncle boonmee who can recall his past lives
ลูกปัด	мънисто	beads
ลูกสาว	дъщеря	daughter
ลูกอม	бонбони	candies
ลูกอัณฑะ	тестисите	testis
ลูซิเฟอร์	луцифер	lucifer
ลูน่า	luna	luna
ล่าทา	на лов	lata
ล่ำซำ	буца	lumsum
ล้อม	около	lom
ล้อแม็กซ์อัลลอยขนาด	размери на лети джанти	alloy wheel
วง	контур	band
วงจรไฟฟ้า	електрическа верига	electrical circuit
วงดนตรี	банда	band
วงศ์กำแหง	семейство	wongkumhang - surname of a famous singer
วงศ์ถั่ว	орехово семейство	fabaceae
วงศ์ปลากดทะเล	семейство риби	ariidae
วงศ์ปลากะรัง	групиране	serranidae family
วงศ์ปลายอดม่วง	вонг пла йот муанг	tonguefish
วงศ์ปลาหลังเขียว	зелена риба	clupeidae - a type of fish
วงศ์ปลาเนื้ออ่อน	cichlid	siluridae
วงศ์ปลาเสือตอ	семейство тигрови риби	datnioididae
วงศ์พัวพันธ์	вонгпуа фан	wongpourpan
วงศ์วิริยะ	wiriya	vongsiriya - a surname
วงศ์เทวัญ	семейство	wongthewan
วงศ์แคหางค่าง	wong khae hang kong	plants in kae-hang-kang family
วงษ์คำเหลา	вонг хам лао	wongkamlao
วงเงิน	лимит	budget
วงเวียน	обиколен	circle
วงแหวน	пръстен	ring form, circle form
วชิรบรรจง	wachirabunjong	wachibanjong
วทบ	dd	bachelor of science
วนอุทยานถ้ำจัน	tham chan forest park	tham chan forest park
วนิดา	wanida	wanida - the name of a drama
วร	wor	won
วรรณกรรม	литература	literature
วรรณสุทธิ์	wansut	wannasut - surname of an actress
วรรธนพิสิฐกุล	уатън физиткун	wanthanaphisitkun
วรัทยา	warutya	varattaya (first name)
วว	дд	office of ____________
วอก	маймуна	wok
วองโกเล่แฟมิลี	семейство вонгола	vongola family
วอชิงตัน	вашингтон	washington
วอลท์	walt	walt
วอล์ค	разходка	walk
วะสี	бях ли	wasee
วัง	дворец	palace
วังจันทร์	ван чан	wang-chan
วังสระปทุม	дворец sra pathum	srapathum palace
วังสะพุง	уанг сафунг	wang saphung
วังหลัง	дворец	wang lang
วังหิน	каменният дворец	rock castle
วัชรพล	watcharapol	watcharapol supermarket
วัฒนชัย	watthanachai	wattanachai - a surname
วัฒนธรรม	култура	culture
วัฒนวิทูกูร	wattanawitkun	watthanawithukun
วัฒนา	wattana	wattana
วัดกลาง	среден храм	wat klang
วัดป่าเลไลยก์วรวิหาร	wat pa lelai worawihan	wat palaylay
วัดพระธาตุดอยสุเทพราชวรวิหาร	wat phra that doi suthep, ratchaworawihan	wat pratatdoisuthep rachavoravihan - the temple erected on top of doi suthep in northern thailand
วัดพระฝางสวางคบุรีมุนีนาถ	wat phra fang sangkhaburi muninat	prhafangsawangkaburimuninat temple
วัดพระมหาธาตุวรมหาวิหาร	wat phra mahathat woramahaviharn	wat phramahathat woramahawihan
วัดพระยืนพุทธบาทยุคล	wat phra yuen phutthayakhon	the standing buddha temple of puttabatyukol
วัดพระลอย	храм phra loi	wat phra loi
วัดพระศรีรัตนมหาธาตุ	wat phra si rattana mahathat	wat phra si rattana mahathat
วัดพระเชตุพนวิมลมังคลารามราชวรมหาวิหาร	wat phra chetuphon vimolmangklararam ratchaworamahawihan	wat pra chetpnvimolmungklaramrajavoramahavihan
วัดระฆังโฆสิตาราม	храм ракхангкозарам	wat rakang kositaram (name of temple)
วัดสองพี่น้อง	храмът на фи нонг	two siblings temple
วัดสุทัศนเทพวรารามราชวรมหาวิหาร	храмът на сутасан теп варарам	wat sutatthepvararamrajavorimahavihan - a temple in thailand
วัดหนองเพียร	храм нонг фиан	wat nong pien - a temple in thailand
วัดหน้าพระธาตุ	na phra този храм	wat na pra tat - a buddhist temple
วัดเจดีย์หลวง	храмът чеди луанг	wat pagoda
วัดโพธิ์	ват фо	wat po - a thai temple
วัตต์	ват	watt
วัตสัน	уотсън	watson
วัน	ден	day
วันชัย	wanchai	wanchai - a male's name
วันที่ขึ้นเครื่องหมาย	дата на подписване	excluding dividend day
วันที่ออกอากาศชื่อตอนแขกรับเชิญ	дата на излъчване, име на епизод, поява на гост	when the invitation comes out
วันที่เข้าฉาย	дата на излизане	release date
วันนี้ที่รอคอย	чакам днес	the day that one has been waiting for
วันพฤหัสบดี	четвъртък	thursday
วันพุธ	сряда	wednesday
วันมหาสงกรานต์	ден на маха сонгкран	songkran day
วันละ	ден	per day
วันศุกร์	петък	friday
วันสงกรานต์	ден на сонгкран	songkran day
วันสำคัญ	важен ден	important day
วันสำคัญทางพุทธศาสนา	важен будистки ден	buddhist holidays
วันหยุดราชการ	официален празник	national holiday
วันอังคาร	вторник	tuesday
วันอาทิตย์	неделя	sunday
วันอาสาฬหบูชา	асанга буча	asalha puja
วันเกิด	рожден ден	birthday
วันเสาร์	събота	saturday
วันแรม	ден	the phase of the moon
วัย	на възраст	age
วัลลิโภดม	walliphodom	wanliphodom
วัสดุฟิสไซล์	делящ се материал	fissile material
วานูอาตู	вануату	vanuatu, australia
วารินชำราบ	warinchamrap	warinchamrap
วาลคิรี	валкирия	valkyrie - angel that helped in valhalla war
วาลีน	валин	valine - a type of protein
วาเรีย	varia	varia
วาเลนไทน์	валентин	valentine
วาไรตี้	разнообразие	variety
วิกตอร์	победител	victor
วิคตอเรีย	виктория	victoria
วิจัย	изследване	investigate, study
วิจิตรศิลป์	изящни изкуства	fine art
วิชาการ	академичен	academic
วิชาการคอม	академичен компютър	vcharkarn.com
วิชิต	wichit	wichit - a male's name
วิญญาณ	дух	soul
วิฑูรย์	лапис лазули	witoon
วิดีโอเกม	видео игра	video game
วิตามินอี	витамин е	vitamin e
วิทยาการคอมพิวเตอร์	информатика	computer courses
วิทยาการระบาด	епидемиология	epidemiology
วิทยาลัยการจัดการเพื่อการพัฒนา	колеж за мениджмънт за развитие	management for development college
วิทยาลัยการบริหารรัฐกิจ	колеж по публична администрация	management college
วิทยาลัยครูสวนสุนันทา	учителски колеж суан сунанда	soun sunanta teachers college
วิทยาลัยดุริยางคศิลป์	музикален колеж	college of music
วิทยาลัยนวัตกรรมและการจัดการ	колеж за иновации и управление	the college specialized in arts
วิทยาลัยพยาบาลกองทัพเรือ	военноморски сестрински колеж	royal thai navy college of nursing
วิทยาลัยพยาบาลบรมราชชนนี	boromarajonani college of nursing	nursing university of barom raj chonnani
วิทยาลัยพาณิชยศาสตร์	търговски колеж	panitsat university
วิทยาลัยวิชาการศึกษา	колеж по образование	college of education
วิทยาลัยเทคนิคธนบุรี	технически колеж тонбури	king mongkut's university of technology thonburi
วิทยาลัยแพทยศาสตร์พระมงกุฎเกล้า	phramongkutklao медицински колеж	phramongkutklao college of medicine
วิทยาศาสตรมหาบัณฑิต	магистър на науките	master of science
วิทยาศาสตร์สุขภาพ	здравна наука	health science
วิทยาศาสตร์และเทคโนโลยี	науката и технологиите	science and technology
วิทยาเขต	кампус	campus
วิทยาเขตกาญจนบุรี	камчанабури кампус	kanchanaburi college
วิทยาเขตนครศรีธรรมราช	кампус nakhon si thammarat	nakhon si thammarat campus
วิทยาเขตพิษณุโลก	phitsanulok campus	pissanulok college
วิทยาเขตสารสนเทศเพชรบุรี	кампус за информационни технологии phetchaburi	information technology college of petchaburi
วิทยาเขตสุพรรณบุรี	кампус suphanburi	suphanburi campus
วิทยาเขตสุรินทร์	кампус сурин	surin university
วิทยาเขตหนองคาย	nong khai campus	nong kai university
วิทยาเขตเฉลิมพระเกียรติ	chaloem phrakiat campus	vittaya kat chalerm pra kiet - a location at kasetsat university in thailand
วิทยุ	радио	radio
วิธีการหาความสัมพันธ์	как да намерите връзки	formula for the correlation coefficient
วินชี	винчи	vinci
วินัย	дисциплина	manners
วินเนอร์	победител	winner
วิบูลย์	довиждане	wibul - a male's name
วิมเบิลดัน	уимбълдън	wimbledon
วิลลี่	willy	willy
วิลเลจ	село	village
วิลเลียม	уилям	williams
วิลเลี่ยม	уилям	william
วิวัฒนาการ	еволюция	evolution
วิวัฒน์	evolve	produce, making up, invent
วิวัฒน์เกียรติ	wiwat kiat	wiwatkiat
วิศว	инженерство	engineering
วิศวกร	инженер	engineer
วิศวกรรมวัสดุ	материално инженерство	material engineering
วิศวกรรมสิ่งแวดล้อม	екологично инженерство	environmental engineering
วิศวกรรมเครื่องกล	машиностроене	engineering
วิศวกรรมไฟฟ้า	електроинженерство	electrical engineering
วิสา	wisisa	wisa
วิสูตร	диагностичен	wisut
วิหาร	светилище	vihara
วิเศษ	магия	wiset
วิเศษแก้ว	магическо стъкло	visetkeaw - surname of a singer
วิโนทัย	vinothai	winothai
วีดีโอ	видео	video
วีดีโอเกม	видео игра	video game
วีรบุรุษ	герой	hero
วีระ	veera	veera
วีระยุทธ	wirayut	werayut - a male's name
วีออส	vios	vios
วุฒิสภา	сенат	senate
วุฒิเมธี	wuttimethi	wuttimethi - a surname
ว้าวุ่น	разсеян	wawun
ศ	проф	a thai alphabet
ศร	стрелка	arrow
ศรชัย	sornchai	sornchai - a male's name
ศรายุทธ	sarayuth	sarayut - a male's name
ศรีนครินทร์	srinakarin	srinakarin
ศรีนวล	srinual	sinuan
ศรีบุญเรือง	шри бунрюанг	si bun rueang
ศรีประจวบ	си прачуап	siprachuap
ศรีปาน	шри пан	sri pan - a surname
ศรีมะฆะ	шри маха	sirimaka - a thai name
ศรียาภัย	sriyapai	siyaphai
ศรีสวัสดิ์	srisawat	srisawat -  a surname
ศรีสำโรง	си самронг	si samrong
ศรีเมือง	шри муанг	srimuang
ศรีไพร	шри фрай	sri prai - a name
ศรเพชร	диамантена стрелка	sonpet
ศศิธร	саситорн	sasitorn - a females name
ศักดิ์ศรี	престиж	dignity
ศักย์ไฟฟ้า	електрически потенциал	electric potential
ศัพท์	терминология	vocabulary
ศาลชั้นต้น	граждански съд	curcuit court
ศาลหลักเมือง	градски стълб	the old court house
ศาลเจ้าพ่อหลักเมือง	градски стълб	the city's god
ศาสตราจารย์	професор	professor
ศาสนา	религия	religion
ศาสนาพราหมณ์ฮินดู	индуизъм	hindu religion
ศาสนาฮินดู	индуизъм	hinduism
ศาสนาโซโรอัสเตอร์	зороастризма	zoroastrianism
ศิริวรรณ	siriwan	siriwan - a female's name
ศิลปอาชา	art archa	silpa-archa
ศิลปะ	изкуство	arts
ศิลปะการแสดง	изпълнително изкуство	performing arts
ศิลปะลพบุรี	art lopburi	lopburi art
ศิลปะศรีวิชัย	srivijaya art	arts from sri vi chai province
ศิลปะเขมร	кхмерско изкуство	cambodian arts
ศิลปะเครื่องปั้นดินเผา	керамично изкуство	pottery art
ศิลปะเชียงแสน	чианг саен арт	chaingsan art
ศิลปินแห่งชาติ	национален художник	national artist
ศิลป์	изкуство	silpa
ศิษย์เก่าคณะมนุษยศาสตร์	възпитаници на хуманитарния факултет	former humanity student
ศิษย์เก่าคณะรัฐศาสตร์	възпитаници на политическите науки	faculty of political science alumni
ศิษย์เก่าคณะเศรษฐศาสตร์	възпитаници на икономическия факултет	economics alumni
ศีรษะ	глава	head
ศึกนันทบุเรง	нантабуренг битката	suknuntabureng -  a war in thailand
ศึกษาศาสตร์	образование	field of education
ศุกลวัฒน์	sukonwat	sukolawat (a person's name)
ศุภกิจ	supakit	supphakit
ศุภณัฐ	suphanat	supanat (first name)
ศูนย์	център	center
ศูนย์การค้า	търговски център	shopping center
ศูนย์การบินทหารบก	армейски авиационен център	marine forces
ศูนย์การศึกษาแม่ฮ่องสอน	образователен център mae hong son	maehongsorn learning center
ศูนย์คอมพิวเตอร์	компютърен център	computer center
ศูนย์ค้าส่ง	център за търговия на едро	wholesale center
ศูนย์บริการวิชาการ	академичен сервизен център	academic service center
ศูนย์ภาษา	езиков център	language center
ศูนย์รังสิต	rangsit center	rangsit university center
ศูนย์ลำปาง	център лампанг	lampang center
ศูนย์แพทยศาสตรศึกษาชั้นคลินิก	образователен център по клинична медицина	medical education center
สก	винт	abbreviation of two letters
สกว	рф	trf
สกอ	шотландия	office of higher education commission
สกอตแลนด์	шотландия	scotland
สกาย	небе	sky
สกุล	семейство	sakun
สกุลหยาดน้ำค้าง	росянка	d. etrythrorhiza - a type of plant
สกุลเพชรหึง	petcheng	grammatophyllum
สควอโล่	squalo	squalo
สงคราม	война	war
สงครามครูเสด	кръстоносен поход	crusades war
สงครามมหาเอเชียบูรพา	голямата война в източна азия	world war two
สงครามอวกาศ	космическа война	space war
สงครามเกาหลี	корейска война	korean war
สงครามเย็น	студена война	cold war
สง่าพล	елегантен	sangapol - a thai surname
สด	прясно	fresh
สตรอเบอรี่	ягода	strawberry
สตรีวิทยา	радиология	satriwithaya
สติปัญญา	интелигентност	intelligence
สตึก	satuek	satuek (name of district)
สตูดิโอ	студиото	studio
สถานที่ท่องเที่ยวทางธรรมชาติ	природни забележителности	natural attraction
สถานะ	статус	status
สถานีคาราวาน	гара каравана	caravan station
สถานีวิทยุโทรทัศน์ไทยทีวีสีช่อง	тайландски телевизионни станции с цветни телевизионни канали	thai television station number _____
สถานีโทรทัศน์ไทยพีบีเอส	тайландска телевизия pbs	thai public broadcasting service
สถาบัน	институция	office, department
สถาบันการศึกษา	образователна институция	educational institution
สถาบันบัณฑิตพัฒนบริหารศาสตร์	национален институт за администрация за развитие	satabunbunthitpakanabarihansart - a university in thailand, as known as nida
สถาบันพระบรมราชชนก	кралски институт	red cross department
สถาบันวิจัยจุฬาภรณ์	chulabhorn research institute	julapon academy
สถาบันวิจัยและพัฒนา	научно-изследователски институт	reseach and development institution
สถาบันศูนย์และหน่วยงานในมหาวิทยาลัย	институции, центрове и катедри в университети	current faculties/college/school/institutes
สถาบันสมทบ	асоциирана институция	affiliated institute
สถาบันอาชีวศึกษา	професионален институт	ahchevasuksa academy
สถาบันอุดมศึกษา	висше учебно заведение	higher education institute
สถาบันเทคโนโลยีนานาชาติสิรินธร	сириндхорн международен технологичен институт	sirindhorn international institute of technology
สถาบันเทคโนโลยีพระจอมเกล้า	технологичният институт на крал монгкут	king mongkut's institute of technology
สถาบันเทคโนโลยีพระจอมเกล้าเจ้าคุณทหารลาดกระบัง	технологичният институт на крал mongkut ladkrabang	king mongkut's institute of technology ladkrabang
สถาบันเทคโนโลยีราชมงคล	раджамангала технологичен институт	rajamangala university of technology
สถาบันโภชนาการ	институт по хранене	institute of nutrition
สถาปนิก	архитект	architect
สถาปัตยกรรมไทย	тайландска архитектура	architecture of thailand
สถิติศาสตร์	статистика	statistic
สธ	sth	two letters from thai alphabets
สนธยา	полумрак	twilight
สนธิ	кръстовище	sonti - a male's name
สนธิไชย	sonthichai	sontichai
สนามกีฬากลาง	централен стадион	main athletic field
สนามชัยเขต	санам чай кет	sanamchaikate - a location in thailand
สนามฟุตบอล	футболно игрище	football field
สนามแม่เหล็ก	магнитно поле	magnetic field
สนามไฟฟ้า	електрическо поле	electric field
สนิทวงศ์	санит вонг	there are families.
สนิม	ръжда	rust
สนเกรวิลเลีย	борово грозде	grevilea - family of 250 types of plants
สปริงฟิลด์	springfield	springfield
สปรินเตอร์	спринтьор	sprinter
สปาร์ค	искра	spark
สพ	спекулация	oc
สภานิติบัญญัติแห่งชาติ	национално законодателно събрание	national diet
สภาผู้แทนนิสิต	ученически представителен съвет	college student representatives
สภาพอากาศ	времето	weather conditions
สมจิตต์	somchit	somjit - a female's name
สมจิตร	somchit	somjit
สมชัย	somchai	somchai
สมชาย	somchai	somchai - a male's name
สมภพ	раждане	sompob
สมศรี	somsri	somsi
สมศักดิ์	somsak	somsak
สมัคร	приложи	samak
สมัย	период	era
สมัยกรุงธนบุรี	период тонбури	thonburi era
สมัยก่อนประวัติศาสตร์	праисторически времена	prehistory
สมัยที่	кога	term
สมัยรัชกาลที่	reign	in the reign of
สมัยสุโขทัย	сухотайски период	sukothai era
สมัยอาณานิคมฝรั่งเศส	френски колониален период	modern france
สมาคมประชาชาติแห่งเอเชียตะวันออกเฉียงใต้	асоциация на страните от югоизточна азия	association of south east asian nations (asean)
สมาชิกรับเชิญตอนพิเศษ	поканени членове за специален епизод	special guests
สมาชิกฤดูกาลที่	сезонни членове	member of the parliament
สมุทวณิช	samutavanich	samudavanija
สมเด็จ	нейно величество	your highness
สมเด็จพระนางเจ้ารำไพพรรณี	кралица рамбай барни	queen rambhai barni
สมเด็จพระนางเจ้าสิริกิติ์	кралица сирикит	queen sirikit
สมเด็จพระนางเจ้าฯ	нейно величество	the queen of thailand
สมเด็จพระบรมราชาที่	кралят	king
สมเด็จพระบรมโอรสาธิราช	престолонаследник	his highness, royal crowned prince
สมเด็จพระบรมโอรสาธิราชฯ	престолонаследник	the crown prince of thailand
สมเด็จพระมหิตลาธิเบศร	somdet phra mahidol latibes	somdet phra mahitra thibet
สมเด็จพระรามาธิบดีที่	цар рама v	som dej pra rama tippadee #_____ , number of the king
สมเด็จพระศรีนครินทราบรมราชชนนี	врз принцеса маха чакри сириндхорн	queen sirikit
สมเด็จพระอนุชาธิราช	сомдей анухатират	som dej pra ah nu cha thi raj - a famous royalty in thailand a long time ago
สมเด็จพระเจ้ากรุงธนบุรี	кронг тон бури	the king of the thonburi kingdom
สมเด็จพระเจ้าภคินีเธอ	нейно кралско височество	the king's sister, som dej pra jao pakini ther
สมเด็จพระเจ้าลูกเธอ	нейно кралско височество	the king's daughter, the princess
สยามดารา	сиам дара	siam stars
สยามบรมราชกุมารี	siam	the current king's eldest daughter, the eldest princess
สยามพารากอน	сиам парагон	siam paragon
สร	създавам	abbreviation for the royalties' accessories
สรรพสินค้า	универсален магазин	department store
สราวุธ	sarawut	sarawut
สร้าง	създавам	build
สลักใจ	впечатлявам	salakchai
สวนดุสิตโพล	анкета на suan dusit	suan dusit poll
สวนผึ้ง	суан пхуенг	bee garden
สวนสมเด็จพระศรีนครินทร์	парк somdet phra srinagarindra	pra sri nakarin - a king of thailand
สวรรคต	отмина	die
สวรรคตหรือ	почина	die or ___________
สวรรคโลก	sawankhalok	heaven on earth
สวัสดิ์	sawat	sawat - a male's name
สวัสดีปีใหม่	честита нова година	happy new year
สวิตเซอร์แลนด์	швейцария	switzerland
สวี	suites	sawi
สส	тайна	representatives
สหพันธ์สาธารณรัฐเยอรมนี	федерална република германия	germany
สหรัฐอาหรับเอมิเรตส์	обединени арабски емирства	arab emirate
สหรัฐอเมริกา	нас.	america, usa
สหราชอาณาจักร	великобритания	united kingdom
สหวงษ์	sahawong	sawong - a male's name
สองสาย	два проводника	double-stranded
สอยดาว	апъркат	soidao
สะดวก	лесно	convenient
สะตอ	сато	sator
สะล้อ	спирачка	salao
สะเดา	neem	neem, a type of plant
สัจธรรม	истина	normal truth; common knowledge
สัญญา	договор	sanya
สัญลักษณ์ประจำมหาวิทยาลัย	университетско лого	logo of the university
สัดส่วน	пропорция	ratio
สัตว์	животно	animal
สัตว์มีกระดูกสันหลัง	гръбначни	vertebrate animals
สัตว์มีแกนสันหลัง	гръбначен стълб	chordata
สัตว์เลี้ยงลูกด้วยน้ำนม	бозайниците	mammal
สัตว์เลื้อยคลาน	влечуго	reptile
สัตว์เลื้อยคลานในอันดับนี้	влечуги от този ранг	reptile in this order
สัทศาสตร์	фонетика	phonetics
สันติ	мир	peace
สันติสุข	мир	santi suk
สัมผัสนอก	външна рима	outside touch
สัมพันธ์	взаимоотношения	relationship
สัมมา	прав	summa - the buddhist prayer often starts with this
สาขา	клон	office location
สาขานครราชสีมา	клон накхон ратчасима	nakhon ratchasima branch
สาขานครสวรรค์	клон nakhon sawan	nakhon sawan branch
สาขานิเทศศาสตร์	комуникационни изкуства	faculty of communication arts
สาขาประจวบคีรีขันธ์	клон на прачуап хири хан	prachuap khiri khan branch
สาขาปราจีนบุรี	клон прачинбури	pracheenburi branch
สาขาพิษณุโลก	клон phitsanulok	pisanulok location
สาขามนุษยศาสตร์	хуманитарни науки	humanities
สาขาย่อย	подраздел	offices
สาขาลำปาง	клон лампанг	lumpang location
สาขาวิชานิติศาสตร์	юридически факултет	law department
สาขาวิชาบริหารธุรกิจ	програма за бизнес администрация	business administration program
สาขาวิชารัฐประศาสนศาสตร์	департамент по публична администрация	local government
สาขาวิชาวิทยาการคอมพิวเตอร์	програма за компютърни науки	school of computer science
สาขาวิชาวิศวกรรมคอมพิวเตอร์	програма за компютърно инженерство	computer engineering
สาขาวิชาวิศวกรรมอาหาร	хранителна техника	food engineering
สาขาวิชาวิศวกรรมอิเล็กทรอนิกส์	програма за електронен инженеринг	major electronic engineering
สาขาวิชาศิลปอุตสาหกรรม	отдел за изкуство	arts department
สาขาวิชาเคมี	катедра по химия	department of chemistry
สาขาวิชาเทคโนโลยีชีวภาพ	биотехнологична програма	department of biotechnology
สาขาวิชาเศรษฐศาสตร์	икономика	finance department
สาขาศิลปะสถาปัตยกรรม	художествена архитектура	art and architecture branch
สาขาสมุย	клон самуи	smui branch
สาขาหัวหิน	клон хуа хин	hoa hin branch
สาครสินธุ์	sakorn sin	sakornsin - a surname
สาทร	sathorn	sathon
สาธารณรัฐประชาชนจีน	китайска народна република	people's republic of china
สาธารณรัฐออสเตรีย	република австрия	republic of austria
สาธารณรัฐอินโดนีเซีย	република индонезия	republic of indonesia
สาธารณรัฐเช็ก	чехия	czech republic
สาธารณรัฐโดมินิกัน	доминиканска република	republic dominican
สานติวัตร	santiwat	santiwat
สามก๊ก	три царства	three kingdom 'sam kok' - a thai legend
สามชัย	сам чай	samchai - a location in thailand
สามชุก	сам чук	sam chuk district
สามพราน	sampran	sam phran
สามอัศวินในจินตนาการ	три фентъзи рицари	sam assavin in jintanakan - the name of a japanese story
สามัญ	обикновен	common
สายการบิน	airlines	airline
สายรัชกาลที่	късно царуване	family tree of king rama ...
สายรุ้ง	дъга	rainbow
สายสนั่น	гръмотевична линия	siasanan
สายสีชมพู	розова линия	pink line
สายสีน้ำเงิน	синя линия	blue line
สายสีม่วง	лилава линия	purple line (rapid transit)
สายหมอก	мъгла	fog
สายเดียว	една линия	single helix
สายเมืองทอง	линия на mueang thong	muang thong line
สารต้านอนุมูลอิสระ	антиоксидантите	antioxidants
สารพฤกษเคมี	фитохимия	phytochemical
สารภี	saraphi	saraphi
สารละลาย	решение	solution
สารานุกรมไทย	тайландска енциклопедия	saranukromthai
สารานุกรมไทยฉบับราชบัณฑิตยสถาน	тайландска енциклопедия royal institute edition	thai's publication
สารีวงษ์	sareewong	sariwong
สาวิตรี	савитри	sawitri
สาเหตุ	кауза	reasons
สำนวนเก่า	стара идиома	old aphorism
สำนักงานขนส่งกรุงเทพมหานครพื้นที่	офис за транспорт на бангкок	thai general transport
สำนักงานคณะกรรมการวัฒนธรรมแห่งชาติ	служба на националната комисия по култура	office of arts and culture preservation of thailand
สำนักงานโครงการพัฒนาแห่งสหประชาชาติ	служба за развитие на организацията на обединените нации	united nations development prograท
สำนักระบาดวิทยา	бюро по епидемиология	bureau of epidemiology
สำนักราชเลขาธิการ	секретариат	operation department of the king's palace
สำนักวิทยบริการ	служба за академични ресурси	office of academic services
สำนักหอสมุด	библиотека	library
สำนักหอสมุดกลาง	централна библиотека	the central library
สำรวจ	изследване	investigate
สำราญ	радостно	happily
สำหรับ	за	for
สำหรับประเทศไทย	за тайланд	for thailand
สำหรับใช้เป็นตราหัวหนังสือราชการไทย	за използване като печат върху правителствената книжка на тайланд	emblem thailand garuda
สำหรับในปี	за през годината	for the year
สำเนียง	акцент	dialect
สำโรง	samrong	sumrong - a location in thailand
สิงหาคม	август	august
สิงหไตรภพ	сингха трипоп	sing tri pop - a thai drama
สิงโต	лъв	lion
สิทธิ	права	rights
สิทธิมนุษยชน	човешки права	human rights
สิน	грях	sihn
สินค้าคงเหลือ	материални запаси	inventory
สินค้าอุปโภคบริโภค	потребителски стоки	supplies
สินสมุทร	грех самут	sihnsmut
สินิทธา	zithitha	sinitra - first name of an actor
สิปปภาค	регион zippy	sippapak
สิเรียม	sirium	syriam (name of city in myanmar)
สิ่ง	нещо	things
สิ่งมีชีวิต	живи същества	living things
สิ่งเสพติด	лекарство	addictive substance, drugs
สิ้นพระชนม์ในรัชกาลที่	умира при управлението на	died in
สี	цвят	color
สีขาว	бял цвят	white
สีดำ	черен цвят	black color
สีน้ำตาล	кафяв цвят	brown
สีน้ำเงิน	син	blue
สีฟ้า	син	blue
สีม่วง	лилаво	purple
สีลม	вятърна мелница	silom
สึนะ	tsuna	tsuna
สึนะโยชิ	цунайоши	tsunayoshi
สืบต่อมา	наследят	live on
สื่อสารมวลชน	масова комуникация	mass communication
สื่อสิ่งพิมพ์	печатни медии	printing media
สุกิจ	sukit	sukit
สุขภาพ	здраве	health
สุขสวัสดิ์	suksawat	suksawas
สุขาภิบาล	санитарен	sukhapibal (name of district)
สุขุมวิท	sukhumvit	sukhumvit
สุครีพ	sukree	sugriva
สุจริตกุล	sucharitkun	sucharitkul
สุจาริณี	sucharinee	sujarinee
สุชิน	suchin	suchin
สุดท้ายตายด้วยฝีมือ	накрая умрете от умение.	eventually dies at the hand of
สุดสาคร	sudsakorn	sootsakorn - a character in a thai legend
สุดารัตน์	sudarat	sudarat
สุทธิชัย	sutthichai	suttichai - a male's first name
สุทัศนะจินดา	sutasachinda	sututnajinda - surname of a tv host
สุทัศน์	suthat	sutas
สุธี	учен	sutee - a male's name
สุนทร	sunthorn	sunthon
สุนทรภู่	сунтхорн фу	soontornpoo - a character from a legend
สุนทรเวช	sunthornwet	"surname ""sundaravej"""
สุนัขจิ้งจอก	лисицата	baby fox
สุปรีย์	supri	supri - a name
สุพจน์	suphot	supot
สุพล	supon	surapol
สุมณทิพย์	sumonthip	sumonthip
สุรชาติ	surachat	surachart - a male's name
สุรพล	surapon	suraphol
สุรพันธ์	suraphan	surapan - a male's name
สุรวุฒิ	surawut	surawut
สุรศักดิ์	surasak	surasak
สุรัสวดี	surasawadee	suratsawadee - a thai surname
สุราษฎร์ธานี	сурат тани	surat thani
สุรินทร์	сурин	surin - a place in thailand
สุริยัน	suriyan	suriyan - a male actor
สุริโยไท	suriyothai	"movie called ""suriyothai"""
สุลต่าน	султан	sultan
สุวนันท์	suwanan	suwanan
สุวรรณรัฐ	suwannarat	suwannarath
สุวรรณานนท์	suwannanon	suwannanon - a surname
สุเทพ	сутеп	suthep - first name of a famous singer
สุโขทัย	sukhothai	sukothai - ancient thailand
สุ่น	слънце	sun
สูง	високо	high
สูงจากระดับน้ำทะเลปานกลาง	над средното морско ниво	above average sea level
สู่	да се	indicate
สเตราส์	щраус	strauss.
สเตอรอล	sterol	steroid anabolic
สเตเดี้ยม	стадион	stadium
สเปน	испания	spain
สไตรค์	стачка	strike
สไตล์การเล่น	стил на игра	style
ส่งเสริม	насърчаване	support, encourage
ส่วนของผู้ถือหุ้น	капиталов капитал	shareholder fund
ส่วนต่อขยายบางซื่อท่าพระ	удължаване bang sue tha phra	bang sue – tha phra expansion
ส่วนสูง	височина	height
ส่วนส่งกำลังบำรุง	раздел логистика	supply center
ส่วนหัว	удар с глава	top part
ส่วนในฤดูฝนน้ำจะท่วมทุกปี	в сезона на дъждовете водата ще наводнява всяка година.	flooding in the rainy season
ส่วนใหญ่	най-много	mostly
ส่วนใหญ่เป็นโรงสีข้าว	повечето от тях са оризови мелници.	most of them are rice refinery
ส่องแสง	блясък	shining light
ส้ม	оранжев	orange
ส้มเช้ง	оранжево оранжево	acidless orange
ส้มโอ	грейпфрут	pomelo
หงษ์ทอง	хонг тонг	hongthong
หงษ์มานพ	хонг маноп	hongmanop
หงสกุล	хонг сакул	hongsakul (a famous surname in thailand), as in harin hongsakul
หญ้าทะเล	морска трева	seagrass
หญ้าฝรั่น	шафран	saffaron
หนองคาย	нонг хай	nong kai -  a location in thailand
หนองม่วง	нонг муанг	nong muang
หนองหาน	нонг хан	nong-haan
หนองฮี	nong hee	nong hi - a location in thailand
หนองแซง	занг	nong sang - area in thailand
หนอน	червей	worm
หนัก	тежък	heavy
หนังสือ	книга	book
หนังสือการ์ตูน	комикс	comic book
หนังสือลามก	порнографски книги	pornographic magazines
หนังใหญ่	голям филм	nang yai
หนึ่ง	един	one
หนึ่งธิดา	една дъщеря	nuengthida
หนุมาน	хануман	hanuman - a giant in a thai tale
หนุ่ม	млад	young (used for men)
หน่วยความจำ	памет	computer memory
หน่วยคำเติม	морфема	affix
หน่วยทหารในค่าย	военно поделение в лагера	units in camp
หน่วยที่	мерна единица	order of 1, 2, 3...
หน่วยบัญชาการนาวิกโยธิน	щаб на морската пехота	royal thai marine corps
หน่วยประมวลผลกลาง	централен процесор	central processing unit
หน่วยพันธุกรรม	генетична единица	gene
หน้าอก	гръден кош	breast
หมวด	група	category
หมวดหมู่	категория	category
หมวดหมู่กลุ่มดนตรีที่ก่อตั้งในปี	категория музикална група, основана през	category: music band established in the year
หมวดหมู่กลุ่มดนตรีสัญชาติเกาหลี	категория на корейската музикална група	korean musical group
หมวดหมู่กวีชาวไทย	категория на тайландски поет	thai poem category
หมวดหมู่การฉลองปีใหม่	нова година категория празнуване	the group in charge of new year celebration
หมวดหมู่การประท้วงในประเทศไทย	категория протест в тайланд	category:protests in thailand
หมวดหมู่การ์ตูนญี่ปุ่นแนวโชเน็น	категория: японски анимационен филм, стил шон	the cartoons of japan
หมวดหมู่จุลชีววิทยา	категория микробиология	category:microbiology
หมวดหมู่ชาวไทยที่นับถือศาสนาพุทธ	категория тайландски будисти	category:thai buddhists
หมวดหมู่ชาวไทยที่เกิดในต่างประเทศ	категория тайландски родени в чужбина	thais that were born outside thailand
หมวดหมู่ดาวเคราะห์ชั้นใน	категория на вътрешната планета	group of stars inside
หมวดหมู่ดาวเคราะห์หิน	категория планет камък	category:terrestrial planets
หมวดหมู่ทหารอากาศชาวไทย	категория ввс на тайланд	category:royal thai air force personnel
หมวดหมู่ทหารเรือชาวไทย	категория тайландски флот	group of thai navy officers
หมวดหมู่นักการเมืองไทย	категория тайландски политици	politician
หมวดหมู่นักร้องไทย	категория на тайландски певици	singer category
หมวดหมู่นายกรัฐมนตรีไทย	категория министър-председател на тайланд	category:prime ministers of thailand
หมวดหมู่บริษัทของไทย	тайландска компания категория	group of thai's companies
หมวดหมู่บริษัทที่ก่อตั้งในปี	компания, основана през	category:companies established in
หมวดหมู่บอยแบนด์	категория група за момчета	a group of boys band
หมวดหมู่บุคคลจากจุฬาลงกรณ์มหาวิทยาลัย	категории от chulalongkorn university	category:chulalongkorn university alumni
หมวดหมู่บุคคลจากมหาวิทยาลัยธรรมศาสตร์	категория от университета thammasat	group of staff from thammasat university
หมวดหมู่บุคคลจากมหาวิทยาลัยสุโขทัยธรรมาธิราช	категории от открития университет „сухотай thammathirat“	group: person from sukhothai thammathirach university
หมวดหมู่บุคคลจากมหาวิทยาลัยอ๊อกซฟอร์ด	индивидуална категория от оксфордския университет	the staff of oxford university, england
หมวดหมู่บุคคลจากสถาบันบัณฑิตพัฒนศิลป์	категория хора от института bunditpatanasilpa	group of staff from art schools
หมวดหมู่บุคคลจากโรงเรียนนายร้อยพระจุลจอมเกล้า	категории от кралската военна академия в chulachomklao	catagory: people from prchomklhaw academy
หมวดหมู่บุคคลจากโรงเรียนมงฟอร์ตวิทยาลัย	категория лица от montfort college	category: people from mongford college
หมวดหมู่บุคคลที่เกี่ยวข้องกับเหตุการณ์	категория хора, свързани със събитието	catagory: individuals invovled
หมวดหมู่ประวัติศาสตร์ไทย	категория история на тайланд	category:history of thailand
หมวดหมู่ประเภทของภาพยนตร์	категория категория филми	types of film
หมวดหมู่ปรัชญา	категория философия	category:philosophy
หมวดหมู่พระราชนัดดาในรัชกาลที่	категория кралски внук на царуването	"catagory: royal heirs during the ""blank"" reign"
หมวดหมู่พระราชปทินัดดาในรัชกาลที่	категория царство царуване по време на царуването	the king's army
หมวดหมู่พระราชปนัดดาในรัชกาลที่	категория цар панада през царуването	belonging to the king # ________
หมวดหมู่พิธีกรไทย	категория тайландски водещи	host for thai shows
หมวดหมู่ฟุตบอลในประเทศไทย	футболна категория в тайланд	category; football in thailand
หมวดหมู่ภัยธรรมชาติ	категория на природни бедствия	catagory: natural disasters
หมวดหมู่ภัยพิบัติทางการแพทย์	категория медицинска катастрофа	category: medical disaster
หมวดหมู่มหาวิทยาลัยธรรมศาสตร์	thammasat university категория	thamasat university
หมวดหมู่รัชกาลที่	категория царуване	reign 9 category
หมวดหมู่รัฐคอมมิวนิสต์	категория на комунистическата държава	communist countries
หมวดหมู่รัฐมนตรีว่าการกระทรวงการต่างประเทศไทย	категория: министър на външните работи на тайланд	category:foreign ministers of thailand
หมวดหมู่รัฐวิสาหกิจไทย	категория тайландски предприятия	category:government-owned companies of thailand
หมวดหมู่รัฐสิ้นสภาพในทวีปเอเชีย	категория държавна държава прекрати в азия	asian counties in controlled
หมวดหมู่รัฐและดินแดนที่ก่อตั้งในปี	категория държава и територия, основана в	categories state and territory established in
หมวดหมู่รายการโทรทัศน์ไทย	категория на тайландската телевизия	the group of thai television channels
หมวดหมู่ละครโทรทัศน์ไทย	категория тайландска телевизионна драма	thai drama category
หมวดหมู่วัฒนธรรมไทย	категория на тайландската култура	category:thai culture
หมวดหมู่วันสำคัญทางศาสนาที่นับโดยปฏิทินจันทรคติ	категории важни религиозни дни, преброени от лунния календар	group of religious holidays
หมวดหมู่ศิลปินสังกัดจีเอ็มเอ็ม	категория изпълнители под gmm	mgm artists
หมวดหมู่สถาบันอุดมศึกษาในกรุงเทพมหานคร	категории висши учебни заведения в банкок	category:universities in bangkok
หมวดหมู่สมุนไพร	категория билки	herbal, herbs
หมวดหมู่สัตว์มีแกนสันหลัง	категория прешлена ос	category:chordates
หมวดหมู่สัตว์เลื้อยคลาน	категория на влечуги	reptilians
หมวดหมู่สิ่งก่อสร้างในพุทธศตวรรษที่	категория сгради през 21 век	development in the century # ____
หมวดหมู่สิ้นสุดในคริสต์ศตวรรษที่	категорията завършва през 19 век.	category: ended in xth century
หมวดหมู่สโมสรในพรีเมียร์ลีก	клубна категория във висшата лига	group of premier club
หมวดหมู่อดีตอาณานิคมของฝรั่งเศส	френска бивша колониална категория	category:former french colonies
หมวดหมู่อดีตอาณานิคมของสเปน	испанска бивша колониална категория	category:former spanish colonies
หมวดหมู่อดีตอาณานิคมของอังกฤษ	британска бивша колониална категория	the group of countries that were under british control
หมวดหมู่อวัยวะ	категория органи	group of organs
หมวดหมู่อวัยวะเพศ	генитална категория	category:sex organs
หมวดหมู่เครื่องเทศ	категория подправки	herbs
หมวดหมู่เพศศึกษา	категория сексуално образование	sex education category
หมวดหมู่แนวพระราชดำริ	категория инициатива	the king's words (instruction)
หมวดหมู่โรค	категория на заболяванията	group of disease
หมวดหมู่โรงเรียนที่มีอัตราการแข่งขันสูง	категория училища с висока степен на конкуренция	categories high competition school
หมวดหมู่โรงเรียนบุรุษในประเทศไทย	категория училища за мъже в тайланд	category:boys' schools in thailand
หมอชิต	morchit	mochit bus station
หมากรุกสากล	международен шах	chess
หมายความว่า	средства	means
หมู่	свине	district, group
หมู่ที่	село	moo.
หมู่เกาะเคย์แมน	кайманови острови	cayman island
หมู่เกาะแบลีแอริก	балеарски острови	balearic island in spain
หมู่เกาะโซโลมอน	соломоновите острови	solomon islands
หม่อมราชวงศ์ปรีดิยาธร	р. придияторн	mom rajawongse pridiyathorn devakula
หม่อมหลวงปิ่น	мама пин	mom luang pin
หม่อมเจ้าจุฑาวัชร	принц ютаватчай	his serene highness prince juthawat
หม่อมเจ้าวัชรวีร์	принц ватхарауе	mom chao vatcharee - a member of the royal family
หม่อมเจ้าวัชรเรศร	мама уотчарачорн	watcharaje - a member of royal family
หม้อข้าวหม้อแกงลิง	nepenthes	nepenthes - a type of tropical plant
หยุ่น	гъвкав	yun - nickname of a thai newscaster
หรั่ง	lang	rang
หรือ	или	or
หรือการแสดงธงชาติ	или показва националния флаг	national flag display
หรือชื่อทางการคือ	или официалното име е	official name is
หรือที่รู้จักกันในชื่อ	или известен като	also known as
หรือที่เรียกกันว่า	също известен като	or what it is called ...
หรือเรียกว่า	или се обади	called
หลวง	царски	loung - a thai title for people who services the king
หลอก	псевдо	fake, fooling someone
หลอดอาหาร	хранопровод	esophagus
หลอดเลือดแดงใหญ่เอออร์ตา	аорта	aorta
หลักจริยธรรม	етика	ethics
หลักทรัพย์	ценни книжа	property
หลักสี่	laksi	luk sri - a location in bangkok
หลักสูตรการจัดการดุษฏีบัณฑิต	доктор по философия програма по мениджмънт	doctor of management program
หลักสูตรที่เปิดสอน	курс	curriculum
หลักสูตรนานาชาติ	международен курс	international course
หลักสูตรปกติ	нормален курс	normal program
หลักสูตรภาษาอังกฤษ	курс по английски език	english curriculum
หลักสูตรภาษาไทย	курс по тайландски език	thai language curriculum
หลักสูตรวิทยาศาสตรมหาบัณฑิต	магистърска програма	degree requirements for a bachelor degree in science
หลังจาก	след	after
หลังสงคราม	след войната	after the war
หลังสงครามโลกครั้งที่	след световната война	world war
หลังสงครามโลกครั้งที่สอง	след втората световна война	after world war ii
หลังเหตุการณ์	след събитието	after the event
หลาย	много	many, vastly
หลีกภัย	бягство	mr. cheun leakpai, the former foreign ministor
หลุมดำจิ๋ว	малка черна дупка	small black hole
หล่มสัก	лом сак	lohmsak
หวาย	ратан	bamboo
หอก	копие	spear
หอประชุมพ่อขุนรามคำแหงมหาราช	крал ракхамаенг великият зрител	pho khun ram khamhaeng convention center
หอมรดกไทย	зала на тайландското наследство	national ancient museum of thailand
หอย	миди	shells, clams
หอไอเฟล	айфеловата кула	eiffel tower
หัก	се изважда	broken
หัว	глава	head
หัวหิน	хуа хин	hua hin
หัวโขน	маска	khon mask
หัวใจ	сърце	heart
หาง	опашка	tail
หาดทรายแก้ว	плаж sai kaew	glass beach
หาบเร่	амбулантен търговец	street vending
หินปูน	варовик	limestone
หินอ่อน	мрамор	marble
หินเชิร์ต	каменна риза	chert
หินแกรนิต	гранит	granite rock
หินไซอัล	шистов камък	sial
หี	котенце	vagina (impolite word)
หุตะสิงห์	хута синг	hutasingha
หุ่น	куклен	model
หุ่นยนต์	робот	robot
หเตุการณ์	ситуация	event
ห่วงใย	грижовна	care
ห้วยขวาง	хуай кванг	huai khwang
ห้วยทับทัน	хуай тхап	huai thap than
ห้องน้ำ	тоалетна	bathroom
ห้องสมุด	библиотека	library
ห้าง	магазин	mall
ห้างฉัตร	hang chat	hang chat
ห้างหุ้นส่วนจำกัด	ограничено партньорство	limited partnership
ฬาพานิช	търговски	fapanit - surname of an actor
อก	гърди	chest
อคิลลีส	ахил	achilles
องคชาต	полови органи	penis
องคต	организация	angada
องค์กรปกครองส่วนท้องถิ่น	организация на местната власт	local administration
องค์การนิสิต	студентска организация	student organization
องค์การมหาชน	обществена организация	human services
องค์การสหประชาชาติ	обединените нации	united nation
องค์บาก	онг бак	ong-bak
องค์ประกันหงสา	застраховка hongsa	prakunhongsa - a famous person from the ancient time
องอาจ	храбър	ongart
อดิศักดิ์	adisak	adisak
อดีต	бивш	the past
อดีตผู้บัญชาการทหารบก	бивш военен командир	ex-commander in chief of the royal thai army
อดีตรองนายกรัฐมนตรี	бивш вицепремиер	former deputy prime minister
อดีตรองหัวหน้าหน่วยที่	бивш заместник-началник на звеното	former lieutenant
อธิการบดี	канцлер	dean of the college
อธิการบดีมหาวิทยาลัยธรรมศาสตร์	президент на университета thammasat	former chanceller of thamasat university
อธิบายว่า	обяснете това	explain
อนันตยะ	anantaya	anantaya
อนันตรัย	anantai	anuntrai
อนาลโย	analoy	analayo
อนึ่ง	между другото	once
อนุทิน	дневник	diary
อนุสรณ์สถาน	паметник	monument
อนุสรา	anusara	anusara
อปักธงชัย	пак тонгчай	pak thongchai district
อพอลโล่	аполон	apollo
อพิมาย	aphimai	phimai district
อภัยนุราช	прощавам	aphainurat
อภินันท์	aphinan	ahpinun - a male's name
อภิปรัชญา	метафизика	metaphysics
อภิรักษ์	aphirak	apirak
อมฤต	мъртъв	ummarit - a male's name
อมาตยกุล	amatayakun	amattayakun
อยู่	сте	is
อยู่วิทยา	физиология	yoovidhya
อยู่ห่างออกไปจากชายฝั่ง	далеч от брега	away offshore
อยู่แล้ว	вече	already
อยู่ในเขตอำเภอกุฉินารายณ์	намира се в област кучинарай	in the kuchinarai district
อย่างต่อเนื่อง	непрекъснато	continuously
อย่างแพร่หลาย	широко	many, various
อย่างไรก็ตาม	въпреки това	however
อร	орн	orn (thai name)
อรทัย	младо момиче	orathai - surname of a thai country singer
อรรถกถา	коментар	atthakatha
อรรถพร	athaphon	uttapon - a female's name
อรัญประเทศ	aranyaprathet	arranyapratet - a location in thailand
อริยสัจ	благородна истина	teaching of buddha
อรุณี	arunee	arunee
อลังการ	декорация	alungan - the name of a movie theater in thailand
อลาสก้า	аляска	alaska
อลิซ	алис	alice
อวอร์ดส	награди	award
อวัยวะสืบพันธุ์สตรีด้านนอก	женските полови органи отвън	femal reproductive system
อวัยวะสืบพันธุ์หญิง	женските полови органи	female reproductive system
อวัยวะเพศ	полови органи	sex organ
อศรีประจันต์	асри прачан	master sri prajan - a priest's name
อสมท	mcot	acronym for thai communication companies
อสามชุก	сам чук	sam chuk district
ออ	или	auu - a thai vowel
ออกฉายครั้งแรกเมื่อวันที่	първо екранизирано	first screening
ออกมาในอะนิเมะเท่านั้น	излиза само в анимето	only in anime
ออกอากาศ	излъчване	on the air
ออกอากาศครั้งที่	излъчен на	airing
ออกอากาศทางช่อง	излъчва се на	aired on channel
ออกัสตัส	augustus	augustus
ออกเป็น	в	into
ออกแบบตัวละคร	дизайн на персонажи	character design
ออนไลน์	онлайн	online
ออฟ	от	off
ออลแบนี	съюзниците	albany
ออสเตรเลีย	австралия	australia
ออโตทรอพ	autobot	autotroph
อะ	какво	a
อะซูไรต์	азурит	azurite
อะตอม	атом	atom
อะนิเมะ	аниме	anime
อะบุราเมะ	абураме	aburame
อะพาไทต์	апатит	apartheid
อะมาเดอุส	amadeus	amadeus
อะลูมิเนียม	алуминий	aluminum
อะโกนิสต์	агонистичното	agonist
อะโลน	сам	alone
อักษร	писмо	letters, alphabets
อักษรย่อ	съкращения	abbreviation
อักษรเกาหลี	корейска азбука	korea alphabet
อังกฤษสมัยแองโกล-นอร์มัน	англо-нормандски английски	england anglo-norman era
อังการา	анкара	ankara
อัญมณี	скъпоценен камък	gem
อัฒภาค	точка и запетая	semicolon
อัตราการว่างงาน	процент на безработица	unemployment rate
อัธฮา	athha	athha
อันดับ	оценка	order
อันประกอบด้วย	състояща се от	consists of
อันโตนิโอ	антонио	"name ""antonio"""
อันโตนีโอ	антонио	antonio
อันได้แก่	включително	which are
อัฟกานิสถาน	афганистан	afghanistan
อัมพร	amporn	umpon - a female's name
อัมพาต	парализа	paralysis
อัลบัส	албус	albus in harry potter stories
อัลบั้ม	албум	album
อัลเดบารัน	алдебаран	arudebaran
อัลเฟรด	алфред	alfred
อัสนี	болт	thunderbolt
อาการหวาดระแวง	параноя	paranoid
อากาศ	въздух	air, weather
อากาศอำนวย	метеорологично време	akat amnuai
อากาเป	захласнато	the word meaning 'love' in greek language
อาคามัตสึ	akamatsu	akamatsi
อาคารส่วนที่	секция за сгради	part (insert number) of the the building
อาคารอุบลรัตนราชกัญญา	сграда ubonratana ratchakanya	buildings outside ubon ratana graz contract.
อาคารเฉลิมพระเกียรติ	chaloem phrakiat building	chalermphrakiat building
อาจหมายถึง	може да означава	may also mean
อาจารย์	професор	teacher
อาจารย์ใหญ่	директор	headmaster
อาซึกะ	асука	asuka
อาณัตพล	anataphon	arnattapon
อาณาจักร	царство	kingdom
อาณาจักรธนบุรี	кралство тонбури	thonburi empire
อาณาจักรสุโขทัย	кралство сухотай	sukhothai kingdom
อาณาจักรอยุธยาปกครองเขมรเป็นเวลาเกือบปี	царството на аюттая управлява камбоджа почти година.	ayutthaya dynasty had colonized khmer for almort 400 years
อาณาจักรอยุธยาเริ่มเสื่อมอำนาจลงราวพุทธศตวรรษที่	аютейското царство започва да се влошава през будисткия век.	ayutthaya kingdom had started to downfall around 24 b.e.
อาณาจักรแพกเจ	pakae kingdom	pakja territory
อาณาเขตติดต่อ	област за контакт	adjoining parcel
อาดัม	адам	adam
อาทิ	като	for example
อาทิตย์	седмица	sunday
อานนท์	веднага	anon
อานันทมหิดล	ананда махидол	ahnanmahidol - someone with the king's surname
อานุภาพ	мощност	power
อานโตนิโอ	антонио	antonio
อาบาราอิ	abarai	abarai
อายุ	възраст	age
อารยา	araya	araya
อาร์	r	r.
อาร์กอน	аргон	argon
อาร์คิมิดีส	архимед	archimedes
อาร์ม	въоръжете	arms
อาร์มาดิลโล	броненосец	armadillo
อาร์เคด	аркада	arcade
อาร์เมเนีย	армения	armenia
อาร์เอ็นเอ	рнк	ribonucleic acid - rna
อาร์โนลด์	арнолд	arnold
อาวุธคือ	оръжие е	type of weapons
อาวุธประจำกาย	лично оръжие	personal weapon
อาหาร	храна	food
อาเจียน	бълвоч	vomit
อาเธอร์	артър	arthur
อาเนีย	ана	anya
อำนาจ	мощност	amnat
อำนาจอธิปไตย	суверенитет	sovereignty
อำเภอ	област	district
อำเภอกมลาไสย	област камаласай	kamalasai district
อำเภอกระสัง	област красанг	krasang district
อำเภอกันทรลักษ์	област кантаралак	kantharalak district
อำเภอขุขันธ์	област кхухан	khukhan district
อำเภอขุนหาญ	област хун хан	amphur kunhan
อำเภอครบุรี	област хон бури	amphur kornburi
อำเภอคูเมือง	област кху муанг	khu mueang district
อำเภอจอมทอง	район чом тонг	jom thong district
อำเภอดอยสะเก็ด	област дой сакет	doi saket district
อำเภอด่านขุนทด	област дан хун тот	dan koontod district
อำเภอตะพานหิน	район тафан хин	taphan hin district
อำเภอทับคล้อ	област thap khlo	amphoe tap khlo
อำเภอทุ่งช้าง	област тунг чанг	thung chang district
อำเภอท่าตูม	област тха тум	ta toom district
อำเภอท่าวังผา	район tha wang pha	ta wung pa province
อำเภอท่าวุ้ง	област tha wung	ta wung district
อำเภอนครชัยศรี	район накхон чай си	nakhon chai si district
อำเภอนาบอน	област на бон	nabon district
อำเภอน้ำเกลี้ยง	област нам клианг	amphur namleang
อำเภอบัวเชด	област буачет	buachet district
อำเภอบัวใหญ่	област буа яй	amphoe buayai (buayai district)
อำเภอบางบัวทอง	район bang bua thong	bang bua thong district
อำเภอบางบ่อ	област банг бо	bang bor district
อำเภอบางพลี	област банг пли	bang plee district
อำเภอบางละมุง	област банг ламунг	bang lamung district
อำเภอบางเสาธง	район банг сао тонг	bang sao thong district
อำเภอบ้านลาด	област ban lat	bahn lad district
อำเภอบ้านหมี่	област бан ми	ban mi district
อำเภอปราสาท	област прасат	amphor-prasart
อำเภอปากช่อง	район пак чонг	pak chong district
อำเภอปากพนัง	район пак фананг	pak phanang district
อำเภอปาย	район пай	pai district
อำเภอฝาง	област фанг	fang district
อำเภอพระประแดง	област фра праденг	pra-pradaeng district
อำเภอพระพรหม	област фра фром	pra phrom province
อำเภอพระสมุทรเจดีย์	област фра самут чеди	samutjadee district
อำเภอพลับพลาชัย	област флапла чай	plubplachai province in thailand
อำเภอพัฒนานิคม	област фатана ником	amphur pattananikhom
อำเภอพิปูน	област phipun	phipun district
อำเภอพุทธมณฑล	област футхамонтон	ampore phuthamontol
อำเภอภูสิงห์	област phu sing	aumphor phu sing (name of district)
อำเภอยางชุมน้อย	район ян чум ной	choom noi province
อำเภอรหัสไปรษณีย์หมายเหตุ	област, пощенски код, бележка	district, post code, note
อำเภอรัตนบุรี	област ратанабури	rhatanaburi district
อำเภอราษีไศล	район салай салай	rasi-salai district
อำเภอร่อนพิบูลย์	район рон пибун	ronpibul district
อำเภอลาดหลุมแก้ว	район lat lum kaeo	lat lum kaeo district
อำเภอลำปลายมาศ	област лам плай мат	lum plai maad district in burrirum province
อำเภอศรีณรงค์	област си наронг	si narong district
อำเภอศรีเมืองใหม่	район si mueang mai	sri meung mai district
อำเภอสระโบสถ์	квартал sra church	sa bot district
อำเภอสหัสขันธ์	област сахацахан	sahuskhan district
อำเภอสองแคว	песен квай	song khwae district
อำเภอสังขะ	област сангха	sang ka district
อำเภอสันป่าตอง	област сан па тонг	sunpathong province in thailand
อำเภอสามพราน	област сам фран	sam pran area
อำเภอสารภี	област сарафи	sarape district
อำเภอสิชล	област сикон	sichon district
อำเภอสุไหงโกลก	област сунгай колок	amphoe su-ngai kolok
อำเภอหนองกี่	област нонг ки	nong kee district
อำเภอห้วยราช	район хуай плъх	huai rat district
อำเภออมก๋อย	област омкой	om koi district in chiang mai, thailand
อำเภอเกาะคา	област ко ха	amphoe ko kha
อำเภอเขวาสินรินทร์	област хвао синарин	ampore khavasinrin
อำเภอเฉลิมพระเกียรติ	район chaloem phrakiat	amphur chalermprakiet
อำเภอเชียงของ	област чианг конг	chiang khong district
อำเภอเชียงคาน	област чианг хан	chiang khan district
อำเภอเชียรใหญ่	област чиан яй	chien yai district in thailand
อำเภอเมืองกาฬสินธุ์	mueang kalasin district	mueang kalasin provincial district
อำเภอเมืองนครราชสีมา	район mueang nakhon ratchasima	mueang nakhon ratchasima district
อำเภอเมืองนนทบุรี	район mueang nonthaburi	nontaburi district
อำเภอเมืองบุรีรัมย์	район mueang buri ram	burerum province
อำเภอเมืองพิจิตร	mueang phichit district	mueang phichit district
อำเภอเมืองพิษณุโลก	mueang phitsanulok	ampore maung pisanulok
อำเภอเมืองลพบุรี	район mueang lop buri	lopburi province
อำเภอเมืองสุรินทร์	mueang surin district	surin province
อำเภอเมืองอุตรดิตถ์	mueang uttaradit district	mueang uttaradit district
อำเภอเมืองเชียงใหม่	mueang chiang mai district	mung chiang mai district
อำเภอเมืองเพชรบุรี	mueang phetchaburi district	pechaburi province
อำเภอเวียงชัย	област вианг чай	wiang chai district
อำเภอเวียงแก่น	област вианг каен	wiang kaen district
อำเภอเสริมงาม	област соем нгам	soem ngam district
อำเภอแจ้ห่ม	област чае хом	chae hom district
อำเภอแม่ทะ	област мае та	mahta district
อำเภอแม่แจ่ม	област мае чаем	mae jam province
อำเภอแม่แตง	област мае таенг	mae taeng district
อำเภอโนนดินแดง	нон дин даенг	din dang sub district
อำเภอโนนสุวรรณ	област нюан	none su wan province
อิงค์	inc.	inc.
อิงลิช	английски	english
อิทธิพล	влияние	power
อิน	в	in
อินทิรา	индира	intira
อินฟราเรด	инфрачервен	infared
อินฮิบิเตอร์	инхибитор	inhibitors
อินุยาฉะ	inuyasha	inuyacha - a japanese cartoon
อินเซคทิวอรา	inseqtura	insectivora
อินเดียน	индийски	indian
อินเด็กซ์	индекс	index
อินโดนีเซีย	индонезия	indonesia
อิม	imm	im
อิมาจิน	imajin	imagine
อิมแพ็ค	въздействие	impact
อิรัก	ирак	iraq
อิริโทรมัยซิน	електролиза	erythromycin
อิสตันบูล	истанбул	istanbul
อิหร่าน	иран	iran
อิเควทอเรียลกินี	екваториална гвинея	equitorial
อิโนะ	аз не	ino
อีก	повече ▼	more
อีกครั้ง	още веднъж	again
อีกด้วย	също	also
อึ	лайна	poop
อึ๊งภากรณ์	ungphakorn	ungpakorn - a famous surname
อือ	да!	uu - a thai vowel
อื่น	друг	other
อุ	о	ou
อุซึมากิ	узумаки	uzumaki naruto
อุณหภูมิ	температура	temperature
อุณหเคมี	термохимия	using energy and heat in chemical study
อุดม	плодороден	udom
อุดรธานี	удон тани	udon thani
อุตตมะโยธิน	uppharat yothin	uttamayothin
อุตรดิตถ์	утарадит	uttaradit
อุทยาน	парк	park
อุทยานประวัติศาสตร์พนมรุ้ง	исторически парк phanom rung	phanom rung historical park
อุทยานประวัติศาสตร์พิมาย	исторически парк фимай	phimai historical park
อุทยานแห่งชาติคลองตรอน	национален парк хлонг трон	khlong tron national park
อุทยานแห่งชาติดอยภูคา	национален парк дой пху ха	doi phu kha national park
อุทยานแห่งชาติดอยอินทนนท์	национален парк doi inthanon	national park doi inthanon in northern thailand
อุทยานแห่งชาติทุ่งแสลงหลวง	национален парк тунг салаенг луанг	thung salaeng luang national park
อุทยานแห่งชาติธารโบกขรณี	отколкото национален парк бок хорани	tarabokorani national preserve area
อุทยานแห่งชาติน้ำตกสี่ขีด	национален парк водопад si khit	namtoksekeed national park
อุทยานแห่งชาติน้ำพอง	национален парк нам фонг	nam phong national park
อุทยานแห่งชาติภูผาเหล็ก	национален парк iron mountain	phupalek national park
อุทยานแห่งชาติภูพาน	национален парк фу фун	phu phan national park
อุทยานแห่งชาติภูสวนทราย	национален парк phu suan sai	pusuansai national preserve
อุทยานแห่งชาติภูสอยดาว	национален парк phu soi dao	soi dao mountain preserve
อุทยานแห่งชาติภูเรือ	национален парк phu ruea	national park pu reau
อุทยานแห่งชาติภูเวียง	национален парк phu wiang	phu wiang national park
อุทยานแห่งชาติภูแลนคา	национален парк пуланка	phu laenkha national park
อุทยานแห่งชาติหาดนพรัตน์ธาราหมู่เกาะพีพี	национален парк нопфарат тара, острови фи фи	hat nopparatthara-mu ko phi phi national park
อุทยานแห่งชาติเขาหลวง	национален парк као луанг	khao luang national park
อุทยานแห่งชาติไทรทอง	национален парк сай тонг	sai thong national preserve area
อุทุมพรพิสัย	uthumphon phisai	utompisai - an area in thai province
อุบล	убон	ubol - a place in thailand
อุปกรณ์	оборудване	instrument
อุปกรณ์คอมพิวเตอร์	компютърни аксесоари	computer hardware
อุปนิสัย	характер	manners
อุภัยราศี	прости зодията	ambivert zodiac
อุรุกวัย	уругвай	urookwai - a location
อุเทน	uthen	utain - a male's name
อู	ou	u (a vowel)
อู๋	wu	auu (first name)
อเมริกัน	американски	american
อเมริกา	америка	america, usa
อเมริกาเหนือ	северна америка	north america
อเล็กซานเดอร์	александър	alexander
อเล็กซ์	алекс	alex
อโลหะ	неметал	nonmetal
อ่อนเพลีย	уморен	fatigue
อ่าน	прочети	read
อ่าวลึก	ао луек	ao luek
อ้างว่า	заявете това	claim
อ้างว้าง	пуст	loneliness
ฮอกกี้	хокей	hockey
ฮอท	горещ	hot
ฮอฟมัน	хофман	hoofman - a name
ฮอยเกนส์	hogens	huygens
ฮอร์โมน	хормон	hormone
ฮอลแลนด์	холандия	holland
ฮอลโลว์	кух	hollow (as in dead soul)
ฮอว์ค	сийхоукс	hawk
ฮักบี้	довиждане	hugby - an album that received many awards
ฮันกึล	хангул	hangeul
ฮัมบูร์ก	хамбург	hamburg
ฮาจิ	хачи	haji
ฮาตาเกะ	hatake	hatake
ฮานอย	ханой	hanoi
ฮายาโตะ	хаято	hayada - a japanese surname
ฮารุกะ	харука	haruka - a japanese name
ฮาวาย	хавай	hawaii
ฮิซาชิ	хисаши	hitachi
ฮิซานะ	hisana	hisana
ฮิตเลอร์	хитлер	hitler
ฮินาตะ	хината	hinada - a japanese story
ฮิมาวาริ	himawari	himawari - a japanese surname
ฮิราโกะ	hirako	hirako (japanese name)
ฮิวงะ	hyuga	hewnga - a japanese name from a story
ฮิโซกะ	hisoka	hisoka
ฮิโรชิ	хироши	hiroshi
ฮีชอล	heechul	heechul
ฮุก	кука	hook
ฮโยยอน	hyoyeon	hyoon - a dancer from japan
ฯพณฯ	негово превъзходителство	two thai alphabets.  abbreviation that means many things
เกตส์	гейтс	gates
เกตุทัต	ketthat	kettut - a surname
เกมที่	играта	game number _________
เกมบุค	игра	game book
เกรย์	сив	gray
เกษตรกรรม	селско стопанство	farming
เกษตรวิสัย	kaset wisai	kasetvisai (name of thai district)
เกษมศรี	kasemsri	kasemsri surname
เกอริง	геринг	the name 'gerring'
เกอไทต์	гьоте	goethite mineral
เกาหลีใต้	южна кореа	south korea
เกาะ	остров	island
เกาะคา	кауай	ko kha
เกาะลูซอน	остров лузон	luzon island
เกาะสุมาตรา	суматра	sumatra
เกิด	е роден	born
เกิดขึ้นหลังจากมหาวิทยาลัยศรีนครินทรวิโรฒวิทยาเขตต่างๆ	възникна след университета шринахаринвирот	happened after srinakarinviroj university started
เกิดขึ้นเมื่อวันที่	възникна на	birthdate
เกิดจากการรวมชิ้นส่วนที่	причинено от комбиниране на части, които	put together to form something
เกิดจากการรวมตัวของ	причинено от включването на	combination of
เกิดจากเชื้อไวรัส	причинява се от вирус	occur from the viral agent
เกิดนิมิตร	създайте визия	caused a vision/realization
เกียรติ	чест	honour
เกียรติประวัติ	чест	biography
เกียรติศักดิ์	слава	reputation.  kietisak can be a male's name
เกียวโตะ	киото	kyoto
เก็กโค	checco	gecko
เขตคลองสาน	област хлонг сан	klongsan district
เขตจอมทอง	район чом тонг	jomthong area
เขตดุสิต	dusit	khet dusit
เขตที่	област	district number _______
เขตบางกอกใหญ่	район бангкок яй	bangkok yai district in thailand
เขตบางซื่อ	област банг сю	bang sue district
เขตบางแค	банг хае	bang khae district
เขตปทุมวัน	pathumwan	pathum wan district
เขตภาษีเจริญ	област фаси чароен	phasi charoen district
เขตมีนบุรี	област мин бури	min buri district
เขตรักษาพันธุ์สัตว์ป่า	светилище за дивата природа	national wildlife preserve
เขตรักษาพันธุ์สัตว์ป่าภูหลวง	светилище на дивата природа phu luang	wildlife preserve
เขตลาดกระบัง	lat krabang	lad krabang district
เขตวังทองหลาง	район wang thonglang	wang thonglang district
เขตวัฒนา	област ватана	watana district
เขตสวนหลวง	област суан луанг	suan luang district
เขตสาทร	sathon	sathorn area
เขตห้วยขวาง	хуай кванг	huai khwang district
เขตเลือกตั้งที่	квартал	election area number
เขมนิจ	властен	khemanit
เขากล่าวว่า	той каза	he said
เขาทราย	хао сай	sand dunes
เขียนว่า	написа това	wrote
เขียนโดย	написано от	written by
เขี้ยวพิษ	токсични зъби	vemon fangs
เขื่อนกิ่วลม	kio wind dam	kio lom dam
เขื่อนป่าสักชลสิทธิ์	язовир пасак чонлазит	parsakchonlasit dam
เขื่อนลำปาว	язовир лампао	lum pao dam
เขื่อนแม่งัดสมบูรณ์ชล	язовир mae ngad somboon chon	mae ngud som bul chol dam in chiangmai
เข็มศิลปวิทยา	иглени изкуства	khem sinlapawitthaya
เข็มอัปสร	игла	kem uppasorn - a thai drama
เข่า	коляно	knee
เข้าฉาย	шоу	release date
เข้าชิงไนน์เอ็นเตอร์เทนอวอร์ดส	номиниран за награди за девет забавления.	compete in entertaining world
เข้ารอบ	финалист	made it to the next round, selected from the initial round
เข้าเฝ้า	да има публика	visit (word for the king)
เคน	познание	ken
เคนยา	кения	kenya
เคมีไฟฟ้า	електрохимия	electrochemistry
เคยสู้กับโกคุเทระ	използва се за битка с гокудера	fought with gokudera
เครือข่าย	мрежата	network
เครื่องขัตติยราชอิสริยาภรณ์อันมีเกียรติคุณรุ่งเรืองยิ่งมหาจักรีบรมราชวงศ์	в памет на голямата чест на династията чакри	something used in a thai ceremony - too obscure
เครื่องดีด	щтрум	thai string musical instruments
เครื่องตี	beat машина	musical intrument
เครื่องบิน	самолет	airplane
เครื่องปั้นดินเผาและเซรามิค	керамика и керамика	pottery and ceramic
เครื่องยนต์	двигател	engine
เครื่องราชอิสริยาภรณ์	отличителни знаци	the king's accessories for ceremonies
เครื่องราชอิสริยาภรณ์อันเป็นที่เชิดชูยิ่งช้างเผือก	знакът, който се прославя от белия слон	order of the white elephant
เครื่องราชอิสริยาภรณ์อันเป็นสิริยิ่งรามกีรติ	знакът на голямата слава на кирати	king's accessories
เครื่องราชอิสริยาภรณ์อันเป็นโบราณมงคลนพรัตนราชวราภรณ์	древна инсигния	the ancient and auspicious order of the nine gems
เครื่องสาย	струнни инструменти	string instrument
เครื่องแต่งกาย	костюм	clothes
เคลลี่	кели	kelly
เคอาร์วาย	kryy	k.r.y
เค้ก	торта	cake
เงิน	пари	money
เงินทุน	финансиране	fund
เงินในบัญชีธนาคาร	пари в банкова сметка	balance
เงี้ยว	заплетен	shan tribe in northern part of thailand
เจ	j	j.
เจนี่	джени	jenny
เจมินี่	зодия близнаци	gemini
เจริญ	растат	charoen
เจสเปอร์	йеспер	jasper
เจียะแจ	jae jae	nine emperor gods festival
เจี๊ยบ	пиле	jeab (thai name)
เจเน็ต	джанет	janet
เจ็ดเทพโจรสลัด	shichibukai	seven warlords of the sea
เจ็บ	язва	pain
เจ้าของจุกนม	собственик на зърната	the owner of the baby's bottle
เจ้าจอม	майстор	king's concubine
เจ้าฟ้ากรมพระยานริศรานุวัดติวงศ์	принц кром фрая нарисарану, храм тивун	refer to a title of a royal family member - jao fa krom pra ya rissanuwattiwong
เจ้าฟ้ากรมพระยานริศรานุวัติวงศ์	принц кром фрая нарисара нуватунг	prince narisara nuvativongse
เจ้าฟ้าจิตรเจริญ	принц житчароен	prince chitcharoen
เจ้าฟ้าภาณุรังษีสว่างวงศ์	принц фанурангсеесавангвонг	prince panuragui bright chestnut.
เจ้าฟ้ามหาวชิราลงกรณ	принц маха ваджиралонгкорн	thailand's crown prince
เจ้าฟ้ามหาวชิรุณหิศ	принц махаваджирунхит	crown prince maha vajirunhis
เจ้าฟ้ามหิดลอดุลยเดช	принц махидол адуладей	prince mahidol adulyadej
เจ้าฟ้ามหิดลอดุลเดช	принц махидол адуладей	a member of thai royalties
เจ้าฟ้าหญิง	принцеса	princes
เจ้าฟ้าอุบลรัตนราชกัญญา	чаофа убонратана раджаганя	princess ubon ratana graz's' contract.
เจ้าหนี้การค้า	дължима сметка	trade account payable
เจ้าเมือง	губернатор	mayor
เจ้าเมืองขุขันธ์	губернатор на хухан	a name of the head of the state
เจ้าโลก	хегемония	world conqueror
เฉพาะด้านตะวันออกเฉียงใต้เท่านั้นที่เป็นที่ราบลุ่มแม่น้ำโขง	само югоизточната страна е басейна на река меконг.	only south-east area that is in mekhong plateau
เฉลิม	chalerm	chalerm - a male's name
เฉลิมชัย	chalermchai	chalermchai
เฉลิมชัยเจริญกิจ	chalermchai charoenkit	chalermchaichareonkij
เฉลิมพระเกียรติ	чест	chaloem phra kiat
เฉลิมพล	chalermpol	shalermpol - a surname
เฉลิมแสน	chalermsaen	chaloemsaen
เฉลียว	възприемчив	chaleuw - a male's name
เชส	гонитба	(jp morgan) chase
เชอร์รี่	череша	cherry
เชา	храна	chow -  a chinese name
เชาวน์	интелигентност	chow - a name
เชาวราษฎร์	chaowarat	chowarat - the surname of a famous actress
เชิญยิ้ม	усмихни се	smile
เชิดชัย	conquer	"name ""churd-chai"""
เชียงกลาง	чианг кланг	chiang klang
เชียงของ	chiangkhong	chiang khong
เชียงดาว	чианг дао	chiang dao
เชียงปุม	chiang pum	chiang poom - area in thailand
เชียงยืน	чианг юен	chiang yuen
เชียงราย	чианг рай	chiang rai
เชียงใหม่	чианг май	chiang mai
เชี่ยววงศ์กุล	chiewwongkun	chiaowongkul
เชื่อมต่อกับรถไฟฟ้ามหานคร	свързан е с mrt	connect with skytrain
เชื่อมแม่น้ำท่าจีน	свържете река tha chin.	confluence to the ta jean river
เชื้อชาติ	раса	helping the country
เชื้อรา	гъбичките	fungus
เช็ค	проверка	check
เช่นกัน	както и	as well
เช่นเดียวกัน	по същия начин	similar to
เช้ามืดวันที่	зората на деня	in dawn of
เช้าวันรุ่งขึ้น	на следващата сутрин	next morning
เซกิ	seki	seki
เซน	дзен	saint
เซนทอร์	кентавър	centaur
เซบาสเตียน	себастиан	sebastian
เซฟ	запази	save
เซลล์	клетка	cell
เซสติโม	сето	settimo
เซอร์	господине	sir
เซอร์วิส	обслужване	service
เซอร์เบีย	сърбия	serbia
เซอวิวาสแตติน	cervivastin	cerivastatin - drug
เซโรกัชเชอร์	серо къчър	sero gusher - a type of weapon
เซโรนอส	seronos	zeronos
เซโรไลเนอร์	seroliner	seroliner
เซ็กส์	секс	sex
เซ็นทรัล	централен	central - department stores in thailand
เซ็นทารา	centara	centara
เซ็นเซอร์	сензорът	sensor
เณร	новак	samanera
เดคลิเนชัน	decloration	declination
เดชา	дача	decha
เดธโน้ต	забележка за смъртта	death note - a mysterious japanese cartoon
เดนกัชเชอร์	denkucher	den gusher - a weapon in japanese movies
เดนโอ	den o	den-o
เดนโอเบลท์	denobelt	den-o belt
เดย์	ден	day
เดอะซิมส์	симовете	the sims
เดอะฮาเดส	хадите	the hades
เดอะฮาเดสแชปเตอร์	главата на хадес	the hades chapter
เดิม	стар	at first
เดิมชื่อ	по-рано	former name
เดิมที	първоначално	at first
เดิมเรียกว่า	познат още като	formerly known as
เดียวกัน	същото	same
เดือดทะลุจุดศูนย์	кипене през центъра	zero point breakthrough
เดือนกุมภาพันธ์	февруари	february
เดือนตุลาคม	октомври	october
เดือนตุลาคมมีฝนตกชุกที่สุด	октомври е най-дъждовният.	highest amount of rainfall in october
เดือนธันวาคม	декември	december
เดือนมกราคม	януари	january
เดือนมิถุนายน	юни	june
เดือนอ้าย	лунен месец	first lunar month
เด็กหญิงอายุ	старо момиче	the girl's age
เด็กและเยาวชน	деца и младежи	children and youth
เต่า	костенурка	tao (first name)
เต๋อ	да се	ter
เถรวาท	доктрина	buddha's teaching
เทคนิคอิลลูชั่น	техника на илюзия	technique illusion
เทควันโด้	таекуондо	tai kwon do
เทคโนโลยี	технологията	technology
เทคโนโลยีสารสนเทศ	информационни технологии	san son tej techonology
เทนนิส	тенис	tennis
เทนโจอิน	теньо-в	tenjoin - a character in a japanese story
เทพพิทักษ์	theppitak	theppitak
เทพมรณะ	смърт	bleach
เทพหัสดิน	бог на небето	tephussadin (a surname)
เทพอานูบิส	анубис	anubis
เทพอาเตน	атина	aten
เทพีเธมิส	богиня	themis
เทริโอ	therio	terio - surname of a singer
เทวดา	ангел	angel
เทวรูป	идол	graven image
เทศบาล	общината	municipality
เทศบาลนครขอนแก่น	община хон каен	khon khan public works
เทศบาลนครนครราชสีมา	нахон ратчасима	nakorn rachasrima province public work
เทศบาลนครนครศรีธรรมราช	нахон си тамарат	nakorn sri thamarat city public works
เทศบาลนครเชียงราย	чианг рай	chiang rai province public works
เทศบาลนครเชียงใหม่	община чианг май	chiang mai municipality
เทศบาลเมืองชัยภูมิ	община chaiyaphum	mueang chaiyaphum
เทศบาลเมืองบุรีรัมย์	buriram	bureerum public works
เทศบาลเมืองมหาสารคาม	община маха саракам	thesaban mueang maha sarakham
เทศบาลเมืองมุกดาหาร	община мукдахан	mookdahan public works
เทศบาลเมืองสกลนคร	община сакон нахон	municipality of sakonnakon
เทศบาลเมืองหนองคาย	община нонг хай	nong khai municipality
เทศบาลเมืองหนองบัวลำภู	община nong bua lamphu	nong bua lam phu town municipality
เทศวิศาล	експанзивен	tasavisakal - a surname
เทิดศักดิ์	чест	therdsak
เทียนทอง	златни свещи	tientong - a male's name
เทียนเงิน	сребърна свещ	tienngern
เทียนโพธิ์สุวรรณ	тиан фо суван	tianphosuwan (thai last name)
เทเบิลเทนนิส	тенис на маса	table tennis
เทโรศาสน	теро сасана	terosat football club
เท็ดดี้	теди	teddy
เท็นเท็น	десет десет	tin-tin
เท่ง	тенг	teng (first name)
เท่านั้น	само	only
เธคุนุ	поддържа	dhekunu
เธรซ	тракия	thrace - an area in greece
เธอกับฉัน	ти и аз	you and i
เธอจะอยู่กับฉันตลอดไป	ще останеш с мен завинаги	you will be with me forever
เธอยัง	вие все още	tur yung
เธอเป็นเพื่อนอาบาราอิ	тя е приятел на абарай.	she is a friend of arbarae
เนกิ	negi	negi
เนย	масло	butter
เนรมิต	измислям	casting a spell
เนะ	прав	ney
เนื่องจาก	от	because
เนื่องจากประเทศเหล่านั้นอยู่ในตำแหน่งบนโลกที่ต่างไปจากประเทศไทย	защото те са в положение на земята, което е различно от тайланд	because those countries are in the group of...
เนื้อที่	■ площ	area
เนื้อที่ประมาณ	приблизителна площ	approximate area
เนื้อร้อง	текстове на песни	lyrics
เนื้อเรื่องย่อ	резюме	summary
เนเธอร์แลนด์	холандия	netherlands
เนโกะ	neko	neko
เน็น	нен	nen
เบจิต้า	bechita	vegeta
เบธเลเฮม	витлеем	bethleham
เบนจามิน	най-малкото дете	benjamin
เบรกมา	почивка	bregma
เบริธ	верита	berith
เบลเฟกอล	bellegal	belphegor- a demon in a legend
เบส	бас	bass
เบอร์ลิน	берлин	berlin
เบา	светлина	soft (voice)
เบาท์	baut	(dieric) bouts
เบาหวาน	диабет	diabetes
เบื่ออาหาร	отегчен	not appetite, eating disorder.
เบื้องหลัง	заден план	behind the sence
เบโทเฟิน	бетовен	beethoven
เบ็นเท็น	бен 10	ben 10
เปรม	удовлетворен	pream
เปรี้ยว	вгорчи	sour
เปรู	перу	peru
เปลวไฟ	пламък	flame
เปลี่ยนชื่อเป็น	преименуван на	changed the name to
เปลื้อง	събличам	nude
เปล่งพานิช	plengpanich	plengpanich
เปอร์เซีย	персия	persia
เปอร์โตริโก้	пуерто рико	puerto rico
เปิดสอนระดับปริญญาตรี	отворен за бакалавърско обучение	offer bachelor degree curriculum
เปียงยาง	пхенян	piang yang - in north korea
เปียโตร	pietro	pietro
เปียโน	пиано	piano
เปโซ	песо	peso
เป็ด	патица	duck
เป็น	сте	is
เป็นขนมของชาวไทยมุสลิม	десерт е на тайландски мюсюлмани	is a thai-muslim dessert
เป็นครั้งแรก	първият път	first
เป็นงานเขียนในชุด	е набор от писане	in the edition of...
เป็นต่อ	срещу	pen to
เป็นต้น	и т.н.	for example
เป็นต้นมา	от	onward
เป็นต้นไม้ประจำมหาวิทยาลัย	е дърво на университета	tree of university
เป็นบัวในสกุล	е лотос в рода	is a lotus in the family
เป็นประธาน	станете президент	principal of
เป็นปลาตู้สวยงาม	е красива аквариумна риба	is an ornamental fish
เป็นพระราชโอรสพระองค์เดียวในพระบาทสมเด็จพระปรมินทรมหาภูมิพลอดุลยเดช	е единственият син на цар бумибол адулядей	is the only son of
เป็นพ่อของ	бащата на	is the father of
เป็นวิญญาณเทียมเพศชาย	е мъжки изкуствен дух	the spirit who is a male
เป็นสีประจำ	редовен цвят	official color
เป็นหนึ่งใน	е един от	is one of
เป็นหัวหน้าพรรค	партиен лидер	party leader
เป็นอดีตหัวหน้าหน่วยที่	бивш лидер на звеното	is the former leader of the unit
เป็นอาวุธ	като оръжие	as a weapon
เป็นเครื่องหมายแสดงว่า	това е знак, че	indicates that
เป็นเจ้าเมืองปกครอง	губернатор	governor
เป็นเมืองหลวง	столицата е	capital
เป็นเวลา	за	utilized time
เป็นโฮโมโลกัสกับ	хомолог е с	homologous
เป๊ปซี่	пепси	pepsi
เพกาซัส	пегас	pegasus
เพชร	диамант	diamond
เพชรบุรี	печабури	petchaburi province
เพชรบูรณ์	петчабун	prechabun
เพชรพระอุมา	диамант фра ума	ancient diamond
เพชรา	старец	petchara - name of a famous actress
เพชรเกษม	petchkasem	petchakasem area in bangkok
เพดานอ่อน	мек таван	gill
เพทาย	циркон	zircon
เพพซิน	пепсин	pepsin
เพราะ	защото	because
เพราะว่า	защото	because
เพรียะ	piriya	preah - cambodia
เพลงประกอบภาพยนตร์	саундтрак към филма	soundtrack
เพลงประจำจังหวัด	провинциална песен	province anthem
เพลงประจำมหาวิทยาลัย	университетски песни	university song
เพลงปิดเรื่อง	кавър песен	pid reung song
เพลงพระราชนิพนธ์	кралска музика	the king's song
เพลงลูกทุ่ง	кънтри музика	folk song
เพลงลูกทุ่งขับร้อง	кънтри музика	luk thung song
เพลงอีแซว	музикална закачка	a type of thai country music
เพลงเปิด	песен за откриване	opening song
เพลงเปิดเรื่อง	песен за откриване	opening song
เพลย์สเตชัน	конзола за игри	playstation
เพลโต	платон	plato
เพศ	секс	sex
เพศชาย	мъжки пол	male
เพิ่มมา	| повече ▼	addition
เพียงพอ	достатъчно	enough
เพื่อ	за	for
เพื่อเป็นการเผยแผ่พระพุทธศาสนาและประชาสัมพันธ์กิจกรรมทางพระพุทธศาสนาต่าง	с цел пропагандиране на будизма и насърчаване на религиозните дейности	passing knowledge about buddhism
เพื่อใช้ร่วมกับตัวชี้วัดอื่น	да се използва с други индикатори	to be used with other indicators
เพ็ชรทาย	phettha	petchtai
เฟนิรามีน	фенирамина	pheniramine
เฟย์	вярност	fay
เฟรดริก	фредерик	fredrick
เฟส	фаза	phase
เฟอร์นิเจอร์	мебели	furniture
เฟื่องอารมย์	foudarom	fueangarom
เภสัชกร	фармацевт	pharmacist
เภสัชจลนศาสตร์	фармакокинетика	pharmacokinetics
เม	може	may
เมกา	mega	mega
เมฆ	облак	clouds
เมฆออร์ต	оортов облак	ash cloud in the space
เมจิ	мейджи	maji - a nickname
เมตร	м.	metre
เมทริกซ์	матрица	matrix
เมทะนี	metani	metanee - the surname of a famous actor
เมอร์คิวรี	живак	mercury
เมือง	град	town
เมืองทองฯ	муанг тонг	muangthong
เมืองนครราชสีมา	нахон ратчасима	nakornrachasrima city
เมืองปทุมธานี	pathum thani	mueang pathum thani
เมืองปราจีนบุรี	prachinburi	prajinburi city
เมืองพิจิตร	фичит	pijit city
เมืองพิษณุโลก	фитсанулок	phitsanulok
เมืองยอง	еленски град	mueng-yor
เมืองลำพูน	ламфун	lumpoon province
เมืองสกลนคร	сакон нахон	sakon nakhon
เมืองสิงห์	singha	muangsing
เมืองสุรินทร์	сурин	surin city
เมืองหลวง	капитал	capital city
เมืองหลวงของอาณาจักรเขมร	столица на империята кхмер	capital of cambudia
เมืองเคมบริดจ์	кеймбридж сити	city of cambridge
เมืองเอก	ake city	mueang-ake
เมืองโคราช	korat	muang korat
เมืองใหญ่	голям град	city
เมืองใหญ่ในเขตนี้	големи градове в този квартал	capital presently
เมื่อประมาณ	кога	estimate
เมื่อปีพศ	миналата година	in buddhist era
เมื่อปีพุทธศักราช	в годината на будистката ера	in b.e.
เมื่อวันจันทร์	в понеделник	on monday
เมื่อเดือนกันยายน	миналия септември	in september
เมื่อเดือนมีนาคม	през март	in march
เม็ดขนุน	jackfruit	metkhanun
เม่น	таралеж	porcupine
เย	вие	yay - a sound
เยลโล่	жълт	yellow
เยอรมนี	германия	germany
เยอรมัน	немски	german
เยาวชน	младежта	youth
เยาวชนอายุ	младежка възраст	youth age of ...
เยาวราช	китайски квартал	yaowaraj
เยื่อหุ้มสมอง	кора	meninges
เรซูเม	продължи	resume
เรด	червен	red
เรดวัน	червен ден	redone
เรย์	лъч	ray
เรวดี	добри новини	rawadee
เราเตอร์	router	router
เริ่มการผลิตนำเข้า	започнете производството на внос	importing
เริ่มก่อสร้าง	започнете строителството	began constuction
เริ่มจากเดือนพฤศจิกายนเมษายน	от ноември до април	begins from november to april
เริ่มตั้งแต่อาณาจักรอยุธยาได้โจมตีอาณาจักรเขมร	започвайки с кралството аюттая, атакуващо кхмерското кралство.	ever since the ayudhya (military) assault...
เรียกกันว่า	наречен	called
เรียกว่า	наречен	call
เรียล	реален	real
เรียว	строен	ryo
เรียวทาโร่	ryotaro	totoro - a japanese cartoon
เรียวเฮ	ръж хе	reohay - a japanese character
เรียะชอาณาจักร	царство	reacheanachak
เรืองรุ่ง	нажежен	rueangrung
เรืองศรี	rueangsri	rueng sri - a surname
เรือตรี	лодка	ensign
เรือนนาค	нага къща	nak castle
เรือยกพลขึ้นบก	кацащ кораб	boat for advance the army
เรือสำรวจ	анкетиран кораб	survey vessel
เรือเร็วโจมตี	скоростна атака с лодка	fast attack craft
เรือใบ	платноходка	sailboat
เรื่อง	предмет	story
เรื่องย่อ	резюме	synopsis
เรื่องสั้น	разказ	short story
เร้กเก้	реге	reggae
เลข	номер	mathematics
เลขที่	номер	number
เลขาธิการสหประชาชาติ	генерален секретар на организацията на обединените нации	united nations secretary-general
เลนส์	обектива	lens
เลออน	leon	lyon
เลิฟ	любов	love
เลือดออกตามไรฟัน	скорбут	bleeding of the gum
เลโอ	лъв	alo
เลโอนาร์โด	леонардо	leonardo
เล็ก	малък	small
เล่ม	книга	book
เล่มที่	номер на книгата	volume
เวทีทอง	златна сцена	golden podium
เวล	отстъпвам	vail
เวลาประมาณ	очаквано време	approximate time
เวสต์	запад	west
เวอร์ชัน	версия	version
เวอร์โก้	vergo	virgo
เวิร์คพอยท์	workpoint	workpoint company
เวิร์คพอยท์สตูดิโอ	workpoint studio	workpoint studio
เวิร์ม	глисти	worm
เวิลด์	светът	world
เวียงสระ	wiang sa	wiang sa
เวียงสา	wiang sa	wiang sa
เวียนเทียนรอบอุโบสถหรือสถูปเจดีย์พุทธสถานต่าง	обикаляйки около параклиса или пагодата	a thai religious ceremony
เวโรนา	верона	verona in italy
เว็บ	мрежата	web
เว็บสเตอร์	уебстър	webster
เว็บเบราว์เซอร์	уеб браузър	web browser
เว็บไซต์ของเกมส์	уебсайт за игри	gaming website
เว็บไซต์ซีไอเอ	уебсайт на цру	cia website
เว้นวรรค	пространство	space
เศรษฐกิจพอเพียง	икономика на достатъчност	sufficiency economy
เศรษฐบุตร	sethaputra	settabut - the family that started bus system in thailand
เศรษฐศาสตร์จุลภาค	микроикономика	microeconomics
เศรษฐศาสตร์มหภาค	макроикономика	macroeconomics
เสงี่ยม	възпитан	sa-ngiam
เสชนะ	печеля	sechana
เสด็จพระราชสมภพ	царско раждане	royal birth
เสนอชื่อเข้าชิงและรับรางวัล	номинирайте и получете награда.	nominate and win
เสนา	sena	sena
เสนาเมือง	сена сити	senamuang
เสนีวงศ์	сени вонг	seniwong
เสน่ห์	чар	sanea
เสมอ	винаги	always
เสรี	безплатно	seri
เสรีภาพ	свобода	freedom
เสียง	звук	sound
เสียงเปิด	отворен звук	approximant, semi-vowel
เสียงเสียดแทรก	фрикативен звук	noise
เสือจากัวร์	ягуар	jaquar
เสื้อครุย	роба	gown
เส้นทแยงมุม	диагонал	diagonal
เส้นพุ่ง	линия	yarn that is used for weaving
เส้นโค้ง	крива	curve
เส้นใย	влакно	polymer, yarn
เหงื่อ	пот	sweat
เหตุการณ์	събитие	situation
เหตุการณ์สำคัญ	важно събитие	important event
เหรียญ	медал	coin
เหรียญกษาปณ์	мента	coin
เหรียญทอง	златен медал	gold medal
เหรียญรัตนาภรณ์	ратанапорна монета	a special thai medallion
เหลือง	жълт	yellow
เหลือสมาชิก	оставащи членове	members left
เหล็ก	стомана	iron
เหล่านี้	тези	these
เหล่าสุนทร	laosonthorn	soontorn group
เห็นภาพลวงตา	вижте илюзията	seeing hallucination
เอก	първи	the first tonal marker of thai writing system represented by  '
เอกชน	частен	private
เอกซ์	х	x
เอกราช	независимост	sovereignty
เอกวาดอร์	еквадор	edwardor
เอกสิทธิ์	привилегия	privilege
เอจิเซ็น	echizen	echizen
เอชไอวี	хив	hiv, human immunodevficiency virus
เอซ	aces	letter h
เอตาสีติ	atacati	sesasiti
เอนจิเนียริ่ง	инженерство	engineering
เอนไซม์	ензим	enzyme
เอบีซี	abc	abc
เอม	цел	aim - could be a nickname
เอริค	eric	eric
เอล	el	el
เอสปาด้า	espada	eapada
เอสปาด้าตกชั้น	еспада отстъпи	aspata
เอสเอ็ม	sm	sm entertainment from korea
เอสโตเนีย	естония	astonia - a country
เออร์โกสเฟียร์	ergosphere	ergosphere
เอี่ยมยิ่ง	аз съм	super, awesome
เอี่ยมสุข	щастлив съм	iamsuk
เอื้อย	ури	eay - a thai nickname
เอเชีย	азия	asia
เอเชียตะวันตกเฉียงใต้	югозападна азия	southwest asia
เอเชียเหนือ	северна азия	north asia
เอเชียแปซิฟิก	азия тиха	asia-pacific
เอเชียใต้	южна азия	south asia
เอเธนส์	атина	athens
เอเอฟซี	afc	afc
เอเอฟซีแชมเปียนส์ลีก	шампионска лига afc	afc championship
เอ็กซ์โป	международно изложение	expo
เอ็กโทเดิร์ม	ecterm	ectoderm, top level of skin layer.
เอ็กโปรพลาซ่า	expo plaza	expo plaza in thailand
เอ็ดดูเทนเมนท์	edutainment	edutainment
เอ็ดเวิร์ด	едуард	edward
เอ็น	лигамент	n
เอ็นบีเอ	нба	nba - national basketball association
เอ็นเตอร์เทนเม้นท์	забавление	entertainment
เอ็นเทอร์เทนเมนท์	забавление	entertainemnt
เอ็มม่า	ема	emma
เอ๋	а	ah - a nick name
เฮติ	хаити	haiti
เฮลมุต	хелмут	helmut
เฮสเตีย	хестия	hestia
เฮอร์เชล	herschel	herschel
เฮาส์	къща	house
เฮียวงะ	hyuga	heonga
แกง	къри	soup
แกมเบีย	гамбия	cambia
แกรนซ์	грант	grantz
แกรมมี่	грами	grammy
แกริซั่น	гарнизон	garrison - an english name
แกลง	klaeng	glang
แกลเลอรี	галерия	gallery
แกสโทรโพดา	gastropoda	"name ""gastropoda"""
แกะ	овца	sheep
แกแล็คซี่	галактика	galaxy
แก่	да се	aging
แก้ว	стъкло	glass
แก้วทอง	златно стъкло	golden cup
แก้วบัวสาย	стъкло лотос	kaeobuasai
แก๊สธรรมชาติ	природен газ	natural gas
แขก	гост	indian
แขน	въоръжете	arm
แขวงจำปาสัก	провинция чампасак	champasak province
แขวงหลวงพระบาง	подрайон луанг прабанг	luang pra bang province
แคดเมียม	кадмий	cadnium
แคทแพท	котка пат	kat - pat kamikaze - the thai famous stars
แคน	кан	kan - a type of thai music
แคนดี้	бонбони	candy
แคนเซอร์	рак	cancer
แคม	камери	cam
แคมป์เบลล์	кембъл	campbell
แคมเปญ	кампанията	campagne
แคมเล็ก	малка камера	vagina fold
แคมใหญ่	голяма камера	labia
แคร็กเกอร์	орешарка	crackers
แคลคูลัสเชิงปริพันธ์	интегрално смятане	integral calculas
แคลคูลัสเชิงอนุพันธ์	диференциално смятане	differential calculus
แคลอรี	калории	calorie
แคลิฟอร์เนีย	калифорния	california
แคลิฟอร์เนียม	калифорния	californium
แคว้น	област	kwon - a korean surname
แจ	конфитюр	live purely and clean both in body and mind - from chinese belief
แจ็กสัน	джаксън	jackson
แจ็ค	крик	jack
แจ๊ค	крик	jack
แจ๊ส	джаз	jazz
แด	dae	dae
แดงทั้งแผ่นดิน	цялата земя червена	red (political party all over the country
แดนสุพรรณ	suphan	dansuphan
แดเนียล	даниел	daniel
แตน	стършел	grass hopper
แต่งงาน	се ожени	wedding, marriage
แต่งตั้ง	назначат	giving a new title to
แต่งโดย	съставен от	composed by
แต่ใน	но в	but in
แต่ในปัจจุบัน	но сега	in the present
แต่ไม่ประสบความสำเร็จ	но без успех	failed
แต่ไม่สำเร็จ	но неуспешно	no success
แถบ	бар	flat fish
แทซิทัส	tasitus	tacitus
แทน	представляват	instead
แทนเจนต์	допирателна	tangent
แทยอน	taeyeon	tae yon
แทลเลียม	талий	thallium
แท็กซี่	такси	taxi
แท็บเล็ต	таблетка	tablet computer
แนท	нат	nat
แนวความคิดที่	понятие	idea number...
แนวพระราชดำริ	кралска инициатива	royal initiative
แนสแด็ก	nasdaq	nasdaq
แบคทีเรีย	бактерии	bacteria
แบงค์	банка	bank
แบทเทิลบรอลเลอร์	боен танкер	battle brawlers
แบรนด์แอมบาสเดอร์	посланик на марката	brand ambassador
แบ่งประเทศไทยออกเป็น	разделете тайланд на	dividing thailand into 6 areas
แบ่งออกเป็น	разделена на	divided into...
แบ่งออกได้เป็น	разделена на	divided into
แบ่งได้เป็น	може да се раздели на	divided into
แป้ง	брашно	pang
แผนที่	карта	map
แผนไพรีพินาศ	консорциум план	pan pirepinat - a plan to destroy the mobs
แผลศักดิ์สิทธิ์	свещена рана	stigmata
แผลไหม้	бърнс	burn
แพทย์	лекар	physician
แพน	тиган	pan
แพร่	разпространение	the state of praa
แพลทฟอร์ม	платформа	platform
แพะ	коза	goat
แพ้	губя	to lose
แฟชั่น	мода	fashion
แฟนเก่า	бивше гадже	ex boyfriend/girlfriend
แฟมิลีที่ไปพักผ่อนที่เกาะมาเฟีย	семейство отиват да почиват на мафиотския остров	family that went to mafia island for vacation
แฟรงค์	откровен	frank
แฟรี่	фея	fairy
แฟรี่เทล	приказка	fairy tale
แมกนีเซียม	магнезиев	magnesium
แมคอินทอช	шлифер	mcintosh
แมนดาริน	мандарина	mandarin
แมนเชสเตอร์	манчестър	manchester
แมว	котка	cat
แมวป่า	дива котка	jungle cat
แมวลายหินอ่อน	мраморен табби	pardofelis marmorata
แมวไทย	тайландска котка	thai cat
แม็คโคร	makro	macro
แม่	майка	mother
แม่จริม	майката им	mae charim
แม่ชี	монахини	nun
แม่นาคพระโขนง	мей нак фра ханонг	mae nak phra khanong
แม่น้ำ	река	river
แม่น้ำชี	река чи	chee river
แม่น้ำทะเลสาบสำคัญ	важна езерна река	important rivers and lakes
แม่น้ำปิง	река пинг	ping rover
แม่น้ำโขง	река меконг	kong river from laos
แม่ริม	мей рим	amphoe mae rim
แยกจากคลองชักพระฝั่งซ้าย	отделете от канал chak phra отляво	forks from khlong chak phra
แยกจากคลองบางกอกน้อยฝั่งซ้าย	от канала бангкок ной вляво	forks from the left branch of khlong bangkok noi
แยกจากคลองบางกอกใหญ่ฝั่งขวา	разклонение от канала бангкок яи вдясно	split from the bankok yai canal to the right
แยกจากคลองบางกอกใหญ่ฝั่งซ้าย	разклонение от канала бангкок яи вляво	forked from khlong bangkok yai
แย้มนาม	име	yamnam - a surname
แย้มบุญเรือง	избирайки за заслуги	yaembunrueang
แรงโน้มถ่วง	земно притегляне	gravity
แร็ปเปอร์	рапърът	rapper
แลกเปลี่ยนโดยถือ	размяна чрез задържане	exchange, conversion
แลมบ์ดา	lambda	lampda
และ	и	and
และกลายเป็นอู่ข้าวอู่น้ำที่มีชื่อเสียงของไทย	и стана известен хлебник в тайланд	and becoming the futile land
และกัมพูชา	и камбоджа	and cambodia
และครอบครัว	и семейство	and family
และคำว่า	и думата	"and the word ""......."""
และจังหวัดใกล้เคียง	и близките провинции	and nearby state
และดุษฎีบัณฑิต	и доктор по философия	honorary degree
และตามสภาพเศรษฐกิจและสังคม	и според икономическите и социалните условия	and following the economy and social conditions
และตำแหน่ง	и позиция	and position
และที่สำคัญคือ	и важното е	and important thing is...
และธงของต่างประเทศ	и чужди знамена	and other countries' flags
และปัจจุบัน	и настоящ	now
และพรรคฟุนซินเปค	и партито на funchinpec	funcinpec
และรถไฟ	и да тренирам	and railways
และรัสเซีย	и русия	and russia
และสหรัฐอเมริกา	и сащ	in america
และสังคม	и обществото	and society
และสังคมศาสตร์	и социални науки	and social science
และสัตว์	и животни	and animal
และสโรชา	и сароча	and sarocha - a male's name
และหลังจากสงครามภายใน	и след вътрешната война	after inside war
และออกซิเจน	и кислород	and oxygen
และอำเภอกันทรารมย์	и окръг кантараром	and kanthararom district
และอื่น	и други	etc.
และอเมริกาเหนือ	и северна америка	and north america
และเปียโน	и пианото	and piano
และเป็น	и е	is also
และเป็นสมาชิกราชวงศ์	и е член на кралското семейство	in monarchs family
และเมืองเก่า	и старият град	old city
และเมื่อวันที่	и на	when date
และเรียกว่า	и се обади	and call
และโลก	и светът	and earth
และในปี	и през годината	and in the year
และได้ปรากฏตัวตอนภาค	и се появи в епизода	appeared
แล้วเดินเวียนรอบปูชนียสถาน	след това обиколи светилището	walk with lighted candles in hand around a temple
แวน	фургон	wan
แสงจันทร์	лунна светлина	saengchan
แสงชูโต	chuto	sangchuto - a surname
แสงทอง	sangthong	golden sun ray
แสงสิงแก้ว	sang singkaew	sangsingkaew
แสงเทียน	свещи	saengthian
แสตมป์	печат	stamp
แสนรัก	любов	saenrak
แสนโภศิก	саен фосик	sankosuk - a surname
แหลมสิงห์	лем синг	lam sing - a famous country singer in thailand
แหล่งท่องเที่ยว	туристическа атракция	tourist attraction
แหล่งโบราณคดีบ้านเชียง	археологически обект бан чианг	ban chiang archaeological site
แหวน	пръстен	ring
แหวนธรรมดา	обикновен пръстен	ordinary ring
แหวนมาเล่ริง	мъжки пръстен	ring (faux jewelry)
แห่งบันนัม	на бан нам	of bannam
แห่งสหประชาชาติ	обединените нации	of united nations
แองกวิลลา	ангуила	anguilla
แองเจิ้ล	ангел	angel
แอซิด	киселина	acid
แอด	добави	add
แอนดรอยด์	андроид	android
แอนดี้	анди	andy
แอนด์	и	and
แอนิเมชัน	анимация	animation
แอนเนลิดา	клас червеи	annelida phylum
แอนโทนี	антъни	anthony
แอฟริกา	африка	africa
แอฟริกาใต้	южна африка	south africa
แอมะซอน	амазонка	amazon
แอมเวย์	amway	amway
แอร์ไลน์	airlines	airlines
แอล	l	letter 'l'
แอลจีเรีย	алжир	algeria
แอสกี	asci	ascii
แอสซิสต์	assist	assist
แอสปาร์แตม	аспартамът	aspartame
แฮช	хашиш	hash
แฮปปี้	щастлив	happy
แฮปปี้และชาร์ล	честит и чарлз	happy and charles
แฮ็ค	hacking	hack
โกบอล	в световен мащаб	cobalt
โกร	порасна	guro
โกรกพระ	пукнатина	krok-phra
โกลด์	злато	gold
โกวิท	kowit	kowit
โกโก้	какао	cocoa
โขน	пантомима	khon
โคกสำโรง	khok samrong	koksamrong
โคนัน	конан	conan
โคฟี	кофи	kofe annan
โครงการ	проект	project
โครงการก่อสร้าง	строителен проект	project
โครงการนานาชาติ	международен проект	international program
โครงการศิลปินแห่งชาติ	проект за национален художник	national artist campaign
โครงการเรียนภาษาอังกฤษแบบเข้ม	интензивна програма за обучение по английски език	intensive english program
โครงสร้างภายใน	вътрешна структура	internal structure
โคราช	korat	khorat or nakorn rajjasrima state
โครโมโซม	хромозом	chromosome
โคล	рапица	cold
โคลอมเบีย	колумбия	colombia
โคล้ด	код	claude
โคเคน	кокаин	cocain
โคเบะ	кобе	kobe
โคแทนเจนต์	котангенс	cotangent
โคโทเน่ที่	котоне в	kotone
โฆษะ	вокализация	kosa
โฆษิตพิพัฒน์	косит фифат	the surname kopitpipat
โจจิ	joji	choji
โจเซฟ	джоузеф	joseph
โจโจ้	jojo	jojo
โช	чо	sho
โชคดี	късмет	lucky
โชว์	шоу	show
โชอิจิ	шоичи	shoichi
โชแปง	шопен	chopin
โซน	зона	zone
โซนยอชิแด	поколението на момичетата	senyosede - a japanese name
โซนี่	sony	sony company
โซล	сеул	seoul
โซลดิ๊ก	soldick	sol-dig
โซลโซไซตี้	душевно общество	soul society
โซเดียม	натрий	sodium
โซเฟีย	софия	sofia
โดจินชิ	правете джинчи	dōjinshi
โดย	от	by
โดยคำว่า	с думата	by the word
โดยตรง	пряко	directly
โดยทรงพระกรุณาโปรดเกล้าฯ	благодарно предоставено от негово величество	the king's order
โดยที่	където	by
โดยบ่งบอกถึงปริมาณและคุณภาพของสิ่งตีพิมพ์อิเล็กทรอนิกส์ของสถาบัน	чрез посочване на количеството и качеството на електронните публикации на института	stating the limitation and quality of a product
โดยปกติ	нормално	regular, common, normalcy
โดยปกติตามวัดต่าง	обикновено според различните храмове	normally, at the various temples...
โดยปกติแล้ว	нормално	usually
โดยมี	с	make available
โดยมีตัวอย่างบทพากย์ฉบัง	с примери за стихове	background movie in music video
โดยมีพระภิกษุสงฆ์นำเวียนเทียน	с монах, който води процесия, запалена със свещи	buddhist monks performing ceremony for vientien buddhist religious holiday
โดยราชบัณฑิตยสถาน	от кралския институт	by royal institute
โดยสรุป	в обобщение	in summary.
โดยเจ้าฟ้าธรรมธิเบศรไชยเชษฐสุริยวงศ์	от принц thamathibet sornchai chetchuriyawong	the name of a king
โดยใช้ชื่อว่า	по име	using name
โดยใช้ทางหลวงแผ่นดินหมายเลข	по национална магистрала	using freeway #________
โดยในวันที่	от нататък	on the date of ___
โดราเอมอนฉบับภาพยนตร์	doraemon movie edition	doraemon movie
โดเมกิ	domome	domagi - a japanese word.
โดเมน	домейн	domain
โต	пораснал	big
โตชิบา	toshiba	toshiba
โทน	тон	tone
โทนะหงษา	tonahahasa	tonahongsa - a surname
โทนี่	шик	tony
โทบรามัยซิน	tobramamcin	tobramycin
โทมัส	томас	thomas
โทรจัน	троянски	trojan
โทรลล์	troll	troll
โทริคาบูโตะ	torikabuto	torikabuto - a japanese word
โทรโข่ง	мегафон	a megaphone, portable sound directing equipment.
โน	не	no
โนบิตะ	nobita	nobita
โนบิตะและอัศวินแดนวิหค	нобита и рицарят	nobita and the winged braves
โนรา	нора	nora
โนะ	дино	noh - a japanese word
โนเบล	нобелова	nobel prize
โบตั๋นกลีบสุดท้าย	последният божур	botun kleep suttai - a novel
โบราณสถาน	археологически сайт	the ancient place
โบอิง	boeing	boeing company
โบฮีเมีย	бохемия	bohemia
โบแดง	възхитителен	bodin
โปงลางสะออน	ponglang sa-on	pong langsaoun
โปรดเกล้า	моля те	the king's order
โปรตอน	протон	proton
โปรตีน	протеин	protein
โปรเจกต์	проект	project
โปรเจกต์พิเศษ	специален проект	special project
โปรแกรมคอมพิวเตอร์	компютърна програма	computer programming
โปรโมชั่น	насърчаване	promotion
โปเกมอน	покемон	pokemon, a very popular japanese anime.
โป๊	гол	nude
โพธิ์ศรี	phosri	phosi
โพนพิสัย	phon phisai	phonphisai
โพรทิสต์	протист	protist
โพแทสเซียม	калий	potassium
โฟลต	поплавък	float
โฟลเอ็ม	flo m	phloem
โฟโตสเฟียร์	фотосфери	photosphere
โมซาร์ท	моцарт	mozart
โมบิลสูทกันดั้ม	мобилен костюм gundam	mobile suit gundam
โมรา	халцедон	agate
โมร็อกโก	марокански	morocco
โมลิบดีนัม	молибден	molybdenum
โมฮัมหมัด	мохамед	mohamad
โมเดิร์น	модерен	modern
โมเต็ต	motate	motet (sound)
โมเลกุล	молекулите	molecule
โมโคนะ	mokona	mokona - a japanese word
โมโนไซต์	mono сайт	mono site.
โยชิโนะ	йошино	yoshino
โยฮันน์	йохан	johann
โยเซฟ	джоузеф	joseph
โรค	болест	disease
โรคประจำตัว	вродена болест	personal illness
โรคปอดบวม	пневмония	pneumonia
โรคออทิซึม	аутизъм	autism
โรคุโด	rokudo	rokudo
โรคเกาต์	подагра	gout
โรคไต	заболяване на бъбреците	kidney disease
โรงพยาบาลกรุงเทพ	болница в банкок	krung thep hospital
โรงพยาบาลจุฬาลงกรณ์	мемориална болница „цар чулалонгкорн“	king chulalongkorn memorial hospital
โรงพยาบาลรามาธิบดี	болница раматибоди	ramathibodi hospital
โรงพยาบาลอานันทมหิดล	болница анандамахидол	ananthamahidol hospital
โรงพยาบาลอุตรดิตถ์	болница утарадит	uttaradit hospital
โรงละคร	театър	theater
โรงเรียนการบิน	летна школа	aviation school
โรงเรียนดาราวิทยาลัย	колеж дара	dara academy
โรงเรียนนนทรีวิทยา	училище nonsi witthaya	nontrivittaya school
โรงเรียนนายเรือ	военноморска академия	royal thai naval academy
โรงเรียนนายเรืออากาศ	royal thai air force academy	royal thai air force academy
โรงเรียนบดินทรเดชา	училище в бодиндеча	bodindecha school
โรงเรียนประชานิเวศน์	праханивец училище	prachanivet school
โรงเรียนปรินส์รอยแยลส์วิทยาลัย	принц роял колеж	the prince royal's college
โรงเรียนพระตำหนักสวนกุหลาบ	училище suan kularb tamnak	the school in the king's compound.  it is reserved for the princess and the royal family
โรงเรียนมัธยมสาธิตวัดพระศรีมหาธาตุ	демонстрация на средно училище на wat phra si mahathat	wat phrasri mahadhat secondary demonstration school
โรงเรียนมารีวิทย์	училище мери вит	maryvit school
โรงเรียนยุพราชวิทยาลัย	yupparat wittayalai school	yupparaj wittayalai school
โรงเรียนราชินีบน	горна кралическа школа	rachinibon school in thailand
โรงเรียนวัฒโนทัยพายัพ	watthanothai payap school	vattanotaipayup school
โรงเรียนศึกษานารี	naree school of education	suksanari school
โรงเรียนสาธิต	демонстрационна школа	demonstration school
โรงเรียนสาธิตแห่งมหาวิทยาลัยเกษตรศาสตร์	демонстрационна школа на университета kasetsart	kasetsart university laboratory school
โรงเรียนห้องสอนศึกษา	учебна зала в училище	class room in school
โรงเรียนเขมะสิริอนุสสรณ์	училище „хемасири анусорн“	kamasirianussorn school
โรงเรียนเจ้าพระยาวิทยาคม	училище chao phraya witthayakhom	chao praya vitanakom school
โรงเรียนเฉลิมพระเกียรติสมเด็จพระศรีนครินทร์	chaloem phrakiat somdet phra srinagarindra school	srinagarindra the princress mother school
โรงเรียนเทศบาล	държавно училище	public schools
โรงเรียนไตรมิตรวิทยาลัย	училище traimit wittayalai	trimittavitayalai school
โรงแรม	хотел	hotel
โรจูโร่	rojero	rojuro - a japanese character
โรตารี	ротационен	rotary
โรม	рим	rome
โรมัน	римски	roman
โรลเลอร์เบลด	ролково острие	rollerblade
โรส	rose	rose
โรเจอร์	прието	"name ""roger"""
โลก	свят	world
โลกแอมะซอน	амазонски свят	world of amazon
โลงหิน	саркофаг	sarcophagus
โลโซ	loso	lasso
โสณกุล	sonakul	sonakul
โสน	sesbania	sa-nho, has yellow flower, use in thai sweet/desert
โสภณ	прекрасен	sophon
โหมด	вид	mode
โหม่ง	такъми	mong - a thai musical instrument
โอกาส	шанс	opportunities
โอบามา	обама	obama
โอภาส	блясък	oh pas - a thai name
โอร์มาน	оман	oman - country
โอวีเอ	ova	ova
โอสถสภา	osotspa	osotspa
โอสถานุเคราะห์	osathanugrah	social service
โออิชิ	oishi	oochi - a name of food business in thailand
โอะกินะวะ	окинава	okinawa
โอเค	добре	ok
โอเอกซ์	морски шах	ox - a game like tic tac toe
โฮม	у дома	"english word ""home"""
โฮลดิ้ง	холдинг	houlding
ใจดี	мил	chaidi
ใช่	да!	yes
ใช้ขยายความเฉพาะบุคคล	използвайте за персонализиране	to describe
ใช้ชื่อว่า	на име	named
ใช้เวลา	отнеме време	it takes time
ใต้	при	south
ในกรณีนี้	в такъв случай	in this isituation
ในกลุ่ม	в група	in group
ในการประเมินผลงานวิจัยของสถาบัน	при оценка на резултатите от изследванията на института	in research evaluating of institute
ในการเลือกตั้ง	в изборите	election
ในกาลต่อมา	в бъдеще	later
ในขณะที่	докато	while
ในคริสต์ศตวรรษที่	през 19 век	in the #___ century
ในคศ	в годината	in a.d.
ในชิงร้อยชิงล้าน	в милиона чинг чинг	game show to compete for 1 million baht
ในช่วงปี	през годината	in the year of ________
ในช่วงสงครามเย็น	по време на студената война	during the cold war
ในช่วงสงครามโลกครั้งที่	по време на световната война	in time of world war
ในช่วงสงครามโลกครั้งที่สอง	по време на втората световна война	during world war ii
ในช่วงหลัง	по късно	later
ในช่วงแรก	в началото	in the first part, primarily
ในดาร์ฟูร์	в дарфур	inside dafur
ในต่างประเทศ	в чужди страни	foreign countries
ในทางกลับกัน	от друга страна	opposite
ในทางดาราศาสตร์	в астрономията	astrology
ในทางตรงกันข้าม	напротив	oppositely
ในบางฉบับ	в някои издания	in a certain issue (of a magazine)
ในประเทศญี่ปุ่น	в япония	japan
ในปลายปี	в края на годината	at teh end of the year
ในปี	в годината	in the year
ในปีที่	в годината	in year
ในปีนี้	тази година	in this year
ในปีพศ	в годината	in b.e. year
ในปีพุทธศักราช	в годината.	in b.e.
ในปีเดียวกัน	през същата година	in the same year
ในปีเดียวกันนั้น	през същата година	in that year
ในพระบาทสมเด็จพระพุทธยอดฟ้าจุฬาโลก	в царуването на цар буда йодфа чула лок	under the reign of one of the thailand's past king
ในพระบาทสมเด็จพระพุทธเลิศหล้านภาลัย	в негово величество краля, фра буда лертла, напалай	under one of the king of siam
ในภายหลัง	по късно	background
ในภาษาสันสกฤต	на санскрит	in sanskrit language
ในภาษาอังกฤษ	на английски	in english
ในภาษาอิตาลี่	на италиански	in italian
ในภาษาไทย	на тайландски	in the thai language
ในยุคกลาง	в средните векове	in the middle ages
ในยุคแรก	в началото	in early age
ในระบบสุริยะ	в слънчевата система	in the solar system
ในระยะหลัง	напоследък	at the end
ในระหว่างปี	през годината	between the years
ในระหว่างวันที่	през деня	during the dates
ในรัชสมัยพระบาทสมเด็จพระจอมเกล้าเจ้าอยู่หัว	по време на управлението на цар монгкут	in the reign of thailand's 4th king
ในรัฐบาล	в правителството	in the government
ในฤดูกาล	в сезон	in season
ในสมัยกรุงศรีอยุธยา	в аюттейския период	in  ayutthaya kingdom era
ในสมัยก่อน	в старите дни	in the past
ในสมัยพุทธกาล	в модерната епоха	in buddha era
ในสมัยรัชกาลที่	по време на управлението на	in period
ในสหรัฐอเมริกา	в сащ	in united states of america
ในหนังสือ	в книгата	in book
ในอดีต	в миналото	in the past
ในอดีตทุ่งกุลาร้องไห้ในฤดูแล้ง	в миналото тунг кула плачеше в сухия сезон.	thung kula rong hai in dry season in the past
ในอัลบั้ม	в албума	in the album
ในเกมเดอะซิมส์	в играта sims	sims game
ในเครือ	афилиирана	in the area of
ในเดือน	в месец	in the month of ...
ในเดือนมิถุนายน	през юни	in june
ในเดือนมีนาคม	през март	in april
ในเบื้องต้น	първоначално	primarily
ในเรื่อง	по отношение на	in story
ในเหตุการณ์	в събитието	in the event
ในเอเชียตะวันออกเฉียงใต้	в югоизточна азия	in southeast asia.
ในแฮร์รี่	грабя	in harry
ในโอกาสครบรอบ	по повод годишнината	anniversary
ใบเสมา	бойниците	boundary marker of a temple
ใหญ่	голям	large
ให้พลเอกเปรม	за генерал прем	general prem - a former military figure
ให้สมเด็จพระเทพรัตนราชสุดาฯ	за нч принцеса маха чакри сириндхорн	given to the thai's eldest princess
ให้เสียงพากย์	гласова актьорска игра	dubbed
ให้แก่ประชาชน	на хората	for the people
ให้ใช้หลัก	използвайте принципа	large size
ไกรทอง	край тонг	krei thong - a surname
ไกรลาศ	krailat	krailard
ไกลกังวล	тревожи	klai kangwon
ไก่	пиле	chicken
ไขมัน	дебел	lipid, fat
ไขสันหลัง	гръбначен мозък	spinal cord
ไข่	яйце	egg
ไข้รากสาดใหญ่	тифус	typhus
ไข้สูง	висока температура	high fever
ไข้หวัดใหญ่สายพันธุ์ใหม่	нов щам на грипа	new flu strain
ไข้หวัดใหญ่สเปน	испански грип	spanish flu
ไคเอ็น	kaien	kaien
ไชยกิตติ	чай кити	chaikitti
ไชยยงค์	chaiyong	chaiyayong
ไชยวัฒน์	chaiwat	chaiwat
ไชยา	chaiya	chaiya
ไชโย	браво!	chaiyo
ไซน์	синус	sine
ไซโทสเกเลตอน	cytoskeletons	cytoskeleton
ไซโปรเฮปตาดีน	сипро хептадин	cyproheptadine
ไดคลอกซาซิลลิน	daiklok sillin	dicloxacillin - a drug
ไดดาโนซีน	dinocene	didanosine - medication
ไดอาน่า	диана	diana
ไดโนเสาร์ของโนบิตะ	динозавърът на нобита	nobita's dinosaur
ได้	имам	receive
ได้กล่าวว่า	казах	stating that, commenting on something
ได้ดังนี้	както следва	these
ได้ทูลเกล้าฯ	представено	report to the king
ได้มีโอกาสสร้างความสัมพันธ์อันดีต่อกัน	имайте възможност да изградите добри отношения помежду си	good relationship
ได้รับ	получавам	received
ได้รับฉายาว่า	получих прякора	recived the alias
ได้รับรางวัล	вземете награда	awarded
ได้ร่วมกันในภารกิจในด้านต่าง	заедно в мисията в различни области.	participated in activities
ได้สำเร็จ	успешно	successfully
ได้สู้กับ	сблъска се с	competing against
ได้เคลื่อนไหวตรวจสอบการทำงานของรัฐบาลกัมพูชาอย่างแข็งขัน	активно се премести да инспектира работата на правителството на камбоджа	underground investigation
ได้เป็น	стани	is
ไต	бъбрек	kidney
ไต้หวัน	тайван	taiwan
ไท	независим	tai
ไทย	thai	thai
ไทยทีวีสีช่อง	thai color tv канал	thai tv
ไทยพรีเมียร์ลีก	тайландска висша лига	thai premiere
ไทยรามา	тайланд рама	thairama
ไทยานนท์	thaiyanon	taiyanon - a thai surname
ไทรโลจี	трилогия	trilogy
ไทลื้อ	thai lue	group of laotians that lives on flatlands
ไทโรซีน	тирозин	thyrosine
ไนท์	нощ	sege
ไนลอน	найлон	nylon
ไนโตรเจน	азот	nitrogen
ไปจนถึง	да се	to
ไปบรรจบแม่น้ำเจ้าพระยา	отидете да се срещнете с река чао прая	runs to chao phraya river
ไปรษณีย์กาฬสินธุ์	пощенска служба каласин	kalasin post office
ไปรษณีย์ฉะเชิงเทรา	пощенска служба chachoengsao	cha cheng sao postal zone
ไปรษณีย์นครศรีธรรมราช	nakhon si thammarat пощенска служба	nakornsritamarat postal station
ไปรษณีย์ภูเวียง	пощенска служба phu wiang	pu weang postal office
ไปรษณีย์ยานนาวา	пощенска служба yannawa	yan nawa post office
ไปรษณีย์ร้อยเอ็ด	roi et post office	roi et post office
ไปรษณีย์สามเสนใน	пощенска служба &quot;самсен най&quot;	samsen nai post office
ไปรษณีย์หนองหาน	пощенска служба в нонг хан	nong han postal office
ไปรษณีย์อำนาจเจริญ	amnat charoen post office	amnat charoen post office
ไปรษณีย์อุทุมพรพิสัย	uthumphon phisai post office	utumporn pisai post office
ไปรษณีย์อุบลราชธานี	пощенска служба ubon ratchathani	ubon ratchathani post office
ไปรษณีย์เดชอุดม	det post office	det udom post office
ไปรษณีย์โพนพิสัย	пощенска служба phon phisai	phon phisai post office
ไผ่แดง	червен бамбук	red bamboo
ไพฑูรย์	хризоберил	phaithun
ไพรบึง	гора	phrai bueng
ไพรวัลย์	praiwan	phraiwan
ไพศาล	експанзивен	phaisan
ไฟ	пожар	fire
ไฟนอลแฟนตาซี	последна фантазия	final fantasy
ไฟร์วอลล์	firewall	firewall
ไมค์	микрофон	mike
ไมอามี่	маями	miami
ไมโครซอฟท์	microsoft	microsoft
ไม่ต่ำกว่า	не по-малко от	not lower than
ไม่ทราบข้อมูล	неизвестна информация	no background information
ไม่บังคับ	по избор	not enforced
ไม่ผ่านเข้ารอบ	не квалифициран	did not make it to the next round, got eliminated in the initial round
ไม่มีบันทึกว่าใครเป็นคนสร้าง	няма запис кой го е създал.	don't note who make id
ไม่มีแขน	без оръжие	armless
ไม่ว่าจะ	дали	such as
ไม่สามารถทำการเกษตรได้	не може да се занимава със земеделие	unable to practice agriculture
ไม่แตกกิ่ง	не е разклонен	no chain
ไม่ใช่	не	no
ไม้	дървесината	mai
ไม้กวาด	метла	broom
ไม้หนีบผ้า	колче за дрехи	clip
ไม้ไม่ผลัดใบ	вечнозелен	plants that have leaves all year round
ไรงะ	рига	reiya - a character from a japanese story
ไรโบโซม	рибозомите	ribosome
ไร่	ферма	field, parcel
ไลท์	светлина	light
ไลบร้า	везни	libra
ไลฟ์สไตน์	lifstein	life style
ไลเบรชัน	библиотека	libration
ไวชาน่า	waichana	baishana - weapon in a japanese story
ไวทยางกูร	vittayangkun	wathaiyangkun
ไวทยานนท์	waithayanon	waithayanon
ไวท์สเปล	whitespell	white spell
ไวน์	вино	wine
ไวยากรณ์	граматика	waiyakorn
ไวรัส	вирус	virus
ไวรัสตับอักเสบ	хепатит	hepatitis
ไวเซิร์ด	вайс	vizard
ไวเปอร์	пепелянка	viper
ไวเวิร์น	wvern	wyvern
ไวโอเลต	виолетов	violet
ไว้ว่า	казвам	as
ไหซอง	флиртувам	haisong
ไหมกัน	заедно	maigun - a surname
ไหลจากลาวเข้าสู่ภาคเหนือของกัมพูชาแล้วไหลผ่านเข้าเขตเวียดนาม	тече от лаос в северна камбоджа и се влива във виетнам	flows from laos into northern cambodia
ไอทีวี	itv	itv
ไอน์สไตน์	айнщайн	einstein
ไอน์สไตเนียม	айнщайний	einsteinium
ไอพอด	ipod	ipod
ไอริส	ирис	iris
ไอร์แลนด์เหนือ	северна ирландия	northern ireland
ไอเอ	ia	ia
ไอโมบาย	i-мобилна	i-mobile
ไอโอ	йо	io - from greek mythology
ไฮยาซินธ์	зюмбюл	hyacinth
ไฮเดรนเยีย	хортензия	hydrangea
ไฮเปอร์มาร์เก็ต	хипермаркет	tesco lotus hypermarket chain
ไฮแจ็ค	отвличане	hijack
ไฮโดรเจน	водород	hydrogen
๑๔	14	14
๑๕	15	15
๑๖	16	16
๑๘	18	18
๒๑	21	21
๒๒	22	22
๒๔๕๐	1907	2450
๒๕๐๒	1962	2502
๒๕๐๓	1963	2503
๒๕๒๓	1980	1980
๒๕๓๔	1991	2534
๒๕๓๕	1992	2535
๒๕๓๖	2536	2536 be (1993 ad)
๒๕๔๗	2004	2547
๒๕๔๘	2005	2548
๒๕๕๐	2007	2550
๒๕๕๔	2011	2554
๒๗	27	27
๒๘	28	28
๓	3	3
๔๘	48	48
๕	5	5
๖๐	60	60
๙	9	nine
ព្រះរាជាណាចក្រកម្ពុជា	ព្រះរាជាណាចក្រ កម្ពុជា	cambodia
疾風伝	疾風 伝	not in thai - cannot translate
