+	+	plus sign
=	=	equal to
 °ซ  °ฟ 	° c ° f	เซลเซียส ฟาเรนไฮต์
 ซม	cm	cm.
 −°ซ  °ฟ	- ° c ° f	thai letters
×	×	letter x
γ	γ	y
π	π	pi
กกกก	kg	a thai letter repeated 4 times
กกกข	khor khor	4 thai alphabets - jibberish
กขขข	abc b	4 of thai letters
กขขขขขขข	a b a b b b a	abbbbbbb
กฎ	aturannya	law, rule
กฎของโคไซน์	hukum kosinus	law of cosines
กฎแห่งกรรม	karma	bad karma
กติกา	aturan	rule
กทม	bangkok	agency
กนู	ksatria	gnu - computer related acronym
กบ	seekor katak	frog
กบฏทหารนอกราชการ	pemberontakan militer	coup de lat
กมล	lily	kamon
กมลรัตน์	kamonrat	kamolrat - a surname
กรณีที่	koper	case
กรมขุนอิศเรศรังสรรค์	krom khun iset rangsan	the convention of angels
กรมขุนเพ็ชรบูรณ์อินทราชัย	kromkhunpetchaboon-indachai	department of....
กรมข่าวทหารอากาศ	departemen berita angkatan udara	communication department of the thai air force
กรมควบคุมโรค	departemen pengendalian penyakit	department of disease control
กรมทหารราบที่	resimen infanteri	infantry regiment
กรมรบพิเศษที่	departemen tempur khusus	special force group
กรมศิลปากร	departemen seni rupa	fine arts department
กรมหลวงนราธิวาสราชนครินทร์	krom luang narathiwatratchanakharin	krom ma loung naratifatrachanakarin - the name of a royal family member
กรมหลวงสงขลานครินทร์	kromluang songkhla nakarin	prince of songkla
กรมอุตุนิยมวิทยา	departemen meteorologi	the meteorology department
กรรชัย	kanchai	kanchai
กรอง	saring	screen
กระดูกค้อน	tulang palu	malleus, hammer bone
กระดูกต้นแขน	humerus	humerus
กระดูกฝ่ามือ	telapak tangan	metacapus
กระดูกสะบัก	skapula	scapula
กระดูกสะบ้า	patella	kneecap
กระทรวงกลาโหม	kementerian pertahanan	defense ministry
กระทรวงการคลัง	kementerian keuangan	ministry of finance
กระทรวงการต่างประเทศ	kementerian luar negeri	ministry of foreign affairs
กระทรวงวัฒนธรรม	kementerian kebudayaan	ministry of culture
กระทรวงศึกษาธิการ	kementerian pendidikan	ministry of education
กระทรวงสาธารณสุข	kementerian kesehatan masyarakat	ministry of public health
กระทรวงอุตสาหกรรม	kementerian perindustrian	ministry of industry
กระทรวงเกษตรและสหกรณ์	kementerian pertanian dan koperasi	ministry of agriculture and cooperatives
กระทรวงเศรษฐการ	kementerian urusan ekonomi	ministry of commerce
กระทุ่มแบน	keranjang kecil	krathum baen district, samut songkram province
กระนวน	pitch	granuan - location in knon kan province
กระนั้น	meskipun demikian	however
กระบวนการสร้าง	proses pembangunan	anabolism
กระบวนการสร้างและสลาย	proses menciptakan dan disintegrasi	metabolism
กระบอง	blackjack	club
กระบะทราย	kotak pasir	litter box or sand box
กระบี่กระบอง	pedang	krabi krabong (swordplay)
กระรอก	tupai	squirrel
กระวนกระวาย	cemas	nervous
กระหม่อม	fontanel	fontanelle
กระเพาะอาหาร	perut	stomach
กระแต	tupai	wasp
กรับ	angkat	wooden rhythm clappers
กรับพวง	pilih banyak	krap phuang
กรับเสภา	krapao	wooden rhythm clappers
กรัม	gram	gram
กรัยวิเชียร	kraiwichian	krivician - a surname
กรานาดา	granada	granada
กริม	grimm	grim
กรี	abu-abu	karee
กรุง	kota	city
กรุงธนบุรี	krung thon buri	thonburi city
กรุงลอนดอน	london	london
กรุงศรีอยุธยา	ayutthaya	sri ayuttaya city - former capital of thailand
กรุงเทพ	bangkok	bangkok
กรุงเทพเชียงใหม่กรุงเทพ	bangkok, chiang mai, bangkok	bangkok changmai bangkok
กรุงเทพโพลล์	polling bangkok	bangkok poll
กรุ๊ป	grup	group
กลอง	gendang	drum
กลองมโหระทึก	drum besar	big drum
กลองยาว	gendang	tom-tom
กลองสองหน้า	gendang dua sisi	glong songna
กลอน	ayat	poem
กลอบูลิน	glossy	globulin
กลาง	tengah	in the middle
กลิ่น	baunya	odor
กลุ่มดาวกล้องจุลทรรศน์	rasi bintang mikroskop	microscopium
กลุ่มดาวนกทูแคน	toucan	tucana
กลุ่มดาวสิ่ว	pahat	siu star
กลุ่มดาวเข็มทิศ	kompas rasi bintang	pyxis constellation
กลุ่มดาวเตาหลอม	blast furnace	fornax
กลุ่มดาวแมงป่อง	kalajengking	scorpion constellation
กลุ่มดาวแมลงวัน	lalat	musca
กลุ่มที่	grup	group
กลุ่มแสงอุษา	usa light group	light at dawn
กลูคากอน	glucon	glucagon
กล่าวคือ	artinya	that is
กล้วยไม้ดาว	anggrek bintang	type of orchid that have slim petal like star
กล้องถ่ายภาพ	kamera	camera
กล้ามเนื้อ	otot	muscle
กวม	guam	obscure
กวาง	rusa	deer
กวิน	kawin	gwen - a name
กวี	penyair	poet
กว่า	dari	than
กองกลาง	gelandang	headquarter
กองการบินทหารเรือ	divisi penerbangan angkatan laut	the flying section of the navy
กองการศึกษา	divisi pendidikan	education group
กองการเจ้าหน้าที่	divisi personalia	division of personnel
กองกำลังกึ่งทหาร	pasukan semi-militer	armforces
กองคลัง	perbendaharaan	division of finance
กองทัพ	tentara	arm forces
กองทัพบกไทย	tentara thailand	thai army
กองทัพภาคที่	tentara daerah	army area
กองทัพเรือ	angkatan laut	navy
กองทัพเรือไทย	angkatan laut thailand	the royal thai navy
กองทัพแห่งความชอบธรรม	pasukan kebenaran	army of the righteous
กองทัพไทย	tentara thailand	thai military forces
กองบิน	angkatan udara	air force
กองบินปีกหมุนที่	wing spinning wing	flight corp number __________
กองพลทหารม้าที่	brigade kavaleri	cavalry division
กองพันทหารช่างที่	brigade insinyur	troop unit number ___________`
กอด	pelukan	kord
กอนซาเลซ	gonzalez	gonzales - a name
กอร์ดอน	gordon	gordon
กอลมเบต์	goreme	glombet - a catholic priest
กอล์ฟ	golf	golf
กอล์ฟไมค์	mikrofon golf	golf-mike
กะเหรี่ยง	karen	karen
กะโหลก	tengkorak	skull
กะโหลกศีรษะ	tengkorak	skull; cranium
กังหันชัยพัฒนา	turbin chaipattana	chaipattana's windmill
กันดั้ม	gundam	gundam - a cartoon
กันตัง	kantang	kuntun in trung state
กันทรลักษ์	kantharalak	kuntaraluk - an area in thailand
กันฟอร์ม	formulir	gun form
กันอริ	kenari	gan-ari
กันเอง	secara damai	casual
กับนางสุจาริณี	dengan ny. sucharinee	with mrs. sujarinee
กัมปูเชีย	kampuchia	kampuchea
กัมพูชา	kamboja	cambodia
กัมพูชาประชาธิปไตย	kamboja demokratis	democratic kampuchea
กัมพูชาเป็นประเทศที่มีป่าไม้อุดมสมบูรณ์มากที่สุดหากเปรียบเทียบกับประเทศเพื่อนบ้าน	kamboja adalah negara dengan hutan paling melimpah jika dibandingkan dengan negara tetangga.	cambodia is the country with nice, healthy forests
กัมพูชาเป็นอดีตประเทศอาณานิคมของฝรั่งเศสในภูมิภาคเอเชียตะวันออกเฉียงใต้เพียงแค่ประเทศเดียวเท่านั้นที่มีการปกครองด้วยระบอบราชาธิปไตยภายใต้รัฐธรรมนูญ	kamboja adalah satu-satunya negara bekas kolonial prancis di asia tenggara yang memiliki monarki di bawah konstitusi.	cambodia was a former french colony
กัมพูชาเป็นอาณานิคมของฝรั่งเศสมาตั้งแต่พศ	kamboja telah menjadi koloni perancis sejak itu.	cambodia was a france colony from year
กัวเตมาลา	guatemala	guatemala
กานซู	gansu	honshu in china
กานต์	kan	kan
กานา	ghana	ghana
กานามัยซิน	kanamycin	kanamycin
กาบอง	gabon	baton
กาพย์ฉบัง	puisi epik	poem
กาพย์สุรางคนางค์	puisi	gabsuranknang
กาม	wanton	lust
กาย	tubuh	body
การ	itu	project
การกีฬา	olah raga	sport
การขัดเกลาทางสังคม	sosialisasi	socialization
การขับถ่าย	ekskresi	excretion
การขับไล่	penggusuran	discharge
การคมนาคม	transportasi	transportation department
การคลัง	keuangan	public finance
การค้นพบ	penemuan	discover
การค้า	perdagangan	marketing
การจัดการ	manajemen	project
การจัดการคุณภาพ	manajemen mutu	quality control
การจัดอันดับ	peringkat	ranking
การจัดให้มี	ketentuan	putting together something
การจูบ	ciuman	kissing
การชัก	kejang	the act of pulling the flag wiht string up the pole
การดำเนินการ	operasi	progression
การตอบรับ	umpan balik	welcoming
การตั้งถิ่นฐาน	penyelesaian	start a project
การต่างประเทศ	urusan luar negeri	foreign affairs
การทำงานของ	pekerjaan	function
การทำป่าไม้	kehutanan	forestry
การท่องเที่ยว	pariwisata	tourism
การท่าเรือ	otoritas pelabuhan	port authority
การบริการ	layanan	customer service
การบริหารการพัฒนา	manajemen pengembangan	development
การบริหารการศึกษา	administrasi pendidikan	educational administration
การบริหารจัดการ	manajemen	management
การบริหารราชการแผ่นดิน	administrasi pemerintahan	administration
การบินไทย	thai airways	thai airways
การปกครองท้องถิ่น	pemerintah daerah	local administration
การปกครองส่วนท้องถิ่น	pemerintah daerah	local government
การปกครองแบ่งออกเป็น	aturan dibagi menjadi	administration
การปฏิรูประบบจัดเก็บภาษีเงินได้	reformasi sistem pengumpulan pajak penghasilan	taxation reform
การปฏิรูปศาสนา	reformasi	religious reformation
การปฏิวัติฝรั่งเศส	revolusi perancis	french revolution
การปฏิวัติอุตสาหกรรม	revolusi industri	industrial revolution
การปฏิสนธิ	pemupukan	fertilisation
การประมง	perikanan	fishery
การพัฒนา	pengembangan	development
การพัฒนาประชาธิปไตย	perkembangan demokrasi	democratic development
การพูด	berbicara	speaking
การยึดครองมะละกาของโปรตุเกสในปี	pendudukan portugis di melaka pada tahun itu	portugal took over malaga
การระบาดของไข้หวัดใหญ่สายพันธุ์ใหม่	strain baru influenza	flu pandemic
การรักษาพยาบาล	perawatan medis	nursing care
การร่วมเพศทางทวารหนัก	sialan anal	sodomy
การลดรูป	merusak	reduction
การละเล่นพื้นบ้าน	game rakyat	local game
การวิจัย	penelitian	researching
การวิเคราะห์	analisisnya	analysis
การศึกษา	pendidikan	study of, education
การสังคายนาครั้งที่	perintah terakhir	the event of convention of monks
การสั่นพ้อง	resonansi	resonance
การสำเร็จความใคร่ด้วยตนเอง	masturbasi	masturbation
การสืบพันธุ์	reproduksi	reproduction
การสื่อสาร	komunikasi	communications
การาจ	garasi	garage
การุณ	karun	karoon
การเต้นรำ	tarian	dance
การเพิ่มสิทธิประโยชน์แก่นักลงทุนต่างประเทศ	meningkatkan hak istimewa bagi investor asing	increase benefits for foreign investors
การเล่น	untuk bermain	play
การแข่งขัน	persaingan	competition
การแบ่งพื้นที่	partisi	land division
การใช้คำ	penggunaan kata	terminology
การไฟฟ้าส่วนภูมิภาค	otoritas kelistrikan provinsi	distribution electric transformer
การไหว้	hormat	thai greeting
การ์ด	kartu	guard
กาฬสินธุ์	kalasin	katsin - a thai surname
กาเวน	gawain	gawain
กาเหว่าที่บางเพลง	the raven of some songs	the cuckoo's song.
กำกับการแสดงโดย	disutradarai oleh	produced by (movie)
กำกับโดยอภิชาติพงศ์	disutradarai oleh aphichat pong	produced by apichartpong - a famous thai movie producer
กำมะถัน	belerang	sulfur
กำลังจะปรับเปลี่ยนเป็น	akan berubah menjadi	is changing to
กำหนดตามสภาพภูมิศาสตร์	ditentukan oleh geografi	geography estimation
กำแพงเพชร	kamphaeng phet	kamphaeng phet
กำแพงเมืองจีน	tembok besar	the great wall of china
กำแพงแสน	kamphaengsaen	kampangsaen (name of district)
กิจผลิต	produksi	kitpalit (last name)
กิมป์	gimb	gimp - gnu image manipulation program
กิโลกรัม	kilogram	kilogram
กิโลไบต์	kb	kilobyte
กิ่งแก้ว	kingkaew	kingkaeo
กิ้งกือ	kaki seribu	millipedes
กิ๊ก	kik	gig
กีฏวิทยา	entomologi	entomology
กีฬา	olah raga	sports
กีฬาทางน้ำ	olahraga air	water sports
กีฬาแหลมทอง	laem thong sport	seap games
กุดจับ	cetakan	good jub - a place
กุลดิลก	kuldilok	kuldilok
กุลละวณิชย์	kulalawanit	kullawanich
กุหลาบ	bunga mawar	kularb (first name)
กุ้ง	udang	shrimp
กุ้งต้ม	udang rebus	boiled shrimp
กูเกิล	google	google
ก็คือ	apakah	which is
ก็ใช้เป็น	digunakan sebagai	utilize
ก่อตั้ง	didirikan	founded
ก่อตั้งโดย	didirikan oleh	make by
ก่อนที่	sebelumnya	before
ก่อนที่จะตกเป็นของฝรั่งเศสในเวลาต่อมา	sebelum menjadi prancis nanti	belonging to france, under the control of france
ก่อนหน้านั้น	sebelum itu	before
ก้อย	pinky	koi
ก้าน	tangkai	thorn
ก้านกล้วย	tangkai pisang	kankluai
ก๊าซธรรมชาติ	gas alam	natural gas
ก๎ล	hadiah	magic
ขขขขขขขขขข	b b b b b b b	repeated letter from thai alphabet
ขณะทรงพระเยาว์	saat dia muda	having to do with the young prince or princess
ขณะที่	sementara	while
ขนม	makanan penutup	dessert
ขนมกล้วย	pisang	banana dessert
ขนมครก	knmcrk	kind of thai sweetmeat
ขนมปัง	roti	bread
ขนมปังขิง	roti jahe	gingerbread
ขนมเปียกปูน	belah ketupat	a type of thai dessert with flour and sugar
ขนมไทย	hidangan penutup thailand	thai dessert
ขนสัตว์	wol	fur, animal hair
ขนอม	khanom	kanom - location in thailand
ขนาดหน้าตัก	ukuran pangkuan	length between both knees of buddha statue in posture of meditation
ขนาดใหญ่	ukuran besar	l
ขบวนการอ๊บอ๊บป่วนโลก	pergerakan bumi	original name is keroro gunso
ขบวนรถสินค้า	melatih	caravan of trucks
ขม	pahit	bitter taste
ขรรค์ชัย	khan chai	kanchai - a male's name
ขลุ่ยหลิบ	suling	khlui lib
ขวด	sebotol	bottle
ขวัญ	semangat	morale
ขวัญใจช่างภาพ	fotografer tercinta	miss photogenic
ขสมก	misa	an acronym consists of four thai letters
ของ	dari	of
ของทุกปี	setiap tahun	every year
ของประเทศจีน	dari cina	owned by china
ของมหาวิทยาลัย	dari universitas	of university
ของมัน	ini	their
ของร่างกาย	tubuh	of the body
ของสมเด็จฮุน	dari somdej hun	houssaine of cambodia
ของสิ่งมีชีวิต	makhluk hidup	living things
ของสุนทรภู่	dari sunthorn phu	belong to soon thong pu (a thai legend)
ของเหลว	cair	liquid
ของโลก	dari dunia	of world
ขอนแก่น	khon kaen	khon kan - an area in thailand
ขอบคุณที่รักกัน	terima kasih telah mencintaiku	thank you for loving each other
ขอเช็ดน้ำตา	mari kita menghapus air mata	wipe the tears
ขอให้เด็กสมัยปฏิวัติของข้าพเจ้า	semoga anak-anak revolusioner saya	i hope that the children in my lifetime will ____________
ขั้นที่	langkah	level
ขา	kaki	leg
ขาย	untuk menjual	sell
ขิง	jahe	ginger
ขิม	dulcimer	kim - a thai musical instrument
ขีดเส้นใต้	garis bawahi	underline
ขี้ผึ้ง	lilin	wax
ขึ้นเป็น	hingga	to
ขึ้นไป	naik	next one up
ขุขันธิน	khan tin	kukuntin
ขุนหาญ	han	koonhan - a location in thailand
ข้อมูลทั่วไป	informasi umum	general information
ข้อมูลประเทศเดนมาร์ก	informasi denmark	information on denmark
ข้อมูลปรากฏการณ์โลกร้อน	fenomena pemanasan global	global climate change
ข้อมูลปี	data tahun	information from the year ________
ข้อมูลอื่นๆ	informasi lainnya	other information
ข้อมูลโดย	data oleh	information from
ข้อวิพากษ์วิจารณ์	kritik	critique reports
ข้ามฉาก	melintasi tempat kejadian	sin(a)
ข้าวสาลี	gandum	wheat
ข้าวหลาม	khao lam	bamboo rice
ข้าวเกรียบปากหม้อ	kerupuk nasi	a thai snack
ข้าวเจ้า	beras	white rice
ข้าวโพด	jagung	corn
ข้าหลวงกำกับราชการเมืองขุขันธ์คนที่	gubernur, gubernur kota khukhan	government worker for ku khan city
ฃ	ฃ	a letter from thai alphabet
คงยิ่ง	sangat mungkin	kongying
คงเจริญ	mungkin berhasil	khongcharoen
คณะครุศาสตร์	fakultas pendidikan	education department
คณะครุศาสตร์อุตสาหกรรม	fakultas pendidikan industri	faculty of industrial education
คณะที่	fakultas di	the current administration
คณะบัญชี	fakultas akuntansi	accounting department (major)
คณะปฏิรูปการปกครองแผ่นดิน	komite revolusioner	national administrative reform council
คณะประมง	fakultas perikanan	fishery division of the college of farming and agriculture
คณะพยาบาลศาสตร์	fakultas keperawatan	nursing department
คณะมนุษย์ศาสตร์และสังคมศาสตร์	fakultas humaniora dan ilmu sosial	humanity department
คณะรัฐมนตรีคณะที่	kabinet	council of ministers
คณะวิทยาการจัดการ	fakultas ilmu manajemen	management department
คณะวิศวกรรมศาสตร์	fakultas teknik	engineering department
คณะศิลปกรรมศาสตร์	fakultas seni rupa	faculty of fine arts
คณะสถาปัตยกรรมศาสตร์	fakultas arsitektur	faculty of architecture
คณะสหเวชศาสตร์	fakultas ilmu kesehatan sekutu	อังกฤษ   faculty of allied health science
คณะสาธารณสุขศาสตร์	fakultas kesehatan masyarakat	faculty of public health
คณะเกษตร	fakultas pertanian	faculty of agriculture
คณะแพทยศาสตร์ศิริราชพยาบาล	rumah sakit fakultas kedokteran siriraj	faculty of medicine siriraj hospital
คณะแพทยศาสตร์โรงพยาบาลรามาธิบดี	fakultas kedokteran, rumah sakit ramathibodi	the staff of ramatippadee hospital
คณารศ	kanara	kanaros - a surname
คนที่	orang yang	person number __________________________
คนที่ไปช่วยรุ่นที่	orang-orang yang membantu generasi	volunteer group number __________
คนแคระ	dwarf	dwarf
คนแรก	orang pertama	first
คปค	tahun	3 thai letters
คม	tajam	sharp
ครอคโคไดล์	buaya	crocodile
ครอบครัว	keluarga	family
ครั้งหนึ่ง	satu kali	once upon a time
คราประยูร	prayun	karaprayoon - a thai surname
คราม	indigo	indigo
คริส	chris	christ
คริสตี	christi	christie - a female name
คริสต์ศาสนา	kekristenan	christainity
ครุฑ	garuda	garuda
ครู	guru	teacher
ครูพิเศษจอมป่วน	guru troll	kru pisat jom poun  - name of a story
คลอง	kanal	canal
คลองสาน	khlong san	klongsan
คลองเตย	khlong toei	klongtoei
คลับ	klub	club
คลาวิคอร์ด	kelas	clavichord
คลิก	klik	click
คลินิก	klinik	clinic
คลิป	klip	clip
คลื่นสึนามิ	tsunami	tsunami wave
ควอน	kwon	kwon - a surname of a korean singer
ควอร์เตอร์	seperempat	quarter
ความกว้าง	lebar	width
ความงาม	keindahan	beauty
ความจำ	memori	memory
ความต่างศักย์	perbedaan potensial	potential difference in physics
ความถี่	frekuensi	frequencies
ความนิยม	popularitas	popular
ความบริสุทธิ์	kemurnian	purity
ความฝันอันสูงสุด	mimpi terakhir	the impossible dream
ความพอประมาณ	kesederhanaan	estimate
ความยากจน	kemiskinan	poverty
ความยาว	panjangnya	length
ความยาวคลื่น	panjang gelombang	frequencies
ความยาวช่วงคลื่น	panjang gelombang	wave length
ความยาวเพลง	panjang lagu	the length of the song
ความรัก	cinta	love
ความรู้	pengetahuan itu	knowledge
ความสว่าง	kecerahan	illumination
ความสัมพันธ์กับประเทศไทย	hubungan dengan thailand	relationship with thailand
ความสัมพันธ์ระหว่างจีนกับอเมริกา	hubungan antara cina dan amerika	relationship with china and the usa
ความสูง	tingginya	height
ความส่องสว่าง	kecerahan	luminance
ความหนาแน่นของประชากร	kepadatan populasi	population density
ความหมาย	artinya	meaning
ความหมายโดยพยัญชนะ	makna konsonan	definition that derived from translation from another language
ความเข้มของการส่องสว่าง	intensitas bercahaya	luminous intensity
ความเข้าใจ	memahami	understanding
ความเร่ง	akselerasi	acceleration
ความโกรธ	amarah	anger
ความโน้มถ่วง	gravitasi	gravity
ควินโต	quinto	quinto
ควีนซี่	ratu	quincy
คอ	leher	neck
คอนสตรัคชั่น	konstruksi	construction
คอนเวนชัน	konvensi	convention
คอนเสิร์ตประสานเสียงสามสถาบัน	konser paduan suara tiga institusi	chulalongkorn kasetsart thammasat choral concert
คอมพิวเตอร์ยุคที่	era komputer	_-generation computer (as in frist generation, second generation etc)
คอร์ด	akord	chord
คอลลิงวูด	memanggil kayu	collingwood
คอสตาริกา	costa rica	costa rica
คัง	kang	kan
คัชชินสกี	kutchinski	kaczyński
คัญทัพ	tentara penting	main army.
คัทลียา	cattleya	kathaleeya (thai first name)
คันธวงศ์	kanthavong	kunntavong - a surname
คัพ	cangkir	cup
คัมภีร์	kitab suci	bible
คั่ว	dipanggang	dry roasting
คาคาชิ	kakashi	cacashi
คางาริ	kagari	kagari
คาซัคสถาน	kazakhstan	kazakhstan
คาถาอัญเชิญ	mantra	a magic spell
คาบ	periode	frequency
คาบัคโรเน่	kabakhroone	kyabarrone
คาบูโตะ	kabuto	kabuto
คาปูชิโน่	cappuccino	cappuccino
คามิว	kamui	camus
คาราคุระ	karakura	karakura
คาร์ล	carl	karl
คาวทอง	fishyong	lizard tail
คาเมนไรเดอร์	kamen rider	kamen rider
คาโรลัส	carolas	carolus linnaeus
คำขวัญวันเด็ก	slogan hari anak	quote for kids day
คำถามข้อที่	nomor pertanyaan	the question number_________
คำนวณ	untuk menghitung	calculate
คำนาม	kata benda	noun
คำพ้องรูป	sinonim	hemonym
คำมั่นสัญญา	janji	agreement
คำม่วง	kham muang	kham muang
คำวิลัยศักดิ์	kamwilai sak	important words, magic words
คำศัพท์	kosakata	word
คำสรรพนาม	ucapan selamat	pronoun
คำสร้อย	kata	kumsoi - a country singer
คำสุดท้ายของวรรคที่	kata terakhir dari paragraf	the last word (in a poem)
คำสุภาพ	sopan	formal
คำอธิบาย	deskripsi	explanation
คำเมือง	kata kota	kum meuong - a location in chiang mai
คำแปล	terjemahan	translation
คิง	raja	king
คิงส์	raja	kings
คิงส์คัพ	piala raja	king's cup
คิงไลเนอร์	kingliner	kingliner
คิชิเนีย	kishinya	kishinia
คิด	pikirkan	thinking
คินนิคุแมน	kinnikuman	kinkiku man
คิมิฮิโระ	kimihiro	kimihiro
คิระ	kira	kira - japanese name
คิเคียว	kikyo	kikyo
คีตกวี	komposer	composer
คือประมาณ	sekitar	estimated to be
คือเพลง	apakah sebuah lagu	is the song
คุณ	kamu	you
คุณครูจอมเวท	guru pesulap	magister
คุณปลื้ม	khun pluem	kunpleam
คุณหญิงโม	permaisuri mo	suranaree
คุณากร	kamu	khunakon
คุราปิก้า	kurapika	kurapika
คุโรซึจิ	kurotsuji	kurochiji - a japanese word
คุ้มค่า	nilai bagus	worth the money spent on
คูกิมิยะ	kukimiya	kugimiya
คูคาคุ	kuku	kukaku (japanese last name)
คูเรียม	curium	"chemical element ""curium"""
คูเวต	kuwait	kuwait
คู่กรรม	mitra	soul mate
ค่าความต้านทานตัวที่	nilai resistansi itu	resistance value of the
ค่าจีดีพี	pdb	gdp - an economics term
ค่าใช้จ่าย	biaya	expense
ค่ำแล้ว	senja	getting dark, at dusk
ค้างคาว	kelelawar	bat
ฆ	juan	a letter from thai alphabet
ฆ้อง	gong	gong
ฆ้องวงใหญ่	gong besar	a group of thai drum music
งดส่งเข้าประกวด	tidak ada entri	enroll in the contest
งาน	pekerjaan	work, job
งานอดิเรก	hobi	hobby
งานเขียน	tulisan-tulisan	writing, composition work
งานเทางามสัมพันธ์	hubungan tao ngam	public party
งานโมเสก	mosaik	mosaic
งามวงศ์วาน	ngamwongwan	ngamwongwan
งู	ular itu	snake
งูอนาคอนดา	anaconda	anaconda snake
จดหมายอากาศ	surat udara	aerogram
จตรัง	trang	trang province (name of province in thailand)
จตุรงค์	chatuchak	jaturong - a surname of a comedian
จนกระทั่ง	sampai	until
จนกระทั่งปี	sampai tahun ini	until the year
จนกระทั่งเมื่อปี	sampai tahun lalu	until the year
จนครปฐม	nakhon pathom	nakorn pratom state
จนมีคำกล่าวว่า	sampai dikatakan demikian	said
จน่าน	senin	nan state
จบุรีรัมย์	buriram	burerum state
จมูก	hidung	nose
จระเข้และแอลลิเกเตอร์	buaya dan buaya	crocodile and alligator
จรัญญา	charanya	jarunya - a surname
จริยธรรม	etika	ethics
จริยศาสตร์	etika	ethics
จริยา	nyonya	jariya
จลำพูน	lamphun	jalumpoon - a place in thailand
จสตูล	satun	stoul state
จสุราษฎร์ธานี	surat thani	surat thani province
จอมบึง	bengkak	chom bueng
จอมพลถนอม	chom phon thanom	field marshal thanom
จอมพลสฤษดิ์	field marshal sarit	field marshal sarit
จอมพลเรือ	kapal marshal	the general of the navy
จอมเทียน	jomtien	jom tien - a location in thailand
จอร์เจีย	georgia	georgia
จะต้องหาตัวแทนลงจากเวที	harus menemukan perwakilan untuk turun dari panggung	find a teammate to leave the stage, a unique game
จะเขียนว่า	akan menulis	written as
จะเข้	sitar	jakhe
จะได้	akan mendapatkan	results in
จักจั่น	jangkrik	chakkachan
จักรพรรดิเนอร์วา	kaisar nirwana	emperor nerva
จักรพรรดิไททัส	kaisar titus	titus (flavius vespa)
จักรพันธุ์	chakphan	chakrabhand
จักรวาลวิทยา	kosmologi	cosmology
จังหวัด	provinsi	province
จังหวัดกระบี่	provinsi krabi	krabee state
จังหวัดกาญจนบุรี	kanchanaburi	kanchanaburi province
จังหวัดกาฬสินธุ์	kalasin	kalasin province
จังหวัดขอนแก่น	provinsi khon kaen	khon kaen province
จังหวัดคยองกี	provinsi gyeonggi	the state of kyong gee
จังหวัดคยองซาง	provinsi gyeongsang	kyongchang province
จังหวัดฉะเชิงเทรา	chachoengsao	chachoengsao province
จังหวัดชุมพร	chumphon	chumphon province
จังหวัดตราด	provinsi trat	trat province
จังหวัดตาก	provinsi tak	tak province
จังหวัดนครปฐม	provinsi nakhon pathom	nakhon pathom province
จังหวัดนครพนม	provinsi nakhon phanom	nakorn panom state
จังหวัดนครสวรรค์	provinsi nakhon sawan	nakorn sawan province in thailand
จังหวัดน่าน	provinsi nan	nan state in the north east of thailand
จังหวัดปัตตานี	provinsi pattani	pattani state
จังหวัดพระนครศรีอยุธยา	phra nakhon si ayutthaya	nakon sri ahyutthaya province
จังหวัดพังงา	provinsi phang nga	phang nga province
จังหวัดพิษณุโลก	provinsi phitsanulok	pisanulok state
จังหวัดมหาสารคาม	provinsi maha sarakham	maha sarakham province
จังหวัดยโสธร	yasothon	yasothorn province (name of thai province)
จังหวัดระยอง	rayong	rayong province
จังหวัดราชบุรี	ratchaburi	ratchaburi province
จังหวัดลำพูน	lamphun	lamphun province
จังหวัดสงขลา	songkhla	songkla province
จังหวัดสมุทรสงคราม	provinsi samut songkhram	samut songkhram province
จังหวัดสิงห์บุรี	provinsi sing buri	sing buri province
จังหวัดหนองบัวลำภู	provinsi nong bua lamphu	nong bua lamphu province
จังหวัดอุดรธานี	provinsi udon thani	udon thani state
จังหวัดเชลลา	shella	chella city
จังหวัดเชียงราย	chiang rai	chianrai province
จังหวัดเชียงใหม่	provinsi chiang mai	chiang mai province
จังหวัดเพชรบุรี	provinsi phetchaburi	petcharaburi state
จังหวัดเพชรบูรณ์	phetchabun	petchabun province
จังหวัดเลย	provinsi loei	loei (name of thai province)
จังหวัดแพร่	phrae	prae state
จังหาร	junghan	changhan
จัดขึ้นเมื่อ	diadakan	occur on the date of _______________
จัดตั้งขึ้นโดย	didirikan oleh	produced by
จัดอยู่ในภูมิภาค	diorganisasikan di wilayah tersebut	in region
จัดเมื่อวันที่	diadakan	็held on the date of ...
จัดโดย	diatur oleh	arrange by
จัน	chan	chan
จันทบุรี	chanthaburi	juntaburi state
จันทร	bulan	chantorn
จันทรุปราคา	gerhana bulan	lunar eclipse
จันทร์	senin	chan
จันทร์ภักดี	chan phakdi	juntapukdee - surname of a famous actor
จันทร์เกษ	chan ket	juntagaset - a surname
จาก	dari	from
จากการพิสูจน์อายุโดยคาร์บอน	dari bukti usia menurut karbon	from the forensic carbon dating
จากภาษากรีก	dari yunani	greek language
จากละคร	dari drama	from drama
จากละครเรื่อง	dari drama	from the soap opera
จากสารานุกรมบริทานิกา	dari encyclopaedia britannica	from printed information
จากอัลบั้ม	dari album	from the album
จากเรื่อง	dari ceritanya	from the story of ...
จากเว็บ	dari web	from the web
จากเว็บไซต์กระทรวงการต่างประเทศ	dari situs web kementerian luar negeri	from the website of foreign department
จากเว็บไซต์กระทรวงต่างประเทศ	dari situs web kementerian luar negeri	from the foreign government affairs website
จากโซล	dari seoul	from soeul
จาติกวณิช	chatikavanij	chatikavanij
จามจุรี	jamjuree	jamjuri flower
จารีตประเพณี	kebiasaan	tradition from the culture
จารุเสถียร	jaru sathien	charusathien
จาวตาลเชื่อม	jao tan weld	sweetened palm - a type of thai dessert
จำกัด	terbatas	limited
จำกัดมหาชน	terbatas	public limited
จำนวน	jumlahnya	amount
จำนวนประชากร	populasi	population
จำปาเทศ	champa	a specific type of magnolia tree; similar michelia champaca
จำเริญ	berkembang	jamroen
จิกะไบต์	jigtes	gigabyte
จิตรกร	pelukis	painter
จิตรกรรม	lukisan	arts and craft or music
จิตวิทยา	psikologi	psychology
จิตใจ	pikiran	heart; feelings
จินตหรา	jintara	jinnara - a female's name who is a singer
จิบูตี	djibouti	ji bu dee event on june 27
จิบเบอเรลลิน	gibberelin	gibberellin
จิม	jim	jim
จิโอวานนี	giovanni	giovanni
จี	g	g
จีนตัวย่อ	bahasa cina sederhana	simplified chinese characters
จียอน	jiyeon	๋jiyeon (korean name)
จึงทรงพระกรุณาโปรดเกล้า	oleh karena itu diperintahkan dengan ramah	be kind enough to
จึงเปิดโอกาสให้	karena itu beri kesempatan	open up opportunities
จึงใช้ธาตุหมอกและเมฆาได้	karena itu bisa menggunakan elemen mist dan cloud	using magic with cloud and spells
จุกนมสีขุ่น	puting buram	corrupted pacifier
จุดกึ่งกลาง	titik tengah	midpoint
จุดจอมฟ้า	titik biru	zenith
จุลจอมเกล้าเจ้าอยู่หัว	vajiralongkorn	phra chunla chom klao chao yu hua
จุฬาลงกรณินทรวรางกูร	chulalongkorn nintharangrangkun	new title for the princess
จูล	joule	joule
จูเซปเป	giuseppe	giuseppe
จูเนียร์	junior	junior
จเชียงใหม่	chiang mai	chiang mai province
จเพชรบุรี	phetchaburi	pedchaburee province
จเพชรบูรณ์	phetchabun	province pechaboon
จ๊กมก	jumkum	jokmok - a surname of a comedian
ฉ	f	ninth thai alphabet
ฉบับชั่วคราว	versi sementara	special (temporary) edition
ฉบับวณิพก	angka	begger version
ฉลอง	rayakan	celebrate
ฉลองพระชนมายุ	rayakan tahun ke-80	celebrated birth anniversary of
ฉันรักคุณ	aku cinta kamu	i love you
ฉาบ	dempul	cymbal
ฉายเมื่อ	tunjukkan pada	aired
ฉิ่ง	simbal	small cup-shaped cymbals
ฉี่	kencing	qi
ชนะ	menang	winning
ชนิด	jenisnya	kind
ชนิดของเมฆ	jenis cloud	types of clound
ชม	lihat	chom
ชมชื่น	pujian	chomchuen
ชมพู	merah muda	rose apple
ชมพูทวีป	anak benua india	south asia
ชมพู่	mawar apel	syzygium
ชล	danau	chol (first name)
ชลธารวิทยา	chaloem wittaya	limnology
ชลบุรี	chonburi	cholburi state
ชลิต	chalit	chalit - a male's name
ชวนชื่น	mengundang	choun cheen - a surname
ชอบ	seperti	chop
ชะนี	owa	gibbon
ชะมด	musk	anteater
ชะอวด	pamer	chaoud - location in thailand
ชะอำ	cha-am	cha-am (name of thai district)
ชัชพล	chatchapon	chatchapol - a male's name
ชัย	kemenangan	chai
ชัยชนะ	kemenangan	chaichana
ชัยนาม	chai nam	chainam
ชัยบัญชา	chai bancha	chaibancha
ชัยมงคล	chaimongkol	chaimongkol - a male's name
ชัยยุทธ	chaiyut	chaiyuth (first name)
ชั้น	lantai	class
ชั้นที่	lantai	order
ชั้นประทวน	lantai	non-commissioned officer
ชั้นมหาวชิรมงกุฎ	mahkota maha vajiraj	order of the king's jewels
ชั้นยศ	peringkat	millitary rank
ชั้นสูงสุด	tingkat tertinggi	special class
ชา	tehnya	tea
ชากะ	shaka	shaka
ชาคริต	chakrit	charkrit
ชาญชัย	chanchai	chanchai - a thai name
ชาตะ	teh	born
ชาติ	bangsa	nation
ชาย	seorang pria	male
ชาร์ป	tajam	sharp
ชาร์ล	charles	charles
ชาร์ลส	charles	charles
ชาลส์	charles	charles
ชาลี	charlie	charlie
ชาวนา	petani itu	farmer
ชาวไทย	orang thailand	thai
ชาวไทยภูเขา	suku bukit	thai hill tribe
ชำนิ	chamni	chumni - a location in thailand
ชิคิกามิ	shikikami	shikigami
ชิงร้อย	bersaing	ching roi
ชิงร้อยล้าน	bersainglah untuk seratus juta	ching roi lan
ชิซุกะ	shizuka	shizuka
ชิดจันทร์	chidchan	chidjun (a person's last name)
ชิน	digunakan	get used to
ชินวัตร	shinawatra	shinawatra
ชิริว	chiryu	cherew - a japanese character
ชิลี	chili	chilli
ชิโนะ	chino	shino
ชีพด็อก	anjing gembala	chief dog
ชีวนิชพันธ์	biologis	chiwanitphan
ชีวประวัติ	biografi	biography
ชีวมวล	biomassa	alternative (natural) power
ชีวสถิติ	biostatistik	biometry, biostatistics
ชื่อดัง	terkenal	famous
ชื่อนามสกุล	nama depan nama keluarga	name-lastname
ชื่อภาษาญี่ปุ่น	nama jepang	japanese name
ชื่อภาษาอังกฤษ	nama inggris	english name
ชื่อยศภาษาไทย	peringkat thailand	thai title
ชื่ออัลบั้ม	nama album	album name
ชื่ออื่น	nama lain	synonym
ชื่อเก่าในวงการ	nama lama di industri	old stage name
ชื่อเดิม	nama sebelumnya	old name
ชื่อเมือง	nama kota	city's name
ชื่อเรื่อง	judul	the name of the story
ชื่อเล่น	nama panggilan	nickname
ชุดแพนเค้ก	pancake set	pancake
ชุติมา	chutima	chutima
ชุมชนออนไลน์ชาวจังหวัดสกลนคร	komunitas online sakon nakhon	sakon nakhon people online community
ชุมพลบุรี	chumphon buri	chompolburi area
ชุมแพ	chum phae	choompa - location in thailand
ชุมแสง	chum saeng	choomsang - a male's name
ชูมันน์	schumann	schumann
ชูศักดิ์	chusak	chusak
ชโย	bravo	cheer; hurray
ชไนเดอร์	schneider	schneider
ช็อกโกแลต	cokelat	chocolate
ช่วงปี	tahun	between year
ช่อง	saluran	channel
ช่องเชิงเทิน	battlements	machicolation
ช้อน	sendok	spoon
ซ	h	the eleventh letter of the thai alphabets
ซน	nakal	crashing into
ซบที่อกฉัน	nestle di dadaku	cry in my arms
ซอมบี้	zombie	zombie
ซออู้	zo o	a woodwind thai instrument
ซันไชน์	sinar matahari	sunshine
ซัลฟานิลาไมด์	sulfanilamide	salfanilamide
ซัลฟาไดอะซีน	sulfadiazin	sulfadiazine
ซัลเฟต	sulfat	sulphate
ซากดึกดำบรรพ์	paleontologi	fossil
ซาคุโร่	sakuro	zakuro - a japanese character
ซาซางาวะ	sasagawa	sasangngawa - a japanese name
ซานกัลโล	san gallo	sangallo family
ซาบุซะ	sabuza	zabuza
ซาลาดิน	saladin	saladin
ซาอิ	sayi	chai - a japanese name
ซาโลมอน	salomon	salomon
ซิกนัส	cignus	signus
ซิงเกอร์	penyanyi	sinder
ซิงเกิ้ล	jomblo	single
ซิทคอม	sitkom	sitcom
ซินเดอเรลล่า	cinderella	cinderella
ซิมไฟลา	simphila	class symphyl
ซิโนไทย	sino thailand	sino-thai
ซี	c	see
ซีซี	cc	cc
ซีรีเบลลัม	serabellum	cerebellum
ซีลีเนียม	selenium	selenium (chemical element)
ซีสต์	kista	cyst
ซีเกมส์	sea games	southeast asian game
ซีเจ	cj	cj
ซีเซียม	cesium	cesium
ซีเนม่า	bioskop	cinema
ซีแคนต์	garis potong	secant
ซีโร่	nol	zero
ซึง	yang mana	feeling touched (by the music or movie)
ซึม	meresap	absorb
ซึ่ง	di mana	because
ซึ่งประกอบด้วย	terdiri dari	consists of
ซึ่งมี	yang punya	with
ซึ่งมีความหมายว่า	yang artinya	meaning
ซึ่งมีทั้งหมด	yang memiliki semuanya	in total of
ซึ่งรู้จักกันว่า	yang dikenal sebagai	called
ซึ่งเกิดจากปัจจัยภายนอก	disebabkan oleh faktor eksternal	which is caused by external factors
ซึ่งเรียกว่า	yang disebut	called
ซึ่งแท้จริงแล้ว	sebenarnya	real name
ซึ่งได้แก่	yang mana	such as
ซุง	log	sung
ซุน	sun	son
ซุปเปอร์มาร์เก็ต	supermarket	supermarket
ซุปเปอร์เซ็นเตอร์	super center	super center
ซู	sue	holding up high
ซูจี	suzy	fuji
ซูซูกิ	suzuki	suzuki brand
ซูรินาเม	suriname	suriname
ซูเปอร์เซ็นเตอร์	pusat super	super center
ซ่อมแซม	untuk memperbaiki	repair
ซ่าหริ่ม	bahagia	a type of thai dessert
ซ้าย	kiri	left
ฌอง	jean	jean - french name
ญ	j	a thai alphabet with a y sound
ฐานข้อมูล	basis data	database
ฐานทัพ	base	armforce
ณภัทร	naphat	napat
ณรงค์	narong	narong - a male's name
ณัฏฐธิดา	natthida	nattathida - a thai female actress
ณัฐวุฒิ	nattawut	nattawut
ด	m.	a letter from thai alphabet
ดง	sariawan	area, location
ดม	hirup	smell
ดรทรงศักดิ์	dr songsak	doctor songsuk - a famous person
ดรนิพนธ์	dr nipon	doctor nipon
ดรสาโรช	dr saroj	dr. sarot
ดรสุชาติ	dr suchart	dr. suchart
ดราก้อน	naga	dragon
ดราก้อนเควสต์	quest naga	dragon quest
ดวงพร	keberuntungan	dwongpol
ดวงอาทิตย์	matahari	sun
ดอก	bunga	flower
ดอกอ้อ	bunga buluh	dok aou
ดอกไม้	bunga	flower
ดอกไม้ประจำจังหวัด	bunga provinsi	state's flower
ดอตคอม	dot com	dotcom
ดอนเมือง	don mueang	don mueang
ดอยอินทนนท์	doi inthanon	doi inthanon
ดอร์	pintu	door
ดอลลาร์สหรัฐ	kami dolar	united states dollar
ดอว์ขิ่นจี	dawin ji	dorkingi
ดังนั้น	jadi	for that reason
ดังเช่น	seperti	such as
ดัชนีการพัฒนามนุษย์	indeks pembangunan manusia	human development index
ดัตช์	belanda	dutch
ดันแฮม	dunham	dunham, the mother of barrack obama
ดับเบิลยู	w.	letter w
ดา	da	da - a thai nickname
ดาบ	pedang	sward
ดาบเขี้ยวฟ้าฟื้น	pedang pembalasan	sky fang sword of revival
ดารา	bintang	star
ดารากร	aktor	darakon
ดาราคู่แรกของไทย	bintang pertama di thailand	first movie stars in thailand
ดาราจักร	galaksi	planet in the solar system
ดาราศาสตร์รังสีเอ็กซ์	astronomi sinar-x	xray astronomy
ดาราหญิงไทยยอดนิยม	selebriti wanita thailand populer	famous actress
ดาวกระจาย	starburst	star disperse
ดาวคาโนปุส	canapas	canopus star
ดาวพฤหัสบดี	jupiter	jupiter
ดาวพุธ	merkuri	mercury
ดาวยูเรนัส	uranus	uranus
ดาวศุกร์	venus	venus
ดาวอาร์คตุรุส	arcturus	arcturus
ดาวเคราะห์	planet ini	planet
ดาวเคราะห์แคระ	planet kerdil	dwarf planet
ดาวเสาร์	saturnus	saturn
ดำรงค์	wimax	dumrong - a male's name
ดำรงตำแหน่ง	tahan posisi	hold the title of
ดำรงอ่องตระกูล	damrong ong family	dumrongongtrakul
ดำเนินสะดวก	damnoen saduak	damnoen saduak
ดิกชันนารี	kamus	dictionary
ดิค	***	dick - the name
ดิจิตอล	digital	digital
ดิน	tanah	soil
ดินเซนฮอฟเฟอร์	zenhoffer	dientzenhofer - as in christoph or leonhard or johannes
ดินแดน	wilayah	territory
ดิว	embun	dew - a nickname
ดิวิชั่น	divisi	division
ดิศ	disc	dis (thai first name)
ดิศกุล	diskul	disakul (last name)
ดิสนีย์	disney	disney
ดิสโพรเซียม	disprosium	dysprosium
ดี	bagus	d.
ดีคอนสตรักทิวิสม์	dconrak tavist	deconstructivism
ดีน	dean	religion (islamic term)
ดีบุก	timah	tin
ดีเวลลอปเมนท์	pengembangan	development
ดีเวลลอปเม้นท์	pengembangan	development
ดีเอ็นเอ	dna	dna
ดุสิต	dusit	dusit
ดูที่	lihatlah	see
ดูเพิ่มเติม	lihat lebih lanjut	see also
ดูเพิ่มเติมที่	lihat juga	see more detail in
ดูเร็กซ์	durex	durex
ดูแล	berhati-hatilah	take care
ด็อก	anjing	dog
ด้วย	dengan	too, also, together, with
ด้วยเหตุนี้	karena alasan ini	for this reason
ด้านการกีฬา	olah raga	sports
ด้านการต่างประเทศ	luar negeri	foreign affairs
ด้านการเกษตร	pertanian	agriculture
ด้านดนตรี	musik	in music
ด้านหน้า	bagian depan	front
ด้านหลัง	bagian belakang	backside
ด้านอ่าวไทย	teluk thailand	gulf of thailand side
ต	o	a letter from thai alphabet with th sound
ตกรอบที่	dieliminasi	did not make the cut
ตรงกับวันขึ้น	cocokkan	on the date of
ตรงกับวันที่	tanggal pertandingan	on the date of _______________
ตระกูล	klan	family
ตระกูลนารา	keluarga nara	nara lineage
ตระกูลปาร์ค	taman klan	park family (korean last name)
ตระกูลยามานากะ	keluarga yamanaka	yamanaka clan
ตระกูลอินุซึกะ	keluarga inuzuka	inu-tsuka family
ตระกูลเซนจู	keluarga senju	chen ju dynasty
ตรัง	trang	trung province
ตรางู	ular	snake brand
ตราด	trat	trad state
ตรานี้	segel ini	this seal
ตราสัญลักษณ์	lambang	symbol
ตรึงใจ	terpesona	truengjai
ตรุษจีน	tahun baru cina	chinese festival
ตลาด	pasar	market
ตลาดโลตัส	pasar teratai	lotus market
ตอน	episode	edition number
ตะกร้อ	takraw	takraw
ตะกั่ว	timbal	copper
ตะละภัฏ	talapat	talaput - a surname
ตะลุยอวกาศ	space dabble	space trek
ตะวันทอแสง	matahari terbit	tawanthosaeng
ตะวันออก	timur	east
ตะวันออกเฉียงเหนือ	timur laut	east
ตันติเวชกุล	tantivejkul	tuntivetchakul - a surname
ตัว	tubuh	body
ตัวพระ	protagonis	main character
ตัวยักษ์	raksasa	giant
ตัวละคร	karakter	character
ตัวละครจากเรื่อง	karakter dari cerita	soap opera based on a written story
ตัวลิง	monyet	monkey
ตัวสะกด	ejaan	final consonant
ตัวหาร	pembagi	divisor
ตัวอย่าง	sebuah contoh	example
ตัวอย่างคำบาลี	contoh pali	bali example words
ตัวอย่างคำประพันธ์	sajak sampel	sample writing
ตัวอย่างต้นแบบแรก	contoh prototipe pertama	holotype
ตัวอย่างภาพยนตร์	cuplikan film	movie trailer
ตัวอย่างเช่น	sebagai contoh	for example
ตัวเลขอย่างเป็นทางการ	nomor resmi	formally number
ตัวแปร	variabel	variable
ตั้งงี่สุ่น	tang ngeon	tang ngee soon
ตั้งอยู่ที่	terletak di	located
ตั้งอยู่เลขที่	terletak di	at house number
ตั๊กแตน	belalang	grasshopper
ตา	mata	ta (a person's name)
ตาคลี	takhli	ta-klee
ตามตัวสวมเครื่องประดับต่าง	saat ia mengenakan ornamen yang berbeda	accessories
ตามตำราพรหมชาติฉบับหลวง	menurut buku teks kerajaan dari brahma	by royal botanic manual/handbook
ตาระวา	tarawa	square yard
ตาราง	meja	table
ตำนานวายุสลาตัน	legenda badai	shippuden
ตำนานแฝงคำสอน	ajaran legendaris	tales
ตำบลกระเทียม	kecamatan bawang putih	garlic district
ตำบลกังแอน	distrik gang ann	ung gan district
ตำบลตาเมียง	distrik ta myung	tambon tameung
ตำบลนางแล	kecamatan nanglae	nang lae province
ตำบลนาดี	kecamatan nadi	na dee district
ตำบลบ้านกง	kecamatan ban kong	tambon bankong (name of the district)
ตำบลยะวึก	distrik yuwak	tambon yawuek
ตำบลระแงง	kabupaten rahang	ra-ngang district
ตำบลสังขะ	sangkha	thambol sangka
ตำบลเมืองบัว	kecamatan bua	muangbua district
ตำบลโพนครก	distrik phon nakhon	tambon poncrok
ตำบลไพรขลา	kecamatan phrai khala	phrai khla subdistrict
ติณสูลานนท์	tinsulanon	thinasulanon
ติอามัต	tiamat	tiarmut
ตี๋ใหญ่	tee besar	ti yai
ตึก	gedung	building
ตุรกี	turki	turkey
ตุลาคม	oktober	october
ตุ๊กแก	tokek	gecko
ตูน	kartun	toon
ต่อกันด้วยพันธะ	lanjutkan dengan obligasi	linked by bond
ต่อจาก	lanjutkan dari	resulting from
ต่อมา	nanti	later
ต่อมาวันที่	tanggal berikutnya	later on the date
ต่อมาในปี	di akhir tahun	later in the year
ต่อมาในรัชกาลที่	kemudian pada masa pemerintahan	afterwards, in the reign of
ต่อมาในสมัยกรุงธนบุรีและกรุงรัตนโกสินทร์เขมรตกอยู่ภายใต้การควบคุมของจักรวรรดิสยามอย่างเข้มงวด	kemudian, dalam periode thonburi dan rattanakosin, khmer berada di bawah kendali ketat kekaisaran siam.	later in thonburi period and rattanakosin period
ต่าง	berbeda	different, various
ต่างๆ	beragam	various, different
ต้น	awal	medication for multi-symptoms
ต้นตอจักรวาลวิทยา	kosmologi	cosmogony
ต้นสกุล	genus	clan
ถนน	jalan	street
ถนนคนเดิน	jalan berjalan	kon dern road
ถนนประชาธิปก	jalan demokrasi	prachatiphok road
ถนนมิตรภาพ	jalan persahabatan	thanon mittraphap
ถนนสุขุมวิท	jalan sukhumvit	sukhumvit road
ถมิตรภาพ	persahabatan	mittraphap road
ถวาย	tawarkan	presented (royal language)
ถึงกระนั้น	meskipun demikian	until
ถึงเดือนกรกฎาคม	untuk juli	starting july
ถ้วย	secangkir	cup
ถ้อยคำ	kata-kata	accent
ทดลอง	percobaan	experiment
ทนงศักดิ์	thanongsak	thanongsak
ทนาย	pengacara	lawyer
ทนายความ	pengacara	attorney
ทรงคล้ายทรงกลม	bulat	spheroid
ทรงถือหุ้นจำนวน	yang mulia memegang saham	stock ownership
ทรงผนวช	yang mulia	ordain
ทรงพระกรุณาโปรดเกล้าโปรดกระหม่อมให้	dengan ramah menguduskan saya	gift (word for the king)
ทรงยี่สิบหน้า	dua puluh wajah	icosahedron
ทรงลูกบาศก์	kubus	cube
ทรงสี่เหลี่ยมขนมเปียกปูน	belah ketupat	rhombohedron shaped
ทรงสี่เหลี่ยมมุมฉาก	persegi panjang	triangular prism
ทรงห้าหน้า	lima wajah	polyhedron
ทรงได้รับการทูลเกล้าฯ	menerima yang mulia raja	the king of thailand gives out ____ to people
ทรัพยากร	sumber daya	wealth
ทรัพยากรน้ำ	sumber daya air	water resources
ทรัพย์วิจิตร	kekayaan	sapwichit
ทรัพย์เพิ่ม	aset tambahan	subpherm
ทรัมเป็ต	trumpet	trumpet
ทรีทูวัน	tiga berbanding satu	three.two.one
ทวารหนัก	anus	anus
ทวีป	benua	continent
ทวีปอเมริกา	amerika	america continent
ทวีปเอเชีย	asia	asia
ทวีวัฒน์	thawiwat	taweewan
ทว่า	tapi	however
ทศกัณฐ์	tosakan	ravana
ทศพล	tosapon	thotsaphon
ทหาร	tentara itu	soldier
ทหารหน่วยอาเฟลันดราที่	unit militer aphelandra	afelandra army
ทหารอากาศ	angkatan udara	air force man
ทอง	emas	gold
ทองขาว	emas putih	thongkhao
ทองประสม	emas	thongprasom
ทองผาภูมิ	thong pha phum	thong pha phum
ทองหยอด	daun emas	a type of thai dessert
ทองหล่อ	thonglor	gold
ทองเจือ	emas dicampur	tong jea - a surname
ทองแดง	tembaga	copper
ทองใหญ่	emas besar	tong yai - a name
ทอม	tom	tom
ทอมสัน	thomson	thomson
ทอมัส	thomas	thomas
ทะเล	laut	ocean, sea
ทะเลทราย	gurun	dessert
ทะเลสาบ	danau	lake
ทักษะ	keterampilan	skill
ทัช	sentuh	touch
ทับ	tebas	thon-rammana
ทัพเรือภาคที่	departemen angkatan laut	naval area command
ทัวร์คอนเสิร์ต	tur konser	concert tour
ทั่วไป	jenderal	general
ทั้ง	keduanya	all
ทั้งหมด	semua	all
ทางทิศตะวันออก	timur	east
ทางทิศตะวันออกติดกับเวียดนาม	perbatasan timur vietnam.	borders vietnam to the east
ทางทิศเหนือติดกับประเทศไทยและลาว	sebelah utara berbatasan dengan thailand dan laos.	borders thailand and laos to the north
ทางน้ำ	cara air	by water
ทางรถไฟ	kereta	rail
ทางหลวงพิเศษ	jalan raya khusus	motorway
ทางอากาศ	melalui udara	by air
ทางไอทีวี	di itv	via itv ( a television station in thailand)
ทานากะ	tanaka	tanage - a japanese name
ทาร์ดิกราดา	tardikrada	tardigrada
ทาวเวอร์	menara	tower
ทำงาน	untuk bekerja	working
ทำนอง	tune	melody
ทำบุญตักบาตรฯ	membuat prestasi dan menawarkan makanan kepada para bhikkhu	put food offerings into a buddhist monk's bowl
ทำหน้าที่	lakukan tugasnya	task, function
ทำให้	buat	made
ทิฆัมพรธีรวงศ์	tikamporn thirawong	timkamporntiravong (thai last name)
ทิพย์	thip	thip
ทิฟฟานี่	tiffany	tiffany - female's name
ทิม	tim	tim
ทิวานนท์	tiwanon	thiwanon
ทิศตะวันตก	barat	west
ที	t	t.
ทีบีเอส	tbs	tbs
ทีมชาติไทย	tim nasional thailand	thai national team
ทีมใดที่จำนวนข้อที่ถูกน้อยกว่า	tim mana yang memiliki jumlah penawaran lebih rendah?	the team with the least correct answers
ทีวีอินไซด์	tv inside	tv inside
ทีโอที	tot	tot
ที่จ่ายร้อยละ	itu membayar persentase	costing
ที่นี้	di sini	here
ที่ประชาชนชอบมากที่สุด	yang paling disukai orang	people's most favorite
ที่มา	sumber	source
ที่มี	itu sudah	possess
ที่มีชื่อว่า	bernama	named
ที่สำคัญ	kuncinya	important
ที่หมายถึง	itu artinya	explanation
ที่อยู่อาศัย	tempat tinggal	residence
ที่เกิดขึ้น	itu terjadi	appear
ที่โดดเด่นคือ	yang luar biasa adalah	notable
ทุก	setiap	every
ทุกครั้ง	setiap saat	every time
ทุติยจุลจอมเกล้าวิเศษ	kapal	tuthit julajomklawwiset - the title of those you received jewelry from the king
ทุ่งตะโก	thung tako	thung tako district
ทุ่งสง	thung song	tong song or nakon sri thamarat state
ทุ่งใหญ่	thung yai	tungyai
ทู	juga	to
ทูล	alat	thun
ทเวนตี้	dua puluh	twenty
ทโกมลบุตร	tapi thongkom	komolbut - a surname
ทไย	mengapa	thayai
ท่องอาณาจักรโฮ่งเหมียว	bacalah kerajaan hong miao	traveling the kingdom of woof-meow
ท่าชนะ	postur tubuh	thachana
ท่านอิน	thanin	than in
ท่านอ่อง	ong	tan ong - a member of the royal family
ท่านอ้วน	pria gendut	than uan
ท่าน้ำนนท์	tepi laut	nam non pier
ท่ายาง	stempel karet	tha yang
ท่าศาลา	tha sala	sala pier
ท่าอากาศยานเลย	bandara loei	loei airport
ท่าเรือ	pelabuhan	pier
ท่าไม้ตาย	pemukim	deadly move
ท้องสนามหลวง	sanam luang	sanamloung - a landmark in thailand
ธกรุงไทย	krung thai bank	krung thai bank
ธกส	baac	bank for agriculture and agriculture
ธกสิกรไทย	bank kasikorn	kasikornbank
ธง	bendera	flag
ธงชัย	thongchai	thongchai
ธงชาติ	bendera nasional	national flag
ธงธง	bendera	thongthong
ธนบุรี	thonburi	thonburi province
ธนพร	thanaporn	thanaporn
ธนะรัชต์	thanarat	tanarat -a surname
ธนาคาร	bank	bank
ธนาคารกรุงศรีอยุธยา	bank ayudhya	bank of ayudhya
ธนาคารกรุงไทย	krung thai bank	krung thai bank
ธนาคารทหารไทย	bank militer thailand	tahanthai bank
ธนาคารทิสโก้	bank tisco	tisco bank
ธนาคารอิสลามแห่งประเทศไทย	bank islam thailand	islamic bank of thailand
ธนาคารเกษตร	bank pertanian	farmer's bank
ธนาคารเพื่อการพัฒนาแห่งเอเชีย	bank pembangunan asia	patana asia bank
ธนาคารไทยพาณิชย์	siam commercial bank	siam commercial bank
ธนิต	thanit	thanit
ธปท	bot	bot
ธรณินทราธิราช	tharawintharathirat	having to do with the king
ธรณีสัณฐานวิทยา	morfologi tanah	geomorphology
ธรรมนูญ	konstitusi	law
ธรรมศักดิ์	thammasak	tamasak - surname of an elected prime minister
ธรรมศาสตร์	universitas thammasat	thammasat
ธรรมเมกขสถูป	stupa dharma makk	dhamek stupa
ธานินทร์	thanin	tanin
ธารทิพย์	dari thip	tarnthip (first name)
ธำมงรค์	thamrong	ring
ธิติกานต์	thitikan	thitikan
ธีม	temanya	theme
ธีระ	thira	teera
ธีรเดช	thiradej	theeradej
ธุรกิจ	bisnis	business
ธุรกิจการบิน	bisnis penerbangan	airline business
นก	seekor burung	bird
นกกระจอก	burung gereja	sparrow
นกกระทา	puyuh	quail
นกกระทุง	pelikan	pelican
นกกระเต็น	kingfisher	kingfisher
นกขมิ้น	kenari	oriole
นกน้อย	burung kecil	noknoi
นกแก้ว	parrot	parot
นกแอร์	nok air	airline
นครนิวยอร์ก	kota new york	new york city
นครปฐม	nakhon pathom	nakhon pathom
นครพนม	nakhon phanom	nakhon phanom
นครราชสีมา	nakhon ratchasima	nakhon ratchasima
นครสวรรค์	nakhon sawan	nakhon sawan
นครหลวงเวียงจันทน์	vientiane capital	vientiane
นที	natee	natee - a male's name
นปช	udd	three letter acronym
นพจินดา	noppachinda	noppajinda - a surname
นพดล	nopadon	noppadol - a male's name
นร	pelajar	the ancient and auspicious order of the nine gems
นราธิป	narathip	naratip - a male's name of a singer
นราธิวาส	narathiwat	narativat state
นวนิยาย	sebuah novel	story
นวรัตน์	nawarat	navaratna
นวล	lembut	noul -  a name
นอกจาก	selain itu	other than, to exclude
นอกจากนี้	selain itu	furthermore
นอกจากนี้แล้ว	selain itu	besides
นอกเหนือจากนี้	terlepas dari ini	moreover
นอนไม่หลับ	tidak bisa tidur	insomnia
นอร์ส	norse	norse
นะงะซะกิ	nagasaki	nagasaki
นะโม	namo	namo
นักดนตรี	musisi	musician
นักบินของออร์บ	pilot orb	orb pilot
นักบินอวกาศ	astronot	astronaut
นักปรัชญา	filsuf	philosophist
นักพากย์	aktor suara	voice actor
นักมวย	boxer	boxer
นักร้อง	penyanyi	singer
นักร้องชายไทย	penyanyi pria thailand	thai male vocalist
นักร้องนักดนตรี	musisi penyanyi	singer, musician
นักร้องเพลงไทยสากลชาย	penyanyi thailand pria internasional	male thai pop singer
นักร้องเสียงหลัก	vokalis utama	lead singer
นักวิชาการ	akademik	i was in for.
นักวิทยาศาสตร์	ilmuwan	scientist
นักศึกษาวิชาทหาร	siswa militer	army reserve force students
นักสู้อันดับ	petarung peringkat	fighter rank
นักเขียน	penulis	writer
นักเขียนการ์ตูน	kartunis	cartoonist
นักเต้นนำ	penari utama	dancers
นักเศรษฐศาสตร์	ekonom	economist
นักแต่งเพลง	komposer	songwriter
นักแสดง	para aktor	actor/actress
นักแสดงพิธีกร	aktor	presenter of the show
นักแสดงรับเชิญ	aktor yang diundang	guest star
นัดกับนัด	berkencan dengan	nut kab nut - a thai sitcom
นันทนาการ	rekreasi	recreation
นันทนาคร	nanthanakorn	nantanakorn
นันทเสน	nanthasen	nanthasen
นันทไกร	nantakrai	nandhakrai
นับตั้งแต่เริ่มก่อตั้งจนถึงปัจจุบัน	sejak awal hingga sekarang	from the foundation up to the present
นัยนา	analogi	naiyana
นั่นคือ	yaitu	that is
นั่นเอง	cukup yakin	that is
นั้น	itu	that
นา	bidang	na
นากา	naga	naga
นากิ	nagi	nagi
นาคหิรัญกนก	nak hirankanok	nakhirunkanok
นางงามจักรวาล	miss universe	ms. universe
นางสาวสุวรรณ	nona suwan	miss suwan
นางสุพรรณมัจฉา	ny. suphan matcha	mrs. supanmatja - a character in a thai legend
นางาโตะ	nagato	logo ontario.
นาดี	nadi	na di
นาดูน	nadun	nadune (name of district)
นาทวี	nathawi	natavee district
นาทาล	natal	"exactly: ""natal;""  proper name: natarle"
นาที	satu menit	minute
นานา	banyak	nana
นามิ	nami	nami
นายกรัฐมนตรีของประเทศไทย	perdana menteri thailand	prime minister of thailand
นายกรัฐมนตรีไทย	perdana menteri thailand	thai prime minister
นายกำพล	tuan kampon	kamphon
นายชลอ	tn chalo	chalo
นายชวน	tuan chuan	mr. chuan
นายชาญชัย	tuan chanchai	chanchai
นายณรงค์	tuan narong	mr. narong - a male's name
นายดำรง	tuan damrong	mr dumrong - a male's name
นายทวี	tuan thawee	mr.tawee
นายประกอบ	tuan majelis	mr. prakob - a male's name
นายปรีชา	tuan preecha	mr.preecha
นายปรีดี	pak pridi	pridi - a male's name
นายยงยุทธ	tuan yongyut	mr. yongyut - a male's name
นายศักดา	sakda	sakda
นายสมชัย	tuan somchai	mr. somchai
นายสมัคร	pemohon	mr. samak - a thai name
นายสวัสดิ์	tuan sawat	sawat
นายสุชาติ	tuan suchart	mr. suchat
นายสุนทร	tuan sunthorn	mr. soontorn - a male's name
นายแพทย์	dokter	male doctor
นารูโตะ	naruto	naruto - a japanese cartoon
นาวาอากาศเอกหญิง	kapten wanita	woman airforce captain
นาฬิกา	jam itu	clock
นาโนเทคโนโลยี	nanoteknologi	nanotechnology
นำกลับมาสร้างใหม่อีกครั้ง	dibawa kembali untuk membuat lagi	remake (of an old movie)
นำแสดงโดย	dibintangi	performed by
นำโดย	dipimpin oleh	led by
นิกาย	sekte	sect
นิกเกิล	nikel	nickel
นิคมพัฒนา	nikom phatthana	nikhom phatthana
นิตยสารชีวจิต	majalah homeopati	cheewajit magazine
นิตยสารเอเชียวีก	majalah asia week	asiaweek magazine
นิตโย	nittayo	nittayo
นิทาน	dongeng	tales
นิยม	populer	niyom, name of a thai country music singer
นิยมจัดขึ้นในเดือน	populer diadakan di bulan ini	usually held in the month of
นิยาม	definisi	symbols
นิรมิต	mimpi	niramit
นิรันดร์กุล	nirunkun	nirankun
นิรุกติศาสตร์	etimologi	philology
นิลภิรมย์	nilphirom	nipinpirom - a surname
นิวคลีโอไทด์	nukleotida	nucleotide
นิวยอร์ก	new york	new york
นิวัฒน์	newwat	niwat
นิวเคลียร์	nuklir	nuclear
นิวเคลียส	inti	nucleus
นิฮง	nihong	nippon or nikon, a japanese reading language
นิเทศศาสตรบัณฑิต	sarjana seni	communication major graduates
นิ่ม	lembut	pangolin
นิ่มสกุล	nim sakul	nimsakun
นีโอ	neo	neo
นี่คือ	ini adalah	this is
นุช	sukacita	nucth
นเรศ	nares	naret - a male's name
นโยบายทางการทูตของจีน	kebijakan diplomatik cina	china;s foreign policies
น็อกซ์	knox	left.
น้องครีม	nong cream	nong kreme - a nickname of someone in thai entertainment
น้องชาย	adik laki-laki	brother
น้อยมาก	sangat sedikit	noimak
น้ำ	air	water
น้ำค้าง	embun	namkhang
น้ำดื่ม	air minum	beverages
น้ำท่วม	banjir	flooding
น้ำฝน	air hujan	rainwater
น้ำพอง	tiup	nam pong in kon kan province
น้ำมะนาว	jus lemon	lemonade
น้ำมัน	minyak	oil
น้ำมันสน	terpentin	oil of turpentine
น้ำยืน	air berdiri	numyeen - location in ubolthani state
น้ำหนัก	berat	weight
บทนมัสการนอบน้อมบูชาพระพุทธเจ้า	bab penyembahan yang rendah hati dari sang buddha	a prayer to the lord buddha
บทบาททางการเมือง	peran politik	politic
บทสวดบาลีที่ขึ้นต้นด้วยอรหัง	nyanyian pali yang dimulai dengan arhat	"pali mantra started with ""arhat"""
บทสวดสรภัญญะที่ขึ้นต้นด้วยธรรมมะคือ	nyanyian sorapanya yang dimulai dengan dharma adalah	a buddhist prayer
บนบก	di darat	on land
บรมนาถชาติอาชาวศรัย	borommanachat achan sai	something has to do with the king - too obscure
บรมนาถบพิตร	boromnat bophit	borommanatbophit
บรรณาธิการ	editor	editor
บรรพชีวินวิทยา	paleontologi	paleontology
บราซิเลีย	brasilia	brazilian
บราเธอร์ส	saudara	brothers
บริบาล	peduli	baribal - a famous soccer player
บริพัตร	makanan	paribatra
บริวเวอรี่	tempat pembuatan bir	brewery
บริสุทธิ์	murni	pure
บริหารธุรกิจ	administrasi bisnis	business administration
บริเวณรอบทะเลสาบเขมร	di sekitar danau khmer	area around the lake in cambodia
บริเวณเขตภูเขาทางภาคเหนือ	wilayah pegunungan di utara	mountain in north of thailand
บรูไน	brunei	brunei
บลีช	pemutih	bleach
บลู	biru	blue
บลูคอสมอส	blue cosmos	blue cosmos
บลูเบอร์รี่	blueberry	blueberry
บวก	plus	positive
บวม	bengkak	swelling
บวร	ilahi	bawon
บอมบ์	bom	bomb
บอย	anak laki-laki	boy
บอยซ์	boyz	boys
บอล	bolanya	ball
บอลด์วิน	baldwin	baldwin
บอส	bos	boss
บังคลาเทศ	bangladesh	bangladesh
บังไค	bangkai	bankai
บัณฑิต	lulusan	bandit
บัณฑิตวิทยาลัยร่วมด้านพลังงานและสิ่งแวดล้อม	sekolah pascasarjana bersama energi dan lingkungan	joint graduate school of energy and environment
บันทึก	simpan	record
บันทึกการสร้างโลก	rekor dunia	genesis diary
บันทึกความทรงจำ	memo	diary
บันเทิง	hiburan	entertainment
บัว	lotus	lotus
บัวลอย	bualoy	kind of thai sweetmeat
บัวเชด	bunga teratai	cedric dubois.
บัวใหญ่	bua yai	big lotus
บาคคัส	bacchus	bacchus
บาคุกันธาตุไฟ	elemen api bakugan	dragonoid
บาคุกันลูกน้องของนากา	bakugan, seorang pendukung naga	bakugan, minion of naga
บางกอกกล๊าส	bangkok glass	bangkok glass
บางกอกน้อย	bangkok noi	bangkok noi
บางครั้ง	terkadang	sometimes
บางซื่อ	bang sue	bang see - a location in thailand
บางปะกอก	bang pakok	bang prakok - an area in bangkok
บางปะหัน	bang pahan	a district in ayutthaya province
บางพลัด	bangplad	bangplad
บางส่วน	beberapa	some
บางเขน	bangkhen	bang khen
บางแสน	bangsaen	bang saen
บางใหญ่	bang yai	bang yai - a location in thailand
บานไม่รู้โรย	amaranth	gomphrena
บารอมิเตอร์	barometer	barometer
บารัก	barack	barack
บาร์	sebuah bar	bar
บาลี	pali	vatthu
บาอัล	baal	baal - a demon in hebrew
บิน	terbang	bin
บิล	tagihan	bill
บิ๊กซี	big c	big c
บิ๊กซ้งซุปเปอร์สโตร์	superstore lagu besar	big song superstore
บี	b.	b
บีช	pantai	beach
บีบี	bb	bb
บีฟเค้ก	kue daging sapi	beef cake
บี้	runtuh	flatten
บี้สุกฤษฎิ์	bie sukrit	be- sukasit wisetkeaw - name of a singer
บุคคล	orangnya	person
บุคคลสำคัญ	orang yang penting	vip person, very important person
บุคลิกภาพ	kepribadian	mannerism
บุช	bush	(george) bush
บุญค้ำ	merit	bunkham
บุญนะโชติ	bunnachot	bunachot - a surname
บุญนาค	merit	boon nak - a famous surname
บุณยเกตุ	bunyaket	boonyaket
บุตร	anak-anak	son
บุษบา	busaba	busaba - a woman's name
บูมเมอแรง	bumerang	boomerang
บ่อทอง	kolam emas	bothong
บ้านฉาง	ban chang	bahn shang -a  location in thailand
บ้านปราสาท	rumah kastil	castle house
บ้านผือ	ban phue	ban phue
บ้านฝันดอตคอม	baan fan com	bahnfun.com
บ้านลาด	rumah	ban lat
บ้านเขว้า	rumah	bahn kaywah, an area in thailand
บ้านแพ้ว	rumah	ban paw
บ้านโพธิ์	ban pho	bahn po - a location in thailand
ปจ	tahun	two letters acronym
ปช	pantai	two letters acronym
ปฏิทินช่อง	kalender saluran	calendar
ปฏิภาณ	esprit	male's name patipan
ปตท	ptt	three letters from thai alphabets
ปทานุกรม	kamus	encyclopedia
ปทุมธานี	pathum thani	pathum thani
ปภ	keamanan	the order of the direkgunabhorn
ปภัสรา	papassara	papatsara
ปม	simpul	knot
ประกอบด้วย	terdiri dari	composed of
ประกอบไปด้วย	terdiri dari	included
ประการที่	nomor	point
ประกาศิต	nyatakan	command
ประกาศเป็นป่าสงวน	dinyatakan sebagai cagar hutan	preserve area, the protected forest
ประจวบ	bertepatan	prachuap
ประจวบคีรีขันธ์	prachuap khiri khan	prajoubkirikan state
ประจักษ์	jelas	mr. prajak
ประจำปี	tahunan	annual
ประชากรประมาณ	perkiraan populasi	population about
ประชากรศาสตร์	demografi	literature subject
ประดิษฐาน	tempat	placed
ประติมากรรม	patung	production of a play
ประติมากรรมไทย	patung thailand	thai sculpture
ประตู	pintu	gate
ประตูน้ำ	pratunam	pratunam
ประตูเสีย	pintu rusak	broken door
ประทีป	prateep	continent
ประธาน	presiden	president
ประธานกรรมการ	ketua	chief executive officer
ประธานศาลฎีกา	presiden mahkamah agung	president of the supreme court
ประธานสภารัฐสภา	ketua parlemen	speaker of parliament
ประธานาธิบดี	presiden	president
ประมาณ	tentang	about, estimated to be
ประมาณคศ	tentang	christ year
ประมาณปี	sekitar satu tahun	approximately in the year
ประยงค์	prayong	prayong
ประวัติศาสตร์	sejarah	history
ประวัติศาสตร์สเปน	sejarah spanyol	history of spain
ประวัติศาสตร์ไทย	sejarah thailand	history of thailand
ประสาท	gugup	castle
ประสิทธิภาพ	efisiensi	efficiency
ประหยัด	simpan	thrifty, cheap
ประเด็นที่	masalah	point number
ประเทศ	negara	country
ประเทศกัมพูชา	kamboja	cambodia
ประเทศซูดาน	sudan	sudan
ประเทศทำการค้าขายกับต่างประเทศมากยิ่งขึ้น	negara melakukan lebih banyak perdagangan dengan negara asing	country that trades with other countries
ประเทศนอร์เวย์	norwegia	norway
ประเทศฝรั่งเศส	prancis	france
ประเทศพม่า	myanmar	burma
ประเทศฟินแลนด์	finlandia	finland
ประเทศภูฏาน	bhutan	bhutan
ประเทศมาเลเซีย	malaysia	malaysia
ประเทศราช	negara kerajaan	vassal state
ประเทศลาว	laos	laos
ประเทศสวีเดน	swedia	sweden
ประเทศสเปน	spanyol	spain
ประเทศอียิปต์	mesir	egypt
ประเทศเกาหลี	korea	korea
ประเทศเกาหลีใต้	korea selatan	south korea
ประเทศเนปาล	nepal	nepal
ประเทศเปรู	peru	peru
ประเทศเม็กซิโก	meksiko	mexico
ประเทศเวียดนาม	vietnam	vietnam
ประเทศแคนาดา	kanada	canada
ประเทศและดินแดน	negara dan wilayah	natoin and territory
ประเทศไทย	thailand	thailand
ประเพณีชักพระ	tradisi chak phra	chak phra festival
ประเภท	tipe	category
ประเภทของ	jenis	type of
ประเภทรายการแข่งขันชิงรางวัลดีเด่น	kategori penghargaan kompetisi luar biasa	award show for
ประโยค	kalimat itu	sentence
ปรัชญา	filosofi	philosophy
ปรัชญาตะวันตก	filsafat barat	western philosophy
ปรากฏการณ์โลกร้อน	pemanasan global	global warming
ปรากฏตัวตอนแรกในตอน	pertama kali muncul dalam sebuah episode	first appear in
ปรากฏตัวในตอน	muncul di	showing their presence
ปราจีนบุรี	prachinburi	prachin-buri
ปราบดาภิเษก	dinobatkan	prapdapisek
ปราสาทเขาพระวิหาร	kuil preah vihear	kao pravihan ancient ruins
ปราโมทย์	pramot	pramot
ปริญ	prin	parin
ปริญญา	gelar	degree
ปริภูมิ	ruang	3 dimensions
ปริมาณการผลิต	volume produksi	capacity
ปริศนา	teka-teki	puzzle
ปริ๊นซ์	pangeran	prince
ปรีดา	senang	prida - a male's name
ปรีดี	pri	pridi
ปลา	seekor ikan	fish
ปลาบู่ทอง	golden goby	goldfish
ปลาปอมปาดัวร์	pompadour	pompadour
ปลาย	akhirnya	at the end
ปลายคริสต์ศตวรรษที่	akhir abad ke-19	late century
ปลาในสกุลนี้เรียกว่า	ikan dalam genus ini disebut	the fish in this family is called _________
ปลิงทะเล	teripang	sea cucumber
ปล่อย	lepaskan	release
ปวดข้อ	nyeri sendi	joint pain
ปวันรัตน์	pawanrat	pavunnarat - a surname
ปวีณา	paweena	paweena
ปักกิ่ง	beijing	beijing
ปักธงชัย	pak thong chai	pakthongchai
ปัจจุบัน	saat ini	at present
ปัจจุบันนี้	sekarang	presently
ปัจจุบันประเทศไทยมีภาพยนตร์ที่มุ่งสู่ตลาดโลก	saat ini, thailand memiliki film yang ditujukan untuk pasar dunia.	currently thailand has international movies
ปัจจุบันมีที่นั่งอยู่ในสภาผู้แทนราษฎร	saat ini memiliki kursi di dpr	presently have elected representatives
ปัจจุบันเลิกเขียนแล้ว	saat ini tidak lagi menulis	presently retired from writing
ปัญจาบ	punjabi	panjab
ปัญโญภาส	panopa	panyopat - a surname
ปัน	bagikan	pan
ปั้น	cetakan	clay molding
ปั๊บ	seketika	pup
ปาก	mulut	mouth
ปากดี	mulut yang bagus	be talkative
ปากน้ำ	muara	samutpragan province in thailand
ปากีสถาน	orang pakistan	country of pakistan
ปากเกร็ด	pak kret	pak kret
ปากแม่น้ำสิงคโปร์	mulut singapura	singapore river delta
ปาน	seperti	pan - a thai name
ปานามา	panama	panama
ปานแร่	tanda lahir	panrae
ปาย	pai	pai
ปาริชาต	parichat	tiger’s claw
ปารีส	paris	paris
ปาร์ค	park	park
ปาสกาล	pascal	pascal - computer language or name
ปาเลสไตน์	palestina	palestine
ปิปเปอราซิลลิน	piper acillin	piperacillin
ปิยะพงษ์	piyapong	piyapong
ปิ่นเกล้า	pinklao	pin glow - an area in thailand
ปีคศ	tahun	christain era
ปีจอโทศก	tahun babi	year of the dog
ปีที่	tahun	the year
ปีที่วางจำหน่าย	tahun rilis	the year that the product was on the market
ปีพุทธศักราช	tahun buddhis	buddhism year
ปีย์	tahun	pe - a thai music artist
ปีย์ชนิตว์	piyachit	peechanit
ปีเตอร์	peter	peter
ปี่กลาง	tas tengah	a thai woodwind instrument
ปืนพก	pistol	handgun
ปืนพกกึ่งอัตโนมัติ	pistol semi-otomatis	semi-automatic pistol
ปืนใหญ่	meriam	cannon
ปืนใหญ่กลางกระสุนวิถีโค้ง	kurva lintasan medium meriam	cannon
ปืนไร้แรงสะท้อนถอยหลัง	pistol recoil	recoilless rifle
ปุณณกันต์	punnakan	bhunnagun
ปุตราจายา	putrajaya	putrajaya
ปุ๋ย	pupuk	pui
ปู	kepiting	crab
ป่าชายหาด	hutan pantai	beach forest
ป่าชายเลน	hutan bakau	mangrove forest
ป่าดิบแล้ง	hutan cemara kering	dry evergreen forest
ป่าเบญจพรรณ	hutan campuran	mixed forest
ป่าโกงกาง	hutan bakau	mangrove
ป๊อป	pop	pop
ป๊อปปี้	opium	poppy
ผจญภัยเกาะมหาสมบัติ	petualangan pulau harta karun	nobita's south sea adventure
ผดุง	dukungan	phadung
ผล	hasilnya	result
ผลการแข่งขัน	hasil kompetisi	result of competition
ผลงานหนังสือ	portofolio buku	publication
ผลงานเพลง	musik	song production
ผลงานโฆษณา	iklan	marketing project
ผลประเสริฐ	hasil luar biasa	polpasert - last name of the 2nd wife of the thai prince
ผลผลิตพลอยได้	produk sampingan	result, effects
ผลรวม	jumlah	summation
ผลสำรวจ	hasil survei	survey results
ผิวขาว	kulit putih	white
ผิวสี	warna kulit	skin color
ผี	hantu itu	ghost
ผีน่ารัก	hantu lucu	cute ghost
ผู้กำกับ	direktur	producer
ผู้จัดการ	manajer	manager
ผู้จัดการทีม	manajer tim	manager
ผู้ชนะ	pemenang	winner
ผู้ชาย	seorang pria	male, man
ผู้ช่วยศาสตราจารย์	asisten profesor	assistant professor
ผู้ดำเนินรายการ	moderator	moderator
ผู้บริหาร	eksekutif	manager
ผู้ผลิต	pabrikan	producer
ผู้ฝึกสอน	pelatih	trainer
ผู้พิทักษ์แห่งพิรุณ	penjaga masalah	rain defender
ผู้พิทักษ์แห่งอรุณ	penjaga fajar	guardian of the dawn.
ผู้ว่าการธนาคารแห่งประเทศไทย	gubernur bank of thailand	governor of the bank of thailand
ผู้ว่าราชการจังหวัด	gubernur	the governor of the city
ผู้สนับสนุน	pendukung	supporter
ผู้อำนวยการ	direktur	superintendent
ผู้เล่น	para pemain	player
ผู้เล่นชุด	atur pemain	team
ผู้ใหญ่	seorang dewasa	adult
ผ่องศรี	phongsri	pongsri
ผ้าขาวม้า	cawat	a special thai cloth that men used to tie around their waists
ผ้าอนามัยโซฟี	sophie pembalut wanita	sofi sanitary napkin
ฝ	perancis	a letter with ph sound
ฝอยทอง	fuzz	foythong - a thai dessert
ฝิ่น	candu	opium
ฝูงชนวุ่นวาย	kerumunan yang kacau	mob
ฝ่ามือ	telapak tangan	palm
ฝ่ายบริหาร	manajemen	executive branch
ฝ่าเท้า	telapak kaki	sole of foot
ฝ่าแดนเขาวงกต	melalui labirin	in the boundaries of kao wonkut
ฝ้าย	kapas	fai
พ	t	a thai alphabet
พงศ์ศิลป์พิพัฒน์	pongsilp phiphat	pongsinpipat
พงศ์เรืองรอง	pongrueangrong	"surname ""pong reuang-rong"""
พงษ์พานิช	pongpanich	phongphanit
พงษ์เพชร	phong phet	phong phet
พงษ์ไพบูลย์	phongpaibun	pongphatboon
พจนานุกรมออนไลน์	kamus online	online dictionary
พญา	ular	phaya
พญามังราย	phaya mangrai	mangrai the great
พตท	area	three letters acronym
พธม	th	people's alliance for democracy
พนมไพร	phanom phrai	phanom phrai
พบหลักฐานของมนุษย์ซึ่งมีอายุเก่าแก่ที่สุดถึงห้าแสนปี	ditemukan bukti manusia, yang tertua hingga lima ratus ribu tahun.	found an evidence of the the oldest human that lived in that area
พยัญชนะ	konsonan	consonant
พยัญชนะสะกดควบกล้ำ	konsonan	diphthong's consonant
พยางค์	suku kata	syllable
พยาธิกำเนิด	patogenesis	pathogenesis
พยาธิวิทยา	patologi	pathology
พยาบาล	seorang perawat	nurse
พยายามชี้ให้สาธารณชนและนานาชาติ	mencoba menunjukkan kepada publik dan internasional	encourage to promote the people and international policies
พร	porno	wishes
พรนารายณ์	narai	phonnarai
พรบ	act	act
พรรคการเมืองใหม่	partai politik baru	kan mai meung political party
พรรคชาติไทย	bagan pesta thailand	thai nation party
พรรคธรรมาธิปัตย์	partai thammathipat	tamatipat political party
พรรคประชาธรรม	pesta prachatham	prachatam political party
พรรคภูมิใจไทย	pesta thailand phuea	bhumjaithai party
พรรคสม	partai persamaan	som rangsi political party
พรรคสังคมประชาธิปไตย	partai sosial demokrat	social democratic party
พรรคเพื่อแผ่นดิน	pesta thailand pheu	puea pandin party
พรอุดมศักดิ์	phonudomsak	pornudomsak (last name)
พระคาถาชินบัญชร	mantra chinnabanchon	chinbanchon
พระจันทร์	bulan	moon
พระจันทร์สีรุ้ง	bulan pelangi	phrachan sirung
พระชนม์	hidup	the father of the king
พระตำหนัก	istana	the king's residence
พระที่นั่งจักรพรรดิพิมาน	istana kaisar phiman	chakraput piman hall
พระที่นั่งดุสิตมหาปราสาท	aula singgasana dusit maha prasat	phra thinang dusit maha prasat
พระที่นั่งบรมพิมาน	rumah boromphiman	the king's seat
พระธรรมปิฎก	dhammapitaka	phra thampidok
พระธิดา	anak perempuan	daughter
พระนคร	modal	phra nakhon
พระนาม	nama	name of the king
พระนามต้นราชสกุล	nama depan	the first person in the dynasty
พระนารายณ์	wisnu	narayana
พระบรมธาตุไชยา	peninggalan buddha	buddha's relics chaiya
พระบรมราชชนก	pelindung kerajaan	the king's sister
พระบรมราชินี	ratu	queen
พระบรมวงศานุวงศ์	royalti	members of the royal family
พระบาทสมเด็จพระนั่งเกล้าเจ้าอยู่หัว	raja nang klao	jessadabodindra
พระบาทสมเด็จพระปกเกล้าเจ้าอยู่หัว	raja prajadhipok	phrabat somdet phra poramintharamaha - 7th king of thailand
พระบาทสมเด็จพระปรเมนทรมหาอานันทมหิดล	yang mulia raja bhumibol adulyadej maha anandamahidol	phra bat somdet phra poramentharamaha ananda mahidol
พระบาทสมเด็จพระพุทธยอดฟ้าจุฬาโลก	buddha phra phra yot fa, chulalongkorn	king rama 1 of chakri monarchy (bangkok)
พระบาทสมเด็จพระเจ้าอยู่หัวภูมิพลอดุลยเดชทรงพระกรุณาโปรดเกล้าฯ	yang mulia raja bhumibol adulyadej dengan anggun senang	the current king of thailand
พระบาทสมเด็จพระเจ้าอยู่หัวอานันทมหิดล	raja ananda mahidol	king ananda mahidol
พระบาทสมเด็จพระเจ้าอยู่หัวเสด็จฯ	yang mulia raja	the current king
พระปกเกล้าเจ้าอยู่หัว	raja prajadhipok	king rama vii
พระประแดง	phra pradaeng	prapadaeng
พระปรางค์สามยอด	prang sam yot	prapang samyod
พระพรหมคุณาภรณ์	phra prom khunaporn	pra prhom kunaporn - a person in thailand
พระพันปีหลวง	milenium luang	queen mother
พระพันวัสสาอัยยิกาเจ้า	phra phanwassa aiya	pra paunvatsaeyyigajao - name of a monk
พระพุทธชินราช	phra buddha chinnarat	phra buddha chinnarat
พระพุทธบาท	jejak buddha	phra phutthabat
พระพุทธศาสนา	agama buddha	buddhism
พระมงกุฏเกล้าเจ้าอยู่หัว	raja rama iv	phra mongkut klao chao yu hua
พระมเหสี	selir	the wife of a king
พระยศขณะนั้น	saat itu	the current title
พระยาชัยสุนทร	phraya chai soonthorn	praya chaisoontorn - first mayor of thailand
พระยาราม	phraya ram	prayaram - the governor of sukothai city (the ancient city of thailand)
พระยาวิเศษภักดี	phraya wisetphakdi	praya wiset pakdi -a  name of a head of state in the ancient time
พระยาสุนทรสงคราม	phraya sunthornsongkram	phraya sonthornsongkram (thai name)
พระยาไกรภักดีศรีนครลำดวน	phraya kraiphakdi srinakhon lamduan	phraya kraiphakdi sinakhon lamduan
พระราชกรณียกิจ	tugas kerajaan	royal duties
พระราชลัญจกรประจำพระองค์	segel kerajaan	the king's body guard
พระราชวงศ์	keluarga kerajaan	royal family
พระราชวรวงศ์เธอ	keluarga kerajaan	the title of the princess
พระราชวังดุสิต	istana dusit	dusit palace
พระราชวังเดิม	istana asli	phra racha wang derm
พระลอ	phra lor	phra lo
พระสมเด็จจิตรลดา	phra somdej chitralada	pra jitlada - something that was built by the king
พระสัมมาสัมพุทธเจ้า	sang buddha	buddha
พระองค์เจ้าสิริวัณณวรีนารีรัตน์	hrh princess siriwannawari wareerat	the name of one of the king's granddaughter
พระอังสาเบื้องซ้ายประดับเหรียญรัตนาภรณ์	jimat buddha yang menguntungkan di sebelah kiri, dihiasi dengan medali rattanakhon	diagonal sash for the princess
พระอัษฎามหาเจดีย์	phra asada maha chedi	(royal name/language)
พระอิศวร	siwa	the god shiva
พระอิสริยยศ	gelar kerajaan	given rank or honor by the monarchy
พระอุโบสถ	candi budha	the temple
พระเกียรติยศ	hormat	royal honour
พระเจ้าลูกยาเธอ	anak tuhan	the royal princess
พระเจ้าหลานเธอ	tuhan keponakanmu	hmh princess
พระโคตมพุทธเจ้า	jimat buddha	pra kotomputtachao - another name of buddha
พรานกระต่าย	hunter	prankatai - an area in thai province
พราหมณ์	brahmana	brahman
พริกหยวก	paprika	a type of thai pepper
พริกหวาน	paprika	sweet pepper
พริกไทย	merica	thai pepper
พฤกษศาสตร์	botani	botany
พลตรี	angkatan udara	major general
พลตรีหญิง	angkatan udara wanita	a female officer
พลตำรวจเอก	jenderal polisi	police general
พลทหาร	prajurit	first class, enlisted men
พลศักดิ์	polsak	polsak
พลอย	batu permata	ploy
พลอสนธิ	polson junction	sonthi - a famous thai army officer
พลอากาศเอกหญิง	acm perempuan	air chief marshal
พลฯ	jenderal	private
พลังงานคลื่น	kekuatan gelombang	wave power
พลังงานนิวเคลียร์	tenaga nuklir	nuclear power
พลังงานลม	tenaga angin	wind power
พลังงานไฟฟ้า	tenaga listrik	electrical energy
พลัส	plus	plus
พลาซา	plaza	plaza
พลาสติก	plastik	plastic
พลาสมา	plasma	plasma
พลเรือเอก	laksamana	admiral
พลเอกสนธิ	jenderal sonthi	sonthi - a thai army officer
พวกสัตว์ลำตัวกลม	hewan berbentuk bulat	animals with no backbones
พศ	jumat	b.e.
พอ	cukup	col.
พอตเตอร์	potter	potter
พอตเตอร์กับเจ้าชายเลือดผสม	potter dan pangeran berdarah campuran	(harry) potter and the half-blood prince
พอยท์	point	point
พอล	paul	paul
พัชรี	phachari	pacharee - a female's name
พัฒน์ชัย	phatchai	pattachai - a male's name, famous singer
พัทยาเหนือ	pattaya utara	north pattaya
พัทยาใต้	pattaya selatan	south pattaya - in thailand
พัน	seribu	pan
พันธมิตร	mitra	alliance
พันธุศาสตร์	genetika	genetic
พันธุ์พืช	spesies tanaman	seed
พันธุ์สุนัข	anjing berkembang biak	dogs
พันธเสน	obligasi	panthasen (thai last name)
พับลิชชิ่ง	penerbitan	publishing
พัลซาร์	pulsar	pulsar
พากย์เป็น	dijuluki sebagai	subtitle
พายุ	badai	storm
พารา	para	parasetamol - a drug
พารามีเซียม	parametrik	paramecium
พาร์ค	park	park
พาวเวอร์บาย	beli daya	power buy
พาเมล่า	pamela	pamela
พิชัย	phichai	pichai
พิชิต	taklukkan	phichit
พิณ	harpa	harp
พิธีกรรายการ	tuan rumah	host
พิบูลมังสาหาร	phibun mangsahan	pi bul mung sa har (province name)
พิพิธภัณฑสถานแห่งชาติ	museum nasional	thailand meseum
พิพิธภัณฑ์	museum	museum
พิม	pim	type
พิมประภา	phimprapa	phimprapha
พิมพ์เล็ก	cetakan kecil	small photo frame 1.4 cm x 2.1 cm x 0.5 cm thick
พิมลวรรณ	phimonwan	pimonvun - the name of a female anchor person
พิรุณ	fajar	rain water
พิสุทธิ์	cemerlang	pisut - a male's name
พิออจชา	teh phion	piodcha
พิเศษนครกิจ	nakornkit special	pisetnakornkit - a surname
พีท	pete	pete
พีระมิด	piramida	pyramid
พีระศรี	phirasri	balcony
พีอีเอ	pia	pea
พี่น้อง	saudara	siblings
พี่สาวของ	saudara perempuan	the sister of ____________
พึ่งสุนทร	andalkan sunthorn	puangsunthorn
พืช	tumbuhan	plants
พืชที่สำคัญคือ	tumbuhan penting adalah	important plants are ...
พืชไม่มีท่อลำเลียง	tanaman tanpa konveyor	plants without tubelike structures
พื้นฐานทางเศรษฐกิจ	dasar ekonomi	base economics
พื้นที่มหาวิทยาลัย	wilayah universitas	university area
พุฒตาล	putthan	puttan
พุทธคยา	bodh gaya	bodh gaya
พุทธนิกายเถรวาท	buddhisme theravada	a sect of buddhist religion
พุทธศตวรรษที่	buddha abad	buddhist era
พุทธศักราช	era buddhis	buddhist era
พุ่มพวง	semak	poompoang - surname of a famous actor
พู่กัน	kuas	pugun
พ่อขุนรามคำแหง	raja ramkhamhaeng	the leader of sukothai empire
พ่อขุนศรีอินทราทิตย์	raja intharathit	po kun intarathip - the fist king of thailand
พ่อมด	wisaya	wizard
พ่ายแพ้ให้กับ	kalah dari	lose to
พ๎ร	selamat datang	wish
ฟง	fong	fong - a chinese name
ฟรานซ์	franz	franz
ฟรีดริช	friedrich	friedrich
ฟรีด้อม	menyelinap gratis	freedom
ฟรีแวร์	freeware	freeware
ฟลายเวท	kelas terbang	flyweight
ฟลูวาสแตติน	fluvastin	fluvastatin - a drug
ฟอน	von	von - in german name
ฟอร์ด	ford	ford
ฟอสฟอรัส	fosfor	phosphorus
ฟอสเฟต	fosfat	phosphate
ฟังพระธรรมเทศนา	dengarkan khotbah	listen to the gospel
ฟังเพลง	dengarkan musik	listen to music
ฟังไจ	dengarkan jaime	fungi
ฟัน	gigi	tooth
ฟาง	jerami	fhang
ฟาน	van	van - as in the surname
ฟิชเชอร์	fisher	fisher
ฟินแลนด์	finlandia	finland
ฟิลิป	philip	philip
ฟิลิปปินส์	filipina	philippines
ฟิลิปีโน	filipino	filipino
ฟิวชัน	fusion	fusion
ฟิสิกส์ดาราศาสตร์	astrofisika	astrophysics
ฟิสิกส์อนุภาค	fisika partikel	physic particle
ฟีนิลคีโตนูเรีย	fenilketuria	phenylketonuria
ฟีฟ่าคลับเวิลด์คัพ	piala dunia klub fifa	fifa world cup
ฟุตซอล	futsal	futsal
ฟุตบอล	sepakbola	football
ฟุตบอลอาเซียนเยาวชน	asean youth football	asian youth soccer
ฟุตบอลเอเชียเยาวชน	sepak bola pemuda asia	asian football club youth championship
ฟู	penuh	rise up
ฟูจิ	fuji	fuji
ฟูลส์	penuh	fools
ฟ้อน	menari	fon
ฟ้า	biru	blue
ฟ้าร้อง	guntur	thunder
ฟ้าหลัว	haze	haze
ภมรมนตรี	bamamon montri	pamornmontri
ภักดี	setia	pakdi
ภัณฑิลา	panthila	paktila - first name of a female actress
ภาคกลาง	wilayah tengah	central thailand
ภาคคนแสดง	tampilkan	human version
ภาคตะวันตก	wilayah barat	west
ภาคตะวันออกเฉียงเหนือ	wilayah timur laut	northeast region
ภาคพิเศษ	spesial	special program
ภาควิชาคณิตศาสตร์	departemen matematika	department of mathematics
ภาควิชาพยาธิวิทยา	departemen patologi	department of pathology
ภาควิชาฟิสิกส์	departemen fisika	physics
ภาควิชาวิศวกรรมเครื่องกล	departemen teknik mesin	engineering division
ภาควิชาวิศวกรรมไฟฟ้า	departemen teknik listrik	engineering department
ภาควิชาสูติศาสตร์และนรีเวชวิทยา	departemen kebidanan dan ginekologi	gynecology
ภาควิชาเทคโนโลยีอาหาร	departemen teknologi pangan	faculty of food technology
ภาคเหนือ	utara	northern region
ภาคใต้ตอนล่าง	wilayah selatan lebih rendah	southern thailand
ภาพตรา	citra merek	coat of arms
ภาพถ่าย	foto itu	photograph
ภาพพาโนรามา	panorama	panoramic image
ภาพพิมพ์	cetak gambar	lithography
ภาพยนตร์	film	movie
ภาพยนตร์การ์ตูนไทย	film kartun thailand	thai cartoon
ภาพยนตร์ชุดนี้	set film ini	this series
ภาพยนตร์ตอน	episode	version of the movie
ภาพยนตร์ลามก	film yang buruk	porn movie
ภาพรวม	ikhtisar	group of pictures
ภายหลัง	setelah	background
ภายหลังสงคราม	setelah perang	after the war
ภายใต้ความช่วยเหลือจากกองทุนการเงินระหว่างประเทศ	di bawah bantuan dana moneter internasional	with the financial help, sponsored by
ภายในวงขอบเหรียญเบื้องบนมีข้อความว่า	di bagian atas koin adalah pernyataan itu	etching in the medal that ______________
ภารกิจ	misi	business
ภาวะเศรษฐกิจของกัมพูชาหลังจากมีการเปลี่ยนแปลงการปกครองจากระบอบสังคมนิยมเป็นระบอบประชาธิปไตย	kondisi ekonomi kamboja setelah transisi dari sosialisme demokratis ke demokrasi.	cambodia economy after political change
ภาษาญี่ปุ่น	orang jepang	japanese language
ภาษาบาลี	pali	balese language
ภาษาสเปน	bahasa spanyol	spanish language
ภาษาอังกฤษ	bahasa inggris	english language
ภาษาอีสาน	bahasa timur laut	eastern thai language
ภาษาเกชัว	quechua	quechua language
ภาษาเฉพาะอาชีพ	jargon	jargon
ภาษาเบสิก	dasar	basic programming lauguage
ภาษาเยอรมัน	jerman	german language
ภาษาโคบอล	cobol	cobol programming language
ภิญโญ	bagus	pinyo - a female's name
ภิรมย์	puas	philom
ภิรมย์ภักดี	phirom phakdi	pirompakdee
ภูกระดึง	phukradueng	phu kradueng
ภูกามยาว	phu kam yao	phu kamyao district
ภูธเนศ	bhutanet	putanet - a male's name
ภูพาน	phu phan	phu phan
ภูมิประเทศและภูมิอากาศ	topografi dan iklim	geography and climate
ภูมิภาค	wilayah	region
ภูมิรัตน์	bhumirat	poomirath
ภูหลวง	phu luang	phu luang
ภูเขา	gunung	mountain
ภูเขาน้ำแข็ง	gunung es	glacier
ภู่สว่าง	phoo sawang	poosawang - a surname
ม	m.	a thai alphabet with an 'm' sound
มกราคม	januari	january
มจก	m.	the most illustrious order of the royal house of chakri
มณฑลหูหนาน	hunan	hunan in china
มณีวรรณ	maniwan	maniwan
มด	semut	ant
มดลูก	rahim	uterus
มต้น	mulai	primary level of secondary school
มธ	tu	abbreviation for thammasat university
มธรรมศาสตร์	universitas thammasat	thammasat university
มน	bulat	two letters acronym
มนุษย์	manusia	human
มนุษย์กลายพันธุ์	mutan	human mutant
มนเรศวร	naresuan	naresuan university
มปท	simpul	acronyms
มม	ny	mm
มมหิดล	universitas mahidol	mahidol university
มยุรา	mayura	mayura - a female's name
มลายู	melayu	malayu
มวยปล้ำ	gulat	wrestling
มสงขลานครินทร์	prince of songkla	prince of songkla university
มหัพภาค	penuh	a symbol used in thai writing
มหาชน	publik	public company
มหาชัย	mahachai	mahachai - male's name
มหาบัณฑิต	tuan	graduates from college
มหาปรมาภรณ์ช้างเผือก	maha paramaporn chang phueak	highest class of the order of white elephant
มหาวชิรมงกุฎ	mahavajira crown	the biggest crown of the king
มหาวรรค	maha buddha	mahavak - a buddhist priest
มหาวิทยาลัย	universitas	university
มหาวิทยาลัยขอนแก่น	universitas khon kaen	khon kaen university
มหาวิทยาลัยทักษิณ	universitas thaksin	thaksin university
มหาวิทยาลัยนเรศวร	universitas naresuan	naresuan university
มหาวิทยาลัยบูรพา	universitas burapha	university
มหาวิทยาลัยปทุมธานี	universitas pathum thani	pathumthani university
มหาวิทยาลัยพะเยา	universitas phayao	prayao university
มหาวิทยาลัยภูมินทร์พนมเปญ	universitas phurin phnom penh	university of phnom penh
มหาวิทยาลัยมหาจุฬาลงกรณราชวิทยาลัย	universitas mahachulalongkornrajavidyalaya	chulalongkorn university
มหาวิทยาลัยมหาสารคาม	universitas maha sarakham	mahasarakham university
มหาวิทยาลัยมหิดล	universitas mahidol	mahidol university
มหาวิทยาลัยรังสิต	universitas rangsit	rangsit university
มหาวิทยาลัยราชภัฏบ้านสมเด็จเจ้าพระยา	universitas bansomdejchaopraya rajabhat	rajapak bahn somdej jao praya college
มหาวิทยาลัยราชภัฏสงขลา	universitas songkhla rajabhat	songkhla rajabhat university
มหาวิทยาลัยราชภัฏสวนสุนันทา	universitas suan sunandha rajabhat	suan sunandha rajabhat university
มหาวิทยาลัยราชภัฏอุตรดิตถ์	universitas uttaradit rajabhat	uttaradit rajabhat university
มหาวิทยาลัยราชภัฏเทพสตรี	universitas thepsatri rajabhat	thepsatri rajabhat university
มหาวิทยาลัยราชภัฏเลย	universitas loei rajabhat	loei rajabhat university
มหาวิทยาลัยวงษ์ชวลิตกุล	universitas wongchawalitkun	vongchavalitkul university
มหาวิทยาลัยศรีนครินทรวิโรฒ	universitas srinakharinwirot	srinakarinvirot university
มหาวิทยาลัยศรีปทุม	universitas sripatum	sripatum university
มหาวิทยาลัยศิลปากร	universitas silpakorn	silapakorn university
มหาวิทยาลัยสุโขทัยธรรมาธิราช	universitas terbuka sukhothai thammathirat	sukhothai thammathirat open university
มหาวิทยาลัยอีสาน	universitas timur laut	issan univbersity
มหาวิทยาลัยอุบลราชธานี	universitas ubon ratchathani	ubon ratchathani university
มหาวิทยาลัยอ๊อกซฟอร์ด	universitas oxford	university of oxford
มหาวิทยาลัยเกษตรศาสตร์	universitas kasetsart	kasetsart university
มหาวิทยาลัยเทคโนโลยีพระจอมเกล้าพระนครเหนือ	universitas teknologi king mongkut bangkok utara	king mongkut's university of technology.
มหาวิทยาลัยเทคโนโลยีราชมงคลกรุงเทพ	universitas teknologi rajamangala krungthep	rajamangala university of technology krungthep
มหาวิทยาลัยเทคโนโลยีราชมงคลตะวันออก	universitas teknologi rajamangala tawan-ok	the eastern university of teachnology
มหาวิทยาลัยเทคโนโลยีราชมงคลธัญบุรี	universitas teknologi rajamangala thanyaburi	rajamangala university of technology thanyaburi
มหาวิทยาลัยเทคโนโลยีราชมงคลสุวรรณภูมิ	universitas teknologi rajamangala suvarnabhumi	techonology university at rajamongkolsuwannapoom
มหาวิทยาลัยเทคโนโลยีราชมงคลอีสาน	universitas teknologi isan rajamangala	rajamangala university of technology isan
มหาวิทยาลัยเปิด	universitas terbuka	open university
มหาวิทยาลัยแม่โจ้	universitas maejo	mae joe university
มหาวิทยาลัยแห่งแรกของประเทศไทย	universitas pertama di thailand	first university of thailand
มองโกเลียใน	mongolia dalam	mongolia
มอร์ริส	morris	morris
มอส	lumut	mos
มอสส์	lumut	moss
มอหาดใหญ่	mor hat yai	had yai city in southern thailand
มะขาม	asam jawa	tamarind
มะม่วงหิมพานต์	kacang mete	mango (anacardium occidentale)
มะริด	myeik	myeik
มะเร็ง	kanker	cancer
มังกี้	monyet	monkey
มังคุด	manggis	mangosteen
มัจฉานุ	matcha	majjanu - the son of the giant in a thai legend.  majanu is half monkey and half fish.
มัชฌิมาปฏิปทา	jalan tengah	the middle way
มัทนะพาธา	muthana phatha	matthanaphatha
มัธยฐาน	median	mode (as in statistic)
มัธยมศึกษา	sekunder	junior high school
มัธยมศึกษาปีที่	nilai	secondary school year
มันติคอร์	manticore	manticore
มัลเจร่า	malera	wonderweiss margera - a cartoon character
มากกว่า	lebih dari	more than
มากที่สุด	yang paling	most abundant
มากิ	maki	magi osuki - the artist
มาครอส	macross	macross
มาจยาร์	mayar	magyar
มาจากภาษาละติน	dari bahasa latin	from latin root
มาซากิ	masaki	masaki
มาดริด	madrid	madrid
มาตรฐาน	standar	standard
มาตรา	bagian	article
มานี	mani	mani - a thai name
มายน์ส	tambang	mine
มาริสา	marisa	marissa
มาริเบล	maribel	maribel
มาร์ช	marsh	march
มาร์ติน	martin	martin
มาร์ตินีก	martinique	martinique
มาร์แชล	marshall	marshall
มาลัยพร	porno malai	malaiphon
มาลากุล	malakul	malakul
มาลี	mali	flower
มาสคาร่า	maskara	mascara
มาเก๊า	macau	macao
มาเฟีย	mafia	mafia
มาเรีย	maria	maria
มาเลเซีย	malaysia	malaysia
มาเลเซียตะวันตก	malaysia barat	west malaysia
มิจิรุ	michiru	mijiru
มิตร	ramah	mitr
มิตรชัย	mitchai	mitchai
มิตรเพชรา	ramah	mit pechara - two of famous actors in the old time
มิถุนายน	juni	june
มินต์	mint	mint
มิลจิ	milji	mulji
มิลตัน	milton	milton
มิลฟีโอเล่	milfi ole	millefiore
มิลลิเมตร	milimeter	millimeter
มิลินทจินดา	milinthinda	milinjinda - a surname of a singer
มิล่า	mila	mila
มิว	mew	mu
มิวฟิลโอเล่	bagal phil ole	millefiore
มิวสิกวีดีโอ	video musik	music video
มิสทีน	mistine	mistine
มิฮอว์ค	mihawk	mihawk - surname of a character in a japanese movie
มิเกล	miguel	miguel
มิเชล	michelle	michelle
มิเตอร์	meteran	meter
มิโร	miro	miro - name
มีขนาดใหญ่	besar	big
มีข้อความว่า	berlabel	inscription reads
มีความยาว	punya panjang	has length of
มีความหมายว่า	berarti itu	meaning
มีจำนวน	punya nomor	have the amount of
มีฉายาว่า	dengan julukan itu	famous for...
มีชื่อว่า	bernama	is called
มีชื่อเล่นว่า	dijuluki	nick name
มีด	pisau	knife
มีดาบฟันวิญญาณ	dengan pedang roh	have a sword to fight the ghost
มีทั้งสิ้น	semua	own, available
มีทิวเขาล้อมรอบทางเหนือ	dengan pegunungan di utara	surrounded by the mountains in the north
มีน	min	min - a nick name
มีนบุรี	min buri	minburi province
มีนวิทยา	minologi	ichthyology
มีนายกรัฐมนตรี	punya perdana menteri	have a prime minister
มีประวัติศาสตร์ยาวนาน	memiliki sejarah panjang	having a long history
มีพรมแดนทางทิศใต้จรดกับอ่าวไทย	berbatasan di selatan dengan teluk thailand	having boundaries adjacent to the gulf of thailand
มีภูเขาล้อมรอบอยู่	dikelilingi oleh pegunungan	surrounded by mountains
มีลักษณะดังนี้	memiliki karakteristik sebagai berikut	has following characteristics
มีลักษณะภูมิประเทศคล้ายชามหรืออ่าง	dengan fitur-fitur seperti mangkuk atau baskom	have topography like bowl or basin
มีลาภ	semoga beruntung	milap
มีล่า	dapatkan perburuan	mila
มีสูตรการคำนวณหาจำนวนฟัน	ada rumus untuk menghitung jumlah gigi.	dental formula
มีอยู่	ada	possess, present
มีอุณหภูมิเฉลี่ย	suhu rata-rata	average temperature
มีอุทยานแห่งชาติสำคัญหลายแห่ง	ada banyak taman nasional yang penting.	has many important national parks
มีเดีย	media	media
มีโคลซีน	dengan adegan cole	meclozine
มือ	tangan	hand
มู	halus	mu
มูลนิธิชัยพัฒนา	yayasan chaipattana	chaipattana foundation
มูลนิธิอานันทมหิดล	yayasan anandamahidol	the king's charities
มูลสาร	fundamental	munsan
มเชียงใหม่	chiang mai	chaing mai university
มโนราห์	manohra	thai dance art
ม้า	kuda itu	horse
ม้าม	limpa	spleen
ย	renang	a thai alphabet with the y sound
ยกเว้น	kecuali	except
ยศ	peringkat	rank
ยอด	bagian atas	super, great
ยอดนักสืบจิ๋วโคนัน	detektif conan	conan the detective
ยอดเขาสูงที่สุดของกัมพูชาคือ	puncak tertinggi kamboja adalah	highest mountain in cambodia
ยอพระกลิ่น	yor phra klin	yorpaglin - name of a story
ยัง	belum	young
ยาขับปัสสาวะ	diuretik	diuretic pills
ยาง	karet	rubber, tire
ยางธรรมชาติ	karet alam	natural rubber
ยางามิ	yagami	yangami
ยานอนหลับ	pil tidur	sleeping pills
ยานอวกาศ	kapal luar angkasa	rocket ship
ยาบ้า	amphetamine	ya ba
ยาปฏิชีวนะ	antibiotik	antibiotic
ยามาโตะ	yamato	yamato - a japanese name
ยามาโมโตะ	yamamoto	yamamoto
ยามเย็น	malam	sundown, evening time
ยิ่งยง	yingyong	yingyong - a first name
ยิ่งลักษณ์	yingluck	yingluck
ยิ้มสู้	senyum	smile fight
ยีน	gen	gene
ยืนยง	bertahan	(inthira) yeenyong - lead singer of budogun band
ยุคกลาง	abad pertengahan	middle age
ยุคก่อนประวัติศาสตร์	era prasejarah	prehistory
ยุคที่	era	age
ยุคปัจจุบัน	zaman modern	present age
ยุคศตวรรษที่	era abad	century
ยุคสามก๊ก	era tiga kerajaan	three kingdoms - the legend
ยุคอะซึกะ	era asuka	asuka period
ยุคอาณาจักรเหนือใต้	era kerajaan utara dan selatan	north-south dynasty
ยุคเรเนสซองส์	era renaissance	renaissance
ยุคเฮอัง	era heian	heian period of japan
ยุคโบราณ	zaman kuno	ancient history
ยุคโลหะ	zaman logam	metal age
ยุคใหม่	zaman baru	new age
ยุทธนาวี	pertempuran angkatan laut	naval battle
ยุวธิดา	putri muda	yuwatidah
ยุ้ย	berlebihan	yui
ยู	u	u
ยูกิโอ	yukio	yu-gi-oh
ยูฟ่า	uefa	uefa
ยูริ	yuri	yuri -  a japanese name
ยูโด	judo	judo
ยูโรเพียม	europium	europium
ยูไนเต็ด	bersatu	united
ย่านตาขาว	yan khao	yan ta khao
รณชัย	ronnachai	ronnachai
รณภพ	dunia	ronapop
รณฤทธิ์	pertempuran	ranariddh
รถด่วนสายทางช้างเผือก	bus ekspres bima sakti	galactic express
รถประจำทางสาย	jalur bus	bus number
รถยนต์อเนกประสงค์	mobil serba guna	automobile
รถลาก	becak	pulled rickshaw
รถโดยสารประจำทาง	bus	passenger bus
รถโดยสารประจำทางสาย	jalur bus	bus
รถไฟฟ้าชานเมืองสายสีแดงอ่อน	pinggiran kota lampu merah	rapid transit light red line
รถไฟฟ้ามหานคร	mrt	metropolitan rapid transit
รฟม	r.o.	public transit
รวดเร็ว	cepat	rapid
รวม	untuk memasukkan	total
รวมกับ	dikombinasikan dengan	add to
รวมทั้ง	termasuk	include
รวมทั้งประเทศที่ให้ความช่วยเหลืออื่นๆ	termasuk negara yang memberikan bantuan lain	the countries that provided helps
รวมทั้งสิ้น	total keseluruhan	result
รวมระยะทางทั้งสิ้น	total jarak	total distance
รศ	rekanan	ratanakosin era
รหัส	kodenya	code
รอก	hoist	roack
รองประธานรัฐสภาคนที่หนึ่ง	wakil presiden pertama parlemen	an assistant head of a thai governmental committee
รองประธานสภาคนที่สอง	wakil presiden kedua dewan	second vice chairman
รองเท้า	sepatu	shoes
รอญับ	tunggu	seventh month of the hijra calendar
รอบ	sekitar	surrounding
รอบคอบ	bijaksana	careful
รอบชิงชนะเลิศระดับประเทศ	final nasional	national final round
รอบที่	bulat	round
รอบเมือง	keliling kota	around town
ระดับกระโดดสูง	lompat tinggi	high jump  height
ระดับการกระโดดสูง	lompat tinggi	high jump
ระดับปริญญาเอก	tingkat phd	doctorate degree level
ระดับปริญญาโท	gelar magister	master's degree
ระดับมัธยมศึกษา	sekunder	middle school level
ระดับอาชีวศึกษา	tingkat kejuruan	vocational education
ระนอง	ranong	ranong
ระนาด	gambang	ranad - a thai musical instrument
ระนาดทุ้ม	gambang	a type of thai musical instrument
ระนาดเอก	alto	ranad eg -  a thai musical instrument
ระบบ	sistem	system
ระบบกษัตริย์ของกัมพูชา	monarki kamboja	cambodian monarchy
ระบบรัฐสภา	sistem parlementer	rajya sabha system of governing
ระบบสืบพันธุ์	sistem reproduksi	reproductive system
ระบบสุริยะ	tata surya	solar system
ระบบโครงกระดูก	sistem kerangka	skeletal system
ระบบใช้อำนาจเด็ดขาด	sistem daya absolut	despotism
ระยะ	term	phase
ระยะเวลา	durasi	period
ระยะเวลาการดำรงตำแหน่ง	ketentuan layanan	the term in the office
ระวิ	antara	rawi
ระหว่างปี	sepanjang tahun	between the year
ระหว่างสงครามโลกครั้งที่	selama perang dunia	during wold war
ระเบียง	balkon	bhirasri
ระเบียบ	peraturan	regulation
ระโนด	mati	ranode (name of district in thailand)
รักษาศีล	perhatikan sila	keep the precepts
รักษาสิ่งแวดล้อม	selamatkan lingkungan	protect the environment
รักแห่งสยาม	cinta siam	love thailand
รังสิตคลอง	rangsit khlong	rangsit canal
รังสี	radiasi	radiation
รังสีเอกซ์	sinar-x	xray
รังสีแกมมา	sinar gamma	gamma ray
รัชกาลที่	memerintah	rama
รัชกาลสมเด็จพระจุลจอมเกล้าเจ้าอยู่หัว	pemerintahan raja chulalongkorn	king chula chomklao's reign
รัชดาภิเษก	ratchadaphisek	rajada pisek - a location in thailand
รัฐธรรมนูญแห่งราชอาณาจักรไทย	konstitusi kerajaan thailand	constitution of the kingdom of thailand
รัฐบาลไทย	pemerintah thailand	thai government
รัฐบุรุษ	negarawan	statesman
รัฐประหาร	kudeta	coup d'état
รัฐประหารในประเทศไทย	kudeta di thailand	thailand's coup d'état
รัฐมนตรีว่าการกระทรวงคมนาคม	menteri perhubungan	transportation secretary of thailand
รัฐวิสาหกิจ	perusahaan negara	financial situation of the country
รัฐวิสาหกิจไทย	perusahaan negara thailand	thai state enterprise
รัฐสภา	parlemen	parliament
รัฐสีมาคุณากรปิยชาติ	ratthasima kunakornpiyachat	ratthasimakhunakonpiyachat
รัฐอิลลินอยส์	illinois	state of illinois
รัฐเทกซัส	texas	state of texas
รัตนบุรี	rattanaburi	ratanaburi district - a location in thailand
รัตนาธิเบศร์	rattanathibet	ratana thibet
รับบทโดย	dimainkan oleh	played by
รับพระราชทาน	terima	receive
รัศมี	radius	radius
รัสเซล	russell	russell
รากแก่น	akar inti	rakkan
รางวัลนักร้องยอดเยี่ยม	penghargaan penyanyi terbaik	best singer award
รางวัลนักร้องไทยสากลชายยอดนิยม	penghargaan penyanyi internasional pria thailand populer	best thai male singer award
รางวัลนาฏราช	penghargaan royal dancer	naktarath prize
รางวัลโนเบล	hadiah nobel	nobel prize
รางวัลไนน์เอ็นเตอร์เทน	penghargaan nine entertainment	nine entertain awards
ราชตระกูล	keluarga kerajaan	royal family
ราชนาวี	angkatan laut	royal navy
ราชมังคลากีฬาสถาน	stadion rajamangala	rajamangala national stadium
ราชวงศ์จิ้นตะวันออก	dinasti jin timur	east jin dynasty
ราชวงศ์ชิง	dinasti qing	ching dynasty
ราชวงศ์ถัง	dinasti tang	tang dynasty
ราชวงศ์ทิพย์จักราธิวงศ์	keluarga kerajaan, chakrathiwong	thipjaklatiwong dynasty
ราชวงศ์บ้านพลูหลวง	rumah kerajaan plu luang	ban phlu luang dynasty
ราชวงศ์พระร่วง	phra ruang dynasty	pra roung dynasty
ราชวงศ์หยวน	dinasti yuan	yuan dynasty
ราชวงศ์อู่ทอง	dinasti u-thong	utong empire in ancient thailand
ราชสกุล	token	royal family members
ราชสีมา	ratchasima	ratchasima
ราชินิกุล	keluarga kerajaan	relatives of the queen
ราบเป็นหน้ากลอง	bersikaplah polos	flattened like a drum (meaning to be defeated)
รามอินทรา	ramintra	ram inthra
รายการ	daftar	show
รายการวันสำคัญทางพุทธศาสนา	daftar tanggal buddhis yang penting	important days in buddhism
รายชื่อ	daftar	list of the names
รายชื่อคำในภาษาไทยที่มักเขียนผิด	daftar kata-kata thailand yang sering ditulis secara tidak benar	common misspelled thai words
รายชื่อภาพยนตร์ไทย	daftar film thailand	a list of thai movies
รายชื่อหุ่นยนต์ใน	daftar robot di	name of robots
รายชื่ออธิการบดี	daftar kanselir	list of presidents
รายชื่อเพลง	daftar lagu	songs list
รายนามรองอธิการประจำวิทยาเขต	daftar nama wakil rektor di kampus	llist of deputy directors of the college
รายนามอธิการบดี	daftar presiden	chancellor list
รายพระนามพระมหากษัตริย์ไทย	daftar raja thailand	list of thai monarchs
รายะนาค	raya nak	rayanak
รายได้อื่น	penghasilan lainnya	other wages, incomes
ราวพุทธศตวรรษที่	sekitar abad ini	about buddhist era
ราศีธนู	sagitarius	sagittarius
รำพันพิลาป	berteriak	poem called rum pan pi lab
ริน	tuang	rin
ริมแม่น้ำเจ้าพระยา	sungai riverside chao phraya	near chao praya river
ริวซากิ	ryuzaki	riusaki - from japanese story
ริเอะ	rie	rie tanaga - a japanese singer
รีสอร์ท	sebuah resor	resort
รีเนียม	renium	rhenium
รุจิพรรณ	rujipan	pan - a name
รุ่ง	fajar	dawn
รุ่งสว่าง	fajar	rungsawang
รุ่งเพชร	rung petch	roongpetch - a female's name
รูดอล์ฟ	rudolph	rudolf
รูทีเนียม	rutenium	ruthenium
รูปภาพ	sebuah gambar	picture
รูปร่าง	bentuknya	body
รูปวรรณยุกต์	bentuk nada	tones
รูปสามเหลี่ยมมุมป้าน	segitiga segitiga	obtuse
รูปสี่เหลี่ยมด้านขนาน	paralelogram	a paralellogram
รูสเวลต์	roosevelt	roosevelt
ร็อดฟอร์ม	bentuk batang	rock form
ร่วมแสดงกับ	lakukan dengan	costarring
ร้องคู่กับ	bernyanyi bersama	sing a duet with
ร้องร่วมกับ	bernyanyi bersama	featuring
ร้องโดย	dinyanyikan oleh	sung by
ร้อยตรี	letnan dua	second lieutenant
ร้านอาหาร	sebuah restoran	restaurants
ฤดูกาล	musim	season
ฤดูฝน	musim hujan	rainy season
ฤดูร้อน	musim panas	summer
ล	itu	a thai alphabet with an l sound
ลงวันที่	tanggal	on this date
ลพบุรี	lopburi	lopburi
ลอนดอน	london	london
ลอยกระทง	loi krathong	loy kratong festival
ลอร์ด	tuan	lord
ละคร	drama	play
ละครชาตรี	drama obrolan	lakorn-chatri
ละครวิทยุ	drama radio	soap opera broadcasted on the radio
ละครสั้น	drama pendek	short drama
ละครเพลง	musikal	stage musical theatre
ละครโทรทัศน์	opera sabun	television drama
ละติจูด	lintang	latitude
ลักษณะ	karakteristiknya	characteristic
ลักษณะทั่วไป	karakteristik umum	common characteristic
ลักษณะทางกายภาพ	karakteristik fisik	physical characteristics
ลักษณะภูมิอากาศ	iklim	the type of climate
ลักษณะสำคัญ	karakteristik penting	main characteristics
ลักเซมเบิร์ก	luksemburg	luxembourg
ลัคนา	ascendant	ascendant
ลา	selamat tinggal	goodbye
ลานจาตุรงคสันนิบาต	segi empat	lan jaturonsunnibat - an ancient place in india
ลามิวูดีน	lamiwooden	lamivudine
ลายน้ำ	tanda air	watetmark
ลาว	laos	lao
ลาออก	mundur	resign
ลำดับ	urutan	order, sequence
ลำดับพระปฐมวงศ์ในพระบรมราชวงศ์จักรี	orde kejadian dalam dinasti chakri	order of the kings
ลำดับพระมหากษัตริย์ไทย	perintah raja thailand	the order of the kings of thailand
ลำตัว	bagasi	body
ลำลูกกา	lam luk ka	lumlookka - a location in thailand
ลำลูกกาคลอง	kanal lam luk ka	lum luk kak klong
ลำไส้เล็ก	usus kecil	small intestine
ลิง	monyet	monkey
ลิซท์	liszt	(franz) liszt
ลิปปี	tahun bibir	rippi - a surname
ลิพิด	lipid	lipid
ลิฟวิ่งมอลล์	mall hidup	living mall
ลิเก	drama musikal rakyat	like
ลิเทียม	lithium	lithium
ลีกคัพ	piala liga	league cup
ลีซอ	lisu	lisu
ลีเมอร์	lemur	lemur
ลี้	li	lee, a district in lumpoon province.
ลี้สุวรรณ	li suwan	lisuwan
ลุงบุญมีระลึกชาติ	paman boonmee mengingat bangsa	uncle boonmee who can recall his past lives
ลูกปัด	manik-manik	beads
ลูกสาว	anak perempuan	daughter
ลูกอม	permen	candies
ลูกอัณฑะ	testis	testis
ลูซิเฟอร์	lucifer	lucifer
ลูน่า	luna	luna
ล่าทา	berburu	lata
ล่ำซำ	benjolan	lumsum
ล้อม	besiege	lom
ล้อแม็กซ์อัลลอยขนาด	velg, ukuran	alloy wheel
วง	band	band
วงจรไฟฟ้า	sirkuit listrik	electrical circuit
วงดนตรี	band	band
วงศ์กำแหง	keluarga	wongkumhang - surname of a famous singer
วงศ์ถั่ว	keluarga kacang	fabaceae
วงศ์ปลากดทะเล	keluarga ikan	ariidae
วงศ์ปลากะรัง	kerapu	serranidae family
วงศ์ปลายอดม่วง	wong pla yot muang	tonguefish
วงศ์ปลาหลังเขียว	ikan hijau	clupeidae - a type of fish
วงศ์ปลาเนื้ออ่อน	cichlid	siluridae
วงศ์ปลาเสือตอ	keluarga ikan harimau	datnioididae
วงศ์พัวพันธ์	wongpua phan	wongpourpan
วงศ์วิริยะ	wiriya	vongsiriya - a surname
วงศ์เทวัญ	keluarga	wongthewan
วงศ์แคหางค่าง	wong khae hang kong	plants in kae-hang-kang family
วงษ์คำเหลา	wong kham lao	wongkamlao
วงเงิน	batasi	budget
วงเวียน	bundaran	circle
วงแหวน	dering	ring form, circle form
วชิรบรรจง	wachirabunjong	wachibanjong
วทบ	dd	bachelor of science
วนอุทยานถ้ำจัน	taman hutan tham chan	tham chan forest park
วนิดา	wanida	wanida - the name of a drama
วร	terburuk	won
วรรณกรรม	sastra	literature
วรรณสุทธิ์	wansut	wannasut - surname of an actress
วรรธนพิสิฐกุล	watthon phisitkun	wanthanaphisitkun
วรัทยา	warutya	varattaya (first name)
วว	dd	office of ____________
วอก	monyet	wok
วองโกเล่แฟมิลี	keluarga vongola	vongola family
วอชิงตัน	washington	washington
วอลท์	walt	walt
วอล์ค	berjalan	walk
วะสี	wasi	wasee
วัง	istana	palace
วังจันทร์	wang chan	wang-chan
วังสระปทุม	istana sra pathum	srapathum palace
วังสะพุง	wang saphung	wang saphung
วังหลัง	istana	wang lang
วังหิน	istana batu	rock castle
วัชรพล	watcharapol	watcharapol supermarket
วัฒนชัย	watthanachai	wattanachai - a surname
วัฒนธรรม	budaya	culture
วัฒนวิทูกูร	wattanawitkun	watthanawithukun
วัฒนา	wattana	wattana
วัดกลาง	candi sedang	wat klang
วัดป่าเลไลยก์วรวิหาร	wat pa lelai worawihan	wat palaylay
วัดพระธาตุดอยสุเทพราชวรวิหาร	wat phra that doi suthep, ratchaworawihan	wat pratatdoisuthep rachavoravihan - the temple erected on top of doi suthep in northern thailand
วัดพระฝางสวางคบุรีมุนีนาถ	wat phra fang sangkhaburi muninat	prhafangsawangkaburimuninat temple
วัดพระมหาธาตุวรมหาวิหาร	wat phra mahathat woramahaviharn	wat phramahathat woramahawihan
วัดพระยืนพุทธบาทยุคล	wat phra yuen phutthayakhon	the standing buddha temple of puttabatyukol
วัดพระลอย	kuil phra loi	wat phra loi
วัดพระศรีรัตนมหาธาตุ	wat phra si rattana mahathat	wat phra si rattana mahathat
วัดพระเชตุพนวิมลมังคลารามราชวรมหาวิหาร	kuil phra chetuphon vimolmangklararam	wat pra chetpnvimolmungklaramrajavoramahavihan
วัดระฆังโฆสิตาราม	kuil rakhangkosaram	wat rakang kositaram (name of temple)
วัดสองพี่น้อง	kuil song phi nong	two siblings temple
วัดสุทัศนเทพวรารามราชวรมหาวิหาร	candi suthasan thep wararam	wat sutatthepvararamrajavorimahavihan - a temple in thailand
วัดหนองเพียร	kuil nong phian	wat nong pien - a temple in thailand
วัดหน้าพระธาตุ	kuil na phra that	wat na pra tat - a buddhist temple
วัดเจดีย์หลวง	kuil chedi luang	wat pagoda
วัดโพธิ์	wat pho	wat po - a thai temple
วัตต์	watt	watt
วัตสัน	watson	watson
วัน	hari itu	day
วันชัย	wanchai	wanchai - a male's name
วันที่ขึ้นเครื่องหมาย	tanggal masuk	excluding dividend day
วันที่ออกอากาศชื่อตอนแขกรับเชิญ	tanggal tayang, nama episode, tamu	when the invitation comes out
วันที่เข้าฉาย	tanggal rilis	release date
วันนี้ที่รอคอย	menunggu hari ini	the day that one has been waiting for
วันพฤหัสบดี	kamis	thursday
วันพุธ	rabu	wednesday
วันมหาสงกรานต์	hari maha songkran	songkran day
วันละ	sehari	per day
วันศุกร์	jumat	friday
วันสงกรานต์	hari songkran	songkran day
วันสำคัญ	hari penting	important day
วันสำคัญทางพุทธศาสนา	hari buddhis penting	buddhist holidays
วันหยุดราชการ	hari libur nasional	national holiday
วันอังคาร	selasa	tuesday
วันอาทิตย์	minggu	sunday
วันอาสาฬหบูชา	asanha bucha day	asalha puja
วันเกิด	ulang tahun	birthday
วันเสาร์	sabtu	saturday
วันแรม	hari	the phase of the moon
วัย	berumur	age
วัลลิโภดม	walliphodom	wanliphodom
วัสดุฟิสไซล์	bahan fisil	fissile material
วานูอาตู	vanuatu	vanuatu, australia
วารินชำราบ	warinchamrap	warinchamrap
วาลคิรี	valkyrie	valkyrie - angel that helped in valhalla war
วาลีน	valine	valine - a type of protein
วาเรีย	varia	varia
วาเลนไทน์	valentine	valentine
วาไรตี้	berbagai	variety
วิกตอร์	victor	victor
วิคตอเรีย	victoria	victoria
วิจัย	penelitian	investigate, study
วิจิตรศิลป์	seni rupa	fine art
วิชาการ	akademik	academic
วิชาการคอม	komputer akademik	vcharkarn.com
วิชิต	wichit	wichit - a male's name
วิญญาณ	roh	soul
วิฑูรย์	kucing dengan	witoon
วิดีโอเกม	video game	video game
วิตามินอี	vitamin e	vitamin e
วิทยาการคอมพิวเตอร์	ilmu komputer	computer courses
วิทยาการระบาด	epidemiologi	epidemiology
วิทยาลัยการจัดการเพื่อการพัฒนา	sekolah tinggi manajemen untuk pembangunan	management for development college
วิทยาลัยการบริหารรัฐกิจ	sekolah tinggi administrasi publik	management college
วิทยาลัยครูสวนสุนันทา	suan sunandha teacher college	soun sunanta teachers college
วิทยาลัยดุริยางคศิลป์	sekolah tinggi musik	college of music
วิทยาลัยนวัตกรรมและการจัดการ	sekolah tinggi inovasi dan manajemen	the college specialized in arts
วิทยาลัยพยาบาลกองทัพเรือ	akademi keperawatan angkatan laut	royal thai navy college of nursing
วิทยาลัยพยาบาลบรมราชชนนี	sekolah tinggi keperawatan boromarajonani	nursing university of barom raj chonnani
วิทยาลัยพาณิชยศาสตร์	sekolah tinggi perdagangan	panitsat university
วิทยาลัยวิชาการศึกษา	sekolah tinggi pendidikan	college of education
วิทยาลัยเทคนิคธนบุรี	perguruan tinggi teknik thonburi	king mongkut's university of technology thonburi
วิทยาลัยแพทยศาสตร์พระมงกุฎเกล้า	fakultas kedokteran phramongkutklao	phramongkutklao college of medicine
วิทยาศาสตรมหาบัณฑิต	magister sains	master of science
วิทยาศาสตร์สุขภาพ	ilmu kesehatan	health science
วิทยาศาสตร์และเทคโนโลยี	sains dan teknologi	science and technology
วิทยาเขต	kampus	campus
วิทยาเขตกาญจนบุรี	kampus kanchanaburi	kanchanaburi college
วิทยาเขตนครศรีธรรมราช	kampus nakhon si thammarat	nakhon si thammarat campus
วิทยาเขตพิษณุโลก	kampus phitsanulok	pissanulok college
วิทยาเขตสารสนเทศเพชรบุรี	kampus teknologi informasi phetchaburi	information technology college of petchaburi
วิทยาเขตสุพรรณบุรี	kampus suphanburi	suphanburi campus
วิทยาเขตสุรินทร์	kampus surin	surin university
วิทยาเขตหนองคาย	kampus nong khai	nong kai university
วิทยาเขตเฉลิมพระเกียรติ	kampus chaloem phrakiat	vittaya kat chalerm pra kiet - a location at kasetsat university in thailand
วิทยุ	sebuah radio	radio
วิธีการหาความสัมพันธ์	cara menemukan hubungan	formula for the correlation coefficient
วินชี	vinci	vinci
วินัย	disiplin	manners
วินเนอร์	pemenang	winner
วิบูลย์	selamat tinggal	wibul - a male's name
วิมเบิลดัน	wimbledon	wimbledon
วิลลี่	willy	willy
วิลเลจ	desa	village
วิลเลียม	william	williams
วิลเลี่ยม	william	william
วิวัฒนาการ	evolusi	evolution
วิวัฒน์	berkembang	produce, making up, invent
วิวัฒน์เกียรติ	wiwat kiat	wiwatkiat
วิศว	rekayasa	engineering
วิศวกร	seorang insinyur	engineer
วิศวกรรมวัสดุ	rekayasa material	material engineering
วิศวกรรมสิ่งแวดล้อม	teknik lingkungan	environmental engineering
วิศวกรรมเครื่องกล	teknik mesin	engineering
วิศวกรรมไฟฟ้า	rekayasa kelistrikan	electrical engineering
วิสา	wisisa	wisa
วิสูตร	diagnostik	wisut
วิหาร	kuil	vihara
วิเศษ	luar biasa	wiset
วิเศษแก้ว	gelas ajaib	visetkeaw - surname of a singer
วิโนทัย	vinothai	winothai
วีดีโอ	video	video
วีดีโอเกม	video game	video game
วีรบุรุษ	pahlawan	hero
วีระ	veera	veera
วีระยุทธ	wirayut	werayut - a male's name
วีออส	vios	vios
วุฒิสภา	senat	senate
วุฒิเมธี	wuttimethi	wuttimethi - a surname
ว้าวุ่น	mengalihkan perhatian	wawun
ศ	jumat	a thai alphabet
ศร	panah	arrow
ศรชัย	sornchai	sornchai - a male's name
ศรายุทธ	sarayuth	sarayut - a male's name
ศรีนครินทร์	srinakarin	srinakarin
ศรีนวล	srinual	sinuan
ศรีบุญเรือง	sri bunrueang	si bun rueang
ศรีประจวบ	si prachuap	siprachuap
ศรีปาน	sri pan	sri pan - a surname
ศรีมะฆะ	sri makha	sirimaka - a thai name
ศรียาภัย	sriyapai	siyaphai
ศรีสวัสดิ์	srisawat	srisawat -  a surname
ศรีสำโรง	si samrong	si samrong
ศรีเมือง	sri mueang	srimuang
ศรีไพร	sri phrai	sri prai - a name
ศรเพชร	panah berlian	sonpet
ศศิธร	sasithorn	sasitorn - a females name
ศักดิ์ศรี	gengsi	dignity
ศักย์ไฟฟ้า	potensi listrik	electric potential
ศัพท์	kosakata	vocabulary
ศาลชั้นต้น	pengadilan tingkat pertama	curcuit court
ศาลหลักเมือง	kuil pilar kota	the old court house
ศาลเจ้าพ่อหลักเมือง	kuil pilar kota	the city's god
ศาสตราจารย์	profesor	professor
ศาสนา	agama	religion
ศาสนาพราหมณ์ฮินดู	agama hindu	hindu religion
ศาสนาฮินดู	agama hindu	hinduism
ศาสนาโซโรอัสเตอร์	zoroastrianisme	zoroastrianism
ศิริวรรณ	siriwan	siriwan - a female's name
ศิลปอาชา	seni archa	silpa-archa
ศิลปะ	seni	arts
ศิลปะการแสดง	seni pertunjukan	performing arts
ศิลปะลพบุรี	seni lopburi	lopburi art
ศิลปะศรีวิชัย	seni srivijaya	arts from sri vi chai province
ศิลปะเขมร	seni khmer	cambodian arts
ศิลปะเครื่องปั้นดินเผา	seni tembikar	pottery art
ศิลปะเชียงแสน	chiang saen art	chaingsan art
ศิลปินแห่งชาติ	artis nasional	national artist
ศิลป์	seni	silpa
ศิษย์เก่าคณะมนุษยศาสตร์	alumni fakultas ilmu budaya	former humanity student
ศิษย์เก่าคณะรัฐศาสตร์	alumni ilmu politik	faculty of political science alumni
ศิษย์เก่าคณะเศรษฐศาสตร์	alumni fakultas ekonomi	economics alumni
ศีรษะ	kepala	head
ศึกนันทบุเรง	pertempuran nanthabureng	suknuntabureng -  a war in thailand
ศึกษาศาสตร์	pendidikan	field of education
ศุกลวัฒน์	sukonwat	sukolawat (a person's name)
ศุภกิจ	supakit	supphakit
ศุภณัฐ	suphanat	supanat (first name)
ศูนย์	pusat	center
ศูนย์การค้า	pusat perbelanjaan	shopping center
ศูนย์การบินทหารบก	pusat penerbangan angkatan darat	marine forces
ศูนย์การศึกษาแม่ฮ่องสอน	pusat pendidikan mae hong son	maehongsorn learning center
ศูนย์คอมพิวเตอร์	pusat komputer	computer center
ศูนย์ค้าส่ง	pusat grosir	wholesale center
ศูนย์บริการวิชาการ	pusat layanan akademik	academic service center
ศูนย์ภาษา	pusat bahasa	language center
ศูนย์รังสิต	pusat rangsit	rangsit university center
ศูนย์ลำปาง	pusat lampang	lampang center
ศูนย์แพทยศาสตรศึกษาชั้นคลินิก	pusat pendidikan klinis	medical education center
สก	sekrup	abbreviation of two letters
สกว	trf	trf
สกอ	skotlandia	office of higher education commission
สกอตแลนด์	skotlandia	scotland
สกาย	langit	sky
สกุล	keluarga	sakun
สกุลหยาดน้ำค้าง	sundew	d. etrythrorhiza - a type of plant
สกุลเพชรหึง	petcheng	grammatophyllum
สควอโล่	squalo	squalo
สงคราม	perang	war
สงครามครูเสด	perang salib	crusades war
สงครามมหาเอเชียบูรพา	perang asia timur besar	world war two
สงครามอวกาศ	perang antariksa	space war
สงครามเกาหลี	perang korea	korean war
สงครามเย็น	perang dingin	cold war
สง่าพล	anggun	sangapol - a thai surname
สด	segar	fresh
สตรอเบอรี่	strawberry	strawberry
สตรีวิทยา	radiologi	satriwithaya
สติปัญญา	kecerdasan	intelligence
สตึก	satuek	satuek (name of district)
สตูดิโอ	studio	studio
สถานที่ท่องเที่ยวทางธรรมชาติ	objek wisata alam	natural attraction
สถานะ	status	status
สถานีคาราวาน	stasiun kafilah	caravan station
สถานีวิทยุโทรทัศน์ไทยทีวีสีช่อง	stasiun televisi thailand dengan saluran tv berwarna	thai television station number _____
สถานีโทรทัศน์ไทยพีบีเอส	stasiun televisi pbs thailand	thai public broadcasting service
สถาบัน	institusi	office, department
สถาบันการศึกษา	institusi pendidikan	educational institution
สถาบันบัณฑิตพัฒนบริหารศาสตร์	institut administrasi pembangunan nasional	satabunbunthitpakanabarihansart - a university in thailand, as known as nida
สถาบันพระบรมราชชนก	institut kerajaan	red cross department
สถาบันวิจัยจุฬาภรณ์	lembaga penelitian chulabhorn	julapon academy
สถาบันวิจัยและพัฒนา	lembaga penelitian dan pengembangan	reseach and development institution
สถาบันศูนย์และหน่วยงานในมหาวิทยาลัย	lembaga, pusat, dan departemen di universitas	current faculties/college/school/institutes
สถาบันสมทบ	lembaga asosiasi	affiliated institute
สถาบันอาชีวศึกษา	lembaga kejuruan	ahchevasuksa academy
สถาบันอุดมศึกษา	institusi pendidikan tinggi	higher education institute
สถาบันเทคโนโลยีนานาชาติสิรินธร	institut teknologi internasional sirindhorn	sirindhorn international institute of technology
สถาบันเทคโนโลยีพระจอมเกล้า	institut teknologi king mongkut	king mongkut's institute of technology
สถาบันเทคโนโลยีพระจอมเกล้าเจ้าคุณทหารลาดกระบัง	institut teknologi raja mongkut ladkrabang	king mongkut's institute of technology ladkrabang
สถาบันเทคโนโลยีราชมงคล	institut teknologi rajamangala	rajamangala university of technology
สถาบันโภชนาการ	institut gizi	institute of nutrition
สถาปนิก	arsitek	architect
สถาปัตยกรรมไทย	arsitektur thailand	architecture of thailand
สถิติศาสตร์	statistik	statistic
สธ	sth	two letters from thai alphabets
สนธยา	senja	twilight
สนธิ	persimpangan	sonti - a male's name
สนธิไชย	sonthichai	sontichai
สนามกีฬากลาง	stadion pusat	main athletic field
สนามชัยเขต	sanam chai khet	sanamchaikate - a location in thailand
สนามฟุตบอล	lapangan sepak bola	football field
สนามแม่เหล็ก	medan magnet	magnetic field
สนามไฟฟ้า	medan listrik	electric field
สนิทวงศ์	sanit wong	there are families.
สนิม	karat	rust
สนเกรวิลเลีย	anggur pinus	grevilea - family of 250 types of plants
สปริงฟิลด์	springfield	springfield
สปรินเตอร์	pelari cepat	sprinter
สปาร์ค	spark	spark
สพ	spec	oc
สภานิติบัญญัติแห่งชาติ	majelis legislatif nasional	national diet
สภาผู้แทนนิสิต	dewan perwakilan mahasiswa	college student representatives
สภาพอากาศ	cuaca	weather conditions
สมจิตต์	somchit	somjit - a female's name
สมจิตร	somchit	somjit
สมชัย	somchai	somchai
สมชาย	somchai	somchai - a male's name
สมภพ	kelahiran	sompob
สมศรี	somsri	somsi
สมศักดิ์	somsak	somsak
สมัคร	terapkan	samak
สมัย	era	era
สมัยกรุงธนบุรี	periode thonburi	thonburi era
สมัยก่อนประวัติศาสตร์	zaman prasejarah	prehistory
สมัยที่	kapan	term
สมัยรัชกาลที่	memerintah	in the reign of
สมัยสุโขทัย	periode sukhothai	sukothai era
สมัยอาณานิคมฝรั่งเศส	periode kolonial perancis	modern france
สมาคมประชาชาติแห่งเอเชียตะวันออกเฉียงใต้	asosiasi negara-negara asia tenggara	association of south east asian nations (asean)
สมาชิกรับเชิญตอนพิเศษ	mengundang anggota ke episode khusus	special guests
สมาชิกฤดูกาลที่	anggota musim	member of the parliament
สมุทวณิช	samutavanich	samudavanija
สมเด็จ	yang mulia	your highness
สมเด็จพระนางเจ้ารำไพพรรณี	ratu rambhai barni	queen rambhai barni
สมเด็จพระนางเจ้าสิริกิติ์	ratu sirikit	queen sirikit
สมเด็จพระนางเจ้าฯ	yang mulia	the queen of thailand
สมเด็จพระบรมราชาที่	sang raja	king
สมเด็จพระบรมโอรสาธิราช	putra mahkota	his highness, royal crowned prince
สมเด็จพระบรมโอรสาธิราชฯ	putra mahkota	the crown prince of thailand
สมเด็จพระมหิตลาธิเบศร	somdet phra mahidol latibes	somdet phra mahitra thibet
สมเด็จพระรามาธิบดีที่	raja ramathibodi	som dej pra rama tippadee #_____ , number of the king
สมเด็จพระศรีนครินทราบรมราชชนนี	hrh princess maha chakri sirindhorn	queen sirikit
สมเด็จพระอนุชาธิราช	somdej anuchatthirat	som dej pra ah nu cha thi raj - a famous royalty in thailand a long time ago
สมเด็จพระเจ้ากรุงธนบุรี	krung thon buri	the king of the thonburi kingdom
สมเด็จพระเจ้าภคินีเธอ	yang mulia	the king's sister, som dej pra jao pakini ther
สมเด็จพระเจ้าลูกเธอ	yang mulia	the king's daughter, the princess
สยามดารา	siam dara	siam stars
สยามบรมราชกุมารี	siam	the current king's eldest daughter, the eldest princess
สยามพารากอน	siam paragon	siam paragon
สร	buat	abbreviation for the royalties' accessories
สรรพสินค้า	toko serba ada	department store
สราวุธ	sarawut	sarawut
สร้าง	membangun	build
สลักใจ	terkesan	salakchai
สวนดุสิตโพล	polling suan dusit	suan dusit poll
สวนผึ้ง	suan phueng	bee garden
สวนสมเด็จพระศรีนครินทร์	taman somdet phra srinagarindra	pra sri nakarin - a king of thailand
สวรรคต	meninggal dunia	die
สวรรคตหรือ	meninggal dunia	die or ___________
สวรรคโลก	sawankhalok	heaven on earth
สวัสดิ์	sawat	sawat - a male's name
สวัสดีปีใหม่	selamat tahun baru	happy new year
สวิตเซอร์แลนด์	swiss	switzerland
สวี	suites	sawi
สส	rahasia	representatives
สหพันธ์สาธารณรัฐเยอรมนี	republik federal jerman	germany
สหรัฐอาหรับเอมิเรตส์	uni emirat arab	arab emirate
สหรัฐอเมริกา	amerika serikat	america, usa
สหราชอาณาจักร	kerajaan inggris	united kingdom
สหวงษ์	sahawong	sawong - a male's name
สองสาย	dua kabel	double-stranded
สอยดาว	pukulan	soidao
สะดวก	nyaman	convenient
สะตอ	sato	sator
สะล้อ	rem	salao
สะเดา	neem	neem, a type of plant
สัจธรรม	kebenaran	normal truth; common knowledge
สัญญา	janji itu	sanya
สัญลักษณ์ประจำมหาวิทยาลัย	logo universitas	logo of the university
สัดส่วน	proporsi	ratio
สัตว์	binatang itu	animal
สัตว์มีกระดูกสันหลัง	vertebrata	vertebrate animals
สัตว์มีแกนสันหลัง	tulang belakang	chordata
สัตว์เลี้ยงลูกด้วยน้ำนม	mamalia	mammal
สัตว์เลื้อยคลาน	reptil	reptile
สัตว์เลื้อยคลานในอันดับนี้	reptil di peringkat ini	reptile in this order
สัทศาสตร์	fonetik	phonetics
สันติ	damai	peace
สันติสุข	damai	santi suk
สัมผัสนอก	paparkan	outside touch
สัมพันธ์	hubungan	relationship
สัมมา	benar	summa - the buddhist prayer often starts with this
สาขา	cabang	office location
สาขานครราชสีมา	cabang nakhon ratchasima	nakhon ratchasima branch
สาขานครสวรรค์	cabang nakhon sawan	nakhon sawan branch
สาขานิเทศศาสตร์	seni komunikasi	faculty of communication arts
สาขาประจวบคีรีขันธ์	cabang prachuap khiri khan	prachuap khiri khan branch
สาขาปราจีนบุรี	cabang prachinburi	pracheenburi branch
สาขาพิษณุโลก	cabang phitsanulok	pisanulok location
สาขามนุษยศาสตร์	humaniora	humanities
สาขาย่อย	cabang pembantu	offices
สาขาลำปาง	cabang lampang	lumpang location
สาขาวิชานิติศาสตร์	fakultas hukum	law department
สาขาวิชาบริหารธุรกิจ	program administrasi bisnis	business administration program
สาขาวิชารัฐประศาสนศาสตร์	departemen administrasi publik	local government
สาขาวิชาวิทยาการคอมพิวเตอร์	program ilmu komputer	school of computer science
สาขาวิชาวิศวกรรมคอมพิวเตอร์	program teknik komputer	computer engineering
สาขาวิชาวิศวกรรมอาหาร	rekayasa pangan	food engineering
สาขาวิชาวิศวกรรมอิเล็กทรอนิกส์	program rekayasa elektronik	major electronic engineering
สาขาวิชาศิลปอุตสาหกรรม	departemen seni	arts department
สาขาวิชาเคมี	departemen kimia	department of chemistry
สาขาวิชาเทคโนโลยีชีวภาพ	program bioteknologi	department of biotechnology
สาขาวิชาเศรษฐศาสตร์	ekonomi	finance department
สาขาศิลปะสถาปัตยกรรม	arsitektur seni	art and architecture branch
สาขาสมุย	cabang samui	smui branch
สาขาหัวหิน	cabang hua hin	hoa hin branch
สาครสินธุ์	dosa sakorn	sakornsin - a surname
สาทร	sathorn	sathon
สาธารณรัฐประชาชนจีน	republik rakyat tiongkok	people's republic of china
สาธารณรัฐออสเตรีย	republik austria	republic of austria
สาธารณรัฐอินโดนีเซีย	republik indonesia	republic of indonesia
สาธารณรัฐเช็ก	republik ceko	czech republic
สาธารณรัฐโดมินิกัน	republik dominika	republic dominican
สานติวัตร	santiwat	santiwat
สามก๊ก	tiga kerajaan	three kingdom 'sam kok' - a thai legend
สามชัย	sam chai	samchai - a location in thailand
สามชุก	sam chuk	sam chuk district
สามพราน	sampran	sam phran
สามอัศวินในจินตนาการ	tiga ksatria fantasi	sam assavin in jintanakan - the name of a japanese story
สามัญ	biasa	common
สายการบิน	maskapai	airline
สายรัชกาลที่	pemerintahan terlambat	family tree of king rama ...
สายรุ้ง	pelangi	rainbow
สายสนั่น	garis guntur	siasanan
สายสีชมพู	garis merah muda	pink line
สายสีน้ำเงิน	garis biru	blue line
สายสีม่วง	garis ungu	purple line (rapid transit)
สายหมอก	kabut	fog
สายเดียว	satu baris	single helix
สายเมืองทอง	garis mueang thong	muang thong line
สารต้านอนุมูลอิสระ	antioksidan	antioxidants
สารพฤกษเคมี	fitokimia	phytochemical
สารภี	saraphi	saraphi
สารละลาย	solusi	solution
สารานุกรมไทย	ensiklopedia thailand	saranukromthai
สารานุกรมไทยฉบับราชบัณฑิตยสถาน	thai encyclopedia royal institute edition	thai's publication
สารีวงษ์	sareewong	sariwong
สาวิตรี	savitri	sawitri
สาเหตุ	penyebabnya	reasons
สำนวนเก่า	idiom tua	old aphorism
สำนักงานขนส่งกรุงเทพมหานครพื้นที่	kantor transportasi area bangkok	thai general transport
สำนักงานคณะกรรมการวัฒนธรรมแห่งชาติ	kantor komisi kebudayaan nasional	office of arts and culture preservation of thailand
สำนักงานโครงการพัฒนาแห่งสหประชาชาติ	kantor program pembangunan pbb	united nations development prograท
สำนักระบาดวิทยา	biro epidemiologi	bureau of epidemiology
สำนักราชเลขาธิการ	sekretariat	operation department of the king's palace
สำนักวิทยบริการ	kantor sumber daya akademik	office of academic services
สำนักหอสมุด	perpustakaan	library
สำนักหอสมุดกลาง	perpustakaan pusat	the central library
สำรวจ	jelajahi	investigate
สำราญ	dapatkan kesenangan	happily
สำหรับ	untuk	for
สำหรับประเทศไทย	untuk thailand	for thailand
สำหรับใช้เป็นตราหัวหนังสือราชการไทย	untuk digunakan sebagai segel untuk surat resmi pemerintah thailand	emblem thailand garuda
สำหรับในปี	untuk tahun ini	for the year
สำเนียง	aksen	dialect
สำโรง	samrong	sumrong - a location in thailand
สิงหาคม	agustus	august
สิงหไตรภพ	singha tripop	sing tri pop - a thai drama
สิงโต	singa	lion
สิทธิ	hak	rights
สิทธิมนุษยชน	hak asasi manusia	human rights
สิน	dosa	sihn
สินค้าคงเหลือ	persediaan	inventory
สินค้าอุปโภคบริโภค	barang konsumsi	supplies
สินสมุทร	sin samut	sihnsmut
สินิทธา	zithitha	sinitra - first name of an actor
สิปปภาค	wilayah zippy	sippapak
สิเรียม	sirium	syriam (name of city in myanmar)
สิ่ง	masalahnya	things
สิ่งมีชีวิต	makhluk hidup	living things
สิ่งเสพติด	narkoba	addictive substance, drugs
สิ้นพระชนม์ในรัชกาลที่	meninggal pada masa pemerintahan	died in
สี	warnanya	color
สีขาว	warna putih	white
สีดำ	hitam	black color
สีน้ำตาล	warna coklat	brown
สีน้ำเงิน	biru	blue
สีฟ้า	biru	blue
สีม่วง	ungu	purple
สีลม	silom	silom
สึนะ	tsuna	tsuna
สึนะโยชิ	tsunayoshi	tsunayoshi
สืบต่อมา	mewarisi	live on
สื่อสารมวลชน	jurnalisme	mass communication
สื่อสิ่งพิมพ์	media cetak	printing media
สุกิจ	sukit	sukit
สุขภาพ	kesehatan	health
สุขสวัสดิ์	suksawat	suksawas
สุขาภิบาล	sanitasi	sukhapibal (name of district)
สุขุมวิท	sukhumvit	sukhumvit
สุครีพ	sukree	sugriva
สุจริตกุล	sucharitkun	sucharitkul
สุจาริณี	sucharinee	sujarinee
สุชิน	suchin	suchin
สุดท้ายตายด้วยฝีมือ	akhirnya, mati karena keterampilan.	eventually dies at the hand of
สุดสาคร	sudsakorn	sootsakorn - a character in a thai legend
สุดารัตน์	sudarat	sudarat
สุทธิชัย	sutthichai	suttichai - a male's first name
สุทัศนะจินดา	sutasachinda	sututnajinda - surname of a tv host
สุทัศน์	suthat	sutas
สุธี	sarjana	sutee - a male's name
สุนทร	sunthorn	sunthon
สุนทรภู่	sunthorn phu	soontornpoo - a character from a legend
สุนทรเวช	sunthornwet	"surname ""sundaravej"""
สุนัขจิ้งจอก	rubah	baby fox
สุปรีย์	supri	supri - a name
สุพจน์	suphot	supot
สุพล	supon	surapol
สุมณทิพย์	sumonthip	sumonthip
สุรชาติ	surachat	surachart - a male's name
สุรพล	surapon	suraphol
สุรพันธ์	suraphan	surapan - a male's name
สุรวุฒิ	surawut	surawut
สุรศักดิ์	surasak	surasak
สุรัสวดี	surasawadee	suratsawadee - a thai surname
สุราษฎร์ธานี	surat thani	surat thani
สุรินทร์	surin	surin - a place in thailand
สุริยัน	suriyan	suriyan - a male actor
สุริโยไท	suriyo thai	"movie called ""suriyothai"""
สุลต่าน	sultan	sultan
สุวนันท์	suwanan	suwanan
สุวรรณรัฐ	suwannarat	suwannarath
สุวรรณานนท์	suwannanon	suwannanon - a surname
สุเทพ	suthep	suthep - first name of a famous singer
สุโขทัย	sukhothai	sukothai - ancient thailand
สุ่น	sun	sun
สูง	tinggi	high
สูงจากระดับน้ำทะเลปานกลาง	di atas permukaan laut rata-rata	above average sea level
สู่	untuk	indicate
สเตราส์	strauss	strauss.
สเตอรอล	sterol	steroid anabolic
สเตเดี้ยม	stadion	stadium
สเปน	spanyol	spain
สไตรค์	strike	strike
สไตล์การเล่น	gaya bermain	style
ส่งเสริม	promosikan	support, encourage
ส่วนของผู้ถือหุ้น	ekuitas pemegang saham	shareholder fund
ส่วนต่อขยายบางซื่อท่าพระ	extension bang sue tha phra	bang sue – tha phra expansion
ส่วนสูง	tinggi	height
ส่วนส่งกำลังบำรุง	bagian logistik	supply center
ส่วนหัว	header	top part
ส่วนในฤดูฝนน้ำจะท่วมทุกปี	di musim hujan, air akan banjir setiap tahun.	flooding in the rainy season
ส่วนใหญ่	kebanyakan	mostly
ส่วนใหญ่เป็นโรงสีข้าว	kebanyakan dari mereka adalah penggilingan padi.	most of them are rice refinery
ส่องแสง	bersinar	shining light
ส้ม	oranye	orange
ส้มเช้ง	oranye oranye	acidless orange
ส้มโอ	grapefruit	pomelo
หงษ์ทอง	hong thong	hongthong
หงษ์มานพ	hong manop	hongmanop
หงสกุล	hong sakul	hongsakul (a famous surname in thailand), as in harin hongsakul
หญ้าทะเล	rumput laut	seagrass
หญ้าฝรั่น	safron	saffaron
หนองคาย	nong khai	nong kai -  a location in thailand
หนองม่วง	nong muang	nong muang
หนองหาน	nong han	nong-haan
หนองฮี	nong hee	nong hi - a location in thailand
หนองแซง	zang	nong sang - area in thailand
หนอน	cacing	worm
หนัก	berat	heavy
หนังสือ	sebuah buku	book
หนังสือการ์ตูน	buku komik	comic book
หนังสือลามก	buku-buku porno	pornographic magazines
หนังใหญ่	film besar	nang yai
หนึ่ง	satu	one
หนึ่งธิดา	satu anak perempuan	nuengthida
หนุมาน	hanuman	hanuman - a giant in a thai tale
หนุ่ม	anak muda	young (used for men)
หน่วยความจำ	memori	computer memory
หน่วยคำเติม	morfem	affix
หน่วยทหารในค่าย	unit militer di kamp	units in camp
หน่วยที่	unit	order of 1, 2, 3...
หน่วยบัญชาการนาวิกโยธิน	markas besar marinir	royal thai marine corps
หน่วยประมวลผลกลาง	unit pemrosesan sentral	central processing unit
หน่วยพันธุกรรม	unit genetik	gene
หน้าอก	dada	breast
หมวด	kategori	category
หมวดหมู่	kategori	category
หมวดหมู่กลุ่มดนตรีที่ก่อตั้งในปี	kategori grup musik didirikan di jakarta	category: music band established in the year
หมวดหมู่กลุ่มดนตรีสัญชาติเกาหลี	kategori grup musik korea	korean musical group
หมวดหมู่กวีชาวไทย	kategori penyair thailand	thai poem category
หมวดหมู่การฉลองปีใหม่	kategori perayaan tahun baru	the group in charge of new year celebration
หมวดหมู่การประท้วงในประเทศไทย	kategori protes di thailand	category:protests in thailand
หมวดหมู่การ์ตูนญี่ปุ่นแนวโชเน็น	kategori kartun gaya jepang shonen	the cartoons of japan
หมวดหมู่จุลชีววิทยา	kategori mikrobiologi	category:microbiology
หมวดหมู่ชาวไทยที่นับถือศาสนาพุทธ	kategori buddha thailand	category:thai buddhists
หมวดหมู่ชาวไทยที่เกิดในต่างประเทศ	kategori orang thailand lahir di luar negeri	thais that were born outside thailand
หมวดหมู่ดาวเคราะห์ชั้นใน	kategori planet dalam	group of stars inside
หมวดหมู่ดาวเคราะห์หิน	kategori planet batu	category:terrestrial planets
หมวดหมู่ทหารอากาศชาวไทย	kategori angkatan udara thailand	category:royal thai air force personnel
หมวดหมู่ทหารเรือชาวไทย	kategori angkatan laut thailand	group of thai navy officers
หมวดหมู่นักการเมืองไทย	kategori politisi thailand	politician
หมวดหมู่นักร้องไทย	kategori penyanyi thailand	singer category
หมวดหมู่นายกรัฐมนตรีไทย	kategori perdana menteri thailand	category:prime ministers of thailand
หมวดหมู่บริษัทของไทย	kategori perusahaan thailand	group of thai's companies
หมวดหมู่บริษัทที่ก่อตั้งในปี	kategori perusahaan didirikan pada	category:companies established in
หมวดหมู่บอยแบนด์	kategori boy band	a group of boys band
หมวดหมู่บุคคลจากจุฬาลงกรณ์มหาวิทยาลัย	kategori dari universitas chulalongkorn	category:chulalongkorn university alumni
หมวดหมู่บุคคลจากมหาวิทยาลัยธรรมศาสตร์	kategori dari universitas thammasat	group of staff from thammasat university
หมวดหมู่บุคคลจากมหาวิทยาลัยสุโขทัยธรรมาธิราช	kategori dari universitas terbuka sukhothai thammathirat	group: person from sukhothai thammathirach university
หมวดหมู่บุคคลจากมหาวิทยาลัยอ๊อกซฟอร์ด	kategori individu dari universitas oxford	the staff of oxford university, england
หมวดหมู่บุคคลจากสถาบันบัณฑิตพัฒนศิลป์	kategori orang dari institut bunditpatanasilpa	group of staff from art schools
หมวดหมู่บุคคลจากโรงเรียนนายร้อยพระจุลจอมเกล้า	kategori dari akademi militer kerajaan chulachomklao	catagory: people from prchomklhaw academy
หมวดหมู่บุคคลจากโรงเรียนมงฟอร์ตวิทยาลัย	kategori individu dari montfort college	category: people from mongford college
หมวดหมู่บุคคลที่เกี่ยวข้องกับเหตุการณ์	kategori orang yang terkait dengan acara tersebut	catagory: individuals invovled
หมวดหมู่ประวัติศาสตร์ไทย	kategori sejarah thailand	category:history of thailand
หมวดหมู่ประเภทของภาพยนตร์	kategori kategori film	types of film
หมวดหมู่ปรัชญา	kategori filsafat	category:philosophy
หมวดหมู่พระราชนัดดาในรัชกาลที่	kategori cucu kerajaan dari masa pemerintahan	"catagory: royal heirs during the ""blank"" reign"
หมวดหมู่พระราชปทินัดดาในรัชกาลที่	kategori kerajaan memerintah selama masa pemerintahan	the king's army
หมวดหมู่พระราชปนัดดาในรัชกาลที่	kategori raja panadda pada masa pemerintahan	belonging to the king # ________
หมวดหมู่พิธีกรไทย	kategori presenter thailand	host for thai shows
หมวดหมู่ฟุตบอลในประเทศไทย	kategori sepakbola di thailand	category; football in thailand
หมวดหมู่ภัยธรรมชาติ	kategori bencana alam	catagory: natural disasters
หมวดหมู่ภัยพิบัติทางการแพทย์	kategori bencana medis	category: medical disaster
หมวดหมู่มหาวิทยาลัยธรรมศาสตร์	kategori universitas thammasat	thamasat university
หมวดหมู่รัชกาลที่	kategori pemerintahan	reign 9 category
หมวดหมู่รัฐคอมมิวนิสต์	kategori negara komunis	communist countries
หมวดหมู่รัฐมนตรีว่าการกระทรวงการต่างประเทศไทย	kategori menteri luar negeri thailand	category:foreign ministers of thailand
หมวดหมู่รัฐวิสาหกิจไทย	kategori perusahaan thailand	category:government-owned companies of thailand
หมวดหมู่รัฐสิ้นสภาพในทวีปเอเชีย	kategori negara bagian berhenti di asia	asian counties in controlled
หมวดหมู่รัฐและดินแดนที่ก่อตั้งในปี	kategori negara dan wilayah didirikan di	categories state and territory established in
หมวดหมู่รายการโทรทัศน์ไทย	kategori program televisi thailand	the group of thai television channels
หมวดหมู่ละครโทรทัศน์ไทย	kategori drama televisi thailand	thai drama category
หมวดหมู่วัฒนธรรมไทย	kategori budaya thailand	category:thai culture
หมวดหมู่วันสำคัญทางศาสนาที่นับโดยปฏิทินจันทรคติ	kategori hari-hari keagamaan penting dihitung dengan kalender lunar	group of religious holidays
หมวดหมู่ศิลปินสังกัดจีเอ็มเอ็ม	kategori artis di bawah gmm	mgm artists
หมวดหมู่สถาบันอุดมศึกษาในกรุงเทพมหานคร	kategori institusi pendidikan tinggi di bangkok	category:universities in bangkok
หมวดหมู่สมุนไพร	kategori ramuan	herbal, herbs
หมวดหมู่สัตว์มีแกนสันหลัง	kategori sumbu vertebral	category:chordates
หมวดหมู่สัตว์เลื้อยคลาน	kategori reptil	reptilians
หมวดหมู่สิ่งก่อสร้างในพุทธศตวรรษที่	kategori bangunan di abad ke-21	development in the century # ____
หมวดหมู่สิ้นสุดในคริสต์ศตวรรษที่	kategori berakhir pada abad ke-19.	category: ended in xth century
หมวดหมู่สโมสรในพรีเมียร์ลีก	kategori klub di liga premier	group of premier club
หมวดหมู่อดีตอาณานิคมของฝรั่งเศส	bekas kategori kolonial perancis	category:former french colonies
หมวดหมู่อดีตอาณานิคมของสเปน	spanyol bekas kategori kolonial	category:former spanish colonies
หมวดหมู่อดีตอาณานิคมของอังกฤษ	bekas kategori kolonial inggris	the group of countries that were under british control
หมวดหมู่อวัยวะ	kategori organ	group of organs
หมวดหมู่อวัยวะเพศ	kategori genital	category:sex organs
หมวดหมู่เครื่องเทศ	kategori rempah-rempah	herbs
หมวดหมู่เพศศึกษา	kategori pendidikan seks	sex education category
หมวดหมู่แนวพระราชดำริ	kategori inisiatif	the king's words (instruction)
หมวดหมู่โรค	kategori penyakit	group of disease
หมวดหมู่โรงเรียนที่มีอัตราการแข่งขันสูง	kategori sekolah dengan tingkat persaingan yang tinggi	categories high competition school
หมวดหมู่โรงเรียนบุรุษในประเทศไทย	kategori sekolah pria di thailand	category:boys' schools in thailand
หมอชิต	morchit	mochit bus station
หมากรุกสากล	catur internasional	chess
หมายความว่า	berarti	means
หมู่	grup	district, group
หมู่ที่	desa	moo.
หมู่เกาะเคย์แมน	kepulauan cayman	cayman island
หมู่เกาะแบลีแอริก	kepulauan balearic	balearic island in spain
หมู่เกาะโซโลมอน	kepulauan solomon	solomon islands
หม่อมราชวงศ์ปรีดิยาธร	r. pridiyathorn	mom rajawongse pridiyathorn devakula
หม่อมหลวงปิ่น	pin ibu	mom luang pin
หม่อมเจ้าจุฑาวัชร	pangeran jutawatchai	his serene highness prince juthawat
หม่อมเจ้าวัชรวีร์	pangeran watcharawee	mom chao vatcharee - a member of the royal family
หม่อมเจ้าวัชรเรศร	mom watcharachorn	watcharaje - a member of royal family
หม้อข้าวหม้อแกงลิง	nepenthes	nepenthes - a type of tropical plant
หยุ่น	fleksibel	yun - nickname of a thai newscaster
หรั่ง	lang	rang
หรือ	atau	or
หรือการแสดงธงชาติ	atau menunjukkan bendera nasional	national flag display
หรือชื่อทางการคือ	atau nama resminya	official name is
หรือที่รู้จักกันในชื่อ	atau dikenal sebagai	also known as
หรือที่เรียกกันว่า	juga dikenal sebagai	or what it is called ...
หรือเรียกว่า	atau disebut	called
หลวง	kerajaan	loung - a thai title for people who services the king
หลอก	trick	fake, fooling someone
หลอดอาหาร	kerongkongan	esophagus
หลอดเลือดแดงใหญ่เอออร์ตา	aorta	aorta
หลักจริยธรรม	etika	ethics
หลักทรัพย์	efek	property
หลักสี่	laksi	luk sri - a location in bangkok
หลักสูตรการจัดการดุษฏีบัณฑิต	program doktor filsafat dalam manajemen	doctor of management program
หลักสูตรที่เปิดสอน	tentu saja	curriculum
หลักสูตรนานาชาติ	kursus internasional	international course
หลักสูตรปกติ	tentu saja normal	normal program
หลักสูตรภาษาอังกฤษ	kursus bahasa inggris	english curriculum
หลักสูตรภาษาไทย	kursus bahasa thailand	thai language curriculum
หลักสูตรวิทยาศาสตรมหาบัณฑิต	program magister sains	degree requirements for a bachelor degree in science
หลังจาก	setelah	after
หลังสงคราม	setelah perang	after the war
หลังสงครามโลกครั้งที่	setelah perang dunia	world war
หลังสงครามโลกครั้งที่สอง	setelah perang dunia kedua	after world war ii
หลังเหตุการณ์	setelah acara	after the event
หลาย	banyak	many, vastly
หลีกภัย	melarikan diri	mr. cheun leakpai, the former foreign ministor
หลุมดำจิ๋ว	lubang hitam kecil	small black hole
หล่มสัก	lom sak	lohmsak
หวาย	rotan	bamboo
หอก	tombak	spear
หอประชุมพ่อขุนรามคำแหงมหาราช	raja ramkhamhaeng auditorium agung	pho khun ram khamhaeng convention center
หอมรดกไทย	balai warisan thailand	national ancient museum of thailand
หอย	kerang	shells, clams
หอไอเฟล	menara eiffel	eiffel tower
หัก	rusak	broken
หัว	kepala	head
หัวหิน	hua hin	hua hin
หัวโขน	topeng	khon mask
หัวใจ	hati	heart
หาง	ekor	tail
หาดทรายแก้ว	pantai sai kaew	glass beach
หาบเร่	penjaja	street vending
หินปูน	batu kapur	limestone
หินอ่อน	marmer	marble
หินเชิร์ต	baju batu	chert
หินแกรนิต	granit	granite rock
หินไซอัล	batu serpih	sial
หี	vagina	vagina (impolite word)
หุตะสิงห์	huta sing	hutasingha
หุ่น	wayang	model
หุ่นยนต์	robot	robot
หเตุการณ์	situasi	event
ห่วงใย	peduli	care
ห้วยขวาง	huai khwang	huai khwang
ห้วยทับทัน	huai thap than	huai thap than
ห้องน้ำ	kamar mandi	bathroom
ห้องสมุด	perpustakaan	library
ห้าง	toko serba ada	mall
ห้างฉัตร	tunggu obrolan	hang chat
ห้างหุ้นส่วนจำกัด	kemitraan terbatas	limited partnership
ฬาพานิช	komersial	fapanit - surname of an actor
อก	dada	chest
อคิลลีส	achilles	achilles
องคชาต	penis	penis
องคต	organisasi	angada
องค์กรปกครองส่วนท้องถิ่น	organisasi pemerintah daerah	local administration
องค์การนิสิต	organisasi kemahasiswaan	student organization
องค์การมหาชน	organisasi publik	human services
องค์การสหประชาชาติ	perserikatan bangsa-bangsa	united nation
องค์บาก	ong bak	ong-bak
องค์ประกันหงสา	asuransi hongsa	prakunhongsa - a famous person from the ancient time
องอาจ	gagah berani	ongart
อดิศักดิ์	adisak	adisak
อดีต	masa lalu	the past
อดีตผู้บัญชาการทหารบก	mantan komandan militer	ex-commander in chief of the royal thai army
อดีตรองนายกรัฐมนตรี	mantan wakil perdana menteri	former deputy prime minister
อดีตรองหัวหน้าหน่วยที่	mantan wakil kepala unit	former lieutenant
อธิการบดี	kanselir	dean of the college
อธิการบดีมหาวิทยาลัยธรรมศาสตร์	presiden universitas thammasat	former chanceller of thamasat university
อธิบายว่า	jelaskan itu	explain
อนันตยะ	anantaya	anantaya
อนันตรัย	anantai	anuntrai
อนาลโย	analoy	analayo
อนึ่ง	ngomong-ngomong	once
อนุทิน	buku harian	diary
อนุสรณ์สถาน	peringatan	monument
อนุสรา	anusara	anusara
อปักธงชัย	pak thong chai	pak thongchai district
อพอลโล่	apollo	apollo
อพิมาย	aphimai	phimai district
อภัยนุราช	pengampunan	aphainurat
อภินันท์	aphinan	ahpinun - a male's name
อภิปรัชญา	metafisika	metaphysics
อภิรักษ์	aphirak	apirak
อมฤต	mati	ummarit - a male's name
อมาตยกุล	amatayakun	amattayakun
อยู่	tinggal	is
อยู่วิทยา	fisiologi	yoovidhya
อยู่ห่างออกไปจากชายฝั่ง	jauh dari pantai	away offshore
อยู่แล้ว	sudah	already
อยู่ในเขตอำเภอกุฉินารายณ์	terletak di distrik kuchinarai	in the kuchinarai district
อย่างต่อเนื่อง	terus menerus	continuously
อย่างแพร่หลาย	luas	many, various
อย่างไรก็ตาม	namun demikian	however
อร	orn	orn (thai name)
อรทัย	orathai	orathai - surname of a thai country singer
อรรถกถา	komentar	atthakatha
อรรถพร	athaphon	uttapon - a female's name
อรัญประเทศ	aranyaprathet	arranyapratet - a location in thailand
อริยสัจ	kebenaran mulia	teaching of buddha
อรุณี	arunee	arunee
อลังการ	dihiasi	alungan - the name of a movie theater in thailand
อลาสก้า	alaska	alaska
อลิซ	alice	alice
อวอร์ดส	penghargaan	award
อวัยวะสืบพันธุ์สตรีด้านนอก	organ genital wanita di bagian luar	femal reproductive system
อวัยวะสืบพันธุ์หญิง	alat kelamin wanita	female reproductive system
อวัยวะเพศ	alat kelamin	sex organ
อศรีประจันต์	asri prachan	master sri prajan - a priest's name
อสมท	mcot	acronym for thai communication companies
อสามชุก	sam chuk	sam chuk district
ออ	atau	auu - a thai vowel
ออกฉายครั้งแรกเมื่อวันที่	pertama kali diputar	first screening
ออกมาในอะนิเมะเท่านั้น	keluar di anime saja	only in anime
ออกอากาศ	siaran	on the air
ออกอากาศครั้งที่	ditayangkan	airing
ออกอากาศทางช่อง	siaran aktif	aired on channel
ออกัสตัส	augustus	augustus
ออกเป็น	ke dalam	into
ออกแบบตัวละคร	desain karakter	character design
ออนไลน์	online	online
ออฟ	tidak aktif	off
ออลแบนี	sekutu	albany
ออสเตรเลีย	australia	australia
ออโตทรอพ	autobot	autotroph
อะ	apa	a
อะซูไรต์	orang azur	azurite
อะตอม	atom	atom
อะนิเมะ	anime	anime
อะบุราเมะ	aburame	aburame
อะพาไทต์	apatite	apartheid
อะมาเดอุส	amadeus	amadeus
อะลูมิเนียม	aluminium	aluminum
อะโกนิสต์	agonis	agonist
อะโลน	sendiri	alone
อักษร	alfabet	letters, alphabets
อักษรย่อ	singkatan	abbreviation
อักษรเกาหลี	alfabet korea	korea alphabet
อังกฤษสมัยแองโกล-นอร์มัน	bahasa inggris anglo-norman	england anglo-norman era
อังการา	ankara	ankara
อัญมณี	permata	gem
อัฒภาค	titik koma	semicolon
อัตราการว่างงาน	tingkat pengangguran	unemployment rate
อัธฮา	athha	athha
อันดับ	peringkat	order
อันประกอบด้วย	terdiri dari	consists of
อันโตนิโอ	antonio	"name ""antonio"""
อันโตนีโอ	antonio	antonio
อันได้แก่	termasuk	which are
อัฟกานิสถาน	afghanistan	afghanistan
อัมพร	amporn	umpon - a female's name
อัมพาต	kelumpuhan	paralysis
อัลบัส	albus	albus in harry potter stories
อัลบั้ม	album	album
อัลเดบารัน	aldebaran	arudebaran
อัลเฟรด	alfred	alfred
อัสนี	baut	thunderbolt
อาการหวาดระแวง	paranoia	paranoid
อากาศ	cuaca	air, weather
อากาศอำนวย	cuaca	akat amnuai
อากาเป	agape	the word meaning 'love' in greek language
อาคามัตสึ	akamatsu	akamatsi
อาคารส่วนที่	bagian bangunan	part (insert number) of the the building
อาคารอุบลรัตนราชกัญญา	gedung ubonratana ratchakanya	buildings outside ubon ratana graz contract.
อาคารเฉลิมพระเกียรติ	gedung chaloem phrakiat	chalermphrakiat building
อาจหมายถึง	mungkin berarti	may also mean
อาจารย์	guru	teacher
อาจารย์ใหญ่	kepala sekolah	headmaster
อาซึกะ	asuka	asuka
อาณัตพล	anataphon	arnattapon
อาณาจักร	kerajaan	kingdom
อาณาจักรธนบุรี	kerajaan thonburi	thonburi empire
อาณาจักรสุโขทัย	kerajaan sukhothai	sukhothai kingdom
อาณาจักรอยุธยาปกครองเขมรเป็นเวลาเกือบปี	kerajaan ayutthaya memerintah kamboja selama hampir setahun.	ayutthaya dynasty had colonized khmer for almort 400 years
อาณาจักรอยุธยาเริ่มเสื่อมอำนาจลงราวพุทธศตวรรษที่	kerajaan ayutthaya mulai menurun kekuatannya sekitar abad budha.	ayutthaya kingdom had started to downfall around 24 b.e.
อาณาจักรแพกเจ	kerajaan pakae	pakja territory
อาณาเขตติดต่อ	bidang kontak	adjoining parcel
อาดัม	adam	adam
อาทิ	seperti	for example
อาทิตย์	minggu	sunday
อานนท์	anon	anon
อานันทมหิดล	ananda mahidol	ahnanmahidol - someone with the king's surname
อานุภาพ	perkasa	power
อานโตนิโอ	antonio	antonio
อาบาราอิ	abarai	abarai
อายุ	usia	age
อารยา	araya	araya
อาร์	r	r.
อาร์กอน	argon	argon
อาร์คิมิดีส	archimedes	archimedes
อาร์ม	lengan	arms
อาร์มาดิลโล	armadillo	armadillo
อาร์เคด	arcade	arcade
อาร์เมเนีย	armenia	armenia
อาร์เอ็นเอ	rna	ribonucleic acid - rna
อาร์โนลด์	arnold	arnold
อาวุธคือ	senjata adalah	type of weapons
อาวุธประจำกาย	senjata pribadi	personal weapon
อาหาร	makanan	food
อาเจียน	muntah	vomit
อาเธอร์	arthur	arthur
อาเนีย	ana	anya
อำนาจ	kekuasaan	amnat
อำนาจอธิปไตย	kedaulatan	sovereignty
อำเภอ	distrik	district
อำเภอกมลาไสย	distrik kamalasai	kamalasai district
อำเภอกระสัง	distrik krasang	krasang district
อำเภอกันทรลักษ์	distrik kantharalak	kantharalak district
อำเภอขุขันธ์	distrik khukhan	khukhan district
อำเภอขุนหาญ	distrik khun han	amphur kunhan
อำเภอครบุรี	distrik khon buri	amphur kornburi
อำเภอคูเมือง	distrik khu mueang	khu mueang district
อำเภอจอมทอง	distrik chom thong	jom thong district
อำเภอดอยสะเก็ด	distrik doi saket	doi saket district
อำเภอด่านขุนทด	distrik dan khun thot	dan koontod district
อำเภอตะพานหิน	distrik taphan hin	taphan hin district
อำเภอทับคล้อ	distrik thap khlo	amphoe tap khlo
อำเภอทุ่งช้าง	distrik thung chang	thung chang district
อำเภอท่าตูม	distrik tha tum	ta toom district
อำเภอท่าวังผา	distrik tha wang pha	ta wung pa province
อำเภอท่าวุ้ง	distrik tha wung	ta wung district
อำเภอนครชัยศรี	distrik nakhon chai si	nakhon chai si district
อำเภอนาบอน	distrik na bon	nabon district
อำเภอน้ำเกลี้ยง	distrik nam kliang	amphur namleang
อำเภอบัวเชด	distrik buachet	buachet district
อำเภอบัวใหญ่	distrik bua yai	amphoe buayai (buayai district)
อำเภอบางบัวทอง	distrik bang bua thong	bang bua thong district
อำเภอบางบ่อ	distrik bang bo	bang bor district
อำเภอบางพลี	distrik bang phli	bang plee district
อำเภอบางละมุง	kabupaten bang lamung	bang lamung district
อำเภอบางเสาธง	distrik bang sao thong	bang sao thong district
อำเภอบ้านลาด	ban lat district	bahn lad district
อำเภอบ้านหมี่	distrik ban mi	ban mi district
อำเภอปราสาท	distrik prasat	amphor-prasart
อำเภอปากช่อง	distrik pak chong	pak chong district
อำเภอปากพนัง	distrik pak phanang	pak phanang district
อำเภอปาย	distrik pai	pai district
อำเภอฝาง	distrik fang	fang district
อำเภอพระประแดง	distrik phra pradaeng	pra-pradaeng district
อำเภอพระพรหม	distrik phra phrom	pra phrom province
อำเภอพระสมุทรเจดีย์	distrik phra samut chedi	samutjadee district
อำเภอพลับพลาชัย	distrik phlapphla chai	plubplachai province in thailand
อำเภอพัฒนานิคม	distrik phatthana nikhom	amphur pattananikhom
อำเภอพิปูน	distrik phipun	phipun district
อำเภอพุทธมณฑล	distrik phutthamonthon	ampore phuthamontol
อำเภอภูสิงห์	distrik phu sing	aumphor phu sing (name of district)
อำเภอยางชุมน้อย	distrik yang chum noi	choom noi province
อำเภอรหัสไปรษณีย์หมายเหตุ	distrik, kode pos, catatan	district, post code, note
อำเภอรัตนบุรี	kabupaten rattanaburi	rhatanaburi district
อำเภอราษีไศล	distrik rasi salai	rasi-salai district
อำเภอร่อนพิบูลย์	distrik ron phibun	ronpibul district
อำเภอลาดหลุมแก้ว	distrik lat lum kaeo	lat lum kaeo district
อำเภอลำปลายมาศ	distrik lam plai mat	lum plai maad district in burrirum province
อำเภอศรีณรงค์	distrik si narong	si narong district
อำเภอศรีเมืองใหม่	distrik si mueang mai	sri meung mai district
อำเภอสระโบสถ์	distrik gereja sra	sa bot district
อำเภอสหัสขันธ์	distrik sahatsakhan	sahuskhan district
อำเภอสองแคว	song khwae	song khwae district
อำเภอสังขะ	distrik sangkha	sang ka district
อำเภอสันป่าตอง	distrik san pa tong	sunpathong province in thailand
อำเภอสามพราน	distrik sam phran	sam pran area
อำเภอสารภี	distrik saraphi	sarape district
อำเภอสิชล	distrik sichon	sichon district
อำเภอสุไหงโกลก	distrik sungai kolok	amphoe su-ngai kolok
อำเภอหนองกี่	distrik nong ki	nong kee district
อำเภอห้วยราช	distrik huai rat	huai rat district
อำเภออมก๋อย	distrik omkoi	om koi district in chiang mai, thailand
อำเภอเกาะคา	distrik ko kha	amphoe ko kha
อำเภอเขวาสินรินทร์	distrik khwao sinarin	ampore khavasinrin
อำเภอเฉลิมพระเกียรติ	distrik chaloem phrakiat	amphur chalermprakiet
อำเภอเชียงของ	distrik chiang khong	chiang khong district
อำเภอเชียงคาน	distrik chiang khan	chiang khan district
อำเภอเชียรใหญ่	distrik chian yai	chien yai district in thailand
อำเภอเมืองกาฬสินธุ์	mueang kalasin	mueang kalasin provincial district
อำเภอเมืองนครราชสีมา	distrik mueang nakhon ratchasima	mueang nakhon ratchasima district
อำเภอเมืองนนทบุรี	distrik mueang nonthaburi	nontaburi district
อำเภอเมืองบุรีรัมย์	distrik mueang buri ram	burerum province
อำเภอเมืองพิจิตร	distrik mueang phichit	mueang phichit district
อำเภอเมืองพิษณุโลก	mueang phitsanulok	ampore maung pisanulok
อำเภอเมืองลพบุรี	distrik mueang lop buri	lopburi province
อำเภอเมืองสุรินทร์	distrik mueang surin	surin province
อำเภอเมืองอุตรดิตถ์	distrik uttaradit mueang	mueang uttaradit district
อำเภอเมืองเชียงใหม่	distrik mueang chiang mai	mung chiang mai district
อำเภอเมืองเพชรบุรี	distrik mueang phetchaburi	pechaburi province
อำเภอเวียงชัย	distrik wiang chai	wiang chai district
อำเภอเวียงแก่น	distrik wiang kaen	wiang kaen district
อำเภอเสริมงาม	distrik soem ngam	soem ngam district
อำเภอแจ้ห่ม	distrik chae hom	chae hom district
อำเภอแม่ทะ	distrik mae tha	mahta district
อำเภอแม่แจ่ม	distrik mae chaem	mae jam province
อำเภอแม่แตง	distrik mae taeng	mae taeng district
อำเภอโนนดินแดง	distrik non din daeng	din dang sub district
อำเภอโนนสุวรรณ	distrik non suwan	none su wan province
อิงค์	inc.	inc.
อิงลิช	bahasa inggris	english
อิทธิพล	pengaruh	power
อิน	masuk	in
อินทิรา	indira	intira
อินฟราเรด	inframerah	infared
อินฮิบิเตอร์	inhibitor	inhibitors
อินุยาฉะ	inuyasha	inuyacha - a japanese cartoon
อินเซคทิวอรา	inseqtura	insectivora
อินเดียน	india	indian
อินเด็กซ์	indeks	index
อินโดนีเซีย	indonesia	indonesia
อิม	imm	im
อิมาจิน	imajin	imagine
อิมแพ็ค	dampak	impact
อิรัก	irak	iraq
อิริโทรมัยซิน	elektrolisis	erythromycin
อิสตันบูล	istanbul	istanbul
อิหร่าน	iran	iran
อิเควทอเรียลกินี	guinea ekuatorial	equitorial
อิโนะ	ino	ino
อีก	lebih banyak	more
อีกครั้ง	sekali lagi	again
อีกด้วย	juga	also
อึ	sial	poop
อึ๊งภากรณ์	ungphakorn	ungpakorn - a famous surname
อือ	ya	uu - a thai vowel
อื่น	lain	other
อุ	o	ou
อุซึมากิ	uzumaki	uzumaki naruto
อุณหภูมิ	suhu	temperature
อุณหเคมี	termokimia	using energy and heat in chemical study
อุดม	kaya	udom
อุดรธานี	udon thani	udon thani
อุตตมะโยธิน	upparat	uttamayothin
อุตรดิตถ์	uttaradit	uttaradit
อุทยาน	taman	park
อุทยานประวัติศาสตร์พนมรุ้ง	taman bersejarah phanom rung	phanom rung historical park
อุทยานประวัติศาสตร์พิมาย	taman bersejarah phimai	phimai historical park
อุทยานแห่งชาติคลองตรอน	taman nasional khlong tron	khlong tron national park
อุทยานแห่งชาติดอยภูคา	taman nasional doi phu kha	doi phu kha national park
อุทยานแห่งชาติดอยอินทนนท์	taman nasional doi inthanon	national park doi inthanon in northern thailand
อุทยานแห่งชาติทุ่งแสลงหลวง	taman nasional thung salaeng luang	thung salaeng luang national park
อุทยานแห่งชาติธารโบกขรณี	taman nasional than bok khorani	tarabokorani national preserve area
อุทยานแห่งชาติน้ำตกสี่ขีด	taman nasional air terjun si khit	namtoksekeed national park
อุทยานแห่งชาติน้ำพอง	taman nasional nam phong	nam phong national park
อุทยานแห่งชาติภูผาเหล็ก	taman nasional gunung besi	phupalek national park
อุทยานแห่งชาติภูพาน	taman nasional phu phan	phu phan national park
อุทยานแห่งชาติภูสวนทราย	taman nasional phu suan sai	pusuansai national preserve
อุทยานแห่งชาติภูสอยดาว	taman nasional phu soi dao	soi dao mountain preserve
อุทยานแห่งชาติภูเรือ	taman nasional phu ruea	national park pu reau
อุทยานแห่งชาติภูเวียง	taman nasional phu wiang	phu wiang national park
อุทยานแห่งชาติภูแลนคา	taman nasional phulanca	phu laenkha national park
อุทยานแห่งชาติหาดนพรัตน์ธาราหมู่เกาะพีพี	taman nasional pantai noppharat thara, kepulauan phi phi	hat nopparatthara-mu ko phi phi national park
อุทยานแห่งชาติเขาหลวง	taman nasional khao luang	khao luang national park
อุทยานแห่งชาติไทรทอง	taman nasional sai thong	sai thong national preserve area
อุทุมพรพิสัย	uthumphon phisai	utompisai - an area in thai province
อุบล	ubon	ubol - a place in thailand
อุปกรณ์	peralatan	instrument
อุปกรณ์คอมพิวเตอร์	aksesori komputer	computer hardware
อุปนิสัย	karakter	manners
อุภัยราศี	maafkan zodiak	ambivert zodiac
อุรุกวัย	uruguay	urookwai - a location
อุเทน	uthen	utain - a male's name
อู	ou	u (a vowel)
อู๋	wu	auu (first name)
อเมริกัน	orang amerika	american
อเมริกา	amerika	america, usa
อเมริกาเหนือ	amerika utara	north america
อเล็กซานเดอร์	alexander	alexander
อเล็กซ์	alex	alex
อโลหะ	logam non-ferrous	nonmetal
อ่อนเพลีย	keletihan	fatigue
อ่าน	baca	read
อ่าวลึก	ao luek	ao luek
อ้างว่า	klaim itu	claim
อ้างว้าง	kesepian	loneliness
ฮอกกี้	hoki	hockey
ฮอท	panas	hot
ฮอฟมัน	hoffman	hoofman - a name
ฮอยเกนส์	hogens	huygens
ฮอร์โมน	hormon	hormone
ฮอลแลนด์	belanda	holland
ฮอลโลว์	hampa	hollow (as in dead soul)
ฮอว์ค	seahawks	hawk
ฮักบี้	selamat tinggal	hugby - an album that received many awards
ฮันกึล	hangul	hangeul
ฮัมบูร์ก	hamburg	hamburg
ฮาจิ	hachi	haji
ฮาตาเกะ	hatake	hatake
ฮานอย	hanoi	hanoi
ฮายาโตะ	hayato	hayada - a japanese surname
ฮารุกะ	haruka	haruka - a japanese name
ฮาวาย	hawaii	hawaii
ฮิซาชิ	hisashi	hitachi
ฮิซานะ	hisana	hisana
ฮิตเลอร์	hitler	hitler
ฮินาตะ	hinata	hinada - a japanese story
ฮิมาวาริ	himawari	himawari - a japanese surname
ฮิราโกะ	hirako	hirako (japanese name)
ฮิวงะ	hyuga	hewnga - a japanese name from a story
ฮิโซกะ	hisoka	hisoka
ฮิโรชิ	hiroshi	hiroshi
ฮีชอล	heechul	heechul
ฮุก	kait	hook
ฮโยยอน	hyoyeon	hyoon - a dancer from japan
ฯพณฯ	yang mulia	two thai alphabets.  abbreviation that means many things
เกตส์	gates	gates
เกตุทัต	ketthat	kettut - a surname
เกมที่	permainan	game number _________
เกมบุค	game	game book
เกรย์	abu-abu	gray
เกษตรกรรม	agribisnis	farming
เกษตรวิสัย	kaset wisai	kasetvisai (name of thai district)
เกษมศรี	kasemsri	kasemsri surname
เกอริง	gering	the name 'gerring'
เกอไทต์	goethe	goethite mineral
เกาหลีใต้	korea selatan	south korea
เกาะ	pulau itu	island
เกาะคา	kauai	ko kha
เกาะลูซอน	pulau luzon	luzon island
เกาะสุมาตรา	sumatra	sumatra
เกิด	terlahir	born
เกิดขึ้นหลังจากมหาวิทยาลัยศรีนครินทรวิโรฒวิทยาเขตต่างๆ	terjadi setelah universitas srinakharinwirot, berbagai kampus	happened after srinakarinviroj university started
เกิดขึ้นเมื่อวันที่	terjadi pada	birthdate
เกิดจากการรวมชิ้นส่วนที่	disebabkan dengan menggabungkan bagian-bagian itu	put together to form something
เกิดจากการรวมตัวของ	disebabkan oleh penggabungan	combination of
เกิดจากเชื้อไวรัส	disebabkan oleh virus	occur from the viral agent
เกิดนิมิตร	ciptakan sebuah visi	caused a vision/realization
เกียรติ	hormat	honour
เกียรติประวัติ	hormat	biography
เกียรติศักดิ์	hormat	reputation.  kietisak can be a male's name
เกียวโตะ	kyoto	kyoto
เก็กโค	checco	gecko
เขตคลองสาน	distrik khlong san	klongsan district
เขตจอมทอง	distrik chom thong	jomthong area
เขตดุสิต	dusit	khet dusit
เขตที่	distrik	district number _______
เขตบางกอกใหญ่	distrik bangkok yai	bangkok yai district in thailand
เขตบางซื่อ	distrik bang sue	bang sue district
เขตบางแค	bang khae	bang khae district
เขตปทุมวัน	pathumwan	pathum wan district
เขตภาษีเจริญ	distrik phasi charoen	phasi charoen district
เขตมีนบุรี	distrik min buri	min buri district
เขตรักษาพันธุ์สัตว์ป่า	suaka margasatwa	national wildlife preserve
เขตรักษาพันธุ์สัตว์ป่าภูหลวง	suaka margasatwa phu luang	wildlife preserve
เขตลาดกระบัง	lat krabang	lad krabang district
เขตวังทองหลาง	distrik wang thonglang	wang thonglang district
เขตวัฒนา	distrik wattana	watana district
เขตสวนหลวง	distrik suan luang	suan luang district
เขตสาทร	sathon	sathorn area
เขตห้วยขวาง	huai khwang	huai khwang district
เขตเลือกตั้งที่	borough	election area number
เขมนิจ	imperious	khemanit
เขากล่าวว่า	katanya	he said
เขาทราย	khao sai	sand dunes
เขียนว่า	tulis itu	wrote
เขียนโดย	ditulis oleh	written by
เขี้ยวพิษ	taring beracun	vemon fangs
เขื่อนกิ่วลม	kio wind dam	kio lom dam
เขื่อนป่าสักชลสิทธิ์	bendungan pasak chonlasit	parsakchonlasit dam
เขื่อนลำปาว	bendungan lampao	lum pao dam
เขื่อนแม่งัดสมบูรณ์ชล	bendungan mae ngad somboon chon	mae ngud som bul chol dam in chiangmai
เข็มศิลปวิทยา	seni jarum	khem sinlapawitthaya
เข็มอัปสร	jarum	kem uppasorn - a thai drama
เข่า	lutut	knee
เข้าฉาย	tampilkan	release date
เข้าชิงไนน์เอ็นเตอร์เทนอวอร์ดส	dinominasikan untuk sembilan penghargaan hiburan.	compete in entertaining world
เข้ารอบ	finalis	made it to the next round, selected from the initial round
เข้าเฝ้า	punya audiensi	visit (word for the king)
เคน	ken	ken
เคนยา	kenya	kenya
เคมีไฟฟ้า	elektrokimia	electrochemistry
เคยสู้กับโกคุเทระ	dulu bertarung dengan gokudera	fought with gokudera
เครือข่าย	jaringan	network
เครื่องขัตติยราชอิสริยาภรณ์อันมีเกียรติคุณรุ่งเรืองยิ่งมหาจักรีบรมราชวงศ์	memperingati kehormatan besar dinasti chakri	something used in a thai ceremony - too obscure
เครื่องดีด	strum	thai string musical instruments
เครื่องตี	kocok mesin	musical intrument
เครื่องบิน	pesawat itu	airplane
เครื่องปั้นดินเผาและเซรามิค	tembikar dan keramik	pottery and ceramic
เครื่องยนต์	mesinnya	engine
เครื่องราชอิสริยาภรณ์	lambang	the king's accessories for ceremonies
เครื่องราชอิสริยาภรณ์อันเป็นที่เชิดชูยิ่งช้างเผือก	lambang gajah putih tertinggi	order of the white elephant
เครื่องราชอิสริยาภรณ์อันเป็นสิริยิ่งรามกีรติ	lambang kemuliaan besar kirati	king's accessories
เครื่องราชอิสริยาภรณ์อันเป็นโบราณมงคลนพรัตนราชวราภรณ์	lambang kuno dengan keberuntungan	the ancient and auspicious order of the nine gems
เครื่องสาย	instrumen bersenar	string instrument
เครื่องแต่งกาย	kostum	clothes
เคลลี่	kelly	kelly
เคอาร์วาย	kryy	k.r.y
เค้ก	kue	cake
เงิน	uang	money
เงินทุน	pendanaan	fund
เงินในบัญชีธนาคาร	uang di rekening bank	balance
เงี้ยว	bent	shan tribe in northern part of thailand
เจ	j	j.
เจนี่	janie	jenny
เจมินี่	gemini	gemini
เจริญ	kemajuan	charoen
เจสเปอร์	jesper	jasper
เจียะแจ	jae jae	nine emperor gods festival
เจี๊ยบ	cewek	jeab (thai name)
เจเน็ต	janet	janet
เจ็ดเทพโจรสลัด	shichibukai	seven warlords of the sea
เจ็บ	sakit	pain
เจ้าของจุกนม	pemilik puting	the owner of the baby's bottle
เจ้าจอม	tuan	king's concubine
เจ้าฟ้ากรมพระยานริศรานุวัดติวงศ์	pangeran krom phraya narisaranu, kuil tiwong	refer to a title of a royal family member - jao fa krom pra ya rissanuwattiwong
เจ้าฟ้ากรมพระยานริศรานุวัติวงศ์	pangeran krom phraya narisara nuwatwong	prince narisara nuvativongse
เจ้าฟ้าจิตรเจริญ	pangeran jitcharoen	prince chitcharoen
เจ้าฟ้าภาณุรังษีสว่างวงศ์	pangeran phanurangseesawangwong	prince panuragui bright chestnut.
เจ้าฟ้ามหาวชิราลงกรณ	pangeran maha vajiralongkorn	thailand's crown prince
เจ้าฟ้ามหาวชิรุณหิศ	pangeran mahawajirunhit	crown prince maha vajirunhis
เจ้าฟ้ามหิดลอดุลยเดช	pangeran mahidol adulyadej	prince mahidol adulyadej
เจ้าฟ้ามหิดลอดุลเดช	pangeran mahidol adulyadej	a member of thai royalties
เจ้าฟ้าหญิง	putri	princes
เจ้าฟ้าอุบลรัตนราชกัญญา	chaofa ubonratana rajaganya	princess ubon ratana graz's' contract.
เจ้าหนี้การค้า	hutang akun	trade account payable
เจ้าเมือง	gubernur	mayor
เจ้าเมืองขุขันธ์	gubernur khukhan	a name of the head of the state
เจ้าโลก	hegemoni	world conqueror
เฉพาะด้านตะวันออกเฉียงใต้เท่านั้นที่เป็นที่ราบลุ่มแม่น้ำโขง	hanya sisi tenggara adalah lembah sungai mekong.	only south-east area that is in mekhong plateau
เฉลิม	chalerm	chalerm - a male's name
เฉลิมชัย	chalermchai	chalermchai
เฉลิมชัยเจริญกิจ	chalermchai charoenkit	chalermchaichareonkij
เฉลิมพระเกียรติ	untuk menghormati	chaloem phra kiat
เฉลิมพล	chalermpol	shalermpol - a surname
เฉลิมแสน	chalermsaen	chaloemsaen
เฉลียว	tanggap	chaleuw - a male's name
เชส	kejar	(jp morgan) chase
เชอร์รี่	cherry	cherry
เชา	chow	chow -  a chinese name
เชาวน์	kecerdasan	chow - a name
เชาวราษฎร์	chaowarat	chowarat - the surname of a famous actress
เชิญยิ้ม	senyum	smile
เชิดชัย	taklukkan	"name ""churd-chai"""
เชียงกลาง	chiang klang	chiang klang
เชียงของ	chiangkhong	chiang khong
เชียงดาว	chiang dao	chiang dao
เชียงปุม	chiang pum	chiang poom - area in thailand
เชียงยืน	chiang yuen	chiang yuen
เชียงราย	chiang rai	chiang rai
เชียงใหม่	chiang mai	chiang mai
เชี่ยววงศ์กุล	chiewwongkun	chiaowongkul
เชื่อมต่อกับรถไฟฟ้ามหานคร	terhubung ke mrt	connect with skytrain
เชื่อมแม่น้ำท่าจีน	hubungkan sungai tha chin.	confluence to the ta jean river
เชื้อชาติ	ras	helping the country
เชื้อรา	jamur	fungus
เช็ค	periksa	check
เช่นกัน	juga	as well
เช่นเดียวกัน	demikian juga	similar to
เช้ามืดวันที่	fajar hari itu	in dawn of
เช้าวันรุ่งขึ้น	pagi berikutnya	next morning
เซกิ	seki	seki
เซน	zen	saint
เซนทอร์	centaur	centaur
เซบาสเตียน	sebastian	sebastian
เซฟ	simpan	save
เซลล์	sel	cell
เซสติโม	seto	settimo
เซอร์	pak	sir
เซอร์วิส	melayani	service
เซอร์เบีย	serbia	serbia
เซอวิวาสแตติน	cervivastin	cerivastatin - drug
เซโรกัชเชอร์	sero kutcher	sero gusher - a type of weapon
เซโรนอส	seronos	zeronos
เซโรไลเนอร์	seroliner	seroliner
เซ็กส์	seks	sex
เซ็นทรัล	pusat	central - department stores in thailand
เซ็นทารา	centara	centara
เซ็นเซอร์	sensornya	sensor
เณร	seorang pemula	samanera
เดคลิเนชัน	dekorasi	declination
เดชา	dacha	decha
เดธโน้ต	death note	death note - a mysterious japanese cartoon
เดนกัชเชอร์	denkucher	den gusher - a weapon in japanese movies
เดนโอ	den o	den-o
เดนโอเบลท์	den obelt	den-o belt
เดย์	hari	day
เดอะซิมส์	sims	the sims
เดอะฮาเดส	the hades	the hades
เดอะฮาเดสแชปเตอร์	bab hades	the hades chapter
เดิม	asli	at first
เดิมชื่อ	sebelumnya	former name
เดิมที	awalnya	at first
เดิมเรียกว่า	dahulu dikenal sebagai	formerly known as
เดียวกัน	sama	same
เดือดทะลุจุดศูนย์	mendidih melalui titik nol	zero point breakthrough
เดือนกุมภาพันธ์	februari	february
เดือนตุลาคม	oktober	october
เดือนตุลาคมมีฝนตกชุกที่สุด	oktober adalah bulan paling hujan.	highest amount of rainfall in october
เดือนธันวาคม	desember	december
เดือนมกราคม	januari	january
เดือนมิถุนายน	juni	june
เดือนอ้าย	bulan bulan	first lunar month
เด็กหญิงอายุ	gadis tua	the girl's age
เด็กและเยาวชน	anak-anak dan remaja	children and youth
เต่า	kura-kura	tao (first name)
เต๋อ	untuk	ter
เถรวาท	theravada	buddha's teaching
เทคนิคอิลลูชั่น	teknik ilusi	technique illusion
เทควันโด้	taekwondo	tai kwon do
เทคโนโลยี	teknologi	technology
เทคโนโลยีสารสนเทศ	teknologi informasi	san son tej techonology
เทนนิส	tenis	tennis
เทนโจอิน	tenjo-in	tenjoin - a character in a japanese story
เทพพิทักษ์	terima kasih	theppitak
เทพมรณะ	kematian	bleach
เทพหัสดิน	dewa surga	tephussadin (a surname)
เทพอานูบิส	anubis	anubis
เทพอาเตน	athen	aten
เทพีเธมิส	dewi	themis
เทริโอ	therio	terio - surname of a singer
เทวดา	malaikat	angel
เทวรูป	idola	graven image
เทศบาล	kotamadya	municipality
เทศบาลนครขอนแก่น	kotamadya khon kaen	khon khan public works
เทศบาลนครนครราชสีมา	nakhon ratchasima	nakorn rachasrima province public work
เทศบาลนครนครศรีธรรมราช	nakhon si thammarat	nakorn sri thamarat city public works
เทศบาลนครเชียงราย	chiang rai	chiang rai province public works
เทศบาลนครเชียงใหม่	kotamadya chiang mai	chiang mai municipality
เทศบาลเมืองชัยภูมิ	kotamadya chaiyaphum	mueang chaiyaphum
เทศบาลเมืองบุรีรัมย์	buriram	bureerum public works
เทศบาลเมืองมหาสารคาม	kotamadya maha sarakham	thesaban mueang maha sarakham
เทศบาลเมืองมุกดาหาร	kotamadya mukdahan	mookdahan public works
เทศบาลเมืองสกลนคร	kotamadya sakon nakhon	municipality of sakonnakon
เทศบาลเมืองหนองคาย	nong khai municipality	nong khai municipality
เทศบาลเมืองหนองบัวลำภู	kotamadya nong bua lamphu	nong bua lam phu town municipality
เทศวิศาล	ekspansif	tasavisakal - a surname
เทิดศักดิ์	hormat	therdsak
เทียนทอง	lilin emas	tientong - a male's name
เทียนเงิน	lilin perak	tienngern
เทียนโพธิ์สุวรรณ	thian pho suwan	tianphosuwan (thai last name)
เทเบิลเทนนิส	tenis meja	table tennis
เทโรศาสน	tero sasana	terosat football club
เท็ดดี้	teddy	teddy
เท็นเท็น	sepuluh sepuluh	tin-tin
เท่ง	teng	teng (first name)
เท่านั้น	hanya	only
เธคุนุ	dukungan	dhekunu
เธรซ	thrace	thrace - an area in greece
เธอกับฉัน	anda dan saya	you and i
เธอจะอยู่กับฉันตลอดไป	kamu akan tinggal bersamaku selamanya	you will be with me forever
เธอยัง	dia masih	tur yung
เธอเป็นเพื่อนอาบาราอิ	dia adalah teman abarai.	she is a friend of arbarae
เนกิ	negi	negi
เนย	mentega	butter
เนรมิต	ciptakan	casting a spell
เนะ	benar	ney
เนื่องจาก	karena	because
เนื่องจากประเทศเหล่านั้นอยู่ในตำแหน่งบนโลกที่ต่างไปจากประเทศไทย	karena mereka berada di posisi di bumi yang berbeda dari thailand	because those countries are in the group of...
เนื้อที่	area	area
เนื้อที่ประมาณ	perkiraan area	approximate area
เนื้อร้อง	lirik	lyrics
เนื้อเรื่องย่อ	ringkasan	summary
เนเธอร์แลนด์	belanda	netherlands
เนโกะ	neko	neko
เน็น	nen	nen
เบจิต้า	bechita	vegeta
เบธเลเฮม	betlehem	bethleham
เบนจามิน	benjamin	benjamin
เบรกมา	hancurkan	bregma
เบริธ	berith	berith
เบลเฟกอล	cantik	belphegor- a demon in a legend
เบส	bass	bass
เบอร์ลิน	berlin	berlin
เบา	ringan	soft (voice)
เบาท์	baut	(dieric) bouts
เบาหวาน	diabetes	diabetes
เบื่ออาหาร	bosan	not appetite, eating disorder.
เบื้องหลัง	di belakang layar	behind the sence
เบโทเฟิน	beethoven	beethoven
เบ็นเท็น	ben 10	ben 10
เปรม	prem	pream
เปรี้ยว	masam	sour
เปรู	peru	peru
เปลวไฟ	nyala api	flame
เปลี่ยนชื่อเป็น	berganti nama menjadi	changed the name to
เปลื้อง	dicabut	nude
เปล่งพานิช	plengpanich	plengpanich
เปอร์เซีย	persia	persia
เปอร์โตริโก้	puerto riko	puerto rico
เปิดสอนระดับปริญญาตรี	terbuka untuk studi sarjana	offer bachelor degree curriculum
เปียงยาง	pyongyang	piang yang - in north korea
เปียโตร	pietro	pietro
เปียโน	piano	piano
เปโซ	peso	peso
เป็ด	seekor bebek	duck
เป็น	menjadi	is
เป็นขนมของชาวไทยมุสลิม	merupakan hidangan penutup dari muslim thailand	is a thai-muslim dessert
เป็นครั้งแรก	pertama kali	first
เป็นงานเขียนในชุด	seperangkat tulisan	in the edition of...
เป็นต่อ	terhadap	pen to
เป็นต้น	sebagai contoh	for example
เป็นต้นมา	sejak	onward
เป็นต้นไม้ประจำมหาวิทยาลัย	adalah pohon universitas	tree of university
เป็นบัวในสกุล	apakah lotus dalam genus	is a lotus in the family
เป็นประธาน	menjadi presiden	principal of
เป็นปลาตู้สวยงาม	adalah ikan akuarium yang indah	is an ornamental fish
เป็นพระราชโอรสพระองค์เดียวในพระบาทสมเด็จพระปรมินทรมหาภูมิพลอดุลยเดช	apakah putra tunggal raja bhumibol adulyadej	is the only son of
เป็นพ่อของ	apakah ayah dari	is the father of
เป็นวิญญาณเทียมเพศชาย	adalah roh buatan pria	the spirit who is a male
เป็นสีประจำ	warna biasa	official color
เป็นหนึ่งใน	apakah salah satunya	is one of
เป็นหัวหน้าพรรค	pemimpin partai	party leader
เป็นอดีตหัวหน้าหน่วยที่	adalah mantan kepala unit	is the former leader of the unit
เป็นอาวุธ	sebagai senjata	as a weapon
เป็นเครื่องหมายแสดงว่า	apakah itu pertanda	indicates that
เป็นเจ้าเมืองปกครอง	gubernur	governor
เป็นเมืองหลวง	apakah modal	capital
เป็นเวลา	untuk	utilized time
เป็นโฮโมโลกัสกับ	menjadi homologus dengan	homologous
เป๊ปซี่	pepsi	pepsi
เพกาซัส	pegasus	pegasus
เพชร	berlian	diamond
เพชรบุรี	phetchaburi	petchaburi province
เพชรบูรณ์	phetchabun	prechabun
เพชรพระอุมา	diamond phra uma	ancient diamond
เพชรา	orang tua	petchara - name of a famous actress
เพชรเกษม	petchkasem	petchakasem area in bangkok
เพดานอ่อน	langit-langit yang lembut	gill
เพทาย	zirkon	zircon
เพพซิน	pepsin	pepsin
เพราะ	karena	because
เพราะว่า	karena	because
เพรียะ	piriya	preah - cambodia
เพลงประกอบภาพยนตร์	soundtrack film	soundtrack
เพลงประจำจังหวัด	lagu provinsi	province anthem
เพลงประจำมหาวิทยาลัย	lagu universitas	university song
เพลงปิดเรื่อง	lagu penutup	pid reung song
เพลงพระราชนิพนธ์	musik kerajaan	the king's song
เพลงลูกทุ่ง	musik country	folk song
เพลงลูกทุ่งขับร้อง	musik country	luk thung song
เพลงอีแซว	menggoda musik	a type of thai country music
เพลงเปิด	lagu pembuka	opening song
เพลงเปิดเรื่อง	lagu pembuka	opening song
เพลย์สเตชัน	playstation	playstation
เพลโต	plato	plato
เพศ	gender	sex
เพศชาย	jenis kelamin laki-laki	male
เพิ่มมา	lebih banyak	addition
เพียงพอ	cukup	enough
เพื่อ	untuk	for
เพื่อเป็นการเผยแผ่พระพุทธศาสนาและประชาสัมพันธ์กิจกรรมทางพระพุทธศาสนาต่าง	untuk menyebarkan agama buddha dan mempromosikan kegiatan keagamaan	passing knowledge about buddhism
เพื่อใช้ร่วมกับตัวชี้วัดอื่น	untuk digunakan dengan indikator lain	to be used with other indicators
เพ็ชรทาย	phettha	petchtai
เฟนิรามีน	feniramin	pheniramine
เฟย์	fay	fay
เฟรดริก	frederick	fredrick
เฟส	fase	phase
เฟอร์นิเจอร์	perabotan	furniture
เฟื่องอารมย์	foudarom	fueangarom
เภสัชกร	apoteker	pharmacist
เภสัชจลนศาสตร์	farmakokinetik	pharmacokinetics
เม	mei	may
เมกา	mega	mega
เมฆ	awan	clouds
เมฆออร์ต	oort cloud	ash cloud in the space
เมจิ	meiji	maji - a nickname
เมตร	m.	metre
เมทริกซ์	matriks	matrix
เมทะนี	metani	metanee - the surname of a famous actor
เมอร์คิวรี	merkuri	mercury
เมือง	kota	town
เมืองทองฯ	muang thong	muangthong
เมืองนครราชสีมา	nakhon ratchasima	nakornrachasrima city
เมืองปทุมธานี	pathum thani	mueang pathum thani
เมืองปราจีนบุรี	prachinburi	prajinburi city
เมืองพิจิตร	phichit	pijit city
เมืองพิษณุโลก	phitsanulok	phitsanulok
เมืองยอง	kota rusa	mueng-yor
เมืองลำพูน	lamphun	lumpoon province
เมืองสกลนคร	sakon nakhon	sakon nakhon
เมืองสิงห์	singha	muangsing
เมืองสุรินทร์	surin	surin city
เมืองหลวง	ibukotanya	capital city
เมืองหลวงของอาณาจักรเขมร	ibukota kerajaan khmer	capital of cambudia
เมืองเคมบริดจ์	kota cambridge	city of cambridge
เมืองเอก	kota ake	mueang-ake
เมืองโคราช	korat	muang korat
เมืองใหญ่	kota besar	city
เมืองใหญ่ในเขตนี้	kota-kota besar di kabupaten ini	capital presently
เมื่อประมาณ	kapan	estimate
เมื่อปีพศ	tahun lalu	in buddhist era
เมื่อปีพุทธศักราช	di era budha tahun ini	in b.e.
เมื่อวันจันทร์	hari senin	on monday
เมื่อเดือนกันยายน	september lalu	in september
เมื่อเดือนมีนาคม	berbaris	in march
เม็ดขนุน	nangka	metkhanun
เม่น	landak	porcupine
เย	kamu	yay - a sound
เยลโล่	kuning	yellow
เยอรมนี	jerman	germany
เยอรมัน	jerman	german
เยาวชน	pemuda	youth
เยาวชนอายุ	usia muda	youth age of ...
เยาวราช	pecinan	yaowaraj
เยื่อหุ้มสมอง	cortex	meninges
เรซูเม	lanjutkan	resume
เรด	merah	red
เรดวัน	hari merah	redone
เรย์	ray	ray
เรวดี	kabar baik	rawadee
เราเตอร์	router	router
เริ่มการผลิตนำเข้า	mulai produksi impor	importing
เริ่มก่อสร้าง	mulai konstruksi	began constuction
เริ่มจากเดือนพฤศจิกายนเมษายน	mulai dari november hingga april	begins from november to april
เริ่มตั้งแต่อาณาจักรอยุธยาได้โจมตีอาณาจักรเขมร	dimulai dengan kerajaan ayutthaya menyerang kerajaan khmer.	ever since the ayudhya (military) assault...
เรียกกันว่า	dipanggil	called
เรียกว่า	dipanggil	call
เรียล	nyata	real
เรียว	ramping	ryo
เรียวทาโร่	ryotaro	totoro - a japanese cartoon
เรียวเฮ	rye hye	reohay - a japanese character
เรียะชอาณาจักร	kerajaan	reacheanachak
เรืองรุ่ง	bersinar	rueangrung
เรืองศรี	rueangsri	rueng sri - a surname
เรือตรี	perahu	ensign
เรือนนาค	rumah naga	nak castle
เรือยกพลขึ้นบก	landboat	boat for advance the army
เรือสำรวจ	kapal survei	survey vessel
เรือเร็วโจมตี	serangan speed boat	fast attack craft
เรือใบ	perahu layar	sailboat
เรื่อง	ceritanya	story
เรื่องย่อ	ringkasan	synopsis
เรื่องสั้น	cerita pendek	short story
เร้กเก้	reggae	reggae
เลข	nomor	mathematics
เลขที่	nomor	number
เลขาธิการสหประชาชาติ	sekretaris jenderal perserikatan bangsa-bangsa	united nations secretary-general
เลนส์	lensa	lens
เลออน	leon	lyon
เลิฟ	cinta	love
เลือดออกตามไรฟัน	penyakit kudis	bleeding of the gum
เลโอ	leo	alo
เลโอนาร์โด	leonardo	leonardo
เล็ก	kecil	small
เล่ม	buku	book
เล่มที่	nomor buku	volume
เวทีทอง	panggung emas	golden podium
เวล	vail	vail
เวลาประมาณ	perkiraan waktu	approximate time
เวสต์	barat	west
เวอร์ชัน	versi	version
เวอร์โก้	vergo	virgo
เวิร์คพอยท์	titik kerja	workpoint company
เวิร์คพอยท์สตูดิโอ	studio workpoint	workpoint studio
เวิร์ม	cacing	worm
เวิลด์	dunia	world
เวียงสระ	wiang sa	wiang sa
เวียงสา	wiang sa	wiang sa
เวียนเทียนรอบอุโบสถหรือสถูปเจดีย์พุทธสถานต่าง	berkeliling di sekitar kapel atau pagoda	a thai religious ceremony
เวโรนา	verona	verona in italy
เว็บ	web	web
เว็บสเตอร์	webster	webster
เว็บเบราว์เซอร์	browser web	web browser
เว็บไซต์ของเกมส์	situs game	gaming website
เว็บไซต์ซีไอเอ	situs web cia	cia website
เว้นวรรค	ruang	space
เศรษฐกิจพอเพียง	ekonomi kecukupan	sufficiency economy
เศรษฐบุตร	sethaputra	settabut - the family that started bus system in thailand
เศรษฐศาสตร์จุลภาค	ekonomi mikro	microeconomics
เศรษฐศาสตร์มหภาค	ekonomi makro	macroeconomics
เสงี่ยม	sederhana	sa-ngiam
เสชนะ	menang	sechana
เสด็จพระราชสมภพ	kelahiran kerajaan	royal birth
เสนอชื่อเข้าชิงและรับรางวัล	nominasikan dan terima penghargaan.	nominate and win
เสนา	sena	sena
เสนาเมือง	kota sena	senamuang
เสนีวงศ์	seni wong	seniwong
เสน่ห์	pesona	sanea
เสมอ	selalu	always
เสรี	gratis	seri
เสรีภาพ	kebebasan	freedom
เสียง	suara	sound
เสียงเปิด	suara terbuka	approximant, semi-vowel
เสียงเสียดแทรก	suara frikatif	noise
เสือจากัวร์	jaguar	jaquar
เสื้อครุย	jubah	gown
เส้นทแยงมุม	diagonal	diagonal
เส้นพุ่ง	line	yarn that is used for weaving
เส้นโค้ง	kurva	curve
เส้นใย	serat	polymer, yarn
เหงื่อ	keringat	sweat
เหตุการณ์	acara tersebut	situation
เหตุการณ์สำคัญ	peristiwa penting	important event
เหรียญ	koin	coin
เหรียญกษาปณ์	mint	coin
เหรียญทอง	medali emas	gold medal
เหรียญรัตนาภรณ์	koin rattanaporn	a special thai medallion
เหลือง	kuning	yellow
เหลือสมาชิก	anggota yang tersisa	members left
เหล็ก	setrika	iron
เหล่านี้	ini	these
เหล่าสุนทร	laosonthorn	soontorn group
เห็นภาพลวงตา	lihat ilusi	seeing hallucination
เอก	pertama	the first tonal marker of thai writing system represented by  '
เอกชน	pribadi	private
เอกซ์	x	x
เอกราช	kemandirian	sovereignty
เอกวาดอร์	ekuador	edwardor
เอกสิทธิ์	eksklusif	privilege
เอจิเซ็น	echizen	echizen
เอชไอวี	hiv	hiv, human immunodevficiency virus
เอซ	aces	letter h
เอตาสีติ	atacati	sesasiti
เอนจิเนียริ่ง	rekayasa	engineering
เอนไซม์	enzim	enzyme
เอบีซี	abc	abc
เอม	bidik	aim - could be a nickname
เอริค	eric	eric
เอล	el	el
เอสปาด้า	espada	eapada
เอสปาด้าตกชั้น	espada terdegradasi	aspata
เอสเอ็ม	sm	sm entertainment from korea
เอสโตเนีย	estonia	astonia - a country
เออร์โกสเฟียร์	ergosphere	ergosphere
เอี่ยมยิ่ง	saya	super, awesome
เอี่ยมสุข	saya senang	iamsuk
เอื้อย	uri	eay - a thai nickname
เอเชีย	asia	asia
เอเชียตะวันตกเฉียงใต้	asia barat daya	southwest asia
เอเชียเหนือ	asia utara	north asia
เอเชียแปซิฟิก	asia pasifik	asia-pacific
เอเชียใต้	asia selatan	south asia
เอเธนส์	athena	athens
เอเอฟซี	afc	afc
เอเอฟซีแชมเปียนส์ลีก	liga champions afc	afc championship
เอ็กซ์โป	expo	expo
เอ็กโทเดิร์ม	ecterm	ectoderm, top level of skin layer.
เอ็กโปรพลาซ่า	expo plaza	expo plaza in thailand
เอ็ดดูเทนเมนท์	edutainment	edutainment
เอ็ดเวิร์ด	edward	edward
เอ็น	tendon	n
เอ็นบีเอ	nba	nba - national basketball association
เอ็นเตอร์เทนเม้นท์	hiburan	entertainment
เอ็นเทอร์เทนเมนท์	hiburan	entertainemnt
เอ็มม่า	emma	emma
เอ๋	eh	ah - a nick name
เฮติ	haiti	haiti
เฮลมุต	helmut	helmut
เฮสเตีย	hestia	hestia
เฮอร์เชล	herschel	herschel
เฮาส์	rumah	house
เฮียวงะ	hyuga	heonga
แกง	kari	soup
แกมเบีย	gambia	cambia
แกรนซ์	hibah	grantz
แกรมมี่	grammy	grammy
แกริซั่น	garnisun	garrison - an english name
แกลง	klaeng	glang
แกลเลอรี	galeri	gallery
แกสโทรโพดา	gastropoda	"name ""gastropoda"""
แกะ	domba	sheep
แกแล็คซี่	galaksi	galaxy
แก่	untuk	aging
แก้ว	gelas	glass
แก้วทอง	gelas emas	golden cup
แก้วบัวสาย	gelas teratai	kaeobuasai
แก๊สธรรมชาติ	gas alam	natural gas
แขก	tamu	indian
แขน	lengan	arm
แขวงจำปาสัก	provinsi champasak	champasak province
แขวงหลวงพระบาง	kecamatan luang prabang	luang pra bang province
แคดเมียม	kadmium	cadnium
แคทแพท	pat cat	kat - pat kamikaze - the thai famous stars
แคน	caen	kan - a type of thai music
แคนดี้	permen	candy
แคนเซอร์	canzer	cancer
แคม	webcam	cam
แคมป์เบลล์	campbell	campbell
แคมเปญ	kampanye	campagne
แคมเล็ก	cam kecil	vagina fold
แคมใหญ่	kamera besar	labia
แคร็กเกอร์	nutcracker	crackers
แคลคูลัสเชิงปริพันธ์	kalkulus integral	integral calculas
แคลคูลัสเชิงอนุพันธ์	kalkulus diferensial	differential calculus
แคลอรี	kalori	calorie
แคลิฟอร์เนีย	california	california
แคลิฟอร์เนียม	california	californium
แคว้น	wilayah	kwon - a korean surname
แจ	selai	live purely and clean both in body and mind - from chinese belief
แจ็กสัน	jackson	jackson
แจ็ค	jack	jack
แจ๊ค	jack	jack
แจ๊ส	jazz	jazz
แด	dae	dae
แดงทั้งแผ่นดิน	seluruh bumi berwarna merah	red (political party all over the country
แดนสุพรรณ	suphan	dansuphan
แดเนียล	daniel	daniel
แตน	hornet	grass hopper
แต่งงาน	sudah menikah	wedding, marriage
แต่งตั้ง	tunjuk	giving a new title to
แต่งโดย	disusun oleh	composed by
แต่ใน	tapi di	but in
แต่ในปัจจุบัน	tapi sekarang	in the present
แต่ไม่ประสบความสำเร็จ	tetapi tanpa hasil	failed
แต่ไม่สำเร็จ	tetapi tidak berhasil	no success
แถบ	strip	flat fish
แทซิทัส	tasitus	tacitus
แทน	sebaliknya	instead
แทนเจนต์	bersinggungan	tangent
แทยอน	taeyeon	tae yon
แทลเลียม	talium	thallium
แท็กซี่	sebuah taksi	taxi
แท็บเล็ต	tablet	tablet computer
แนท	nat	nat
แนวความคิดที่	konsep	idea number...
แนวพระราชดำริ	inisiatif kerajaan	royal initiative
แนสแด็ก	nasdaq	nasdaq
แบคทีเรีย	bakteri	bacteria
แบงค์	bank	bank
แบทเทิลบรอลเลอร์	kapal tanker	battle brawlers
แบรนด์แอมบาสเดอร์	duta merek	brand ambassador
แบ่งประเทศไทยออกเป็น	bagilah thailand menjadi	dividing thailand into 6 areas
แบ่งออกเป็น	dibagi menjadi	divided into...
แบ่งออกได้เป็น	dibagi menjadi	divided into
แบ่งได้เป็น	dapat dibagi menjadi	divided into
แป้ง	tepung	pang
แผนที่	peta	map
แผนไพรีพินาศ	rencana konsorsium	pan pirepinat - a plan to destroy the mobs
แผลศักดิ์สิทธิ์	luka suci	stigmata
แผลไหม้	terbakar	burn
แพทย์	seorang dokter	physician
แพน	pan	pan
แพร่	phrae	the state of praa
แพลทฟอร์ม	platform	platform
แพะ	seekor kambing	goat
แพ้	kehilangan	to lose
แฟชั่น	fesyen	fashion
แฟนเก่า	mantan pacar	ex boyfriend/girlfriend
แฟมิลีที่ไปพักผ่อนที่เกาะมาเฟีย	keluarga pergi beristirahat di pulau mafia	family that went to mafia island for vacation
แฟรงค์	frank	frank
แฟรี่	peri	fairy
แฟรี่เทล	dongeng	fairy tale
แมกนีเซียม	magnesium	magnesium
แมคอินทอช	macintosh	mcintosh
แมนดาริน	mandarin	mandarin
แมนเชสเตอร์	manchester	manchester
แมว	kucing itu	cat
แมวป่า	kucing liar	jungle cat
แมวลายหินอ่อน	kucing marmer	pardofelis marmorata
แมวไทย	kucing thailand	thai cat
แม็คโคร	makro	macro
แม่	ibu	mother
แม่จริม	ibu jim	mae charim
แม่ชี	biarawati	nun
แม่นาคพระโขนง	mae nak phra khanong	mae nak phra khanong
แม่น้ำ	sungai	river
แม่น้ำชี	sungai chi	chee river
แม่น้ำทะเลสาบสำคัญ	sungai danau yang penting	important rivers and lakes
แม่น้ำปิง	sungai ping	ping rover
แม่น้ำโขง	sungai mekong	kong river from laos
แม่ริม	mae rim	amphoe mae rim
แยกจากคลองชักพระฝั่งซ้าย	pisahkan dari kanal chak phra di sebelah kiri	forks from khlong chak phra
แยกจากคลองบางกอกน้อยฝั่งซ้าย	dari kanal bangkok noi di sebelah kiri	forks from the left branch of khlong bangkok noi
แยกจากคลองบางกอกใหญ่ฝั่งขวา	persimpangan dari kanal bangkok yai di sebelah kanan	split from the bankok yai canal to the right
แยกจากคลองบางกอกใหญ่ฝั่งซ้าย	persimpangan dari kanal bangkok yai di sebelah kiri	forked from khlong bangkok yai
แย้มนาม	nama	yamnam - a surname
แย้มบุญเรือง	memilih untuk jasa	yaembunrueang
แรงโน้มถ่วง	gravitasi	gravity
แร็ปเปอร์	rapper	rapper
แลกเปลี่ยนโดยถือ	tukar dengan memegang	exchange, conversion
แลมบ์ดา	lambda	lampda
และ	dan	and
และกลายเป็นอู่ข้าวอู่น้ำที่มีชื่อเสียงของไทย	dan menjadi keranjang roti terkenal di thailand	and becoming the futile land
และกัมพูชา	dan kamboja	and cambodia
และครอบครัว	dan keluarga	and family
และคำว่า	dan kata itu	"and the word ""......."""
และจังหวัดใกล้เคียง	dan provinsi terdekat	and nearby state
และดุษฎีบัณฑิต	dan doktor filsafat	honorary degree
และตามสภาพเศรษฐกิจและสังคม	dan sesuai dengan kondisi ekonomi dan sosial	and following the economy and social conditions
และตำแหน่ง	dan posisi	and position
และที่สำคัญคือ	dan yang penting adalah	and important thing is...
และธงของต่างประเทศ	dan bendera asing	and other countries' flags
และปัจจุบัน	dan hadir	now
และพรรคฟุนซินเปค	dan pesta funchinpec	funcinpec
และรถไฟ	dan melatih	and railways
และรัสเซีย	dan rusia	and russia
และสหรัฐอเมริกา	dan amerika serikat	in america
และสังคม	dan masyarakat	and society
และสังคมศาสตร์	dan ilmu sosial	and social science
และสัตว์	dan binatang	and animal
และสโรชา	dan sarocha	and sarocha - a male's name
และหลังจากสงครามภายใน	dan setelah perang internal	after inside war
และออกซิเจน	dan oksigen	and oxygen
และอำเภอกันทรารมย์	dan distrik kanthararom	and kanthararom district
และอื่น	dan lainnya	etc.
และอเมริกาเหนือ	dan amerika utara	and north america
และเปียโน	dan piano	and piano
และเป็น	dan itu	is also
และเป็นสมาชิกราชวงศ์	dan adalah anggota keluarga kerajaan	in monarchs family
และเมืองเก่า	dan kota tua	old city
และเมื่อวันที่	dan terus	when date
และเรียกว่า	dan dipanggil	and call
และโลก	dan dunia	and earth
และในปี	dan di tahun ini	and in the year
และได้ปรากฏตัวตอนภาค	dan muncul di episode itu	appeared
แล้วเดินเวียนรอบปูชนียสถาน	kemudian berjalan di sekitar tempat kudus	walk with lighted candles in hand around a temple
แวน	van	wan
แสงจันทร์	cahaya bulan	saengchan
แสงชูโต	chuto	sangchuto - a surname
แสงทอง	sangthong	golden sun ray
แสงสิงแก้ว	sang singkaew	sangsingkaew
แสงเทียน	cahaya lilin	saengthian
แสตมป์	cap	stamp
แสนรัก	cinta	saenrak
แสนโภศิก	saen phosik	sankosuk - a surname
แหลมสิงห์	laem sing	lam sing - a famous country singer in thailand
แหล่งท่องเที่ยว	objek wisata	tourist attraction
แหล่งโบราณคดีบ้านเชียง	situs arkeologi ban chiang	ban chiang archaeological site
แหวน	sebuah cincin	ring
แหวนธรรมดา	cincin biasa	ordinary ring
แหวนมาเล่ริง	malele ring	ring (faux jewelry)
แห่งบันนัม	dari ban nam	of bannam
แห่งสหประชาชาติ	perserikatan bangsa-bangsa	of united nations
แองกวิลลา	anguilla	anguilla
แองเจิ้ล	malaikat	angel
แอซิด	asam	acid
แอด	tambah	add
แอนดรอยด์	android	android
แอนดี้	andy	andy
แอนด์	dan	and
แอนิเมชัน	animasi	animation
แอนเนลิดา	annelida	annelida phylum
แอนโทนี	anthony	anthony
แอฟริกา	afrika	africa
แอฟริกาใต้	afrika selatan	south africa
แอมะซอน	amazon	amazon
แอมเวย์	amway	amway
แอร์ไลน์	maskapai	airlines
แอล	l.	letter 'l'
แอลจีเรีย	aljazair	algeria
แอสกี	asci	ascii
แอสซิสต์	bantu	assist
แอสปาร์แตม	aspartame	aspartame
แฮช	hash	hash
แฮปปี้	senang	happy
แฮปปี้และชาร์ล	selamat dan charles	happy and charles
แฮ็ค	peretasan	hack
โกบอล	global	cobalt
โกร	tumbuh	guro
โกรกพระ	celah	krok-phra
โกลด์	emas	gold
โกวิท	kowit	kowit
โกโก้	kakao	cocoa
โขน	pantomim	khon
โคกสำโรง	khok samrong	koksamrong
โคนัน	conan	conan
โคฟี	kofi	kofe annan
โครงการ	proyek	project
โครงการก่อสร้าง	proyek konstruksi	project
โครงการนานาชาติ	proyek internasional	international program
โครงการศิลปินแห่งชาติ	proyek artis nasional	national artist campaign
โครงการเรียนภาษาอังกฤษแบบเข้ม	program pembelajaran bahasa inggris intensif	intensive english program
โครงสร้างภายใน	struktur internal	internal structure
โคราช	korat	khorat or nakorn rajjasrima state
โครโมโซม	kromosom	chromosome
โคล	cole	cold
โคลอมเบีย	kolombia	colombia
โคล้ด	kode	claude
โคเคน	kokain	cocain
โคเบะ	kobe	kobe
โคแทนเจนต์	cotangent	cotangent
โคโทเน่ที่	kotone di	kotone
โฆษะ	vokalisasi	kosa
โฆษิตพิพัฒน์	kosit phiphat	the surname kopitpipat
โจจิ	joji	choji
โจเซฟ	yusuf	joseph
โจโจ้	jojo	jojo
โช	cho	sho
โชคดี	semoga beruntung	lucky
โชว์	tampilkan	show
โชอิจิ	shoichi	shoichi
โชแปง	chopin	chopin
โซน	zone	zone
โซนยอชิแด	girls &#39;generation	senyosede - a japanese name
โซนี่	sony	sony company
โซล	seoul	seoul
โซลดิ๊ก	soldick	sol-dig
โซลโซไซตี้	masyarakat jiwa	soul society
โซเดียม	sodium	sodium
โซเฟีย	sofia	sofia
โดจินชิ	apakah jinchi	dōjinshi
โดย	oleh	by
โดยคำว่า	dari kata	by the word
โดยตรง	secara langsung	directly
โดยทรงพระกรุณาโปรดเกล้าฯ	diberikan dengan hormat oleh yang mulia	the king's order
โดยที่	dimana	by
โดยบ่งบอกถึงปริมาณและคุณภาพของสิ่งตีพิมพ์อิเล็กทรอนิกส์ของสถาบัน	dengan menunjukkan kuantitas dan kualitas publikasi elektronik institusi	stating the limitation and quality of a product
โดยปกติ	biasanya	regular, common, normalcy
โดยปกติตามวัดต่าง	biasanya menurut kuil yang berbeda	normally, at the various temples...
โดยปกติแล้ว	biasanya	usually
โดยมี	dengan	make available
โดยมีตัวอย่างบทพากย์ฉบัง	dengan contoh-contoh puisi	background movie in music video
โดยมีพระภิกษุสงฆ์นำเวียนเทียน	dengan seorang bhikkhu memimpin prosesi menyalakan lilin	buddhist monks performing ceremony for vientien buddhist religious holiday
โดยราชบัณฑิตยสถาน	oleh royal institute	by royal institute
โดยสรุป	singkatnya	in summary.
โดยเจ้าฟ้าธรรมธิเบศรไชยเชษฐสุริยวงศ์	oleh pangeran thamathibet sornchai chetchasuriyawong	the name of a king
โดยใช้ชื่อว่า	dengan nama	using name
โดยใช้ทางหลวงแผ่นดินหมายเลข	melalui jalan raya nasional	using freeway #________
โดยในวันที่	oleh pada	on the date of ___
โดราเอมอนฉบับภาพยนตร์	edisi film doraemon	doraemon movie
โดเมกิ	domome	domagi - a japanese word.
โดเมน	domain	domain
โต	tumbuh dewasa	big
โตชิบา	toshiba	toshiba
โทน	nada	tone
โทนะหงษา	tonahahasa	tonahongsa - a surname
โทนี่	tony	tony
โทบรามัยซิน	tobramamcin	tobramycin
โทมัส	thomas	thomas
โทรจัน	trojan	trojan
โทรลล์	troll	troll
โทริคาบูโตะ	torikabuto	torikabuto - a japanese word
โทรโข่ง	megafon	a megaphone, portable sound directing equipment.
โน	tidak	no
โนบิตะ	nobita	nobita
โนบิตะและอัศวินแดนวิหค	nobita dan ksatria	nobita and the winged braves
โนรา	nora	nora
โนะ	dino	noh - a japanese word
โนเบล	nobel	nobel prize
โบตั๋นกลีบสุดท้าย	peony terakhir	botun kleep suttai - a novel
โบราณสถาน	situs arkeologi	the ancient place
โบอิง	boeing	boeing company
โบฮีเมีย	bohemia	bohemia
โบแดง	luar biasa	bodin
โปงลางสะออน	ponglang sa-on	pong langsaoun
โปรดเกล้า	tolong	the king's order
โปรตอน	proton	proton
โปรตีน	protein	protein
โปรเจกต์	proyek	project
โปรเจกต์พิเศษ	proyek khusus	special project
โปรแกรมคอมพิวเตอร์	program komputer	computer programming
โปรโมชั่น	promosi	promotion
โปเกมอน	pokemon	pokemon, a very popular japanese anime.
โป๊	porno	nude
โพธิ์ศรี	phosri	phosi
โพนพิสัย	phon phisai	phonphisai
โพรทิสต์	protista	protist
โพแทสเซียม	kalium	potassium
โฟลต	mengapung	float
โฟลเอ็ม	flo m	phloem
โฟโตสเฟียร์	foto 360.	photosphere
โมซาร์ท	mozart	mozart
โมบิลสูทกันดั้ม	mobile suit gundam	mobile suit gundam
โมรา	kalsedon	agate
โมร็อกโก	maroko	morocco
โมลิบดีนัม	molibdenum	molybdenum
โมฮัมหมัด	mohammad	mohamad
โมเดิร์น	modern	modern
โมเต็ต	memotivasi	motet (sound)
โมเลกุล	molekul	molecule
โมโคนะ	mokona	mokona - a japanese word
โมโนไซต์	situs mono	mono site.
โยชิโนะ	yoshino	yoshino
โยฮันน์	johann	johann
โยเซฟ	yusuf	joseph
โรค	penyakit	disease
โรคประจำตัว	penyakit bawaan	personal illness
โรคปอดบวม	pneumonia	pneumonia
โรคออทิซึม	autisme	autism
โรคุโด	rokudo	rokudo
โรคเกาต์	gout	gout
โรคไต	penyakit ginjal	kidney disease
โรงพยาบาลกรุงเทพ	rumah sakit bangkok	krung thep hospital
โรงพยาบาลจุฬาลงกรณ์	rumah sakit king chulalongkorn memorial	king chulalongkorn memorial hospital
โรงพยาบาลรามาธิบดี	rumah sakit ramathibodi	ramathibodi hospital
โรงพยาบาลอานันทมหิดล	rumah sakit anandamahidol	ananthamahidol hospital
โรงพยาบาลอุตรดิตถ์	rumah sakit uttaradit	uttaradit hospital
โรงละคร	teater	theater
โรงเรียนการบิน	sekolah penerbangan	aviation school
โรงเรียนดาราวิทยาลัย	dara college	dara academy
โรงเรียนนนทรีวิทยา	sekolah nonsi witthaya	nontrivittaya school
โรงเรียนนายเรือ	akademi angkatan laut	royal thai naval academy
โรงเรียนนายเรืออากาศ	akademi angkatan udara kerajaan thailand	royal thai air force academy
โรงเรียนบดินทรเดชา	sekolah bodindecha	bodindecha school
โรงเรียนประชานิเวศน์	sekolah prachaniwet	prachanivet school
โรงเรียนปรินส์รอยแยลส์วิทยาลัย	universitas prince royal	the prince royal's college
โรงเรียนพระตำหนักสวนกุหลาบ	suan kularb tamnak school	the school in the king's compound.  it is reserved for the princess and the royal family
โรงเรียนมัธยมสาธิตวัดพระศรีมหาธาตุ	demonstrasi sekolah menengah wat phra si mahathat	wat phrasri mahadhat secondary demonstration school
โรงเรียนมารีวิทย์	sekolah mary wit	maryvit school
โรงเรียนยุพราชวิทยาลัย	sekolah yupparat wittayalai	yupparaj wittayalai school
โรงเรียนราชินีบน	sekolah ratu atas	rachinibon school in thailand
โรงเรียนวัฒโนทัยพายัพ	watthanothai payap school	vattanotaipayup school
โรงเรียนศึกษานารี	sekolah pendidikan naree	suksanari school
โรงเรียนสาธิต	sekolah demonstrasi	demonstration school
โรงเรียนสาธิตแห่งมหาวิทยาลัยเกษตรศาสตร์	sekolah demonstrasi universitas kasetsart	kasetsart university laboratory school
โรงเรียนห้องสอนศึกษา	ruang pengajaran sekolah	class room in school
โรงเรียนเขมะสิริอนุสสรณ์	khemasiri anusorn school	kamasirianussorn school
โรงเรียนเจ้าพระยาวิทยาคม	sekolah chao phraya witthayakhom	chao praya vitanakom school
โรงเรียนเฉลิมพระเกียรติสมเด็จพระศรีนครินทร์	chaloem phrakiat somdet phra srinagarindra school	srinagarindra the princress mother school
โรงเรียนเทศบาล	sekolah umum	public schools
โรงเรียนไตรมิตรวิทยาลัย	sekolah traimit wittayalai	trimittavitayalai school
โรงแรม	hotel	hotel
โรจูโร่	rojero	rojuro - a japanese character
โรตารี	rotary	rotary
โรม	roma	rome
โรมัน	romawi	roman
โรลเลอร์เบลด	roller blade	rollerblade
โรส	rose	rose
โรเจอร์	roger	"name ""roger"""
โลก	dunia	world
โลกแอมะซอน	amazon world	world of amazon
โลงหิน	sarkofagus	sarcophagus
โลโซ	loso	lasso
โสณกุล	sonakul	sonakul
โสน	sesbania	sa-nho, has yellow flower, use in thai sweet/desert
โสภณ	sophon	sophon
โหมด	mode	mode
โหม่ง	mengatasi	mong - a thai musical instrument
โอกาส	kesempatan	opportunities
โอบามา	obama	obama
โอภาส	senang	oh pas - a thai name
โอร์มาน	oman	oman - country
โอวีเอ	ova	ova
โอสถสภา	osotspa	osotspa
โอสถานุเคราะห์	osathanugrah	social service
โออิชิ	oishi	oochi - a name of food business in thailand
โอะกินะวะ	okinawa	okinawa
โอเค	ok	ok
โอเอกซ์	tic-tac-toe	ox - a game like tic tac toe
โฮม	rumah	"english word ""home"""
โฮลดิ้ง	memegang	houlding
ใจดี	baik hati	chaidi
ใช่	ya	yes
ใช้ขยายความเฉพาะบุคคล	gunakan untuk mempersonalisasi	to describe
ใช้ชื่อว่า	bernama	named
ใช้เวลา	luangkan waktu	it takes time
ใต้	selatan	south
ในกรณีนี้	dalam hal ini	in this isituation
ในกลุ่ม	dalam kelompok	in group
ในการประเมินผลงานวิจัยของสถาบัน	dalam mengevaluasi hasil penelitian lembaga	in research evaluating of institute
ในการเลือกตั้ง	dalam pemilihan	election
ในกาลต่อมา	di masa depan	later
ในขณะที่	sementara	while
ในคริสต์ศตวรรษที่	pada abad ke-19	in the #___ century
ในคศ	di tahun ini	in a.d.
ในชิงร้อยชิงล้าน	dalam jutaan ching ching	game show to compete for 1 million baht
ในช่วงปี	sepanjang tahun	in the year of ________
ในช่วงสงครามเย็น	selama perang dingin	during the cold war
ในช่วงสงครามโลกครั้งที่	selama perang dunia	in time of world war
ในช่วงสงครามโลกครั้งที่สอง	selama perang dunia kedua	during world war ii
ในช่วงหลัง	nanti	later
ในช่วงแรก	awalnya	in the first part, primarily
ในดาร์ฟูร์	di darfur	inside dafur
ในต่างประเทศ	di luar negeri	foreign countries
ในทางกลับกัน	di sisi lain	opposite
ในทางดาราศาสตร์	dalam astronomi	astrology
ในทางตรงกันข้าม	sebaliknya	oppositely
ในบางฉบับ	dalam beberapa edisi	in a certain issue (of a magazine)
ในประเทศญี่ปุ่น	di jepang	japan
ในปลายปี	di akhir tahun	at teh end of the year
ในปี	di tahun ini	in the year
ในปีที่	di tahun ini	in year
ในปีนี้	tahun ini	in this year
ในปีพศ	di tahun ini	in b.e. year
ในปีพุทธศักราช	di tahun ini.	in b.e.
ในปีเดียวกัน	di tahun yang sama	in the same year
ในปีเดียวกันนั้น	di tahun yang sama	in that year
ในพระบาทสมเด็จพระพุทธยอดฟ้าจุฬาโลก	pada masa pemerintahan raja buddha yodfa chula lok	under the reign of one of the thailand's past king
ในพระบาทสมเด็จพระพุทธเลิศหล้านภาลัย	dalam yang mulia raja, phra buddha lertlah, napalai	under one of the king of siam
ในภายหลัง	nanti	background
ในภาษาสันสกฤต	dalam bahasa sansekerta	in sanskrit language
ในภาษาอังกฤษ	dalam bahasa inggris	in english
ในภาษาอิตาลี่	dalam bahasa italia	in italian
ในภาษาไทย	di thailand	in the thai language
ในยุคกลาง	di abad pertengahan	in the middle ages
ในยุคแรก	awalnya	in early age
ในระบบสุริยะ	di tata surya	in the solar system
ในระยะหลัง	nanti	at the end
ในระหว่างปี	sepanjang tahun	between the years
ในระหว่างวันที่	siang hari	during the dates
ในรัชสมัยพระบาทสมเด็จพระจอมเกล้าเจ้าอยู่หัว	pada masa pemerintahan raja mongkut	in the reign of thailand's 4th king
ในรัฐบาล	di pemerintahan	in the government
ในฤดูกาล	musimnya	in season
ในสมัยกรุงศรีอยุธยา	pada periode ayutthaya	in  ayutthaya kingdom era
ในสมัยก่อน	dahulu kala	in the past
ในสมัยพุทธกาล	di era modern	in buddha era
ในสมัยรัชกาลที่	selama masa pemerintahan	in period
ในสหรัฐอเมริกา	di amerika serikat	in united states of america
ในหนังสือ	di dalam buku	in book
ในอดีต	di masa lalu	in the past
ในอดีตทุ่งกุลาร้องไห้ในฤดูแล้ง	di masa lalu, thung kula menangis di musim kemarau.	thung kula rong hai in dry season in the past
ในอัลบั้ม	di dalam album	in the album
ในเกมเดอะซิมส์	dalam game sims	sims game
ในเครือ	berafiliasi	in the area of
ในเดือน	dalam sebulan	in the month of ...
ในเดือนมิถุนายน	di bulan juni	in june
ในเดือนมีนาคม	berbaris	in april
ในเบื้องต้น	awalnya	primarily
ในเรื่อง	berkenaan dengan	in story
ในเหตุการณ์	dalam acara tersebut	in the event
ในเอเชียตะวันออกเฉียงใต้	di asia tenggara	in southeast asia.
ในแฮร์รี่	menyerobot	in harry
ในโอกาสครบรอบ	pada kesempatan ulang tahun	anniversary
ใบเสมา	battlements	boundary marker of a temple
ใหญ่	besar	large
ให้พลเอกเปรม	untuk jenderal prem	general prem - a former military figure
ให้สมเด็จพระเทพรัตนราชสุดาฯ	untuk hrh putri maha chakri sirindhorn	given to the thai's eldest princess
ให้เสียงพากย์	akting suara	dubbed
ให้แก่ประชาชน	kepada orang-orang	for the people
ให้ใช้หลัก	gunakan prinsip	large size
ไกรทอง	krai thong	krei thong - a surname
ไกรลาศ	krailat	krailard
ไกลกังวล	khawatir	klai kangwon
ไก่	seekor ayam	chicken
ไขมัน	gendut	lipid, fat
ไขสันหลัง	sumsum tulang belakang	spinal cord
ไข่	sebutir telur	egg
ไข้รากสาดใหญ่	tifus	typhus
ไข้สูง	demam tinggi	high fever
ไข้หวัดใหญ่สายพันธุ์ใหม่	strain baru influenza	new flu strain
ไข้หวัดใหญ่สเปน	flu spanyol	spanish flu
ไคเอ็น	kaien	kaien
ไชยกิตติ	chai kitti	chaikitti
ไชยยงค์	chaiyong	chaiyayong
ไชยวัฒน์	chaiwat	chaiwat
ไชยา	chaiya	chaiya
ไชโย	cheers	chaiyo
ไซน์	sinus	sine
ไซโทสเกเลตอน	zeitos gateela	cytoskeleton
ไซโปรเฮปตาดีน	sipro heptadine	cyproheptadine
ไดคลอกซาซิลลิน	daiklok sillin	dicloxacillin - a drug
ไดดาโนซีน	dinocene	didanosine - medication
ไดอาน่า	diana	diana
ไดโนเสาร์ของโนบิตะ	dinosaurus nobita	nobita's dinosaur
ได้	dapatkan	receive
ได้กล่าวว่า	kata	stating that, commenting on something
ได้ดังนี้	sebagai berikut	these
ได้ทูลเกล้าฯ	disajikan	report to the king
ได้มีโอกาสสร้างความสัมพันธ์อันดีต่อกัน	miliki kesempatan untuk membangun hubungan yang baik satu sama lain	good relationship
ได้รับ	dapatkan	received
ได้รับฉายาว่า	menerima julukan	recived the alias
ได้รับรางวัล	dapatkan penghargaan	awarded
ได้ร่วมกันในภารกิจในด้านต่าง	bersama dalam misi di berbagai bidang.	participated in activities
ได้สำเร็จ	berhasil	successfully
ได้สู้กับ	berjuang dengan	competing against
ได้เคลื่อนไหวตรวจสอบการทำงานของรัฐบาลกัมพูชาอย่างแข็งขัน	telah aktif bergerak untuk memeriksa pekerjaan pemerintah kamboja	underground investigation
ได้เป็น	menjadi	is
ไต	ginjal	kidney
ไต้หวัน	taiwan	taiwan
ไท	thailand	tai
ไทย	thailand	thai
ไทยทีวีสีช่อง	saluran tv berwarna thailand	thai tv
ไทยพรีเมียร์ลีก	liga premier thailand	thai premiere
ไทยรามา	thai rama	thairama
ไทยานนท์	thaiyanon	taiyanon - a thai surname
ไทรโลจี	trilogi	trilogy
ไทลื้อ	lue thailand	group of laotians that lives on flatlands
ไทโรซีน	tirosin	thyrosine
ไนท์	malam	sege
ไนลอน	nilon	nylon
ไนโตรเจน	nitrogen	nitrogen
ไปจนถึง	untuk	to
ไปบรรจบแม่น้ำเจ้าพระยา	temui sungai chao phraya	runs to chao phraya river
ไปรษณีย์กาฬสินธุ์	kantor pos kalasin	kalasin post office
ไปรษณีย์ฉะเชิงเทรา	kantor pos chachoengsao	cha cheng sao postal zone
ไปรษณีย์นครศรีธรรมราช	kantor pos nakhon si thammarat	nakornsritamarat postal station
ไปรษณีย์ภูเวียง	kantor pos phu wiang	pu weang postal office
ไปรษณีย์ยานนาวา	kantor pos yannawa	yan nawa post office
ไปรษณีย์ร้อยเอ็ด	kantor pos roi et	roi et post office
ไปรษณีย์สามเสนใน	kantor pos samsen nai	samsen nai post office
ไปรษณีย์หนองหาน	kantor pos nong han	nong han postal office
ไปรษณีย์อำนาจเจริญ	kantor pos amnat charoen	amnat charoen post office
ไปรษณีย์อุทุมพรพิสัย	kantor pos uthumphon phisai	utumporn pisai post office
ไปรษณีย์อุบลราชธานี	kantor pos ubon ratchathani	ubon ratchathani post office
ไปรษณีย์เดชอุดม	det kantor pos	det udom post office
ไปรษณีย์โพนพิสัย	kantor pos phon phisai	phon phisai post office
ไผ่แดง	bambu merah	red bamboo
ไพฑูรย์	lapis lazuli	phaithun
ไพรบึง	hutan	phrai bueng
ไพรวัลย์	praiwan	phraiwan
ไพศาล	lebar	phaisan
ไฟ	api itu	fire
ไฟนอลแฟนตาซี	final fantasy	final fantasy
ไฟร์วอลล์	firewall	firewall
ไมค์	mike	mike
ไมอามี่	miami	miami
ไมโครซอฟท์	microsoft	microsoft
ไม่ต่ำกว่า	tidak kurang dari	not lower than
ไม่ทราบข้อมูล	informasi tidak dikenal	no background information
ไม่บังคับ	opsional	not enforced
ไม่ผ่านเข้ารอบ	tidak berkualitas	did not make it to the next round, got eliminated in the initial round
ไม่มีบันทึกว่าใครเป็นคนสร้าง	tidak ada catatan tentang siapa yang membuatnya.	don't note who make id
ไม่มีแขน	tanpa senjata	armless
ไม่ว่าจะ	apakah	such as
ไม่สามารถทำการเกษตรได้	tidak bisa bertani	unable to practice agriculture
ไม่แตกกิ่ง	tidak bercabang	no chain
ไม่ใช่	tidak	no
ไม้	kayu	mai
ไม้กวาด	sapu	broom
ไม้หนีบผ้า	pasak pakaian	clip
ไม้ไม่ผลัดใบ	hijau abadi	plants that have leaves all year round
ไรงะ	riga	reiya - a character from a japanese story
ไรโบโซม	ribosome	ribosome
ไร่	peternakan	field, parcel
ไลท์	ringan	light
ไลบร้า	libra	libra
ไลฟ์สไตน์	lifstein	life style
ไลเบรชัน	perpustakaan	libration
ไวชาน่า	waichana	baishana - weapon in a japanese story
ไวทยางกูร	vittayangkun	wathaiyangkun
ไวทยานนท์	waithayanon	waithayanon
ไวท์สเปล	whitespell	white spell
ไวน์	anggur	wine
ไวยากรณ์	tata bahasa	waiyakorn
ไวรัส	virusnya	virus
ไวรัสตับอักเสบ	hepatitis	hepatitis
ไวเซิร์ด	weiss	vizard
ไวเปอร์	viper	viper
ไวเวิร์น	wvern	wyvern
ไวโอเลต	violet	violet
ไว้ว่า	katakan	as
ไหซอง	main mata	haisong
ไหมกัน	bersama	maigun - a surname
ไหลจากลาวเข้าสู่ภาคเหนือของกัมพูชาแล้วไหลผ่านเข้าเขตเวียดนาม	mengalir dari laos ke kamboja utara dan mengalir ke vietnam	flows from laos into northern cambodia
ไอทีวี	itv	itv
ไอน์สไตน์	einstein	einstein
ไอน์สไตเนียม	einsteinium	einsteinium
ไอพอด	ipod	ipod
ไอริส	iris	iris
ไอร์แลนด์เหนือ	irlandia utara	northern ireland
ไอเอ	ia	ia
ไอโมบาย	i-mobile	i-mobile
ไอโอ	io	io - from greek mythology
ไฮยาซินธ์	hyacinth	hyacinth
ไฮเดรนเยีย	hydrangea	hydrangea
ไฮเปอร์มาร์เก็ต	hypermarket	tesco lotus hypermarket chain
ไฮแจ็ค	dibajak	hijack
ไฮโดรเจน	hidrogen	hydrogen
๑๔	14	14
๑๕	15	15
๑๖	16	16
๑๘	18	18
๒๑	21	21
๒๒	22	22
๒๔๕๐	1907	2450
๒๕๐๒	1962	2502
๒๕๐๓	1963	2503
๒๕๒๓	1980	1980
๒๕๓๔	1991	2534
๒๕๓๕	1992	2535
๒๕๓๖	2536	2536 be (1993 ad)
๒๕๔๗	2004	2547
๒๕๔๘	2005	2548
๒๕๕๐	2007	2550
๒๕๕๔	2011	2554
๒๗	27	27
๒๘	28	28
๓	3	3
๔๘	48	48
๕	5	5
๖๐	60	60
๙	9	nine
ព្រះរាជាណាចក្រកម្ពុជា	ព្រះរាជាណាចក្រ កម្ពុជា	cambodia
疾風伝	疾風 伝	not in thai - cannot translate
