+	+	plus sign
=	=	equal to
 °ซ  °ฟ 	° c ° f.	เซลเซียส ฟาเรนไฮต์
 ซม	cm	cm.
 −°ซ  °ฟ	- ° c ° f.	thai letters
×	×	letter x
γ	γ	y
π	π	pi
กกกก	kg	a thai letter repeated 4 times
กกกข	khor khor	4 thai alphabets - jibberish
กขขข	abc b	4 of thai letters
กขขขขขขข	a b a b b b a	abbbbbbb
กฎ	y rheolau	law, rule
กฎของโคไซน์	cyfraith cosin	law of cosines
กฎแห่งกรรม	karma	bad karma
กติกา	rheol	rule
กทม	bangkok	agency
กนู	marchog	gnu - computer related acronym
กบ	broga	frog
กบฏทหารนอกราชการ	gwrthryfel milwrol	coup de lat
กมล	lili	kamon
กมลรัตน์	kamonrat	kamolrat - a surname
กรณีที่	yr achos	case
กรมขุนอิศเรศรังสรรค์	krom khun iset rangsan	the convention of angels
กรมขุนเพ็ชรบูรณ์อินทราชัย	kromkhunpetchaboon-indachai	department of....
กรมข่าวทหารอากาศ	newyddion adran y llu awyr	communication department of the thai air force
กรมควบคุมโรค	adran rheoli clefydau	department of disease control
กรมทหารราบที่	catrawd y troedfilwyr	infantry regiment
กรมรบพิเศษที่	yr adran brwydro yn erbyn arbennig	special force group
กรมศิลปากร	adran y celfyddydau cain	fine arts department
กรมหลวงนราธิวาสราชนครินทร์	krom luang narathiwatratchanakharin	krom ma loung naratifatrachanakarin - the name of a royal family member
กรมหลวงสงขลานครินทร์	kromluang songkhla nakarin	prince of songkla
กรมอุตุนิยมวิทยา	adran feteorolegol	the meteorology department
กรรชัย	kanchai	kanchai
กรอง	hidlo	screen
กระดูกค้อน	asgwrn morthwyl	malleus, hammer bone
กระดูกต้นแขน	humerus	humerus
กระดูกฝ่ามือ	palms	metacapus
กระดูกสะบัก	scapula	scapula
กระดูกสะบ้า	patella	kneecap
กระทรวงกลาโหม	y weinyddiaeth amddiffyn	defense ministry
กระทรวงการคลัง	y weinyddiaeth gyllid	ministry of finance
กระทรวงการต่างประเทศ	y weinyddiaeth materion tramor	ministry of foreign affairs
กระทรวงวัฒนธรรม	gweinidogaeth diwylliant	ministry of culture
กระทรวงศึกษาธิการ	y weinyddiaeth addysg	ministry of education
กระทรวงสาธารณสุข	y weinyddiaeth iechyd cyhoeddus	ministry of public health
กระทรวงอุตสาหกรรม	y weinyddiaeth ddiwydiant	ministry of industry
กระทรวงเกษตรและสหกรณ์	y weinyddiaeth amaeth a chydweithfeydd	ministry of agriculture and cooperatives
กระทรวงเศรษฐการ	y weinyddiaeth materion economaidd	ministry of commerce
กระทุ่มแบน	basged fach	krathum baen district, samut songkram province
กระนวน	cae	granuan - location in knon kan province
กระนั้น	serch hynny	however
กระบวนการสร้าง	proses adeiladu	anabolism
กระบวนการสร้างและสลาย	y broses o greu a chwalu	metabolism
กระบอง	blackjack	club
กระบะทราย	blwch tywod	litter box or sand box
กระบี่กระบอง	cleddyf	krabi krabong (swordplay)
กระรอก	gwiwer	squirrel
กระวนกระวาย	pryderus	nervous
กระหม่อม	fontanel	fontanelle
กระเพาะอาหาร	stumog	stomach
กระแต	chipmunk	wasp
กรับ	codwch	wooden rhythm clappers
กรับพวง	dewiswch griw	krap phuang
กรับเสภา	krapao	wooden rhythm clappers
กรัม	grams	gram
กรัยวิเชียร	kraiwichian	krivician - a surname
กรานาดา	granada	granada
กริม	grimm	grim
กรี	llwyd	karee
กรุง	dinas	city
กรุงธนบุรี	krung thon buri	thonburi city
กรุงลอนดอน	llundain	london
กรุงศรีอยุธยา	ayutthaya	sri ayuttaya city - former capital of thailand
กรุงเทพ	bangkok	bangkok
กรุงเทพเชียงใหม่กรุงเทพ	bangkok, chiang mai, bangkok	bangkok changmai bangkok
กรุงเทพโพลล์	pleidlais bangkok	bangkok poll
กรุ๊ป	grŵp	group
กลอง	y drwm	drum
กลองมโหระทึก	drwm mawr	big drum
กลองยาว	drwm	tom-tom
กลองสองหน้า	drwm dwy ochr	glong songna
กลอน	adnod	poem
กลอบูลิน	sgleiniog	globulin
กลาง	y canol	in the middle
กลิ่น	yr arogl	odor
กลุ่มดาวกล้องจุลทรรศน์	cytserau microsgopau	microscopium
กลุ่มดาวนกทูแคน	toucan	tucana
กลุ่มดาวสิ่ว	chisel	siu star
กลุ่มดาวเข็มทิศ	cwmpawd cytser	pyxis constellation
กลุ่มดาวเตาหลอม	ffwrnais chwyth	fornax
กลุ่มดาวแมงป่อง	scorpion	scorpion constellation
กลุ่มดาวแมลงวัน	clêr	musca
กลุ่มที่	y grwp	group
กลุ่มแสงอุษา	grŵp golau usa	light at dawn
กลูคากอน	glucon	glucagon
กล่าวคือ	hynny yw	that is
กล้วยไม้ดาว	tegeirian seren	type of orchid that have slim petal like star
กล้องถ่ายภาพ	camera	camera
กล้ามเนื้อ	cyhyrau	muscle
กวม	guam	obscure
กวาง	y ceirw	deer
กวิน	kawin	gwen - a name
กวี	y bardd	poet
กว่า	na	than
กองกลาง	chwaraewr canol cae	headquarter
กองการบินทหารเรือ	adran hedfan y llynges	the flying section of the navy
กองการศึกษา	yr is-adran addysg	education group
กองการเจ้าหน้าที่	is-adran personél	division of personnel
กองกำลังกึ่งทหาร	lluoedd lled-filwrol	armforces
กองคลัง	yr is-adran gyllid	division of finance
กองทัพ	y fyddin	arm forces
กองทัพบกไทย	byddin gwlad thai	thai army
กองทัพภาคที่	byddin y rhanbarth	army area
กองทัพเรือ	llynges	navy
กองทัพเรือไทย	llynges gwlad thai	the royal thai navy
กองทัพแห่งความชอบธรรม	byddin cyfiawnder	army of the righteous
กองทัพไทย	byddin gwlad thai	thai military forces
กองบิน	llu awyr	air force
กองบินปีกหมุนที่	adain nyddu adain	flight corp number __________
กองพลทหารม้าที่	y frigâd marchfilwyr	cavalry division
กองพันทหารช่างที่	brigâd y peiriannydd	troop unit number ___________`
กอด	cwtsh	kord
กอนซาเลซ	gonzalez	gonzales - a name
กอร์ดอน	gordon	gordon
กอลมเบต์	goreme	glombet - a catholic priest
กอล์ฟ	golff	golf
กอล์ฟไมค์	mic golff	golf-mike
กะเหรี่ยง	karen	karen
กะโหลก	y benglog	skull
กะโหลกศีรษะ	penglog	skull; cranium
กังหันชัยพัฒนา	tyrbin chaipattana	chaipattana's windmill
กันดั้ม	gundam	gundam - a cartoon
กันตัง	kantang	kuntun in trung state
กันทรลักษ์	kantharalak	kuntaraluk - an area in thailand
กันฟอร์ม	ffurflen	gun form
กันอริ	dedwydd	gan-ari
กันเอง	yn gyfeillgar	casual
กับนางสุจาริณี	gyda mrs. sucharinee	with mrs. sujarinee
กัมปูเชีย	kampuchia	kampuchea
กัมพูชา	cambodia	cambodia
กัมพูชาประชาธิปไตย	cambodia democrataidd	democratic kampuchea
กัมพูชาเป็นประเทศที่มีป่าไม้อุดมสมบูรณ์มากที่สุดหากเปรียบเทียบกับประเทศเพื่อนบ้าน	cambodia yw&#39;r wlad sydd â&#39;r coedwigoedd mwyaf niferus o&#39;i chymharu â gwledydd cyfagos.	cambodia is the country with nice, healthy forests
กัมพูชาเป็นอดีตประเทศอาณานิคมของฝรั่งเศสในภูมิภาคเอเชียตะวันออกเฉียงใต้เพียงแค่ประเทศเดียวเท่านั้นที่มีการปกครองด้วยระบอบราชาธิปไตยภายใต้รัฐธรรมนูญ	cambodia yw&#39;r unig hen wlad drefedigaethol yn ffrainc yn ne-ddwyrain asia sydd â brenhiniaeth o dan y cyfansoddiad.	cambodia was a former french colony
กัมพูชาเป็นอาณานิคมของฝรั่งเศสมาตั้งแต่พศ	mae cambodia wedi bod yn wladfa ffrengig ers hynny.	cambodia was a france colony from year
กัวเตมาลา	guatemala	guatemala
กานซู	gansu	honshu in china
กานต์	kan	kan
กานา	ghana	ghana
กานามัยซิน	kanamycin	kanamycin
กาบอง	gabon	baton
กาพย์ฉบัง	cerdd epig	poem
กาพย์สุรางคนางค์	cerdd	gabsuranknang
กาม	wanton	lust
กาย	y corff	body
การ	mae&#39;r	project
การกีฬา	chwaraeon	sport
การขัดเกลาทางสังคม	cymdeithasoli	socialization
การขับถ่าย	eithriad	excretion
การขับไล่	diarddel	discharge
การคมนาคม	cludiant	transportation department
การคลัง	cyllid	public finance
การค้นพบ	y darganfyddiad	discover
การค้า	y fasnach	marketing
การจัดการ	y rheolwyr	project
การจัดการคุณภาพ	rheoli ansawdd	quality control
การจัดอันดับ	safle	ranking
การจัดให้มี	darpariaeth	putting together something
การจูบ	cusan	kissing
การชัก	atafaelu	the act of pulling the flag wiht string up the pole
การดำเนินการ	gweithrediad	progression
การตอบรับ	adborth	welcoming
การตั้งถิ่นฐาน	setliad	start a project
การต่างประเทศ	materion tramor	foreign affairs
การทำงานของ	gwaith	function
การทำป่าไม้	coedwigaeth	forestry
การท่องเที่ยว	y dwristiaeth	tourism
การท่าเรือ	awdurdod porthladdoedd	port authority
การบริการ	gwasanaeth	customer service
การบริหารการพัฒนา	rheoli datblygu	development
การบริหารการศึกษา	gweinyddiaeth addysgol	educational administration
การบริหารจัดการ	rheoli	management
การบริหารราชการแผ่นดิน	gweinyddiaeth y llywodraeth	administration
การบินไทย	airways thai	thai airways
การปกครองท้องถิ่น	llywodraeth leol	local administration
การปกครองส่วนท้องถิ่น	llywodraeth leol	local government
การปกครองแบ่งออกเป็น	rhennir y rheol yn	administration
การปฏิรูประบบจัดเก็บภาษีเงินได้	diwygio&#39;r system casglu treth incwm	taxation reform
การปฏิรูปศาสนา	diwygiad	religious reformation
การปฏิวัติฝรั่งเศส	chwyldro ffrengig	french revolution
การปฏิวัติอุตสาหกรรม	chwyldro diwydiannol	industrial revolution
การปฏิสนธิ	ffrwythloni	fertilisation
การประมง	pysgodfeydd	fishery
การพัฒนา	y datblygiad	development
การพัฒนาประชาธิปไตย	datblygiad democrataidd	democratic development
การพูด	siarad	speaking
การยึดครองมะละกาของโปรตุเกสในปี	galwedigaeth portiwgaleg o melaka yn y flwyddyn	portugal took over malaga
การระบาดของไข้หวัดใหญ่สายพันธุ์ใหม่	y straen newydd o&#39;r ffliw	flu pandemic
การรักษาพยาบาล	triniaeth feddygol	nursing care
การร่วมเพศทางทวารหนัก	ffycin rhefrol	sodomy
การลดรูป	anffurfio	reduction
การละเล่นพื้นบ้าน	gemau gwerin	local game
การวิจัย	ymchwil	researching
การวิเคราะห์	y dadansoddiad	analysis
การศึกษา	yr addysg	study of, education
การสังคายนาครั้งที่	y gorchymyn olaf	the event of convention of monks
การสั่นพ้อง	cyseiniant	resonance
การสำเร็จความใคร่ด้วยตนเอง	masturbation	masturbation
การสืบพันธุ์	atgynhyrchu	reproduction
การสื่อสาร	cyfathrebu	communications
การาจ	garej	garage
การุณ	karun	karoon
การเต้นรำ	y ddawns	dance
การเพิ่มสิทธิประโยชน์แก่นักลงทุนต่างประเทศ	breintiau cynyddol i fuddsoddwyr tramor	increase benefits for foreign investors
การเล่น	i chwarae	play
การแข่งขัน	y gystadleuaeth	competition
การแบ่งพื้นที่	rhaniad	land division
การใช้คำ	defnydd geiriau	terminology
การไฟฟ้าส่วนภูมิภาค	awdurdod trydan taleithiol	distribution electric transformer
การไหว้	parch	thai greeting
การ์ด	cerdyn	guard
กาฬสินธุ์	kalasin	katsin - a thai surname
กาเวน	gawain	gawain
กาเหว่าที่บางเพลง	cigfran rhai caneuon	the cuckoo's song.
กำกับการแสดงโดย	cyfarwyddwyd gan	produced by (movie)
กำกับโดยอภิชาติพงศ์	cyfarwyddwyd gan aphichat pong	produced by apichartpong - a famous thai movie producer
กำมะถัน	sylffwr	sulfur
กำลังจะปรับเปลี่ยนเป็น	mynd i newid i	is changing to
กำหนดตามสภาพภูมิศาสตร์	wedi&#39;i bennu gan ddaearyddiaeth	geography estimation
กำแพงเพชร	kamphaeng phet	kamphaeng phet
กำแพงเมืองจีน	y wal fawr	the great wall of china
กำแพงแสน	kamphaengsaen	kampangsaen (name of district)
กิจผลิต	cynhyrchu	kitpalit (last name)
กิมป์	gimb	gimp - gnu image manipulation program
กิโลกรัม	cilogram	kilogram
กิโลไบต์	kb	kilobyte
กิ่งแก้ว	kingkaew	kingkaeo
กิ้งกือ	millipede	millipedes
กิ๊ก	kik	gig
กีฏวิทยา	entomoleg	entomology
กีฬา	y gamp	sports
กีฬาทางน้ำ	chwaraeon dŵr	water sports
กีฬาแหลมทอง	chwaraeon laem thong	seap games
กุดจับ	yr wyddgrug	good jub - a place
กุลดิลก	kuldilok	kuldilok
กุลละวณิชย์	kulalawanit	kullawanich
กุหลาบ	rhosyn	kularb (first name)
กุ้ง	berdys	shrimp
กุ้งต้ม	berdys wedi&#39;i ferwi	boiled shrimp
กูเกิล	google	google
ก็คือ	is	which is
ก็ใช้เป็น	defnyddir fel	utilize
ก่อตั้ง	sefydlwyd	founded
ก่อตั้งโดย	sefydlwyd gan	make by
ก่อนที่	cyn	before
ก่อนที่จะตกเป็นของฝรั่งเศสในเวลาต่อมา	cyn dod yn ffrainc yn ddiweddarach	belonging to france, under the control of france
ก่อนหน้านั้น	cyn hynny	before
ก้อย	pinc	koi
ก้าน	y coesyn	thorn
ก้านกล้วย	coesyn banana	kankluai
ก๊าซธรรมชาติ	nwy naturiol	natural gas
ก๎ล	rhodd	magic
ขขขขขขขขขข	b b b b b b b	repeated letter from thai alphabet
ขณะทรงพระเยาว์	tra oedd yn ifanc	having to do with the young prince or princess
ขณะที่	tra	while
ขนม	y pwdin	dessert
ขนมกล้วย	banana	banana dessert
ขนมครก	knmcrk	kind of thai sweetmeat
ขนมปัง	bara	bread
ขนมปังขิง	bara sinsir	gingerbread
ขนมเปียกปูน	rhombus	a type of thai dessert with flour and sugar
ขนมไทย	pwdin thai	thai dessert
ขนสัตว์	gwlân	fur, animal hair
ขนอม	khanom	kanom - location in thailand
ขนาดหน้าตัก	maint lap	length between both knees of buddha statue in posture of meditation
ขนาดใหญ่	maint mawr	l
ขบวนการอ๊บอ๊บป่วนโลก	symudiad y ddaear	original name is keroro gunso
ขบวนรถสินค้า	trên	caravan of trucks
ขม	chwerw	bitter taste
ขรรค์ชัย	khan chai	kanchai - a male's name
ขลุ่ยหลิบ	ffliwt	khlui lib
ขวด	potel	bottle
ขวัญ	morâl	morale
ขวัญใจช่างภาพ	ffotograffydd annwyl	miss photogenic
ขสมก	offeren	an acronym consists of four thai letters
ของ	of	of
ของทุกปี	bob blwyddyn	every year
ของประเทศจีน	o lestri	owned by china
ของมหาวิทยาลัย	o&#39;r brifysgol	of university
ของมัน	mae ei	their
ของร่างกาย	o gorff	of the body
ของสมเด็จฮุน	o somdej hun	houssaine of cambodia
ของสิ่งมีชีวิต	o bethau byw	living things
ของสุนทรภู่	of sunthorn phu	belong to soon thong pu (a thai legend)
ของเหลว	hylif	liquid
ของโลก	o&#39;r byd	of world
ขอนแก่น	khon kaen	khon kan - an area in thailand
ขอบคุณที่รักกัน	diolch am fy ngharu i	thank you for loving each other
ขอเช็ดน้ำตา	gadewch i ni sychu&#39;r dagrau	wipe the tears
ขอให้เด็กสมัยปฏิวัติของข้าพเจ้า	boed fy mhlant chwyldroadol	i hope that the children in my lifetime will ____________
ขั้นที่	cam	level
ขา	y coesau	leg
ขาย	i werthu	sell
ขิง	sinsir	ginger
ขิม	dulcimer	kim - a thai musical instrument
ขีดเส้นใต้	tanlinellwch	underline
ขี้ผึ้ง	cwyr	wax
ขึ้นเป็น	hyd at	to
ขึ้นไป	i fyny	next one up
ขุขันธิน	tin khan	kukuntin
ขุนหาญ	han	koonhan - a location in thailand
ข้อมูลทั่วไป	gwybodaeth gyffredinol	general information
ข้อมูลประเทศเดนมาร์ก	gwybodaeth denmarc	information on denmark
ข้อมูลปรากฏการณ์โลกร้อน	ffenomen cynhesu byd-eang	global climate change
ข้อมูลปี	data blwyddyn	information from the year ________
ข้อมูลอื่นๆ	gwybodaeth arall	other information
ข้อมูลโดย	data gan	information from
ข้อวิพากษ์วิจารณ์	beirniadaeth	critique reports
ข้ามฉาก	ar draws yr olygfa	sin(a)
ข้าวสาลี	gwenith	wheat
ข้าวหลาม	khao lam	bamboo rice
ข้าวเกรียบปากหม้อ	cracwyr reis	a thai snack
ข้าวเจ้า	reis	white rice
ข้าวโพด	corn	corn
ข้าหลวงกำกับราชการเมืองขุขันธ์คนที่	llywodraethwr, llywodraethwr dinas khukhan	government worker for ku khan city
ฃ	ฃ	a letter from thai alphabet
คงยิ่ง	tebygol iawn	kongying
คงเจริญ	ffynnu yn ôl pob tebyg	khongcharoen
คณะครุศาสตร์	cyfadran addysg	education department
คณะครุศาสตร์อุตสาหกรรม	cyfadran addysg ddiwydiannol	faculty of industrial education
คณะที่	cyfadran yn	the current administration
คณะบัญชี	cyfadran cyfrifeg	accounting department (major)
คณะปฏิรูปการปกครองแผ่นดิน	pwyllgor chwyldroadol	national administrative reform council
คณะประมง	cyfadran pysgodfeydd	fishery division of the college of farming and agriculture
คณะพยาบาลศาสตร์	cyfadran nyrsio	nursing department
คณะมนุษย์ศาสตร์และสังคมศาสตร์	cyfadran y dyniaethau a&#39;r gwyddorau cymdeithasol	humanity department
คณะรัฐมนตรีคณะที่	cabinet	council of ministers
คณะวิทยาการจัดการ	cyfadran gwyddoniaeth rheolaeth	management department
คณะวิศวกรรมศาสตร์	cyfadran peirianneg	engineering department
คณะศิลปกรรมศาสตร์	cyfadran y celfyddydau cain	faculty of fine arts
คณะสถาปัตยกรรมศาสตร์	cyfadran pensaernïaeth	faculty of architecture
คณะสหเวชศาสตร์	cyfadran y gwyddorau iechyd perthynol	อังกฤษ   faculty of allied health science
คณะสาธารณสุขศาสตร์	cyfadran iechyd y cyhoedd	faculty of public health
คณะเกษตร	cyfadran amaeth	faculty of agriculture
คณะแพทยศาสตร์ศิริราชพยาบาล	cyfadran meddygaeth ysbyty siriraj	faculty of medicine siriraj hospital
คณะแพทยศาสตร์โรงพยาบาลรามาธิบดี	cyfadran meddygaeth, ysbyty ramathibodi	the staff of ramatippadee hospital
คณารศ	kanara	kanaros - a surname
คนที่	y person sydd	person number __________________________
คนที่ไปช่วยรุ่นที่	y bobl a aeth i helpu&#39;r genhedlaeth	volunteer group number __________
คนแคระ	corrach	dwarf
คนแรก	person cyntaf	first
คปค	blwyddyn	3 thai letters
คม	sharp	sharp
ครอคโคไดล์	crocodeil	crocodile
ครอบครัว	y teulu	family
ครั้งหนึ่ง	un tro	once upon a time
คราประยูร	prayun	karaprayoon - a thai surname
คราม	indigo	indigo
คริส	chris	christ
คริสตี	christi	christie - a female name
คริสต์ศาสนา	cristnogaeth	christainity
ครุฑ	garuda	garuda
ครู	yr athro	teacher
ครูพิเศษจอมป่วน	athro trolio	kru pisat jom poun  - name of a story
คลอง	camlas	canal
คลองสาน	khlong san	klongsan
คลองเตย	khlong toei	klongtoei
คลับ	y clwb	club
คลาวิคอร์ด	dosbarth	clavichord
คลิก	cliciwch	click
คลินิก	clinig	clinic
คลิป	clip	clip
คลื่นสึนามิ	tsunami	tsunami wave
ควอน	kwon	kwon - a surname of a korean singer
ควอร์เตอร์	chwarter	quarter
ความกว้าง	lled	width
ความงาม	yr harddwch	beauty
ความจำ	y cof	memory
ความต่างศักย์	gwahaniaeth posib	potential difference in physics
ความถี่	yr amledd	frequencies
ความนิยม	poblogrwydd	popular
ความบริสุทธิ์	purdeb	purity
ความฝันอันสูงสุด	y freuddwyd yn y pen draw	the impossible dream
ความพอประมาณ	gwyleidd-dra	estimate
ความยากจน	tlodi	poverty
ความยาว	y hyd	length
ความยาวคลื่น	tonfedd	frequencies
ความยาวช่วงคลื่น	hyd y don	wave length
ความยาวเพลง	hyd y gân	the length of the song
ความรัก	cariad	love
ความรู้	y wybodaeth	knowledge
ความสว่าง	disgleirdeb	illumination
ความสัมพันธ์กับประเทศไทย	cysylltiadau â gwlad thai	relationship with thailand
ความสัมพันธ์ระหว่างจีนกับอเมริกา	cysylltiadau rhwng china ac america	relationship with china and the usa
ความสูง	yr uchder	height
ความส่องสว่าง	disgleirdeb	luminance
ความหนาแน่นของประชากร	dwysedd poblogaeth	population density
ความหมาย	yr ystyr	meaning
ความหมายโดยพยัญชนะ	ystyr cytsain	definition that derived from translation from another language
ความเข้มของการส่องสว่าง	dwysedd llewychol	luminous intensity
ความเข้าใจ	deall	understanding
ความเร่ง	cyflymiad	acceleration
ความโกรธ	dicter	anger
ความโน้มถ่วง	disgyrchiant	gravity
ควินโต	quinto	quinto
ควีนซี่	frenhines	quincy
คอ	y gwddf	neck
คอนสตรัคชั่น	adeiladu	construction
คอนเวนชัน	confensiynau	convention
คอนเสิร์ตประสานเสียงสามสถาบัน	cyngerdd côr tri sefydliad	chulalongkorn kasetsart thammasat choral concert
คอมพิวเตอร์ยุคที่	oes gyfrifiadurol	_-generation computer (as in frist generation, second generation etc)
คอร์ด	cordiau	chord
คอลลิงวูด	callingwood	collingwood
คอสตาริกา	costa rica	costa rica
คัง	kang	kan
คัชชินสกี	kutchinski	kaczyński
คัญทัพ	byddin bwysig	main army.
คัทลียา	cattleya	kathaleeya (thai first name)
คันธวงศ์	kanthavong	kunntavong - a surname
คัพ	cwpan	cup
คัมภีร์	ysgrythur	bible
คั่ว	rhost	dry roasting
คาคาชิ	kakashi	cacashi
คางาริ	kagari	kagari
คาซัคสถาน	kazakhstan	kazakhstan
คาถาอัญเชิญ	gwareiddiad	a magic spell
คาบ	cyfnod	frequency
คาบัคโรเน่	kabakhroone	kyabarrone
คาบูโตะ	kabuto	kabuto
คาปูชิโน่	cappuccino	cappuccino
คามิว	kamui	camus
คาราคุระ	karakura	karakura
คาร์ล	carl	karl
คาวทอง	fishyong	lizard tail
คาเมนไรเดอร์	marchog kamen	kamen rider
คาโรลัส	carolas	carolus linnaeus
คำขวัญวันเด็ก	slogan diwrnod y plant	quote for kids day
คำถามข้อที่	rhif cwestiwn	the question number_________
คำนวณ	i gyfrifo	calculate
คำนาม	enw	noun
คำพ้องรูป	cyfystyron	hemonym
คำมั่นสัญญา	addewid	agreement
คำม่วง	kham muang	kham muang
คำวิลัยศักดิ์	kamwilai sak	important words, magic words
คำศัพท์	geirfa	word
คำสรรพนาม	rhagenw	pronoun
คำสร้อย	gair	kumsoi - a country singer
คำสุดท้ายของวรรคที่	gair olaf y paragraff	the last word (in a poem)
คำสุภาพ	gwrtais	formal
คำอธิบาย	y disgrifiad	explanation
คำเมือง	gair y ddinas	kum meuong - a location in chiang mai
คำแปล	cyfieithiad	translation
คิง	brenin	king
คิงส์	brenhinoedd	kings
คิงส์คัพ	cwpan y brenin	king's cup
คิงไลเนอร์	kingliner	kingliner
คิชิเนีย	kishinya	kishinia
คิด	meddyliwch	thinking
คินนิคุแมน	kinnikuman	kinkiku man
คิมิฮิโระ	kimihiro	kimihiro
คิระ	kira	kira - japanese name
คิเคียว	kikyo	kikyo
คีตกวี	cyfansoddwr	composer
คือประมาณ	yn ymwneud	estimated to be
คือเพลง	yn gân	is the song
คุณ	chi	you
คุณครูจอมเวท	yr athro dewin	magister
คุณปลื้ม	khun pluem	kunpleam
คุณหญิงโม	empress mo.	suranaree
คุณากร	chi	khunakon
คุราปิก้า	kurapika	kurapika
คุโรซึจิ	kurotsuji	kurochiji - a japanese word
คุ้มค่า	gwerth da	worth the money spent on
คูกิมิยะ	kukimiya	kugimiya
คูคาคุ	kuku	kukaku (japanese last name)
คูเรียม	curiwm	"chemical element ""curium"""
คูเวต	kuwait	kuwait
คู่กรรม	partner	soul mate
ค่าความต้านทานตัวที่	mae&#39;r gwrthiant yn gwerthfawrogi hynny	resistance value of the
ค่าจีดีพี	cmc	gdp - an economics term
ค่าใช้จ่าย	y gost	expense
ค่ำแล้ว	cyfnos	getting dark, at dusk
ค้างคาว	yr ystlum	bat
ฆ	juan	a letter from thai alphabet
ฆ้อง	gong	gong
ฆ้องวงใหญ่	gong fawr	a group of thai drum music
งดส่งเข้าประกวด	dim mynediad	enroll in the contest
งาน	y swydd	work, job
งานอดิเรก	hobïau	hobby
งานเขียน	ysgrifau	writing, composition work
งานเทางามสัมพันธ์	perthynas tao ngam	public party
งานโมเสก	mosaig	mosaic
งามวงศ์วาน	ngamwongwan	ngamwongwan
งู	y neidr	snake
งูอนาคอนดา	anaconda	anaconda snake
จดหมายอากาศ	post awyr	aerogram
จตรัง	trang	trang province (name of province in thailand)
จตุรงค์	chatuchak	jaturong - a surname of a comedian
จนกระทั่ง	tan	until
จนกระทั่งปี	tan y flwyddyn	until the year
จนกระทั่งเมื่อปี	tan y llynedd	until the year
จนครปฐม	pathom nakhon	nakorn pratom state
จนมีคำกล่าวว่า	hyd nes y dywedwyd hynny	said
จน่าน	llun	nan state
จบุรีรัมย์	buriram	burerum state
จมูก	y trwyn	nose
จระเข้และแอลลิเกเตอร์	crocodeil ac alligator	crocodile and alligator
จรัญญา	charanya	jarunya - a surname
จริยธรรม	moeseg	ethics
จริยศาสตร์	moeseg	ethics
จริยา	arglwyddes	jariya
จลำพูน	lamphun	jalumpoon - a place in thailand
จสตูล	satun	stoul state
จสุราษฎร์ธานี	surat thani	surat thani province
จอมบึง	chwyddedig	chom bueng
จอมพลถนอม	than phon thanom	field marshal thanom
จอมพลสฤษดิ์	sarit maes maes	field marshal sarit
จอมพลเรือ	marsial llong	the general of the navy
จอมเทียน	jomtien	jom tien - a location in thailand
จอร์เจีย	georgia	georgia
จะต้องหาตัวแทนลงจากเวที	rhaid dod o hyd i gynrychiolydd i ddod oddi ar y llwyfan	find a teammate to leave the stage, a unique game
จะเขียนว่า	bydd yn ysgrifennu	written as
จะเข้	zither	jakhe
จะได้	bydd yn cael	results in
จักจั่น	cicada	chakkachan
จักรพรรดิเนอร์วา	ymerawdwr nirvana	emperor nerva
จักรพรรดิไททัส	ymerawdwr titus	titus (flavius vespa)
จักรพันธุ์	chakphan	chakrabhand
จักรวาลวิทยา	cosmoleg	cosmology
จังหวัด	y dalaith	province
จังหวัดกระบี่	talaith krabi	krabee state
จังหวัดกาญจนบุรี	kanchanaburi	kanchanaburi province
จังหวัดกาฬสินธุ์	kalasin	kalasin province
จังหวัดขอนแก่น	talaith khon kaen	khon kaen province
จังหวัดคยองกี	talaith gyeonggi	the state of kyong gee
จังหวัดคยองซาง	talaith gyeongsang	kyongchang province
จังหวัดฉะเชิงเทรา	chachoengsao	chachoengsao province
จังหวัดชุมพร	chumphon	chumphon province
จังหวัดตราด	talaith trat	trat province
จังหวัดตาก	talaith tak	tak province
จังหวัดนครปฐม	talaith pathom nakhon	nakhon pathom province
จังหวัดนครพนม	talaith nakhon phanom	nakorn panom state
จังหวัดนครสวรรค์	talaith nakhon sawan	nakorn sawan province in thailand
จังหวัดน่าน	talaith nan	nan state in the north east of thailand
จังหวัดปัตตานี	talaith pattani	pattani state
จังหวัดพระนครศรีอยุธยา	phra nakhon si ayutthaya	nakon sri ahyutthaya province
จังหวัดพังงา	talaith phang nga	phang nga province
จังหวัดพิษณุโลก	talaith phitsanulok	pisanulok state
จังหวัดมหาสารคาม	talaith maha sarakham	maha sarakham province
จังหวัดยโสธร	yasothon	yasothorn province (name of thai province)
จังหวัดระยอง	rayong	rayong province
จังหวัดราชบุรี	ratchaburi	ratchaburi province
จังหวัดลำพูน	lamphun	lamphun province
จังหวัดสงขลา	songkhla	songkla province
จังหวัดสมุทรสงคราม	talaith samut songkhram	samut songkhram province
จังหวัดสิงห์บุรี	canu talaith buri	sing buri province
จังหวัดหนองบัวลำภู	talaith nong bua lamphu	nong bua lamphu province
จังหวัดอุดรธานี	talaith udon thani	udon thani state
จังหวัดเชลลา	shella	chella city
จังหวัดเชียงราย	chiang rai	chianrai province
จังหวัดเชียงใหม่	talaith chiang mai	chiang mai province
จังหวัดเพชรบุรี	talaith phetchaburi	petcharaburi state
จังหวัดเพชรบูรณ์	phetchabun	petchabun province
จังหวัดเลย	talaith loei	loei (name of thai province)
จังหวัดแพร่	phrae	prae state
จังหาร	junghan	changhan
จัดขึ้นเมื่อ	wedi&#39;i gynnal	occur on the date of _______________
จัดตั้งขึ้นโดย	sefydlwyd gan	produced by
จัดอยู่ในภูมิภาค	trefnwyd yn y rhanbarth	in region
จัดเมื่อวันที่	wedi&#39;i gynnal	็held on the date of ...
จัดโดย	trefnwyd gan	arrange by
จัน	chan	chan
จันทบุรี	chanthaburi	juntaburi state
จันทร	lleuad	chantorn
จันทรุปราคา	eclipse lleuad	lunar eclipse
จันทร์	dydd llun	chan
จันทร์ภักดี	chan phakdi	juntapukdee - surname of a famous actor
จันทร์เกษ	chan ket	juntagaset - a surname
จาก	o	from
จากการพิสูจน์อายุโดยคาร์บอน	o&#39;r prawf oedran gan garbon	from the forensic carbon dating
จากภาษากรีก	o greek	greek language
จากละคร	o&#39;r ddrama	from drama
จากละครเรื่อง	o&#39;r ddrama	from the soap opera
จากสารานุกรมบริทานิกา	o&#39;r gwyddoniadur britannica	from printed information
จากอัลบั้ม	o&#39;r albwm	from the album
จากเรื่อง	o&#39;r stori	from the story of ...
จากเว็บ	o&#39;r we	from the web
จากเว็บไซต์กระทรวงการต่างประเทศ	o wefan y weinyddiaeth materion tramor	from the website of foreign department
จากเว็บไซต์กระทรวงต่างประเทศ	o wefan y weinyddiaeth materion tramor	from the foreign government affairs website
จากโซล	o seoul	from soeul
จาติกวณิช	chatikavanij	chatikavanij
จามจุรี	jamjuree	jamjuri flower
จารีตประเพณี	custom	tradition from the culture
จารุเสถียร	jaru sathien	charusathien
จาวตาลเชื่อม	jao tan weld	sweetened palm - a type of thai dessert
จำกัด	cyfyngedig	limited
จำกัดมหาชน	cyfyngedig	public limited
จำนวน	y swm	amount
จำนวนประชากร	poblogaeth	population
จำปาเทศ	champa	a specific type of magnolia tree; similar michelia champaca
จำเริญ	blodeuog	jamroen
จิกะไบต์	jigtes	gigabyte
จิตรกร	peintiwr	painter
จิตรกรรม	peintio	arts and craft or music
จิตวิทยา	seicoleg	psychology
จิตใจ	y meddwl	heart; feelings
จินตหรา	jintara	jinnara - a female's name who is a singer
จิบูตี	djibouti	ji bu dee event on june 27
จิบเบอเรลลิน	gibberellin	gibberellin
จิม	jim	jim
จิโอวานนี	giovanni	giovanni
จี	g.	g
จีนตัวย่อ	tsieineaidd symlach	simplified chinese characters
จียอน	jiyeon	๋jiyeon (korean name)
จึงทรงพระกรุณาโปรดเกล้า	felly wedi&#39;i orchymyn yn raslon	be kind enough to
จึงเปิดโอกาสให้	felly rhoddodd y cyfle	open up opportunities
จึงใช้ธาตุหมอกและเมฆาได้	felly gall ddefnyddio&#39;r elfen o niwl a chwmwl	using magic with cloud and spells
จุกนมสีขุ่น	teat afloyw	corrupted pacifier
จุดกึ่งกลาง	midpoint	midpoint
จุดจอมฟ้า	pwynt glas	zenith
จุลจอมเกล้าเจ้าอยู่หัว	vajiralongkorn	phra chunla chom klao chao yu hua
จุฬาลงกรณินทรวรางกูร	chulalongkorn nintharangrangkun	new title for the princess
จูล	joule	joule
จูเซปเป	giuseppe	giuseppe
จูเนียร์	iau	junior
จเชียงใหม่	chiang mai	chiang mai province
จเพชรบุรี	phetchaburi	pedchaburee province
จเพชรบูรณ์	phetchabun	province pechaboon
จ๊กมก	jumkum	jokmok - a surname of a comedian
ฉ	f.	ninth thai alphabet
ฉบับชั่วคราว	fersiwn dros dro	special (temporary) edition
ฉบับวณิพก	rhifolion	begger version
ฉลอง	dathlwch	celebrate
ฉลองพระชนมายุ	dathlwch yr 80fed flwyddyn	celebrated birth anniversary of
ฉันรักคุณ	rwy&#39;n dy garu di	i love you
ฉาบ	pwti	cymbal
ฉายเมื่อ	dangos ymlaen	aired
ฉิ่ง	cymbals	small cup-shaped cymbals
ฉี่	pee	qi
ชนะ	ennill	winning
ชนิด	y math	kind
ชนิดของเมฆ	math o gwmwl	types of clound
ชม	gwyliwch	chom
ชมชื่น	canmoliaeth	chomchuen
ชมพู	pinc	rose apple
ชมพูทวีป	is-gyfandir indiaidd	south asia
ชมพู่	afal rhosyn	syzygium
ชล	llyn	chol (first name)
ชลธารวิทยา	chaloem wittaya	limnology
ชลบุรี	chonburi	cholburi state
ชลิต	cadwyn	chalit - a male's name
ชวนชื่น	gwahodd	choun cheen - a surname
ชอบ	fel	chop
ชะนี	gibbons	gibbon
ชะมด	mwsg	anteater
ชะอวด	dangos i ffwrdd	chaoud - location in thailand
ชะอำ	cha-am	cha-am (name of thai district)
ชัชพล	chatchapon	chatchapol - a male's name
ชัย	triumph	chai
ชัยชนะ	y fuddugoliaeth	chaichana
ชัยนาม	chai nam	chainam
ชัยบัญชา	chai bancha	chaibancha
ชัยมงคล	chaimongkol	chaimongkol - a male's name
ชัยยุทธ	chaiyut	chaiyuth (first name)
ชั้น	y llawr	class
ชั้นที่	llawr	order
ชั้นประทวน	llawr	non-commissioned officer
ชั้นมหาวชิรมงกุฎ	maha vajiraj y goron	order of the king's jewels
ชั้นยศ	safle	millitary rank
ชั้นสูงสุด	y lefel uchaf	special class
ชา	y te	tea
ชากะ	shaka	shaka
ชาคริต	chakrit	charkrit
ชาญชัย	chanchai	chanchai - a thai name
ชาตะ	te	born
ชาติ	y genedl	nation
ชาย	dyn	male
ชาร์ป	sharp	sharp
ชาร์ล	charles	charles
ชาร์ลส	charles	charles
ชาลส์	charles	charles
ชาลี	charlie	charlie
ชาวนา	y ffermwr	farmer
ชาวไทย	pobl gwlad thai	thai
ชาวไทยภูเขา	llwyth bryn	thai hill tribe
ชำนิ	arbenigol	chumni - a location in thailand
ชิคิกามิ	shikikami	shikigami
ชิงร้อย	cystadlu	ching roi
ชิงร้อยล้าน	cystadlu am gan miliwn	ching roi lan
ชิซุกะ	shizuka	shizuka
ชิดจันทร์	chidchan	chidjun (a person's last name)
ชิน	defnyddir	get used to
ชินวัตร	shinawatra	shinawatra
ชิริว	chiryu	cherew - a japanese character
ชิลี	chile	chilli
ชิโนะ	chino	shino
ชีพด็อก	cŵn defaid	chief dog
ชีวนิชพันธ์	biolegol	chiwanitphan
ชีวประวัติ	bywgraffiad	biography
ชีวมวล	biomas	alternative (natural) power
ชีวสถิติ	biostatistics	biometry, biostatistics
ชื่อดัง	enwog	famous
ชื่อนามสกุล	cyfenw enw cyntaf	name-lastname
ชื่อภาษาญี่ปุ่น	enw japaneaidd	japanese name
ชื่อภาษาอังกฤษ	enw saesneg	english name
ชื่อยศภาษาไทย	safle thai	thai title
ชื่ออัลบั้ม	enw&#39;r albwm	album name
ชื่ออื่น	enwau eraill	synonym
ชื่อเก่าในวงการ	hen enw yn y diwydiant	old stage name
ชื่อเดิม	enw blaenorol	old name
ชื่อเมือง	enw&#39;r ddinas	city's name
ชื่อเรื่อง	y teitl	the name of the story
ชื่อเล่น	llysenw	nickname
ชุดแพนเค้ก	set crempog	pancake
ชุติมา	chutima	chutima
ชุมชนออนไลน์ชาวจังหวัดสกลนคร	cymuned ar-lein sakon nakhon	sakon nakhon people online community
ชุมพลบุรี	chumphon buri	chompolburi area
ชุมแพ	chum phae	choompa - location in thailand
ชุมแสง	chum saeng	choomsang - a male's name
ชูมันน์	schumann	schumann
ชูศักดิ์	chusak	chusak
ชโย	bravo	cheer; hurray
ชไนเดอร์	schneider	schneider
ช็อกโกแลต	siocled	chocolate
ช่วงปี	y flwyddyn	between year
ช่อง	sianel	channel
ช่องเชิงเทิน	brwydrau	machicolation
ช้อน	llwy	spoon
ซ	h.	the eleventh letter of the thai alphabets
ซน	yn ddrwg	crashing into
ซบที่อกฉัน	nestle yn fy mrest	cry in my arms
ซอมบี้	zombies	zombie
ซออู้	zo o.	a woodwind thai instrument
ซันไชน์	heulwen	sunshine
ซัลฟานิลาไมด์	sulfanilamide	salfanilamide
ซัลฟาไดอะซีน	sulfadiazine	sulfadiazine
ซัลเฟต	sylffad	sulphate
ซากดึกดำบรรพ์	paleontoleg	fossil
ซาคุโร่	sakuro	zakuro - a japanese character
ซาซางาวะ	sasagawa	sasangngawa - a japanese name
ซานกัลโล	san gallo	sangallo family
ซาบุซะ	sabuza	zabuza
ซาลาดิน	saladin	saladin
ซาอิ	sayi	chai - a japanese name
ซาโลมอน	salomon	salomon
ซิกนัส	cignus	signus
ซิงเกอร์	canwr	sinder
ซิงเกิ้ล	senglau	single
ซิทคอม	sitcom	sitcom
ซินเดอเรลล่า	sinderela	cinderella
ซิมไฟลา	simphila	class symphyl
ซิโนไทย	thai sino	sino-thai
ซี	c.	see
ซีซี	cc	cc
ซีรีเบลลัม	serabellum	cerebellum
ซีลีเนียม	seleniwm	selenium (chemical element)
ซีสต์	cystiau	cyst
ซีเกมส์	gemau aas	southeast asian game
ซีเจ	cj	cj
ซีเซียม	cesiwm	cesium
ซีเนม่า	sinema	cinema
ซีแคนต์	secant	secant
ซีโร่	sero	zero
ซึง	pa	feeling touched (by the music or movie)
ซึม	seep	absorb
ซึ่ง	ym mha	because
ซึ่งประกอบด้วย	yn cynnwys	consists of
ซึ่งมี	sydd wedi	with
ซึ่งมีความหมายว่า	sy&#39;n golygu	meaning
ซึ่งมีทั้งหมด	sydd wedi popeth	in total of
ซึ่งรู้จักกันว่า	a elwir yn	called
ซึ่งเกิดจากปัจจัยภายนอก	wedi&#39;i achosi gan ffactorau allanol	which is caused by external factors
ซึ่งเรียกว่า	sydd yn cael ei alw	called
ซึ่งแท้จริงแล้ว	mewn gwirionedd	real name
ซึ่งได้แก่	pa rai yw	such as
ซุง	log	sung
ซุน	haul	son
ซุปเปอร์มาร์เก็ต	archfarchnad	supermarket
ซุปเปอร์เซ็นเตอร์	canolfan super	super center
ซู	sue	holding up high
ซูจี	suzy	fuji
ซูซูกิ	suzuki	suzuki brand
ซูรินาเม	swrinam	suriname
ซูเปอร์เซ็นเตอร์	canolfan super	super center
ซ่อมแซม	i atgyweirio	repair
ซ่าหริ่ม	byddwch yn hapus	a type of thai dessert
ซ้าย	chwith	left
ฌอง	jean	jean - french name
ญ	mae&#39;r	a thai alphabet with a y sound
ฐานข้อมูล	y gronfa ddata	database
ฐานทัพ	sylfaen	armforce
ณภัทร	naphat	napat
ณรงค์	narong	narong - a male's name
ณัฏฐธิดา	natthida	nattathida - a thai female actress
ณัฐวุฒิ	nattawut	nattawut
ด	m.	a letter from thai alphabet
ดง	fronfraith	area, location
ดม	sniff	smell
ดรทรงศักดิ์	dr songsak	doctor songsuk - a famous person
ดรนิพนธ์	dr nipon	doctor nipon
ดรสาโรช	dr saroj	dr. sarot
ดรสุชาติ	dr suchart	dr. suchart
ดราก้อน	ddraig	dragon
ดราก้อนเควสต์	quest y ddraig	dragon quest
ดวงพร	fortune	dwongpol
ดวงอาทิตย์	yr haul	sun
ดอก	blodau	flower
ดอกอ้อ	blodyn cyrs	dok aou
ดอกไม้	blodyn	flower
ดอกไม้ประจำจังหวัด	blodyn taleithiol	state's flower
ดอตคอม	dot com	dotcom
ดอนเมือง	don mueang	don mueang
ดอยอินทนนท์	doi inthanon	doi inthanon
ดอร์	drws	door
ดอลลาร์สหรัฐ	us doler	united states dollar
ดอว์ขิ่นจี	dawin ji	dorkingi
ดังนั้น	felly	for that reason
ดังเช่น	fel	such as
ดัชนีการพัฒนามนุษย์	mynegai datblygiad dynol	human development index
ดัตช์	iseldireg	dutch
ดันแฮม	dunham	dunham, the mother of barrack obama
ดับเบิลยู	w.	letter w
ดา	da	da - a thai nickname
ดาบ	y cleddyf	sward
ดาบเขี้ยวฟ้าฟื้น	cleddyf y dial	sky fang sword of revival
ดารา	seren	star
ดารากร	actor	darakon
ดาราคู่แรกของไทย	y seren gyntaf yng ngwlad thai	first movie stars in thailand
ดาราจักร	galaxy	planet in the solar system
ดาราศาสตร์รังสีเอ็กซ์	seryddiaeth pelydr-x	xray astronomy
ดาราหญิงไทยยอดนิยม	enwogion benywaidd poblogaidd thai	famous actress
ดาวกระจาย	starburst	star disperse
ดาวคาโนปุส	canapas	canopus star
ดาวพฤหัสบดี	iau	jupiter
ดาวพุธ	mercwri	mercury
ดาวยูเรนัส	wranws	uranus
ดาวศุกร์	venus	venus
ดาวอาร์คตุรุส	arcturus	arcturus
ดาวเคราะห์	y blaned	planet
ดาวเคราะห์แคระ	planed gorrach	dwarf planet
ดาวเสาร์	sadwrn	saturn
ดำรงค์	wimax	dumrong - a male's name
ดำรงตำแหน่ง	dal swydd	hold the title of
ดำรงอ่องตระกูล	teulu damrong ong	dumrongongtrakul
ดำเนินสะดวก	damnoen saduak	damnoen saduak
ดิกชันนารี	geiriadur	dictionary
ดิค	dick	dick - the name
ดิจิตอล	digidol	digital
ดิน	y pridd	soil
ดินเซนฮอฟเฟอร์	zenhoffer	dientzenhofer - as in christoph or leonhard or johannes
ดินแดน	tiriogaeth	territory
ดิว	dew	dew - a nickname
ดิวิชั่น	adran	division
ดิศ	disg	dis (thai first name)
ดิศกุล	diskul	disakul (last name)
ดิสนีย์	disney	disney
ดิสโพรเซียม	dysprosiwm	dysprosium
ดี	da	d.
ดีคอนสตรักทิวิสม์	dconrak tavist	deconstructivism
ดีน	deon	religion (islamic term)
ดีบุก	tun	tin
ดีเวลลอปเมนท์	datblygiad	development
ดีเวลลอปเม้นท์	datblygiad	development
ดีเอ็นเอ	dna	dna
ดุสิต	dusit	dusit
ดูที่	edrychwch ar	see
ดูเพิ่มเติม	gweld mwy	see also
ดูเพิ่มเติมที่	gweler hefyd	see more detail in
ดูเร็กซ์	durex	durex
ดูแล	cymerwch ofal	take care
ด็อก	ci	dog
ด้วย	gyda	too, also, together, with
ด้วยเหตุนี้	am y rheswm hwn	for this reason
ด้านการกีฬา	chwaraeon	sports
ด้านการต่างประเทศ	materion tramor	foreign affairs
ด้านการเกษตร	amaethyddol	agriculture
ด้านดนตรี	cerddoriaeth	in music
ด้านหน้า	y blaen	front
ด้านหลัง	y cefn	backside
ด้านอ่าวไทย	gwlff gwlad thai	gulf of thailand side
ต	o.	a letter from thai alphabet with th sound
ตกรอบที่	dileu	did not make the cut
ตรงกับวันขึ้น	cydweddwch	on the date of
ตรงกับวันที่	dyddiad paru	on the date of _______________
ตระกูล	clan	family
ตระกูลนารา	teulu nara	nara lineage
ตระกูลปาร์ค	parc clan	park family (korean last name)
ตระกูลยามานากะ	teulu yamanaka	yamanaka clan
ตระกูลอินุซึกะ	teulu inuzuka	inu-tsuka family
ตระกูลเซนจู	teulu senju	chen ju dynasty
ตรัง	trang	trung province
ตรางู	neidr	snake brand
ตราด	trat	trad state
ตรานี้	y sêl hon	this seal
ตราสัญลักษณ์	arwyddlun	symbol
ตรึงใจ	yn ddiddorol	truengjai
ตรุษจีน	blwyddyn newydd tsieineaidd	chinese festival
ตลาด	y farchnad	market
ตลาดโลตัส	marchnad lotus	lotus market
ตอน	pennod	edition number
ตะกร้อ	takraw	takraw
ตะกั่ว	arwain	copper
ตะละภัฏ	talapat	talaput - a surname
ตะลุยอวกาศ	dabble gofod	space trek
ตะวันทอแสง	codiad haul	tawanthosaeng
ตะวันออก	dwyrain	east
ตะวันออกเฉียงเหนือ	gogledd ddwyrain	east
ตันติเวชกุล	tantivejkul	tuntivetchakul - a surname
ตัว	y corff	body
ตัวพระ	prif gymeriad	main character
ตัวยักษ์	cawr	giant
ตัวละคร	y cymeriad	character
ตัวละครจากเรื่อง	cymeriadau&#39;r stori	soap opera based on a written story
ตัวลิง	mwnci	monkey
ตัวสะกด	sillafu	final consonant
ตัวหาร	rhanydd	divisor
ตัวอย่าง	enghraifft	example
ตัวอย่างคำบาลี	enghraifft pali	bali example words
ตัวอย่างคำประพันธ์	rhigwm enghreifftiol	sample writing
ตัวอย่างต้นแบบแรก	enghraifft prototeip gyntaf	holotype
ตัวอย่างภาพยนตร์	trelar ffilm	movie trailer
ตัวอย่างเช่น	er enghraifft	for example
ตัวเลขอย่างเป็นทางการ	rhifau swyddogol	formally number
ตัวแปร	amrywiol	variable
ตั้งงี่สุ่น	tang ngeon	tang ngee soon
ตั้งอยู่ที่	wedi&#39;i leoli yn	located
ตั้งอยู่เลขที่	wedi&#39;i leoli yn	at house number
ตั๊กแตน	ceiliog rhedyn	grasshopper
ตา	y llygad	ta (a person's name)
ตาคลี	takhli	ta-klee
ตามตัวสวมเครื่องประดับต่าง	wrth iddo wisgo gwahanol addurniadau	accessories
ตามตำราพรหมชาติฉบับหลวง	yn ôl gwerslyfr brenhinol y brahma	by royal botanic manual/handbook
ตาระวา	tarawa	square yard
ตาราง	y bwrdd	table
ตำนานวายุสลาตัน	chwedl storm	shippuden
ตำนานแฝงคำสอน	dysgeidiaeth chwedlonol	tales
ตำบลกระเทียม	israniad garlleg	garlic district
ตำบลกังแอน	ardal gang ann	ung gan district
ตำบลตาเมียง	ardal ta myung	tambon tameung
ตำบลนางแล	isranbarth nanglae	nang lae province
ตำบลนาดี	isranbarth nadi	na dee district
ตำบลบ้านกง	isranbarth ban kong	tambon bankong (name of the district)
ตำบลยะวึก	ardal yuwak	tambon yawuek
ตำบลระแงง	ardal rahang	ra-ngang district
ตำบลสังขะ	sangkha	thambol sangka
ตำบลเมืองบัว	isranbarth bua	muangbua district
ตำบลโพนครก	dosbarth phon nakhon	tambon poncrok
ตำบลไพรขลา	isranbarth phrai khala	phrai khla subdistrict
ติณสูลานนท์	tinsulanon	thinasulanon
ติอามัต	tiamat	tiarmut
ตี๋ใหญ่	tî mawr	ti yai
ตึก	yr adeilad	building
ตุรกี	twrci	turkey
ตุลาคม	hydref	october
ตุ๊กแก	gecko	gecko
ตูน	cartwn	toon
ต่อกันด้วยพันธะ	parhewch â bondiau	linked by bond
ต่อจาก	parhewch o	resulting from
ต่อมา	yn ddiweddarach	later
ต่อมาวันที่	dyddiad nesaf	later on the date
ต่อมาในปี	yn ddiweddarach yn y flwyddyn	later in the year
ต่อมาในรัชกาลที่	yn ddiweddarach yn y deyrnasiad	afterwards, in the reign of
ต่อมาในสมัยกรุงธนบุรีและกรุงรัตนโกสินทร์เขมรตกอยู่ภายใต้การควบคุมของจักรวรรดิสยามอย่างเข้มงวด	yn ddiweddarach, yng nghyfnodau thonburi a rattanakosin, roedd y khmer dan reolaeth lem yr ymerodraeth siamese.	later in thonburi period and rattanakosin period
ต่าง	gwahanol	different, various
ต่างๆ	amrywiol	various, different
ต้น	y dechrau	medication for multi-symptoms
ต้นตอจักรวาลวิทยา	cosmoleg	cosmogony
ต้นสกุล	genws	clan
ถนน	y ffordd	street
ถนนคนเดิน	cerdded stryd	kon dern road
ถนนประชาธิปก	ffordd democratiaeth	prachatiphok road
ถนนมิตรภาพ	ffordd cyfeillgarwch	thanon mittraphap
ถนนสุขุมวิท	ffordd sukhumvit	sukhumvit road
ถมิตรภาพ	cyfeillgarwch	mittraphap road
ถวาย	cynnig	presented (royal language)
ถึงกระนั้น	serch hynny	until
ถึงเดือนกรกฎาคม	i july	starting july
ถ้วย	cwpan	cup
ถ้อยคำ	geiriau	accent
ทดลอง	treial	experiment
ทนงศักดิ์	thanongsak	thanongsak
ทนาย	cyfreithiwr	lawyer
ทนายความ	cyfreithiwr	attorney
ทรงคล้ายทรงกลม	spherical	spheroid
ทรงถือหุ้นจำนวน	mae ei uchelder yn dal cyfranddaliadau yn	stock ownership
ทรงผนวช	ei uchelder	ordain
ทรงพระกรุณาโปรดเกล้าโปรดกระหม่อมให้	cysegrwch fi yn rasol	gift (word for the king)
ทรงยี่สิบหน้า	ugain wyneb	icosahedron
ทรงลูกบาศก์	ciwb	cube
ทรงสี่เหลี่ยมขนมเปียกปูน	rhombus	rhombohedron shaped
ทรงสี่เหลี่ยมมุมฉาก	petryal	triangular prism
ทรงห้าหน้า	pump wyneb	polyhedron
ทรงได้รับการทูลเกล้าฯ	wedi derbyn ei fawrhydi y brenin	the king of thailand gives out ____ to people
ทรัพยากร	adnoddau	wealth
ทรัพยากรน้ำ	adnoddau dŵr	water resources
ทรัพย์วิจิตร	cyfoeth	sapwichit
ทรัพย์เพิ่ม	asedau ychwanegol	subpherm
ทรัมเป็ต	trwmped	trumpet
ทรีทูวัน	tri i un	three.two.one
ทวารหนัก	anws	anus
ทวีป	cyfandir	continent
ทวีปอเมริกา	america	america continent
ทวีปเอเชีย	asia	asia
ทวีวัฒน์	thawiwat	taweewan
ทว่า	ond	however
ทศกัณฐ์	tosakan	ravana
ทศพล	tosapon	thotsaphon
ทหาร	y milwr	soldier
ทหารหน่วยอาเฟลันดราที่	uned filwrol aphelandra	afelandra army
ทหารอากาศ	llu awyr	air force man
ทอง	aur	gold
ทองขาว	aur gwyn	thongkhao
ทองประสม	aur	thongprasom
ทองผาภูมิ	thong pha phum	thong pha phum
ทองหยอด	deilen aur	a type of thai dessert
ทองหล่อ	thonglor	gold
ทองเจือ	aur laced	tong jea - a surname
ทองแดง	copr	copper
ทองใหญ่	aur mawr	tong yai - a name
ทอม	tom	tom
ทอมสัน	thomson	thomson
ทอมัส	thomas	thomas
ทะเล	y môr	ocean, sea
ทะเลทราย	yr anialwch	dessert
ทะเลสาบ	y llyn	lake
ทักษะ	y sgiliau	skill
ทัช	cyffwrdd	touch
ทับ	slais	thon-rammana
ทัพเรือภาคที่	adran y llynges	naval area command
ทัวร์คอนเสิร์ต	taith gyngerdd	concert tour
ทั่วไป	cyffredinol	general
ทั้ง	y ddau	all
ทั้งหมด	mae&#39;r holl	all
ทางทิศตะวันออก	dwyrain	east
ทางทิศตะวันออกติดกับเวียดนาม	mae&#39;r dwyrain yn ffinio â fietnam.	borders vietnam to the east
ทางทิศเหนือติดกับประเทศไทยและลาว	mae&#39;r gogledd yn ffinio â gwlad thai a laos.	borders thailand and laos to the north
ทางน้ำ	ffordd ddŵr	by water
ทางรถไฟ	rheilffordd	rail
ทางหลวงพิเศษ	priffordd arbennig	motorway
ทางอากาศ	mewn awyr	by air
ทางไอทีวี	ar itv	via itv ( a television station in thailand)
ทานากะ	tanaka	tanage - a japanese name
ทาร์ดิกราดา	tardikrada	tardigrada
ทาวเวอร์	y twr	tower
ทำงาน	i weithio	working
ทำนอง	alaw	melody
ทำบุญตักบาตรฯ	gwneud teilyngdod a chynnig bwyd i fynachod	put food offerings into a buddhist monk's bowl
ทำหน้าที่	gwnewch y ddyletswydd	task, function
ทำให้	gwneud	made
ทิฆัมพรธีรวงศ์	tikamporn thirawong	timkamporntiravong (thai last name)
ทิพย์	thip	thip
ทิฟฟานี่	tiffany	tiffany - female's name
ทิม	tim	tim
ทิวานนท์	tiwanon	thiwanon
ทิศตะวันตก	gorllewin	west
ที	t.	t.
ทีบีเอส	tbs	tbs
ทีมชาติไทย	tîm cenedlaethol gwlad thai	thai national team
ทีมใดที่จำนวนข้อที่ถูกน้อยกว่า	pa dîm sydd â nifer is o fargeinion?	the team with the least correct answers
ทีวีอินไซด์	teledu y tu mewn	tv inside
ทีโอที	cyfanswm	tot
ที่จ่ายร้อยละ	mae hynny&#39;n talu canran	costing
ที่นี้	yma	here
ที่ประชาชนชอบมากที่สุด	pa bobl sy&#39;n hoffi&#39;r mwyaf	people's most favorite
ที่มา	ffynhonnell	source
ที่มี	mae hynny wedi	possess
ที่มีชื่อว่า	enwyd	named
ที่สำคัญ	yr allwedd	important
ที่หมายถึง	mae hynny&#39;n golygu	explanation
ที่อยู่อาศัย	preswyliad	residence
ที่เกิดขึ้น	digwyddodd hynny	appear
ที่โดดเด่นคือ	mae&#39;r rhagorol yn	notable
ทุก	pob	every
ทุกครั้ง	bob tro	every time
ทุติยจุลจอมเกล้าวิเศษ	llongau	tuthit julajomklawwiset - the title of those you received jewelry from the king
ทุ่งตะโก	thung tako	thung tako district
ทุ่งสง	cân thung	tong song or nakon sri thamarat state
ทุ่งใหญ่	thung yai	tungyai
ทู	rhy	to
ทูล	offeryn	thun
ทเวนตี้	ugain	twenty
ทโกมลบุตร	thongkom ond	komolbut - a surname
ทไย	pam	thayai
ท่องอาณาจักรโฮ่งเหมียว	adrodd teyrnas hong miao	traveling the kingdom of woof-meow
ท่าชนะ	ystum	thachana
ท่านอิน	thanin	than in
ท่านอ่อง	ong	tan ong - a member of the royal family
ท่านอ้วน	dyn tew	than uan
ท่าน้ำนนท์	glannau	nam non pier
ท่ายาง	stamp rwber	tha yang
ท่าศาลา	mae sala	sala pier
ท่าอากาศยานเลย	maes awyr loei	loei airport
ท่าเรือ	harbwr	pier
ท่าไม้ตาย	setlwr	deadly move
ท้องสนามหลวง	sanam luang	sanamloung - a landmark in thailand
ธกรุงไทย	banc thai krung	krung thai bank
ธกส	baac	bank for agriculture and agriculture
ธกสิกรไทย	banc kasikorn	kasikornbank
ธง	y faner	flag
ธงชัย	thongchai	thongchai
ธงชาติ	baner genedlaethol	national flag
ธงธง	baner	thongthong
ธนบุรี	thonburi	thonburi province
ธนพร	thanaporn	thanaporn
ธนะรัชต์	thanarat	tanarat -a surname
ธนาคาร	y banc	bank
ธนาคารกรุงศรีอยุธยา	banc ayudhya	bank of ayudhya
ธนาคารกรุงไทย	banc thai krung	krung thai bank
ธนาคารทหารไทย	banc milwrol gwlad thai	tahanthai bank
ธนาคารทิสโก้	banc tisco	tisco bank
ธนาคารอิสลามแห่งประเทศไทย	banc islamaidd gwlad thai	islamic bank of thailand
ธนาคารเกษตร	banc amaethyddol	farmer's bank
ธนาคารเพื่อการพัฒนาแห่งเอเชีย	banc datblygu asiaidd	patana asia bank
ธนาคารไทยพาณิชย์	banc masnachol siam	siam commercial bank
ธนิต	thanit	thanit
ธปท	bot	bot
ธรณินทราธิราช	tharawintharathirat	having to do with the king
ธรณีสัณฐานวิทยา	morffoleg pridd	geomorphology
ธรรมนูญ	cyfansoddiad	law
ธรรมศักดิ์	thammasak	tamasak - surname of an elected prime minister
ธรรมศาสตร์	prifysgol thammasat	thammasat
ธรรมเมกขสถูป	dharma makk stupa	dhamek stupa
ธานินทร์	thanin	tanin
ธารทิพย์	na thip	tarnthip (first name)
ธำมงรค์	thamrong	ring
ธิติกานต์	thitikan	thitikan
ธีม	y thema	theme
ธีระ	thira	teera
ธีรเดช	thiradej	theeradej
ธุรกิจ	busnes	business
ธุรกิจการบิน	busnes hedfan	airline business
นก	aderyn	bird
นกกระจอก	gwreichionen	sparrow
นกกระทา	quail	quail
นกกระทุง	pelican	pelican
นกกระเต็น	glas y dorlan	kingfisher
นกขมิ้น	dedwydd	oriole
นกน้อย	aderyn bach	noknoi
นกแก้ว	parot	parot
นกแอร์	nok air	airline
นครนิวยอร์ก	dinas york newydd	new york city
นครปฐม	pathom nakhon	nakhon pathom
นครพนม	phanom nakhon	nakhon phanom
นครราชสีมา	nakhon ratchasima	nakhon ratchasima
นครสวรรค์	nakhon sawan	nakhon sawan
นครหลวงเวียงจันทน์	prifddinas vientiane	vientiane
นที	natee	natee - a male's name
นปช	udd	three letter acronym
นพจินดา	noppachinda	noppajinda - a surname
นพดล	nopadon	noppadol - a male's name
นร	myfyriwr	the ancient and auspicious order of the nine gems
นราธิป	narathip	naratip - a male's name of a singer
นราธิวาส	narathiwat	narativat state
นวนิยาย	nofel	story
นวรัตน์	nawarat	navaratna
นวล	meddal	noul -  a name
นอกจาก	eithr	other than, to exclude
นอกจากนี้	yn ogystal	furthermore
นอกจากนี้แล้ว	eithr	besides
นอกเหนือจากนี้	heblaw am hyn	moreover
นอนไม่หลับ	methu cysgu	insomnia
นอร์ส	llychlynnaidd	norse
นะงะซะกิ	nagasaki	nagasaki
นะโม	namo	namo
นักดนตรี	cerddor	musician
นักบินของออร์บ	peilot orb	orb pilot
นักบินอวกาศ	gofodwr	astronaut
นักปรัชญา	athronydd	philosophist
นักพากย์	actor llais	voice actor
นักมวย	bocsiwr	boxer
นักร้อง	y canwr	singer
นักร้องชายไทย	cantorion gwrywaidd thai	thai male vocalist
นักร้องนักดนตรี	canwr cerddor	singer, musician
นักร้องเพลงไทยสากลชาย	canwr gwrywaidd gwrywaidd rhyngwladol	male thai pop singer
นักร้องเสียงหลัก	prif leisydd	lead singer
นักวิชาการ	academaidd	i was in for.
นักวิทยาศาสตร์	y gwyddonydd	scientist
นักศึกษาวิชาทหาร	myfyriwr milwrol	army reserve force students
นักสู้อันดับ	diffoddwr wedi&#39;i restru	fighter rank
นักเขียน	yr ysgrifennwr	writer
นักเขียนการ์ตูน	cartwnydd	cartoonist
นักเต้นนำ	prif ddawnsiwr	dancers
นักเศรษฐศาสตร์	economegydd	economist
นักแต่งเพลง	cyfansoddwr	songwriter
นักแสดง	yr actorion	actor/actress
นักแสดงพิธีกร	actor	presenter of the show
นักแสดงรับเชิญ	actor gwahoddedig	guest star
นัดกับนัด	dyddiad gyda	nut kab nut - a thai sitcom
นันทนาการ	hamdden	recreation
นันทนาคร	nanthanakorn	nantanakorn
นันทเสน	nanthasen	nanthasen
นันทไกร	nantakrai	nandhakrai
นับตั้งแต่เริ่มก่อตั้งจนถึงปัจจุบัน	ers ei sefydlu tan yn bresennol	from the foundation up to the present
นัยนา	cyfatebiaeth	naiyana
นั่นคือ	hynny yw	that is
นั่นเอง	digon sicr	that is
นั้น	hynny	that
นา	maes	na
นากา	naga	naga
นากิ	nagi	nagi
นาคหิรัญกนก	nak hirankanok	nakhirunkanok
นางงามจักรวาล	bydysawd miss	ms. universe
นางสาวสุวรรณ	miss suwan	miss suwan
นางสุพรรณมัจฉา	suphan matcha mrs.	mrs. supanmatja - a character in a thai legend
นางาโตะ	nagato	logo ontario.
นาดี	nadi	na di
นาดูน	nadun	nadune (name of district)
นาทวี	nathawi	natavee district
นาทาล	natal	"exactly: ""natal;""  proper name: natarle"
นาที	munud	minute
นานา	llawer	nana
นามิ	nami	nami
นายกรัฐมนตรีของประเทศไทย	prif weinidog gwlad thai	prime minister of thailand
นายกรัฐมนตรีไทย	prif weinidog gwlad thai	thai prime minister
นายกำพล	kampon mr.	kamphon
นายชลอ	mr chalo	chalo
นายชวน	chuan mr.	mr. chuan
นายชาญชัย	chanchai mr.	chanchai
นายณรงค์	narong mr.	mr. narong - a male's name
นายดำรง	mr damrong	mr dumrong - a male's name
นายทวี	mr thawee	mr.tawee
นายประกอบ	cynulliad mr	mr. prakob - a male's name
นายปรีชา	preecha mr.	mr.preecha
นายปรีดี	pridi mr.	pridi - a male's name
นายยงยุทธ	mr yongyut	mr. yongyut - a male's name
นายศักดา	sakda	sakda
นายสมชัย	somchai mr.	mr. somchai
นายสมัคร	ymgeisydd	mr. samak - a thai name
นายสวัสดิ์	sawat mr.	sawat
นายสุชาติ	mr suchart	mr. suchat
นายสุนทร	sunthorn mr.	mr. soontorn - a male's name
นายแพทย์	meddyg	male doctor
นารูโตะ	naruto	naruto - a japanese cartoon
นาวาอากาศเอกหญิง	capten merched	woman airforce captain
นาฬิกา	y cloc	clock
นาโนเทคโนโลยี	nanotechnoleg	nanotechnology
นำกลับมาสร้างใหม่อีกครั้ง	wedi dod yn ôl i greu eto	remake (of an old movie)
นำแสดงโดย	yn serennu	performed by
นำโดย	arwain gan	led by
นิกาย	sect	sect
นิกเกิล	nickel	nickel
นิคมพัฒนา	nikom phatthana	nikhom phatthana
นิตยสารชีวจิต	cylchgrawn homeopathig	cheewajit magazine
นิตยสารเอเชียวีก	cylchgrawn wythnos asia	asiaweek magazine
นิตโย	nittayo	nittayo
นิทาน	straeon tylwyth teg	tales
นิยม	poblogaidd	niyom, name of a thai country music singer
นิยมจัดขึ้นในเดือน	poblogaidd yn ystod y mis	usually held in the month of
นิยาม	y diffiniad	symbols
นิรมิต	breuddwyd	niramit
นิรันดร์กุล	nirunkun	nirankun
นิรุกติศาสตร์	etymology	philology
นิลภิรมย์	nilphirom	nipinpirom - a surname
นิวคลีโอไทด์	niwcleotid	nucleotide
นิวยอร์ก	york newydd	new york
นิวัฒน์	newwat	niwat
นิวเคลียร์	niwclear	nuclear
นิวเคลียส	cnewyllyn	nucleus
นิฮง	nihong	nippon or nikon, a japanese reading language
นิเทศศาสตรบัณฑิต	baglor yn y celfyddydau	communication major graduates
นิ่ม	meddal	pangolin
นิ่มสกุล	nim sakul	nimsakun
นีโอ	neo	neo
นี่คือ	mae hyn	this is
นุช	llawenydd	nucth
นเรศ	nares	naret - a male's name
นโยบายทางการทูตของจีน	polisi diplomyddol tsieina	china;s foreign policies
น็อกซ์	knox	left.
น้องครีม	hufen nong	nong kreme - a nickname of someone in thai entertainment
น้องชาย	brawd iau	brother
น้อยมาก	ychydig iawn	noimak
น้ำ	y dŵr	water
น้ำค้าง	dew	namkhang
น้ำดื่ม	dŵr yfed	beverages
น้ำท่วม	llifogydd	flooding
น้ำฝน	dŵr glaw	rainwater
น้ำพอง	theganau gwynt	nam pong in kon kan province
น้ำมะนาว	sudd lemon	lemonade
น้ำมัน	olew	oil
น้ำมันสน	turpentine	oil of turpentine
น้ำยืน	dŵr sefydlog	numyeen - location in ubolthani state
น้ำหนัก	y pwysau	weight
บทนมัสการนอบน้อมบูชาพระพุทธเจ้า	penodau addoliad gostyngedig yr arglwydd bwdha	a prayer to the lord buddha
บทบาททางการเมือง	rôl wleidyddol	politic
บทสวดบาลีที่ขึ้นต้นด้วยอรหัง	siantio pali sy&#39;n dechrau gyda&#39;r arhat	"pali mantra started with ""arhat"""
บทสวดสรภัญญะที่ขึ้นต้นด้วยธรรมมะคือ	mae siantiau sorapanya sy&#39;n dechrau gyda dharma	a buddhist prayer
บนบก	ar dir	on land
บรมนาถชาติอาชาวศรัย	borommanachat achan sai	something has to do with the king - too obscure
บรมนาถบพิตร	bophit boromnat	borommanatbophit
บรรณาธิการ	y golygydd	editor
บรรพชีวินวิทยา	paleontoleg	paleontology
บราซิเลีย	brasilia	brazilian
บราเธอร์ส	frodyr	brothers
บริบาล	gofal	baribal - a famous soccer player
บริพัตร	bwyd	paribatra
บริวเวอรี่	bragdy	brewery
บริสุทธิ์	pur	pure
บริหารธุรกิจ	gweinyddu busnes	business administration
บริเวณรอบทะเลสาบเขมร	o amgylch llyn khmer	area around the lake in cambodia
บริเวณเขตภูเขาทางภาคเหนือ	rhanbarth mynyddig yn y gogledd	mountain in north of thailand
บรูไน	brunei	brunei
บลีช	bleach	bleach
บลู	glas	blue
บลูคอสมอส	cosmos glas	blue cosmos
บลูเบอร์รี่	llus	blueberry
บวก	hefyd	positive
บวม	chwydd	swelling
บวร	dwyfol	bawon
บอมบ์	bom	bomb
บอย	bachgen	boy
บอยซ์	boyz	boys
บอล	y bêl	ball
บอลด์วิน	baldwin	baldwin
บอส	y bos	boss
บังคลาเทศ	bangladesh	bangladesh
บังไค	bangkai	bankai
บัณฑิต	graddedig	bandit
บัณฑิตวิทยาลัยร่วมด้านพลังงานและสิ่งแวดล้อม	ysgol ynni a&#39;r amgylchedd graddedigion ar y cyd	joint graduate school of energy and environment
บันทึก	arbedwch	record
บันทึกการสร้างโลก	record y byd	genesis diary
บันทึกความทรงจำ	memo	diary
บันเทิง	adloniant	entertainment
บัว	lotus	lotus
บัวลอย	bualoy	kind of thai sweetmeat
บัวเชด	blodyn lotus	cedric dubois.
บัวใหญ่	bua yai	big lotus
บาคคัส	bacchus	bacchus
บาคุกันธาตุไฟ	elfen dân bakugan	dragonoid
บาคุกันลูกน้องของนากา	bakugan, cefnogwr i naga	bakugan, minion of naga
บางกอกกล๊าส	gwydr bangkok	bangkok glass
บางกอกน้อย	bangkok noi	bangkok noi
บางครั้ง	weithiau	sometimes
บางซื่อ	bang sue	bang see - a location in thailand
บางปะกอก	bang pakok	bang prakok - an area in bangkok
บางปะหัน	bang pahan	a district in ayutthaya province
บางพลัด	bangplad	bangplad
บางส่วน	rhai	some
บางเขน	bangkhen	bang khen
บางแสน	bangsaen	bang saen
บางใหญ่	bang yai	bang yai - a location in thailand
บานไม่รู้โรย	amaranth	gomphrena
บารอมิเตอร์	baromedr	barometer
บารัก	barack	barack
บาร์	bar	bar
บาลี	pali	vatthu
บาอัล	baal	baal - a demon in hebrew
บิน	plu	bin
บิล	y bil	bill
บิ๊กซี	mawr c.	big c
บิ๊กซ้งซุปเปอร์สโตร์	uwchfarchnad y gân fawr	big song superstore
บี	b.	b
บีช	y traeth	beach
บีบี	bb	bb
บีฟเค้ก	cacen cig eidion	beef cake
บี้	yn dadfeilio	flatten
บี้สุกฤษฎิ์	sukrit bie	be- sukasit wisetkeaw - name of a singer
บุคคล	y person	person
บุคคลสำคัญ	person pwysig	vip person, very important person
บุคลิกภาพ	personoliaeth	mannerism
บุช	bush	(george) bush
บุญค้ำ	teilyngdod	bunkham
บุญนะโชติ	bunnachot	bunachot - a surname
บุญนาค	teilyngdod	boon nak - a famous surname
บุณยเกตุ	bunyaket	boonyaket
บุตร	plant	son
บุษบา	busaba	busaba - a woman's name
บูมเมอแรง	boomerang	boomerang
บ่อทอง	aur pwll	bothong
บ้านฉาง	ban chang	bahn shang -a  location in thailand
บ้านปราสาท	tŷ&#39;r castell	castle house
บ้านผือ	ban phue	ban phue
บ้านฝันดอตคอม	com baan fan	bahnfun.com
บ้านลาด	hafan	ban lat
บ้านเขว้า	tŷ	bahn kaywah, an area in thailand
บ้านแพ้ว	tŷ	ban paw
บ้านโพธิ์	ban pho	bahn po - a location in thailand
ปจ	blwyddyn	two letters acronym
ปช	traeth	two letters acronym
ปฏิทินช่อง	calendr y sianel	calendar
ปฏิภาณ	esprit	male's name patipan
ปตท	ptt	three letters from thai alphabets
ปทานุกรม	geiriadur	encyclopedia
ปทุมธานี	pathwm thani	pathum thani
ปภ	diogelwch	the order of the direkgunabhorn
ปภัสรา	papassara	papatsara
ปม	y gwlwm	knot
ประกอบด้วย	yn cynnwys	composed of
ประกอบไปด้วย	yn cynnwys	included
ประการที่	rhif	point
ประกาศิต	datgan	command
ประกาศเป็นป่าสงวน	wedi&#39;i ddatgan fel gwarchodfa goedwig	preserve area, the protected forest
ประจวบ	cyd-daro	prachuap
ประจวบคีรีขันธ์	prachuap khiri khan	prajoubkirikan state
ประจักษ์	ymddangosiadol	mr. prajak
ประจำปี	blynyddol	annual
ประชากรประมาณ	amcangyfrif o&#39;r boblogaeth	population about
ประชากรศาสตร์	demograffeg	literature subject
ประดิษฐาน	lle	placed
ประติมากรรม	cerflun	production of a play
ประติมากรรมไทย	cerflun thai	thai sculpture
ประตู	y drws	gate
ประตูน้ำ	pratunam	pratunam
ประตูเสีย	drws wedi torri	broken door
ประทีป	prateep	continent
ประธาน	yr arlywydd	president
ประธานกรรมการ	cadeirydd	chief executive officer
ประธานศาลฎีกา	llywydd y goruchaf lys	president of the supreme court
ประธานสภารัฐสภา	llefarydd y senedd	speaker of parliament
ประธานาธิบดี	llywydd	president
ประมาณ	am	about, estimated to be
ประมาณคศ	am	christ year
ประมาณปี	tua blwyddyn	approximately in the year
ประยงค์	prayong	prayong
ประวัติศาสตร์	yr hanes	history
ประวัติศาสตร์สเปน	hanes sbaen	history of spain
ประวัติศาสตร์ไทย	hanes gwlad thai	history of thailand
ประสาท	nervous	castle
ประสิทธิภาพ	effeithlonrwydd	efficiency
ประหยัด	arbedwch	thrifty, cheap
ประเด็นที่	y mater	point number
ประเทศ	y wlad	country
ประเทศกัมพูชา	cambodia	cambodia
ประเทศซูดาน	sudan	sudan
ประเทศทำการค้าขายกับต่างประเทศมากยิ่งขึ้น	gwledydd sy&#39;n gwneud mwy o fasnachu gyda gwledydd tramor	country that trades with other countries
ประเทศนอร์เวย์	norwy	norway
ประเทศฝรั่งเศส	ffrainc	france
ประเทศพม่า	myanmar	burma
ประเทศฟินแลนด์	y ffindir	finland
ประเทศภูฏาน	bhutan	bhutan
ประเทศมาเลเซีย	malaysia	malaysia
ประเทศราช	gwlad frenhinol	vassal state
ประเทศลาว	laos	laos
ประเทศสวีเดน	sweden	sweden
ประเทศสเปน	sbaen	spain
ประเทศอียิปต์	yr aifft	egypt
ประเทศเกาหลี	korea	korea
ประเทศเกาหลีใต้	de korea	south korea
ประเทศเนปาล	nepal	nepal
ประเทศเปรู	periw	peru
ประเทศเม็กซิโก	mecsico	mexico
ประเทศเวียดนาม	fietnam	vietnam
ประเทศแคนาดา	canada	canada
ประเทศและดินแดน	gwledydd a thiriogaethau	natoin and territory
ประเทศไทย	gwlad thai	thailand
ประเพณีชักพระ	traddodiad chak phra	chak phra festival
ประเภท	math	category
ประเภทของ	math o	type of
ประเภทรายการแข่งขันชิงรางวัลดีเด่น	categori gwobr cystadleuaeth ragorol	award show for
ประโยค	y frawddeg	sentence
ปรัชญา	yr athroniaeth	philosophy
ปรัชญาตะวันตก	athroniaeth y gorllewin	western philosophy
ปรากฏการณ์โลกร้อน	cynhesu byd-eang	global warming
ปรากฏตัวตอนแรกในตอน	ymddangosodd gyntaf mewn pennod	first appear in
ปรากฏตัวในตอน	ymddangos yn	showing their presence
ปราจีนบุรี	prachinburi	prachin-buri
ปราบดาภิเษก	coroni	prapdapisek
ปราสาทเขาพระวิหาร	teml preah vihear	kao pravihan ancient ruins
ปราโมทย์	pramot	pramot
ปริญ	argraff	parin
ปริญญา	gradd	degree
ปริภูมิ	gofod	3 dimensions
ปริมาณการผลิต	cyfrol cynhyrchu	capacity
ปริศนา	pos	puzzle
ปริ๊นซ์	tywysog	prince
ปรีดา	delight	prida - a male's name
ปรีดี	pri	pridi
ปลา	pysgodyn	fish
ปลาบู่ทอง	goby aur	goldfish
ปลาปอมปาดัวร์	pompadour	pompadour
ปลาย	y diwedd	at the end
ปลายคริสต์ศตวรรษที่	diwedd y 19eg ganrif	late century
ปลาในสกุลนี้เรียกว่า	gelwir y pysgod yn y genws hwn	the fish in this family is called _________
ปลิงทะเล	ciwcymbr môr	sea cucumber
ปล่อย	rhyddhau	release
ปวดข้อ	poen ar y cyd	joint pain
ปวันรัตน์	pawanrat	pavunnarat - a surname
ปวีณา	paweena	paweena
ปักกิ่ง	beijing	beijing
ปักธงชัย	pak thong chai	pakthongchai
ปัจจุบัน	cyfredol	at present
ปัจจุบันนี้	nawr	presently
ปัจจุบันประเทศไทยมีภาพยนตร์ที่มุ่งสู่ตลาดโลก	y dyddiau hyn, mae gan wlad thai ffilmiau sydd wedi&#39;u hanelu at farchnad y byd.	currently thailand has international movies
ปัจจุบันมีที่นั่งอยู่ในสภาผู้แทนราษฎร	ar hyn o bryd mae gennych sedd yn nhŷ&#39;r cynrychiolwyr	presently have elected representatives
ปัจจุบันเลิกเขียนแล้ว	ar hyn o bryd ddim yn ysgrifennu mwyach	presently retired from writing
ปัญจาบ	punjab	panjab
ปัญโญภาส	panopas	panyopat - a surname
ปัน	rhannu	pan
ปั้น	yr wyddgrug	clay molding
ปั๊บ	ar unwaith	pup
ปาก	y geg	mouth
ปากดี	ceg dda	be talkative
ปากน้ำ	aber	samutpragan province in thailand
ปากีสถาน	pacistan	country of pakistan
ปากเกร็ด	pak kret	pak kret
ปากแม่น้ำสิงคโปร์	ceg singapore	singapore river delta
ปาน	fel	pan - a thai name
ปานามา	panama	panama
ปานแร่	marciau geni	panrae
ปาย	pai	pai
ปาริชาต	parichat	tiger’s claw
ปารีส	paris	paris
ปาร์ค	parc	park
ปาสกาล	pascal	pascal - computer language or name
ปาเลสไตน์	palestina	palestine
ปิปเปอราซิลลิน	aciper piper	piperacillin
ปิยะพงษ์	piyapong	piyapong
ปิ่นเกล้า	pinklao	pin glow - an area in thailand
ปีคศ	blwyddyn	christain era
ปีจอโทศก	blwyddyn y moch	year of the dog
ปีที่	blwyddyn	the year
ปีที่วางจำหน่าย	blwyddyn ryddhau	the year that the product was on the market
ปีพุทธศักราช	blwyddyn bwdhaidd	buddhism year
ปีย์	blwyddyn	pe - a thai music artist
ปีย์ชนิตว์	piyachit	peechanit
ปีเตอร์	pedr	peter
ปี่กลาง	bag canol	a thai woodwind instrument
ปืนพก	pistol	handgun
ปืนพกกึ่งอัตโนมัติ	pistol lled-awtomatig	semi-automatic pistol
ปืนใหญ่	cannon	cannon
ปืนใหญ่กลางกระสุนวิถีโค้ง	cromliniau taflwybr canolig canon	cannon
ปืนไร้แรงสะท้อนถอยหลัง	y gwn recoil	recoilless rifle
ปุณณกันต์	punnakan	bhunnagun
ปุตราจายา	putrajaya	putrajaya
ปุ๋ย	gwrtaith	pui
ปู	cranc	crab
ป่าชายหาด	coedwig y traeth	beach forest
ป่าชายเลน	coedwig mangrove	mangrove forest
ป่าดิบแล้ง	coedwig fythwyrdd sych	dry evergreen forest
ป่าเบญจพรรณ	coedwig gymysg	mixed forest
ป่าโกงกาง	coedwig mangrove	mangrove
ป๊อป	pop	pop
ป๊อปปี้	pabi	poppy
ผจญภัยเกาะมหาสมบัติ	antur treasure island	nobita's south sea adventure
ผดุง	cefnogaeth	phadung
ผล	y canlyniad	result
ผลการแข่งขัน	canlyniadau&#39;r gystadleuaeth	result of competition
ผลงานหนังสือ	portffolio llyfrau	publication
ผลงานเพลง	cerddoriaeth	song production
ผลงานโฆษณา	hysbysebu	marketing project
ผลประเสริฐ	canlyniadau rhagorol	polpasert - last name of the 2nd wife of the thai prince
ผลผลิตพลอยได้	sgil-gynhyrchion	result, effects
ผลรวม	swm	summation
ผลสำรวจ	canlyniadau&#39;r arolwg	survey results
ผิวขาว	croen gwyn	white
ผิวสี	lliw croen	skin color
ผี	yr ysbryd	ghost
ผีน่ารัก	bwgan ciwt	cute ghost
ผู้กำกับ	cyfarwyddwr	producer
ผู้จัดการ	y rheolwr	manager
ผู้จัดการทีม	rheolwr tîm	manager
ผู้ชนะ	yr enillydd	winner
ผู้ชาย	dyn	male, man
ผู้ช่วยศาสตราจารย์	athro cynorthwyol	assistant professor
ผู้ดำเนินรายการ	cymedrolwr	moderator
ผู้บริหาร	gweithrediaeth	manager
ผู้ผลิต	y gwneuthurwr	producer
ผู้ฝึกสอน	hyfforddwr	trainer
ผู้พิทักษ์แห่งพิรุณ	gwarcheidwad trafferth	rain defender
ผู้พิทักษ์แห่งอรุณ	gwarcheidwad y wawr	guardian of the dawn.
ผู้ว่าการธนาคารแห่งประเทศไทย	llywodraethwr banc gwlad thai	governor of the bank of thailand
ผู้ว่าราชการจังหวัด	llywodraethwr	the governor of the city
ผู้สนับสนุน	cefnogwr	supporter
ผู้อำนวยการ	y cyfarwyddwr	superintendent
ผู้เล่น	y chwaraewyr	player
ผู้เล่นชุด	chwaraewr gosod	team
ผู้ใหญ่	oedolyn	adult
ผ่องศรี	phongsri	pongsri
ผ้าขาวม้า	loincloth	a special thai cloth that men used to tie around their waists
ผ้าอนามัยโซฟี	napcynau misglwyf sophie	sofi sanitary napkin
ฝ	mae&#39;r	a letter with ph sound
ฝอยทอง	fuzz	foythong - a thai dessert
ฝิ่น	opiwm	opium
ฝูงชนวุ่นวาย	torf anhrefnus	mob
ฝ่ามือ	y palmwydd	palm
ฝ่ายบริหาร	rheoli	executive branch
ฝ่าเท้า	unig y droed	sole of foot
ฝ่าแดนเขาวงกต	trwy&#39;r ddrysfa	in the boundaries of kao wonkut
ฝ้าย	cotwm	fai
พ	t.	a thai alphabet
พงศ์ศิลป์พิพัฒน์	pongsilp phiphat	pongsinpipat
พงศ์เรืองรอง	pongrueangrong	"surname ""pong reuang-rong"""
พงษ์พานิช	pongpanich	phongphanit
พงษ์เพชร	phong phet	phong phet
พงษ์ไพบูลย์	phongpaibun	pongphatboon
พจนานุกรมออนไลน์	geiriadur ar-lein	online dictionary
พญา	sarff	phaya
พญามังราย	phaya mangrai	mangrai the great
พตท	ardal	three letters acronym
พธม	th	people's alliance for democracy
พนมไพร	phanom phrai	phanom phrai
พบหลักฐานของมนุษย์ซึ่งมีอายุเก่าแก่ที่สุดถึงห้าแสนปี	wedi dod o hyd i dystiolaeth o fodau dynol, yr hynaf hyd at bum can mil o flynyddoedd.	found an evidence of the the oldest human that lived in that area
พยัญชนะ	cytsain	consonant
พยัญชนะสะกดควบกล้ำ	cytsain	diphthong's consonant
พยางค์	sillaf	syllable
พยาธิกำเนิด	pathogenesis	pathogenesis
พยาธิวิทยา	patholeg	pathology
พยาบาล	nyrs	nurse
พยายามชี้ให้สาธารณชนและนานาชาติ	ceisio tynnu sylw&#39;r cyhoedd a rhyngwladol	encourage to promote the people and international policies
พร	porn	wishes
พรนารายณ์	narai	phonnarai
พรบ	deddf	act
พรรคการเมืองใหม่	plaid wleidyddol newydd	kan mai meung political party
พรรคชาติไทย	parti siart gwlad thai	thai nation party
พรรคธรรมาธิปัตย์	parti thammathipat	tamatipat political party
พรรคประชาธรรม	parti prachatham	prachatam political party
พรรคภูมิใจไทย	parti thai phuea	bhumjaithai party
พรรคสม	plaid hafaliad	som rangsi political party
พรรคสังคมประชาธิปไตย	plaid ddemocrataidd gymdeithasol	social democratic party
พรรคเพื่อแผ่นดิน	parti thai pheu	puea pandin party
พรอุดมศักดิ์	phonudomsak	pornudomsak (last name)
พระคาถาชินบัญชร	incantation chinnabanchon	chinbanchon
พระจันทร์	y lleuad	moon
พระจันทร์สีรุ้ง	lleuad enfys	phrachan sirung
พระชนม์	bywyd	the father of the king
พระตำหนัก	palas	the king's residence
พระที่นั่งจักรพรรดิพิมาน	palas yr ymerawdwr phiman	chakraput piman hall
พระที่นั่งดุสิตมหาปราสาท	neuadd orsedd dusit maha prasat	phra thinang dusit maha prasat
พระที่นั่งบรมพิมาน	plasty boromphiman	the king's seat
พระธรรมปิฎก	dhammapitaka	phra thampidok
พระธิดา	merch	daughter
พระนคร	cyfalaf	phra nakhon
พระนาม	enw	name of the king
พระนามต้นราชสกุล	enw cyntaf	the first person in the dynasty
พระนารายณ์	vishnu	narayana
พระบรมธาตุไชยา	creiriau bwdha	buddha's relics chaiya
พระบรมราชชนก	nawdd brenhinol	the king's sister
พระบรมราชินี	frenhines	queen
พระบรมวงศานุวงศ์	breindal	members of the royal family
พระบาทสมเด็จพระนั่งเกล้าเจ้าอยู่หัว	brenin nang klao	jessadabodindra
พระบาทสมเด็จพระปกเกล้าเจ้าอยู่หัว	brenin prajadhipok	phrabat somdet phra poramintharamaha - 7th king of thailand
พระบาทสมเด็จพระปรเมนทรมหาอานันทมหิดล	ei fawrhydi brenin bhumibol adulyadej maha anandamahidol	phra bat somdet phra poramentharamaha ananda mahidol
พระบาทสมเด็จพระพุทธยอดฟ้าจุฬาโลก	phra buddha phra yot fa, chulalongkorn	king rama 1 of chakri monarchy (bangkok)
พระบาทสมเด็จพระเจ้าอยู่หัวภูมิพลอดุลยเดชทรงพระกรุณาโปรดเกล้าฯ	roedd ei fawrhydi brenin bhumibol adulyadej yn falch o raslon	the current king of thailand
พระบาทสมเด็จพระเจ้าอยู่หัวอานันทมหิดล	brenin ananda mahidol	king ananda mahidol
พระบาทสมเด็จพระเจ้าอยู่หัวเสด็จฯ	ei fawrhydi y brenin	the current king
พระปกเกล้าเจ้าอยู่หัว	brenin prajadhipok	king rama vii
พระประแดง	phra pradaeng	prapadaeng
พระปรางค์สามยอด	prang sam yot	prapang samyod
พระพรหมคุณาภรณ์	phra prom khunaporn	pra prhom kunaporn - a person in thailand
พระพันปีหลวง	luang y mileniwm	queen mother
พระพันวัสสาอัยยิกาเจ้า	phra phanwassa aiya	pra paunvatsaeyyigajao - name of a monk
พระพุทธชินราช	phra bwdha chinnarat	phra buddha chinnarat
พระพุทธบาท	ôl-troed bwdha	phra phutthabat
พระพุทธศาสนา	bwdhaeth	buddhism
พระมงกุฏเกล้าเจ้าอยู่หัว	brenin rama iv	phra mongkut klao chao yu hua
พระมเหสี	consort	the wife of a king
พระยศขณะนั้น	bryd hynny	the current title
พระยาชัยสุนทร	phraya chai cyn bo hir	praya chaisoontorn - first mayor of thailand
พระยาราม	hwrdd phraya	prayaram - the governor of sukothai city (the ancient city of thailand)
พระยาวิเศษภักดี	phraya wisetphakdi	praya wiset pakdi -a  name of a head of state in the ancient time
พระยาสุนทรสงคราม	phraya sunthornsongkram	phraya sonthornsongkram (thai name)
พระยาไกรภักดีศรีนครลำดวน	phraya kraiphakdi srinakhon lamduan	phraya kraiphakdi sinakhon lamduan
พระราชกรณียกิจ	dyletswyddau brenhinol	royal duties
พระราชลัญจกรประจำพระองค์	sêl frenhinol	the king's body guard
พระราชวงศ์	teulu brenhinol	royal family
พระราชวรวงศ์เธอ	teulu brenhinol	the title of the princess
พระราชวังดุสิต	palas dusit	dusit palace
พระราชวังเดิม	palas gwreiddiol	phra racha wang derm
พระลอ	phra lor	phra lo
พระสมเด็จจิตรลดา	phra somdej chitralada	pra jitlada - something that was built by the king
พระสัมมาสัมพุทธเจ้า	arglwydd bwdha	buddha
พระองค์เจ้าสิริวัณณวรีนารีรัตน์	ei uchelder brenhinol y dywysoges siriwannawari wareerat	the name of one of the king's granddaughter
พระอังสาเบื้องซ้ายประดับเหรียญรัตนาภรณ์	amulet bwdha addawol ar yr ochr chwith, wedi&#39;i addurno â darnau arian rattanaporn	diagonal sash for the princess
พระอัษฎามหาเจดีย์	phra asada maha chedi	(royal name/language)
พระอิศวร	shiva	the god shiva
พระอิสริยยศ	teitl brenhinol	given rank or honor by the monarchy
พระอุโบสถ	teml bwdhaidd	the temple
พระเกียรติยศ	anrhydedd	royal honour
พระเจ้าลูกยาเธอ	duw blentyn	the royal princess
พระเจ้าหลานเธอ	duw dy nith	hmh princess
พระโคตมพุทธเจ้า	bwdha amulet	pra kotomputtachao - another name of buddha
พรานกระต่าย	heliwr	prankatai - an area in thai province
พราหมณ์	brahmin	brahman
พริกหยวก	pupur cloch	a type of thai pepper
พริกหวาน	pupur cloch	sweet pepper
พริกไทย	pupur	thai pepper
พฤกษศาสตร์	botaneg	botany
พลตรี	llu awyr	major general
พลตรีหญิง	llu awyr benywaidd	a female officer
พลตำรวจเอก	cyffredinol yr heddlu	police general
พลทหาร	milwr	first class, enlisted men
พลศักดิ์	polsak	polsak
พลอย	gemstone	ploy
พลอสนธิ	cyffordd polson	sonthi - a famous thai army officer
พลอากาศเอกหญิง	acm benywaidd	air chief marshal
พลฯ	cyffredinol	private
พลังงานคลื่น	pwer tonnau	wave power
พลังงานนิวเคลียร์	pwer niwclear	nuclear power
พลังงานลม	pwer gwynt	wind power
พลังงานไฟฟ้า	pwer trydan	electrical energy
พลัส	hefyd	plus
พลาซา	plaza	plaza
พลาสติก	plastig	plastic
พลาสมา	plasma	plasma
พลเรือเอก	llyngesydd	admiral
พลเอกสนธิ	sonthi cyffredinol	sonthi - a thai army officer
พวกสัตว์ลำตัวกลม	anifeiliaid corff crwn	animals with no backbones
พศ	gwe	b.e.
พอ	digon	col.
พอตเตอร์	crochenydd	potter
พอตเตอร์กับเจ้าชายเลือดผสม	crochenydd a&#39;r tywysog hanner gwaed	(harry) potter and the half-blood prince
พอยท์	pwynt	point
พอล	paul	paul
พัชรี	phachari	pacharee - a female's name
พัฒน์ชัย	phatchai	pattachai - a male's name, famous singer
พัทยาเหนือ	gogledd pattaya	north pattaya
พัทยาใต้	de pattaya	south pattaya - in thailand
พัน	mil	pan
พันธมิตร	partner	alliance
พันธุศาสตร์	geneteg	genetic
พันธุ์พืช	rhywogaethau planhigion	seed
พันธุ์สุนัข	brîd cŵn	dogs
พันธเสน	bond	panthasen (thai last name)
พับลิชชิ่ง	cyhoeddi	publishing
พัลซาร์	pulsar	pulsar
พากย์เป็น	wedi&#39;i drosleisio fel	subtitle
พายุ	y storm	storm
พารา	para	parasetamol - a drug
พารามีเซียม	parametrig	paramecium
พาร์ค	parc	park
พาวเวอร์บาย	prynu pwer	power buy
พาเมล่า	pamela	pamela
พิชัย	phichai	pichai
พิชิต	gorchfygu	phichit
พิณ	delyn	harp
พิธีกรรายการ	gwesteiwr	host
พิบูลมังสาหาร	phibun mangsahan	pi bul mung sa har (province name)
พิพิธภัณฑสถานแห่งชาติ	amgueddfa genedlaethol	thailand meseum
พิพิธภัณฑ์	yr amgueddfa	museum
พิม	pim	type
พิมประภา	phimprapa	phimprapha
พิมพ์เล็ก	print bach	small photo frame 1.4 cm x 2.1 cm x 0.5 cm thick
พิมลวรรณ	phimonwan	pimonvun - the name of a female anchor person
พิรุณ	dawn	rain water
พิสุทธิ์	gwych	pisut - a male's name
พิออจชา	te phion	piodcha
พิเศษนครกิจ	nakornkit arbennig	pisetnakornkit - a surname
พีท	pete	pete
พีระมิด	pyramid	pyramid
พีระศรี	phirasri	balcony
พีอีเอ	pia	pea
พี่น้อง	frodyr	siblings
พี่สาวของ	chwaer	the sister of ____________
พึ่งสุนทร	dibynnu ar sunthorn	puangsunthorn
พืช	y planhigion	plants
พืชที่สำคัญคือ	mae planhigion pwysig yn	important plants are ...
พืชไม่มีท่อลำเลียง	planhigion heb biblinellau	plants without tubelike structures
พื้นฐานทางเศรษฐกิจ	sail economaidd	base economics
พื้นที่มหาวิทยาลัย	ardal y brifysgol	university area
พุฒตาล	putthan	puttan
พุทธคยา	bodhgaya	bodh gaya
พุทธนิกายเถรวาท	bwdhaeth theravada	a sect of buddhist religion
พุทธศตวรรษที่	bwdhaeth ganrif	buddhist era
พุทธศักราช	oes bwdhaidd	buddhist era
พุ่มพวง	llwyn	poompoang - surname of a famous actor
พู่กัน	brwsh paent	pugun
พ่อขุนรามคำแหง	brenin ramkhamhaeng	the leader of sukothai empire
พ่อขุนศรีอินทราทิตย์	intharathit y brenin	po kun intarathip - the fist king of thailand
พ่อมด	dewin	wizard
พ่ายแพ้ให้กับ	ar goll i	lose to
พ๎ร	croeso	wish
ฟง	fong	fong - a chinese name
ฟรานซ์	franz	franz
ฟรีดริช	friedrich	friedrich
ฟรีด้อม	siglo am ddim	freedom
ฟรีแวร์	radwedd	freeware
ฟลายเวท	pwysau plu	flyweight
ฟลูวาสแตติน	fluvastin	fluvastatin - a drug
ฟอน	von	von - in german name
ฟอร์ด	ford	ford
ฟอสฟอรัส	ffosfforws	phosphorus
ฟอสเฟต	ffosffad	phosphate
ฟังพระธรรมเทศนา	gwrandewch ar bregethau	listen to the gospel
ฟังเพลง	gwrandewch ar gerddoriaeth	listen to music
ฟังไจ	gwrandewch ar jaime	fungi
ฟัน	y dannedd	tooth
ฟาง	gwellt	fhang
ฟาน	fan	van - as in the surname
ฟิชเชอร์	fisher	fisher
ฟินแลนด์	ffinneg	finland
ฟิลิป	philip	philip
ฟิลิปปินส์	philippines	philippines
ฟิลิปีโน	philippino	filipino
ฟิวชัน	ymasiad	fusion
ฟิสิกส์ดาราศาสตร์	astroffiseg	astrophysics
ฟิสิกส์อนุภาค	ffiseg gronynnau	physic particle
ฟีนิลคีโตนูเรีย	phenylketuria	phenylketonuria
ฟีฟ่าคลับเวิลด์คัพ	cwpan y byd clwb fifa	fifa world cup
ฟุตซอล	futsal	futsal
ฟุตบอล	pêl-droed	football
ฟุตบอลอาเซียนเยาวชน	pêl-droed ieuenctid asean	asian youth soccer
ฟุตบอลเอเชียเยาวชน	pêl-droed ieuenctid asiaidd	asian football club youth championship
ฟู	llawn	rise up
ฟูจิ	fuji	fuji
ฟูลส์	baeddu	fools
ฟ้อน	dawns	fon
ฟ้า	glas	blue
ฟ้าร้อง	thunder	thunder
ฟ้าหลัว	haze	haze
ภมรมนตรี	bamamon montri	pamornmontri
ภักดี	teyrngarwch	pakdi
ภัณฑิลา	panthila	paktila - first name of a female actress
ภาคกลาง	rhanbarth canolog	central thailand
ภาคคนแสดง	sioe	human version
ภาคตะวันตก	rhanbarth y gorllewin	west
ภาคตะวันออกเฉียงเหนือ	rhanbarth y gogledd-ddwyrain	northeast region
ภาคพิเศษ	arbennig	special program
ภาควิชาคณิตศาสตร์	adran fathemateg	department of mathematics
ภาควิชาพยาธิวิทยา	adran patholeg	department of pathology
ภาควิชาฟิสิกส์	adran ffiseg	physics
ภาควิชาวิศวกรรมเครื่องกล	adran peirianneg fecanyddol	engineering division
ภาควิชาวิศวกรรมไฟฟ้า	adran peirianneg drydanol	engineering department
ภาควิชาสูติศาสตร์และนรีเวชวิทยา	adran obstetreg a gynaecoleg	gynecology
ภาควิชาเทคโนโลยีอาหาร	adran technoleg bwyd	faculty of food technology
ภาคเหนือ	gogledd	northern region
ภาคใต้ตอนล่าง	rhanbarth deheuol is	southern thailand
ภาพตรา	delwedd sêl	coat of arms
ภาพถ่าย	y llun	photograph
ภาพพาโนรามา	panorama	panoramic image
ภาพพิมพ์	argraffu delwedd	lithography
ภาพยนตร์	y ffilm	movie
ภาพยนตร์การ์ตูนไทย	ffilm cartwn thai	thai cartoon
ภาพยนตร์ชุดนี้	y set ffilm hon	this series
ภาพยนตร์ตอน	pennod	version of the movie
ภาพยนตร์ลามก	ffilm gas	porn movie
ภาพรวม	trosolwg	group of pictures
ภายหลัง	ar ôl	background
ภายหลังสงคราม	ar ôl y rhyfel	after the war
ภายใต้ความช่วยเหลือจากกองทุนการเงินระหว่างประเทศ	o dan gymorth y gronfa ariannol ryngwladol	with the financial help, sponsored by
ภายในวงขอบเหรียญเบื้องบนมีข้อความว่า	o fewn brig y geiniog mae datganiad bod	etching in the medal that ______________
ภารกิจ	cenhadaeth	business
ภาวะเศรษฐกิจของกัมพูชาหลังจากมีการเปลี่ยนแปลงการปกครองจากระบอบสังคมนิยมเป็นระบอบประชาธิปไตย	amodau economaidd cambodia ar ôl y newid o sosialaeth ddemocrataidd i ddemocratiaeth.	cambodia economy after political change
ภาษาญี่ปุ่น	japaneaidd	japanese language
ภาษาบาลี	pali	balese language
ภาษาสเปน	iaith sbaeneg	spanish language
ภาษาอังกฤษ	iaith saesneg	english language
ภาษาอีสาน	iaith y gogledd-ddwyrain	eastern thai language
ภาษาเกชัว	quechua	quechua language
ภาษาเฉพาะอาชีพ	jargon	jargon
ภาษาเบสิก	sylfaenol	basic programming lauguage
ภาษาเยอรมัน	almaeneg	german language
ภาษาโคบอล	cobol	cobol programming language
ภิญโญ	gwych	pinyo - a female's name
ภิรมย์	bodlon	philom
ภิรมย์ภักดี	phirom phakdi	pirompakdee
ภูกระดึง	phukradueng	phu kradueng
ภูกามยาว	phu kam yao	phu kamyao district
ภูธเนศ	bhutanet	putanet - a male's name
ภูพาน	phu phan	phu phan
ภูมิประเทศและภูมิอากาศ	topograffi a hinsawdd	geography and climate
ภูมิภาค	y rhanbarth	region
ภูมิรัตน์	bhumirat	poomirath
ภูหลวง	phu luang	phu luang
ภูเขา	mynydd	mountain
ภูเขาน้ำแข็ง	iceberg	glacier
ภู่สว่าง	phoo sawang	poosawang - a surname
ม	m	a thai alphabet with an 'm' sound
มกราคม	ionawr	january
มจก	m.	the most illustrious order of the royal house of chakri
มณฑลหูหนาน	hunan	hunan in china
มณีวรรณ	maniwan	maniwan
มด	morgrug	ant
มดลูก	uterus	uterus
มต้น	dechreuwch	primary level of secondary school
มธ	tu	abbreviation for thammasat university
มธรรมศาสตร์	prifysgol thammasat	thammasat university
มน	rownd	two letters acronym
มนุษย์	dyn	human
มนุษย์กลายพันธุ์	mutant	human mutant
มนเรศวร	naresuan	naresuan university
มปท	cwlwm	acronyms
มม	mm	mm
มมหิดล	prifysgol mahidol	mahidol university
มยุรา	paun	mayura - a female's name
มลายู	maleieg	malayu
มวยปล้ำ	reslo	wrestling
มสงขลานครินทร์	tywysog songkla	prince of songkla university
มหัพภาค	yn gyffredinol	a symbol used in thai writing
มหาชน	cyhoeddus	public company
มหาชัย	mahachai	mahachai - male's name
มหาบัณฑิต	meistr	graduates from college
มหาปรมาภรณ์ช้างเผือก	maha paramaporn chang phueak	highest class of the order of white elephant
มหาวชิรมงกุฎ	coron mahavajira	the biggest crown of the king
มหาวรรค	mahawan	mahavak - a buddhist priest
มหาวิทยาลัย	prifysgol	university
มหาวิทยาลัยขอนแก่น	prifysgol khon kaen	khon kaen university
มหาวิทยาลัยทักษิณ	prifysgol thaksin	thaksin university
มหาวิทยาลัยนเรศวร	prifysgol naresuan	naresuan university
มหาวิทยาลัยบูรพา	prifysgol burapha	university
มหาวิทยาลัยปทุมธานี	prifysgol pathum thani	pathumthani university
มหาวิทยาลัยพะเยา	prifysgol phayao	prayao university
มหาวิทยาลัยภูมินทร์พนมเปญ	prifysgol phumin, phnom penh	university of phnom penh
มหาวิทยาลัยมหาจุฬาลงกรณราชวิทยาลัย	prifysgol mahachulalongkornrajavidyalaya	chulalongkorn university
มหาวิทยาลัยมหาสารคาม	prifysgol maha sarakham	mahasarakham university
มหาวิทยาลัยมหิดล	prifysgol mahidol	mahidol university
มหาวิทยาลัยรังสิต	prifysgol rangsit	rangsit university
มหาวิทยาลัยราชภัฏบ้านสมเด็จเจ้าพระยา	prifysgol bansomdejchaopraya rajabhat	rajapak bahn somdej jao praya college
มหาวิทยาลัยราชภัฏสงขลา	prifysgol songkhla rajabhat	songkhla rajabhat university
มหาวิทยาลัยราชภัฏสวนสุนันทา	prifysgol suan sunandha rajabhat	suan sunandha rajabhat university
มหาวิทยาลัยราชภัฏอุตรดิตถ์	prifysgol uttaradit rajabhat	uttaradit rajabhat university
มหาวิทยาลัยราชภัฏเทพสตรี	prifysgol thepsatri rajabhat	thepsatri rajabhat university
มหาวิทยาลัยราชภัฏเลย	prifysgol loei rajabhat	loei rajabhat university
มหาวิทยาลัยวงษ์ชวลิตกุล	prifysgol wongchawalitkun	vongchavalitkul university
มหาวิทยาลัยศรีนครินทรวิโรฒ	prifysgol srinakharinwirot	srinakarinvirot university
มหาวิทยาลัยศรีปทุม	prifysgol sripatum	sripatum university
มหาวิทยาลัยศิลปากร	prifysgol silpakorn	silapakorn university
มหาวิทยาลัยสุโขทัยธรรมาธิราช	prifysgol agored sukhothai thammathirat	sukhothai thammathirat open university
มหาวิทยาลัยอีสาน	prifysgol gogledd-ddwyrain lloegr	issan univbersity
มหาวิทยาลัยอุบลราชธานี	prifysgol ucha ratchathani	ubon ratchathani university
มหาวิทยาลัยอ๊อกซฟอร์ด	prifysgol rhydychen	university of oxford
มหาวิทยาลัยเกษตรศาสตร์	prifysgol kasetsart	kasetsart university
มหาวิทยาลัยเทคโนโลยีพระจอมเกล้าพระนครเหนือ	prifysgol technoleg king mongkut gogledd bangkok	king mongkut's university of technology.
มหาวิทยาลัยเทคโนโลยีราชมงคลกรุงเทพ	prifysgol technoleg rajamangala krungthep	rajamangala university of technology krungthep
มหาวิทยาลัยเทคโนโลยีราชมงคลตะวันออก	prifysgol technoleg rajamangala tawan-ok	the eastern university of teachnology
มหาวิทยาลัยเทคโนโลยีราชมงคลธัญบุรี	prifysgol technoleg rajamangala thanyaburi	rajamangala university of technology thanyaburi
มหาวิทยาลัยเทคโนโลยีราชมงคลสุวรรณภูมิ	prifysgol technoleg rajamangala suvarnabhumi	techonology university at rajamongkolsuwannapoom
มหาวิทยาลัยเทคโนโลยีราชมงคลอีสาน	prifysgol technoleg rajamangala isan	rajamangala university of technology isan
มหาวิทยาลัยเปิด	prifysgol agored	open university
มหาวิทยาลัยแม่โจ้	prifysgol maejo	mae joe university
มหาวิทยาลัยแห่งแรกของประเทศไทย	y brifysgol gyntaf yng ngwlad thai	first university of thailand
มองโกเลียใน	mongolia fewnol	mongolia
มอร์ริส	morris	morris
มอส	mwsogl	mos
มอสส์	mwsogl	moss
มอหาดใหญ่	mor hat yai	had yai city in southern thailand
มะขาม	tamarind	tamarind
มะม่วงหิมพานต์	cnau cashiw	mango (anacardium occidentale)
มะริด	myeik	myeik
มะเร็ง	canser	cancer
มังกี้	mwnci	monkey
มังคุด	mangosteen	mangosteen
มัจฉานุ	matcha	majjanu - the son of the giant in a thai legend.  majanu is half monkey and half fish.
มัชฌิมาปฏิปทา	llwybr canol	the middle way
มัทนะพาธา	muthana phatha	matthanaphatha
มัธยฐาน	canolrif	mode (as in statistic)
มัธยมศึกษา	addysg uwchradd	junior high school
มัธยมศึกษาปีที่	gradd	secondary school year
มันติคอร์	manticore	manticore
มัลเจร่า	malera	wonderweiss margera - a cartoon character
มากกว่า	drosodd	more than
มากที่สุด	y mwyaf	most abundant
มากิ	maki	magi osuki - the artist
มาครอส	macross	macross
มาจยาร์	mayar	magyar
มาจากภาษาละติน	o lladin	from latin root
มาซากิ	masaki	masaki
มาดริด	madrid	madrid
มาตรฐาน	safon	standard
มาตรา	adran	article
มานี	mani	mani - a thai name
มายน์ส	mwyngloddiau	mine
มาริสา	marisa	marissa
มาริเบล	maribel	maribel
มาร์ช	cors	march
มาร์ติน	martin	martin
มาร์ตินีก	martinique	martinique
มาร์แชล	marshall	marshall
มาลัยพร	porn malai	malaiphon
มาลากุล	malakul	malakul
มาลี	mali	flower
มาสคาร่า	mascara	mascara
มาเก๊า	macau	macao
มาเฟีย	maffia	mafia
มาเรีย	maria	maria
มาเลเซีย	malaysia	malaysia
มาเลเซียตะวันตก	gorllewin malaysia	west malaysia
มิจิรุ	michiru	mijiru
มิตร	cyfeillgar	mitr
มิตรชัย	mitchai	mitchai
มิตรเพชรา	cyfeillgar	mit pechara - two of famous actors in the old time
มิถุนายน	mehefin	june
มินต์	bathdy	mint
มิลจิ	milji	mulji
มิลตัน	milton	milton
มิลฟีโอเล่	milfi ole	millefiore
มิลลิเมตร	milimedr	millimeter
มิลินทจินดา	milinthinda	milinjinda - a surname of a singer
มิล่า	mila	mila
มิว	mew	mu
มิวฟิลโอเล่	mule phil ole	millefiore
มิวสิกวีดีโอ	fideo cerddoriaeth	music video
มิสทีน	mistine	mistine
มิฮอว์ค	mihawk	mihawk - surname of a character in a japanese movie
มิเกล	miguel	miguel
มิเชล	michelle	michelle
มิเตอร์	mesurydd	meter
มิโร	miro	miro - name
มีขนาดใหญ่	mawr	big
มีข้อความว่า	wedi&#39;i labelu	inscription reads
มีความยาว	cael hyd	has length of
มีความหมายว่า	yn golygu hynny	meaning
มีจำนวน	cael rhif	have the amount of
มีฉายาว่า	gyda&#39;r llysenw	famous for...
มีชื่อว่า	enwyd	is called
มีชื่อเล่นว่า	llysenw	nick name
มีด	cyllell	knife
มีดาบฟันวิญญาณ	gyda chleddyf ysbryd	have a sword to fight the ghost
มีทั้งสิ้น	pawb	own, available
มีทิวเขาล้อมรอบทางเหนือ	gyda mynyddoedd yn y gogledd	surrounded by the mountains in the north
มีน	munud	min - a nick name
มีนบุรี	min buri	minburi province
มีนวิทยา	minoleg	ichthyology
มีนายกรัฐมนตรี	cael prif weinidog	have a prime minister
มีประวัติศาสตร์ยาวนาน	mae ganddo hanes hir	having a long history
มีพรมแดนทางทิศใต้จรดกับอ่าวไทย	gwlff gwlad thai yn ffinio â&#39;r de	having boundaries adjacent to the gulf of thailand
มีภูเขาล้อมรอบอยู่	wedi&#39;i amgylchynu gan fynyddoedd	surrounded by mountains
มีลักษณะดังนี้	mae ganddo&#39;r nodweddion canlynol	has following characteristics
มีลักษณะภูมิประเทศคล้ายชามหรืออ่าง	gyda nodweddion fel bowlen neu fasn	have topography like bowl or basin
มีลาภ	cael ffortiwn	milap
มีล่า	cael helfa	mila
มีสูตรการคำนวณหาจำนวนฟัน	mae fformiwla i gyfrifo nifer y dannedd.	dental formula
มีอยู่	yn bodoli	possess, present
มีอุณหภูมิเฉลี่ย	tymheredd cyfartalog	average temperature
มีอุทยานแห่งชาติสำคัญหลายแห่ง	mae yna lawer o barciau cenedlaethol pwysig.	has many important national parks
มีเดีย	cyfryngau	media
มีโคลซีน	gyda cole scene	meclozine
มือ	y llaw	hand
มู	llyfn	mu
มูลนิธิชัยพัฒนา	sefydliad chaipattana	chaipattana foundation
มูลนิธิอานันทมหิดล	sefydliad anandamahidol	the king's charities
มูลสาร	hanfodion	munsan
มเชียงใหม่	chiang mai	chaing mai university
มโนราห์	manohra	thai dance art
ม้า	y ceffyl	horse
ม้าม	spleen	spleen
ย	mae&#39;r	a thai alphabet with the y sound
ยกเว้น	ac eithrio	except
ยศ	safle	rank
ยอด	y brig	super, great
ยอดนักสืบจิ๋วโคนัน	ditectif conan	conan the detective
ยอดเขาสูงที่สุดของกัมพูชาคือ	copa uchaf cambodia yw	highest mountain in cambodia
ยอพระกลิ่น	yor phra klin	yorpaglin - name of a story
ยัง	ddim eto	young
ยาขับปัสสาวะ	diuretig	diuretic pills
ยาง	y rwber	rubber, tire
ยางธรรมชาติ	rwber naturiol	natural rubber
ยางามิ	yagami	yangami
ยานอนหลับ	pils cysgu	sleeping pills
ยานอวกาศ	llong ofod	rocket ship
ยาบ้า	amffetamin	ya ba
ยาปฏิชีวนะ	gwrthfiotigau	antibiotic
ยามาโตะ	yamato	yamato - a japanese name
ยามาโมโตะ	yamamoto	yamamoto
ยามเย็น	gyda&#39;r nos	sundown, evening time
ยิ่งยง	yingyong	yingyong - a first name
ยิ่งลักษณ์	yingluck	yingluck
ยิ้มสู้	gwen	smile fight
ยีน	genynnau	gene
ยืนยง	dioddef	(inthira) yeenyong - lead singer of budogun band
ยุคกลาง	oesoedd canol	middle age
ยุคก่อนประวัติศาสตร์	oes gynhanesyddol	prehistory
ยุคที่	cyfnod	age
ยุคปัจจุบัน	y cyfnod modern	present age
ยุคศตวรรษที่	oes y ganrif	century
ยุคสามก๊ก	cyfnod y tair teyrnas	three kingdoms - the legend
ยุคอะซึกะ	oes asuka	asuka period
ยุคอาณาจักรเหนือใต้	oes y de a gogledd y de	north-south dynasty
ยุคเรเนสซองส์	oes y dadeni	renaissance
ยุคเฮอัง	oes heian	heian period of japan
ยุคโบราณ	yr amseroedd hynafol	ancient history
ยุคโลหะ	oedran metel	metal age
ยุคใหม่	oes newydd	new age
ยุทธนาวี	brwydr y llynges	naval battle
ยุวธิดา	merch ifanc	yuwatidah
ยุ้ย	gorliwio	yui
ยู	u.	u
ยูกิโอ	yukio	yu-gi-oh
ยูฟ่า	uefa	uefa
ยูริ	yuri	yuri -  a japanese name
ยูโด	judo	judo
ยูโรเพียม	europium	europium
ยูไนเต็ด	unedig	united
ย่านตาขาว	yan khao	yan ta khao
รณชัย	ronnachai	ronnachai
รณภพ	byd	ronapop
รณฤทธิ์	brwydr	ranariddh
รถด่วนสายทางช้างเผือก	y bws cyflym ffordd llaethog	galactic express
รถประจำทางสาย	llinell fysiau	bus number
รถยนต์อเนกประสงค์	car amlbwrpas	automobile
รถลาก	rickshaw	pulled rickshaw
รถโดยสารประจำทาง	bws	passenger bus
รถโดยสารประจำทางสาย	llinell fysiau	bus
รถไฟฟ้าชานเมืองสายสีแดงอ่อน	maestref golau coch	rapid transit light red line
รถไฟฟ้ามหานคร	mrt	metropolitan rapid transit
รฟม	r.o.	public transit
รวดเร็ว	cyflym	rapid
รวม	i gynnwys	total
รวมกับ	wedi&#39;i gyfuno â	add to
รวมทั้ง	gan gynnwys	include
รวมทั้งประเทศที่ให้ความช่วยเหลืออื่นๆ	gan gynnwys gwledydd sy&#39;n darparu cymorth arall	the countries that provided helps
รวมทั้งสิ้น	cyfanswm mawr	result
รวมระยะทางทั้งสิ้น	cyfanswm y pellter	total distance
รศ	cydymaith	ratanakosin era
รหัส	y cod	code
รอก	teclyn codi	roack
รองประธานรัฐสภาคนที่หนึ่ง	is-lywydd seneddol cyntaf	an assistant head of a thai governmental committee
รองประธานสภาคนที่สอง	ail is-lywydd y cyngor	second vice chairman
รองเท้า	yr esgidiau	shoes
รอญับ	arhoswch	seventh month of the hijra calendar
รอบ	o gwmpas	surrounding
รอบคอบ	darbodus	careful
รอบชิงชนะเลิศระดับประเทศ	rowndiau terfynol cenedlaethol	national final round
รอบที่	rownd	round
รอบเมือง	o amgylch y dref	around town
ระดับกระโดดสูง	neidio uchel	high jump  height
ระดับการกระโดดสูง	neidio uchel	high jump
ระดับปริญญาเอก	lefel phd	doctorate degree level
ระดับปริญญาโท	gradd meistr	master's degree
ระดับมัธยมศึกษา	uwchradd	middle school level
ระดับอาชีวศึกษา	lefel alwedigaethol	vocational education
ระนอง	ranong	ranong
ระนาด	seiloffon	ranad - a thai musical instrument
ระนาดทุ้ม	seiloffon	a type of thai musical instrument
ระนาดเอก	alto	ranad eg -  a thai musical instrument
ระบบ	y system	system
ระบบกษัตริย์ของกัมพูชา	brenhiniaeth cambodia	cambodian monarchy
ระบบรัฐสภา	system seneddol	rajya sabha system of governing
ระบบสืบพันธุ์	system atgenhedlu	reproductive system
ระบบสุริยะ	system solar	solar system
ระบบโครงกระดูก	system sgerbwd	skeletal system
ระบบใช้อำนาจเด็ดขาด	system pŵer absoliwt	despotism
ระยะ	tymor	phase
ระยะเวลา	hyd	period
ระยะเวลาการดำรงตำแหน่ง	tymor y gwasanaeth	the term in the office
ระวิ	rhwng	rawi
ระหว่างปี	yn ystod y flwyddyn	between the year
ระหว่างสงครามโลกครั้งที่	yn ystod y rhyfel byd	during wold war
ระเบียง	y balconi	bhirasri
ระเบียบ	rheoliad	regulation
ระโนด	marw	ranode (name of district in thailand)
รักษาศีล	sylwch ar y praeseptau	keep the precepts
รักษาสิ่งแวดล้อม	amddiffyn yr amgylchedd	protect the environment
รักแห่งสยาม	cariad o siam	love thailand
รังสิตคลอง	rangsit khlong	rangsit canal
รังสี	ymbelydredd	radiation
รังสีเอกซ์	pelydr-x	xray
รังสีแกมมา	pelydr gama	gamma ray
รัชกาลที่	teyrnasu	rama
รัชกาลสมเด็จพระจุลจอมเกล้าเจ้าอยู่หัว	teyrnasiad y brenin chulalongkorn	king chula chomklao's reign
รัชดาภิเษก	ratchadaphisek	rajada pisek - a location in thailand
รัฐธรรมนูญแห่งราชอาณาจักรไทย	cyfansoddiad teyrnas gwlad thai	constitution of the kingdom of thailand
รัฐบาลไทย	llywodraeth gwlad thai	thai government
รัฐบุรุษ	gwladwr	statesman
รัฐประหาร	pâr	coup d'état
รัฐประหารในประเทศไทย	pâr yng ngwlad thai	thailand's coup d'état
รัฐมนตรีว่าการกระทรวงคมนาคม	gweinidog trafnidiaeth	transportation secretary of thailand
รัฐวิสาหกิจ	menter y wladwriaeth	financial situation of the country
รัฐวิสาหกิจไทย	mentrau talaith gwlad thai	thai state enterprise
รัฐสภา	senedd	parliament
รัฐสีมาคุณากรปิยชาติ	ratthasima kunakornpiyachat	ratthasimakhunakonpiyachat
รัฐอิลลินอยส์	illinois	state of illinois
รัฐเทกซัส	texas	state of texas
รัตนบุรี	rattanaburi	ratanaburi district - a location in thailand
รัตนาธิเบศร์	rattanathibet	ratana thibet
รับบทโดย	chwarae gan	played by
รับพระราชทาน	derbyn	receive
รัศมี	radiws	radius
รัสเซล	russell	russell
รากแก่น	gwreiddyn craidd	rakkan
รางวัลนักร้องยอดเยี่ยม	gwobr canwr gorau	best singer award
รางวัลนักร้องไทยสากลชายยอดนิยม	gwobr canwr rhyngwladol poblogaidd gwryw thai	best thai male singer award
รางวัลนาฏราช	gwobrau dawnswyr brenhinol	naktarath prize
รางวัลโนเบล	gwobr nobel	nobel prize
รางวัลไนน์เอ็นเตอร์เทน	gwobr naw adloniant	nine entertain awards
ราชตระกูล	teulu brenhinol	royal family
ราชนาวี	llynges	royal navy
ราชมังคลากีฬาสถาน	stadiwm rajamangala	rajamangala national stadium
ราชวงศ์จิ้นตะวันออก	brenhinllin dwyrain jin	east jin dynasty
ราชวงศ์ชิง	brenhinllin qing	ching dynasty
ราชวงศ์ถัง	brenhinllin tang	tang dynasty
ราชวงศ์ทิพย์จักราธิวงศ์	y teulu brenhinol, chakrathiwong	thipjaklatiwong dynasty
ราชวงศ์บ้านพลูหลวง	tŷ brenhinol plu luang	ban phlu luang dynasty
ราชวงศ์พระร่วง	brenhinllin phra ruang	pra roung dynasty
ราชวงศ์หยวน	brenhinllin yuan	yuan dynasty
ราชวงศ์อู่ทอง	brenhinllin u-thong	utong empire in ancient thailand
ราชสกุล	tocynnau	royal family members
ราชสีมา	ratchasima	ratchasima
ราชินิกุล	teulu brenhinol	relatives of the queen
ราบเป็นหน้ากลอง	byddwch yn blaen	flattened like a drum (meaning to be defeated)
รามอินทรา	ramintra	ram inthra
รายการ	y rhestr	show
รายการวันสำคัญทางพุทธศาสนา	rhestr o ddyddiadau bwdhaidd pwysig	important days in buddhism
รายชื่อ	rhestr	list of the names
รายชื่อคำในภาษาไทยที่มักเขียนผิด	rhestr o eiriau thai sy&#39;n aml yn cael eu hysgrifennu&#39;n anghywir	common misspelled thai words
รายชื่อภาพยนตร์ไทย	rhestr o ffilmiau thai	a list of thai movies
รายชื่อหุ่นยนต์ใน	rhestr o robotiaid i mewn	name of robots
รายชื่ออธิการบดี	rhestr o gangellorion	list of presidents
รายชื่อเพลง	rhestr o ganeuon	songs list
รายนามรองอธิการประจำวิทยาเขต	rhestr enwau is-gangellorion ar y campws	llist of deputy directors of the college
รายนามอธิการบดี	rhestr o&#39;r llywydd	chancellor list
รายพระนามพระมหากษัตริย์ไทย	rhestr o frenhinoedd gwlad thai	list of thai monarchs
รายะนาค	raya nak	rayanak
รายได้อื่น	incwm arall	other wages, incomes
ราวพุทธศตวรรษที่	tua&#39;r ganrif	about buddhist era
ราศีธนู	sagittarius	sagittarius
รำพันพิลาป	sgrechian	poem called rum pan pi lab
ริน	arllwyswch	rin
ริมแม่น้ำเจ้าพระยา	glan yr afon chao phraya	near chao praya river
ริวซากิ	ryuzaki	riusaki - from japanese story
ริเอะ	rie	rie tanaga - a japanese singer
รีสอร์ท	cyrchfan	resort
รีเนียม	rhenium	rhenium
รุจิพรรณ	rujipan	pan - a name
รุ่ง	dawn	dawn
รุ่งสว่าง	dawn	rungsawang
รุ่งเพชร	petch rung	roongpetch - a female's name
รูดอล์ฟ	rudolph	rudolf
รูทีเนียม	ruthenium	ruthenium
รูปภาพ	llun	picture
รูปร่าง	y siâp	body
รูปวรรณยุกต์	ffurf tonyddol	tones
รูปสามเหลี่ยมมุมป้าน	triongl aflem	obtuse
รูปสี่เหลี่ยมด้านขนาน	paralelogram	a paralellogram
รูสเวลต์	roosevelt	roosevelt
ร็อดฟอร์ม	ffurflen rod	rock form
ร่วมแสดงกับ	perfformio gyda	costarring
ร้องคู่กับ	canu ynghyd â	sing a duet with
ร้องร่วมกับ	canu gyda	featuring
ร้องโดย	canwyd gan	sung by
ร้อยตรี	ail raglaw	second lieutenant
ร้านอาหาร	bwyty	restaurants
ฤดูกาล	y tymor	season
ฤดูฝน	tymor glawog	rainy season
ฤดูร้อน	tymor poeth	summer
ล	mae&#39;r	a thai alphabet with an l sound
ลงวันที่	dyddiedig	on this date
ลพบุรี	lopburi	lopburi
ลอนดอน	llundain	london
ลอยกระทง	loi krathong	loy kratong festival
ลอร์ด	yr arglwydd	lord
ละคร	y ddrama	play
ละครชาตรี	drama chatri	lakorn-chatri
ละครวิทยุ	drama radio	soap opera broadcasted on the radio
ละครสั้น	drama fer	short drama
ละครเพลง	sioe gerdd	stage musical theatre
ละครโทรทัศน์	opera sebon	television drama
ละติจูด	lledred	latitude
ลักษณะ	y nodweddion	characteristic
ลักษณะทั่วไป	nodweddion cyffredinol	common characteristic
ลักษณะทางกายภาพ	nodweddion corfforol	physical characteristics
ลักษณะภูมิอากาศ	hinsawdd	the type of climate
ลักษณะสำคัญ	nodweddion pwysig	main characteristics
ลักเซมเบิร์ก	lwcsembwrg	luxembourg
ลัคนา	ascendant	ascendant
ลา	hwyl fawr	goodbye
ลานจาตุรงคสันนิบาต	cwadrangle	lan jaturonsunnibat - an ancient place in india
ลามิวูดีน	lamiwoodine	lamivudine
ลายน้ำ	dyfrnod	watetmark
ลาว	laos	lao
ลาออก	ymddiswyddo	resign
ลำดับ	dilyniant	order, sequence
ลำดับพระปฐมวงศ์ในพระบรมราชวงศ์จักรี	trefn y genesis yn llinach chakri	order of the kings
ลำดับพระมหากษัตริย์ไทย	trefn brenin gwlad thai	the order of the kings of thailand
ลำตัว	cefnffordd	body
ลำลูกกา	lam luk ka	lumlookka - a location in thailand
ลำลูกกาคลอง	camlas lam luk ka	lum luk kak klong
ลำไส้เล็ก	coluddyn bach	small intestine
ลิง	y mwnci	monkey
ลิซท์	liszt	(franz) liszt
ลิปปี	blwyddyn wefus	rippi - a surname
ลิพิด	gwefus	lipid
ลิฟวิ่งมอลล์	living mall	living mall
ลิเก	drama werin gerddorol	like
ลิเทียม	lithiwm	lithium
ลีกคัพ	cwpan y gynghrair	league cup
ลีซอ	lisu	lisu
ลีเมอร์	lemur	lemur
ลี้	li	lee, a district in lumpoon province.
ลี้สุวรรณ	li suwan	lisuwan
ลุงบุญมีระลึกชาติ	cenedl dwyn i gof wncwl boonmee	uncle boonmee who can recall his past lives
ลูกปัด	y gleiniau	beads
ลูกสาว	merch	daughter
ลูกอม	candy	candies
ลูกอัณฑะ	ceilliau	testis
ลูซิเฟอร์	lucifer	lucifer
ลูน่า	luna	luna
ล่าทา	hela	lata
ล่ำซำ	lwmp	lumsum
ล้อม	besiege	lom
ล้อแม็กซ์อัลลอยขนาด	olwynion aloi, maint	alloy wheel
วง	y band	band
วงจรไฟฟ้า	cylched drydan	electrical circuit
วงดนตรี	band	band
วงศ์กำแหง	teulu	wongkumhang - surname of a famous singer
วงศ์ถั่ว	teulu cnau	fabaceae
วงศ์ปลากดทะเล	teulu pysgod	ariidae
วงศ์ปลากะรัง	grwpiwr	serranidae family
วงศ์ปลายอดม่วง	wong pla yot muang	tonguefish
วงศ์ปลาหลังเขียว	pysgod gwyrdd	clupeidae - a type of fish
วงศ์ปลาเนื้ออ่อน	cichlid	siluridae
วงศ์ปลาเสือตอ	teulu pysgod teigr	datnioididae
วงศ์พัวพันธ์	phan wongpua	wongpourpan
วงศ์วิริยะ	wiriya	vongsiriya - a surname
วงศ์เทวัญ	teulu	wongthewan
วงศ์แคหางค่าง	wong khae hang kong	plants in kae-hang-kang family
วงษ์คำเหลา	wong kham lao	wongkamlao
วงเงิน	terfyn	budget
วงเวียน	cylchfan	circle
วงแหวน	ffoniwch	ring form, circle form
วชิรบรรจง	wachirabunjong	wachibanjong
วทบ	dd	bachelor of science
วนอุทยานถ้ำจัน	parc coedwig tham chan	tham chan forest park
วนิดา	wanida	wanida - the name of a drama
วร	wor	won
วรรณกรรม	llenyddiaeth	literature
วรรณสุทธิ์	wansut	wannasut - surname of an actress
วรรธนพิสิฐกุล	watthon phisitkun	wanthanaphisitkun
วรัทยา	warutya	varattaya (first name)
วว	dd	office of ____________
วอก	mwnci	wok
วองโกเล่แฟมิลี	teulu vongola	vongola family
วอชิงตัน	washington	washington
วอลท์	walt	walt
วอล์ค	cerdded	walk
วะสี	wasi	wasee
วัง	palas	palace
วังจันทร์	wang chan	wang-chan
วังสระปทุม	palas sra pathum	srapathum palace
วังสะพุง	wang saphung	wang saphung
วังหลัง	palas	wang lang
วังหิน	palas cerrig	rock castle
วัชรพล	watcharapol	watcharapol supermarket
วัฒนชัย	watthanachai	wattanachai - a surname
วัฒนธรรม	y diwylliant	culture
วัฒนวิทูกูร	wattanawitkun	watthanawithukun
วัฒนา	wattana	wattana
วัดกลาง	teml ganolig	wat klang
วัดป่าเลไลยก์วรวิหาร	wat pa lelai worawihan	wat palaylay
วัดพระธาตุดอยสุเทพราชวรวิหาร	wat phra bod doi suthep, ratchaworawihan	wat pratatdoisuthep rachavoravihan - the temple erected on top of doi suthep in northern thailand
วัดพระฝางสวางคบุรีมุนีนาถ	wat phra fang sangkhaburi muninat	prhafangsawangkaburimuninat temple
วัดพระมหาธาตุวรมหาวิหาร	wat phra mahathat woramahaviharn	wat phramahathat woramahawihan
วัดพระยืนพุทธบาทยุคล	wat phra yuen phutthayakhon	the standing buddha temple of puttabatyukol
วัดพระลอย	teml phra loi	wat phra loi
วัดพระศรีรัตนมหาธาตุ	wat phra si rattana mahathat	wat phra si rattana mahathat
วัดพระเชตุพนวิมลมังคลารามราชวรมหาวิหาร	teml phra chetuphon vimolmangklararam	wat pra chetpnvimolmungklaramrajavoramahavihan
วัดระฆังโฆสิตาราม	teml rakhangkosaram	wat rakang kositaram (name of temple)
วัดสองพี่น้อง	teml cân phi nong	two siblings temple
วัดสุทัศนเทพวรารามราชวรมหาวิหาร	teml wararam suthasan thep	wat sutatthepvararamrajavorimahavihan - a temple in thailand
วัดหนองเพียร	teml nong phian	wat nong pien - a temple in thailand
วัดหน้าพระธาตุ	na phra y deml honno	wat na pra tat - a buddhist temple
วัดเจดีย์หลวง	teml chedi luang	wat pagoda
วัดโพธิ์	wat pho	wat po - a thai temple
วัตต์	watts	watt
วัตสัน	watson	watson
วัน	y diwrnod	day
วันชัย	wanchai	wanchai - a male's name
วันที่ขึ้นเครื่องหมาย	dyddiad llofnodi	excluding dividend day
วันที่ออกอากาศชื่อตอนแขกรับเชิญ	dyddiad darlledu, enw&#39;r bennod, ymddangosiad gwestai	when the invitation comes out
วันที่เข้าฉาย	dyddiad rhyddhau	release date
วันนี้ที่รอคอย	aros heddiw	the day that one has been waiting for
วันพฤหัสบดี	dydd iau	thursday
วันพุธ	dydd mercher	wednesday
วันมหาสงกรานต์	diwrnod maha songkran	songkran day
วันละ	diwrnod	per day
วันศุกร์	dydd gwener	friday
วันสงกรานต์	diwrnod songkran	songkran day
วันสำคัญ	diwrnod pwysig	important day
วันสำคัญทางพุทธศาสนา	diwrnod bwdhaidd pwysig	buddhist holidays
วันหยุดราชการ	gwyliau cyhoeddus	national holiday
วันอังคาร	dydd mawrth	tuesday
วันอาทิตย์	dydd sul	sunday
วันอาสาฬหบูชา	diwrnod bucha asanha	asalha puja
วันเกิด	pen-blwydd	birthday
วันเสาร์	dydd sadwrn	saturday
วันแรม	diwrnod	the phase of the moon
วัย	yn oed	age
วัลลิโภดม	walliphodom	wanliphodom
วัสดุฟิสไซล์	deunydd hydwyth	fissile material
วานูอาตู	vanuatu	vanuatu, australia
วารินชำราบ	chamrap warin	warinchamrap
วาลคิรี	valkyrie	valkyrie - angel that helped in valhalla war
วาลีน	valine	valine - a type of protein
วาเรีย	varia	varia
วาเลนไทน์	dydd san ffolant	valentine
วาไรตี้	amrywiaeth	variety
วิกตอร์	victor	victor
วิคตอเรีย	victoria	victoria
วิจัย	ymchwil	investigate, study
วิจิตรศิลป์	celfyddydau cain	fine art
วิชาการ	academaidd	academic
วิชาการคอม	cyfrifiadur academaidd	vcharkarn.com
วิชิต	wichit	wichit - a male's name
วิญญาณ	yr ysbryd	soul
วิฑูรย์	llygad y gath	witoon
วิดีโอเกม	gêm fideo	video game
วิตามินอี	fitamin e.	vitamin e
วิทยาการคอมพิวเตอร์	cyfrifiadureg	computer courses
วิทยาการระบาด	epidemioleg	epidemiology
วิทยาลัยการจัดการเพื่อการพัฒนา	coleg rheoli datblygu	management for development college
วิทยาลัยการบริหารรัฐกิจ	coleg gweinyddiaeth gyhoeddus	management college
วิทยาลัยครูสวนสุนันทา	coleg athrawon suan sunandha	soun sunanta teachers college
วิทยาลัยดุริยางคศิลป์	coleg cerdd	college of music
วิทยาลัยนวัตกรรมและการจัดการ	coleg arloesi a rheolaeth	the college specialized in arts
วิทยาลัยพยาบาลกองทัพเรือ	coleg nyrsio&#39;r llynges	royal thai navy college of nursing
วิทยาลัยพยาบาลบรมราชชนนี	coleg nyrsio boromarajonani	nursing university of barom raj chonnani
วิทยาลัยพาณิชยศาสตร์	coleg masnach	panitsat university
วิทยาลัยวิชาการศึกษา	coleg addysg	college of education
วิทยาลัยเทคนิคธนบุรี	coleg technegol thonburi	king mongkut's university of technology thonburi
วิทยาลัยแพทยศาสตร์พระมงกุฎเกล้า	coleg meddygaeth phramongkutklao	phramongkutklao college of medicine
วิทยาศาสตรมหาบัณฑิต	meistr o wyddoniaeth	master of science
วิทยาศาสตร์สุขภาพ	gwyddor iechyd	health science
วิทยาศาสตร์และเทคโนโลยี	gwyddoniaeth a thechnoleg	science and technology
วิทยาเขต	y campws	campus
วิทยาเขตกาญจนบุรี	campws kanchanaburi	kanchanaburi college
วิทยาเขตนครศรีธรรมราช	campws nakhon si thammarat	nakhon si thammarat campus
วิทยาเขตพิษณุโลก	campws phitsanulok	pissanulok college
วิทยาเขตสารสนเทศเพชรบุรี	campws technoleg gwybodaeth phetchaburi	information technology college of petchaburi
วิทยาเขตสุพรรณบุรี	campws suphanburi	suphanburi campus
วิทยาเขตสุรินทร์	campws surin	surin university
วิทยาเขตหนองคาย	campws nong khai	nong kai university
วิทยาเขตเฉลิมพระเกียรติ	campws chaloem phrakiat	vittaya kat chalerm pra kiet - a location at kasetsat university in thailand
วิทยุ	radio	radio
วิธีการหาความสัมพันธ์	sut i ddod o hyd i berthnasoedd	formula for the correlation coefficient
วินชี	vinci	vinci
วินัย	disgyblaeth	manners
วินเนอร์	enillydd	winner
วิบูลย์	hwyl fawr	wibul - a male's name
วิมเบิลดัน	wimbledon	wimbledon
วิลลี่	willy	willy
วิลเลจ	pentref	village
วิลเลียม	william	williams
วิลเลี่ยม	william	william
วิวัฒนาการ	esblygiad	evolution
วิวัฒน์	esblygu	produce, making up, invent
วิวัฒน์เกียรติ	wiwat kiat	wiwatkiat
วิศว	peirianneg	engineering
วิศวกร	peiriannydd	engineer
วิศวกรรมวัสดุ	peirianneg deunydd	material engineering
วิศวกรรมสิ่งแวดล้อม	peirianneg amgylcheddol	environmental engineering
วิศวกรรมเครื่องกล	peirianneg fecanyddol	engineering
วิศวกรรมไฟฟ้า	peirianneg drydanol	electrical engineering
วิสา	wisisa	wisa
วิสูตร	diagnostig	wisut
วิหาร	cysegr	vihara
วิเศษ	hud	wiset
วิเศษแก้ว	gwydr hud	visetkeaw - surname of a singer
วิโนทัย	vinothai	winothai
วีดีโอ	fideo	video
วีดีโอเกม	gêm fideo	video game
วีรบุรุษ	arwr	hero
วีระ	veera	veera
วีระยุทธ	wirayut	werayut - a male's name
วีออส	vios	vios
วุฒิสภา	senedd	senate
วุฒิเมธี	wuttimethi	wuttimethi - a surname
ว้าวุ่น	tynnu sylw	wawun
ศ	yr athro	a thai alphabet
ศร	saeth	arrow
ศรชัย	sornchai	sornchai - a male's name
ศรายุทธ	sarayuth	sarayut - a male's name
ศรีนครินทร์	srinakarin	srinakarin
ศรีนวล	srinual	sinuan
ศรีบุญเรือง	sri bunrueang	si bun rueang
ศรีประจวบ	si prachuap	siprachuap
ศรีปาน	sri pan	sri pan - a surname
ศรีมะฆะ	sri makha	sirimaka - a thai name
ศรียาภัย	sriyapai	siyaphai
ศรีสวัสดิ์	srisawat	srisawat -  a surname
ศรีสำโรง	si samrong	si samrong
ศรีเมือง	sri mueang	srimuang
ศรีไพร	sri phrai	sri prai - a name
ศรเพชร	saeth diemwnt	sonpet
ศศิธร	sasithorn	sasitorn - a females name
ศักดิ์ศรี	bri	dignity
ศักย์ไฟฟ้า	potensial trydan	electric potential
ศัพท์	terminoleg	vocabulary
ศาลชั้นต้น	llys sifil	curcuit court
ศาลหลักเมือง	cysegrfa piler y ddinas	the old court house
ศาลเจ้าพ่อหลักเมือง	cysegrfa piler y ddinas	the city's god
ศาสตราจารย์	athro	professor
ศาสนา	y grefydd	religion
ศาสนาพราหมณ์ฮินดู	hindŵaeth	hindu religion
ศาสนาฮินดู	hindŵaeth	hinduism
ศาสนาโซโรอัสเตอร์	zoroastrianiaeth	zoroastrianism
ศิริวรรณ	siriwan	siriwan - a female's name
ศิลปอาชา	art archa	silpa-archa
ศิลปะ	y gelf	arts
ศิลปะการแสดง	celf perfformio	performing arts
ศิลปะลพบุรี	celf lopburi	lopburi art
ศิลปะศรีวิชัย	celf srivijaya	arts from sri vi chai province
ศิลปะเขมร	celf khmer	cambodian arts
ศิลปะเครื่องปั้นดินเผา	celf crochenwaith	pottery art
ศิลปะเชียงแสน	celf chiang saen	chaingsan art
ศิลปินแห่งชาติ	artist cenedlaethol	national artist
ศิลป์	celf	silpa
ศิษย์เก่าคณะมนุษยศาสตร์	cyn-fyfyrwyr cyfadran y dyniaethau	former humanity student
ศิษย์เก่าคณะรัฐศาสตร์	cyn-fyfyrwyr cyfadran gwyddor gwleidyddol	faculty of political science alumni
ศิษย์เก่าคณะเศรษฐศาสตร์	cyn-fyfyrwyr y gyfadran economeg	economics alumni
ศีรษะ	y pen	head
ศึกนันทบุเรง	brwydr nanthabureng	suknuntabureng -  a war in thailand
ศึกษาศาสตร์	addysg	field of education
ศุกลวัฒน์	sukonwat	sukolawat (a person's name)
ศุภกิจ	supakit	supphakit
ศุภณัฐ	suphanat	supanat (first name)
ศูนย์	y ganolfan	center
ศูนย์การค้า	canolfan siopa	shopping center
ศูนย์การบินทหารบก	canolfan hedfan y fyddin	marine forces
ศูนย์การศึกษาแม่ฮ่องสอน	canolfan addysg mae hong son	maehongsorn learning center
ศูนย์คอมพิวเตอร์	canolfan gyfrifiaduron	computer center
ศูนย์ค้าส่ง	canolfan gyfanwerthu	wholesale center
ศูนย์บริการวิชาการ	canolfan gwasanaethau academaidd	academic service center
ศูนย์ภาษา	canolfan iaith	language center
ศูนย์รังสิต	canolfan rangsit	rangsit university center
ศูนย์ลำปาง	canolfan lampang	lampang center
ศูนย์แพทยศาสตรศึกษาชั้นคลินิก	canolfan addysg glinigol	medical education center
สก	sgriw	abbreviation of two letters
สกว	trf	trf
สกอ	yr alban	office of higher education commission
สกอตแลนด์	yr alban	scotland
สกาย	sky	sky
สกุล	teulu	sakun
สกุลหยาดน้ำค้าง	sundew	d. etrythrorhiza - a type of plant
สกุลเพชรหึง	petcheng	grammatophyllum
สควอโล่	squalo	squalo
สงคราม	y rhyfel	war
สงครามครูเสด	croesgad	crusades war
สงครามมหาเอเชียบูรพา	rhyfel mawr dwyrain asia	world war two
สงครามอวกาศ	rhyfel gofod	space war
สงครามเกาหลี	rhyfel corea	korean war
สงครามเย็น	rhyfel oer	cold war
สง่าพล	cain	sangapol - a thai surname
สด	ffres	fresh
สตรอเบอรี่	mefus	strawberry
สตรีวิทยา	radioleg	satriwithaya
สติปัญญา	cudd-wybodaeth	intelligence
สตึก	satun	satuek (name of district)
สตูดิโอ	y stiwdio	studio
สถานที่ท่องเที่ยวทางธรรมชาติ	atyniadau naturiol	natural attraction
สถานะ	statws	status
สถานีคาราวาน	gorsaf garafán	caravan station
สถานีวิทยุโทรทัศน์ไทยทีวีสีช่อง	gorsafoedd teledu gwlad thai gyda sianeli teledu lliw	thai television station number _____
สถานีโทรทัศน์ไทยพีบีเอส	gorsaf deledu pbs thai	thai public broadcasting service
สถาบัน	sefydliad	office, department
สถาบันการศึกษา	sefydliad addysgol	educational institution
สถาบันบัณฑิตพัฒนบริหารศาสตร์	sefydliad cenedlaethol gweinyddiaeth datblygu	satabunbunthitpakanabarihansart - a university in thailand, as known as nida
สถาบันพระบรมราชชนก	sefydliad brenhinol	red cross department
สถาบันวิจัยจุฬาภรณ์	sefydliad ymchwil chulabhorn	julapon academy
สถาบันวิจัยและพัฒนา	sefydliad ymchwil a datblygu	reseach and development institution
สถาบันศูนย์และหน่วยงานในมหาวิทยาลัย	sefydliadau, canolfannau, ac adrannau mewn prifysgolion	current faculties/college/school/institutes
สถาบันสมทบ	sefydliad cysylltiol	affiliated institute
สถาบันอาชีวศึกษา	sefydliad galwedigaethol	ahchevasuksa academy
สถาบันอุดมศึกษา	sefydliad addysg uwch	higher education institute
สถาบันเทคโนโลยีนานาชาติสิรินธร	sefydliad technoleg rhyngwladol sirindhorn	sirindhorn international institute of technology
สถาบันเทคโนโลยีพระจอมเกล้า	sefydliad technoleg king mongkut	king mongkut's institute of technology
สถาบันเทคโนโลยีพระจอมเกล้าเจ้าคุณทหารลาดกระบัง	sefydliad technoleg king mongkut ladkrabang	king mongkut's institute of technology ladkrabang
สถาบันเทคโนโลยีราชมงคล	sefydliad technoleg rajamangala	rajamangala university of technology
สถาบันโภชนาการ	sefydliad maeth	institute of nutrition
สถาปนิก	y pensaer	architect
สถาปัตยกรรมไทย	pensaernïaeth gwlad thai	architecture of thailand
สถิติศาสตร์	ystadegau	statistic
สธ	sth	two letters from thai alphabets
สนธยา	cyfnos	twilight
สนธิ	cyffordd	sonti - a male's name
สนธิไชย	sonthichai	sontichai
สนามกีฬากลาง	stadiwm ganolog	main athletic field
สนามชัยเขต	sanam chai khet	sanamchaikate - a location in thailand
สนามฟุตบอล	cae pêl-droed	football field
สนามแม่เหล็ก	maes magnetig	magnetic field
สนามไฟฟ้า	maes trydan	electric field
สนิทวงศ์	sanit wong	there are families.
สนิม	rhwd	rust
สนเกรวิลเลีย	grawnwin pinwydd	grevilea - family of 250 types of plants
สปริงฟิลด์	springfield	springfield
สปรินเตอร์	sprinter	sprinter
สปาร์ค	gwreichionen	spark
สพ	spec	oc
สภานิติบัญญัติแห่งชาติ	cynulliad deddfwriaethol cenedlaethol	national diet
สภาผู้แทนนิสิต	cyngor cynrychiolwyr myfyrwyr	college student representatives
สภาพอากาศ	y tywydd	weather conditions
สมจิตต์	somchit	somjit - a female's name
สมจิตร	somchit	somjit
สมชัย	somchai	somchai
สมชาย	somchai	somchai - a male's name
สมภพ	geni	sompob
สมศรี	somsri	somsi
สมศักดิ์	somsak	somsak
สมัคร	ymgeisiwch	samak
สมัย	cyfnod	era
สมัยกรุงธนบุรี	cyfnod thonburi	thonburi era
สมัยก่อนประวัติศาสตร์	amserau cynhanesyddol	prehistory
สมัยที่	pryd	term
สมัยรัชกาลที่	teyrnasu	in the reign of
สมัยสุโขทัย	cyfnod sukhothai	sukothai era
สมัยอาณานิคมฝรั่งเศส	cyfnod trefedigaethol ffrainc	modern france
สมาคมประชาชาติแห่งเอเชียตะวันออกเฉียงใต้	cymdeithas cenhedloedd de-ddwyrain asia	association of south east asian nations (asean)
สมาชิกรับเชิญตอนพิเศษ	gwahoddwyd aelodau ar gyfer pennod arbennig	special guests
สมาชิกฤดูกาลที่	aelodau&#39;r tymor	member of the parliament
สมุทวณิช	samutavanich	samudavanija
สมเด็จ	ei fawrhydi	your highness
สมเด็จพระนางเจ้ารำไพพรรณี	y frenhines rambhai barni	queen rambhai barni
สมเด็จพระนางเจ้าสิริกิติ์	y frenhines sirikit	queen sirikit
สมเด็จพระนางเจ้าฯ	ei mawrhydi	the queen of thailand
สมเด็จพระบรมราชาที่	y brenin	king
สมเด็จพระบรมโอรสาธิราช	tywysog y goron	his highness, royal crowned prince
สมเด็จพระบรมโอรสาธิราชฯ	tywysog y goron	the crown prince of thailand
สมเด็จพระมหิตลาธิเบศร	latibes phd mahidol somdet	somdet phra mahitra thibet
สมเด็จพระรามาธิบดีที่	brenin ramathibodi	som dej pra rama tippadee #_____ , number of the king
สมเด็จพระศรีนครินทราบรมราชชนนี	ei uchelder brenhinol y dywysoges maha chakri sirindhorn	queen sirikit
สมเด็จพระอนุชาธิราช	somdej anuchatthirat	som dej pra ah nu cha thi raj - a famous royalty in thailand a long time ago
สมเด็จพระเจ้ากรุงธนบุรี	krung thon buri	the king of the thonburi kingdom
สมเด็จพระเจ้าภคินีเธอ	ei huchelder brenhinol	the king's sister, som dej pra jao pakini ther
สมเด็จพระเจ้าลูกเธอ	ei huchelder brenhinol	the king's daughter, the princess
สยามดารา	siam dara	siam stars
สยามบรมราชกุมารี	siam	the current king's eldest daughter, the eldest princess
สยามพารากอน	siam paragon	siam paragon
สร	creu	abbreviation for the royalties' accessories
สรรพสินค้า	siop adrannol	department store
สราวุธ	sarawut	sarawut
สร้าง	adeiladu	build
สลักใจ	argraff	salakchai
สวนดุสิตโพล	pôl suan dusit	suan dusit poll
สวนผึ้ง	suan phueng	bee garden
สวนสมเด็จพระศรีนครินทร์	parc somdet phra srinagarindra	pra sri nakarin - a king of thailand
สวรรคต	pasio i ffwrdd	die
สวรรคตหรือ	wedi pasio i ffwrdd	die or ___________
สวรรคโลก	sawankhalok	heaven on earth
สวัสดิ์	sawat	sawat - a male's name
สวัสดีปีใหม่	blwyddyn newydd dda	happy new year
สวิตเซอร์แลนด์	swistir	switzerland
สวี	ystafelloedd	sawi
สส	cyfrinach	representatives
สหพันธ์สาธารณรัฐเยอรมนี	gweriniaeth ffederal yr almaen	germany
สหรัฐอาหรับเอมิเรตส์	emiradau arabaidd unedig	arab emirate
สหรัฐอเมริกา	taleithiau unedig america	america, usa
สหราชอาณาจักร	teyrnas unedig	united kingdom
สหวงษ์	sahawong	sawong - a male's name
สองสาย	dwy wifren	double-stranded
สอยดาว	uppercut	soidao
สะดวก	cyfleus	convenient
สะตอ	sato	sator
สะล้อ	brêc	salao
สะเดา	neem	neem, a type of plant
สัจธรรม	y gwir	normal truth; common knowledge
สัญญา	yr addewid	sanya
สัญลักษณ์ประจำมหาวิทยาลัย	logo&#39;r brifysgol	logo of the university
สัดส่วน	cyfran	ratio
สัตว์	yr anifail	animal
สัตว์มีกระดูกสันหลัง	fertebratau	vertebrate animals
สัตว์มีแกนสันหลัง	sbin	chordata
สัตว์เลี้ยงลูกด้วยน้ำนม	mamaliaid	mammal
สัตว์เลื้อยคลาน	ymlusgiad	reptile
สัตว์เลื้อยคลานในอันดับนี้	ymlusgiaid yn y rheng hon	reptile in this order
สัทศาสตร์	seineg	phonetics
สันติ	heddwch	peace
สันติสุข	heddwch	santi suk
สัมผัสนอก	datguddio	outside touch
สัมพันธ์	perthynas	relationship
สัมมา	reit	summa - the buddhist prayer often starts with this
สาขา	cangen	office location
สาขานครราชสีมา	cangen nakhon ratchasima	nakhon ratchasima branch
สาขานครสวรรค์	cangen sawan nakhon	nakhon sawan branch
สาขานิเทศศาสตร์	celfyddydau cyfathrebu	faculty of communication arts
สาขาประจวบคีรีขันธ์	cangen prachuap khiri khan	prachuap khiri khan branch
สาขาปราจีนบุรี	cangen prachinburi	pracheenburi branch
สาขาพิษณุโลก	cangen phitsanulok	pisanulok location
สาขามนุษยศาสตร์	dyniaethau	humanities
สาขาย่อย	is-gangen	offices
สาขาลำปาง	cangen lampang	lumpang location
สาขาวิชานิติศาสตร์	cyfadran y gyfraith	law department
สาขาวิชาบริหารธุรกิจ	rhaglen gweinyddu busnes	business administration program
สาขาวิชารัฐประศาสนศาสตร์	adran gweinyddiaeth gyhoeddus	local government
สาขาวิชาวิทยาการคอมพิวเตอร์	rhaglen cyfrifiadureg	school of computer science
สาขาวิชาวิศวกรรมคอมพิวเตอร์	rhaglen peirianneg gyfrifiadurol	computer engineering
สาขาวิชาวิศวกรรมอาหาร	peirianneg bwyd	food engineering
สาขาวิชาวิศวกรรมอิเล็กทรอนิกส์	rhaglen peirianneg electronig	major electronic engineering
สาขาวิชาศิลปอุตสาหกรรม	adran gelf	arts department
สาขาวิชาเคมี	adran cemeg	department of chemistry
สาขาวิชาเทคโนโลยีชีวภาพ	rhaglen biotechnoleg	department of biotechnology
สาขาวิชาเศรษฐศาสตร์	economeg	finance department
สาขาศิลปะสถาปัตยกรรม	pensaernïaeth celf	art and architecture branch
สาขาสมุย	cangen samui	smui branch
สาขาหัวหิน	cangen hua hin	hoa hin branch
สาครสินธุ์	pechod sakorn	sakornsin - a surname
สาทร	sathorn	sathon
สาธารณรัฐประชาชนจีน	gweriniaeth pobl tsieina	people's republic of china
สาธารณรัฐออสเตรีย	gweriniaeth austria	republic of austria
สาธารณรัฐอินโดนีเซีย	gweriniaeth indonesia	republic of indonesia
สาธารณรัฐเช็ก	gweriniaeth tsiec	czech republic
สาธารณรัฐโดมินิกัน	gweriniaeth ddominicaidd	republic dominican
สานติวัตร	santiwat	santiwat
สามก๊ก	tair teyrnas	three kingdom 'sam kok' - a thai legend
สามชัย	sam chai	samchai - a location in thailand
สามชุก	sam chuk	sam chuk district
สามพราน	sampran	sam phran
สามอัศวินในจินตนาการ	tri marchog ffantasi	sam assavin in jintanakan - the name of a japanese story
สามัญ	cyffredin	common
สายการบิน	airlines	airline
สายรัชกาลที่	teyrnasiad hwyr	family tree of king rama ...
สายรุ้ง	enfys	rainbow
สายสนั่น	llinell thunder	siasanan
สายสีชมพู	llinell binc	pink line
สายสีน้ำเงิน	llinell las	blue line
สายสีม่วง	llinell borffor	purple line (rapid transit)
สายหมอก	niwl	fog
สายเดียว	llinell sengl	single helix
สายเมืองทอง	llinell mueang thong	muang thong line
สารต้านอนุมูลอิสระ	gwrthocsidyddion	antioxidants
สารพฤกษเคมี	ffytochemistry	phytochemical
สารภี	saraphi	saraphi
สารละลาย	datrysiad	solution
สารานุกรมไทย	gwyddoniadur gwlad thai	saranukromthai
สารานุกรมไทยฉบับราชบัณฑิตยสถาน	rhifyn sefydliad brenhinol gwyddoniadur gwlad thai	thai's publication
สารีวงษ์	sareewong	sariwong
สาวิตรี	savitri	sawitri
สาเหตุ	achos	reasons
สำนวนเก่า	hen idiom	old aphorism
สำนักงานขนส่งกรุงเทพมหานครพื้นที่	swyddfa cludiant ardal bangkok	thai general transport
สำนักงานคณะกรรมการวัฒนธรรมแห่งชาติ	swyddfa&#39;r comisiwn diwylliant cenedlaethol	office of arts and culture preservation of thailand
สำนักงานโครงการพัฒนาแห่งสหประชาชาติ	swyddfa rhaglen ddatblygu&#39;r cenhedloedd unedig	united nations development prograท
สำนักระบาดวิทยา	swyddfa epidemioleg	bureau of epidemiology
สำนักราชเลขาธิการ	ysgrifenyddiaeth	operation department of the king's palace
สำนักวิทยบริการ	swyddfa adnoddau academaidd	office of academic services
สำนักหอสมุด	llyfrgell	library
สำนักหอสมุดกลาง	llyfrgell ganolog	the central library
สำรวจ	arolwg	investigate
สำราญ	yn gleefully	happily
สำหรับ	canys	for
สำหรับประเทศไทย	ar gyfer gwlad thai	for thailand
สำหรับใช้เป็นตราหัวหนังสือราชการไทย	i&#39;w ddefnyddio fel sêl ar gyfer llythyr swyddogol llywodraeth gwlad thai	emblem thailand garuda
สำหรับในปี	canys yn y flwyddyn	for the year
สำเนียง	acen	dialect
สำโรง	samrong	sumrong - a location in thailand
สิงหาคม	awst	august
สิงหไตรภพ	tripha singha	sing tri pop - a thai drama
สิงโต	llew	lion
สิทธิ	hawliau	rights
สิทธิมนุษยชน	hawliau dynol	human rights
สิน	pechod	sihn
สินค้าคงเหลือ	stocrestrau	inventory
สินค้าอุปโภคบริโภค	nwyddau defnyddwyr	supplies
สินสมุทร	sin samut	sihnsmut
สินิทธา	zithitha	sinitra - first name of an actor
สิปปภาค	rhanbarth zippy	sippapak
สิเรียม	sirium	syriam (name of city in myanmar)
สิ่ง	peth	things
สิ่งมีชีวิต	pethau byw	living things
สิ่งเสพติด	cyffur	addictive substance, drugs
สิ้นพระชนม์ในรัชกาลที่	bu farw yn nheyrnasiad	died in
สี	lliw	color
สีขาว	lliw gwyn	white
สีดำ	du	black color
สีน้ำตาล	lliw brown	brown
สีน้ำเงิน	glas	blue
สีฟ้า	glas	blue
สีม่วง	porffor	purple
สีลม	silom	silom
สึนะ	tsuna	tsuna
สึนะโยชิ	tsunayoshi	tsunayoshi
สืบต่อมา	etifedd	live on
สื่อสารมวลชน	cyfathrebu torfol	mass communication
สื่อสิ่งพิมพ์	cyfryngau print	printing media
สุกิจ	sukit	sukit
สุขภาพ	iechyd	health
สุขสวัสดิ์	suksawat	suksawas
สุขาภิบาล	misglwyf	sukhapibal (name of district)
สุขุมวิท	sukhumvit	sukhumvit
สุครีพ	sukree	sugriva
สุจริตกุล	sucharitkun	sucharitkul
สุจาริณี	sucharinee	sujarinee
สุชิน	suchin	suchin
สุดท้ายตายด้วยฝีมือ	yn olaf, marw yn ôl sgil.	eventually dies at the hand of
สุดสาคร	sudsakorn	sootsakorn - a character in a thai legend
สุดารัตน์	sudarat	sudarat
สุทธิชัย	sutthichai	suttichai - a male's first name
สุทัศนะจินดา	sutasachinda	sututnajinda - surname of a tv host
สุทัศน์	suthat	sutas
สุธี	ysgolhaig	sutee - a male's name
สุนทร	orn haul	sunthon
สุนทรภู่	sunuorn phu	soontornpoo - a character from a legend
สุนทรเวช	sunthornwet	"surname ""sundaravej"""
สุนัขจิ้งจอก	y llwynog	baby fox
สุปรีย์	supri	supri - a name
สุพจน์	suphot	supot
สุพล	supon	surapol
สุมณทิพย์	sumonthip	sumonthip
สุรชาติ	surachat	surachart - a male's name
สุรพล	surapon	suraphol
สุรพันธ์	suraphan	surapan - a male's name
สุรวุฒิ	surawut	surawut
สุรศักดิ์	surasak	surasak
สุรัสวดี	surasawadee	suratsawadee - a thai surname
สุราษฎร์ธานี	surat thani	surat thani
สุรินทร์	surin	surin - a place in thailand
สุริยัน	suriyan	suriyan - a male actor
สุริโยไท	thai suriyo	"movie called ""suriyothai"""
สุลต่าน	sultan	sultan
สุวนันท์	suwanan	suwanan
สุวรรณรัฐ	suwannarat	suwannarath
สุวรรณานนท์	suwannanon	suwannanon - a surname
สุเทพ	suthep	suthep - first name of a famous singer
สุโขทัย	sukhothai	sukothai - ancient thailand
สุ่น	haul	sun
สูง	uchel	high
สูงจากระดับน้ำทะเลปานกลาง	uwchlaw lefel gymedrig y môr	above average sea level
สู่	i	indicate
สเตราส์	strauss	strauss.
สเตอรอล	sterol	steroid anabolic
สเตเดี้ยม	stadiwm	stadium
สเปน	sbaen	spain
สไตรค์	streic	strike
สไตล์การเล่น	arddull chwarae	style
ส่งเสริม	hyrwyddo	support, encourage
ส่วนของผู้ถือหุ้น	ecwiti cyfranddalwyr	shareholder fund
ส่วนต่อขยายบางซื่อท่าพระ	estyniad bang sue tha phra	bang sue – tha phra expansion
ส่วนสูง	uchder	height
ส่วนส่งกำลังบำรุง	adran logisteg	supply center
ส่วนหัว	pennawd	top part
ส่วนในฤดูฝนน้ำจะท่วมทุกปี	yn y tymor glawog, bydd y dŵr yn gorlifo bob blwyddyn.	flooding in the rainy season
ส่วนใหญ่	mwyaf	mostly
ส่วนใหญ่เป็นโรงสีข้าว	melinau reis yw&#39;r mwyafrif	most of them are rice refinery
ส่องแสง	disgleirio	shining light
ส้ม	oren	orange
ส้มเช้ง	oren oren	acidless orange
ส้มโอ	grawnffrwyth	pomelo
หงษ์ทอง	hong thong	hongthong
หงษ์มานพ	hong manop	hongmanop
หงสกุล	hong sakul	hongsakul (a famous surname in thailand), as in harin hongsakul
หญ้าทะเล	glaswellt y môr	seagrass
หญ้าฝรั่น	saffrwm	saffaron
หนองคาย	nong khai	nong kai -  a location in thailand
หนองม่วง	nong muang	nong muang
หนองหาน	nong han	nong-haan
หนองฮี	nong hee	nong hi - a location in thailand
หนองแซง	zang	nong sang - area in thailand
หนอน	mwydyn	worm
หนัก	trwm	heavy
หนังสือ	llyfr	book
หนังสือการ์ตูน	llyfr comig	comic book
หนังสือลามก	llyfrau pornograffig	pornographic magazines
หนังใหญ่	ffilm fawr	nang yai
หนึ่ง	un	one
หนึ่งธิดา	un ferch	nuengthida
หนุมาน	hanuman	hanuman - a giant in a thai tale
หนุ่ม	dyn ifanc	young (used for men)
หน่วยความจำ	cof	computer memory
หน่วยคำเติม	lorporp	affix
หน่วยทหารในค่าย	uned filwrol yn y gwersyll	units in camp
หน่วยที่	uned	order of 1, 2, 3...
หน่วยบัญชาการนาวิกโยธิน	pencadlys morol	royal thai marine corps
หน่วยประมวลผลกลาง	uned brosesu ganolog	central processing unit
หน่วยพันธุกรรม	uned enetig	gene
หน้าอก	cist	breast
หมวด	categori	category
หมวดหมู่	categori	category
หมวดหมู่กลุ่มดนตรีที่ก่อตั้งในปี	categori grŵp cerdd wedi&#39;i sefydlu yn	category: music band established in the year
หมวดหมู่กลุ่มดนตรีสัญชาติเกาหลี	categori grŵp cerddoriaeth corea	korean musical group
หมวดหมู่กวีชาวไทย	categori bardd gwlad thai	thai poem category
หมวดหมู่การฉลองปีใหม่	categori dathlu blwyddyn newydd	the group in charge of new year celebration
หมวดหมู่การประท้วงในประเทศไทย	protest categori yng ngwlad thai	category:protests in thailand
หมวดหมู่การ์ตูนญี่ปุ่นแนวโชเน็น	categori japaneaidd cartŵn siapaneaidd arddull shonen	the cartoons of japan
หมวดหมู่จุลชีววิทยา	categori microbioleg	category:microbiology
หมวดหมู่ชาวไทยที่นับถือศาสนาพุทธ	categori bwdistiaid gwlad thai	category:thai buddhists
หมวดหมู่ชาวไทยที่เกิดในต่างประเทศ	categori pobl thai a anwyd dramor	thais that were born outside thailand
หมวดหมู่ดาวเคราะห์ชั้นใน	categori planed fewnol	group of stars inside
หมวดหมู่ดาวเคราะห์หิน	categori cerrig planet	category:terrestrial planets
หมวดหมู่ทหารอากาศชาวไทย	categori llu awyr gwlad thai	category:royal thai air force personnel
หมวดหมู่ทหารเรือชาวไทย	categori llynges gwlad thai	group of thai navy officers
หมวดหมู่นักการเมืองไทย	categori o wleidyddion gwlad thai	politician
หมวดหมู่นักร้องไทย	categori canwr gwlad thai	singer category
หมวดหมู่นายกรัฐมนตรีไทย	categori prif weinidog gwlad thai	category:prime ministers of thailand
หมวดหมู่บริษัทของไทย	categori cwmni gwlad thai	group of thai's companies
หมวดหมู่บริษัทที่ก่อตั้งในปี	cwmni categori wedi&#39;i sefydlu yn	category:companies established in
หมวดหมู่บอยแบนด์	categori band bechgyn	a group of boys band
หมวดหมู่บุคคลจากจุฬาลงกรณ์มหาวิทยาลัย	categorïau o brifysgol chulalongkorn	category:chulalongkorn university alumni
หมวดหมู่บุคคลจากมหาวิทยาลัยธรรมศาสตร์	categori o brifysgol thammasat	group of staff from thammasat university
หมวดหมู่บุคคลจากมหาวิทยาลัยสุโขทัยธรรมาธิราช	categorïau o brifysgol agored sukhothai thammathirat	group: person from sukhothai thammathirach university
หมวดหมู่บุคคลจากมหาวิทยาลัยอ๊อกซฟอร์ด	categori unigol o brifysgol rhydychen	the staff of oxford university, england
หมวดหมู่บุคคลจากสถาบันบัณฑิตพัฒนศิลป์	categori o bobl o sefydliad bunditpatanasilpa	group of staff from art schools
หมวดหมู่บุคคลจากโรงเรียนนายร้อยพระจุลจอมเกล้า	categorïau o academi filwrol frenhinol chulachomklao	catagory: people from prchomklhaw academy
หมวดหมู่บุคคลจากโรงเรียนมงฟอร์ตวิทยาลัย	categori unigolion o goleg montfort	category: people from mongford college
หมวดหมู่บุคคลที่เกี่ยวข้องกับเหตุการณ์	categori o bobl sy&#39;n gysylltiedig â&#39;r digwyddiad	catagory: individuals invovled
หมวดหมู่ประวัติศาสตร์ไทย	categori hanes gwlad thai	category:history of thailand
หมวดหมู่ประเภทของภาพยนตร์	categori categori ffilm	types of film
หมวดหมู่ปรัชญา	categori athroniaeth	category:philosophy
หมวดหมู่พระราชนัดดาในรัชกาลที่	categori ŵyr brenhinol y deyrnasiad	"catagory: royal heirs during the ""blank"" reign"
หมวดหมู่พระราชปทินัดดาในรัชกาลที่	categori teyrnasiad brenhinol yn ystod y deyrnasiad	the king's army
หมวดหมู่พระราชปนัดดาในรัชกาลที่	categori brenin panadda yn ystod y deyrnasiad	belonging to the king # ________
หมวดหมู่พิธีกรไทย	cyflwynwyr categori thai	host for thai shows
หมวดหมู่ฟุตบอลในประเทศไทย	categori pêl-droed yng ngwlad thai	category; football in thailand
หมวดหมู่ภัยธรรมชาติ	categori trychineb naturiol	catagory: natural disasters
หมวดหมู่ภัยพิบัติทางการแพทย์	categori trychineb meddygol	category: medical disaster
หมวดหมู่มหาวิทยาลัยธรรมศาสตร์	categori prifysgol thammasat	thamasat university
หมวดหมู่รัชกาลที่	teyrnasiad categori	reign 9 category
หมวดหมู่รัฐคอมมิวนิสต์	categori gwladwriaeth gomiwnyddol	communist countries
หมวดหมู่รัฐมนตรีว่าการกระทรวงการต่างประเทศไทย	categori gweinidog tramor gwlad thai	category:foreign ministers of thailand
หมวดหมู่รัฐวิสาหกิจไทย	categori mentrau gwlad thai	category:government-owned companies of thailand
หมวดหมู่รัฐสิ้นสภาพในทวีปเอเชีย	daeth categori cyflwr y wladwriaeth i ben yn asia	asian counties in controlled
หมวดหมู่รัฐและดินแดนที่ก่อตั้งในปี	categori gwladwriaeth a thiriogaeth a sefydlwyd yn	categories state and territory established in
หมวดหมู่รายการโทรทัศน์ไทย	categori rhaglen deledu gwlad thai	the group of thai television channels
หมวดหมู่ละครโทรทัศน์ไทย	categori drama deledu thai	thai drama category
หมวดหมู่วัฒนธรรมไทย	categori diwylliant gwlad thai	category:thai culture
หมวดหมู่วันสำคัญทางศาสนาที่นับโดยปฏิทินจันทรคติ	categorïau o ddyddiau crefyddol pwysig a gyfrifir gan y calendr lleuad	group of religious holidays
หมวดหมู่ศิลปินสังกัดจีเอ็มเอ็ม	categori artistiaid o dan gmm	mgm artists
หมวดหมู่สถาบันอุดมศึกษาในกรุงเทพมหานคร	categorïau sefydliadau addysg uwch yn bangkok	category:universities in bangkok
หมวดหมู่สมุนไพร	categori perlysiau	herbal, herbs
หมวดหมู่สัตว์มีแกนสันหลัง	echel asgwrn cefn categori	category:chordates
หมวดหมู่สัตว์เลื้อยคลาน	categori ymlusgiaid	reptilians
หมวดหมู่สิ่งก่อสร้างในพุทธศตวรรษที่	categori o adeiladau yn yr 21ain ganrif	development in the century # ____
หมวดหมู่สิ้นสุดในคริสต์ศตวรรษที่	daeth y categori i ben yn y 19eg ganrif.	category: ended in xth century
หมวดหมู่สโมสรในพรีเมียร์ลีก	categori clwb yn yr uwch gynghrair	group of premier club
หมวดหมู่อดีตอาณานิคมของฝรั่งเศส	categori trefedigaethol blaenorol ffrainc	category:former french colonies
หมวดหมู่อดีตอาณานิคมของสเปน	categori trefedigaethol blaenorol sbaen	category:former spanish colonies
หมวดหมู่อดีตอาณานิคมของอังกฤษ	categori cyn-drefedigaethol prydain	the group of countries that were under british control
หมวดหมู่อวัยวะ	categori organau	group of organs
หมวดหมู่อวัยวะเพศ	categori organau cenhedlu	category:sex organs
หมวดหมู่เครื่องเทศ	categori sbeis	herbs
หมวดหมู่เพศศึกษา	categori addysg rhyw	sex education category
หมวดหมู่แนวพระราชดำริ	categori menter	the king's words (instruction)
หมวดหมู่โรค	categori afiechyd	group of disease
หมวดหมู่โรงเรียนที่มีอัตราการแข่งขันสูง	categori o ysgolion sydd â chyfraddau cystadlu uchel	categories high competition school
หมวดหมู่โรงเรียนบุรุษในประเทศไทย	categori ysgol dynion yng ngwlad thai	category:boys' schools in thailand
หมอชิต	morchit	mochit bus station
หมากรุกสากล	gwyddbwyll rhyngwladol	chess
หมายความว่า	yn golygu	means
หมู่	grŵp	district, group
หมู่ที่	pentref	moo.
หมู่เกาะเคย์แมน	ynysoedd cayman	cayman island
หมู่เกาะแบลีแอริก	ynysoedd balearaidd	balearic island in spain
หมู่เกาะโซโลมอน	ynysoedd solomon	solomon islands
หม่อมราชวงศ์ปรีดิยาธร	r. pridiyathorn	mom rajawongse pridiyathorn devakula
หม่อมหลวงปิ่น	pin mam	mom luang pin
หม่อมเจ้าจุฑาวัชร	tywysog jutawatchai	his serene highness prince juthawat
หม่อมเจ้าวัชรวีร์	tywysog watcharawee	mom chao vatcharee - a member of the royal family
หม่อมเจ้าวัชรเรศร	mam watcharachorn	watcharaje - a member of royal family
หม้อข้าวหม้อแกงลิง	nepenthes	nepenthes - a type of tropical plant
หยุ่น	hyblyg	yun - nickname of a thai newscaster
หรั่ง	lang	rang
หรือ	neu	or
หรือการแสดงธงชาติ	neu ddangos y faner genedlaethol	national flag display
หรือชื่อทางการคือ	neu enw swyddogol yw	official name is
หรือที่รู้จักกันในชื่อ	neu a elwir yn	also known as
หรือที่เรียกกันว่า	adwaenir hefyd fel	or what it is called ...
หรือเรียกว่า	neu o&#39;r enw	called
หลวง	brenhinol	loung - a thai title for people who services the king
หลอก	tric	fake, fooling someone
หลอดอาหาร	esoffagws	esophagus
หลอดเลือดแดงใหญ่เอออร์ตา	aorta	aorta
หลักจริยธรรม	moeseg	ethics
หลักทรัพย์	gwarantau	property
หลักสี่	laksi	luk sri - a location in bangkok
หลักสูตรการจัดการดุษฏีบัณฑิต	rhaglen doethur mewn athroniaeth mewn rheolaeth	doctor of management program
หลักสูตรที่เปิดสอน	cwrs	curriculum
หลักสูตรนานาชาติ	cwrs rhyngwladol	international course
หลักสูตรปกติ	cwrs arferol	normal program
หลักสูตรภาษาอังกฤษ	cwrs iaith saesneg	english curriculum
หลักสูตรภาษาไทย	cwrs iaith thai	thai language curriculum
หลักสูตรวิทยาศาสตรมหาบัณฑิต	rhaglen meistr gwyddoniaeth	degree requirements for a bachelor degree in science
หลังจาก	ar ôl	after
หลังสงคราม	ar ôl y rhyfel	after the war
หลังสงครามโลกครั้งที่	ar ôl rhyfel byd	world war
หลังสงครามโลกครั้งที่สอง	ar ôl yr ail ryfel byd	after world war ii
หลังเหตุการณ์	ar ôl y digwyddiad	after the event
หลาย	llawer	many, vastly
หลีกภัย	dianc	mr. cheun leakpai, the former foreign ministor
หลุมดำจิ๋ว	twll du bach	small black hole
หล่มสัก	lom sak	lohmsak
หวาย	rattan	bamboo
หอก	gwaywffon	spear
หอประชุมพ่อขุนรามคำแหงมหาราช	brenin ramkhamhaeng yr awditoriwm mawr	pho khun ram khamhaeng convention center
หอมรดกไทย	neuadd treftadaeth gwlad thai	national ancient museum of thailand
หอย	cregyn	shells, clams
หอไอเฟล	twr eiffel	eiffel tower
หัก	wedi torri	broken
หัว	y pen	head
หัวหิน	hua hin	hua hin
หัวโขน	mwgwd	khon mask
หัวใจ	y galon	heart
หาง	y gynffon	tail
หาดทรายแก้ว	traeth sai kaew	glass beach
หาบเร่	hawker	street vending
หินปูน	calchfaen	limestone
หินอ่อน	marmor	marble
หินเชิร์ต	crys carreg	chert
หินแกรนิต	gwenithfaen	granite rock
หินไซอัล	carreg siâl	sial
หี	pussy	vagina (impolite word)
หุตะสิงห์	canu huta	hutasingha
หุ่น	pyped	model
หุ่นยนต์	robot	robot
หเตุการณ์	sefyllfa	event
ห่วงใย	gofalu	care
ห้วยขวาง	huai khwang	huai khwang
ห้วยทับทัน	huai thap than	huai thap than
ห้องน้ำ	yr ystafell ymolchi	bathroom
ห้องสมุด	y llyfrgell	library
ห้าง	siop adrannol	mall
ห้างฉัตร	sgwrs hongian	hang chat
ห้างหุ้นส่วนจำกัด	partneriaeth gyfyngedig	limited partnership
ฬาพานิช	masnachol	fapanit - surname of an actor
อก	cist	chest
อคิลลีส	achilles	achilles
องคชาต	pidyn	penis
องคต	sefydliad	angada
องค์กรปกครองส่วนท้องถิ่น	sefydliad llywodraeth leol	local administration
องค์การนิสิต	trefniadaeth myfyrwyr	student organization
องค์การมหาชน	sefydliad cyhoeddus	human services
องค์การสหประชาชาติ	cenhedloedd unedig	united nation
องค์บาก	bak ong	ong-bak
องค์ประกันหงสา	yswiriant hongsa	prakunhongsa - a famous person from the ancient time
องอาจ	gwerthfawr	ongart
อดิศักดิ์	adisak	adisak
อดีต	gynt	the past
อดีตผู้บัญชาการทหารบก	cyn-bennaeth milwrol	ex-commander in chief of the royal thai army
อดีตรองนายกรัฐมนตรี	cyn ddirprwy brif weinidog	former deputy prime minister
อดีตรองหัวหน้าหน่วยที่	cyn ddirprwy bennaeth yr uned	former lieutenant
อธิการบดี	canghellor	dean of the college
อธิการบดีมหาวิทยาลัยธรรมศาสตร์	llywydd prifysgol thammasat	former chanceller of thamasat university
อธิบายว่า	esboniwch hynny	explain
อนันตยะ	anantaya	anantaya
อนันตรัย	anantai	anuntrai
อนาลโย	analoy	analayo
อนึ่ง	gyda llaw	once
อนุทิน	dyddiadur	diary
อนุสรณ์สถาน	cofeb	monument
อนุสรา	anusara	anusara
อปักธงชัย	pak thong chai	pak thongchai district
อพอลโล่	apollo	apollo
อพิมาย	aphimai	phimai district
อภัยนุราช	maddeuant	aphainurat
อภินันท์	aphinan	ahpinun - a male's name
อภิปรัชญา	metaffiseg	metaphysics
อภิรักษ์	aphirak	apirak
อมฤต	marw	ummarit - a male's name
อมาตยกุล	amatayakun	amattayakun
อยู่	yn	is
อยู่วิทยา	gwyddoniaeth	yoovidhya
อยู่ห่างออกไปจากชายฝั่ง	ymhell i ffwrdd o&#39;r arfordir	away offshore
อยู่แล้ว	eisoes	already
อยู่ในเขตอำเภอกุฉินารายณ์	wedi&#39;i leoli yn ardal kuchinarai	in the kuchinarai district
อย่างต่อเนื่อง	yn barhaus	continuously
อย่างแพร่หลาย	eang	many, various
อย่างไรก็ตาม	fodd bynnag	however
อร	orn	orn (thai name)
อรทัย	merch ifanc	orathai - surname of a thai country singer
อรรถกถา	sylwebaeth	atthakatha
อรรถพร	athaphon	uttapon - a female's name
อรัญประเทศ	aranyaprathet	arranyapratet - a location in thailand
อริยสัจ	gwirionedd nobl	teaching of buddha
อรุณี	arunee	arunee
อลังการ	addurn	alungan - the name of a movie theater in thailand
อลาสก้า	alaska	alaska
อลิซ	alice	alice
อวอร์ดส	gwobrau	award
อวัยวะสืบพันธุ์สตรีด้านนอก	organau organau cenhedlu benywod ar y tu allan	femal reproductive system
อวัยวะสืบพันธุ์หญิง	organau organau cenhedlu benywod	female reproductive system
อวัยวะเพศ	organau cenhedlu	sex organ
อศรีประจันต์	asri prachan	master sri prajan - a priest's name
อสมท	mcot	acronym for thai communication companies
อสามชุก	sam chuk	sam chuk district
ออ	neu	auu - a thai vowel
ออกฉายครั้งแรกเมื่อวันที่	wedi&#39;i sgrinio gyntaf	first screening
ออกมาในอะนิเมะเท่านั้น	yn dod allan yn yr anime yn unig	only in anime
ออกอากาศ	darlledu	on the air
ออกอากาศครั้งที่	wedi&#39;i ddarlledu ar	airing
ออกอากาศทางช่อง	darlledu ymlaen	aired on channel
ออกัสตัส	augustus	augustus
ออกเป็น	i mewn	into
ออกแบบตัวละคร	dyluniad cymeriad	character design
ออนไลน์	ar-lein	online
ออฟ	i ffwrdd	off
ออลแบนี	cynghreiriaid	albany
ออสเตรเลีย	awstralia	australia
ออโตทรอพ	autobot	autotroph
อะ	beth	a
อะซูไรต์	azurite	azurite
อะตอม	atomau	atom
อะนิเมะ	anime	anime
อะบุราเมะ	aburame	aburame
อะพาไทต์	apatite	apartheid
อะมาเดอุส	amadeus	amadeus
อะลูมิเนียม	alwminiwm	aluminum
อะโกนิสต์	agonydd	agonist
อะโลน	ar ei ben ei hun	alone
อักษร	yr wyddor	letters, alphabets
อักษรย่อ	talfyriadau	abbreviation
อักษรเกาหลี	wyddor corea	korea alphabet
อังกฤษสมัยแองโกล-นอร์มัน	saesneg eingl-normanaidd	england anglo-norman era
อังการา	ankara	ankara
อัญมณี	gem	gem
อัฒภาค	hanner colon	semicolon
อัตราการว่างงาน	cyfradd diweithdra	unemployment rate
อัธฮา	athha	athha
อันดับ	safle	order
อันประกอบด้วย	yn cynnwys	consists of
อันโตนิโอ	antonio	"name ""antonio"""
อันโตนีโอ	antonio	antonio
อันได้แก่	gan gynnwys	which are
อัฟกานิสถาน	afghanistan	afghanistan
อัมพร	amporn	umpon - a female's name
อัมพาต	parlys	paralysis
อัลบัส	albws	albus in harry potter stories
อัลบั้ม	albwm	album
อัลเดบารัน	aldebaran	arudebaran
อัลเฟรด	alfred	alfred
อัสนี	bollt	thunderbolt
อาการหวาดระแวง	paranoia	paranoid
อากาศ	y tywydd	air, weather
อากาศอำนวย	tywydd	akat amnuai
อากาเป	agape	the word meaning 'love' in greek language
อาคามัตสึ	akamatsu	akamatsi
อาคารส่วนที่	adran adeiladu	part (insert number) of the the building
อาคารอุบลรัตนราชกัญญา	adeilad ratchakanya ubonratana	buildings outside ubon ratana graz contract.
อาคารเฉลิมพระเกียรติ	adeilad chaloem phrakiat	chalermphrakiat building
อาจหมายถึง	gall olygu	may also mean
อาจารย์	yr athro	teacher
อาจารย์ใหญ่	prifathro	headmaster
อาซึกะ	asuka	asuka
อาณัตพล	anataphon	arnattapon
อาณาจักร	y deyrnas	kingdom
อาณาจักรธนบุรี	teyrnas thonburi	thonburi empire
อาณาจักรสุโขทัย	teyrnas sukhothai	sukhothai kingdom
อาณาจักรอยุธยาปกครองเขมรเป็นเวลาเกือบปี	bu teyrnas ayutthaya yn rheoli cambodia am bron i flwyddyn.	ayutthaya dynasty had colonized khmer for almort 400 years
อาณาจักรอยุธยาเริ่มเสื่อมอำนาจลงราวพุทธศตวรรษที่	dechreuodd teyrnas ayutthaya ddirywio mewn grym o amgylch y ganrif fwdhaidd.	ayutthaya kingdom had started to downfall around 24 b.e.
อาณาจักรแพกเจ	teyrnas pakae	pakja territory
อาณาเขตติดต่อ	ardal gyswllt	adjoining parcel
อาดัม	adam	adam
อาทิ	megis	for example
อาทิตย์	dydd sul	sunday
อานนท์	anon	anon
อานันทมหิดล	ananda mahidol	ahnanmahidol - someone with the king's surname
อานุภาพ	mighty	power
อานโตนิโอ	antonio	antonio
อาบาราอิ	abarai	abarai
อายุ	yr oes	age
อารยา	araya	araya
อาร์	r.	r.
อาร์กอน	argon	argon
อาร์คิมิดีส	archimedes	archimedes
อาร์ม	braich	arms
อาร์มาดิลโล	armadillo	armadillo
อาร์เคด	arcêd	arcade
อาร์เมเนีย	armenia	armenia
อาร์เอ็นเอ	rna	ribonucleic acid - rna
อาร์โนลด์	arnold	arnold
อาวุธคือ	arf yw	type of weapons
อาวุธประจำกาย	arf personol	personal weapon
อาหาร	y bwyd	food
อาเจียน	chwydu	vomit
อาเธอร์	arthur	arthur
อาเนีย	ana	anya
อำนาจ	pwer	amnat
อำนาจอธิปไตย	sofraniaeth	sovereignty
อำเภอ	dosbarth	district
อำเภอกมลาไสย	dosbarth kamalasai	kamalasai district
อำเภอกระสัง	dosbarth krasang	krasang district
อำเภอกันทรลักษ์	dosbarth kantharalak	kantharalak district
อำเภอขุขันธ์	dosbarth khukhan	khukhan district
อำเภอขุนหาญ	ardal khun han	amphur kunhan
อำเภอครบุรี	dosbarth khon buri	amphur kornburi
อำเภอคูเมือง	dosbarth khu mueang	khu mueang district
อำเภอจอมทอง	ardal chom thong	jom thong district
อำเภอดอยสะเก็ด	dosbarth doi saket	doi saket district
อำเภอด่านขุนทด	ardal dan khun thot	dan koontod district
อำเภอตะพานหิน	ardal taphan hin	taphan hin district
อำเภอทับคล้อ	ardal thap khlo	amphoe tap khlo
อำเภอทุ่งช้าง	ardal thung chang	thung chang district
อำเภอท่าตูม	ardal tum	ta toom district
อำเภอท่าวังผา	ardal wang pha	ta wung pa province
อำเภอท่าวุ้ง	ardal wung	ta wung district
อำเภอนครชัยศรี	ardal nakhon chai si	nakhon chai si district
อำเภอนาบอน	ardal na bon	nabon district
อำเภอน้ำเกลี้ยง	ardal nam kliang	amphur namleang
อำเภอบัวเชด	ardal buachet	buachet district
อำเภอบัวใหญ่	ardal bua yai	amphoe buayai (buayai district)
อำเภอบางบัวทอง	ardal bang bua thong	bang bua thong district
อำเภอบางบ่อ	ardal bang bo	bang bor district
อำเภอบางพลี	ardal bang phli	bang plee district
อำเภอบางละมุง	ardal bang lamung	bang lamung district
อำเภอบางเสาธง	ardal bang sao thong	bang sao thong district
อำเภอบ้านลาด	ardal ban lat	bahn lad district
อำเภอบ้านหมี่	ardal ban mi.	ban mi district
อำเภอปราสาท	ardal prasat	amphor-prasart
อำเภอปากช่อง	ardal pak chong	pak chong district
อำเภอปากพนัง	ardal pak phanang	pak phanang district
อำเภอปาย	dosbarth pai	pai district
อำเภอฝาง	ardal fang	fang district
อำเภอพระประแดง	dosbarth phra pradaeng	pra-pradaeng district
อำเภอพระพรหม	ardal phra phrom	pra phrom province
อำเภอพระสมุทรเจดีย์	dosbarth phra samut chedi	samutjadee district
อำเภอพลับพลาชัย	rhanbarth phlapphla chai	plubplachai province in thailand
อำเภอพัฒนานิคม	rhanbarth phatthana nikhom	amphur pattananikhom
อำเภอพิปูน	dosbarth phipun	phipun district
อำเภอพุทธมณฑล	dosbarth phutthamonthon	ampore phuthamontol
อำเภอภูสิงห์	ardal canu phu	aumphor phu sing (name of district)
อำเภอยางชุมน้อย	dosbarth yang chum noi	choom noi province
อำเภอรหัสไปรษณีย์หมายเหตุ	dosbarth, cod post, nodyn	district, post code, note
อำเภอรัตนบุรี	dosbarth rattanaburi	rhatanaburi district
อำเภอราษีไศล	ardal rasi salai	rasi-salai district
อำเภอร่อนพิบูลย์	dosbarth ron phibun	ronpibul district
อำเภอลาดหลุมแก้ว	dosbarth lat lum kaeo	lat lum kaeo district
อำเภอลำปลายมาศ	ardal lam plai mat	lum plai maad district in burrirum province
อำเภอศรีณรงค์	ardal si narong	si narong district
อำเภอศรีเมืองใหม่	ardal si mueang mai	sri meung mai district
อำเภอสระโบสถ์	ardal eglwys sra	sa bot district
อำเภอสหัสขันธ์	dosbarth sahatsakhan	sahuskhan district
อำเภอสองแคว	cân khwae	song khwae district
อำเภอสังขะ	ardal sangkha	sang ka district
อำเภอสันป่าตอง	ardal san pa tong	sunpathong province in thailand
อำเภอสามพราน	ardal sam phran	sam pran area
อำเภอสารภี	ardal saraphi	sarape district
อำเภอสิชล	dosbarth sichon	sichon district
อำเภอสุไหงโกลก	ardal sungai kolok	amphoe su-ngai kolok
อำเภอหนองกี่	ardal nong ki	nong kee district
อำเภอห้วยราช	ardal rat huai	huai rat district
อำเภออมก๋อย	dosbarth omkoi	om koi district in chiang mai, thailand
อำเภอเกาะคา	dosbarth ko kha	amphoe ko kha
อำเภอเขวาสินรินทร์	dosbarth khwao sinarin	ampore khavasinrin
อำเภอเฉลิมพระเกียรติ	dosbarth chaloem phrakiat	amphur chalermprakiet
อำเภอเชียงของ	dosbarth chiang khong	chiang khong district
อำเภอเชียงคาน	dosbarth chiang khan	chiang khan district
อำเภอเชียรใหญ่	dosbarth chian yai	chien yai district in thailand
อำเภอเมืองกาฬสินธุ์	mueang kalasin	mueang kalasin provincial district
อำเภอเมืองนครราชสีมา	ardal mueang nakhon ratchasima	mueang nakhon ratchasima district
อำเภอเมืองนนทบุรี	ardal mueang nonthaburi	nontaburi district
อำเภอเมืองบุรีรัมย์	ardal ram mueang buri	burerum province
อำเภอเมืองพิจิตร	ardal mueang phichit	mueang phichit district
อำเภอเมืองพิษณุโลก	mueang phitsanulok	ampore maung pisanulok
อำเภอเมืองลพบุรี	ardal burue lop mueang	lopburi province
อำเภอเมืองสุรินทร์	ardal surin mueang	surin province
อำเภอเมืองอุตรดิตถ์	dosbarth utueradit mueang	mueang uttaradit district
อำเภอเมืองเชียงใหม่	ardal mueang chiang mai	mung chiang mai district
อำเภอเมืองเพชรบุรี	ardal mueang phetchaburi	pechaburi province
อำเภอเวียงชัย	ardal wiang chai	wiang chai district
อำเภอเวียงแก่น	ardal wiang kaen	wiang kaen district
อำเภอเสริมงาม	ardal soem ngam	soem ngam district
อำเภอแจ้ห่ม	ardal chae hom	chae hom district
อำเภอแม่ทะ	dosbarth mae tha	mahta district
อำเภอแม่แจ่ม	ardal mae chaem	mae jam province
อำเภอแม่แตง	ardal mae taeng	mae taeng district
อำเภอโนนดินแดง	ardal non din daeng	din dang sub district
อำเภอโนนสุวรรณ	ardal nad yw&#39;n suwan	none su wan province
อิงค์	inc.	inc.
อิงลิช	saesneg	english
อิทธิพล	dylanwad	power
อิน	yn	in
อินทิรา	indira	intira
อินฟราเรด	is-goch	infared
อินฮิบิเตอร์	atalydd	inhibitors
อินุยาฉะ	inuyasha	inuyacha - a japanese cartoon
อินเซคทิวอรา	inseqtura	insectivora
อินเดียน	indiaidd	indian
อินเด็กซ์	mynegai	index
อินโดนีเซีย	indonesia	indonesia
อิม	imm	im
อิมาจิน	imajin	imagine
อิมแพ็ค	effaith	impact
อิรัก	irac	iraq
อิริโทรมัยซิน	electrolysis	erythromycin
อิสตันบูล	istanbwl	istanbul
อิหร่าน	iran	iran
อิเควทอเรียลกินี	gini cyhydeddol	equitorial
อิโนะ	ino	ino
อีก	mwy	more
อีกครั้ง	unwaith eto	again
อีกด้วย	rhy	also
อึ	crap	poop
อึ๊งภากรณ์	ungphakorn	ungpakorn - a famous surname
อือ	ie	uu - a thai vowel
อื่น	un arall	other
อุ	o.	ou
อุซึมากิ	uzumaki	uzumaki naruto
อุณหภูมิ	y tymheredd	temperature
อุณหเคมี	thermochemistry	using energy and heat in chemical study
อุดม	cyfoethog	udom
อุดรธานี	udon thani	udon thani
อุตตมะโยธิน	upparat	uttamayothin
อุตรดิตถ์	uttaradit	uttaradit
อุทยาน	y parc	park
อุทยานประวัติศาสตร์พนมรุ้ง	parc hanesyddol phanom rung	phanom rung historical park
อุทยานประวัติศาสตร์พิมาย	parc hanesyddol phimai	phimai historical park
อุทยานแห่งชาติคลองตรอน	parc cenedlaethol khlong tron	khlong tron national park
อุทยานแห่งชาติดอยภูคา	parc cenedlaethol doi phu kha	doi phu kha national park
อุทยานแห่งชาติดอยอินทนนท์	parc cenedlaethol doi inthanon	national park doi inthanon in northern thailand
อุทยานแห่งชาติทุ่งแสลงหลวง	parc cenedlaethol thung salaeng luang	thung salaeng luang national park
อุทยานแห่งชาติธารโบกขรณี	parc cenedlaethol than bok khorani	tarabokorani national preserve area
อุทยานแห่งชาติน้ำตกสี่ขีด	parc cenedlaethol rhaeadr si khit	namtoksekeed national park
อุทยานแห่งชาติน้ำพอง	parc cenedlaethol nam phong	nam phong national park
อุทยานแห่งชาติภูผาเหล็ก	parc cenedlaethol y mynydd haearn	phupalek national park
อุทยานแห่งชาติภูพาน	parc cenedlaethol phu phan	phu phan national park
อุทยานแห่งชาติภูสวนทราย	parc cenedlaethol phu suan sai	pusuansai national preserve
อุทยานแห่งชาติภูสอยดาว	parc cenedlaethol phu soi dao	soi dao mountain preserve
อุทยานแห่งชาติภูเรือ	parc cenedlaethol phu ruea	national park pu reau
อุทยานแห่งชาติภูเวียง	parc cenedlaethol phu wiang	phu wiang national park
อุทยานแห่งชาติภูแลนคา	parc cenedlaethol phulanca	phu laenkha national park
อุทยานแห่งชาติหาดนพรัตน์ธาราหมู่เกาะพีพี	parc cenedlaethol traeth noppharat thara, ynysoedd phi phi	hat nopparatthara-mu ko phi phi national park
อุทยานแห่งชาติเขาหลวง	parc cenedlaethol khao luang	khao luang national park
อุทยานแห่งชาติไทรทอง	parc cenedlaethol sai thong	sai thong national preserve area
อุทุมพรพิสัย	uthumphon phisai	utompisai - an area in thai province
อุบล	ubon	ubol - a place in thailand
อุปกรณ์	yr offer	instrument
อุปกรณ์คอมพิวเตอร์	ategolion cyfrifiadurol	computer hardware
อุปนิสัย	cymeriad	manners
อุภัยราศี	maddeuwch y sidydd	ambivert zodiac
อุรุกวัย	uruguay	urookwai - a location
อุเทน	uthen	utain - a male's name
อู	ou	u (a vowel)
อู๋	wu	auu (first name)
อเมริกัน	americanaidd	american
อเมริกา	america	america, usa
อเมริกาเหนือ	gogledd america	north america
อเล็กซานเดอร์	alexander	alexander
อเล็กซ์	alex	alex
อโลหะ	metel anfferrus	nonmetal
อ่อนเพลีย	blinder	fatigue
อ่าน	darllenwch	read
อ่าวลึก	ao luek	ao luek
อ้างว่า	hawliwch hynny	claim
อ้างว้าง	yn unig	loneliness
ฮอกกี้	hoci	hockey
ฮอท	poeth	hot
ฮอฟมัน	hoffman	hoofman - a name
ฮอยเกนส์	hogens	huygens
ฮอร์โมน	hormonau	hormone
ฮอลแลนด์	holland	holland
ฮอลโลว์	hollow	hollow (as in dead soul)
ฮอว์ค	seahawks	hawk
ฮักบี้	hwyl fawr	hugby - an album that received many awards
ฮันกึล	hangul	hangeul
ฮัมบูร์ก	hamburg	hamburg
ฮาจิ	hachi	haji
ฮาตาเกะ	hatake	hatake
ฮานอย	hanoi	hanoi
ฮายาโตะ	hayato	hayada - a japanese surname
ฮารุกะ	haruka	haruka - a japanese name
ฮาวาย	hawaii	hawaii
ฮิซาชิ	hisashi	hitachi
ฮิซานะ	hisana	hisana
ฮิตเลอร์	hitler	hitler
ฮินาตะ	hinata	hinada - a japanese story
ฮิมาวาริ	himawari	himawari - a japanese surname
ฮิราโกะ	hirako	hirako (japanese name)
ฮิวงะ	hyuga	hewnga - a japanese name from a story
ฮิโซกะ	hisoka	hisoka
ฮิโรชิ	hiroshi	hiroshi
ฮีชอล	heechul	heechul
ฮุก	bachyn	hook
ฮโยยอน	hyoyeon	hyoon - a dancer from japan
ฯพณฯ	ei ardderchowgrwydd	two thai alphabets.  abbreviation that means many things
เกตส์	gatiau	gates
เกตุทัต	ketthat	kettut - a surname
เกมที่	y gêm	game number _________
เกมบุค	gêm	game book
เกรย์	llwyd	gray
เกษตรกรรม	amaeth-fusnes	farming
เกษตรวิสัย	kaset wisai	kasetvisai (name of thai district)
เกษมศรี	kasemsri	kasemsri surname
เกอริง	gering	the name 'gerring'
เกอไทต์	goethe	goethite mineral
เกาหลีใต้	de corea	south korea
เกาะ	yr ynys	island
เกาะคา	kauai	ko kha
เกาะลูซอน	ynys luzon	luzon island
เกาะสุมาตรา	sumatra	sumatra
เกิด	ganwyd	born
เกิดขึ้นหลังจากมหาวิทยาลัยศรีนครินทรวิโรฒวิทยาเขตต่างๆ	digwyddodd ar ôl prifysgol srinakharinwirot, campysau amrywiol	happened after srinakarinviroj university started
เกิดขึ้นเมื่อวันที่	digwyddodd	birthdate
เกิดจากการรวมชิ้นส่วนที่	wedi&#39;i achosi trwy gyfuno rhannau hynny	put together to form something
เกิดจากการรวมตัวของ	wedi&#39;i achosi gan gorffori	combination of
เกิดจากเชื้อไวรัส	wedi&#39;i achosi gan firws	occur from the viral agent
เกิดนิมิตร	creu gweledigaeth	caused a vision/realization
เกียรติ	anrhydedd	honour
เกียรติประวัติ	anrhydedd	biography
เกียรติศักดิ์	anrhydedd	reputation.  kietisak can be a male's name
เกียวโตะ	kyoto	kyoto
เก็กโค	checco	gecko
เขตคลองสาน	dosbarth khlong san	klongsan district
เขตจอมทอง	ardal chom thong	jomthong area
เขตดุสิต	dusit	khet dusit
เขตที่	dosbarth	district number _______
เขตบางกอกใหญ่	ardal bangkok yai	bangkok yai district in thailand
เขตบางซื่อ	ardal bang sue	bang sue district
เขตบางแค	bang khae	bang khae district
เขตปทุมวัน	pathumwan	pathum wan district
เขตภาษีเจริญ	ardal phasi charoen	phasi charoen district
เขตมีนบุรี	ardal min buri	min buri district
เขตรักษาพันธุ์สัตว์ป่า	noddfa bywyd gwyllt	national wildlife preserve
เขตรักษาพันธุ์สัตว์ป่าภูหลวง	noddfa bywyd gwyllt phu luang	wildlife preserve
เขตลาดกระบัง	lat krabang	lad krabang district
เขตวังทองหลาง	ardal wang thonglang	wang thonglang district
เขตวัฒนา	ardal wattana	watana district
เขตสวนหลวง	ardal suan luang	suan luang district
เขตสาทร	sathon	sathorn area
เขตห้วยขวาง	huai khwang	huai khwang district
เขตเลือกตั้งที่	bwrdeistref	election area number
เขมนิจ	amherffaith	khemanit
เขากล่าวว่า	meddai	he said
เขาทราย	khao sai	sand dunes
เขียนว่า	ysgrifennu hynny	wrote
เขียนโดย	ysgrifennwyd gan	written by
เขี้ยวพิษ	fangs gwenwynig	vemon fangs
เขื่อนกิ่วลม	argae gwynt kio	kio lom dam
เขื่อนป่าสักชลสิทธิ์	argae chonlasit pasak	parsakchonlasit dam
เขื่อนลำปาว	argae lampao	lum pao dam
เขื่อนแม่งัดสมบูรณ์ชล	argae chon somboon mae ngad	mae ngud som bul chol dam in chiangmai
เข็มศิลปวิทยา	celfyddydau nodwydd	khem sinlapawitthaya
เข็มอัปสร	nodwydd	kem uppasorn - a thai drama
เข่า	pen-glin	knee
เข้าฉาย	sioe	release date
เข้าชิงไนน์เอ็นเตอร์เทนอวอร์ดส	enwebwyd ar gyfer naw gwobr adloniant.	compete in entertaining world
เข้ารอบ	rownd derfynol	made it to the next round, selected from the initial round
เข้าเฝ้า	cael cynulleidfa	visit (word for the king)
เคน	ken	ken
เคนยา	kenya	kenya
เคมีไฟฟ้า	electrochemistry	electrochemistry
เคยสู้กับโกคุเทระ	yn arfer ymladd â gokudera	fought with gokudera
เครือข่าย	y rhwydwaith	network
เครื่องขัตติยราชอิสริยาภรณ์อันมีเกียรติคุณรุ่งเรืองยิ่งมหาจักรีบรมราชวงศ์	yn coffáu anrhydedd mawr brenhinllin chakri	something used in a thai ceremony - too obscure
เครื่องดีด	strum	thai string musical instruments
เครื่องตี	peiriant curo	musical intrument
เครื่องบิน	yr awyren	airplane
เครื่องปั้นดินเผาและเซรามิค	crochenwaith a cherameg	pottery and ceramic
เครื่องยนต์	yr injan	engine
เครื่องราชอิสริยาภรณ์	insignia	the king's accessories for ceremonies
เครื่องราชอิสริยาภรณ์อันเป็นที่เชิดชูยิ่งช้างเผือก	yr arwyddlun sy&#39;n cael ei ogoneddu gan yr eliffant gwyn	order of the white elephant
เครื่องราชอิสริยาภรณ์อันเป็นสิริยิ่งรามกีรติ	arwydd gogoniant mawr kirati	king's accessories
เครื่องราชอิสริยาภรณ์อันเป็นโบราณมงคลนพรัตนราชวราภรณ์	arwyddion hynafol y ratchawaraphon addawol nopparat	the ancient and auspicious order of the nine gems
เครื่องสาย	offeryn llinynnol	string instrument
เครื่องแต่งกาย	gwisg	clothes
เคลลี่	kelly	kelly
เคอาร์วาย	kryy	k.r.y
เค้ก	cacen	cake
เงิน	yr arian	money
เงินทุน	cyllid	fund
เงินในบัญชีธนาคาร	arian mewn cyfrif banc	balance
เงี้ยว	bent	shan tribe in northern part of thailand
เจ	j.	j.
เจนี่	janie	jenny
เจมินี่	gemini	gemini
เจริญ	cynnydd	charoen
เจสเปอร์	jesper	jasper
เจียะแจ	jae jae	nine emperor gods festival
เจี๊ยบ	cyw	jeab (thai name)
เจเน็ต	janet	janet
เจ็ดเทพโจรสลัด	shichibukai	seven warlords of the sea
เจ็บ	dolur	pain
เจ้าของจุกนม	perchennog nipple	the owner of the baby's bottle
เจ้าจอม	meistr	king's concubine
เจ้าฟ้ากรมพระยานริศรานุวัดติวงศ์	tywysog krom phraya narisaranu, teml tiwong	refer to a title of a royal family member - jao fa krom pra ya rissanuwattiwong
เจ้าฟ้ากรมพระยานริศรานุวัติวงศ์	tywysog krom phraya narisara nuwatwong	prince narisara nuvativongse
เจ้าฟ้าจิตรเจริญ	tywysog jitcharoen	prince chitcharoen
เจ้าฟ้าภาณุรังษีสว่างวงศ์	tywysog phanurangseesawangwong	prince panuragui bright chestnut.
เจ้าฟ้ามหาวชิราลงกรณ	tywysog maha vajiralongkorn	thailand's crown prince
เจ้าฟ้ามหาวชิรุณหิศ	tywysog mahawajirunhit	crown prince maha vajirunhis
เจ้าฟ้ามหิดลอดุลยเดช	adulyadej y tywysog mahidol	prince mahidol adulyadej
เจ้าฟ้ามหิดลอดุลเดช	adulyadej y tywysog mahidol	a member of thai royalties
เจ้าฟ้าหญิง	dywysoges	princes
เจ้าฟ้าอุบลรัตนราชกัญญา	chaofa ubonratana rajaganya	princess ubon ratana graz's' contract.
เจ้าหนี้การค้า	cyfrifon yn daladwy	trade account payable
เจ้าเมือง	llywodraethwr	mayor
เจ้าเมืองขุขันธ์	llywodraethwr khukhan	a name of the head of the state
เจ้าโลก	hegemoni	world conqueror
เฉพาะด้านตะวันออกเฉียงใต้เท่านั้นที่เป็นที่ราบลุ่มแม่น้ำโขง	yr ochr dde-ddwyreiniol yn unig yw basn afon mekong.	only south-east area that is in mekhong plateau
เฉลิม	chalerm	chalerm - a male's name
เฉลิมชัย	chalermchai	chalermchai
เฉลิมชัยเจริญกิจ	chalermchai charoenkit	chalermchaichareonkij
เฉลิมพระเกียรติ	er anrhydedd	chaloem phra kiat
เฉลิมพล	chalermpol	shalermpol - a surname
เฉลิมแสน	chalermsaen	chaloemsaen
เฉลียว	craff	chaleuw - a male's name
เชส	dilynwch	(jp morgan) chase
เชอร์รี่	cherry	cherry
เชา	chow	chow -  a chinese name
เชาวน์	cudd-wybodaeth	chow - a name
เชาวราษฎร์	chaowarat	chowarat - the surname of a famous actress
เชิญยิ้ม	gwen	smile
เชิดชัย	gorchfygu	"name ""churd-chai"""
เชียงกลาง	chiang klang	chiang klang
เชียงของ	chiangkhong	chiang khong
เชียงดาว	chiang dao	chiang dao
เชียงปุม	pum chiang	chiang poom - area in thailand
เชียงยืน	chiang yuen	chiang yuen
เชียงราย	chiang rai	chiang rai
เชียงใหม่	chiang mai	chiang mai
เชี่ยววงศ์กุล	chiewwongkun	chiaowongkul
เชื่อมต่อกับรถไฟฟ้ามหานคร	yn gysylltiedig â&#39;r mrt	connect with skytrain
เชื่อมแม่น้ำท่าจีน	cysylltwch afon tha chin.	confluence to the ta jean river
เชื้อชาติ	ras	helping the country
เชื้อรา	y ffwng	fungus
เช็ค	gwiriwch	check
เช่นกัน	yn ogystal	as well
เช่นเดียวกัน	yn yr un modd	similar to
เช้ามืดวันที่	dawn y dydd	in dawn of
เช้าวันรุ่งขึ้น	bore trannoeth	next morning
เซกิ	seki	seki
เซน	zen	saint
เซนทอร์	centaur	centaur
เซบาสเตียน	sebastian	sebastian
เซฟ	arbedwch	save
เซลล์	y gell	cell
เซสติโม	seto	settimo
เซอร์	syr	sir
เซอร์วิส	gwasanaethu	service
เซอร์เบีย	serbia	serbia
เซอวิวาสแตติน	cervivastin	cerivastatin - drug
เซโรกัชเชอร์	sero kutcher	sero gusher - a type of weapon
เซโรนอส	seronos	zeronos
เซโรไลเนอร์	seroliner	seroliner
เซ็กส์	rhyw	sex
เซ็นทรัล	canolog	central - department stores in thailand
เซ็นทารา	centara	centara
เซ็นเซอร์	y synhwyrydd	sensor
เณร	dechreuwr	samanera
เดคลิเนชัน	datgelu	declination
เดชา	dacha	decha
เดธโน้ต	nodyn marwolaeth	death note - a mysterious japanese cartoon
เดนกัชเชอร์	denkucher	den gusher - a weapon in japanese movies
เดนโอ	den o.	den-o
เดนโอเบลท์	den obelt	den-o belt
เดย์	diwrnod	day
เดอะซิมส์	y sims	the sims
เดอะฮาเดส	yr hades	the hades
เดอะฮาเดสแชปเตอร์	pennod hades	the hades chapter
เดิม	y gwreiddiol	at first
เดิมชื่อ	gynt	former name
เดิมที	yn wreiddiol	at first
เดิมเรียกว่า	arferai gael ei alw&#39;n	formerly known as
เดียวกัน	yr un peth	same
เดือดทะลุจุดศูนย์	berwi trwy&#39;r pwynt sero	zero point breakthrough
เดือนกุมภาพันธ์	chwefror	february
เดือนตุลาคม	hydref	october
เดือนตุลาคมมีฝนตกชุกที่สุด	hydref yw&#39;r mwyaf glawog.	highest amount of rainfall in october
เดือนธันวาคม	rhagfyr	december
เดือนมกราคม	ionawr	january
เดือนมิถุนายน	mehefin	june
เดือนอ้าย	mis lleuad	first lunar month
เด็กหญิงอายุ	hen ferch	the girl's age
เด็กและเยาวชน	plant ac ieuenctid	children and youth
เต่า	y crwban	tao (first name)
เต๋อ	i	ter
เถรวาท	theravada	buddha's teaching
เทคนิคอิลลูชั่น	techneg rhith	technique illusion
เทควันโด้	taekwondo	tai kwon do
เทคโนโลยี	y dechnoleg	technology
เทคโนโลยีสารสนเทศ	technoleg gwybodaeth	san son tej techonology
เทนนิส	tenis	tennis
เทนโจอิน	tenjo-in	tenjoin - a character in a japanese story
เทพพิทักษ์	theppitak	theppitak
เทพมรณะ	duw marwolaeth	bleach
เทพหัสดิน	duw&#39;r nefoedd	tephussadin (a surname)
เทพอานูบิส	anubis	anubis
เทพอาเตน	athen	aten
เทพีเธมิส	duwies	themis
เทริโอ	therio	terio - surname of a singer
เทวดา	angel	angel
เทวรูป	idol	graven image
เทศบาล	y fwrdeistref	municipality
เทศบาลนครขอนแก่น	dinesig khon kaen	khon khan public works
เทศบาลนครนครราชสีมา	nakhon ratchasima	nakorn rachasrima province public work
เทศบาลนครนครศรีธรรมราช	nakhon si thammarat	nakorn sri thamarat city public works
เทศบาลนครเชียงราย	chiang rai	chiang rai province public works
เทศบาลนครเชียงใหม่	dinesig chiang mai	chiang mai municipality
เทศบาลเมืองชัยภูมิ	dinesig chaiyaphum	mueang chaiyaphum
เทศบาลเมืองบุรีรัมย์	buriram	bureerum public works
เทศบาลเมืองมหาสารคาม	dinesig maha sarakham	thesaban mueang maha sarakham
เทศบาลเมืองมุกดาหาร	dinesig mukdahan	mookdahan public works
เทศบาลเมืองสกลนคร	dinesig sakon nakhon	municipality of sakonnakon
เทศบาลเมืองหนองคาย	dinesig nong khai	nong khai municipality
เทศบาลเมืองหนองบัวลำภู	dinesig tref nong bua lamphu	nong bua lam phu town municipality
เทศวิศาล	ehangu	tasavisakal - a surname
เทิดศักดิ์	anrhydedd	therdsak
เทียนทอง	canhwyllau aur	tientong - a male's name
เทียนเงิน	canwyll arian	tienngern
เทียนโพธิ์สุวรรณ	thian pho suwan	tianphosuwan (thai last name)
เทเบิลเทนนิส	tenis bwrdd	table tennis
เทโรศาสน	tero sasana	terosat football club
เท็ดดี้	tedi	teddy
เท็นเท็น	deg deg	tin-tin
เท่ง	teng	teng (first name)
เท่านั้น	yn unig	only
เธคุนุ	cefnogaeth	dhekunu
เธรซ	thrace	thrace - an area in greece
เธอกับฉัน	ti a fi	you and i
เธอจะอยู่กับฉันตลอดไป	byddwch chi&#39;n aros gyda mi am byth	you will be with me forever
เธอยัง	mae hi&#39;n dal	tur yung
เธอเป็นเพื่อนอาบาราอิ	mae hi&#39;n ffrind i abarai.	she is a friend of arbarae
เนกิ	negi	negi
เนย	menyn	butter
เนรมิต	dyfeisiwch	casting a spell
เนะ	reit	ney
เนื่องจาก	oherwydd	because
เนื่องจากประเทศเหล่านั้นอยู่ในตำแหน่งบนโลกที่ต่างไปจากประเทศไทย	oherwydd eu bod mewn sefyllfa ar y ddaear sy&#39;n wahanol i wlad thai	because those countries are in the group of...
เนื้อที่	ardal	area
เนื้อที่ประมาณ	ardal fras	approximate area
เนื้อร้อง	geiriau	lyrics
เนื้อเรื่องย่อ	crynodeb	summary
เนเธอร์แลนด์	yr iseldiroedd	netherlands
เนโกะ	neko	neko
เน็น	nen	nen
เบจิต้า	bechita	vegeta
เบธเลเฮม	bethlehem	bethleham
เบนจามิน	benjamin	benjamin
เบรกมา	egwyl	bregma
เบริธ	berith	berith
เบลเฟกอล	bellegal	belphegor- a demon in a legend
เบส	bas	bass
เบอร์ลิน	berlin	berlin
เบา	golau	soft (voice)
เบาท์	baut	(dieric) bouts
เบาหวาน	diabetes	diabetes
เบื่ออาหาร	wedi diflasu ar fwyd	not appetite, eating disorder.
เบื้องหลัง	y tu ôl i&#39;r llenni	behind the sence
เบโทเฟิน	beethoven	beethoven
เบ็นเท็น	ben 10	ben 10
เปรม	prem	pream
เปรี้ยว	sur	sour
เปรู	periw	peru
เปลวไฟ	fflam	flame
เปลี่ยนชื่อเป็น	ailenwyd i	changed the name to
เปลื้อง	cael eich amddifadu	nude
เปล่งพานิช	plengpanich	plengpanich
เปอร์เซีย	persia	persia
เปอร์โตริโก้	puerto rico	puerto rico
เปิดสอนระดับปริญญาตรี	ar agor ar gyfer astudio israddedig	offer bachelor degree curriculum
เปียงยาง	pyongyang	piang yang - in north korea
เปียโตร	pietro	pietro
เปียโน	piano	piano
เปโซ	peso	peso
เป็ด	hwyaden	duck
เป็น	i fod	is
เป็นขนมของชาวไทยมุสลิม	yn bwdin o fwslimiaid gwlad thai	is a thai-muslim dessert
เป็นครั้งแรก	y tro cyntaf	first
เป็นงานเขียนในชุด	yn set o ysgrifennu	in the edition of...
เป็นต่อ	yn erbyn	pen to
เป็นต้น	er enghraifft	for example
เป็นต้นมา	ers	onward
เป็นต้นไม้ประจำมหาวิทยาลัย	yn goeden o&#39;r brifysgol	tree of university
เป็นบัวในสกุล	a yw lotws yn y genws	is a lotus in the family
เป็นประธาน	dewch yn llywydd	principal of
เป็นปลาตู้สวยงาม	yn bysgodyn acwariwm hardd	is an ornamental fish
เป็นพระราชโอรสพระองค์เดียวในพระบาทสมเด็จพระปรมินทรมหาภูมิพลอดุลยเดช	a yw unig fab y brenin bhumibol adulyadej	is the only son of
เป็นพ่อของ	a yw tad	is the father of
เป็นวิญญาณเทียมเพศชาย	yn ysbryd artiffisial gwrywaidd	the spirit who is a male
เป็นสีประจำ	lliw rheolaidd	official color
เป็นหนึ่งใน	a yw un o	is one of
เป็นหัวหน้าพรรค	arweinydd y blaid	party leader
เป็นอดีตหัวหน้าหน่วยที่	yn gyn-bennaeth yr uned	is the former leader of the unit
เป็นอาวุธ	fel arf	as a weapon
เป็นเครื่องหมายแสดงว่า	yn arwydd bod	indicates that
เป็นเจ้าเมืองปกครอง	llywodraethwr	governor
เป็นเมืองหลวง	a yw&#39;r brifddinas	capital
เป็นเวลา	ar gyfer	utilized time
เป็นโฮโมโลกัสกับ	bod yn homologws gyda	homologous
เป๊ปซี่	pepsi	pepsi
เพกาซัส	pegasus	pegasus
เพชร	diemwnt	diamond
เพชรบุรี	phetchaburi	petchaburi province
เพชรบูรณ์	phetchabun	prechabun
เพชรพระอุมา	diamond phra uma	ancient diamond
เพชรา	hen ddyn	petchara - name of a famous actress
เพชรเกษม	petchkasem	petchakasem area in bangkok
เพดานอ่อน	nenfwd meddal	gill
เพทาย	zircon	zircon
เพพซิน	pepsin	pepsin
เพราะ	oherwydd	because
เพราะว่า	oherwydd	because
เพรียะ	piriya	preah - cambodia
เพลงประกอบภาพยนตร์	trac sain ffilm	soundtrack
เพลงประจำจังหวัด	cân daleithiol	province anthem
เพลงประจำมหาวิทยาลัย	cân y brifysgol	university song
เพลงปิดเรื่อง	cân y clawr	pid reung song
เพลงพระราชนิพนธ์	cerddoriaeth frenhinol	the king's song
เพลงลูกทุ่ง	canu gwlad	folk song
เพลงลูกทุ่งขับร้อง	canu gwlad	luk thung song
เพลงอีแซว	pryfocio cerddoriaeth	a type of thai country music
เพลงเปิด	cân agoriadol	opening song
เพลงเปิดเรื่อง	cân agoriadol	opening song
เพลย์สเตชัน	playstation	playstation
เพลโต	plato	plato
เพศ	rhyw	sex
เพศชาย	rhyw gwrywaidd	male
เพิ่มมา	mwy	addition
เพียงพอ	digon	enough
เพื่อ	ar gyfer	for
เพื่อเป็นการเผยแผ่พระพุทธศาสนาและประชาสัมพันธ์กิจกรรมทางพระพุทธศาสนาต่าง	er mwyn lluosogi bwdhaeth a hyrwyddo gweithgareddau crefyddol	passing knowledge about buddhism
เพื่อใช้ร่วมกับตัวชี้วัดอื่น	i&#39;w ddefnyddio gyda dangosyddion eraill	to be used with other indicators
เพ็ชรทาย	phettha	petchtai
เฟนิรามีน	pheniramine	pheniramine
เฟย์	fay	fay
เฟรดริก	frederick	fredrick
เฟส	cyfnod	phase
เฟอร์นิเจอร์	y dodrefn	furniture
เฟื่องอารมย์	foudarom	fueangarom
เภสัชกร	fferyllydd	pharmacist
เภสัชจลนศาสตร์	ffarmacokinetics	pharmacokinetics
เม	mai	may
เมกา	mega	mega
เมฆ	y cymylau	clouds
เมฆออร์ต	cwmwl oort	ash cloud in the space
เมจิ	meiji	maji - a nickname
เมตร	m.	metre
เมทริกซ์	matrics	matrix
เมทะนี	metani	metanee - the surname of a famous actor
เมอร์คิวรี	mercwri	mercury
เมือง	y ddinas	town
เมืองทองฯ	muang thong	muangthong
เมืองนครราชสีมา	nakhon ratchasima	nakornrachasrima city
เมืองปทุมธานี	pathwm thani	mueang pathum thani
เมืองปราจีนบุรี	prachinburi	prajinburi city
เมืองพิจิตร	phichit	pijit city
เมืองพิษณุโลก	phitsanulok	phitsanulok
เมืองยอง	dinas stag	mueng-yor
เมืองลำพูน	lamphun	lumpoon province
เมืองสกลนคร	sakon nakhon	sakon nakhon
เมืองสิงห์	singha	muangsing
เมืองสุรินทร์	surin	surin city
เมืองหลวง	y brifddinas	capital city
เมืองหลวงของอาณาจักรเขมร	prifddinas ymerodraeth khmer	capital of cambudia
เมืองเคมบริดจ์	dinas caergrawnt	city of cambridge
เมืองเอก	dinas ake	mueang-ake
เมืองโคราช	korat	muang korat
เมืองใหญ่	dinas fawr	city
เมืองใหญ่ในเขตนี้	dinasoedd mawr yr ardal hon	capital presently
เมื่อประมาณ	pryd	estimate
เมื่อปีพศ	y llynedd	in buddhist era
เมื่อปีพุทธศักราช	yn y flwyddyn oes bwdhaidd	in b.e.
เมื่อวันจันทร์	ar ddydd llun	on monday
เมื่อเดือนกันยายน	fis medi diwethaf	in september
เมื่อเดือนมีนาคม	mewn gorymdaith	in march
เม็ดขนุน	jackfruit	metkhanun
เม่น	porcupine	porcupine
เย	ye	yay - a sound
เยลโล่	melyn	yellow
เยอรมนี	yr almaen	germany
เยอรมัน	almaeneg	german
เยาวชน	ieuenctid	youth
เยาวชนอายุ	oed ieuenctid	youth age of ...
เยาวราช	chinatown	yaowaraj
เยื่อหุ้มสมอง	cortecs	meninges
เรซูเม	ail-ddechrau	resume
เรด	coch	red
เรดวัน	diwrnod coch	redone
เรย์	ray	ray
เรวดี	newyddion da	rawadee
เราเตอร์	llwybrydd	router
เริ่มการผลิตนำเข้า	dechreuwch gynhyrchu mewnforio	importing
เริ่มก่อสร้าง	dechreuwch y gwaith adeiladu	began constuction
เริ่มจากเดือนพฤศจิกายนเมษายน	gan ddechrau o fis tachwedd i fis ebrill	begins from november to april
เริ่มตั้งแต่อาณาจักรอยุธยาได้โจมตีอาณาจักรเขมร	gan ddechrau gyda theyrnas ayutthaya yn ymosod ar deyrnas khmer.	ever since the ayudhya (military) assault...
เรียกกันว่า	galwyd	called
เรียกว่า	galwyd	call
เรียล	go iawn	real
เรียว	slender	ryo
เรียวทาโร่	ryotaro	totoro - a japanese cartoon
เรียวเฮ	rye hye	reohay - a japanese character
เรียะชอาณาจักร	teyrnas	reacheanachak
เรืองรุ่ง	yn disglair	rueangrung
เรืองศรี	rueangsri	rueng sri - a surname
เรือตรี	cychod	ensign
เรือนนาค	tŷ naga	nak castle
เรือยกพลขึ้นบก	cychod tir	boat for advance the army
เรือสำรวจ	llong arolygu	survey vessel
เรือเร็วโจมตี	ymosodiad cwch cyflym	fast attack craft
เรือใบ	cwch hwylio	sailboat
เรื่อง	y stori	story
เรื่องย่อ	crynodeb	synopsis
เรื่องสั้น	stori fer	short story
เร้กเก้	reggae	reggae
เลข	rhif	mathematics
เลขที่	rhif	number
เลขาธิการสหประชาชาติ	ysgrifennydd cyffredinol y cenhedloedd unedig	united nations secretary-general
เลนส์	y lens	lens
เลออน	leon	lyon
เลิฟ	cariad	love
เลือดออกตามไรฟัน	scurvy	bleeding of the gum
เลโอ	leo	alo
เลโอนาร์โด	leonardo	leonardo
เล็ก	bach	small
เล่ม	llyfr	book
เล่มที่	rhif llyfr	volume
เวทีทอง	llwyfan aur	golden podium
เวล	vail	vail
เวลาประมาณ	amcangyfrif o&#39;r amser	approximate time
เวสต์	gorllewin	west
เวอร์ชัน	fersiwn	version
เวอร์โก้	vergo	virgo
เวิร์คพอยท์	gweithfan	workpoint company
เวิร์คพอยท์สตูดิโอ	stiwdio workpoint	workpoint studio
เวิร์ม	mwydod	worm
เวิลด์	y byd	world
เวียงสระ	wiang sa	wiang sa
เวียงสา	wiang sa	wiang sa
เวียนเทียนรอบอุโบสถหรือสถูปเจดีย์พุทธสถานต่าง	cylch o amgylch y capel neu&#39;r pagoda	a thai religious ceremony
เวโรนา	verona	verona in italy
เว็บ	y we	web
เว็บสเตอร์	webster	webster
เว็บเบราว์เซอร์	porwr gwe	web browser
เว็บไซต์ของเกมส์	gwefan gêm	gaming website
เว็บไซต์ซีไอเอ	gwefan cia	cia website
เว้นวรรค	gofod	space
เศรษฐกิจพอเพียง	economi ddigonolrwydd	sufficiency economy
เศรษฐบุตร	sethaputra	settabut - the family that started bus system in thailand
เศรษฐศาสตร์จุลภาค	micro-economeg	microeconomics
เศรษฐศาสตร์มหภาค	macro-economeg	macroeconomics
เสงี่ยม	cymedrol	sa-ngiam
เสชนะ	ennill	sechana
เสด็จพระราชสมภพ	geni brenhinol	royal birth
เสนอชื่อเข้าชิงและรับรางวัล	enwebu a derbyn gwobr.	nominate and win
เสนา	sena	sena
เสนาเมือง	dinas sena	senamuang
เสนีวงศ์	seni wong	seniwong
เสน่ห์	swyn	sanea
เสมอ	bob amser	always
เสรี	am ddim	seri
เสรีภาพ	rhyddid	freedom
เสียง	y sain	sound
เสียงเปิด	sain agored	approximant, semi-vowel
เสียงเสียดแทรก	sain ffrithiannol	noise
เสือจากัวร์	jaguar	jaquar
เสื้อครุย	robe	gown
เส้นทแยงมุม	croeslin	diagonal
เส้นพุ่ง	llinell	yarn that is used for weaving
เส้นโค้ง	cromlin	curve
เส้นใย	ffibr	polymer, yarn
เหงื่อ	chwys	sweat
เหตุการณ์	y digwyddiad	situation
เหตุการณ์สำคัญ	digwyddiad pwysig	important event
เหรียญ	darn arian	coin
เหรียญกษาปณ์	bathdy	coin
เหรียญทอง	medal aur	gold medal
เหรียญรัตนาภรณ์	darn arian rattanaporn	a special thai medallion
เหลือง	melyn	yellow
เหลือสมาชิก	aelodau sy&#39;n weddill	members left
เหล็ก	yr haearn	iron
เหล่านี้	y rhain	these
เหล่าสุนทร	laosonthorn	soontorn group
เห็นภาพลวงตา	gweld y rhith	seeing hallucination
เอก	yn gyntaf	the first tonal marker of thai writing system represented by  '
เอกชน	preifat	private
เอกซ์	x.	x
เอกราช	annibyniaeth	sovereignty
เอกวาดอร์	ecwador	edwardor
เอกสิทธิ์	unigryw	privilege
เอจิเซ็น	echizen	echizen
เอชไอวี	hiv	hiv, human immunodevficiency virus
เอซ	aces	letter h
เอตาสีติ	atacati	sesasiti
เอนจิเนียริ่ง	peirianneg	engineering
เอนไซม์	ensym	enzyme
เอบีซี	abc	abc
เอม	nod	aim - could be a nickname
เอริค	eric	eric
เอล	el	el
เอสปาด้า	espada	eapada
เอสปาด้าตกชั้น	espada wedi&#39;i israddio	aspata
เอสเอ็ม	sm	sm entertainment from korea
เอสโตเนีย	estonia	astonia - a country
เออร์โกสเฟียร์	ergosffer	ergosphere
เอี่ยมยิ่ง	iam	super, awesome
เอี่ยมสุข	rwy&#39;n hapus	iamsuk
เอื้อย	uri	eay - a thai nickname
เอเชีย	asia	asia
เอเชียตะวันตกเฉียงใต้	asia de-orllewinol	southwest asia
เอเชียเหนือ	gogledd asia	north asia
เอเชียแปซิฟิก	asia heddychlon	asia-pacific
เอเชียใต้	de asia	south asia
เอเธนส์	athen	athens
เอเอฟซี	afc	afc
เอเอฟซีแชมเปียนส์ลีก	cynghrair pencampwyr afc	afc championship
เอ็กซ์โป	expo	expo
เอ็กโทเดิร์ม	ecterm	ectoderm, top level of skin layer.
เอ็กโปรพลาซ่า	plaza expo	expo plaza in thailand
เอ็ดดูเทนเมนท์	addysg	edutainment
เอ็ดเวิร์ด	edward	edward
เอ็น	tendon	n
เอ็นบีเอ	nba	nba - national basketball association
เอ็นเตอร์เทนเม้นท์	adloniant	entertainment
เอ็นเทอร์เทนเมนท์	adloniant	entertainemnt
เอ็มม่า	emma	emma
เอ๋	eh	ah - a nick name
เฮติ	haiti	haiti
เฮลมุต	helmut	helmut
เฮสเตีย	hestia	hestia
เฮอร์เชล	herschel	herschel
เฮาส์	tŷ	house
เฮียวงะ	hyuga	heonga
แกง	cyri	soup
แกมเบีย	gambia	cambia
แกรนซ์	grant	grantz
แกรมมี่	grammy	grammy
แกริซั่น	garsiwn	garrison - an english name
แกลง	klaeng	glang
แกลเลอรี	oriel	gallery
แกสโทรโพดา	gastropoda	"name ""gastropoda"""
แกะ	y defaid	sheep
แกแล็คซี่	galaxy	galaxy
แก่	i	aging
แก้ว	gwydraid	glass
แก้วทอง	gwydr aur	golden cup
แก้วบัวสาย	gwydr lotus	kaeobuasai
แก๊สธรรมชาติ	nwy naturiol	natural gas
แขก	guest	indian
แขน	y breichiau	arm
แขวงจำปาสัก	talaith champasak	champasak province
แขวงหลวงพระบาง	isranbarth luang prabang	luang pra bang province
แคดเมียม	cadmiwm	cadnium
แคทแพท	cat pat	kat - pat kamikaze - the thai famous stars
แคน	caen	kan - a type of thai music
แคนดี้	candy	candy
แคนเซอร์	canzer	cancer
แคม	gwegamerau	cam
แคมป์เบลล์	campbell	campbell
แคมเปญ	yr ymgyrch	campagne
แคมเล็ก	cam bach	vagina fold
แคมใหญ่	cam mawr	labia
แคร็กเกอร์	nutcracker	crackers
แคลคูลัสเชิงปริพันธ์	calcwlws integrol	integral calculas
แคลคูลัสเชิงอนุพันธ์	calcwlws gwahaniaethol	differential calculus
แคลอรี	calorïau	calorie
แคลิฟอร์เนีย	california	california
แคลิฟอร์เนียม	california	californium
แคว้น	rhanbarth	kwon - a korean surname
แจ	jam	live purely and clean both in body and mind - from chinese belief
แจ็กสัน	jackson	jackson
แจ็ค	jack	jack
แจ๊ค	jack	jack
แจ๊ส	jazz	jazz
แด	dae	dae
แดงทั้งแผ่นดิน	coch daear cyfan	red (political party all over the country
แดนสุพรรณ	suphan	dansuphan
แดเนียล	daniel	daniel
แตน	hornet	grass hopper
แต่งงาน	priod	wedding, marriage
แต่งตั้ง	penodi	giving a new title to
แต่งโดย	cyfansoddwyd gan	composed by
แต่ใน	ond i mewn	but in
แต่ในปัจจุบัน	ond nawr	in the present
แต่ไม่ประสบความสำเร็จ	ond heb lwyddiant	failed
แต่ไม่สำเร็จ	ond yn aflwyddiannus	no success
แถบ	llain	flat fish
แทซิทัส	tasitus	tacitus
แทน	yn lle	instead
แทนเจนต์	tangent	tangent
แทยอน	taeyeon	tae yon
แทลเลียม	thallium	thallium
แท็กซี่	tacsi	taxi
แท็บเล็ต	tabled	tablet computer
แนท	nat	nat
แนวความคิดที่	cysyniad	idea number...
แนวพระราชดำริ	menter frenhinol	royal initiative
แนสแด็ก	nasdaq	nasdaq
แบคทีเรีย	bacteria	bacteria
แบงค์	banc	bank
แบทเทิลบรอลเลอร์	tancer brwydr	battle brawlers
แบรนด์แอมบาสเดอร์	llysgennad brand	brand ambassador
แบ่งประเทศไทยออกเป็น	rhannwch wlad thai i mewn	dividing thailand into 6 areas
แบ่งออกเป็น	wedi&#39;i rannu	divided into...
แบ่งออกได้เป็น	wedi&#39;i rannu	divided into
แบ่งได้เป็น	gellir ei rannu&#39;n	divided into
แป้ง	y blawd	pang
แผนที่	y map	map
แผนไพรีพินาศ	cynllun consortiwm	pan pirepinat - a plan to destroy the mobs
แผลศักดิ์สิทธิ์	clwyf sanctaidd	stigmata
แผลไหม้	llosgiadau	burn
แพทย์	meddyg	physician
แพน	pan	pan
แพร่	phrae	the state of praa
แพลทฟอร์ม	llwyfan	platform
แพะ	afr	goat
แพ้	i golli	to lose
แฟชั่น	y ffasiwn	fashion
แฟนเก่า	cyn gariad	ex boyfriend/girlfriend
แฟมิลีที่ไปพักผ่อนที่เกาะมาเฟีย	teulu&#39;n mynd i orffwys ar ynys y maffia	family that went to mafia island for vacation
แฟรงค์	frank	frank
แฟรี่	tylwyth teg	fairy
แฟรี่เทล	stori tylwyth teg	fairy tale
แมกนีเซียม	magnesiwm	magnesium
แมคอินทอช	macintosh	mcintosh
แมนดาริน	mandarin	mandarin
แมนเชสเตอร์	manceinion	manchester
แมว	y gath	cat
แมวป่า	cath wyllt	jungle cat
แมวลายหินอ่อน	tabby marmor	pardofelis marmorata
แมวไทย	cath thai	thai cat
แม็คโคร	makro	macro
แม่	mam	mother
แม่จริม	mam jim	mae charim
แม่ชี	lleianod	nun
แม่นาคพระโขนง	mae nak phra khanong	mae nak phra khanong
แม่น้ำ	afon	river
แม่น้ำชี	afon chi	chee river
แม่น้ำทะเลสาบสำคัญ	afon llyn pwysig	important rivers and lakes
แม่น้ำปิง	afon ping	ping rover
แม่น้ำโขง	afon mekong	kong river from laos
แม่ริม	mae rim	amphoe mae rim
แยกจากคลองชักพระฝั่งซ้าย	ar wahân i gamlas chak phra ar y chwith	forks from khlong chak phra
แยกจากคลองบางกอกน้อยฝั่งซ้าย	o gamlas bangkok noi ar y chwith	forks from the left branch of khlong bangkok noi
แยกจากคลองบางกอกใหญ่ฝั่งขวา	cyffordd o gamlas bangkok yai ar y dde	split from the bankok yai canal to the right
แยกจากคลองบางกอกใหญ่ฝั่งซ้าย	cyffordd o gamlas bangkok yai ar y chwith	forked from khlong bangkok yai
แย้มนาม	enw	yamnam - a surname
แย้มบุญเรือง	dewis teilyngdod	yaembunrueang
แรงโน้มถ่วง	disgyrchiant	gravity
แร็ปเปอร์	rapper	rapper
แลกเปลี่ยนโดยถือ	cyfnewid trwy ddal	exchange, conversion
แลมบ์ดา	lambda	lampda
และ	ac	and
และกลายเป็นอู่ข้าวอู่น้ำที่มีชื่อเสียงของไทย	a daeth yn fasged fara enwog yng ngwlad thai	and becoming the futile land
และกัมพูชา	a cambodia	and cambodia
และครอบครัว	a theulu	and family
และคำว่า	a&#39;r gair	"and the word ""......."""
และจังหวัดใกล้เคียง	a thaleithiau cyfagos	and nearby state
และดุษฎีบัณฑิต	a doethur mewn athroniaeth	honorary degree
และตามสภาพเศรษฐกิจและสังคม	ac yn ôl yr amodau economaidd a chymdeithasol	and following the economy and social conditions
และตำแหน่ง	a safle	and position
และที่สำคัญคือ	a&#39;r peth pwysig yw	and important thing is...
และธงของต่างประเทศ	a baneri tramor	and other countries' flags
และปัจจุบัน	ac yn bresennol	now
และพรรคฟุนซินเปค	a pharti funchinpec	funcinpec
และรถไฟ	a thrên	and railways
และรัสเซีย	a rwsia	and russia
และสหรัฐอเมริกา	a&#39;r unol daleithiau	in america
และสังคม	a chymdeithas	and society
และสังคมศาสตร์	a gwyddorau cymdeithasol	and social science
และสัตว์	ac anifeiliaid	and animal
และสโรชา	a sarocha	and sarocha - a male's name
และหลังจากสงครามภายใน	ac ar ôl y rhyfel mewnol	after inside war
และออกซิเจน	ac ocsigen	and oxygen
และอำเภอกันทรารมย์	ac ardal kanthararom	and kanthararom district
และอื่น	ac eraill	etc.
และอเมริกาเหนือ	a gogledd america	and north america
และเปียโน	a&#39;r piano	and piano
และเป็น	ac yn	is also
และเป็นสมาชิกราชวงศ์	ac mae&#39;n aelod o&#39;r teulu brenhinol	in monarchs family
และเมืองเก่า	a&#39;r hen dref	old city
และเมื่อวันที่	ac ymlaen	when date
และเรียกว่า	a galw	and call
และโลก	a&#39;r byd	and earth
และในปี	ac yn y flwyddyn	and in the year
และได้ปรากฏตัวตอนภาค	ac ymddangos yn y bennod	appeared
แล้วเดินเวียนรอบปูชนียสถาน	yna cerdded o amgylch y cysegr	walk with lighted candles in hand around a temple
แวน	fan	wan
แสงจันทร์	golau&#39;r lleuad	saengchan
แสงชูโต	chuto	sangchuto - a surname
แสงทอง	sangthong	golden sun ray
แสงสิงแก้ว	sang singkaew	sangsingkaew
แสงเทียน	golau canhwyllau	saengthian
แสตมป์	stamp	stamp
แสนรัก	cariad	saenrak
แสนโภศิก	saos phosik	sankosuk - a surname
แหลมสิงห์	canu laem	lam sing - a famous country singer in thailand
แหล่งท่องเที่ยว	atyniad i dwristiaid	tourist attraction
แหล่งโบราณคดีบ้านเชียง	safle archeolegol ban chiang	ban chiang archaeological site
แหวน	modrwy	ring
แหวนธรรมดา	modrwy plaen	ordinary ring
แหวนมาเล่ริง	modrwy malele	ring (faux jewelry)
แห่งบันนัม	o ban nam	of bannam
แห่งสหประชาชาติ	cenhedloedd unedig	of united nations
แองกวิลลา	anguilla	anguilla
แองเจิ้ล	angel	angel
แอซิด	asid	acid
แอด	ychwanegu	add
แอนดรอยด์	android	android
แอนดี้	andy	andy
แอนด์	ac	and
แอนิเมชัน	animeiddio	animation
แอนเนลิดา	annelida	annelida phylum
แอนโทนี	anthony	anthony
แอฟริกา	affrica	africa
แอฟริกาใต้	de africa	south africa
แอมะซอน	amazon	amazon
แอมเวย์	amway	amway
แอร์ไลน์	airlines	airlines
แอล	l.	letter 'l'
แอลจีเรีย	algeria	algeria
แอสกี	asci	ascii
แอสซิสต์	cynorthwyo	assist
แอสปาร์แตม	aspartame	aspartame
แฮช	hash	hash
แฮปปี้	hapus	happy
แฮปปี้และชาร์ล	hapus a charles	happy and charles
แฮ็ค	hacio	hack
โกบอล	byd-eang	cobalt
โกร	tyfu	guro
โกรกพระ	hollt	krok-phra
โกลด์	aur	gold
โกวิท	kowit	kowit
โกโก้	coco	cocoa
โขน	pantomeim	khon
โคกสำโรง	khok samrong	koksamrong
โคนัน	conan	conan
โคฟี	kofi	kofe annan
โครงการ	y prosiect	project
โครงการก่อสร้าง	prosiect adeiladu	project
โครงการนานาชาติ	prosiect rhyngwladol	international program
โครงการศิลปินแห่งชาติ	prosiect artistiaid cenedlaethol	national artist campaign
โครงการเรียนภาษาอังกฤษแบบเข้ม	rhaglen ddysgu saesneg dwys	intensive english program
โครงสร้างภายใน	strwythur mewnol	internal structure
โคราช	korat	khorat or nakorn rajjasrima state
โครโมโซม	cromosom	chromosome
โคล	cole	cold
โคลอมเบีย	colombia	colombia
โคล้ด	cod	claude
โคเคน	cocên	cocain
โคเบะ	kobe	kobe
โคแทนเจนต์	cotangent	cotangent
โคโทเน่ที่	kotone yn	kotone
โฆษะ	lleisio	kosa
โฆษิตพิพัฒน์	kosit phiphat	the surname kopitpipat
โจจิ	joji	choji
โจเซฟ	joseff	joseph
โจโจ้	jojo	jojo
โช	cho	sho
โชคดี	pob lwc	lucky
โชว์	sioe	show
โชอิจิ	shoichi	shoichi
โชแปง	chopin	chopin
โซน	parth	zone
โซนยอชิแด	cenhedlaeth merched	senyosede - a japanese name
โซนี่	sony	sony company
โซล	seoul	seoul
โซลดิ๊ก	soldick	sol-dig
โซลโซไซตี้	cymdeithas enaid	soul society
โซเดียม	sodiwm	sodium
โซเฟีย	sofia	sofia
โดจินชิ	gwneud jinchi	dōjinshi
โดย	gan	by
โดยคำว่า	wrth y gair	by the word
โดยตรง	yn uniongyrchol	directly
โดยทรงพระกรุณาโปรดเกล้าฯ	wedi&#39;i roi yn rasol gan ei fawrhydi	the king's order
โดยที่	lle	by
โดยบ่งบอกถึงปริมาณและคุณภาพของสิ่งตีพิมพ์อิเล็กทรอนิกส์ของสถาบัน	trwy nodi maint ac ansawdd cyhoeddiadau electronig y sefydliad	stating the limitation and quality of a product
โดยปกติ	fel rheol	regular, common, normalcy
โดยปกติตามวัดต่าง	fel arfer yn ôl gwahanol demlau	normally, at the various temples...
โดยปกติแล้ว	fel rheol	usually
โดยมี	gyda	make available
โดยมีตัวอย่างบทพากย์ฉบัง	gydag enghreifftiau o gerddi	background movie in music video
โดยมีพระภิกษุสงฆ์นำเวียนเทียน	gyda mynach yn arwain gorymdaith yng ngolau cannwyll	buddhist monks performing ceremony for vientien buddhist religious holiday
โดยราชบัณฑิตยสถาน	gan y sefydliad brenhinol	by royal institute
โดยสรุป	i grynhoi	in summary.
โดยเจ้าฟ้าธรรมธิเบศรไชยเชษฐสุริยวงศ์	gan y tywysog thamathibet sornchai chetchuriyawong	the name of a king
โดยใช้ชื่อว่า	yn ôl enw	using name
โดยใช้ทางหลวงแผ่นดินหมายเลข	ar briffordd genedlaethol	using freeway #________
โดยในวันที่	erbyn ymlaen	on the date of ___
โดราเอมอนฉบับภาพยนตร์	rhifyn ffilm doraemon	doraemon movie
โดเมกิ	domome	domagi - a japanese word.
โดเมน	parth	domain
โต	wedi tyfu i fyny	big
โตชิบา	toshiba	toshiba
โทน	tôn	tone
โทนะหงษา	tonahahasa	tonahongsa - a surname
โทนี่	tony	tony
โทบรามัยซิน	tobramamcin	tobramycin
โทมัส	thomas	thomas
โทรจัน	trojan	trojan
โทรลล์	trolio	troll
โทริคาบูโตะ	torikabuto	torikabuto - a japanese word
โทรโข่ง	megaphone	a megaphone, portable sound directing equipment.
โน	na	no
โนบิตะ	nobita	nobita
โนบิตะและอัศวินแดนวิหค	nobita a&#39;r marchog	nobita and the winged braves
โนรา	nora	nora
โนะ	dino	noh - a japanese word
โนเบล	nobel	nobel prize
โบตั๋นกลีบสุดท้าย	y peony olaf	botun kleep suttai - a novel
โบราณสถาน	safle archeolegol	the ancient place
โบอิง	boeing	boeing company
โบฮีเมีย	bohemia	bohemia
โบแดง	rhyfeddol	bodin
โปงลางสะออน	ponglang sa-on	pong langsaoun
โปรดเกล้า	os gwelwch yn dda	the king's order
โปรตอน	proton	proton
โปรตีน	protein	protein
โปรเจกต์	prosiect	project
โปรเจกต์พิเศษ	prosiect arbennig	special project
โปรแกรมคอมพิวเตอร์	rhaglen gyfrifiadurol	computer programming
โปรโมชั่น	hyrwyddo	promotion
โปเกมอน	pokémon	pokemon, a very popular japanese anime.
โป๊	porn	nude
โพธิ์ศรี	phosri	phosi
โพนพิสัย	phonai phisai	phonphisai
โพรทิสต์	protist	protist
โพแทสเซียม	potasiwm	potassium
โฟลต	arnofio	float
โฟลเอ็ม	llawr m.	phloem
โฟโตสเฟียร์	sfferau lluniau	photosphere
โมซาร์ท	mozart	mozart
โมบิลสูทกันดั้ม	gundam siwt symudol	mobile suit gundam
โมรา	chalcedony	agate
โมร็อกโก	moroco	morocco
โมลิบดีนัม	molybdenwm	molybdenum
โมฮัมหมัด	mohammad	mohamad
โมเดิร์น	modern	modern
โมเต็ต	motate	motet (sound)
โมเลกุล	moleciwlau	molecule
โมโคนะ	mokona	mokona - a japanese word
โมโนไซต์	safle mono	mono site.
โยชิโนะ	yoshino	yoshino
โยฮันน์	johann	johann
โยเซฟ	joseff	joseph
โรค	y clefyd	disease
โรคประจำตัว	clefyd cynhenid	personal illness
โรคปอดบวม	niwmonia	pneumonia
โรคออทิซึม	awtistiaeth	autism
โรคุโด	rokudo	rokudo
โรคเกาต์	gowt	gout
โรคไต	clefyd yr arennau	kidney disease
โรงพยาบาลกรุงเทพ	ysbyty bangkok	krung thep hospital
โรงพยาบาลจุฬาลงกรณ์	ysbyty coffa&#39;r brenin chulalongkorn	king chulalongkorn memorial hospital
โรงพยาบาลรามาธิบดี	ysbyty ramathibodi	ramathibodi hospital
โรงพยาบาลอานันทมหิดล	ysbyty anandamahidol	ananthamahidol hospital
โรงพยาบาลอุตรดิตถ์	ysbyty uttaradit	uttaradit hospital
โรงละคร	y theatr	theater
โรงเรียนการบิน	ysgol hedfan	aviation school
โรงเรียนดาราวิทยาลัย	coleg dara	dara academy
โรงเรียนนนทรีวิทยา	ysgol nonsi witthaya	nontrivittaya school
โรงเรียนนายเรือ	academi llynges	royal thai naval academy
โรงเรียนนายเรืออากาศ	academi llu awyr brenhinol gwlad thai	royal thai air force academy
โรงเรียนบดินทรเดชา	ysgol bodindecha	bodindecha school
โรงเรียนประชานิเวศน์	ysgol prachaniwet	prachanivet school
โรงเรียนปรินส์รอยแยลส์วิทยาลัย	coleg y tywysog brenhinol	the prince royal's college
โรงเรียนพระตำหนักสวนกุหลาบ	ysgol suan kularb tamnak	the school in the king's compound.  it is reserved for the princess and the royal family
โรงเรียนมัธยมสาธิตวัดพระศรีมหาธาตุ	arddangosiad ysgol uwchradd o wat phra si mahathat	wat phrasri mahadhat secondary demonstration school
โรงเรียนมารีวิทย์	ysgol mary wit	maryvit school
โรงเรียนยุพราชวิทยาลัย	ysgol yupparat wittayalai	yupparaj wittayalai school
โรงเรียนราชินีบน	ysgol y frenhines uchaf	rachinibon school in thailand
โรงเรียนวัฒโนทัยพายัพ	ysgol payap watthanothai	vattanotaipayup school
โรงเรียนศึกษานารี	ysgol addysg naree	suksanari school
โรงเรียนสาธิต	ysgol arddangos	demonstration school
โรงเรียนสาธิตแห่งมหาวิทยาลัยเกษตรศาสตร์	ysgol arddangos prifysgol kasetsart	kasetsart university laboratory school
โรงเรียนห้องสอนศึกษา	ystafell ddysgu ysgol	class room in school
โรงเรียนเขมะสิริอนุสสรณ์	ysgol khemasiri anusorn	kamasirianussorn school
โรงเรียนเจ้าพระยาวิทยาคม	ysgol chao phraya witthayakhom	chao praya vitanakom school
โรงเรียนเฉลิมพระเกียรติสมเด็จพระศรีนครินทร์	ysgol chaloem phrakiat somdet phra srinagarindra	srinagarindra the princress mother school
โรงเรียนเทศบาล	ysgol gyhoeddus	public schools
โรงเรียนไตรมิตรวิทยาลัย	ysgol traimit wittayalai	trimittavitayalai school
โรงแรม	y gwesty	hotel
โรจูโร่	rojero	rojuro - a japanese character
โรตารี	rotari	rotary
โรม	rhufain	rome
โรมัน	rhufeinig	roman
โรลเลอร์เบลด	llafn rholer	rollerblade
โรส	rhosyn	rose
โรเจอร์	roger	"name ""roger"""
โลก	y byd	world
โลกแอมะซอน	byd amazon	world of amazon
โลงหิน	sarcophagus	sarcophagus
โลโซ	loso	lasso
โสณกุล	sonakul	sonakul
โสน	sesbania	sa-nho, has yellow flower, use in thai sweet/desert
โสภณ	sophon	sophon
โหมด	y modd	mode
โหม่ง	mynd i&#39;r afael â hyn	mong - a thai musical instrument
โอกาส	y cyfle	opportunities
โอบามา	obama	obama
โอภาส	hapus	oh pas - a thai name
โอร์มาน	oman	oman - country
โอวีเอ	ova	ova
โอสถสภา	osotspa	osotspa
โอสถานุเคราะห์	osathanugrah	social service
โออิชิ	oishi	oochi - a name of food business in thailand
โอะกินะวะ	okinawa	okinawa
โอเค	iawn	ok
โอเอกซ์	tic-tac-toe	ox - a game like tic tac toe
โฮม	hafan	"english word ""home"""
โฮลดิ้ง	dal	houlding
ใจดี	garedig	chaidi
ใช่	ydw	yes
ใช้ขยายความเฉพาะบุคคล	defnyddiwch i bersonoli	to describe
ใช้ชื่อว่า	enwyd	named
ใช้เวลา	cymerwch amser	it takes time
ใต้	de	south
ในกรณีนี้	yn yr achos hwn	in this isituation
ในกลุ่ม	yn y grŵp	in group
ในการประเมินผลงานวิจัยของสถาบัน	wrth werthuso canlyniadau ymchwil yr athrofa	in research evaluating of institute
ในการเลือกตั้ง	yn yr etholiad	election
ในกาลต่อมา	yn y dyfodol	later
ในขณะที่	tra	while
ในคริสต์ศตวรรษที่	yn y 19eg ganrif	in the #___ century
ในคศ	yn y flwyddyn	in a.d.
ในชิงร้อยชิงล้าน	yn y miliwn ching ching	game show to compete for 1 million baht
ในช่วงปี	yn ystod y flwyddyn	in the year of ________
ในช่วงสงครามเย็น	yn ystod y rhyfel oer	during the cold war
ในช่วงสงครามโลกครั้งที่	yn ystod y rhyfel byd	in time of world war
ในช่วงสงครามโลกครั้งที่สอง	yn ystod yr ail ryfel byd	during world war ii
ในช่วงหลัง	yn ddiweddarach	later
ในช่วงแรก	yn y dechrau	in the first part, primarily
ในดาร์ฟูร์	yn darfur	inside dafur
ในต่างประเทศ	mewn gwledydd tramor	foreign countries
ในทางกลับกัน	ar y llaw arall	opposite
ในทางดาราศาสตร์	mewn seryddiaeth	astrology
ในทางตรงกันข้าม	i&#39;r gwrthwyneb	oppositely
ในบางฉบับ	mewn rhai rhifynnau	in a certain issue (of a magazine)
ในประเทศญี่ปุ่น	yn japan	japan
ในปลายปี	ar ddiwedd y flwyddyn	at teh end of the year
ในปี	yn y flwyddyn	in the year
ในปีที่	yn y flwyddyn	in year
ในปีนี้	eleni	in this year
ในปีพศ	yn y flwyddyn	in b.e. year
ในปีพุทธศักราช	yn y flwyddyn.	in b.e.
ในปีเดียวกัน	yn yr un flwyddyn	in the same year
ในปีเดียวกันนั้น	yn yr un flwyddyn	in that year
ในพระบาทสมเด็จพระพุทธยอดฟ้าจุฬาโลก	yn nheyrnasiad y brenin bwdha yodfa chula lok	under the reign of one of the thailand's past king
ในพระบาทสมเด็จพระพุทธเลิศหล้านภาลัย	yn ei fawrhydi y brenin, phra buddha lertlah, napalai	under one of the king of siam
ในภายหลัง	yn ddiweddarach	background
ในภาษาสันสกฤต	yn sansgrit	in sanskrit language
ในภาษาอังกฤษ	yn saesneg	in english
ในภาษาอิตาลี่	yn eidaleg	in italian
ในภาษาไทย	yn thai	in the thai language
ในยุคกลาง	yn y canol oesoedd	in the middle ages
ในยุคแรก	yn y dechrau	in early age
ในระบบสุริยะ	yng nghysawd yr haul	in the solar system
ในระยะหลัง	yn ddiweddarach	at the end
ในระหว่างปี	yn ystod y flwyddyn	between the years
ในระหว่างวันที่	yn ystod y dydd	during the dates
ในรัชสมัยพระบาทสมเด็จพระจอมเกล้าเจ้าอยู่หัว	yn ystod teyrnasiad y brenin mongkut	in the reign of thailand's 4th king
ในรัฐบาล	yn y llywodraeth	in the government
ในฤดูกาล	yn eu tymor	in season
ในสมัยกรุงศรีอยุธยา	yn y cyfnod ayutthaya	in  ayutthaya kingdom era
ในสมัยก่อน	yn yr hen ddyddiau	in the past
ในสมัยพุทธกาล	yn yr oes fodern	in buddha era
ในสมัยรัชกาลที่	yn ystod teyrnasiad	in period
ในสหรัฐอเมริกา	yn y taleithiau unedig	in united states of america
ในหนังสือ	yn y llyfr	in book
ในอดีต	yn y gorffennol	in the past
ในอดีตทุ่งกุลาร้องไห้ในฤดูแล้ง	yn y gorffennol, wylodd thung kula yn y tymor sych.	thung kula rong hai in dry season in the past
ในอัลบั้ม	yn yr albwm	in the album
ในเกมเดอะซิมส์	yn y gêm sims	sims game
ในเครือ	cysylltiedig	in the area of
ในเดือน	yn y mis	in the month of ...
ในเดือนมิถุนายน	yn mehefin	in june
ในเดือนมีนาคม	mewn gorymdaith	in april
ในเบื้องต้น	i ddechrau	primarily
ในเรื่อง	o ran	in story
ในเหตุการณ์	beth bynnag	in the event
ในเอเชียตะวันออกเฉียงใต้	yn asia de-ddwyrain	in southeast asia.
ในแฮร์รี่	harry	in harry
ในโอกาสครบรอบ	ar achlysur y pen-blwydd	anniversary
ใบเสมา	brwydrau	boundary marker of a temple
ใหญ่	mawr	large
ให้พลเอกเปรม	ar gyfer prem cyffredinol	general prem - a former military figure
ให้สมเด็จพระเทพรัตนราชสุดาฯ	ar gyfer hrh princess maha chakri sirindhorn	given to the thai's eldest princess
ให้เสียงพากย์	actio llais	dubbed
ให้แก่ประชาชน	i&#39;r bobl	for the people
ให้ใช้หลัก	defnyddiwch yr egwyddor	large size
ไกรทอง	krai thong	krei thong - a surname
ไกรลาศ	krailat	krailard
ไกลกังวล	poeni	klai kangwon
ไก่	cyw iâr	chicken
ไขมัน	braster	lipid, fat
ไขสันหลัง	llinyn y cefn	spinal cord
ไข่	wy	egg
ไข้รากสาดใหญ่	teiffws	typhus
ไข้สูง	twymyn uchel	high fever
ไข้หวัดใหญ่สายพันธุ์ใหม่	straen newydd o&#39;r ffliw	new flu strain
ไข้หวัดใหญ่สเปน	ffliw sbaenaidd	spanish flu
ไคเอ็น	kaien	kaien
ไชยกิตติ	chai kitti	chaikitti
ไชยยงค์	chaiyong	chaiyayong
ไชยวัฒน์	chaiwat	chaiwat
ไชยา	chaiya	chaiya
ไชโย	lloniannau	chaiyo
ไซน์	sine	sine
ไซโทสเกเลตอน	zeitos gateela	cytoskeleton
ไซโปรเฮปตาดีน	sipro heptadine	cyproheptadine
ไดคลอกซาซิลลิน	daiklok sillin	dicloxacillin - a drug
ไดดาโนซีน	dinocene	didanosine - medication
ไดอาน่า	diana	diana
ไดโนเสาร์ของโนบิตะ	deinosor nobita	nobita's dinosaur
ได้	cael	receive
ได้กล่าวว่า	meddai	stating that, commenting on something
ได้ดังนี้	fel a ganlyn	these
ได้ทูลเกล้าฯ	cyflwynwyd	report to the king
ได้มีโอกาสสร้างความสัมพันธ์อันดีต่อกัน	cael cyfle i adeiladu perthnasoedd da â&#39;i gilydd	good relationship
ได้รับ	cael	received
ได้รับฉายาว่า	wedi derbyn y llysenw	recived the alias
ได้รับรางวัล	cael gwobr	awarded
ได้ร่วมกันในภารกิจในด้านต่าง	gyda&#39;n gilydd yn y genhadaeth mewn amrywiol feysydd.	participated in activities
ได้สำเร็จ	yn llwyddiannus	successfully
ได้สู้กับ	wedi&#39;i brynu gyda	competing against
ได้เคลื่อนไหวตรวจสอบการทำงานของรัฐบาลกัมพูชาอย่างแข็งขัน	wedi symud ymlaen i archwilio gwaith llywodraeth cambodia	underground investigation
ได้เป็น	cael i fod	is
ไต	aren	kidney
ไต้หวัน	taiwan	taiwan
ไท	thai	tai
ไทย	thai	thai
ไทยทีวีสีช่อง	sianel deledu lliw thai	thai tv
ไทยพรีเมียร์ลีก	uwch gynghrair gwlad thai	thai premiere
ไทยรามา	rama thai	thairama
ไทยานนท์	thaiyanon	taiyanon - a thai surname
ไทรโลจี	trioleg	trilogy
ไทลื้อ	lue thai	group of laotians that lives on flatlands
ไทโรซีน	tyrosine	thyrosine
ไนท์	noson	sege
ไนลอน	neilon	nylon
ไนโตรเจน	nitrogen	nitrogen
ไปจนถึง	i	to
ไปบรรจบแม่น้ำเจ้าพระยา	cyfarfod ag afon chao phraya	runs to chao phraya river
ไปรษณีย์กาฬสินธุ์	swyddfa bost kalasin	kalasin post office
ไปรษณีย์ฉะเชิงเทรา	swyddfa bost chachoengsao	cha cheng sao postal zone
ไปรษณีย์นครศรีธรรมราช	swyddfa bost nakhon si thammarat	nakornsritamarat postal station
ไปรษณีย์ภูเวียง	swyddfa bost phu wiang	pu weang postal office
ไปรษณีย์ยานนาวา	swyddfa bost yannawa	yan nawa post office
ไปรษณีย์ร้อยเอ็ด	swyddfa&#39;r post roi et	roi et post office
ไปรษณีย์สามเสนใน	swyddfa bost samsen nai	samsen nai post office
ไปรษณีย์หนองหาน	swyddfa bost nong han	nong han postal office
ไปรษณีย์อำนาจเจริญ	swyddfa bost amnat charoen	amnat charoen post office
ไปรษณีย์อุทุมพรพิสัย	swyddfa bost uthumphon phisai	utumporn pisai post office
ไปรษณีย์อุบลราชธานี	swyddfa bost ubon ratchathani	ubon ratchathani post office
ไปรษณีย์เดชอุดม	det swyddfa&#39;r post	det udom post office
ไปรษณีย์โพนพิสัย	swyddfa bost phonai phonai	phon phisai post office
ไผ่แดง	bambŵ coch	red bamboo
ไพฑูรย์	lapis lazuli	phaithun
ไพรบึง	coedwig	phrai bueng
ไพรวัลย์	praiwan	phraiwan
ไพศาล	eang	phaisan
ไฟ	y tân	fire
ไฟนอลแฟนตาซี	ffantasi terfynol	final fantasy
ไฟร์วอลล์	mur tân	firewall
ไมค์	mike	mike
ไมอามี่	miami	miami
ไมโครซอฟท์	microsoft	microsoft
ไม่ต่ำกว่า	dim llai na	not lower than
ไม่ทราบข้อมูล	gwybodaeth anhysbys	no background information
ไม่บังคับ	dewisol	not enforced
ไม่ผ่านเข้ารอบ	heb gymhwyso	did not make it to the next round, got eliminated in the initial round
ไม่มีบันทึกว่าใครเป็นคนสร้าง	nid oes cofnod o bwy a&#39;i creodd.	don't note who make id
ไม่มีแขน	dim breichiau	armless
ไม่ว่าจะ	p&#39;un ai	such as
ไม่สามารถทำการเกษตรได้	methu â ffermio	unable to practice agriculture
ไม่แตกกิ่ง	heb ganghennog	no chain
ไม่ใช่	na	no
ไม้	y pren	mai
ไม้กวาด	broom	broom
ไม้หนีบผ้า	dillad peg	clip
ไม้ไม่ผลัดใบ	bytholwyrdd	plants that have leaves all year round
ไรงะ	riga	reiya - a character from a japanese story
ไรโบโซม	ribosom	ribosome
ไร่	ranch	field, parcel
ไลท์	golau	light
ไลบร้า	libra	libra
ไลฟ์สไตน์	lifstein	life style
ไลเบรชัน	llyfrgell	libration
ไวชาน่า	waichana	baishana - weapon in a japanese story
ไวทยางกูร	vittayangkun	wathaiyangkun
ไวทยานนท์	waithayanon	waithayanon
ไวท์สเปล	whitespell	white spell
ไวน์	gwin	wine
ไวยากรณ์	gramadeg	waiyakorn
ไวรัส	y firws	virus
ไวรัสตับอักเสบ	hepatitis	hepatitis
ไวเซิร์ด	weiss	vizard
ไวเปอร์	viper	viper
ไวเวิร์น	wvern	wyvern
ไวโอเลต	fioled	violet
ไว้ว่า	dywedwch	as
ไหซอง	flirt	haisong
ไหมกัน	gyda&#39;n gilydd	maigun - a surname
ไหลจากลาวเข้าสู่ภาคเหนือของกัมพูชาแล้วไหลผ่านเข้าเขตเวียดนาม	yn llifo o laos i ogledd cambodia ac yn llifo i fietnam	flows from laos into northern cambodia
ไอทีวี	itv	itv
ไอน์สไตน์	einstein	einstein
ไอน์สไตเนียม	einsteinium	einsteinium
ไอพอด	ipod	ipod
ไอริส	iris	iris
ไอร์แลนด์เหนือ	gogledd iwerddon	northern ireland
ไอเอ	ia	ia
ไอโมบาย	i-symudol	i-mobile
ไอโอ	io	io - from greek mythology
ไฮยาซินธ์	hyacinth	hyacinth
ไฮเดรนเยีย	hydrangea	hydrangea
ไฮเปอร์มาร์เก็ต	hypermarket	tesco lotus hypermarket chain
ไฮแจ็ค	hijack	hijack
ไฮโดรเจน	hydrogen	hydrogen
๑๔	14	14
๑๕	15	15
๑๖	16	16
๑๘	18	18
๒๑	21	21
๒๒	22	22
๒๔๕๐	1907	2450
๒๕๐๒	1962	2502
๒๕๐๓	1963	2503
๒๕๒๓	1980	1980
๒๕๓๔	1991	2534
๒๕๓๕	1992	2535
๒๕๓๖	2536	2536 be (1993 ad)
๒๕๔๗	2004	2547
๒๕๔๘	2005	2548
๒๕๕๐	2007	2550
๒๕๕๔	2011	2554
๒๗	27	27
๒๘	28	28
๓	3	3
๔๘	48	48
๕	5	5
๖๐	60	60
๙	9	nine
ព្រះរាជាណាចក្រកម្ពុជា	ព្រះរាជាណាចក្រ កម្ពុជា	cambodia
疾風伝	疾風 伝	not in thai - cannot translate
