+	+	plus sign
=	=	equal to
 °ซ  °ฟ 	° c ° f.	เซลเซียส ฟาเรนไฮต์
 ซม	செ.மீ.	cm.
 −°ซ  °ฟ	- ° c ° f.	thai letters
×	×	letter x
γ	γ	y
π	π	pi
กกกก	கி.கி.	a thai letter repeated 4 times
กกกข	கோர் கோர்	4 thai alphabets - jibberish
กขขข	ஏபிசி ஆ	4 of thai letters
กขขขขขขข	அ ப ப ப ப ப	abbbbbbb
กฎ	ஆட்சி	law, rule
กฎของโคไซน์	கொசைன் சட்டம்	law of cosines
กฎแห่งกรรม	கர்மா	bad karma
กติกา	விதிகள்	rule
กทม	பாங்காக்	agency
กนู	நைட்	gnu - computer related acronym
กบ	தவளை	frog
กบฏทหารนอกราชการ	இராணுவ கிளர்ச்சி	coup de lat
กมล	லில்லி	kamon
กมลรัตน์	கமோன்ராட்	kamolrat - a surname
กรณีที่	வழக்கு	case
กรมขุนอิศเรศรังสรรค์	க்ரோம் குன் ஐசெட் ரங்சன்	the convention of angels
กรมขุนเพ็ชรบูรณ์อินทราชัย	க்ரோம்குன்பேட்சபூன்-இந்தாச்சாய்	department of....
กรมข่าวทหารอากาศ	விமானப்படை செய்தித் துறை	communication department of the thai air force
กรมควบคุมโรค	நோய் கட்டுப்பாட்டுத் துறை	department of disease control
กรมทหารราบที่	காலாட்படை படைப்பிரிவு	infantry regiment
กรมรบพิเศษที่	சிறப்புப் படைத் துறை	special force group
กรมศิลปากร	நுண்கலைத்துறை	fine arts department
กรมหลวงนราธิวาสราชนครินทร์	க்ரோம் லுவாங் நாரதிவத்ரட்சநகரின்	krom ma loung naratifatrachanakarin - the name of a royal family member
กรมหลวงสงขลานครินทร์	க்ரோம் லுவாங் சாங்ஹ்லா நகரின்	prince of songkla
กรมอุตุนิยมวิทยา	வானிலை ஆய்வு துறை	the meteorology department
กรรชัย	காஞ்சாய்	kanchai
กรอง	வடிகட்டி	screen
กระดูกค้อน	சுத்தி எலும்பு	malleus, hammer bone
กระดูกต้นแขน	ஹுமரஸ்	humerus
กระดูกฝ่ามือ	உள்ளங்கைகள்	metacapus
กระดูกสะบัก	ஸ்கபுலா	scapula
กระดูกสะบ้า	படெல்லா	kneecap
กระทรวงกลาโหม	பாதுகாப்பு அமைச்சகம்	defense ministry
กระทรวงการคลัง	நிதி அமைச்சகம்	ministry of finance
กระทรวงการต่างประเทศ	வெளிநாட்டு அலுவல்கள் அமைச்சு	ministry of foreign affairs
กระทรวงวัฒนธรรม	கலாச்சார அமைச்சகம்	ministry of culture
กระทรวงศึกษาธิการ	கல்வி அமைச்சு	ministry of education
กระทรวงสาธารณสุข	பொது சுகாதார அமைச்சகம்	ministry of public health
กระทรวงอุตสาหกรรม	கைத்தொழில் அமைச்சு	ministry of industry
กระทรวงเกษตรและสหกรณ์	வேளாண்மை மற்றும் கூட்டுறவு அமைச்சகம்	ministry of agriculture and cooperatives
กระทรวงเศรษฐการ	பொருளாதார விவகார அமைச்சகம்	ministry of commerce
กระทุ่มแบน	சிறிய கூடை	krathum baen district, samut songkram province
กระนวน	சுருதி	granuan - location in knon kan province
กระนั้น	ஆயினும்கூட	however
กระบวนการสร้าง	கட்டிட செயல்முறை	anabolism
กระบวนการสร้างและสลาย	உருவாக்கி சிதைக்கும் செயல்முறை	metabolism
กระบอง	பிளாக் ஜாக்	club
กระบะทราย	மணல் பெட்டி	litter box or sand box
กระบี่กระบอง	வாள்களுடன் போட்டியிடுங்கள்	krabi krabong (swordplay)
กระรอก	அணில்	squirrel
กระวนกระวาย	ஆர்வத்துடன்	nervous
กระหม่อม	தலை	fontanelle
กระเพาะอาหาร	வயிறு	stomach
กระแต	சிப்மங்க்	wasp
กรับ	எடு	wooden rhythm clappers
กรับพวง	ஒரு கொத்து எடுக்கவும்	krap phuang
กรับเสภา	க்ராபாவ்	wooden rhythm clappers
กรัม	கிராம்	gram
กรัยวิเชียร	கிரெய்விச்சியன்	krivician - a surname
กรานาดา	கிரனாடா	granada
กริม	கிரிம்	grim
กรี	சாம்பல்	karee
กรุง	மூலதனம்	city
กรุงธนบุรี	தோன் பூரி	thonburi city
กรุงลอนดอน	லண்டன்	london
กรุงศรีอยุธยา	அயுதயா	sri ayuttaya city - former capital of thailand
กรุงเทพ	பாங்காக்	bangkok
กรุงเทพเชียงใหม่กรุงเทพ	பாங்காக், சியாங் மாய், பாங்காக்	bangkok changmai bangkok
กรุงเทพโพลล์	பாங்காக் வாக்கெடுப்பு	bangkok poll
กรุ๊ป	குழு	group
กลอง	டிரம்	drum
กลองมโหระทึก	பெரிய டிரம்	big drum
กลองยาว	டிரம்	tom-tom
กลองสองหน้า	இரண்டு முகம் கொண்ட டிரம்	glong songna
กลอน	வசனம்	poem
กลอบูลิน	பளபளப்பான	globulin
กลาง	நடுத்தர	in the middle
กลิ่น	வாசனை	odor
กลุ่มดาวกล้องจุลทรรศน์	நுண்ணோக்கிகளின் விண்மீன்கள்	microscopium
กลุ่มดาวนกทูแคน	டூக்கன்	tucana
กลุ่มดาวสิ่ว	உளி	siu star
กลุ่มดาวเข็มทิศ	விண்மீன் திசைகாட்டி	pyxis constellation
กลุ่มดาวเตาหลอม	குண்டு வெடிப்பு உலை	fornax
กลุ่มดาวแมงป่อง	தேள்	scorpion constellation
กลุ่มดาวแมลงวัน	ஈக்கள்	musca
กลุ่มที่	குழு	group
กลุ่มแสงอุษา	யுசா லைட் குழு	light at dawn
กลูคากอน	குளுக்கோன்	glucagon
กล่าวคือ	அதாவது	that is
กล้วยไม้ดาว	நட்சத்திர ஆர்க்கிட்	type of orchid that have slim petal like star
กล้องถ่ายภาพ	புகைப்பட கருவி	camera
กล้ามเนื้อ	தசை	muscle
กวม	குவாம்	obscure
กวาง	மான்	deer
กวิน	கவின்	gwen - a name
กวี	கவிஞர்	poet
กว่า	விட	than
กองกลาง	மிட்ஃபீல்டர்	headquarter
กองการบินทหารเรือ	கடற்படை விமானப் பிரிவு	the flying section of the navy
กองการศึกษา	கல்வி பிரிவு	education group
กองการเจ้าหน้าที่	பணியாளர்களின் பிரிவு	division of personnel
กองกำลังกึ่งทหาร	அரை இராணுவ படைகள்	armforces
กองคลัง	நிதி பிரிவு	division of finance
กองทัพ	இராணுவம்	arm forces
กองทัพบกไทย	தாய் ராணுவம்	thai army
กองทัพภาคที่	பிராந்தியத்தின் இராணுவம்	army area
กองทัพเรือ	கடற்படை	navy
กองทัพเรือไทย	தாய் கடற்படை	the royal thai navy
กองทัพแห่งความชอบธรรม	நீதியின் இராணுவம்	army of the righteous
กองทัพไทย	தாய் ராணுவம்	thai military forces
กองบิน	விமானப்படை	air force
กองบินปีกหมุนที่	விங் ஸ்பின்னிங் விங்	flight corp number __________
กองพลทหารม้าที่	குதிரைப்படை படை	cavalry division
กองพันทหารช่างที่	பொறியாளர் படைப்பிரிவு	troop unit number ___________`
กอด	கட்டிப்பிடி	kord
กอนซาเลซ	கோன்சலஸ்	gonzales - a name
กอร์ดอน	கார்டன்	gordon
กอลมเบต์	கோரேம்	glombet - a catholic priest
กอล์ฟ	கோல்ஃப்	golf
กอล์ฟไมค์	கோல்ஃப் மைக்	golf-mike
กะเหรี่ยง	கரேன்	karen
กะโหลก	மண்டை ஓடு	skull
กะโหลกศีรษะ	மண்டை ஓடு	skull; cranium
กังหันชัยพัฒนา	சாய்பட்டனா டர்பைன்	chaipattana's windmill
กันดั้ม	குண்டம்	gundam - a cartoon
กันตัง	காந்தாங்	kuntun in trung state
กันทรลักษ์	காந்தரலக்	kuntaraluk - an area in thailand
กันฟอร์ม	படிவம்	gun form
กันอริ	கனோரி	gan-ari
กันเอง	இணக்கமாக	casual
กับนางสุจาริณี	திருமதி சுச்சாரினியுடன்	with mrs. sujarinee
กัมปูเชีย	காம்பூசியா	kampuchea
กัมพูชา	கம்போடியா	cambodia
กัมพูชาประชาธิปไตย	ஜனநாயக கம்போடியா	democratic kampuchea
กัมพูชาเป็นประเทศที่มีป่าไม้อุดมสมบูรณ์มากที่สุดหากเปรียบเทียบกับประเทศเพื่อนบ้าน	அண்டை நாடுகளுடன் ஒப்பிடும்போது கம்போடியா அதிக அளவில் காடுகளைக் கொண்ட நாடு.	cambodia is the country with nice, healthy forests
กัมพูชาเป็นอดีตประเทศอาณานิคมของฝรั่งเศสในภูมิภาคเอเชียตะวันออกเฉียงใต้เพียงแค่ประเทศเดียวเท่านั้นที่มีการปกครองด้วยระบอบราชาธิปไตยภายใต้รัฐธรรมนูญ	தென்கிழக்கு ஆசியாவில் அரசியலமைப்பின் கீழ் முடியாட்சியைக் கொண்ட ஒரே முன்னாள் பிரெஞ்சு காலனித்துவ நாடு கம்போடியா ஆகும்.	cambodia was a former french colony
กัมพูชาเป็นอาณานิคมของฝรั่งเศสมาตั้งแต่พศ	கம்போடியா ஒரு பிரெஞ்சு காலனியாக இருந்து வருகிறது.	cambodia was a france colony from year
กัวเตมาลา	குவாத்தமாலா	guatemala
กานซู	கன்சு	honshu in china
กานต์	கான்	kan
กานา	கானா	ghana
กานามัยซิน	கனமைசின்	kanamycin
กาบอง	காபோன்	baton
กาพย์ฉบัง	காவிய கவிதை	poem
กาพย์สุรางคนางค์	கவிதை	gabsuranknang
กาม	வாண்டன்	lust
กาย	உடல்	body
การ	தி	project
การกีฬา	விளையாட்டு	sport
การขัดเกลาทางสังคม	சமூகமயமாக்கல்	socialization
การขับถ่าย	வெளியேற்றம்	excretion
การขับไล่	வெளியேற்றம்	discharge
การคมนาคม	போக்குவரத்து	transportation department
การคลัง	நிதி	public finance
การค้นพบ	கண்டுபிடிப்பு	discover
การค้า	வர்த்தகம்	marketing
การจัดการ	நிர்வாகம்	project
การจัดการคุณภาพ	தர மேலாண்மை	quality control
การจัดอันดับ	தரவரிசை	ranking
การจัดให้มี	ஏற்பாடு	putting together something
การจูบ	ஒரு முத்தம்	kissing
การชัก	வலிப்பு	the act of pulling the flag wiht string up the pole
การดำเนินการ	ஒரு செயல்பாடு	progression
การตอบรับ	பின்னூட்டம்	welcoming
การตั้งถิ่นฐาน	தீர்வு	start a project
การต่างประเทศ	வெளிநாட்டு விவகாரங்கள்	foreign affairs
การทำงานของ	இன் வேலை	function
การทำป่าไม้	வனவியல்	forestry
การท่องเที่ยว	சுற்றுலா	tourism
การท่าเรือ	துறைமுக அதிகாரசபை	port authority
การบริการ	சேவை	customer service
การบริหารการพัฒนา	அபிவிருத்தி மேலாண்மை	development
การบริหารการศึกษา	கல்வி நிர்வாகம்	educational administration
การบริหารจัดการ	மேலாண்மை	management
การบริหารราชการแผ่นดิน	அரசு நிர்வாகம்	administration
การบินไทย	தாய் ஏர்வேஸ்	thai airways
การปกครองท้องถิ่น	உள்ளூர் அரசு	local administration
การปกครองส่วนท้องถิ่น	உள்ளூர் அரசு	local government
การปกครองแบ่งออกเป็น	விதி பிரிக்கப்பட்டுள்ளது	administration
การปฏิรูประบบจัดเก็บภาษีเงินได้	வருமான வரி வசூல் முறையின் சீர்திருத்தம்	taxation reform
การปฏิรูปศาสนา	சீர்திருத்தம்	religious reformation
การปฏิวัติฝรั่งเศส	பிரஞ்சு புரட்சி	french revolution
การปฏิวัติอุตสาหกรรม	தொழில் புரட்சி	industrial revolution
การปฏิสนธิ	கருத்தரித்தல்	fertilisation
การประมง	மீன்வளம்	fishery
การพัฒนา	வளர்ச்சி	development
การพัฒนาประชาธิปไตย	ஜனநாயக வளர்ச்சி	democratic development
การพูด	பேசும்	speaking
การยึดครองมะละกาของโปรตุเกสในปี	இந்த ஆண்டில் மேலகாவின் போர்த்துகீசிய ஆக்கிரமிப்பு	portugal took over malaga
การระบาดของไข้หวัดใหญ่สายพันธุ์ใหม่	காய்ச்சலின் புதிய திரிபு	flu pandemic
การรักษาพยาบาล	மருத்துவ சிகிச்சை	nursing care
การร่วมเพศทางทวารหนัก	குத செக்ஸ்	sodomy
การลดรูป	சிதைப்பது	reduction
การละเล่นพื้นบ้าน	நாட்டுப்புற விளையாட்டுகள்	local game
การวิจัย	ஆராய்ச்சி	researching
การวิเคราะห์	பகுப்பாய்வு	analysis
การศึกษา	கல்வி	study of, education
การสังคายนาครั้งที่	கடைசி ஆணை	the event of convention of monks
การสั่นพ้อง	அதிர்வு	resonance
การสำเร็จความใคร่ด้วยตนเอง	சுயஇன்பம்	masturbation
การสืบพันธุ์	இனப்பெருக்கம்	reproduction
การสื่อสาร	தொடர்பு	communications
การาจ	கேரேஜ்	garage
การุณ	கருண்	karoon
การเต้นรำ	நடனம்	dance
การเพิ่มสิทธิประโยชน์แก่นักลงทุนต่างประเทศ	வெளிநாட்டு முதலீட்டாளர்களுக்கு சலுகைகளை அதிகரித்தல்	increase benefits for foreign investors
การเล่น	விளையாட	play
การแข่งขัน	போட்டி	competition
การแบ่งพื้นที่	பகிர்வு	land division
การใช้คำ	சொல் பயன்பாடு	terminology
การไฟฟ้าส่วนภูมิภาค	மாகாண மின்சார ஆணையம்	distribution electric transformer
การไหว้	மரியாதை	thai greeting
การ์ด	அட்டை	guard
กาฬสินธุ์	கலாசின்	katsin - a thai surname
กาเวน	கவைன்	gawain
กาเหว่าที่บางเพลง	சில பாடல்களின் ராவன்	the cuckoo's song.
กำกับการแสดงโดย	இயக்கம்	produced by (movie)
กำกับโดยอภิชาติพงศ์	அபிச்சாட் பாங் இயக்கியுள்ளார்	produced by apichartpong - a famous thai movie producer
กำมะถัน	கந்தகம்	sulfur
กำลังจะปรับเปลี่ยนเป็น	மாற்றப் போகிறது	is changing to
กำหนดตามสภาพภูมิศาสตร์	புவியியலால் தீர்மானிக்கப்படுகிறது	geography estimation
กำแพงเพชร	கம்பேங் பெட்	kamphaeng phet
กำแพงเมืองจีน	பெருஞ்சுவர்	the great wall of china
กำแพงแสน	கம்பேங்சேன்	kampangsaen (name of district)
กิจผลิต	உற்பத்தி	kitpalit (last name)
กิมป์	கிம்ப்	gimp - gnu image manipulation program
กิโลกรัม	கிலோ	kilogram
กิโลไบต์	கே.பி.	kilobyte
กิ่งแก้ว	கிங்க்கேவ்	kingkaeo
กิ้งกือ	மில்லிபீட்	millipedes
กิ๊ก	கிக்	gig
กีฏวิทยา	பூச்சியியல்	entomology
กีฬา	விளையாட்டு	sports
กีฬาทางน้ำ	நீர் விளையாட்டு	water sports
กีฬาแหลมทอง	லாம் தாங் விளையாட்டு	seap games
กุดจับ	அச்சு	good jub - a place
กุลดิลก	குல்திலோக்	kuldilok
กุลละวณิชย์	குலலவநிட்	kullawanich
กุหลาบ	உயர்ந்தது	kularb (first name)
กุ้ง	இறால்	shrimp
กุ้งต้ม	வேகவைத்த இறால்	boiled shrimp
กูเกิล	கூகிள்	google
ก็คือ	இருக்கிறது	which is
ก็ใช้เป็น	எனப் பயன்படுத்தப்படுகிறது	utilize
ก่อตั้ง	நிறுவப்பட்டது	founded
ก่อตั้งโดย	நிறுவியவர்	make by
ก่อนที่	முன்	before
ก่อนที่จะตกเป็นของฝรั่งเศสในเวลาต่อมา	பின்னர் பிரான்ஸ் ஆவதற்கு முன்	belonging to france, under the control of france
ก่อนหน้านั้น	அதற்கு முன்	before
ก้อย	பிங்கி	koi
ก้าน	தண்டு	thorn
ก้านกล้วย	வாழை தண்டு	kankluai
ก๊าซธรรมชาติ	இயற்கை எரிவாயு	natural gas
ก๎ล	பரிசு	magic
ขขขขขขขขขข	ப ப ப ப ப ப	repeated letter from thai alphabet
ขณะทรงพระเยาว์	அவர் இளமையாக இருந்தபோது	having to do with the young prince or princess
ขณะที่	போது	while
ขนม	மிட்டாய்	dessert
ขนมกล้วย	வாழை	banana dessert
ขนมครก	knmcrk	kind of thai sweetmeat
ขนมปัง	ரொட்டி	bread
ขนมปังขิง	கிங்கர்பிரெட்	gingerbread
ขนมเปียกปูน	ரோம்பஸ்	a type of thai dessert with flour and sugar
ขนมไทย	தாய் இனிப்பு	thai dessert
ขนสัตว์	கம்பளி	fur, animal hair
ขนอม	கானோம்	kanom - location in thailand
ขนาดหน้าตัก	மடியில் அளவு	length between both knees of buddha statue in posture of meditation
ขนาดใหญ่	பெரிய அளவு	l
ขบวนการอ๊บอ๊บป่วนโลก	பூமியின் இயக்கம்	original name is keroro gunso
ขบวนรถสินค้า	தொடர்வண்டி	caravan of trucks
ขม	கசப்பான	bitter taste
ขรรค์ชัย	கான் சாய்	kanchai - a male's name
ขลุ่ยหลิบ	புல்லாங்குழல்	khlui lib
ขวด	பாட்டில்	bottle
ขวัญ	மன உறுதியும்	morale
ขวัญใจช่างภาพ	அன்பான புகைப்படக்காரர்	miss photogenic
ขสมก	நிறை	an acronym consists of four thai letters
ของ	of	of
ของทุกปี	ஒவ்வொரு வருடமும்	every year
ของประเทศจีน	சீனாவின்	owned by china
ของมหาวิทยาลัย	பல்கலைக்கழகத்தின்	of university
ของมัน	அதன்	their
ของร่างกาย	உடலின்	of the body
ของสมเด็จฮุน	சோம்தேஜ் ஹுன்	houssaine of cambodia
ของสิ่งมีชีวิต	உயிரினங்களின்	living things
ของสุนทรภู่	சுந்தோர்ன் ஃபூவின்	belong to soon thong pu (a thai legend)
ของเหลว	திரவ	liquid
ของโลก	உலகின்	of world
ขอนแก่น	கோன் கான்	khon kan - an area in thailand
ขอบคุณที่รักกัน	என்னை நேசித்ததற்கு நன்றி	thank you for loving each other
ขอเช็ดน้ำตา	கண்ணீரைத் துடைப்போம்	wipe the tears
ขอให้เด็กสมัยปฏิวัติของข้าพเจ้า	எனது புரட்சிகர குழந்தைகள்	i hope that the children in my lifetime will ____________
ขั้นที่	படி	level
ขา	கால்	leg
ขาย	விற்க	sell
ขิง	இஞ்சி	ginger
ขิม	dulcimer	kim - a thai musical instrument
ขีดเส้นใต้	அடிக்கோடிட்டு	underline
ขี้ผึ้ง	மெழுகு	wax
ขึ้นเป็น	அது வரை	to
ขึ้นไป	மேலே	next one up
ขุขันธิน	கான் டின்	kukuntin
ขุนหาญ	ஹான்	koonhan - a location in thailand
ข้อมูลทั่วไป	பொதுவான செய்தி	general information
ข้อมูลประเทศเดนมาร์ก	டென்மார்க் தகவல்	information on denmark
ข้อมูลปรากฏการณ์โลกร้อน	புவி வெப்பமடைதல் நிகழ்வு	global climate change
ข้อมูลปี	ஆண்டு தரவு	information from the year ________
ข้อมูลอื่นๆ	பிற தகவல்	other information
ข้อมูลโดย	வழங்கியவர்	information from
ข้อวิพากษ์วิจารณ์	திறனாய்வு	critique reports
ข้ามฉาก	காட்சி முழுவதும்	sin(a)
ข้าวสาลี	கோதுமை	wheat
ข้าวหลาม	காவ் லாம்	bamboo rice
ข้าวเกรียบปากหม้อ	அரிசி பட்டாசுகள்	a thai snack
ข้าวเจ้า	நெல்	white rice
ข้าวโพด	சோளம்	corn
ข้าหลวงกำกับราชการเมืองขุขันธ์คนที่	ஆளுநர், குகான் நகர ஆளுநர்	government worker for ku khan city
ฃ	ฃ	a letter from thai alphabet
คงยิ่ง	அநேகமாக	kongying
คงเจริญ	அநேகமாக செழிக்கும்	khongcharoen
คณะครุศาสตร์	கல்வித்துறை	education department
คณะครุศาสตร์อุตสาหกรรม	தொழில்துறை கல்வி பீடம்	faculty of industrial education
คณะที่	இல் ஆசிரிய	the current administration
คณะบัญชี	கணக்கியல் பீடம்	accounting department (major)
คณะปฏิรูปการปกครองแผ่นดิน	புரட்சிகர குழு	national administrative reform council
คณะประมง	மீன்வள பீடம்	fishery division of the college of farming and agriculture
คณะพยาบาลศาสตร์	நர்சிங் பீடம்	nursing department
คณะมนุษย์ศาสตร์และสังคมศาสตร์	மனிதநேயம் மற்றும் சமூக அறிவியல் பீடம்	humanity department
คณะรัฐมนตรีคณะที่	மந்திரி சபை	council of ministers
คณะวิทยาการจัดการ	மேலாண்மை அறிவியல் பீடம்	management department
คณะวิศวกรรมศาสตร์	பொறியியல் ஆசிரியர்	engineering department
คณะศิลปกรรมศาสตร์	நுண்கலை பீடம்	faculty of fine arts
คณะสถาปัตยกรรมศาสตร์	கட்டிடக்கலை பீடம்	faculty of architecture
คณะสหเวชศาสตร์	கூட்டு சுகாதார அறிவியல் பீடம்	อังกฤษ   faculty of allied health science
คณะสาธารณสุขศาสตร์	பொது சுகாதார பீடம்	faculty of public health
คณะเกษตร	வேளாண்மை பீடம்	faculty of agriculture
คณะแพทยศาสตร์ศิริราชพยาบาล	மருத்துவ பீடம் சிரிராஜ் மருத்துவமனை	faculty of medicine siriraj hospital
คณะแพทยศาสตร์โรงพยาบาลรามาธิบดี	மருத்துவ பீடம், ராமதிபோடி மருத்துவமனை	the staff of ramatippadee hospital
คณารศ	கனரா	kanaros - a surname
คนที่	மக்கள்	person number __________________________
คนที่ไปช่วยรุ่นที่	தலைமுறைக்கு உதவியவர்கள்	volunteer group number __________
คนแคระ	குள்ள	dwarf
คนแรก	முதல் நபர்	first
คปค	ஆண்டு	3 thai letters
คม	கூர்மையான	sharp
ครอคโคไดล์	முதலை	crocodile
ครอบครัว	குடும்பம்	family
ครั้งหนึ่ง	ஒரு முறை	once upon a time
คราประยูร	பிரயுன்	karaprayoon - a thai surname
คราม	இண்டிகோ	indigo
คริส	கிறிஸ்	christ
คริสตี	கிறிஸ்டி	christie - a female name
คริสต์ศาสนา	கிறிஸ்தவம்	christainity
ครุฑ	கருடா	garuda
ครู	ஆசிரியர்	teacher
ครูพิเศษจอมป่วน	பூதம் ஆசிரியர்	kru pisat jom poun  - name of a story
คลอง	கால்வாய்	canal
คลองสาน	க்ளோங் சான்	klongsan
คลองเตย	க்ளோங் டோய்	klongtoei
คลับ	சங்கம்	club
คลาวิคอร์ด	வர்க்கம்	clavichord
คลิก	கிளிக் செய்க	click
คลินิก	சிகிச்சையகம்	clinic
คลิป	கிளிப்	clip
คลื่นสึนามิ	சுனாமி	tsunami wave
ควอน	க்வோன்	kwon - a surname of a korean singer
ควอร์เตอร์	காலாண்டு	quarter
ความกว้าง	அகலம்	width
ความงาม	அழகு	beauty
ความจำ	நினைவகம்	memory
ความต่างศักย์	சாத்தியமான வேறுபாடு	potential difference in physics
ความถี่	அதிர்வெண்	frequencies
ความนิยม	புகழ்	popular
ความบริสุทธิ์	தூய்மை	purity
ความฝันอันสูงสุด	இறுதி கனவு	the impossible dream
ความพอประมาณ	அடக்கம்	estimate
ความยากจน	வறுமை	poverty
ความยาว	நீளம்	length
ความยาวคลื่น	அலைநீளம்	frequencies
ความยาวช่วงคลื่น	அலை நீளம்	wave length
ความยาวเพลง	பாடல் நீளம்	the length of the song
ความรัก	காதல்	love
ความรู้	அறிவு	knowledge
ความสว่าง	பிரகாசம்	illumination
ความสัมพันธ์กับประเทศไทย	தாய்லாந்துடன் உறவுகள்	relationship with thailand
ความสัมพันธ์ระหว่างจีนกับอเมริกา	சீனாவுக்கும் அமெரிக்காவிற்கும் இடையிலான உறவுகள்	relationship with china and the usa
ความสูง	உயரம்	height
ความส่องสว่าง	பிரகாசம்	luminance
ความหนาแน่นของประชากร	மக்கள் அடர்த்தி	population density
ความหมาย	பொருள்	meaning
ความหมายโดยพยัญชนะ	மெய் பொருள்	definition that derived from translation from another language
ความเข้มของการส่องสว่าง	ஒளிரும் தீவிரம்	luminous intensity
ความเข้าใจ	புரிதல்	understanding
ความเร่ง	முடுக்கம்	acceleration
ความโกรธ	கோபம்	anger
ความโน้มถ่วง	ஈர்ப்பு	gravity
ควินโต	குயின்டோ	quinto
ควีนซี่	ராணி	quincy
คอ	கழுத்து	neck
คอนสตรัคชั่น	கட்டுமானம்	construction
คอนเวนชัน	மாநாடுகள்	convention
คอนเสิร์ตประสานเสียงสามสถาบัน	மூன்று நிறுவனங்கள் கொயர் கச்சேரி	chulalongkorn kasetsart thammasat choral concert
คอมพิวเตอร์ยุคที่	கணினி சகாப்தம்	_-generation computer (as in frist generation, second generation etc)
คอร์ด	நாண்	chord
คอลลิงวูด	காலிங்வுட்	collingwood
คอสตาริกา	கோஸ்ட்டா ரிக்கா	costa rica
คัง	காங்	kan
คัชชินสกี	குச்சின்ஸ்கி	kaczyński
คัญทัพ	முக்கியமான இராணுவம்	main army.
คัทลียา	கேட்லியா	kathaleeya (thai first name)
คันธวงศ์	காந்தவோங்	kunntavong - a surname
คัพ	கோப்பை	cup
คัมภีร์	வேதம்	bible
คั่ว	வறுக்கவும்	dry roasting
คาคาชิ	ககாஷி	cacashi
คางาริ	ககாரி	kagari
คาซัคสถาน	கஜகஸ்தான்	kazakhstan
คาถาอัญเชิญ	மந்திரம்	a magic spell
คาบ	காலம்	frequency
คาบัคโรเน่	கபக்ரூன்	kyabarrone
คาบูโตะ	கபுடோ	kabuto
คาปูชิโน่	கப்புசினோ	cappuccino
คามิว	கமுய்	camus
คาราคุระ	கரகுரா	karakura
คาร์ล	கார்ல்	karl
คาวทอง	ஃபிஷியோங்	lizard tail
คาเมนไรเดอร์	காமென் ரைடர்	kamen rider
คาโรลัส	கரோலாஸ்	carolus linnaeus
คำขวัญวันเด็ก	குழந்தைகள் தின முழக்கம்	quote for kids day
คำถามข้อที่	கேள்வி எண்	the question number_________
คำนวณ	கணக்கிடுங்கள்	calculate
คำนาม	பெயர்ச்சொல்	noun
คำพ้องรูป	ஒத்த	hemonym
คำมั่นสัญญา	வாக்குறுதி	agreement
คำม่วง	காம் முவாங்	kham muang
คำวิลัยศักดิ์	கம்விலைசக்	important words, magic words
คำศัพท์	சொல்லகராதி	word
คำสรรพนาม	உச்சரிப்பு	pronoun
คำสร้อย	சொல்	kumsoi - a country singer
คำสุดท้ายของวรรคที่	பத்தியின் கடைசி சொல்	the last word (in a poem)
คำสุภาพ	கண்ணியமான சொல்	formal
คำอธิบาย	விளக்கம்	explanation
คำเมือง	நகர சொல்	kum meuong - a location in chiang mai
คำแปล	மொழிபெயர்ப்பு	translation
คิง	ராஜா	king
คิงส์	கிங்ஸ்	kings
คิงส์คัพ	கிங்ஸ் கோப்பை	king's cup
คิงไลเนอร์	கிங்லைனர்	kingliner
คิชิเนีย	கிஷின்யா	kishinia
คิด	சிந்தியுங்கள்	thinking
คินนิคุแมน	கின்னிகுமான்	kinkiku man
คิมิฮิโระ	கிமிஹிரோ	kimihiro
คิระ	கிரா	kira - japanese name
คิเคียว	கிகியோ	kikyo
คีตกวี	இசையமைப்பாளர்	composer
คือประมาณ	பற்றி	estimated to be
คือเพลง	ஒரு பாடல்	is the song
คุณ	நீங்கள்	you
คุณครูจอมเวท	வித்தைக்காரர் ஆசிரியர்	magister
คุณปลื้ม	குன் ப்ளூம்	kunpleam
คุณหญิงโม	பேரரசி மோ	suranaree
คุณากร	நீங்கள்	khunakon
คุราปิก้า	குராபிகா	kurapika
คุโรซึจิ	குரோட்சுஜி	kurochiji - a japanese word
คุ้มค่า	நல்ல மதிப்பு	worth the money spent on
คูกิมิยะ	குகிமியா	kugimiya
คูคาคุ	குகாகு	kukaku (japanese last name)
คูเรียม	கியூரியம்	"chemical element ""curium"""
คูเวต	குவைத்	kuwait
คู่กรรม	கூட்டாளர்	soul mate
ค่าความต้านทานตัวที่	எதிர்ப்பு மதிப்பு என்று	resistance value of the
ค่าจีดีพี	மொத்த உள்நாட்டு உற்பத்தி	gdp - an economics term
ค่าใช้จ่าย	செலவு	expense
ค่ำแล้ว	அந்தி	getting dark, at dusk
ค้างคาว	மட்டை	bat
ฆ	ஜுவான்	a letter from thai alphabet
ฆ้อง	காங்	gong
ฆ้องวงใหญ่	பிக் காங்	a group of thai drum music
งดส่งเข้าประกวด	செல்லக்கூடாது	enroll in the contest
งาน	வேலை	work, job
งานอดิเรก	பொழுதுபோக்குகள்	hobby
งานเขียน	எழுத்துக்கள்	writing, composition work
งานเทางามสัมพันธ์	தாவோ நகம் உறவு	public party
งานโมเสก	மொசைக்	mosaic
งามวงศ์วาน	ngamwongwan	ngamwongwan
งู	பாம்பு	snake
งูอนาคอนดา	அனகோண்டா	anaconda snake
จดหมายอากาศ	விமான அஞ்சல்	aerogram
จตรัง	ட்ராங்	trang province (name of province in thailand)
จตุรงค์	சதுசக்	jaturong - a surname of a comedian
จนกระทั่ง	வரை	until
จนกระทั่งปี	ஆண்டு வரை	until the year
จนกระทั่งเมื่อปี	கடந்த ஆண்டு வரை	until the year
จนครปฐม	நக்கோன் பாத்தோம்	nakorn pratom state
จนมีคำกล่าวว่า	என்று சொல்லப்படும் வரை	said
จน่าน	திங்கள்	nan state
จบุรีรัมย์	புரிராம்	burerum state
จมูก	மூக்கு	nose
จระเข้และแอลลิเกเตอร์	முதலை மற்றும் முதலை	crocodile and alligator
จรัญญา	சரண்யா	jarunya - a surname
จริยธรรม	நெறிமுறைகள்	ethics
จริยศาสตร์	நெறிமுறைகள்	ethics
จริยา	பெண்	jariya
จลำพูน	லம்பூன்	jalumpoon - a place in thailand
จสตูล	சாதுன்	stoul state
จสุราษฎร์ธานี	சூரத் தானி	surat thani province
จอมบึง	வீக்கம்	chom bueng
จอมพลถนอม	சோம் ஃபோன் தானோம்	field marshal thanom
จอมพลสฤษดิ์	பீல்ட் மார்ஷல் சரித்	field marshal sarit
จอมพลเรือ	கப்பல் மார்ஷல்	the general of the navy
จอมเทียน	ஜோம்டியன்	jom tien - a location in thailand
จอร์เจีย	ஜார்ஜியா	georgia
จะต้องหาตัวแทนลงจากเวที	மேடையில் இருந்து இறங்க ஒரு பிரதிநிதியைக் கண்டுபிடிக்க வேண்டும்	find a teammate to leave the stage, a unique game
จะเขียนว่า	சொல்வார்	written as
จะเข้	சித்தர்	jakhe
จะได้	கிடைக்கும்	results in
จักจั่น	cicada	chakkachan
จักรพรรดิเนอร์วา	பேரரசர் நிர்வாணம்	emperor nerva
จักรพรรดิไททัส	டைட்டஸ் பேரரசர்	titus (flavius vespa)
จักรพันธุ์	சக்பன்	chakrabhand
จักรวาลวิทยา	அண்டவியல்	cosmology
จังหวัด	மாகாணம்	province
จังหวัดกระบี่	கிராபி மாகாணம்	krabee state
จังหวัดกาญจนบุรี	காஞ்சனபுரி	kanchanaburi province
จังหวัดกาฬสินธุ์	கலாசின்	kalasin province
จังหวัดขอนแก่น	கோன் கான் மாகாணம்	khon kaen province
จังหวัดคยองกี	கியோங்கி மாகாணம்	the state of kyong gee
จังหวัดคยองซาง	கியோங்சாங் மாகாணம்	kyongchang province
จังหวัดฉะเชิงเทรา	சச்சோங்சாவ்	chachoengsao province
จังหวัดชุมพร	சம்பன்	chumphon province
จังหวัดตราด	டிராட் மாகாணம்	trat province
จังหวัดตาก	தக் மாகாணம்	tak province
จังหวัดนครปฐม	நக்கோன் பாத்தோம் மாகாணம்	nakhon pathom province
จังหวัดนครพนม	நக்கோன் பானோம் மாகாணம்	nakorn panom state
จังหวัดนครสวรรค์	நக்கோன் சவான் மாகாணம்	nakorn sawan province in thailand
จังหวัดน่าน	நான் மாகாணம்	nan state in the north east of thailand
จังหวัดปัตตานี	பட்டானி மாகாணம்	pattani state
จังหวัดพระนครศรีอยุธยา	ஃபிரா நக்கோன் சி அயுதயா	nakon sri ahyutthaya province
จังหวัดพังงา	பாங் நாகா மாகாணம்	phang nga province
จังหวัดพิษณุโลก	பிட்சானுலோக் மாகாணம்	pisanulok state
จังหวัดมหาสารคาม	மகா சரகம் மாகாணம்	maha sarakham province
จังหวัดยโสธร	யசோதன்	yasothorn province (name of thai province)
จังหวัดระยอง	ராயோங்	rayong province
จังหวัดราชบุรี	ராட்சபுரி	ratchaburi province
จังหวัดลำพูน	லம்பூன்	lamphun province
จังหวัดสงขลา	சாங்ஹ்லா	songkla province
จังหวัดสมุทรสงคราม	சமுத் சாங்க்கிராம் மாகாணம்	samut songkhram province
จังหวัดสิงห์บุรี	புரி மாகாணம் பாடுங்கள்	sing buri province
จังหวัดหนองบัวลำภู	நோங் புவா லம்பூ மாகாணம்	nong bua lamphu province
จังหวัดอุดรธานี	உடோன் தானி மாகாணம்	udon thani state
จังหวัดเชลลา	ஷெல்லா	chella city
จังหวัดเชียงราย	சியாங் ராய்	chianrai province
จังหวัดเชียงใหม่	சியாங் மாய் மாகாணம்	chiang mai province
จังหวัดเพชรบุรี	பெட்சபுரி மாகாணம்	petcharaburi state
จังหวัดเพชรบูรณ์	பெட்சபூன்	petchabun province
จังหวัดเลย	லோய் மாகாணம்	loei (name of thai province)
จังหวัดแพร่	ஃப்ரே	prae state
จังหาร	ஜுங்கான்	changhan
จัดขึ้นเมื่อ	அன்று நடைபெற்ற	occur on the date of _______________
จัดตั้งขึ้นโดย	நிறுவியது	produced by
จัดอยู่ในภูมิภาค	பிராந்தியத்தில் ஏற்பாடு செய்யப்பட்டது	in region
จัดเมื่อวันที่	அன்று நடைபெற்ற	็held on the date of ...
จัดโดย	ஏற்பாடு	arrange by
จัน	சான்	chan
จันทบุรี	சாந்தபுரி	juntaburi state
จันทร	நிலா	chantorn
จันทรุปราคา	சந்திர கிரகணம்	lunar eclipse
จันทร์	திங்கட்கிழமை	chan
จันทร์ภักดี	சான் பக்தி	juntapukdee - surname of a famous actor
จันทร์เกษ	சான் கேட்	juntagaset - a surname
จาก	இருந்து	from
จากการพิสูจน์อายุโดยคาร์บอน	கார்பன் மூலம் வயது நிரூபிக்கப்பட்டதிலிருந்து	from the forensic carbon dating
จากภาษากรีก	கிரேக்கத்திலிருந்து	greek language
จากละคร	நாடகத்திலிருந்து	from drama
จากละครเรื่อง	நாடகத்திலிருந்து	from the soap opera
จากสารานุกรมบริทานิกา	என்சைக்ளோபீடியா பிரிட்டானிக்காவிலிருந்து	from printed information
จากอัลบั้ม	ஆல்பத்திலிருந்து	from the album
จากเรื่อง	கதையிலிருந்து	from the story of ...
จากเว็บ	வலையிலிருந்து	from the web
จากเว็บไซต์กระทรวงการต่างประเทศ	வெளியுறவு அமைச்சின் வலைத்தளத்திலிருந்து	from the website of foreign department
จากเว็บไซต์กระทรวงต่างประเทศ	வெளியுறவு அமைச்சின் வலைத்தளத்திலிருந்து	from the foreign government affairs website
จากโซล	சியோலில் இருந்து	from soeul
จาติกวณิช	சட்டிகவானிஜ்	chatikavanij
จามจุรี	சம்சூரி	jamjuri flower
จารีตประเพณี	பாரம்பரியம்	tradition from the culture
จารุเสถียร	ஜரு சத்தியன்	charusathien
จาวตาลเชื่อม	ஜாவோ டான் வெல்ட்	sweetened palm - a type of thai dessert
จำกัด	லிமிடெட்.	limited
จำกัดมหาชน	வரையறுக்கப்பட்டவை	public limited
จำนวน	எண்	amount
จำนวนประชากร	மக்கள் தொகை	population
จำปาเทศ	சம்பா	a specific type of magnolia tree; similar michelia champaca
จำเริญ	செழிப்பு	jamroen
จิกะไบต์	ஜிக்டெஸ்	gigabyte
จิตรกร	ஓவியர்	painter
จิตรกรรม	ஓவியம்	arts and craft or music
จิตวิทยา	உளவியல்	psychology
จิตใจ	மனம்	heart; feelings
จินตหรา	ஜிந்தாரா	jinnara - a female's name who is a singer
จิบูตี	ஜிபூட்டி	ji bu dee event on june 27
จิบเบอเรลลิน	கிபெரெலின்	gibberellin
จิม	ஜிம்	jim
จิโอวานนี	ஜியோவானி	giovanni
จี	ஜி	g
จีนตัวย่อ	எளிமைப்படுத்தப்பட்ட சீன	simplified chinese characters
จียอน	ஜியான்	๋jiyeon (korean name)
จึงทรงพระกรุณาโปรดเกล้า	எனவே தயவுசெய்து உத்தரவிட்டார்	be kind enough to
จึงเปิดโอกาสให้	எனவே வாய்ப்பு கொடுத்தார்	open up opportunities
จึงใช้ธาตุหมอกและเมฆาได้	எனவே மூடுபனி மற்றும் மேகத்தின் உறுப்பைப் பயன்படுத்தலாம்	using magic with cloud and spells
จุกนมสีขุ่น	ஒளிபுகா டீட்	corrupted pacifier
จุดกึ่งกลาง	நடுப்பகுதி	midpoint
จุดจอมฟ้า	நீல புள்ளி	zenith
จุลจอมเกล้าเจ้าอยู่หัว	மன்னர் ராமா வி	phra chunla chom klao chao yu hua
จุฬาลงกรณินทรวรางกูร	சுலலாங்கொர்ன் நிந்தரங்கங்கங்குன்	new title for the princess
จูล	ஜூல்	joule
จูเซปเป	கியூசெப்	giuseppe
จูเนียร์	ஜூனியர்	junior
จเชียงใหม่	சியங் மாய்	chiang mai province
จเพชรบุรี	பெட்சபுரி	pedchaburee province
จเพชรบูรณ์	பெட்சபூன்	province pechaboon
จ๊กมก	ஜும்கும்	jokmok - a surname of a comedian
ฉ	எஃப்	ninth thai alphabet
ฉบับชั่วคราว	தற்காலிக பதிப்பு	special (temporary) edition
ฉบับวณิพก	எண்கள்	begger version
ฉลอง	கொண்டாடு	celebrate
ฉลองพระชนมายุ	80 வது ஆண்டைக் கொண்டாடுங்கள்	celebrated birth anniversary of
ฉันรักคุณ	நான் உன்னை நேசிக்கிறேன்	i love you
ฉาบ	பூச்சு	cymbal
ฉายเมื่อ	காட்டப்பட்டது	aired
ฉิ่ง	சிலம்பல்	small cup-shaped cymbals
ฉี่	சிறுநீர் கழித்தல்	qi
ชนะ	வெற்றி	winning
ชนิด	வகை	kind
ชนิดของเมฆ	மேகக்கணி வகை	types of clound
ชม	வாட்ச்	chom
ชมชื่น	பாராட்டு	chomchuen
ชมพู	இளஞ்சிவப்பு	rose apple
ชมพูทวีป	இந்தியா	south asia
ชมพู่	ரோஜா ஆப்பிள்	syzygium
ชล	ஏரிகள்	chol (first name)
ชลธารวิทยา	சலோம் விட்டாயா	limnology
ชลบุรี	சோன் பூரி	cholburi state
ชลิต	சாலிட்	chalit - a male's name
ชวนชื่น	அழைக்கிறது	choun cheen - a surname
ชอบ	போன்ற	chop
ชะนี	கிப்பன்	gibbon
ชะมด	கஸ்தூரி	anteater
ชะอวด	காட்டு	chaoud - location in thailand
ชะอำ	சா-ஆம்	cha-am (name of thai district)
ชัชพล	சாட்சபோன்	chatchapol - a male's name
ชัย	வெற்றி	chai
ชัยชนะ	வெற்றி	chaichana
ชัยนาม	சாய் நம்	chainam
ชัยบัญชา	சாய் பஞ்சா	chaibancha
ชัยมงคล	சைமோன்கோல்	chaimongkol - a male's name
ชัยยุทธ	சாயுத்	chaiyuth (first name)
ชั้น	வர்க்கம்	class
ชั้นที่	தரை	order
ชั้นประทวน	தரை	non-commissioned officer
ชั้นมหาวชิรมงกุฎ	கிரீடம் மகா வச்சிரா வகுப்பு	order of the king's jewels
ชั้นยศ	தரவரிசை	millitary rank
ชั้นสูงสุด	மிக உயர்ந்த நிலை	special class
ชา	தேநீர்	tea
ชากะ	ஷாகா	shaka
ชาคริต	எச்சரிக்கை	charkrit
ชาญชัย	சஞ்சாய்	chanchai - a thai name
ชาตะ	பிறக்க வேண்டும்	born
ชาติ	தேசம்	nation
ชาย	ஆண்	male
ชาร์ป	கூர்மையானது	sharp
ชาร์ล	சார்லஸ்	charles
ชาร์ลส	சார்லஸ்	charles
ชาลส์	சார்லஸ்	charles
ชาลี	சார்லி	charlie
ชาวนา	உழவர்	farmer
ชาวไทย	தாய் மக்கள்	thai
ชาวไทยภูเขา	மலை கோத்திரம்	thai hill tribe
ชำนิ	நிபுணர்	chumni - a location in thailand
ชิคิกามิ	ஷிகிகாமி	shikigami
ชิงร้อย	போட்டியிடுங்கள்	ching roi
ชิงร้อยล้าน	நூறு மில்லியனுக்கு போட்டியிடுங்கள்	ching roi lan
ชิซุกะ	ஷிசுகா	shizuka
ชิดจันทร์	சிச்சன்	chidjun (a person's last name)
ชิน	பழக்கமாகிவிட்டது	get used to
ชินวัตร	ஷினாவத்ரா	shinawatra
ชิริว	சிரியு	cherew - a japanese character
ชิลี	சிலி	chilli
ชิโนะ	சினோ	shino
ชีพด็อก	செம்மறி	chief dog
ชีวนิชพันธ์	உயிரியல்	chiwanitphan
ชีวประวัติ	சுயசரிதை	biography
ชีวมวล	பயோமாஸ்	alternative (natural) power
ชีวสถิติ	பயோஸ்டாடிஸ்டிக்ஸ்	biometry, biostatistics
ชื่อดัง	பிரபலமானது	famous
ชื่อนามสกุล	முதல் பெயர் குடும்ப பெயர்	name-lastname
ชื่อภาษาญี่ปุ่น	ஜப்பானிய பெயர்	japanese name
ชื่อภาษาอังกฤษ	ஆங்கில பெயர்	english name
ชื่อยศภาษาไทย	தாய் தலைப்பு	thai title
ชื่ออัลบั้ม	ஆல்பத்தின் பெயர்	album name
ชื่ออื่น	மற்ற பெயர்கள்	synonym
ชื่อเก่าในวงการ	தொழிலில் பழைய பெயர்	old stage name
ชื่อเดิม	முன்னாள் பெயர்	old name
ชื่อเมือง	நகரத்தின் பெயர்	city's name
ชื่อเรื่อง	தலைப்பு	the name of the story
ชื่อเล่น	புனைப்பெயர்	nickname
ชุดแพนเค้ก	பான்கேக் செட்	pancake
ชุติมา	சுட்டிமா	chutima
ชุมชนออนไลน์ชาวจังหวัดสกลนคร	சகோன் நாகோன் ஆன்லைன் சமூகம்	sakon nakhon people online community
ชุมพลบุรี	சம்பன் பூரி	chompolburi area
ชุมแพ	சும் பே	choompa - location in thailand
ชุมแสง	சும் சாங்	choomsang - a male's name
ชูมันน์	சூமான்	schumann
ชูศักดิ์	சுசக்	chusak
ชโย	பிராவோ	cheer; hurray
ชไนเดอร์	ஷ்னீடர்	schneider
ช็อกโกแลต	சாக்லேட்	chocolate
ช่วงปี	ஆண்டு	between year
ช่อง	சேனல்	channel
ช่องเชิงเทิน	போர்கள்	machicolation
ช้อน	ஸ்பூன்	spoon
ซ	சி	the eleventh letter of the thai alphabets
ซน	குறும்பு	crashing into
ซบที่อกฉัน	என் மார்பில் நெஸ்லே	cry in my arms
ซอมบี้	ஜோம்பிஸ்	zombie
ซออู้	ஸோ ஓ	a woodwind thai instrument
ซันไชน์	சன்ஷைன்	sunshine
ซัลฟานิลาไมด์	சல்பானிலமைடு	salfanilamide
ซัลฟาไดอะซีน	சல்பாடியாசின்	sulfadiazine
ซัลเฟต	சல்பேட்	sulphate
ซากดึกดำบรรพ์	தொல்பொருள்	fossil
ซาคุโร่	சகுரோ	zakuro - a japanese character
ซาซางาวะ	சசகவா	sasangngawa - a japanese name
ซานกัลโล	சான் கல்லோ	sangallo family
ซาบุซะ	சபுசா	zabuza
ซาลาดิน	சலாடின்	saladin
ซาอิ	சாயி	chai - a japanese name
ซาโลมอน	சாலமன்	salomon
ซิกนัส	சிக்னஸ்	signus
ซิงเกอร์	பாடகர்	sinder
ซิงเกิ้ล	ஒற்றையர்	single
ซิทคอม	சிட்காம்	sitcom
ซินเดอเรลล่า	சிண்ட்ரெல்லா	cinderella
ซิมไฟลา	சிம்பிலா	class symphyl
ซิโนไทย	சீன தாய்	sino-thai
ซี	சி	see
ซีซี	சி.சி.	cc
ซีรีเบลลัม	செராபெல்லம்	cerebellum
ซีลีเนียม	செலினியம்	selenium (chemical element)
ซีสต์	நீர்க்கட்டிகள்	cyst
ซีเกมส์	sea விளையாட்டு	southeast asian game
ซีเจ	சி.ஜே.	cj
ซีเซียม	சீசியம்	cesium
ซีเนม่า	சினிமா	cinema
ซีแคนต์	செகண்ட்	secant
ซีโร่	பூஜ்யம்	zero
ซึง	எந்த	feeling touched (by the music or movie)
ซึม	சீப்	absorb
ซึ่ง	எந்த	because
ซึ่งประกอบด้วย	கொண்ட	consists of
ซึ่งมี	இது உள்ளது	with
ซึ่งมีความหมายว่า	இதன் பொருள்	meaning
ซึ่งมีทั้งหมด	இது அனைத்தையும் கொண்டுள்ளது	in total of
ซึ่งรู้จักกันว่า	இது அறியப்படுகிறது	called
ซึ่งเกิดจากปัจจัยภายนอก	வெளிப்புற காரணிகளால் ஏற்படுகிறது	which is caused by external factors
ซึ่งเรียกว่า	எது என்று அழைக்கப்படுகிறது	called
ซึ่งแท้จริงแล้ว	உண்மையில்	real name
ซึ่งได้แก่	அவை	such as
ซุง	பதிவு	sung
ซุน	சூரியன்	son
ซุปเปอร์มาร์เก็ต	பல்பொருள் அங்காடி	supermarket
ซุปเปอร์เซ็นเตอร์	சூப்பர் சென்டர்	super center
ซู	சூ	holding up high
ซูจี	சுசி	fuji
ซูซูกิ	சுசுகி	suzuki brand
ซูรินาเม	சுரினேம்	suriname
ซูเปอร์เซ็นเตอร์	சூப்பர் சென்டர்	super center
ซ่อมแซม	பழுது	repair
ซ่าหริ่ม	மகிழ்ச்சியாக இரு	a type of thai dessert
ซ้าย	இடது	left
ฌอง	ஜீன்	jean - french name
ญ	தி	a thai alphabet with a y sound
ฐานข้อมูล	தரவுத்தளம்	database
ฐานทัพ	கன்டோன்மென்ட்	armforce
ณภัทร	நாபாட்	napat
ณรงค์	பிரச்சாரம்	narong - a male's name
ณัฏฐธิดา	நத்திதா	nattathida - a thai female actress
ณัฐวุฒิ	நட்டாவூட்	nattawut
ด	எம்	a letter from thai alphabet
ดง	த்ரஷ்	area, location
ดม	வாசனை	smell
ดรทรงศักดิ์	டாக்டர் சாங்சாக்	doctor songsuk - a famous person
ดรนิพนธ์	டாக்டர் நிபோன்	doctor nipon
ดรสาโรช	டாக்டர் சரோஜ்	dr. sarot
ดรสุชาติ	டாக்டர் சுச்சார்ட்	dr. suchart
ดราก้อน	டிராகன்	dragon
ดราก้อนเควสต์	டிராகன் குவெஸ்ட்	dragon quest
ดวงพร	அதிர்ஷ்டம்	dwongpol
ดวงอาทิตย์	சூரியன்	sun
ดอก	பூ	flower
ดอกอ้อ	நாணல் மலர்	dok aou
ดอกไม้	பூ	flower
ดอกไม้ประจำจังหวัด	மாகாண மலர்	state's flower
ดอตคอม	டாட் காம்	dotcom
ดอนเมือง	டான் மியூங்	don mueang
ดอยอินทนนท์	டோய் இன்டனான்	doi inthanon
ดอร์	கதவு	door
ดอลลาร์สหรัฐ	அமெரிக்க டாலர்	united states dollar
ดอว์ขิ่นจี	டாவின் ஜி	dorkingi
ดังนั้น	அதனால்	for that reason
ดังเช่น	பிடிக்கும்	such as
ดัชนีการพัฒนามนุษย์	மனித மேம்பாட்டு குறியீடு	human development index
ดัตช์	டச்சு	dutch
ดันแฮม	டன்ஹாம்	dunham, the mother of barrack obama
ดับเบิลยู	டபிள்யூ.	letter w
ดา	டா	da - a thai nickname
ดาบ	வாள்	sward
ดาบเขี้ยวฟ้าฟื้น	பழிவாங்கும் வாள்	sky fang sword of revival
ดารา	நட்சத்திரம்	star
ดารากร	நடிகர்	darakon
ดาราคู่แรกของไทย	தாய்லாந்தில் முதல் நட்சத்திரம்	first movie stars in thailand
ดาราจักร	கேலக்ஸி	planet in the solar system
ดาราศาสตร์รังสีเอ็กซ์	எக்ஸ்ரே வானியல்	xray astronomy
ดาราหญิงไทยยอดนิยม	பிரபலமான தாய் பெண் பிரபலங்கள்	famous actress
ดาวกระจาย	ஸ்டார்பர்ஸ்ட்	star disperse
ดาวคาโนปุส	கனபாஸ்	canopus star
ดาวพฤหัสบดี	வியாழன்	jupiter
ดาวพุธ	புதன்	mercury
ดาวยูเรนัส	யுரேனஸ்	uranus
ดาวศุกร์	வெள்ளி	venus
ดาวอาร์คตุรุส	ஆர்க்டரஸ்	arcturus
ดาวเคราะห์	கிரகம்	planet
ดาวเคราะห์แคระ	குள்ள கிரகம்	dwarf planet
ดาวเสาร์	சனி	saturn
ดำรงค์	விமாக்ஸ்	dumrong - a male's name
ดำรงตำแหน่ง	ஒரு பதவியை வகிக்கவும்	hold the title of
ดำรงอ่องตระกูล	டாம்ராங் ஓங் குலம்	dumrongongtrakul
ดำเนินสะดวก	டாம்னோன் சாதுக்	damnoen saduak
ดิกชันนารี	அகராதி	dictionary
ดิค	டிக்	dick - the name
ดิจิตอล	டிஜிட்டல்	digital
ดิน	மண்	soil
ดินเซนฮอฟเฟอร์	ஜென் ஹோஃபர்	dientzenhofer - as in christoph or leonhard or johannes
ดินแดน	மண்டலம்	territory
ดิว	பனி	dew - a nickname
ดิวิชั่น	பிரிவு	division
ดิศ	வட்டு	dis (thai first name)
ดิศกุล	டிஸ்குல்	disakul (last name)
ดิสนีย์	டிஸ்னி	disney
ดิสโพรเซียม	டிஸ்ப்ரோசியம்	dysprosium
ดี	நல்ல	d.
ดีคอนสตรักทิวิสม์	டோகன்ராக் டேவிஸ்ட்	deconstructivism
ดีน	டீன்	religion (islamic term)
ดีบุก	தகரம்	tin
ดีเวลลอปเมนท์	வளர்ச்சி	development
ดีเวลลอปเม้นท์	வளர்ச்சி	development
ดีเอ็นเอ	டி.என்.ஏ	dna
ดุสิต	துசிட்	dusit
ดูที่	அதை நோக்கு	see
ดูเพิ่มเติม	மேலும் பார்க்க	see also
ดูเพิ่มเติมที่	மேலும் காண்க	see more detail in
ดูเร็กซ์	டூரெக்ஸ்	durex
ดูแล	பராமரிப்பு	take care
ด็อก	நாய்	dog
ด้วย	உடன்	too, also, together, with
ด้วยเหตุนี้	இந்த காரணத்திற்காக	for this reason
ด้านการกีฬา	விளையாட்டு	sports
ด้านการต่างประเทศ	வெளிநாட்டு விவகாரங்கள்	foreign affairs
ด้านการเกษตร	வேளாண்மை	agriculture
ด้านดนตรี	இசை	in music
ด้านหน้า	முன்	front
ด้านหลัง	பின்புறம்	backside
ด้านอ่าวไทย	வளைகுடா பக்கம்	gulf of thailand side
ต	ஓ	a letter from thai alphabet with th sound
ตกรอบที่	நீக்கப்பட்டது	did not make the cut
ตรงกับวันขึ้น	இணை செய்	on the date of
ตรงกับวันที่	போட்டி தேதி	on the date of _______________
ตระกูล	குலம்	family
ตระกูลนารา	நாரா குடும்பம்	nara lineage
ตระกูลปาร์ค	குல பூங்கா	park family (korean last name)
ตระกูลยามานากะ	யமனக்க குடும்பம்	yamanaka clan
ตระกูลอินุซึกะ	இனுசுகா குடும்பம்	inu-tsuka family
ตระกูลเซนจู	செஞ்சு குடும்பம்	chen ju dynasty
ตรัง	ட்ராங்	trung province
ตรางู	பாம்பு	snake brand
ตราด	டிராட்	trad state
ตรานี้	இந்த முத்திரை	this seal
ตราสัญลักษณ์	சின்னம்	symbol
ตรึงใจ	கவர்ச்சியானது	truengjai
ตรุษจีน	சீன புத்தாண்டு	chinese festival
ตลาด	சந்தை	market
ตลาดโลตัส	தாமரை சந்தை	lotus market
ตอน	எப்பொழுது	edition number
ตะกร้อ	முகவாய்	takraw
ตะกั่ว	வழி நடத்து	copper
ตะละภัฏ	தலபத்	talaput - a surname
ตะลุยอวกาศ	ஸ்பேஸ் டேபிள்	space trek
ตะวันทอแสง	சூரிய உதயம்	tawanthosaeng
ตะวันออก	கிழக்கு	east
ตะวันออกเฉียงเหนือ	வடகிழக்கு	east
ตันติเวชกุล	தந்திவேஜ்குல்	tuntivetchakul - a surname
ตัว	உடல்	body
ตัวพระ	கதாநாயகன்	main character
ตัวยักษ์	இராட்சத	giant
ตัวละคร	பாத்திரம்	character
ตัวละครจากเรื่อง	கதையிலிருந்து வரும் கதாபாத்திரங்கள்	soap opera based on a written story
ตัวลิง	குரங்கு	monkey
ตัวสะกด	எழுத்துப்பிழை	final consonant
ตัวหาร	வகுப்பி	divisor
ตัวอย่าง	உதாரணமாக	example
ตัวอย่างคำบาลี	பாலி உதாரணம்	bali example words
ตัวอย่างคำประพันธ์	மாதிரி வசனம்	sample writing
ตัวอย่างต้นแบบแรก	முதல் முன்மாதிரி உதாரணம்	holotype
ตัวอย่างภาพยนตร์	திரைப்பட டிரெய்லர்	movie trailer
ตัวอย่างเช่น	உதாரணத்திற்கு	for example
ตัวเลขอย่างเป็นทางการ	அதிகாரப்பூர்வ எண்கள்	formally number
ตัวแปร	மாறி	variable
ตั้งงี่สุ่น	டாங் என்ஜியன்	tang ngee soon
ตั้งอยู่ที่	இல் அமைந்துள்ளது	located
ตั้งอยู่เลขที่	இல் அமைந்துள்ளது	at house number
ตั๊กแตน	வெட்டுக்கிளி	grasshopper
ตา	கண்	ta (a person's name)
ตาคลี	தக்லி	ta-klee
ตามตัวสวมเครื่องประดับต่าง	அவர் வெவ்வேறு ஆபரணங்களை அணிந்திருந்தார்	accessories
ตามตำราพรหมชาติฉบับหลวง	பிரம்மாவின் அரச பாடப்புத்தகத்தின்படி	by royal botanic manual/handbook
ตาระวา	தாராவா	square yard
ตาราง	மேசை	table
ตำนานวายุสลาตัน	புயலின் புராணக்கதை	shippuden
ตำนานแฝงคำสอน	பழம்பெரும் போதனைகள்	tales
ตำบลกระเทียม	பூண்டு துணைப்பிரிவு	garlic district
ตำบลกังแอน	கேங் ஆன் மாவட்டம்	ung gan district
ตำบลตาเมียง	தா மியுங் மாவட்டம்	tambon tameung
ตำบลนางแล	நாங்லே துணைப்பிரிவு	nang lae province
ตำบลนาดี	நாடி துணைப்பிரிவு	na dee district
ตำบลบ้านกง	பான் காங் துணைப்பிரிவு	tambon bankong (name of the district)
ตำบลยะวึก	யுவக் மாவட்டம்	tambon yawuek
ตำบลระแงง	ரஹாங் மாவட்டம்	ra-ngang district
ตำบลสังขะ	சங்கா	thambol sangka
ตำบลเมืองบัว	புவா துணைப்பிரிவு	muangbua district
ตำบลโพนครก	ஃபோன் நகோன் மாவட்டம்	tambon poncrok
ตำบลไพรขลา	ஃபிராய் காலா துணைப்பிரிவு	phrai khla subdistrict
ติณสูลานนท์	டின்சுலனான்	thinasulanon
ติอามัต	தியாமத்	tiarmut
ตี๋ใหญ่	பெரிய டீ	ti yai
ตึก	கட்டிடம்	building
ตุรกี	துருக்கி	turkey
ตุลาคม	அக்டோபர்	october
ตุ๊กแก	கெக்கோ	gecko
ตูน	கார்ட்டூன்	toon
ต่อกันด้วยพันธะ	பிணைப்புகளுடன் தொடரவும்	linked by bond
ต่อจาก	இருந்து தொடரவும்	resulting from
ต่อมา	பின்னர்	later
ต่อมาวันที่	அடுத்த தேதி	later on the date
ต่อมาในปี	ஆண்டின் பிற்பகுதியில்	later in the year
ต่อมาในรัชกาลที่	பின்னர் ஆட்சியில்	afterwards, in the reign of
ต่อมาในสมัยกรุงธนบุรีและกรุงรัตนโกสินทร์เขมรตกอยู่ภายใต้การควบคุมของจักรวรรดิสยามอย่างเข้มงวด	பின்னர், தோன்பூரி மற்றும் ரட்டனகோசின் காலங்களில், கெமர் சியாமிய பேரரசின் கடுமையான கட்டுப்பாட்டில் இருந்தது.	later in thonburi period and rattanakosin period
ต่าง	வெவ்வேறு	different, various
ต่างๆ	பல்வேறு	various, different
ต้น	ஆரம்பம்	medication for multi-symptoms
ต้นตอจักรวาลวิทยา	அண்டவியல் தோற்றம்	cosmogony
ต้นสกุล	பேரினம்	clan
ถนน	சாலை	street
ถนนคนเดิน	நடைபயிற்சி தெரு	kon dern road
ถนนประชาธิปก	ஜனநாயகம் சாலை	prachatiphok road
ถนนมิตรภาพ	நட்பு சாலை	thanon mittraphap
ถนนสุขุมวิท	சுகும்விட் சாலை	sukhumvit road
ถมิตรภาพ	நட்பு	mittraphap road
ถวาย	சலுகை	presented (royal language)
ถึงกระนั้น	ஆயினும்கூட	until
ถึงเดือนกรกฎาคม	ஜூலை	starting july
ถ้วย	கோப்பை	cup
ถ้อยคำ	சொற்கள்	accent
ทดลอง	சோதனை	experiment
ทนงศักดิ์	தானோங்சாக்	thanongsak
ทนาย	வழக்கறிஞர்	lawyer
ทนายความ	வழக்கறிஞர்	attorney
ทรงคล้ายทรงกลม	கோள	spheroid
ทรงถือหุ้นจำนวน	அவரது ஹைனெஸ் பங்குகளை வைத்திருக்கிறது	stock ownership
ทรงผนวช	அவரது உயர்நிலை	ordain
ทรงพระกรุณาโปรดเกล้าโปรดกระหม่อมให้	தயவுசெய்து என்னை புனிதப்படுத்துங்கள்	gift (word for the king)
ทรงยี่สิบหน้า	இருபது முகம்	icosahedron
ทรงลูกบาศก์	கன	cube
ทรงสี่เหลี่ยมขนมเปียกปูน	ரோம்பஸ்	rhombohedron shaped
ทรงสี่เหลี่ยมมุมฉาก	செவ்வகம்	triangular prism
ทรงห้าหน้า	ஐந்து முகம்	polyhedron
ทรงได้รับการทูลเกล้าฯ	அவரது மாட்சிமை மன்னரைப் பெற்றார்	the king of thailand gives out ____ to people
ทรัพยากร	ஆதாரம்	wealth
ทรัพยากรน้ำ	நீர் வளங்கள்	water resources
ทรัพย์วิจิตร	செல்வம்	sapwichit
ทรัพย์เพิ่ม	கூடுதல் சொத்துக்கள்	subpherm
ทรัมเป็ต	எக்காளம்	trumpet
ทรีทูวัน	மூன்று முதல் ஒன்று	three.two.one
ทวารหนัก	ஆசனவாய்	anus
ทวีป	கண்டம்	continent
ทวีปอเมริกา	அமெரிக்கா	america continent
ทวีปเอเชีย	ஆசியா	asia
ทวีวัฒน์	தவிவத்	taweewan
ทว่า	ஆனாலும்	however
ทศกัณฐ์	டோசகன்	ravana
ทศพล	டோசபன்	thotsaphon
ทหาร	சிப்பாய்	soldier
ทหารหน่วยอาเฟลันดราที่	அபெலந்திரா துருப்பு	afelandra army
ทหารอากาศ	விமானப்படை	air force man
ทอง	தங்கம்	gold
ทองขาว	வெள்ளை தங்கம்	thongkhao
ทองประสม	கலப்பு தங்கம்	thongprasom
ทองผาภูมิ	தாங் பா ஃபும்	thong pha phum
ทองหยอด	தங்க இலை	a type of thai dessert
ทองหล่อ	தொங்லர்	gold
ทองเจือ	தங்கம் பூசப்பட்டது	tong jea - a surname
ทองแดง	தாமிரம்	copper
ทองใหญ่	பெரிய தங்கம்	tong yai - a name
ทอม	டாம்	tom
ทอมสัน	தாம்சன்	thomson
ทอมัส	தாமஸ்	thomas
ทะเล	கடல்	ocean, sea
ทะเลทราย	பாலைவனம்	dessert
ทะเลสาบ	குளம்	lake
ทักษะ	திறன்கள்	skill
ทัช	தொடவும்	touch
ทับ	சாய்வு	thon-rammana
ทัพเรือภาคที่	கடற்படைத் துறை	naval area command
ทัวร์คอนเสิร์ต	கச்சேரி சுற்றுப்பயணம்	concert tour
ทั่วไป	பொது	general
ทั้ง	இருவரும்	all
ทั้งหมด	அனைத்தும்	all
ทางทิศตะวันออก	கிழக்கு	east
ทางทิศตะวันออกติดกับเวียดนาม	கிழக்கு வியட்நாமின் எல்லையாகும்.	borders vietnam to the east
ทางทิศเหนือติดกับประเทศไทยและลาว	வடக்கு தாய்லாந்து மற்றும் லாவோஸின் எல்லைகள்.	borders thailand and laos to the north
ทางน้ำ	நீர் வழி	by water
ทางรถไฟ	ரயில்	rail
ทางหลวงพิเศษ	சிறப்பு நெடுஞ்சாலை	motorway
ทางอากาศ	விமானம் மூலம்	by air
ทางไอทีวี	ஐடிவியில்	via itv ( a television station in thailand)
ทานากะ	தனகா	tanage - a japanese name
ทาร์ดิกราดา	தர்திகிரதா	tardigrada
ทาวเวอร์	கோபுரம்	tower
ทำงาน	வேலை	working
ทำนอง	டியூன்	melody
ทำบุญตักบาตรฯ	தகுதி மற்றும் துறவிகளுக்கு உணவு வழங்குதல்	put food offerings into a buddhist monk's bowl
ทำหน้าที่	கடமையைச் செய்யுங்கள்	task, function
ทำให้	செய்ய	made
ทิฆัมพรธีรวงศ์	டிகாம்போர்ன் திருவாங்	timkamporntiravong (thai last name)
ทิพย์	கப்பல்	thip
ทิฟฟานี่	டிஃப்பனி	tiffany - female's name
ทิม	டிம்	tim
ทิวานนท์	திவனான்	thiwanon
ทิศตะวันตก	மேற்கு	west
ที	டி	t.
ทีบีเอส	டி.பி.எஸ்	tbs
ทีมชาติไทย	தாய்லாந்து தேசிய அணி	thai national team
ทีมใดที่จำนวนข้อที่ถูกน้อยกว่า	எந்த அணியை விட குறைந்த எண்ணிக்கையில் உள்ளது	the team with the least correct answers
ทีวีอินไซด์	டிவி உள்ளே	tv inside
ทีโอที	tot	tot
ที่จ่ายร้อยละ	கட்டணம்	costing
ที่นี้	இங்கே	here
ที่ประชาชนชอบมากที่สุด	எந்த மக்கள் மிகவும் விரும்புகிறார்கள்	people's most favorite
ที่มา	மூல	source
ที่มี	அது உள்ளது	possess
ที่มีชื่อว่า	பெயரிடப்பட்டது	named
ที่สำคัญ	சாவி	important
ที่หมายถึง	அதாவது	explanation
ที่อยู่อาศัย	குடியிருப்பு	residence
ที่เกิดขึ้น	அது நடந்தது	appear
ที่โดดเด่นคือ	நிலுவையில் உள்ளது	notable
ทุก	ஒவ்வொன்றும்	every
ทุกครั้ง	ஒவ்வொரு முறையும்	every time
ทุติยจุลจอมเกล้าวิเศษ	நாளங்கள்	tuthit julajomklawwiset - the title of those you received jewelry from the king
ทุ่งตะโก	துங் டகோ	thung tako district
ทุ่งสง	துங் பாடல்	tong song or nakon sri thamarat state
ทุ่งใหญ่	துங் யாய்	tungyai
ทู	மிகவும்	to
ทูล	கருவி	thun
ทเวนตี้	இருபது	twenty
ทโกมลบุตร	தகோமோலாபுட்ர்	komolbut - a surname
ทไย	ஏன்	thayai
ท่องอาณาจักรโฮ่งเหมียว	ஹாங் மியாவோ இராச்சியத்தை ஓதிக் கொள்ளுங்கள்	traveling the kingdom of woof-meow
ท่าชนะ	தோரணை	thachana
ท่านอิน	இல்	than in
ท่านอ่อง	ஆங்	tan ong - a member of the royal family
ท่านอ้วน	தடித்த மனிதன்	than uan
ท่าน้ำนนท์	நீர்முனை	nam non pier
ท่ายาง	முத்திரை	tha yang
ท่าศาลา	தா சலா	sala pier
ท่าอากาศยานเลย	லோய் விமான நிலையம்	loei airport
ท่าเรือ	போர்ட்	pier
ท่าไม้ตาย	குடியேறுபவர்	deadly move
ท้องสนามหลวง	சனம் லுவாங்	sanamloung - a landmark in thailand
ธกรุงไทย	க்ரங் தாய் வங்கி	krung thai bank
ธกส	baac	bank for agriculture and agriculture
ธกสิกรไทย	காசிகார்ன் வங்கி	kasikornbank
ธง	கொடி	flag
ธงชัย	தொங்சாய்	thongchai
ธงชาติ	தேசிய கொடி	national flag
ธงธง	கொடி	thongthong
ธนบุรี	தோன்பூரி	thonburi province
ธนพร	தனபார்ன்	thanaporn
ธนะรัชต์	தனரத்	tanarat -a surname
ธนาคาร	வங்கி	bank
ธนาคารกรุงศรีอยุธยา	ஆயுத் வங்கி	bank of ayudhya
ธนาคารกรุงไทย	க்ரங் தாய் வங்கி	krung thai bank
ธนาคารทหารไทย	தாய் மிலிட்டரி வங்கி	tahanthai bank
ธนาคารทิสโก้	டிஸ்கோ வங்கி	tisco bank
ธนาคารอิสลามแห่งประเทศไทย	இஸ்லாமிய வங்கி தாய்லாந்து	islamic bank of thailand
ธนาคารเกษตร	விவசாய வங்கி	farmer's bank
ธนาคารเพื่อการพัฒนาแห่งเอเชีย	ஆசிய அபிவிருத்தி வங்கி	patana asia bank
ธนาคารไทยพาณิชย์	சியாம் கொமர்ஷல் வங்கி	siam commercial bank
ธนิต	தானித்	thanit
ธปท	போட்	bot
ธรณินทราธิราช	தரவிந்தாரதிரத்	having to do with the king
ธรณีสัณฐานวิทยา	மண் உருவவியல்	geomorphology
ธรรมนูญ	சாசனம்	law
ธรรมศักดิ์	தம்மசக்	tamasak - surname of an elected prime minister
ธรรมศาสตร์	தம்மசாத் பல்கலைக்கழகம்	thammasat
ธรรมเมกขสถูป	தர்ம மக் ஸ்தூபம்	dhamek stupa
ธานินทร์	தானின்	tanin
ธารทิพย์	திப் விட	tarnthip (first name)
ธำมงรค์	தம்ரோங்	ring
ธิติกานต์	திட்டிகன்	thitikan
ธีม	தீம்	theme
ธีระ	தீரா	teera
ธีรเดช	திரதேஜ்	theeradej
ธุรกิจ	ஒரு வணிகம்	business
ธุรกิจการบิน	விமான வணிகம்	airline business
นก	பறவை	bird
นกกระจอก	குருவி	sparrow
นกกระทา	காடை	quail
นกกระทุง	பெலிகன்	pelican
นกกระเต็น	கிங்பிஷர்	kingfisher
นกขมิ้น	கேனரி	oriole
นกน้อย	சிறிய பறவை	noknoi
นกแก้ว	கிளி	parot
นกแอร์	நோக் ஏர்	airline
นครนิวยอร์ก	நியூயார்க் நகரம்	new york city
นครปฐม	நக்கோன் பாத்தோம்	nakhon pathom
นครพนม	நக்கோன் பானோம்	nakhon phanom
นครราชสีมา	நக்கோன் ராட்சாசிமா	nakhon ratchasima
นครสวรรค์	நக்கோன் சவான்	nakhon sawan
นครหลวงเวียงจันทน์	வியஞ்சான் மூலதனம்	vientiane
นที	துணை நதி	natee - a male's name
นปช	யு.டி.டி.	three letter acronym
นพจินดา	நோப்பச்சிந்தா	noppajinda - a surname
นพดล	நோபாடோன்	noppadol - a male's name
นร	மாணவர்	the ancient and auspicious order of the nine gems
นราธิป	நாரதீப்	naratip - a male's name of a singer
นราธิวาส	நாரதிவத்	narativat state
นวนิยาย	நாவல்	story
นวรัตน์	நவரத்	navaratna
นวล	தந்தம்	noul -  a name
นอกจาก	தவிர	other than, to exclude
นอกจากนี้	கூடுதலாக	furthermore
นอกจากนี้แล้ว	தவிர	besides
นอกเหนือจากนี้	இது தவிர	moreover
นอนไม่หลับ	தூங்க முடியாது	insomnia
นอร์ส	நார்ஸ்	norse
นะงะซะกิ	நாகசாகி	nagasaki
นะโม	நமோ	namo
นักดนตรี	இசைக்கலைஞர்	musician
นักบินของออร์บ	உருண்டையின் பைலட்	orb pilot
นักบินอวกาศ	விண்வெளி	astronaut
นักปรัชญา	தத்துவஞானி	philosophist
นักพากย์	குரல் நடிகர்	voice actor
นักมวย	குத்துச்சண்டை வீரர்	boxer
นักร้อง	பாடகர்	singer
นักร้องชายไทย	தாய் ஆண் பாடகர்கள்	thai male vocalist
นักร้องนักดนตรี	பாடகர் இசைக்கலைஞர்	singer, musician
นักร้องเพลงไทยสากลชาย	சர்வதேச ஆண் தாய் பாடகர்	male thai pop singer
นักร้องเสียงหลัก	முக்கிய பாடகர்	lead singer
นักวิชาการ	கல்வி	i was in for.
นักวิทยาศาสตร์	விஞ்ஞானி	scientist
นักศึกษาวิชาทหาร	ராணுவ மாணவர்	army reserve force students
นักสู้อันดับ	தரவரிசை போராளி	fighter rank
นักเขียน	எழுத்தாளர்	writer
นักเขียนการ์ตูน	கார்ட்டூனிஸ்ட்	cartoonist
นักเต้นนำ	முன்னணி நடனக் கலைஞர்	dancers
นักเศรษฐศาสตร์	பொருளாதார நிபுணர்	economist
นักแต่งเพลง	இசையமைப்பாளர்	songwriter
นักแสดง	நடிகர்கள்	actor/actress
นักแสดงพิธีกร	நடிகர்	presenter of the show
นักแสดงรับเชิญ	அழைக்கப்பட்ட நடிகர்	guest star
นัดกับนัด	உடன் தேதி	nut kab nut - a thai sitcom
นันทนาการ	பொழுதுபோக்கு	recreation
นันทนาคร	நந்தனகோர்ன்	nantanakorn
นันทเสน	நந்தசென்	nanthasen
นันทไกร	நந்தக்ராய்	nandhakrai
นับตั้งแต่เริ่มก่อตั้งจนถึงปัจจุบัน	ஆரம்பம் முதல் தற்போது வரை	from the foundation up to the present
นัยนา	கண்	naiyana
นั่นคือ	அது	that is
นั่นเอง	அங்கே	that is
นั้น	அந்த	that
นา	புலம்	na
นากา	நாக	naga
นากิ	நாகி	nagi
นาคหิรัญกนก	நக் ஹிரங்கனோக்	nakhirunkanok
นางงามจักรวาล	பிரபஞ்ச அழகி	ms. universe
นางสาวสุวรรณ	மிஸ் சுவான்	miss suwan
นางสุพรรณมัจฉา	திருமதி சுபன் மாட்சா	mrs. supanmatja - a character in a thai legend
นางาโตะ	நாகடோ	logo ontario.
นาดี	நாடி	na di
นาดูน	நாதுன்	nadune (name of district)
นาทวี	நாதாவி	natavee district
นาทาล	நடால்	"exactly: ""natal;""  proper name: natarle"
นาที	நிமிடம்	minute
นานา	ஏராளமான	nana
นามิ	நமி	nami
นายกรัฐมนตรีของประเทศไทย	தாய்லாந்து பிரதமர்	prime minister of thailand
นายกรัฐมนตรีไทย	தாய் பிரதமர்	thai prime minister
นายกำพล	திரு. கம்போன்	kamphon
นายชลอ	திரு சாலோ	chalo
นายชวน	திரு சுவான்	mr. chuan
นายชาญชัย	திரு.சஞ்சாய்	chanchai
นายณรงค์	திரு. நரோங்	mr. narong - a male's name
นายดำรง	திரு டாம்ராங்	mr dumrong - a male's name
นายทวี	திரு தாவீ	mr.tawee
นายประกอบ	திரு சட்டமன்றம்	mr. prakob - a male's name
นายปรีชา	திரு. ப்ரீச்சா	mr.preecha
นายปรีดี	திரு. பிரிடி	pridi - a male's name
นายยงยุทธ	திரு யோங்யூட்	mr. yongyut - a male's name
นายศักดา	திரு சக்தா	sakda
นายสมชัย	திரு சோம்சாய்	mr. somchai
นายสมัคร	விண்ணப்பதாரர்	mr. samak - a thai name
นายสวัสดิ์	திரு சவத்	sawat
นายสุชาติ	திரு சுச்சார்ட்	mr. suchat
นายสุนทร	திரு. சுந்தோர்ன்	mr. soontorn - a male's name
นายแพทย์	டாக்டர்	male doctor
นารูโตะ	நருடோ	naruto - a japanese cartoon
นาวาอากาศเอกหญิง	படைத் தலைவர்	woman airforce captain
นาฬิกา	கடிகாரம்	clock
นาโนเทคโนโลยี	நானோ தொழில்நுட்பம்	nanotechnology
นำกลับมาสร้างใหม่อีกครั้ง	மீண்டும் உருவாக்க மீண்டும் கொண்டு வரப்பட்டது	remake (of an old movie)
นำแสดงโดย	நட்சத்திரம்	performed by
นำโดย	மூலம் வழிநடத்துங்கள்	led by
นิกาย	பிரிவு	sect
นิกเกิล	நிக்கல்	nickel
นิคมพัฒนา	நிகோம் பட்டானா	nikhom phatthana
นิตยสารชีวจิต	ஹோமியோபதி இதழ்	cheewajit magazine
นิตยสารเอเชียวีก	ஆசியா வீக் இதழ்	asiaweek magazine
นิตโย	நிட்டாயோ	nittayo
นิทาน	கதை	tales
นิยม	பிரபலமானது	niyom, name of a thai country music singer
นิยมจัดขึ้นในเดือน	பிரபலமான மாதம் நடைபெற்றது	usually held in the month of
นิยาม	வரையறு	symbols
นิรมิต	கனவு	niramit
นิรันดร์กุล	நிரங்குன்	nirankun
นิรุกติศาสตร์	சொற்பிறப்பியல்	philology
นิลภิรมย์	நீல்பிரோம்	nipinpirom - a surname
นิวคลีโอไทด์	உட்கரு அமிலம்	nucleotide
นิวยอร์ก	நியூயார்க்	new york
นิวัฒน์	நிவத்	niwat
นิวเคลียร์	அணு	nuclear
นิวเคลียส	நியூக்ளியஸ்	nucleus
นิฮง	நிஹோங்	nippon or nikon, a japanese reading language
นิเทศศาสตรบัณฑิต	கலை இளங்கலை	communication major graduates
นิ่ม	மென்மையான	pangolin
นิ่มสกุล	நிம் சகுல்	nimsakun
นีโอ	நியோ	neo
นี่คือ	இது	this is
นุช	மகிழ்ச்சி	nucth
นเรศ	நரேஸ்	naret - a male's name
นโยบายทางการทูตของจีน	சீனாவின் இராஜதந்திர கொள்கை	china;s foreign policies
น็อกซ์	நாக்ஸ்	left.
น้องครีม	நோங் கிரீம்	nong kreme - a nickname of someone in thai entertainment
น้องชาย	இளைய சகோதரர்	brother
น้อยมาก	மிக சில	noimak
น้ำ	தண்ணீர்	water
น้ำค้าง	பனி	namkhang
น้ำดื่ม	குடிநீர்	beverages
น้ำท่วม	வெள்ளம்	flooding
น้ำฝน	மழைநீர்	rainwater
น้ำพอง	ஊதப்பட்ட	nam pong in kon kan province
น้ำมะนาว	எலுமிச்சை சாறு	lemonade
น้ำมัน	எண்ணெய்	oil
น้ำมันสน	டர்பெண்டைன்	oil of turpentine
น้ำยืน	நிற்கும் நீர்	numyeen - location in ubolthani state
น้ำหนัก	எடை	weight
บทนมัสการนอบน้อมบูชาพระพุทธเจ้า	வழிபாட்டின் அத்தியாயம்	a prayer to the lord buddha
บทบาททางการเมือง	அரசியல் பங்கு	politic
บทสวดบาลีที่ขึ้นต้นด้วยอรหัง	அர்ஹத்துடன் தொடங்கும் பாலி கோஷம்	"pali mantra started with ""arhat"""
บทสวดสรภัญญะที่ขึ้นต้นด้วยธรรมมะคือ	தர்மத்துடன் தொடங்கும் சோரபன்யா மந்திரங்கள்	a buddhist prayer
บนบก	நிலத்தில்	on land
บรมนาถชาติอาชาวศรัย	போரோமனாச்சட் அச்சன் சாய்	something has to do with the king - too obscure
บรมนาถบพิตร	போரோம்நாட் போபிட்	borommanatbophit
บรรณาธิการ	ஆசிரியர்	editor
บรรพชีวินวิทยา	பாலியான்டாலஜி	paleontology
บราซิเลีย	பிரேசிலியா	brazilian
บราเธอร์ส	சகோதரர்கள்	brothers
บริบาล	பராமரிப்பு	baribal - a famous soccer player
บริพัตร	உணவு	paribatra
บริวเวอรี่	மதுபானம்	brewery
บริสุทธิ์	தூய்மையானது	pure
บริหารธุรกิจ	வியாபார நிர்வாகம்	business administration
บริเวณรอบทะเลสาบเขมร	கெமர் ஏரியைச் சுற்றி	area around the lake in cambodia
บริเวณเขตภูเขาทางภาคเหนือ	வடக்கில் மலைப்பிரதேசம்	mountain in north of thailand
บรูไน	புருனே	brunei
บลีช	ப்ளீச்	bleach
บลู	நீலம்	blue
บลูคอสมอส	நீல காஸ்மோஸ்	blue cosmos
บลูเบอร์รี่	புளுபெர்ரி	blueberry
บวก	நேர்மறை	positive
บวม	வீக்கம்	swelling
บวร	தெய்வீக	bawon
บอมบ์	குண்டு	bomb
บอย	சிறுவன்	boy
บอยซ์	பாய்ஸ்	boys
บอล	பந்து	ball
บอลด์วิน	பால்ட்வின்	baldwin
บอส	முதலாளி	boss
บังคลาเทศ	பங்களாதேஷ்	bangladesh
บังไค	பாங்கை	bankai
บัณฑิต	பட்டதாரி	bandit
บัณฑิตวิทยาลัยร่วมด้านพลังงานและสิ่งแวดล้อม	கூட்டு பட்டதாரி பள்ளி ஆற்றல் மற்றும் சுற்றுச்சூழல்	joint graduate school of energy and environment
บันทึก	பதிவு	record
บันทึกการสร้างโลก	உலக சாதனை	genesis diary
บันทึกความทรงจำ	மெமோ	diary
บันเทิง	பொழுதுபோக்கு	entertainment
บัว	தாமரை	lotus
บัวลอย	bualoy	kind of thai sweetmeat
บัวเชด	தாமரை மலர்	cedric dubois.
บัวใหญ่	புவா யாய்	big lotus
บาคคัส	பேச்சஸ்	bacchus
บาคุกันธาตุไฟ	பாகுகன் தீ உறுப்பு	dragonoid
บาคุกันลูกน้องของนากา	நாகாவின் ஆதரவாளரான பாகுகன்	bakugan, minion of naga
บางกอกกล๊าส	பாங்காக் கண்ணாடி	bangkok glass
บางกอกน้อย	பாங்காக் நொய்	bangkok noi
บางครั้ง	சில நேரங்களில்	sometimes
บางซื่อ	பேங் சூ	bang see - a location in thailand
บางปะกอก	பேங் பக்கோக்	bang prakok - an area in bangkok
บางปะหัน	பேங் பஹான்	a district in ayutthaya province
บางพลัด	பேங்க் பிளாட்	bangplad
บางส่วน	சில	some
บางเขน	பாங்கேன்	bang khen
บางแสน	பாங்சேன்	bang saen
บางใหญ่	பேங் யாய்	bang yai - a location in thailand
บานไม่รู้โรย	அமராந்த்	gomphrena
บารอมิเตอร์	காற்றழுத்தமானி	barometer
บารัก	பராக்	barack
บาร์	மதுக்கூடம்	bar
บาลี	பாலி	vatthu
บาอัล	பால்	baal - a demon in hebrew
บิน	ஈ	bin
บิล	ர சி து	bill
บิ๊กซี	பெரிய சி	big c
บิ๊กซ้งซุปเปอร์สโตร์	பெரிய பாடல் சூப்பர் ஸ்டோர்	big song superstore
บี	பி.	b
บีช	கடற்கரை	beach
บีบี	பிபி	bb
บีฟเค้ก	மாட்டிறைச்சி கேக்	beef cake
บี้	நொறுங்குகிறது	flatten
บี้สุกฤษฎิ์	பை சுக்ரித்	be- sukasit wisetkeaw - name of a singer
บุคคล	நபர்	person
บุคคลสำคัญ	முக்கியமான நபர்	vip person, very important person
บุคลิกภาพ	ஆளுமை	mannerism
บุช	புஷ்	(george) bush
บุญค้ำ	தகுதி	bunkham
บุญนะโชติ	புன்னச்சோட்	bunachot - a surname
บุญนาค	தகுதி	boon nak - a famous surname
บุณยเกตุ	புன்யாகெட்	boonyaket
บุตร	குழந்தை	son
บุษบา	பூ	busaba - a woman's name
บูมเมอแรง	எறிவளைதடு	boomerang
บ่อทอง	குளம் தங்கம்	bothong
บ้านฉาง	பான் சாங்	bahn shang -a  location in thailand
บ้านปราสาท	கோட்டை வீடு	castle house
บ้านผือ	பான் ஃபியூ	ban phue
บ้านฝันดอตคอม	பான் ரசிகர் காம்	bahnfun.com
บ้านลาด	பான் லாட்	ban lat
บ้านเขว้า	வீடு	bahn kaywah, an area in thailand
บ้านแพ้ว	வீடு	ban paw
บ้านโพธิ์	பா ஃபோ	bahn po - a location in thailand
ปจ	ஆண்டு	two letters acronym
ปช	கடற்கரை	two letters acronym
ปฏิทินช่อง	சேனல் காலண்டர்	calendar
ปฏิภาณ	எஸ்பிரிட்	male's name patipan
ปตท	பி.டி.டி.	three letters from thai alphabets
ปทานุกรม	அகராதி	encyclopedia
ปทุมธานี	பதும் தானி	pathum thani
ปภ	பாதுகாப்பு	the order of the direkgunabhorn
ปภัสรา	பாப்பாசரா	papatsara
ปม	முடிச்சு	knot
ประกอบด้วย	சேர்க்கிறது	composed of
ประกอบไปด้วย	கொண்டுள்ளது	included
ประการที่	எண்	point
ประกาศิต	ஆணை	command
ประกาศเป็นป่าสงวน	வனப்பகுதியாக அறிவிக்கப்பட்டது	preserve area, the protected forest
ประจวบ	மோதுக	prachuap
ประจวบคีรีขันธ์	பிரச்சுப் கிரி கான்	prajoubkirikan state
ประจักษ์	பகிரங்கமான	mr. prajak
ประจำปี	ஆண்டு	annual
ประชากรประมาณ	மதிப்பிடப்பட்ட மக்கள் தொகை	population about
ประชากรศาสตร์	மக்கள்தொகை	literature subject
ประดิษฐาน	இடம்	placed
ประติมากรรม	சிற்பம்	production of a play
ประติมากรรมไทย	தாய் சிற்பம்	thai sculpture
ประตู	கதவு	gate
ประตูน้ำ	அணை	pratunam
ประตูเสีย	உடைந்த கதவு	broken door
ประทีป	விளக்கு	continent
ประธาน	ஜனாதிபதி	president
ประธานกรรมการ	தலைவர்	chief executive officer
ประธานศาลฎีกา	உச்ச நீதிமன்றத்தின் தலைவர்	president of the supreme court
ประธานสภารัฐสภา	நாடாளுமன்ற சபாநாயகர்	speaker of parliament
ประธานาธิบดี	ஜனாதிபதி	president
ประมาณ	பற்றி	about, estimated to be
ประมาณคศ	பற்றி	christ year
ประมาณปี	சுமார் ஒரு வருடம்	approximately in the year
ประยงค์	பிரயோங்	prayong
ประวัติศาสตร์	வரலாறு	history
ประวัติศาสตร์สเปน	ஸ்பானிஷ் வரலாறு	history of spain
ประวัติศาสตร์ไทย	தாய் வரலாறு	history of thailand
ประสาท	நரம்பு	castle
ประสิทธิภาพ	செயல்திறன்	efficiency
ประหยัด	சேமி	thrifty, cheap
ประเด็นที่	பிரச்சனை	point number
ประเทศ	நாடு	country
ประเทศกัมพูชา	கம்போடியா	cambodia
ประเทศซูดาน	சூடான்	sudan
ประเทศทำการค้าขายกับต่างประเทศมากยิ่งขึ้น	வெளிநாடுகளுடன் அதிக வர்த்தகம் செய்யும் நாடுகள்	country that trades with other countries
ประเทศนอร์เวย์	நோர்வே	norway
ประเทศฝรั่งเศส	பிரான்ஸ்	france
ประเทศพม่า	மியான்மர்	burma
ประเทศฟินแลนด์	பின்லாந்து	finland
ประเทศภูฏาน	பூட்டான்	bhutan
ประเทศมาเลเซีย	மலேசியா	malaysia
ประเทศราช	ராயல் நாடு	vassal state
ประเทศลาว	லாவோஸ்	laos
ประเทศสวีเดน	சுவீடன்	sweden
ประเทศสเปน	ஸ்பெயின்	spain
ประเทศอียิปต์	எகிப்து	egypt
ประเทศเกาหลี	கொரியா	korea
ประเทศเกาหลีใต้	தென் கொரியா	south korea
ประเทศเนปาล	நேபாளம்	nepal
ประเทศเปรู	பெரு	peru
ประเทศเม็กซิโก	மெக்சிகோ	mexico
ประเทศเวียดนาม	வியட்நாம்	vietnam
ประเทศแคนาดา	கனடா	canada
ประเทศและดินแดน	நாடுகள் மற்றும் பிரதேசங்கள்	natoin and territory
ประเทศไทย	தாய்லாந்து	thailand
ประเพณีชักพระ	சக் ஃபிரா பாரம்பரியம்	chak phra festival
ประเภท	வகை	category
ประเภทของ	வகை	type of
ประเภทรายการแข่งขันชิงรางวัลดีเด่น	விருது வகை சிறந்த போட்டி	award show for
ประโยค	தண்டனை	sentence
ปรัชญา	தத்துவம்	philosophy
ปรัชญาตะวันตก	மேற்கத்திய தத்துவம்	western philosophy
ปรากฏการณ์โลกร้อน	உலக வெப்பமயமாதல்	global warming
ปรากฏตัวตอนแรกในตอน	முதலில் ஒரு அத்தியாயத்தில் தோன்றியது	first appear in
ปรากฏตัวในตอน	இல் தோன்றியது	showing their presence
ปราจีนบุรี	பிரச்சின் பூரி	prachin-buri
ปราบดาภิเษก	முடிசூட்டப்பட்டது	prapdapisek
ปราสาทเขาพระวิหาร	preah vihear கோயில்	kao pravihan ancient ruins
ปราโมทย์	மகிழ்ச்சி	pramot
ปริญ	அச்சு	parin
ปริญญา	பட்டம்	degree
ปริภูมิ	இடம்	3 dimensions
ปริมาณการผลิต	உற்பத்தி அளவு	capacity
ปริศนา	புதிர்	puzzle
ปริ๊นซ์	இளவரசன்	prince
ปรีดา	மகிழ்ச்சி	prida - a male's name
ปรีดี	பி.ஆர்.ஐ.	pridi
ปลา	மீன்	fish
ปลาบู่ทอง	கோல்டன் கோபி	goldfish
ปลาปอมปาดัวร์	பொம்படோர்	pompadour
ปลาย	முடிவு	at the end
ปลายคริสต์ศตวรรษที่	19 ஆம் நூற்றாண்டின் பிற்பகுதியில்	late century
ปลาในสกุลนี้เรียกว่า	இந்த இனத்தில் உள்ள மீன்கள் என்று அழைக்கப்படுகின்றன	the fish in this family is called _________
ปลิงทะเล	கடல் வெள்ளரி	sea cucumber
ปล่อย	வெளியீடு	release
ปวดข้อ	மூட்டு வலி	joint pain
ปวันรัตน์	பவன்ரத்	pavunnarat - a surname
ปวีณา	பவீனா	paweena
ปักกิ่ง	பீக்கிங்	beijing
ปักธงชัย	பாக் தாங் சாய்	pakthongchai
ปัจจุบัน	தற்போது	at present
ปัจจุบันนี้	இப்போதெல்லாம்	presently
ปัจจุบันประเทศไทยมีภาพยนตร์ที่มุ่งสู่ตลาดโลก	இப்போதெல்லாம், தாய்லாந்தில் உலக சந்தையை நோக்கிய திரைப்படங்கள் உள்ளன.	currently thailand has international movies
ปัจจุบันมีที่นั่งอยู่ในสภาผู้แทนราษฎร	தற்போது பிரதிநிதிகள் சபையில் ஒரு இடம் உள்ளது	presently have elected representatives
ปัจจุบันเลิกเขียนแล้ว	தற்போது எழுதவில்லை	presently retired from writing
ปัญจาบ	பஞ்சாப்	panjab
ปัญโญภาส	பனோபாஸ்	panyopat - a surname
ปัน	பகிர்	pan
ปั้น	அச்சு	clay molding
ปั๊บ	திடீரென்று	pup
ปาก	வாய்	mouth
ปากดี	நல்ல வாய்	be talkative
ปากน้ำ	தோட்டம்	samutpragan province in thailand
ปากีสถาน	பாகிஸ்தான்	country of pakistan
ปากเกร็ด	பாக் கிரெட்	pak kret
ปากแม่น้ำสิงคโปร์	சிங்கப்பூர் வாய்	singapore river delta
ปาน	களங்கம்	pan - a thai name
ปานามา	பனாமா	panama
ปานแร่	பிறந்த அடையாளங்கள்	panrae
ปาย	பை	pai
ปาริชาต	பரிச்சாட்	tiger’s claw
ปารีส	பாரிஸ்	paris
ปาร์ค	பூங்கா	park
ปาสกาล	பாஸ்கல்	pascal - computer language or name
ปาเลสไตน์	பாலஸ்தீனம்	palestine
ปิปเปอราซิลลิน	பைபர் அசிலின்	piperacillin
ปิยะพงษ์	பியாபோங்	piyapong
ปิ่นเกล้า	பிங்க்லாவ்	pin glow - an area in thailand
ปีคศ	ஆண்டு	christain era
ปีจอโทศก	பன்றியின் ஆண்டு	year of the dog
ปีที่	ஆண்டு	the year
ปีที่วางจำหน่าย	வெளியீட்டு ஆண்டு	the year that the product was on the market
ปีพุทธศักราช	ப year த்த ஆண்டு	buddhism year
ปีย์	ஆண்டு	pe - a thai music artist
ปีย์ชนิตว์	பியாச்சிட்	peechanit
ปีเตอร์	பீட்டர்	peter
ปี่กลาง	நடுத்தர பை	a thai woodwind instrument
ปืนพก	பிஸ்டல்	handgun
ปืนพกกึ่งอัตโนมัติ	அரை தானியங்கி கைத்துப்பாக்கி	semi-automatic pistol
ปืนใหญ่	பீரங்கி	cannon
ปืนใหญ่กลางกระสุนวิถีโค้ง	பீரங்கி நடுத்தர பாதை வளைவுகள்	cannon
ปืนไร้แรงสะท้อนถอยหลัง	பின்னடைவு துப்பாக்கி	recoilless rifle
ปุณณกันต์	புன்னகன்	bhunnagun
ปุตราจายา	புத்ராஜெயா	putrajaya
ปุ๋ย	உரம்	pui
ปู	நண்டு	crab
ป่าชายหาด	கடற்கரை காடு	beach forest
ป่าชายเลน	சதுப்புநில காடு	mangrove forest
ป่าดิบแล้ง	உலர் பசுமையான காடு	dry evergreen forest
ป่าเบญจพรรณ	கலப்பு காடு	mixed forest
ป่าโกงกาง	சதுப்புநில காடு	mangrove
ป๊อป	பாப்	pop
ป๊อปปี้	பாப்பி	poppy
ผจญภัยเกาะมหาสมบัติ	புதையல் தீவு சாதனை	nobita's south sea adventure
ผดุง	ஆதரவு	phadung
ผล	முடிவுகள்	result
ผลการแข่งขัน	போட்டி முடிவுகள்	result of competition
ผลงานหนังสือ	புத்தக இலாகா	publication
ผลงานเพลง	இசை	song production
ผลงานโฆษณา	விளம்பரம்	marketing project
ผลประเสริฐ	சிறந்த முடிவுகள்	polpasert - last name of the 2nd wife of the thai prince
ผลผลิตพลอยได้	துணை தயாரிப்புகள்	result, effects
ผลรวม	தொகை	summation
ผลสำรวจ	கணக்கெடுப்பு முடிவுகள்	survey results
ผิวขาว	வெள்ளை தோல்	white
ผิวสี	ேதாலின் நிறம்	skin color
ผี	பேய்	ghost
ผีน่ารัก	அழகான பேய்	cute ghost
ผู้กำกับ	இயக்குனர்	producer
ผู้จัดการ	மேலாளர்	manager
ผู้จัดการทีม	அணி மேலாளர்	manager
ผู้ชนะ	வெற்றியாளர்	winner
ผู้ชาย	ஆண்	male, man
ผู้ช่วยศาสตราจารย์	உதவி பேராசிரியர்	assistant professor
ผู้ดำเนินรายการ	மதிப்பீட்டாளர்	moderator
ผู้บริหาร	நிர்வாகி	manager
ผู้ผลิต	உற்பத்தியாளர்	producer
ผู้ฝึกสอน	பயிற்சியாளர்	trainer
ผู้พิทักษ์แห่งพิรุณ	பிரச்சனையின் பாதுகாவலர்	rain defender
ผู้พิทักษ์แห่งอรุณ	விடியலின் கார்டியன்	guardian of the dawn.
ผู้ว่าการธนาคารแห่งประเทศไทย	தாய்லாந்து வங்கியின் ஆளுநர்	governor of the bank of thailand
ผู้ว่าราชการจังหวัด	கவர்னர்	the governor of the city
ผู้สนับสนุน	ஆதரவாளர்	supporter
ผู้อำนวยการ	இயக்குனர்	superintendent
ผู้เล่น	விளையாட்டாளர்கள்	player
ผู้เล่นชุด	பிளேயரை அமைக்கவும்	team
ผู้ใหญ่	வயது வந்தோர்	adult
ผ่องศรี	போங்ஸ்ரி	pongsri
ผ้าขาวม้า	இடுப்பு	a special thai cloth that men used to tie around their waists
ผ้าอนามัยโซฟี	சோஃபி சானிட்டரி நாப்கின்கள்	sofi sanitary napkin
ฝ	தி	a letter with ph sound
ฝอยทอง	குழப்பம்	foythong - a thai dessert
ฝิ่น	அபின்	opium
ฝูงชนวุ่นวาย	குழப்பமான கூட்டம்	mob
ฝ่ามือ	பனை	palm
ฝ่ายบริหาร	மேலாண்மை	executive branch
ฝ่าเท้า	கால் ஒரே	sole of foot
ฝ่าแดนเขาวงกต	பிரமை வழியாக	in the boundaries of kao wonkut
ฝ้าย	பருத்தி	fai
พ	டி	a thai alphabet
พงศ์ศิลป์พิพัฒน์	போங்சில்ப் பிபாட்	pongsinpipat
พงศ์เรืองรอง	பொங்ரூயாங்	"surname ""pong reuang-rong"""
พงษ์พานิช	போங்பனிச்	phongphanit
พงษ์เพชร	போங் பெட்	phong phet
พงษ์ไพบูลย์	போங்பைபன்	pongphatboon
พจนานุกรมออนไลน์	ஆன்லைன் அகராதி	online dictionary
พญา	பாம்பு	phaya
พญามังราย	பயா மங்ராய்	mangrai the great
พตท	பரப்பளவு	three letters acronym
พธม	வது	people's alliance for democracy
พนมไพร	ஃபனோம் ஃபிராய்	phanom phrai
พบหลักฐานของมนุษย์ซึ่งมีอายุเก่าแก่ที่สุดถึงห้าแสนปี	மனிதர்களின் ஆதாரங்கள் கிடைத்தன, ஐநூறாயிரம் ஆண்டுகள் வரை பழமையானவை.	found an evidence of the the oldest human that lived in that area
พยัญชนะ	மெய்	consonant
พยัญชนะสะกดควบกล้ำ	மெய்	diphthong's consonant
พยางค์	எழுத்து	syllable
พยาธิกำเนิด	நோய்க்கிருமி உருவாக்கம்	pathogenesis
พยาธิวิทยา	நோயியல்	pathology
พยาบาล	செவிலியர்	nurse
พยายามชี้ให้สาธารณชนและนานาชาติ	பொது மற்றும் சர்வதேசத்தை சுட்டிக்காட்ட முயற்சிக்கிறது	encourage to promote the people and international policies
พร	ஆபாச	wishes
พรนารายณ์	நராய்	phonnarai
พรบ	நாடகம்	act
พรรคการเมืองใหม่	புதிய அரசியல் கட்சி	kan mai meung political party
พรรคชาติไทย	விளக்கப்படம் தாய் கட்சி	thai nation party
พรรคธรรมาธิปัตย์	தம்மதிபத் கட்சி	tamatipat political party
พรรคประชาธรรม	பிரச்சாதம் கட்சி	prachatam political party
พรรคภูมิใจไทย	புவியா தாய் கட்சி	bhumjaithai party
พรรคสม	சமன்பாடு கட்சி	som rangsi political party
พรรคสังคมประชาธิปไตย	சமூக ஜனநாயகக் கட்சி	social democratic party
พรรคเพื่อแผ่นดิน	பியூ தாய் கட்சி	puea pandin party
พรอุดมศักดิ์	ஃபோனூடோம்சாக்	pornudomsak (last name)
พระคาถาชินบัญชร	மந்திரம் சின்னபஞ்சன்	chinbanchon
พระจันทร์	நிலா	moon
พระจันทร์สีรุ้ง	ரெயின்போ நிலவு	phrachan sirung
พระชนม์	வாழ்க்கை	the father of the king
พระตำหนัก	அரண்மனை	the king's residence
พระที่นั่งจักรพรรดิพิมาน	பேரரசர் பிமான் அரண்மனை	chakraput piman hall
พระที่นั่งดุสิตมหาปราสาท	துசித் மகா பிரசாத் சிம்மாசன மண்டபம்	phra thinang dusit maha prasat
พระที่นั่งบรมพิมาน	போரோம்பிமான் மாளிகை	the king's seat
พระธรรมปิฎก	தம்மபிடக	phra thampidok
พระธิดา	மகள்	daughter
พระนคร	மூலதனம்	phra nakhon
พระนาม	பெயர்	name of the king
พระนามต้นราชสกุล	முதல் பெயர்	the first person in the dynasty
พระนารายณ์	விஷ்ணு	narayana
พระบรมธาตุไชยา	புத்தரின் நினைவுச்சின்னங்கள்	buddha's relics chaiya
พระบรมราชชนก	ராயல் ஆதரவு	the king's sister
พระบรมราชินี	ராணி	queen
พระบรมวงศานุวงศ์	ராயல்டி	members of the royal family
พระบาทสมเด็จพระนั่งเกล้าเจ้าอยู่หัว	மன்னர் நாங் கிளாவ்	jessadabodindra
พระบาทสมเด็จพระปกเกล้าเจ้าอยู่หัว	ராஜா பிரஜாதிபோக்	phrabat somdet phra poramintharamaha - 7th king of thailand
พระบาทสมเด็จพระปรเมนทรมหาอานันทมหิดล	அவரது மாட்சிமை மன்னர் பூமிபோல் ஆடுல்யதேஜ் மகா ஆனந்தமஹிதோல்	phra bat somdet phra poramentharamaha ananda mahidol
พระบาทสมเด็จพระพุทธยอดฟ้าจุฬาโลก	ஃபிர புத்தர் ஃபிரா யோட் பா, சுலலாங்கொர்ன்	king rama 1 of chakri monarchy (bangkok)
พระบาทสมเด็จพระเจ้าอยู่หัวภูมิพลอดุลยเดชทรงพระกรุณาโปรดเกล้าฯ	அவரது மாட்சிமை மன்னர் பூமிபோல் ஆடுல்யாதேஜ் மனதார மகிழ்ச்சி அடைந்தார்	the current king of thailand
พระบาทสมเด็จพระเจ้าอยู่หัวอานันทมหิดล	மன்னர் ஆனந்த மஹிடோல்	king ananda mahidol
พระบาทสมเด็จพระเจ้าอยู่หัวเสด็จฯ	அவரது மாட்சிமை மன்னர்	the current king
พระปกเกล้าเจ้าอยู่หัว	ராஜா பிரஜாதிபோக்	king rama vii
พระประแดง	ஃபிரா பிராடெங்	prapadaeng
พระปรางค์สามยอด	ப்ராங் சாம் யோட்	prapang samyod
พระพรหมคุณาภรณ์	ஃபிரா ப்ரோம் குனாபோர்ன்	pra prhom kunaporn - a person in thailand
พระพันปีหลวง	மில்லினியம் லுவாங்	queen mother
พระพันวัสสาอัยยิกาเจ้า	ஆயிரம் புத்தர்கள்	pra paunvatsaeyyigajao - name of a monk
พระพุทธชินราช	ஃபிர புத்த புத்த சின்னரத்	phra buddha chinnarat
พระพุทธบาท	புத்தரின் தடம்	phra phutthabat
พระพุทธศาสนา	ப buddhism த்தம்	buddhism
พระมงกุฏเกล้าเจ้าอยู่หัว	ராஜா iv	phra mongkut klao chao yu hua
พระมเหสี	துணைவியார்	the wife of a king
พระยศขณะนั้น	அந்த நேரத்தில்	the current title
พระยาชัยสุนทร	ஃபிரயா சாய் சூந்தோர்ன்	praya chaisoontorn - first mayor of thailand
พระยาราม	ஃபிரயா ராம்	prayaram - the governor of sukothai city (the ancient city of thailand)
พระยาวิเศษภักดี	ஃபிரயா விசெட்பக்டி	praya wiset pakdi -a  name of a head of state in the ancient time
พระยาสุนทรสงคราม	ஃபிரயா சுந்தோர்ன்சோங்கிராம்	phraya sonthornsongkram (thai name)
พระยาไกรภักดีศรีนครลำดวน	ஃபிரயா கிரைபக்தி ஸ்ரீநகோன் லம்துவான்	phraya kraiphakdi sinakhon lamduan
พระราชกรณียกิจ	ராயல் கடமைகள்	royal duties
พระราชลัญจกรประจำพระองค์	ராயல் முத்திரை	the king's body guard
พระราชวงศ์	அரச குடும்பம்	royal family
พระราชวรวงศ์เธอ	அரச குடும்பம்	the title of the princess
พระราชวังดุสิต	துசிட் அரண்மனை	dusit palace
พระราชวังเดิม	அசல் அரண்மனை	phra racha wang derm
พระลอ	ஃபிரா லோர்	phra lo
พระสมเด็จจิตรลดา	ஃபிரா சோம்தேஜ் சித்ரலதா	pra jitlada - something that was built by the king
พระสัมมาสัมพุทธเจ้า	பகவான் புத்தர்	buddha
พระองค์เจ้าสิริวัณณวรีนารีรัตน์	எச்.ஆர்.எச் இளவரசி சிறிவண்ணாவரி வாரீரத்	the name of one of the king's granddaughter
พระอังสาเบื้องซ้ายประดับเหรียญรัตนาภรณ์	ரத்தானபார்னால் அலங்கரிக்கப்பட்ட இடதுபுறத்தில் புனிதமான புத்த தாயத்து	diagonal sash for the princess
พระอัษฎามหาเจดีย์	ஃபிரா அசாதா மஹா சேடி	(royal name/language)
พระอิศวร	சிவன்	the god shiva
พระอิสริยยศ	ராயல் தலைப்பு	given rank or honor by the monarchy
พระอุโบสถ	புத்த கோவில்	the temple
พระเกียรติยศ	மரியாதை	royal honour
พระเจ้าลูกยาเธอ	கடவுள் குழந்தை	the royal princess
พระเจ้าหลานเธอ	கடவுள் உங்கள் மருமகள்	hmh princess
พระโคตมพุทธเจ้า	புத்த தாயத்து	pra kotomputtachao - another name of buddha
พรานกระต่าย	ஹண்டர்	prankatai - an area in thai province
พราหมณ์	பிராமணர்	brahman
พริกหยวก	பெல் மிளகு	a type of thai pepper
พริกหวาน	பெல் மிளகு	sweet pepper
พริกไทย	மிளகு	thai pepper
พฤกษศาสตร์	தாவரவியல்	botany
พลตรี	விமானப்படை	major general
พลตรีหญิง	பெண் விமானப்படை	a female officer
พลตำรวจเอก	போலீஸ் ஜெனரல்	police general
พลทหาร	சிப்பாய்	first class, enlisted men
พลศักดิ์	போல்சக்	polsak
พลอย	ரத்தினம்	ploy
พลอสนธิ	போல்சன் சந்தி	sonthi - a famous thai army officer
พลอากาศเอกหญิง	பெண் ஏ.சி.எம்	air chief marshal
พลฯ	பொது	private
พลังงานคลื่น	அலை சக்தி	wave power
พลังงานนิวเคลียร์	அணு சக்தி	nuclear power
พลังงานลม	காற்றாலை சக்தி	wind power
พลังงานไฟฟ้า	மின் சக்தி	electrical energy
พลัส	பிளஸ்	plus
พลาซา	பிளாசா	plaza
พลาสติก	நெகிழி	plastic
พลาสมา	பிளாஸ்மா	plasma
พลเรือเอก	அட்மிரல்	admiral
พลเอกสนธิ	ஜெனரல் சோந்தி	sonthi - a thai army officer
พวกสัตว์ลำตัวกลม	சுற்று உடல் விலங்குகள்	animals with no backbones
พศ	வெள்ளி	b.e.
พอ	போதும்	col.
พอตเตอร์	குயவன்	potter
พอตเตอร์กับเจ้าชายเลือดผสม	பாட்டர் மற்றும் அரை இரத்த இளவரசர்	(harry) potter and the half-blood prince
พอยท์	புள்ளி	point
พอล	பால்	paul
พัชรี	பச்சரி	pacharee - a female's name
พัฒน์ชัย	பட்சாய்	pattachai - a male's name, famous singer
พัทยาเหนือ	வடக்கு பட்டாயா	north pattaya
พัทยาใต้	தெற்கு பட்டாயா	south pattaya - in thailand
พัน	ஆயிரம்	pan
พันธมิตร	கூட்டணி	alliance
พันธุศาสตร์	மரபியல்	genetic
พันธุ์พืช	தாவர இனங்கள்	seed
พันธุ์สุนัข	நாய் இனம்	dogs
พันธเสน	பத்திரம்	panthasen (thai last name)
พับลิชชิ่ง	வெளியிடுகிறது	publishing
พัลซาร์	பல்சர்	pulsar
พากย์เป็น	என பெயரிடப்பட்டது	subtitle
พายุ	புயல்	storm
พารา	பாரா	parasetamol - a drug
พารามีเซียม	அளவுரு	paramecium
พาร์ค	பூங்கா	park
พาวเวอร์บาย	பவர் பை	power buy
พาเมล่า	பமீலா	pamela
พิชัย	பிச்சாய்	pichai
พิชิต	கைப்பற்றும்	phichit
พิณ	மாண்டோலின்	harp
พิธีกรรายการ	தொகுப்பாளர்	host
พิบูลมังสาหาร	பிபுன் மங்சஹான்	pi bul mung sa har (province name)
พิพิธภัณฑสถานแห่งชาติ	தேசிய அருங்காட்சியகம்	thailand meseum
พิพิธภัณฑ์	அருங்காட்சியகம்	museum
พิม	பிம்	type
พิมประภา	பிம்ப்ராபா	phimprapha
พิมพ์เล็ก	சிறிய அச்சு	small photo frame 1.4 cm x 2.1 cm x 0.5 cm thick
พิมลวรรณ	பிமோன்வான்	pimonvun - the name of a female anchor person
พิรุณ	மழை	rain water
พิสุทธิ์	புத்திசாலி	pisut - a male's name
พิออจชา	பியோன்சா	piodcha
พิเศษนครกิจ	நகோர்ன்கிட் சிறப்பு	pisetnakornkit - a surname
พีท	பீட்	pete
พีระมิด	பிரமிட்	pyramid
พีระศรี	ஃபிரஸ்ரி	balcony
พีอีเอ	பி.ஐ.ஏ.	pea
พี่น้อง	சகோதரரே	siblings
พี่สาวของ	சகோதரி	the sister of ____________
พึ่งสุนทร	சந்தோர்னை நம்புங்கள்	puangsunthorn
พืช	ஆலை	plants
พืชที่สำคัญคือ	முக்கியமான தாவரங்கள்	important plants are ...
พืชไม่มีท่อลำเลียง	குழாய் இல்லாத தாவரங்கள்	plants without tubelike structures
พื้นฐานทางเศรษฐกิจ	பொருளாதார அடிப்படையில்	base economics
พื้นที่มหาวิทยาลัย	பல்கலைக்கழக பகுதி	university area
พุฒตาล	புத்தன்	puttan
พุทธคยา	போத் கயா	bodh gaya
พุทธนิกายเถรวาท	தேரவாத புத்தமதம்	a sect of buddhist religion
พุทธศตวรรษที่	நூற்றாண்டு புத்த	buddhist era
พุทธศักราช	புத்த சகாப்தம்	buddhist era
พุ่มพวง	பெண்	poompoang - surname of a famous actor
พู่กัน	வர்ண தூரிகை	pugun
พ่อขุนรามคำแหง	மன்னர் ராம்காம்ஹெங்	the leader of sukothai empire
พ่อขุนศรีอินทราทิตย์	மன்னர் இனாரதித்	po kun intarathip - the fist king of thailand
พ่อมด	வழிகாட்டி	wizard
พ่ายแพ้ให้กับ	இழந்தது	lose to
พ๎ร	வரவேற்பு	wish
ฟง	ஃபாங்	fong - a chinese name
ฟรานซ์	ஃபிரான்ஸ்	franz
ฟรีดริช	ப்ரீட்ரிச்	friedrich
ฟรีด้อม	இலவச ஸ்னீக்கிங்	freedom
ฟรีแวร์	ஃப்ரீவேர்	freeware
ฟลายเวท	ஃப்ளைவெயிட்	flyweight
ฟลูวาสแตติน	ஃப்ளூவாஸ்டின்	fluvastatin - a drug
ฟอน	வான்	von - in german name
ฟอร์ด	ஃபோர்டு	ford
ฟอสฟอรัส	பாஸ்பரஸ்	phosphorus
ฟอสเฟต	பாஸ்பேட்	phosphate
ฟังพระธรรมเทศนา	பிரசங்கங்களைக் கேளுங்கள்	listen to the gospel
ฟังเพลง	இசையைக் கேளுங்கள்	listen to music
ฟังไจ	ஜெய்மைக் கேளுங்கள்	fungi
ฟัน	பற்கள்	tooth
ฟาง	வைக்கோல்	fhang
ฟาน	வேன்	van - as in the surname
ฟิชเชอร์	ஃபிஷர்	fisher
ฟินแลนด์	பின்லாந்து	finland
ฟิลิป	பிலிப்	philip
ฟิลิปปินส์	பிலிப்பைன்ஸ்	philippines
ฟิลิปีโน	பிலிப்பைன்ஸ்	filipino
ฟิวชัน	இணைவு	fusion
ฟิสิกส์ดาราศาสตร์	வானியற்பியல்	astrophysics
ฟิสิกส์อนุภาค	துகள் இயற்பியல்	physic particle
ฟีนิลคีโตนูเรีย	ஃபெனில்கெட்டோனூரியா	phenylketonuria
ฟีฟ่าคลับเวิลด์คัพ	ஃபிஃபா கிளப் உலகக் கோப்பை	fifa world cup
ฟุตซอล	புட்சல்	futsal
ฟุตบอล	கால்பந்து	football
ฟุตบอลอาเซียนเยาวชน	ஆசியான் இளைஞர் கால்பந்து	asian youth soccer
ฟุตบอลเอเชียเยาวชน	ஆசிய இளைஞர் கால்பந்து	asian football club youth championship
ฟู	முழு	rise up
ฟูจิ	புஜி	fuji
ฟูลส์	முழு	fools
ฟ้อน	நடனம்	fon
ฟ้า	நீலம்	blue
ฟ้าร้อง	இடி	thunder
ฟ้าหลัว	சூரிய உதயம்	haze
ภมรมนตรี	பாமமன் மாண்ட்ரி	pamornmontri
ภักดี	விசுவாசமான	pakdi
ภัณฑิลา	பாந்திலா	paktila - first name of a female actress
ภาคกลาง	மத்திய பகுதி	central thailand
ภาคคนแสดง	காட்டு	human version
ภาคตะวันตก	மேற்கு பகுதி	west
ภาคตะวันออกเฉียงเหนือ	வடகிழக்கு பகுதி	northeast region
ภาคพิเศษ	சிறப்பு	special program
ภาควิชาคณิตศาสตร์	கணிதத் துறை	department of mathematics
ภาควิชาพยาธิวิทยา	நோயியல் துறை	department of pathology
ภาควิชาฟิสิกส์	இயற்பியல் துறை	physics
ภาควิชาวิศวกรรมเครื่องกล	இயந்திர பொறியியல் துறை	engineering division
ภาควิชาวิศวกรรมไฟฟ้า	மின் பொறியியல் துறை	engineering department
ภาควิชาสูติศาสตร์และนรีเวชวิทยา	மகப்பேறியல் மற்றும் பெண்ணோயியல் துறை	gynecology
ภาควิชาเทคโนโลยีอาหาร	உணவு தொழில்நுட்பத் துறை	faculty of food technology
ภาคเหนือ	வடக்கு	northern region
ภาคใต้ตอนล่าง	கீழ் தெற்கு பகுதி	southern thailand
ภาพตรา	முத்திரை படம்	coat of arms
ภาพถ่าย	புகைப்படம்	photograph
ภาพพาโนรามา	பனோரமா	panoramic image
ภาพพิมพ์	படத்தை அச்சிடுக	lithography
ภาพยนตร์	திரைப்படங்கள்	movie
ภาพยนตร์การ์ตูนไทย	தாய் கார்ட்டூன் படம்	thai cartoon
ภาพยนตร์ชุดนี้	இந்த திரைப்பட தொகுப்பு	this series
ภาพยนตร์ตอน	அத்தியாயம்	version of the movie
ภาพยนตร์ลามก	மோசமான திரைப்படங்கள்	porn movie
ภาพรวม	கண்ணோட்டம்	group of pictures
ภายหลัง	பிறகு	background
ภายหลังสงคราม	போருக்குப் பிறகு	after the war
ภายใต้ความช่วยเหลือจากกองทุนการเงินระหว่างประเทศ	சர்வதேச நாணய நிதியத்தின் உதவியுடன்	with the financial help, sponsored by
ภายในวงขอบเหรียญเบื้องบนมีข้อความว่า	நாணயத்தின் மேற்புறத்தில் ஒரு அறிக்கை உள்ளது	etching in the medal that ______________
ภารกิจ	மிஷன்	business
ภาวะเศรษฐกิจของกัมพูชาหลังจากมีการเปลี่ยนแปลงการปกครองจากระบอบสังคมนิยมเป็นระบอบประชาธิปไตย	ஜனநாயக சோசலிசத்திலிருந்து ஜனநாயகத்திற்கு மாறிய பின்னர் கம்போடியாவின் பொருளாதார நிலைமைகள்	cambodia economy after political change
ภาษาญี่ปุ่น	ஜப்பானியர்கள்	japanese language
ภาษาบาลี	பாலி	balese language
ภาษาสเปน	ஸ்பானிஷ் மொழி	spanish language
ภาษาอังกฤษ	ஆங்கில மொழி	english language
ภาษาอีสาน	வடகிழக்கு மொழி	eastern thai language
ภาษาเกชัว	கெச்சுவா	quechua language
ภาษาเฉพาะอาชีพ	ஜர்கன்	jargon
ภาษาเบสิก	அடிப்படை	basic programming lauguage
ภาษาเยอรมัน	ஜெர்மன்	german language
ภาษาโคบอล	cobol	cobol programming language
ภิญโญ	பெருகிய முறையில்	pinyo - a female's name
ภิรมย์	மகிழ்ச்சி	philom
ภิรมย์ภักดี	ஃபிரோம் பக்தி	pirompakdee
ภูกระดึง	புக்ராதுங்	phu kradueng
ภูกามยาว	ஃபூ காம் யாவ்	phu kamyao district
ภูธเนศ	பூட்டானெட்	putanet - a male's name
ภูพาน	ஃபூ ஃபான்	phu phan
ภูมิประเทศและภูมิอากาศ	நிலப்பரப்பு மற்றும் காலநிலை	geography and climate
ภูมิภาค	பகுதி	region
ภูมิรัตน์	பூமிரத்	poomirath
ภูหลวง	ஃபூ லுவாங்	phu luang
ภูเขา	மலை	mountain
ภูเขาน้ำแข็ง	பனிப்பாறை	glacier
ภู่สว่าง	ஃபூ சவாங்	poosawang - a surname
ม	மீ	a thai alphabet with an 'm' sound
มกราคม	ஜனவரி	january
มจก	எம்	the most illustrious order of the royal house of chakri
มณฑลหูหนาน	ஹுனன்	hunan in china
มณีวรรณ	மணிவன்	maniwan
มด	எறும்பு	ant
มดลูก	கருப்பை	uterus
มต้น	தொடங்குங்கள்	primary level of secondary school
มธ	tu	abbreviation for thammasat university
มธรรมศาสตร์	தம்மசாத் பல்கலைக்கழகம்	thammasat university
มน	சுற்று	two letters acronym
มนุษย์	ஆண்	human
มนุษย์กลายพันธุ์	விகாரி	human mutant
มนเรศวร	நரேசுவான்	naresuan university
มปท	என்.பி.எஸ்	acronyms
มม	எம்.எம்	mm
มมหิดล	மஹிடோல் பல்கலைக்கழகம்	mahidol university
มยุรา	மயில்	mayura - a female's name
มลายู	மலாய்	malayu
มวยปล้ำ	மல்யுத்தம்	wrestling
มสงขลานครินทร์	சாங்க்லா இளவரசர்	prince of songkla university
มหัพภาค	ஒட்டுமொத்த	a symbol used in thai writing
มหาชน	பொது	public company
มหาชัย	மகாசாய்	mahachai - male's name
มหาบัณฑิต	குரு	graduates from college
มหาปรมาภรณ์ช้างเผือก	மஹா பரமபார்ன் சாங் ஃபியூக்	highest class of the order of white elephant
มหาวชิรมงกุฎ	மகாவாஜிரா கிரீடம்	the biggest crown of the king
มหาวรรค	மகா புத்தர்	mahavak - a buddhist priest
มหาวิทยาลัย	பல்கலைக்கழகம்	university
มหาวิทยาลัยขอนแก่น	கோன் கான் பல்கலைக்கழகம்	khon kaen university
มหาวิทยาลัยทักษิณ	தாக்சின் பல்கலைக்கழகம்	thaksin university
มหาวิทยาลัยนเรศวร	நரேசுவான் பல்கலைக்கழகம்	naresuan university
มหาวิทยาลัยบูรพา	புராஃபா பல்கலைக்கழகம்	university
มหาวิทยาลัยปทุมธานี	பதும் தானி பல்கலைக்கழகம்	pathumthani university
มหาวิทยาลัยพะเยา	பயோ பல்கலைக்கழகம்	prayao university
มหาวิทยาลัยภูมินทร์พนมเปญ	ஃபுமின் பல்கலைக்கழகம், புனோம் பென்	university of phnom penh
มหาวิทยาลัยมหาจุฬาลงกรณราชวิทยาลัย	மகாச்சுலலாங்கொர்ன்ராஜாவித்யாலயா பல்கலைக்கழகம்	chulalongkorn university
มหาวิทยาลัยมหาสารคาม	மகா சாரகம் பல்கலைக்கழகம்	mahasarakham university
มหาวิทยาลัยมหิดล	மஹிடோல் பல்கலைக்கழகம்	mahidol university
มหาวิทยาลัยรังสิต	ரங்சிட் பல்கலைக்கழகம்	rangsit university
มหาวิทยาลัยราชภัฏบ้านสมเด็จเจ้าพระยา	பன்சோம்தேஜ்சோபிரய ராஜபட் பல்கலைக்கழகம்	rajapak bahn somdej jao praya college
มหาวิทยาลัยราชภัฏสงขลา	சாங்ஹ்லா ராஜபட் பல்கலைக்கழகம்	songkhla rajabhat university
มหาวิทยาลัยราชภัฏสวนสุนันทา	சுவான் சுனந்தா ராஜபட் பல்கலைக்கழகம்	suan sunandha rajabhat university
มหาวิทยาลัยราชภัฏอุตรดิตถ์	உத்தரடித் ராஜபட் பல்கலைக்கழகம்	uttaradit rajabhat university
มหาวิทยาลัยราชภัฏเทพสตรี	தெப்சத்ரி ராஜபட் பல்கலைக்கழகம்	thepsatri rajabhat university
มหาวิทยาลัยราชภัฏเลย	லோய் ராஜபட் பல்கலைக்கழகம்	loei rajabhat university
มหาวิทยาลัยวงษ์ชวลิตกุล	வோங்சவாலிட்குன் பல்கலைக்கழகம்	vongchavalitkul university
มหาวิทยาลัยศรีนครินทรวิโรฒ	ஸ்ரீநாகரின்விரோட் பல்கலைக்கழகம்	srinakarinvirot university
มหาวิทยาลัยศรีปทุม	ஸ்ரீபதம் பல்கலைக்கழகம்	sripatum university
มหาวิทยาลัยศิลปากร	சில்பாகார்ன் பல்கலைக்கழகம்	silapakorn university
มหาวิทยาลัยสุโขทัยธรรมาธิราช	சுகோதாய் தமதிராத் திறந்த பல்கலைக்கழகம்	sukhothai thammathirat open university
มหาวิทยาลัยอีสาน	வடகிழக்கு பல்கலைக்கழகம்	issan univbersity
มหาวิทยาลัยอุบลราชธานี	உபோன் ராட்சதானி பல்கலைக்கழகம்	ubon ratchathani university
มหาวิทยาลัยอ๊อกซฟอร์ด	ஆக்ஸ்போர்டு பல்கலைக்கழகம்	university of oxford
มหาวิทยาลัยเกษตรศาสตร์	கசெட்சார்ட் பல்கலைக்கழகம்	kasetsart university
มหาวิทยาลัยเทคโนโลยีพระจอมเกล้าพระนครเหนือ	கிங் மோங்க்குட்டின் தொழில்நுட்ப பல்கலைக்கழகம் வடக்கு பாங்காக்	king mongkut's university of technology.
มหาวิทยาลัยเทคโนโลยีราชมงคลกรุงเทพ	ராஜமங்கள தொழில்நுட்ப பல்கலைக்கழகம் க்ருங்தேப்	rajamangala university of technology krungthep
มหาวิทยาลัยเทคโนโลยีราชมงคลตะวันออก	ராஜமங்கள தொழில்நுட்ப பல்கலைக்கழகம் தவான்-ஓகே	the eastern university of teachnology
มหาวิทยาลัยเทคโนโลยีราชมงคลธัญบุรี	ராஜமங்கள தொழில்நுட்ப பல்கலைக்கழகம் தன்யாபுரி	rajamangala university of technology thanyaburi
มหาวิทยาลัยเทคโนโลยีราชมงคลสุวรรณภูมิ	ராஜமங்கள தொழில்நுட்ப பல்கலைக்கழகம் சுவர்ணபூமி	techonology university at rajamongkolsuwannapoom
มหาวิทยาลัยเทคโนโลยีราชมงคลอีสาน	ராஜமங்கள தொழில்நுட்ப பல்கலைக்கழகம் இசான்	rajamangala university of technology isan
มหาวิทยาลัยเปิด	திறந்த பல்கலைக்கழகம்	open university
มหาวิทยาลัยแม่โจ้	மேஜோ பல்கலைக்கழகம்	mae joe university
มหาวิทยาลัยแห่งแรกของประเทศไทย	தாய்லாந்தின் முதல் பல்கலைக்கழகம்	first university of thailand
มองโกเลียใน	உள் மங்கோலியா	mongolia
มอร์ริส	மோரிஸ்	morris
มอส	பாசி	mos
มอสส์	பாசி	moss
มอหาดใหญ่	மோர் ஹாட் யாய்	had yai city in southern thailand
มะขาม	புளி	tamarind
มะม่วงหิมพานต์	முந்திரிப்பருப்பு	mango (anacardium occidentale)
มะริด	மெயிக்	myeik
มะเร็ง	புற்றுநோய்	cancer
มังกี้	குரங்கு	monkey
มังคุด	மாங்கோஸ்டீன்	mangosteen
มัจฉานุ	மாட்சா	majjanu - the son of the giant in a thai legend.  majanu is half monkey and half fish.
มัชฌิมาปฏิปทา	நடுத்தர பாதை	the middle way
มัทนะพาธา	முத்தனா பாத்தா	matthanaphatha
มัธยฐาน	சராசரி	mode (as in statistic)
มัธยมศึกษา	இடைநிலைக் கல்வி	junior high school
มัธยมศึกษาปีที่	தரம் 9	secondary school year
มันติคอร์	மன்டிகோர்	manticore
มัลเจร่า	மலேரா	wonderweiss margera - a cartoon character
มากกว่า	ஓவர்	more than
มากที่สุด	மிக அதிகம்	most abundant
มากิ	மக்கி	magi osuki - the artist
มาครอส	மேக்ரோஸ்	macross
มาจยาร์	மாயர்	magyar
มาจากภาษาละติน	லத்தீன் இருந்து	from latin root
มาซากิ	மசாகி	masaki
มาดริด	மாட்ரிட்	madrid
มาตรฐาน	தரநிலை	standard
มาตรา	பிரிவு	article
มานี	மணி	mani - a thai name
มายน์ส	சுரங்கங்கள்	mine
มาริสา	மரிசா	marissa
มาริเบล	மரிபெல்	maribel
มาร์ช	மார்ஷ்	march
มาร์ติน	மார்ட்டின்	martin
มาร์ตินีก	மார்டினிக்	martinique
มาร์แชล	மார்ஷல்	marshall
มาลัยพร	மலாய் ஆபாச	malaiphon
มาลากุล	மலாக்குல்	malakul
มาลี	மாலி	flower
มาสคาร่า	மஸ்காரா	mascara
มาเก๊า	மக்காவு	macao
มาเฟีย	மாஃபியா	mafia
มาเรีย	மரியா	maria
มาเลเซีย	மலேசியா	malaysia
มาเลเซียตะวันตก	மேற்கு மலேசியா	west malaysia
มิจิรุ	மிச்சிரு	mijiru
มิตร	நட்பாக	mitr
มิตรชัย	மிட்சாய்	mitchai
มิตรเพชรา	நட்பாக	mit pechara - two of famous actors in the old time
มิถุนายน	ஜூன்	june
มินต์	புதினா	mint
มิลจิ	மில்ஜி	mulji
มิลตัน	மில்டன்	milton
มิลฟีโอเล่	மில்ஃபி ஓலே	millefiore
มิลลิเมตร	மிமீ.	millimeter
มิลินทจินดา	மிலிந்திந்தா	milinjinda - a surname of a singer
มิล่า	மிலா	mila
มิว	மியூ	mu
มิวฟิลโอเล่	மியூல் பில் ஓலே	millefiore
มิวสิกวีดีโอ	இசை வீடியோ	music video
มิสทีน	மிஸ்டின்	mistine
มิฮอว์ค	மிஹாக்	mihawk - surname of a character in a japanese movie
มิเกล	மிகுவல்	miguel
มิเชล	மைக்கேல்	michelle
มิเตอร์	மீட்டர்	meter
มิโร	மிரோ	miro - name
มีขนาดใหญ่	பெரியது	big
มีข้อความว่า	லேபிளிடப்பட்டது	inscription reads
มีความยาว	ஒரு நீளம் வேண்டும்	has length of
มีความหมายว่า	பொருள்	meaning
มีจำนวน	ஒரு எண்ணை வைத்திருங்கள்	have the amount of
มีฉายาว่า	புனைப்பெயருடன்	famous for...
มีชื่อว่า	பெயரிடப்பட்டது	is called
มีชื่อเล่นว่า	புனைப்பெயர்	nick name
มีด	ஒரு கத்தி	knife
มีดาบฟันวิญญาณ	ஆவி வாளால்	have a sword to fight the ghost
มีทั้งสิ้น	அனைத்தும்	own, available
มีทิวเขาล้อมรอบทางเหนือ	வடக்கில் மலைத்தொடர்களுடன்	surrounded by the mountains in the north
มีน	குறைந்தபட்சம்	min - a nick name
มีนบุรี	மின் பூரி	minburi province
มีนวิทยา	மினாலஜி	ichthyology
มีนายกรัฐมนตรี	பிரதம மந்திரி	have a prime minister
มีประวัติศาสตร์ยาวนาน	நீண்ட வரலாறு உண்டு	having a long history
มีพรมแดนทางทิศใต้จรดกับอ่าวไทย	தெற்கே தாய்லாந்து வளைகுடாவால் எல்லை	having boundaries adjacent to the gulf of thailand
มีภูเขาล้อมรอบอยู่	மலைகளால் சூழப்பட்டுள்ளது	surrounded by mountains
มีลักษณะดังนี้	பின்வரும் பண்புகள் உள்ளன	has following characteristics
มีลักษณะภูมิประเทศคล้ายชามหรืออ่าง	ஒரு கிண்ணம் அல்லது பேசின் போன்ற அம்சங்களைக் கொண்டுள்ளது	have topography like bowl or basin
มีลาภ	ஒரு அதிர்ஷ்டம் வேண்டும்	milap
มีล่า	வேட்டையாடுங்கள்	mila
มีสูตรการคำนวณหาจำนวนฟัน	பற்களின் எண்ணிக்கையை கணக்கிட ஒரு சூத்திரம் உள்ளது.	dental formula
มีอยู่	உள்ளது	possess, present
มีอุณหภูมิเฉลี่ย	சராசரி வெப்பநிலை	average temperature
มีอุทยานแห่งชาติสำคัญหลายแห่ง	பல முக்கியமான தேசிய பூங்காக்கள் உள்ளன.	has many important national parks
มีเดีย	மீடியா	media
มีโคลซีน	கோல் காட்சியுடன்	meclozine
มือ	கை	hand
มู	மென்மையான	mu
มูลนิธิชัยพัฒนา	சாய்பட்டனா அறக்கட்டளை	chaipattana foundation
มูลนิธิอานันทมหิดล	ஆனந்தமஹிடோல் அறக்கட்டளை	the king's charities
มูลสาร	அடிப்படைகள்	munsan
มเชียงใหม่	சியங் மாய்	chaing mai university
มโนราห์	மனோஹ்ரா	thai dance art
ม้า	குதிரை	horse
ม้าม	மண்ணீரல்	spleen
ย	தி	a thai alphabet with the y sound
ยกเว้น	தவிர	except
ยศ	ரேங்க்	rank
ยอด	உயரடுக்கு	super, great
ยอดนักสืบจิ๋วโคนัน	துப்பறியும் கோனன்	conan the detective
ยอดเขาสูงที่สุดของกัมพูชาคือ	கம்போடியாவின் மிக உயர்ந்த சிகரம்	highest mountain in cambodia
ยอพระกลิ่น	யோர் ஃபிரா கிளின்	yorpaglin - name of a story
ยัง	க்கு	young
ยาขับปัสสาวะ	டையூரிடிக்	diuretic pills
ยาง	ரப்பர்	rubber, tire
ยางธรรมชาติ	இயற்கை ரப்பர்	natural rubber
ยางามิ	யாகமி	yangami
ยานอนหลับ	உறக்க மாத்திரைகள்	sleeping pills
ยานอวกาศ	விண்வெளி கப்பல்	rocket ship
ยาบ้า	ஆம்பெடமைன்	ya ba
ยาปฏิชีวนะ	நுண்ணுயிர் எதிர்ப்பிகள்	antibiotic
ยามาโตะ	யமடோ	yamato - a japanese name
ยามาโมโตะ	யமமோட்டோ	yamamoto
ยามเย็น	சாயங்காலம்	sundown, evening time
ยิ่งยง	யிங்யோங்	yingyong - a first name
ยิ่งลักษณ์	யிங்லக்	yingluck
ยิ้มสู้	புன்னகை	smile fight
ยีน	மரபணு	gene
ยืนยง	தாங்க	(inthira) yeenyong - lead singer of budogun band
ยุคกลาง	நடுத்தர வயது	middle age
ยุคก่อนประวัติศาสตร์	வரலாற்றுக்கு முந்தைய சகாப்தம்	prehistory
ยุคที่	சகாப்தம்	age
ยุคปัจจุบัน	நவீன காலத்தில்	present age
ยุคศตวรรษที่	நூற்றாண்டு சகாப்தம்	century
ยุคสามก๊ก	மூன்று ராஜ்யங்கள் சகாப்தம்	three kingdoms - the legend
ยุคอะซึกะ	அசுகா சகாப்தம்	asuka period
ยุคอาณาจักรเหนือใต้	வடக்கு மற்றும் தெற்கு இராச்சியம் சகாப்தம்	north-south dynasty
ยุคเรเนสซองส์	மறுமலர்ச்சி சகாப்தம்	renaissance
ยุคเฮอัง	ஹியான் சகாப்தம்	heian period of japan
ยุคโบราณ	பண்டைய காலங்கள்	ancient history
ยุคโลหะ	உலோக வயது	metal age
ยุคใหม่	புதிய காலம்	new age
ยุทธนาวี	கடற்படை போர்	naval battle
ยุวธิดา	இளம் மகள்	yuwatidah
ยุ้ย	மிகைப்படுத்தப்பட்ட	yui
ยู	யு	u
ยูกิโอ	யுகியோ	yu-gi-oh
ยูฟ่า	யுஃபா	uefa
ยูริ	யூரி	yuri -  a japanese name
ยูโด	ஜூடோ	judo
ยูโรเพียม	யூரோபியம்	europium
ยูไนเต็ด	யுனைடெட்	united
ย่านตาขาว	யான் காவ்	yan ta khao
รณชัย	ரொனாச்சாய்	ronnachai
รณภพ	உலகம்	ronapop
รณฤทธิ์	போர்	ranariddh
รถด่วนสายทางช้างเผือก	பால்வெளி எக்ஸ்பிரஸ் பஸ்	galactic express
รถประจำทางสาย	பஸ் பாதை	bus number
รถยนต์อเนกประสงค์	பல்நோக்கு கார்	automobile
รถลาก	ரிக்‌ஷா	pulled rickshaw
รถโดยสารประจำทาง	பேருந்து	passenger bus
รถโดยสารประจำทางสาย	பஸ் பாதை	bus
รถไฟฟ้าชานเมืองสายสีแดงอ่อน	சிவப்பு ஒளி புறநகர்	rapid transit light red line
รถไฟฟ้ามหานคร	எம்.ஆர்.டி.	metropolitan rapid transit
รฟม	ஆர்.ஓ.	public transit
รวดเร็ว	வேகமாக	rapid
รวม	சேர்க்க	total
รวมกับ	உடன் இணைந்த	add to
รวมทั้ง	உட்பட	include
รวมทั้งประเทศที่ให้ความช่วยเหลืออื่นๆ	பிற உதவிகளை வழங்கும் நாடுகள் உட்பட	the countries that provided helps
รวมทั้งสิ้น	மொத்தம்	result
รวมระยะทางทั้งสิ้น	மொத்த தூரம்	total distance
รศ	இணை	ratanakosin era
รหัส	குறியீடு	code
รอก	ரீல்	roack
รองประธานรัฐสภาคนที่หนึ่ง	பாராளுமன்றத்தின் முதல் துணைத் தலைவர்	an assistant head of a thai governmental committee
รองประธานสภาคนที่สอง	சபையின் இரண்டாவது துணைத் தலைவர்	second vice chairman
รองเท้า	காலணிகள்	shoes
รอญับ	காத்திரு	seventh month of the hijra calendar
รอบ	சுற்றி	surrounding
รอบคอบ	கவனமாக	careful
รอบชิงชนะเลิศระดับประเทศ	தேசிய இறுதிப் போட்டிகள்	national final round
รอบที่	சுற்று	round
รอบเมือง	நகரத்தை சுற்றி	around town
ระดับกระโดดสูง	உயரம் தாண்டுதல்	high jump  height
ระดับการกระโดดสูง	உயரம் தாண்டுதல்	high jump
ระดับปริญญาเอก	பிஎச்டி நிலை	doctorate degree level
ระดับปริญญาโท	முதுகலை பட்டம்	master's degree
ระดับมัธยมศึกษา	இரண்டாம் நிலை	middle school level
ระดับอาชีวศึกษา	தொழில் நிலை	vocational education
ระนอง	ரனோங்	ranong
ระนาด	xylophone	ranad - a thai musical instrument
ระนาดทุ้ม	ஆல்டோ சைலோபோன்	a type of thai musical instrument
ระนาดเอก	ஆல்டோ	ranad eg -  a thai musical instrument
ระบบ	அமைப்பு	system
ระบบกษัตริย์ของกัมพูชา	கம்போடிய முடியாட்சி	cambodian monarchy
ระบบรัฐสภา	பாராளுமன்ற அமைப்பு	rajya sabha system of governing
ระบบสืบพันธุ์	இனப்பெருக்க அமைப்பு	reproductive system
ระบบสุริยะ	சூரிய குடும்பம்	solar system
ระบบโครงกระดูก	எலும்புக்கூடு அமைப்பு	skeletal system
ระบบใช้อำนาจเด็ดขาด	முழுமையான சக்தி அமைப்பு	despotism
ระยะ	கட்டம்	phase
ระยะเวลา	காலம்	period
ระยะเวลาการดำรงตำแหน่ง	சேவை காலம்	the term in the office
ระวิ	இடையில்	rawi
ระหว่างปี	வருடத்தின் போது	between the year
ระหว่างสงครามโลกครั้งที่	உலகப் போரின் போது	during wold war
ระเบียง	பால்கனியில்	bhirasri
ระเบียบ	ஆர்டர்	regulation
ระโนด	இறந்தவர்	ranode (name of district in thailand)
รักษาศีล	கட்டளைகளைக் கவனியுங்கள்	keep the precepts
รักษาสิ่งแวดล้อม	சுற்றுச்சூழலைப் பாதுகாக்கவும்	protect the environment
รักแห่งสยาม	சியாமின் காதல்	love thailand
รังสิตคลอง	ரங்சித் க்ளோங்	rangsit canal
รังสี	கதிர்	radiation
รังสีเอกซ์	எக்ஸ்ரே	xray
รังสีแกมมา	காமா கதிர்	gamma ray
รัชกาลที่	ஆட்சி	rama
รัชกาลสมเด็จพระจุลจอมเกล้าเจ้าอยู่หัว	மன்னர் சுலலாங்கொர்னின் ஆட்சி	king chula chomklao's reign
รัชดาภิเษก	ராட்சதாபிசெக்	rajada pisek - a location in thailand
รัฐธรรมนูญแห่งราชอาณาจักรไทย	தாய்லாந்து இராச்சியத்தின் அரசியலமைப்பு	constitution of the kingdom of thailand
รัฐบาลไทย	தாய் அரசு	thai government
รัฐบุรุษ	அரசியல்வாதி	statesman
รัฐประหาร	சதி	coup d'état
รัฐประหารในประเทศไทย	தாய்லாந்தில் சதி	thailand's coup d'état
รัฐมนตรีว่าการกระทรวงคมนาคม	போக்குவரத்து அமைச்சர்	transportation secretary of thailand
รัฐวิสาหกิจ	மாநில நிறுவனம்	financial situation of the country
รัฐวิสาหกิจไทย	தாய் அரசு நிறுவனங்கள்	thai state enterprise
รัฐสภา	பாராளுமன்றம்	parliament
รัฐสีมาคุณากรปิยชาติ	ரத்தசிமா குனகோர்ன்பியாச்சட்	ratthasimakhunakonpiyachat
รัฐอิลลินอยส์	இல்லினாய்ஸ்	state of illinois
รัฐเทกซัส	டெக்சாஸ்	state of texas
รัตนบุรี	ரத்தனபுரி	ratanaburi district - a location in thailand
รัตนาธิเบศร์	ரத்தநாதிபேட்	ratana thibet
รับบทโดย	நடித்தார்	played by
รับพระราชทาน	ஏற்றுக்கொள்	receive
รัศมี	ஆரம்	radius
รัสเซล	ரஸ்ஸல்	russell
รากแก่น	கோர் ரூட்	rakkan
รางวัลนักร้องยอดเยี่ยม	சிறந்த பாடகர் விருது	best singer award
รางวัลนักร้องไทยสากลชายยอดนิยม	பிரபலமான ஆண் தாய் சர்வதேச பாடகர் விருது	best thai male singer award
รางวัลนาฏราช	ராயல் டான்சர் விருதுகள்	naktarath prize
รางวัลโนเบล	நோபல் பரிசு	nobel prize
รางวัลไนน์เอ็นเตอร์เทน	ஒன்பது பொழுதுபோக்கு விருது	nine entertain awards
ราชตระกูล	அரச குடும்பம்	royal family
ราชนาวี	கடற்படை	royal navy
ราชมังคลากีฬาสถาน	ராஜமங்கள ஸ்டேடியம்	rajamangala national stadium
ราชวงศ์จิ้นตะวันออก	கிழக்கு ஜின் வம்சம்	east jin dynasty
ราชวงศ์ชิง	குயிங் வம்சம்	ching dynasty
ราชวงศ์ถัง	டாங் வம்சம்	tang dynasty
ราชวงศ์ทิพย์จักราธิวงศ์	அரச குடும்பம், சக்ரதிவாங்	thipjaklatiwong dynasty
ราชวงศ์บ้านพลูหลวง	ராயல் ஹவுஸ் ஆஃப் ப்ளூ லுவாங்	ban phlu luang dynasty
ราชวงศ์พระร่วง	ஃபிரா ருவாங் வம்சம்	pra roung dynasty
ราชวงศ์หยวน	யுவான் வம்சம்	yuan dynasty
ราชวงศ์อู่ทอง	யு-தாங் வம்சம்	utong empire in ancient thailand
ราชสกุล	டோக்கன்கள்	royal family members
ราชสีมา	ராட்சாசிமா	ratchasima
ราชินิกุล	ராணியின் உறவினர்கள்	relatives of the queen
ราบเป็นหน้ากลอง	தெளிவாக இருங்கள்	flattened like a drum (meaning to be defeated)
รามอินทรา	ராமிந்திரா	ram inthra
รายการ	பட்டியல்	show
รายการวันสำคัญทางพุทธศาสนา	முக்கியமான புத்த தேதிகளின் பட்டியல்	important days in buddhism
รายชื่อ	பட்டியல்	list of the names
รายชื่อคำในภาษาไทยที่มักเขียนผิด	பெரும்பாலும் தவறாக எழுதப்பட்ட தாய் சொற்களின் பட்டியல்	common misspelled thai words
รายชื่อภาพยนตร์ไทย	தாய் திரைப்படங்களின் பட்டியல்	a list of thai movies
รายชื่อหุ่นยนต์ใน	இல் ரோபோக்களின் பட்டியல்	name of robots
รายชื่ออธิการบดี	அதிபர்களின் பட்டியல்	list of presidents
รายชื่อเพลง	பாடல்களின் பட்டியல்	songs list
รายนามรองอธิการประจำวิทยาเขต	வளாகத்தில் துணைவேந்தர்களின் பெயர் பட்டியல்	llist of deputy directors of the college
รายนามอธิการบดี	ஜனாதிபதியின் பட்டியல்	chancellor list
รายพระนามพระมหากษัตริย์ไทย	தாய் மன்னர்களின் பட்டியல்	list of thai monarchs
รายะนาค	ராயா நக்	rayanak
รายได้อื่น	வேறு வருமானம்	other wages, incomes
ราวพุทธศตวรรษที่	சுமார் நூற்றாண்டு	about buddhist era
ราศีธนู	தனுசு	sagittarius
รำพันพิลาป	அலறல்	poem called rum pan pi lab
ริน	ஊற்றவும்	rin
ริมแม่น้ำเจ้าพระยา	ரிவர்சைடு சாவோ ஃபிராயா நதி	near chao praya river
ริวซากิ	ரியுசாகி	riusaki - from japanese story
ริเอะ	rie	rie tanaga - a japanese singer
รีสอร์ท	ஒரு ரிசார்ட்	resort
รีเนียม	அரிமம்	rhenium
รุจิพรรณ	ருஜிபன்	pan - a name
รุ่ง	விடியல்	dawn
รุ่งสว่าง	விடியல்	rungsawang
รุ่งเพชร	ரங் பெட்ச்	roongpetch - a female's name
รูดอล์ฟ	ருடால்ப்	rudolf
รูทีเนียม	ருத்தேனியம்	ruthenium
รูปภาพ	படம்	picture
รูปร่าง	வடிவம்	body
รูปวรรณยุกต์	டோனல் வடிவம்	tones
รูปสามเหลี่ยมมุมป้าน	முக்கோணத்தைத் தடுக்கவும்	obtuse
รูปสี่เหลี่ยมด้านขนาน	இணைகரம்	a paralellogram
รูสเวลต์	ரூஸ்வெல்ட்	roosevelt
ร็อดฟอร์ม	ராட் படிவம்	rock form
ร่วมแสดงกับ	உடன் செய்யுங்கள்	costarring
ร้องคู่กับ	உடன் சேர்ந்து பாடுங்கள்	sing a duet with
ร้องร่วมกับ	உடன் பாடுங்கள்	featuring
ร้องโดย	பாடியது	sung by
ร้อยตรี	இரண்டாவது லெப்டினன்ட்	second lieutenant
ร้านอาหาร	ஒரு உணவகம்	restaurants
ฤดูกาล	பருவம்	season
ฤดูฝน	மழைக்காலம்	rainy season
ฤดูร้อน	சூடான பருவம்	summer
ล	தி	a thai alphabet with an l sound
ลงวันที่	தேதியிட்டது	on this date
ลพบุรี	லாப் பூரி	lopburi
ลอนดอน	லண்டன்	london
ลอยกระทง	லோய் க்ராடோங் விழா	loy kratong festival
ลอร์ด	ஆண்டவர்	lord
ละคร	நாடகம்	play
ละครชาตรี	சத்ரி நாடகம்	lakorn-chatri
ละครวิทยุ	வானொலி நாடகம்	soap opera broadcasted on the radio
ละครสั้น	குறும்படம்	short drama
ละครเพลง	இசை	stage musical theatre
ละครโทรทัศน์	சோப் ஓபரா	television drama
ละติจูด	அட்சரேகை	latitude
ลักษณะ	பாருங்கள்	characteristic
ลักษณะทั่วไป	பொதுவான பண்புகள்	common characteristic
ลักษณะทางกายภาพ	உடல் பண்புகள்	physical characteristics
ลักษณะภูมิอากาศ	காலநிலை	the type of climate
ลักษณะสำคัญ	முக்கிய பண்புகள்	main characteristics
ลักเซมเบิร์ก	லக்சம்பர்க்	luxembourg
ลัคนา	ஏற்றம்	ascendant
ลา	லா	goodbye
ลานจาตุรงคสันนิบาต	நால்வர்	lan jaturonsunnibat - an ancient place in india
ลามิวูดีน	லாமிவுடின்	lamivudine
ลายน้ำ	வாட்டர்மார்க்	watetmark
ลาว	லாவோஸ்	lao
ลาออก	ராஜினாமா	resign
ลำดับ	ஆர்டர்	order, sequence
ลำดับพระปฐมวงศ์ในพระบรมราชวงศ์จักรี	சக்ரி வம்சத்தில் ஆதியாகமத்தின் ஆணை	order of the kings
ลำดับพระมหากษัตริย์ไทย	தாய் மன்னரின் ஆணை	the order of the kings of thailand
ลำตัว	தண்டு	body
ลำลูกกา	லாம் லுக் கா	lumlookka - a location in thailand
ลำลูกกาคลอง	லாம் லுக் கா கால்வாய்	lum luk kak klong
ลำไส้เล็ก	சிறு குடல்	small intestine
ลิง	குரங்கு	monkey
ลิซท์	லிஸ்ட்	(franz) liszt
ลิปปี	உதடு ஆண்டு	rippi - a surname
ลิพิด	கொழுமியம்	lipid
ลิฟวิ่งมอลล์	லிவிங் மால்	living mall
ลิเก	இசை நாட்டுப்புற நாடகம்	like
ลิเทียม	லித்தியம்	lithium
ลีกคัพ	லீக் கோப்பை	league cup
ลีซอ	லிசு	lisu
ลีเมอร์	லெமூர்	lemur
ลี้	li	lee, a district in lumpoon province.
ลี้สุวรรณ	லி சுவான்	lisuwan
ลุงบุญมีระลึกชาติ	மாமா பூன்மீ நினைவுகூரும் தேசம்	uncle boonmee who can recall his past lives
ลูกปัด	மணி	beads
ลูกสาว	மகள்	daughter
ลูกอม	மிட்டாய்	candies
ลูกอัณฑะ	விந்தணுக்கள்	testis
ลูซิเฟอร์	லூசிபர்	lucifer
ลูน่า	லூனா	luna
ล่าทา	வேட்டை	lata
ล่ำซำ	கட்டை	lumsum
ล้อม	சுற்றி	lom
ล้อแม็กซ์อัลลอยขนาด	அலாய் வீல் அளவுகள்	alloy wheel
วง	வளைய	band
วงจรไฟฟ้า	மின் சுற்று	electrical circuit
วงดนตรี	பேண்ட்	band
วงศ์กำแหง	குடும்பம்	wongkumhang - surname of a famous singer
วงศ์ถั่ว	நட்டு குடும்பம்	fabaceae
วงศ์ปลากดทะเล	மீன் குடும்பம்	ariidae
วงศ์ปลากะรัง	குழு	serranidae family
วงศ์ปลายอดม่วง	வோங் ப்ளா யோட் முவாங்	tonguefish
วงศ์ปลาหลังเขียว	பச்சை மீன்	clupeidae - a type of fish
วงศ์ปลาเนื้ออ่อน	சிச்லிட்	siluridae
วงศ์ปลาเสือตอ	புலி மீன் குடும்பம்	datnioididae
วงศ์พัวพันธ์	வோங்புவா ஃபான்	wongpourpan
วงศ์วิริยะ	விரியா	vongsiriya - a surname
วงศ์เทวัญ	குடும்பம்	wongthewan
วงศ์แคหางค่าง	வோங் கே ஹாங்காங்	plants in kae-hang-kang family
วงษ์คำเหลา	வோங் காம் லாவோ	wongkamlao
วงเงิน	அளவு	budget
วงเวียน	ரவுண்டானா	circle
วงแหวน	மோதிரம்	ring form, circle form
วชิรบรรจง	வச்சிரபுன்ஜோங்	wachibanjong
วทบ	dd	bachelor of science
วนอุทยานถ้ำจัน	தாம் சான் வன பூங்கா	tham chan forest park
วนิดา	வனிடா	wanida - the name of a drama
วร	வோர்	won
วรรณกรรม	இலக்கியம்	literature
วรรณสุทธิ์	வான்சுட்	wannasut - surname of an actress
วรรธนพิสิฐกุล	வாத்தன் பிசிட்குன்	wanthanaphisitkun
วรัทยา	வார்த்யா	varattaya (first name)
วว	dd	office of ____________
วอก	குரங்கு	wok
วองโกเล่แฟมิลี	வோங்கோலா குடும்பம்	vongola family
วอชิงตัน	வாஷிங்டன்	washington
วอลท์	வால்ட்	walt
วอล์ค	நட	walk
วะสี	நானா	wasee
วัง	அரண்மனை	palace
วังจันทร์	வாங் சான்	wang-chan
วังสระปทุม	ஸ்ரா பதும் அரண்மனை	srapathum palace
วังสะพุง	வாங் சபுங்	wang saphung
วังหลัง	அரண்மனை	wang lang
วังหิน	கல் அரண்மனை	rock castle
วัชรพล	வாட்சரபோல்	watcharapol supermarket
วัฒนชัย	வத்தனாச்சாய்	wattanachai - a surname
วัฒนธรรม	கலாச்சாரம்	culture
วัฒนวิทูกูร	வட்டனாவிட்குன்	watthanawithukun
วัฒนา	வட்டனா	wattana
วัดกลาง	நடுத்தர கோயில்	wat klang
วัดป่าเลไลยก์วรวิหาร	வாட் பா லெலை வோராவிஹான்	wat palaylay
วัดพระธาตุดอยสุเทพราชวรวิหาร	வாட் ஃபிரா தட் டோய் சுதேப், ராட்சவோரவிஹான்	wat pratatdoisuthep rachavoravihan - the temple erected on top of doi suthep in northern thailand
วัดพระฝางสวางคบุรีมุนีนาถ	வாட் ஃபிரா ஃபாங் சங்கபூரி முனினாட்	prhafangsawangkaburimuninat temple
วัดพระมหาธาตุวรมหาวิหาร	வாட் ஃபிர மகாதத் வோரமஹவிஹார்ன்	wat phramahathat woramahawihan
วัดพระยืนพุทธบาทยุคล	வாட் ஃபிரா யுயென் புத்தாயகோன்	the standing buddha temple of puttabatyukol
วัดพระลอย	ஃபிரா லோய் கோயில்	wat phra loi
วัดพระศรีรัตนมหาธาตุ	வாட் ஃபிரா சி ரத்தனா மகாதத்	wat phra si rattana mahathat
วัดพระเชตุพนวิมลมังคลารามราชวรมหาวิหาร	வாட் ஃபிரா சேதுபோன் விமோல்மாங்லாராரம் ராட்சவோரமஹவிஹான்	wat pra chetpnvimolmungklaramrajavoramahavihan
วัดระฆังโฆสิตาราม	ராகங்க்கோசரம் கோயில்	wat rakang kositaram (name of temple)
วัดสองพี่น้อง	பாடல் ஃபை நோங் கோயில்	two siblings temple
วัดสุทัศนเทพวรารามราชวรมหาวิหาร	சுதாசன் தேப் வாரரம் கோயில்	wat sutatthepvararamrajavorimahavihan - a temple in thailand
วัดหนองเพียร	நோங் பியான் கோயில்	wat nong pien - a temple in thailand
วัดหน้าพระธาตุ	நா ஃபிரா அந்த கோயில்	wat na pra tat - a buddhist temple
วัดเจดีย์หลวง	சேடி லுவாங் கோயில்	wat pagoda
วัดโพธิ์	வாட் ஃபோ	wat po - a thai temple
วัตต์	வாட்	watt
วัตสัน	வாட்சன்	watson
วัน	நாள்	day
วันชัย	வஞ்சாய்	wanchai - a male's name
วันที่ขึ้นเครื่องหมาย	கையொப்ப தேதி	excluding dividend day
วันที่ออกอากาศชื่อตอนแขกรับเชิญ	ஒளிபரப்பு தேதி, அத்தியாயத்தின் பெயர், விருந்தினர் தோற்றம்	when the invitation comes out
วันที่เข้าฉาย	வெளிவரும் தேதி	release date
วันนี้ที่รอคอย	இன்று காத்திருக்கிறது	the day that one has been waiting for
วันพฤหัสบดี	வியாழக்கிழமை	thursday
วันพุธ	புதன்கிழமை	wednesday
วันมหาสงกรานต์	மகா பாடல் நாள்	songkran day
วันละ	ஒரு நாள்	per day
วันศุกร์	வெள்ளி	friday
วันสงกรานต์	பாடல் நாள்	songkran day
วันสำคัญ	முக்கிய நாள்	important day
วันสำคัญทางพุทธศาสนา	முக்கியமான ப day த்த தினம்	buddhist holidays
วันหยุดราชการ	பொது விடுமுறை	national holiday
วันอังคาร	செவ்வாய்	tuesday
วันอาทิตย์	ஞாயிற்றுக்கிழமை	sunday
วันอาสาฬหบูชา	அசன்ஹா புச்சா	asalha puja
วันเกิด	பிறந்த நாள்	birthday
วันเสาร์	சனிக்கிழமை	saturday
วันแรม	நாள்	the phase of the moon
วัย	வயது	age
วัลลิโภดม	வாலிஃபோடோம்	wanliphodom
วัสดุฟิสไซล์	பிளவு பொருள்	fissile material
วานูอาตู	வனடு	vanuatu, australia
วารินชำราบ	வாரின்சாம்ராப்	warinchamrap
วาลคิรี	வால்கெய்ரி	valkyrie - angel that helped in valhalla war
วาลีน	வாலின்	valine - a type of protein
วาเรีย	வரியா	varia
วาเลนไทน์	காதலர்	valentine
วาไรตี้	வெரைட்டி	variety
วิกตอร์	விக்டர்	victor
วิคตอเรีย	விக்டோரியா	victoria
วิจัย	ஆராய்ச்சி	investigate, study
วิจิตรศิลป์	நுண்கலைகள்	fine art
วิชาการ	கல்வி	academic
วิชาการคอม	கல்வி கணினி	vcharkarn.com
วิชิต	விசிட்	wichit - a male's name
วิญญาณ	ஆவி	soul
วิฑูรย์	lapis lazuli	witoon
วิดีโอเกม	வீடியோ கேம்	video game
วิตามินอี	வைட்டமின் ஈ	vitamin e
วิทยาการคอมพิวเตอร์	கணினி அறிவியல்	computer courses
วิทยาการระบาด	தொற்றுநோய்	epidemiology
วิทยาลัยการจัดการเพื่อการพัฒนา	மேம்பாட்டு மேலாண்மை கல்லூரி	management for development college
วิทยาลัยการบริหารรัฐกิจ	பொது நிர்வாகக் கல்லூரி	management college
วิทยาลัยครูสวนสุนันทา	சுவான் சுனந்தா ஆசிரியர் கல்லூரி	soun sunanta teachers college
วิทยาลัยดุริยางคศิลป์	இசைக் கல்லூரி	college of music
วิทยาลัยนวัตกรรมและการจัดการ	கண்டுபிடிப்பு மற்றும் மேலாண்மை கல்லூரி	the college specialized in arts
วิทยาลัยพยาบาลกองทัพเรือ	கடற்படை நர்சிங் கல்லூரி	royal thai navy college of nursing
วิทยาลัยพยาบาลบรมราชชนนี	போரோமராஜோனனி நர்சிங் கல்லூரி	nursing university of barom raj chonnani
วิทยาลัยพาณิชยศาสตร์	வணிகக் கல்லூரி	panitsat university
วิทยาลัยวิชาการศึกษา	கல்வி கல்லூரி	college of education
วิทยาลัยเทคนิคธนบุรี	தோன்பூரி தொழில்நுட்பக் கல்லூரி	king mongkut's university of technology thonburi
วิทยาลัยแพทยศาสตร์พระมงกุฎเกล้า	ஃபிரமோங்க்குட்க்லாவ் மருத்துவக் கல்லூரி	phramongkutklao college of medicine
วิทยาศาสตรมหาบัณฑิต	அறிவியல் மாஸ்டர்	master of science
วิทยาศาสตร์สุขภาพ	உடல் நல அறிவியல்	health science
วิทยาศาสตร์และเทคโนโลยี	அறிவியல் மற்றும் தொழில்நுட்பம்	science and technology
วิทยาเขต	வளாகம்	campus
วิทยาเขตกาญจนบุรี	காஞ்சனபுரி வளாகம்	kanchanaburi college
วิทยาเขตนครศรีธรรมราช	நகோன் சி தம்மரத் வளாகம்	nakhon si thammarat campus
วิทยาเขตพิษณุโลก	பிட்சானுலோக் வளாகம்	pissanulok college
วิทยาเขตสารสนเทศเพชรบุรี	பெட்சபுரி தகவல் தொழில்நுட்ப வளாகம்	information technology college of petchaburi
วิทยาเขตสุพรรณบุรี	சுபன்பூரி வளாகம்	suphanburi campus
วิทยาเขตสุรินทร์	சுரின் வளாகம்	surin university
วิทยาเขตหนองคาย	நோங் கை வளாகம்	nong kai university
วิทยาเขตเฉลิมพระเกียรติ	சலோம் ஃபிராகியாட் வளாகம்	vittaya kat chalerm pra kiet - a location at kasetsat university in thailand
วิทยุ	வானொலி	radio
วิธีการหาความสัมพันธ์	உறவுகளை எவ்வாறு கண்டுபிடிப்பது	formula for the correlation coefficient
วินชี	வின்சி	vinci
วินัย	ஒழுக்கம்	manners
วินเนอร์	வெற்றி	winner
วิบูลย์	பிரியாவிடை	wibul - a male's name
วิมเบิลดัน	விம்பிள்டன்	wimbledon
วิลลี่	வில்லி	willy
วิลเลจ	கிராமம்	village
วิลเลียม	வில்லியம்	williams
วิลเลี่ยม	வில்லியம்	william
วิวัฒนาการ	பரிணாமம்	evolution
วิวัฒน์	பரிணாமம்	produce, making up, invent
วิวัฒน์เกียรติ	விவாட் கியாட்	wiwatkiat
วิศว	பொறியியல்	engineering
วิศวกร	பொறியாளர்	engineer
วิศวกรรมวัสดุ	பொருள் பொறியியல்	material engineering
วิศวกรรมสิ่งแวดล้อม	சுற்று சூழல் பொறியியல்	environmental engineering
วิศวกรรมเครื่องกล	இயந்திர பொறியியல்	engineering
วิศวกรรมไฟฟ้า	மின் பொறியியல்	electrical engineering
วิสา	விசிசா	wisa
วิสูตร	நோய் கண்டறிதல்	wisut
วิหาร	சரணாலயம்	vihara
วิเศษ	மந்திரம்	wiset
วิเศษแก้ว	மேஜிக் கண்ணாடி	visetkeaw - surname of a singer
วิโนทัย	வினோதாய்	winothai
วีดีโอ	காணொளி	video
วีดีโอเกม	வீடியோ கேம்	video game
วีรบุรุษ	ஹீரோ	hero
วีระ	வீர	veera
วีระยุทธ	விராயுத்	werayut - a male's name
วีออส	வயோஸ்	vios
วุฒิสภา	செனட்	senate
วุฒิเมธี	வுடிமேதி	wuttimethi - a surname
ว้าวุ่น	திசைதிருப்பப்பட்டது	wawun
ศ	பேராசிரியர்	a thai alphabet
ศร	அம்பு	arrow
ศรชัย	சோர்ன்சாய்	sornchai - a male's name
ศรายุทธ	சரயுத்	sarayut - a male's name
ศรีนครินทร์	ஸ்ரீநாகரின்	srinakarin
ศรีนวล	ஸ்ரீனுவல்	sinuan
ศรีบุญเรือง	ஸ்ரீ புன்ருவாங்	si bun rueang
ศรีประจวบ	சி பிரச்சுப்	siprachuap
ศรีปาน	ஸ்ரீ பான்	sri pan - a surname
ศรีมะฆะ	ஸ்ரீ மாகா	sirimaka - a thai name
ศรียาภัย	ஸ்ரியபாய்	siyaphai
ศรีสวัสดิ์	ஸ்ரீசாவத்	srisawat -  a surname
ศรีสำโรง	எஸ்ஐ சாம்ராங்	si samrong
ศรีเมือง	ஸ்ரீ மியூங்	srimuang
ศรีไพร	ஸ்ரீ ஃபிராய்	sri prai - a name
ศรเพชร	வைர அம்பு	sonpet
ศศิธร	சசிதோர்ன்	sasitorn - a females name
ศักดิ์ศรี	க ti ரவம்	dignity
ศักย์ไฟฟ้า	மின்சார திறன்	electric potential
ศัพท์	சொல்	vocabulary
ศาลชั้นต้น	சிவில் நீதிமன்றம்	curcuit court
ศาลหลักเมือง	நகர தூண் சன்னதி	the old court house
ศาลเจ้าพ่อหลักเมือง	நகர தூண் சன்னதி	the city's god
ศาสตราจารย์	பேராசிரியர்	professor
ศาสนา	மதம்	religion
ศาสนาพราหมณ์ฮินดู	இந்து மதம்	hindu religion
ศาสนาฮินดู	இந்து மதம்	hinduism
ศาสนาโซโรอัสเตอร์	ஜோராஸ்ட்ரியனிசம்	zoroastrianism
ศิริวรรณ	சிரிவன்	siriwan - a female's name
ศิลปอาชา	கலை அர்ச்சா	silpa-archa
ศิลปะ	கலை	arts
ศิลปะการแสดง	செயல்திறன் கலை	performing arts
ศิลปะลพบุรี	கலை லோபூரி	lopburi art
ศิลปะศรีวิชัย	ஸ்ரீவிஜய கலை	arts from sri vi chai province
ศิลปะเขมร	கெமர் கலை	cambodian arts
ศิลปะเครื่องปั้นดินเผา	மட்பாண்ட கலை	pottery art
ศิลปะเชียงแสน	சியாங் சென் கலை	chaingsan art
ศิลปินแห่งชาติ	தேசிய கலைஞர்	national artist
ศิลป์	கலை	silpa
ศิษย์เก่าคณะมนุษยศาสตร์	மனிதநேயம் முன்னாள் மாணவர்கள் பீடம்	former humanity student
ศิษย์เก่าคณะรัฐศาสตร์	அரசியல் அறிவியல் முன்னாள் மாணவர்கள்	faculty of political science alumni
ศิษย์เก่าคณะเศรษฐศาสตร์	பொருளாதார பீடம் முன்னாள் மாணவர்கள்	economics alumni
ศีรษะ	தலை	head
ศึกนันทบุเรง	நந்தபுரெங் போர்	suknuntabureng -  a war in thailand
ศึกษาศาสตร์	கல்வி	field of education
ศุกลวัฒน์	சுகோன்வாட்	sukolawat (a person's name)
ศุภกิจ	சுபாகிட்	supphakit
ศุภณัฐ	சுபனாத்	supanat (first name)
ศูนย์	மையம்	center
ศูนย์การค้า	பல்பொருள் வர்த்தக மையம்	shopping center
ศูนย์การบินทหารบก	ராணுவ விமான நிலையம்	marine forces
ศูนย์การศึกษาแม่ฮ่องสอน	மே ஹாங் மகன் கல்வி மையம்	maehongsorn learning center
ศูนย์คอมพิวเตอร์	கணினி மையம்	computer center
ศูนย์ค้าส่ง	மொத்த விற்பனை மையம்	wholesale center
ศูนย์บริการวิชาการ	கல்வி சேவை மையம்	academic service center
ศูนย์ภาษา	மொழி மையம்	language center
ศูนย์รังสิต	ரங்சிட் மையம்	rangsit university center
ศูนย์ลำปาง	லம்பாங் மையம்	lampang center
ศูนย์แพทยศาสตรศึกษาชั้นคลินิก	மருத்துவ மருத்துவம் கல்வி மையம்	medical education center
สก	திருகு	abbreviation of two letters
สกว	டி.ஆர்.எஃப்	trf
สกอ	ஸ்காட்லாந்து	office of higher education commission
สกอตแลนด์	ஸ்காட்லாந்து	scotland
สกาย	வானம்	sky
สกุล	குடும்பம்	sakun
สกุลหยาดน้ำค้าง	சண்டே	d. etrythrorhiza - a type of plant
สกุลเพชรหึง	பெட்செங்	grammatophyllum
สควอโล่	ஸ்குவாலோ	squalo
สงคราม	போர்	war
สงครามครูเสด	சிலுவைப்போர்	crusades war
สงครามมหาเอเชียบูรพา	பெரிய கிழக்கு ஆசியா போர்	world war two
สงครามอวกาศ	விண்வெளிப் போர்	space war
สงครามเกาหลี	கொரியப் போர்	korean war
สงครามเย็น	பனிப்போர்	cold war
สง่าพล	நேர்த்தியான	sangapol - a thai surname
สด	புதியது	fresh
สตรอเบอรี่	ஸ்ட்ராபெரி	strawberry
สตรีวิทยา	கதிரியக்கவியல்	satriwithaya
สติปัญญา	உளவுத்துறை	intelligence
สตึก	சாதுக்	satuek (name of district)
สตูดิโอ	ஸ்டுடியோ	studio
สถานที่ท่องเที่ยวทางธรรมชาติ	இயற்கை ஈர்ப்புகள்	natural attraction
สถานะ	நிலை	status
สถานีคาราวาน	கேரவன் நிலையம்	caravan station
สถานีวิทยุโทรทัศน์ไทยทีวีสีช่อง	வண்ண தொலைக்காட்சி சேனல்களைக் கொண்ட தாய் தொலைக்காட்சி நிலையங்கள்	thai television station number _____
สถานีโทรทัศน์ไทยพีบีเอส	தாய் பிபிஎஸ் தொலைக்காட்சி நிலையம்	thai public broadcasting service
สถาบัน	நிறுவனம்	office, department
สถาบันการศึกษา	கல்வி நிறுவனம்	educational institution
สถาบันบัณฑิตพัฒนบริหารศาสตร์	தேசிய மேம்பாட்டு நிர்வாக நிறுவனம்	satabunbunthitpakanabarihansart - a university in thailand, as known as nida
สถาบันพระบรมราชชนก	ராயல் நிறுவனம்	red cross department
สถาบันวิจัยจุฬาภรณ์	சுலபார்ன் ஆராய்ச்சி நிறுவனம்	julapon academy
สถาบันวิจัยและพัฒนา	ஆராய்ச்சி மற்றும் மேம்பாட்டு நிறுவனம்	reseach and development institution
สถาบันศูนย์และหน่วยงานในมหาวิทยาลัย	பல்கலைக்கழகங்களில் உள்ள நிறுவனங்கள், மையங்கள் மற்றும் துறைகள்	current faculties/college/school/institutes
สถาบันสมทบ	இணை நிறுவனம்	affiliated institute
สถาบันอาชีวศึกษา	தொழிற்கல்வி நிறுவனம்	ahchevasuksa academy
สถาบันอุดมศึกษา	உயர் கல்வி நிறுவனம்	higher education institute
สถาบันเทคโนโลยีนานาชาติสิรินธร	சிரிந்தோர்ன் சர்வதேச தொழில்நுட்ப நிறுவனம்	sirindhorn international institute of technology
สถาบันเทคโนโลยีพระจอมเกล้า	கிங் மோங்க்குட்டின் தொழில்நுட்ப நிறுவனம்	king mongkut's institute of technology
สถาบันเทคโนโลยีพระจอมเกล้าเจ้าคุณทหารลาดกระบัง	கிங் மோங்க்குட்டின் தொழில்நுட்ப நிறுவனம் லட்க்ராபங்	king mongkut's institute of technology ladkrabang
สถาบันเทคโนโลยีราชมงคล	ராஜமங்கள தொழில்நுட்ப நிறுவனம்	rajamangala university of technology
สถาบันโภชนาการ	ஊட்டச்சத்து நிறுவனம்	institute of nutrition
สถาปนิก	கட்டட வடிவமைப்பாளர்	architect
สถาปัตยกรรมไทย	தாய் கட்டிடக்கலை	architecture of thailand
สถิติศาสตร์	புள்ளிவிவரம்	statistic
สธ	எஸ்.டி.	two letters from thai alphabets
สนธยา	அந்தி	twilight
สนธิ	சந்தி	sonti - a male's name
สนธิไชย	சோந்திச்சாய்	sontichai
สนามกีฬากลาง	மத்திய அரங்கம்	main athletic field
สนามชัยเขต	சனம் சாய் கேத்	sanamchaikate - a location in thailand
สนามฟุตบอล	கால்பந்து துறையில்	football field
สนามแม่เหล็ก	காந்த புலம்	magnetic field
สนามไฟฟ้า	மின்சார புலம்	electric field
สนิทวงศ์	சனித் வோங்	there are families.
สนิม	துரு	rust
สนเกรวิลเลีย	பைன் திராட்சை	grevilea - family of 250 types of plants
สปริงฟิลด์	ஸ்பிரிங்ஃபீல்ட்	springfield
สปรินเตอร์	தடகள வீரர்	sprinter
สปาร์ค	தீப்பொறி	spark
สพ	விவரக்குறிப்பு	oc
สภานิติบัญญัติแห่งชาติ	தேசிய சட்டமன்றம்	national diet
สภาผู้แทนนิสิต	மாணவர் பிரதிநிதி சபை	college student representatives
สภาพอากาศ	வானிலை	weather conditions
สมจิตต์	சோம்சிட்	somjit - a female's name
สมจิตร	சோம்சிட்	somjit
สมชัย	சோம்சாய்	somchai
สมชาย	சோம்சாய்	somchai - a male's name
สมภพ	பிறப்பு	sompob
สมศรี	சோம்ஸ்ரி	somsi
สมศักดิ์	சோம்சக்	somsak
สมัคร	விண்ணப்பிக்கவும்	samak
สมัย	காலம்	era
สมัยกรุงธนบุรี	தோன்பூரி காலம்	thonburi era
สมัยก่อนประวัติศาสตร์	வரலாற்றுக்கு முந்தைய காலம்	prehistory
สมัยที่	எப்பொழுது	term
สมัยรัชกาลที่	ஆட்சி	in the reign of
สมัยสุโขทัย	சுகோதை காலம்	sukothai era
สมัยอาณานิคมฝรั่งเศส	பிரெஞ்சு காலனித்துவ காலம்	modern france
สมาคมประชาชาติแห่งเอเชียตะวันออกเฉียงใต้	தென்கிழக்கு ஆசிய நாடுகள் சங்கம்	association of south east asian nations (asean)
สมาชิกรับเชิญตอนพิเศษ	சிறப்பு அத்தியாயங்களுக்கு உறுப்பினர்களை அழைத்தார்	special guests
สมาชิกฤดูกาลที่	பருவ உறுப்பினர்கள்	member of the parliament
สมุทวณิช	சாமுதவானிச்	samudavanija
สมเด็จ	அவளுடைய மகத்துவம்	your highness
สมเด็จพระนางเจ้ารำไพพรรณี	ராணி ரம்பாய் பார்னி	queen rambhai barni
สมเด็จพระนางเจ้าสิริกิติ์	ராணி சிரிகிட்	queen sirikit
สมเด็จพระนางเจ้าฯ	அவளுடைய மகத்துவம்	the queen of thailand
สมเด็จพระบรมราชาที่	ராஜா	king
สมเด็จพระบรมโอรสาธิราช	கிரீடம் இளவரசன்	his highness, royal crowned prince
สมเด็จพระบรมโอรสาธิราชฯ	கிரீடம் இளவரசன்	the crown prince of thailand
สมเด็จพระมหิตลาธิเบศร	சோம்டெட் ஃபிரா மஹிடோல் லத்தீபஸ்	somdet phra mahitra thibet
สมเด็จพระรามาธิบดีที่	மன்னர் ராமதிபோடி	som dej pra rama tippadee #_____ , number of the king
สมเด็จพระศรีนครินทราบรมราชชนนี	எச்.ஆர்.எச் இளவரசி மகா சக்ரி சிரிந்தோர்ன்	queen sirikit
สมเด็จพระอนุชาธิราช	சோம்தேஜ் அனுச்சதிராத்	som dej pra ah nu cha thi raj - a famous royalty in thailand a long time ago
สมเด็จพระเจ้ากรุงธนบุรี	க்ரங் தோன் பூரி	the king of the thonburi kingdom
สมเด็จพระเจ้าภคินีเธอ	அவரது ராயல் ஹைனஸ்	the king's sister, som dej pra jao pakini ther
สมเด็จพระเจ้าลูกเธอ	அவரது ராயல் ஹைனஸ்	the king's daughter, the princess
สยามดารา	சியாம் தாரா	siam stars
สยามบรมราชกุมารี	சியாம்	the current king's eldest daughter, the eldest princess
สยามพารากอน	சியாம் பாராகான்	siam paragon
สร	உருவாக்கு	abbreviation for the royalties' accessories
สรรพสินค้า	பல் பொருள் அங்காடி	department store
สราวุธ	சரவுத்	sarawut
สร้าง	உருவாக்கு	build
สลักใจ	ஈர்க்க	salakchai
สวนดุสิตโพล	சுவான் துசிட் வாக்கெடுப்பு	suan dusit poll
สวนผึ้ง	சுவான் புவெங்	bee garden
สวนสมเด็จพระศรีนครินทร์	சோம்டெட் ஃபிரா ஸ்ரீநகரிந்திர பூங்கா	pra sri nakarin - a king of thailand
สวรรคต	காலமானார்	die
สวรรคตหรือ	காலமானார்	die or ___________
สวรรคโลก	சாவன்கலோக்	heaven on earth
สวัสดิ์	சவத்	sawat - a male's name
สวัสดีปีใหม่	புத்தாண்டு வாழ்த்துக்கள்	happy new year
สวิตเซอร์แลนด์	சுவிட்சர்லாந்து	switzerland
สวี	தொகுப்புகள்	sawi
สส	ரகசியம்	representatives
สหพันธ์สาธารณรัฐเยอรมนี	ஜெர்மனி கூட்டாட்சி குடியரசு	germany
สหรัฐอาหรับเอมิเรตส์	ஐக்கிய அரபு நாடுகள்	arab emirate
สหรัฐอเมริกา	எங்களுக்கு.	america, usa
สหราชอาณาจักร	ஐக்கிய இராச்சியம்	united kingdom
สหวงษ์	சஹாவோங்	sawong - a male's name
สองสาย	இரண்டு கம்பிகள்	double-stranded
สอยดาว	அப்பர்கட்	soidao
สะดวก	சுலபம்	convenient
สะตอ	சாடோ	sator
สะล้อ	பிரேக்	salao
สะเดา	வேம்பு	neem, a type of plant
สัจธรรม	உண்மை	normal truth; common knowledge
สัญญา	ஒப்பந்த	sanya
สัญลักษณ์ประจำมหาวิทยาลัย	பல்கலைக்கழக சின்னம்	logo of the university
สัดส่วน	விகிதம்	ratio
สัตว์	விலங்கு	animal
สัตว์มีกระดูกสันหลัง	முதுகெலும்புகள்	vertebrate animals
สัตว์มีแกนสันหลัง	முதுகெலும்பு	chordata
สัตว์เลี้ยงลูกด้วยน้ำนม	பாலூட்டிகள்	mammal
สัตว์เลื้อยคลาน	ஊர்வன	reptile
สัตว์เลื้อยคลานในอันดับนี้	இந்த வரிசையில் ஊர்வன	reptile in this order
สัทศาสตร์	ஒலிப்பு	phonetics
สันติ	சமாதானம்	peace
สันติสุข	சமாதானம்	santi suk
สัมผัสนอก	வெளிப்புற ரைம்	outside touch
สัมพันธ์	உறவுகள்	relationship
สัมมา	சரி	summa - the buddhist prayer often starts with this
สาขา	கிளை	office location
สาขานครราชสีมา	நக்கோன் ராட்சாசிமா கிளை	nakhon ratchasima branch
สาขานครสวรรค์	நக்கோன் சவான் கிளை	nakhon sawan branch
สาขานิเทศศาสตร์	தொடர்பு கலைகள்	faculty of communication arts
สาขาประจวบคีรีขันธ์	பிரச்சுப் கிரி கான் கிளை	prachuap khiri khan branch
สาขาปราจีนบุรี	பிரச்சின்பூரி கிளை	pracheenburi branch
สาขาพิษณุโลก	பிட்சானுலோக் கிளை	pisanulok location
สาขามนุษยศาสตร์	மனிதநேயம்	humanities
สาขาย่อย	துணை கிளை	offices
สาขาลำปาง	லம்பாங் கிளை	lumpang location
สาขาวิชานิติศาสตร์	சட்ட பீடம்	law department
สาขาวิชาบริหารธุรกิจ	வணிக நிர்வாக திட்டம்	business administration program
สาขาวิชารัฐประศาสนศาสตร์	பொது நிர்வாகத் துறை	local government
สาขาวิชาวิทยาการคอมพิวเตอร์	கணினி அறிவியல் திட்டம்	school of computer science
สาขาวิชาวิศวกรรมคอมพิวเตอร์	கணினி பொறியியல்	computer engineering
สาขาวิชาวิศวกรรมอาหาร	உணவு பொறியியல்	food engineering
สาขาวิชาวิศวกรรมอิเล็กทรอนิกส์	மின்னணு பொறியியல் திட்டம்	major electronic engineering
สาขาวิชาศิลปอุตสาหกรรม	கலைத்துறை	arts department
สาขาวิชาเคมี	வேதியியல் துறை	department of chemistry
สาขาวิชาเทคโนโลยีชีวภาพ	பயோடெக்னாலஜி திட்டம்	department of biotechnology
สาขาวิชาเศรษฐศาสตร์	பொருளாதாரம்	finance department
สาขาศิลปะสถาปัตยกรรม	கலை கட்டிடக்கலை	art and architecture branch
สาขาสมุย	சாமுய் கிளை	smui branch
สาขาหัวหิน	ஹுவா ஹின் கிளை	hoa hin branch
สาครสินธุ์	சாகோர்ன் பாவம்	sakornsin - a surname
สาทร	சாத்தோர்ன்	sathon
สาธารณรัฐประชาชนจีน	சீன மக்கள் குடியரசு	people's republic of china
สาธารณรัฐออสเตรีย	ஆஸ்ட்ரியா குடியரசு	republic of austria
สาธารณรัฐอินโดนีเซีย	இந்தோனேசியா குடியரசு	republic of indonesia
สาธารณรัฐเช็ก	செ குடியரசு	czech republic
สาธารณรัฐโดมินิกัน	டொமினிக்கன் குடியரசு	republic dominican
สานติวัตร	சாந்திவத்	santiwat
สามก๊ก	மூன்று ராஜ்யங்கள்	three kingdom 'sam kok' - a thai legend
สามชัย	சாம் சாய்	samchai - a location in thailand
สามชุก	சாம் சுக்	sam chuk district
สามพราน	சம்ப்ரான்	sam phran
สามอัศวินในจินตนาการ	மூன்று கற்பனை மாவீரர்கள்	sam assavin in jintanakan - the name of a japanese story
สามัญ	சாதாரண	common
สายการบิน	விமான நிறுவனங்கள்	airline
สายรัชกาลที่	பிற்பகுதியில் ஆட்சி	family tree of king rama ...
สายรุ้ง	வானவில்	rainbow
สายสนั่น	இடி வரி	siasanan
สายสีชมพู	இளஞ்சிவப்பு வரி	pink line
สายสีน้ำเงิน	நீலக்கோடு	blue line
สายสีม่วง	ஊதா கோடு	purple line (rapid transit)
สายหมอก	மூடுபனி	fog
สายเดียว	ஒற்றை வரி	single helix
สายเมืองทอง	மியூங் தாங் லைன்	muang thong line
สารต้านอนุมูลอิสระ	ஆக்ஸிஜனேற்றிகள்	antioxidants
สารพฤกษเคมี	பைட்டோ கெமிஸ்ட்ரி	phytochemical
สารภี	சரபி	saraphi
สารละลาย	தீர்வு	solution
สารานุกรมไทย	தாய் என்சைக்ளோபீடியா	saranukromthai
สารานุกรมไทยฉบับราชบัณฑิตยสถาน	தாய் என்சைக்ளோபீடியா ராயல் இன்ஸ்டிடியூட் பதிப்பு	thai's publication
สารีวงษ์	சாரீவாங்	sariwong
สาวิตรี	சாவித்ரி	sawitri
สาเหตุ	காரணம்	reasons
สำนวนเก่า	பழைய முட்டாள்தனம்	old aphorism
สำนักงานขนส่งกรุงเทพมหานครพื้นที่	பாங்காக் பகுதி போக்குவரத்து அலுவலகம்	thai general transport
สำนักงานคณะกรรมการวัฒนธรรมแห่งชาติ	தேசிய கலாச்சார ஆணையத்தின் அலுவலகம்	office of arts and culture preservation of thailand
สำนักงานโครงการพัฒนาแห่งสหประชาชาติ	ஐக்கிய நாடுகளின் அபிவிருத்தி திட்ட அலுவலகம்	united nations development prograท
สำนักระบาดวิทยา	தொற்றுநோயியல் பணியகம்	bureau of epidemiology
สำนักราชเลขาธิการ	செயலகம்	operation department of the king's palace
สำนักวิทยบริการ	கல்வி வளங்கள் அலுவலகம்	office of academic services
สำนักหอสมุด	நூலகம்	library
สำนักหอสมุดกลาง	மத்திய நூலகம்	the central library
สำรวจ	கணக்கெடுப்பு	investigate
สำราญ	களிப்புடன்	happily
สำหรับ	க்கு	for
สำหรับประเทศไทย	தாய்லாந்திற்கு	for thailand
สำหรับใช้เป็นตราหัวหนังสือราชการไทย	தாய் அரசாங்க கையேட்டில் ஒரு முத்திரையாக பயன்படுத்த	emblem thailand garuda
สำหรับในปี	ஆண்டுக்கு	for the year
สำเนียง	உச்சரிப்பு	dialect
สำโรง	சாம்ராங்	sumrong - a location in thailand
สิงหาคม	ஆகஸ்ட்	august
สิงหไตรภพ	சிங்கா திரிபாப்	sing tri pop - a thai drama
สิงโต	சிங்கம்	lion
สิทธิ	உரிமைகள்	rights
สิทธิมนุษยชน	மனித உரிமைகள்	human rights
สิน	பாவம்	sihn
สินค้าคงเหลือ	சரக்குகள்	inventory
สินค้าอุปโภคบริโภค	நுகர்வோர் பொருட்கள்	supplies
สินสมุทร	பாவம் சமுத்	sihnsmut
สินิทธา	ஜிதிதா	sinitra - first name of an actor
สิปปภาค	ஜிப்பி பிராந்தியம்	sippapak
สิเรียม	சிரியம்	syriam (name of city in myanmar)
สิ่ง	விஷயம்	things
สิ่งมีชีวิต	உயிரினங்கள்	living things
สิ่งเสพติด	மருந்து	addictive substance, drugs
สิ้นพระชนม์ในรัชกาลที่	ஆட்சியில் இறந்தார்	died in
สี	நிறம்	color
สีขาว	வெள்ளை நிறம்	white
สีดำ	கருப்பு நிறம்	black color
สีน้ำตาล	பழுப்பு நிறம்	brown
สีน้ำเงิน	நீலம்	blue
สีฟ้า	நீலம்	blue
สีม่วง	ஊதா	purple
สีลม	காற்றாலை	silom
สึนะ	சுனா	tsuna
สึนะโยชิ	சுனயோஷி	tsunayoshi
สืบต่อมา	மரபுரிமையாக	live on
สื่อสารมวลชน	வெகுஜன தொடர்பு	mass communication
สื่อสิ่งพิมพ์	அச்சு ஊடகம்	printing media
สุกิจ	சுகித்	sukit
สุขภาพ	ஆரோக்கியம்	health
สุขสวัสดิ์	சுக்சாவத்	suksawas
สุขาภิบาล	சுகாதார	sukhapibal (name of district)
สุขุมวิท	சுகும்விட்	sukhumvit
สุครีพ	சுக்ரீ	sugriva
สุจริตกุล	சுச்சாரித்குன்	sucharitkul
สุจาริณี	சுச்சாரினி	sujarinee
สุชิน	சுசின்	suchin
สุดท้ายตายด้วยฝีมือ	இறுதியாக, திறமையால் இறந்து விடுங்கள்.	eventually dies at the hand of
สุดสาคร	சுட்சகோர்ன்	sootsakorn - a character in a thai legend
สุดารัตน์	சுதரத்	sudarat
สุทธิชัย	சுத்திச்சாய்	suttichai - a male's first name
สุทัศนะจินดา	சுதாசச்சிந்தா	sututnajinda - surname of a tv host
สุทัศน์	சுதாத்	sutas
สุธี	அறிஞர்	sutee - a male's name
สุนทร	சந்தோர்ன்	sunthon
สุนทรภู่	சுந்தோர்ன் ஃபூ	soontornpoo - a character from a legend
สุนทรเวช	சுந்தோர்ன்வெட்	"surname ""sundaravej"""
สุนัขจิ้งจอก	நரி	baby fox
สุปรีย์	சுப்ரி	supri - a name
สุพจน์	சுபோட்	supot
สุพล	சூப்பன்	surapol
สุมณทิพย์	சுமந்தி	sumonthip
สุรชาติ	சூரச்சத்	surachart - a male's name
สุรพล	சூரபோன்	suraphol
สุรพันธ์	சூரபன்	surapan - a male's name
สุรวุฒิ	சுராவத்	surawut
สุรศักดิ์	சூரசக்	surasak
สุรัสวดี	சூரசாவதி	suratsawadee - a thai surname
สุราษฎร์ธานี	சூரத் தானி	surat thani
สุรินทร์	சுரின்	surin - a place in thailand
สุริยัน	சூரியன்	suriyan - a male actor
สุริโยไท	சூரியோதாய்	"movie called ""suriyothai"""
สุลต่าน	சுல்தான்	sultan
สุวนันท์	சுவானன்	suwanan
สุวรรณรัฐ	சுவண்ணாரத்	suwannarath
สุวรรณานนท์	சுவண்ணனன்	suwannanon - a surname
สุเทพ	சுதேப்	suthep - first name of a famous singer
สุโขทัย	சுகோதை	sukothai - ancient thailand
สุ่น	சூரியன்	sun
สูง	உயர்	high
สูงจากระดับน้ำทะเลปานกลาง	சராசரி கடல் மட்டத்திற்கு மேலே	above average sea level
สู่	க்கு	indicate
สเตราส์	ஸ்ட்ராஸ்	strauss.
สเตอรอล	ஸ்டெரால்	steroid anabolic
สเตเดี้ยม	ஸ்டேடியம்	stadium
สเปน	ஸ்பெயின்	spain
สไตรค์	வேலைநிறுத்தம்	strike
สไตล์การเล่น	நடை நடை	style
ส่งเสริม	ஊக்குவிக்க	support, encourage
ส่วนของผู้ถือหุ้น	பங்குதாரர்களுக்கு பங்கு	shareholder fund
ส่วนต่อขยายบางซื่อท่าพระ	நீட்டிப்பு பேங் சூ தா ஃபிரா	bang sue – tha phra expansion
ส่วนสูง	உயரம்	height
ส่วนส่งกำลังบำรุง	தளவாடங்கள் பிரிவு	supply center
ส่วนหัว	தலைப்பு	top part
ส่วนในฤดูฝนน้ำจะท่วมทุกปี	மழைக்காலத்தில், ஒவ்வொரு ஆண்டும் நீர் வெள்ளத்தில் மூழ்கும்.	flooding in the rainy season
ส่วนใหญ่	பெரும்பாலானவை	mostly
ส่วนใหญ่เป็นโรงสีข้าว	அவற்றில் பெரும்பாலானவை அரிசி ஆலைகள்.	most of them are rice refinery
ส่องแสง	பிரகாசிக்கவும்	shining light
ส้ม	ஆரஞ்சு	orange
ส้มเช้ง	ஆரஞ்சு ஆரஞ்சு	acidless orange
ส้มโอ	திராட்சைப்பழம்	pomelo
หงษ์ทอง	ஹாங் தாங்	hongthong
หงษ์มานพ	ஹாங் மனோப்	hongmanop
หงสกุล	ஹாங் சகுல்	hongsakul (a famous surname in thailand), as in harin hongsakul
หญ้าทะเล	கடல் புல்	seagrass
หญ้าฝรั่น	குங்குமப்பூ	saffaron
หนองคาย	நோங் கை	nong kai -  a location in thailand
หนองม่วง	நோங் முவாங்	nong muang
หนองหาน	நோங் ஹான்	nong-haan
หนองฮี	நோங் ஹீ	nong hi - a location in thailand
หนองแซง	ஜாங்	nong sang - area in thailand
หนอน	புழு	worm
หนัก	கனமான	heavy
หนังสือ	நூல்	book
หนังสือการ์ตูน	காமிக் புத்தகம்	comic book
หนังสือลามก	ஆபாச புத்தகங்கள்	pornographic magazines
หนังใหญ่	பெரிய படம்	nang yai
หนึ่ง	ஒன்று	one
หนึ่งธิดา	ஒரு மகள்	nuengthida
หนุมาน	அனுமன்	hanuman - a giant in a thai tale
หนุ่ม	இளம்	young (used for men)
หน่วยความจำ	நினைவு	computer memory
หน่วยคำเติม	மார்பிம்	affix
หน่วยทหารในค่าย	முகாமில் இராணுவ பிரிவு	units in camp
หน่วยที่	அலகு	order of 1, 2, 3...
หน่วยบัญชาการนาวิกโยธิน	கடல் தலைமையகம்	royal thai marine corps
หน่วยประมวลผลกลาง	மத்திய செயலாக்க அலகு	central processing unit
หน่วยพันธุกรรม	மரபணு அலகு	gene
หน้าอก	மார்பு	breast
หมวด	குழு	category
หมวดหมู่	வகை	category
หมวดหมู่กลุ่มดนตรีที่ก่อตั้งในปี	இசைக் குழு வகை நிறுவப்பட்டது	category: music band established in the year
หมวดหมู่กลุ่มดนตรีสัญชาติเกาหลี	கொரிய இசைக் குழு வகை	korean musical group
หมวดหมู่กวีชาวไทย	தாய் கவிஞர் வகை	thai poem category
หมวดหมู่การฉลองปีใหม่	புத்தாண்டு கொண்டாட்ட வகை	the group in charge of new year celebration
หมวดหมู่การประท้วงในประเทศไทย	வகை எதிர்ப்பு தாய்லாந்தில்	category:protests in thailand
หมวดหมู่การ์ตูนญี่ปุ่นแนวโชเน็น	வகை: ஜப்பானிய கார்ட்டூன், ஷோனன் பாணி	the cartoons of japan
หมวดหมู่จุลชีววิทยา	நுண்ணுயிரியல் வகை	category:microbiology
หมวดหมู่ชาวไทยที่นับถือศาสนาพุทธ	வகை தாய் ப ists த்தர்கள்	category:thai buddhists
หมวดหมู่ชาวไทยที่เกิดในต่างประเทศ	வகை தாய்லாந்து மக்கள் வெளிநாட்டில் பிறந்தவர்கள்	thais that were born outside thailand
หมวดหมู่ดาวเคราะห์ชั้นใน	உள் கிரக வகை	group of stars inside
หมวดหมู่ดาวเคราะห์หิน	பிளானட் ஸ்டோன் வகை	category:terrestrial planets
หมวดหมู่ทหารอากาศชาวไทย	தாய் விமானப்படை வகை	category:royal thai air force personnel
หมวดหมู่ทหารเรือชาวไทย	தாய் கடற்படை வகை	group of thai navy officers
หมวดหมู่นักการเมืองไทย	தாய் அரசியல்வாதிகளின் வகை	politician
หมวดหมู่นักร้องไทย	தாய் பாடகர் வகை	singer category
หมวดหมู่นายกรัฐมนตรีไทย	வகை தாய் பிரதமர்	category:prime ministers of thailand
หมวดหมู่บริษัทของไทย	தாய் நிறுவன வகை	group of thai's companies
หมวดหมู่บริษัทที่ก่อตั้งในปี	வகை நிறுவனம் நிறுவப்பட்டது	category:companies established in
หมวดหมู่บอยแบนด์	பாய் பேண்ட் வகை	a group of boys band
หมวดหมู่บุคคลจากจุฬาลงกรณ์มหาวิทยาลัย	சுலலாங்கொர்ன் பல்கலைக்கழகத்தின் வகைகள்	category:chulalongkorn university alumni
หมวดหมู่บุคคลจากมหาวิทยาลัยธรรมศาสตร์	தம்மசாத் பல்கலைக்கழகத்திலிருந்து வகை	group of staff from thammasat university
หมวดหมู่บุคคลจากมหาวิทยาลัยสุโขทัยธรรมาธิราช	சுகோதாய் தமதிராத் திறந்த பல்கலைக்கழகத்தின் வகைகள்	group: person from sukhothai thammathirach university
หมวดหมู่บุคคลจากมหาวิทยาลัยอ๊อกซฟอร์ด	ஆக்ஸ்போர்டு பல்கலைக்கழகத்தின் தனிப்பட்ட வகை	the staff of oxford university, england
หมวดหมู่บุคคลจากสถาบันบัณฑิตพัฒนศิลป์	பண்டித்பதனசில்பா நிறுவனத்தைச் சேர்ந்தவர்களின் வகை	group of staff from art schools
หมวดหมู่บุคคลจากโรงเรียนนายร้อยพระจุลจอมเกล้า	சுலாச்சோம்க்லாவ் ராயல் மிலிட்டரி அகாடமியின் வகைகள்	catagory: people from prchomklhaw academy
หมวดหมู่บุคคลจากโรงเรียนมงฟอร์ตวิทยาลัย	மான்ட்போர்ட் கல்லூரியின் தனிநபர்களின் வகை	category: people from mongford college
หมวดหมู่บุคคลที่เกี่ยวข้องกับเหตุการณ์	நிகழ்வு தொடர்பான நபர்களின் வகை	catagory: individuals invovled
หมวดหมู่ประวัติศาสตร์ไทย	தாய் வரலாறு வகை	category:history of thailand
หมวดหมู่ประเภทของภาพยนตร์	திரைப்பட வகை வகை	types of film
หมวดหมู่ปรัชญา	தத்துவ வகை	category:philosophy
หมวดหมู่พระราชนัดดาในรัชกาลที่	வகை ராயலின் பேரன்	"catagory: royal heirs during the ""blank"" reign"
หมวดหมู่พระราชปทินัดดาในรัชกาลที่	வகை ராயல் ஆட்சி	the king's army
หมวดหมู่พระราชปนัดดาในรัชกาลที่	வகை மன்னர் பனாடா ஆட்சியில்	belonging to the king # ________
หมวดหมู่พิธีกรไทย	வகை தாய் வழங்குநர்கள்	host for thai shows
หมวดหมู่ฟุตบอลในประเทศไทย	தாய்லாந்தில் கால்பந்து வகை	category; football in thailand
หมวดหมู่ภัยธรรมชาติ	இயற்கை பேரழிவு வகை	catagory: natural disasters
หมวดหมู่ภัยพิบัติทางการแพทย์	மருத்துவ பேரழிவு வகை	category: medical disaster
หมวดหมู่มหาวิทยาลัยธรรมศาสตร์	தம்மசாத் பல்கலைக்கழக வகை	thamasat university
หมวดหมู่รัชกาลที่	வகை ஆட்சி	reign 9 category
หมวดหมู่รัฐคอมมิวนิสต์	கம்யூனிஸ்ட் மாநில வகை	communist countries
หมวดหมู่รัฐมนตรีว่าการกระทรวงการต่างประเทศไทย	தாய் வெளியுறவு அமைச்சரின் வகை	category:foreign ministers of thailand
หมวดหมู่รัฐวิสาหกิจไทย	வகை தாய் நிறுவனங்கள்	category:government-owned companies of thailand
หมวดหมู่รัฐสิ้นสภาพในทวีปเอเชีย	வகை மாநிலம் ஆசியாவில் அணைக்கப்பட்டது	asian counties in controlled
หมวดหมู่รัฐและดินแดนที่ก่อตั้งในปี	மாநில மற்றும் பிரதேச வகைகளை நிறுவியது	categories state and territory established in
หมวดหมู่รายการโทรทัศน์ไทย	தாய் தொலைக்காட்சி நிகழ்ச்சி வகை	the group of thai television channels
หมวดหมู่ละครโทรทัศน์ไทย	வகை தாய் தொலைக்காட்சி நாடகம்	thai drama category
หมวดหมู่วัฒนธรรมไทย	தாய் கலாச்சார வகை	category:thai culture
หมวดหมู่วันสำคัญทางศาสนาที่นับโดยปฏิทินจันทรคติ	சந்திர நாட்காட்டியால் கணக்கிடப்பட்ட முக்கியமான மத நாட்களின் வகைகள்	group of religious holidays
หมวดหมู่ศิลปินสังกัดจีเอ็มเอ็ม	gmm இன் கீழ் கலைஞர் வகை	mgm artists
หมวดหมู่สถาบันอุดมศึกษาในกรุงเทพมหานคร	பாங்காக்கில் உயர்கல்வி நிறுவனங்களின் வகைகள்	category:universities in bangkok
หมวดหมู่สมุนไพร	மூலிகை வகை	herbal, herbs
หมวดหมู่สัตว์มีแกนสันหลัง	வகை முதுகெலும்பு அச்சு	category:chordates
หมวดหมู่สัตว์เลื้อยคลาน	ஊர்வன வகை	reptilians
หมวดหมู่สิ่งก่อสร้างในพุทธศตวรรษที่	21 ஆம் நூற்றாண்டில் கட்டிடங்களின் வகை	development in the century # ____
หมวดหมู่สิ้นสุดในคริสต์ศตวรรษที่	வகை 19 ஆம் நூற்றாண்டில் முடிந்தது.	category: ended in xth century
หมวดหมู่สโมสรในพรีเมียร์ลีก	பிரீமியர் லீக்கில் கிளப் வகை	group of premier club
หมวดหมู่อดีตอาณานิคมของฝรั่งเศส	பிரெஞ்சு முன்னாள் காலனித்துவ வகை	category:former french colonies
หมวดหมู่อดีตอาณานิคมของสเปน	முன்னாள் ஸ்பானிஷ் காலனித்துவ வகை	category:former spanish colonies
หมวดหมู่อดีตอาณานิคมของอังกฤษ	பிரிட்டிஷ் முன்னாள் காலனித்துவ வகை	the group of countries that were under british control
หมวดหมู่อวัยวะ	உறுப்பு வகை	group of organs
หมวดหมู่อวัยวะเพศ	பிறப்புறுப்பு வகை	category:sex organs
หมวดหมู่เครื่องเทศ	மசாலா வகை	herbs
หมวดหมู่เพศศึกษา	பாலியல் கல்வி வகை	sex education category
หมวดหมู่แนวพระราชดำริ	முன்முயற்சி வகை	the king's words (instruction)
หมวดหมู่โรค	நோய் வகை	group of disease
หมวดหมู่โรงเรียนที่มีอัตราการแข่งขันสูง	அதிக போட்டி விகிதங்களைக் கொண்ட பள்ளிகளின் வகை	categories high competition school
หมวดหมู่โรงเรียนบุรุษในประเทศไทย	தாய்லாந்தில் ஆண்கள் பள்ளி பிரிவு	category:boys' schools in thailand
หมอชิต	மோர்ச்சிட்	mochit bus station
หมากรุกสากล	சர்வதேச சதுரங்கம்	chess
หมายความว่า	பொருள்	means
หมู่	பன்றி	district, group
หมู่ที่	கிராமம்	moo.
หมู่เกาะเคย์แมน	கெய்மன் தீவுகள்	cayman island
หมู่เกาะแบลีแอริก	பலேரிக் தீவுகள்	balearic island in spain
หมู่เกาะโซโลมอน	சாலமன் தீவுகள்	solomon islands
หม่อมราชวงศ์ปรีดิยาธร	ஆர்.பிரிதியாதோர்ன்	mom rajawongse pridiyathorn devakula
หม่อมหลวงปิ่น	அம்மா பின்	mom luang pin
หม่อมเจ้าจุฑาวัชร	இளவரசர் ஜுதாவாட்சாய்	his serene highness prince juthawat
หม่อมเจ้าวัชรวีร์	இளவரசர் வாட்சராவி	mom chao vatcharee - a member of the royal family
หม่อมเจ้าวัชรเรศร	அம்மா வாட்சராச்சோர்ன்	watcharaje - a member of royal family
หม้อข้าวหม้อแกงลิง	நேபென்டஸ்	nepenthes - a type of tropical plant
หยุ่น	நெகிழ்வான	yun - nickname of a thai newscaster
หรั่ง	லாங்	rang
หรือ	அல்லது	or
หรือการแสดงธงชาติ	அல்லது தேசியக் கொடியைக் காட்டும்	national flag display
หรือชื่อทางการคือ	அல்லது அதிகாரப்பூர்வ பெயர்	official name is
หรือที่รู้จักกันในชื่อ	அல்லது அறியப்படுகிறது	also known as
หรือที่เรียกกันว่า	எனவும் அறியப்படுகிறது	or what it is called ...
หรือเรียกว่า	அல்லது அழைக்கப்பட்டது	called
หลวง	அரச	loung - a thai title for people who services the king
หลอก	போலி	fake, fooling someone
หลอดอาหาร	உணவுக்குழாய்	esophagus
หลอดเลือดแดงใหญ่เอออร์ตา	பெருநாடி	aorta
หลักจริยธรรม	நெறிமுறைகள்	ethics
หลักทรัพย์	பத்திரங்கள்	property
หลักสี่	லக்ஸி	luk sri - a location in bangkok
หลักสูตรการจัดการดุษฏีบัณฑิต	நிர்வாகத்தில் தத்துவ திட்டத்தின் டாக்டர்	doctor of management program
หลักสูตรที่เปิดสอน	பாடநெறி	curriculum
หลักสูตรนานาชาติ	சர்வதேச பாடநெறி	international course
หลักสูตรปกติ	இயல்பான படிப்பு	normal program
หลักสูตรภาษาอังกฤษ	ஆங்கில மொழி பாடநெறி	english curriculum
หลักสูตรภาษาไทย	தாய் மொழி படிப்பு	thai language curriculum
หลักสูตรวิทยาศาสตรมหาบัณฑิต	அறிவியல் திட்டத்தின் மாஸ்டர்	degree requirements for a bachelor degree in science
หลังจาก	பிறகு	after
หลังสงคราม	போருக்குப் பிறகு	after the war
หลังสงครามโลกครั้งที่	உலகப் போருக்குப் பிறகு	world war
หลังสงครามโลกครั้งที่สอง	இரண்டாம் உலகப் போருக்குப் பிறகு	after world war ii
หลังเหตุการณ์	நிகழ்வுக்குப் பிறகு	after the event
หลาย	நிறைய	many, vastly
หลีกภัย	எஸ்கேப்	mr. cheun leakpai, the former foreign ministor
หลุมดำจิ๋ว	சிறிய கருந்துளை	small black hole
หล่มสัก	லோம் சாக்	lohmsak
หวาย	பிரம்பு	bamboo
หอก	ஈட்டி	spear
หอประชุมพ่อขุนรามคำแหงมหาราช	கிங் ராம்காம்ஹெங் தி கிரேட் ஆடிட்டோரியம்	pho khun ram khamhaeng convention center
หอมรดกไทย	தாய் ஹெரிடேஜ் ஹால்	national ancient museum of thailand
หอย	மட்டி	shells, clams
หอไอเฟล	ஈபிள் கோபுரம்	eiffel tower
หัก	கழித்தல்	broken
หัว	தலை	head
หัวหิน	ஹுவா ஹின்	hua hin
หัวโขน	முகமூடி	khon mask
หัวใจ	இதயம்	heart
หาง	வால்	tail
หาดทรายแก้ว	சாய் கெய்வ் கடற்கரை	glass beach
หาบเร่	ஹாக்கர்	street vending
หินปูน	சுண்ணாம்பு	limestone
หินอ่อน	பளிங்கு	marble
หินเชิร์ต	கல் சட்டை	chert
หินแกรนิต	கிரானைட்	granite rock
หินไซอัล	ஷேல் கல்	sial
หี	புண்டை	vagina (impolite word)
หุตะสิงห์	ஹூட்டா சிங்	hutasingha
หุ่น	கைப்பாவை	model
หุ่นยนต์	ரோபோ	robot
หเตุการณ์	நிலைமை	event
ห่วงใย	கவனித்தல்	care
ห้วยขวาง	ஹுவாய் குவாங்	huai khwang
ห้วยทับทัน	ஹுவாய் தாப் தான்	huai thap than
ห้องน้ำ	கழிப்பறை	bathroom
ห้องสมุด	நூலகம்	library
ห้าง	கடை	mall
ห้างฉัตร	அரட்டை தொங்கு	hang chat
ห้างหุ้นส่วนจำกัด	வரையறுக்கப்பட்ட கூட்டாண்மை	limited partnership
ฬาพานิช	வணிகரீதியானது	fapanit - surname of an actor
อก	மார்பக	chest
อคิลลีส	அகில்லெஸ்	achilles
องคชาต	பிறப்புறுப்புகள்	penis
องคต	அமைப்பு	angada
องค์กรปกครองส่วนท้องถิ่น	உள்ளூர் அரசாங்க அமைப்பு	local administration
องค์การนิสิต	மாணவர் அமைப்பு	student organization
องค์การมหาชน	பொது அமைப்பு	human services
องค์การสหประชาชาติ	ஐக்கிய நாடுகள்	united nation
องค์บาก	ஆங் பாக்	ong-bak
องค์ประกันหงสา	ஹோங்சா காப்பீடு	prakunhongsa - a famous person from the ancient time
องอาจ	வீரம்	ongart
อดิศักดิ์	அடிசக்	adisak
อดีต	முன்னாள்	the past
อดีตผู้บัญชาการทหารบก	முன்னாள் இராணுவத் தளபதி	ex-commander in chief of the royal thai army
อดีตรองนายกรัฐมนตรี	முன்னாள் துணை பிரதமர்	former deputy prime minister
อดีตรองหัวหน้าหน่วยที่	பிரிவின் முன்னாள் துணைத் தலைவர்	former lieutenant
อธิการบดี	அதிபர்	dean of the college
อธิการบดีมหาวิทยาลัยธรรมศาสตร์	தம்மசாத் பல்கலைக்கழகத் தலைவர்	former chanceller of thamasat university
อธิบายว่า	அதை விளக்குங்கள்	explain
อนันตยะ	அனந்தயா	anantaya
อนันตรัย	அனந்தை	anuntrai
อนาลโย	அனலோய்	analayo
อนึ่ง	தற்செயலாக	once
อนุทิน	டைரி	diary
อนุสรณ์สถาน	நினைவகம்	monument
อนุสรา	அனுசரா	anusara
อปักธงชัย	பாக் தொங்சாய்	pak thongchai district
อพอลโล่	அப்பல்லோ	apollo
อพิมาย	அபிமாய்	phimai district
อภัยนุราช	மன்னிக்கவும்	aphainurat
อภินันท์	அஃபினன்	ahpinun - a male's name
อภิปรัชญา	மீமெய்யியல்	metaphysics
อภิรักษ์	அபிராக்	apirak
อมฤต	இறந்தவர்	ummarit - a male's name
อมาตยกุล	அமதாயகுன்	amattayakun
อยู่	உள்ளன	is
อยู่วิทยา	விஞ்ஞானம்	yoovidhya
อยู่ห่างออกไปจากชายฝั่ง	கடற்கரையிலிருந்து வெகு தொலைவில்	away offshore
อยู่แล้ว	ஏற்கனவே	already
อยู่ในเขตอำเภอกุฉินารายณ์	குச்சினராய் மாவட்டத்தில் அமைந்துள்ளது	in the kuchinarai district
อย่างต่อเนื่อง	தொடர்ந்து	continuously
อย่างแพร่หลาย	பரவலாக	many, various
อย่างไรก็ตาม	எனினும்	however
อร	ஆர்ன்	orn (thai name)
อรทัย	இளம் பெண்	orathai - surname of a thai country singer
อรรถกถา	வர்ணனை	atthakatha
อรรถพร	அதாஃபோன்	uttapon - a female's name
อรัญประเทศ	ஆரண்யபிரத்தேத்	arranyapratet - a location in thailand
อริยสัจ	உன்னத உண்மை	teaching of buddha
อรุณี	அருணீ	arunee
อลังการ	அலங்கார	alungan - the name of a movie theater in thailand
อลาสก้า	அலாஸ்கா	alaska
อลิซ	ஆலிஸ்	alice
อวอร์ดส	விருதுகள்	award
อวัยวะสืบพันธุ์สตรีด้านนอก	வெளியில் பெண் பிறப்புறுப்பு உறுப்புகள்	femal reproductive system
อวัยวะสืบพันธุ์หญิง	பெண் பிறப்புறுப்பு உறுப்புகள்	female reproductive system
อวัยวะเพศ	பிறப்புறுப்புகள்	sex organ
อศรีประจันต์	அஸ்ரி பிரச்சன்	master sri prajan - a priest's name
อสมท	mcot	acronym for thai communication companies
อสามชุก	சாம் சுக்	sam chuk district
ออ	அல்லது	auu - a thai vowel
ออกฉายครั้งแรกเมื่อวันที่	முதலில் திரையிடப்பட்டது	first screening
ออกมาในอะนิเมะเท่านั้น	அனிமேஷில் மட்டும் வெளியே வருகிறது	only in anime
ออกอากาศ	ஒளிபரப்பு	on the air
ออกอากาศครั้งที่	ஒளிபரப்பப்பட்டது	airing
ออกอากาศทางช่อง	ஒளிபரப்பப்பட்டது	aired on channel
ออกัสตัส	அகஸ்டஸ்	augustus
ออกเป็น	க்குள்	into
ออกแบบตัวละคร	எழுத்து வடிவமைப்பு	character design
ออนไลน์	நிகழ்நிலை	online
ออฟ	முடக்கு	off
ออลแบนี	கூட்டாளிகள்	albany
ออสเตรเลีย	ஆஸ்திரேலியா	australia
ออโตทรอพ	ஆட்டோபோட்	autotroph
อะ	என்ன	a
อะซูไรต์	அசுரைட்	azurite
อะตอม	அணு	atom
อะนิเมะ	அனிம்	anime
อะบุราเมะ	அபுரேம்	aburame
อะพาไทต์	அபாடைட்	apartheid
อะมาเดอุส	அமேடியஸ்	amadeus
อะลูมิเนียม	அலுமினியம்	aluminum
อะโกนิสต์	அகோனிஸ்ட்	agonist
อะโลน	தனியாக	alone
อักษร	கடிதம்	letters, alphabets
อักษรย่อ	சுருக்கங்கள்	abbreviation
อักษรเกาหลี	கொரிய எழுத்துக்கள்	korea alphabet
อังกฤษสมัยแองโกล-นอร์มัน	ஆங்கிலோ-நார்மன் ஆங்கிலம்	england anglo-norman era
อังการา	அங்காரா	ankara
อัญมณี	மாணிக்கம்	gem
อัฒภาค	அரைப்புள்ளி	semicolon
อัตราการว่างงาน	வேலையின்மை விகிதம்	unemployment rate
อัธฮา	ஆத்தா	athha
อันดับ	மதிப்பீடு	order
อันประกอบด้วย	கொண்ட	consists of
อันโตนิโอ	அன்டோனியோ	"name ""antonio"""
อันโตนีโอ	அன்டோனியோ	antonio
อันได้แก่	உட்பட	which are
อัฟกานิสถาน	ஆப்கானிஸ்தான்	afghanistan
อัมพร	ஆம்போர்ன்	umpon - a female's name
อัมพาต	முடக்கம்	paralysis
อัลบัส	அல்பஸ்	albus in harry potter stories
อัลบั้ม	ஆல்பம்	album
อัลเดบารัน	ஆல்டெபரன்	arudebaran
อัลเฟรด	ஆல்பிரட்	alfred
อัสนี	ஆணி	thunderbolt
อาการหวาดระแวง	சித்தப்பிரமை	paranoid
อากาศ	காற்று	air, weather
อากาศอำนวย	வானிலை	akat amnuai
อากาเป	அகபே	the word meaning 'love' in greek language
อาคามัตสึ	அகமாட்சு	akamatsi
อาคารส่วนที่	கட்டிட பிரிவு	part (insert number) of the the building
อาคารอุบลรัตนราชกัญญา	உபோன்ரதான ராட்சகன்யா கட்டிடம்	buildings outside ubon ratana graz contract.
อาคารเฉลิมพระเกียรติ	சலோம் ஃப்ராகியாட் கட்டிடம்	chalermphrakiat building
อาจหมายถึง	பொருள் கொள்ளலாம்	may also mean
อาจารย์	பேராசிரியர்	teacher
อาจารย์ใหญ่	தலைமை ஆசிரியர்	headmaster
อาซึกะ	அசுகா	asuka
อาณัตพล	அனாடபோன்	arnattapon
อาณาจักร	இராச்சியம்	kingdom
อาณาจักรธนบุรี	தோன்பூரி இராச்சியம்	thonburi empire
อาณาจักรสุโขทัย	சுகோதாய் இராச்சியம்	sukhothai kingdom
อาณาจักรอยุธยาปกครองเขมรเป็นเวลาเกือบปี	அயுதாய இராச்சியம் கம்போடியாவை கிட்டத்தட்ட ஒரு வருடம் ஆட்சி செய்தது.	ayutthaya dynasty had colonized khmer for almort 400 years
อาณาจักรอยุธยาเริ่มเสื่อมอำนาจลงราวพุทธศตวรรษที่	ப buddhist த்த நூற்றாண்டில் அயுதாய இராச்சியம் மோசமடையத் தொடங்கியது.	ayutthaya kingdom had started to downfall around 24 b.e.
อาณาจักรแพกเจ	பக்கே இராச்சியம்	pakja territory
อาณาเขตติดต่อ	தொடர்பு பகுதி	adjoining parcel
อาดัม	ஆடம்	adam
อาทิ	போன்றவை	for example
อาทิตย์	வாரம்	sunday
อานนท์	அனோன்	anon
อานันทมหิดล	ஆனந்த மஹிடோல்	ahnanmahidol - someone with the king's surname
อานุภาพ	சக்தி	power
อานโตนิโอ	அன்டோனியோ	antonio
อาบาราอิ	அபராய்	abarai
อายุ	வயது	age
อารยา	அரயா	araya
อาร์	ஆர்	r.
อาร์กอน	ஆர்கான்	argon
อาร์คิมิดีส	ஆர்க்கிமிடிஸ்	archimedes
อาร์ม	கை	arms
อาร์มาดิลโล	அர்மடிலோ	armadillo
อาร์เคด	ஆர்கேட்	arcade
อาร์เมเนีย	ஆர்மீனியா	armenia
อาร์เอ็นเอ	ஆர்.என்.ஏ	ribonucleic acid - rna
อาร์โนลด์	அர்னால்ட்	arnold
อาวุธคือ	ஆயுதம்	type of weapons
อาวุธประจำกาย	தனிப்பட்ட ஆயுதம்	personal weapon
อาหาร	உணவு	food
อาเจียน	வாந்தி	vomit
อาเธอร์	ஆர்தர்	arthur
อาเนีย	அனா	anya
อำนาจ	சக்தி	amnat
อำนาจอธิปไตย	இறையாண்மை	sovereignty
อำเภอ	மாவட்டம்	district
อำเภอกมลาไสย	கமலாசாய் மாவட்டம்	kamalasai district
อำเภอกระสัง	கிராசங் மாவட்டம்	krasang district
อำเภอกันทรลักษ์	காந்தராலக் மாவட்டம்	kantharalak district
อำเภอขุขันธ์	குகான் மாவட்டம்	khukhan district
อำเภอขุนหาญ	குன் ஹான் மாவட்டம்	amphur kunhan
อำเภอครบุรี	கோன் பூரி மாவட்டம்	amphur kornburi
อำเภอคูเมือง	கு முயாங் மாவட்டம்	khu mueang district
อำเภอจอมทอง	சோம் தோங் மாவட்டம்	jom thong district
อำเภอดอยสะเก็ด	டோய் சாகேத் மாவட்டம்	doi saket district
อำเภอด่านขุนทด	டான் குன் தோட் மாவட்டம்	dan koontod district
อำเภอตะพานหิน	தபன் ஹின் மாவட்டம்	taphan hin district
อำเภอทับคล้อ	தப் க்ளோ மாவட்டம்	amphoe tap khlo
อำเภอทุ่งช้าง	துங் சாங் மாவட்டம்	thung chang district
อำเภอท่าตูม	தா தும் மாவட்டம்	ta toom district
อำเภอท่าวังผา	தா வாங் பா மாவட்டம்	ta wung pa province
อำเภอท่าวุ้ง	தா வுங் மாவட்டம்	ta wung district
อำเภอนครชัยศรี	நக்கோன் சாய் சி மாவட்டம்	nakhon chai si district
อำเภอนาบอน	நா பான் மாவட்டம்	nabon district
อำเภอน้ำเกลี้ยง	நாம் கிளியாங் மாவட்டம்	amphur namleang
อำเภอบัวเชด	புச்சேட் மாவட்டம்	buachet district
อำเภอบัวใหญ่	புவா யாய் மாவட்டம்	amphoe buayai (buayai district)
อำเภอบางบัวทอง	பேங் புவா தாங் மாவட்டம்	bang bua thong district
อำเภอบางบ่อ	பேங் போ மாவட்டம்	bang bor district
อำเภอบางพลี	பேங் ஃபிலி மாவட்டம்	bang plee district
อำเภอบางละมุง	பேங் லாமுங் மாவட்டம்	bang lamung district
อำเภอบางเสาธง	பேங் சாவ் தாங் மாவட்டம்	bang sao thong district
อำเภอบ้านลาด	லாட் மாவட்டத்தை தடைசெய்க	bahn lad district
อำเภอบ้านหมี่	பான் மி மாவட்டம்	ban mi district
อำเภอปราสาท	பிரசாத் மாவட்டம்	amphor-prasart
อำเภอปากช่อง	பாக் சோங் மாவட்டம்	pak chong district
อำเภอปากพนัง	பாக் ஃபனாங் மாவட்டம்	pak phanang district
อำเภอปาย	பை மாவட்டம்	pai district
อำเภอฝาง	ஃபாங் மாவட்டம்	fang district
อำเภอพระประแดง	ஃபிரா பிராடெங் மாவட்டம்	pra-pradaeng district
อำเภอพระพรหม	ஃபிரா ப்ரோம் மாவட்டம்	pra phrom province
อำเภอพระสมุทรเจดีย์	ஃபிரா சமுத் செடி மாவட்டம்	samutjadee district
อำเภอพลับพลาชัย	பிளப்லா சாய் மாவட்டம்	plubplachai province in thailand
อำเภอพัฒนานิคม	பட்டானா நிகோம் மாவட்டம்	amphur pattananikhom
อำเภอพิปูน	பிபூன் மாவட்டம்	phipun district
อำเภอพุทธมณฑล	புத்தமண்டன் மாவட்டம்	ampore phuthamontol
อำเภอภูสิงห์	ஃபூ சிங் மாவட்டம்	aumphor phu sing (name of district)
อำเภอยางชุมน้อย	யாங் சும் நொய் மாவட்டம்	choom noi province
อำเภอรหัสไปรษณีย์หมายเหตุ	மாவட்டம், அஞ்சல் குறியீடு, குறிப்பு	district, post code, note
อำเภอรัตนบุรี	ரத்தனபுரி மாவட்டம்	rhatanaburi district
อำเภอราษีไศล	ராசி சலாய் மாவட்டம்	rasi-salai district
อำเภอร่อนพิบูลย์	ரான் பிபூன் மாவட்டம்	ronpibul district
อำเภอลาดหลุมแก้ว	லாட் லம் கியோ மாவட்டம்	lat lum kaeo district
อำเภอลำปลายมาศ	லாம் பிளாய் மாட் மாவட்டம்	lum plai maad district in burrirum province
อำเภอศรีณรงค์	எஸ்ஐ நரோங் மாவட்டம்	si narong district
อำเภอศรีเมืองใหม่	si mueang mai மாவட்டம்	sri meung mai district
อำเภอสระโบสถ์	ஸ்ரா சர்ச்	sa bot district
อำเภอสหัสขันธ์	சஹத்சகான் மாவட்டம்	sahuskhan district
อำเภอสองแคว	பாடல் குவே	song khwae district
อำเภอสังขะ	சங்க மாவட்டம்	sang ka district
อำเภอสันป่าตอง	சான் பா டோங் மாவட்டம்	sunpathong province in thailand
อำเภอสามพราน	சாம் ஃபிரான் மாவட்டம்	sam pran area
อำเภอสารภี	சராபி மாவட்டம்	sarape district
อำเภอสิชล	சிச்சான் மாவட்டம்	sichon district
อำเภอสุไหงโกลก	சுங்கை கோலோக் மாவட்டம்	amphoe su-ngai kolok
อำเภอหนองกี่	நோங் கி மாவட்டம்	nong kee district
อำเภอห้วยราช	ஹுவாய் எலி மாவட்டம்	huai rat district
อำเภออมก๋อย	ஓம்கோய் மாவட்டம்	om koi district in chiang mai, thailand
อำเภอเกาะคา	கோ கா மாவட்டம்	amphoe ko kha
อำเภอเขวาสินรินทร์	குவாவோ சினரின் மாவட்டம்	ampore khavasinrin
อำเภอเฉลิมพระเกียรติ	சலோம் ஃபிராகியாட் மாவட்டம்	amphur chalermprakiet
อำเภอเชียงของ	சியாங் காங் மாவட்டம்	chiang khong district
อำเภอเชียงคาน	சியாங் கான் மாவட்டம்	chiang khan district
อำเภอเชียรใหญ่	சியான் யாய் மாவட்டம்	chien yai district in thailand
อำเภอเมืองกาฬสินธุ์	மியூங் கலசின் மாவட்டம்	mueang kalasin provincial district
อำเภอเมืองนครราชสีมา	மியூங் நாகோன் ராட்சாசிமா மாவட்டம்	mueang nakhon ratchasima district
อำเภอเมืองนนทบุรี	மியூங் நோந்தபுரி மாவட்டம்	nontaburi district
อำเภอเมืองบุรีรัมย์	மியூங் பூரி ராம் மாவட்டம்	burerum province
อำเภอเมืองพิจิตร	மியூங் பிச்சிட் மாவட்டம்	mueang phichit district
อำเภอเมืองพิษณุโลก	மியூங் பிட்சானுலோக்	ampore maung pisanulok
อำเภอเมืองลพบุรี	மியூங் லோப் பூரி மாவட்டம்	lopburi province
อำเภอเมืองสุรินทร์	மியூங் சுரின் மாவட்டம்	surin province
อำเภอเมืองอุตรดิตถ์	மியூங் உத்தரடிட் மாவட்டம்	mueang uttaradit district
อำเภอเมืองเชียงใหม่	மியூங் சியாங் மாய் மாவட்டம்	mung chiang mai district
อำเภอเมืองเพชรบุรี	மியூங் பெட்சபுரி மாவட்டம்	pechaburi province
อำเภอเวียงชัย	வியாங் சாய் மாவட்டம்	wiang chai district
อำเภอเวียงแก่น	வியாங் கான் மாவட்டம்	wiang kaen district
อำเภอเสริมงาม	சோம் நகம் மாவட்டம்	soem ngam district
อำเภอแจ้ห่ม	சே ஹோம் மாவட்டம்	chae hom district
อำเภอแม่ทะ	மே தா மாவட்டம்	mahta district
อำเภอแม่แจ่ม	மே சேம் மாவட்டம்	mae jam province
อำเภอแม่แตง	மே டேங் மாவட்டம்	mae taeng district
อำเภอโนนดินแดง	அல்லாத தின் டேங் மாவட்டம்	din dang sub district
อำเภอโนนสุวรรณ	அல்லாத சுவான் மாவட்டம்	none su wan province
อิงค์	இன்க்.	inc.
อิงลิช	ஆங்கிலம்	english
อิทธิพล	செல்வாக்கு	power
อิน	இல்	in
อินทิรา	இந்திரா	intira
อินฟราเรด	அகச்சிவப்பு	infared
อินฮิบิเตอร์	தடுப்பான்	inhibitors
อินุยาฉะ	இனுயாஷா	inuyacha - a japanese cartoon
อินเซคทิวอรา	இன்செக்துரா	insectivora
อินเดียน	இந்தியன்	indian
อินเด็กซ์	குறியீட்டு	index
อินโดนีเซีย	இந்தோனேசியா	indonesia
อิม	இம்	im
อิมาจิน	இமாஜின்	imagine
อิมแพ็ค	impact	impact
อิรัก	ஈராக்	iraq
อิริโทรมัยซิน	மின்னாற்பகுப்பு	erythromycin
อิสตันบูล	இஸ்தான்புல்	istanbul
อิหร่าน	ஈரான்	iran
อิเควทอเรียลกินี	எக்குவடோரியல் கினியா	equitorial
อิโนะ	இன்னோ	ino
อีก	மேலும்	more
อีกครั้ง	மீண்டும்	again
อีกด้วย	மிகவும்	also
อึ	மலம்	poop
อึ๊งภากรณ์	ungphakorn	ungpakorn - a famous surname
อือ	ஆம்!	uu - a thai vowel
อื่น	மற்றொன்று	other
อุ	ஓ	ou
อุซึมากิ	உசுமகி	uzumaki naruto
อุณหภูมิ	வெப்ப நிலை	temperature
อุณหเคมี	வெப்ப வேதியியல்	using energy and heat in chemical study
อุดม	வளமான	udom
อุดรธานี	உடோன் தானி	udon thani
อุตตมะโยธิน	உபரத் யோதின்	uttamayothin
อุตรดิตถ์	உத்தரடித்	uttaradit
อุทยาน	பூங்கா	park
อุทยานประวัติศาสตร์พนมรุ้ง	ஃபனோம் ரங் வரலாற்று பூங்கா	phanom rung historical park
อุทยานประวัติศาสตร์พิมาย	பிமாய் வரலாற்று பூங்கா	phimai historical park
อุทยานแห่งชาติคลองตรอน	க்ளோங் ட்ரான் தேசிய பூங்கா	khlong tron national park
อุทยานแห่งชาติดอยภูคา	டோய் ஃபூ கா தேசிய பூங்கா	doi phu kha national park
อุทยานแห่งชาติดอยอินทนนท์	டோய் இன்டனான் தேசிய பூங்கா	national park doi inthanon in northern thailand
อุทยานแห่งชาติทุ่งแสลงหลวง	துங் சலெங் லுவாங் தேசிய பூங்கா	thung salaeng luang national park
อุทยานแห่งชาติธารโบกขรณี	போக் கோரணி தேசிய பூங்காவை விட	tarabokorani national preserve area
อุทยานแห่งชาติน้ำตกสี่ขีด	எஸ்ஐ கிட் நீர்வீழ்ச்சி தேசிய பூங்கா	namtoksekeed national park
อุทยานแห่งชาติน้ำพอง	நாம் போங் தேசிய பூங்கா	nam phong national park
อุทยานแห่งชาติภูผาเหล็ก	இரும்பு மலை தேசிய பூங்கா	phupalek national park
อุทยานแห่งชาติภูพาน	ஃபூ ஃபான் தேசிய பூங்கா	phu phan national park
อุทยานแห่งชาติภูสวนทราย	பூ சுவான் சாய் தேசிய பூங்கா	pusuansai national preserve
อุทยานแห่งชาติภูสอยดาว	ஃபூ சோய் தாவோ தேசிய பூங்கா	soi dao mountain preserve
อุทยานแห่งชาติภูเรือ	ஃபூ ருயா தேசிய பூங்கா	national park pu reau
อุทยานแห่งชาติภูเวียง	ஃபூ வியாங் தேசிய பூங்கா	phu wiang national park
อุทยานแห่งชาติภูแลนคา	ஃபுலாங்கா தேசிய பூங்கா	phu laenkha national park
อุทยานแห่งชาติหาดนพรัตน์ธาราหมู่เกาะพีพี	நோபரத் தாரா பீச் தேசிய பூங்கா, ஃபை ஃபை தீவுகள்	hat nopparatthara-mu ko phi phi national park
อุทยานแห่งชาติเขาหลวง	காவ் லுவாங் தேசிய பூங்கா	khao luang national park
อุทยานแห่งชาติไทรทอง	சாய் தாங் தேசிய பூங்கா	sai thong national preserve area
อุทุมพรพิสัย	உத்தம்போன் பிசாய்	utompisai - an area in thai province
อุบล	யூபோன்	ubol - a place in thailand
อุปกรณ์	உபகரணங்கள்	instrument
อุปกรณ์คอมพิวเตอร์	கணினி பாகங்கள்	computer hardware
อุปนิสัย	தன்மை	manners
อุภัยราศี	ராசியை மன்னியுங்கள்	ambivert zodiac
อุรุกวัย	உருகுவே	urookwai - a location
อุเทน	உத்தேன்	utain - a male's name
อู	ஓ	u (a vowel)
อู๋	வு	auu (first name)
อเมริกัน	அமெரிக்கன்	american
อเมริกา	அமெரிக்கா	america, usa
อเมริกาเหนือ	வட அமெரிக்கா	north america
อเล็กซานเดอร์	அலெக்சாண்டர்	alexander
อเล็กซ์	அலெக்ஸ்	alex
อโลหะ	அல்லாத உலோகம்	nonmetal
อ่อนเพลีย	சோர்வாக	fatigue
อ่าน	படி	read
อ่าวลึก	ao luek	ao luek
อ้างว่า	என்று உரிமை கோருங்கள்	claim
อ้างว้าง	பாழடைந்த	loneliness
ฮอกกี้	ஹாக்கி	hockey
ฮอท	சூடாக	hot
ฮอฟมัน	ஹாஃப்மேன்	hoofman - a name
ฮอยเกนส์	ஹோகன்ஸ்	huygens
ฮอร์โมน	ஹார்மோன்	hormone
ฮอลแลนด์	ஹாலந்து	holland
ฮอลโลว์	வெற்று	hollow (as in dead soul)
ฮอว์ค	சீஹாக்குகள்	hawk
ฮักบี้	பிரியாவிடை	hugby - an album that received many awards
ฮันกึล	ஹங்குல்	hangeul
ฮัมบูร์ก	ஹாம்பர்க்	hamburg
ฮาจิ	ஹச்சி	haji
ฮาตาเกะ	ஹடகே	hatake
ฮานอย	ஹனோய்	hanoi
ฮายาโตะ	ஹயாடோ	hayada - a japanese surname
ฮารุกะ	ஹருகா	haruka - a japanese name
ฮาวาย	ஹவாய்	hawaii
ฮิซาชิ	ஹிசாஷி	hitachi
ฮิซานะ	ஹிசானா	hisana
ฮิตเลอร์	ஹிட்லர்	hitler
ฮินาตะ	ஹினாட்டா	hinada - a japanese story
ฮิมาวาริ	இமாவாரி	himawari - a japanese surname
ฮิราโกะ	ஹிராகோ	hirako (japanese name)
ฮิวงะ	ஹ்யூகா	hewnga - a japanese name from a story
ฮิโซกะ	ஹிசோகா	hisoka
ฮิโรชิ	ஹிரோஷி	hiroshi
ฮีชอล	ஹீச்சுல்	heechul
ฮุก	கொக்கி	hook
ฮโยยอน	ஹையோயோன்	hyoon - a dancer from japan
ฯพณฯ	அவரது மேன்மை	two thai alphabets.  abbreviation that means many things
เกตส์	கேட்ஸ்	gates
เกตุทัต	கெட்டட்	kettut - a surname
เกมที่	விளையாட்டு	game number _________
เกมบุค	விளையாட்டு	game book
เกรย์	சாம்பல்	gray
เกษตรกรรม	வேளாண்மை	farming
เกษตรวิสัย	கசெட் விசாய்	kasetvisai (name of thai district)
เกษมศรี	கசெம்ஸ்ரி	kasemsri surname
เกอริง	ஜெரிங்	the name 'gerring'
เกอไทต์	கோதே	goethite mineral
เกาหลีใต้	தென் கொரியா	south korea
เกาะ	தீவு	island
เกาะคา	கவாய்	ko kha
เกาะลูซอน	லூசன் தீவு	luzon island
เกาะสุมาตรา	சுமத்ரா	sumatra
เกิด	பிறந்த	born
เกิดขึ้นหลังจากมหาวิทยาลัยศรีนครินทรวิโรฒวิทยาเขตต่างๆ	ஸ்ரீநாகரின்விரோட் பல்கலைக்கழகத்திற்குப் பிறகு நிகழ்ந்தது	happened after srinakarinviroj university started
เกิดขึ้นเมื่อวันที่	நிகழ்ந்தது	birthdate
เกิดจากการรวมชิ้นส่วนที่	அந்த பகுதிகளை இணைப்பதன் மூலம் ஏற்படுகிறது	put together to form something
เกิดจากการรวมตัวของ	இணைப்பதன் காரணமாக ஏற்படுகிறது	combination of
เกิดจากเชื้อไวรัส	வைரஸால் ஏற்படுகிறது	occur from the viral agent
เกิดนิมิตร	ஒரு பார்வையை உருவாக்கவும்	caused a vision/realization
เกียรติ	மரியாதை	honour
เกียรติประวัติ	மரியாதை	biography
เกียรติศักดิ์	மகிமை	reputation.  kietisak can be a male's name
เกียวโตะ	கியோட்டோ	kyoto
เก็กโค	செக்கோ	gecko
เขตคลองสาน	க்ளோங் சான் மாவட்டம்	klongsan district
เขตจอมทอง	சோம் தோங் மாவட்டம்	jomthong area
เขตดุสิต	துசிட்	khet dusit
เขตที่	மாவட்டம்	district number _______
เขตบางกอกใหญ่	பாங்காக் யாய் மாவட்டம்	bangkok yai district in thailand
เขตบางซื่อ	பேங் சூ மாவட்டம்	bang sue district
เขตบางแค	பேங் கே	bang khae district
เขตปทุมวัน	பதும்வான்	pathum wan district
เขตภาษีเจริญ	பாசி சரோயன் மாவட்டம்	phasi charoen district
เขตมีนบุรี	மின் பூரி மாவட்டம்	min buri district
เขตรักษาพันธุ์สัตว์ป่า	வனவிலங்கு சரணாலயம்	national wildlife preserve
เขตรักษาพันธุ์สัตว์ป่าภูหลวง	ஃபூ லுவாங் வனவிலங்கு சரணாலயம்	wildlife preserve
เขตลาดกระบัง	லாட் கிரபாங்	lad krabang district
เขตวังทองหลาง	வாங் தொங்லாங் மாவட்டம்	wang thonglang district
เขตวัฒนา	வட்டானா மாவட்டம்	watana district
เขตสวนหลวง	சுவான் லுவாங் மாவட்டம்	suan luang district
เขตสาทร	சாத்தான்	sathorn area
เขตห้วยขวาง	ஹுவாய் குவாங்	huai khwang district
เขตเลือกตั้งที่	போரோ	election area number
เขมนิจ	அசாத்திய	khemanit
เขากล่าวว่า	அவன் சொன்னான்	he said
เขาทราย	காவ் சாய்	sand dunes
เขียนว่า	என்று எழுதுங்கள்	wrote
เขียนโดย	எழுதியவர்	written by
เขี้ยวพิษ	நச்சு மங்கைகள்	vemon fangs
เขื่อนกิ่วลม	கியோ விண்ட் அணை	kio lom dam
เขื่อนป่าสักชลสิทธิ์	பசக் சோன்லாசிட் அணை	parsakchonlasit dam
เขื่อนลำปาว	லம்பாவோ அணை	lum pao dam
เขื่อนแม่งัดสมบูรณ์ชล	மே ந்காட் சோம்பூன் சோன் அணை	mae ngud som bul chol dam in chiangmai
เข็มศิลปวิทยา	ஊசி கலைகள்	khem sinlapawitthaya
เข็มอัปสร	ஊசி	kem uppasorn - a thai drama
เข่า	முழங்கால்	knee
เข้าฉาย	காட்டு	release date
เข้าชิงไนน์เอ็นเตอร์เทนอวอร์ดส	ஒன்பது பொழுதுபோக்கு விருதுகளுக்கு பரிந்துரைக்கப்பட்டது.	compete in entertaining world
เข้ารอบ	இறுதி	made it to the next round, selected from the initial round
เข้าเฝ้า	பார்வையாளர்களைக் கொண்டிருங்கள்	visit (word for the king)
เคน	கென்	ken
เคนยา	கென்யா	kenya
เคมีไฟฟ้า	மின் வேதியியல்	electrochemistry
เคยสู้กับโกคุเทระ	கோகுடேராவுடன் சண்டையிடப் பயன்படுகிறது	fought with gokudera
เครือข่าย	வலையமைப்பு	network
เครื่องขัตติยราชอิสริยาภรณ์อันมีเกียรติคุณรุ่งเรืองยิ่งมหาจักรีบรมราชวงศ์	சக்ரி வம்சத்தின் மகத்தான மரியாதையை நினைவுகூரும்	something used in a thai ceremony - too obscure
เครื่องดีด	ஸ்ட்ரம்	thai string musical instruments
เครื่องตี	இயந்திரத்தை வெல்லுங்கள்	musical intrument
เครื่องบิน	விமானம்	airplane
เครื่องปั้นดินเผาและเซรามิค	மட்பாண்டங்கள் மற்றும் மட்பாண்டங்கள்	pottery and ceramic
เครื่องยนต์	இயந்திரம்	engine
เครื่องราชอิสริยาภรณ์	சின்னம்	the king's accessories for ceremonies
เครื่องราชอิสริยาภรณ์อันเป็นที่เชิดชูยิ่งช้างเผือก	வெள்ளை யானையை மகிமைப்படுத்தும் சின்னம்	order of the white elephant
เครื่องราชอิสริยาภรณ์อันเป็นสิริยิ่งรามกีรติ	கிராட்டியின் மகத்துவத்தின் சின்னம்	king's accessories
เครื่องราชอิสริยาภรณ์อันเป็นโบราณมงคลนพรัตนราชวราภรณ์	புனிதமான நோப்பரத் ராட்சவராஃபோனின் பண்டைய சின்னம்	the ancient and auspicious order of the nine gems
เครื่องสาย	சரம் வாசித்தல்	string instrument
เครื่องแต่งกาย	உடையில்	clothes
เคลลี่	கெல்லி	kelly
เคอาร์วาย	kryy	k.r.y
เค้ก	கேக்	cake
เงิน	பணம்	money
เงินทุน	நிதி	fund
เงินในบัญชีธนาคาร	வங்கி கணக்கில் பணம்	balance
เงี้ยว	கடினமான	shan tribe in northern part of thailand
เจ	ஜெ	j.
เจนี่	ஜானி	jenny
เจมินี่	ஜெமினி	gemini
เจริญ	வளர	charoen
เจสเปอร์	ஜெஸ்பர்	jasper
เจียะแจ	ஜெய் ஜே	nine emperor gods festival
เจี๊ยบ	குஞ்சு	jeab (thai name)
เจเน็ต	ஜேனட்	janet
เจ็ดเทพโจรสลัด	ஷிச்சிபுகை	seven warlords of the sea
เจ็บ	புண்	pain
เจ้าของจุกนม	முலைக்காம்பு உரிமையாளர்	the owner of the baby's bottle
เจ้าจอม	குரு	king's concubine
เจ้าฟ้ากรมพระยานริศรานุวัดติวงศ์	இளவரசர் க்ரோம் ஃபிரயா நரிசரனு, திவாங் கோயில்	refer to a title of a royal family member - jao fa krom pra ya rissanuwattiwong
เจ้าฟ้ากรมพระยานริศรานุวัติวงศ์	இளவரசர் க்ரோம் ஃபிரயா நரிசாரா நுவத்வாங்	prince narisara nuvativongse
เจ้าฟ้าจิตรเจริญ	இளவரசர் ஜிட்சரோயன்	prince chitcharoen
เจ้าฟ้าภาณุรังษีสว่างวงศ์	இளவரசர் பானுரங்கசீசவாங்வாங்	prince panuragui bright chestnut.
เจ้าฟ้ามหาวชิราลงกรณ	இளவரசர் மகா வஜிரலோங்க்கார்ன்	thailand's crown prince
เจ้าฟ้ามหาวชิรุณหิศ	இளவரசர் மகாவாஜிருன்ஹித்	crown prince maha vajirunhis
เจ้าฟ้ามหิดลอดุลยเดช	இளவரசர் மஹிடோல் ஆடுல்யாதேஜ்	prince mahidol adulyadej
เจ้าฟ้ามหิดลอดุลเดช	இளவரசர் மஹிடோல் ஆடுல்யாதேஜ்	a member of thai royalties
เจ้าฟ้าหญิง	இளவரசி	princes
เจ้าฟ้าอุบลรัตนราชกัญญา	சாஃபா உபோன்ரதான ராஜகன்யா	princess ubon ratana graz's' contract.
เจ้าหนี้การค้า	செலுத்த வேண்டிய கணக்குகள்	trade account payable
เจ้าเมือง	கவர்னர்	mayor
เจ้าเมืองขุขันธ์	குகான் ஆளுநர்	a name of the head of the state
เจ้าโลก	மேலாதிக்கம்	world conqueror
เฉพาะด้านตะวันออกเฉียงใต้เท่านั้นที่เป็นที่ราบลุ่มแม่น้ำโขง	தென்கிழக்கு பகுதி மட்டுமே மீகாங் நதி படுகை.	only south-east area that is in mekhong plateau
เฉลิม	சவால்	chalerm - a male's name
เฉลิมชัย	சலேர்மச்சாய்	chalermchai
เฉลิมชัยเจริญกิจ	சலெர்ம்சாய் சரோயன்கிட்	chalermchaichareonkij
เฉลิมพระเกียรติ	மரியாதை	chaloem phra kiat
เฉลิมพล	சாலர்போல்	shalermpol - a surname
เฉลิมแสน	சாலர்மேசன்	chaloemsaen
เฉลียว	புலனுணர்வு	chaleuw - a male's name
เชส	துரத்தல்	(jp morgan) chase
เชอร์รี่	செர்ரி	cherry
เชา	சோவ்	chow -  a chinese name
เชาวน์	உளவுத்துறை	chow - a name
เชาวราษฎร์	ச ow வரத்	chowarat - the surname of a famous actress
เชิญยิ้ม	புன்னகை	smile
เชิดชัย	கைப்பற்றும்	"name ""churd-chai"""
เชียงกลาง	சியாங் கிளாங்	chiang klang
เชียงของ	சியாங்கொங்	chiang khong
เชียงดาว	சியாங் தாவோ	chiang dao
เชียงปุม	சியாங் பம்	chiang poom - area in thailand
เชียงยืน	சியாங் யுயென்	chiang yuen
เชียงราย	சியாங் ராய்	chiang rai
เชียงใหม่	சியங் மாய்	chiang mai
เชี่ยววงศ์กุล	சிவ்வொங்க்குன்	chiaowongkul
เชื่อมต่อกับรถไฟฟ้ามหานคร	எம்ஆர்டியுடன் இணைக்கப்பட்டுள்ளது	connect with skytrain
เชื่อมแม่น้ำท่าจีน	தா சின் நதியை இணைக்கவும்.	confluence to the ta jean river
เชื้อชาติ	இனம்	helping the country
เชื้อรา	பூஞ்சை	fungus
เช็ค	காசோலை	check
เช่นกัน	அத்துடன்	as well
เช่นเดียวกัน	அதேபோல்	similar to
เช้ามืดวันที่	நாள் விடியல்	in dawn of
เช้าวันรุ่งขึ้น	அடுத்த நாள் காலை	next morning
เซกิ	சேக்கி	seki
เซน	ஜென்	saint
เซนทอร์	செண்டார்	centaur
เซบาสเตียน	செபாஸ்டியன்	sebastian
เซฟ	சேமி	save
เซลล์	செல்	cell
เซสติโม	செட்டோ	settimo
เซอร์	ஐயா	sir
เซอร์วิส	சேவை	service
เซอร์เบีย	செர்பியா	serbia
เซอวิวาสแตติน	செர்விவாஸ்டின்	cerivastatin - drug
เซโรกัชเชอร์	செரோ குட்சர்	sero gusher - a type of weapon
เซโรนอส	செரோனோஸ்	zeronos
เซโรไลเนอร์	செரோலைனர்	seroliner
เซ็กส์	செக்ஸ்	sex
เซ็นทรัล	மத்திய	central - department stores in thailand
เซ็นทารา	சென்டாரா	centara
เซ็นเซอร์	சென்சார்	sensor
เณร	நியோபைட்	samanera
เดคลิเนชัน	அறிவிப்பு	declination
เดชา	டச்சா	decha
เดธโน้ต	மரணக்குறிப்பு	death note - a mysterious japanese cartoon
เดนกัชเชอร์	டெங்குச்சர்	den gusher - a weapon in japanese movies
เดนโอ	டென் ஓ	den-o
เดนโอเบลท์	டெனோபெல்ட்	den-o belt
เดย์	நாள்	day
เดอะซิมส์	சிம்ஸ்	the sims
เดอะฮาเดส	தி ஹேடீஸ்	the hades
เดอะฮาเดสแชปเตอร์	ஹேடீஸ் அத்தியாயம்	the hades chapter
เดิม	பழையது	at first
เดิมชื่อ	முன்பு	former name
เดิมที	முதலில்	at first
เดิมเรียกว่า	முன்பு அறியப்பட்டது	formerly known as
เดียวกัน	அதே	same
เดือดทะลุจุดศูนย์	மையத்தின் வழியாக கொதித்தல்	zero point breakthrough
เดือนกุมภาพันธ์	பிப்ரவரி	february
เดือนตุลาคม	அக்டோபர்	october
เดือนตุลาคมมีฝนตกชุกที่สุด	அக்டோபர் மழை பெய்யும்.	highest amount of rainfall in october
เดือนธันวาคม	டிசம்பர்	december
เดือนมกราคม	ஜனவரி	january
เดือนมิถุนายน	ஜூன்	june
เดือนอ้าย	சந்திர மாதம்	first lunar month
เด็กหญิงอายุ	வயதான பெண்	the girl's age
เด็กและเยาวชน	குழந்தைகள் மற்றும் இளைஞர்கள்	children and youth
เต่า	ஆமை	tao (first name)
เต๋อ	க்கு	ter
เถรวาท	கோட்பாட்டை	buddha's teaching
เทคนิคอิลลูชั่น	மாயை நுட்பம்	technique illusion
เทควันโด้	டேக்வாண்டோ	tai kwon do
เทคโนโลยี	தொழில்நுட்பம்	technology
เทคโนโลยีสารสนเทศ	தகவல் தொழில்நுட்பம்	san son tej techonology
เทนนิส	டென்னிஸ்	tennis
เทนโจอิน	டென்ஜோ-இன்	tenjoin - a character in a japanese story
เทพพิทักษ์	தெப்பிடக்	theppitak
เทพมรณะ	மரண கடவுள்	bleach
เทพหัสดิน	சொர்க்கத்தின் கடவுள்	tephussadin (a surname)
เทพอานูบิส	அனுபிஸ்	anubis
เทพอาเตน	ஏதென்	aten
เทพีเธมิส	தெய்வம்	themis
เทริโอ	தேரியோ	terio - surname of a singer
เทวดา	தேவதை	angel
เทวรูป	சிலை	graven image
เทศบาล	நகராட்சி	municipality
เทศบาลนครขอนแก่น	கோன் கான் நகராட்சி	khon khan public works
เทศบาลนครนครราชสีมา	நக்கோன் ராட்சாசிமா	nakorn rachasrima province public work
เทศบาลนครนครศรีธรรมราช	நக்கோன் சி தம்மரத்	nakorn sri thamarat city public works
เทศบาลนครเชียงราย	சியாங் ராய் நகராட்சி	chiang rai province public works
เทศบาลนครเชียงใหม่	சியாங் மாய் நகராட்சி	chiang mai municipality
เทศบาลเมืองชัยภูมิ	சாயபம் நகராட்சி	mueang chaiyaphum
เทศบาลเมืองบุรีรัมย์	புரிராம்	bureerum public works
เทศบาลเมืองมหาสารคาม	மகா சாரகம் நகராட்சி	thesaban mueang maha sarakham
เทศบาลเมืองมุกดาหาร	முக்தஹான் நகராட்சி	mookdahan public works
เทศบาลเมืองสกลนคร	சகோன் நாகோன் நகராட்சி	municipality of sakonnakon
เทศบาลเมืองหนองคาย	நோங் கை நகராட்சி	nong khai municipality
เทศบาลเมืองหนองบัวลำภู	நோங் புவா லம்பூ டவுன் நகராட்சி	nong bua lam phu town municipality
เทศวิศาล	விரிவானது	tasavisakal - a surname
เทิดศักดิ์	மரியாதை	therdsak
เทียนทอง	தங்க மெழுகுவர்த்திகள்	tientong - a male's name
เทียนเงิน	வெள்ளி மெழுகுவர்த்தி	tienngern
เทียนโพธิ์สุวรรณ	தியான் ஃபோ சுவான்	tianphosuwan (thai last name)
เทเบิลเทนนิส	டேபிள் டென்னிஸ்	table tennis
เทโรศาสน	தேரோ சசனா	terosat football club
เท็ดดี้	டெடி	teddy
เท็นเท็น	பத்து பத்து	tin-tin
เท่ง	டெங்	teng (first name)
เท่านั้น	மட்டும்	only
เธคุนุ	ஆதரவு	dhekunu
เธรซ	திரேஸ்	thrace - an area in greece
เธอกับฉัน	நீயும் நானும்	you and i
เธอจะอยู่กับฉันตลอดไป	நீங்கள் என்றென்றும் என்னுடன் இருப்பீர்கள்	you will be with me forever
เธอยัง	நீங்கள் இன்னும்	tur yung
เธอเป็นเพื่อนอาบาราอิ	அவள் அபாராயின் தோழி.	she is a friend of arbarae
เนกิ	நேகி	negi
เนย	வெண்ணெய்	butter
เนรมิต	கண்டுபிடி	casting a spell
เนะ	சரி	ney
เนื่องจาก	முதல்	because
เนื่องจากประเทศเหล่านั้นอยู่ในตำแหน่งบนโลกที่ต่างไปจากประเทศไทย	ஏனென்றால் அவை தாய்லாந்திலிருந்து வேறுபட்ட பூமியில் உள்ளன	because those countries are in the group of...
เนื้อที่	பரப்பளவு	area
เนื้อที่ประมาณ	தோராயமான பகுதி	approximate area
เนื้อร้อง	பாடல் வரிகள்	lyrics
เนื้อเรื่องย่อ	சுருக்கம்	summary
เนเธอร์แลนด์	நெதர்லாந்து	netherlands
เนโกะ	நெக்கோ	neko
เน็น	நென்	nen
เบจิต้า	பெச்சிட்டா	vegeta
เบธเลเฮม	பெத்லகேம்	bethleham
เบนจามิน	பெஞ்சமின்	benjamin
เบรกมา	இடைவெளி	bregma
เบริธ	பெரித்	berith
เบลเฟกอล	சட்டவிரோத	belphegor- a demon in a legend
เบส	பாஸ்	bass
เบอร์ลิน	பெர்லின்	berlin
เบา	ஒளி	soft (voice)
เบาท์	பாட்	(dieric) bouts
เบาหวาน	நீரிழிவு நோய்	diabetes
เบื่ออาหาร	சலித்துவிட்டது	not appetite, eating disorder.
เบื้องหลัง	பின்னணி	behind the sence
เบโทเฟิน	பீத்தோவன்	beethoven
เบ็นเท็น	பென் 10	ben 10
เปรม	திருப்தி	pream
เปรี้ยว	புளிப்பான	sour
เปรู	பெரு	peru
เปลวไฟ	சுடர்	flame
เปลี่ยนชื่อเป็น	என மறுபெயரிடப்பட்டது	changed the name to
เปลื้อง	divest	nude
เปล่งพานิช	பிளெங்பானிச்	plengpanich
เปอร์เซีย	பெர்சியா	persia
เปอร์โตริโก้	புவேர்ட்டோ ரிக்கோ	puerto rico
เปิดสอนระดับปริญญาตรี	இளங்கலை படிப்புக்கு திறந்திருக்கும்	offer bachelor degree curriculum
เปียงยาง	பியோங்யாங்	piang yang - in north korea
เปียโตร	பியட்ரோ	pietro
เปียโน	பியானோ	piano
เปโซ	பெசோ	peso
เป็ด	வாத்து	duck
เป็น	உள்ளன	is
เป็นขนมของชาวไทยมุสลิม	தாய் முஸ்லிம்களின் இனிப்பு	is a thai-muslim dessert
เป็นครั้งแรก	முதல் முறையாக	first
เป็นงานเขียนในชุด	ஒரு தொகுப்பில் எழுதப்பட்ட படைப்பு	in the edition of...
เป็นต่อ	எதிராக	pen to
เป็นต้น	முதலியன	for example
เป็นต้นมา	முதல்	onward
เป็นต้นไม้ประจำมหาวิทยาลัย	என்பது பல்கலைக்கழகத்தின் மரம்	tree of university
เป็นบัวในสกุล	இனத்தில் தாமரை	is a lotus in the family
เป็นประธาน	ஜனாதிபதியாகுங்கள்	principal of
เป็นปลาตู้สวยงาม	ஒரு அழகான மீன் மீன்	is an ornamental fish
เป็นพระราชโอรสพระองค์เดียวในพระบาทสมเด็จพระปรมินทรมหาภูมิพลอดุลยเดช	பூமிபோல் ஆடுல்யாதேஜின் ஒரே மகன்	is the only son of
เป็นพ่อของ	தந்தை	is the father of
เป็นวิญญาณเทียมเพศชาย	ஒரு ஆண் செயற்கை ஆவி	the spirit who is a male
เป็นสีประจำ	வழக்கமான நிறம்	official color
เป็นหนึ่งใน	ஒன்றாகும்	is one of
เป็นหัวหน้าพรรค	கட்சித் தலைவர்	party leader
เป็นอดีตหัวหน้าหน่วยที่	அலகு முன்னாள் தலைவர்	is the former leader of the unit
เป็นอาวุธ	ஒரு ஆயுதமாக	as a weapon
เป็นเครื่องหมายแสดงว่า	அதற்கான அறிகுறியாகும்	indicates that
เป็นเจ้าเมืองปกครอง	கவர்னர்	governor
เป็นเมืองหลวง	என்பது மூலதனம்	capital
เป็นเวลา	க்கு	utilized time
เป็นโฮโมโลกัสกับ	உடன் ஒரு ஹோமோலோகஸ்	homologous
เป๊ปซี่	பெப்சி	pepsi
เพกาซัส	பெகாசஸ்	pegasus
เพชร	வைரம்	diamond
เพชรบุรี	பெட்சபுரி	petchaburi province
เพชรบูรณ์	பெட்சபூன்	prechabun
เพชรพระอุมา	டயமண்ட் ஃபிரா உமா	ancient diamond
เพชรา	வயதானவர்	petchara - name of a famous actress
เพชรเกษม	பெட்ச்காசெம்	petchakasem area in bangkok
เพดานอ่อน	மென்மையான உச்சவரம்பு	gill
เพทาย	சிர்கான்	zircon
เพพซิน	பெப்சின்	pepsin
เพราะ	ஏனெனில்	because
เพราะว่า	ஏனெனில்	because
เพรียะ	பிரியா	preah - cambodia
เพลงประกอบภาพยนตร์	திரைப்பட ஒலிப்பதிவு	soundtrack
เพลงประจำจังหวัด	மாகாண பாடல்	province anthem
เพลงประจำมหาวิทยาลัย	பல்கலைக்கழக பாடல்கள்	university song
เพลงปิดเรื่อง	கவர் பாடல்	pid reung song
เพลงพระราชนิพนธ์	ராயல் இசை	the king's song
เพลงลูกทุ่ง	நாட்டுப்புற இசை	folk song
เพลงลูกทุ่งขับร้อง	நாட்டுப்புற இசை	luk thung song
เพลงอีแซว	இசை கிண்டல்	a type of thai country music
เพลงเปิด	திறக்கும் பாடல்	opening song
เพลงเปิดเรื่อง	திறக்கும் பாடல்	opening song
เพลย์สเตชัน	பிளேஸ்டேஷன்	playstation
เพลโต	பிளேட்டோ	plato
เพศ	செக்ஸ்	sex
เพศชาย	ஆண் பாலினம்	male
เพิ่มมา	மேலும்	addition
เพียงพอ	போதும்	enough
เพื่อ	க்கு	for
เพื่อเป็นการเผยแผ่พระพุทธศาสนาและประชาสัมพันธ์กิจกรรมทางพระพุทธศาสนาต่าง	ப buddhism த்த மதத்தைப் பரப்புவதற்கும் மத நடவடிக்கைகளை மேம்படுத்துவதற்கும்	passing knowledge about buddhism
เพื่อใช้ร่วมกับตัวชี้วัดอื่น	பிற குறிகளுடன் பயன்படுத்தப்பட வேண்டும்	to be used with other indicators
เพ็ชรทาย	ஃபெத்தா	petchtai
เฟนิรามีน	ஃபெனிரமைன்	pheniramine
เฟย์	ஃபே	fay
เฟรดริก	ஃபிரடெரிக்	fredrick
เฟส	கட்டம்	phase
เฟอร์นิเจอร์	தளபாடங்கள்	furniture
เฟื่องอารมย์	உரத்த	fueangarom
เภสัชกร	மருந்தாளர்	pharmacist
เภสัชจลนศาสตร์	பார்மகோகினெடிக்ஸ்	pharmacokinetics
เม	மே	may
เมกา	மெகா	mega
เมฆ	மேகம்	clouds
เมฆออร์ต	oort மேகம்	ash cloud in the space
เมจิ	மீஜி	maji - a nickname
เมตร	மீ.	metre
เมทริกซ์	மேட்ரிக்ஸ்	matrix
เมทะนี	மெட்டானி	metanee - the surname of a famous actor
เมอร์คิวรี	புதன்	mercury
เมือง	நகரம்	town
เมืองทองฯ	முவாங் தோங்	muangthong
เมืองนครราชสีมา	நக்கோன் ராட்சாசிமா	nakornrachasrima city
เมืองปทุมธานี	பதும் தானி	mueang pathum thani
เมืองปราจีนบุรี	பிரச்சின்பூரி	prajinburi city
เมืองพิจิตร	பிச்சிட்	pijit city
เมืองพิษณุโลก	பிட்சானுலோக்	phitsanulok
เมืองยอง	ஸ்டாக் நகரம்	mueng-yor
เมืองลำพูน	லம்பூன்	lumpoon province
เมืองสกลนคร	சகோன் நகோன்	sakon nakhon
เมืองสิงห์	சிங்கா	muangsing
เมืองสุรินทร์	சுரின்	surin city
เมืองหลวง	மூலதனம்	capital city
เมืองหลวงของอาณาจักรเขมร	கெமர் பேரரசின் தலைநகரம்	capital of cambudia
เมืองเคมบริดจ์	கேம்பிரிட்ஜ் நகரம்	city of cambridge
เมืองเอก	அகே சிட்டி	mueang-ake
เมืองโคราช	கோரத்	muang korat
เมืองใหญ่	பெரிய நகரம்	city
เมืองใหญ่ในเขตนี้	இந்த மாவட்டத்தின் முக்கிய நகரங்கள்	capital presently
เมื่อประมาณ	எப்பொழுது	estimate
เมื่อปีพศ	கடந்த ஆண்டு	in buddhist era
เมื่อปีพุทธศักราช	ப buddhist த்த சகாப்தத்தில்	in b.e.
เมื่อวันจันทร์	திங்களன்று	on monday
เมื่อเดือนกันยายน	கடந்த செப்டம்பர்	in september
เมื่อเดือนมีนาคม	அணிவகுப்பில்	in march
เม็ดขนุน	பலாப்பழம்	metkhanun
เม่น	முள்ளம்பன்றி	porcupine
เย	நீங்கள்	yay - a sound
เยลโล่	மஞ்சள்	yellow
เยอรมนี	ஜெர்மனி	germany
เยอรมัน	ஜெர்மன்	german
เยาวชน	இளைஞர்கள்	youth
เยาวชนอายุ	இளைஞர்களின் வயது	youth age of ...
เยาวราช	சைனாடவுன்	yaowaraj
เยื่อหุ้มสมอง	புறணி	meninges
เรซูเม	தற்குறிப்பு	resume
เรด	சிவப்பு	red
เรดวัน	சிவப்பு நாள்	redone
เรย์	ரே	ray
เรวดี	நல்ல செய்தி	rawadee
เราเตอร์	திசைவி	router
เริ่มการผลิตนำเข้า	இறக்குமதி உற்பத்தியைத் தொடங்கவும்	importing
เริ่มก่อสร้าง	கட்டுமானத்தைத் தொடங்குங்கள்	began constuction
เริ่มจากเดือนพฤศจิกายนเมษายน	நவம்பர் முதல் ஏப்ரல் வரை	begins from november to april
เริ่มตั้งแต่อาณาจักรอยุธยาได้โจมตีอาณาจักรเขมร	ஆயர் இராச்சியம் கெமர் இராச்சியத்தைத் தாக்குவதில் தொடங்கி.	ever since the ayudhya (military) assault...
เรียกกันว่า	என்று அழைக்கப்படுகிறது	called
เรียกว่า	என்று அழைக்கப்படுகிறது	call
เรียล	உண்மையானது	real
เรียว	மெல்லிய	ryo
เรียวทาโร่	ரியோட்டாரோ	totoro - a japanese cartoon
เรียวเฮ	கம்பு ஹை	reohay - a japanese character
เรียะชอาณาจักร	இராச்சியம்	reacheanachak
เรืองรุ่ง	ஒளிரும்	rueangrung
เรืองศรี	ருவாங்ஸ்ரி	rueng sri - a surname
เรือตรี	படகு	ensign
เรือนนาค	நாகா ஹவுஸ்	nak castle
เรือยกพลขึ้นบก	தரையிறங்கும் கப்பல்	boat for advance the army
เรือสำรวจ	சர்வே கப்பல்	survey vessel
เรือเร็วโจมตี	வேக படகு தாக்குதல்	fast attack craft
เรือใบ	படகோட்டம்	sailboat
เรื่อง	பொருள்	story
เรื่องย่อ	சுருக்கம்	synopsis
เรื่องสั้น	சிறு கதை	short story
เร้กเก้	ரெக்கே	reggae
เลข	எண்	mathematics
เลขที่	எண்	number
เลขาธิการสหประชาชาติ	ஐக்கிய நாடுகள் சபையின் பொதுச்செயலாளர்	united nations secretary-general
เลนส์	லென்ஸ்	lens
เลออน	லியோன்	lyon
เลิฟ	காதல்	love
เลือดออกตามไรฟัน	ஸ்கர்வி	bleeding of the gum
เลโอ	லியோ	alo
เลโอนาร์โด	லியோனார்டோ	leonardo
เล็ก	சிறிய	small
เล่ม	நூல்	book
เล่มที่	புத்தக எண்	volume
เวทีทอง	தங்க நிலை	golden podium
เวล	வெயில்	vail
เวลาประมาณ	கணிக்கப்பட்ட நேரம்	approximate time
เวสต์	மேற்கு	west
เวอร์ชัน	பதிப்பு	version
เวอร์โก้	வெர்கோ	virgo
เวิร์คพอยท์	பணியிடம்	workpoint company
เวิร์คพอยท์สตูดิโอ	பணியிட ஸ்டுடியோ	workpoint studio
เวิร์ม	புழுக்கள்	worm
เวิลด์	உலகம்	world
เวียงสระ	வியாங் சா	wiang sa
เวียงสา	வியாங் சா	wiang sa
เวียนเทียนรอบอุโบสถหรือสถูปเจดีย์พุทธสถานต่าง	தேவாலயம் அல்லது பகோடாவைச் சுற்றி வட்டமிடுகிறது	a thai religious ceremony
เวโรนา	வெரோனா	verona in italy
เว็บ	வலை	web
เว็บสเตอร์	வெப்ஸ்டர்	webster
เว็บเบราว์เซอร์	இணைய உலாவி	web browser
เว็บไซต์ของเกมส์	விளையாட்டு வலைத்தளம்	gaming website
เว็บไซต์ซีไอเอ	சிஐஏ வலைத்தளம்	cia website
เว้นวรรค	இடம்	space
เศรษฐกิจพอเพียง	போதுமான பொருளாதாரம்	sufficiency economy
เศรษฐบุตร	சேதாபுத்ரா	settabut - the family that started bus system in thailand
เศรษฐศาสตร์จุลภาค	நுண் பொருளாதாரம்	microeconomics
เศรษฐศาสตร์มหภาค	மேக்ரோ பொருளாதாரம்	macroeconomics
เสงี่ยม	முறையாக	sa-ngiam
เสชนะ	வெற்றி	sechana
เสด็จพระราชสมภพ	அரச பிறப்பு	royal birth
เสนอชื่อเข้าชิงและรับรางวัล	ஒரு விருதை பரிந்துரைக்கவும் பெறவும்.	nominate and win
เสนา	சேனா	sena
เสนาเมือง	சேனா நகரம்	senamuang
เสนีวงศ์	செனி வோங்	seniwong
เสน่ห์	கவர்ச்சி	sanea
เสมอ	எப்போதும்	always
เสรี	இலவசம்	seri
เสรีภาพ	சுதந்திரம்	freedom
เสียง	ஒலி	sound
เสียงเปิด	திறந்த ஒலி	approximant, semi-vowel
เสียงเสียดแทรก	fricative ஒலி	noise
เสือจากัวร์	ஜாகுவார்	jaquar
เสื้อครุย	அங்கி	gown
เส้นทแยงมุม	மூலைவிட்ட	diagonal
เส้นพุ่ง	வரி	yarn that is used for weaving
เส้นโค้ง	வளைவு	curve
เส้นใย	ஃபைபர்	polymer, yarn
เหงื่อ	வியர்வை	sweat
เหตุการณ์	நிகழ்வு	situation
เหตุการณ์สำคัญ	முக்கியமான நிகழ்வு	important event
เหรียญ	பதக்கம்	coin
เหรียญกษาปณ์	புதினா	coin
เหรียญทอง	தங்க பதக்கம்	gold medal
เหรียญรัตนาภรณ์	ரத்தனபார்ன் நாணயம்	a special thai medallion
เหลือง	மஞ்சள்	yellow
เหลือสมาชิก	மீதமுள்ள உறுப்பினர்கள்	members left
เหล็ก	எஃகு	iron
เหล่านี้	இவை	these
เหล่าสุนทร	லாசோந்தோர்ன்	soontorn group
เห็นภาพลวงตา	மாயையைப் பாருங்கள்	seeing hallucination
เอก	முதலில்	the first tonal marker of thai writing system represented by  '
เอกชน	தனிப்பட்ட	private
เอกซ์	எக்ஸ்	x
เอกราช	சுதந்திரம்	sovereignty
เอกวาดอร์	ஈக்வடார்	edwardor
เอกสิทธิ์	சலுகை	privilege
เอจิเซ็น	எச்சிசென்	echizen
เอชไอวี	எச்.ஐ.வி.	hiv, human immunodevficiency virus
เอซ	ஏசஸ்	letter h
เอตาสีติ	அட்டகாட்டி	sesasiti
เอนจิเนียริ่ง	பொறியியல்	engineering
เอนไซม์	நொதி	enzyme
เอบีซี	ஏபிசி	abc
เอม	நோக்கம்	aim - could be a nickname
เอริค	எரிக்	eric
เอล	எல்	el
เอสปาด้า	எஸ்படா	eapada
เอสปาด้าตกชั้น	எஸ்படா வெளியேற்றப்பட்டார்	aspata
เอสเอ็ม	எஸ்.எம்	sm entertainment from korea
เอสโตเนีย	எஸ்டோனியா	astonia - a country
เออร์โกสเฟียร์	எர்கோஸ்பியர்	ergosphere
เอี่ยมยิ่ง	நான்	super, awesome
เอี่ยมสุข	நான் மகிழ்ச்சியாக இருக்கிறேன்	iamsuk
เอื้อย	யூரி	eay - a thai nickname
เอเชีย	ஆசியா	asia
เอเชียตะวันตกเฉียงใต้	தென்மேற்கு ஆசியா	southwest asia
เอเชียเหนือ	வடக்கு ஆசியா	north asia
เอเชียแปซิฟิก	ஆசிய பசிபிக்	asia-pacific
เอเชียใต้	தெற்கு ஆசியா	south asia
เอเธนส์	ஏதென்ஸ்	athens
เอเอฟซี	afc	afc
เอเอฟซีแชมเปียนส์ลีก	afc சாம்பியன்ஸ் லீக்	afc championship
เอ็กซ์โป	எக்ஸ்போ	expo
เอ็กโทเดิร์ม	எக்டெர்ம்	ectoderm, top level of skin layer.
เอ็กโปรพลาซ่า	எக்ஸ்போ பிளாசா	expo plaza in thailand
เอ็ดดูเทนเมนท์	கல்வி	edutainment
เอ็ดเวิร์ด	எட்வர்ட்	edward
เอ็น	தசைநார்	n
เอ็นบีเอ	nba	nba - national basketball association
เอ็นเตอร์เทนเม้นท์	பொழுதுபோக்கு	entertainment
เอ็นเทอร์เทนเมนท์	பொழுதுபோக்கு	entertainemnt
เอ็มม่า	எம்மா	emma
เอ๋	இ	ah - a nick name
เฮติ	ஹைட்டி	haiti
เฮลมุต	ஹெல்முட்	helmut
เฮสเตีย	ஹெஸ்டியா	hestia
เฮอร์เชล	ஹெர்ஷல்	herschel
เฮาส์	வீடு	house
เฮียวงะ	ஹ்யூகா	heonga
แกง	கறி	soup
แกมเบีย	காம்பியா	cambia
แกรนซ์	மானியம்	grantz
แกรมมี่	கிராமி	grammy
แกริซั่น	பாதுகாப்பு அரண்	garrison - an english name
แกลง	கிளாங்	glang
แกลเลอรี	கேலரி	gallery
แกสโทรโพดา	காஸ்ட்ரோபோடா	"name ""gastropoda"""
แกะ	ஆடுகள்	sheep
แกแล็คซี่	கேலக்ஸி	galaxy
แก่	க்கு	aging
แก้ว	கண்ணாடி	glass
แก้วทอง	தங்க கண்ணாடி	golden cup
แก้วบัวสาย	தாமரை கண்ணாடி	kaeobuasai
แก๊สธรรมชาติ	இயற்கை எரிவாயு	natural gas
แขก	விருந்தினர்	indian
แขน	கை	arm
แขวงจำปาสัก	சம்பசக் மாகாணம்	champasak province
แขวงหลวงพระบาง	லுவாங் பிரபாங் துணைப்பிரிவு	luang pra bang province
แคดเมียม	காட்மியம்	cadnium
แคทแพท	பூனை பாட்	kat - pat kamikaze - the thai famous stars
แคน	கெய்ன்	kan - a type of thai music
แคนดี้	மிட்டாய்	candy
แคนเซอร์	புற்றுநோய்	cancer
แคม	வெப்கேம்கள்	cam
แคมป์เบลล์	காம்ப்பெல்	campbell
แคมเปญ	பிரச்சாரம்	campagne
แคมเล็ก	சிறிய கேம்	vagina fold
แคมใหญ่	பெரிய கேம்	labia
แคร็กเกอร์	நட்கிராக்கர்	crackers
แคลคูลัสเชิงปริพันธ์	ஒருங்கிணைந்த கால்குலஸ்	integral calculas
แคลคูลัสเชิงอนุพันธ์	வேறுபட்ட கால்குலஸ்	differential calculus
แคลอรี	கலோரிகள்	calorie
แคลิฟอร์เนีย	கலிபோர்னியா	california
แคลิฟอร์เนียม	கலிபோர்னியா	californium
แคว้น	பிராந்தியம்	kwon - a korean surname
แจ	ஜாம்	live purely and clean both in body and mind - from chinese belief
แจ็กสัน	ஜாக்சன்	jackson
แจ็ค	ஜாக்	jack
แจ๊ค	ஜாக்	jack
แจ๊ส	ஜாஸ்	jazz
แด	டே	dae
แดงทั้งแผ่นดิน	முழு நிலம் சிவப்பு	red (political party all over the country
แดนสุพรรณ	சுபன்	dansuphan
แดเนียล	டேனியல்	daniel
แตน	ஹார்னெட்	grass hopper
แต่งงาน	திருமணம்	wedding, marriage
แต่งตั้ง	நியமிக்கவும்	giving a new title to
แต่งโดย	இசையமைத்தவர்	composed by
แต่ใน	ஆனால் உள்ளே	but in
แต่ในปัจจุบัน	ஆனால் இப்போது	in the present
แต่ไม่ประสบความสำเร็จ	ஆனால் வெற்றி இல்லாமல்	failed
แต่ไม่สำเร็จ	ஆனால் தோல்வியுற்றது	no success
แถบ	மதுக்கூடம்	flat fish
แทซิทัส	டாசிடஸ்	tacitus
แทน	பிரதிநிதித்துவம்	instead
แทนเจนต์	தொடுகோடு	tangent
แทยอน	தையியோன்	tae yon
แทลเลียม	தாலியம்	thallium
แท็กซี่	டாக்ஸி	taxi
แท็บเล็ต	டேப்லெட்	tablet computer
แนท	நாட்	nat
แนวความคิดที่	கருத்து	idea number...
แนวพระราชดำริ	ராயல் முயற்சி	royal initiative
แนสแด็ก	நாஸ்டாக்	nasdaq
แบคทีเรีย	பாக்டீரியா	bacteria
แบงค์	வங்கி	bank
แบทเทิลบรอลเลอร์	போர் டேங்கர்	battle brawlers
แบรนด์แอมบาสเดอร์	பிராண்ட் தூதர்	brand ambassador
แบ่งประเทศไทยออกเป็น	தாய்லாந்தை பிரிக்கவும்	dividing thailand into 6 areas
แบ่งออกเป็น	பிரிக்கப்பட்டுள்ளது	divided into...
แบ่งออกได้เป็น	பிரிக்கப்பட்டுள்ளது	divided into
แบ่งได้เป็น	எனப் பிரிக்கலாம்	divided into
แป้ง	மாவு	pang
แผนที่	வரைபடம்	map
แผนไพรีพินาศ	கூட்டமைப்பு திட்டம்	pan pirepinat - a plan to destroy the mobs
แผลศักดิ์สิทธิ์	புனித காயம்	stigmata
แผลไหม้	தீக்காயங்கள்	burn
แพทย์	மருத்துவர்	physician
แพน	பான்	pan
แพร่	பரவுதல்	the state of praa
แพลทฟอร์ม	நடைமேடை	platform
แพะ	வெள்ளாடு	goat
แพ้	இழக்க	to lose
แฟชั่น	ஃபேஷன்	fashion
แฟนเก่า	முன்னாள் காதலி	ex boyfriend/girlfriend
แฟมิลีที่ไปพักผ่อนที่เกาะมาเฟีย	குடும்பம் மாஃபியா தீவில் ஓய்வெடுக்க செல்கிறது	family that went to mafia island for vacation
แฟรงค์	பிராங்க்	frank
แฟรี่	தேவதை	fairy
แฟรี่เทล	விசித்திரக் கதை	fairy tale
แมกนีเซียม	வெளிமம்	magnesium
แมคอินทอช	மேகிண்டோஷ்	mcintosh
แมนดาริน	மாண்டரின்	mandarin
แมนเชสเตอร์	மான்செஸ்டர்	manchester
แมว	பூனை	cat
แมวป่า	வைல்ட் கேட்	jungle cat
แมวลายหินอ่อน	பளிங்கு தாவல்	pardofelis marmorata
แมวไทย	தாய் பூனை	thai cat
แม็คโคร	மக்ரோ	macro
แม่	அம்மா	mother
แม่จริม	அம்மா ஜிம்	mae charim
แม่ชี	கன்னியாஸ்திரிகள்	nun
แม่นาคพระโขนง	மே நக் ஃபிரா கானோங்	mae nak phra khanong
แม่น้ำ	நதி	river
แม่น้ำชี	சி நதி	chee river
แม่น้ำทะเลสาบสำคัญ	முக்கியமான ஏரி நதி	important rivers and lakes
แม่น้ำปิง	பிங் நதி	ping rover
แม่น้ำโขง	மீகாங் நதி	kong river from laos
แม่ริม	மே ரிம்	amphoe mae rim
แยกจากคลองชักพระฝั่งซ้าย	இடதுபுறத்தில் சக் ஃபிரா கால்வாயிலிருந்து பிரிக்கவும்	forks from khlong chak phra
แยกจากคลองบางกอกน้อยฝั่งซ้าย	இடதுபுறத்தில் உள்ள பாங்காக் நொய் கால்வாயிலிருந்து	forks from the left branch of khlong bangkok noi
แยกจากคลองบางกอกใหญ่ฝั่งขวา	வலதுபுறத்தில் பாங்காக் யாய் கால்வாயிலிருந்து சந்திப்பு	split from the bankok yai canal to the right
แยกจากคลองบางกอกใหญ่ฝั่งซ้าย	இடதுபுறத்தில் பாங்காக் யாய் கால்வாயிலிருந்து சந்தி	forked from khlong bangkok yai
แย้มนาม	பெயர்	yamnam - a surname
แย้มบุญเรือง	தகுதியைத் தேர்வுசெய்கிறது	yaembunrueang
แรงโน้มถ่วง	ஈர்ப்பு	gravity
แร็ปเปอร์	ராப்பர்	rapper
แลกเปลี่ยนโดยถือ	வைத்திருப்பதன் மூலம் பரிமாற்றம்	exchange, conversion
แลมบ์ดา	லாம்ப்டா	lampda
และ	மற்றும்	and
และกลายเป็นอู่ข้าวอู่น้ำที่มีชื่อเสียงของไทย	மற்றும் தாய்லாந்தில் ஒரு பிரபலமான பிரெட் பாஸ்கெட்டாக மாறியது	and becoming the futile land
และกัมพูชา	மற்றும் கம்போடியா	and cambodia
และครอบครัว	மற்றும் குடும்பம்	and family
และคำว่า	மற்றும் சொல்	"and the word ""......."""
และจังหวัดใกล้เคียง	மற்றும் அருகிலுள்ள மாகாணங்கள்	and nearby state
และดุษฎีบัณฑิต	மற்றும் டாக்டர் ஆஃப் தத்துவவியல்	honorary degree
และตามสภาพเศรษฐกิจและสังคม	மற்றும் பொருளாதார மற்றும் சமூக நிலைமைகளின்படி	and following the economy and social conditions
และตำแหน่ง	மற்றும் நிலை	and position
และที่สำคัญคือ	மற்றும் முக்கியமான விஷயம்	and important thing is...
และธงของต่างประเทศ	மற்றும் வெளிநாட்டு கொடிகள்	and other countries' flags
และปัจจุบัน	மற்றும் தற்போது	now
และพรรคฟุนซินเปค	மற்றும் ஃபஞ்சின்பெக் கட்சி	funcinpec
และรถไฟ	மற்றும் ரயில்	and railways
และรัสเซีย	மற்றும் ரஷ்யா	and russia
และสหรัฐอเมริกา	மற்றும் அமெரிக்கா	in america
และสังคม	மற்றும் சமூகம்	and society
และสังคมศาสตร์	மற்றும் சமூக அறிவியல்	and social science
และสัตว์	மற்றும் விலங்குகள்	and animal
และสโรชา	மற்றும் சரோச்சா	and sarocha - a male's name
และหลังจากสงครามภายใน	மற்றும் உள் போருக்குப் பிறகு	after inside war
และออกซิเจน	மற்றும் ஆக்ஸிஜன்	and oxygen
และอำเภอกันทรารมย์	மற்றும் காந்தாரோம் மாவட்டம்	and kanthararom district
และอื่น	மற்றும் பலர்	etc.
และอเมริกาเหนือ	மற்றும் வடக்கு அமெரிக்கா	and north america
และเปียโน	மற்றும் பியானோ	and piano
และเป็น	மற்றும் உள்ளது	is also
และเป็นสมาชิกราชวงศ์	மற்றும் அரச குடும்பத்தைச் சேர்ந்தவர்	in monarchs family
และเมืองเก่า	மற்றும் பழைய நகரம்	old city
และเมื่อวันที่	மற்றும்	when date
และเรียกว่า	மற்றும் அழைத்தார்	and call
และโลก	மற்றும் உலகம்	and earth
และในปี	மற்றும் ஆண்டில்	and in the year
และได้ปรากฏตัวตอนภาค	மற்றும் அத்தியாயத்தில் தோன்றியது	appeared
แล้วเดินเวียนรอบปูชนียสถาน	பின்னர் சரணாலயத்தை சுற்றி நடந்தார்	walk with lighted candles in hand around a temple
แวน	வேன்	wan
แสงจันทร์	நிலவொளி	saengchan
แสงชูโต	சுட்டோ	sangchuto - a surname
แสงทอง	சாங்தாங்	golden sun ray
แสงสิงแก้ว	சாங் சிங்க்கேவ்	sangsingkaew
แสงเทียน	மெழுகுவர்த்தி	saengthian
แสตมป์	முத்திரை	stamp
แสนรัก	காதல்	saenrak
แสนโภศิก	சென் போசிக்	sankosuk - a surname
แหลมสิงห์	லாம் பாடு	lam sing - a famous country singer in thailand
แหล่งท่องเที่ยว	சுற்றுலா ஈர்ப்பு	tourist attraction
แหล่งโบราณคดีบ้านเชียง	பான் சியாங் தொல்பொருள் தளம்	ban chiang archaeological site
แหวน	மோதிரம்	ring
แหวนธรรมดา	வெற்று வளையம்	ordinary ring
แหวนมาเล่ริง	ஆண் வளையம்	ring (faux jewelry)
แห่งบันนัม	பான் நாம்	of bannam
แห่งสหประชาชาติ	ஐக்கிய நாடுகள்	of united nations
แองกวิลลา	அங்குவிலா	anguilla
แองเจิ้ล	தேவதை	angel
แอซิด	அமிலம்	acid
แอด	கூட்டு	add
แอนดรอยด์	android	android
แอนดี้	ஆண்டி	andy
แอนด์	மற்றும்	and
แอนิเมชัน	இயங்குபடம்	animation
แอนเนลิดา	அன்னெலிடா	annelida phylum
แอนโทนี	அந்தோணி	anthony
แอฟริกา	ஆப்பிரிக்கா	africa
แอฟริกาใต้	தென்னாப்பிரிக்கா	south africa
แอมะซอน	அமேசான்	amazon
แอมเวย์	ஆம்வே	amway
แอร์ไลน์	விமான நிறுவனங்கள்	airlines
แอล	எல்	letter 'l'
แอลจีเรีย	அல்ஜீரியா	algeria
แอสกี	ஆஸ்கி	ascii
แอสซิสต์	உதவு	assist
แอสปาร์แตม	அஸ்பார்டேம்	aspartame
แฮช	ஹாஷ்	hash
แฮปปี้	சந்தோஷமாக	happy
แฮปปี้และชาร์ล	இனிய மற்றும் சார்லஸ்	happy and charles
แฮ็ค	ஹேக்கிங்	hack
โกบอล	உலகளாவிய	cobalt
โกร	வளருங்கள்	guro
โกรกพระ	கிரெவிஸ்	krok-phra
โกลด์	தங்கம்	gold
โกวิท	கோவிட்	kowit
โกโก้	கோகோ	cocoa
โขน	pantomime	khon
โคกสำโรง	கோக் சாம்ராங்	koksamrong
โคนัน	கோனன்	conan
โคฟี	கோஃபி	kofe annan
โครงการ	திட்டம்	project
โครงการก่อสร้าง	கட்டுமான திட்டம்	project
โครงการนานาชาติ	சர்வதேச திட்டம்	international program
โครงการศิลปินแห่งชาติ	தேசிய கலைஞர் திட்டம்	national artist campaign
โครงการเรียนภาษาอังกฤษแบบเข้ม	தீவிர ஆங்கில கற்றல் திட்டம்	intensive english program
โครงสร้างภายใน	உள் கட்டமைப்பு	internal structure
โคราช	கோரத்	khorat or nakorn rajjasrima state
โครโมโซม	குரோமோசோம்	chromosome
โคล	கோல்	cold
โคลอมเบีย	கொலம்பியா	colombia
โคล้ด	குறியீடு	claude
โคเคน	கோகோயின்	cocain
โคเบะ	கோபி	kobe
โคแทนเจนต์	cotangent	cotangent
โคโทเน่ที่	இல் கோட்டோன்	kotone
โฆษะ	குரல்	kosa
โฆษิตพิพัฒน์	கோசித் பிபாட்	the surname kopitpipat
โจจิ	ஜோஜி	choji
โจเซฟ	ஜோசப்	joseph
โจโจ้	ஜோஜோ	jojo
โช	சோ	sho
โชคดี	நல்ல அதிர்ஷ்டம்	lucky
โชว์	காட்டு	show
โชอิจิ	ஷோச்சி	shoichi
โชแปง	சோபின்	chopin
โซน	மண்டலம்	zone
โซนยอชิแด	பெண்கள் தலைமுறை	senyosede - a japanese name
โซนี่	சோனி	sony company
โซล	சியோல்	seoul
โซลดิ๊ก	சோல்டிக்	sol-dig
โซลโซไซตี้	சோல் சொசைட்டி	soul society
โซเดียม	சோடியம்	sodium
โซเฟีย	சோபியா	sofia
โดจินชิ	ஜின்ச்சி செய்யுங்கள்	dōjinshi
โดย	வழங்கியவர்	by
โดยคำว่า	வார்த்தையால்	by the word
โดยตรง	நேரடியாக	directly
โดยทรงพระกรุณาโปรดเกล้าฯ	அவரது மாட்சிமை மூலம் தயவுசெய்து வழங்கப்பட்டது	the king's order
โดยที่	எங்கே	by
โดยบ่งบอกถึงปริมาณและคุณภาพของสิ่งตีพิมพ์อิเล็กทรอนิกส์ของสถาบัน	நிறுவனத்தின் மின்னணு வெளியீடுகளின் அளவு மற்றும் தரத்தைக் குறிப்பதன் மூலம்	stating the limitation and quality of a product
โดยปกติ	பொதுவாக	regular, common, normalcy
โดยปกติตามวัดต่าง	பொதுவாக வெவ்வேறு கோயில்களின் படி	normally, at the various temples...
โดยปกติแล้ว	பொதுவாக	usually
โดยมี	உடன்	make available
โดยมีตัวอย่างบทพากย์ฉบัง	கவிதைகளின் எடுத்துக்காட்டுகளுடன்	background movie in music video
โดยมีพระภิกษุสงฆ์นำเวียนเทียน	ஒரு துறவி மெழுகுவர்த்தி ஏற்றி ஊர்வலத்தை வழிநடத்தினார்	buddhist monks performing ceremony for vientien buddhist religious holiday
โดยราชบัณฑิตยสถาน	எழுதியவர் ராயல் நிறுவனம்	by royal institute
โดยสรุป	சுருக்கமாக	in summary.
โดยเจ้าฟ้าธรรมธิเบศรไชยเชษฐสุริยวงศ์	எழுதியவர் இளவரசர் தாமதிபேட் சோர்ன்சாய் சேட்சூரியாவோங்	the name of a king
โดยใช้ชื่อว่า	பெயரால்	using name
โดยใช้ทางหลวงแผ่นดินหมายเลข	தேசிய நெடுஞ்சாலை மூலம்	using freeway #________
โดยในวันที่	மூலம்	on the date of ___
โดราเอมอนฉบับภาพยนตร์	டோரமன் மூவி பதிப்பு	doraemon movie
โดเมกิ	டோமோம்	domagi - a japanese word.
โดเมน	களம்	domain
โต	வளர்ந்த	big
โตชิบา	தோஷிபா	toshiba
โทน	டோன்	tone
โทนะหงษา	டோனாஹாசா	tonahongsa - a surname
โทนี่	டோனி	tony
โทบรามัยซิน	டோபாமைசின்	tobramycin
โทมัส	தாமஸ்	thomas
โทรจัน	ட்ரோஜன்	trojan
โทรลล์	பூதம்	troll
โทริคาบูโตะ	டோரிகாபுடோ	torikabuto - a japanese word
โทรโข่ง	மெகாஃபோன்	a megaphone, portable sound directing equipment.
โน	இல்லை	no
โนบิตะ	நோபிடா	nobita
โนบิตะและอัศวินแดนวิหค	நோபிடா மற்றும் நைட்	nobita and the winged braves
โนรา	நோரா	nora
โนะ	டினோ	noh - a japanese word
โนเบล	நோபல்	nobel prize
โบตั๋นกลีบสุดท้าย	கடைசி பியோனி	botun kleep suttai - a novel
โบราณสถาน	தொல்பொருள் தளம்	the ancient place
โบอิง	போயிங்	boeing company
โบฮีเมีย	போஹேமியா	bohemia
โบแดง	போற்றத்தக்கது	bodin
โปงลางสะออน	போங்லாங் சா-ஆன்	pong langsaoun
โปรดเกล้า	தயவு செய்து	the king's order
โปรตอน	புரோட்டான்	proton
โปรตีน	புரத	protein
โปรเจกต์	திட்டம்	project
โปรเจกต์พิเศษ	சிறப்பு திட்டம்	special project
โปรแกรมคอมพิวเตอร์	கணினி நிரல்	computer programming
โปรโมชั่น	பதவி உயர்வு	promotion
โปเกมอน	போகிமொன்	pokemon, a very popular japanese anime.
โป๊	நிர்வாணமாக	nude
โพธิ์ศรี	போஸ்ரி	phosi
โพนพิสัย	ஃபோன் பிசாய்	phonphisai
โพรทิสต์	புராட்டிஸ்ட்	protist
โพแทสเซียม	பொட்டாசியம்	potassium
โฟลต	மிதவை	float
โฟลเอ็ม	ஃப்ளோ எம்	phloem
โฟโตสเฟียร์	புகைப்படக் கோளங்கள்	photosphere
โมซาร์ท	மொஸார்ட்	mozart
โมบิลสูทกันดั้ม	மொபைல் சூட் குண்டம்	mobile suit gundam
โมรา	chalcedony	agate
โมร็อกโก	மொராக்கோ	morocco
โมลิบดีนัม	மாலிப்டினம்	molybdenum
โมฮัมหมัด	முகமது	mohamad
โมเดิร์น	நவீன	modern
โมเต็ต	மோட்டேட்	motet (sound)
โมเลกุล	மூலக்கூறுகள்	molecule
โมโคนะ	மோகோனா	mokona - a japanese word
โมโนไซต์	மோனோ தளம்	mono site.
โยชิโนะ	யோஷினோ	yoshino
โยฮันน์	ஜோஹன்	johann
โยเซฟ	ஜோசப்	joseph
โรค	நோய்	disease
โรคประจำตัว	பிறவி நோய்	personal illness
โรคปอดบวม	நிமோனியா	pneumonia
โรคออทิซึม	மன இறுக்கம்	autism
โรคุโด	ரோகுடோ	rokudo
โรคเกาต์	கீல்வாதம்	gout
โรคไต	சிறுநீரக நோய்	kidney disease
โรงพยาบาลกรุงเทพ	பாங்காக் மருத்துவமனை	krung thep hospital
โรงพยาบาลจุฬาลงกรณ์	கிங் சுலலாங்கொர்ன் நினைவு மருத்துவமனை	king chulalongkorn memorial hospital
โรงพยาบาลรามาธิบดี	ராமதிபோடி மருத்துவமனை	ramathibodi hospital
โรงพยาบาลอานันทมหิดล	ஆனந்தமஹிடோல் மருத்துவமனை	ananthamahidol hospital
โรงพยาบาลอุตรดิตถ์	உத்தரடித் மருத்துவமனை	uttaradit hospital
โรงละคร	திரையரங்கம்	theater
โรงเรียนการบิน	விமானப் பள்ளி	aviation school
โรงเรียนดาราวิทยาลัย	தாரா கல்லூரி	dara academy
โรงเรียนนนทรีวิทยา	நோன்சி வித்தயா பள்ளி	nontrivittaya school
โรงเรียนนายเรือ	கடற்படை அகாடமி	royal thai naval academy
โรงเรียนนายเรืออากาศ	ராயல் தாய் விமானப்படை அகாடமி	royal thai air force academy
โรงเรียนบดินทรเดชา	போடிண்டேச்சா பள்ளி	bodindecha school
โรงเรียนประชานิเวศน์	பிரச்சனிவெட் பள்ளி	prachanivet school
โรงเรียนปรินส์รอยแยลส์วิทยาลัย	பிரின்ஸ் ராயல் கல்லூரி	the prince royal's college
โรงเรียนพระตำหนักสวนกุหลาบ	சுவான் குலார்ப் தம்னக் பள்ளி	the school in the king's compound.  it is reserved for the princess and the royal family
โรงเรียนมัธยมสาธิตวัดพระศรีมหาธาตุ	வாட் ஃபிரா சி மகாதத்தின் மேல்நிலைப் பள்ளி ஆர்ப்பாட்டம்	wat phrasri mahadhat secondary demonstration school
โรงเรียนมารีวิทย์	மேரி விட் பள்ளி	maryvit school
โรงเรียนยุพราชวิทยาลัย	யூப்பரத் விட்டாயலாய் பள்ளி	yupparaj wittayalai school
โรงเรียนราชินีบน	மேல் ராணி பள்ளி	rachinibon school in thailand
โรงเรียนวัฒโนทัยพายัพ	வட்டனோதாய் பயாப் பள்ளி	vattanotaipayup school
โรงเรียนศึกษานารี	நரி ஸ்கூல் ஆஃப் எஜுகேஷன்	suksanari school
โรงเรียนสาธิต	ஆர்ப்பாட்டம் பள்ளி	demonstration school
โรงเรียนสาธิตแห่งมหาวิทยาลัยเกษตรศาสตร์	கசெட்சார்ட் பல்கலைக்கழக ஆர்ப்பாட்டம் பள்ளி	kasetsart university laboratory school
โรงเรียนห้องสอนศึกษา	பள்ளி கற்பித்தல் அறை	class room in school
โรงเรียนเขมะสิริอนุสสรณ์	கெமசிறி அனுசோர்ன் பள்ளி	kamasirianussorn school
โรงเรียนเจ้าพระยาวิทยาคม	சாவோ ஃபிரயா வித்தயகோம் பள்ளி	chao praya vitanakom school
โรงเรียนเฉลิมพระเกียรติสมเด็จพระศรีนครินทร์	சலோம் ஃப்ராகியாட் சோம்டெட் ஃபிரா ஸ்ரீநகரிந்திர பள்ளி	srinagarindra the princress mother school
โรงเรียนเทศบาล	பொது பள்ளி	public schools
โรงเรียนไตรมิตรวิทยาลัย	டிராமிட் விட்டயலாய் பள்ளி	trimittavitayalai school
โรงแรม	ஹோட்டல்	hotel
โรจูโร่	ரோஜெரோ	rojuro - a japanese character
โรตารี	ரோட்டரி	rotary
โรม	ரோம்	rome
โรมัน	ரோமன்	roman
โรลเลอร์เบลด	உருளை கத்தி	rollerblade
โรส	உயர்ந்தது	rose
โรเจอร์	ரோஜர்	"name ""roger"""
โลก	உலகம்	world
โลกแอมะซอน	அமேசான் உலகம்	world of amazon
โลงหิน	சர்கோபகஸ்	sarcophagus
โลโซ	லோசோ	lasso
โสณกุล	சோனகுல்	sonakul
โสน	செஸ்பேனியா	sa-nho, has yellow flower, use in thai sweet/desert
โสภณ	அழகான	sophon
โหมด	பயன்முறை	mode
โหม่ง	சமாளித்தல்	mong - a thai musical instrument
โอกาส	வாய்ப்பு	opportunities
โอบามา	ஒபாமா	obama
โอภาส	புத்திசாலித்தனம்	oh pas - a thai name
โอร์มาน	ஓமான்	oman - country
โอวีเอ	ova	ova
โอสถสภา	ஒசோட்ஸ்பா	osotspa
โอสถานุเคราะห์	ஒசாதானுக்ரா	social service
โออิชิ	ஓஷி	oochi - a name of food business in thailand
โอะกินะวะ	ஒகினாவா	okinawa
โอเค	சரி	ok
โอเอกซ์	டிக் டாக் டோ	ox - a game like tic tac toe
โฮม	வீடு	"english word ""home"""
โฮลดิ้ง	வைத்திருத்தல்	houlding
ใจดี	கருணை	chaidi
ใช่	ஆம்!	yes
ใช้ขยายความเฉพาะบุคคล	தனிப்பயனாக்க பயன்படுத்தவும்	to describe
ใช้ชื่อว่า	பெயரிடப்பட்டது	named
ใช้เวลา	நேரம் ஒதுக்குங்கள்	it takes time
ใต้	கீழ்	south
ในกรณีนี้	இந்த வழக்கில்	in this isituation
ในกลุ่ม	குழுவில்	in group
ในการประเมินผลงานวิจัยของสถาบัน	நிறுவனத்தின் ஆராய்ச்சி முடிவுகளை மதிப்பீடு செய்வதில்	in research evaluating of institute
ในการเลือกตั้ง	தேர்தலில்	election
ในกาลต่อมา	எதிர்காலத்தில்	later
ในขณะที่	போது	while
ในคริสต์ศตวรรษที่	19 ஆம் நூற்றாண்டில்	in the #___ century
ในคศ	வருடத்தில்	in a.d.
ในชิงร้อยชิงล้าน	சிங் சிங் மில்லியனில்	game show to compete for 1 million baht
ในช่วงปี	வருடத்தின் போது	in the year of ________
ในช่วงสงครามเย็น	பனிப்போரின் போது	during the cold war
ในช่วงสงครามโลกครั้งที่	உலகப் போரின் போது	in time of world war
ในช่วงสงครามโลกครั้งที่สอง	இரண்டாம் உலகப் போரின் போது	during world war ii
ในช่วงหลัง	பின்னர்	later
ในช่วงแรก	ஆரம்பத்தில்	in the first part, primarily
ในดาร์ฟูร์	டார்பூரில்	inside dafur
ในต่างประเทศ	வெளிநாடுகளில்	foreign countries
ในทางกลับกัน	மறுபுறம்	opposite
ในทางดาราศาสตร์	வானியலில்	astrology
ในทางตรงกันข้าม	மாறாக	oppositely
ในบางฉบับ	சில பதிப்புகளில்	in a certain issue (of a magazine)
ในประเทศญี่ปุ่น	ஜப்பானில்	japan
ในปลายปี	ஆண்டு இறுதியில்	at teh end of the year
ในปี	வருடத்தில்	in the year
ในปีที่	வருடத்தில்	in year
ในปีนี้	இந்த வருடம்	in this year
ในปีพศ	வருடத்தில்	in b.e. year
ในปีพุทธศักราช	வருடத்தில்.	in b.e.
ในปีเดียวกัน	அதே ஆண்டில்	in the same year
ในปีเดียวกันนั้น	அதே ஆண்டில்	in that year
ในพระบาทสมเด็จพระพุทธยอดฟ้าจุฬาโลก	மன்னர் புத்த யோத்ஃபா சுலா லோக்கின் ஆட்சியில்	under the reign of one of the thailand's past king
ในพระบาทสมเด็จพระพุทธเลิศหล้านภาลัย	ஹிஸ் மெஜஸ்டி தி கிங், ஃபிரா புத்த லெர்ட்லா, நபாலாய்	under one of the king of siam
ในภายหลัง	பின்னர்	background
ในภาษาสันสกฤต	சமஸ்கிருதத்தில்	in sanskrit language
ในภาษาอังกฤษ	ஆங்கிலத்தில்	in english
ในภาษาอิตาลี่	இத்தாலிய மொழியில்	in italian
ในภาษาไทย	தாய் மொழியில்	in the thai language
ในยุคกลาง	நடுத்தர வயதில்	in the middle ages
ในยุคแรก	ஆரம்பத்தில்	in early age
ในระบบสุริยะ	சூரிய மண்டலத்தில்	in the solar system
ในระยะหลัง	சமீபத்தில்	at the end
ในระหว่างปี	வருடத்தின் போது	between the years
ในระหว่างวันที่	பகலில்	during the dates
ในรัชสมัยพระบาทสมเด็จพระจอมเกล้าเจ้าอยู่หัว	மன்னர் மொங்க்குட் ஆட்சியின் போது	in the reign of thailand's 4th king
ในรัฐบาล	அரசாங்கத்தில்	in the government
ในฤดูกาล	பருவத்தில்	in season
ในสมัยกรุงศรีอยุธยา	ஆயுதயா காலத்தில்	in  ayutthaya kingdom era
ในสมัยก่อน	பழைய நாட்களில்	in the past
ในสมัยพุทธกาล	நவீன யுகத்தில்	in buddha era
ในสมัยรัชกาลที่	ஆட்சியின் போது	in period
ในสหรัฐอเมริกา	அமெரிக்காவில்	in united states of america
ในหนังสือ	புத்தகத்தில்	in book
ในอดีต	கடந்த காலத்தில்	in the past
ในอดีตทุ่งกุลาร้องไห้ในฤดูแล้ง	கடந்த காலத்தில், துங் குலா வறண்ட காலங்களில் அழுதார்.	thung kula rong hai in dry season in the past
ในอัลบั้ม	ஆல்பத்தில்	in the album
ในเกมเดอะซิมส์	சிம்ஸ் விளையாட்டில்	sims game
ในเครือ	இணைந்த	in the area of
ในเดือน	மாதத்தில்	in the month of ...
ในเดือนมิถุนายน	ஜூனில்	in june
ในเดือนมีนาคม	அணிவகுப்பில்	in april
ในเบื้องต้น	ஆரம்பத்தில்	primarily
ในเรื่อง	சம்பந்தமாக	in story
ในเหตุการณ์	அப்படி ஒருவேளை நடந்தால்	in the event
ในเอเชียตะวันออกเฉียงใต้	தென்கிழக்கு ஆசியாவில்	in southeast asia.
ในแฮร์รี่	ஹாரி	in harry
ในโอกาสครบรอบ	ஆண்டுவிழா அன்று	anniversary
ใบเสมา	போர்க்களங்கள்	boundary marker of a temple
ใหญ่	பெரியது	large
ให้พลเอกเปรม	ஜெனரல் பிரேமுக்கு	general prem - a former military figure
ให้สมเด็จพระเทพรัตนราชสุดาฯ	எச்.ஆர்.எச் இளவரசி மகா சக்ரி சிரிந்தோர்னுக்கு	given to the thai's eldest princess
ให้เสียงพากย์	குரல் நடிப்பு	dubbed
ให้แก่ประชาชน	மக்களுக்கு	for the people
ให้ใช้หลัก	கொள்கையைப் பயன்படுத்துங்கள்	large size
ไกรทอง	கிராய் தாங்	krei thong - a surname
ไกรลาศ	கிரைலத்	krailard
ไกลกังวล	கவலை	klai kangwon
ไก่	கோழி	chicken
ไขมัน	கொழுப்பு	lipid, fat
ไขสันหลัง	பித்	spinal cord
ไข่	முட்டை	egg
ไข้รากสาดใหญ่	டைபஸ்	typhus
ไข้สูง	அதிக காய்ச்சல்	high fever
ไข้หวัดใหญ่สายพันธุ์ใหม่	காய்ச்சலின் புதிய திரிபு	new flu strain
ไข้หวัดใหญ่สเปน	ஸ்பானிஷ் காய்ச்சல்	spanish flu
ไคเอ็น	கெய்ன்	kaien
ไชยกิตติ	சாய் கிட்டி	chaikitti
ไชยยงค์	சாயோங்	chaiyayong
ไชยวัฒน์	சைவத்	chaiwat
ไชยา	சாயா	chaiya
ไชโย	பிராவோ!	chaiyo
ไซน์	சைன்	sine
ไซโทสเกเลตอน	ஜீடோஸ் கட்டீலா	cytoskeleton
ไซโปรเฮปตาดีน	சிப்ரோ ஹெப்டாடின்	cyproheptadine
ไดคลอกซาซิลลิน	டைக்லோக் சிலின்	dicloxacillin - a drug
ไดดาโนซีน	டைனோசீன்	didanosine - medication
ไดอาน่า	டயானா	diana
ไดโนเสาร์ของโนบิตะ	நோபிடாவின் டைனோசர்	nobita's dinosaur
ได้	வேண்டும்	receive
ได้กล่าวว่า	கூறினார்	stating that, commenting on something
ได้ดังนี้	பின்வருமாறு	these
ได้ทูลเกล้าฯ	வழங்கப்பட்டது	report to the king
ได้มีโอกาสสร้างความสัมพันธ์อันดีต่อกัน	ஒருவருக்கொருவர் நல்ல உறவை வளர்ப்பதற்கான வாய்ப்பைப் பெறுங்கள்	good relationship
ได้รับ	பெறு	received
ได้รับฉายาว่า	புனைப்பெயரைப் பெற்றது	recived the alias
ได้รับรางวัล	ஒரு விருது கிடைக்கும்	awarded
ได้ร่วมกันในภารกิจในด้านต่าง	ஒன்றாக பல்வேறு துறைகளில் பணி.	participated in activities
ได้สำเร็จ	வெற்றிகரமாக	successfully
ได้สู้กับ	உடன் போராடியது	competing against
ได้เคลื่อนไหวตรวจสอบการทำงานของรัฐบาลกัมพูชาอย่างแข็งขัน	கம்போடிய அரசாங்கத்தின் பணிகளை ஆய்வு செய்ய தீவிரமாக நகர்ந்துள்ளது	underground investigation
ได้เป็น	இருக்க வேண்டும்	is
ไต	சிறுநீரகம்	kidney
ไต้หวัน	தைவான்	taiwan
ไท	சுயாதீனமான	tai
ไทย	தாய்	thai
ไทยทีวีสีช่อง	தாய் கலர் டிவி சேனல்	thai tv
ไทยพรีเมียร์ลีก	தாய் பிரீமியர் லீக்	thai premiere
ไทยรามา	தாய் ராமர்	thairama
ไทยานนท์	தியானான்	taiyanon - a thai surname
ไทรโลจี	முத்தொகுப்பு	trilogy
ไทลื้อ	தாய் லூ	group of laotians that lives on flatlands
ไทโรซีน	டைரோசின்	thyrosine
ไนท์	இரவு	sege
ไนลอน	நைலான்	nylon
ไนโตรเจน	நைட்ரஜன்	nitrogen
ไปจนถึง	க்கு	to
ไปบรรจบแม่น้ำเจ้าพระยา	சாவோ ஃபிரயா நதியை சந்திக்கவும்	runs to chao phraya river
ไปรษณีย์กาฬสินธุ์	கலாசின் தபால் அலுவலகம்	kalasin post office
ไปรษณีย์ฉะเชิงเทรา	சச்சோங்சாவ் தபால் அலுவலகம்	cha cheng sao postal zone
ไปรษณีย์นครศรีธรรมราช	நகோன் சி தம்மரத் தபால் அலுவலகம்	nakornsritamarat postal station
ไปรษณีย์ภูเวียง	ஃபூ வியாங் தபால் அலுவலகம்	pu weang postal office
ไปรษณีย์ยานนาวา	யன்னவா தபால் அலுவலகம்	yan nawa post office
ไปรษณีย์ร้อยเอ็ด	ரோய் மற்றும் தபால் அலுவலகம்	roi et post office
ไปรษณีย์สามเสนใน	சாம்சென் நாய் தபால் அலுவலகம்	samsen nai post office
ไปรษณีย์หนองหาน	நோங் ஹான் தபால் அலுவலகம்	nong han postal office
ไปรษณีย์อำนาจเจริญ	அம்னாத் சாரோன் தபால் அலுவலகம்	amnat charoen post office
ไปรษณีย์อุทุมพรพิสัย	உத்தம்போன் பிசாய் தபால் அலுவலகம்	utumporn pisai post office
ไปรษณีย์อุบลราชธานี	உபோன் ராட்சதானி தபால் அலுவலகம்	ubon ratchathani post office
ไปรษณีย์เดชอุดม	தபால் அலுவலகம்	det udom post office
ไปรษณีย์โพนพิสัย	தொலைபேசி பிசாய் தபால் அலுவலகம்	phon phisai post office
ไผ่แดง	சிவப்பு மூங்கில்	red bamboo
ไพฑูรย์	chrysoberyl	phaithun
ไพรบึง	காடு	phrai bueng
ไพรวัลย์	பிரைவான்	phraiwan
ไพศาล	விரிவான	phaisan
ไฟ	தீ	fire
ไฟนอลแฟนตาซี	இறுதி பேண்டஸி	final fantasy
ไฟร์วอลล์	ஃபயர்வால்	firewall
ไมค์	மைக்	mike
ไมอามี่	மியாமி	miami
ไมโครซอฟท์	மைக்ரோசாப்ட்	microsoft
ไม่ต่ำกว่า	கொஞ்சமும் குறைவின்றி	not lower than
ไม่ทราบข้อมูล	தெரியாத தகவல்	no background information
ไม่บังคับ	விரும்பினால்	not enforced
ไม่ผ่านเข้ารอบ	தகுதி இல்லை	did not make it to the next round, got eliminated in the initial round
ไม่มีบันทึกว่าใครเป็นคนสร้าง	இதை உருவாக்கியவர் யார் என்பது குறித்து எந்த பதிவும் இல்லை.	don't note who make id
ไม่มีแขน	ஆயுதங்கள் இல்லை	armless
ไม่ว่าจะ	என்பது	such as
ไม่สามารถทำการเกษตรได้	விவசாயம் செய்ய முடியவில்லை	unable to practice agriculture
ไม่แตกกิ่ง	கிளைக்கவில்லை	no chain
ไม่ใช่	இல்லை	no
ไม้	மரம்	mai
ไม้กวาด	துடைப்பம்	broom
ไม้หนีบผ้า	துணி பெக்	clip
ไม้ไม่ผลัดใบ	பசுமையானது	plants that have leaves all year round
ไรงะ	ரிகா	reiya - a character from a japanese story
ไรโบโซม	ரைபோசோம்கள்	ribosome
ไร่	பண்ணை	field, parcel
ไลท์	ஒளி	light
ไลบร้า	துலாம்	libra
ไลฟ์สไตน์	லிஃப்ஸ்டீன்	life style
ไลเบรชัน	நூலகம்	libration
ไวชาน่า	வைச்சனா	baishana - weapon in a japanese story
ไวทยางกูร	விட்டயங்க்குன்	wathaiyangkun
ไวทยานนท์	வைத்தியனோன்	waithayanon
ไวท์สเปล	வைட்ஸ்பெல்	white spell
ไวน์	மது	wine
ไวยากรณ์	இலக்கணம்	waiyakorn
ไวรัส	வைரஸ்	virus
ไวรัสตับอักเสบ	ஹெபடைடிஸ்	hepatitis
ไวเซิร์ด	வெயிஸ்	vizard
ไวเปอร์	வைப்பர்	viper
ไวเวิร์น	wvern	wyvern
ไวโอเลต	வயலட்	violet
ไว้ว่า	சொல்	as
ไหซอง	உல்லாசமாக	haisong
ไหมกัน	ஒன்றாக	maigun - a surname
ไหลจากลาวเข้าสู่ภาคเหนือของกัมพูชาแล้วไหลผ่านเข้าเขตเวียดนาม	லாவோஸிலிருந்து வடக்கு கம்போடியாவில் பாய்ந்து வியட்நாமில் பாய்கிறது	flows from laos into northern cambodia
ไอทีวี	ஐ.டி.வி.	itv
ไอน์สไตน์	ஐன்ஸ்டீன்	einstein
ไอน์สไตเนียม	ஐன்ஸ்டீனியம்	einsteinium
ไอพอด	ஐபாட்	ipod
ไอริส	ஐரிஸ்	iris
ไอร์แลนด์เหนือ	வட அயர்லாந்து	northern ireland
ไอเอ	ஐ.ஏ.	ia
ไอโมบาย	ஐ-மொபைல்	i-mobile
ไอโอ	அயோ	io - from greek mythology
ไฮยาซินธ์	பதுமராகம்	hyacinth
ไฮเดรนเยีย	ஹைட்ரேஞ்சா	hydrangea
ไฮเปอร์มาร์เก็ต	ஹைப்பர் மார்க்கெட்	tesco lotus hypermarket chain
ไฮแจ็ค	ஹைஜாக்	hijack
ไฮโดรเจน	ஹைட்ரஜன்	hydrogen
๑๔	14	14
๑๕	15	15
๑๖	16	16
๑๘	18	18
๒๑	21	21
๒๒	22	22
๒๔๕๐	1907	2450
๒๕๐๒	1962	2502
๒๕๐๓	1963	2503
๒๕๒๓	1980	1980
๒๕๓๔	1991	2534
๒๕๓๕	1992	2535
๒๕๓๖	2536	2536 be (1993 ad)
๒๕๔๗	2004	2547
๒๕๔๘	2005	2548
๒๕๕๐	2007	2550
๒๕๕๔	2011	2554
๒๗	27	27
๒๘	28	28
๓	3	3
๔๘	48	48
๕	5	5
๖๐	60	60
๙	9	nine
ព្រះរាជាណាចក្រកម្ពុជា	ព្រះរាជាណាចក្រ កម្ពុជា	cambodia
疾風伝	疾風 伝	not in thai - cannot translate
