+	+	plus sign
=	=	equal to
 °ซ  °ฟ 	° c ° f	เซลเซียส ฟาเรนไฮต์
 ซม	cm	cm.
 −°ซ  °ฟ	- ° c ° f	thai letters
×	×	letter x
γ	γ	y
π	π	pi
กกกก	kg	a thai letter repeated 4 times
กกกข	khor khor	4 thai alphabets - jibberish
กขขข	abc b	4 of thai letters
กขขขขขขข	a b a b b b a	abbbbbbb
กฎ	pravilo	law, rule
กฎของโคไซน์	kozine zakon	law of cosines
กฎแห่งกรรม	karma	bad karma
กติกา	pravila	rule
กทม	bangkok	agency
กนู	vitez	gnu - computer related acronym
กบ	žaba	frog
กบฏทหารนอกราชการ	vojna pobuna	coup de lat
กมล	ljiljan	kamon
กมลรัตน์	kamonrat	kamolrat - a surname
กรณีที่	slučaj	case
กรมขุนอิศเรศรังสรรค์	krom khun iset rangsan	the convention of angels
กรมขุนเพ็ชรบูรณ์อินทราชัย	kromkhunpetchaboon-indachai	department of....
กรมข่าวทหารอากาศ	odjeljenje vijesti ratnog zrakoplovstva	communication department of the thai air force
กรมควบคุมโรค	odeljenje za kontrolu bolesti	department of disease control
กรมทหารราบที่	pešadijske pukovnije	infantry regiment
กรมรบพิเศษที่	odjeljenje za specijalne snage	special force group
กรมศิลปากร	odeljenje likovnih umetnosti	fine arts department
กรมหลวงนราธิวาสราชนครินทร์	krom luang narathiwatratchanakharin	krom ma loung naratifatrachanakarin - the name of a royal family member
กรมหลวงสงขลานครินทร์	krom luang songkhla nakarin	prince of songkla
กรมอุตุนิยมวิทยา	meteorološki odjel	the meteorology department
กรรชัย	kanchai	kanchai
กรอง	filter	screen
กระดูกค้อน	čekićna kost	malleus, hammer bone
กระดูกต้นแขน	humerus	humerus
กระดูกฝ่ามือ	palme	metacapus
กระดูกสะบัก	scapula	scapula
กระดูกสะบ้า	patella	kneecap
กระทรวงกลาโหม	ministarstvo odbrane	defense ministry
กระทรวงการคลัง	ministarstvo finansija	ministry of finance
กระทรวงการต่างประเทศ	ministarstvo vanjskih poslova	ministry of foreign affairs
กระทรวงวัฒนธรรม	ministarstvo kulture	ministry of culture
กระทรวงศึกษาธิการ	ministarstvo obrazovanja	ministry of education
กระทรวงสาธารณสุข	ministarstvo za javno zdravstvo	ministry of public health
กระทรวงอุตสาหกรรม	ministarstvo industrije	ministry of industry
กระทรวงเกษตรและสหกรณ์	ministarstvo poljoprivrede i zadruge	ministry of agriculture and cooperatives
กระทรวงเศรษฐการ	ministarstvo za ekonomska pitanja	ministry of commerce
กระทุ่มแบน	mala korpa	krathum baen district, samut songkram province
กระนวน	pitch	granuan - location in knon kan province
กระนั้น	ipak	however
กระบวนการสร้าง	proces izgradnje	anabolism
กระบวนการสร้างและสลาย	proces stvaranja i raspada	metabolism
กระบอง	blackjack	club
กระบะทราย	kutija sa peskom	litter box or sand box
กระบี่กระบอง	takmičenje sa mačevima	krabi krabong (swordplay)
กระรอก	vjeverica	squirrel
กระวนกระวาย	zabrinut	nervous
กระหม่อม	glava	fontanelle
กระเพาะอาหาร	stomach	stomach
กระแต	chipmunk	wasp
กรับ	pokupiti	wooden rhythm clappers
กรับพวง	izaberite gomilu	krap phuang
กรับเสภา	krapao	wooden rhythm clappers
กรัม	gram	gram
กรัยวิเชียร	kraiwichian	krivician - a surname
กรานาดา	granada	granada
กริม	grimm	grim
กรี	siva	karee
กรุง	kapital	city
กรุงธนบุรี	thon buri	thonburi city
กรุงลอนดอน	london	london
กรุงศรีอยุธยา	ayutthaya	sri ayuttaya city - former capital of thailand
กรุงเทพ	bangkok	bangkok
กรุงเทพเชียงใหม่กรุงเทพ	bangkok, chiang mai, bangkok	bangkok changmai bangkok
กรุงเทพโพลล์	anketa u bangkoku	bangkok poll
กรุ๊ป	grupa	group
กลอง	bubanj	drum
กลองมโหระทึก	veliki bubanj	big drum
กลองยาว	bubanj	tom-tom
กลองสองหน้า	dvostrani bubanj	glong songna
กลอน	stih	poem
กลอบูลิน	sjajni	globulin
กลาง	sredina	in the middle
กลิ่น	miris	odor
กลุ่มดาวกล้องจุลทรรศน์	sazvežđa mikroskopa	microscopium
กลุ่มดาวนกทูแคน	toucan	tucana
กลุ่มดาวสิ่ว	dlijeto	siu star
กลุ่มดาวเข็มทิศ	kompas sazvežđa	pyxis constellation
กลุ่มดาวเตาหลอม	visoka peć	fornax
กลุ่มดาวแมงป่อง	škorpion	scorpion constellation
กลุ่มดาวแมลงวัน	muhe	musca
กลุ่มที่	grupa	group
กลุ่มแสงอุษา	usa light group	light at dawn
กลูคากอน	glucon	glucagon
กล่าวคือ	to znači	that is
กล้วยไม้ดาว	zvjezdana orhideja	type of orchid that have slim petal like star
กล้องถ่ายภาพ	kamera	camera
กล้ามเนื้อ	mišića	muscle
กวม	guam	obscure
กวาง	jelen	deer
กวิน	kawin	gwen - a name
กวี	pjesnik	poet
กว่า	nego	than
กองกลาง	vezni	headquarter
กองการบินทหารเรือ	divizija mornaričke avijacije	the flying section of the navy
กองการศึกษา	odjeljenje za obrazovanje	education group
กองการเจ้าหน้าที่	odjeljenje za osoblje	division of personnel
กองกำลังกึ่งทหาร	polu-vojne snage	armforces
กองคลัง	riznica	division of finance
กองทัพ	vojska	arm forces
กองทัพบกไทย	tajlandska vojska	thai army
กองทัพภาคที่	vojska regije	army area
กองทัพเรือ	mornarica	navy
กองทัพเรือไทย	tajlandska mornarica	the royal thai navy
กองทัพแห่งความชอบธรรม	vojska pravednosti	army of the righteous
กองทัพไทย	tajlandska vojska	thai military forces
กองบิน	leteća grupa	air force
กองบินปีกหมุนที่	krila predenje krila	flight corp number __________
กองพลทหารม้าที่	konjica brigade	cavalry division
กองพันทหารช่างที่	inženjerska brigada	troop unit number ___________`
กอด	zagrljaj	kord
กอนซาเลซ	gonzalez	gonzales - a name
กอร์ดอน	gordon	gordon
กอลมเบต์	goreme	glombet - a catholic priest
กอล์ฟ	golf	golf
กอล์ฟไมค์	golf mikrofon	golf-mike
กะเหรี่ยง	karen	karen
กะโหลก	lobanja	skull
กะโหลกศีรษะ	lobanja	skull; cranium
กังหันชัยพัฒนา	chaipattana turbina	chaipattana's windmill
กันดั้ม	gundam	gundam - a cartoon
กันตัง	kantang	kuntun in trung state
กันทรลักษ์	kantharalak	kuntaraluk - an area in thailand
กันฟอร์ม	obrazac	gun form
กันอริ	kanori	gan-ari
กันเอง	ljubazno	casual
กับนางสุจาริณี	sa gospođom sucharinee	with mrs. sujarinee
กัมปูเชีย	kampuchia	kampuchea
กัมพูชา	kambodža	cambodia
กัมพูชาประชาธิปไตย	demokratska kambodža	democratic kampuchea
กัมพูชาเป็นประเทศที่มีป่าไม้อุดมสมบูรณ์มากที่สุดหากเปรียบเทียบกับประเทศเพื่อนบ้าน	kambodža je zemlja s najbrojnijim šumama u usporedbi sa susjednim zemljama.	cambodia is the country with nice, healthy forests
กัมพูชาเป็นอดีตประเทศอาณานิคมของฝรั่งเศสในภูมิภาคเอเชียตะวันออกเฉียงใต้เพียงแค่ประเทศเดียวเท่านั้นที่มีการปกครองด้วยระบอบราชาธิปไตยภายใต้รัฐธรรมนูญ	kambodža je jedina bivša francuska kolonijalna zemlja u jugoistočnoj aziji koja ima monarhiju prema ustavu.	cambodia was a former french colony
กัมพูชาเป็นอาณานิคมของฝรั่งเศสมาตั้งแต่พศ	kambodža je od tada francuska kolonija.	cambodia was a france colony from year
กัวเตมาลา	gvatemala	guatemala
กานซู	gansu	honshu in china
กานต์	kan	kan
กานา	gana	ghana
กานามัยซิน	kanamycin	kanamycin
กาบอง	gabon	baton
กาพย์ฉบัง	epska poema	poem
กาพย์สุรางคนางค์	pjesma	gabsuranknang
กาม	wanton	lust
กาย	telo	body
การ	the	project
การกีฬา	sport	sport
การขัดเกลาทางสังคม	socijalizacija	socialization
การขับถ่าย	izlučivanje	excretion
การขับไล่	deložacija	discharge
การคมนาคม	prevoz	transportation department
การคลัง	finansije	public finance
การค้นพบ	otkriće	discover
การค้า	trgovina	marketing
การจัดการ	menadžment	project
การจัดการคุณภาพ	upravljanje kvalitetom	quality control
การจัดอันดับ	rangiranje	ranking
การจัดให้มี	odredba	putting together something
การจูบ	poljubac	kissing
การชัก	napadaj	the act of pulling the flag wiht string up the pole
การดำเนินการ	operacija	progression
การตอบรับ	povratne informacije	welcoming
การตั้งถิ่นฐาน	nagodba	start a project
การต่างประเทศ	spoljni poslovi	foreign affairs
การทำงานของ	rad od	function
การทำป่าไม้	šumarstvo	forestry
การท่องเที่ยว	turizam	tourism
การท่าเรือ	lučka uprava	port authority
การบริการ	usluga	customer service
การบริหารการพัฒนา	upravljanje razvojem	development
การบริหารการศึกษา	obrazovna uprava	educational administration
การบริหารจัดการ	menadžment	management
การบริหารราชการแผ่นดิน	vladina uprava	administration
การบินไทย	thai airways	thai airways
การปกครองท้องถิ่น	lokalna uprava	local administration
การปกครองส่วนท้องถิ่น	lokalna uprava	local government
การปกครองแบ่งออกเป็น	pravilo je podeljeno na	administration
การปฏิรูประบบจัดเก็บภาษีเงินได้	reforma sistema naplate poreza na dohodak	taxation reform
การปฏิรูปศาสนา	reformacija	religious reformation
การปฏิวัติฝรั่งเศส	francuska revolucija	french revolution
การปฏิวัติอุตสาหกรรม	industrijske revolucije	industrial revolution
การปฏิสนธิ	gnojidba	fertilisation
การประมง	ribarstvo	fishery
การพัฒนา	razvoj	development
การพัฒนาประชาธิปไตย	demokratski razvoj	democratic development
การพูด	govoreći	speaking
การยึดครองมะละกาของโปรตุเกสในปี	portugalska okupacija melake godine	portugal took over malaga
การระบาดของไข้หวัดใหญ่สายพันธุ์ใหม่	novi soj gripa	flu pandemic
การรักษาพยาบาล	liječenje	nursing care
การร่วมเพศทางทวารหนัก	analno jebanje	sodomy
การลดรูป	deformiranje	reduction
การละเล่นพื้นบ้าน	narodne igre	local game
การวิจัย	istraživanje	researching
การวิเคราะห์	analiza	analysis
การศึกษา	obrazovanje	study of, education
การสังคายนาครั้งที่	poslednja naredba	the event of convention of monks
การสั่นพ้อง	rezonanca	resonance
การสำเร็จความใคร่ด้วยตนเอง	masturbacija	masturbation
การสืบพันธุ์	reprodukcija	reproduction
การสื่อสาร	komunikacija	communications
การาจ	garaža	garage
การุณ	karun	karoon
การเต้นรำ	ples	dance
การเพิ่มสิทธิประโยชน์แก่นักลงทุนต่างประเทศ	povećanje privilegija za strane investitore	increase benefits for foreign investors
การเล่น	igrati se	play
การแข่งขัน	takmičenje	competition
การแบ่งพื้นที่	particija	land division
การใช้คำ	upotreba reči	terminology
การไฟฟ้าส่วนภูมิภาค	pokrajinska uprava za električnu energiju	distribution electric transformer
การไหว้	poštovanje	thai greeting
การ์ด	kartica	guard
กาฬสินธุ์	kalasin	katsin - a thai surname
กาเวน	gawain	gawain
กาเหว่าที่บางเพลง	gavran nekih pjesama	the cuckoo's song.
กำกับการแสดงโดย	režija:	produced by (movie)
กำกับโดยอภิชาติพงศ์	režija: aphichat pong	produced by apichartpong - a famous thai movie producer
กำมะถัน	krošnja	sulfur
กำลังจะปรับเปลี่ยนเป็น	idite na promjenu u	is changing to
กำหนดตามสภาพภูมิศาสตร์	određeno geografijom	geography estimation
กำแพงเพชร	kamphaeng phet	kamphaeng phet
กำแพงเมืองจีน	veliki zid	the great wall of china
กำแพงแสน	kamphaengsaen	kampangsaen (name of district)
กิจผลิต	proizvodnja	kitpalit (last name)
กิมป์	gimb	gimp - gnu image manipulation program
กิโลกรัม	kg	kilogram
กิโลไบต์	kb	kilobyte
กิ่งแก้ว	kingkaew	kingkaeo
กิ้งกือ	millipede	millipedes
กิ๊ก	kik	gig
กีฏวิทยา	entomologija	entomology
กีฬา	sport	sports
กีฬาทางน้ำ	vodene sportove	water sports
กีฬาแหลมทอง	laem thong sport	seap games
กุดจับ	kalupi	good jub - a place
กุลดิลก	kuldilok	kuldilok
กุลละวณิชย์	kulalawanit	kullawanich
กุหลาบ	ruža	kularb (first name)
กุ้ง	kozice	shrimp
กุ้งต้ม	kuvane škampe	boiled shrimp
กูเกิล	google	google
ก็คือ	is	which is
ก็ใช้เป็น	koristi se kao	utilize
ก่อตั้ง	osnovan	founded
ก่อตั้งโดย	osnovao	make by
ก่อนที่	prije	before
ก่อนที่จะตกเป็นของฝรั่งเศสในเวลาต่อมา	prije nego što kasnije postane francuska	belonging to france, under the control of france
ก่อนหน้านั้น	pre toga	before
ก้อย	pinky	koi
ก้าน	stabljika	thorn
ก้านกล้วย	stabljika banane	kankluai
ก๊าซธรรมชาติ	prirodni gas	natural gas
ก๎ล	poklon	magic
ขขขขขขขขขข	b b b b b b b	repeated letter from thai alphabet
ขณะทรงพระเยาว์	dok je bio mlad	having to do with the young prince or princess
ขณะที่	dok	while
ขนม	slatkiš	dessert
ขนมกล้วย	banana	banana dessert
ขนมครก	knmcrk	kind of thai sweetmeat
ขนมปัง	hleb	bread
ขนมปังขิง	medenjaci	gingerbread
ขนมเปียกปูน	rhombus	a type of thai dessert with flour and sugar
ขนมไทย	tajlandski desert	thai dessert
ขนสัตว์	vuna	fur, animal hair
ขนอม	khanom	kanom - location in thailand
ขนาดหน้าตัก	veličina kruga	length between both knees of buddha statue in posture of meditation
ขนาดใหญ่	velike veličine	l
ขบวนการอ๊บอ๊บป่วนโลก	kretanje zemlje	original name is keroro gunso
ขบวนรถสินค้า	voz	caravan of trucks
ขม	gorka	bitter taste
ขรรค์ชัย	khan chai	kanchai - a male's name
ขลุ่ยหลิบ	flauta	khlui lib
ขวด	boca	bottle
ขวัญ	morale	morale
ขวัญใจช่างภาพ	voljeni fotograf	miss photogenic
ขสมก	misa	an acronym consists of four thai letters
ของ	od	of
ของทุกปี	svake godine	every year
ของประเทศจีน	kina	owned by china
ของมหาวิทยาลัย	univerziteta	of university
ของมัน	njegova	their
ของร่างกาย	tela	of the body
ของสมเด็จฮุน	somdeja huna	houssaine of cambodia
ของสิ่งมีชีวิต	živih stvari	living things
ของสุนทรภู่	sunthorn phu	belong to soon thong pu (a thai legend)
ของเหลว	tečnost	liquid
ของโลก	svijeta	of world
ขอนแก่น	khon kaen	khon kan - an area in thailand
ขอบคุณที่รักกัน	hvala ti što me voliš	thank you for loving each other
ขอเช็ดน้ำตา	obrišemo suze	wipe the tears
ขอให้เด็กสมัยปฏิวัติของข้าพเจ้า	neka moja revolucionarna djeca	i hope that the children in my lifetime will ____________
ขั้นที่	korak	level
ขา	noga	leg
ขาย	prodati	sell
ขิง	đumbir	ginger
ขิม	dulcimer	kim - a thai musical instrument
ขีดเส้นใต้	podvući	underline
ขี้ผึ้ง	vosak	wax
ขึ้นเป็น	do	to
ขึ้นไป	gore	next one up
ขุขันธิน	khan tin	kukuntin
ขุนหาญ	han	koonhan - a location in thailand
ข้อมูลทั่วไป	opće informacije	general information
ข้อมูลประเทศเดนมาร์ก	danska informacije	information on denmark
ข้อมูลปรากฏการณ์โลกร้อน	fenomen globalnog zagrijavanja	global climate change
ข้อมูลปี	podaci o godini	information from the year ________
ข้อมูลอื่นๆ	ostale informacije	other information
ข้อมูลโดย	data by	information from
ข้อวิพากษ์วิจารณ์	kritika	critique reports
ข้ามฉาก	preko scene	sin(a)
ข้าวสาลี	pšenica	wheat
ข้าวหลาม	khao lam	bamboo rice
ข้าวเกรียบปากหม้อ	pirinčani krekeri	a thai snack
ข้าวเจ้า	neolušan	white rice
ข้าวโพด	kukuruz	corn
ข้าหลวงกำกับราชการเมืองขุขันธ์คนที่	guverner, guverner grada khukhan	government worker for ku khan city
ฃ	ฃ	a letter from thai alphabet
คงยิ่ง	vrlo moguće	kongying
คงเจริญ	vjerovatno prosperira	khongcharoen
คณะครุศาสตร์	pedagoški fakultet	education department
คณะครุศาสตร์อุตสาหกรรม	fakultet za industrijsko obrazovanje	faculty of industrial education
คณะที่	fakultet na	the current administration
คณะบัญชี	fakultet za računovodstvo	accounting department (major)
คณะปฏิรูปการปกครองแผ่นดิน	revolucionarni odbor	national administrative reform council
คณะประมง	ribarski fakultet	fishery division of the college of farming and agriculture
คณะพยาบาลศาสตร์	medicinski fakultet	nursing department
คณะมนุษย์ศาสตร์และสังคมศาสตร์	fakultet humanističkih i društvenih nauka	humanity department
คณะรัฐมนตรีคณะที่	kabinet	council of ministers
คณะวิทยาการจัดการ	fakultet nauka o upravljanju	management department
คณะวิศวกรรมศาสตร์	tehnički fakultet	engineering department
คณะศิลปกรรมศาสตร์	fakultet likovnih umjetnosti	faculty of fine arts
คณะสถาปัตยกรรมศาสตร์	arhitektonski fakultet	faculty of architecture
คณะสหเวชศาสตร์	fakultet srodnih zdravstvenih nauka	อังกฤษ   faculty of allied health science
คณะสาธารณสุขศาสตร์	fakultet za javno zdravstvo	faculty of public health
คณะเกษตร	poljoprivredni fakultet	faculty of agriculture
คณะแพทยศาสตร์ศิริราชพยาบาล	medicinski fakultet bolnica siriraj	faculty of medicine siriraj hospital
คณะแพทยศาสตร์โรงพยาบาลรามาธิบดี	medicinski fakultet, bolnica ramathibodi	the staff of ramatippadee hospital
คณารศ	kanara	kanaros - a surname
คนที่	ljudi	person number __________________________
คนที่ไปช่วยรุ่นที่	ljudi koji su pomogli generaciji	volunteer group number __________
คนแคระ	patuljak	dwarf
คนแรก	prva osoba	first
คปค	godina	3 thai letters
คม	oštar	sharp
ครอคโคไดล์	krokodil	crocodile
ครอบครัว	porodica	family
ครั้งหนึ่ง	jednom	once upon a time
คราประยูร	prayun	karaprayoon - a thai surname
คราม	indigo	indigo
คริส	chris	christ
คริสตี	christi	christie - a female name
คริสต์ศาสนา	hrišćanstvo	christainity
ครุฑ	garuda	garuda
ครู	učitelj	teacher
ครูพิเศษจอมป่วน	nastavnik trola	kru pisat jom poun  - name of a story
คลอง	kanal	canal
คลองสาน	khlong san	klongsan
คลองเตย	khlong toei	klongtoei
คลับ	klub	club
คลาวิคอร์ด	klasa	clavichord
คลิก	klikni	click
คลินิก	klinika	clinic
คลิป	isječak	clip
คลื่นสึนามิ	tsunami	tsunami wave
ควอน	kwon	kwon - a surname of a korean singer
ควอร์เตอร์	četvrtina	quarter
ความกว้าง	širina	width
ความงาม	ljepota	beauty
ความจำ	sećanje	memory
ความต่างศักย์	potencijalna razlika	potential difference in physics
ความถี่	frekvencija	frequencies
ความนิยม	popularnost	popular
ความบริสุทธิ์	čistoća	purity
ความฝันอันสูงสุด	vrhunski san	the impossible dream
ความพอประมาณ	skromnost	estimate
ความยากจน	siromaštvo	poverty
ความยาว	dužina	length
ความยาวคลื่น	talasna dužina	frequencies
ความยาวช่วงคลื่น	talasna dužina	wave length
ความยาวเพลง	dužina pesme	the length of the song
ความรัก	ljubav	love
ความรู้	znanje	knowledge
ความสว่าง	svjetlina	illumination
ความสัมพันธ์กับประเทศไทย	odnosi s tajlandom	relationship with thailand
ความสัมพันธ์ระหว่างจีนกับอเมริกา	odnosi kine i amerike	relationship with china and the usa
ความสูง	visina	height
ความส่องสว่าง	svjetlina	luminance
ความหนาแน่นของประชากร	gustoća naseljenosti	population density
ความหมาย	značenje	meaning
ความหมายโดยพยัญชนะ	suglasničko značenje	definition that derived from translation from another language
ความเข้มของการส่องสว่าง	svjetlosni intenzitet	luminous intensity
ความเข้าใจ	razumevanje	understanding
ความเร่ง	ubrzanje	acceleration
ความโกรธ	ljutnja	anger
ความโน้มถ่วง	gravitacija	gravity
ควินโต	quinto	quinto
ควีนซี่	kraljice	quincy
คอ	vrat	neck
คอนสตรัคชั่น	izgradnja	construction
คอนเวนชัน	konvencije	convention
คอนเสิร์ตประสานเสียงสามสถาบัน	koncert zbora tri instituta	chulalongkorn kasetsart thammasat choral concert
คอมพิวเตอร์ยุคที่	doba računara	_-generation computer (as in frist generation, second generation etc)
คอร์ด	akord	chord
คอลลิงวูด	callingwood	collingwood
คอสตาริกา	kosta rika	costa rica
คัง	kang	kan
คัชชินสกี	kutchinski	kaczyński
คัญทัพ	važna vojska	main army.
คัทลียา	cattleya	kathaleeya (thai first name)
คันธวงศ์	kanthavong	kunntavong - a surname
คัพ	kup	cup
คัมภีร์	pismo	bible
คั่ว	pečena	dry roasting
คาคาชิ	kakashi	cacashi
คางาริ	kagari	kagari
คาซัคสถาน	kazahstana	kazakhstan
คาถาอัญเชิญ	nagon	a magic spell
คาบ	period	frequency
คาบัคโรเน่	kabakhroone	kyabarrone
คาบูโตะ	kabuto	kabuto
คาปูชิโน่	cappuccino	cappuccino
คามิว	kamui	camus
คาราคุระ	karakura	karakura
คาร์ล	carl	karl
คาวทอง	fishyong	lizard tail
คาเมนไรเดอร์	kamen rider	kamen rider
คาโรลัส	carolas	carolus linnaeus
คำขวัญวันเด็ก	slogan dječijeg dana	quote for kids day
คำถามข้อที่	broj pitanja	the question number_________
คำนวณ	izračunati	calculate
คำนาม	imenica	noun
คำพ้องรูป	sinonimi	hemonym
คำมั่นสัญญา	obećaj	agreement
คำม่วง	kham muang	kham muang
คำวิลัยศักดิ์	kamwilaisak	important words, magic words
คำศัพท์	vokabular	word
คำสรรพนาม	pronoun	pronoun
คำสร้อย	riječ	kumsoi - a country singer
คำสุดท้ายของวรรคที่	posljednja riječ odlomka	the last word (in a poem)
คำสุภาพ	pristojna reč	formal
คำอธิบาย	opis	explanation
คำเมือง	gradska riječ	kum meuong - a location in chiang mai
คำแปล	prevod	translation
คิง	kralju	king
คิงส์	kraljevi	kings
คิงส์คัพ	king&#39;s cup	king's cup
คิงไลเนอร์	kingliner	kingliner
คิชิเนีย	kishinya	kishinia
คิด	misli	thinking
คินนิคุแมน	kinnikuman	kinkiku man
คิมิฮิโระ	kimihiro	kimihiro
คิระ	kira	kira - japanese name
คิเคียว	kikyo	kikyo
คีตกวี	kompozitor	composer
คือประมาณ	je oko	estimated to be
คือเพลง	je li pjesma	is the song
คุณ	ti	you
คุณครูจอมเวท	učitelj mađioničara	magister
คุณปลื้ม	khun pluem	kunpleam
คุณหญิงโม	carica mo	suranaree
คุณากร	ti	khunakon
คุราปิก้า	kurapika	kurapika
คุโรซึจิ	kurotsuji	kurochiji - a japanese word
คุ้มค่า	dobra vrijednost	worth the money spent on
คูกิมิยะ	kukimiya	kugimiya
คูคาคุ	kuku	kukaku (japanese last name)
คูเรียม	kurijum	"chemical element ""curium"""
คูเวต	kuvajt	kuwait
คู่กรรม	partner	soul mate
ค่าความต้านทานตัวที่	vrijednost otpora koja	resistance value of the
ค่าจีดีพี	bdp	gdp - an economics term
ค่าใช้จ่าย	troškova	expense
ค่ำแล้ว	sumrak	getting dark, at dusk
ค้างคาว	šišmiš	bat
ฆ	juan	a letter from thai alphabet
ฆ้อง	gong	gong
ฆ้องวงใหญ่	veliki gong	a group of thai drum music
งดส่งเข้าประกวด	zabranjen ulaz	enroll in the contest
งาน	posla	work, job
งานอดิเรก	hobiji	hobby
งานเขียน	writings	writing, composition work
งานเทางามสัมพันธ์	tao ngam odnos	public party
งานโมเสก	mozaik	mosaic
งามวงศ์วาน	ngamwongwan	ngamwongwan
งู	zmija	snake
งูอนาคอนดา	anakonda	anaconda snake
จดหมายอากาศ	vazdušna pošta	aerogram
จตรัง	trang	trang province (name of province in thailand)
จตุรงค์	chatuchak	jaturong - a surname of a comedian
จนกระทั่ง	dok	until
จนกระทั่งปี	do godine	until the year
จนกระทั่งเมื่อปี	sve do prošle godine	until the year
จนครปฐม	nakhon pathom	nakorn pratom state
จนมีคำกล่าวว่า	sve dok to nije rečeno	said
จน่าน	pon	nan state
จบุรีรัมย์	buriram	burerum state
จมูก	nosa	nose
จระเข้และแอลลิเกเตอร์	krokodil i aligator	crocodile and alligator
จรัญญา	charanya	jarunya - a surname
จริยธรรม	etika	ethics
จริยศาสตร์	etika	ethics
จริยา	dama	jariya
จลำพูน	lamphun	jalumpoon - a place in thailand
จสตูล	satun	stoul state
จสุราษฎร์ธานี	surat thani	surat thani province
จอมบึง	otečen	chom bueng
จอมพลถนอม	chom phon thanom	field marshal thanom
จอมพลสฤษดิ์	feldmaršal sarit	field marshal sarit
จอมพลเรือ	brod maršal	the general of the navy
จอมเทียน	jomtien	jom tien - a location in thailand
จอร์เจีย	gruzije	georgia
จะต้องหาตัวแทนลงจากเวที	morate naći predstavnika koji bi sišao sa pozornice	find a teammate to leave the stage, a unique game
จะเขียนว่า	reći će	written as
จะเข้	citer	jakhe
จะได้	će dobiti	results in
จักจั่น	cicada	chakkachan
จักรพรรดิเนอร์วา	careva nirvana	emperor nerva
จักรพรรดิไททัส	cara tita	titus (flavius vespa)
จักรพันธุ์	čakphan	chakrabhand
จักรวาลวิทยา	kozmologija	cosmology
จังหวัด	provincija	province
จังหวัดกระบี่	provincija krabi	krabee state
จังหวัดกาญจนบุรี	kanchanaburi	kanchanaburi province
จังหวัดกาฬสินธุ์	kalasin	kalasin province
จังหวัดขอนแก่น	provincija khon kaen	khon kaen province
จังหวัดคยองกี	provincija gyeonggi	the state of kyong gee
จังหวัดคยองซาง	provincija gyeongsang	kyongchang province
จังหวัดฉะเชิงเทรา	chachoengsao	chachoengsao province
จังหวัดชุมพร	chumphon	chumphon province
จังหวัดตราด	provincija trat	trat province
จังหวัดตาก	provincija tak	tak province
จังหวัดนครปฐม	provincija nakhon pathom	nakhon pathom province
จังหวัดนครพนม	provincija nakhon phanom	nakorn panom state
จังหวัดนครสวรรค์	nakhon sawan province	nakorn sawan province in thailand
จังหวัดน่าน	provincija nan	nan state in the north east of thailand
จังหวัดปัตตานี	provincija pattani	pattani state
จังหวัดพระนครศรีอยุธยา	phra nakhon si ayutthaya	nakon sri ahyutthaya province
จังหวัดพังงา	provincija phang nga	phang nga province
จังหวัดพิษณุโลก	provincija phitsanulok	pisanulok state
จังหวัดมหาสารคาม	provincija maha sarakham	maha sarakham province
จังหวัดยโสธร	yasothon	yasothorn province (name of thai province)
จังหวัดระยอง	rayong	rayong province
จังหวัดราชบุรี	ratchaburi	ratchaburi province
จังหวัดลำพูน	lamphun	lamphun province
จังหวัดสงขลา	songkhla	songkla province
จังหวัดสมุทรสงคราม	provincija samut songkhram	samut songkhram province
จังหวัดสิงห์บุรี	sing buri provincija	sing buri province
จังหวัดหนองบัวลำภู	provincija nong bua lamphu	nong bua lamphu province
จังหวัดอุดรธานี	provincija udon thani	udon thani state
จังหวัดเชลลา	shella	chella city
จังหวัดเชียงราย	chiang rai	chianrai province
จังหวัดเชียงใหม่	provincija čijang maj	chiang mai province
จังหวัดเพชรบุรี	provincija phetchaburi	petcharaburi state
จังหวัดเพชรบูรณ์	phetchabun	petchabun province
จังหวัดเลย	provincija loei	loei (name of thai province)
จังหวัดแพร่	phrae	prae state
จังหาร	junghan	changhan
จัดขึ้นเมื่อ	održanoj	occur on the date of _______________
จัดตั้งขึ้นโดย	osnovao	produced by
จัดอยู่ในภูมิภาค	organizovano u regionu	in region
จัดเมื่อวันที่	održanoj	็held on the date of ...
จัดโดย	dogovorio	arrange by
จัน	chan	chan
จันทบุรี	chanthaburi	juntaburi state
จันทร	mesec	chantorn
จันทรุปราคา	pomračenje mjeseca	lunar eclipse
จันทร์	ponedeljak	chan
จันทร์ภักดี	chan phakdi	juntapukdee - surname of a famous actor
จันทร์เกษ	chan ket	juntagaset - a surname
จาก	od	from
จากการพิสูจน์อายุโดยคาร์บอน	iz dokaza o starosti ugljenikom	from the forensic carbon dating
จากภาษากรีก	od grčke	greek language
จากละคร	iz drame	from drama
จากละครเรื่อง	iz drame	from the soap opera
จากสารานุกรมบริทานิกา	iz encyclopeedia britannica	from printed information
จากอัลบั้ม	sa albuma	from the album
จากเรื่อง	iz priče	from the story of ...
จากเว็บ	s interneta	from the web
จากเว็บไซต์กระทรวงการต่างประเทศ	sa web stranice ministarstva vanjskih poslova	from the website of foreign department
จากเว็บไซต์กระทรวงต่างประเทศ	sa web stranice ministarstva vanjskih poslova	from the foreign government affairs website
จากโซล	iz seula	from soeul
จาติกวณิช	chatikavanij	chatikavanij
จามจุรี	chamchuri	jamjuri flower
จารีตประเพณี	tradicija	tradition from the culture
จารุเสถียร	jaru sathien	charusathien
จาวตาลเชื่อม	jao tan weld	sweetened palm - a type of thai dessert
จำกัด	ltd.	limited
จำกัดมหาชน	ograničena	public limited
จำนวน	broj	amount
จำนวนประชากร	stanovništvo	population
จำปาเทศ	champa	a specific type of magnolia tree; similar michelia champaca
จำเริญ	prosperirati	jamroen
จิกะไบต์	jigtes	gigabyte
จิตรกร	slikar	painter
จิตรกรรม	slikanje	arts and craft or music
จิตวิทยา	psihologija	psychology
จิตใจ	um	heart; feelings
จินตหรา	jintara	jinnara - a female's name who is a singer
จิบูตี	džibuti	ji bu dee event on june 27
จิบเบอเรลลิน	gibberellin	gibberellin
จิม	jim	jim
จิโอวานนี	giovanni	giovanni
จี	ji	g
จีนตัวย่อ	pojednostavljeni kinezi	simplified chinese characters
จียอน	jiyeon	๋jiyeon (korean name)
จึงทรงพระกรุณาโปรดเกล้า	stoga ljubazno naređena	be kind enough to
จึงเปิดโอกาสให้	stoga je dao priliku	open up opportunities
จึงใช้ธาตุหมอกและเมฆาได้	stoga se može koristiti element magle i oblaka	using magic with cloud and spells
จุกนมสีขุ่น	prozirni čaj	corrupted pacifier
จุดกึ่งกลาง	midpoint	midpoint
จุดจอมฟ้า	plava tačka	zenith
จุลจอมเกล้าเจ้าอยู่หัว	kralj rama v	phra chunla chom klao chao yu hua
จุฬาลงกรณินทรวรางกูร	chulalongkorn nintharangrangkun	new title for the princess
จูล	joule	joule
จูเซปเป	giuseppe	giuseppe
จูเนียร์	junior	junior
จเชียงใหม่	chiang mai	chiang mai province
จเพชรบุรี	phetchaburi	pedchaburee province
จเพชรบูรณ์	phetchabun	province pechaboon
จ๊กมก	jumkum	jokmok - a surname of a comedian
ฉ	f	ninth thai alphabet
ฉบับชั่วคราว	privremena verzija	special (temporary) edition
ฉบับวณิพก	brojevi	begger version
ฉลอง	slaviti	celebrate
ฉลองพระชนมายุ	proslavite 80. godinu	celebrated birth anniversary of
ฉันรักคุณ	volim te	i love you
ฉาบ	malter	cymbal
ฉายเมื่อ	prikazana	aired
ฉิ่ง	cimbal	small cup-shaped cymbals
ฉี่	piškiti	qi
ชนะ	pobijediti	winning
ชนิด	tip	kind
ชนิดของเมฆ	vrsta oblaka	types of clound
ชม	pazi	chom
ชมชื่น	kompliment	chomchuen
ชมพู	roze	rose apple
ชมพูทวีป	indija	south asia
ชมพู่	ružna jabuka	syzygium
ชล	jezera	chol (first name)
ชลธารวิทยา	chaloem wittaya	limnology
ชลบุรี	chon buri	cholburi state
ชลิต	chalit	chalit - a male's name
ชวนชื่น	poziv	choun cheen - a surname
ชอบ	kao	chop
ชะนี	gibon	gibbon
ชะมด	mošus	anteater
ชะอวด	pokažite se	chaoud - location in thailand
ชะอำ	cha-am	cha-am (name of thai district)
ชัชพล	chatchapon	chatchapol - a male's name
ชัย	pobjeda	chai
ชัยชนะ	pobjeda	chaichana
ชัยนาม	chai nam	chainam
ชัยบัญชา	chai bancha	chaibancha
ชัยมงคล	chaimongkol	chaimongkol - a male's name
ชัยยุทธ	chaiyut	chaiyuth (first name)
ชั้น	klasa	class
ชั้นที่	pod	order
ชั้นประทวน	pod	non-commissioned officer
ชั้นมหาวชิรมงกุฎ	klasa crown maha wachira	order of the king's jewels
ชั้นยศ	rang	millitary rank
ชั้นสูงสุด	najviši nivo	special class
ชา	čaj	tea
ชากะ	shaka	shaka
ชาคริต	uzbunu	charkrit
ชาญชัย	chanchai	chanchai - a thai name
ชาตะ	biti rođen	born
ชาติ	nacija	nation
ชาย	muško	male
ชาร์ป	oštro	sharp
ชาร์ล	charles	charles
ชาร์ลส	charles	charles
ชาลส์	charles	charles
ชาลี	charlie	charlie
ชาวนา	farmer	farmer
ชาวไทย	tajlanđani	thai
ชาวไทยภูเขา	pleme hill	thai hill tribe
ชำนิ	chamni	chumni - a location in thailand
ชิคิกามิ	shikikami	shikigami
ชิงร้อย	nadmetati se	ching roi
ชิงร้อยล้าน	takmičite se za sto miliona	ching roi lan
ชิซุกะ	shizuka	shizuka
ชิดจันทร์	chidchan	chidjun (a person's last name)
ชิน	naviknut	get used to
ชินวัตร	shinawatra	shinawatra
ชิริว	chiryu	cherew - a japanese character
ชิลี	čile	chilli
ชิโนะ	kino	shino
ชีพด็อก	ovčar	chief dog
ชีวนิชพันธ์	biološki	chiwanitphan
ชีวประวัติ	biografija	biography
ชีวมวล	biomasa	alternative (natural) power
ชีวสถิติ	biostatistika	biometry, biostatistics
ชื่อดัง	poznat	famous
ชื่อนามสกุล	ime prezime	name-lastname
ชื่อภาษาญี่ปุ่น	japansko ime	japanese name
ชื่อภาษาอังกฤษ	englesko ime	english name
ชื่อยศภาษาไทย	tajlandski rang	thai title
ชื่ออัลบั้ม	naziv albuma	album name
ชื่ออื่น	ostala imena	synonym
ชื่อเก่าในวงการ	staro ime u industriji	old stage name
ชื่อเดิม	bivše ime	old name
ชื่อเมือง	naziv grada	city's name
ชื่อเรื่อง	naslov	the name of the story
ชื่อเล่น	nadimak	nickname
ชุดแพนเค้ก	set palačinki	pancake
ชุติมา	chutima	chutima
ชุมชนออนไลน์ชาวจังหวัดสกลนคร	sakon nakhon online zajednica	sakon nakhon people online community
ชุมพลบุรี	chumphon buri	chompolburi area
ชุมแพ	chum phae	choompa - location in thailand
ชุมแสง	chum saeng	choomsang - a male's name
ชูมันน์	schumann	schumann
ชูศักดิ์	chusak	chusak
ชโย	bravo	cheer; hurray
ชไนเดอร์	schneider	schneider
ช็อกโกแลต	čokolada	chocolate
ช่วงปี	godina	between year
ช่อง	kanal	channel
ช่องเชิงเทิน	bitke	machicolation
ช้อน	kašika	spoon
ซ	c	the eleventh letter of the thai alphabets
ซน	nestašan	crashing into
ซบที่อกฉัน	gnezdi mi se u grudima	cry in my arms
ซอมบี้	zombija	zombie
ซออู้	zo o	a woodwind thai instrument
ซันไชน์	sunce	sunshine
ซัลฟานิลาไมด์	sulfanilamid	salfanilamide
ซัลฟาไดอะซีน	sulfadiazin	sulfadiazine
ซัลเฟต	sulfate	sulphate
ซากดึกดำบรรพ์	fosil	fossil
ซาคุโร่	sakuro	zakuro - a japanese character
ซาซางาวะ	sasagawa	sasangngawa - a japanese name
ซานกัลโล	san gallo	sangallo family
ซาบุซะ	sabuza	zabuza
ซาลาดิน	saladin	saladin
ซาอิ	sayi	chai - a japanese name
ซาโลมอน	salomon	salomon
ซิกนัส	cignus	signus
ซิงเกอร์	singer	sinder
ซิงเกิ้ล	samci	single
ซิทคอม	sitcom	sitcom
ซินเดอเรลล่า	pepeljuga	cinderella
ซิมไฟลา	simphila	class symphyl
ซิโนไทย	sino thai	sino-thai
ซี	c	see
ซีซี	cc	cc
ซีรีเบลลัม	serabellum	cerebellum
ซีลีเนียม	selen	selenium (chemical element)
ซีสต์	ciste	cyst
ซีเกมส์	sea games	southeast asian game
ซีเจ	cj	cj
ซีเซียม	cezijuma	cesium
ซีเนม่า	kino	cinema
ซีแคนต์	tajna	secant
ซีโร่	nula	zero
ซึง	koji	feeling touched (by the music or movie)
ซึม	prodirati	absorb
ซึ่ง	koja	because
ซึ่งประกอบด้วย	koji se sastoji od	consists of
ซึ่งมี	koje je	with
ซึ่งมีความหมายว่า	što znači	meaning
ซึ่งมีทั้งหมด	koje sve ima	in total of
ซึ่งรู้จักกันว่า	koji je poznat kao	called
ซึ่งเกิดจากปัจจัยภายนอก	uzrokuju je vanjski faktori	which is caused by external factors
ซึ่งเรียกว่า	koji se zove	called
ซึ่งแท้จริงแล้ว	u istini	real name
ซึ่งได้แก่	koji su	such as
ซุง	zapisnik	sung
ซุน	sunce	son
ซุปเปอร์มาร์เก็ต	supermarket	supermarket
ซุปเปอร์เซ็นเตอร์	super center	super center
ซู	sue	holding up high
ซูจี	suzy	fuji
ซูซูกิ	suzuki	suzuki brand
ซูรินาเม	surinam	suriname
ซูเปอร์เซ็นเตอร์	super center	super center
ซ่อมแซม	popravak	repair
ซ่าหริ่ม	budi sretan	a type of thai dessert
ซ้าย	levo	left
ฌอง	jean	jean - french name
ญ	the	a thai alphabet with a y sound
ฐานข้อมูล	baza podataka	database
ฐานทัพ	kantonment	armforce
ณภัทร	naphat	napat
ณรงค์	kampanju	narong - a male's name
ณัฏฐธิดา	natthida	nattathida - a thai female actress
ณัฐวุฒิ	natthawut	nattawut
ด	m	a letter from thai alphabet
ดง	trza	area, location
ดม	miris	smell
ดรทรงศักดิ์	dr songsak	doctor songsuk - a famous person
ดรนิพนธ์	dr nipon	doctor nipon
ดรสาโรช	dr saroj	dr. sarot
ดรสุชาติ	dr suchart	dr. suchart
ดราก้อน	zmaj	dragon
ดราก้อนเควสต์	potraga za zmajevima	dragon quest
ดวงพร	fortune	dwongpol
ดวงอาทิตย์	sunce	sun
ดอก	cvijet	flower
ดอกอ้อ	reed cvet	dok aou
ดอกไม้	cvijet	flower
ดอกไม้ประจำจังหวัด	provincijski cvet	state's flower
ดอตคอม	dot com	dotcom
ดอนเมือง	don mueang	don mueang
ดอยอินทนนท์	doi inthanon	doi inthanon
ดอร์	vrata	door
ดอลลาร์สหรัฐ	američki dolar	united states dollar
ดอว์ขิ่นจี	dawin ji	dorkingi
ดังนั้น	tako	for that reason
ดังเช่น	kao	such as
ดัชนีการพัฒนามนุษย์	indeks ljudskog razvoja	human development index
ดัตช์	holandski	dutch
ดันแฮม	dunham	dunham, the mother of barrack obama
ดับเบิลยู	w.	letter w
ดา	da	da - a thai nickname
ดาบ	mač	sward
ดาบเขี้ยวฟ้าฟื้น	mač osvete	sky fang sword of revival
ดารา	zvijezda	star
ดารากร	glumac	darakon
ดาราคู่แรกของไทย	prva zvezda na tajlandu	first movie stars in thailand
ดาราจักร	galaksija	planet in the solar system
ดาราศาสตร์รังสีเอ็กซ์	rendgenska astronomija	xray astronomy
ดาราหญิงไทยยอดนิยม	popularne tajlandske ženske poznate ličnosti	famous actress
ดาวกระจาย	starburst	star disperse
ดาวคาโนปุส	canapas	canopus star
ดาวพฤหัสบดี	jupiter	jupiter
ดาวพุธ	merkur	mercury
ดาวยูเรนัส	uran	uranus
ดาวศุกร์	venera	venus
ดาวอาร์คตุรุส	arcturus	arcturus
ดาวเคราะห์	planeta	planet
ดาวเคราะห์แคระ	patuljasti planet	dwarf planet
ดาวเสาร์	saturn	saturn
ดำรงค์	wimax	dumrong - a male's name
ดำรงตำแหน่ง	držite položaj	hold the title of
ดำรงอ่องตระกูล	damrong ong clan	dumrongongtrakul
ดำเนินสะดวก	damnoen saduak	damnoen saduak
ดิกชันนารี	rečnik	dictionary
ดิค	dick	dick - the name
ดิจิตอล	digitalni	digital
ดิน	tlo	soil
ดินเซนฮอฟเฟอร์	zen hoffer	dientzenhofer - as in christoph or leonhard or johannes
ดินแดน	teritorij	territory
ดิว	rosa	dew - a nickname
ดิวิชั่น	divizija	division
ดิศ	disk	dis (thai first name)
ดิศกุล	diskul	disakul (last name)
ดิสนีย์	disney	disney
ดิสโพรเซียม	disprozijum	dysprosium
ดี	dobro	d.
ดีคอนสตรักทิวิสม์	dconrak tavist	deconstructivism
ดีน	dean	religion (islamic term)
ดีบุก	kalaj	tin
ดีเวลลอปเมนท์	razvoj	development
ดีเวลลอปเม้นท์	razvoj	development
ดีเอ็นเอ	dnk	dna
ดุสิต	dusit	dusit
ดูที่	pogledaj u	see
ดูเพิ่มเติม	vidjeti više	see also
ดูเพิ่มเติมที่	vidi takođe	see more detail in
ดูเร็กซ์	durex	durex
ดูแล	briga	take care
ด็อก	pas	dog
ด้วย	sa	too, also, together, with
ด้วยเหตุนี้	iz tog razloga	for this reason
ด้านการกีฬา	sport	sports
ด้านการต่างประเทศ	spoljni poslovi	foreign affairs
ด้านการเกษตร	poljoprivredne	agriculture
ด้านดนตรี	muzika	in music
ด้านหน้า	prednji	front
ด้านหลัง	leđa	backside
ด้านอ่าวไทย	zaljevska strana	gulf of thailand side
ต	o	a letter from thai alphabet with th sound
ตกรอบที่	eliminisan	did not make the cut
ตรงกับวันขึ้น	uskladite se	on the date of
ตรงกับวันที่	datum podudaranja	on the date of _______________
ตระกูล	klan	family
ตระกูลนารา	porodica nara	nara lineage
ตระกูลปาร์ค	clan park	park family (korean last name)
ตระกูลยามานากะ	porodica yamanaka	yamanaka clan
ตระกูลอินุซึกะ	porodica inuzuka	inu-tsuka family
ตระกูลเซนจู	porodica senju	chen ju dynasty
ตรัง	trang	trung province
ตรางู	zmija	snake brand
ตราด	trat	trad state
ตรานี้	ovaj pečat	this seal
ตราสัญลักษณ์	grb	symbol
ตรึงใจ	fascinantno	truengjai
ตรุษจีน	kineska nova godina	chinese festival
ตลาด	tržište	market
ตลาดโลตัส	lotus tržište	lotus market
ตอน	kada	edition number
ตะกร้อ	njuška	takraw
ตะกั่ว	olovo	copper
ตะละภัฏ	talapat	talaput - a surname
ตะลุยอวกาศ	space dabble	space trek
ตะวันทอแสง	izlazak sunca	tawanthosaeng
ตะวันออก	istok	east
ตะวันออกเฉียงเหนือ	sjeveroistok	east
ตันติเวชกุล	tantivejkul	tuntivetchakul - a surname
ตัว	telo	body
ตัวพระ	glavni junak	main character
ตัวยักษ์	džinovski	giant
ตัวละคร	lik	character
ตัวละครจากเรื่อง	likovi iz priče	soap opera based on a written story
ตัวลิง	majmun	monkey
ตัวสะกด	pravopis	final consonant
ตัวหาร	razdjelnik	divisor
ตัวอย่าง	primjer	example
ตัวอย่างคำบาลี	pali primjer	bali example words
ตัวอย่างคำประพันธ์	primjer stiha	sample writing
ตัวอย่างต้นแบบแรก	primjer prvog prototipa	holotype
ตัวอย่างภาพยนตร์	trejler filma	movie trailer
ตัวอย่างเช่น	na primjer	for example
ตัวเลขอย่างเป็นทางการ	službeni brojevi	formally number
ตัวแปร	promenljiva	variable
ตั้งงี่สุ่น	tang ngeon	tang ngee soon
ตั้งอยู่ที่	smješten na	located
ตั้งอยู่เลขที่	smješten na	at house number
ตั๊กแตน	skakavac	grasshopper
ตา	oko	ta (a person's name)
ตาคลี	takhli	ta-klee
ตามตัวสวมเครื่องประดับต่าง	dok je nosio različite ukrase	accessories
ตามตำราพรหมชาติฉบับหลวง	prema kraljevskom udžbeniku brahme	by royal botanic manual/handbook
ตาระวา	tarawa	square yard
ตาราง	stola	table
ตำนานวายุสลาตัน	legenda oluje	shippuden
ตำนานแฝงคำสอน	legendarna učenja	tales
ตำบลกระเทียม	pododjel češnjaka	garlic district
ตำบลกังแอน	okrug gang ann	ung gan district
ตำบลตาเมียง	okrug ta myung	tambon tameung
ตำบลนางแล	područna oblast nanglae	nang lae province
ตำบลนาดี	poddirekt nadi	na dee district
ตำบลบ้านกง	podrucje ban kong	tambon bankong (name of the district)
ตำบลยะวึก	okrug yuwak	tambon yawuek
ตำบลระแงง	rahang district	ra-ngang district
ตำบลสังขะ	sangkha	thambol sangka
ตำบลเมืองบัว	područna oblast bua	muangbua district
ตำบลโพนครก	okrug phon nakhon	tambon poncrok
ตำบลไพรขลา	podraga phrai khala	phrai khla subdistrict
ติณสูลานนท์	tinsulanon	thinasulanon
ติอามัต	tiamat	tiarmut
ตี๋ใหญ่	veliki tinejdžer	ti yai
ตึก	zgrada	building
ตุรกี	turska	turkey
ตุลาคม	oktobar	october
ตุ๊กแก	gecko	gecko
ตูน	crtani film	toon
ต่อกันด้วยพันธะ	nastavite s obveznicama	linked by bond
ต่อจาก	nastavite od	resulting from
ต่อมา	kasnije	later
ต่อมาวันที่	sledeći datum	later on the date
ต่อมาในปี	kasnije godine	later in the year
ต่อมาในรัชกาลที่	kasnije u vladavini	afterwards, in the reign of
ต่อมาในสมัยกรุงธนบุรีและกรุงรัตนโกสินทร์เขมรตกอยู่ภายใต้การควบคุมของจักรวรรดิสยามอย่างเข้มงวด	kasnije, u periodima thonburi i rattanakosin, kmeri su bili pod strogom kontrolom siamskog carstva.	later in thonburi period and rattanakosin period
ต่าง	različito	different, various
ต่างๆ	razne	various, different
ต้น	početak	medication for multi-symptoms
ต้นตอจักรวาลวิทยา	kozmološkog porekla	cosmogony
ต้นสกุล	rod	clan
ถนน	cesta	street
ถนนคนเดิน	šetajuća ulica	kon dern road
ถนนประชาธิปก	put demokratije	prachatiphok road
ถนนมิตรภาพ	put prijateljstva	thanon mittraphap
ถนนสุขุมวิท	sukhumvit road	sukhumvit road
ถมิตรภาพ	prijateljstvo	mittraphap road
ถวาย	ponuda	presented (royal language)
ถึงกระนั้น	ipak	until
ถึงเดือนกรกฎาคม	do jula	starting july
ถ้วย	šolja	cup
ถ้อยคำ	reči	accent
ทดลอง	probni rad	experiment
ทนงศักดิ์	thanongsak	thanongsak
ทนาย	advokat	lawyer
ทนายความ	advokat	attorney
ทรงคล้ายทรงกลม	sferno	spheroid
ทรงถือหุ้นจำนวน	njegovo visočanstvo ima udjele u	stock ownership
ทรงผนวช	njegovo visočanstvo	ordain
ทรงพระกรุณาโปรดเกล้าโปรดกระหม่อมให้	milostivo me posveti	gift (word for the king)
ทรงยี่สิบหน้า	dvadeset lica	icosahedron
ทรงลูกบาศก์	kocka	cube
ทรงสี่เหลี่ยมขนมเปียกปูน	rhombus	rhombohedron shaped
ทรงสี่เหลี่ยมมุมฉาก	pravougaonik	triangular prism
ทรงห้าหน้า	pet lica	polyhedron
ทรงได้รับการทูลเกล้าฯ	primio je njegovo veličanstvo kralj	the king of thailand gives out ____ to people
ทรัพยากร	resurs	wealth
ทรัพยากรน้ำ	vodeni resursi	water resources
ทรัพย์วิจิตร	bogatstvo	sapwichit
ทรัพย์เพิ่ม	dodatna imovina	subpherm
ทรัมเป็ต	truba	trumpet
ทรีทูวัน	tri do jedan	three.two.one
ทวารหนัก	analni otvor	anus
ทวีป	kontinent	continent
ทวีปอเมริกา	amerika	america continent
ทวีปเอเชีย	aziji	asia
ทวีวัฒน์	thawiwat	taweewan
ทว่า	ali	however
ทศกัณฐ์	tosakan	ravana
ทศพล	tosapon	thotsaphon
ทหาร	vojnik	soldier
ทหารหน่วยอาเฟลันดราที่	afelandrska trupa	afelandra army
ทหารอากาศ	zračne snage	air force man
ทอง	zlato	gold
ทองขาว	bijelo zlato	thongkhao
ทองประสม	mešano zlato	thongprasom
ทองผาภูมิ	thong pha phum	thong pha phum
ทองหยอด	zlatni list	a type of thai dessert
ทองหล่อ	thonglor	gold
ทองเจือ	zlatan čipkan	tong jea - a surname
ทองแดง	bakar	copper
ทองใหญ่	veliko zlato	tong yai - a name
ทอม	tome	tom
ทอมสัน	thomson	thomson
ทอมัส	thomas	thomas
ทะเล	more	ocean, sea
ทะเลทราย	pustinja	dessert
ทะเลสาบ	laguna	lake
ทักษะ	veštine	skill
ทัช	dodirnite	touch
ทับ	slash	thon-rammana
ทัพเรือภาคที่	mornarički odjel	naval area command
ทัวร์คอนเสิร์ต	koncertna turneja	concert tour
ทั่วไป	opšte	general
ทั้ง	i jedno i drugo	all
ทั้งหมด	sve	all
ทางทิศตะวันออก	istok	east
ทางทิศตะวันออกติดกับเวียดนาม	istok graniči s vijetnamom.	borders vietnam to the east
ทางทิศเหนือติดกับประเทศไทยและลาว	sjever graniči s tajlandom i laosom.	borders thailand and laos to the north
ทางน้ำ	vodeni put	by water
ทางรถไฟ	voz	rail
ทางหลวงพิเศษ	specijalni autoput	motorway
ทางอากาศ	zrakom	by air
ทางไอทีวี	na itv	via itv ( a television station in thailand)
ทานากะ	tanaka	tanage - a japanese name
ทาร์ดิกราดา	tardikrada	tardigrada
ทาวเวอร์	toranj	tower
ทำงาน	posla	working
ทำนอง	tune	melody
ทำบุญตักบาตรฯ	zasluge i nudeći monahe hranu	put food offerings into a buddhist monk's bowl
ทำหน้าที่	obavi dužnost	task, function
ทำให้	napravite	made
ทิฆัมพรธีรวงศ์	tikamporn thirawong	timkamporntiravong (thai last name)
ทิพย์	thip	thip
ทิฟฟานี่	tiffany	tiffany - female's name
ทิม	tim	tim
ทิวานนท์	tiwanon	thiwanon
ทิศตะวันตก	zapad	west
ที	t	t.
ทีบีเอส	tbs	tbs
ทีมชาติไทย	reprezentacija tajlanda	thai national team
ทีมใดที่จำนวนข้อที่ถูกน้อยกว่า	koji tim ima manji broj od	the team with the least correct answers
ทีวีอินไซด์	tv iznutra	tv inside
ทีโอที	tot	tot
ที่จ่ายร้อยละ	to plaća procenat	costing
ที่นี้	evo	here
ที่ประชาชนชอบมากที่สุด	koje osobe vole najviše	people's most favorite
ที่มา	izvor	source
ที่มี	to ima	possess
ที่มีชื่อว่า	imenovana	named
ที่สำคัญ	ključ	important
ที่หมายถึง	to znači	explanation
ที่อยู่อาศัย	rezidencija	residence
ที่เกิดขึ้น	to se i dogodilo	appear
ที่โดดเด่นคือ	izuzetno je	notable
ทุก	svaki	every
ทุกครั้ง	svaki put	every time
ทุติยจุลจอมเกล้าวิเศษ	plovila	tuthit julajomklawwiset - the title of those you received jewelry from the king
ทุ่งตะโก	thung tako	thung tako district
ทุ่งสง	thung song	tong song or nakon sri thamarat state
ทุ่งใหญ่	thung yai	tungyai
ทู	također	to
ทูล	alat	thun
ทเวนตี้	dvadeset	twenty
ทโกมลบุตร	t komolabut	komolbut - a surname
ทไย	zašto?	thayai
ท่องอาณาจักรโฮ่งเหมียว	recitirajte kraljevstvo hong miao	traveling the kingdom of woof-meow
ท่าชนะ	držanje	thachana
ท่านอิน	thanin	than in
ท่านอ่อง	ong	tan ong - a member of the royal family
ท่านอ้วน	debeo čovek	than uan
ท่าน้ำนนท์	riva	nam non pier
ท่ายาง	gumeni pečat	tha yang
ท่าศาลา	tha sala	sala pier
ท่าอากาศยานเลย	aerodrom loei	loei airport
ท่าเรือ	luka	pier
ท่าไม้ตาย	settler	deadly move
ท้องสนามหลวง	sanam luang	sanamloung - a landmark in thailand
ธกรุงไทย	krung thai banka	krung thai bank
ธกส	baac	bank for agriculture and agriculture
ธกสิกรไทย	kasikorn banka	kasikornbank
ธง	zastava	flag
ธงชัย	thongchai	thongchai
ธงชาติ	nacionalna zastava	national flag
ธงธง	zastava	thongthong
ธนบุรี	thonburi	thonburi province
ธนพร	thanaporn	thanaporn
ธนะรัชต์	thanarat	tanarat -a surname
ธนาคาร	banka	bank
ธนาคารกรุงศรีอยุธยา	banka ayudhya	bank of ayudhya
ธนาคารกรุงไทย	krung thai banka	krung thai bank
ธนาคารทหารไทย	tajlandska vojna banka	tahanthai bank
ธนาคารทิสโก้	tisco banka	tisco bank
ธนาคารอิสลามแห่งประเทศไทย	islamska banka tajlanda	islamic bank of thailand
ธนาคารเกษตร	poljoprivredna banka	farmer's bank
ธนาคารเพื่อการพัฒนาแห่งเอเชีย	azijska razvojna banka	patana asia bank
ธนาคารไทยพาณิชย์	siam commercial bank	siam commercial bank
ธนิต	thanit	thanit
ธปท	bot	bot
ธรณินทราธิราช	tharawintharathirat	having to do with the king
ธรณีสัณฐานวิทยา	morfologija tla	geomorphology
ธรรมนูญ	povelja	law
ธรรมศักดิ์	thammasak	tamasak - surname of an elected prime minister
ธรรมศาสตร์	univerzitet thammasat	thammasat
ธรรมเมกขสถูป	dharma makk stupa	dhamek stupa
ธานินทร์	thanin	tanin
ธารทิพย์	than thip	tarnthip (first name)
ธำมงรค์	thamrong	ring
ธิติกานต์	thitikan	thitikan
ธีม	tema	theme
ธีระ	thira	teera
ธีรเดช	thiradej	theeradej
ธุรกิจ	posao	business
ธุรกิจการบิน	avionski posao	airline business
นก	ptica	bird
นกกระจอก	vrabac	sparrow
นกกระทา	prepelice	quail
นกกระทุง	pelikan	pelican
นกกระเต็น	kingfisher	kingfisher
นกขมิ้น	kanarski	oriole
นกน้อย	mala ptica	noknoi
นกแก้ว	papagaj	parot
นกแอร์	nok air	airline
นครนิวยอร์ก	new york city	new york city
นครปฐม	nakhon pathom	nakhon pathom
นครพนม	nakhon phanom	nakhon phanom
นครราชสีมา	nakhon ratchasima	nakhon ratchasima
นครสวรรค์	nakhon sawan	nakhon sawan
นครหลวงเวียงจันทน์	vientiane capital	vientiane
นที	pritoka	natee - a male's name
นปช	udd	three letter acronym
นพจินดา	noppachinda	noppajinda - a surname
นพดล	nopadon	noppadol - a male's name
นร	student	the ancient and auspicious order of the nine gems
นราธิป	narathip	naratip - a male's name of a singer
นราธิวาส	narathiwat	narativat state
นวนิยาย	roman	story
นวรัตน์	nawarat	navaratna
นวล	bjelokosti	noul -  a name
นอกจาก	pored toga	other than, to exclude
นอกจากนี้	pored toga	furthermore
นอกจากนี้แล้ว	pored toga	besides
นอกเหนือจากนี้	osim ovog	moreover
นอนไม่หลับ	ne mogu spavati	insomnia
นอร์ส	norveški	norse
นะงะซะกิ	nagasaki	nagasaki
นะโม	namo	namo
นักดนตรี	muzičar	musician
นักบินของออร์บ	orbov pilot	orb pilot
นักบินอวกาศ	astronaut	astronaut
นักปรัชญา	filozof	philosophist
นักพากย์	glas glumac	voice actor
นักมวย	bokser	boxer
นักร้อง	pjevač	singer
นักร้องชายไทย	tajlandski muški pjevači	thai male vocalist
นักร้องนักดนตรี	pevač muzičar	singer, musician
นักร้องเพลงไทยสากลชาย	međunarodni muški tajlandski pjevač	male thai pop singer
นักร้องเสียงหลัก	glavni vokalista	lead singer
นักวิชาการ	akademska	i was in for.
นักวิทยาศาสตร์	naučnik	scientist
นักศึกษาวิชาทหาร	vojni student	army reserve force students
นักสู้อันดับ	rang borac	fighter rank
นักเขียน	pisac	writer
นักเขียนการ์ตูน	crtani film	cartoonist
นักเต้นนำ	vodeća plesačica	dancers
นักเศรษฐศาสตร์	ekonomista	economist
นักแต่งเพลง	kompozitor	songwriter
นักแสดง	glumci	actor/actress
นักแสดงพิธีกร	glumac	presenter of the show
นักแสดงรับเชิญ	pozvani glumac	guest star
นัดกับนัด	datum sa	nut kab nut - a thai sitcom
นันทนาการ	rekreacija	recreation
นันทนาคร	nanthanakorn	nantanakorn
นันทเสน	nantasen	nanthasen
นันทไกร	nantakrai	nandhakrai
นับตั้งแต่เริ่มก่อตั้งจนถึงปัจจุบัน	od osnivanja do danas	from the foundation up to the present
นัยนา	oko	naiyana
นั่นคือ	to je	that is
นั่นเอง	tamo	that is
นั้น	da	that
นา	polje	na
นากา	naga	naga
นากิ	nagi	nagi
นาคหิรัญกนก	nak hirankanok	nakhirunkanok
นางงามจักรวาล	miss universe	ms. universe
นางสาวสุวรรณ	gospođice suwan	miss suwan
นางสุพรรณมัจฉา	gđa suphan matcha	mrs. supanmatja - a character in a thai legend
นางาโตะ	nagato	logo ontario.
นาดี	nadi	na di
นาดูน	na dun	nadune (name of district)
นาทวี	nathawi	natavee district
นาทาล	natalno	"exactly: ""natal;""  proper name: natarle"
นาที	minutu	minute
นานา	brojne	nana
นามิ	nami	nami
นายกรัฐมนตรีของประเทศไทย	premijer tajlanda	prime minister of thailand
นายกรัฐมนตรีไทย	tajlandski premijer	thai prime minister
นายกำพล	gospodine kampon	kamphon
นายชลอ	gospodine chalo	chalo
นายชวน	g. chuan	mr. chuan
นายชาญชัย	gospodine chanchai	chanchai
นายณรงค์	gospodine narong	mr. narong - a male's name
นายดำรง	g. damrong	mr dumrong - a male's name
นายทวี	g. thawee	mr.tawee
นายประกอบ	gospodine skupštinu	mr. prakob - a male's name
นายปรีชา	gospodine preecha	mr.preecha
นายปรีดี	gospodine pridi	pridi - a male's name
นายยงยุทธ	gospodine yongyut	mr. yongyut - a male's name
นายศักดา	gospodine sakda	sakda
นายสมชัย	gospodine somchai	mr. somchai
นายสมัคร	podnosilac prijave	mr. samak - a thai name
นายสวัสดิ์	gospodine sawat	sawat
นายสุชาติ	gospodine suchart	mr. suchat
นายสุนทร	g. sunthorn	mr. soontorn - a male's name
นายแพทย์	doktore	male doctor
นารูโตะ	naruto	naruto - a japanese cartoon
นาวาอากาศเอกหญิง	vođa eskadrile	woman airforce captain
นาฬิกา	sat	clock
นาโนเทคโนโลยี	nanotehnologija	nanotechnology
นำกลับมาสร้างใหม่อีกครั้ง	vraćeno za stvaranje ponovo	remake (of an old movie)
นำแสดงโดย	uloge u glavnim ulogama	performed by
นำโดย	vodi	led by
นิกาย	sekta	sect
นิกเกิล	nikal	nickel
นิคมพัฒนา	nikom phatthana	nikhom phatthana
นิตยสารชีวจิต	homeopatski magazin	cheewajit magazine
นิตยสารเอเชียวีก	magazin azija	asiaweek magazine
นิตโย	nittayo	nittayo
นิทาน	priča	tales
นิยม	popularno	niyom, name of a thai country music singer
นิยมจัดขึ้นในเดือน	popularno se održavalo u toku mjeseca	usually held in the month of
นิยาม	definirati	symbols
นิรมิต	san	niramit
นิรันดร์กุล	nirunkun	nirankun
นิรุกติศาสตร์	etimologija	philology
นิลภิรมย์	nilphirom	nipinpirom - a surname
นิวคลีโอไทด์	nukleotid	nucleotide
นิวยอร์ก	njujork	new york
นิวัฒน์	niwat	niwat
นิวเคลียร์	nuklearna	nuclear
นิวเคลียส	nukleus	nucleus
นิฮง	nihong	nippon or nikon, a japanese reading language
นิเทศศาสตรบัณฑิต	bachelor of arts	communication major graduates
นิ่ม	meko	pangolin
นิ่มสกุล	nim sakul	nimsakun
นีโอ	neo	neo
นี่คือ	ovo je	this is
นุช	radost	nucth
นเรศ	nares	naret - a male's name
นโยบายทางการทูตของจีน	diplomatska politika kine	china;s foreign policies
น็อกซ์	knox	left.
น้องครีม	nong krema	nong kreme - a nickname of someone in thai entertainment
น้องชาย	mlađi brat	brother
น้อยมาก	vrlo malo	noimak
น้ำ	voda	water
น้ำค้าง	rosa	namkhang
น้ำดื่ม	pije vodu	beverages
น้ำท่วม	poplava	flooding
น้ำฝน	kišnica	rainwater
น้ำพอง	na naduvavanje	nam pong in kon kan province
น้ำมะนาว	sok od limuna	lemonade
น้ำมัน	ulje	oil
น้ำมันสน	terpentin	oil of turpentine
น้ำยืน	stajaća voda	numyeen - location in ubolthani state
น้ำหนัก	težina	weight
บทนมัสการนอบน้อมบูชาพระพุทธเจ้า	poglavlje bogosluženja	a prayer to the lord buddha
บทบาททางการเมือง	politička uloga	politic
บทสวดบาลีที่ขึ้นต้นด้วยอรหัง	palijsko pjevanje koje započinje s arhatom	"pali mantra started with ""arhat"""
บทสวดสรภัญญะที่ขึ้นต้นด้วยธรรมมะคือ	sorapanjska pjevanja koja počinju s dharmom jesu	a buddhist prayer
บนบก	na zemlji	on land
บรมนาถชาติอาชาวศรัย	borommanachat achan sai	something has to do with the king - too obscure
บรมนาถบพิตร	boromnat bophit	borommanatbophit
บรรณาธิการ	urednik	editor
บรรพชีวินวิทยา	paleontologija	paleontology
บราซิเลีย	brasilia	brazilian
บราเธอร์ส	braćo	brothers
บริบาล	njega	baribal - a famous soccer player
บริพัตร	hrana	paribatra
บริวเวอรี่	pivara	brewery
บริสุทธิ์	čisto	pure
บริหารธุรกิจ	poslovna administracija	business administration
บริเวณรอบทะเลสาบเขมร	oko jezera khmer	area around the lake in cambodia
บริเวณเขตภูเขาทางภาคเหนือ	planinsko područje na sjeveru	mountain in north of thailand
บรูไน	brunei	brunei
บลีช	bleach	bleach
บลู	plava	blue
บลูคอสมอส	plavi kozmos	blue cosmos
บลูเบอร์รี่	borovnica	blueberry
บวก	pozitivno	positive
บวม	oticanje	swelling
บวร	božanstveno	bawon
บอมบ์	bomba	bomb
บอย	dečko	boy
บอยซ์	boyz	boys
บอล	lopta	ball
บอลด์วิน	baldwin	baldwin
บอส	šef	boss
บังคลาเทศ	bangladešu	bangladesh
บังไค	bangkai	bankai
บัณฑิต	diplomirati	bandit
บัณฑิตวิทยาลัยร่วมด้านพลังงานและสิ่งแวดล้อม	zajednička diplomska škola energije i okoliša	joint graduate school of energy and environment
บันทึก	rekord	record
บันทึกการสร้างโลก	svjetski rekord	genesis diary
บันทึกความทรงจำ	memo	diary
บันเทิง	zabava	entertainment
บัว	lotos	lotus
บัวลอย	bualoy	kind of thai sweetmeat
บัวเชด	cvijet lotosa	cedric dubois.
บัวใหญ่	bua yai	big lotus
บาคคัส	bacchus	bacchus
บาคุกันธาตุไฟ	bakugan element vatre	dragonoid
บาคุกันลูกน้องของนากา	bakugan, pobornik nage	bakugan, minion of naga
บางกอกกล๊าส	bangkok glass	bangkok glass
บางกอกน้อย	bangkok noi	bangkok noi
บางครั้ง	ponekad	sometimes
บางซื่อ	bang sue	bang see - a location in thailand
บางปะกอก	bang pakok	bang prakok - an area in bangkok
บางปะหัน	bang pahan	a district in ayutthaya province
บางพลัด	bangplad	bangplad
บางส่วน	neki	some
บางเขน	bangkhen	bang khen
บางแสน	bangsaen	bang saen
บางใหญ่	bang yai	bang yai - a location in thailand
บานไม่รู้โรย	amarant	gomphrena
บารอมิเตอร์	barometar	barometer
บารัก	barack	barack
บาร์	bar	bar
บาลี	pali	vatthu
บาอัล	baal	baal - a demon in hebrew
บิน	letjeti	bin
บิล	račun	bill
บิ๊กซี	veliki c	big c
บิ๊กซ้งซุปเปอร์สโตร์	super song superstore	big song superstore
บี	b.	b
บีช	plaža	beach
บีบี	bb	bb
บีฟเค้ก	goveđa torta	beef cake
บี้	raspadanje	flatten
บี้สุกฤษฎิ์	bie sukrit	be- sukasit wisetkeaw - name of a singer
บุคคล	osoba	person
บุคคลสำคัญ	važna osoba	vip person, very important person
บุคลิกภาพ	ličnost	mannerism
บุช	bush	(george) bush
บุญค้ำ	zasluga	bunkham
บุญนะโชติ	bunnachot	bunachot - a surname
บุญนาค	zasluga	boon nak - a famous surname
บุณยเกตุ	bunyaket	boonyaket
บุตร	dijete	son
บุษบา	cvijet	busaba - a woman's name
บูมเมอแรง	bumerang	boomerang
บ่อทอง	ribnjak zlato	bothong
บ้านฉาง	ban chang	bahn shang -a  location in thailand
บ้านปราสาท	dvorac zamka	castle house
บ้านผือ	ban phue	ban phue
บ้านฝันดอตคอม	baan fan com	bahnfun.com
บ้านลาด	ban lad	ban lat
บ้านเขว้า	kuća	bahn kaywah, an area in thailand
บ้านแพ้ว	kuća	ban paw
บ้านโพธิ์	ban pho	bahn po - a location in thailand
ปจ	godina	two letters acronym
ปช	plaža	two letters acronym
ปฏิทินช่อง	kalendar kanala	calendar
ปฏิภาณ	esprit	male's name patipan
ปตท	ptt	three letters from thai alphabets
ปทานุกรม	leksikon	encyclopedia
ปทุมธานี	pathum thani	pathum thani
ปภ	sigurnost	the order of the direkgunabhorn
ปภัสรา	papassara	papatsara
ปม	čvor	knot
ประกอบด้วย	uključuju	composed of
ประกอบไปด้วย	sastoji se od	included
ประการที่	broj	point
ประกาศิต	uredbom	command
ประกาศเป็นป่าสงวน	deklariran kao šumski rezervat	preserve area, the protected forest
ประจวบ	sudarati	prachuap
ประจวบคีรีขันธ์	prachuap khiri khan	prajoubkirikan state
ประจักษ์	manifest	mr. prajak
ประจำปี	godišnje	annual
ประชากรประมาณ	procenjena populacija	population about
ประชากรศาสตร์	demografija	literature subject
ประดิษฐาน	mesto	placed
ประติมากรรม	skulptura	production of a play
ประติมากรรมไทย	tajlandska skulptura	thai sculpture
ประตู	vrata	gate
ประตูน้ำ	brana	pratunam
ประตูเสีย	slomljena vrata	broken door
ประทีป	lampa	continent
ประธาน	predsednika	president
ประธานกรรมการ	predsjedavajućeg	chief executive officer
ประธานศาลฎีกา	predsednik vrhovnog suda	president of the supreme court
ประธานสภารัฐสภา	predsjedavajućeg parlamenta	speaker of parliament
ประธานาธิบดี	predsednika	president
ประมาณ	otprilike	about, estimated to be
ประมาณคศ	o:	christ year
ประมาณปี	oko godinu dana	approximately in the year
ประยงค์	prayong	prayong
ประวัติศาสตร์	istorija	history
ประวัติศาสตร์สเปน	istorija španije	history of spain
ประวัติศาสตร์ไทย	istorija tajlanda	history of thailand
ประสาท	živaca	castle
ประสิทธิภาพ	efikasnost	efficiency
ประหยัด	uštedjeti	thrifty, cheap
ประเด็นที่	pitanje	point number
ประเทศ	država	country
ประเทศกัมพูชา	kambodža	cambodia
ประเทศซูดาน	sudan	sudan
ประเทศทำการค้าขายกับต่างประเทศมากยิ่งขึ้น	zemlje koje trguju više sa stranim zemljama	country that trades with other countries
ประเทศนอร์เวย์	norveška	norway
ประเทศฝรั่งเศส	francuska	france
ประเทศพม่า	mjanmar	burma
ประเทศฟินแลนด์	finska	finland
ประเทศภูฏาน	butan	bhutan
ประเทศมาเลเซีย	malezija	malaysia
ประเทศราช	kraljevska zemlja	vassal state
ประเทศลาว	laos	laos
ประเทศสวีเดน	švedska	sweden
ประเทศสเปน	španija	spain
ประเทศอียิปต์	egipat	egypt
ประเทศเกาหลี	koreju	korea
ประเทศเกาหลีใต้	sjeverna koreja	south korea
ประเทศเนปาล	nepal	nepal
ประเทศเปรู	peru	peru
ประเทศเม็กซิโก	meksiko	mexico
ประเทศเวียดนาม	vijetnam	vietnam
ประเทศแคนาดา	kanada	canada
ประเทศและดินแดน	zemlje i teritorije	natoin and territory
ประเทศไทย	tajlandu	thailand
ประเพณีชักพระ	tradicija chak phra	chak phra festival
ประเภท	kategoriju	category
ประเภทของ	vrstu	type of
ประเภทรายการแข่งขันชิงรางวัลดีเด่น	nagrada kategorija izuzetno takmičenje	award show for
ประโยค	rečenica	sentence
ปรัชญา	filozofija	philosophy
ปรัชญาตะวันตก	zapadnjačka filozofija	western philosophy
ปรากฏการณ์โลกร้อน	globalno zagrijavanje	global warming
ปรากฏตัวตอนแรกในตอน	prvo se pojavilo u epizodi	first appear in
ปรากฏตัวในตอน	pojavio se u	showing their presence
ปราจีนบุรี	prachin buri	prachin-buri
ปราบดาภิเษก	krunjen	prapdapisek
ปราสาทเขาพระวิหาร	hram preah vihear	kao pravihan ancient ruins
ปราโมทย์	ushićenje	pramot
ปริญ	prin	parin
ปริญญา	stepen	degree
ปริภูมิ	prostor	3 dimensions
ปริมาณการผลิต	obim proizvodnje	capacity
ปริศนา	slagalica	puzzle
ปริ๊นซ์	princ	prince
ปรีดา	radost	prida - a male's name
ปรีดี	pri	pridi
ปลา	riba	fish
ปลาบู่ทอง	golden goby	goldfish
ปลาปอมปาดัวร์	pompadour	pompadour
ปลาย	kraj	at the end
ปลายคริสต์ศตวรรษที่	krajem 19. veka	late century
ปลาในสกุลนี้เรียกว่า	riba u ovom rodu naziva se	the fish in this family is called _________
ปลิงทะเล	morski krastavac	sea cucumber
ปล่อย	pustiti	release
ปวดข้อ	bol u zglobovima	joint pain
ปวันรัตน์	pawanrat	pavunnarat - a surname
ปวีณา	paweena	paweena
ปักกิ่ง	peking	beijing
ปักธงชัย	pak thong chai	pakthongchai
ปัจจุบัน	prisutan	at present
ปัจจุบันนี้	u današnje vrijeme	presently
ปัจจุบันประเทศไทยมีภาพยนตร์ที่มุ่งสู่ตลาดโลก	danas tajland ima filmove koji su usmjereni prema svjetskom tržištu.	currently thailand has international movies
ปัจจุบันมีที่นั่งอยู่ในสภาผู้แทนราษฎร	trenutno imaju sjedište u predstavničkom domu	presently have elected representatives
ปัจจุบันเลิกเขียนแล้ว	trenutno više ne pišem	presently retired from writing
ปัญจาบ	punjab	panjab
ปัญโญภาส	panopas	panyopat - a surname
ปัน	podeliti	pan
ปั้น	kalup	clay molding
ปั๊บ	odjednom	pup
ปาก	usta	mouth
ปากดี	dobra usta	be talkative
ปากน้ำ	estuarij	samutpragan province in thailand
ปากีสถาน	pakistan	country of pakistan
ปากเกร็ด	pak kret	pak kret
ปากแม่น้ำสิงคโปร์	singapurska usta	singapore river delta
ปาน	stigma	pan - a thai name
ปานามา	panama	panama
ปานแร่	rođendani	panrae
ปาย	pai	pai
ปาริชาต	parichat	tiger’s claw
ปารีส	pariz	paris
ปาร์ค	park	park
ปาสกาล	pascal	pascal - computer language or name
ปาเลสไตน์	palestina	palestine
ปิปเปอราซิลลิน	piper acillin	piperacillin
ปิยะพงษ์	piyapong	piyapong
ปิ่นเกล้า	pinklao	pin glow - an area in thailand
ปีคศ	godina	christain era
ปีจอโทศก	godina svinje	year of the dog
ปีที่	godina	the year
ปีที่วางจำหน่าย	godina izdavanja	the year that the product was on the market
ปีพุทธศักราช	budistička godina	buddhism year
ปีย์	godina	pe - a thai music artist
ปีย์ชนิตว์	piyachit	peechanit
ปีเตอร์	peter	peter
ปี่กลาง	srednja torba	a thai woodwind instrument
ปืนพก	pištolj	handgun
ปืนพกกึ่งอัตโนมัติ	poluautomatski pištolj	semi-automatic pistol
ปืนใหญ่	cannon	cannon
ปืนใหญ่กลางกระสุนวิถีโค้ง	srednje krivulje putanje topa	cannon
ปืนไร้แรงสะท้อนถอยหลัง	puška za povratak	recoilless rifle
ปุณณกันต์	punnakan	bhunnagun
ปุตราจายา	putrajaya	putrajaya
ปุ๋ย	đubrivo	pui
ปู	rak	crab
ป่าชายหาด	šuma na plaži	beach forest
ป่าชายเลน	mangrove šuma	mangrove forest
ป่าดิบแล้ง	suva zimzelena šuma	dry evergreen forest
ป่าเบญจพรรณ	mješovita šuma	mixed forest
ป่าโกงกาง	mangrove šuma	mangrove
ป๊อป	pop	pop
ป๊อปปี้	maka	poppy
ผจญภัยเกาะมหาสมบัติ	avantura za ostrvo blaga	nobita's south sea adventure
ผดุง	podrška	phadung
ผล	rezultata	result
ผลการแข่งขัน	rezultati takmičenja	result of competition
ผลงานหนังสือ	portfelj knjiga	publication
ผลงานเพลง	muzika	song production
ผลงานโฆษณา	oglašavanje	marketing project
ผลประเสริฐ	odlični rezultati	polpasert - last name of the 2nd wife of the thai prince
ผลผลิตพลอยได้	nusproizvodi	result, effects
ผลรวม	suma	summation
ผลสำรวจ	rezultati ankete	survey results
ผิวขาว	bijela koža	white
ผิวสี	boja kože	skin color
ผี	duh	ghost
ผีน่ารัก	slatki duh	cute ghost
ผู้กำกับ	direktor	producer
ผู้จัดการ	menadžer	manager
ผู้จัดการทีม	menadžer tima	manager
ผู้ชนะ	pobjednik	winner
ผู้ชาย	čovek	male, man
ผู้ช่วยศาสตราจารย์	docent	assistant professor
ผู้ดำเนินรายการ	moderator	moderator
ผู้บริหาร	izvršni	manager
ผู้ผลิต	proizvođač	producer
ผู้ฝึกสอน	trener	trainer
ผู้พิทักษ์แห่งพิรุณ	čuvar nevolje	rain defender
ผู้พิทักษ์แห่งอรุณ	čuvar zore	guardian of the dawn.
ผู้ว่าการธนาคารแห่งประเทศไทย	guverner banke tajlanda	governor of the bank of thailand
ผู้ว่าราชการจังหวัด	guvernera	the governor of the city
ผู้สนับสนุน	pristalice	supporter
ผู้อำนวยการ	direktor	superintendent
ผู้เล่น	igrači	player
ผู้เล่นชุด	postavi igrača	team
ผู้ใหญ่	odrasla osoba	adult
ผ่องศรี	phongsri	pongsri
ผ้าขาวม้า	lančić	a special thai cloth that men used to tie around their waists
ผ้าอนามัยโซฟี	sophie sanitarne salvete	sofi sanitary napkin
ฝ	the	a letter with ph sound
ฝอยทอง	fuzz	foythong - a thai dessert
ฝิ่น	opijum	opium
ฝูงชนวุ่นวาย	haotična gužva	mob
ฝ่ามือ	dlan	palm
ฝ่ายบริหาร	menadžment	executive branch
ฝ่าเท้า	potplat	sole of foot
ฝ่าแดนเขาวงกต	kroz lavirint	in the boundaries of kao wonkut
ฝ้าย	pamuk	fai
พ	t	a thai alphabet
พงศ์ศิลป์พิพัฒน์	pongsilp phiphat	pongsinpipat
พงศ์เรืองรอง	pongrueangrong	"surname ""pong reuang-rong"""
พงษ์พานิช	pongpanich	phongphanit
พงษ์เพชร	phong phet	phong phet
พงษ์ไพบูลย์	phongpaibun	pongphatboon
พจนานุกรมออนไลน์	online rječnik	online dictionary
พญา	zmija	phaya
พญามังราย	phaya mangrai	mangrai the great
พตท	područje	three letters acronym
พธม	th	people's alliance for democracy
พนมไพร	phanom phrai	phanom phrai
พบหลักฐานของมนุษย์ซึ่งมีอายุเก่าแก่ที่สุดถึงห้าแสนปี	pronađeni su dokazi o ljudima, najstariji do pet stotina hiljada godina.	found an evidence of the the oldest human that lived in that area
พยัญชนะ	konsonant	consonant
พยัญชนะสะกดควบกล้ำ	suglasnici	diphthong's consonant
พยางค์	slog	syllable
พยาธิกำเนิด	patogeneza	pathogenesis
พยาธิวิทยา	patologija	pathology
พยาบาล	medicinska sestra	nurse
พยายามชี้ให้สาธารณชนและนานาชาติ	pokušaj da se istakne za javnost i međunarodnu	encourage to promote the people and international policies
พร	porno	wishes
พรนารายณ์	narai	phonnarai
พรบ	zakon	act
พรรคการเมืองใหม่	nova politička stranka	kan mai meung political party
พรรคชาติไทย	chart thai party	thai nation party
พรรคธรรมาธิปัตย์	thammathipat party	tamatipat political party
พรรคประชาธรรม	prachatham party	prachatam political party
พรรคภูมิใจไทย	phuea thai party	bhumjaithai party
พรรคสม	party equation	som rangsi political party
พรรคสังคมประชาธิปไตย	socijaldemokratska stranka	social democratic party
พรรคเพื่อแผ่นดิน	pheu tajlandska zabava	puea pandin party
พรอุดมศักดิ์	phonudomsak	pornudomsak (last name)
พระคาถาชินบัญชร	nagon chinnabanchon	chinbanchon
พระจันทร์	mesec	moon
พระจันทร์สีรุ้ง	rainbow moon	phrachan sirung
พระชนม์	život	the father of the king
พระตำหนัก	palata	the king's residence
พระที่นั่งจักรพรรดิพิมาน	palata cara phimana	chakraput piman hall
พระที่นั่งดุสิตมหาปราสาท	prijestolska dvorana dusit maha prasat	phra thinang dusit maha prasat
พระที่นั่งบรมพิมาน	boromphiman mansion	the king's seat
พระธรรมปิฎก	dhammapitaka	phra thampidok
พระธิดา	kćerka	daughter
พระนคร	kapital	phra nakhon
พระนาม	ime	name of the king
พระนามต้นราชสกุล	ime	the first person in the dynasty
พระนารายณ์	vishnu	narayana
พระบรมธาตุไชยา	mošti budine	buddha's relics chaiya
พระบรมราชชนก	kraljevsko pokroviteljstvo	the king's sister
พระบรมราชินี	kraljice	queen
พระบรมวงศานุวงศ์	royalty free	members of the royal family
พระบาทสมเด็จพระนั่งเกล้าเจ้าอยู่หัว	kralj nang klao	jessadabodindra
พระบาทสมเด็จพระปกเกล้าเจ้าอยู่หัว	kralj prajadhipok	phrabat somdet phra poramintharamaha - 7th king of thailand
พระบาทสมเด็จพระปรเมนทรมหาอานันทมหิดล	njegovo veličanstvo kralj bhumibol adulyadej maha anandamahidol	phra bat somdet phra poramentharamaha ananda mahidol
พระบาทสมเด็จพระพุทธยอดฟ้าจุฬาโลก	phra buda phra yot fa, chulalongkorn	king rama 1 of chakri monarchy (bangkok)
พระบาทสมเด็จพระเจ้าอยู่หัวภูมิพลอดุลยเดชทรงพระกรุณาโปรดเกล้าฯ	njegovo veličanstvo kralj bhumibol adulyadej milostivo je ugodio	the current king of thailand
พระบาทสมเด็จพระเจ้าอยู่หัวอานันทมหิดล	kralj ananda mahidol	king ananda mahidol
พระบาทสมเด็จพระเจ้าอยู่หัวเสด็จฯ	njegovo veličanstvo kralj	the current king
พระปกเกล้าเจ้าอยู่หัว	kralj prajadhipok	king rama vii
พระประแดง	phra pradaeng	prapadaeng
พระปรางค์สามยอด	prang sam yot	prapang samyod
พระพรหมคุณาภรณ์	phra prom khunaporn	pra prhom kunaporn - a person in thailand
พระพันปีหลวง	milenijum luang	queen mother
พระพันวัสสาอัยยิกาเจ้า	hiljadu buddha	pra paunvatsaeyyigajao - name of a monk
พระพุทธชินราช	phra buda chinnarat	phra buddha chinnarat
พระพุทธบาท	budin otisak	phra phutthabat
พระพุทธศาสนา	budizam	buddhism
พระมงกุฏเกล้าเจ้าอยู่หัว	kralj rama iv	phra mongkut klao chao yu hua
พระมเหสี	consort	the wife of a king
พระยศขณะนั้น	u to vrijeme	the current title
พระยาชัยสุนทร	phraya chai soonthorn	praya chaisoontorn - first mayor of thailand
พระยาราม	phraya ram	prayaram - the governor of sukothai city (the ancient city of thailand)
พระยาวิเศษภักดี	phraya wisetphakdi	praya wiset pakdi -a  name of a head of state in the ancient time
พระยาสุนทรสงคราม	phraya sunthornsongkram	phraya sonthornsongkram (thai name)
พระยาไกรภักดีศรีนครลำดวน	phraya kraiphakdi srinakhon lamduan	phraya kraiphakdi sinakhon lamduan
พระราชกรณียกิจ	kraljevske dužnosti	royal duties
พระราชลัญจกรประจำพระองค์	kraljevski pečat	the king's body guard
พระราชวงศ์	kraljevska porodica	royal family
พระราชวรวงศ์เธอ	kraljevska porodica	the title of the princess
พระราชวังดุสิต	palata dusit	dusit palace
พระราชวังเดิม	originalna palata	phra racha wang derm
พระลอ	phra lor	phra lo
พระสมเด็จจิตรลดา	phra somdej chitralada	pra jitlada - something that was built by the king
พระสัมมาสัมพุทธเจ้า	lord buda	buddha
พระองค์เจ้าสิริวัณณวรีนารีรัตน์	nj.kv princeza siriwannawari wareerat	the name of one of the king's granddaughter
พระอังสาเบื้องซ้ายประดับเหรียญรัตนาภรณ์	na lijevoj strani simpatični buda amulet, ukrašen kovanicama rattanaporna	diagonal sash for the princess
พระอัษฎามหาเจดีย์	phra asada maha chedi	(royal name/language)
พระอิศวร	shiva	the god shiva
พระอิสริยยศ	kraljevski naslov	given rank or honor by the monarchy
พระอุโบสถ	budistički hram	the temple
พระเกียรติยศ	čast	royal honour
พระเจ้าลูกยาเธอ	božje dijete	the royal princess
พระเจ้าหลานเธอ	bože tvoja nećakinja	hmh princess
พระโคตมพุทธเจ้า	budi amulet	pra kotomputtachao - another name of buddha
พรานกระต่าย	hunter	prankatai - an area in thai province
พราหมณ์	brahmin	brahman
พริกหยวก	beli biber	a type of thai pepper
พริกหวาน	beli biber	sweet pepper
พริกไทย	biber	thai pepper
พฤกษศาสตร์	botanika	botany
พลตรี	zračne snage	major general
พลตรีหญิง	žensko ratno vazduhoplovstvo	a female officer
พลตำรวจเอก	general policije	police general
พลทหาร	vojnik	first class, enlisted men
พลศักดิ์	polsak	polsak
พลอย	gemstone	ploy
พลอสนธิ	polson junction	sonthi - a famous thai army officer
พลอากาศเอกหญิง	ženski acm	air chief marshal
พลฯ	opšte	private
พลังงานคลื่น	talasna snaga	wave power
พลังงานนิวเคลียร์	nuklearne energije	nuclear power
พลังงานลม	snaga vjetra	wind power
พลังงานไฟฟ้า	električna energija	electrical energy
พลัส	plus	plus
พลาซา	plaza	plaza
พลาสติก	plastični	plastic
พลาสมา	plazma	plasma
พลเรือเอก	admirale	admiral
พลเอกสนธิ	general sonthi	sonthi - a thai army officer
พวกสัตว์ลำตัวกลม	životinje okruglog tijela	animals with no backbones
พศ	pet	b.e.
พอ	dosta	col.
พอตเตอร์	potter	potter
พอตเตอร์กับเจ้าชายเลือดผสม	lončar i polukrvni princ	(harry) potter and the half-blood prince
พอยท์	tačka	point
พอล	paul	paul
พัชรี	phachari	pacharee - a female's name
พัฒน์ชัย	phatchai	pattachai - a male's name, famous singer
พัทยาเหนือ	sjeverna pattaya	north pattaya
พัทยาใต้	south pattaya	south pattaya - in thailand
พัน	hiljadu	pan
พันธมิตร	savez	alliance
พันธุศาสตร์	genetika	genetic
พันธุ์พืช	biljne vrste	seed
พันธุ์สุนัข	pasmina pasa	dogs
พันธเสน	bond	panthasen (thai last name)
พับลิชชิ่ง	izdavaštvo	publishing
พัลซาร์	pulsar	pulsar
พากย์เป็น	pod nazivom	subtitle
พายุ	oluja	storm
พารา	para	parasetamol - a drug
พารามีเซียม	parametrično	paramecium
พาร์ค	park	park
พาวเวอร์บาย	power buy	power buy
พาเมล่า	pamela	pamela
พิชัย	phichai	pichai
พิชิต	osvojiti	phichit
พิณ	mandolina	harp
พิธีกรรายการ	domaćin	host
พิบูลมังสาหาร	phibun mangsahan	pi bul mung sa har (province name)
พิพิธภัณฑสถานแห่งชาติ	nacionalni muzej	thailand meseum
พิพิธภัณฑ์	muzej	museum
พิม	pim	type
พิมประภา	phimprapa	phimprapha
พิมพ์เล็ก	mali ispis	small photo frame 1.4 cm x 2.1 cm x 0.5 cm thick
พิมลวรรณ	phimonwan	pimonvun - the name of a female anchor person
พิรุณ	kiša	rain water
พิสุทธิ์	sjajan	pisut - a male's name
พิออจชา	phion čaj	piodcha
พิเศษนครกิจ	nakornkit special	pisetnakornkit - a surname
พีท	pete	pete
พีระมิด	piramida	pyramid
พีระศรี	phirasri	balcony
พีอีเอ	pia	pea
พี่น้อง	braćo	siblings
พี่สาวของ	sestro	the sister of ____________
พึ่งสุนทร	oslanjajte se na sunthorn	puangsunthorn
พืช	biljka	plants
พืชที่สำคัญคือ	važne su biljke	important plants are ...
พืชไม่มีท่อลำเลียง	postrojenja bez cjevovoda	plants without tubelike structures
พื้นฐานทางเศรษฐกิจ	ekonomska osnova	base economics
พื้นที่มหาวิทยาลัย	univerzitetsko područje	university area
พุฒตาล	putthan	puttan
พุทธคยา	bodh gaya	bodh gaya
พุทธนิกายเถรวาท	theravada budizam	a sect of buddhist religion
พุทธศตวรรษที่	vek budista	buddhist era
พุทธศักราช	budistička era	buddhist era
พุ่มพวง	žena	poompoang - surname of a famous actor
พู่กัน	četkica za farbanje	pugun
พ่อขุนรามคำแหง	kralj ramkhamhaeng	the leader of sukothai empire
พ่อขุนศรีอินทราทิตย์	king intharathit	po kun intarathip - the fist king of thailand
พ่อมด	čarobnjak	wizard
พ่ายแพ้ให้กับ	izgubio	lose to
พ๎ร	dobrodošli	wish
ฟง	fong	fong - a chinese name
ฟรานซ์	franz	franz
ฟรีดริช	friedrich	friedrich
ฟรีด้อม	besplatno snehanje	freedom
ฟรีแวร์	freeware	freeware
ฟลายเวท	lagana težina	flyweight
ฟลูวาสแตติน	fluvastin	fluvastatin - a drug
ฟอน	von	von - in german name
ฟอร์ด	ford	ford
ฟอสฟอรัส	fosfor	phosphorus
ฟอสเฟต	fosfat	phosphate
ฟังพระธรรมเทศนา	slušajte propovijedi	listen to the gospel
ฟังเพลง	slusati muziku	listen to music
ฟังไจ	slušaj jaime	fungi
ฟัน	zubi	tooth
ฟาง	slama	fhang
ฟาน	van	van - as in the surname
ฟิชเชอร์	fisher	fisher
ฟินแลนด์	finska	finland
ฟิลิป	philip	philip
ฟิลิปปินส์	filipini	philippines
ฟิลิปีโน	filipino	filipino
ฟิวชัน	fuzija	fusion
ฟิสิกส์ดาราศาสตร์	astrofizika	astrophysics
ฟิสิกส์อนุภาค	fizika čestica	physic particle
ฟีนิลคีโตนูเรีย	fenilketonurija	phenylketonuria
ฟีฟ่าคลับเวิลด์คัพ	fifa-in klupski svjetski kup	fifa world cup
ฟุตซอล	futsal	futsal
ฟุตบอล	fudbal	football
ฟุตบอลอาเซียนเยาวชน	asean youth football	asian youth soccer
ฟุตบอลเอเชียเยาวชน	azijski omladinski fudbal	asian football club youth championship
ฟู	pun	rise up
ฟูจิ	fuji	fuji
ฟูลส์	pun	fools
ฟ้อน	ples	fon
ฟ้า	plava	blue
ฟ้าร้อง	grom	thunder
ฟ้าหลัว	izlazak sunca	haze
ภมรมนตรี	bamamon montri	pamornmontri
ภักดี	odani	pakdi
ภัณฑิลา	panthila	paktila - first name of a female actress
ภาคกลาง	centralna regija	central thailand
ภาคคนแสดง	pokaži	human version
ภาคตะวันตก	zapadna regija	west
ภาคตะวันออกเฉียงเหนือ	sjeveroistočni region	northeast region
ภาคพิเศษ	poseban	special program
ภาควิชาคณิตศาสตร์	odjel za matematiku	department of mathematics
ภาควิชาพยาธิวิทยา	odeljenje za patologiju	department of pathology
ภาควิชาฟิสิกส์	odjel za fiziku	physics
ภาควิชาวิศวกรรมเครื่องกล	odeljenje za mašinstvo	engineering division
ภาควิชาวิศวกรรมไฟฟ้า	odjel za elektrotehniku	engineering department
ภาควิชาสูติศาสตร์และนรีเวชวิทยา	zavod za akušerstvo i ginekologiju	gynecology
ภาควิชาเทคโนโลยีอาหาร	odjel prehrambene tehnologije	faculty of food technology
ภาคเหนือ	sjever	northern region
ภาคใต้ตอนล่าง	donja južna regija	southern thailand
ภาพตรา	slika pečata	coat of arms
ภาพถ่าย	fotografija	photograph
ภาพพาโนรามา	panorama	panoramic image
ภาพพิมพ์	ispis slike	lithography
ภาพยนตร์	filmova	movie
ภาพยนตร์การ์ตูนไทย	tajlandski crtani film	thai cartoon
ภาพยนตร์ชุดนี้	ovaj filmski set	this series
ภาพยนตร์ตอน	epizoda	version of the movie
ภาพยนตร์ลามก	gadan film	porn movie
ภาพรวม	pregled	group of pictures
ภายหลัง	posle	background
ภายหลังสงคราม	posle rata	after the war
ภายใต้ความช่วยเหลือจากกองทุนการเงินระหว่างประเทศ	uz pomoć međunarodnog monetarnog fonda	with the financial help, sponsored by
ภายในวงขอบเหรียญเบื้องบนมีข้อความว่า	na vrhu novčića je izjava koja	etching in the medal that ______________
ภารกิจ	misija	business
ภาวะเศรษฐกิจของกัมพูชาหลังจากมีการเปลี่ยนแปลงการปกครองจากระบอบสังคมนิยมเป็นระบอบประชาธิปไตย	ekonomski uvjeti kambodže nakon prelaska iz demokratskog socijalizma u demokratiju	cambodia economy after political change
ภาษาญี่ปุ่น	japanci	japanese language
ภาษาบาลี	pali	balese language
ภาษาสเปน	španski jezik	spanish language
ภาษาอังกฤษ	engleski jezik	english language
ภาษาอีสาน	sjeveroistočni jezik	eastern thai language
ภาษาเกชัว	quechua	quechua language
ภาษาเฉพาะอาชีพ	žargon	jargon
ภาษาเบสิก	osnovni	basic programming lauguage
ภาษาเยอรมัน	njemački	german language
ภาษาโคบอล	cobol	cobol programming language
ภิญโญ	sve više i više	pinyo - a female's name
ภิรมย์	prijatno	philom
ภิรมย์ภักดี	phirom phakdi	pirompakdee
ภูกระดึง	phukradueng	phu kradueng
ภูกามยาว	phu kam yao	phu kamyao district
ภูธเนศ	bhutanet	putanet - a male's name
ภูพาน	phu phan	phu phan
ภูมิประเทศและภูมิอากาศ	topografija i klima	geography and climate
ภูมิภาค	region	region
ภูมิรัตน์	bhumirat	poomirath
ภูหลวง	phu luang	phu luang
ภูเขา	planina	mountain
ภูเขาน้ำแข็ง	ledeno brijeg	glacier
ภู่สว่าง	phoo sawang	poosawang - a surname
ม	m	a thai alphabet with an 'm' sound
มกราคม	januar	january
มจก	m	the most illustrious order of the royal house of chakri
มณฑลหูหนาน	hunan	hunan in china
มณีวรรณ	maniwan	maniwan
มด	mrav	ant
มดลูก	maternica	uterus
มต้น	počnite	primary level of secondary school
มธ	tu	abbreviation for thammasat university
มธรรมศาสตร์	univerzitet thammasat	thammasat university
มน	okrugli	two letters acronym
มนุษย์	čovek	human
มนุษย์กลายพันธุ์	mutant	human mutant
มนเรศวร	naresuan	naresuan university
มปท	nps	acronyms
มม	mm	mm
มมหิดล	mahidol univerzitet	mahidol university
มยุรา	paun	mayura - a female's name
มลายู	malajski	malayu
มวยปล้ำ	hrvanje	wrestling
มสงขลานครินทร์	princ songkla	prince of songkla university
มหัพภาค	sveukupno	a symbol used in thai writing
มหาชน	javno	public company
มหาชัย	mahachai	mahachai - male's name
มหาบัณฑิต	majstore	graduates from college
มหาปรมาภรณ์ช้างเผือก	maha paramaporn chang phueak	highest class of the order of white elephant
มหาวชิรมงกุฎ	mahavajira kruna	the biggest crown of the king
มหาวรรค	maha buddha	mahavak - a buddhist priest
มหาวิทยาลัย	univerzitet	university
มหาวิทยาลัยขอนแก่น	univerzitet khon kaen	khon kaen university
มหาวิทยาลัยทักษิณ	thaksin university	thaksin university
มหาวิทยาลัยนเรศวร	naresuan university	naresuan university
มหาวิทยาลัยบูรพา	univerzitet burapha	university
มหาวิทยาลัยปทุมธานี	univerzitet pathum thani	pathumthani university
มหาวิทยาลัยพะเยา	univerzitet phayao	prayao university
มหาวิทยาลัยภูมินทร์พนมเปญ	univerzitet phumin, pnom pen	university of phnom penh
มหาวิทยาลัยมหาจุฬาลงกรณราชวิทยาลัย	mahachulalongkornrajavidyalaya university	chulalongkorn university
มหาวิทยาลัยมหาสารคาม	univerzitet maha sarakham	mahasarakham university
มหาวิทยาลัยมหิดล	mahidol univerzitet	mahidol university
มหาวิทยาลัยรังสิต	univerzitet rangsit	rangsit university
มหาวิทยาลัยราชภัฏบ้านสมเด็จเจ้าพระยา	univerzitet bansomdejchaopraya rajabhat	rajapak bahn somdej jao praya college
มหาวิทยาลัยราชภัฏสงขลา	univerzitet songkhla rajabhat	songkhla rajabhat university
มหาวิทยาลัยราชภัฏสวนสุนันทา	univerzitet suan sunandha rajabhat	suan sunandha rajabhat university
มหาวิทยาลัยราชภัฏอุตรดิตถ์	univerzitet uttaradit rajabhat	uttaradit rajabhat university
มหาวิทยาลัยราชภัฏเทพสตรี	univerzitet thepsatri rajabhat	thepsatri rajabhat university
มหาวิทยาลัยราชภัฏเลย	loei rajabhat univerzitet	loei rajabhat university
มหาวิทยาลัยวงษ์ชวลิตกุล	univerzitet wongchawalitkun	vongchavalitkul university
มหาวิทยาลัยศรีนครินทรวิโรฒ	univerzitet srinakharinwirot	srinakarinvirot university
มหาวิทยาลัยศรีปทุม	univerzitet sripatum	sripatum university
มหาวิทยาลัยศิลปากร	univerzitet silpakorn	silapakorn university
มหาวิทยาลัยสุโขทัยธรรมาธิราช	otvoreni univerzitet sukhothai thammathirat	sukhothai thammathirat open university
มหาวิทยาลัยอีสาน	sjeveroistočni univerzitet	issan univbersity
มหาวิทยาลัยอุบลราชธานี	univerzitet ubon ratchathani	ubon ratchathani university
มหาวิทยาลัยอ๊อกซฟอร์ด	univerzitet u oxfordu	university of oxford
มหาวิทยาลัยเกษตรศาสตร์	kasetsart univerzitet	kasetsart university
มหาวิทยาลัยเทคโนโลยีพระจอมเกล้าพระนครเหนือ	sveučilišni tehnološki univerzitet kralja mongkuta sjeverni bangkok	king mongkut's university of technology.
มหาวิทยาลัยเทคโนโลยีราชมงคลกรุงเทพ	rajamangala university of technology krungthep	rajamangala university of technology krungthep
มหาวิทยาลัยเทคโนโลยีราชมงคลตะวันออก	rajamangala tehnološki univerzitet tawan-ok	the eastern university of teachnology
มหาวิทยาลัยเทคโนโลยีราชมงคลธัญบุรี	rajamangala university of technology thanyaburi	rajamangala university of technology thanyaburi
มหาวิทยาลัยเทคโนโลยีราชมงคลสุวรรณภูมิ	rajamangala university of technology suvarnabhumi	techonology university at rajamongkolsuwannapoom
มหาวิทยาลัยเทคโนโลยีราชมงคลอีสาน	rajamangala university of technology isan	rajamangala university of technology isan
มหาวิทยาลัยเปิด	otvoreni univerzitet	open university
มหาวิทยาลัยแม่โจ้	univerzitet maejo	mae joe university
มหาวิทยาลัยแห่งแรกของประเทศไทย	prvi univerzitet na tajlandu	first university of thailand
มองโกเลียใน	unutrašnja mongolija	mongolia
มอร์ริส	morris	morris
มอส	moss	mos
มอสส์	moss	moss
มอหาดใหญ่	mor hat yai	had yai city in southern thailand
มะขาม	tamarind	tamarind
มะม่วงหิมพานต์	indijski oraščić	mango (anacardium occidentale)
มะริด	myeik	myeik
มะเร็ง	rak	cancer
มังกี้	majmun	monkey
มังคุด	mangosteen	mangosteen
มัจฉานุ	matcha	majjanu - the son of the giant in a thai legend.  majanu is half monkey and half fish.
มัชฌิมาปฏิปทา	srednji put	the middle way
มัทนะพาธา	muthana phatha	matthanaphatha
มัธยฐาน	medijan	mode (as in statistic)
มัธยมศึกษา	srednje obrazovanje	junior high school
มัธยมศึกษาปีที่	grade	secondary school year
มันติคอร์	manticore	manticore
มัลเจร่า	malera	wonderweiss margera - a cartoon character
มากกว่า	preko	more than
มากที่สุด	najviše	most abundant
มากิ	maki	magi osuki - the artist
มาครอส	macross	macross
มาจยาร์	mayar	magyar
มาจากภาษาละติน	od latinskog	from latin root
มาซากิ	masaki	masaki
มาดริด	madrid	madrid
มาตรฐาน	standardna	standard
มาตรา	odjeljak	article
มานี	mani	mani - a thai name
มายน์ส	mine	mine
มาริสา	marisa	marissa
มาริเบล	maribel	maribel
มาร์ช	marsh	march
มาร์ติน	martin	martin
มาร์ตินีก	martinique	martinique
มาร์แชล	marshall	marshall
มาลัยพร	malai porn	malaiphon
มาลากุล	malakul	malakul
มาลี	mali	flower
มาสคาร่า	maskara	mascara
มาเก๊า	makao	macao
มาเฟีย	mafija	mafia
มาเรีย	maria	maria
มาเลเซีย	malezija	malaysia
มาเลเซียตะวันตก	zapadna malezija	west malaysia
มิจิรุ	michiru	mijiru
มิตร	prijateljski	mitr
มิตรชัย	mitchai	mitchai
มิตรเพชรา	prijateljski	mit pechara - two of famous actors in the old time
มิถุนายน	juna	june
มินต์	menta	mint
มิลจิ	milji	mulji
มิลตัน	milton	milton
มิลฟีโอเล่	milfi ole	millefiore
มิลลิเมตร	mm	millimeter
มิลินทจินดา	milinthinda	milinjinda - a surname of a singer
มิล่า	mila	mila
มิว	mew	mu
มิวฟิลโอเล่	mule phil ole	millefiore
มิวสิกวีดีโอ	muzicki video	music video
มิสทีน	mistine	mistine
มิฮอว์ค	mihawk	mihawk - surname of a character in a japanese movie
มิเกล	miguel	miguel
มิเชล	michelle	michelle
มิเตอร์	metar	meter
มิโร	miro	miro - name
มีขนาดใหญ่	veliko	big
มีข้อความว่า	označeno	inscription reads
มีความยาว	imajte dužinu	has length of
มีความหมายว่า	značenje	meaning
มีจำนวน	uzmi broj	have the amount of
มีฉายาว่า	sa nadimkom	famous for...
มีชื่อว่า	imenovana	is called
มีชื่อเล่นว่า	nadimak	nick name
มีด	nož	knife
มีดาบฟันวิญญาณ	sa mačem duha	have a sword to fight the ghost
มีทั้งสิ้น	sve	own, available
มีทิวเขาล้อมรอบทางเหนือ	sa planinskim predjelima na sjeveru	surrounded by the mountains in the north
มีน	min	min - a nick name
มีนบุรี	min buri	minburi province
มีนวิทยา	minologija	ichthyology
มีนายกรัฐมนตรี	imajte premijera	have a prime minister
มีประวัติศาสตร์ยาวนาน	ima dugu istoriju	having a long history
มีพรมแดนทางทิศใต้จรดกับอ่าวไทย	južno je omeđen tajlandskim zaljevom	having boundaries adjacent to the gulf of thailand
มีภูเขาล้อมรอบอยู่	okruženi planinama	surrounded by mountains
มีลักษณะดังนี้	ima sljedeće karakteristike	has following characteristics
มีลักษณะภูมิประเทศคล้ายชามหรืออ่าง	sa značajkama poput posude ili umivaonika	have topography like bowl or basin
มีลาภ	imati bogatstvo	milap
มีล่า	neka lovi	mila
มีสูตรการคำนวณหาจำนวนฟัน	postoji formula za izračun broja zuba.	dental formula
มีอยู่	postoje	possess, present
มีอุณหภูมิเฉลี่ย	prosječna temperatura	average temperature
มีอุทยานแห่งชาติสำคัญหลายแห่ง	postoje mnogi važni nacionalni parkovi.	has many important national parks
มีเดีย	mediji	media
มีโคลซีน	sa scenom cole-a	meclozine
มือ	ruka	hand
มู	glatko	mu
มูลนิธิชัยพัฒนา	fondacija chaipattana	chaipattana foundation
มูลนิธิอานันทมหิดล	fondacija anandamahidol	the king's charities
มูลสาร	osnove	munsan
มเชียงใหม่	chiang mai	chaing mai university
มโนราห์	manohra	thai dance art
ม้า	konj	horse
ม้าม	slezina	spleen
ย	the	a thai alphabet with the y sound
ยกเว้น	osim	except
ยศ	čin	rank
ยอด	elita	super, great
ยอดนักสืบจิ๋วโคนัน	detektiv conan	conan the detective
ยอดเขาสูงที่สุดของกัมพูชาคือ	najviši je vrh kambodže	highest mountain in cambodia
ยอพระกลิ่น	yor phra klin	yorpaglin - name of a story
ยัง	do	young
ยาขับปัสสาวะ	diuretički	diuretic pills
ยาง	guma	rubber, tire
ยางธรรมชาติ	prirodna guma	natural rubber
ยางามิ	yagami	yangami
ยานอนหลับ	tablete za spavanje	sleeping pills
ยานอวกาศ	svemirski brod	rocket ship
ยาบ้า	amfetamin	ya ba
ยาปฏิชีวนะ	antibiotici	antibiotic
ยามาโตะ	yamato	yamato - a japanese name
ยามาโมโตะ	yamamoto	yamamoto
ยามเย็น	večer	sundown, evening time
ยิ่งยง	yingyong	yingyong - a first name
ยิ่งลักษณ์	yingluck	yingluck
ยิ้มสู้	smijte se	smile fight
ยีน	gen	gene
ยืนยง	izdržati	(inthira) yeenyong - lead singer of budogun band
ยุคกลาง	srednje godine	middle age
ยุคก่อนประวัติศาสตร์	prapovijesno doba	prehistory
ยุคที่	era	age
ยุคปัจจุบัน	moderno vrijeme	present age
ยุคศตวรรษที่	vekovna era	century
ยุคสามก๊ก	tri kraljevstva	three kingdoms - the legend
ยุคอะซึกะ	asuka doba	asuka period
ยุคอาณาจักรเหนือใต้	sjeverno i južno kraljevstvo	north-south dynasty
ยุคเรเนสซองส์	doba renesanse	renaissance
ยุคเฮอัง	heian doba	heian period of japan
ยุคโบราณ	antička vremena	ancient history
ยุคโลหะ	metalno doba	metal age
ยุคใหม่	novo doba	new age
ยุทธนาวี	bitka mornarice	naval battle
ยุวธิดา	mlada kćerka	yuwatidah
ยุ้ย	pretjerana	yui
ยู	u	u
ยูกิโอ	yukio	yu-gi-oh
ยูฟ่า	uefa	uefa
ยูริ	jurij	yuri -  a japanese name
ยูโด	judo	judo
ยูโรเพียม	europium	europium
ยูไนเต็ด	united	united
ย่านตาขาว	yan khao	yan ta khao
รณชัย	ronnachai	ronnachai
รณภพ	svijet	ronapop
รณฤทธิ์	bitka	ranariddh
รถด่วนสายทางช้างเผือก	autobus sa mliječnim putem	galactic express
รถประจำทางสาย	autobuska linija	bus number
รถยนต์อเนกประสงค์	višenamjenski automobil	automobile
รถลาก	rickshaw	pulled rickshaw
รถโดยสารประจำทาง	autobus	passenger bus
รถโดยสารประจำทางสาย	autobuska linija	bus
รถไฟฟ้าชานเมืองสายสีแดงอ่อน	predgrađe crvenog svetla	rapid transit light red line
รถไฟฟ้ามหานคร	mrt	metropolitan rapid transit
รฟม	r.o.	public transit
รวดเร็ว	brzo	rapid
รวม	uključiti	total
รวมกับ	kombinovano sa	add to
รวมทั้ง	uključujući	include
รวมทั้งประเทศที่ให้ความช่วยเหลืออื่นๆ	uključujući zemlje koje pružaju drugu pomoć	the countries that provided helps
รวมทั้งสิ้น	veliko ukupno	result
รวมระยะทางทั้งสิ้น	ukupna udaljenost	total distance
รศ	suradnik	ratanakosin era
รหัส	kod	code
รอก	kolut	roack
รองประธานรัฐสภาคนที่หนึ่ง	prvi potpredsjednik parlamenta	an assistant head of a thai governmental committee
รองประธานสภาคนที่สอง	drugi potpredsjednik vijeća	second vice chairman
รองเท้า	cipele	shoes
รอญับ	čekaj	seventh month of the hijra calendar
รอบ	okolo	surrounding
รอบคอบ	pažljivo	careful
รอบชิงชนะเลิศระดับประเทศ	nacionalno finale	national final round
รอบที่	okrugli	round
รอบเมือง	oko grada	around town
ระดับกระโดดสูง	skok uvis	high jump  height
ระดับการกระโดดสูง	skok uvis	high jump
ระดับปริญญาเอก	doktorski nivo	doctorate degree level
ระดับปริญญาโท	magistarski rad	master's degree
ระดับมัธยมศึกษา	sekundarni nivo	middle school level
ระดับอาชีวศึกษา	profesionalni nivo	vocational education
ระนอง	ranong	ranong
ระนาด	ksilofon	ranad - a thai musical instrument
ระนาดทุ้ม	alto ksilofon	a type of thai musical instrument
ระนาดเอก	alto	ranad eg -  a thai musical instrument
ระบบ	sistem	system
ระบบกษัตริย์ของกัมพูชา	kambodžanska monarhija	cambodian monarchy
ระบบรัฐสภา	parlamentarni sistem	rajya sabha system of governing
ระบบสืบพันธุ์	reproduktivni sistem	reproductive system
ระบบสุริยะ	solarni sistem	solar system
ระบบโครงกระดูก	skelet sistem	skeletal system
ระบบใช้อำนาจเด็ดขาด	apsolutni sistem napajanja	despotism
ระยะ	faza	phase
ระยะเวลา	trajanje	period
ระยะเวลาการดำรงตำแหน่ง	termin usluge	the term in the office
ระวิ	između	rawi
ระหว่างปี	u toku godine	between the year
ระหว่างสงครามโลกครั้งที่	tokom svetskog rata	during wold war
ระเบียง	balkon	bhirasri
ระเบียบ	red	regulation
ระโนด	smrt	ranode (name of district in thailand)
รักษาศีล	pridržavajte se pravila	keep the precepts
รักษาสิ่งแวดล้อม	zaštitite okoliš	protect the environment
รักแห่งสยาม	ljubav prema siamu	love thailand
รังสิตคลอง	rangsit khlong	rangsit canal
รังสี	zraka	radiation
รังสีเอกซ์	rendgenski snimak	xray
รังสีแกมมา	gama zraka	gamma ray
รัชกาลที่	vladavina	rama
รัชกาลสมเด็จพระจุลจอมเกล้าเจ้าอยู่หัว	vladavina kralja chulalongkorna	king chula chomklao's reign
รัชดาภิเษก	ratchadaphisek	rajada pisek - a location in thailand
รัฐธรรมนูญแห่งราชอาณาจักรไทย	ustav kraljevine tajland	constitution of the kingdom of thailand
รัฐบาลไทย	tajlandska vlada	thai government
รัฐบุรุษ	državnik	statesman
รัฐประหาร	državni udar	coup d'état
รัฐประหารในประเทศไทย	državni udar na tajlandu	thailand's coup d'état
รัฐมนตรีว่าการกระทรวงคมนาคม	ministar saobraćaja	transportation secretary of thailand
รัฐวิสาหกิจ	državno preduzeće	financial situation of the country
รัฐวิสาหกิจไทย	tajlandska državna preduzeća	thai state enterprise
รัฐสภา	parlament	parliament
รัฐสีมาคุณากรปิยชาติ	ratthasima kunakornpiyachat	ratthasimakhunakonpiyachat
รัฐอิลลินอยส์	illinois	state of illinois
รัฐเทกซัส	texas	state of texas
รัตนบุรี	rattanaburi	ratanaburi district - a location in thailand
รัตนาธิเบศร์	rattanathibet	ratana thibet
รับบทโดย	igrao	played by
รับพระราชทาน	prihvati	receive
รัศมี	radijus	radius
รัสเซล	russell	russell
รากแก่น	core root	rakkan
รางวัลนักร้องยอดเยี่ยม	nagrada za najboljeg pevača	best singer award
รางวัลนักร้องไทยสากลชายยอดนิยม	popularna nagrada za muški međunarodni pjevač	best thai male singer award
รางวัลนาฏราช	nagrade royal dancer	naktarath prize
รางวัลโนเบล	nobelova nagrada	nobel prize
รางวัลไนน์เอ็นเตอร์เทน	nine entertainment award	nine entertain awards
ราชตระกูล	kraljevska porodica	royal family
ราชนาวี	mornarica	royal navy
ราชมังคลากีฬาสถาน	stadion rajamangala	rajamangala national stadium
ราชวงศ์จิ้นตะวันออก	istočna dinastija jin	east jin dynasty
ราชวงศ์ชิง	dinastija qing	ching dynasty
ราชวงศ์ถัง	dinastija tang	tang dynasty
ราชวงศ์ทิพย์จักราธิวงศ์	ratchawongthip chakrathiwong	thipjaklatiwong dynasty
ราชวงศ์บ้านพลูหลวง	kraljevska kuća plu luang	ban phlu luang dynasty
ราชวงศ์พระร่วง	dinastija phra ruang	pra roung dynasty
ราชวงศ์หยวน	dinastija yuan	yuan dynasty
ราชวงศ์อู่ทอง	u-thong dinastija	utong empire in ancient thailand
ราชสกุล	žetone	royal family members
ราชสีมา	ratchasima	ratchasima
ราชินิกุล	rodbina kraljice	relatives of the queen
ราบเป็นหน้ากลอง	budite otvoreni	flattened like a drum (meaning to be defeated)
รามอินทรา	ramintra	ram inthra
รายการ	lista	show
รายการวันสำคัญทางพุทธศาสนา	popis važnih budističkih datuma	important days in buddhism
รายชื่อ	lista	list of the names
รายชื่อคำในภาษาไทยที่มักเขียนผิด	spisak tajlandskih reči koje se često pišu pogrešno	common misspelled thai words
รายชื่อภาพยนตร์ไทย	lista tajlandskih filmova	a list of thai movies
รายชื่อหุ่นยนต์ใน	lista robota u	name of robots
รายชื่ออธิการบดี	spisak kancelara	list of presidents
รายชื่อเพลง	spisak pesama	songs list
รายนามรองอธิการประจำวิทยาเขต	lista imena prorektora kampusa	llist of deputy directors of the college
รายนามอธิการบดี	lista predsednika	chancellor list
รายพระนามพระมหากษัตริย์ไทย	popis tajlandskih kraljeva	list of thai monarchs
รายะนาค	raya nak	rayanak
รายได้อื่น	drugi prihodi	other wages, incomes
ราวพุทธศตวรรษที่	oko veka	about buddhist era
ราศีธนู	strelac	sagittarius
รำพันพิลาป	vrišti	poem called rum pan pi lab
ริน	sipati	rin
ริมแม่น้ำเจ้าพระยา	rijeka river chao phraya	near chao praya river
ริวซากิ	ryuzaki	riusaki - from japanese story
ริเอะ	rie	rie tanaga - a japanese singer
รีสอร์ท	odmaralište	resort
รีเนียม	renijuma	rhenium
รุจิพรรณ	rujipan	pan - a name
รุ่ง	zora	dawn
รุ่งสว่าง	zora	rungsawang
รุ่งเพชร	rung petch	roongpetch - a female's name
รูดอล์ฟ	rudolph	rudolf
รูทีเนียม	rutenijum	ruthenium
รูปภาพ	image	picture
รูปร่าง	oblik	body
รูปวรรณยุกต์	tonski oblik	tones
รูปสามเหลี่ยมมุมป้าน	tupi trokut	obtuse
รูปสี่เหลี่ยมด้านขนาน	paralelogram	a paralellogram
รูสเวลต์	roosevelt	roosevelt
ร็อดฟอร์ม	rod form	rock form
ร่วมแสดงกับ	nastupite sa	costarring
ร้องคู่กับ	pevaj zajedno sa	sing a duet with
ร้องร่วมกับ	pevaj sa	featuring
ร้องโดย	otpevano	sung by
ร้อยตรี	drugi poručnik	second lieutenant
ร้านอาหาร	restoran	restaurants
ฤดูกาล	sezona	season
ฤดูฝน	kišna sezona	rainy season
ฤดูร้อน	vruća sezona	summer
ล	the	a thai alphabet with an l sound
ลงวันที่	datum	on this date
ลพบุรี	lop buri	lopburi
ลอนดอน	london	london
ลอยกระทง	loy kratong festival	loy kratong festival
ลอร์ด	gospod	lord
ละคร	drame	play
ละครชาตรี	chatri drama	lakorn-chatri
ละครวิทยุ	radio drama	soap opera broadcasted on the radio
ละครสั้น	kratka drama	short drama
ละครเพลง	mjuzikl	stage musical theatre
ละครโทรทัศน์	sapunica	television drama
ละติจูด	širina	latitude
ลักษณะ	pogledaj	characteristic
ลักษณะทั่วไป	opće karakteristike	common characteristic
ลักษณะทางกายภาพ	fizičke karakteristike	physical characteristics
ลักษณะภูมิอากาศ	klima	the type of climate
ลักษณะสำคัญ	važne karakteristike	main characteristics
ลักเซมเบิร์ก	luksemburg	luxembourg
ลัคนา	ascendent	ascendant
ลา	la	goodbye
ลานจาตุรงคสันนิบาต	četverokut	lan jaturonsunnibat - an ancient place in india
ลามิวูดีน	lamiwooden	lamivudine
ลายน้ำ	vodeni žig	watetmark
ลาว	laos	lao
ลาออก	podneti ostavku	resign
ลำดับ	red	order, sequence
ลำดับพระปฐมวงศ์ในพระบรมราชวงศ์จักรี	red postanka iz dinastije chakri	order of the kings
ลำดับพระมหากษัตริย์ไทย	naredba kralja tajlanda	the order of the kings of thailand
ลำตัว	trupek	body
ลำลูกกา	lam luk ka	lumlookka - a location in thailand
ลำลูกกาคลอง	kanal lam luk ka	lum luk kak klong
ลำไส้เล็ก	tanko crijevo	small intestine
ลิง	majmun	monkey
ลิซท์	liszt	(franz) liszt
ลิปปี	godina usana	rippi - a surname
ลิพิด	lipid	lipid
ลิฟวิ่งมอลล์	living mall	living mall
ลิเก	muzička narodna drama	like
ลิเทียม	litijum	lithium
ลีกคัพ	liga kup	league cup
ลีซอ	lisu	lisu
ลีเมอร์	lemur	lemur
ลี้	li	lee, a district in lumpoon province.
ลี้สุวรรณ	li suwan	lisuwan
ลุงบุญมีระลึกชาติ	ujak boonmee prisjećajući se nacije	uncle boonmee who can recall his past lives
ลูกปัด	perla	beads
ลูกสาว	kćerka	daughter
ลูกอม	slatkiš	candies
ลูกอัณฑะ	testisi	testis
ลูซิเฟอร์	lucifer	lucifer
ลูน่า	luna	luna
ล่าทา	lov	lata
ล่ำซำ	kvrga	lumsum
ล้อม	okolo	lom
ล้อแม็กซ์อัลลอยขนาด	aluminijumske felne, veličina	alloy wheel
วง	petlja	band
วงจรไฟฟ้า	električni krug	electrical circuit
วงดนตรี	band	band
วงศ์กำแหง	porodica	wongkumhang - surname of a famous singer
วงศ์ถั่ว	nut porodica	fabaceae
วงศ์ปลากดทะเล	porodica riba	ariidae
วงศ์ปลากะรัง	grudnjak	serranidae family
วงศ์ปลายอดม่วง	wong pla yot muang	tonguefish
วงศ์ปลาหลังเขียว	zelena riba	clupeidae - a type of fish
วงศ์ปลาเนื้ออ่อน	cichlid	siluridae
วงศ์ปลาเสือตอ	porodica tigrastih riba	datnioididae
วงศ์พัวพันธ์	wongpua phan	wongpourpan
วงศ์วิริยะ	wiriya	vongsiriya - a surname
วงศ์เทวัญ	porodica	wongthewan
วงศ์แคหางค่าง	wong khae hang kong	plants in kae-hang-kang family
วงษ์คำเหลา	wong kham lao	wongkamlao
วงเงิน	limit	budget
วงเวียน	kružni tok	circle
วงแหวน	prsten	ring form, circle form
วชิรบรรจง	wachirabunjong	wachibanjong
วทบ	dd	bachelor of science
วนอุทยานถ้ำจัน	park šuma tham chan	tham chan forest park
วนิดา	wanida	wanida - the name of a drama
วร	wor	won
วรรณกรรม	književnosti	literature
วรรณสุทธิ์	wannasut	wannasut - surname of an actress
วรรธนพิสิฐกุล	watthon phisitkun	wanthanaphisitkun
วรัทยา	warutya	varattaya (first name)
วว	dd	office of ____________
วอก	majmun	wok
วองโกเล่แฟมิลี	porodica vongola	vongola family
วอชิงตัน	washington	washington
วอลท์	walt	walt
วอล์ค	šetnja	walk
วะสี	wasi	wasee
วัง	palata	palace
วังจันทร์	wang chan	wang-chan
วังสระปทุม	palata sra pathum	srapathum palace
วังสะพุง	wang saphung	wang saphung
วังหลัง	palata	wang lang
วังหิน	kamena palača	rock castle
วัชรพล	watcharapol	watcharapol supermarket
วัฒนชัย	watthanachai	wattanachai - a surname
วัฒนธรรม	kultura	culture
วัฒนวิทูกูร	wattanawitkun	watthanawithukun
วัฒนา	wattana	wattana
วัดกลาง	srednji hram	wat klang
วัดป่าเลไลยก์วรวิหาร	wat pa lelai worawihan	wat palaylay
วัดพระธาตุดอยสุเทพราชวรวิหาร	wat phra that doi suthep, ratchaworawihan	wat pratatdoisuthep rachavoravihan - the temple erected on top of doi suthep in northern thailand
วัดพระฝางสวางคบุรีมุนีนาถ	wat phra fang sangkhaburi muninat	prhafangsawangkaburimuninat temple
วัดพระมหาธาตุวรมหาวิหาร	wat phra mahathat woramahaviharn	wat phramahathat woramahawihan
วัดพระยืนพุทธบาทยุคล	wat phra yuen phutthayakhon	the standing buddha temple of puttabatyukol
วัดพระลอย	hram phra loi	wat phra loi
วัดพระศรีรัตนมหาธาตุ	wat phra si rattana mahathat	wat phra si rattana mahathat
วัดพระเชตุพนวิมลมังคลารามราชวรมหาวิหาร	wat phra chetuphon vimolmangklararam ratchaworamahawihan	wat pra chetpnvimolmungklaramrajavoramahavihan
วัดระฆังโฆสิตาราม	hram rakhangkosaram	wat rakang kositaram (name of temple)
วัดสองพี่น้อง	pjesma hrama phi nong	two siblings temple
วัดสุทัศนเทพวรารามราชวรมหาวิหาร	hram suthasan thep wararam	wat sutatthepvararamrajavorimahavihan - a temple in thailand
วัดหนองเพียร	hram nong phian	wat nong pien - a temple in thailand
วัดหน้าพระธาตุ	na phra taj hram	wat na pra tat - a buddhist temple
วัดเจดีย์หลวง	hram chedi luang	wat pagoda
วัดโพธิ์	wat pho	wat po - a thai temple
วัตต์	vata	watt
วัตสัน	watson	watson
วัน	dan	day
วันชัย	wanchai	wanchai - a male's name
วันที่ขึ้นเครื่องหมาย	datum prijave	excluding dividend day
วันที่ออกอากาศชื่อตอนแขกรับเชิญ	datum emitiranja, ime epizode, nastup gosta	when the invitation comes out
วันที่เข้าฉาย	datum izlaska	release date
วันนี้ที่รอคอย	čekam danas	the day that one has been waiting for
วันพฤหัสบดี	četvrtak	thursday
วันพุธ	srijeda	wednesday
วันมหาสงกรานต์	dan maha songkrana	songkran day
วันละ	dan	per day
วันศุกร์	petak	friday
วันสงกรานต์	dan songkrana	songkran day
วันสำคัญ	važan dan	important day
วันสำคัญทางพุทธศาสนา	važan dan budista	buddhist holidays
วันหยุดราชการ	državni praznik	national holiday
วันอังคาร	utorak	tuesday
วันอาทิตย์	nedelja	sunday
วันอาสาฬหบูชา	asanha bucha	asalha puja
วันเกิด	rođendan	birthday
วันเสาร์	subota	saturday
วันแรม	dan	the phase of the moon
วัย	u starosti	age
วัลลิโภดม	walliphodom	wanliphodom
วัสดุฟิสไซล์	fissile material	fissile material
วานูอาตู	vanuatu	vanuatu, australia
วารินชำราบ	warin chamrap	warinchamrap
วาลคิรี	valkirija	valkyrie - angel that helped in valhalla war
วาลีน	valine	valine - a type of protein
วาเรีย	varia	varia
วาเลนไทน์	valentinovo	valentine
วาไรตี้	raznolikost	variety
วิกตอร์	victor	victor
วิคตอเรีย	victoria	victoria
วิจัย	istraživanje	investigate, study
วิจิตรศิลป์	likovna umetnost	fine art
วิชาการ	akademskog	academic
วิชาการคอม	akademsko računalo	vcharkarn.com
วิชิต	wichit	wichit - a male's name
วิญญาณ	duha	soul
วิฑูรย์	lapis lazuli	witoon
วิดีโอเกม	video igrica	video game
วิตามินอี	vitamin e	vitamin e
วิทยาการคอมพิวเตอร์	računarska nauka	computer courses
วิทยาการระบาด	epidemiologija	epidemiology
วิทยาลัยการจัดการเพื่อการพัฒนา	fakultet za menadžment za razvoj	management for development college
วิทยาลัยการบริหารรัฐกิจ	fakultet za državnu upravu	management college
วิทยาลัยครูสวนสุนันทา	učiteljski fakultet suan sunandha	soun sunanta teachers college
วิทยาลัยดุริยางคศิลป์	muzički fakultet	college of music
วิทยาลัยนวัตกรรมและการจัดการ	fakultet inovacija i menadžmenta	the college specialized in arts
วิทยาลัยพยาบาลกองทัพเรือ	pomorski sestrinski fakultet	royal thai navy college of nursing
วิทยาลัยพยาบาลบรมราชชนนี	boromarajonani fakultet sestrinstva	nursing university of barom raj chonnani
วิทยาลัยพาณิชยศาสตร์	trgovinski fakultet	panitsat university
วิทยาลัยวิชาการศึกษา	fakultet za obrazovanje	college of education
วิทยาลัยเทคนิคธนบุรี	tehnički fakultet thonburi	king mongkut's university of technology thonburi
วิทยาลัยแพทยศาสตร์พระมงกุฎเกล้า	phramongkutklao medicinski fakultet	phramongkutklao college of medicine
วิทยาศาสตรมหาบัณฑิต	magistar nauka	master of science
วิทยาศาสตร์สุขภาพ	nauka o zdravlju	health science
วิทยาศาสตร์และเทคโนโลยี	nauke i tehnologije	science and technology
วิทยาเขต	kampus	campus
วิทยาเขตกาญจนบุรี	kanchanaburi campus	kanchanaburi college
วิทยาเขตนครศรีธรรมราช	kampus nakhon si thammarat	nakhon si thammarat campus
วิทยาเขตพิษณุโลก	phitsanulok campus	pissanulok college
วิทยาเขตสารสนเทศเพชรบุรี	kamp phetchaburi informacione tehnologije	information technology college of petchaburi
วิทยาเขตสุพรรณบุรี	kampus suphanburi	suphanburi campus
วิทยาเขตสุรินทร์	surin campus	surin university
วิทยาเขตหนองคาย	kampus nong khai	nong kai university
วิทยาเขตเฉลิมพระเกียรติ	chaloem phrakiat campus	vittaya kat chalerm pra kiet - a location at kasetsat university in thailand
วิทยุ	radio	radio
วิธีการหาความสัมพันธ์	kako pronaći odnose	formula for the correlation coefficient
วินชี	vinci	vinci
วินัย	disciplina	manners
วินเนอร์	pobjednik	winner
วิบูลย์	zbogom	wibul - a male's name
วิมเบิลดัน	wimbledon	wimbledon
วิลลี่	willy	willy
วิลเลจ	selo	village
วิลเลียม	william	williams
วิลเลี่ยม	william	william
วิวัฒนาการ	evolucija	evolution
วิวัฒน์	evoluirati	produce, making up, invent
วิวัฒน์เกียรติ	wiwat kiat	wiwatkiat
วิศว	inženjering	engineering
วิศวกร	inženjer	engineer
วิศวกรรมวัสดุ	mašinsko inženjerstvo	material engineering
วิศวกรรมสิ่งแวดล้อม	ekološki inženjering	environmental engineering
วิศวกรรมเครื่องกล	mehanički inžinjering	engineering
วิศวกรรมไฟฟ้า	elektrotehnika	electrical engineering
วิสา	wisisa	wisa
วิสูตร	dijagnostička	wisut
วิหาร	svetište	vihara
วิเศษ	magija	wiset
วิเศษแก้ว	čarobno staklo	visetkeaw - surname of a singer
วิโนทัย	vinothai	winothai
วีดีโอ	video	video
วีดีโอเกม	video igrica	video game
วีรบุรุษ	heroj	hero
วีระ	veera	veera
วีระยุทธ	wirayut	werayut - a male's name
วีออส	vios	vios
วุฒิสภา	senat	senate
วุฒิเมธี	wuttimethi	wuttimethi - a surname
ว้าวุ่น	rastresen	wawun
ศ	prof	a thai alphabet
ศร	strelica	arrow
ศรชัย	sornchai	sornchai - a male's name
ศรายุทธ	sarayuth	sarayut - a male's name
ศรีนครินทร์	srinakarin	srinakarin
ศรีนวล	srinual	sinuan
ศรีบุญเรือง	sri bunrueang	si bun rueang
ศรีประจวบ	si prachuap	siprachuap
ศรีปาน	sri pan	sri pan - a surname
ศรีมะฆะ	šri makha	sirimaka - a thai name
ศรียาภัย	sriyapai	siyaphai
ศรีสวัสดิ์	srisawat	srisawat -  a surname
ศรีสำโรง	si samrong	si samrong
ศรีเมือง	sri mueang	srimuang
ศรีไพร	sri phrai	sri prai - a name
ศรเพชร	dijamantna strelica	sonpet
ศศิธร	sasithorn	sasitorn - a females name
ศักดิ์ศรี	prestiž	dignity
ศักย์ไฟฟ้า	električni potencijal	electric potential
ศัพท์	terminologiju	vocabulary
ศาลชั้นต้น	građanski sud	curcuit court
ศาลหลักเมือง	svetište gradskog stuba	the old court house
ศาลเจ้าพ่อหลักเมือง	svetište gradskog stuba	the city's god
ศาสตราจารย์	profesor	professor
ศาสนา	religija	religion
ศาสนาพราหมณ์ฮินดู	hinduizam	hindu religion
ศาสนาฮินดู	hinduizam	hinduism
ศาสนาโซโรอัสเตอร์	zoroastrizam	zoroastrianism
ศิริวรรณ	siriwan	siriwan - a female's name
ศิลปอาชา	art archa	silpa-archa
ศิลปะ	umjetnost	arts
ศิลปะการแสดง	performans art	performing arts
ศิลปะลพบุรี	art lopburi	lopburi art
ศิลปะศรีวิชัย	srivijaya art	arts from sri vi chai province
ศิลปะเขมร	khmer art	cambodian arts
ศิลปะเครื่องปั้นดินเผา	keramika umjetnost	pottery art
ศิลปะเชียงแสน	chiang saen art	chaingsan art
ศิลปินแห่งชาติ	narodni umjetnik	national artist
ศิลป์	umjetnost	silpa
ศิษย์เก่าคณะมนุษยศาสตร์	alumni fakultet filozofskog fakulteta	former humanity student
ศิษย์เก่าคณะรัฐศาสตร์	alumni fakulteta političkih nauka	faculty of political science alumni
ศิษย์เก่าคณะเศรษฐศาสตร์	alumni ekonomski fakultet	economics alumni
ศีรษะ	glava	head
ศึกนันทบุเรง	nanthabureng bitka	suknuntabureng -  a war in thailand
ศึกษาศาสตร์	obrazovanje	field of education
ศุกลวัฒน์	sukonwat	sukolawat (a person's name)
ศุภกิจ	supakit	supphakit
ศุภณัฐ	suphanat	supanat (first name)
ศูนย์	centar	center
ศูนย์การค้า	tržni centar	shopping center
ศูนย์การบินทหารบก	vojni vazduhoplovni centar	marine forces
ศูนย์การศึกษาแม่ฮ่องสอน	obrazovni centar mae hong son	maehongsorn learning center
ศูนย์คอมพิวเตอร์	računarski centar	computer center
ศูนย์ค้าส่ง	veleprodajni centar	wholesale center
ศูนย์บริการวิชาการ	akademski servisni centar	academic service center
ศูนย์ภาษา	jezički centar	language center
ศูนย์รังสิต	rangsit center	rangsit university center
ศูนย์ลำปาง	lampang centar	lampang center
ศูนย์แพทยศาสตรศึกษาชั้นคลินิก	obrazovni centar kliničke medicine	medical education center
สก	vijak	abbreviation of two letters
สกว	trf	trf
สกอ	škotska	office of higher education commission
สกอตแลนด์	škotska	scotland
สกาย	sky	sky
สกุล	porodica	sakun
สกุลหยาดน้ำค้าง	sundew	d. etrythrorhiza - a type of plant
สกุลเพชรหึง	petcheng	grammatophyllum
สควอโล่	squalo	squalo
สงคราม	rata	war
สงครามครูเสด	križarski rat	crusades war
สงครามมหาเอเชียบูรพา	veliki istočni azijski rat	world war two
สงครามอวกาศ	svemirski rat	space war
สงครามเกาหลี	korejski rat	korean war
สงครามเย็น	hladni rat	cold war
สง่าพล	elegantno	sangapol - a thai surname
สด	svež	fresh
สตรอเบอรี่	jagoda	strawberry
สตรีวิทยา	radiologija	satriwithaya
สติปัญญา	inteligencija	intelligence
สตึก	satuek	satuek (name of district)
สตูดิโอ	studio	studio
สถานที่ท่องเที่ยวทางธรรมชาติ	prirodne atrakcije	natural attraction
สถานะ	statusa	status
สถานีคาราวาน	karavanska stanica	caravan station
สถานีวิทยุโทรทัศน์ไทยทีวีสีช่อง	tajlandske televizijske stanice s tv kanalima u boji	thai television station number _____
สถานีโทรทัศน์ไทยพีบีเอส	tajlandska pbs televizijska stanica	thai public broadcasting service
สถาบัน	institucija	office, department
สถาบันการศึกษา	obrazovne ustanove	educational institution
สถาบันบัณฑิตพัฒนบริหารศาสตร์	nacionalni institut za razvojnu upravu	satabunbunthitpakanabarihansart - a university in thailand, as known as nida
สถาบันพระบรมราชชนก	kraljevski institut	red cross department
สถาบันวิจัยจุฬาภรณ์	chulabhorn research institute	julapon academy
สถาบันวิจัยและพัฒนา	institut za istraživanje i razvoj	reseach and development institution
สถาบันศูนย์และหน่วยงานในมหาวิทยาลัย	institucije, centri i odjeli na univerzitetima	current faculties/college/school/institutes
สถาบันสมทบ	pridružena institucija	affiliated institute
สถาบันอาชีวศึกษา	strukovni zavod	ahchevasuksa academy
สถาบันอุดมศึกษา	visokoškolska ustanova	higher education institute
สถาบันเทคโนโลยีนานาชาติสิรินธร	sirindhorn international institute of technology	sirindhorn international institute of technology
สถาบันเทคโนโลยีพระจอมเกล้า	king mongkutov tehnološki institut	king mongkut's institute of technology
สถาบันเทคโนโลยีพระจอมเกล้าเจ้าคุณทหารลาดกระบัง	institut za tehnologiju kralja mongkut-a ladkrabang	king mongkut's institute of technology ladkrabang
สถาบันเทคโนโลยีราชมงคล	rajamangala institute of technology	rajamangala university of technology
สถาบันโภชนาการ	institut za ishranu	institute of nutrition
สถาปนิก	arhitekta	architect
สถาปัตยกรรมไทย	tajlandska arhitektura	architecture of thailand
สถิติศาสตร์	statistika	statistic
สธ	sth	two letters from thai alphabets
สนธยา	sumrak	twilight
สนธิ	spoj	sonti - a male's name
สนธิไชย	sonthichai	sontichai
สนามกีฬากลาง	centralni stadion	main athletic field
สนามชัยเขต	sanam chai khet	sanamchaikate - a location in thailand
สนามฟุตบอล	nogometni teren	football field
สนามแม่เหล็ก	magnetsko polje	magnetic field
สนามไฟฟ้า	električno polje	electric field
สนิทวงศ์	sanit wong	there are families.
สนิม	rđa	rust
สนเกรวิลเลีย	bor grožđa	grevilea - family of 250 types of plants
สปริงฟิลด์	springfield	springfield
สปรินเตอร์	sprinter	sprinter
สปาร์ค	spark	spark
สพ	spec	oc
สภานิติบัญญัติแห่งชาติ	nacionalna zakonodavna skupština	national diet
สภาผู้แทนนิสิต	vijeće studentskog predstavnika	college student representatives
สภาพอากาศ	vrijeme	weather conditions
สมจิตต์	somchit	somjit - a female's name
สมจิตร	somchit	somjit
สมชัย	somchai	somchai
สมชาย	somchai	somchai - a male's name
สมภพ	rođenje	sompob
สมศรี	somsri	somsi
สมศักดิ์	somsak	somsak
สมัคร	prijavite se	samak
สมัย	period	era
สมัยกรุงธนบุรี	thonburi period	thonburi era
สมัยก่อนประวัติศาสตร์	prapovijesna vremena	prehistory
สมัยที่	kada	term
สมัยรัชกาลที่	vladavina	in the reign of
สมัยสุโขทัย	sukhothai period	sukothai era
สมัยอาณานิคมฝรั่งเศส	francuski kolonijalni period	modern france
สมาคมประชาชาติแห่งเอเชียตะวันออกเฉียงใต้	asocijacija nacija jugoistočne azije	association of south east asian nations (asean)
สมาชิกรับเชิญตอนพิเศษ	pozivane članove u posebne epizode	special guests
สมาชิกฤดูกาลที่	članovi sezone	member of the parliament
สมุทวณิช	samutavanich	samudavanija
สมเด็จ	njeno veličanstvo	your highness
สมเด็จพระนางเจ้ารำไพพรรณี	kraljica rambhai barni	queen rambhai barni
สมเด็จพระนางเจ้าสิริกิติ์	kraljica sirikit	queen sirikit
สมเด็จพระนางเจ้าฯ	njeno veličanstvo	the queen of thailand
สมเด็จพระบรมราชาที่	kralj	king
สมเด็จพระบรมโอรสาธิราช	prestolonaslednik	his highness, royal crowned prince
สมเด็จพระบรมโอรสาธิราชฯ	prestolonaslednik	the crown prince of thailand
สมเด็จพระมหิตลาธิเบศร	somdet phra mahidol latibes	somdet phra mahitra thibet
สมเด็จพระรามาธิบดีที่	kralj ramathibodi	som dej pra rama tippadee #_____ , number of the king
สมเด็จพระศรีนครินทราบรมราชชนนี	nj.kv princeza maha chakri sirindhorn	queen sirikit
สมเด็จพระอนุชาธิราช	somdej anuchatthirat	som dej pra ah nu cha thi raj - a famous royalty in thailand a long time ago
สมเด็จพระเจ้ากรุงธนบุรี	krung thon buri	the king of the thonburi kingdom
สมเด็จพระเจ้าภคินีเธอ	njeno kraljevsko visočanstvo	the king's sister, som dej pra jao pakini ther
สมเด็จพระเจ้าลูกเธอ	njeno kraljevsko visočanstvo	the king's daughter, the princess
สยามดารา	siam dara	siam stars
สยามบรมราชกุมารี	siam	the current king's eldest daughter, the eldest princess
สยามพารากอน	siam paragon	siam paragon
สร	stvoriti	abbreviation for the royalties' accessories
สรรพสินค้า	robna kuća	department store
สราวุธ	sarawut	sarawut
สร้าง	stvoriti	build
สลักใจ	impress	salakchai
สวนดุสิตโพล	anketa suan dusit	suan dusit poll
สวนผึ้ง	suan phueng	bee garden
สวนสมเด็จพระศรีนครินทร์	somdet phra srinagarindra park	pra sri nakarin - a king of thailand
สวรรคต	pređi	die
สวรรคตหรือ	prošao	die or ___________
สวรรคโลก	sawankhalok	heaven on earth
สวัสดิ์	sawat	sawat - a male's name
สวัสดีปีใหม่	sretna nova godina	happy new year
สวิตเซอร์แลนด์	švajcarska	switzerland
สวี	apartmani	sawi
สส	tajna	representatives
สหพันธ์สาธารณรัฐเยอรมนี	savezna republika nemačka	germany
สหรัฐอาหรับเอมิเรตส์	ujedinjeni arapski emirati	arab emirate
สหรัฐอเมริกา	u.s.	america, usa
สหราชอาณาจักร	ujedinjeno kraljevstvo	united kingdom
สหวงษ์	sahawong	sawong - a male's name
สองสาย	dve žice	double-stranded
สอยดาว	uppercut	soidao
สะดวก	lako	convenient
สะตอ	sato	sator
สะล้อ	kočnica	salao
สะเดา	neem	neem, a type of plant
สัจธรรม	istina	normal truth; common knowledge
สัญญา	ugovor	sanya
สัญลักษณ์ประจำมหาวิทยาลัย	logo univerziteta	logo of the university
สัดส่วน	proporcija	ratio
สัตว์	životinja	animal
สัตว์มีกระดูกสันหลัง	vertebrates	vertebrate animals
สัตว์มีแกนสันหลัง	kralježnica	chordata
สัตว์เลี้ยงลูกด้วยน้ำนม	sisari	mammal
สัตว์เลื้อยคลาน	reptile	reptile
สัตว์เลื้อยคลานในอันดับนี้	reptili u ovom rangu	reptile in this order
สัทศาสตร์	fonetika	phonetics
สันติ	mir	peace
สันติสุข	mir	santi suk
สัมผัสนอก	vanjska rima	outside touch
สัมพันธ์	odnosa	relationship
สัมมา	tačno	summa - the buddhist prayer often starts with this
สาขา	ogranak	office location
สาขานครราชสีมา	podružnica nakhon ratchasima	nakhon ratchasima branch
สาขานครสวรรค์	nakhon sawan branch	nakhon sawan branch
สาขานิเทศศาสตร์	umjetnost komunikacije	faculty of communication arts
สาขาประจวบคีรีขันธ์	podružnica prachuap khiri khan	prachuap khiri khan branch
สาขาปราจีนบุรี	branch prachinburi	pracheenburi branch
สาขาพิษณุโลก	filijala phitsanulok	pisanulok location
สาขามนุษยศาสตร์	humanističke znanosti	humanities
สาขาย่อย	podružnica	offices
สาขาลำปาง	filijala lampang	lumpang location
สาขาวิชานิติศาสตร์	pravni fakultet	law department
สาขาวิชาบริหารธุรกิจ	program poslovne administracije	business administration program
สาขาวิชารัฐประศาสนศาสตร์	odjeljenje za javnu upravu	local government
สาขาวิชาวิทยาการคอมพิวเตอร์	program informatike	school of computer science
สาขาวิชาวิศวกรรมคอมพิวเตอร์	program računarskog inženjerstva	computer engineering
สาขาวิชาวิศวกรรมอาหาร	prehrambeni inženjering	food engineering
สาขาวิชาวิศวกรรมอิเล็กทรอนิกส์	program elektronskog inženjerstva	major electronic engineering
สาขาวิชาศิลปอุตสาหกรรม	odeljenje za umetnost	arts department
สาขาวิชาเคมี	katedra za hemiju	department of chemistry
สาขาวิชาเทคโนโลยีชีวภาพ	biotehnološki program	department of biotechnology
สาขาวิชาเศรษฐศาสตร์	ekonomija	finance department
สาขาศิลปะสถาปัตยกรรม	umetnička arhitektura	art and architecture branch
สาขาสมุย	filijala samui	smui branch
สาขาหัวหิน	podružnica hua hin	hoa hin branch
สาครสินธุ์	sakorn sin	sakornsin - a surname
สาทร	sathorn	sathon
สาธารณรัฐประชาชนจีน	narodna republika kina	people's republic of china
สาธารณรัฐออสเตรีย	republika austrija	republic of austria
สาธารณรัฐอินโดนีเซีย	republika indonezija	republic of indonesia
สาธารณรัฐเช็ก	češka republika	czech republic
สาธารณรัฐโดมินิกัน	dominikanska republika	republic dominican
สานติวัตร	santiwat	santiwat
สามก๊ก	tri kraljevstva	three kingdom 'sam kok' - a thai legend
สามชัย	sam chai	samchai - a location in thailand
สามชุก	sam chuk	sam chuk district
สามพราน	sampran	sam phran
สามอัศวินในจินตนาการ	tri fantastična viteza	sam assavin in jintanakan - the name of a japanese story
สามัญ	običan	common
สายการบิน	airlines	airline
สายรัชกาลที่	kasna vladavina	family tree of king rama ...
สายรุ้ง	duga	rainbow
สายสนั่น	gromova linija	siasanan
สายสีชมพู	pink line	pink line
สายสีน้ำเงิน	plava linija	blue line
สายสีม่วง	ljubičasta linija	purple line (rapid transit)
สายหมอก	magla	fog
สายเดียว	jedna linija	single helix
สายเมืองทอง	mueang thong line	muang thong line
สารต้านอนุมูลอิสระ	antioksidanti	antioxidants
สารพฤกษเคมี	fitohemija	phytochemical
สารภี	saraphi	saraphi
สารละลาย	rešenje	solution
สารานุกรมไทย	tajlandska enciklopedija	saranukromthai
สารานุกรมไทยฉบับราชบัณฑิตยสถาน	tajlandska enciklopedija royal institute edition	thai's publication
สารีวงษ์	sareewong	sariwong
สาวิตรี	savitri	sawitri
สาเหตุ	uzrok	reasons
สำนวนเก่า	stari idiom	old aphorism
สำนักงานขนส่งกรุงเทพมหานครพื้นที่	ured za transport područja u bangkoku	thai general transport
สำนักงานคณะกรรมการวัฒนธรรมแห่งชาติ	ured nacionalne komisije za kulturu	office of arts and culture preservation of thailand
สำนักงานโครงการพัฒนาแห่งสหประชาชาติ	ured za razvojni program ujedinjenih nacija	united nations development prograท
สำนักระบาดวิทยา	zavod za epidemiologiju	bureau of epidemiology
สำนักราชเลขาธิการ	sekretarijat	operation department of the king's palace
สำนักวิทยบริการ	ured za akademske resurse	office of academic services
สำนักหอสมุด	biblioteka	library
สำนักหอสมุดกลาง	centralna biblioteka	the central library
สำรวจ	istraživanje	investigate
สำราญ	radosno	happily
สำหรับ	za	for
สำหรับประเทศไทย	za tajland	for thailand
สำหรับใช้เป็นตราหัวหนังสือราชการไทย	za upotrebu kao pečat na knjižici tajlandske vlade	emblem thailand garuda
สำหรับในปี	jer u godini	for the year
สำเนียง	akcent	dialect
สำโรง	samrong	sumrong - a location in thailand
สิงหาคม	avgusta	august
สิงหไตรภพ	singha tripop	sing tri pop - a thai drama
สิงโต	lav	lion
สิทธิ	prava	rights
สิทธิมนุษยชน	ljudska prava	human rights
สิน	greh	sihn
สินค้าคงเหลือ	zalihe	inventory
สินค้าอุปโภคบริโภค	roba široke potrošnje	supplies
สินสมุทร	sin samut	sihnsmut
สินิทธา	zithitha	sinitra - first name of an actor
สิปปภาค	zippy region	sippapak
สิเรียม	sirium	syriam (name of city in myanmar)
สิ่ง	stvar	things
สิ่งมีชีวิต	životne stvari	living things
สิ่งเสพติด	lijek	addictive substance, drugs
สิ้นพระชนม์ในรัชกาลที่	poginuo za vreme vladavine	died in
สี	boja	color
สีขาว	bijela boja	white
สีดำ	crna boja	black color
สีน้ำตาล	smeđa boja	brown
สีน้ำเงิน	plava	blue
สีฟ้า	plava	blue
สีม่วง	ljubičasta	purple
สีลม	vjetrenjača	silom
สึนะ	tsuna	tsuna
สึนะโยชิ	tsunayoshi	tsunayoshi
สืบต่อมา	nasljediti	live on
สื่อสารมวลชน	masovne komunikacije	mass communication
สื่อสิ่งพิมพ์	štampani mediji	printing media
สุกิจ	sukit	sukit
สุขภาพ	zdravlja	health
สุขสวัสดิ์	suksawat	suksawas
สุขาภิบาล	sanitarni	sukhapibal (name of district)
สุขุมวิท	sukhumvit	sukhumvit
สุครีพ	sukree	sugriva
สุจริตกุล	sucharitkun	sucharitkul
สุจาริณี	sucharinee	sujarinee
สุชิน	suchin	suchin
สุดท้ายตายด้วยฝีมือ	konačno umri od veštine.	eventually dies at the hand of
สุดสาคร	sudsakorn	sootsakorn - a character in a thai legend
สุดารัตน์	sudarat	sudarat
สุทธิชัย	sutthichai	suttichai - a male's first name
สุทัศนะจินดา	sutasachinda	sututnajinda - surname of a tv host
สุทัศน์	suthat	sutas
สุธี	učenjak	sutee - a male's name
สุนทร	sunthorn	sunthon
สุนทรภู่	sunthorn phu	soontornpoo - a character from a legend
สุนทรเวช	sunthornwet	"surname ""sundaravej"""
สุนัขจิ้งจอก	lisica	baby fox
สุปรีย์	supri	supri - a name
สุพจน์	suphot	supot
สุพล	supon	surapol
สุมณทิพย์	sumonthip	sumonthip
สุรชาติ	surachat	surachart - a male's name
สุรพล	surapon	suraphol
สุรพันธ์	suraphan	surapan - a male's name
สุรวุฒิ	surawut	surawut
สุรศักดิ์	surasak	surasak
สุรัสวดี	surasawadee	suratsawadee - a thai surname
สุราษฎร์ธานี	surat thani	surat thani
สุรินทร์	surin	surin - a place in thailand
สุริยัน	suriyan	suriyan - a male actor
สุริโยไท	suriyo thai	"movie called ""suriyothai"""
สุลต่าน	sultan	sultan
สุวนันท์	suwanan	suwanan
สุวรรณรัฐ	suwannarat	suwannarath
สุวรรณานนท์	suwannanon	suwannanon - a surname
สุเทพ	suthep	suthep - first name of a famous singer
สุโขทัย	sukhothai	sukothai - ancient thailand
สุ่น	sunce	sun
สูง	visok	high
สูงจากระดับน้ำทะเลปานกลาง	iznad srednje razine mora	above average sea level
สู่	do	indicate
สเตราส์	strauss	strauss.
สเตอรอล	sterol	steroid anabolic
สเตเดี้ยม	stadion	stadium
สเปน	španija	spain
สไตรค์	štrajk	strike
สไตล์การเล่น	stil igre	style
ส่งเสริม	promovisati	support, encourage
ส่วนของผู้ถือหุ้น	vlasnički kapital	shareholder fund
ส่วนต่อขยายบางซื่อท่าพระ	produžetak bang sue tha phra	bang sue – tha phra expansion
ส่วนสูง	visina	height
ส่วนส่งกำลังบำรุง	odjeljak za logistiku	supply center
ส่วนหัว	header	top part
ส่วนในฤดูฝนน้ำจะท่วมทุกปี	u kišnoj sezoni voda će poplaviti svake godine.	flooding in the rainy season
ส่วนใหญ่	većina	mostly
ส่วนใหญ่เป็นโรงสีข้าว	većina njih su mlinovi riže.	most of them are rice refinery
ส่องแสง	sijati	shining light
ส้ม	narandžasta	orange
ส้มเช้ง	narančasta narandža	acidless orange
ส้มโอ	grejpfrut	pomelo
หงษ์ทอง	hong thong	hongthong
หงษ์มานพ	hong manop	hongmanop
หงสกุล	hong sakul	hongsakul (a famous surname in thailand), as in harin hongsakul
หญ้าทะเล	morska trava	seagrass
หญ้าฝรั่น	šafran	saffaron
หนองคาย	nong khai	nong kai -  a location in thailand
หนองม่วง	nong muang	nong muang
หนองหาน	nong han	nong-haan
หนองฮี	nong hee	nong hi - a location in thailand
หนองแซง	zang	nong sang - area in thailand
หนอน	crv	worm
หนัก	teška	heavy
หนังสือ	knjiga	book
หนังสือการ์ตูน	strip	comic book
หนังสือลามก	pornografske knjige	pornographic magazines
หนังใหญ่	veliki film	nang yai
หนึ่ง	jedan	one
หนึ่งธิดา	jedna kćerka	nuengthida
หนุมาน	hanuman	hanuman - a giant in a thai tale
หนุ่ม	mlad	young (used for men)
หน่วยความจำ	memorija	computer memory
หน่วยคำเติม	morpheme	affix
หน่วยทหารในค่าย	vojna jedinica u logoru	units in camp
หน่วยที่	jedinica	order of 1, 2, 3...
หน่วยบัญชาการนาวิกโยธิน	štab marinaca	royal thai marine corps
หน่วยประมวลผลกลาง	centralna procesna jedinica	central processing unit
หน่วยพันธุกรรม	genetska jedinica	gene
หน้าอก	prsa	breast
หมวด	grupa	category
หมวดหมู่	kategorija	category
หมวดหมู่กลุ่มดนตรีที่ก่อตั้งในปี	kategorija muzičke grupe osnovana u	category: music band established in the year
หมวดหมู่กลุ่มดนตรีสัญชาติเกาหลี	kategorija korejske muzičke grupe	korean musical group
หมวดหมู่กวีชาวไทย	kategorija tajlandskog pjesnika	thai poem category
หมวดหมู่การฉลองปีใหม่	novogodišnja kategorija proslave	the group in charge of new year celebration
หมวดหมู่การประท้วงในประเทศไทย	kategorija protesta na tajlandu	category:protests in thailand
หมวดหมู่การ์ตูนญี่ปุ่นแนวโชเน็น	kategorija: japanski crtić, shonen stil	the cartoons of japan
หมวดหมู่จุลชีววิทยา	kategorija mikrobiologije	category:microbiology
หมวดหมู่ชาวไทยที่นับถือศาสนาพุทธ	kategorija tajlandski budisti	category:thai buddhists
หมวดหมู่ชาวไทยที่เกิดในต่างประเทศ	kategorija tajlanda rođenih u inozemstvu	thais that were born outside thailand
หมวดหมู่ดาวเคราะห์ชั้นใน	kategorija unutarnje planete	group of stars inside
หมวดหมู่ดาวเคราะห์หิน	planet stone kategorija	category:terrestrial planets
หมวดหมู่ทหารอากาศชาวไทย	thai air force kategorija	category:royal thai air force personnel
หมวดหมู่ทหารเรือชาวไทย	kategorija tajlandske mornarice	group of thai navy officers
หมวดหมู่นักการเมืองไทย	kategorija tajlandskih političara	politician
หมวดหมู่นักร้องไทย	kategorija tajlandskih pevača	singer category
หมวดหมู่นายกรัฐมนตรีไทย	kategorija tajlandski premijer	category:prime ministers of thailand
หมวดหมู่บริษัทของไทย	kategorija kompanije iz tajlanda	group of thai's companies
หมวดหมู่บริษัทที่ก่อตั้งในปี	kompanija osnovana u	category:companies established in
หมวดหมู่บอยแบนด์	kategorija dječaka	a group of boys band
หมวดหมู่บุคคลจากจุฬาลงกรณ์มหาวิทยาลัย	kategorije sa univerziteta chulalongkorn	category:chulalongkorn university alumni
หมวดหมู่บุคคลจากมหาวิทยาลัยธรรมศาสตร์	kategorija sa univerziteta thammasat	group of staff from thammasat university
หมวดหมู่บุคคลจากมหาวิทยาลัยสุโขทัยธรรมาธิราช	kategorije sa pučkog otvorenog univerziteta sukhothai thammathirat	group: person from sukhothai thammathirach university
หมวดหมู่บุคคลจากมหาวิทยาลัยอ๊อกซฟอร์ด	pojedinačna kategorija sa univerziteta oxford	the staff of oxford university, england
หมวดหมู่บุคคลจากสถาบันบัณฑิตพัฒนศิลป์	kategorija ljudi sa instituta bunditpatanasilpa	group of staff from art schools
หมวดหมู่บุคคลจากโรงเรียนนายร้อยพระจุลจอมเกล้า	kategorije s kraljevske vojne akademije chulachomklao	catagory: people from prchomklhaw academy
หมวดหมู่บุคคลจากโรงเรียนมงฟอร์ตวิทยาลัย	kategorija pojedinaca sa montfort koledža	category: people from mongford college
หมวดหมู่บุคคลที่เกี่ยวข้องกับเหตุการณ์	kategorija ljudi povezanih sa događajem	catagory: individuals invovled
หมวดหมู่ประวัติศาสตร์ไทย	kategorija povijesti tajlanda	category:history of thailand
หมวดหมู่ประเภทของภาพยนตร์	kategorija filmskih kategorija	types of film
หมวดหมู่ปรัชญา	kategorija filozofija	category:philosophy
หมวดหมู่พระราชนัดดาในรัชกาลที่	kategorija kraljevski unuk vladavine	"catagory: royal heirs during the ""blank"" reign"
หมวดหมู่พระราชปทินัดดาในรัชกาลที่	kategorija kraljevska vladavina za vrijeme vladavine	the king's army
หมวดหมู่พระราชปนัดดาในรัชกาลที่	kategorija kralj panadda u vladavini	belonging to the king # ________
หมวดหมู่พิธีกรไทย	kategorija tajlandski izlagači	host for thai shows
หมวดหมู่ฟุตบอลในประเทศไทย	nogometna kategorija na tajlandu	category; football in thailand
หมวดหมู่ภัยธรรมชาติ	kategorija prirodne katastrofe	catagory: natural disasters
หมวดหมู่ภัยพิบัติทางการแพทย์	kategorija medicinske katastrofe	category: medical disaster
หมวดหมู่มหาวิทยาลัยธรรมศาสตร์	kategorija univerziteta thammasat	thamasat university
หมวดหมู่รัชกาลที่	kategorija vladavine	reign 9 category
หมวดหมู่รัฐคอมมิวนิสต์	kategorija komunističke države	communist countries
หมวดหมู่รัฐมนตรีว่าการกระทรวงการต่างประเทศไทย	kategorija tajlandskog ministra vanjskih poslova	category:foreign ministers of thailand
หมวดหมู่รัฐวิสาหกิจไทย	kategorija tajlandska preduzeća	category:government-owned companies of thailand
หมวดหมู่รัฐสิ้นสภาพในทวีปเอเชีย	država ugašena u aziji	asian counties in controlled
หมวดหมู่รัฐและดินแดนที่ก่อตั้งในปี	kategorija država i teritorija osnovana u	categories state and territory established in
หมวดหมู่รายการโทรทัศน์ไทย	kategorija programa tajlandske televizije	the group of thai television channels
หมวดหมู่ละครโทรทัศน์ไทย	kategorija tajlandske televizijske drame	thai drama category
หมวดหมู่วัฒนธรรมไทย	kategorija tajlandske kulture	category:thai culture
หมวดหมู่วันสำคัญทางศาสนาที่นับโดยปฏิทินจันทรคติ	kategorije važnih vjerskih dana koje se računaju po mjesečevom kalendaru	group of religious holidays
หมวดหมู่ศิลปินสังกัดจีเอ็มเอ็ม	kategorija izvođača pod gmm	mgm artists
หมวดหมู่สถาบันอุดมศึกษาในกรุงเทพมหานคร	kategorije visokoškolskih ustanova u bangkoku	category:universities in bangkok
หมวดหมู่สมุนไพร	kategorija biljaka	herbal, herbs
หมวดหมู่สัตว์มีแกนสันหลัง	kategorija životinje iz kičme	category:chordates
หมวดหมู่สัตว์เลื้อยคลาน	kategorija gmazova	reptilians
หมวดหมู่สิ่งก่อสร้างในพุทธศตวรรษที่	kategorija građevina u 21. vijeku	development in the century # ____
หมวดหมู่สิ้นสุดในคริสต์ศตวรรษที่	kategorija je završila u 19. vijeku.	category: ended in xth century
หมวดหมู่สโมสรในพรีเมียร์ลีก	kategorija kluba u premier ligi	group of premier club
หมวดหมู่อดีตอาณานิคมของฝรั่งเศส	francuska bivša kolonijalna kategorija	category:former french colonies
หมวดหมู่อดีตอาณานิคมของสเปน	bivša kolonijalna španska kategorija	category:former spanish colonies
หมวดหมู่อดีตอาณานิคมของอังกฤษ	britanska bivša kolonijalna kategorija	the group of countries that were under british control
หมวดหมู่อวัยวะ	kategorija organa	group of organs
หมวดหมู่อวัยวะเพศ	kategorija genitalija	category:sex organs
หมวดหมู่เครื่องเทศ	kategorija začina	herbs
หมวดหมู่เพศศึกษา	kategorija seksualnog obrazovanja	sex education category
หมวดหมู่แนวพระราชดำริ	kategorija inicijative	the king's words (instruction)
หมวดหมู่โรค	kategorija bolesti	group of disease
หมวดหมู่โรงเรียนที่มีอัตราการแข่งขันสูง	kategorija škole sa visokom stopom takmičenja	categories high competition school
หมวดหมู่โรงเรียนบุรุษในประเทศไทย	kategorija muških škola na tajlandu	category:boys' schools in thailand
หมอชิต	morchit	mochit bus station
หมากรุกสากล	međunarodni šah	chess
หมายความว่า	znači	means
หมู่	svinja	district, group
หมู่ที่	selo	moo.
หมู่เกาะเคย์แมน	kajmanska ostrva	cayman island
หมู่เกาะแบลีแอริก	balearska ostrva	balearic island in spain
หมู่เกาะโซโลมอน	salomonova ostrva	solomon islands
หม่อมราชวงศ์ปรีดิยาธร	r. pridiyathorn	mom rajawongse pridiyathorn devakula
หม่อมหลวงปิ่น	mama pin	mom luang pin
หม่อมเจ้าจุฑาวัชร	princ jutawatchai	his serene highness prince juthawat
หม่อมเจ้าวัชรวีร์	prince watcharawee	mom chao vatcharee - a member of the royal family
หม่อมเจ้าวัชรเรศร	mama watcharachorn	watcharaje - a member of royal family
หม้อข้าวหม้อแกงลิง	nepenthes	nepenthes - a type of tropical plant
หยุ่น	fleksibilan	yun - nickname of a thai newscaster
หรั่ง	lang	rang
หรือ	ili	or
หรือการแสดงธงชาติ	ili pokazujući državnu zastavu	national flag display
หรือชื่อทางการคือ	ili je službeno ime	official name is
หรือที่รู้จักกันในชื่อ	ili poznat kao	also known as
หรือที่เรียกกันว่า	takođe poznat kao	or what it is called ...
หรือเรียกว่า	ili pozvano	called
หลวง	kraljevski	loung - a thai title for people who services the king
หลอก	pseudo	fake, fooling someone
หลอดอาหาร	jednjak	esophagus
หลอดเลือดแดงใหญ่เอออร์ตา	aorta	aorta
หลักจริยธรรม	etika	ethics
หลักทรัพย์	hartije od vrednosti	property
หลักสี่	laksi	luk sri - a location in bangkok
หลักสูตรการจัดการดุษฏีบัณฑิต	doktor filozofskog programa menadžment	doctor of management program
หลักสูตรที่เปิดสอน	kurs	curriculum
หลักสูตรนานาชาติ	međunarodni kurs	international course
หลักสูตรปกติ	normalni kurs	normal program
หลักสูตรภาษาอังกฤษ	kurs engleskog jezika	english curriculum
หลักสูตรภาษาไทย	kurs tajlandskog jezika	thai language curriculum
หลักสูตรวิทยาศาสตรมหาบัณฑิต	master of science program	degree requirements for a bachelor degree in science
หลังจาก	posle	after
หลังสงคราม	posle rata	after the war
หลังสงครามโลกครั้งที่	posle svetskog rata	world war
หลังสงครามโลกครั้งที่สอง	posle drugog svetskog rata	after world war ii
หลังเหตุการณ์	nakon događaja	after the event
หลาย	mnogi	many, vastly
หลีกภัย	bijeg	mr. cheun leakpai, the former foreign ministor
หลุมดำจิ๋ว	sitna crna rupa	small black hole
หล่มสัก	lom sak	lohmsak
หวาย	ratana	bamboo
หอก	koplje	spear
หอประชุมพ่อขุนรามคำแหงมหาราช	kralj ramkhamhaeng veliki auditorij	pho khun ram khamhaeng convention center
หอมรดกไทย	dvorana tajlandske baštine	national ancient museum of thailand
หอย	školjke	shells, clams
หอไอเฟล	ajfelova kula	eiffel tower
หัก	odbiti	broken
หัว	glava	head
หัวหิน	hua hin	hua hin
หัวโขน	maska	khon mask
หัวใจ	srce	heart
หาง	rep	tail
หาดทรายแก้ว	plaža sai kaew	glass beach
หาบเร่	hawker	street vending
หินปูน	krečnjak	limestone
หินอ่อน	mramor	marble
หินเชิร์ต	kamena košulja	chert
หินแกรนิต	granit	granite rock
หินไซอัล	škriljasti kamen	sial
หี	maca	vagina (impolite word)
หุตะสิงห์	huta sing	hutasingha
หุ่น	lutka	model
หุ่นยนต์	robot	robot
หเตุการณ์	situacija	event
ห่วงใย	brižna	care
ห้วยขวาง	huai khwang	huai khwang
ห้วยทับทัน	huai thap than	huai thap than
ห้องน้ำ	toalet	bathroom
ห้องสมุด	biblioteka	library
ห้าง	dućan	mall
ห้างฉัตร	hang chat	hang chat
ห้างหุ้นส่วนจำกัด	ograničeno partnerstvo	limited partnership
ฬาพานิช	komercijalno	fapanit - surname of an actor
อก	dojke	chest
อคิลลีส	ahil	achilles
องคชาต	genitalije	penis
องคต	organizacija	angada
องค์กรปกครองส่วนท้องถิ่น	organizacija lokalne uprave	local administration
องค์การนิสิต	organizacija studenata	student organization
องค์การมหาชน	javna organizacija	human services
องค์การสหประชาชาติ	ujedinjeni narodi	united nation
องค์บาก	ong bak	ong-bak
องค์ประกันหงสา	hongsa osiguranje	prakunhongsa - a famous person from the ancient time
องอาจ	odvažan	ongart
อดิศักดิ์	adisak	adisak
อดีต	bivša	the past
อดีตผู้บัญชาการทหารบก	bivši vojni zapovjednik	ex-commander in chief of the royal thai army
อดีตรองนายกรัฐมนตรี	bivši potpredsjednik vlade	former deputy prime minister
อดีตรองหัวหน้าหน่วยที่	bivši zamjenik šefa jedinice	former lieutenant
อธิการบดี	kancelara	dean of the college
อธิการบดีมหาวิทยาลัยธรรมศาสตร์	predsjednik univerziteta thammasat	former chanceller of thamasat university
อธิบายว่า	objasnite to	explain
อนันตยะ	anantaya	anantaya
อนันตรัย	anantai	anuntrai
อนาลโย	analoy	analayo
อนึ่ง	slučajno	once
อนุทิน	dnevnik	diary
อนุสรณ์สถาน	spomen obilježje	monument
อนุสรา	anusara	anusara
อปักธงชัย	pak thongchai	pak thongchai district
อพอลโล่	apolon	apollo
อพิมาย	aphimai	phimai district
อภัยนุราช	oprosti	aphainurat
อภินันท์	aphinan	ahpinun - a male's name
อภิปรัชญา	metafizika	metaphysics
อภิรักษ์	aphirak	apirak
อมฤต	smrt	ummarit - a male's name
อมาตยกุล	amatayakun	amattayakun
อยู่	su	is
อยู่วิทยา	nauka	yoovidhya
อยู่ห่างออกไปจากชายฝั่ง	daleko od obale	away offshore
อยู่แล้ว	već	already
อยู่ในเขตอำเภอกุฉินารายณ์	smješten u okrugu kuchinarai	in the kuchinarai district
อย่างต่อเนื่อง	neprekidno	continuously
อย่างแพร่หลาย	široko	many, various
อย่างไรก็ตาม	kako god	however
อร	orn	orn (thai name)
อรทัย	mlada djevojka	orathai - surname of a thai country singer
อรรถกถา	komentar	atthakatha
อรรถพร	athaphon	uttapon - a female's name
อรัญประเทศ	aranyaprathet	arranyapratet - a location in thailand
อริยสัจ	plemenita istina	teaching of buddha
อรุณี	arunee	arunee
อลังการ	ukras	alungan - the name of a movie theater in thailand
อลาสก้า	aljaska	alaska
อลิซ	alice	alice
อวอร์ดส	nagrade	award
อวัยวะสืบพันธุ์สตรีด้านนอก	spoljni ženski organi spolja	femal reproductive system
อวัยวะสืบพันธุ์หญิง	ženski genitalni organi	female reproductive system
อวัยวะเพศ	genitalije	sex organ
อศรีประจันต์	asri prachan	master sri prajan - a priest's name
อสมท	mcot	acronym for thai communication companies
อสามชุก	sam chuk	sam chuk district
ออ	ili	auu - a thai vowel
ออกฉายครั้งแรกเมื่อวันที่	prvo prikazano	first screening
ออกมาในอะนิเมะเท่านั้น	izlazi samo u animeu	only in anime
ออกอากาศ	emitovanje	on the air
ออกอากาศครั้งที่	emitovano	airing
ออกอากาศทางช่อง	emitiranje dalje	aired on channel
ออกัสตัส	augustus	augustus
ออกเป็น	ulazak	into
ออกแบบตัวละคร	dizajn karaktera	character design
ออนไลน์	online	online
ออฟ	isključeno	off
ออลแบนี	saveznici	albany
ออสเตรเลีย	australija	australia
ออโตทรอพ	autobot	autotroph
อะ	šta	a
อะซูไรต์	azurite	azurite
อะตอม	atom	atom
อะนิเมะ	anime	anime
อะบุราเมะ	aburame	aburame
อะพาไทต์	apatite	apartheid
อะมาเดอุส	amadeus	amadeus
อะลูมิเนียม	aluminijum	aluminum
อะโกนิสต์	agonista	agonist
อะโลน	sam	alone
อักษร	pismo	letters, alphabets
อักษรย่อ	skraćenice	abbreviation
อักษรเกาหลี	korejska abeceda	korea alphabet
อังกฤษสมัยแองโกล-นอร์มัน	anglo-norman engleski	england anglo-norman era
อังการา	ankara	ankara
อัญมณี	dragulj	gem
อัฒภาค	zarez	semicolon
อัตราการว่างงาน	stopa nezaposlenosti	unemployment rate
อัธฮา	athha	athha
อันดับ	ocena	order
อันประกอบด้วย	koji se sastoji od	consists of
อันโตนิโอ	antonio	"name ""antonio"""
อันโตนีโอ	antonio	antonio
อันได้แก่	uključujući	which are
อัฟกานิสถาน	afganistan	afghanistan
อัมพร	amporn	umpon - a female's name
อัมพาต	paraliza	paralysis
อัลบัส	albus	albus in harry potter stories
อัลบั้ม	album	album
อัลเดบารัน	aldebaran	arudebaran
อัลเฟรด	alfred	alfred
อัสนี	vijak	thunderbolt
อาการหวาดระแวง	paranoia	paranoid
อากาศ	zrak	air, weather
อากาศอำนวย	weather	akat amnuai
อากาเป	agape	the word meaning 'love' in greek language
อาคามัตสึ	akamatsu	akamatsi
อาคารส่วนที่	odjel građevine	part (insert number) of the the building
อาคารอุบลรัตนราชกัญญา	zgrada ubonratana ratchakanya	buildings outside ubon ratana graz contract.
อาคารเฉลิมพระเกียรติ	zgrada chaloem phrakiat	chalermphrakiat building
อาจหมายถึง	može značiti	may also mean
อาจารย์	profesor	teacher
อาจารย์ใหญ่	ravnatelj	headmaster
อาซึกะ	asuka	asuka
อาณัตพล	anataphon	arnattapon
อาณาจักร	kraljevstvo	kingdom
อาณาจักรธนบุรี	kraljevstvo thonburi	thonburi empire
อาณาจักรสุโขทัย	sukhothai kingdom	sukhothai kingdom
อาณาจักรอยุธยาปกครองเขมรเป็นเวลาเกือบปี	ayutthaya kraljevstvom je vladala kambodžom gotovo godinu dana.	ayutthaya dynasty had colonized khmer for almort 400 years
อาณาจักรอยุธยาเริ่มเสื่อมอำนาจลงราวพุทธศตวรรษที่	ayutthaya kraljevstvo je počelo propadati u budističkom stoljeću.	ayutthaya kingdom had started to downfall around 24 b.e.
อาณาจักรแพกเจ	pakae kingdom	pakja territory
อาณาเขตติดต่อ	kontakt područje	adjoining parcel
อาดัม	adame	adam
อาทิ	kao što su	for example
อาทิตย์	sedmicu	sunday
อานนท์	anon	anon
อานันทมหิดล	ananda mahidol	ahnanmahidol - someone with the king's surname
อานุภาพ	snage	power
อานโตนิโอ	antonio	antonio
อาบาราอิ	abarai	abarai
อายุ	dob	age
อารยา	araya	araya
อาร์	r	r.
อาร์กอน	argon	argon
อาร์คิมิดีส	arhimed	archimedes
อาร์ม	ruka	arms
อาร์มาดิลโล	armadillo	armadillo
อาร์เคด	arcade	arcade
อาร์เมเนีย	jermenija	armenia
อาร์เอ็นเอ	rna	ribonucleic acid - rna
อาร์โนลด์	arnold	arnold
อาวุธคือ	oružje je	type of weapons
อาวุธประจำกาย	lično oružje	personal weapon
อาหาร	hrana	food
อาเจียน	povraćati	vomit
อาเธอร์	arthur	arthur
อาเนีย	ana	anya
อำนาจ	snage	amnat
อำนาจอธิปไตย	suverenitet	sovereignty
อำเภอ	okrug	district
อำเภอกมลาไสย	kamalasai district	kamalasai district
อำเภอกระสัง	okrug krasang	krasang district
อำเภอกันทรลักษ์	okrug kantharalak	kantharalak district
อำเภอขุขันธ์	okrug khukhan	khukhan district
อำเภอขุนหาญ	okrug khun han	amphur kunhan
อำเภอครบุรี	okrug khon buri	amphur kornburi
อำเภอคูเมือง	okrug khu mueang	khu mueang district
อำเภอจอมทอง	okrug chom thong	jom thong district
อำเภอดอยสะเก็ด	okrug doi saket	doi saket district
อำเภอด่านขุนทด	okrug dan khun thot	dan koontod district
อำเภอตะพานหิน	okrug taphan hin	taphan hin district
อำเภอทับคล้อ	okrug thap khlo	amphoe tap khlo
อำเภอทุ่งช้าง	okrug thung chang	thung chang district
อำเภอท่าตูม	okrug tha tum	ta toom district
อำเภอท่าวังผา	okrug tha wang pha	ta wung pa province
อำเภอท่าวุ้ง	okrug tha wung	ta wung district
อำเภอนครชัยศรี	okrug nakhon chai si	nakhon chai si district
อำเภอนาบอน	na bon district	nabon district
อำเภอน้ำเกลี้ยง	okrug nam kliang	amphur namleang
อำเภอบัวเชด	okrug buachet	buachet district
อำเภอบัวใหญ่	okrug bua yai	amphoe buayai (buayai district)
อำเภอบางบัวทอง	okrug bang bua thong	bang bua thong district
อำเภอบางบ่อ	okrug bang bo	bang bor district
อำเภอบางพลี	okrug bang phli	bang plee district
อำเภอบางละมุง	okrug bang lamung	bang lamung district
อำเภอบางเสาธง	okrug bang sao thong	bang sao thong district
อำเภอบ้านลาด	okrug ban lat	bahn lad district
อำเภอบ้านหมี่	okrug ban mi	ban mi district
อำเภอปราสาท	prasat district	amphor-prasart
อำเภอปากช่อง	okrug pak chong	pak chong district
อำเภอปากพนัง	okrug pak phanang	pak phanang district
อำเภอปาย	pai distrikt	pai district
อำเภอฝาง	okrug fang	fang district
อำเภอพระประแดง	okrug phra pradaeng	pra-pradaeng district
อำเภอพระพรหม	okrug phra phrom	pra phrom province
อำเภอพระสมุทรเจดีย์	okrug phra samut chedi	samutjadee district
อำเภอพลับพลาชัย	okrug phlapphla chai	plubplachai province in thailand
อำเภอพัฒนานิคม	okrug phatthana nikhom	amphur pattananikhom
อำเภอพิปูน	phipun district	phipun district
อำเภอพุทธมณฑล	okrug phutthamonthon	ampore phuthamontol
อำเภอภูสิงห์	phu sing distrikt	aumphor phu sing (name of district)
อำเภอยางชุมน้อย	okrug yang chum noi	choom noi province
อำเภอรหัสไปรษณีย์หมายเหตุ	okrug, poštanski broj, napomena	district, post code, note
อำเภอรัตนบุรี	okrug rattanaburi	rhatanaburi district
อำเภอราษีไศล	rasi salai district	rasi-salai district
อำเภอร่อนพิบูลย์	okrug ron phibun	ronpibul district
อำเภอลาดหลุมแก้ว	okrug lat lum kaeo	lat lum kaeo district
อำเภอลำปลายมาศ	okrug lam plai mat	lum plai maad district in burrirum province
อำเภอศรีณรงค์	okrug si narong	si narong district
อำเภอศรีเมืองใหม่	okrug si mueang mai	sri meung mai district
อำเภอสระโบสถ์	sra church	sa bot district
อำเภอสหัสขันธ์	okrug sahatsakhan	sahuskhan district
อำเภอสองแคว	song khwae	song khwae district
อำเภอสังขะ	district sangkha	sang ka district
อำเภอสันป่าตอง	okrug san pa tong	sunpathong province in thailand
อำเภอสามพราน	okrug sam phran	sam pran area
อำเภอสารภี	okrug saraphi	sarape district
อำเภอสิชล	sichon district	sichon district
อำเภอสุไหงโกลก	okrug sungai kolok	amphoe su-ngai kolok
อำเภอหนองกี่	okrug nong ki	nong kee district
อำเภอห้วยราช	okrug huai rat	huai rat district
อำเภออมก๋อย	omkoi district	om koi district in chiang mai, thailand
อำเภอเกาะคา	okrug ko kha	amphoe ko kha
อำเภอเขวาสินรินทร์	okrug khwao sinarin	ampore khavasinrin
อำเภอเฉลิมพระเกียรติ	okrug chaloem phrakiat	amphur chalermprakiet
อำเภอเชียงของ	okrug čijang khong	chiang khong district
อำเภอเชียงคาน	okrug čijang kan	chiang khan district
อำเภอเชียรใหญ่	okrug chian yai	chien yai district in thailand
อำเภอเมืองกาฬสินธุ์	mueang kalasin	mueang kalasin provincial district
อำเภอเมืองนครราชสีมา	okrug mueang nakhon ratchasima	mueang nakhon ratchasima district
อำเภอเมืองนนทบุรี	okrug mueang nonthaburi	nontaburi district
อำเภอเมืองบุรีรัมย์	okrug mueang buri ram	burerum province
อำเภอเมืองพิจิตร	okrug mueang phichit	mueang phichit district
อำเภอเมืองพิษณุโลก	mueang phitsanulok	ampore maung pisanulok
อำเภอเมืองลพบุรี	okrug mueang lop buri	lopburi province
อำเภอเมืองสุรินทร์	okrug mueang surin	surin province
อำเภอเมืองอุตรดิตถ์	okrug mueang uttaradit	mueang uttaradit district
อำเภอเมืองเชียงใหม่	okrug mueang chiang mai	mung chiang mai district
อำเภอเมืองเพชรบุรี	okrug mueang phetchaburi	pechaburi province
อำเภอเวียงชัย	okrug wiang chai	wiang chai district
อำเภอเวียงแก่น	okrug wiang kaen	wiang kaen district
อำเภอเสริมงาม	okrug soem ngam	soem ngam district
อำเภอแจ้ห่ม	okrug chae hom	chae hom district
อำเภอแม่ทะ	okrug mae tha	mahta district
อำเภอแม่แจ่ม	okrug mae chaem	mae jam province
อำเภอแม่แตง	okrug mae taeng	mae taeng district
อำเภอโนนดินแดง	okrug non din daeng	din dang sub district
อำเภอโนนสุวรรณ	okrug non suwan	none su wan province
อิงค์	inc.	inc.
อิงลิช	engleski	english
อิทธิพล	uticaj	power
อิน	in	in
อินทิรา	indira	intira
อินฟราเรด	infracrveni	infared
อินฮิบิเตอร์	inhibitora	inhibitors
อินุยาฉะ	inuyasha	inuyacha - a japanese cartoon
อินเซคทิวอรา	inseqtura	insectivora
อินเดียน	indijanski	indian
อินเด็กซ์	indeks	index
อินโดนีเซีย	indonezija	indonesia
อิม	imm	im
อิมาจิน	imajin	imagine
อิมแพ็ค	uticaj	impact
อิรัก	irak	iraq
อิริโทรมัยซิน	elektroliza	erythromycin
อิสตันบูล	istanbul	istanbul
อิหร่าน	iran	iran
อิเควทอเรียลกินี	ekvatorijalna gvineja	equitorial
อิโนะ	ja ne	ino
อีก	više	more
อีกครั้ง	ponovo	again
อีกด้วย	također	also
อึ	sranje	poop
อึ๊งภากรณ์	ungphakorn	ungpakorn - a famous surname
อือ	da!	uu - a thai vowel
อื่น	drugi	other
อุ	o	ou
อุซึมากิ	uzumaki	uzumaki naruto
อุณหภูมิ	temperaturu	temperature
อุณหเคมี	termohemija	using energy and heat in chemical study
อุดม	plodna	udom
อุดรธานี	udon thani	udon thani
อุตตมะโยธิน	uppharat yothin	uttamayothin
อุตรดิตถ์	uttaradit	uttaradit
อุทยาน	park	park
อุทยานประวัติศาสตร์พนมรุ้ง	istorijski park phanom rung	phanom rung historical park
อุทยานประวัติศาสตร์พิมาย	istorijski park phimai	phimai historical park
อุทยานแห่งชาติคลองตรอน	nacionalni park khlong tron	khlong tron national park
อุทยานแห่งชาติดอยภูคา	nacionalni park doi phu kha	doi phu kha national park
อุทยานแห่งชาติดอยอินทนนท์	nacionalni park doi inthanon	national park doi inthanon in northern thailand
อุทยานแห่งชาติทุ่งแสลงหลวง	nacionalni park thung salaeng luang	thung salaeng luang national park
อุทยานแห่งชาติธารโบกขรณี	od nacionalnog parka bok khorani	tarabokorani national preserve area
อุทยานแห่งชาติน้ำตกสี่ขีด	nacionalni park vodopada si khit	namtoksekeed national park
อุทยานแห่งชาติน้ำพอง	nacionalni park nam phong	nam phong national park
อุทยานแห่งชาติภูผาเหล็ก	nacionalni park iron mountain	phupalek national park
อุทยานแห่งชาติภูพาน	nacionalni park phu phan	phu phan national park
อุทยานแห่งชาติภูสวนทราย	nacionalni park phu suan sai	pusuansai national preserve
อุทยานแห่งชาติภูสอยดาว	nacionalni park phu soi dao	soi dao mountain preserve
อุทยานแห่งชาติภูเรือ	nacionalni park phu ruea	national park pu reau
อุทยานแห่งชาติภูเวียง	nacionalni park phu wiang	phu wiang national park
อุทยานแห่งชาติภูแลนคา	nacionalni park phulanca	phu laenkha national park
อุทยานแห่งชาติหาดนพรัตน์ธาราหมู่เกาะพีพี	nacionalni park noppharat thara, ostrva phi phi	hat nopparatthara-mu ko phi phi national park
อุทยานแห่งชาติเขาหลวง	nacionalni park khao luang	khao luang national park
อุทยานแห่งชาติไทรทอง	nacionalni park sai thong	sai thong national preserve area
อุทุมพรพิสัย	uthumphon phisai	utompisai - an area in thai province
อุบล	ubon	ubol - a place in thailand
อุปกรณ์	opreme	instrument
อุปกรณ์คอมพิวเตอร์	računarski pribor	computer hardware
อุปนิสัย	karakter	manners
อุภัยราศี	oprosti zodijak	ambivert zodiac
อุรุกวัย	urugvaj	urookwai - a location
อุเทน	uthen	utain - a male's name
อู	ou	u (a vowel)
อู๋	wu	auu (first name)
อเมริกัน	američko	american
อเมริกา	amerika	america, usa
อเมริกาเหนือ	sjeverna amerika	north america
อเล็กซานเดอร์	aleksandra	alexander
อเล็กซ์	alex	alex
อโลหะ	nemetalni	nonmetal
อ่อนเพลีย	umorna	fatigue
อ่าน	čitati	read
อ่าวลึก	ao luek	ao luek
อ้างว่า	tvrdite to	claim
อ้างว้าง	pustoš	loneliness
ฮอกกี้	hokej	hockey
ฮอท	vruće	hot
ฮอฟมัน	hoffman	hoofman - a name
ฮอยเกนส์	hogens	huygens
ฮอร์โมน	hormona	hormone
ฮอลแลนด์	holland	holland
ฮอลโลว์	šuplje	hollow (as in dead soul)
ฮอว์ค	seahawks	hawk
ฮักบี้	zbogom	hugby - an album that received many awards
ฮันกึล	hangul	hangeul
ฮัมบูร์ก	hamburg	hamburg
ฮาจิ	hachi	haji
ฮาตาเกะ	hatake	hatake
ฮานอย	hanoi	hanoi
ฮายาโตะ	hayato	hayada - a japanese surname
ฮารุกะ	haruka	haruka - a japanese name
ฮาวาย	havaji	hawaii
ฮิซาชิ	hisashi	hitachi
ฮิซานะ	hisana	hisana
ฮิตเลอร์	hitler	hitler
ฮินาตะ	hinata	hinada - a japanese story
ฮิมาวาริ	himawari	himawari - a japanese surname
ฮิราโกะ	hirako	hirako (japanese name)
ฮิวงะ	hyuga	hewnga - a japanese name from a story
ฮิโซกะ	hisoka	hisoka
ฮิโรชิ	hiroshi	hiroshi
ฮีชอล	heechul	heechul
ฮุก	kuka	hook
ฮโยยอน	hyoyeon	hyoon - a dancer from japan
ฯพณฯ	njegova ekselencija	two thai alphabets.  abbreviation that means many things
เกตส์	kapije	gates
เกตุทัต	ketthat	kettut - a surname
เกมที่	igra	game number _________
เกมบุค	igra	game book
เกรย์	siva	gray
เกษตรกรรม	poljoprivreda	farming
เกษตรวิสัย	kaset wisai	kasetvisai (name of thai district)
เกษมศรี	kasemsri	kasemsri surname
เกอริง	gering	the name 'gerring'
เกอไทต์	goethe	goethite mineral
เกาหลีใต้	sjeverna koreja	south korea
เกาะ	ostrvo	island
เกาะคา	kauai	ko kha
เกาะลูซอน	ostrvo luzon	luzon island
เกาะสุมาตรา	sumatra	sumatra
เกิด	rođen	born
เกิดขึ้นหลังจากมหาวิทยาลัยศรีนครินทรวิโรฒวิทยาเขตต่างๆ	nastao nakon univerziteta srinakharinwirot	happened after srinakarinviroj university started
เกิดขึ้นเมื่อวันที่	pojavio se dana	birthdate
เกิดจากการรวมชิ้นส่วนที่	uzrokovano kombiniranjem dijelova koji	put together to form something
เกิดจากการรวมตัวของ	prouzrokovano ugradnjom	combination of
เกิดจากเชื้อไวรัส	uzrokuje ga virus	occur from the viral agent
เกิดนิมิตร	stvorite viziju	caused a vision/realization
เกียรติ	čast	honour
เกียรติประวัติ	čast	biography
เกียรติศักดิ์	slava	reputation.  kietisak can be a male's name
เกียวโตะ	kjoto	kyoto
เก็กโค	chegoe	gecko
เขตคลองสาน	okrug khlong san	klongsan district
เขตจอมทอง	okrug chom thong	jomthong area
เขตดุสิต	dusit	khet dusit
เขตที่	okrug	district number _______
เขตบางกอกใหญ่	okrug bangkok yai	bangkok yai district in thailand
เขตบางซื่อ	okrug bang sue	bang sue district
เขตบางแค	bang khae	bang khae district
เขตปทุมวัน	pathumwan	pathum wan district
เขตภาษีเจริญ	okrug phasi charoen	phasi charoen district
เขตมีนบุรี	okrug min buri	min buri district
เขตรักษาพันธุ์สัตว์ป่า	svetište za divlje životinje	national wildlife preserve
เขตรักษาพันธุ์สัตว์ป่าภูหลวง	utočište divljine phu luang	wildlife preserve
เขตลาดกระบัง	lat krabang	lad krabang district
เขตวังทองหลาง	okrug wang thonglang	wang thonglang district
เขตวัฒนา	wattana district	watana district
เขตสวนหลวง	okrug suan luang	suan luang district
เขตสาทร	sathon	sathorn area
เขตห้วยขวาง	huai khwang	huai khwang district
เขตเลือกตั้งที่	općina	election area number
เขมนิจ	imperiozno	khemanit
เขากล่าวว่า	on je rekao	he said
เขาทราย	khao sai	sand dunes
เขียนว่า	napiši to	wrote
เขียนโดย	napisao	written by
เขี้ยวพิษ	otrovni očnjaci	vemon fangs
เขื่อนกิ่วลม	kio wind dam	kio lom dam
เขื่อนป่าสักชลสิทธิ์	brana pasak chonlasit	parsakchonlasit dam
เขื่อนลำปาว	lampao brana	lum pao dam
เขื่อนแม่งัดสมบูรณ์ชล	majka mag ngad somboon chon	mae ngud som bul chol dam in chiangmai
เข็มศิลปวิทยา	needle arts	khem sinlapawitthaya
เข็มอัปสร	igla	kem uppasorn - a thai drama
เข่า	koljeno	knee
เข้าฉาย	pokaži	release date
เข้าชิงไนน์เอ็นเตอร์เทนอวอร์ดส	nominovan za nine entertainment awards.	compete in entertaining world
เข้ารอบ	finalista	made it to the next round, selected from the initial round
เข้าเฝ้า	neka publika	visit (word for the king)
เคน	ken	ken
เคนยา	kenija	kenya
เคมีไฟฟ้า	elektrohemija	electrochemistry
เคยสู้กับโกคุเทระ	koristi se za borbu sa gokuderom	fought with gokudera
เครือข่าย	mreža	network
เครื่องขัตติยราชอิสริยาภรณ์อันมีเกียรติคุณรุ่งเรืองยิ่งมหาจักรีบรมราชวงศ์	u spomen na veliku čast dinastije chakri	something used in a thai ceremony - too obscure
เครื่องดีด	strum	thai string musical instruments
เครื่องตี	beat mašina	musical intrument
เครื่องบิน	aviona	airplane
เครื่องปั้นดินเผาและเซรามิค	keramika i keramika	pottery and ceramic
เครื่องยนต์	motora	engine
เครื่องราชอิสริยาภรณ์	insignije	the king's accessories for ceremonies
เครื่องราชอิสริยาภรณ์อันเป็นที่เชิดชูยิ่งช้างเผือก	oznake koje slavi bijeli slon	order of the white elephant
เครื่องราชอิสริยาภรณ์อันเป็นสิริยิ่งรามกีรติ	oznake velike slave kiratija	king's accessories
เครื่องราชอิสริยาภรณ์อันเป็นโบราณมงคลนพรัตนราชวราภรณ์	drevna oznaka	the ancient and auspicious order of the nine gems
เครื่องสาย	gudački instrumenti	string instrument
เครื่องแต่งกาย	kostim	clothes
เคลลี่	kelly	kelly
เคอาร์วาย	kryy	k.r.y
เค้ก	kolač	cake
เงิน	novac	money
เงินทุน	finansiranje	fund
เงินในบัญชีธนาคาร	novac na bankovnom računu	balance
เงี้ยว	mučan	shan tribe in northern part of thailand
เจ	j	j.
เจนี่	janie	jenny
เจมินี่	blizanci	gemini
เจริญ	rasti	charoen
เจสเปอร์	jesper	jasper
เจียะแจ	jae jae	nine emperor gods festival
เจี๊ยบ	pile	jeab (thai name)
เจเน็ต	janet	janet
เจ็ดเทพโจรสลัด	shichibukai	seven warlords of the sea
เจ็บ	upaljeno	pain
เจ้าของจุกนม	vlasnik bradavice	the owner of the baby's bottle
เจ้าจอม	učiteljice	king's concubine
เจ้าฟ้ากรมพระยานริศรานุวัดติวงศ์	princ krom phraya narisaranu, hram tiwong	refer to a title of a royal family member - jao fa krom pra ya rissanuwattiwong
เจ้าฟ้ากรมพระยานริศรานุวัติวงศ์	princ krom phraya narisara nuwatwong	prince narisara nuvativongse
เจ้าฟ้าจิตรเจริญ	princ jitcharoen	prince chitcharoen
เจ้าฟ้าภาณุรังษีสว่างวงศ์	princ phanurangseesawangwong	prince panuragui bright chestnut.
เจ้าฟ้ามหาวชิราลงกรณ	princ maha vajiralongkorn	thailand's crown prince
เจ้าฟ้ามหาวชิรุณหิศ	princ mahawajirunhit	crown prince maha vajirunhis
เจ้าฟ้ามหิดลอดุลยเดช	princ mahidol adulyadej	prince mahidol adulyadej
เจ้าฟ้ามหิดลอดุลเดช	princ mahidol adulyadej	a member of thai royalties
เจ้าฟ้าหญิง	princezo	princes
เจ้าฟ้าอุบลรัตนราชกัญญา	princ ubonrattanarajakanya	princess ubon ratana graz's' contract.
เจ้าหนี้การค้า	dospjeli	trade account payable
เจ้าเมือง	guvernera	mayor
เจ้าเมืองขุขันธ์	guverner khukhan	a name of the head of the state
เจ้าโลก	hegemonija	world conqueror
เฉพาะด้านตะวันออกเฉียงใต้เท่านั้นที่เป็นที่ราบลุ่มแม่น้ำโขง	samo jugoistočna strana je sliv rijeke mekong.	only south-east area that is in mekhong plateau
เฉลิม	chalerm	chalerm - a male's name
เฉลิมชัย	chalermchai	chalermchai
เฉลิมชัยเจริญกิจ	chalermchai charoenkit	chalermchaichareonkij
เฉลิมพระเกียรติ	čast	chaloem phra kiat
เฉลิมพล	chalermpol	shalermpol - a surname
เฉลิมแสน	chalermsaen	chaloemsaen
เฉลียว	perceptivni	chaleuw - a male's name
เชส	chase	(jp morgan) chase
เชอร์รี่	trešnja	cherry
เชา	chow	chow -  a chinese name
เชาวน์	inteligencija	chow - a name
เชาวราษฎร์	chaowarat	chowarat - the surname of a famous actress
เชิญยิ้ม	smijte se	smile
เชิดชัย	osvojiti	"name ""churd-chai"""
เชียงกลาง	chiang klang	chiang klang
เชียงของ	chiangkhong	chiang khong
เชียงดาว	chiang dao	chiang dao
เชียงปุม	chiang pum	chiang poom - area in thailand
เชียงยืน	chiang yuen	chiang yuen
เชียงราย	chiang rai	chiang rai
เชียงใหม่	chiang mai	chiang mai
เชี่ยววงศ์กุล	chiewwongkun	chiaowongkul
เชื่อมต่อกับรถไฟฟ้ามหานคร	povezano s mrt-om	connect with skytrain
เชื่อมแม่น้ำท่าจีน	spojite rijeku tha chin.	confluence to the ta jean river
เชื้อชาติ	trka	helping the country
เชื้อรา	gljiva	fungus
เช็ค	ček	check
เช่นกัน	takođe	as well
เช่นเดียวกัน	isto tako	similar to
เช้ามืดวันที่	zore dana	in dawn of
เช้าวันรุ่งขึ้น	sljedećeg jutra	next morning
เซกิ	seki	seki
เซน	zen	saint
เซนทอร์	kentaur	centaur
เซบาสเตียน	sebastian	sebastian
เซฟ	spremi	save
เซลล์	ćelija	cell
เซสติโม	seto	settimo
เซอร์	gospodine	sir
เซอร์วิส	servisiranje	service
เซอร์เบีย	srbija	serbia
เซอวิวาสแตติน	cervivastin	cerivastatin - drug
เซโรกัชเชอร์	sero kutcher	sero gusher - a type of weapon
เซโรนอส	seronos	zeronos
เซโรไลเนอร์	seroliner	seroliner
เซ็กส์	seks	sex
เซ็นทรัล	centralni	central - department stores in thailand
เซ็นทารา	centara	centara
เซ็นเซอร์	senzor	sensor
เณร	neofit	samanera
เดคลิเนชัน	izjava	declination
เดชา	dacha	decha
เดธโน้ต	smrtovnica	death note - a mysterious japanese cartoon
เดนกัชเชอร์	denkucher	den gusher - a weapon in japanese movies
เดนโอ	den o	den-o
เดนโอเบลท์	denobelt	den-o belt
เดย์	dan	day
เดอะซิมส์	the sims	the sims
เดอะฮาเดส	hadi	the hades
เดอะฮาเดสแชปเตอร์	poglavlje hada	the hades chapter
เดิม	stari	at first
เดิมชื่อ	ranije	former name
เดิมที	prvobitno	at first
เดิมเรียกว่า	ranije poznat kao	formerly known as
เดียวกัน	isto	same
เดือดทะลุจุดศูนย์	vrela kroz nultu tačku	zero point breakthrough
เดือนกุมภาพันธ์	februar	february
เดือนตุลาคม	oktobar	october
เดือนตุลาคมมีฝนตกชุกที่สุด	oktobar je najkišniji.	highest amount of rainfall in october
เดือนธันวาคม	prosinca	december
เดือนมกราคม	januar	january
เดือนมิถุนายน	juna	june
เดือนอ้าย	lunarni mesec	first lunar month
เด็กหญิงอายุ	starica	the girl's age
เด็กและเยาวชน	djeca i mladi	children and youth
เต่า	kornjača	tao (first name)
เต๋อ	za	ter
เถรวาท	doktrina	buddha's teaching
เทคนิคอิลลูชั่น	iluzijska tehnika	technique illusion
เทควันโด้	taekwondo	tai kwon do
เทคโนโลยี	tehnologija	technology
เทคโนโลยีสารสนเทศ	informaciona tehnologija	san son tej techonology
เทนนิส	tenis	tennis
เทนโจอิน	tenjo-in	tenjoin - a character in a japanese story
เทพพิทักษ์	theppitak	theppitak
เทพมรณะ	smrt	bleach
เทพหัสดิน	bog nebeski	tephussadin (a surname)
เทพอานูบิส	anubis	anubis
เทพอาเตน	athen	aten
เทพีเธมิส	božice	themis
เทริโอ	therio	terio - surname of a singer
เทวดา	anđeo	angel
เทวรูป	idol	graven image
เทศบาล	opština	municipality
เทศบาลนครขอนแก่น	opština khon kaen	khon khan public works
เทศบาลนครนครราชสีมา	nakhon ratchasima	nakorn rachasrima province public work
เทศบาลนครนครศรีธรรมราช	nakhon si thammarat	nakorn sri thamarat city public works
เทศบาลนครเชียงราย	opština chiang rai	chiang rai province public works
เทศบาลนครเชียงใหม่	opština chiang mai	chiang mai municipality
เทศบาลเมืองชัยภูมิ	opština chaiyaphum	mueang chaiyaphum
เทศบาลเมืองบุรีรัมย์	buriram	bureerum public works
เทศบาลเมืองมหาสารคาม	općina maha sarakham	thesaban mueang maha sarakham
เทศบาลเมืองมุกดาหาร	općina mukdahan	mookdahan public works
เทศบาลเมืองสกลนคร	opština sakon nakhon	municipality of sakonnakon
เทศบาลเมืองหนองคาย	općina nong khai	nong khai municipality
เทศบาลเมืองหนองบัวลำภู	općina nong bua lamphu	nong bua lam phu town municipality
เทศวิศาล	ekspanzivan	tasavisakal - a surname
เทิดศักดิ์	čast	therdsak
เทียนทอง	zlatne svijeće	tientong - a male's name
เทียนเงิน	srebrna svijeća	tienngern
เทียนโพธิ์สุวรรณ	thian pho suwan	tianphosuwan (thai last name)
เทเบิลเทนนิส	stoni tenis	table tennis
เทโรศาสน	tero sasana	terosat football club
เท็ดดี้	teddy	teddy
เท็นเท็น	deset deset	tin-tin
เท่ง	teng	teng (first name)
เท่านั้น	samo	only
เธคุนุ	podrška	dhekunu
เธรซ	trakija	thrace - an area in greece
เธอกับฉัน	ti i ja	you and i
เธอจะอยู่กับฉันตลอดไป	ostaćeš sa mnom zauvek	you will be with me forever
เธอยัง	još uvijek	tur yung
เธอเป็นเพื่อนอาบาราอิ	ona je prijateljica abarai.	she is a friend of arbarae
เนกิ	negi	negi
เนย	puter	butter
เนรมิต	izumiti	casting a spell
เนะ	tačno	ney
เนื่องจาก	od tada	because
เนื่องจากประเทศเหล่านั้นอยู่ในตำแหน่งบนโลกที่ต่างไปจากประเทศไทย	jer se nalaze na položaju na zemlji koji je različit od tajlanda	because those countries are in the group of...
เนื้อที่	područje	area
เนื้อที่ประมาณ	približno područje	approximate area
เนื้อร้อง	lyrics	lyrics
เนื้อเรื่องย่อ	sažetak	summary
เนเธอร์แลนด์	holandija	netherlands
เนโกะ	neko	neko
เน็น	nen	nen
เบจิต้า	bechita	vegeta
เบธเลเฮม	betlehem	bethleham
เบนจามิน	benjamin	benjamin
เบรกมา	pauza	bregma
เบริธ	berith	berith
เบลเฟกอล	bellegal	belphegor- a demon in a legend
เบส	bass	bass
เบอร์ลิน	berlin	berlin
เบา	svjetlost	soft (voice)
เบาท์	baut	(dieric) bouts
เบาหวาน	dijabetes	diabetes
เบื่ออาหาร	dosadno	not appetite, eating disorder.
เบื้องหลัง	pozadina	behind the sence
เบโทเฟิน	beethoven	beethoven
เบ็นเท็น	ben 10	ben 10
เปรม	zadovoljan	pream
เปรี้ยว	kiselo	sour
เปรู	peru	peru
เปลวไฟ	plamen	flame
เปลี่ยนชื่อเป็น	preimenovana u	changed the name to
เปลื้อง	oduzeti	nude
เปล่งพานิช	plengpanich	plengpanich
เปอร์เซีย	perzija	persia
เปอร์โตริโก้	puerto rico	puerto rico
เปิดสอนระดับปริญญาตรี	otvoreno za dodiplomski studij	offer bachelor degree curriculum
เปียงยาง	pjongjang	piang yang - in north korea
เปียโตร	pietro	pietro
เปียโน	klavir	piano
เปโซ	peso	peso
เป็ด	patka	duck
เป็น	su	is
เป็นขนมของชาวไทยมุสลิม	desert je tajlandskih muslimana	is a thai-muslim dessert
เป็นครั้งแรก	prvi put	first
เป็นงานเขียนในชุด	da li je delo napisano u setu	in the edition of...
เป็นต่อ	protiv	pen to
เป็นต้น	itd.	for example
เป็นต้นมา	od tada	onward
เป็นต้นไม้ประจำมหาวิทยาลัย	je li drvo univerziteta	tree of university
เป็นบัวในสกุล	je lotos u rodu	is a lotus in the family
เป็นประธาน	postanite predsjednikom	principal of
เป็นปลาตู้สวยงาม	lijepa je akvarijska riba	is an ornamental fish
เป็นพระราชโอรสพระองค์เดียวในพระบาทสมเด็จพระปรมินทรมหาภูมิพลอดุลยเดช	jedini je sin kralja bumumibola adulyadeja	is the only son of
เป็นพ่อของ	je li otac	is the father of
เป็นวิญญาณเทียมเพศชาย	muški je umjetni duh	the spirit who is a male
เป็นสีประจำ	regularna boja	official color
เป็นหนึ่งใน	jedna od	is one of
เป็นหัวหน้าพรรค	vođa stranke	party leader
เป็นอดีตหัวหน้าหน่วยที่	je bivši vođa jedinice	is the former leader of the unit
เป็นอาวุธ	kao oružje	as a weapon
เป็นเครื่องหมายแสดงว่า	to je znak	indicates that
เป็นเจ้าเมืองปกครอง	guvernera	governor
เป็นเมืองหลวง	je glavni grad	capital
เป็นเวลา	za	utilized time
เป็นโฮโมโลกัสกับ	da li je homolog sa	homologous
เป๊ปซี่	pepsi	pepsi
เพกาซัส	pegasus	pegasus
เพชร	dijamant	diamond
เพชรบุรี	phetchaburi	petchaburi province
เพชรบูรณ์	phetchabun	prechabun
เพชรพระอุมา	diamond phra uma	ancient diamond
เพชรา	stari covjek	petchara - name of a famous actress
เพชรเกษม	petchkasem	petchakasem area in bangkok
เพดานอ่อน	mekani strop	gill
เพทาย	cirkon	zircon
เพพซิน	pepsin	pepsin
เพราะ	jer	because
เพราะว่า	jer	because
เพรียะ	piriya	preah - cambodia
เพลงประกอบภาพยนตร์	filmska glazba	soundtrack
เพลงประจำจังหวัด	pokrajinska pesma	province anthem
เพลงประจำมหาวิทยาลัย	univerzitetske pjesme	university song
เพลงปิดเรื่อง	cover song	pid reung song
เพลงพระราชนิพนธ์	royal music	the king's song
เพลงลูกทุ่ง	country muzika	folk song
เพลงลูกทุ่งขับร้อง	country muzika	luk thung song
เพลงอีแซว	muzika zadirkivanje	a type of thai country music
เพลงเปิด	otvaranje pesme	opening song
เพลงเปิดเรื่อง	otvaranje pesme	opening song
เพลย์สเตชัน	play station	playstation
เพลโต	platon	plato
เพศ	seks	sex
เพศชาย	muško	male
เพิ่มมา	još	addition
เพียงพอ	dosta	enough
เพื่อ	za	for
เพื่อเป็นการเผยแผ่พระพุทธศาสนาและประชาสัมพันธ์กิจกรรมทางพระพุทธศาสนาต่าง	s ciljem propagiranja budizma i promocije vjerskih aktivnosti	passing knowledge about buddhism
เพื่อใช้ร่วมกับตัวชี้วัดอื่น	da se koristi s drugim pokazateljima	to be used with other indicators
เพ็ชรทาย	phettha	petchtai
เฟนิรามีน	feniramin	pheniramine
เฟย์	fay	fay
เฟรดริก	frederick	fredrick
เฟส	faza	phase
เฟอร์นิเจอร์	namještaj	furniture
เฟื่องอารมย์	foudarom	fueangarom
เภสัชกร	farmaceut	pharmacist
เภสัชจลนศาสตร์	farmakokinetika	pharmacokinetics
เม	maja	may
เมกา	mega	mega
เมฆ	oblak	clouds
เมฆออร์ต	oort oblak	ash cloud in the space
เมจิ	meiji	maji - a nickname
เมตร	m.	metre
เมทริกซ์	matrica	matrix
เมทะนี	metani	metanee - the surname of a famous actor
เมอร์คิวรี	merkur	mercury
เมือง	grad	town
เมืองทองฯ	muang thong	muangthong
เมืองนครราชสีมา	nakhon ratchasima	nakornrachasrima city
เมืองปทุมธานี	pathum thani	mueang pathum thani
เมืองปราจีนบุรี	prachinburi	prajinburi city
เมืองพิจิตร	phichit	pijit city
เมืองพิษณุโลก	phitsanulok	phitsanulok
เมืองยอง	stag grad	mueng-yor
เมืองลำพูน	lamphun	lumpoon province
เมืองสกลนคร	sakon nakhon	sakon nakhon
เมืองสิงห์	singha	muangsing
เมืองสุรินทร์	surin	surin city
เมืองหลวง	kapital	capital city
เมืองหลวงของอาณาจักรเขมร	glavni grad carstva	capital of cambudia
เมืองเคมบริดจ์	cambridge city	city of cambridge
เมืองเอก	ake city	mueang-ake
เมืองโคราช	korat	muang korat
เมืองใหญ่	veliki grad	city
เมืองใหญ่ในเขตนี้	veliki gradovi u ovom okrugu	capital presently
เมื่อประมาณ	kada	estimate
เมื่อปีพศ	prošle godine	in buddhist era
เมื่อปีพุทธศักราช	u godini budističke ere	in b.e.
เมื่อวันจันทร์	u ponedeljak	on monday
เมื่อเดือนกันยายน	prošlog septembra	in september
เมื่อเดือนมีนาคม	u martu	in march
เม็ดขนุน	jackfruit	metkhanun
เม่น	divokoza	porcupine
เย	da	yay - a sound
เยลโล่	žuto	yellow
เยอรมนี	nemačke	germany
เยอรมัน	njemački	german
เยาวชน	omladina	youth
เยาวชนอายุ	omladinsko doba	youth age of ...
เยาวราช	kineska četvrt	yaowaraj
เยื่อหุ้มสมอง	cortex	meninges
เรซูเม	nastavi	resume
เรด	crveno	red
เรดวัน	crveni dan	redone
เรย์	zraka	ray
เรวดี	dobre vijesti	rawadee
เราเตอร์	ruter	router
เริ่มการผลิตนำเข้า	pokrenite uvoznu proizvodnju	importing
เริ่มก่อสร้าง	započnite izgradnju	began constuction
เริ่มจากเดือนพฤศจิกายนเมษายน	počevši od novembra do aprila	begins from november to april
เริ่มตั้งแต่อาณาจักรอยุธยาได้โจมตีอาณาจักรเขมร	počevši od ayutthaya kraljevstva koje napada kmero kraljevstvo.	ever since the ayudhya (military) assault...
เรียกกันว่า	nazvani	called
เรียกว่า	nazvani	call
เรียล	pravi	real
เรียว	vitko	ryo
เรียวทาโร่	ryotaro	totoro - a japanese cartoon
เรียวเฮ	rye hye	reohay - a japanese character
เรียะชอาณาจักร	kraljevstvo	reacheanachak
เรืองรุ่ง	užaren	rueangrung
เรืองศรี	rueangsri	rueng sri - a surname
เรือตรี	brod	ensign
เรือนนาค	naga house	nak castle
เรือยกพลขึ้นบก	sleti brod	boat for advance the army
เรือสำรวจ	anketni brod	survey vessel
เรือเร็วโจมตี	napad brzim brodom	fast attack craft
เรือใบ	jedrilica	sailboat
เรื่อง	predmet	story
เรื่องย่อ	sažetak	synopsis
เรื่องสั้น	pripovijetka	short story
เร้กเก้	reggae	reggae
เลข	broj	mathematics
เลขที่	broj	number
เลขาธิการสหประชาชาติ	generalnog sekretara ujedinjenih naroda	united nations secretary-general
เลนส์	sočiva	lens
เลออน	leon	lyon
เลิฟ	ljubav	love
เลือดออกตามไรฟัน	škrlet	bleeding of the gum
เลโอ	lav	alo
เลโอนาร์โด	leonardo	leonardo
เล็ก	mala	small
เล่ม	knjiga	book
เล่มที่	broj knjige	volume
เวทีทอง	zlatna pozornica	golden podium
เวล	vail	vail
เวลาประมาณ	predviđeno vrijeme	approximate time
เวสต์	zapad	west
เวอร์ชัน	verzija	version
เวอร์โก้	vergo	virgo
เวิร์คพอยท์	radna tačka	workpoint company
เวิร์คพอยท์สตูดิโอ	workpoint studio	workpoint studio
เวิร์ม	crvi	worm
เวิลด์	svijet	world
เวียงสระ	wiang sa	wiang sa
เวียงสา	wiang sa	wiang sa
เวียนเทียนรอบอุโบสถหรือสถูปเจดีย์พุทธสถานต่าง	kruženje oko kapele ili pagode	a thai religious ceremony
เวโรนา	verona	verona in italy
เว็บ	web	web
เว็บสเตอร์	webster	webster
เว็บเบราว์เซอร์	web preglednik	web browser
เว็บไซต์ของเกมส์	web stranica za igre	gaming website
เว็บไซต์ซีไอเอ	internet stranica cia	cia website
เว้นวรรค	prostor	space
เศรษฐกิจพอเพียง	ekonomija dovoljnosti	sufficiency economy
เศรษฐบุตร	sethaputra	settabut - the family that started bus system in thailand
เศรษฐศาสตร์จุลภาค	mikroekonomija	microeconomics
เศรษฐศาสตร์มหภาค	makroekonomija	macroeconomics
เสงี่ยม	način	sa-ngiam
เสชนะ	pobedi	sechana
เสด็จพระราชสมภพ	kraljevsko rođenje	royal birth
เสนอชื่อเข้าชิงและรับรางวัล	nominovati i dobiti nagradu.	nominate and win
เสนา	sena	sena
เสนาเมือง	sena city	senamuang
เสนีวงศ์	seni wong	seniwong
เสน่ห์	šarm	sanea
เสมอ	uvek	always
เสรี	besplatno	seri
เสรีภาพ	sloboda	freedom
เสียง	zvuk	sound
เสียงเปิด	otvoreni zvuk	approximant, semi-vowel
เสียงเสียดแทรก	friktivni zvuk	noise
เสือจากัวร์	jaguar	jaquar
เสื้อครุย	robe	gown
เส้นทแยงมุม	dijagonalno	diagonal
เส้นพุ่ง	linija	yarn that is used for weaving
เส้นโค้ง	krivulja	curve
เส้นใย	vlakna	polymer, yarn
เหงื่อ	znoja	sweat
เหตุการณ์	događaj	situation
เหตุการณ์สำคัญ	važan događaj	important event
เหรียญ	medalja	coin
เหรียญกษาปณ์	menta	coin
เหรียญทอง	zlatna medalja	gold medal
เหรียญรัตนาภรณ์	rattanaporn coin	a special thai medallion
เหลือง	žuto	yellow
เหลือสมาชิก	preostali članovi	members left
เหล็ก	čelika	iron
เหล่านี้	ovi	these
เหล่าสุนทร	laosonthorn	soontorn group
เห็นภาพลวงตา	vidi iluziju	seeing hallucination
เอก	prvo	the first tonal marker of thai writing system represented by  '
เอกชน	privatni	private
เอกซ์	x	x
เอกราช	nezavisnost	sovereignty
เอกวาดอร์	ekvador	edwardor
เอกสิทธิ์	privilegija	privilege
เอจิเซ็น	echizen	echizen
เอชไอวี	hiv	hiv, human immunodevficiency virus
เอซ	asovi	letter h
เอตาสีติ	atacati	sesasiti
เอนจิเนียริ่ง	inženjering	engineering
เอนไซม์	enzim	enzyme
เอบีซี	abc	abc
เอม	cilj	aim - could be a nickname
เอริค	eric	eric
เอล	el	el
เอสปาด้า	espada	eapada
เอสปาด้าตกชั้น	espada je ispao	aspata
เอสเอ็ม	sm	sm entertainment from korea
เอสโตเนีย	estonija	astonia - a country
เออร์โกสเฟียร์	ergosfera	ergosphere
เอี่ยมยิ่ง	ja sam	super, awesome
เอี่ยมสุข	ja sam sretan	iamsuk
เอื้อย	uri	eay - a thai nickname
เอเชีย	aziji	asia
เอเชียตะวันตกเฉียงใต้	jugozapadna azija	southwest asia
เอเชียเหนือ	sjeverna azija	north asia
เอเชียแปซิฟิก	azija pacifična	asia-pacific
เอเชียใต้	južna azija	south asia
เอเธนส์	atina	athens
เอเอฟซี	afc	afc
เอเอฟซีแชมเปียนส์ลีก	afc liga prvaka	afc championship
เอ็กซ์โป	expo	expo
เอ็กโทเดิร์ม	ecterm	ectoderm, top level of skin layer.
เอ็กโปรพลาซ่า	expo plaza	expo plaza in thailand
เอ็ดดูเทนเมนท์	obrazovanje	edutainment
เอ็ดเวิร์ด	edward	edward
เอ็น	ligament	n
เอ็นบีเอ	nba	nba - national basketball association
เอ็นเตอร์เทนเม้นท์	zabava	entertainment
เอ็นเทอร์เทนเมนท์	zabava	entertainemnt
เอ็มม่า	emma	emma
เอ๋	eh	ah - a nick name
เฮติ	haiti	haiti
เฮลมุต	helmut	helmut
เฮสเตีย	hestia	hestia
เฮอร์เชล	herschel	herschel
เฮาส์	kuća	house
เฮียวงะ	hyuga	heonga
แกง	curry	soup
แกมเบีย	gambija	cambia
แกรนซ์	grant	grantz
แกรมมี่	grammy	grammy
แกริซั่น	garrison	garrison - an english name
แกลง	klaeng	glang
แกลเลอรี	galerija	gallery
แกสโทรโพดา	gastropoda	"name ""gastropoda"""
แกะ	ovce	sheep
แกแล็คซี่	galaksija	galaxy
แก่	do	aging
แก้ว	stakla	glass
แก้วทอง	zlatno staklo	golden cup
แก้วบัวสาย	staklo lotosa	kaeobuasai
แก๊สธรรมชาติ	prirodni gas	natural gas
แขก	gost	indian
แขน	ruka	arm
แขวงจำปาสัก	champasak province	champasak province
แขวงหลวงพระบาง	podraga luang prabang	luang pra bang province
แคดเมียม	kadmijum	cadnium
แคทแพท	mačka pat	kat - pat kamikaze - the thai famous stars
แคน	caen	kan - a type of thai music
แคนดี้	candy	candy
แคนเซอร์	može	cancer
แคม	web kamere	cam
แคมป์เบลล์	campbell	campbell
แคมเปญ	kampanja	campagne
แคมเล็ก	mala kamera	vagina fold
แคมใหญ่	velika kamera	labia
แคร็กเกอร์	oraščić	crackers
แคลคูลัสเชิงปริพันธ์	integralno računanje	integral calculas
แคลคูลัสเชิงอนุพันธ์	diferencijalno računanje	differential calculus
แคลอรี	kalorije	calorie
แคลิฟอร์เนีย	kaliforniji	california
แคลิฟอร์เนียม	kaliforniji	californium
แคว้น	region	kwon - a korean surname
แจ	jam	live purely and clean both in body and mind - from chinese belief
แจ็กสัน	jackson	jackson
แจ็ค	jack	jack
แจ๊ค	jack	jack
แจ๊ส	jazz	jazz
แด	dae	dae
แดงทั้งแผ่นดิน	čitava zemlja crvena	red (political party all over the country
แดนสุพรรณ	suphan	dansuphan
แดเนียล	danijele	daniel
แตน	hornet	grass hopper
แต่งงาน	vjenčati	wedding, marriage
แต่งตั้ง	imenovati	giving a new title to
แต่งโดย	sastavio	composed by
แต่ใน	ali u	but in
แต่ในปัจจุบัน	ali sada	in the present
แต่ไม่ประสบความสำเร็จ	ali bez uspjeha	failed
แต่ไม่สำเร็จ	ali bezuspešno	no success
แถบ	bar	flat fish
แทซิทัส	tasitus	tacitus
แทน	zastupati	instead
แทนเจนต์	tangenta	tangent
แทยอน	taeyeon	tae yon
แทลเลียม	talijuma	thallium
แท็กซี่	taksi	taxi
แท็บเล็ต	tablet	tablet computer
แนท	nat	nat
แนวความคิดที่	koncept	idea number...
แนวพระราชดำริ	kraljevska inicijativa	royal initiative
แนสแด็ก	nasdaq	nasdaq
แบคทีเรีย	bakterija	bacteria
แบงค์	banka	bank
แบทเทิลบรอลเลอร์	battle tanker	battle brawlers
แบรนด์แอมบาสเดอร์	brend ambasador	brand ambassador
แบ่งประเทศไทยออกเป็น	podijelite tajland na	dividing thailand into 6 areas
แบ่งออกเป็น	podijeljen u	divided into...
แบ่งออกได้เป็น	podijeljen u	divided into
แบ่งได้เป็น	podijeljen u	divided into
แป้ง	brašno	pang
แผนที่	karta	map
แผนไพรีพินาศ	plan konzorcijuma	pan pirepinat - a plan to destroy the mobs
แผลศักดิ์สิทธิ์	sveta rana	stigmata
แผลไหม้	opekline	burn
แพทย์	ljekar	physician
แพน	pan	pan
แพร่	širenje	the state of praa
แพลทฟอร์ม	platforma	platform
แพะ	jarac	goat
แพ้	izgubiti	to lose
แฟชั่น	moda	fashion
แฟนเก่า	bivša devojka	ex boyfriend/girlfriend
แฟมิลีที่ไปพักผ่อนที่เกาะมาเฟีย	porodica se odmara na mafijaškom ostrvu	family that went to mafia island for vacation
แฟรงค์	frank	frank
แฟรี่	bajka	fairy
แฟรี่เทล	bajka	fairy tale
แมกนีเซียม	magnezijum	magnesium
แมคอินทอช	macintosh	mcintosh
แมนดาริน	mandarina	mandarin
แมนเชสเตอร์	manchester	manchester
แมว	mačka	cat
แมวป่า	wildcat	jungle cat
แมวลายหินอ่อน	mramorni tabby	pardofelis marmorata
แมวไทย	tajlandska mačka	thai cat
แม็คโคร	makro	macro
แม่	majke	mother
แม่จริม	majka jim	mae charim
แม่ชี	monahinje	nun
แม่นาคพระโขนง	mae nak phra khanong	mae nak phra khanong
แม่น้ำ	rijeka	river
แม่น้ำชี	chi river	chee river
แม่น้ำทะเลสาบสำคัญ	važna rijeka jezera	important rivers and lakes
แม่น้ำปิง	ping river	ping rover
แม่น้ำโขง	rijeka mekong	kong river from laos
แม่ริม	mae rim	amphoe mae rim
แยกจากคลองชักพระฝั่งซ้าย	odvojite od kanala chak phra s lijeve strane	forks from khlong chak phra
แยกจากคลองบางกอกน้อยฝั่งซ้าย	sa kanala bangkok noi s lijeve strane	forks from the left branch of khlong bangkok noi
แยกจากคลองบางกอกใหญ่ฝั่งขวา	čvor s kanalom bangkok yai s desne strane	split from the bankok yai canal to the right
แยกจากคลองบางกอกใหญ่ฝั่งซ้าย	spoj s bangkok yai kanala s lijeve strane	forked from khlong bangkok yai
แย้มนาม	ime	yamnam - a surname
แย้มบุญเรือง	odluči se za zasluge	yaembunrueang
แรงโน้มถ่วง	gravitacija	gravity
แร็ปเปอร์	reper	rapper
แลกเปลี่ยนโดยถือ	razmjena držanjem	exchange, conversion
แลมบ์ดา	lambda	lampda
และ	i	and
และกลายเป็นอู่ข้าวอู่น้ำที่มีชื่อเสียงของไทย	i postao poznati čuveni kruh na tajlandu	and becoming the futile land
และกัมพูชา	i kambodža	and cambodia
และครอบครัว	i porodica	and family
และคำว่า	i riječ	"and the word ""......."""
และจังหวัดใกล้เคียง	i obližnje provincije	and nearby state
และดุษฎีบัณฑิต	i doktor filozofije	honorary degree
และตามสภาพเศรษฐกิจและสังคม	i prema ekonomskim i socijalnim uslovima	and following the economy and social conditions
และตำแหน่ง	i položaj	and position
และที่สำคัญคือ	a važno je	and important thing is...
และธงของต่างประเทศ	i strane zastave	and other countries' flags
และปัจจุบัน	i sadašnjost	now
และพรรคฟุนซินเปค	i funchinpec zabava	funcinpec
และรถไฟ	i trenirati	and railways
และรัสเซีย	i rusija	and russia
และสหรัฐอเมริกา	i sjedinjene države	in america
และสังคม	i društvo	and society
และสังคมศาสตร์	i društvene nauke	and social science
และสัตว์	i životinje	and animal
และสโรชา	i sarocha	and sarocha - a male's name
และหลังจากสงครามภายใน	i nakon unutrašnjeg rata	after inside war
และออกซิเจน	i kiseonik	and oxygen
และอำเภอกันทรารมย์	i kvart kanthararom	and kanthararom district
และอื่น	i drugi	etc.
และอเมริกาเหนือ	i sjeverne amerike	and north america
และเปียโน	i klavir	and piano
และเป็น	i je	is also
และเป็นสมาชิกราชวงศ์	i član je kraljevske porodice	in monarchs family
และเมืองเก่า	i stari grad	old city
และเมื่อวันที่	i dalje	when date
และเรียกว่า	i zvao	and call
และโลก	i svijet	and earth
และในปี	i u godini	and in the year
และได้ปรากฏตัวตอนภาค	i pojavila se u epizodi	appeared
แล้วเดินเวียนรอบปูชนียสถาน	zatim je obišao svetište	walk with lighted candles in hand around a temple
แวน	van	wan
แสงจันทร์	mesečina	saengchan
แสงชูโต	chuto	sangchuto - a surname
แสงทอง	sangthong	golden sun ray
แสงสิงแก้ว	sang singkaew	sangsingkaew
แสงเทียน	svijeća za svijeće	saengthian
แสตมป์	pečat	stamp
แสนรัก	ljubav	saenrak
แสนโภศิก	saen phosik	sankosuk - a surname
แหลมสิงห์	laem sing	lam sing - a famous country singer in thailand
แหล่งท่องเที่ยว	turistička atrakcija	tourist attraction
แหล่งโบราณคดีบ้านเชียง	arheološko nalazište ban chiang	ban chiang archaeological site
แหวน	prsten	ring
แหวนธรรมดา	običan prsten	ordinary ring
แหวนมาเล่ริง	prsten mužjaka	ring (faux jewelry)
แห่งบันนัม	ban nam	of bannam
แห่งสหประชาชาติ	ujedinjeni narodi	of united nations
แองกวิลลา	angvila	anguilla
แองเจิ้ล	anđeo	angel
แอซิด	kiselina	acid
แอด	dodati	add
แอนดรอยด์	android	android
แอนดี้	andy	andy
แอนด์	i	and
แอนิเมชัน	animacija	animation
แอนเนลิดา	annelida	annelida phylum
แอนโทนี	anthony	anthony
แอฟริกา	afrika	africa
แอฟริกาใต้	južna afrika	south africa
แอมะซอน	amazon	amazon
แอมเวย์	amway	amway
แอร์ไลน์	airlines	airlines
แอล	l	letter 'l'
แอลจีเรีย	alžir	algeria
แอสกี	asci	ascii
แอสซิสต์	assist	assist
แอสปาร์แตม	aspartam	aspartame
แฮช	hash	hash
แฮปปี้	sretno	happy
แฮปปี้และชาร์ล	sretan i charles	happy and charles
แฮ็ค	hakiranje	hack
โกบอล	globalno	cobalt
โกร	rasti	guro
โกรกพระ	crevica	krok-phra
โกลด์	zlato	gold
โกวิท	kowit	kowit
โกโก้	kakao	cocoa
โขน	pantomima	khon
โคกสำโรง	khok samrong	koksamrong
โคนัน	conan	conan
โคฟี	kofi	kofe annan
โครงการ	projekat	project
โครงการก่อสร้าง	građevinski projekat	project
โครงการนานาชาติ	međunarodni projekat	international program
โครงการศิลปินแห่งชาติ	projekt nacionalnog umjetnika	national artist campaign
โครงการเรียนภาษาอังกฤษแบบเข้ม	intenzivni program učenja engleskog jezika	intensive english program
โครงสร้างภายใน	unutrašnja struktura	internal structure
โคราช	korat	khorat or nakorn rajjasrima state
โครโมโซม	hromosom	chromosome
โคล	cole	cold
โคลอมเบีย	kolumbija	colombia
โคล้ด	šifra	claude
โคเคน	kokain	cocain
โคเบะ	kobe	kobe
โคแทนเจนต์	kotangens	cotangent
โคโทเน่ที่	kotone at	kotone
โฆษะ	vokalizacija	kosa
โฆษิตพิพัฒน์	kosit phiphat	the surname kopitpipat
โจจิ	joji	choji
โจเซฟ	joseph	joseph
โจโจ้	jojo	jojo
โช	cho	sho
โชคดี	sretno	lucky
โชว์	pokaži	show
โชอิจิ	shoichi	shoichi
โชแปง	chopin	chopin
โซน	zonu	zone
โซนยอชิแด	generacija djevojaka	senyosede - a japanese name
โซนี่	sony	sony company
โซล	seul	seoul
โซลดิ๊ก	soldick	sol-dig
โซลโซไซตี้	društvo duša	soul society
โซเดียม	natrijuma	sodium
โซเฟีย	sofija	sofia
โดจินชิ	do jinchi	dōjinshi
โดย	od	by
โดยคำว่า	riječi	by the word
โดยตรง	direktno	directly
โดยทรงพระกรุณาโปรดเกล้าฯ	milostivo mu je dodeljeno	the king's order
โดยที่	gde	by
โดยบ่งบอกถึงปริมาณและคุณภาพของสิ่งตีพิมพ์อิเล็กทรอนิกส์ของสถาบัน	navođenjem količine i kvalitete elektronskih publikacija zavoda	stating the limitation and quality of a product
โดยปกติ	normalno	regular, common, normalcy
โดยปกติตามวัดต่าง	obično prema različitim hramovima	normally, at the various temples...
โดยปกติแล้ว	normalno	usually
โดยมี	sa	make available
โดยมีตัวอย่างบทพากย์ฉบัง	sa primjerima pjesama	background movie in music video
โดยมีพระภิกษุสงฆ์นำเวียนเทียน	s monahom koji predvodi povorku uz paljenje svijeća	buddhist monks performing ceremony for vientien buddhist religious holiday
โดยราชบัณฑิตยสถาน	kraljevskim institutom	by royal institute
โดยสรุป	ukratko	in summary.
โดยเจ้าฟ้าธรรมธิเบศรไชยเชษฐสุริยวงศ์	princ thamathibet sornchai chetchuriyawong	the name of a king
โดยใช้ชื่อว่า	po imenu	using name
โดยใช้ทางหลวงแผ่นดินหมายเลข	nacionalnim autoputem	using freeway #________
โดยในวันที่	do	on the date of ___
โดราเอมอนฉบับภาพยนตร์	doraemon movie edition	doraemon movie
โดเมกิ	domome	domagi - a japanese word.
โดเมน	domen	domain
โต	odrasti	big
โตชิบา	toshiba	toshiba
โทน	tone	tone
โทนะหงษา	tonahahasa	tonahongsa - a surname
โทนี่	tony	tony
โทบรามัยซิน	tobramamcin	tobramycin
โทมัส	thomas	thomas
โทรจัน	trojan	trojan
โทรลล์	troll	troll
โทริคาบูโตะ	torikabuto	torikabuto - a japanese word
โทรโข่ง	megafon	a megaphone, portable sound directing equipment.
โน	ne	no
โนบิตะ	nobita	nobita
โนบิตะและอัศวินแดนวิหค	nobita i vitez	nobita and the winged braves
โนรา	nora	nora
โนะ	dino	noh - a japanese word
โนเบล	nobel	nobel prize
โบตั๋นกลีบสุดท้าย	poslednji božur	botun kleep suttai - a novel
โบราณสถาน	arheološko nalazište	the ancient place
โบอิง	boeing	boeing company
โบฮีเมีย	bohemija	bohemia
โบแดง	divan	bodin
โปงลางสะออน	ponglang sa-on	pong langsaoun
โปรดเกล้า	molim te	the king's order
โปรตอน	protoni	proton
โปรตีน	protein	protein
โปรเจกต์	projekat	project
โปรเจกต์พิเศษ	specijalni projekat	special project
โปรแกรมคอมพิวเตอร์	kompjuterski program	computer programming
โปรโมชั่น	promocija	promotion
โปเกมอน	pokemon	pokemon, a very popular japanese anime.
โป๊	gola	nude
โพธิ์ศรี	phosri	phosi
โพนพิสัย	phon phisai	phonphisai
โพรทิสต์	protist	protist
โพแทสเซียม	kalijuma	potassium
โฟลต	float	float
โฟลเอ็ม	flo m	phloem
โฟโตสเฟียร์	fotosfere	photosphere
โมซาร์ท	mozart	mozart
โมบิลสูทกันดั้ม	mobilno odijelo gundam	mobile suit gundam
โมรา	kalcedon	agate
โมร็อกโก	marokanski	morocco
โมลิบดีนัม	molibden	molybdenum
โมฮัมหมัด	mohammad	mohamad
โมเดิร์น	moderna	modern
โมเต็ต	motate	motet (sound)
โมเลกุล	molekule	molecule
โมโคนะ	mokona	mokona - a japanese word
โมโนไซต์	mono stranica	mono site.
โยชิโนะ	yoshino	yoshino
โยฮันน์	johann	johann
โยเซฟ	joseph	joseph
โรค	bolest	disease
โรคประจำตัว	urođena bolest	personal illness
โรคปอดบวม	upala pluća	pneumonia
โรคออทิซึม	autizam	autism
โรคุโด	rokudo	rokudo
โรคเกาต์	gihta	gout
โรคไต	bolest bubrega	kidney disease
โรงพยาบาลกรุงเทพ	bolnica bangkok	krung thep hospital
โรงพยาบาลจุฬาลงกรณ์	memorijalna bolnica kralja chulalongkorna	king chulalongkorn memorial hospital
โรงพยาบาลรามาธิบดี	bolnica ramathibodi	ramathibodi hospital
โรงพยาบาลอานันทมหิดล	bolnica anandamahidol	ananthamahidol hospital
โรงพยาบาลอุตรดิตถ์	bolnica uttaradit	uttaradit hospital
โรงละคร	pozorište	theater
โรงเรียนการบิน	letna škola	aviation school
โรงเรียนดาราวิทยาลัย	dara college	dara academy
โรงเรียนนนทรีวิทยา	škola nonsi witthaya	nontrivittaya school
โรงเรียนนายเรือ	mornarička akademija	royal thai naval academy
โรงเรียนนายเรืออากาศ	kraljevska akademija ratnih tajlandskih snaga	royal thai air force academy
โรงเรียนบดินทรเดชา	bodindecha school	bodindecha school
โรงเรียนประชานิเวศน์	prachaniwet school	prachanivet school
โรงเรียนปรินส์รอยแยลส์วิทยาลัย	prince royal&#39;s college	the prince royal's college
โรงเรียนพระตำหนักสวนกุหลาบ	škola suan kularb tamnak	the school in the king's compound.  it is reserved for the princess and the royal family
โรงเรียนมัธยมสาธิตวัดพระศรีมหาธาตุ	demonstracija wat phra si mahathata u srednjoj školi	wat phrasri mahadhat secondary demonstration school
โรงเรียนมารีวิทย์	mary wit school	maryvit school
โรงเรียนยุพราชวิทยาลัย	yupparat wittayalai škola	yupparaj wittayalai school
โรงเรียนราชินีบน	gornja kraljična škola	rachinibon school in thailand
โรงเรียนวัฒโนทัยพายัพ	watthanothai payap škola	vattanotaipayup school
โรงเรียนศึกษานารี	naree school of education	suksanari school
โรงเรียนสาธิต	demonstraciona škola	demonstration school
โรงเรียนสาธิตแห่งมหาวิทยาลัยเกษตรศาสตร์	demonstraciona škola univerziteta kasetsart	kasetsart university laboratory school
โรงเรียนห้องสอนศึกษา	školska učionica	class room in school
โรงเรียนเขมะสิริอนุสสรณ์	khemasiri anusorn škola	kamasirianussorn school
โรงเรียนเจ้าพระยาวิทยาคม	škola chao phraya witthayakhom	chao praya vitanakom school
โรงเรียนเฉลิมพระเกียรติสมเด็จพระศรีนครินทร์	chaloem phrakiat somdet phra srinagarindra škola	srinagarindra the princress mother school
โรงเรียนเทศบาล	javna škola	public schools
โรงเรียนไตรมิตรวิทยาลัย	traimit wittayalai škola	trimittavitayalai school
โรงแรม	hotel	hotel
โรจูโร่	rojero	rojuro - a japanese character
โรตารี	rotacijski	rotary
โรม	rim	rome
โรมัน	rimski	roman
โรลเลอร์เบลด	roller blade	rollerblade
โรส	rose	rose
โรเจอร์	roger	"name ""roger"""
โลก	svetu	world
โลกแอมะซอน	amazon world	world of amazon
โลงหิน	sarkofag	sarcophagus
โลโซ	loso	lasso
โสณกุล	sonakul	sonakul
โสน	sesbanija	sa-nho, has yellow flower, use in thai sweet/desert
โสภณ	ljupko	sophon
โหมด	režimu	mode
โหม่ง	pribor	mong - a thai musical instrument
โอกาส	šansa	opportunities
โอบามา	obama	obama
โอภาส	sjaj	oh pas - a thai name
โอร์มาน	oman	oman - country
โอวีเอ	ova	ova
โอสถสภา	osotspa	osotspa
โอสถานุเคราะห์	osathanugrah	social service
โออิชิ	oishi	oochi - a name of food business in thailand
โอะกินะวะ	okinawa	okinawa
โอเค	uredu	ok
โอเอกซ์	tic-tac-toe	ox - a game like tic tac toe
โฮม	dom	"english word ""home"""
โฮลดิ้ง	držanje	houlding
ใจดี	ljubazan	chaidi
ใช่	da!	yes
ใช้ขยายความเฉพาะบุคคล	koristite za personalizaciju	to describe
ใช้ชื่อว่า	imenovana	named
ใช้เวลา	uzmi vremena	it takes time
ใต้	ispod	south
ในกรณีนี้	u ovom slučaju	in this isituation
ในกลุ่ม	u grupi	in group
ในการประเมินผลงานวิจัยของสถาบัน	u ocjeni rezultata istraživanja instituta	in research evaluating of institute
ในการเลือกตั้ง	na izborima	election
ในกาลต่อมา	u budućnosti	later
ในขณะที่	dok	while
ในคริสต์ศตวรรษที่	u 19. veku	in the #___ century
ในคศ	godine	in a.d.
ในชิงร้อยชิงล้าน	u milionu ching ching	game show to compete for 1 million baht
ในช่วงปี	u toku godine	in the year of ________
ในช่วงสงครามเย็น	tokom hladnog rata	during the cold war
ในช่วงสงครามโลกครั้งที่	tokom svetskog rata	in time of world war
ในช่วงสงครามโลกครั้งที่สอง	tokom drugog svjetskog rata	during world war ii
ในช่วงหลัง	kasnije	later
ในช่วงแรก	u početku	in the first part, primarily
ในดาร์ฟูร์	u darfuru	inside dafur
ในต่างประเทศ	u stranim zemljama	foreign countries
ในทางกลับกัน	s druge strane	opposite
ในทางดาราศาสตร์	u astronomiji	astrology
ในทางตรงกันข้าม	naprotiv	oppositely
ในบางฉบับ	u nekim izdanjima	in a certain issue (of a magazine)
ในประเทศญี่ปุ่น	u japanu	japan
ในปลายปี	na kraju godine	at teh end of the year
ในปี	godine	in the year
ในปีที่	godine	in year
ในปีนี้	ove godine	in this year
ในปีพศ	godine	in b.e. year
ในปีพุทธศักราช	godine.	in b.e.
ในปีเดียวกัน	iste godine	in the same year
ในปีเดียวกันนั้น	iste godine	in that year
ในพระบาทสมเด็จพระพุทธยอดฟ้าจุฬาโลก	u vladavini kralja bude yodfa chula lok	under the reign of one of the thailand's past king
ในพระบาทสมเด็จพระพุทธเลิศหล้านภาลัย	u njegovo veličanstvo kralj, phra buda lertlah, napalai	under one of the king of siam
ในภายหลัง	kasnije	background
ในภาษาสันสกฤต	na sanskrtu	in sanskrit language
ในภาษาอังกฤษ	na engleskom	in english
ในภาษาอิตาลี่	na italijanskom	in italian
ในภาษาไทย	na tajlandskom	in the thai language
ในยุคกลาง	u srednjem veku	in the middle ages
ในยุคแรก	u početku	in early age
ในระบบสุริยะ	u sunčevom sistemu	in the solar system
ในระยะหลัง	u poslednje vreme	at the end
ในระหว่างปี	u toku godine	between the years
ในระหว่างวันที่	tokom dana	during the dates
ในรัชสมัยพระบาทสมเด็จพระจอมเกล้าเจ้าอยู่หัว	za vreme vladavine kralja mongkuta	in the reign of thailand's 4th king
ในรัฐบาล	u vladi	in the government
ในฤดูกาล	u sezoni	in season
ในสมัยกรุงศรีอยุธยา	u ayutthaya periodu	in  ayutthaya kingdom era
ในสมัยก่อน	u stare dane	in the past
ในสมัยพุทธกาล	u moderno doba	in buddha era
ในสมัยรัชกาลที่	tokom vladavine god	in period
ในสหรัฐอเมริกา	u sjedinjenim američkim državama	in united states of america
ในหนังสือ	u knjizi	in book
ในอดีต	u prošlosti	in the past
ในอดีตทุ่งกุลาร้องไห้ในฤดูแล้ง	u prošlosti je thung kula plakao u sušnoj sezoni.	thung kula rong hai in dry season in the past
ในอัลบั้ม	u albumu	in the album
ในเกมเดอะซิมส์	u igri sims	sims game
ในเครือ	pridružena	in the area of
ในเดือน	u mesecu	in the month of ...
ในเดือนมิถุนายน	u junu	in june
ในเดือนมีนาคม	u martu	in april
ในเบื้องต้น	u početku	primarily
ในเรื่อง	u odnosu na	in story
ในเหตุการณ์	u slučaju	in the event
ในเอเชียตะวันออกเฉียงใต้	u jugoistočnoj aziji	in southeast asia.
ในแฮร์รี่	harry	in harry
ในโอกาสครบรอบ	povodom godišnjice	anniversary
ใบเสมา	bitke	boundary marker of a temple
ใหญ่	veliki	large
ให้พลเอกเปรม	za general prem	general prem - a former military figure
ให้สมเด็จพระเทพรัตนราชสุดาฯ	za nj.kv princeza maha chakri sirindhorn	given to the thai's eldest princess
ให้เสียงพากย์	glasovna gluma	dubbed
ให้แก่ประชาชน	ljudima	for the people
ให้ใช้หลัก	koristite princip	large size
ไกรทอง	krai thong	krei thong - a surname
ไกรลาศ	krailat	krailard
ไกลกังวล	brini se	klai kangwon
ไก่	piletina	chicken
ไขมัน	debeo	lipid, fat
ไขสันหลัง	rupa	spinal cord
ไข่	jaje	egg
ไข้รากสาดใหญ่	tifus	typhus
ไข้สูง	visoka temperatura	high fever
ไข้หวัดใหญ่สายพันธุ์ใหม่	novi soj gripa	new flu strain
ไข้หวัดใหญ่สเปน	španski grip	spanish flu
ไคเอ็น	kaien	kaien
ไชยกิตติ	chai kitti	chaikitti
ไชยยงค์	chaiyong	chaiyayong
ไชยวัฒน์	chaiwat	chaiwat
ไชยา	chaiya	chaiya
ไชโย	bravo!	chaiyo
ไซน์	sin	sine
ไซโทสเกเลตอน	zeitos gateela	cytoskeleton
ไซโปรเฮปตาดีน	sipro heptadine	cyproheptadine
ไดคลอกซาซิลลิน	daiklok sillin	dicloxacillin - a drug
ไดดาโนซีน	dinocen	didanosine - medication
ไดอาน่า	diana	diana
ไดโนเสาร์ของโนบิตะ	nobitin dinosaur	nobita's dinosaur
ได้	imati	receive
ได้กล่าวว่า	rekao je	stating that, commenting on something
ได้ดังนี้	kao što slijedi	these
ได้ทูลเกล้าฯ	predstavljeno	report to the king
ได้มีโอกาสสร้างความสัมพันธ์อันดีต่อกัน	imati priliku za izgradnju dobrih odnosa jedni s drugima	good relationship
ได้รับ	get	received
ได้รับฉายาว่า	dobio je nadimak	recived the alias
ได้รับรางวัล	nabavite nagradu	awarded
ได้ร่วมกันในภารกิจในด้านต่าง	zajedno u misiji na raznim poljima.	participated in activities
ได้สำเร็จ	uspješno	successfully
ได้สู้กับ	suočen sa	competing against
ได้เคลื่อนไหวตรวจสอบการทำงานของรัฐบาลกัมพูชาอย่างแข็งขัน	aktivno je krenuo u inspekciju rada vlade kambodže	underground investigation
ได้เป็น	postani	is
ไต	bubreg	kidney
ไต้หวัน	tajvan	taiwan
ไท	nezavisna	tai
ไทย	tajlandski	thai
ไทยทีวีสีช่อง	tv kanal thai color	thai tv
ไทยพรีเมียร์ลีก	tajlandska premijer liga	thai premiere
ไทยรามา	thai rama	thairama
ไทยานนท์	thaiyanon	taiyanon - a thai surname
ไทรโลจี	trilogija	trilogy
ไทลื้อ	thai lue	group of laotians that lives on flatlands
ไทโรซีน	tirozin	thyrosine
ไนท์	noć	sege
ไนลอน	najlon	nylon
ไนโตรเจน	nitrogen	nitrogen
ไปจนถึง	za	to
ไปบรรจบแม่น้ำเจ้าพระยา	idite u susret rijeci chao phraya	runs to chao phraya river
ไปรษณีย์กาฬสินธุ์	pošta kalasin	kalasin post office
ไปรษณีย์ฉะเชิงเทรา	pošta chachoengsao	cha cheng sao postal zone
ไปรษณีย์นครศรีธรรมราช	pok nakhon si thammarat	nakornsritamarat postal station
ไปรษณีย์ภูเวียง	pošta phu wiang	pu weang postal office
ไปรษณีย์ยานนาวา	yannawa pošta	yan nawa post office
ไปรษณีย์ร้อยเอ็ด	roi et pošta	roi et post office
ไปรษณีย์สามเสนใน	poštanski ured samsen nai	samsen nai post office
ไปรษณีย์หนองหาน	pošta nong han	nong han postal office
ไปรษณีย์อำนาจเจริญ	pošta amnat charoen	amnat charoen post office
ไปรษณีย์อุทุมพรพิสัย	pošta uthumphon phisai	utumporn pisai post office
ไปรษณีย์อุบลราชธานี	pošta ubon ratchathani	ubon ratchathani post office
ไปรษณีย์เดชอุดม	det pošta	det udom post office
ไปรษณีย์โพนพิสัย	pošta phon phisai	phon phisai post office
ไผ่แดง	crveni bambus	red bamboo
ไพฑูรย์	hrizoberil	phaithun
ไพรบึง	šuma	phrai bueng
ไพรวัลย์	praiwan	phraiwan
ไพศาล	ekspanzivan	phaisan
ไฟ	vatra	fire
ไฟนอลแฟนตาซี	final fantasy	final fantasy
ไฟร์วอลล์	vatrozid	firewall
ไมค์	mike	mike
ไมอามี่	miami	miami
ไมโครซอฟท์	microsoft	microsoft
ไม่ต่ำกว่า	ne manje od	not lower than
ไม่ทราบข้อมูล	nepoznate informacije	no background information
ไม่บังคับ	neobavezno	not enforced
ไม่ผ่านเข้ารอบ	nije kvalificiran	did not make it to the next round, got eliminated in the initial round
ไม่มีบันทึกว่าใครเป็นคนสร้าง	nema zapisa ko ga je stvorio.	don't note who make id
ไม่มีแขน	bez oružja	armless
ไม่ว่าจะ	da li	such as
ไม่สามารถทำการเกษตรได้	nije moguće baviti se poljoprivredom	unable to practice agriculture
ไม่แตกกิ่ง	nije razgranato	no chain
ไม่ใช่	ne	no
ไม้	drvo	mai
ไม้กวาด	metla	broom
ไม้หนีบผ้า	privjesak za odjeću	clip
ไม้ไม่ผลัดใบ	evergreen	plants that have leaves all year round
ไรงะ	riga	reiya - a character from a japanese story
ไรโบโซม	ribosomi	ribosome
ไร่	farma	field, parcel
ไลท์	svetlost	light
ไลบร้า	vaga	libra
ไลฟ์สไตน์	lifstein	life style
ไลเบรชัน	biblioteka	libration
ไวชาน่า	waichana	baishana - weapon in a japanese story
ไวทยางกูร	vittayangkun	wathaiyangkun
ไวทยานนท์	waithayanon	waithayanon
ไวท์สเปล	whitespell	white spell
ไวน์	vino	wine
ไวยากรณ์	gramatiku	waiyakorn
ไวรัส	virus	virus
ไวรัสตับอักเสบ	hepatitis	hepatitis
ไวเซิร์ด	weiss	vizard
ไวเปอร์	viper	viper
ไวเวิร์น	wvern	wyvern
ไวโอเลต	ljubičasta	violet
ไว้ว่า	reci	as
ไหซอง	flert	haisong
ไหมกัน	zajedno	maigun - a surname
ไหลจากลาวเข้าสู่ภาคเหนือของกัมพูชาแล้วไหลผ่านเข้าเขตเวียดนาม	teče iz laosa u sjevernu kambodžu i uliva se u vijetnam	flows from laos into northern cambodia
ไอทีวี	itv	itv
ไอน์สไตน์	ajnštajn	einstein
ไอน์สไตเนียม	einsteinium	einsteinium
ไอพอด	ipod	ipod
ไอริส	iris	iris
ไอร์แลนด์เหนือ	sjeverna irska	northern ireland
ไอเอ	ia	ia
ไอโมบาย	i-mobile	i-mobile
ไอโอ	io	io - from greek mythology
ไฮยาซินธ์	hyacinth	hyacinth
ไฮเดรนเยีย	hydrangea	hydrangea
ไฮเปอร์มาร์เก็ต	hipermarket	tesco lotus hypermarket chain
ไฮแจ็ค	otmica	hijack
ไฮโดรเจน	vodonik	hydrogen
๑๔	14	14
๑๕	15	15
๑๖	16	16
๑๘	18	18
๒๑	21	21
๒๒	22	22
๒๔๕๐	1907	2450
๒๕๐๒	1962	2502
๒๕๐๓	1963	2503
๒๕๒๓	1980	1980
๒๕๓๔	1991	2534
๒๕๓๕	1992	2535
๒๕๓๖	2536	2536 be (1993 ad)
๒๕๔๗	2004	2547
๒๕๔๘	2005	2548
๒๕๕๐	2007	2550
๒๕๕๔	2011	2554
๒๗	27	27
๒๘	28	28
๓	3	3
๔๘	48	48
๕	5	5
๖๐	60	60
๙	9	nine
ព្រះរាជាណាចក្រកម្ពុជា	ព្រះរាជាណាចក្រ កម្ពុជា	cambodia
疾風伝	疾風 伝	not in thai - cannot translate
