+	+	plus sign
=	=	equal to
 °ซ  °ฟ 	° c ° f	เซลเซียส ฟาเรนไฮต์
 ซม	سم	cm.
 −°ซ  °ฟ	- ° c ° f	thai letters
×	×	letter x
γ	γ	y
π	π	pi
กกกก	كغ	a thai letter repeated 4 times
กกกข	خور خور	4 thai alphabets - jibberish
กขขข	أ ب ب	4 of thai letters
กขขขขขขข	أ ب أ ب ب ب أ	abbbbbbb
กฎ	القواعد	law, rule
กฎของโคไซน์	قانون جيب التمام	law of cosines
กฎแห่งกรรม	الكرمة	bad karma
กติกา	القاعدة	rule
กทม	بانكوك	agency
กนู	نايت	gnu - computer related acronym
กบ	ضفدع	frog
กบฏทหารนอกราชการ	تمرد عسكري	coup de lat
กมล	ليلى	kamon
กมลรัตน์	kamonrat	kamolrat - a surname
กรณีที่	القضية	case
กรมขุนอิศเรศรังสรรค์	كروم خون إيزارسرانجسان	the convention of angels
กรมขุนเพ็ชรบูรณ์อินทราชัย	kromkhunpetchaboon-indachai	department of....
กรมข่าวทหารอากาศ	قسم اخبار القوات الجوية	communication department of the thai air force
กรมควบคุมโรค	قسم السيطرة على الأمراض	department of disease control
กรมทหารราบที่	فوج المشاة	infantry regiment
กรมรบพิเศษที่	قسم القتال الخاص	special force group
กรมศิลปากร	قسم الفنون الجميلة	fine arts department
กรมหลวงนราธิวาสราชนครินทร์	krom luang narathiwatratchanakharin	krom ma loung naratifatrachanakarin - the name of a royal family member
กรมหลวงสงขลานครินทร์	kromluang songkhla nakarin	prince of songkla
กรมอุตุนิยมวิทยา	قسم الأرصاد الجوية	the meteorology department
กรรชัย	كانشاي	kanchai
กรอง	مرشح	screen
กระดูกค้อน	عظم المطرقة	malleus, hammer bone
กระดูกต้นแขน	العضد	humerus
กระดูกฝ่ามือ	النخيل	metacapus
กระดูกสะบัก	الكتف	scapula
กระดูกสะบ้า	الرضفة	kneecap
กระทรวงกลาโหม	وزارة الدفاع	defense ministry
กระทรวงการคลัง	وزارة المالية	ministry of finance
กระทรวงการต่างประเทศ	وزارة الخارجية	ministry of foreign affairs
กระทรวงวัฒนธรรม	وزارة الثقافة	ministry of culture
กระทรวงศึกษาธิการ	وزارة التربية والتعليم	ministry of education
กระทรวงสาธารณสุข	وزارة الصحة العامة	ministry of public health
กระทรวงอุตสาหกรรม	وزارة الصناعة	ministry of industry
กระทรวงเกษตรและสหกรณ์	وزارة الزراعة والتعاونيات	ministry of agriculture and cooperatives
กระทรวงเศรษฐการ	وزارة الشؤون الاقتصادية	ministry of commerce
กระทุ่มแบน	سلة صغيرة	krathum baen district, samut songkram province
กระนวน	الملعب	granuan - location in knon kan province
กระนั้น	مع ذلك	however
กระบวนการสร้าง	عملية البناء	anabolism
กระบวนการสร้างและสลาย	عملية الخلق والتفكك	metabolism
กระบอง	لعبة ورق	club
กระบะทราย	صندوق الرمل	litter box or sand box
กระบี่กระบอง	السيف	krabi krabong (swordplay)
กระรอก	السنجاب	squirrel
กระวนกระวาย	قلقة	nervous
กระหม่อม	فونتانيل	fontanelle
กระเพาะอาหาร	المعدة	stomach
กระแต	السنجاب	wasp
กรับ	التقط	wooden rhythm clappers
กรับพวง	اختر باقة	krap phuang
กรับเสภา	krapao	wooden rhythm clappers
กรัม	غرام	gram
กรัยวิเชียร	kraiwichian	krivician - a surname
กรานาดา	غرناطة	granada
กริม	جريم	grim
กรี	رمادي	karee
กรุง	المدينة	city
กรุงธนบุรี	كرونج ثون بوري	thonburi city
กรุงลอนดอน	لندن	london
กรุงศรีอยุธยา	أيوثايا	sri ayuttaya city - former capital of thailand
กรุงเทพ	بانكوك	bangkok
กรุงเทพเชียงใหม่กรุงเทพ	بانكوك ، شيانج ماي ، بانكوك	bangkok changmai bangkok
กรุงเทพโพลล์	استطلاع بانكوك	bangkok poll
กรุ๊ป	مجموعة	group
กลอง	الطبل	drum
กลองมโหระทึก	طبل كبير	big drum
กลองยาว	طبل	tom-tom
กลองสองหน้า	طبل ذو وجهين	glong songna
กลอน	الآية	poem
กลอบูลิน	لامعة	globulin
กลาง	الوسط	in the middle
กลิ่น	الرائحة	odor
กลุ่มดาวกล้องจุลทรรศน์	أبراج المجاهر	microscopium
กลุ่มดาวนกทูแคน	الطوقان	tucana
กลุ่มดาวสิ่ว	إزميل	siu star
กลุ่มดาวเข็มทิศ	بوصلة كوكبة	pyxis constellation
กลุ่มดาวเตาหลอม	فرن الانفجار	fornax
กลุ่มดาวแมงป่อง	العقرب	scorpion constellation
กลุ่มดาวแมลงวัน	الذباب	musca
กลุ่มที่	المجموعة	group
กลุ่มแสงอุษา	مجموعة ضوء الولايات المتحدة الأمريكية	light at dawn
กลูคากอน	غلوكون	glucagon
กล่าวคือ	هذا يعني	that is
กล้วยไม้ดาว	السحلبية النجمية	type of orchid that have slim petal like star
กล้องถ่ายภาพ	الكاميرا	camera
กล้ามเนื้อ	عضلة	muscle
กวม	غوام	obscure
กวาง	الغزلان	deer
กวิน	kawin	gwen - a name
กวี	الشاعر	poet
กว่า	من	than
กองกลาง	لاعب خط الوسط	headquarter
กองการบินทหารเรือ	قسم الطيران البحري	the flying section of the navy
กองการศึกษา	قسم التعليم	education group
กองการเจ้าหน้าที่	تقسيم الموظفين	division of personnel
กองกำลังกึ่งทหาร	القوات شبه العسكرية	armforces
กองคลัง	الخزانة	division of finance
กองทัพ	الجيش	arm forces
กองทัพบกไทย	الجيش التايلاندي	thai army
กองทัพภาคที่	جيش المنطقة	army area
กองทัพเรือ	البحرية	navy
กองทัพเรือไทย	البحرية التايلاندية	the royal thai navy
กองทัพแห่งความชอบธรรม	جيش البر	army of the righteous
กองทัพไทย	الجيش التايلاندي	thai military forces
กองบิน	مجموعة طيران	air force
กองบินปีกหมุนที่	الجناح	flight corp number __________
กองพลทหารม้าที่	لواء الفرسان	cavalry division
กองพันทหารช่างที่	لواء المهندس	troop unit number ___________`
กอด	عناق	kord
กอนซาเลซ	جونزاليس	gonzales - a name
กอร์ดอน	جوردون	gordon
กอลมเบต์	جوريم	glombet - a catholic priest
กอล์ฟ	جولف	golf
กอล์ฟไมค์	ميكروفون جولف	golf-mike
กะเหรี่ยง	كارين	karen
กะโหลก	الجمجمة	skull
กะโหลกศีรษะ	جمجمة	skull; cranium
กังหันชัยพัฒนา	توربينات تشيباتانا	chaipattana's windmill
กันดั้ม	جاندام	gundam - a cartoon
กันตัง	kantang	kuntun in trung state
กันทรลักษ์	kantharalak	kuntaraluk - an area in thailand
กันฟอร์ม	نموذج	gun form
กันอริ	كناري	gan-ari
กันเอง	ودياً	casual
กับนางสุจาริณี	مع السيدة سوكارين	with mrs. sujarinee
กัมปูเชีย	كمبوتشيا	kampuchea
กัมพูชา	كمبوديا	cambodia
กัมพูชาประชาธิปไตย	كمبوديا الديمقراطية	democratic kampuchea
กัมพูชาเป็นประเทศที่มีป่าไม้อุดมสมบูรณ์มากที่สุดหากเปรียบเทียบกับประเทศเพื่อนบ้าน	كمبوديا هي الدولة ذات الغابات الأكثر وفرة عند مقارنتها بالدول المجاورة.	cambodia is the country with nice, healthy forests
กัมพูชาเป็นอดีตประเทศอาณานิคมของฝรั่งเศสในภูมิภาคเอเชียตะวันออกเฉียงใต้เพียงแค่ประเทศเดียวเท่านั้นที่มีการปกครองด้วยระบอบราชาธิปไตยภายใต้รัฐธรรมนูญ	كمبوديا هي الدولة الاستعمارية الفرنسية السابقة الوحيدة في جنوب شرق آسيا التي لها نظام ملكي بموجب الدستور.	cambodia was a former french colony
กัมพูชาเป็นอาณานิคมของฝรั่งเศสมาตั้งแต่พศ	كانت كمبوديا مستعمرة فرنسية منذ ذلك الحين.	cambodia was a france colony from year
กัวเตมาลา	غواتيمالا	guatemala
กานซู	قانسو	honshu in china
กานต์	كان	kan
กานา	غانا	ghana
กานามัยซิน	كاناميسين	kanamycin
กาบอง	الغابون	baton
กาพย์ฉบัง	قصيدة ملحمية	poem
กาพย์สุรางคนางค์	قصيدة	gabsuranknang
กาม	وانتون	lust
กาย	الجسم	body
การ	إن	project
การกีฬา	الرياضة	sport
การขัดเกลาทางสังคม	التنشئة الاجتماعية	socialization
การขับถ่าย	إفراز	excretion
การขับไล่	الإخلاء	discharge
การคมนาคม	المواصلات	transportation department
การคลัง	المالية	public finance
การค้นพบ	الاكتشاف	discover
การค้า	التجارة	marketing
การจัดการ	الإدارة	project
การจัดการคุณภาพ	إدارة الجودة	quality control
การจัดอันดับ	الترتيب	ranking
การจัดให้มี	الحكم	putting together something
การจูบ	قبلة	kissing
การชัก	الاستيلاء	the act of pulling the flag wiht string up the pole
การดำเนินการ	عملية	progression
การตอบรับ	ملاحظات	welcoming
การตั้งถิ่นฐาน	التسوية	start a project
การต่างประเทศ	الشؤون الخارجية	foreign affairs
การทำงานของ	عمل	function
การทำป่าไม้	الحراجة	forestry
การท่องเที่ยว	السياحة	tourism
การท่าเรือ	هيئة الموانئ	port authority
การบริการ	الخدمة	customer service
การบริหารการพัฒนา	إدارة التنمية	development
การบริหารการศึกษา	الإدارة التربوية	educational administration
การบริหารจัดการ	الإدارة	management
การบริหารราชการแผ่นดิน	الإدارة الحكومية	administration
การบินไทย	الخطوط الجوية التايلاندية	thai airways
การปกครองท้องถิ่น	الحكومة المحلية	local administration
การปกครองส่วนท้องถิ่น	الحكومة المحلية	local government
การปกครองแบ่งออกเป็น	تنقسم القاعدة إلى	administration
การปฏิรูประบบจัดเก็บภาษีเงินได้	إصلاح نظام تحصيل ضريبة الدخل	taxation reform
การปฏิรูปศาสนา	الإصلاح	religious reformation
การปฏิวัติฝรั่งเศส	الثورة الفرنسية	french revolution
การปฏิวัติอุตสาหกรรม	ثورة صناعية	industrial revolution
การปฏิสนธิ	التسميد	fertilisation
การประมง	مصايد الأسماك	fishery
การพัฒนา	التطوير	development
การพัฒนาประชาธิปไตย	التطور الديمقراطي	democratic development
การพูด	يتحدث	speaking
การยึดครองมะละกาของโปรตุเกสในปี	الاحتلال البرتغالي لملقا في السنة	portugal took over malaga
การระบาดของไข้หวัดใหญ่สายพันธุ์ใหม่	سلالة الأنفلونزا الجديدة	flu pandemic
การรักษาพยาบาล	العلاج الطبي	nursing care
การร่วมเพศทางทวารหนัก	سخيف الشرج	sodomy
การลดรูป	تشويه	reduction
การละเล่นพื้นบ้าน	الألعاب الشعبية	local game
การวิจัย	البحث	researching
การวิเคราะห์	التحليل	analysis
การศึกษา	التربية	study of, education
การสังคายนาครั้งที่	الترتيب الأخير	the event of convention of monks
การสั่นพ้อง	الرنين	resonance
การสำเร็จความใคร่ด้วยตนเอง	الاستمناء	masturbation
การสืบพันธุ์	التكاثر	reproduction
การสื่อสาร	التواصل	communications
การาจ	مرآب	garage
การุณ	كارون	karoon
การเต้นรำ	الرقص	dance
การเพิ่มสิทธิประโยชน์แก่นักลงทุนต่างประเทศ	زيادة الامتيازات للمستثمرين الأجانب	increase benefits for foreign investors
การเล่น	اللعب	play
การแข่งขัน	المنافسة	competition
การแบ่งพื้นที่	التقسيم	land division
การใช้คำ	استخدام الكلمات	terminology
การไฟฟ้าส่วนภูมิภาค	هيئة كهرباء المحافظات	distribution electric transformer
การไหว้	الاحترام	thai greeting
การ์ด	البطاقة	guard
กาฬสินธุ์	كالاسين	katsin - a thai surname
กาเวน	جاوين	gawain
กาเหว่าที่บางเพลง	غراب بعض الأغاني	the cuckoo's song.
กำกับการแสดงโดย	إخراج	produced by (movie)
กำกับโดยอภิชาติพงศ์	إخراج aphichat pong	produced by apichartpong - a famous thai movie producer
กำมะถัน	الكبريت	sulfur
กำลังจะปรับเปลี่ยนเป็น	ذاهب للتغيير إلى	is changing to
กำหนดตามสภาพภูมิศาสตร์	تحددها الجغرافيا	geography estimation
กำแพงเพชร	كامفاينج فيت	kamphaeng phet
กำแพงเมืองจีน	سور الصين العظيم	the great wall of china
กำแพงแสน	kamphaengsaen	kampangsaen (name of district)
กิจผลิต	الإنتاج	kitpalit (last name)
กิมป์	جيمب	gimp - gnu image manipulation program
กิโลกรัม	كيلوغرام	kilogram
กิโลไบต์	كيلوبايت	kilobyte
กิ่งแก้ว	kingkaew	kingkaeo
กิ้งกือ	مليبيدي	millipedes
กิ๊ก	كيك	gig
กีฏวิทยา	علم الحشرات	entomology
กีฬา	الرياضة	sports
กีฬาทางน้ำ	الرياضات المائية	water sports
กีฬาแหลมทอง	ليم ثونغ سبورت	seap games
กุดจับ	العفن	good jub - a place
กุลดิลก	kuldilok	kuldilok
กุลละวณิชย์	kulalawanit	kullawanich
กุหลาบ	وردة	kularb (first name)
กุ้ง	جمبري	shrimp
กุ้งต้ม	جمبري مسلوق	boiled shrimp
กูเกิล	جوجل	google
ก็คือ	هو	which is
ก็ใช้เป็น	تستخدم ك	utilize
ก่อตั้ง	تأسست	founded
ก่อตั้งโดย	أسسها	make by
ก่อนที่	من قبل	before
ก่อนที่จะตกเป็นของฝรั่งเศสในเวลาต่อมา	قبل أن تصبح فرنسا في وقت لاحق	belonging to france, under the control of france
ก่อนหน้านั้น	قبل ذلك	before
ก้อย	الخنصر	koi
ก้าน	الساق	thorn
ก้านกล้วย	ساق الموز	kankluai
ก๊าซธรรมชาติ	غاز طبيعي	natural gas
ก๎ล	هدية	magic
ขขขขขขขขขข	ب ب ب ب ب ب ب	repeated letter from thai alphabet
ขณะทรงพระเยาว์	بينما كان صغيرا	having to do with the young prince or princess
ขณะที่	بينما	while
ขนม	الحلوى	dessert
ขนมกล้วย	موز	banana dessert
ขนมครก	كنمرك	kind of thai sweetmeat
ขนมปัง	خبز	bread
ขนมปังขิง	خبز الزنجبيل	gingerbread
ขนมเปียกปูน	المعين	a type of thai dessert with flour and sugar
ขนมไทย	الحلوى التايلاندية	thai dessert
ขนสัตว์	صوف	fur, animal hair
ขนอม	خانوم	kanom - location in thailand
ขนาดหน้าตัก	حجم اللفة	length between both knees of buddha statue in posture of meditation
ขนาดใหญ่	حجم كبير	l
ขบวนการอ๊บอ๊บป่วนโลก	حركة الأرض	original name is keroro gunso
ขบวนรถสินค้า	قطار	caravan of trucks
ขม	مر	bitter taste
ขรรค์ชัย	خان تشاي	kanchai - a male's name
ขลุ่ยหลิบ	الناي	khlui lib
ขวด	زجاجة	bottle
ขวัญ	معنويات	morale
ขวัญใจช่างภาพ	مصور محبوب	miss photogenic
ขสมก	الكتلة	an acronym consists of four thai letters
ของ	من	of
ของทุกปี	كل عام	every year
ของประเทศจีน	من الصين	owned by china
ของมหาวิทยาลัย	من الجامعة	of university
ของมัน	لها	their
ของร่างกาย	من الجسم	of the body
ของสมเด็จฮุน	من somdej hun	houssaine of cambodia
ของสิ่งมีชีวิต	من الكائنات الحية	living things
ของสุนทรภู่	من sunthorn phu	belong to soon thong pu (a thai legend)
ของเหลว	سائل	liquid
ของโลก	من العالم	of world
ขอนแก่น	خون كاين	khon kan - an area in thailand
ขอบคุณที่รักกัน	شكرا لحبك لي	thank you for loving each other
ขอเช็ดน้ำตา	دعونا مسح الدموع	wipe the tears
ขอให้เด็กสมัยปฏิวัติของข้าพเจ้า	نرجو أن يكون أولادي الثوريون	i hope that the children in my lifetime will ____________
ขั้นที่	الخطوة	level
ขา	الأرجل	leg
ขาย	للبيع	sell
ขิง	الزنجبيل	ginger
ขิม	السنطور	kim - a thai musical instrument
ขีดเส้นใต้	تسطير	underline
ขี้ผึ้ง	الشمع	wax
ขึ้นเป็น	حتى	to
ขึ้นไป	لأعلى	next one up
ขุขันธิน	خان تين	kukuntin
ขุนหาญ	هان	koonhan - a location in thailand
ข้อมูลทั่วไป	معلومات عامة	general information
ข้อมูลประเทศเดนมาร์ก	معلومات الدنمارك	information on denmark
ข้อมูลปรากฏการณ์โลกร้อน	ظاهرة الاحتباس الحراري	global climate change
ข้อมูลปี	بيانات السنة	information from the year ________
ข้อมูลอื่นๆ	معلومات أخرى	other information
ข้อมูลโดย	البيانات حسب	information from
ข้อวิพากษ์วิจารณ์	النقد	critique reports
ข้ามฉาก	عبر المشهد	sin(a)
ข้าวสาลี	قمح	wheat
ข้าวหลาม	خاو لام	bamboo rice
ข้าวเกรียบปากหม้อ	المفرقعات الأرز	a thai snack
ข้าวเจ้า	الأرز	white rice
ข้าวโพด	ذرة	corn
ข้าหลวงกำกับราชการเมืองขุขันธ์คนที่	محافظ مدينة خوخان	government worker for ku khan city
ฃ	ฃ	a letter from thai alphabet
คงยิ่ง	محتمل جدا	kongying
คงเจริญ	ربما تزدهر	khongcharoen
คณะครุศาสตร์	كلية التربية	education department
คณะครุศาสตร์อุตสาหกรรม	كلية التربية الصناعية	faculty of industrial education
คณะที่	الكلية في	the current administration
คณะบัญชี	كلية المحاسبة	accounting department (major)
คณะปฏิรูปการปกครองแผ่นดิน	اللجنة الثورية	national administrative reform council
คณะประมง	كلية الثروة السمكية	fishery division of the college of farming and agriculture
คณะพยาบาลศาสตร์	كلية التمريض	nursing department
คณะมนุษย์ศาสตร์และสังคมศาสตร์	كلية العلوم الإنسانية والاجتماعية	humanity department
คณะรัฐมนตรีคณะที่	مجلس الوزراء	council of ministers
คณะวิทยาการจัดการ	كلية العلوم الادارية	management department
คณะวิศวกรรมศาสตร์	كلية الهندسة	engineering department
คณะศิลปกรรมศาสตร์	كلية الفنون الجميلة	faculty of fine arts
คณะสถาปัตยกรรมศาสตร์	كلية العمارة	faculty of architecture
คณะสหเวชศาสตร์	كلية العلوم الصحية المساعدة	อังกฤษ   faculty of allied health science
คณะสาธารณสุขศาสตร์	كلية الصحة العامة	faculty of public health
คณะเกษตร	كلية الزراعة	faculty of agriculture
คณะแพทยศาสตร์ศิริราชพยาบาล	مستشفى سيراج كلية الطب	faculty of medicine siriraj hospital
คณะแพทยศาสตร์โรงพยาบาลรามาธิบดี	كلية الطب ، مستشفى راماثيبودي	the staff of ramatippadee hospital
คณารศ	كنارة	kanaros - a surname
คนที่	الشخص الذي	person number __________________________
คนที่ไปช่วยรุ่นที่	الناس الذين ساعدوا الجيل	volunteer group number __________
คนแคระ	قزم	dwarf
คนแรก	الشخص الأول	first
คปค	عام	3 thai letters
คม	شارب	sharp
ครอคโคไดล์	تمساح	crocodile
ครอบครัว	العائلة	family
ครั้งหนึ่ง	مرة واحدة	once upon a time
คราประยูร	برايون	karaprayoon - a thai surname
คราม	نيلي	indigo
คริส	كريس	christ
คริสตี	كريستي	christie - a female name
คริสต์ศาสนา	المسيحية	christainity
ครุฑ	جارودا	garuda
ครู	المعلم	teacher
ครูพิเศษจอมป่วน	مدرس القزم	kru pisat jom poun  - name of a story
คลอง	القناة	canal
คลองสาน	خلونج سان	klongsan
คลองเตย	خلونج توي	klongtoei
คลับ	النادي	club
คลาวิคอร์ด	فئة	clavichord
คลิก	انقر	click
คลินิก	عيادة	clinic
คลิป	مقطع	clip
คลื่นสึนามิ	تسونامي	tsunami wave
ควอน	كوون	kwon - a surname of a korean singer
ควอร์เตอร์	ربع	quarter
ความกว้าง	العرض	width
ความงาม	الجمال	beauty
ความจำ	الذاكرة	memory
ความต่างศักย์	فرق محتمل	potential difference in physics
ความถี่	التردد	frequencies
ความนิยม	الشعبية	popular
ความบริสุทธิ์	نقاوة	purity
ความฝันอันสูงสุด	الحلم النهائي	the impossible dream
ความพอประมาณ	التواضع	estimate
ความยากจน	الفقر	poverty
ความยาว	الطول	length
ความยาวคลื่น	الطول الموجي	frequencies
ความยาวช่วงคลื่น	طول الموجة	wave length
ความยาวเพลง	طول الأغنية	the length of the song
ความรัก	حب	love
ความรู้	المعرفة	knowledge
ความสว่าง	السطوع	illumination
ความสัมพันธ์กับประเทศไทย	العلاقات مع تايلاند	relationship with thailand
ความสัมพันธ์ระหว่างจีนกับอเมริกา	العلاقات بين الصين وأمريكا	relationship with china and the usa
ความสูง	الارتفاع	height
ความส่องสว่าง	السطوع	luminance
ความหนาแน่นของประชากร	الكثافة السكانية	population density
ความหมาย	المعنى	meaning
ความหมายโดยพยัญชนะ	معنى متناسق	definition that derived from translation from another language
ความเข้มของการส่องสว่าง	شدة مضيئة	luminous intensity
ความเข้าใจ	فهم	understanding
ความเร่ง	تسريع	acceleration
ความโกรธ	الغضب	anger
ความโน้มถ่วง	الجاذبية	gravity
ควินโต	كوينتو	quinto
ควีนซี่	الملكة	quincy
คอ	العنق	neck
คอนสตรัคชั่น	البناء	construction
คอนเวนชัน	الاتفاقيات	convention
คอนเสิร์ตประสานเสียงสามสถาบัน	حفل جوقة ثلاث معاهد	chulalongkorn kasetsart thammasat choral concert
คอมพิวเตอร์ยุคที่	عصر الكمبيوتر	_-generation computer (as in frist generation, second generation etc)
คอร์ด	الحبال	chord
คอลลิงวูด	كالينجوود	collingwood
คอสตาริกา	كوستا ريكا	costa rica
คัง	كانغ	kan
คัชชินสกี	كوتشينسكي	kaczyński
คัญทัพ	جيش مهم	main army.
คัทลียา	كاتليا	kathaleeya (thai first name)
คันธวงศ์	kanthavong	kunntavong - a surname
คัพ	كأس	cup
คัมภีร์	الكتاب المقدس	bible
คั่ว	محمص	dry roasting
คาคาชิ	كاكاشي	cacashi
คางาริ	kagari	kagari
คาซัคสถาน	كازاخستان	kazakhstan
คาถาอัญเชิญ	تعويذة	a magic spell
คาบ	الفترة	frequency
คาบัคโรเน่	الكباخرون	kyabarrone
คาบูโตะ	كابوتو	kabuto
คาปูชิโน่	كابتشينو	cappuccino
คามิว	kamui	camus
คาราคุระ	كاراكورا	karakura
คาร์ล	كارل	karl
คาวทอง	fishyong	lizard tail
คาเมนไรเดอร์	كامين رايدر	kamen rider
คาโรลัส	كارولاس	carolus linnaeus
คำขวัญวันเด็ก	شعار يوم الطفل	quote for kids day
คำถามข้อที่	رقم السؤال	the question number_________
คำนวณ	لحساب	calculate
คำนาม	نون	noun
คำพ้องรูป	المرادفات	hemonym
คำมั่นสัญญา	وعد	agreement
คำม่วง	خام موانج	kham muang
คำวิลัยศักดิ์	kamwilai sak	important words, magic words
คำศัพท์	المفردات	word
คำสรรพนาม	الضمير	pronoun
คำสร้อย	كلمة	kumsoi - a country singer
คำสุดท้ายของวรรคที่	الكلمة الأخيرة من الفقرة	the last word (in a poem)
คำสุภาพ	مهذب	formal
คำอธิบาย	الوصف	explanation
คำเมือง	كلمة المدينة	kum meuong - a location in chiang mai
คำแปล	الترجمة	translation
คิง	الملك	king
คิงส์	الملوك	kings
คิงส์คัพ	كأس الملك	king's cup
คิงไลเนอร์	kingliner	kingliner
คิชิเนีย	كيشينيا	kishinia
คิด	فكر	thinking
คินนิคุแมน	kinnikuman	kinkiku man
คิมิฮิโระ	كيميهيرو	kimihiro
คิระ	كيرا	kira - japanese name
คิเคียว	كيكيو	kikyo
คีตกวี	الملحن	composer
คือประมาณ	على وشك	estimated to be
คือเพลง	هي أغنية	is the song
คุณ	أنت	you
คุณครูจอมเวท	المعلم الساحر	magister
คุณปลื้ม	خون بلويم	kunpleam
คุณหญิงโม	الإمبراطورة مو	suranaree
คุณากร	أنت	khunakon
คุราปิก้า	كورابيكا	kurapika
คุโรซึจิ	كوروتسوجي	kurochiji - a japanese word
คุ้มค่า	قيمة جيدة	worth the money spent on
คูกิมิยะ	kukimiya	kugimiya
คูคาคุ	كوكو	kukaku (japanese last name)
คูเรียม	كوريوم	"chemical element ""curium"""
คูเวต	الكويت	kuwait
คู่กรรม	شريك	soul mate
ค่าความต้านทานตัวที่	قيمة المقاومة التي	resistance value of the
ค่าจีดีพี	الناتج المحلي الإجمالي	gdp - an economics term
ค่าใช้จ่าย	التكلفة	expense
ค่ำแล้ว	الغسق	getting dark, at dusk
ค้างคาว	الخفاش	bat
ฆ	خوان	a letter from thai alphabet
ฆ้อง	غونغ	gong
ฆ้องวงใหญ่	غونغ كبيرة	a group of thai drum music
งดส่งเข้าประกวด	لا دخول	enroll in the contest
งาน	الوظيفة	work, job
งานอดิเรก	الهوايات	hobby
งานเขียน	كتابات	writing, composition work
งานเทางามสัมพันธ์	علاقة تاو نغام	public party
งานโมเสก	فسيفساء	mosaic
งามวงศ์วาน	ngamwongwan	ngamwongwan
งู	الثعبان	snake
งูอนาคอนดา	اناكوندا	anaconda snake
จดหมายอากาศ	البريد الجوي	aerogram
จตรัง	ترانج	trang province (name of province in thailand)
จตุรงค์	تشاتوتشاك	jaturong - a surname of a comedian
จนกระทั่ง	حتى	until
จนกระทั่งปี	حتى العام	until the year
จนกระทั่งเมื่อปี	حتى العام الماضي	until the year
จนครปฐม	ناخون باتوم	nakorn pratom state
จนมีคำกล่าวว่า	حتى قيل ذلك	said
จน่าน	الاثنين	nan state
จบุรีรัมย์	بوريرام	burerum state
จมูก	الأنف	nose
จระเข้และแอลลิเกเตอร์	تمساح وتمساح	crocodile and alligator
จรัญญา	شارانيا	jarunya - a surname
จริยธรรม	الأخلاق	ethics
จริยศาสตร์	الأخلاق	ethics
จริยา	سيدة	jariya
จลำพูน	لامفون	jalumpoon - a place in thailand
จสตูล	ساتون	stoul state
จสุราษฎร์ธานี	سورات ثاني	surat thani province
จอมบึง	متورم	chom bueng
จอมพลถนอม	تشوم فون ثانوم	field marshal thanom
จอมพลสฤษดิ์	المشير ساريت	field marshal sarit
จอมพลเรือ	سفينة المشير	the general of the navy
จอมเทียน	جومتين	jom tien - a location in thailand
จอร์เจีย	جورجيا	georgia
จะต้องหาตัวแทนลงจากเวที	يجب العثور على ممثل للنزول من المسرح	find a teammate to leave the stage, a unique game
จะเขียนว่า	سأكتب	written as
จะเข้	آلة القانون	jakhe
จะได้	سوف تحصل	results in
จักจั่น	الزيز	chakkachan
จักรพรรดิเนอร์วา	الإمبراطور السكينة	emperor nerva
จักรพรรดิไททัส	الإمبراطور تيتوس	titus (flavius vespa)
จักรพันธุ์	تشاكفان	chakrabhand
จักรวาลวิทยา	علم الكونيات	cosmology
จังหวัด	المحافظة	province
จังหวัดกระบี่	محافظة كرابي	krabee state
จังหวัดกาญจนบุรี	كانشانابوري	kanchanaburi province
จังหวัดกาฬสินธุ์	كالاسين	kalasin province
จังหวัดขอนแก่น	محافظة خون كاين	khon kaen province
จังหวัดคยองกี	مقاطعة جيونج جي	the state of kyong gee
จังหวัดคยองซาง	مقاطعة جيونج سانج	kyongchang province
จังหวัดฉะเชิงเทรา	chachoengsao	chachoengsao province
จังหวัดชุมพร	شومفون	chumphon province
จังหวัดตราด	محافظة ترات	trat province
จังหวัดตาก	محافظة تاك	tak province
จังหวัดนครปฐม	محافظة ناخون باتوم	nakhon pathom province
จังหวัดนครพนม	مقاطعة ناخون فانوم	nakorn panom state
จังหวัดนครสวรรค์	محافظة ناخون صوان	nakorn sawan province in thailand
จังหวัดน่าน	محافظة نان	nan state in the north east of thailand
จังหวัดปัตตานี	مقاطعة باتاني	pattani state
จังหวัดพระนครศรีอยุธยา	فرا ناخون سي أيوثايا	nakon sri ahyutthaya province
จังหวัดพังงา	مقاطعة فانغ نغا	phang nga province
จังหวัดพิษณุโลก	محافظة فيتسانولوك	pisanulok state
จังหวัดมหาสารคาม	محافظة مها ساراخام	maha sarakham province
จังหวัดยโสธร	ياسوثون	yasothorn province (name of thai province)
จังหวัดระยอง	رايونج	rayong province
จังหวัดราชบุรี	راتشابوري	ratchaburi province
จังหวัดลำพูน	لامفون	lamphun province
จังหวัดสงขลา	سونغكلا	songkla province
จังหวัดสมุทรสงคราม	محافظة ساموت سونغخرام	samut songkhram province
จังหวัดสิงห์บุรี	محافظة سينغ بوري	sing buri province
จังหวัดหนองบัวลำภู	مقاطعة نونغ بوا لامفو	nong bua lamphu province
จังหวัดอุดรธานี	محافظة أودون ثاني	udon thani state
จังหวัดเชลลา	شيلا	chella city
จังหวัดเชียงราย	شيانغ راي	chianrai province
จังหวัดเชียงใหม่	مقاطعة شيانغ ماي	chiang mai province
จังหวัดเพชรบุรี	مقاطعة فيتشابوري	petcharaburi state
จังหวัดเพชรบูรณ์	فيتشابون	petchabun province
จังหวัดเลย	مقاطعة لوي	loei (name of thai province)
จังหวัดแพร่	phrae	prae state
จังหาร	جونغان	changhan
จัดขึ้นเมื่อ	عقد	occur on the date of _______________
จัดตั้งขึ้นโดย	أسسها	produced by
จัดอยู่ในภูมิภาค	نظمت في المنطقة	in region
จัดเมื่อวันที่	عقد	็held on the date of ...
จัดโดย	مرتبة حسب	arrange by
จัน	تشان	chan
จันทบุรี	تشانثابوري	juntaburi state
จันทร	القمر	chantorn
จันทรุปราคา	خسوف القمر	lunar eclipse
จันทร์	الإثنين	chan
จันทร์ภักดี	تشان فاكدي	juntapukdee - surname of a famous actor
จันทร์เกษ	تشان كيت	juntagaset - a surname
จาก	من	from
จากการพิสูจน์อายุโดยคาร์บอน	من إثبات العمر بالكربون	from the forensic carbon dating
จากภาษากรีก	من اليونانية	greek language
จากละคร	من الدراما	from drama
จากละครเรื่อง	من الدراما	from the soap opera
จากสารานุกรมบริทานิกา	من الموسوعة البريطانية	from printed information
จากอัลบั้ม	من الألبوم	from the album
จากเรื่อง	من القصة	from the story of ...
จากเว็บ	من الويب	from the web
จากเว็บไซต์กระทรวงการต่างประเทศ	من موقع وزارة الخارجية	from the website of foreign department
จากเว็บไซต์กระทรวงต่างประเทศ	من موقع وزارة الخارجية	from the foreign government affairs website
จากโซล	من سيول	from soeul
จาติกวณิช	chatikavanij	chatikavanij
จามจุรี	جامجوري	jamjuri flower
จารีตประเพณี	مخصص	tradition from the culture
จารุเสถียร	جارو ساتين	charusathien
จาวตาลเชื่อม	جاو تان ويلد	sweetened palm - a type of thai dessert
จำกัด	محدودة	limited
จำกัดมหาชน	محدودة	public limited
จำนวน	المبلغ	amount
จำนวนประชากร	السكان	population
จำปาเทศ	تشامبا	a specific type of magnolia tree; similar michelia champaca
จำเริญ	تزدهر	jamroen
จิกะไบต์	jigtes	gigabyte
จิตรกร	رسام	painter
จิตรกรรม	الرسم	arts and craft or music
จิตวิทยา	علم النفس	psychology
จิตใจ	العقل	heart; feelings
จินตหรา	jintara	jinnara - a female's name who is a singer
จิบูตี	جيبوتي	ji bu dee event on june 27
จิบเบอเรลลิน	جببرلين	gibberellin
จิม	جيم	jim
จิโอวานนี	جيوفاني	giovanni
จี	ز	g
จีนตัวย่อ	الصينية المبسطة	simplified chinese characters
จียอน	جيون	๋jiyeon (korean name)
จึงทรงพระกรุณาโปรดเกล้า	لذلك أمر بكرم	be kind enough to
จึงเปิดโอกาสให้	لذلك أعطت الفرصة	open up opportunities
จึงใช้ธาตุหมอกและเมฆาได้	لذلك يمكن استخدام عنصر الضباب والسحابة	using magic with cloud and spells
จุกนมสีขุ่น	حلمة غير شفافة	corrupted pacifier
จุดกึ่งกลาง	نقطة المنتصف	midpoint
จุดจอมฟ้า	النقطة الزرقاء	zenith
จุลจอมเกล้าเจ้าอยู่หัว	vajiralongkorn	phra chunla chom klao chao yu hua
จุฬาลงกรณินทรวรางกูร	chulalongkorn nintharangrangkun	new title for the princess
จูล	جول	joule
จูเซปเป	جوزيبي	giuseppe
จูเนียร์	مبتدئ	junior
จเชียงใหม่	شيانغ ماي	chiang mai province
จเพชรบุรี	فيتشابوري	pedchaburee province
จเพชรบูรณ์	فيتشابون	province pechaboon
จ๊กมก	jumkum	jokmok - a surname of a comedian
ฉ	و	ninth thai alphabet
ฉบับชั่วคราว	نسخة مؤقتة	special (temporary) edition
ฉบับวณิพก	الأرقام	begger version
ฉลอง	احتفل	celebrate
ฉลองพระชนมายุ	احتفل بالعام 80	celebrated birth anniversary of
ฉันรักคุณ	احبك	i love you
ฉาบ	المعجون	cymbal
ฉายเมื่อ	تظهر في	aired
ฉิ่ง	الصنج	small cup-shaped cymbals
ฉี่	تبول	qi
ชนะ	اربح	winning
ชนิด	النوع	kind
ชนิดของเมฆ	نوع السحب	types of clound
ชม	شاهد	chom
ชมชื่น	مجاملة	chomchuen
ชมพู	وردي	rose apple
ชมพูทวีป	شبه القارة الهندية	south asia
ชมพู่	تفاح الورد	syzygium
ชล	بحيرة	chol (first name)
ชลธารวิทยา	شالوم ويتايا	limnology
ชลบุรี	تشونبوري	cholburi state
ชลิต	شاليت	chalit - a male's name
ชวนชื่น	دعوة	choun cheen - a surname
ชอบ	مثل	chop
ชะนี	جيبونز	gibbon
ชะมด	المسك	anteater
ชะอวด	تباهي	chaoud - location in thailand
ชะอำ	تشا صباحا	cha-am (name of thai district)
ชัชพล	chatchapon	chatchapol - a male's name
ชัย	انتصار	chai
ชัยชนะ	النصر	chaichana
ชัยนาม	تشاي نام	chainam
ชัยบัญชา	تشاي بانشا	chaibancha
ชัยมงคล	chaimongkol	chaimongkol - a male's name
ชัยยุทธ	شايوت	chaiyuth (first name)
ชั้น	الكلمة	class
ชั้นที่	الطابق	order
ชั้นประทวน	الطابق	non-commissioned officer
ชั้นมหาวชิรมงกุฎ	تاج مها فاجراج	order of the king's jewels
ชั้นยศ	الرتبة	millitary rank
ชั้นสูงสุด	أعلى مستوى	special class
ชา	الشاي	tea
ชากะ	شاكا	shaka
ชาคริต	شكريت	charkrit
ชาญชัย	تشانتشاي	chanchai - a thai name
ชาตะ	شاي	born
ชาติ	الأمة	nation
ชาย	رجل	male
ชาร์ป	شارب	sharp
ชาร์ล	تشارلز	charles
ชาร์ลส	تشارلز	charles
ชาลส์	تشارلز	charles
ชาลี	تشارلي	charlie
ชาวนา	الفلاح	farmer
ชาวไทย	الشعب التايلاندي	thai
ชาวไทยภูเขา	قبيلة هيل	thai hill tribe
ชำนิ	خبير	chumni - a location in thailand
ชิคิกามิ	شيكيكامي	shikigami
ชิงร้อย	تنافس	ching roi
ชิงร้อยล้าน	تنافس على مائة مليون	ching roi lan
ชิซุกะ	شيزوكا	shizuka
ชิดจันทร์	شيدشان	chidjun (a person's last name)
ชิน	تستخدم	get used to
ชินวัตร	شيناواترا	shinawatra
ชิริว	chiryu	cherew - a japanese character
ชิลี	تشيلي	chilli
ชิโนะ	تشينو	shino
ชีพด็อก	كلب الراعي	chief dog
ชีวนิชพันธ์	بيولوجي	chiwanitphan
ชีวประวัติ	سيرة	biography
ชีวมวล	الكتلة الحيوية	alternative (natural) power
ชีวสถิติ	الإحصاء الحيوي	biometry, biostatistics
ชื่อดัง	مشهور	famous
ชื่อนามสกุล	الاسم الأول اللقب	name-lastname
ชื่อภาษาญี่ปุ่น	الاسم الياباني	japanese name
ชื่อภาษาอังกฤษ	الاسم الانكليزي	english name
ชื่อยศภาษาไทย	رتبة التايلاندية	thai title
ชื่ออัลบั้ม	اسم الألبوم	album name
ชื่ออื่น	أسماء أخرى	synonym
ชื่อเก่าในวงการ	الاسم القديم في الصناعة	old stage name
ชื่อเดิม	الاسم السابق	old name
ชื่อเมือง	اسم المدينة	city's name
ชื่อเรื่อง	العنوان	the name of the story
ชื่อเล่น	لقب	nickname
ชุดแพนเค้ก	مجموعة فطيرة	pancake
ชุติมา	chutima	chutima
ชุมชนออนไลน์ชาวจังหวัดสกลนคร	مجتمع ساكون ناخون أون لاين	sakon nakhon people online community
ชุมพลบุรี	شومفون بوري	chompolburi area
ชุมแพ	تشوم فاى	choompa - location in thailand
ชุมแสง	تشوم ساينج	choomsang - a male's name
ชูมันน์	شومان	schumann
ชูศักดิ์	تشوساك	chusak
ชโย	برافو	cheer; hurray
ชไนเดอร์	شنايدر	schneider
ช็อกโกแลต	شوكولاتة	chocolate
ช่วงปี	السنة	between year
ช่อง	القناة	channel
ช่องเชิงเทิน	البطانات	machicolation
ช้อน	ملعقة	spoon
ซ	ح	the eleventh letter of the thai alphabets
ซน	شقي	crashing into
ซบที่อกฉัน	نستله في صدري	cry in my arms
ซอมบี้	الكسالى	zombie
ซออู้	zo o	a woodwind thai instrument
ซันไชน์	أشعة الشمس	sunshine
ซัลฟานิลาไมด์	سلفانيلاميد	salfanilamide
ซัลฟาไดอะซีน	سلفاديازين	sulfadiazine
ซัลเฟต	كبريتات	sulphate
ซากดึกดำบรรพ์	علم الحفريات	fossil
ซาคุโร่	ساكورو	zakuro - a japanese character
ซาซางาวะ	ساساغاوا	sasangngawa - a japanese name
ซานกัลโล	سان جالو	sangallo family
ซาบุซะ	سابوزا	zabuza
ซาลาดิน	صلاح الدين الأيوبي	saladin
ซาอิ	ساي	chai - a japanese name
ซาโลมอน	سالومون	salomon
ซิกนัส	cignus	signus
ซิงเกอร์	مغني	sinder
ซิงเกิ้ล	الفردي	single
ซิทคอม	سيت كوم	sitcom
ซินเดอเรลล่า	سندريلا	cinderella
ซิมไฟลา	سيمفيلا	class symphyl
ซิโนไทย	الصينية التايلندية	sino-thai
ซี	البحر	see
ซีซี	نسخة	cc
ซีรีเบลลัม	سرابيلوم	cerebellum
ซีลีเนียม	السيلينيوم	selenium (chemical element)
ซีสต์	الخراجات	cyst
ซีเกมส์	ألعاب sea	southeast asian game
ซีเจ	cj	cj
ซีเซียม	سيزيوم	cesium
ซีเนม่า	السينما	cinema
ซีแคนต์	secant	secant
ซีโร่	صفر	zero
ซึง	الذي	feeling touched (by the music or movie)
ซึม	تسرب	absorb
ซึ่ง	فيه	because
ซึ่งประกอบด้วย	تتكون من	consists of
ซึ่งมี	الذي لديه	with
ซึ่งมีความหมายว่า	مما يعني	meaning
ซึ่งมีทั้งหมด	الذي لديه كل شيء	in total of
ซึ่งรู้จักกันว่า	وهو ما يعرف ب	called
ซึ่งเกิดจากปัจจัยภายนอก	سببها عوامل خارجية	which is caused by external factors
ซึ่งเรียกว่า	وهو ما يسمى	called
ซึ่งแท้จริงแล้ว	في الحقيقة	real name
ซึ่งได้แก่	أيهما	such as
ซุง	سجل	sung
ซุน	الشمس	son
ซุปเปอร์มาร์เก็ต	سوبر ماركت	supermarket
ซุปเปอร์เซ็นเตอร์	سوبر سنتر	super center
ซู	سو	holding up high
ซูจี	سوزي	fuji
ซูซูกิ	سوزوكي	suzuki brand
ซูรินาเม	سورينام	suriname
ซูเปอร์เซ็นเตอร์	مركز سوبر	super center
ซ่อมแซม	لإصلاح	repair
ซ่าหริ่ม	كن سعيدا	a type of thai dessert
ซ้าย	غادر	left
ฌอง	جان	jean - french name
ญ	إن	a thai alphabet with a y sound
ฐานข้อมูล	قاعدة البيانات	database
ฐานทัพ	القاعدة	armforce
ณภัทร	نفت	napat
ณรงค์	نارونج	narong - a male's name
ณัฏฐธิดา	natthida	nattathida - a thai female actress
ณัฐวุฒิ	nattawut	nattawut
ด	م	a letter from thai alphabet
ดง	القلاع	area, location
ดม	شم	smell
ดรทรงศักดิ์	dr songsak	doctor songsuk - a famous person
ดรนิพนธ์	الدكتور نيبون	doctor nipon
ดรสาโรช	دكتور ساروج	dr. sarot
ดรสุชาติ	دكتور سوخارت	dr. suchart
ดราก้อน	تنين	dragon
ดราก้อนเควสต์	التنين كويست	dragon quest
ดวงพร	ثروة	dwongpol
ดวงอาทิตย์	الشمس	sun
ดอก	الزهور	flower
ดอกอ้อ	زهرة القصب	dok aou
ดอกไม้	زهرة	flower
ดอกไม้ประจำจังหวัด	زهرة المقاطعة	state's flower
ดอตคอม	دوت كوم	dotcom
ดอนเมือง	دون موينج	don mueang
ดอยอินทนนท์	دوي إنتانون	doi inthanon
ดอร์	باب	door
ดอลลาร์สหรัฐ	دولار أمريكي	united states dollar
ดอว์ขิ่นจี	dawin ji	dorkingi
ดังนั้น	لذا	for that reason
ดังเช่น	مثل	such as
ดัชนีการพัฒนามนุษย์	مؤشر التنمية البشرية	human development index
ดัตช์	هولندي	dutch
ดันแฮม	دنهام	dunham, the mother of barrack obama
ดับเบิลยู	ث.	letter w
ดา	دا	da - a thai nickname
ดาบ	السيف	sward
ดาบเขี้ยวฟ้าฟื้น	سيف الانتقام	sky fang sword of revival
ดารา	نجمة	star
ดารากร	الممثل	darakon
ดาราคู่แรกของไทย	النجم الأول في تايلاند	first movie stars in thailand
ดาราจักร	المجرة	planet in the solar system
ดาราศาสตร์รังสีเอ็กซ์	علم الفلك بالأشعة السينية	xray astronomy
ดาราหญิงไทยยอดนิยม	المشاهير الإناث التايلندية	famous actress
ดาวกระจาย	النجمي	star disperse
ดาวคาโนปุส	كاناباس	canopus star
ดาวพฤหัสบดี	المشتري	jupiter
ดาวพุธ	الزئبق	mercury
ดาวยูเรนัส	أورانوس	uranus
ดาวศุกร์	الزهرة	venus
ดาวอาร์คตุรุส	arcturus	arcturus
ดาวเคราะห์	الكوكب	planet
ดาวเคราะห์แคระ	كوكب قزم	dwarf planet
ดาวเสาร์	زحل	saturn
ดำรงค์	wimax	dumrong - a male's name
ดำรงตำแหน่ง	شغل منصب	hold the title of
ดำรงอ่องตระกูล	عائلة دامرونج أونج	dumrongongtrakul
ดำเนินสะดวก	دامنوين سادواك	damnoen saduak
ดิกชันนารี	القاموس	dictionary
ดิค	ديك	dick - the name
ดิจิตอล	رقمي	digital
ดิน	التربة	soil
ดินเซนฮอฟเฟอร์	زينهوفر	dientzenhofer - as in christoph or leonhard or johannes
ดินแดน	الإقليم	territory
ดิว	الندى	dew - a nickname
ดิวิชั่น	الانقسام	division
ดิศ	القرص	dis (thai first name)
ดิศกุล	ديسكول	disakul (last name)
ดิสนีย์	ديزني	disney
ดิสโพรเซียม	الديسبروسيوم	dysprosium
ดี	جيد	d.
ดีคอนสตรักทิวิสม์	دكونراك تافيست	deconstructivism
ดีน	عميد	religion (islamic term)
ดีบุก	القصدير	tin
ดีเวลลอปเมนท์	التنمية	development
ดีเวลลอปเม้นท์	التنمية	development
ดีเอ็นเอ	الحمض النووي	dna
ดุสิต	دوسيت	dusit
ดูที่	انظروا	see
ดูเพิ่มเติม	شاهد المزيد	see also
ดูเพิ่มเติมที่	انظر أيضًا	see more detail in
ดูเร็กซ์	durex	durex
ดูแล	اعتن بنفسك	take care
ด็อก	كلب	dog
ด้วย	مع	too, also, together, with
ด้วยเหตุนี้	لهذا السبب	for this reason
ด้านการกีฬา	الرياضة	sports
ด้านการต่างประเทศ	الشؤون الخارجية	foreign affairs
ด้านการเกษตร	زراعي	agriculture
ด้านดนตรี	موسيقى	in music
ด้านหน้า	الجبهة	front
ด้านหลัง	الظهر	backside
ด้านอ่าวไทย	خليج تايلاند	gulf of thailand side
ต	يا	a letter from thai alphabet with th sound
ตกรอบที่	تمت إزالته	did not make the cut
ตรงกับวันขึ้น	تطابق	on the date of
ตรงกับวันที่	تاريخ المباراة	on the date of _______________
ตระกูล	عشيرة	family
ตระกูลนารา	عائلة نارا	nara lineage
ตระกูลปาร์ค	حديقة العشيرة	park family (korean last name)
ตระกูลยามานากะ	عائلة ياماناكا	yamanaka clan
ตระกูลอินุซึกะ	عائلة إنوزوكا	inu-tsuka family
ตระกูลเซนจู	عائلة سنجو	chen ju dynasty
ตรัง	ترانج	trung province
ตรางู	ثعبان	snake brand
ตราด	ترات	trad state
ตรานี้	هذا الختم	this seal
ตราสัญลักษณ์	الشعار	symbol
ตรึงใจ	فتن	truengjai
ตรุษจีน	العام الصيني الجديد	chinese festival
ตลาด	السوق	market
ตลาดโลตัส	سوق اللوتس	lotus market
ตอน	الحلقة	edition number
ตะกร้อ	takraw	takraw
ตะกั่ว	الرصاص	copper
ตะละภัฏ	طلبات	talaput - a surname
ตะลุยอวกาศ	space dabble	space trek
ตะวันทอแสง	شروق الشمس	tawanthosaeng
ตะวันออก	الشرق	east
ตะวันออกเฉียงเหนือ	الشمال الشرقي	east
ตันติเวชกุล	tantivejkul	tuntivetchakul - a surname
ตัว	الجسم	body
ตัวพระ	بطل الرواية	main character
ตัวยักษ์	عملاق	giant
ตัวละคร	الشخصية	character
ตัวละครจากเรื่อง	الشخصيات من القصة	soap opera based on a written story
ตัวลิง	قرد	monkey
ตัวสะกด	تهجئة	final consonant
ตัวหาร	المقسوم	divisor
ตัวอย่าง	مثال	example
ตัวอย่างคำบาลี	مثال بالي	bali example words
ตัวอย่างคำประพันธ์	عينة الآية	sample writing
ตัวอย่างต้นแบบแรก	المثال الأول للنموذج	holotype
ตัวอย่างภาพยนตร์	مقطع دعائي لفيلم	movie trailer
ตัวอย่างเช่น	على سبيل المثال	for example
ตัวเลขอย่างเป็นทางการ	الأرقام الرسمية	formally number
ตัวแปร	متغير	variable
ตั้งงี่สุ่น	تانغ نجون	tang ngee soon
ตั้งอยู่ที่	تقع في	located
ตั้งอยู่เลขที่	تقع في	at house number
ตั๊กแตน	جندب	grasshopper
ตา	العين	ta (a person's name)
ตาคลี	تخلي	ta-klee
ตามตัวสวมเครื่องประดับต่าง	كما كان يرتدي زخارف مختلفة	accessories
ตามตำราพรหมชาติฉบับหลวง	وفقا لكتاب براهما الملكي	by royal botanic manual/handbook
ตาระวา	التراوة	square yard
ตาราง	الطاولة	table
ตำนานวายุสลาตัน	أسطورة العاصفة	shippuden
ตำนานแฝงคำสอน	التعاليم الأسطورية	tales
ตำบลกระเทียม	قضاء الثوم	garlic district
ตำบลกังแอน	منطقة جانج آن	ung gan district
ตำบลตาเมียง	منطقة تا ميونغ	tambon tameung
ตำบลนางแล	منطقة نانجلاي	nang lae province
ตำบลนาดี	ناحية نادي	na dee district
ตำบลบ้านกง	منطقة بان كونغ الفرعية	tambon bankong (name of the district)
ตำบลยะวึก	حي يواك	tambon yawuek
ตำบลระแงง	حي راهانغ	ra-ngang district
ตำบลสังขะ	sangkha	thambol sangka
ตำบลเมืองบัว	قضاء بوا	muangbua district
ตำบลโพนครก	فون ناكورن	tambon poncrok
ตำบลไพรขลา	ناحية فراى خلة	phrai khla subdistrict
ติณสูลานนท์	tinsulanon	thinasulanon
ติอามัต	تيامات	tiarmut
ตี๋ใหญ่	المحملة الكبيرة	ti yai
ตึก	المبنى	building
ตุรกี	تركيا	turkey
ตุลาคม	أكتوبر	october
ตุ๊กแก	زغة	gecko
ตูน	كارتون	toon
ต่อกันด้วยพันธะ	تواصل مع السندات	linked by bond
ต่อจาก	تواصل من	resulting from
ต่อมา	لاحقًا	later
ต่อมาวันที่	التاريخ التالي	later on the date
ต่อมาในปี	في وقت لاحق من العام	later in the year
ต่อมาในรัชกาลที่	في وقت لاحق في الحكم	afterwards, in the reign of
ต่อมาในสมัยกรุงธนบุรีและกรุงรัตนโกสินทร์เขมรตกอยู่ภายใต้การควบคุมของจักรวรรดิสยามอย่างเข้มงวด	في وقت لاحق ، في فترات thonburi و rattanakosin ، كان الخمير تحت السيطرة الصارمة للإمبراطورية السيامية.	later in thonburi period and rattanakosin period
ต่าง	مختلفة	different, various
ต่างๆ	مختلف	various, different
ต้น	البداية	medication for multi-symptoms
ต้นตอจักรวาลวิทยา	علم الكونيات	cosmogony
ต้นสกุล	جنس	clan
ถนน	الطريق	street
ถนนคนเดิน	شارع مشي	kon dern road
ถนนประชาธิปก	طريق الديمقراطية	prachatiphok road
ถนนมิตรภาพ	طريق الصداقة	thanon mittraphap
ถนนสุขุมวิท	طريق سوخومفيت	sukhumvit road
ถมิตรภาพ	الصداقة	mittraphap road
ถวาย	العرض	presented (royal language)
ถึงกระนั้น	مع ذلك	until
ถึงเดือนกรกฎาคม	ليوليو	starting july
ถ้วย	كوب	cup
ถ้อยคำ	الكلمات	accent
ทดลอง	المحاكمة	experiment
ทนงศักดิ์	thanongsak	thanongsak
ทนาย	محامي	lawyer
ทนายความ	محامي	attorney
ทรงคล้ายทรงกลม	كروي	spheroid
ทรงถือหุ้นจำนวน	صاحب السمو يحمل اسهم في	stock ownership
ทรงผนวช	صاحب السمو	ordain
ทรงพระกรุณาโปรดเกล้าโปรดกระหม่อมให้	كرمني	gift (word for the king)
ทรงยี่สิบหน้า	الوجه العشرون	icosahedron
ทรงลูกบาศก์	المكعب	cube
ทรงสี่เหลี่ยมขนมเปียกปูน	المعين	rhombohedron shaped
ทรงสี่เหลี่ยมมุมฉาก	مستطيل	triangular prism
ทรงห้าหน้า	خمسة وجه	polyhedron
ทรงได้รับการทูลเกล้าฯ	استقبل جلالة الملك	the king of thailand gives out ____ to people
ทรัพยากร	الموارد	wealth
ทรัพยากรน้ำ	الموارد المائية	water resources
ทรัพย์วิจิตร	الثروة	sapwichit
ทรัพย์เพิ่ม	أصول إضافية	subpherm
ทรัมเป็ต	البوق	trumpet
ทรีทูวัน	ثلاثة إلى واحد	three.two.one
ทวารหนัก	شرج	anus
ทวีป	القارة	continent
ทวีปอเมริกา	أمريكا	america continent
ทวีปเอเชีย	آسيا	asia
ทวีวัฒน์	thawiwat	taweewan
ทว่า	لكن	however
ทศกัณฐ์	توسكان	ravana
ทศพล	tosapon	thotsaphon
ทหาร	الجندي	soldier
ทหารหน่วยอาเฟลันดราที่	وحدة أفلاندرا العسكرية	afelandra army
ทหารอากาศ	القوات الجوية	air force man
ทอง	ذهب	gold
ทองขาว	ذهب أبيض	thongkhao
ทองประสม	ذهب	thongprasom
ทองผาภูมิ	ثونغ فا بوم	thong pha phum
ทองหยอด	أوراق الذهب	a type of thai dessert
ทองหล่อ	ثونجلور	gold
ทองเจือ	ذهب مزينة بالذهب	tong jea - a surname
ทองแดง	نحاس	copper
ทองใหญ่	ذهب كبير	tong yai - a name
ทอม	توم	tom
ทอมสัน	طومسون	thomson
ทอมัส	توماس	thomas
ทะเล	البحر	ocean, sea
ทะเลทราย	الصحراء	dessert
ทะเลสาบ	البحيرة	lake
ทักษะ	المهارات	skill
ทัช	المس	touch
ทับ	مائل	thon-rammana
ทัพเรือภาคที่	القسم البحري	naval area command
ทัวร์คอนเสิร์ต	جولة حفلة موسيقية	concert tour
ทั่วไป	عام	general
ทั้ง	كلاهما	all
ทั้งหมด	كل	all
ทางทิศตะวันออก	الشرق	east
ทางทิศตะวันออกติดกับเวียดนาม	يحد الشرق فيتنام.	borders vietnam to the east
ทางทิศเหนือติดกับประเทศไทยและลาว	ويحد الشمال تايلاند ولاوس.	borders thailand and laos to the north
ทางน้ำ	طريق الماء	by water
ทางรถไฟ	القطار	rail
ทางหลวงพิเศษ	طريق سريع خاص	motorway
ทางอากาศ	عن طريق الجو	by air
ทางไอทีวี	على itv	via itv ( a television station in thailand)
ทานากะ	تاناكا	tanage - a japanese name
ทาร์ดิกราดา	tardikrada	tardigrada
ทาวเวอร์	البرج	tower
ทำงาน	للعمل	working
ทำนอง	اللحن	melody
ทำบุญตักบาตรฯ	جعل الجدارة وتقديم الطعام للرهبان	put food offerings into a buddhist monk's bowl
ทำหน้าที่	قم بالواجب	task, function
ทำให้	اصنع	made
ทิฆัมพรธีรวงศ์	tikamporn thirawong	timkamporntiravong (thai last name)
ทิพย์	ثيب	thip
ทิฟฟานี่	تيفاني	tiffany - female's name
ทิม	تيم	tim
ทิวานนท์	تيوانون	thiwanon
ทิศตะวันตก	الغرب	west
ที	ت	t.
ทีบีเอส	tbs	tbs
ทีมชาติไทย	منتخب تايلاند	thai national team
ทีมใดที่จำนวนข้อที่ถูกน้อยกว่า	الفريق الذي لديه عدد أقل من	the team with the least correct answers
ทีวีอินไซด์	tv الداخل	tv inside
ทีโอที	توت	tot
ที่จ่ายร้อยละ	هذا يدفع نسبة مئوية	costing
ที่นี้	هنا	here
ที่ประชาชนชอบมากที่สุด	أكثر ما يفضله الناس	people's most favorite
ที่มา	المصدر	source
ที่มี	لقد فعلت ذلك	possess
ที่มีชื่อว่า	مسمى	named
ที่สำคัญ	المفتاح	important
ที่หมายถึง	هذا يعني	explanation
ที่อยู่อาศัย	الإقامة	residence
ที่เกิดขึ้น	حدث ذلك	appear
ที่โดดเด่นคือ	المعلقة	notable
ทุก	كل	every
ทุกครั้ง	في كل مرة	every time
ทุติยจุลจอมเกล้าวิเศษ	السفن	tuthit julajomklawwiset - the title of those you received jewelry from the king
ทุ่งตะโก	ثونغ تاكو	thung tako district
ทุ่งสง	ثونغ سونغ	tong song or nakon sri thamarat state
ทุ่งใหญ่	ثونغ ياي	tungyai
ทู	جدا	to
ทูล	الأداة	thun
ทเวนตี้	عشرون	twenty
ทโกมลบุตร	thongkom لكن	komolbut - a surname
ทไย	لماذا	thayai
ท่องอาณาจักรโฮ่งเหมียว	اقرأ مملكة هونغ مياو	traveling the kingdom of woof-meow
ท่าชนะ	الموقف	thachana
ท่านอิน	ثانين	than in
ท่านอ่อง	أونج	tan ong - a member of the royal family
ท่านอ้วน	رجل سمين	than uan
ท่าน้ำนนท์	الواجهة البحرية	nam non pier
ท่ายาง	ختم مطاطي	tha yang
ท่าศาลา	ثالا سالا	sala pier
ท่าอากาศยานเลย	مطار لويي	loei airport
ท่าเรือ	الميناء	pier
ท่าไม้ตาย	مستوطن	deadly move
ท้องสนามหลวง	سانام لوانغ	sanamloung - a landmark in thailand
ธกรุงไทย	بنك krung thai	krung thai bank
ธกส	baac	bank for agriculture and agriculture
ธกสิกรไทย	بنك كاسيكورن	kasikornbank
ธง	العلم	flag
ธงชัย	ثونغشاي	thongchai
ธงชาติ	العلم الوطني	national flag
ธงธง	العلم	thongthong
ธนบุรี	ثونبوري	thonburi province
ธนพร	ثانابورن	thanaporn
ธนะรัชต์	ثانارات	tanarat -a surname
ธนาคาร	البنك	bank
ธนาคารกรุงศรีอยุธยา	بنك أيودهيا	bank of ayudhya
ธนาคารกรุงไทย	بنك krung thai	krung thai bank
ธนาคารทหารไทย	البنك العسكري التايلاندي	tahanthai bank
ธนาคารทิสโก้	بنك tisco	tisco bank
ธนาคารอิสลามแห่งประเทศไทย	البنك الإسلامي في تايلاند	islamic bank of thailand
ธนาคารเกษตร	البنك الزراعي	farmer's bank
ธนาคารเพื่อการพัฒนาแห่งเอเชีย	بنك التنمية الآسيوي	patana asia bank
ธนาคารไทยพาณิชย์	بنك سيام التجاري	siam commercial bank
ธนิต	ثانيت	thanit
ธปท	بوت	bot
ธรณินทราธิราช	tharawintharathirat	having to do with the king
ธรณีสัณฐานวิทยา	مورفولوجيا التربة	geomorphology
ธรรมนูญ	الدستور	law
ธรรมศักดิ์	thammasak	tamasak - surname of an elected prime minister
ธรรมศาสตร์	جامعة ثمسات	thammasat
ธรรมเมกขสถูป	دارما ماك ستوبا	dhamek stupa
ธานินทร์	ثانين	tanin
ธารทิพย์	ثان ثيب	tarnthip (first name)
ธำมงรค์	ثامرونج	ring
ธิติกานต์	thitikan	thitikan
ธีม	السمة	theme
ธีระ	ثيرا	teera
ธีรเดช	ثيراديج	theeradej
ธุรกิจ	عمل	business
ธุรกิจการบิน	أعمال الطيران	airline business
นก	طائر	bird
นกกระจอก	عصفور	sparrow
นกกระทา	السمان	quail
นกกระทุง	البجع	pelican
นกกระเต็น	الرفراف	kingfisher
นกขมิ้น	كناري	oriole
นกน้อย	الطائر الصغير	noknoi
นกแก้ว	ببغاء	parot
นกแอร์	نوك اير	airline
นครนิวยอร์ก	مدينة نيويورك	new york city
นครปฐม	ناخون باتوم	nakhon pathom
นครพนม	ناخون فانوم	nakhon phanom
นครราชสีมา	ناخون راتشاسيما	nakhon ratchasima
นครสวรรค์	ناخون صوان	nakhon sawan
นครหลวงเวียงจันทน์	فينتيان كابيتال	vientiane
นที	ناتي	natee - a male's name
นปช	udd	three letter acronym
นพจินดา	نوباتشيندا	noppajinda - a surname
นพดล	نوبادون	noppadol - a male's name
นร	طالب	the ancient and auspicious order of the nine gems
นราธิป	ناراثيب	naratip - a male's name of a singer
นราธิวาส	ناراثيوات	narativat state
นวนิยาย	رواية	story
นวรัตน์	نوارات	navaratna
นวล	ناعم	noul -  a name
นอกจาก	الى جانب ذلك	other than, to exclude
นอกจากนี้	بالإضافة إلى ذلك	furthermore
นอกจากนี้แล้ว	الى جانب ذلك	besides
นอกเหนือจากนี้	بصرف النظر عن هذا	moreover
นอนไม่หลับ	لا أستطيع النوم	insomnia
นอร์ส	نورس	norse
นะงะซะกิ	ناغازاكي	nagasaki
นะโม	نامو	namo
นักดนตรี	موسيقي	musician
นักบินของออร์บ	طيار أورب	orb pilot
นักบินอวกาศ	رائد فضاء	astronaut
นักปรัชญา	الفيلسوف	philosophist
นักพากย์	ممثل صوت	voice actor
นักมวย	بوكسر	boxer
นักร้อง	المغني	singer
นักร้องชายไทย	المطربين التايلانديين	thai male vocalist
นักร้องนักดนตรี	موسيقي مغني	singer, musician
นักร้องเพลงไทยสากลชาย	المغني التايلاندي العالمي	male thai pop singer
นักร้องเสียงหลัก	المنشد الرئيسي	lead singer
นักวิชาการ	أكاديمي	i was in for.
นักวิทยาศาสตร์	العالم	scientist
นักศึกษาวิชาทหาร	طالب عسكري	army reserve force students
นักสู้อันดับ	مقاتلة مصنفة	fighter rank
นักเขียน	الكاتب	writer
นักเขียนการ์ตูน	رسام الكاريكاتير	cartoonist
นักเต้นนำ	راقصة رئيسية	dancers
นักเศรษฐศาสตร์	اقتصادي	economist
นักแต่งเพลง	الملحن	songwriter
นักแสดง	الفاعلون	actor/actress
นักแสดงพิธีกร	الممثل	presenter of the show
นักแสดงรับเชิญ	ممثل مدعو	guest star
นัดกับนัด	موعد مع	nut kab nut - a thai sitcom
นันทนาการ	الاستجمام	recreation
นันทนาคร	nanthanakorn	nantanakorn
นันทเสน	نانتهاسين	nanthasen
นันทไกร	نانتاكراي	nandhakrai
นับตั้งแต่เริ่มก่อตั้งจนถึงปัจจุบัน	منذ التأسيس حتى الوقت الحاضر	from the foundation up to the present
นัยนา	القياس	naiyana
นั่นคือ	هذا هو	that is
นั่นเอง	أكيد	that is
นั้น	ذلك	that
นา	الميدان	na
นากา	النجا	naga
นากิ	ناجي	nagi
นาคหิรัญกนก	ناك هيرانكانوك	nakhirunkanok
นางงามจักรวาล	ملكة جمال الكون	ms. universe
นางสาวสุวรรณ	ملكة جمال صوان	miss suwan
นางสุพรรณมัจฉา	السيدة سوفان ماتشا	mrs. supanmatja - a character in a thai legend
นางาโตะ	ناجاتو	logo ontario.
นาดี	نادي	na di
นาดูน	nadun	nadune (name of district)
นาทวี	ناثوي	natavee district
นาทาล	الولادة	"exactly: ""natal;""  proper name: natarle"
นาที	دقيقة	minute
นานา	عديدة	nana
นามิ	نامي	nami
นายกรัฐมนตรีของประเทศไทย	رئيس وزراء تايلاند	prime minister of thailand
นายกรัฐมนตรีไทย	رئيس الوزراء التايلاندي	thai prime minister
นายกำพล	السيد كامبون	kamphon
นายชลอ	السيد تشالو	chalo
นายชวน	السيد تشوان	mr. chuan
นายชาญชัย	السيد تشانتشاي	chanchai
นายณรงค์	السيد نارونج	mr. narong - a male's name
นายดำรง	سيد دامرونج	mr dumrong - a male's name
นายทวี	السيد ثاوي	mr.tawee
นายประกอบ	السيد الجمعية	mr. prakob - a male's name
นายปรีชา	السيد بريشا	mr.preecha
นายปรีดี	السيد بريدي	pridi - a male's name
นายยงยุทธ	السيد yongyut	mr. yongyut - a male's name
นายศักดา	سكدة	sakda
นายสมชัย	السيد somchai	mr. somchai
นายสมัคร	مقدم الطلب	mr. samak - a thai name
นายสวัสดิ์	السيد سوات	sawat
นายสุชาติ	السيد سوخارت	mr. suchat
นายสุนทร	السيد سونثورن	mr. soontorn - a male's name
นายแพทย์	دكتور	male doctor
นารูโตะ	ناروتو	naruto - a japanese cartoon
นาวาอากาศเอกหญิง	كابتن المرأة	woman airforce captain
นาฬิกา	الساعة	clock
นาโนเทคโนโลยี	تقنية النانو	nanotechnology
นำกลับมาสร้างใหม่อีกครั้ง	أعاد لإنشاء مرة أخرى	remake (of an old movie)
นำแสดงโดย	بطولة	performed by
นำโดย	بقيادة	led by
นิกาย	قسم	sect
นิกเกิล	نيكل	nickel
นิคมพัฒนา	نيكوم phatthana	nikhom phatthana
นิตยสารชีวจิต	مجلة المثلية	cheewajit magazine
นิตยสารเอเชียวีก	مجلة أسبوع آسيا	asiaweek magazine
นิตโย	نيتايو	nittayo
นิทาน	حكايات خرافية	tales
นิยม	شائع	niyom, name of a thai country music singer
นิยมจัดขึ้นในเดือน	عقد الشعبية في الشهر	usually held in the month of
นิยาม	التعريف	symbols
นิรมิต	الحلم	niramit
นิรันดร์กุล	نيرونكون	nirankun
นิรุกติศาสตร์	علم أصل الكلمة	philology
นิลภิรมย์	نيلفيروم	nipinpirom - a surname
นิวคลีโอไทด์	النوكليوتيد	nucleotide
นิวยอร์ก	نيويورك	new york
นิวัฒน์	newwat	niwat
นิวเคลียร์	النووية	nuclear
นิวเคลียส	النواة	nucleus
นิฮง	نيهونج	nippon or nikon, a japanese reading language
นิเทศศาสตรบัณฑิต	ليسانس الآداب	communication major graduates
นิ่ม	ناعم	pangolin
นิ่มสกุล	نيم ساكول	nimsakun
นีโอ	الجدد	neo
นี่คือ	هذا هو	this is
นุช	الفرح	nucth
นเรศ	ناريس	naret - a male's name
นโยบายทางการทูตของจีน	السياسة الدبلوماسية للصين	china;s foreign policies
น็อกซ์	نوكس	left.
น้องครีม	كريم نونج	nong kreme - a nickname of someone in thai entertainment
น้องชาย	الأخ الأصغر	brother
น้อยมาก	قليل جدا	noimak
น้ำ	الماء	water
น้ำค้าง	الندى	namkhang
น้ำดื่ม	مياه الشرب	beverages
น้ำท่วม	الفيضان	flooding
น้ำฝน	مياه الأمطار	rainwater
น้ำพอง	قابل للنفخ	nam pong in kon kan province
น้ำมะนาว	عصير ليمون	lemonade
น้ำมัน	زيت	oil
น้ำมันสน	التربنتين	oil of turpentine
น้ำยืน	مياه راكدة	numyeen - location in ubolthani state
น้ำหนัก	الوزن	weight
บทนมัสการนอบน้อมบูชาพระพุทธเจ้า	فصول العبادة المتواضعة للرب بوذا	a prayer to the lord buddha
บทบาททางการเมือง	الدور السياسي	politic
บทสวดบาลีที่ขึ้นต้นด้วยอรหัง	البالي يهتف الذي يبدأ مع أرهات	"pali mantra started with ""arhat"""
บทสวดสรภัญญะที่ขึ้นต้นด้วยธรรมมะคือ	هتافات sorapanya التي تبدأ بالدارما هي	a buddhist prayer
บนบก	على الأرض	on land
บรมนาถชาติอาชาวศรัย	borommanachat achan sai	something has to do with the king - too obscure
บรมนาถบพิตร	بورومنات بوفيت	borommanatbophit
บรรณาธิการ	المحرر	editor
บรรพชีวินวิทยา	علم الحفريات	paleontology
บราซิเลีย	برازيليا	brazilian
บราเธอร์ส	أيها الإخوة	brothers
บริบาล	رعاية	baribal - a famous soccer player
บริพัตร	طعام	paribatra
บริวเวอรี่	مصنع الجعة	brewery
บริสุทธิ์	نقي	pure
บริหารธุรกิจ	إدارة الأعمال	business administration
บริเวณรอบทะเลสาบเขมร	حول بحيرة الخمير	area around the lake in cambodia
บริเวณเขตภูเขาทางภาคเหนือ	المنطقة الجبلية في الشمال	mountain in north of thailand
บรูไน	بروناي	brunei
บลีช	مبيض	bleach
บลู	أزرق	blue
บลูคอสมอส	كوزموس الأزرق	blue cosmos
บลูเบอร์รี่	عنبية	blueberry
บวก	زائد	positive
บวม	تورم	swelling
บวร	إلهي	bawon
บอมบ์	قنبلة	bomb
บอย	فتى	boy
บอยซ์	boyz	boys
บอล	الكرة	ball
บอลด์วิน	بالدوين	baldwin
บอส	الرئيس	boss
บังคลาเทศ	بنغلاديش	bangladesh
บังไค	بانجكاي	bankai
บัณฑิต	خريج	bandit
บัณฑิตวิทยาลัยร่วมด้านพลังงานและสิ่งแวดล้อม	كلية الدراسات العليا المشتركة للطاقة والبيئة	joint graduate school of energy and environment
บันทึก	حفظ	record
บันทึกการสร้างโลก	الرقم القياسي العالمي	genesis diary
บันทึกความทรงจำ	مذكرة	diary
บันเทิง	ترفيه	entertainment
บัว	لوتس	lotus
บัวลอย	bualoy	kind of thai sweetmeat
บัวเชด	زهرة اللوتس	cedric dubois.
บัวใหญ่	بوا ياي	big lotus
บาคคัส	باخوس	bacchus
บาคุกันธาตุไฟ	عنصر حريق باكوجان	dragonoid
บาคุกันลูกน้องของนากา	باكوجان أحد أنصار نجا	bakugan, minion of naga
บางกอกกล๊าส	زجاج بانكوك	bangkok glass
บางกอกน้อย	بانكوك نوي	bangkok noi
บางครั้ง	في بعض الأحيان	sometimes
บางซื่อ	بانج سو	bang see - a location in thailand
บางปะกอก	بانج باكوك	bang prakok - an area in bangkok
บางปะหัน	بانج باهان	a district in ayutthaya province
บางพลัด	bangplad	bangplad
บางส่วน	بعض	some
บางเขน	bangkhen	bang khen
บางแสน	bangsaen	bang saen
บางใหญ่	بانج ياي	bang yai - a location in thailand
บานไม่รู้โรย	قطيفة	gomphrena
บารอมิเตอร์	بارومتر	barometer
บารัก	باراك	barack
บาร์	شريط	bar
บาลี	بالي	vatthu
บาอัล	بعل	baal - a demon in hebrew
บิน	تطير	bin
บิล	الفاتورة	bill
บิ๊กซี	كبير ج	big c
บิ๊กซ้งซุปเปอร์สโตร์	متجر الاغنية الكبيرة	big song superstore
บี	ب.	b
บีช	الشاطئ	beach
บีบี	bb	bb
บีฟเค้ก	كيك لحم	beef cake
บี้	ينهار	flatten
บี้สุกฤษฎิ์	بي سكريت	be- sukasit wisetkeaw - name of a singer
บุคคล	الشخص	person
บุคคลสำคัญ	شخص مهم	vip person, very important person
บุคลิกภาพ	الشخصية	mannerism
บุช	بوش	(george) bush
บุญค้ำ	الجدارة	bunkham
บุญนะโชติ	bunnachot	bunachot - a surname
บุญนาค	الجدارة	boon nak - a famous surname
บุณยเกตุ	بونياكيت	boonyaket
บุตร	الابن	son
บุษบา	بوسابا	busaba - a woman's name
บูมเมอแรง	بوميرانج	boomerang
บ่อทอง	الذهب البركة	bothong
บ้านฉาง	بان تشانج	bahn shang -a  location in thailand
บ้านปราสาท	بيت القلعة	castle house
บ้านผือ	حظر phue	ban phue
บ้านฝันดอตคอม	بان فان كوم	bahnfun.com
บ้านลาด	المنزل	ban lat
บ้านเขว้า	البيت	bahn kaywah, an area in thailand
บ้านแพ้ว	البيت	ban paw
บ้านโพธิ์	حظر pho	bahn po - a location in thailand
ปจ	عام	two letters acronym
ปช	الشاطئ	two letters acronym
ปฏิทินช่อง	تقويم القناة	calendar
ปฏิภาณ	إسبريت	male's name patipan
ปตท	ptt	three letters from thai alphabets
ปทานุกรม	القاموس	encyclopedia
ปทุมธานี	باثوم ثاني	pathum thani
ปภ	الأمن	the order of the direkgunabhorn
ปภัสรา	باباسارا	papatsara
ปม	العقدة	knot
ประกอบด้วย	تتكون من	composed of
ประกอบไปด้วย	يتكون من	included
ประการที่	رقم	point
ประกาศิต	نعلن	command
ประกาศเป็นป่าสงวน	أعلن كمحمية للغابات	preserve area, the protected forest
ประจวบ	تزامن	prachuap
ประจวบคีรีขันธ์	براتشواب خيرى خان	prajoubkirikan state
ประจักษ์	واضح	mr. prajak
ประจำปี	سنوي	annual
ประชากรประมาณ	عدد السكان المقدر	population about
ประชากรศาสตร์	الديموغرافيا	literature subject
ประดิษฐาน	مكان	placed
ประติมากรรม	النحت	production of a play
ประติมากรรมไทย	النحت التايلاندي	thai sculpture
ประตู	الباب	gate
ประตูน้ำ	براتونام	pratunam
ประตูเสีย	باب مكسور	broken door
ประทีป	prateep	continent
ประธาน	الرئيس	president
ประธานกรรมการ	رئيس	chief executive officer
ประธานศาลฎีกา	رئيس المحكمة العليا	president of the supreme court
ประธานสภารัฐสภา	رئيس مجلس النواب	speaker of parliament
ประธานาธิบดี	رئيس	president
ประมาณ	حول	about, estimated to be
ประมาณคศ	حول	christ year
ประมาณปี	حوالي عام	approximately in the year
ประยงค์	prayong	prayong
ประวัติศาสตร์	التاريخ	history
ประวัติศาสตร์สเปน	التاريخ الإسباني	history of spain
ประวัติศาสตร์ไทย	التاريخ التايلاندي	history of thailand
ประสาท	عصبية	castle
ประสิทธิภาพ	الكفاءة	efficiency
ประหยัด	احفظ	thrifty, cheap
ประเด็นที่	القضية	point number
ประเทศ	البلد	country
ประเทศกัมพูชา	كمبوديا	cambodia
ประเทศซูดาน	السودان	sudan
ประเทศทำการค้าขายกับต่างประเทศมากยิ่งขึ้น	الدول التي تمارس المزيد من التجارة مع الدول الأجنبية	country that trades with other countries
ประเทศนอร์เวย์	النرويج	norway
ประเทศฝรั่งเศส	فرنسا	france
ประเทศพม่า	ميانمار	burma
ประเทศฟินแลนด์	فنلندا	finland
ประเทศภูฏาน	بوتان	bhutan
ประเทศมาเลเซีย	ماليزيا	malaysia
ประเทศราช	الدولة الملكية	vassal state
ประเทศลาว	لاوس	laos
ประเทศสวีเดน	السويد	sweden
ประเทศสเปน	إسبانيا	spain
ประเทศอียิปต์	مصر	egypt
ประเทศเกาหลี	كوريا	korea
ประเทศเกาหลีใต้	كوريا الجنوبية	south korea
ประเทศเนปาล	نيبال	nepal
ประเทศเปรู	بيرو	peru
ประเทศเม็กซิโก	المكسيك	mexico
ประเทศเวียดนาม	فيتنام	vietnam
ประเทศแคนาดา	كندا	canada
ประเทศและดินแดน	البلدان والأقاليم	natoin and territory
ประเทศไทย	تايلاند	thailand
ประเพณีชักพระ	تقليد تشاك فرا	chak phra festival
ประเภท	نوع	category
ประเภทของ	نوع	type of
ประเภทรายการแข่งขันชิงรางวัลดีเด่น	فئة الجائزة مسابقة متميزة	award show for
ประโยค	الجملة	sentence
ปรัชญา	الفلسفة	philosophy
ปรัชญาตะวันตก	الفلسفة الغربية	western philosophy
ปรากฏการณ์โลกร้อน	الاحتباس الحراري	global warming
ปรากฏตัวตอนแรกในตอน	ظهر لأول مرة في حلقة	first appear in
ปรากฏตัวในตอน	ظهر في	showing their presence
ปราจีนบุรี	براتشينبوري	prachin-buri
ปราบดาภิเษก	توج	prapdapisek
ปราสาทเขาพระวิหาร	معبد برياه فيهير	kao pravihan ancient ruins
ปราโมทย์	براموت	pramot
ปริญ	برين	parin
ปริญญา	الدرجة	degree
ปริภูมิ	الفضاء	3 dimensions
ปริมาณการผลิต	حجم الإنتاج	capacity
ปริศนา	لغز	puzzle
ปริ๊นซ์	الأمير	prince
ปรีดา	فرحة	prida - a male's name
ปรีดี	pri	pridi
ปลา	سمكة	fish
ปลาบู่ทอง	جولدن جوبي	goldfish
ปลาปอมปาดัวร์	بومبادور	pompadour
ปลาย	النهاية	at the end
ปลายคริสต์ศตวรรษที่	أواخر القرن التاسع عشر	late century
ปลาในสกุลนี้เรียกว่า	تسمى الأسماك في هذا الجنس	the fish in this family is called _________
ปลิงทะเล	خيار البحر	sea cucumber
ปล่อย	الافراج	release
ปวดข้อ	آلام المفاصل	joint pain
ปวันรัตน์	باوانرات	pavunnarat - a surname
ปวีณา	باوينا	paweena
ปักกิ่ง	بكين	beijing
ปักธงชัย	باك ثونغ تشاي	pakthongchai
ปัจจุบัน	الحالي	at present
ปัจจุบันนี้	الآن	presently
ปัจจุบันประเทศไทยมีภาพยนตร์ที่มุ่งสู่ตลาดโลก	في الوقت الحاضر ، تايلاند لديها أفلام موجهة إلى السوق العالمية.	currently thailand has international movies
ปัจจุบันมีที่นั่งอยู่ในสภาผู้แทนราษฎร	يوجد حاليا مقعد في مجلس النواب	presently have elected representatives
ปัจจุบันเลิกเขียนแล้ว	حاليا لم تعد الكتابة	presently retired from writing
ปัญจาบ	البنجاب	panjab
ปัญโญภาส	بانوباس	panyopat - a surname
ปัน	شارك	pan
ปั้น	العفن	clay molding
ปั๊บ	على الفور	pup
ปาก	الفم	mouth
ปากดี	فم جيد	be talkative
ปากน้ำ	مصب	samutpragan province in thailand
ปากีสถาน	باكستاني	country of pakistan
ปากเกร็ด	باك كريت	pak kret
ปากแม่น้ำสิงคโปร์	فم سنغافورة	singapore river delta
ปาน	مثل	pan - a thai name
ปานามา	بنما	panama
ปานแร่	الوحمات	panrae
ปาย	باي	pai
ปาริชาต	باريشات	tiger’s claw
ปารีส	باريس	paris
ปาร์ค	بارك	park
ปาสกาล	باسكال	pascal - computer language or name
ปาเลสไตน์	فلسطين	palestine
ปิปเปอราซิลลิน	بايبر اسيلين	piperacillin
ปิยะพงษ์	piyapong	piyapong
ปิ่นเกล้า	بينكلاو	pin glow - an area in thailand
ปีคศ	عام	christain era
ปีจอโทศก	عام الخنزير	year of the dog
ปีที่	عام	the year
ปีที่วางจำหน่าย	سنة الإصدار	the year that the product was on the market
ปีพุทธศักราช	عام بوذي	buddhism year
ปีย์	عام	pe - a thai music artist
ปีย์ชนิตว์	piyachit	peechanit
ปีเตอร์	بيتر	peter
ปี่กลาง	الكيس الأوسط	a thai woodwind instrument
ปืนพก	مسدس	handgun
ปืนพกกึ่งอัตโนมัติ	مسدس نصف آلي	semi-automatic pistol
ปืนใหญ่	مدفع	cannon
ปืนใหญ่กลางกระสุนวิถีโค้ง	منحنيات مسار المدفع المتوسطة	cannon
ปืนไร้แรงสะท้อนถอยหลัง	مسدس الارتداد	recoilless rifle
ปุณณกันต์	punnakan	bhunnagun
ปุตราจายา	بوتراجايا	putrajaya
ปุ๋ย	سماد	pui
ปู	كراب	crab
ป่าชายหาด	غابة الشاطئ	beach forest
ป่าชายเลน	غابة المنغروف	mangrove forest
ป่าดิบแล้ง	غابة دائمة الخضرة جافة	dry evergreen forest
ป่าเบญจพรรณ	غابة مختلطة	mixed forest
ป่าโกงกาง	غابة المنغروف	mangrove
ป๊อป	موسيقى البوب	pop
ป๊อปปี้	الخشخاش	poppy
ผจญภัยเกาะมหาสมบัติ	مغامرة جزيرة الكنز	nobita's south sea adventure
ผดุง	الدعم	phadung
ผล	النتيجة	result
ผลการแข่งขัน	نتائج المسابقة	result of competition
ผลงานหนังสือ	محفظة الكتاب	publication
ผลงานเพลง	موسيقى	song production
ผลงานโฆษณา	الإعلان	marketing project
ผลประเสริฐ	نتائج ممتازة	polpasert - last name of the 2nd wife of the thai prince
ผลผลิตพลอยได้	المنتجات الثانوية	result, effects
ผลรวม	المجموع	summation
ผลสำรวจ	نتائج المسح	survey results
ผิวขาว	بشرة بيضاء	white
ผิวสี	لون البشرة	skin color
ผี	الشبح	ghost
ผีน่ารัก	شبح لطيف	cute ghost
ผู้กำกับ	مدير	producer
ผู้จัดการ	المدير	manager
ผู้จัดการทีม	مدير الفريق	manager
ผู้ชนะ	الفائز	winner
ผู้ชาย	رجل	male, man
ผู้ช่วยศาสตราจารย์	أستاذ مساعد	assistant professor
ผู้ดำเนินรายการ	مشرف	moderator
ผู้บริหาร	تنفيذي	manager
ผู้ผลิต	الشركة المصنعة	producer
ผู้ฝึกสอน	مدرب	trainer
ผู้พิทักษ์แห่งพิรุณ	الوصي على المتاعب	rain defender
ผู้พิทักษ์แห่งอรุณ	وصي الفجر	guardian of the dawn.
ผู้ว่าการธนาคารแห่งประเทศไทย	محافظ بنك تايلاند	governor of the bank of thailand
ผู้ว่าราชการจังหวัด	الحاكم	the governor of the city
ผู้สนับสนุน	مؤيد	supporter
ผู้อำนวยการ	المخرج	superintendent
ผู้เล่น	اللاعبون	player
ผู้เล่นชุด	تعيين لاعب	team
ผู้ใหญ่	شخص بالغ	adult
ผ่องศรี	فونغسري	pongsri
ผ้าขาวม้า	مئزر	a special thai cloth that men used to tie around their waists
ผ้าอนามัยโซฟี	المناديل الصحية صوفي	sofi sanitary napkin
ฝ	إن	a letter with ph sound
ฝอยทอง	الزغب	foythong - a thai dessert
ฝิ่น	الأفيون	opium
ฝูงชนวุ่นวาย	الحشد الفوضوي	mob
ฝ่ามือ	النخيل	palm
ฝ่ายบริหาร	الإدارة	executive branch
ฝ่าเท้า	وحيد القدم	sole of foot
ฝ่าแดนเขาวงกต	من خلال المتاهة	in the boundaries of kao wonkut
ฝ้าย	قطن	fai
พ	ت	a thai alphabet
พงศ์ศิลป์พิพัฒน์	pongsilp phiphat	pongsinpipat
พงศ์เรืองรอง	pongrueangrong	"surname ""pong reuang-rong"""
พงษ์พานิช	pongpanich	phongphanit
พงษ์เพชร	فونج فيت	phong phet
พงษ์ไพบูลย์	فونجيبون	pongphatboon
พจนานุกรมออนไลน์	قاموس على الإنترنت	online dictionary
พญา	الثعبان	phaya
พญามังราย	فايا مانجراي	mangrai the great
พตท	المنطقة	three letters acronym
พธม	ث	people's alliance for democracy
พนมไพร	فانوم فراي	phanom phrai
พบหลักฐานของมนุษย์ซึ่งมีอายุเก่าแก่ที่สุดถึงห้าแสนปี	العثور على دليل على وجود البشر ، أقدم حتى خمسمائة ألف سنة	found an evidence of the the oldest human that lived in that area
พยัญชนะ	متناغم	consonant
พยัญชนะสะกดควบกล้ำ	الحروف الساكنة	diphthong's consonant
พยางค์	مقطع	syllable
พยาธิกำเนิด	إمراضية	pathogenesis
พยาธิวิทยา	علم الأمراض	pathology
พยาบาล	ممرضة	nurse
พยายามชี้ให้สาธารณชนและนานาชาติ	في محاولة للإشارة إلى الجمهور والدولي	encourage to promote the people and international policies
พร	الإباحية	wishes
พรนารายณ์	ناراي	phonnarai
พรบ	فعل	act
พรรคการเมืองใหม่	حزب سياسي جديد	kan mai meung political party
พรรคชาติไทย	مخطط الحزب التايلاندي	thai nation party
พรรคธรรมาธิปัตย์	حزب الثامات	tamatipat political party
พรรคประชาธรรม	حزب prachatham	prachatam political party
พรรคภูมิใจไทย	حزب phuea التايلاندية	bhumjaithai party
พรรคสม	حزب المعادلة	som rangsi political party
พรรคสังคมประชาธิปไตย	الحزب الاشتراكي الديمقراطي	social democratic party
พรรคเพื่อแผ่นดิน	حزب فيو التايلاندي	puea pandin party
พรอุดมศักดิ์	phonudomsak	pornudomsak (last name)
พระคาถาชินบัญชร	التعويذة chinnabanchon	chinbanchon
พระจันทร์	القمر	moon
พระจันทร์สีรุ้ง	القمر قوس قزح	phrachan sirung
พระชนม์	الحياة	the father of the king
พระตำหนัก	قصر	the king's residence
พระที่นั่งจักรพรรดิพิมาน	قصر الإمبراطور فيمان	chakraput piman hall
พระที่นั่งดุสิตมหาปราสาท	قاعة دوسيت مها براسات العرش	phra thinang dusit maha prasat
พระที่นั่งบรมพิมาน	قصر بورومفيمان	the king's seat
พระธรรมปิฎก	dhammapitaka	phra thampidok
พระธิดา	ابنة	daughter
พระนคร	رأس المال	phra nakhon
พระนาม	الاسم	name of the king
พระนามต้นราชสกุล	الاسم الأول	the first person in the dynasty
พระนารายณ์	فيشنو	narayana
พระบรมธาตุไชยา	بقايا بوذا	buddha's relics chaiya
พระบรมราชชนก	رعاية الملكية	the king's sister
พระบรมราชินี	الملكة	queen
พระบรมวงศานุวงศ์	الملوك	members of the royal family
พระบาทสมเด็จพระนั่งเกล้าเจ้าอยู่หัว	الملك نانغ كلاو	jessadabodindra
พระบาทสมเด็จพระปกเกล้าเจ้าอยู่หัว	الملك برجاديبوك	phrabat somdet phra poramintharamaha - 7th king of thailand
พระบาทสมเด็จพระปรเมนทรมหาอานันทมหิดล	جلالة الملك بوميبول أدولياديج مها أنانداماهيدول	phra bat somdet phra poramentharamaha ananda mahidol
พระบาทสมเด็จพระพุทธยอดฟ้าจุฬาโลก	فرا بوذا فرا يوت فا ، شولالونغكورن	king rama 1 of chakri monarchy (bangkok)
พระบาทสมเด็จพระเจ้าอยู่หัวภูมิพลอดุลยเดชทรงพระกรุณาโปรดเกล้าฯ	صاحب الجلالة الملك بوميبول أدولياديج يسعده	the current king of thailand
พระบาทสมเด็จพระเจ้าอยู่หัวอานันทมหิดล	الملك أناندا ماهيدول	king ananda mahidol
พระบาทสมเด็จพระเจ้าอยู่หัวเสด็จฯ	جلالة الملك	the current king
พระปกเกล้าเจ้าอยู่หัว	الملك برجاديبوك	king rama vii
พระประแดง	فرا براداينج	prapadaeng
พระปรางค์สามยอด	برانغ سام يوت	prapang samyod
พระพรหมคุณาภรณ์	phra prom khunaporn	pra prhom kunaporn - a person in thailand
พระพันปีหลวง	ميلينيوم لوانج	queen mother
พระพันวัสสาอัยยิกาเจ้า	فرا فانواسا آيا	pra paunvatsaeyyigajao - name of a monk
พระพุทธชินราช	فرا بوذا chinnarat	phra buddha chinnarat
พระพุทธบาท	بصمة بوذا	phra phutthabat
พระพุทธศาสนา	البوذية	buddhism
พระมงกุฏเกล้าเจ้าอยู่หัว	الملك راما الرابع	phra mongkut klao chao yu hua
พระมเหสี	القرين	the wife of a king
พระยศขณะนั้น	في ذلك الوقت	the current title
พระยาชัยสุนทร	فرايا تشاي سونثورن	praya chaisoontorn - first mayor of thailand
พระยาราม	فرايا رام	prayaram - the governor of sukothai city (the ancient city of thailand)
พระยาวิเศษภักดี	فرايا ويسيتفكدي	praya wiset pakdi -a  name of a head of state in the ancient time
พระยาสุนทรสงคราม	فرايا سونثورن سونغكرام	phraya sonthornsongkram (thai name)
พระยาไกรภักดีศรีนครลำดวน	فرايا كرايفيكدي سريناكون لامدوان	phraya kraiphakdi sinakhon lamduan
พระราชกรณียกิจ	الواجبات الملكية	royal duties
พระราชลัญจกรประจำพระองค์	الختم الملكي	the king's body guard
พระราชวงศ์	العائلة المالكة	royal family
พระราชวรวงศ์เธอ	العائلة المالكة	the title of the princess
พระราชวังดุสิต	قصر دوسيت	dusit palace
พระราชวังเดิม	القصر الأصلي	phra racha wang derm
พระลอ	فرا لور	phra lo
พระสมเด็จจิตรลดา	فرا سومديج تشيترالادا	pra jitlada - something that was built by the king
พระสัมมาสัมพุทธเจ้า	اللورد بوذا	buddha
พระองค์เจ้าสิริวัณณวรีนารีรัตน์	صاحبة السمو الملكي الأميرة سيريوانواري	the name of one of the king's granddaughter
พระอังสาเบื้องซ้ายประดับเหรียญรัตนาภรณ์	تميمة بوذا الميمونة على الجانب الأيسر ، مزينة بقطع نقدية من راتانابورن	diagonal sash for the princess
พระอัษฎามหาเจดีย์	فرا اسادا مها شيدي	(royal name/language)
พระอิศวร	شيفا	the god shiva
พระอิสริยยศ	لقب ملكي	given rank or honor by the monarchy
พระอุโบสถ	معبد بوذي	the temple
พระเกียรติยศ	شرف	royal honour
พระเจ้าลูกยาเธอ	طفل الله	the royal princess
พระเจ้าหลานเธอ	الله ابنة أختك	hmh princess
พระโคตมพุทธเจ้า	تميمة بوذا	pra kotomputtachao - another name of buddha
พรานกระต่าย	صياد	prankatai - an area in thai province
พราหมณ์	البراهمة	brahman
พริกหยวก	فلفل حلو	a type of thai pepper
พริกหวาน	فلفل حلو	sweet pepper
พริกไทย	فلفل	thai pepper
พฤกษศาสตร์	نباتي	botany
พลตรี	القوات الجوية	major general
พลตรีหญิง	القوات الجوية النسائية	a female officer
พลตำรวจเอก	الشرطة العامة	police general
พลทหาร	الجندي	first class, enlisted men
พลศักดิ์	polsak	polsak
พลอย	الأحجار الكريمة	ploy
พลอสนธิ	تقاطع بولسون	sonthi - a famous thai army officer
พลอากาศเอกหญิง	أنثى acm	air chief marshal
พลฯ	عام	private
พลังงานคลื่น	قوة الموجة	wave power
พลังงานนิวเคลียร์	الطاقة النووية	nuclear power
พลังงานลม	طاقة الرياح	wind power
พลังงานไฟฟ้า	الطاقة الكهربائية	electrical energy
พลัส	زائد	plus
พลาซา	بلازا	plaza
พลาสติก	بلاستيك	plastic
พลาสมา	بلازما	plasma
พลเรือเอก	أميرال	admiral
พลเอกสนธิ	الجنرال سونثي	sonthi - a thai army officer
พวกสัตว์ลำตัวกลม	حيوانات الجسم المستديرة	animals with no backbones
พศ	الجمعة	b.e.
พอ	كفى	col.
พอตเตอร์	بوتر	potter
พอตเตอร์กับเจ้าชายเลือดผสม	بوتر والأمير نصف الدم	(harry) potter and the half-blood prince
พอยท์	نقطة	point
พอล	بول	paul
พัชรี	phachari	pacharee - a female's name
พัฒน์ชัย	phatchai	pattachai - a male's name, famous singer
พัทยาเหนือ	شمال باتايا	north pattaya
พัทยาใต้	جنوب باتايا	south pattaya - in thailand
พัน	الف	pan
พันธมิตร	شريك	alliance
พันธุศาสตร์	علم الوراثة	genetic
พันธุ์พืช	الأنواع النباتية	seed
พันธุ์สุนัข	سلالة الكلاب	dogs
พันธเสน	بوند	panthasen (thai last name)
พับลิชชิ่ง	نشر	publishing
พัลซาร์	بولسار	pulsar
พากย์เป็น	يطلق عليها اسم	subtitle
พายุ	العاصفة	storm
พารา	الفقرة	parasetamol - a drug
พารามีเซียม	معلمة	paramecium
พาร์ค	بارك	park
พาวเวอร์บาย	شراء الطاقة	power buy
พาเมล่า	باميلا	pamela
พิชัย	فيتشاي	pichai
พิชิต	قهر	phichit
พิณ	القيثارة	harp
พิธีกรรายการ	المضيف	host
พิบูลมังสาหาร	فيبون مانجشان	pi bul mung sa har (province name)
พิพิธภัณฑสถานแห่งชาติ	المتحف الوطني	thailand meseum
พิพิธภัณฑ์	المتحف	museum
พิม	بيم	type
พิมประภา	فيمرابرا	phimprapha
พิมพ์เล็ก	طباعة صغيرة	small photo frame 1.4 cm x 2.1 cm x 0.5 cm thick
พิมลวรรณ	فيمونوان	pimonvun - the name of a female anchor person
พิรุณ	الفجر	rain water
พิสุทธิ์	رائع	pisut - a male's name
พิออจชา	شاي فيون	piodcha
พิเศษนครกิจ	nakornkit special	pisetnakornkit - a surname
พีท	بيت	pete
พีระมิด	هرم	pyramid
พีระศรี	فيراسري	balcony
พีอีเอ	pia	pea
พี่น้อง	أيها الإخوة	siblings
พี่สาวของ	شقيقة	the sister of ____________
พึ่งสุนทร	الاعتماد على sunthorn	puangsunthorn
พืช	النباتات	plants
พืชที่สำคัญคือ	النباتات المهمة	important plants are ...
พืชไม่มีท่อลำเลียง	نباتات بدون ناقل	plants without tubelike structures
พื้นฐานทางเศรษฐกิจ	الأساس الاقتصادي	base economics
พื้นที่มหาวิทยาลัย	منطقة الجامعة	university area
พุฒตาล	بوتان	puttan
พุทธคยา	بودغايا	bodh gaya
พุทธนิกายเถรวาท	ثيرافادا البوذية	a sect of buddhist religion
พุทธศตวรรษที่	بوذي القرن	buddhist era
พุทธศักราช	العصر البوذي	buddhist era
พุ่มพวง	شجيرة	poompoang - surname of a famous actor
พู่กัน	الرسام	pugun
พ่อขุนรามคำแหง	الملك رامخامهاينج	the leader of sukothai empire
พ่อขุนศรีอินทราทิตย์	الملك intathathit	po kun intarathip - the fist king of thailand
พ่อมด	ساحر	wizard
พ่ายแพ้ให้กับ	خسر	lose to
พ๎ร	مرحبًا	wish
ฟง	فونغ	fong - a chinese name
ฟรานซ์	فرانز	franz
ฟรีดริช	فريدريش	friedrich
ฟรีด้อม	التسلل الحر	freedom
ฟรีแวร์	مجانية	freeware
ฟลายเวท	وزن الذبابة	flyweight
ฟลูวาสแตติน	فلوفاستين	fluvastatin - a drug
ฟอน	فون	von - in german name
ฟอร์ด	فورد	ford
ฟอสฟอรัส	الفسفور	phosphorus
ฟอสเฟต	الفوسفات	phosphate
ฟังพระธรรมเทศนา	استمع للخطب	listen to the gospel
ฟังเพลง	استمع إلى الموسيقى	listen to music
ฟังไจ	استمع إلى خايمي	fungi
ฟัน	الأسنان	tooth
ฟาง	قش	fhang
ฟาน	فان	van - as in the surname
ฟิชเชอร์	فيشر	fisher
ฟินแลนด์	فنلندا	finland
ฟิลิป	فيليب	philip
ฟิลิปปินส์	الفلبين	philippines
ฟิลิปีโน	الفلبينية	filipino
ฟิวชัน	الانصهار	fusion
ฟิสิกส์ดาราศาสตร์	الفيزياء الفلكية	astrophysics
ฟิสิกส์อนุภาค	فيزياء الجسيمات	physic particle
ฟีนิลคีโตนูเรีย	بيلة الفينيل كيتوريا	phenylketonuria
ฟีฟ่าคลับเวิลด์คัพ	كأس العالم للأندية fifa	fifa world cup
ฟุตซอล	كرة الصالات	futsal
ฟุตบอล	كرة القدم	football
ฟุตบอลอาเซียนเยาวชน	كرة القدم للشباب الآسيان	asian youth soccer
ฟุตบอลเอเชียเยาวชน	كرة القدم للشباب الآسيوي	asian football club youth championship
ฟู	كامل	rise up
ฟูจิ	فوجي	fuji
ฟูลส์	كامل	fools
ฟ้อน	ارقص	fon
ฟ้า	أزرق	blue
ฟ้าร้อง	الرعد	thunder
ฟ้าหลัว	الضباب	haze
ภมรมนตรี	bamamon montri	pamornmontri
ภักดี	مخلص	pakdi
ภัณฑิลา	بانثيلا	paktila - first name of a female actress
ภาคกลาง	المنطقة الوسطى	central thailand
ภาคคนแสดง	إظهار	human version
ภาคตะวันตก	المنطقة الغربية	west
ภาคตะวันออกเฉียงเหนือ	المنطقة الشمالية الشرقية	northeast region
ภาคพิเศษ	خاص	special program
ภาควิชาคณิตศาสตร์	قسم الرياضيات	department of mathematics
ภาควิชาพยาธิวิทยา	قسم علم الأمراض	department of pathology
ภาควิชาฟิสิกส์	قسم الفيزياء	physics
ภาควิชาวิศวกรรมเครื่องกล	قسم الهندسة الميكانيكية	engineering division
ภาควิชาวิศวกรรมไฟฟ้า	قسم الهندسة الكهربائية	engineering department
ภาควิชาสูติศาสตร์และนรีเวชวิทยา	قسم أمراض النساء والتوليد	gynecology
ภาควิชาเทคโนโลยีอาหาร	قسم تكنولوجيا الغذاء	faculty of food technology
ภาคเหนือ	الشمال	northern region
ภาคใต้ตอนล่าง	المنطقة الجنوبية السفلى	southern thailand
ภาพตรา	صورة الختم	coat of arms
ภาพถ่าย	الصورة	photograph
ภาพพาโนรามา	بانوراما	panoramic image
ภาพพิมพ์	طباعة الصورة	lithography
ภาพยนตร์	الفيلم	movie
ภาพยนตร์การ์ตูนไทย	فيلم كارتون تايلاندي	thai cartoon
ภาพยนตร์ชุดนี้	تم تعيين هذا الفيلم	this series
ภาพยนตร์ตอน	الحلقة	version of the movie
ภาพยนตร์ลามก	فيلم شرير	porn movie
ภาพรวม	نظرة عامة	group of pictures
ภายหลัง	بعد ذلك	background
ภายหลังสงคราม	بعد الحرب	after the war
ภายใต้ความช่วยเหลือจากกองทุนการเงินระหว่างประเทศ	بمساعدة صندوق النقد الدولي	with the financial help, sponsored by
ภายในวงขอบเหรียญเบื้องบนมีข้อความว่า	داخل الجزء العلوي من العملة هو بيان ذلك	etching in the medal that ______________
ภารกิจ	المهمة	business
ภาวะเศรษฐกิจของกัมพูชาหลังจากมีการเปลี่ยนแปลงการปกครองจากระบอบสังคมนิยมเป็นระบอบประชาธิปไตย	الظروف الاقتصادية لكمبوديا بعد الانتقال من الاشتراكية الديمقراطية إلى الديمقراطية.	cambodia economy after political change
ภาษาญี่ปุ่น	ياباني	japanese language
ภาษาบาลี	بالي	balese language
ภาษาสเปน	اللغة الإسبانية	spanish language
ภาษาอังกฤษ	لغة انجليزية	english language
ภาษาอีสาน	لغة شمال شرق	eastern thai language
ภาษาเกชัว	كيشوا	quechua language
ภาษาเฉพาะอาชีพ	المصطلحات	jargon
ภาษาเบสิก	أساسي	basic programming lauguage
ภาษาเยอรมัน	ألماني	german language
ภาษาโคบอล	كوبول	cobol programming language
ภิญโญ	عظيم	pinyo - a female's name
ภิรมย์	راضية	philom
ภิรมย์ภักดี	فيروم فاكدي	pirompakdee
ภูกระดึง	فوكرادوينج	phu kradueng
ภูกามยาว	فو كام ياو	phu kamyao district
ภูธเนศ	بوتانيت	putanet - a male's name
ภูพาน	فو فان	phu phan
ภูมิประเทศและภูมิอากาศ	التضاريس والمناخ	geography and climate
ภูมิภาค	المنطقة	region
ภูมิรัตน์	بهوميرات	poomirath
ภูหลวง	فو لوانج	phu luang
ภูเขา	جبل	mountain
ภูเขาน้ำแข็ง	جبل جليد	glacier
ภู่สว่าง	فو ساوانج	poosawang - a surname
ม	م	a thai alphabet with an 'm' sound
มกราคม	يناير	january
มจก	م	the most illustrious order of the royal house of chakri
มณฑลหูหนาน	هونان	hunan in china
มณีวรรณ	مانيوان	maniwan
มด	النمل	ant
มดลูก	الرحم	uterus
มต้น	ابدأ	primary level of secondary school
มธ	tu	abbreviation for thammasat university
มธรรมศาสตร์	جامعة ثمسات	thammasat university
มน	الجولة	two letters acronym
มนุษย์	الإنسان	human
มนุษย์กลายพันธุ์	متحولة	human mutant
มนเรศวร	نارسوان	naresuan university
มปท	عقدة	acronyms
มม	مم	mm
มมหิดล	جامعة ماهيدول	mahidol university
มยุรา	مايورا	mayura - a female's name
มลายู	الملايو	malayu
มวยปล้ำ	مصارعة	wrestling
มสงขลานครินทร์	أمير سونغكلا	prince of songkla university
มหัพภาค	كامل	a symbol used in thai writing
มหาชน	عام	public company
มหาชัย	مهاشاي	mahachai - male's name
มหาบัณฑิต	سيد	graduates from college
มหาปรมาภรณ์ช้างเผือก	مها بارامابورن تشانغ فويك	highest class of the order of white elephant
มหาวชิรมงกุฎ	تاج مهافاجيرا	the biggest crown of the king
มหาวรรค	مها بوذا	mahavak - a buddhist priest
มหาวิทยาลัย	الجامعة	university
มหาวิทยาลัยขอนแก่น	جامعة خون كاين	khon kaen university
มหาวิทยาลัยทักษิณ	جامعة ثاكسين	thaksin university
มหาวิทยาลัยนเรศวร	جامعة نارسوان	naresuan university
มหาวิทยาลัยบูรพา	جامعة بورافا	university
มหาวิทยาลัยปทุมธานี	جامعة باثوم ثاني	pathumthani university
มหาวิทยาลัยพะเยา	جامعة فاياو	prayao university
มหาวิทยาลัยภูมินทร์พนมเปญ	جامعة فورين بنوم بنه	university of phnom penh
มหาวิทยาลัยมหาจุฬาลงกรณราชวิทยาลัย	جامعة mahachulalongkornrajavidyalaya	chulalongkorn university
มหาวิทยาลัยมหาสารคาม	جامعة مها ساراخام	mahasarakham university
มหาวิทยาลัยมหิดล	جامعة ماهيدول	mahidol university
มหาวิทยาลัยรังสิต	جامعة رانجسيت	rangsit university
มหาวิทยาลัยราชภัฏบ้านสมเด็จเจ้าพระยา	جامعة bansomdejchaopraya rajabhat	rajapak bahn somdej jao praya college
มหาวิทยาลัยราชภัฏสงขลา	جامعة سونجخلا راجابهات	songkhla rajabhat university
มหาวิทยาลัยราชภัฏสวนสุนันทา	جامعة سوان سوناندا راجابهات	suan sunandha rajabhat university
มหาวิทยาลัยราชภัฏอุตรดิตถ์	جامعة أوتاراديت رجابات	uttaradit rajabhat university
มหาวิทยาลัยราชภัฏเทพสตรี	جامعة ثيباتري رجبابات	thepsatri rajabhat university
มหาวิทยาลัยราชภัฏเลย	جامعة لويي رجبات	loei rajabhat university
มหาวิทยาลัยวงษ์ชวลิตกุล	جامعة wongchawalitkun	vongchavalitkul university
มหาวิทยาลัยศรีนครินทรวิโรฒ	جامعة سريناكارينويروت	srinakarinvirot university
มหาวิทยาลัยศรีปทุม	جامعة سريباتوم	sripatum university
มหาวิทยาลัยศิลปากร	جامعة سيلباكورن	silapakorn university
มหาวิทยาลัยสุโขทัยธรรมาธิราช	جامعة سوخوثاي ثاماتيرات المفتوحة	sukhothai thammathirat open university
มหาวิทยาลัยอีสาน	جامعة شمال شرق	issan univbersity
มหาวิทยาลัยอุบลราชธานี	جامعة أوبون راتشاثاني	ubon ratchathani university
มหาวิทยาลัยอ๊อกซฟอร์ด	جامعة أكسفورد	university of oxford
มหาวิทยาลัยเกษตรศาสตร์	جامعة كاسيتسارت	kasetsart university
มหาวิทยาลัยเทคโนโลยีพระจอมเกล้าพระนครเหนือ	جامعة الملك مونغكوت للتكنولوجيا شمال بانكوك	king mongkut's university of technology.
มหาวิทยาลัยเทคโนโลยีราชมงคลกรุงเทพ	جامعة راجامانغالا للتكنولوجيا كرونثيب	rajamangala university of technology krungthep
มหาวิทยาลัยเทคโนโลยีราชมงคลตะวันออก	جامعة راجامانغالا للتكنولوجيا تاوان أوك	the eastern university of teachnology
มหาวิทยาลัยเทคโนโลยีราชมงคลธัญบุรี	جامعة راجامانغالا للتكنولوجيا ثانيابوري	rajamangala university of technology thanyaburi
มหาวิทยาลัยเทคโนโลยีราชมงคลสุวรรณภูมิ	جامعة راجامانغالا للتكنولوجيا سوفارنابومي	techonology university at rajamongkolsuwannapoom
มหาวิทยาลัยเทคโนโลยีราชมงคลอีสาน	جامعة راجامانغالا للتكنولوجيا إيسان	rajamangala university of technology isan
มหาวิทยาลัยเปิด	الجامعة المفتوحة	open university
มหาวิทยาลัยแม่โจ้	جامعة مايجو	mae joe university
มหาวิทยาลัยแห่งแรกของประเทศไทย	أول جامعة في تايلاند	first university of thailand
มองโกเลียใน	منغوليا الداخلية	mongolia
มอร์ริส	موريس	morris
มอส	الطحلب	mos
มอสส์	الطحلب	moss
มอหาดใหญ่	مور هات ياي	had yai city in southern thailand
มะขาม	تمر هندي	tamarind
มะม่วงหิมพานต์	الكاجو	mango (anacardium occidentale)
มะริด	myeik	myeik
มะเร็ง	السرطان	cancer
มังกี้	قرد	monkey
มังคุด	مانغوستين	mangosteen
มัจฉานุ	ماتشا	majjanu - the son of the giant in a thai legend.  majanu is half monkey and half fish.
มัชฌิมาปฏิปทา	منتصف الطريق	the middle way
มัทนะพาธา	المثنى phatha	matthanaphatha
มัธยฐาน	متوسط	mode (as in statistic)
มัธยมศึกษา	ثانوي	junior high school
มัธยมศึกษาปีที่	الصف	secondary school year
มันติคอร์	مانتيكور	manticore
มัลเจร่า	مليرا	wonderweiss margera - a cartoon character
มากกว่า	أكثر من	more than
มากที่สุด	الأكثر	most abundant
มากิ	ماكي	magi osuki - the artist
มาครอส	macross	macross
มาจยาร์	ميار	magyar
มาจากภาษาละติน	من اللاتينية	from latin root
มาซากิ	ماساكي	masaki
มาดริด	مدريد	madrid
มาตรฐาน	قياسي	standard
มาตรา	القسم	article
มานี	ماني	mani - a thai name
มายน์ส	المناجم	mine
มาริสา	ماريسا	marissa
มาริเบล	ماريبيل	maribel
มาร์ช	مارش	march
มาร์ติน	مارتن	martin
มาร์ตินีก	مارتينيك	martinique
มาร์แชล	مارشال	marshall
มาลัยพร	اباحي الملاي	malaiphon
มาลากุล	malakul	malakul
มาลี	مالي	flower
มาสคาร่า	ماسكارا	mascara
มาเก๊า	ماكاو	macao
มาเฟีย	المافيا	mafia
มาเรีย	ماريا	maria
มาเลเซีย	ماليزيا	malaysia
มาเลเซียตะวันตก	غرب ماليزيا	west malaysia
มิจิรุ	ميتشيرو	mijiru
มิตร	ودود	mitr
มิตรชัย	ميتشاي	mitchai
มิตรเพชรา	ودود	mit pechara - two of famous actors in the old time
มิถุนายน	يونيو	june
มินต์	نعناع	mint
มิลจิ	milji	mulji
มิลตัน	ميلتون	milton
มิลฟีโอเล่	ميلفي أولي	millefiore
มิลลิเมตร	مليمتر	millimeter
มิลินทจินดา	milinthinda	milinjinda - a surname of a singer
มิล่า	ميلة	mila
มิว	ميو	mu
มิวฟิลโอเล่	بغل فيل أولي	millefiore
มิวสิกวีดีโอ	فيديو موسيقي	music video
มิสทีน	ميستين	mistine
มิฮอว์ค	ميهوك	mihawk - surname of a character in a japanese movie
มิเกล	ميغيل	miguel
มิเชล	ميشيل	michelle
มิเตอร์	متر	meter
มิโร	ميرو	miro - name
มีขนาดใหญ่	كبير	big
มีข้อความว่า	المسمى	inscription reads
มีความยาว	لها طول	has length of
มีความหมายว่า	وهذا يعني	meaning
มีจำนวน	لديك رقم	have the amount of
มีฉายาว่า	مع اللقب	famous for...
มีชื่อว่า	مسمى	is called
มีชื่อเล่นว่า	الملقب	nick name
มีด	سكين	knife
มีดาบฟันวิญญาณ	بسيف روح	have a sword to fight the ghost
มีทั้งสิ้น	الكل	own, available
มีทิวเขาล้อมรอบทางเหนือ	مع سلاسل الجبال في الشمال	surrounded by the mountains in the north
มีน	الحد الأدنى	min - a nick name
มีนบุรี	مين بوري	minburi province
มีนวิทยา	مينولوجيا	ichthyology
มีนายกรัฐมนตรี	هل لديك رئيس وزراء	have a prime minister
มีประวัติศาสตร์ยาวนาน	له تاريخ طويل	having a long history
มีพรมแดนทางทิศใต้จรดกับอ่าวไทย	يحدها من الجنوب خليج تايلاند	having boundaries adjacent to the gulf of thailand
มีภูเขาล้อมรอบอยู่	محاطة بالجبال	surrounded by mountains
มีลักษณะดังนี้	لديه الخصائص التالية	has following characteristics
มีลักษณะภูมิประเทศคล้ายชามหรืออ่าง	لديها ميزات مثل وعاء أو حوض	have topography like bowl or basin
มีลาภ	ثروة	milap
มีล่า	احصل على مطاردة	mila
มีสูตรการคำนวณหาจำนวนฟัน	هناك صيغة لحساب عدد الأسنان.	dental formula
มีอยู่	موجود	possess, present
มีอุณหภูมิเฉลี่ย	متوسط درجة الحرارة	average temperature
มีอุทยานแห่งชาติสำคัญหลายแห่ง	هناك العديد من المتنزهات الوطنية الهامة.	has many important national parks
มีเดีย	الوسائط	media
มีโคลซีน	مع مشهد كول	meclozine
มือ	اليد	hand
มู	على نحو سلس	mu
มูลนิธิชัยพัฒนา	مؤسسة تشيباتانا	chaipattana foundation
มูลนิธิอานันทมหิดล	مؤسسة أنانداماهيدول	the king's charities
มูลสาร	الأساسيات	munsan
มเชียงใหม่	شيانغ ماي	chaing mai university
มโนราห์	manohra	thai dance art
ม้า	الحصان	horse
ม้าม	الطحال	spleen
ย	إن	a thai alphabet with the y sound
ยกเว้น	باستثناء	except
ยศ	الرتبة	rank
ยอด	القمة	super, great
ยอดนักสืบจิ๋วโคนัน	المحقق كونان	conan the detective
ยอดเขาสูงที่สุดของกัมพูชาคือ	أعلى قمة في كمبوديا	highest mountain in cambodia
ยอพระกลิ่น	يور فرا كلين	yorpaglin - name of a story
ยัง	ليس بعد	young
ยาขับปัสสาวะ	مدر للبول	diuretic pills
ยาง	المطاط	rubber, tire
ยางธรรมชาติ	المطاط الطبيعي	natural rubber
ยางามิ	ياغامي	yangami
ยานอนหลับ	حبوب منومة	sleeping pills
ยานอวกาศ	سفينة الفضاء	rocket ship
ยาบ้า	الأمفيتامين	ya ba
ยาปฏิชีวนะ	المضادات الحيوية	antibiotic
ยามาโตะ	ياماتو	yamato - a japanese name
ยามาโมโตะ	ياماموتو	yamamoto
ยามเย็น	مساء	sundown, evening time
ยิ่งยง	ينجيونج	yingyong - a first name
ยิ่งลักษณ์	ينجلوك	yingluck
ยิ้มสู้	ابتسم	smile fight
ยีน	الجينات	gene
ยืนยง	تحمل	(inthira) yeenyong - lead singer of budogun band
ยุคกลาง	العصور الوسطى	middle age
ยุคก่อนประวัติศาสตร์	عصر ما قبل التاريخ	prehistory
ยุคที่	عصر	age
ยุคปัจจุบัน	العصر الحديث	present age
ยุคศตวรรษที่	عصر القرن	century
ยุคสามก๊ก	عصر الممالك الثلاث	three kingdoms - the legend
ยุคอะซึกะ	عصر أسوكا	asuka period
ยุคอาณาจักรเหนือใต้	عصر المملكة الشمالية والجنوبية	north-south dynasty
ยุคเรเนสซองส์	عصر النهضة	renaissance
ยุคเฮอัง	عصر هيان	heian period of japan
ยุคโบราณ	العصور القديمة	ancient history
ยุคโลหะ	العصر المعدني	metal age
ยุคใหม่	العصر الجديد	new age
ยุทธนาวี	معركة البحرية	naval battle
ยุวธิดา	ابنة شابة	yuwatidah
ยุ้ย	مبالغ فيه	yui
ยู	ش	u
ยูกิโอ	يوكيو	yu-gi-oh
ยูฟ่า	يويفا	uefa
ยูริ	يوري	yuri -  a japanese name
ยูโด	الجودو	judo
ยูโรเพียม	اليوروبيوم	europium
ยูไนเต็ด	المتحدة	united
ย่านตาขาว	يان خاو	yan ta khao
รณชัย	روناشاي	ronnachai
รณภพ	العالم	ronapop
รณฤทธิ์	معركة	ranariddh
รถด่วนสายทางช้างเผือก	طريق درب التبانة السريع	galactic express
รถประจำทางสาย	خط الحافلات	bus number
รถยนต์อเนกประสงค์	سيارة متعددة الأغراض	automobile
รถลาก	عربة	pulled rickshaw
รถโดยสารประจำทาง	حافلة	passenger bus
รถโดยสารประจำทางสาย	خط الحافلات	bus
รถไฟฟ้าชานเมืองสายสีแดงอ่อน	ضاحية الضوء الأحمر	rapid transit light red line
รถไฟฟ้ามหานคร	mrt	metropolitan rapid transit
รฟม	ر.	public transit
รวดเร็ว	سريع	rapid
รวม	لتضمين	total
รวมกับ	مجتمعة مع	add to
รวมทั้ง	بما في ذلك	include
รวมทั้งประเทศที่ให้ความช่วยเหลืออื่นๆ	بما في ذلك البلدان التي تقدم مساعدات أخرى	the countries that provided helps
รวมทั้งสิ้น	المجموع الكلي	result
รวมระยะทางทั้งสิ้น	المسافة الإجمالية	total distance
รศ	زميل	ratanakosin era
รหัส	الكود	code
รอก	يرفعون	roack
รองประธานรัฐสภาคนที่หนึ่ง	النائب الأول لرئيس مجلس النواب	an assistant head of a thai governmental committee
รองประธานสภาคนที่สอง	النائب الثاني لرئيس المجلس	second vice chairman
รองเท้า	الأحذية	shoes
รอญับ	انتظر	seventh month of the hijra calendar
รอบ	حول	surrounding
รอบคอบ	حصيف	careful
รอบชิงชนะเลิศระดับประเทศ	النهائيات الوطنية	national final round
รอบที่	الجولة	round
รอบเมือง	حول المدينة	around town
ระดับกระโดดสูง	قفزة عالية	high jump  height
ระดับการกระโดดสูง	قفزة عالية	high jump
ระดับปริญญาเอก	مستوى الدكتوراه	doctorate degree level
ระดับปริญญาโท	درجة الماجستير	master's degree
ระดับมัธยมศึกษา	ثانوي	middle school level
ระดับอาชีวศึกษา	المستوى المهني	vocational education
ระนอง	رانونج	ranong
ระนาด	إكسيليفون	ranad - a thai musical instrument
ระนาดทุ้ม	إكسيليفون	a type of thai musical instrument
ระนาดเอก	ألتو	ranad eg -  a thai musical instrument
ระบบ	النظام	system
ระบบกษัตริย์ของกัมพูชา	الملكية الكمبودية	cambodian monarchy
ระบบรัฐสภา	النظام البرلماني	rajya sabha system of governing
ระบบสืบพันธุ์	الجهاز التناسلي	reproductive system
ระบบสุริยะ	النظام الشمسي	solar system
ระบบโครงกระดูก	نظام الهيكل العظمي	skeletal system
ระบบใช้อำนาจเด็ดขาด	نظام طاقة مطلق	despotism
ระยะ	مصطلح	phase
ระยะเวลา	المدة	period
ระยะเวลาการดำรงตำแหน่ง	مدة الخدمة	the term in the office
ระวิ	بين	rawi
ระหว่างปี	خلال العام	between the year
ระหว่างสงครามโลกครั้งที่	خلال الحرب العالمية	during wold war
ระเบียง	الشرفة	bhirasri
ระเบียบ	التنظيم	regulation
ระโนด	ميت	ranode (name of district in thailand)
รักษาศีล	راقب التعليمات	keep the precepts
รักษาสิ่งแวดล้อม	حماية البيئة	protect the environment
รักแห่งสยาม	حب صيام	love thailand
รังสิตคลอง	رانجسيت خلونج	rangsit canal
รังสี	الإشعاع	radiation
รังสีเอกซ์	الأشعة السينية	xray
รังสีแกมมา	أشعة جاما	gamma ray
รัชกาลที่	عهد	rama
รัชกาลสมเด็จพระจุลจอมเกล้าเจ้าอยู่หัว	عهد الملك شولالونجكورن	king chula chomklao's reign
รัชดาภิเษก	راتشادافيسيك	rajada pisek - a location in thailand
รัฐธรรมนูญแห่งราชอาณาจักรไทย	دستور مملكة تايلاند	constitution of the kingdom of thailand
รัฐบาลไทย	الحكومة التايلاندية	thai government
รัฐบุรุษ	رجل الدولة	statesman
รัฐประหาร	انقلاب	coup d'état
รัฐประหารในประเทศไทย	انقلاب في تايلاند	thailand's coup d'état
รัฐมนตรีว่าการกระทรวงคมนาคม	وزير النقل	transportation secretary of thailand
รัฐวิสาหกิจ	مؤسسة الدولة	financial situation of the country
รัฐวิสาหกิจไทย	مؤسسات الدولة التايلاندية	thai state enterprise
รัฐสภา	البرلمان	parliament
รัฐสีมาคุณากรปิยชาติ	ratthasima kunakornpiyachat	ratthasimakhunakonpiyachat
รัฐอิลลินอยส์	إلينوي	state of illinois
รัฐเทกซัส	تكساس	state of texas
รัตนบุรี	راتانابوري	ratanaburi district - a location in thailand
รัตนาธิเบศร์	rattanathibet	ratana thibet
รับบทโดย	لعبت من قبل	played by
รับพระราชทาน	قبول	receive
รัศมี	نصف القطر	radius
รัสเซล	راسل	russell
รากแก่น	الجذر الأساسي	rakkan
รางวัลนักร้องยอดเยี่ยม	جائزة أفضل مطرب	best singer award
รางวัลนักร้องไทยสากลชายยอดนิยม	جائزة المغني التايلاندي الدولي الشعبي	best thai male singer award
รางวัลนาฏราช	جوائز رويال راقصة	naktarath prize
รางวัลโนเบล	جائزة نوبل	nobel prize
รางวัลไนน์เอ็นเตอร์เทน	جائزة التسعة للترفيه	nine entertain awards
ราชตระกูล	العائلة المالكة	royal family
ราชนาวี	البحرية	royal navy
ราชมังคลากีฬาสถาน	ملعب راجامانغالا	rajamangala national stadium
ราชวงศ์จิ้นตะวันออก	سلالة جين الشرقية	east jin dynasty
ราชวงศ์ชิง	سلالة تشينغ	ching dynasty
ราชวงศ์ถัง	سلالة تانغ	tang dynasty
ราชวงศ์ทิพย์จักราธิวงศ์	العائلة المالكة ، chakrathiwong	thipjaklatiwong dynasty
ราชวงศ์บ้านพลูหลวง	البيت الملكي لبلو لوانغ	ban phlu luang dynasty
ราชวงศ์พระร่วง	سلالة فرا روانج	pra roung dynasty
ราชวงศ์หยวน	سلالة يوان	yuan dynasty
ราชวงศ์อู่ทอง	سلالة يو ثونغ	utong empire in ancient thailand
ราชสกุล	الرموز	royal family members
ราชสีมา	راتشاسيما	ratchasima
ราชินิกุล	العائلة المالكة	relatives of the queen
ราบเป็นหน้ากลอง	كن واضحًا	flattened like a drum (meaning to be defeated)
รามอินทรา	رامينترا	ram inthra
รายการ	القائمة	show
รายการวันสำคัญทางพุทธศาสนา	قائمة التواريخ البوذية الهامة	important days in buddhism
รายชื่อ	قائمة	list of the names
รายชื่อคำในภาษาไทยที่มักเขียนผิด	قائمة الكلمات التايلاندية التي تتم كتابتها بشكل غير صحيح في كثير من الأحيان	common misspelled thai words
รายชื่อภาพยนตร์ไทย	قائمة الأفلام التايلاندية	a list of thai movies
รายชื่อหุ่นยนต์ใน	قائمة الروبوتات في	name of robots
รายชื่ออธิการบดี	قائمة المستشارين	list of presidents
รายชื่อเพลง	قائمة الأغاني	songs list
รายนามรองอธิการประจำวิทยาเขต	قائمة بأسماء نواب المستشار في الحرم الجامعي	llist of deputy directors of the college
รายนามอธิการบดี	قائمة الرئيس	chancellor list
รายพระนามพระมหากษัตริย์ไทย	قائمة الملوك التايلانديين	list of thai monarchs
รายะนาค	ريا ناك	rayanak
รายได้อื่น	دخل آخر	other wages, incomes
ราวพุทธศตวรรษที่	حول القرن	about buddhist era
ราศีธนู	القوس	sagittarius
รำพันพิลาป	تصرخ	poem called rum pan pi lab
ริน	صب	rin
ริมแม่น้ำเจ้าพระยา	ريفرسايد تشاو فرايا نهر	near chao praya river
ริวซากิ	ريوزاكي	riusaki - from japanese story
ริเอะ	ري	rie tanaga - a japanese singer
รีสอร์ท	منتجع	resort
รีเนียม	الرينيوم	rhenium
รุจิพรรณ	روجيبان	pan - a name
รุ่ง	الفجر	dawn
รุ่งสว่าง	الفجر	rungsawang
รุ่งเพชร	رونج بيتش	roongpetch - a female's name
รูดอล์ฟ	رودولف	rudolf
รูทีเนียม	الروثينيوم	ruthenium
รูปภาพ	صورة	picture
รูปร่าง	الشكل	body
รูปวรรณยุกต์	شكل نغمي	tones
รูปสามเหลี่ยมมุมป้าน	مثلث منفرج	obtuse
รูปสี่เหลี่ยมด้านขนาน	متوازي الأضلاع	a paralellogram
รูสเวลต์	روزفلت	roosevelt
ร็อดฟอร์ม	شكل رود	rock form
ร่วมแสดงกับ	نفذ مع	costarring
ร้องคู่กับ	الغناء مع	sing a duet with
ร้องร่วมกับ	الغناء مع	featuring
ร้องโดย	تغنى بها	sung by
ร้อยตรี	ملازم ثان	second lieutenant
ร้านอาหาร	مطعم	restaurants
ฤดูกาล	الموسم	season
ฤดูฝน	موسم ممطر	rainy season
ฤดูร้อน	موسم حار	summer
ล	إن	a thai alphabet with an l sound
ลงวันที่	مؤرخ	on this date
ลพบุรี	لوبوري	lopburi
ลอนดอน	لندن	london
ลอยกระทง	لوي كراثونج	loy kratong festival
ลอร์ด	الرب	lord
ละคร	الدراما	play
ละครชาตรี	دراما تشاتري	lakorn-chatri
ละครวิทยุ	الدراما الإذاعية	soap opera broadcasted on the radio
ละครสั้น	دراما قصيرة	short drama
ละครเพลง	موسيقي	stage musical theatre
ละครโทรทัศน์	أوبرا الصابون	television drama
ละติจูด	خط العرض	latitude
ลักษณะ	الخصائص	characteristic
ลักษณะทั่วไป	الخصائص العامة	common characteristic
ลักษณะทางกายภาพ	الخصائص الفيزيائية	physical characteristics
ลักษณะภูมิอากาศ	المناخ	the type of climate
ลักษณะสำคัญ	الخصائص المهمة	main characteristics
ลักเซมเบิร์ก	لوكسمبورج	luxembourg
ลัคนา	صعود	ascendant
ลา	وداعا	goodbye
ลานจาตุรงคสันนิบาต	الرباعي	lan jaturonsunnibat - an ancient place in india
ลามิวูดีน	لاميودين	lamivudine
ลายน้ำ	علامة مائية	watetmark
ลาว	لاوس	lao
ลาออก	استقال	resign
ลำดับ	تسلسل	order, sequence
ลำดับพระปฐมวงศ์ในพระบรมราชวงศ์จักรี	وسام التكوين في سلالة شاكري	order of the kings
ลำดับพระมหากษัตริย์ไทย	وسام الملك التايلاندي	the order of the kings of thailand
ลำตัว	جذع	body
ลำลูกกา	لام لوك كا	lumlookka - a location in thailand
ลำลูกกาคลอง	قناة لام لوك كا	lum luk kak klong
ลำไส้เล็ก	الأمعاء الدقيقة	small intestine
ลิง	القرد	monkey
ลิซท์	ليست	(franz) liszt
ลิปปี	عام الشفاه	rippi - a surname
ลิพิด	شحوم	lipid
ลิฟวิ่งมอลล์	ليفينج مول	living mall
ลิเก	الدراما الشعبية الموسيقية	like
ลิเทียม	الليثيوم	lithium
ลีกคัพ	كأس الدوري	league cup
ลีซอ	ليسو	lisu
ลีเมอร์	ليمور	lemur
ลี้	لي	lee, a district in lumpoon province.
ลี้สุวรรณ	لي صوان	lisuwan
ลุงบุญมีระลึกชาติ	العم boonmee استدعاء الأمة	uncle boonmee who can recall his past lives
ลูกปัด	الخرز	beads
ลูกสาว	ابنة	daughter
ลูกอม	حلوى	candies
ลูกอัณฑะ	الخصيات	testis
ลูซิเฟอร์	لوسيفر	lucifer
ลูน่า	لونا	luna
ล่าทา	الصيد	lata
ล่ำซำ	مقطوع	lumsum
ล้อม	بيسيج	lom
ล้อแม็กซ์อัลลอยขนาด	عجلات من سبائك	alloy wheel
วง	الفرقة	band
วงจรไฟฟ้า	دارة كهربائية	electrical circuit
วงดนตรี	الفرقة	band
วงศ์กำแหง	العائلة	wongkumhang - surname of a famous singer
วงศ์ถั่ว	عائلة البندق	fabaceae
วงศ์ปลากดทะเล	عائلة السمك	ariidae
วงศ์ปลากะรัง	الهامور	serranidae family
วงศ์ปลายอดม่วง	وونغ بلا يوت موانج	tonguefish
วงศ์ปลาหลังเขียว	سمكة خضراء	clupeidae - a type of fish
วงศ์ปลาเนื้ออ่อน	سمك طري	siluridae
วงศ์ปลาเสือตอ	عائلة سمكة النمر	datnioididae
วงศ์พัวพันธ์	wongpua phan	wongpourpan
วงศ์วิริยะ	ويريا	vongsiriya - a surname
วงศ์เทวัญ	العائلة	wongthewan
วงศ์แคหางค่าง	وونغ خاي هانغ كونغ	plants in kae-hang-kang family
วงษ์คำเหลา	وونغ خام لاو	wongkamlao
วงเงิน	الحد	budget
วงเวียน	دوار	circle
วงแหวน	رنين	ring form, circle form
วชิรบรรจง	wachirabanjong	wachibanjong
วทบ	dd	bachelor of science
วนอุทยานถ้ำจัน	ثام تشان فورست بارك	tham chan forest park
วนิดา	wanida	wanida - the name of a drama
วร	أسوأ	won
วรรณกรรม	الأدب	literature
วรรณสุทธิ์	wansut	wannasut - surname of an actress
วรรธนพิสิฐกุล	watthon phisitkun	wanthanaphisitkun
วรัทยา	واروتيا	varattaya (first name)
วว	د	office of ____________
วอก	قرد	wok
วองโกเล่แฟมิลี	عائلة فونجولا	vongola family
วอชิงตัน	واشنطن	washington
วอลท์	والت	walt
วอล์ค	امشي	walk
วะสี	واسي	wasee
วัง	قصر	palace
วังจันทร์	وانغ تشان	wang-chan
วังสระปทุม	قصر سيرا باثوم	srapathum palace
วังสะพุง	وانغ سافونج	wang saphung
วังหลัง	قصر	wang lang
วังหิน	قصر حجري	rock castle
วัชรพล	واتشابولول	watcharapol supermarket
วัฒนชัย	watthanachai	wattanachai - a surname
วัฒนธรรม	الثقافة	culture
วัฒนวิทูกูร	wattanawitkun	watthanawithukun
วัฒนา	وطني	wattana
วัดกลาง	معبد متوسط	wat klang
วัดป่าเลไลยก์วรวิหาร	wat pa lelai worawihan	wat palaylay
วัดพระธาตุดอยสุเทพราชวรวิหาร	وات فرا ذات دوي سوثيب ، راتشاوراوهان	wat pratatdoisuthep rachavoravihan - the temple erected on top of doi suthep in northern thailand
วัดพระฝางสวางคบุรีมุนีนาถ	wat phra fang sangkhaburi muninat	prhafangsawangkaburimuninat temple
วัดพระมหาธาตุวรมหาวิหาร	وات فرا mahathat woramahaviharn	wat phramahathat woramahawihan
วัดพระยืนพุทธบาทยุคล	وات فرا يوين فوتياخون	the standing buddha temple of puttabatyukol
วัดพระลอย	معبد فرا لوي	wat phra loi
วัดพระศรีรัตนมหาธาตุ	وات فرا سي راتانا ماهاتات	wat phra si rattana mahathat
วัดพระเชตุพนวิมลมังคลารามราชวรมหาวิหาร	معبد فرا chetuphon vimolmangklararam	wat pra chetpnvimolmungklaramrajavoramahavihan
วัดระฆังโฆสิตาราม	معبد rakhangkosaram	wat rakang kositaram (name of temple)
วัดสองพี่น้อง	معبد سونغ فاي نونغ	two siblings temple
วัดสุทัศนเทพวรารามราชวรมหาวิหาร	معبد suthasan thep wararam	wat sutatthepvararamrajavorimahavihan - a temple in thailand
วัดหนองเพียร	معبد نونج فيان	wat nong pien - a temple in thailand
วัดหน้าพระธาตุ	نا فرا ذلك المعبد	wat na pra tat - a buddhist temple
วัดเจดีย์หลวง	معبد شيدي لوانج	wat pagoda
วัดโพธิ์	وات فو	wat po - a thai temple
วัตต์	واتس	watt
วัตสัน	واتسون	watson
วัน	اليوم	day
วันชัย	wanchai	wanchai - a male's name
วันที่ขึ้นเครื่องหมาย	تاريخ التوقيع	excluding dividend day
วันที่ออกอากาศชื่อตอนแขกรับเชิญ	تاريخ البث واسم الحلقة ومظهر الضيف	when the invitation comes out
วันที่เข้าฉาย	تاريخ الإصدار	release date
วันนี้ที่รอคอย	الانتظار اليوم	the day that one has been waiting for
วันพฤหัสบดี	الخميس	thursday
วันพุธ	الأربعاء	wednesday
วันมหาสงกรานต์	يوم مها سونغكران	songkran day
วันละ	يوم واحد	per day
วันศุกร์	الجمعة	friday
วันสงกรานต์	يوم سونغكران	songkran day
วันสำคัญ	يوم مهم	important day
วันสำคัญทางพุทธศาสนา	يوم بوذي هام	buddhist holidays
วันหยุดราชการ	عطلة رسمية	national holiday
วันอังคาร	الثلاثاء	tuesday
วันอาทิตย์	الأحد	sunday
วันอาสาฬหบูชา	أسنها بوكا	asalha puja
วันเกิด	عيد ميلاد	birthday
วันเสาร์	السبت	saturday
วันแรม	يوم	the phase of the moon
วัย	مسن	age
วัลลิโภดม	walliphodom	wanliphodom
วัสดุฟิสไซล์	المواد الانشطارية	fissile material
วานูอาตู	فانواتو	vanuatu, australia
วารินชำราบ	warinchamrap	warinchamrap
วาลคิรี	فالكيري	valkyrie - angel that helped in valhalla war
วาลีน	فالين	valine - a type of protein
วาเรีย	فاريا	varia
วาเลนไทน์	عيد الحب	valentine
วาไรตี้	متنوعة	variety
วิกตอร์	فيكتور	victor
วิคตอเรีย	فيكتوريا	victoria
วิจัย	البحث	investigate, study
วิจิตรศิลป์	الفنون الجميلة	fine art
วิชาการ	أكاديمي	academic
วิชาการคอม	كمبيوتر أكاديمي	vcharkarn.com
วิชิต	ويتشيت	wichit - a male's name
วิญญาณ	الروح	soul
วิฑูรย์	القط مع	witoon
วิดีโอเกม	لعبة فيديو	video game
วิตามินอี	فيتامين هـ	vitamin e
วิทยาการคอมพิวเตอร์	علوم الحاسوب	computer courses
วิทยาการระบาด	علم الأوبئة	epidemiology
วิทยาลัยการจัดการเพื่อการพัฒนา	كلية الإدارة للتنمية	management for development college
วิทยาลัยการบริหารรัฐกิจ	كلية الإدارة العامة	management college
วิทยาลัยครูสวนสุนันทา	كلية المعلمين سوان سوناندا	soun sunanta teachers college
วิทยาลัยดุริยางคศิลป์	كلية الموسيقى	college of music
วิทยาลัยนวัตกรรมและการจัดการ	كلية الابتكار والإدارة	the college specialized in arts
วิทยาลัยพยาบาลกองทัพเรือ	كلية التمريض البحري	royal thai navy college of nursing
วิทยาลัยพยาบาลบรมราชชนนี	كلية التمريض boromarajonani	nursing university of barom raj chonnani
วิทยาลัยพาณิชยศาสตร์	كلية التجارة	panitsat university
วิทยาลัยวิชาการศึกษา	كلية التربية	college of education
วิทยาลัยเทคนิคธนบุรี	كلية ثونبوري التقنية	king mongkut's university of technology thonburi
วิทยาลัยแพทยศาสตร์พระมงกุฎเกล้า	كلية الطب phramongkutklao	phramongkutklao college of medicine
วิทยาศาสตรมหาบัณฑิต	ماجستير العلوم	master of science
วิทยาศาสตร์สุขภาพ	علوم الصحة	health science
วิทยาศาสตร์และเทคโนโลยี	العلم والتكنولوجيا	science and technology
วิทยาเขต	الحرم الجامعي	campus
วิทยาเขตกาญจนบุรี	حرم كانشانابوري الجامعي	kanchanaburi college
วิทยาเขตนครศรีธรรมราช	حرم ناخون سي ثامارات	nakhon si thammarat campus
วิทยาเขตพิษณุโลก	حرم فيتسانولوك	pissanulok college
วิทยาเขตสารสนเทศเพชรบุรี	حرم فيتشابوري لتكنولوجيا المعلومات	information technology college of petchaburi
วิทยาเขตสุพรรณบุรี	حرم suphanburi	suphanburi campus
วิทยาเขตสุรินทร์	حرم سورين	surin university
วิทยาเขตหนองคาย	حرم نونغ خاي	nong kai university
วิทยาเขตเฉลิมพระเกียรติ	حرم شالوم فراقيات	vittaya kat chalerm pra kiet - a location at kasetsat university in thailand
วิทยุ	راديو	radio
วิธีการหาความสัมพันธ์	كيف تجد العلاقات	formula for the correlation coefficient
วินชี	فينشي	vinci
วินัย	الانضباط	manners
วินเนอร์	الفائز	winner
วิบูลย์	وداعا	wibul - a male's name
วิมเบิลดัน	ويمبلدون	wimbledon
วิลลี่	ويلي	willy
วิลเลจ	القرية	village
วิลเลียม	وليام	williams
วิลเลี่ยม	وليام	william
วิวัฒนาการ	التطور	evolution
วิวัฒน์	تتطور	produce, making up, invent
วิวัฒน์เกียรติ	ويوات كيات	wiwatkiat
วิศว	هندسة	engineering
วิศวกร	مهندس	engineer
วิศวกรรมวัสดุ	هندسة المواد	material engineering
วิศวกรรมสิ่งแวดล้อม	الهندسة البيئية	environmental engineering
วิศวกรรมเครื่องกล	هندسة ميكانيكية	engineering
วิศวกรรมไฟฟ้า	هندسة كهربائية	electrical engineering
วิสา	ويسيسا	wisa
วิสูตร	التشخيص	wisut
วิหาร	الكاتدرائية	vihara
วิเศษ	رائع	wiset
วิเศษแก้ว	الزجاج السحري	visetkeaw - surname of a singer
วิโนทัย	فينوثاي	winothai
วีดีโอ	فيديو	video
วีดีโอเกม	لعبة فيديو	video game
วีรบุรุษ	البطل	hero
วีระ	veera	veera
วีระยุทธ	wirayut	werayut - a male's name
วีออส	فيوس	vios
วุฒิสภา	مجلس الشيوخ	senate
วุฒิเมธี	wuttimethi	wuttimethi - a surname
ว้าวุ่น	يصرف	wawun
ศ	الجمعة	a thai alphabet
ศร	سهم	arrow
ศรชัย	sornchai	sornchai - a male's name
ศรายุทธ	سرايوث	sarayut - a male's name
ศรีนครินทร์	سريناكارين	srinakarin
ศรีนวล	سريني	sinuan
ศรีบุญเรือง	سري بونروينج	si bun rueang
ศรีประจวบ	سي براتشواب	siprachuap
ศรีปาน	سري بان	sri pan - a surname
ศรีมะฆะ	سري ماخا	sirimaka - a thai name
ศรียาภัย	سرياباي	siyaphai
ศรีสวัสดิ์	سريسوات	srisawat -  a surname
ศรีสำโรง	سي سامرونج	si samrong
ศรีเมือง	سري موينج	srimuang
ศรีไพร	سري فراي	sri prai - a name
ศรเพชร	سهم ماسي	sonpet
ศศิธร	ساسيثورن	sasitorn - a females name
ศักดิ์ศรี	هيبة	dignity
ศักย์ไฟฟ้า	الجهد الكهربائي	electric potential
ศัพท์	المفردات	vocabulary
ศาลชั้นต้น	محكمة ابتدائية	curcuit court
ศาลหลักเมือง	ضريح سيتي بيلار	the old court house
ศาลเจ้าพ่อหลักเมือง	ضريح سيتي بيلار	the city's god
ศาสตราจารย์	أستاذ	professor
ศาสนา	الدين	religion
ศาสนาพราหมณ์ฮินดู	الهندوسية	hindu religion
ศาสนาฮินดู	الهندوسية	hinduism
ศาสนาโซโรอัสเตอร์	الزرادشتية	zoroastrianism
ศิริวรรณ	سيريوان	siriwan - a female's name
ศิลปอาชา	آرتشا	silpa-archa
ศิลปะ	الفن	arts
ศิลปะการแสดง	فن الأداء	performing arts
ศิลปะลพบุรี	فن لوبوري	lopburi art
ศิลปะศรีวิชัย	سريفيجايا آرت	arts from sri vi chai province
ศิลปะเขมร	فن الخمير	cambodian arts
ศิลปะเครื่องปั้นดินเผา	فن الفخار	pottery art
ศิลปะเชียงแสน	تشيانغ ساين آرت	chaingsan art
ศิลปินแห่งชาติ	فنان وطني	national artist
ศิลป์	الفن	silpa
ศิษย์เก่าคณะมนุษยศาสตร์	خريجو كلية العلوم الإنسانية	former humanity student
ศิษย์เก่าคณะรัฐศาสตร์	خريجو كلية العلوم السياسية	faculty of political science alumni
ศิษย์เก่าคณะเศรษฐศาสตร์	خريجو كلية الاقتصاد	economics alumni
ศีรษะ	الرأس	head
ศึกนันทบุเรง	معركة نانتابورينج	suknuntabureng -  a war in thailand
ศึกษาศาสตร์	التعليم	field of education
ศุกลวัฒน์	سوكونوات	sukolawat (a person's name)
ศุภกิจ	supakit	supphakit
ศุภณัฐ	suphanat	supanat (first name)
ศูนย์	المركز	center
ศูนย์การค้า	مركز تسوق	shopping center
ศูนย์การบินทหารบก	مركز طيران الجيش	marine forces
ศูนย์การศึกษาแม่ฮ่องสอน	مركز ماي هونغ سون التعليمي	maehongsorn learning center
ศูนย์คอมพิวเตอร์	مركز الكمبيوتر	computer center
ศูนย์ค้าส่ง	مركز الجملة	wholesale center
ศูนย์บริการวิชาการ	مركز الخدمة الأكاديمية	academic service center
ศูนย์ภาษา	مركز اللغة	language center
ศูนย์รังสิต	مركز رانجسيت	rangsit university center
ศูนย์ลำปาง	مركز لامبانج	lampang center
ศูนย์แพทยศาสตรศึกษาชั้นคลินิก	مركز الطب السريري	medical education center
สก	برغي	abbreviation of two letters
สกว	trf	trf
สกอ	اسكتلندا	office of higher education commission
สกอตแลนด์	اسكتلندا	scotland
สกาย	السماء	sky
สกุล	العائلة	sakun
สกุลหยาดน้ำค้าง	سنديو	d. etrythrorhiza - a type of plant
สกุลเพชรหึง	بيتتشينج	grammatophyllum
สควอโล่	سكوالو	squalo
สงคราม	الحرب	war
สงครามครูเสด	الحملة الصليبية	crusades war
สงครามมหาเอเชียบูรพา	حرب شرق آسيا الكبرى	world war two
สงครามอวกาศ	حرب الفضاء	space war
สงครามเกาหลี	الحرب الكورية	korean war
สงครามเย็น	حرب باردة	cold war
สง่าพล	أنيق	sangapol - a thai surname
สด	طازج	fresh
สตรอเบอรี่	الفراولة	strawberry
สตรีวิทยา	الأشعة	satriwithaya
สติปัญญา	المخابرات	intelligence
สตึก	ساتون	satuek (name of district)
สตูดิโอ	الاستوديو	studio
สถานที่ท่องเที่ยวทางธรรมชาติ	مناطق الجذب الطبيعية	natural attraction
สถานะ	الحالة	status
สถานีคาราวาน	محطة القافلة	caravan station
สถานีวิทยุโทรทัศน์ไทยทีวีสีช่อง	محطات التلفاز التايلاندية مع قنوات التلفزيون الملون	thai television station number _____
สถานีโทรทัศน์ไทยพีบีเอส	محطة تلفزيون pbs التايلاندية	thai public broadcasting service
สถาบัน	مؤسسة	office, department
สถาบันการศึกษา	مؤسسة تعليمية	educational institution
สถาบันบัณฑิตพัฒนบริหารศาสตร์	المعهد الوطني لإدارة التنمية	satabunbunthitpakanabarihansart - a university in thailand, as known as nida
สถาบันพระบรมราชชนก	المعهد الملكي	red cross department
สถาบันวิจัยจุฬาภรณ์	معهد تشولابهورن للأبحاث	julapon academy
สถาบันวิจัยและพัฒนา	معهد البحث والتطوير	reseach and development institution
สถาบันศูนย์และหน่วยงานในมหาวิทยาลัย	المؤسسات والمراكز والأقسام بالجامعات	current faculties/college/school/institutes
สถาบันสมทบ	مؤسسة زميلة	affiliated institute
สถาบันอาชีวศึกษา	معهد مهني	ahchevasuksa academy
สถาบันอุดมศึกษา	مؤسسة التعليم العالي	higher education institute
สถาบันเทคโนโลยีนานาชาติสิรินธร	معهد سيريندهورن الدولي للتكنولوجيا	sirindhorn international institute of technology
สถาบันเทคโนโลยีพระจอมเกล้า	معهد الملك مونغكوت للتكنولوجيا	king mongkut's institute of technology
สถาบันเทคโนโลยีพระจอมเกล้าเจ้าคุณทหารลาดกระบัง	معهد الملك مونغكوت للتكنولوجيا ladkrabang	king mongkut's institute of technology ladkrabang
สถาบันเทคโนโลยีราชมงคล	معهد راجامانغالا للتكنولوجيا	rajamangala university of technology
สถาบันโภชนาการ	معهد التغذية	institute of nutrition
สถาปนิก	المهندس المعماري	architect
สถาปัตยกรรมไทย	العمارة التايلاندية	architecture of thailand
สถิติศาสตร์	إحصائيات	statistic
สธ	sth	two letters from thai alphabets
สนธยา	الشفق	twilight
สนธิ	تقاطع	sonti - a male's name
สนธิไชย	sonthichai	sontichai
สนามกีฬากลาง	الاستاد المركزي	main athletic field
สนามชัยเขต	سنام شاي خت	sanamchaikate - a location in thailand
สนามฟุตบอล	ملعب كرة قدم	football field
สนามแม่เหล็ก	المجال المغناطيسي	magnetic field
สนามไฟฟ้า	المجال الكهربائي	electric field
สนิทวงศ์	سانيت وونغ	there are families.
สนิม	الصدأ	rust
สนเกรวิลเลีย	العنب والصنوبر	grevilea - family of 250 types of plants
สปริงฟิลด์	سبرينغفيلد	springfield
สปรินเตอร์	عداء	sprinter
สปาร์ค	سبارك	spark
สพ	المواصفات	oc
สภานิติบัญญัติแห่งชาติ	الجمعية التشريعية الوطنية	national diet
สภาผู้แทนนิสิต	مجلس تمثيل الطلاب	college student representatives
สภาพอากาศ	الطقس	weather conditions
สมจิตต์	somchit	somjit - a female's name
สมจิตร	somchit	somjit
สมชัย	somchai	somchai
สมชาย	somchai	somchai - a male's name
สมภพ	الميلاد	sompob
สมศรี	سمسري	somsi
สมศักดิ์	سومساك	somsak
สมัคร	تطبيق	samak
สมัย	عصر	era
สมัยกรุงธนบุรี	فترة ثونبوري	thonburi era
สมัยก่อนประวัติศาสตร์	عصور ما قبل التاريخ	prehistory
สมัยที่	متى	term
สมัยรัชกาลที่	عهد	in the reign of
สมัยสุโขทัย	فترة سوخوثاي	sukothai era
สมัยอาณานิคมฝรั่งเศส	الفترة الاستعمارية الفرنسية	modern france
สมาคมประชาชาติแห่งเอเชียตะวันออกเฉียงใต้	رابطة أمم جنوب شرق آسيا	association of south east asian nations (asean)
สมาชิกรับเชิญตอนพิเศษ	أعضاء مدعوون إلى حلقات خاصة	special guests
สมาชิกฤดูกาลที่	أعضاء الموسم	member of the parliament
สมุทวณิช	samutavanich	samudavanija
สมเด็จ	جلالة الملك	your highness
สมเด็จพระนางเจ้ารำไพพรรณี	الملكة رامبهاي بارني	queen rambhai barni
สมเด็จพระนางเจ้าสิริกิติ์	الملكة سيريكيت	queen sirikit
สมเด็จพระนางเจ้าฯ	جلالة	the queen of thailand
สมเด็จพระบรมราชาที่	الملك	king
สมเด็จพระบรมโอรสาธิราช	ولي العهد	his highness, royal crowned prince
สมเด็จพระบรมโอรสาธิราชฯ	ولي العهد	the crown prince of thailand
สมเด็จพระมหิตลาธิเบศร	somdet phra mahidol latibes	somdet phra mahitra thibet
สมเด็จพระรามาธิบดีที่	الملك راماثيبودي	som dej pra rama tippadee #_____ , number of the king
สมเด็จพระศรีนครินทราบรมราชชนนี	صاحبة السمو الملكي الأميرة مها شاكري سيريندهورن	queen sirikit
สมเด็จพระอนุชาธิราช	somdej anuchatthirat	som dej pra ah nu cha thi raj - a famous royalty in thailand a long time ago
สมเด็จพระเจ้ากรุงธนบุรี	كرونج ثون بوري	the king of the thonburi kingdom
สมเด็จพระเจ้าภคินีเธอ	صاحبة السمو الملكي	the king's sister, som dej pra jao pakini ther
สมเด็จพระเจ้าลูกเธอ	صاحبة السمو الملكي	the king's daughter, the princess
สยามดารา	صيام دارا	siam stars
สยามบรมราชกุมารี	صيام	the current king's eldest daughter, the eldest princess
สยามพารากอน	سيام باراجون	siam paragon
สร	إنشاء	abbreviation for the royalties' accessories
สรรพสินค้า	متجر متعدد الأقسام	department store
สราวุธ	ساراوت	sarawut
สร้าง	بناء	build
สลักใจ	اعجاب	salakchai
สวนดุสิตโพล	استطلاع سوان دوسيت	suan dusit poll
สวนผึ้ง	سوان فوينج	bee garden
สวนสมเด็จพระศรีนครินทร์	سومديت فرا سريناجاريندرا بارك	pra sri nakarin - a king of thailand
สวรรคต	توفي	die
สวรรคตหรือ	توفى	die or ___________
สวรรคโลก	sawankhalok	heaven on earth
สวัสดิ์	السواط	sawat - a male's name
สวัสดีปีใหม่	سنة جديدة سعيدة	happy new year
สวิตเซอร์แลนด์	سويسرا	switzerland
สวี	الأجنحة	sawi
สส	سر	representatives
สหพันธ์สาธารณรัฐเยอรมนี	جمهورية ألمانيا الاتحادية	germany
สหรัฐอาหรับเอมิเรตส์	الإمارات العربية المتحدة	arab emirate
สหรัฐอเมริกา	الولايات المتحدة الأمريكية	america, usa
สหราชอาณาจักร	المملكة المتحدة	united kingdom
สหวงษ์	sahawong	sawong - a male's name
สองสาย	سلكان	double-stranded
สอยดาว	uppercut	soidao
สะดวก	ملائم	convenient
สะตอ	ساتو	sator
สะล้อ	الفرامل	salao
สะเดา	نيم	neem, a type of plant
สัจธรรม	الحقيقة	normal truth; common knowledge
สัญญา	الوعد	sanya
สัญลักษณ์ประจำมหาวิทยาลัย	شعار الجامعة	logo of the university
สัดส่วน	نسبة	ratio
สัตว์	الحيوان	animal
สัตว์มีกระดูกสันหลัง	الفقاريات	vertebrate animals
สัตว์มีแกนสันหลัง	العمود الفقري	chordata
สัตว์เลี้ยงลูกด้วยน้ำนม	الثدييات	mammal
สัตว์เลื้อยคลาน	الزواحف	reptile
สัตว์เลื้อยคลานในอันดับนี้	الزواحف في هذه الرتبة	reptile in this order
สัทศาสตร์	الصوتيات	phonetics
สันติ	سلام	peace
สันติสุข	سلام	santi suk
สัมผัสนอก	فضح	outside touch
สัมพันธ์	العلاقة	relationship
สัมมา	حق	summa - the buddhist prayer often starts with this
สาขา	فرع	office location
สาขานครราชสีมา	فرع ناخون راتشاسيما	nakhon ratchasima branch
สาขานครสวรรค์	فرع ناخون صوان	nakhon sawan branch
สาขานิเทศศาสตร์	فنون الاتصال	faculty of communication arts
สาขาประจวบคีรีขันธ์	فرع براتشواب خيرى خان	prachuap khiri khan branch
สาขาปราจีนบุรี	فرع براتشينبوري	pracheenburi branch
สาขาพิษณุโลก	فرع فيتسانولوك	pisanulok location
สาขามนุษยศาสตร์	العلوم الإنسانية	humanities
สาขาย่อย	الفرع الفرعي	offices
สาขาลำปาง	فرع لامبانج	lumpang location
สาขาวิชานิติศาสตร์	كلية القانون	law department
สาขาวิชาบริหารธุรกิจ	برنامج إدارة الأعمال	business administration program
สาขาวิชารัฐประศาสนศาสตร์	قسم الادارة العامة	local government
สาขาวิชาวิทยาการคอมพิวเตอร์	برنامج علوم الكمبيوتر	school of computer science
สาขาวิชาวิศวกรรมคอมพิวเตอร์	برنامج هندسة الكمبيوتر	computer engineering
สาขาวิชาวิศวกรรมอาหาร	هندسة الغذاء	food engineering
สาขาวิชาวิศวกรรมอิเล็กทรอนิกส์	برنامج الهندسة الإلكترونية	major electronic engineering
สาขาวิชาศิลปอุตสาหกรรม	قسم الفن	arts department
สาขาวิชาเคมี	قسم الكيمياء	department of chemistry
สาขาวิชาเทคโนโลยีชีวภาพ	برنامج التكنولوجيا الحيوية	department of biotechnology
สาขาวิชาเศรษฐศาสตร์	الاقتصاد	finance department
สาขาศิลปะสถาปัตยกรรม	فن العمارة	art and architecture branch
สาขาสมุย	فرع ساموي	smui branch
สาขาหัวหิน	فرع هوا هين	hoa hin branch
สาครสินธุ์	ساكورن سين	sakornsin - a surname
สาทร	ساتورن	sathon
สาธารณรัฐประชาชนจีน	جمهورية الصين الشعبية	people's republic of china
สาธารณรัฐออสเตรีย	جمهورية النمسا	republic of austria
สาธารณรัฐอินโดนีเซีย	جمهورية إندونيسيا	republic of indonesia
สาธารณรัฐเช็ก	جمهورية التشيك	czech republic
สาธารณรัฐโดมินิกัน	جمهورية الدومينيكان	republic dominican
สานติวัตร	سانتيوات	santiwat
สามก๊ก	ثلاث ممالك	three kingdom 'sam kok' - a thai legend
สามชัย	سام تشاي	samchai - a location in thailand
สามชุก	سام تشوك	sam chuk district
สามพราน	سامبران	sam phran
สามอัศวินในจินตนาการ	ثلاثة فرسان خيال	sam assavin in jintanakan - the name of a japanese story
สามัญ	عادي	common
สายการบิน	الخطوط الجوية	airline
สายรัชกาลที่	عهد متأخر	family tree of king rama ...
สายรุ้ง	قوس قزح	rainbow
สายสนั่น	خط الرعد	siasanan
สายสีชมพู	الخط الوردي	pink line
สายสีน้ำเงิน	الخط الأزرق	blue line
สายสีม่วง	خط أرجواني	purple line (rapid transit)
สายหมอก	ضباب	fog
สายเดียว	سطر واحد	single helix
สายเมืองทอง	خط mueang thong	muang thong line
สารต้านอนุมูลอิสระ	مضادات الأكسدة	antioxidants
สารพฤกษเคมี	الكيمياء النباتية	phytochemical
สารภี	سارافي	saraphi
สารละลาย	الحل	solution
สารานุกรมไทย	الموسوعة التايلاندية	saranukromthai
สารานุกรมไทยฉบับราชบัณฑิตยสถาน	الموسوعة التايلاندية طبعة المعهد الملكي	thai's publication
สารีวงษ์	sareewong	sariwong
สาวิตรี	سافيتري	sawitri
สาเหตุ	السبب	reasons
สำนวนเก่า	لغة قديمة	old aphorism
สำนักงานขนส่งกรุงเทพมหานครพื้นที่	مكتب النقل في منطقة بانكوك	thai general transport
สำนักงานคณะกรรมการวัฒนธรรมแห่งชาติ	مكتب الهيئة الوطنية للثقافة	office of arts and culture preservation of thailand
สำนักงานโครงการพัฒนาแห่งสหประชาชาติ	مكتب برنامج الأمم المتحدة الإنمائي	united nations development prograท
สำนักระบาดวิทยา	مكتب علم الأوبئة	bureau of epidemiology
สำนักราชเลขาธิการ	الأمانة	operation department of the king's palace
สำนักวิทยบริการ	مكتب الموارد الأكاديمية	office of academic services
สำนักหอสมุด	مكتبة	library
สำนักหอสมุดกลาง	المكتبة المركزية	the central library
สำรวจ	استكشف	investigate
สำราญ	احصل على المتعة	happily
สำหรับ	ل	for
สำหรับประเทศไทย	لتايلاند	for thailand
สำหรับใช้เป็นตราหัวหนังสือราชการไทย	للاستخدام كختم للرسالة الرسمية للحكومة التايلاندية	emblem thailand garuda
สำหรับในปี	للسنة	for the year
สำเนียง	اللهجة	dialect
สำโรง	samrong	sumrong - a location in thailand
สิงหาคม	أغسطس	august
สิงหไตรภพ	singha tripop	sing tri pop - a thai drama
สิงโต	الأسد	lion
สิทธิ	الحقوق	rights
สิทธิมนุษยชน	حقوق الإنسان	human rights
สิน	خطيئة	sihn
สินค้าคงเหลือ	الجرد	inventory
สินค้าอุปโภคบริโภค	السلع الاستهلاكية	supplies
สินสมุทร	سين ساموت	sihnsmut
สินิทธา	zithitha	sinitra - first name of an actor
สิปปภาค	منطقة زيبي	sippapak
สิเรียม	سيريوم	syriam (name of city in myanmar)
สิ่ง	الشيء	things
สิ่งมีชีวิต	الكائنات الحية	living things
สิ่งเสพติด	المخدرات	addictive substance, drugs
สิ้นพระชนม์ในรัชกาลที่	توفي في عهد	died in
สี	اللون	color
สีขาว	اللون الأبيض	white
สีดำ	أسود	black color
สีน้ำตาล	لون بني	brown
สีน้ำเงิน	أزرق	blue
สีฟ้า	أزرق	blue
สีม่วง	أرجواني	purple
สีลม	سيلوم	silom
สึนะ	تسونا	tsuna
สึนะโยชิ	tsunayoshi	tsunayoshi
สืบต่อมา	ترث	live on
สื่อสารมวลชน	صحافة	mass communication
สื่อสิ่งพิมพ์	وسائل الإعلام المطبوعة	printing media
สุกิจ	سوكيت	sukit
สุขภาพ	الصحة	health
สุขสวัสดิ์	سكساوات	suksawas
สุขาภิบาล	الصرف الصحي	sukhapibal (name of district)
สุขุมวิท	سوكومفيت	sukhumvit
สุครีพ	سوكري	sugriva
สุจริตกุล	سوتشارتكون	sucharitkul
สุจาริณี	سوكارين	sujarinee
สุชิน	سوشين	suchin
สุดท้ายตายด้วยฝีมือ	أخيرا ، يموت بالمهارة.	eventually dies at the hand of
สุดสาคร	سودساكورن	sootsakorn - a character in a thai legend
สุดารัตน์	سودارات	sudarat
สุทธิชัย	sutthichai	suttichai - a male's first name
สุทัศนะจินดา	sutasachinda	sututnajinda - surname of a tv host
สุทัศน์	suthat	sutas
สุธี	العالم	sutee - a male's name
สุนทร	سنثورن	sunthon
สุนทรภู่	sunthorn phu	soontornpoo - a character from a legend
สุนทรเวช	sunthornwet	"surname ""sundaravej"""
สุนัขจิ้งจอก	الثعلب	baby fox
สุปรีย์	سوبري	supri - a name
สุพจน์	suphot	supot
สุพล	سوبون	surapol
สุมณทิพย์	sumonthip	sumonthip
สุรชาติ	سورشات	surachart - a male's name
สุรพล	سورابون	suraphol
สุรพันธ์	suraphan	surapan - a male's name
สุรวุฒิ	سوراوت	surawut
สุรศักดิ์	سوراساك	surasak
สุรัสวดี	سوراساوادي	suratsawadee - a thai surname
สุราษฎร์ธานี	سورات ثاني	surat thani
สุรินทร์	سورين	surin - a place in thailand
สุริยัน	سوريان	suriyan - a male actor
สุริโยไท	سوريو تاي	"movie called ""suriyothai"""
สุลต่าน	سلطان	sultan
สุวนันท์	suwanan	suwanan
สุวรรณรัฐ	suwannarat	suwannarath
สุวรรณานนท์	suwannanon	suwannanon - a surname
สุเทพ	سوثيب	suthep - first name of a famous singer
สุโขทัย	سوخوثاي	sukothai - ancient thailand
สุ่น	الشمس	sun
สูง	عالي	high
สูงจากระดับน้ำทะเลปานกลาง	فوق مستوى سطح البحر	above average sea level
สู่	إلى	indicate
สเตราส์	شتراوس	strauss.
สเตอรอล	ستيرول	steroid anabolic
สเตเดี้ยม	الملعب	stadium
สเปน	إسبانيا	spain
สไตรค์	إضراب	strike
สไตล์การเล่น	أسلوب اللعب	style
ส่งเสริม	الترويج	support, encourage
ส่วนของผู้ถือหุ้น	حقوق المساهمين	shareholder fund
ส่วนต่อขยายบางซื่อท่าพระ	تمديد بانج سو ثا فرا	bang sue – tha phra expansion
ส่วนสูง	الارتفاع	height
ส่วนส่งกำลังบำรุง	قسم اللوجستيات	supply center
ส่วนหัว	العنوان	top part
ส่วนในฤดูฝนน้ำจะท่วมทุกปี	في موسم الأمطار ، ستفيض المياه كل عام.	flooding in the rainy season
ส่วนใหญ่	معظم	mostly
ส่วนใหญ่เป็นโรงสีข้าว	معظمها مصانع الأرز	most of them are rice refinery
ส่องแสง	تألق	shining light
ส้ม	برتقالي	orange
ส้มเช้ง	برتقالي برتقالي	acidless orange
ส้มโอ	الجريب فروت	pomelo
หงษ์ทอง	هونغ ثونغ	hongthong
หงษ์มานพ	هونغ مانوب	hongmanop
หงสกุล	هونغ ساكول	hongsakul (a famous surname in thailand), as in harin hongsakul
หญ้าทะเล	عشب البحر	seagrass
หญ้าฝรั่น	الزعفران	saffaron
หนองคาย	نونغ خاي	nong kai -  a location in thailand
หนองม่วง	نونج موانج	nong muang
หนองหาน	نونغ هان	nong-haan
หนองฮี	نونغ هيي	nong hi - a location in thailand
หนองแซง	زانغ	nong sang - area in thailand
หนอน	دودة	worm
หนัก	ثقيل	heavy
หนังสือ	كتاب	book
หนังสือการ์ตูน	كتاب هزلي	comic book
หนังสือลามก	كتب إباحية	pornographic magazines
หนังใหญ่	فيلم كبير	nang yai
หนึ่ง	واحد	one
หนึ่งธิดา	ابنة واحدة	nuengthida
หนุมาน	هانومان	hanuman - a giant in a thai tale
หนุ่ม	الشاب	young (used for men)
หน่วยความจำ	الذاكرة	computer memory
หน่วยคำเติม	مورفيم	affix
หน่วยทหารในค่าย	الوحدة العسكرية في المخيم	units in camp
หน่วยที่	الوحدة	order of 1, 2, 3...
หน่วยบัญชาการนาวิกโยธิน	المقر البحري	royal thai marine corps
หน่วยประมวลผลกลาง	وحدة المعالجة المركزية	central processing unit
หน่วยพันธุกรรม	الوحدة الوراثية	gene
หน้าอก	الصدر	breast
หมวด	الفئة	category
หมวดหมู่	الفئة	category
หมวดหมู่กลุ่มดนตรีที่ก่อตั้งในปี	تأسست فئة الموسيقى في	category: music band established in the year
หมวดหมู่กลุ่มดนตรีสัญชาติเกาหลี	فئة المجموعة الموسيقية الكورية	korean musical group
หมวดหมู่กวีชาวไทย	فئة الشاعر التايلاندي	thai poem category
หมวดหมู่การฉลองปีใหม่	فئة الاحتفال بالعام الجديد	the group in charge of new year celebration
หมวดหมู่การประท้วงในประเทศไทย	احتجاج الفئة في تايلاند	category:protests in thailand
หมวดหมู่การ์ตูนญี่ปุ่นแนวโชเน็น	الفئة: رسوم متحركة يابانية ، أسلوب شونين	the cartoons of japan
หมวดหมู่จุลชีววิทยา	فئة الأحياء الدقيقة	category:microbiology
หมวดหมู่ชาวไทยที่นับถือศาสนาพุทธ	فئة البوذيين التايلانديين	category:thai buddhists
หมวดหมู่ชาวไทยที่เกิดในต่างประเทศ	الفئة التايلانديين المولودين في الخارج	thais that were born outside thailand
หมวดหมู่ดาวเคราะห์ชั้นใน	فئة الكوكب الداخلي	group of stars inside
หมวดหมู่ดาวเคราะห์หิน	فئة حجر الكوكب	category:terrestrial planets
หมวดหมู่ทหารอากาศชาวไทย	فئة القوات الجوية التايلاندية	category:royal thai air force personnel
หมวดหมู่ทหารเรือชาวไทย	فئة البحرية التايلاندية	group of thai navy officers
หมวดหมู่นักการเมืองไทย	فئة السياسيين التايلانديين	politician
หมวดหมู่นักร้องไทย	فئة المغني التايلاندي	singer category
หมวดหมู่นายกรัฐมนตรีไทย	فئة رئيس الوزراء التايلاندي	category:prime ministers of thailand
หมวดหมู่บริษัทของไทย	فئة الشركة التايلاندية	group of thai's companies
หมวดหมู่บริษัทที่ก่อตั้งในปี	تأسست شركة الفئة في	category:companies established in
หมวดหมู่บอยแบนด์	فئة الفرقة الصبي	a group of boys band
หมวดหมู่บุคคลจากจุฬาลงกรณ์มหาวิทยาลัย	فئات من جامعة chulalongkorn	category:chulalongkorn university alumni
หมวดหมู่บุคคลจากมหาวิทยาลัยธรรมศาสตร์	قسم من جامعة ثمسات	group of staff from thammasat university
หมวดหมู่บุคคลจากมหาวิทยาลัยสุโขทัยธรรมาธิราช	فئات من جامعة sukhothai thammathirat المفتوحة	group: person from sukhothai thammathirach university
หมวดหมู่บุคคลจากมหาวิทยาลัยอ๊อกซฟอร์ด	فئة فردية من جامعة أكسفورد	the staff of oxford university, england
หมวดหมู่บุคคลจากสถาบันบัณฑิตพัฒนศิลป์	فئة الناس من معهد bunditpatanasilpa	group of staff from art schools
หมวดหมู่บุคคลจากโรงเรียนนายร้อยพระจุลจอมเกล้า	فئات من chulachomklao الأكاديمية العسكرية الملكية	catagory: people from prchomklhaw academy
หมวดหมู่บุคคลจากโรงเรียนมงฟอร์ตวิทยาลัย	فئة الأفراد من كلية مونتفورت	category: people from mongford college
หมวดหมู่บุคคลที่เกี่ยวข้องกับเหตุการณ์	فئة الأشخاص المرتبطين بالحدث	catagory: individuals invovled
หมวดหมู่ประวัติศาสตร์ไทย	فئة التاريخ التايلاندي	category:history of thailand
หมวดหมู่ประเภทของภาพยนตร์	فئة فئة الفيلم	types of film
หมวดหมู่ปรัชญา	فئة الفلسفة	category:philosophy
หมวดหมู่พระราชนัดดาในรัชกาลที่	الفئة الحفيد الملكي للعهد	"catagory: royal heirs during the ""blank"" reign"
หมวดหมู่พระราชปทินัดดาในรัชกาลที่	الفئة الملكية في عهد الملك	the king's army
หมวดหมู่พระราชปนัดดาในรัชกาลที่	فئة الملك بانادا خلال فترة الحكم	belonging to the king # ________
หมวดหมู่พิธีกรไทย	الفئة التايلاندية العروض	host for thai shows
หมวดหมู่ฟุตบอลในประเทศไทย	فئة كرة القدم في تايلاند	category; football in thailand
หมวดหมู่ภัยธรรมชาติ	فئة الكوارث الطبيعية	catagory: natural disasters
หมวดหมู่ภัยพิบัติทางการแพทย์	فئة الكوارث الطبية	category: medical disaster
หมวดหมู่มหาวิทยาลัยธรรมศาสตร์	فئة جامعة ثمسات	thamasat university
หมวดหมู่รัชกาลที่	عهد الفئة	reign 9 category
หมวดหมู่รัฐคอมมิวนิสต์	فئة الدولة الشيوعية	communist countries
หมวดหมู่รัฐมนตรีว่าการกระทรวงการต่างประเทศไทย	فئة وزير الخارجية التايلاندي	category:foreign ministers of thailand
หมวดหมู่รัฐวิสาหกิจไทย	فئة الشركات التايلاندية	category:government-owned companies of thailand
หมวดหมู่รัฐสิ้นสภาพในทวีปเอเชีย	توقفت دولة الفئة الدولة في آسيا	asian counties in controlled
หมวดหมู่รัฐและดินแดนที่ก่อตั้งในปี	فئة الدولة والأقاليم التي تأسست في	categories state and territory established in
หมวดหมู่รายการโทรทัศน์ไทย	فئة البرامج التلفزيونية التايلاندية	the group of thai television channels
หมวดหมู่ละครโทรทัศน์ไทย	دراما تلفزيونية من الفئة التايلاندية	thai drama category
หมวดหมู่วัฒนธรรมไทย	فئة الثقافة التايلاندية	category:thai culture
หมวดหมู่วันสำคัญทางศาสนาที่นับโดยปฏิทินจันทรคติ	فئات الأيام الدينية المهمة التي يحسبها التقويم القمري	group of religious holidays
หมวดหมู่ศิลปินสังกัดจีเอ็มเอ็ม	فئة الفنان تحت gmm	mgm artists
หมวดหมู่สถาบันอุดมศึกษาในกรุงเทพมหานคร	فئات مؤسسات التعليم العالي في بانكوك	category:universities in bangkok
หมวดหมู่สมุนไพร	فئة عشب	herbal, herbs
หมวดหมู่สัตว์มีแกนสันหลัง	محور الفقرات	category:chordates
หมวดหมู่สัตว์เลื้อยคลาน	فئة الزواحف	reptilians
หมวดหมู่สิ่งก่อสร้างในพุทธศตวรรษที่	فئة المباني في القرن الواحد والعشرين	development in the century # ____
หมวดหมู่สิ้นสุดในคริสต์ศตวรรษที่	انتهت الفئة في القرن التاسع عشر.	category: ended in xth century
หมวดหมู่สโมสรในพรีเมียร์ลีก	فئة النادي في الدوري الإنجليزي	group of premier club
หมวดหมู่อดีตอาณานิคมของฝรั่งเศส	الفئة الاستعمارية الفرنسية السابقة	category:former french colonies
หมวดหมู่อดีตอาณานิคมของสเปน	الفئة الاستعمارية الإسبانية السابقة	category:former spanish colonies
หมวดหมู่อดีตอาณานิคมของอังกฤษ	الفئة الاستعمارية البريطانية السابقة	the group of countries that were under british control
หมวดหมู่อวัยวะ	فئة الجهاز	group of organs
หมวดหมู่อวัยวะเพศ	فئة الأعضاء التناسلية	category:sex organs
หมวดหมู่เครื่องเทศ	فئة التوابل	herbs
หมวดหมู่เพศศึกษา	فئة التربية الجنسية	sex education category
หมวดหมู่แนวพระราชดำริ	فئة المبادرة	the king's words (instruction)
หมวดหมู่โรค	فئة المرض	group of disease
หมวดหมู่โรงเรียนที่มีอัตราการแข่งขันสูง	فئة المدارس ذات معدلات المنافسة العالية	categories high competition school
หมวดหมู่โรงเรียนบุรุษในประเทศไทย	فئة مدارس الرجال في تايلاند	category:boys' schools in thailand
หมอชิต	مورشيت	mochit bus station
หมากรุกสากล	الشطرنج الدولي	chess
หมายความว่า	يعني	means
หมู่	مجموعة	district, group
หมู่ที่	القرية	moo.
หมู่เกาะเคย์แมน	جزر كايمان	cayman island
หมู่เกาะแบลีแอริก	جزر البليار	balearic island in spain
หมู่เกาะโซโลมอน	جزر سليمان	solomon islands
หม่อมราชวงศ์ปรีดิยาธร	ر. بريدياثورن	mom rajawongse pridiyathorn devakula
หม่อมหลวงปิ่น	أمي دبوس	mom luang pin
หม่อมเจ้าจุฑาวัชร	الأمير جوتاواتشاي	his serene highness prince juthawat
หม่อมเจ้าวัชรวีร์	الأمير واتشراوي	mom chao vatcharee - a member of the royal family
หม่อมเจ้าวัชรเรศร	أمي واتشاراشورن	watcharaje - a member of royal family
หม้อข้าวหม้อแกงลิง	تاسع	nepenthes - a type of tropical plant
หยุ่น	مرن	yun - nickname of a thai newscaster
หรั่ง	لانج	rang
หรือ	أو	or
หรือการแสดงธงชาติ	أو إظهار العلم الوطني	national flag display
หรือชื่อทางการคือ	أو الاسم الرسمي	official name is
หรือที่รู้จักกันในชื่อ	أو تعرف باسم	also known as
หรือที่เรียกกันว่า	يُعرف أيضًا باسم	or what it is called ...
หรือเรียกว่า	أو دعا	called
หลวง	رويال	loung - a thai title for people who services the king
หลอก	خدعة	fake, fooling someone
หลอดอาหาร	المريء	esophagus
หลอดเลือดแดงใหญ่เอออร์ตา	الشريان الأورطي	aorta
หลักจริยธรรม	الأخلاق	ethics
หลักทรัพย์	الأوراق المالية	property
หลักสี่	لاكسي	luk sri - a location in bangkok
หลักสูตรการจัดการดุษฏีบัณฑิต	برنامج دكتوراه في الإدارة	doctor of management program
หลักสูตรที่เปิดสอน	بالطبع	curriculum
หลักสูตรนานาชาติ	دورة دولية	international course
หลักสูตรปกติ	بالطبع عادي	normal program
หลักสูตรภาษาอังกฤษ	دورة اللغة الإنجليزية	english curriculum
หลักสูตรภาษาไทย	دورة اللغة التايلاندية	thai language curriculum
หลักสูตรวิทยาศาสตรมหาบัณฑิต	برنامج ماجستير العلوم	degree requirements for a bachelor degree in science
หลังจาก	بعد ذلك	after
หลังสงคราม	بعد الحرب	after the war
หลังสงครามโลกครั้งที่	بعد الحرب العالمية	world war
หลังสงครามโลกครั้งที่สอง	بعد الحرب العالمية الثانية	after world war ii
หลังเหตุการณ์	بعد الحدث	after the event
หลาย	كثير	many, vastly
หลีกภัย	الهروب	mr. cheun leakpai, the former foreign ministor
หลุมดำจิ๋ว	ثقب أسود صغير	small black hole
หล่มสัก	لوم ساك	lohmsak
หวาย	الروطان	bamboo
หอก	الرمح	spear
หอประชุมพ่อขุนรามคำแหงมหาราช	قاعة الملك رامخامهاينج القاعة الكبرى	pho khun ram khamhaeng convention center
หอมรดกไทย	قاعة التراث التايلاندي	national ancient museum of thailand
หอย	قذائف	shells, clams
หอไอเฟล	برج إيفل	eiffel tower
หัก	مكسور	broken
หัว	الرأس	head
หัวหิน	هوا هين	hua hin
หัวโขน	قناع	khon mask
หัวใจ	القلب	heart
หาง	الذيل	tail
หาดทรายแก้ว	شاطئ ساي كايو	glass beach
หาบเร่	هوكر	street vending
หินปูน	الحجر الجيري	limestone
หินอ่อน	رخام	marble
หินเชิร์ต	قميص حجري	chert
หินแกรนิต	الجرانيت	granite rock
หินไซอัล	الحجر الصخري	sial
หี	كس	vagina (impolite word)
หุตะสิงห์	هوتا الغناء	hutasingha
หุ่น	دمية	model
หุ่นยนต์	روبوت	robot
หเตุการณ์	الحالة	event
ห่วงใย	رعاية	care
ห้วยขวาง	هواي خوانج	huai khwang
ห้วยทับทัน	هواي ثاب ثان	huai thap than
ห้องน้ำ	الحمام	bathroom
ห้องสมุด	المكتبة	library
ห้าง	متجر متعدد الأقسام	mall
ห้างฉัตร	تعليق الدردشة	hang chat
ห้างหุ้นส่วนจำกัด	شراكة محدودة	limited partnership
ฬาพานิช	تجاري	fapanit - surname of an actor
อก	الصدر	chest
อคิลลีส	أخيل	achilles
องคชาต	القضيب	penis
องคต	منظمة	angada
องค์กรปกครองส่วนท้องถิ่น	منظمة حكومية محلية	local administration
องค์การนิสิต	منظمة طلابية	student organization
องค์การมหาชน	منظمة عامة	human services
องค์การสหประชาชาติ	الأمم المتحدة	united nation
องค์บาก	ong bak	ong-bak
องค์ประกันหงสา	تأمين هونغسا	prakunhongsa - a famous person from the ancient time
องอาจ	شجاع	ongart
อดิศักดิ์	adisak	adisak
อดีต	الماضي	the past
อดีตผู้บัญชาการทหารบก	القائد العسكري السابق	ex-commander in chief of the royal thai army
อดีตรองนายกรัฐมนตรี	نائب رئيس الوزراء السابق	former deputy prime minister
อดีตรองหัวหน้าหน่วยที่	نائب رئيس الوحدة السابق	former lieutenant
อธิการบดี	المستشار	dean of the college
อธิการบดีมหาวิทยาลัยธรรมศาสตร์	رئيس جامعة ثمسات	former chanceller of thamasat university
อธิบายว่า	اشرح ذلك	explain
อนันตยะ	أنانتايا	anantaya
อนันตรัย	أنانتاي	anuntrai
อนาลโย	أنالوي	analayo
อนึ่ง	بالمناسبة	once
อนุทิน	يوميات	diary
อนุสรณ์สถาน	نصب تذكاري	monument
อนุสรา	أنوسارا	anusara
อปักธงชัย	باك ثونغ تشاي	pak thongchai district
อพอลโล่	أبولو	apollo
อพิมาย	aphimai	phimai district
อภัยนุราช	الغفران	aphainurat
อภินันท์	aphinan	ahpinun - a male's name
อภิปรัชญา	الميتافيزيقيا	metaphysics
อภิรักษ์	أفراك	apirak
อมฤต	ميت	ummarit - a male's name
อมาตยกุล	أماتاياكون	amattayakun
อยู่	ابقى	is
อยู่วิทยา	العلم	yoovidhya
อยู่ห่างออกไปจากชายฝั่ง	بعيد عن الساحل	away offshore
อยู่แล้ว	بالفعل	already
อยู่ในเขตอำเภอกุฉินารายณ์	تقع في منطقة كوتشيناراي	in the kuchinarai district
อย่างต่อเนื่อง	باستمرار	continuously
อย่างแพร่หลาย	على نطاق واسع	many, various
อย่างไรก็ตาม	ومع ذلك	however
อร	orn	orn (thai name)
อรทัย	orathai	orathai - surname of a thai country singer
อรรถกถา	التعليق	atthakatha
อรรถพร	أثافون	uttapon - a female's name
อรัญประเทศ	aranyaprathet	arranyapratet - a location in thailand
อริยสัจ	الحقيقة النبيلة	teaching of buddha
อรุณี	أروني	arunee
อลังการ	مزين	alungan - the name of a movie theater in thailand
อลาสก้า	ألاسكا	alaska
อลิซ	أليس	alice
อวอร์ดส	الجوائز	award
อวัยวะสืบพันธุ์สตรีด้านนอก	الأعضاء التناسلية الأنثوية من الخارج	femal reproductive system
อวัยวะสืบพันธุ์หญิง	الأعضاء التناسلية الأنثوية	female reproductive system
อวัยวะเพศ	الأعضاء التناسلية	sex organ
อศรีประจันต์	أسري براشان	master sri prajan - a priest's name
อสมท	mcot	acronym for thai communication companies
อสามชุก	سام تشوك	sam chuk district
ออ	أو	auu - a thai vowel
ออกฉายครั้งแรกเมื่อวันที่	تم فحص أول مرة	first screening
ออกมาในอะนิเมะเท่านั้น	الخروج في الأنمي فقط	only in anime
ออกอากาศ	بث	on the air
ออกอากาศครั้งที่	بثت على	airing
ออกอากาศทางช่อง	بث يوم	aired on channel
ออกัสตัส	أغسطس	augustus
ออกเป็น	إلى	into
ออกแบบตัวละคร	تصميم الشخصيات	character design
ออนไลน์	عبر الإنترنت	online
ออฟ	متوقف	off
ออลแบนี	الحلفاء	albany
ออสเตรเลีย	أستراليا	australia
ออโตทรอพ	أوتوبوت	autotroph
อะ	ماذا	a
อะซูไรต์	عازوريت	azurite
อะตอม	الذرات	atom
อะนิเมะ	انمي	anime
อะบุราเมะ	أبورامي	aburame
อะพาไทต์	أباتيت	apartheid
อะมาเดอุส	أماديوس	amadeus
อะลูมิเนียม	المنيوم	aluminum
อะโกนิสต์	ناهض	agonist
อะโลน	وحده	alone
อักษร	الأبجدية	letters, alphabets
อักษรย่อ	الاختصارات	abbreviation
อักษรเกาหลี	الأبجدية الكورية	korea alphabet
อังกฤษสมัยแองโกล-นอร์มัน	الأنجلو نورمان الإنجليزية	england anglo-norman era
อังการา	أنقرة	ankara
อัญมณี	جوهرة	gem
อัฒภาค	فاصلة منقوطة	semicolon
อัตราการว่างงาน	معدل البطالة	unemployment rate
อัธฮา	athha	athha
อันดับ	الرتبة	order
อันประกอบด้วย	تتكون من	consists of
อันโตนิโอ	أنطونيو	"name ""antonio"""
อันโตนีโอ	أنطونيو	antonio
อันได้แก่	بما في ذلك	which are
อัฟกานิสถาน	أفغانستان	afghanistan
อัมพร	amporn	umpon - a female's name
อัมพาต	الشلل	paralysis
อัลบัส	البص	albus in harry potter stories
อัลบั้ม	الألبوم	album
อัลเดบารัน	الدبران	arudebaran
อัลเฟรด	ألفريد	alfred
อัสนี	بولت	thunderbolt
อาการหวาดระแวง	جنون العظمة	paranoid
อากาศ	الطقس	air, weather
อากาศอำนวย	الطقس	akat amnuai
อากาเป	agape	the word meaning 'love' in greek language
อาคามัตสึ	أكاماتسو	akamatsi
อาคารส่วนที่	قسم البناء	part (insert number) of the the building
อาคารอุบลรัตนราชกัญญา	مبنى أوبونراتانا راتشاكانيا	buildings outside ubon ratana graz contract.
อาคารเฉลิมพระเกียรติ	مبنى شالوم فراقيات	chalermphrakiat building
อาจหมายถึง	قد يعني	may also mean
อาจารย์	المعلم	teacher
อาจารย์ใหญ่	مدير المدرسة	headmaster
อาซึกะ	أسوكا	asuka
อาณัตพล	anataphon	arnattapon
อาณาจักร	المملكة	kingdom
อาณาจักรธนบุรี	مملكة ثونبوري	thonburi empire
อาณาจักรสุโขทัย	مملكة سوخوثاي	sukhothai kingdom
อาณาจักรอยุธยาปกครองเขมรเป็นเวลาเกือบปี	حكمت مملكة أيوثايا كمبوديا لمدة عام تقريبًا.	ayutthaya dynasty had colonized khmer for almort 400 years
อาณาจักรอยุธยาเริ่มเสื่อมอำนาจลงราวพุทธศตวรรษที่	بدأت مملكة أيوثايا في التدهور في القرن البوذي.	ayutthaya kingdom had started to downfall around 24 b.e.
อาณาจักรแพกเจ	مملكة باكي	pakja territory
อาณาเขตติดต่อ	منطقة الاتصال	adjoining parcel
อาดัม	آدم	adam
อาทิ	مثل	for example
อาทิตย์	الأحد	sunday
อานนท์	أنون	anon
อานันทมหิดล	أناندا ماهيدول	ahnanmahidol - someone with the king's surname
อานุภาพ	عزيز	power
อานโตนิโอ	أنطونيو	antonio
อาบาราอิ	abarai	abarai
อายุ	العمر	age
อารยา	أرايا	araya
อาร์	ص	r.
อาร์กอน	الأرجون	argon
อาร์คิมิดีส	أرخميدس	archimedes
อาร์ม	الذراع	arms
อาร์มาดิลโล	أرماديلو	armadillo
อาร์เคด	ممر	arcade
อาร์เมเนีย	أرمينيا	armenia
อาร์เอ็นเอ	الحمض النووي الريبي	ribonucleic acid - rna
อาร์โนลด์	أرنولد	arnold
อาวุธคือ	السلاح	type of weapons
อาวุธประจำกาย	سلاح شخصي	personal weapon
อาหาร	الطعام	food
อาเจียน	التقيؤ	vomit
อาเธอร์	آرثر	arthur
อาเนีย	آنا	anya
อำนาจ	القوة	amnat
อำนาจอธิปไตย	السيادة	sovereignty
อำเภอ	المقاطعة	district
อำเภอกมลาไสย	منطقة kamalasai	kamalasai district
อำเภอกระสัง	منطقة كراسانغ	krasang district
อำเภอกันทรลักษ์	منطقة كانثارالاك	kantharalak district
อำเภอขุขันธ์	حي خوخان	khukhan district
อำเภอขุนหาญ	منطقة خون هان	amphur kunhan
อำเภอครบุรี	منطقة خون بوري	amphur kornburi
อำเภอคูเมือง	منطقة خو موينج	khu mueang district
อำเภอจอมทอง	منطقة تشوم ثونغ	jom thong district
อำเภอดอยสะเก็ด	منطقة دوي ساكت	doi saket district
อำเภอด่านขุนทด	مقاطعة دان خون تحوت	dan koontod district
อำเภอตะพานหิน	منطقة تفهان هين	taphan hin district
อำเภอทับคล้อ	مقاطعة ثاب خلو	amphoe tap khlo
อำเภอทุ่งช้าง	منطقة ثونغ تشانغ	thung chang district
อำเภอท่าตูม	منطقة ثا توم	ta toom district
อำเภอท่าวังผา	منطقة ثا وانغ فا	ta wung pa province
อำเภอท่าวุ้ง	منطقة ثا وونغ	ta wung district
อำเภอนครชัยศรี	منطقة ناخون تشاي سي	nakhon chai si district
อำเภอนาบอน	منطقة نا بون	nabon district
อำเภอน้ำเกลี้ยง	منطقة نام كليانج	amphur namleang
อำเภอบัวเชด	حي بوعشة	buachet district
อำเภอบัวใหญ่	منطقة بوا ياي	amphoe buayai (buayai district)
อำเภอบางบัวทอง	منطقة بانج بوا ثونج	bang bua thong district
อำเภอบางบ่อ	منطقة بانج بو	bang bor district
อำเภอบางพลี	منطقة بانج فلي	bang plee district
อำเภอบางละมุง	منطقة بانج لامونج	bang lamung district
อำเภอบางเสาธง	منطقة بانج ساو ثونج	bang sao thong district
อำเภอบ้านลาด	منطقة بان لات	bahn lad district
อำเภอบ้านหมี่	منطقة بان مي	ban mi district
อำเภอปราสาท	منطقة براسات	amphor-prasart
อำเภอปากช่อง	منطقة باك تشونغ	pak chong district
อำเภอปากพนัง	منطقة باك فانانج	pak phanang district
อำเภอปาย	منطقة باي	pai district
อำเภอฝาง	منطقة فانغ	fang district
อำเภอพระประแดง	منطقة فرا براداينج	pra-pradaeng district
อำเภอพระพรหม	منطقة فرا فروم	pra phrom province
อำเภอพระสมุทรเจดีย์	منطقة فرا ساموت تشيدي	samutjadee district
อำเภอพลับพลาชัย	مقاطعة فلابلا تشاي	plubplachai province in thailand
อำเภอพัฒนานิคม	منطقة phatthana nikhom	amphur pattananikhom
อำเภอพิปูน	منطقة بيبون	phipun district
อำเภอพุทธมณฑล	منطقة فوتامونثون	ampore phuthamontol
อำเภอภูสิงห์	منطقة فو سينغ	aumphor phu sing (name of district)
อำเภอยางชุมน้อย	منطقة يانغ تشوم نوي	choom noi province
อำเภอรหัสไปรษณีย์หมายเหตุ	المنطقة ، الرمز البريدي ، ملاحظة	district, post code, note
อำเภอรัตนบุรี	منطقة راتانابوري	rhatanaburi district
อำเภอราษีไศล	حي راسي سلاي	rasi-salai district
อำเภอร่อนพิบูลย์	منطقة رون فيبون	ronpibul district
อำเภอลาดหลุมแก้ว	منطقة لات لوم كايو	lat lum kaeo district
อำเภอลำปลายมาศ	منطقة لام بلاي مات	lum plai maad district in burrirum province
อำเภอศรีณรงค์	منطقة سي نارونغ	si narong district
อำเภอศรีเมืองใหม่	منطقة سي موينج ماي	sri meung mai district
อำเภอสระโบสถ์	منطقة كنيسة سيرا	sa bot district
อำเภอสหัสขันธ์	حي sahatsakhan	sahuskhan district
อำเภอสองแคว	اغنية خواي	song khwae district
อำเภอสังขะ	مقاطعة سانغكا	sang ka district
อำเภอสันป่าตอง	منطقة سان با تونغ	sunpathong province in thailand
อำเภอสามพราน	منطقة سام فران	sam pran area
อำเภอสารภี	منطقة سارافي	sarape district
อำเภอสิชล	منطقة سيشون	sichon district
อำเภอสุไหงโกลก	منطقة سونغاي كولوك	amphoe su-ngai kolok
อำเภอหนองกี่	منطقة نونغ كي	nong kee district
อำเภอห้วยราช	مقاطعة هواي رات	huai rat district
อำเภออมก๋อย	منطقة أومكوي	om koi district in chiang mai, thailand
อำเภอเกาะคา	منطقة كو خا	amphoe ko kha
อำเภอเขวาสินรินทร์	منطقة خواو سينارين	ampore khavasinrin
อำเภอเฉลิมพระเกียรติ	منطقة شالوم فراقيات	amphur chalermprakiet
อำเภอเชียงของ	منطقة شيانغ كونغ	chiang khong district
อำเภอเชียงคาน	منطقة شيانغ خان	chiang khan district
อำเภอเชียรใหญ่	منطقة شيان ياي	chien yai district in thailand
อำเภอเมืองกาฬสินธุ์	موينج كلاسين	mueang kalasin provincial district
อำเภอเมืองนครราชสีมา	منطقة موينج ناخون راتشاسيما	mueang nakhon ratchasima district
อำเภอเมืองนนทบุรี	منطقة موينج نونثابوري	nontaburi district
อำเภอเมืองบุรีรัมย์	منطقة موينج بوري رام	burerum province
อำเภอเมืองพิจิตร	منطقة موينج فيتشيت	mueang phichit district
อำเภอเมืองพิษณุโลก	mueang phitsanulok	ampore maung pisanulok
อำเภอเมืองลพบุรี	منطقة موينج لوب بوري	lopburi province
อำเภอเมืองสุรินทร์	منطقة موينج سورين	surin province
อำเภอเมืองอุตรดิตถ์	منطقة موينج أوتاراديت	mueang uttaradit district
อำเภอเมืองเชียงใหม่	منطقة موينج شيانج ماي	mung chiang mai district
อำเภอเมืองเพชรบุรี	منطقة موينج فيتشابوري	pechaburi province
อำเภอเวียงชัย	منطقة ويانغ تشاي	wiang chai district
อำเภอเวียงแก่น	منطقة ويانغ كاين	wiang kaen district
อำเภอเสริมงาม	قضاء صوم نغام	soem ngam district
อำเภอแจ้ห่ม	منطقة تشاي هوم	chae hom district
อำเภอแม่ทะ	منطقة ماي ثا	mahta district
อำเภอแม่แจ่ม	حي ماي تشايم	mae jam province
อำเภอแม่แตง	منطقة ماي تاينج	mae taeng district
อำเภอโนนดินแดง	منطقة غير دين داينج	din dang sub district
อำเภอโนนสุวรรณ	حى غير صوان	none su wan province
อิงค์	inc.	inc.
อิงลิช	الإنجليزية	english
อิทธิพล	التأثير	power
อิน	في	in
อินทิรา	إنديرا	intira
อินฟราเรด	الأشعة تحت الحمراء	infared
อินฮิบิเตอร์	المانع	inhibitors
อินุยาฉะ	إنوياشا	inuyacha - a japanese cartoon
อินเซคทิวอรา	inseqtura	insectivora
อินเดียน	هندي	indian
อินเด็กซ์	الفهرس	index
อินโดนีเซีย	إندونيسيا	indonesia
อิม	إم	im
อิมาจิน	imajin	imagine
อิมแพ็ค	الأثر	impact
อิรัก	العراق	iraq
อิริโทรมัยซิน	التحليل الكهربائي	erythromycin
อิสตันบูล	اسطنبول	istanbul
อิหร่าน	إيران	iran
อิเควทอเรียลกินี	غينيا الاستوائية	equitorial
อิโนะ	إينو	ino
อีก	المزيد	more
อีกครั้ง	مرة أخرى	again
อีกด้วย	جدا	also
อึ	تباً	poop
อึ๊งภากรณ์	ungphakorn	ungpakorn - a famous surname
อือ	نعم	uu - a thai vowel
อื่น	آخر	other
อุ	يا	ou
อุซึมากิ	اوزوماكي	uzumaki naruto
อุณหภูมิ	درجة الحرارة	temperature
อุณหเคมี	الكيمياء الحرارية	using energy and heat in chemical study
อุดม	غني	udom
อุดรธานี	أودون ثاني	udon thani
อุตตมะโยธิน	upparat	uttamayothin
อุตรดิตถ์	أوتاراديت	uttaradit
อุทยาน	الحديقة	park
อุทยานประวัติศาสตร์พนมรุ้ง	منتزه فانوم رونج التاريخي	phanom rung historical park
อุทยานประวัติศาสตร์พิมาย	حديقة فيماي التاريخية	phimai historical park
อุทยานแห่งชาติคลองตรอน	حديقة خلونج ترون الوطنية	khlong tron national park
อุทยานแห่งชาติดอยภูคา	حديقة دوي فو خا الوطنية	doi phu kha national park
อุทยานแห่งชาติดอยอินทนนท์	حديقة دوي إنتانون الوطنية	national park doi inthanon in northern thailand
อุทยานแห่งชาติทุ่งแสลงหลวง	منتزه ثونج سالينج لوانج الوطني	thung salaeng luang national park
อุทยานแห่งชาติธารโบกขรณี	ثانوية بوك خوراني الوطنية	tarabokorani national preserve area
อุทยานแห่งชาติน้ำตกสี่ขีด	شلال سي خيت الوطني	namtoksekeed national park
อุทยานแห่งชาติน้ำพอง	حديقة نام فون الوطنية	nam phong national park
อุทยานแห่งชาติภูผาเหล็ก	منتزه جبل الحديد الوطني	phupalek national park
อุทยานแห่งชาติภูพาน	حديقة فو فان الوطنية	phu phan national park
อุทยานแห่งชาติภูสวนทราย	حديقة فو سوان ساي الوطنية	pusuansai national preserve
อุทยานแห่งชาติภูสอยดาว	حديقة فو صوي داو الوطنية	soi dao mountain preserve
อุทยานแห่งชาติภูเรือ	حديقة فو روي الوطنية	national park pu reau
อุทยานแห่งชาติภูเวียง	حديقة فو ويانغ الوطنية	phu wiang national park
อุทยานแห่งชาติภูแลนคา	حديقة فولانكا الوطنية	phu laenkha national park
อุทยานแห่งชาติหาดนพรัตน์ธาราหมู่เกาะพีพี	noppharat thara national park ، جزر في في	hat nopparatthara-mu ko phi phi national park
อุทยานแห่งชาติเขาหลวง	حديقة خاو لوانغ الوطنية	khao luang national park
อุทยานแห่งชาติไทรทอง	منتزه ساي ثونغ الوطني	sai thong national preserve area
อุทุมพรพิสัย	uthumphon phisai	utompisai - an area in thai province
อุบล	أوبون	ubol - a place in thailand
อุปกรณ์	المعدات	instrument
อุปกรณ์คอมพิวเตอร์	ملحقات الكمبيوتر	computer hardware
อุปนิสัย	حرف	manners
อุภัยราศี	اغفر البروج	ambivert zodiac
อุรุกวัย	أوروغواي	urookwai - a location
อุเทน	أوثين	utain - a male's name
อู	اوو	u (a vowel)
อู๋	وو	auu (first name)
อเมริกัน	أمريكي	american
อเมริกา	أمريكا	america, usa
อเมริกาเหนือ	أمريكا الشمالية	north america
อเล็กซานเดอร์	الكسندر	alexander
อเล็กซ์	أليكس	alex
อโลหะ	معادن غير حديدية	nonmetal
อ่อนเพลีย	الإرهاق	fatigue
อ่าน	اقرأ	read
อ่าวลึก	آو لويك	ao luek
อ้างว่า	ادعي ذلك	claim
อ้างว้าง	وحيدا	loneliness
ฮอกกี้	الهوكي	hockey
ฮอท	حار	hot
ฮอฟมัน	هوفمان	hoofman - a name
ฮอยเกนส์	hogens	huygens
ฮอร์โมน	الهرمونات	hormone
ฮอลแลนด์	هولندا	holland
ฮอลโลว์	أجوف	hollow (as in dead soul)
ฮอว์ค	سي هوكس	hawk
ฮักบี้	وداعا	hugby - an album that received many awards
ฮันกึล	هانغول	hangeul
ฮัมบูร์ก	هامبورغ	hamburg
ฮาจิ	هاتشي	haji
ฮาตาเกะ	هاتاكي	hatake
ฮานอย	هانوي	hanoi
ฮายาโตะ	hayato	hayada - a japanese surname
ฮารุกะ	هاروكا	haruka - a japanese name
ฮาวาย	هاواي	hawaii
ฮิซาชิ	هيساشي	hitachi
ฮิซานะ	هيسانا	hisana
ฮิตเลอร์	هتلر	hitler
ฮินาตะ	حناتا	hinada - a japanese story
ฮิมาวาริ	هيماواري	himawari - a japanese surname
ฮิราโกะ	هيراكو	hirako (japanese name)
ฮิวงะ	هيوجا	hewnga - a japanese name from a story
ฮิโซกะ	hisoka	hisoka
ฮิโรชิ	هيروشي	hiroshi
ฮีชอล	هيتشول	heechul
ฮุก	هوك	hook
ฮโยยอน	hyoyeon	hyoon - a dancer from japan
ฯพณฯ	صاحب السعادة	two thai alphabets.  abbreviation that means many things
เกตส์	غيتس	gates
เกตุทัต	كتهات	kettut - a surname
เกมที่	اللعبة	game number _________
เกมบุค	لعبة	game book
เกรย์	رمادي	gray
เกษตรกรรม	الأعمال الزراعية	farming
เกษตรวิสัย	كاسيت ويساي	kasetvisai (name of thai district)
เกษมศรี	kasemsri	kasemsri surname
เกอริง	التواء	the name 'gerring'
เกอไทต์	جوته	goethite mineral
เกาหลีใต้	كوريا الجنوبية	south korea
เกาะ	الجزيرة	island
เกาะคา	كاواي	ko kha
เกาะลูซอน	جزيرة لوزون	luzon island
เกาะสุมาตรา	سومطرة	sumatra
เกิด	ولد	born
เกิดขึ้นหลังจากมหาวิทยาลัยศรีนครินทรวิโรฒวิทยาเขตต่างๆ	حدث بعد جامعة سريناخارين ويروت	happened after srinakarinviroj university started
เกิดขึ้นเมื่อวันที่	حدث في	birthdate
เกิดจากการรวมชิ้นส่วนที่	تسبب عن طريق الجمع بين الأجزاء التي	put together to form something
เกิดจากการรวมตัวของ	الناجم عن دمج	combination of
เกิดจากเชื้อไวรัส	بسبب الفيروس	occur from the viral agent
เกิดนิมิตร	خلق رؤية	caused a vision/realization
เกียรติ	شرف	honour
เกียรติประวัติ	شرف	biography
เกียรติศักดิ์	شرف	reputation.  kietisak can be a male's name
เกียวโตะ	كيوتو	kyoto
เก็กโค	checco	gecko
เขตคลองสาน	منطقة خلونج سان	klongsan district
เขตจอมทอง	منطقة تشوم ثونغ	jomthong area
เขตดุสิต	دوسيت	khet dusit
เขตที่	المقاطعة	district number _______
เขตบางกอกใหญ่	منطقة بانكوك ياي	bangkok yai district in thailand
เขตบางซื่อ	منطقة بانج سو	bang sue district
เขตบางแค	بانج خي	bang khae district
เขตปทุมวัน	باثموان	pathum wan district
เขตภาษีเจริญ	منطقة phasi charoen	phasi charoen district
เขตมีนบุรี	منطقة مين بوري	min buri district
เขตรักษาพันธุ์สัตว์ป่า	ملاذ الحياة البرية	national wildlife preserve
เขตรักษาพันธุ์สัตว์ป่าภูหลวง	محمية فو لوانج للحياة البرية	wildlife preserve
เขตลาดกระบัง	لات كرابانج	lad krabang district
เขตวังทองหลาง	منطقة وانغ ثونغلانغ	wang thonglang district
เขตวัฒนา	حي وطانة	watana district
เขตสวนหลวง	منطقة سوان لوانغ	suan luang district
เขตสาทร	ساتورن	sathorn area
เขตห้วยขวาง	هواي خوانج	huai khwang district
เขตเลือกตั้งที่	بورو	election area number
เขมนิจ	أمر ملح	khemanit
เขากล่าวว่า	قال	he said
เขาทราย	خاو ساي	sand dunes
เขียนว่า	كتب ذلك	wrote
เขียนโดย	كتبه	written by
เขี้ยวพิษ	الأنياب السامة	vemon fangs
เขื่อนกิ่วลม	سد الرياح كيو	kio lom dam
เขื่อนป่าสักชลสิทธิ์	سد باساك تشونلاسيت	parsakchonlasit dam
เขื่อนลำปาว	سد لامباو	lum pao dam
เขื่อนแม่งัดสมบูรณ์ชล	سد ماي نجاد سومبون تشون	mae ngud som bul chol dam in chiangmai
เข็มศิลปวิทยา	فنون الإبرة	khem sinlapawitthaya
เข็มอัปสร	إبرة	kem uppasorn - a thai drama
เข่า	الركبتين	knee
เข้าฉาย	إظهار	release date
เข้าชิงไนน์เอ็นเตอร์เทนอวอร์ดส	تم ترشيحه لجوائز التسعة للترفيه.	compete in entertaining world
เข้ารอบ	المتأهل للتصفيات النهائية	made it to the next round, selected from the initial round
เข้าเฝ้า	لها جمهور	visit (word for the king)
เคน	كين	ken
เคนยา	كينيا	kenya
เคมีไฟฟ้า	الكيمياء الكهربائية	electrochemistry
เคยสู้กับโกคุเทระ	تستخدم للقتال مع gokudera	fought with gokudera
เครือข่าย	الشبكة	network
เครื่องขัตติยราชอิสริยาภรณ์อันมีเกียรติคุณรุ่งเรืองยิ่งมหาจักรีบรมราชวงศ์	الاحتفال بالشرف العظيم لأسرة شاكري	something used in a thai ceremony - too obscure
เครื่องดีด	ستروم	thai string musical instruments
เครื่องตี	آلة للفوز	musical intrument
เครื่องบิน	الطائرة	airplane
เครื่องปั้นดินเผาและเซรามิค	الفخار والسيراميك	pottery and ceramic
เครื่องยนต์	المحرك	engine
เครื่องราชอิสริยาภรณ์	شارة	the king's accessories for ceremonies
เครื่องราชอิสริยาภรณ์อันเป็นที่เชิดชูยิ่งช้างเผือก	الشارة التي يمجدها الفيل الأبيض	order of the white elephant
เครื่องราชอิสริยาภรณ์อันเป็นสิริยิ่งรามกีรติ	شارة المجد العظيم لقيراتي	king's accessories
เครื่องราชอิสริยาภรณ์อันเป็นโบราณมงคลนพรัตนราชวราภรณ์	شارة قديمة مع الميمون	the ancient and auspicious order of the nine gems
เครื่องสาย	آلة وترية	string instrument
เครื่องแต่งกาย	زي	clothes
เคลลี่	كيلي	kelly
เคอาร์วาย	كري	k.r.y
เค้ก	كعكة	cake
เงิน	المال	money
เงินทุน	التمويل	fund
เงินในบัญชีธนาคาร	المال في الحساب المصرفي	balance
เงี้ยว	بنت	shan tribe in northern part of thailand
เจ	ي	j.
เจนี่	جاني	jenny
เจมินี่	الجوزاء	gemini
เจริญ	تقدم	charoen
เจสเปอร์	يشب	jasper
เจียะแจ	جاي جاي	nine emperor gods festival
เจี๊ยบ	كتكوت	jeab (thai name)
เจเน็ต	جانيت	janet
เจ็ดเทพโจรสลัด	shichibukai	seven warlords of the sea
เจ็บ	قرحة	pain
เจ้าของจุกนม	مالك الحلمة	the owner of the baby's bottle
เจ้าจอม	سيد	king's concubine
เจ้าฟ้ากรมพระยานริศรานุวัดติวงศ์	الأمير كروم فرايا ناريسارانو ، معبد تيونج	refer to a title of a royal family member - jao fa krom pra ya rissanuwattiwong
เจ้าฟ้ากรมพระยานริศรานุวัติวงศ์	الأمير كروم فرايا ناريسارا نواتونج	prince narisara nuvativongse
เจ้าฟ้าจิตรเจริญ	الأمير جيتشارون	prince chitcharoen
เจ้าฟ้าภาณุรังษีสว่างวงศ์	الأمير phanurangseesawangwong	prince panuragui bright chestnut.
เจ้าฟ้ามหาวชิราลงกรณ	الأمير مها فاجيرالونكورن	thailand's crown prince
เจ้าฟ้ามหาวชิรุณหิศ	الأمير mahawajirunhit	crown prince maha vajirunhis
เจ้าฟ้ามหิดลอดุลยเดช	الأمير mahidol adulyadej	prince mahidol adulyadej
เจ้าฟ้ามหิดลอดุลเดช	الأمير mahidol adulyadej	a member of thai royalties
เจ้าฟ้าหญิง	الأميرة	princes
เจ้าฟ้าอุบลรัตนราชกัญญา	chaofa ubonratana rajaganya	princess ubon ratana graz's' contract.
เจ้าหนี้การค้า	حسابات الدفع	trade account payable
เจ้าเมือง	الحاكم	mayor
เจ้าเมืองขุขันธ์	محافظ خوخان	a name of the head of the state
เจ้าโลก	الهيمنة	world conqueror
เฉพาะด้านตะวันออกเฉียงใต้เท่านั้นที่เป็นที่ราบลุ่มแม่น้ำโขง	فقط الجانب الجنوبي الشرقي هو حوض نهر ميكونج.	only south-east area that is in mekhong plateau
เฉลิม	شاليرم	chalerm - a male's name
เฉลิมชัย	تشالرمشاي	chalermchai
เฉลิมชัยเจริญกิจ	chalermchai charoenkit	chalermchaichareonkij
เฉลิมพระเกียรติ	تكريما	chaloem phra kiat
เฉลิมพล	شاليرمبول	shalermpol - a surname
เฉลิมแสน	تشالرمسن	chaloemsaen
เฉลียว	إدراكي	chaleuw - a male's name
เชส	مطاردة	(jp morgan) chase
เชอร์รี่	الكرز	cherry
เชา	تشاو	chow -  a chinese name
เชาวน์	المخابرات	chow - a name
เชาวราษฎร์	chaowarat	chowarat - the surname of a famous actress
เชิญยิ้ม	ابتسم	smile
เชิดชัย	قهر	"name ""churd-chai"""
เชียงกลาง	تشيانج كلانج	chiang klang
เชียงของ	تشيانغخونغ	chiang khong
เชียงดาว	شيانغ داو	chiang dao
เชียงปุม	تشيانج بوم	chiang poom - area in thailand
เชียงยืน	شيانغ يوين	chiang yuen
เชียงราย	شيانغ راي	chiang rai
เชียงใหม่	شيانغ ماي	chiang mai
เชี่ยววงศ์กุล	chiewwongkun	chiaowongkul
เชื่อมต่อกับรถไฟฟ้ามหานคร	متصل mrt	connect with skytrain
เชื่อมแม่น้ำท่าจีน	ربط نهر ثا تشين.	confluence to the ta jean river
เชื้อชาติ	العرق	helping the country
เชื้อรา	الفطر	fungus
เช็ค	تحقق	check
เช่นกัน	كذلك	as well
เช่นเดียวกัน	وبالمثل	similar to
เช้ามืดวันที่	فجر اليوم	in dawn of
เช้าวันรุ่งขึ้น	في صباح اليوم التالي	next morning
เซกิ	سيكي	seki
เซน	زين	saint
เซนทอร์	القنطور	centaur
เซบาสเตียน	سيباستيان	sebastian
เซฟ	حفظ	save
เซลล์	الخلية	cell
เซสติโม	سيتو	settimo
เซอร์	سيدي	sir
เซอร์วิส	الخدمة	service
เซอร์เบีย	صربيا	serbia
เซอวิวาสแตติน	سيرفيفاستين	cerivastatin - drug
เซโรกัชเชอร์	سيرو كوتشر	sero gusher - a type of weapon
เซโรนอส	السيرونوس	zeronos
เซโรไลเนอร์	سيرولينر	seroliner
เซ็กส์	الجنس	sex
เซ็นทรัล	المركزي	central - department stores in thailand
เซ็นทารา	سنتارا	centara
เซ็นเซอร์	جهاز الاستشعار	sensor
เณร	مبتدئ	samanera
เดคลิเนชัน	إعلان	declination
เดชา	داشا	decha
เดธโน้ต	مذكرة الموت	death note - a mysterious japanese cartoon
เดนกัชเชอร์	دنكوشر	den gusher - a weapon in japanese movies
เดนโอ	دن أو	den-o
เดนโอเบลท์	دن أوبلت	den-o belt
เดย์	يوم	day
เดอะซิมส์	سيمز	the sims
เดอะฮาเดส	الجحيم	the hades
เดอะฮาเดสแชปเตอร์	الفصل حادس	the hades chapter
เดิม	الأصل	at first
เดิมชื่อ	سابقًا	former name
เดิมที	في الأصل	at first
เดิมเรียกว่า	المعروف سابقا باسم	formerly known as
เดียวกัน	نفس الشيء	same
เดือดทะลุจุดศูนย์	الغليان من خلال نقطة الصفر	zero point breakthrough
เดือนกุมภาพันธ์	فبراير	february
เดือนตุลาคม	أكتوبر	october
เดือนตุลาคมมีฝนตกชุกที่สุด	أكتوبر هو الأكثر أمطارًا.	highest amount of rainfall in october
เดือนธันวาคม	ديسمبر	december
เดือนมกราคม	يناير	january
เดือนมิถุนายน	يونيو	june
เดือนอ้าย	الشهر القمري	first lunar month
เด็กหญิงอายุ	فتاة عجوز	the girl's age
เด็กและเยาวชน	الأطفال والشباب	children and youth
เต่า	السلحفاة	tao (first name)
เต๋อ	إلى	ter
เถรวาท	ثيرافادا	buddha's teaching
เทคนิคอิลลูชั่น	تقنية الوهم	technique illusion
เทควันโด้	التايكوندو	tai kwon do
เทคโนโลยี	التكنولوجيا	technology
เทคโนโลยีสารสนเทศ	تكنولوجيا المعلومات	san son tej techonology
เทนนิส	تنس	tennis
เทนโจอิน	تينجو-إن	tenjoin - a character in a japanese story
เทพพิทักษ์	ثيبتاك	theppitak
เทพมรณะ	الموت	bleach
เทพหัสดิน	إله السماء	tephussadin (a surname)
เทพอานูบิส	أنوبيس	anubis
เทพอาเตน	أثينا	aten
เทพีเธมิส	إلهة	themis
เทริโอ	therio	terio - surname of a singer
เทวดา	ملاك	angel
เทวรูป	المعبود	graven image
เทศบาล	البلدية	municipality
เทศบาลนครขอนแก่น	بلدية خون كاين	khon khan public works
เทศบาลนครนครราชสีมา	ناخون راتشاسيما	nakorn rachasrima province public work
เทศบาลนครนครศรีธรรมราช	ناخون سي ثامارات	nakorn sri thamarat city public works
เทศบาลนครเชียงราย	شيانغ راي	chiang rai province public works
เทศบาลนครเชียงใหม่	بلدية شيانغ ماي	chiang mai municipality
เทศบาลเมืองชัยภูมิ	بلدية تشايافوم	mueang chaiyaphum
เทศบาลเมืองบุรีรัมย์	بوريرام	bureerum public works
เทศบาลเมืองมหาสารคาม	بلدية مها سركام	thesaban mueang maha sarakham
เทศบาลเมืองมุกดาหาร	بلدية مخدان	mookdahan public works
เทศบาลเมืองสกลนคร	بلدية ساكون ناخون	municipality of sakonnakon
เทศบาลเมืองหนองคาย	بلدية نونغ خاي	nong khai municipality
เทศบาลเมืองหนองบัวลำภู	بلدية مدينة نونغ بوا لامفو	nong bua lam phu town municipality
เทศวิศาล	توسعية	tasavisakal - a surname
เทิดศักดิ์	شرف	therdsak
เทียนทอง	الشموع الذهبية	tientong - a male's name
เทียนเงิน	شمعة فضية	tienngern
เทียนโพธิ์สุวรรณ	ثيان فو صوان	tianphosuwan (thai last name)
เทเบิลเทนนิส	تنس الطاولة	table tennis
เทโรศาสน	تيرو ساسانا	terosat football club
เท็ดดี้	تيدي	teddy
เท็นเท็น	عشرة عشرة	tin-tin
เท่ง	تنغ	teng (first name)
เท่านั้น	فقط	only
เธคุนุ	الدعم	dhekunu
เธรซ	تراقيا	thrace - an area in greece
เธอกับฉัน	أنت وأنا	you and i
เธอจะอยู่กับฉันตลอดไป	ستبقى معي إلى الأبد	you will be with me forever
เธอยัง	ما زالت	tur yung
เธอเป็นเพื่อนอาบาราอิ	هي صديقة abarai.	she is a friend of arbarae
เนกิ	نيغي	negi
เนย	زبدة	butter
เนรมิต	اخترع	casting a spell
เนะ	حق	ney
เนื่องจาก	بسبب	because
เนื่องจากประเทศเหล่านั้นอยู่ในตำแหน่งบนโลกที่ต่างไปจากประเทศไทย	لأنهم في وضع على الأرض يختلف عن تايلاند	because those countries are in the group of...
เนื้อที่	المنطقة	area
เนื้อที่ประมาณ	المساحة التقريبية	approximate area
เนื้อร้อง	الأغاني	lyrics
เนื้อเรื่องย่อ	الملخص	summary
เนเธอร์แลนด์	هولندا	netherlands
เนโกะ	نيكو	neko
เน็น	نين	nen
เบจิต้า	بشيتا	vegeta
เบธเลเฮม	بيت لحم	bethleham
เบนจามิน	بنيامين	benjamin
เบรกมา	استراحة	bregma
เบริธ	بيريث	berith
เบลเฟกอล	شرعي	belphegor- a demon in a legend
เบส	باس	bass
เบอร์ลิน	برلين	berlin
เบา	خفيف	soft (voice)
เบาท์	بوت	(dieric) bouts
เบาหวาน	داء السكري	diabetes
เบื่ออาหาร	بالملل من الطعام	not appetite, eating disorder.
เบื้องหลัง	خلف الكواليس	behind the sence
เบโทเฟิน	بيتهوفن	beethoven
เบ็นเท็น	بن 10	ben 10
เปรม	بريم	pream
เปรี้ยว	تعكر	sour
เปรู	بيرو	peru
เปลวไฟ	اللهب	flame
เปลี่ยนชื่อเป็น	أعيدت تسميته إلى	changed the name to
เปลื้อง	يحرم من	nude
เปล่งพานิช	plengpanich	plengpanich
เปอร์เซีย	الفارسية	persia
เปอร์โตริโก้	بورتوريكو	puerto rico
เปิดสอนระดับปริญญาตรี	مفتوح للدراسة الجامعية	offer bachelor degree curriculum
เปียงยาง	بيونغ يانغ	piang yang - in north korea
เปียโตร	بيترو	pietro
เปียโน	بيانو	piano
เปโซ	بيزو	peso
เป็ด	بطة	duck
เป็น	ليكون	is
เป็นขนมของชาวไทยมุสลิม	هي حلوى المسلمين التايلانديين	is a thai-muslim dessert
เป็นครั้งแรก	المرة الأولى	first
เป็นงานเขียนในชุด	هي مجموعة كتابة	in the edition of...
เป็นต่อ	ضد	pen to
เป็นต้น	على سبيل المثال	for example
เป็นต้นมา	منذ ذلك الحين	onward
เป็นต้นไม้ประจำมหาวิทยาลัย	هي شجرة الجامعة	tree of university
เป็นบัวในสกุล	هو لوتس في الجنس	is a lotus in the family
เป็นประธาน	كن رئيسًا	principal of
เป็นปลาตู้สวยงาม	هي أسماك الزينة الجميلة	is an ornamental fish
เป็นพระราชโอรสพระองค์เดียวในพระบาทสมเด็จพระปรมินทรมหาภูมิพลอดุลยเดช	هو الابن الوحيد للملك بهوميبول أدولياديج	is the only son of
เป็นพ่อของ	هو والد	is the father of
เป็นวิญญาณเทียมเพศชาย	هو روح اصطناعية للذكور	the spirit who is a male
เป็นสีประจำ	لون عادي	official color
เป็นหนึ่งใน	هي واحدة من	is one of
เป็นหัวหน้าพรรค	زعيم الحزب	party leader
เป็นอดีตหัวหน้าหน่วยที่	هو رئيس سابق للوحدة	is the former leader of the unit
เป็นอาวุธ	كسلاح	as a weapon
เป็นเครื่องหมายแสดงว่า	هي علامة على ذلك	indicates that
เป็นเจ้าเมืองปกครอง	الحاكم	governor
เป็นเมืองหลวง	هي العاصمة	capital
เป็นเวลา	ل	utilized time
เป็นโฮโมโลกัสกับ	يجري homologus مع	homologous
เป๊ปซี่	بيبسي	pepsi
เพกาซัส	بيغاسوس	pegasus
เพชร	الماس	diamond
เพชรบุรี	فيتشابوري	petchaburi province
เพชรบูรณ์	فيتشابون	prechabun
เพชรพระอุมา	الماس فرا أوما	ancient diamond
เพชรา	رجل عجوز	petchara - name of a famous actress
เพชรเกษม	بيتشكيم	petchakasem area in bangkok
เพดานอ่อน	سقف ناعم	gill
เพทาย	الزركون	zircon
เพพซิน	بيبسين	pepsin
เพราะ	لأن	because
เพราะว่า	لأن	because
เพรียะ	piriya	preah - cambodia
เพลงประกอบภาพยนตร์	الموسيقى التصويرية للفيلم	soundtrack
เพลงประจำจังหวัด	أغنية المقاطعة	province anthem
เพลงประจำมหาวิทยาลัย	أغنية الجامعة	university song
เพลงปิดเรื่อง	أغنية الغلاف	pid reung song
เพลงพระราชนิพนธ์	الموسيقى الملكية	the king's song
เพลงลูกทุ่ง	موسيقى الريف	folk song
เพลงลูกทุ่งขับร้อง	موسيقى الريف	luk thung song
เพลงอีแซว	ندف الموسيقى	a type of thai country music
เพลงเปิด	أغنية الافتتاح	opening song
เพลงเปิดเรื่อง	أغنية افتتاحية	opening song
เพลย์สเตชัน	بلاي ستيشن	playstation
เพลโต	أفلاطون	plato
เพศ	الجنس	sex
เพศชาย	جنس الذكور	male
เพิ่มมา	المزيد	addition
เพียงพอ	كفى	enough
เพื่อ	ل	for
เพื่อเป็นการเผยแผ่พระพุทธศาสนาและประชาสัมพันธ์กิจกรรมทางพระพุทธศาสนาต่าง	من أجل نشر البوذية وتعزيز الأنشطة الدينية	passing knowledge about buddhism
เพื่อใช้ร่วมกับตัวชี้วัดอื่น	لاستخدامها مع مؤشرات أخرى	to be used with other indicators
เพ็ชรทาย	فيثا	petchtai
เฟนิรามีน	فينيرامين	pheniramine
เฟย์	فاي	fay
เฟรดริก	فريدريك	fredrick
เฟส	المرحلة	phase
เฟอร์นิเจอร์	الأثاث	furniture
เฟื่องอารมย์	فودروم	fueangarom
เภสัชกร	صيدلي	pharmacist
เภสัชจลนศาสตร์	حركية الدواء	pharmacokinetics
เม	مايو	may
เมกา	ميجا	mega
เมฆ	الغيوم	clouds
เมฆออร์ต	سحابة أورت	ash cloud in the space
เมจิ	ميجي	maji - a nickname
เมตร	م	metre
เมทริกซ์	مصفوفة	matrix
เมทะนี	ميتاني	metanee - the surname of a famous actor
เมอร์คิวรี	عطارد	mercury
เมือง	المدينة	town
เมืองทองฯ	موانج ثونج	muangthong
เมืองนครราชสีมา	ناخون راتشاسيما	nakornrachasrima city
เมืองปทุมธานี	باثوم ثاني	mueang pathum thani
เมืองปราจีนบุรี	براتشينبوري	prajinburi city
เมืองพิจิตร	فيتشيت	pijit city
เมืองพิษณุโลก	فيتسانولوك	phitsanulok
เมืองยอง	مدينة الأيل	mueng-yor
เมืองลำพูน	لامفون	lumpoon province
เมืองสกลนคร	ساكون ناخون	sakon nakhon
เมืองสิงห์	سينجا	muangsing
เมืองสุรินทร์	سورين	surin city
เมืองหลวง	العاصمة	capital city
เมืองหลวงของอาณาจักรเขมร	عاصمة امبراطورية الخمير	capital of cambudia
เมืองเคมบริดจ์	كامبريدج سيتي	city of cambridge
เมืองเอก	مدينة آكي	mueang-ake
เมืองโคราช	كورات	muang korat
เมืองใหญ่	مدينة كبيرة	city
เมืองใหญ่ในเขตนี้	المدن الرئيسية في هذه المنطقة	capital presently
เมื่อประมาณ	متى	estimate
เมื่อปีพศ	العام الماضي	in buddhist era
เมื่อปีพุทธศักราช	في العصر البوذي العام	in b.e.
เมื่อวันจันทร์	يوم الاثنين	on monday
เมื่อเดือนกันยายน	سبتمبر الماضي	in september
เมื่อเดือนมีนาคม	في مارس	in march
เม็ดขนุน	جاكفروت	metkhanun
เม่น	النيص	porcupine
เย	انتم	yay - a sound
เยลโล่	أصفر	yellow
เยอรมนี	ألمانيا	germany
เยอรมัน	ألماني	german
เยาวชน	الشباب	youth
เยาวชนอายุ	سن الشباب	youth age of ...
เยาวราช	الحي الصيني	yaowaraj
เยื่อหุ้มสมอง	اللحاء	meninges
เรซูเม	استئناف	resume
เรด	أحمر	red
เรดวัน	يوم أحمر	redone
เรย์	راي	ray
เรวดี	بشرى سارة	rawadee
เราเตอร์	جهاز التوجيه	router
เริ่มการผลิตนำเข้า	ابدأ إنتاج الاستيراد	importing
เริ่มก่อสร้าง	ابدأ البناء	began constuction
เริ่มจากเดือนพฤศจิกายนเมษายน	من نوفمبر إلى أبريل	begins from november to april
เริ่มตั้งแต่อาณาจักรอยุธยาได้โจมตีอาณาจักรเขมร	بداية من مهاجمة مملكة أيوثايا مملكة الخمير.	ever since the ayudhya (military) assault...
เรียกกันว่า	دعا	called
เรียกว่า	دعا	call
เรียล	حقيقي	real
เรียว	مرهف	ryo
เรียวทาโร่	ryotaro	totoro - a japanese cartoon
เรียวเฮ	راي هاي	reohay - a japanese character
เรียะชอาณาจักร	المملكة	reacheanachak
เรืองรุ่ง	متوهجة	rueangrung
เรืองศรี	rueangsri	rueng sri - a surname
เรือตรี	قارب	ensign
เรือนนาค	بيت النجا	nak castle
เรือยกพลขึ้นบก	القارب	boat for advance the army
เรือสำรวจ	سفينة المسح	survey vessel
เรือเร็วโจมตี	هجوم سريع بالقارب	fast attack craft
เรือใบ	المراكب الشراعية	sailboat
เรื่อง	القصة	story
เรื่องย่อ	الملخص	synopsis
เรื่องสั้น	قصة قصيرة	short story
เร้กเก้	الريغي	reggae
เลข	رقم	mathematics
เลขที่	رقم	number
เลขาธิการสหประชาชาติ	الأمين العام للأمم المتحدة	united nations secretary-general
เลนส์	العدسة	lens
เลออน	ليون	lyon
เลิฟ	حب	love
เลือดออกตามไรฟัน	الاسقربوط	bleeding of the gum
เลโอ	ليو	alo
เลโอนาร์โด	ليوناردو	leonardo
เล็ก	صغير	small
เล่ม	كتاب	book
เล่มที่	رقم الكتاب	volume
เวทีทอง	المرحلة الذهبية	golden podium
เวล	فيل	vail
เวลาประมาณ	الوقت المقدر	approximate time
เวสต์	الغرب	west
เวอร์ชัน	الإصدار	version
เวอร์โก้	vergo	virgo
เวิร์คพอยท์	نقطة العمل	workpoint company
เวิร์คพอยท์สตูดิโอ	استوديو workpoint	workpoint studio
เวิร์ม	الديدان	worm
เวิลด์	العالم	world
เวียงสระ	ويانغ سا	wiang sa
เวียงสา	ويانغ سا	wiang sa
เวียนเทียนรอบอุโบสถหรือสถูปเจดีย์พุทธสถานต่าง	تدور حول الكنيسة أو المعبد	a thai religious ceremony
เวโรนา	فيرونا	verona in italy
เว็บ	الويب	web
เว็บสเตอร์	وبستر	webster
เว็บเบราว์เซอร์	متصفح الويب	web browser
เว็บไซต์ของเกมส์	موقع اللعبة	gaming website
เว็บไซต์ซีไอเอ	موقع وكالة المخابرات المركزية	cia website
เว้นวรรค	الفضاء	space
เศรษฐกิจพอเพียง	الاقتصاد الكافي	sufficiency economy
เศรษฐบุตร	سيثابوترا	settabut - the family that started bus system in thailand
เศรษฐศาสตร์จุลภาค	الاقتصاد الجزئي	microeconomics
เศรษฐศาสตร์มหภาค	الاقتصاد الكلي	macroeconomics
เสงี่ยม	متواضع	sa-ngiam
เสชนะ	فوز	sechana
เสด็จพระราชสมภพ	الولادة الملكية	royal birth
เสนอชื่อเข้าชิงและรับรางวัล	الترشيح والحصول على الجوائز.	nominate and win
เสนา	سينا	sena
เสนาเมือง	مدينة سينا	senamuang
เสนีวงศ์	سينى وونغ	seniwong
เสน่ห์	سحر	sanea
เสมอ	دائما	always
เสรี	مجانًا	seri
เสรีภาพ	الحرية	freedom
เสียง	الصوت	sound
เสียงเปิด	افتح الصوت	approximant, semi-vowel
เสียงเสียดแทรก	صوت احتكاكي	noise
เสือจากัวร์	جاكوار	jaquar
เสื้อครุย	رداء	gown
เส้นทแยงมุม	قطري	diagonal
เส้นพุ่ง	الخط	yarn that is used for weaving
เส้นโค้ง	منحنى	curve
เส้นใย	الألياف	polymer, yarn
เหงื่อ	عرق	sweat
เหตุการณ์	الحدث	situation
เหตุการณ์สำคัญ	حدث هام	important event
เหรียญ	عملة معدنية	coin
เหรียญกษาปณ์	نعناع	coin
เหรียญทอง	الميدالية الذهبية	gold medal
เหรียญรัตนาภรณ์	عملة الراتانابورن	a special thai medallion
เหลือง	أصفر	yellow
เหลือสมาชิก	الأعضاء المتبقون	members left
เหล็ก	الحديد	iron
เหล่านี้	هذه	these
เหล่าสุนทร	لاوسونثورن	soontorn group
เห็นภาพลวงตา	انظر الوهم	seeing hallucination
เอก	أولاً	the first tonal marker of thai writing system represented by  '
เอกชน	خاص	private
เอกซ์	x	x
เอกราช	الاستقلال	sovereignty
เอกวาดอร์	إكوادور	edwardor
เอกสิทธิ์	حصري	privilege
เอจิเซ็น	إيكيزين	echizen
เอชไอวี	فيروس نقص المناعة البشرية	hiv, human immunodevficiency virus
เอซ	ارسالا ساحقا	letter h
เอตาสีติ	أتاكاتي	sesasiti
เอนจิเนียริ่ง	هندسة	engineering
เอนไซม์	انزيم	enzyme
เอบีซี	abc	abc
เอม	الهدف	aim - could be a nickname
เอริค	إريك	eric
เอล	ش	el
เอสปาด้า	إسبادا	eapada
เอสปาด้าตกชั้น	هبطت إسبادا	aspata
เอสเอ็ม	sm	sm entertainment from korea
เอสโตเนีย	إستونيا	astonia - a country
เออร์โกสเฟียร์	إرجوسفير	ergosphere
เอี่ยมยิ่ง	أنا	super, awesome
เอี่ยมสุข	أنا سعيد	iamsuk
เอื้อย	أوري	eay - a thai nickname
เอเชีย	آسيا	asia
เอเชียตะวันตกเฉียงใต้	جنوب غرب آسيا	southwest asia
เอเชียเหนือ	شمال آسيا	north asia
เอเชียแปซิฟิก	آسيا السلمي	asia-pacific
เอเชียใต้	جنوب آسيا	south asia
เอเธนส์	أثينا	athens
เอเอฟซี	آسيا	afc
เอเอฟซีแชมเปียนส์ลีก	دوري أبطال آسيا	afc championship
เอ็กซ์โป	المعرض	expo
เอ็กโทเดิร์ม	إكسترم	ectoderm, top level of skin layer.
เอ็กโปรพลาซ่า	إكسبو بلازا	expo plaza in thailand
เอ็ดดูเทนเมนท์	التعليم الترفيهي	edutainment
เอ็ดเวิร์ด	إدوارد	edward
เอ็น	وتر	n
เอ็นบีเอ	الدوري الاميركي للمحترفين	nba - national basketball association
เอ็นเตอร์เทนเม้นท์	ترفيه	entertainment
เอ็นเทอร์เทนเมนท์	ترفيه	entertainemnt
เอ็มม่า	إيما	emma
เอ๋	إيه	ah - a nick name
เฮติ	هايتي	haiti
เฮลมุต	هيلموت	helmut
เฮสเตีย	هيستيا	hestia
เฮอร์เชล	هيرشيل	herschel
เฮาส์	البيت	house
เฮียวงะ	هيوجا	heonga
แกง	كاري	soup
แกมเบีย	غامبيا	cambia
แกรนซ์	جرانت	grantz
แกรมมี่	جرامي	grammy
แกริซั่น	حامية	garrison - an english name
แกลง	كلاينج	glang
แกลเลอรี	معرض	gallery
แกสโทรโพดา	المعدة	"name ""gastropoda"""
แกะ	الأغنام	sheep
แกแล็คซี่	المجرة	galaxy
แก่	إلى	aging
แก้ว	كأس	glass
แก้วทอง	زجاج ذهبي	golden cup
แก้วบัวสาย	زجاج لوتس	kaeobuasai
แก๊สธรรมชาติ	غاز طبيعي	natural gas
แขก	ضيف	indian
แขน	الأسلحة	arm
แขวงจำปาสัก	مقاطعة شامباساك	champasak province
แขวงหลวงพระบาง	منطقة لوانغ برابانغ	luang pra bang province
แคดเมียม	الكادميوم	cadnium
แคทแพท	كات بات	kat - pat kamikaze - the thai famous stars
แคน	كاين	kan - a type of thai music
แคนดี้	حلوى	candy
แคนเซอร์	كانزر	cancer
แคม	كاميرات الويب	cam
แคมป์เบลล์	كامبل	campbell
แคมเปญ	الحملة	campagne
แคมเล็ก	كاميرا صغيرة	vagina fold
แคมใหญ่	كاميرا كبيرة	labia
แคร็กเกอร์	كسارة البندق	crackers
แคลคูลัสเชิงปริพันธ์	حساب التفاضل والتكامل	integral calculas
แคลคูลัสเชิงอนุพันธ์	حساب التفاضل	differential calculus
แคลอรี	السعرات الحرارية	calorie
แคลิฟอร์เนีย	كاليفورنيا	california
แคลิฟอร์เนียม	كاليفورنيا	californium
แคว้น	المنطقة	kwon - a korean surname
แจ	مربى	live purely and clean both in body and mind - from chinese belief
แจ็กสัน	جاكسون	jackson
แจ็ค	جاك	jack
แจ๊ค	جاك	jack
แจ๊ส	موسيقى الجاز	jazz
แด	داي	dae
แดงทั้งแผ่นดิน	الأحمر كله الأرض	red (political party all over the country
แดนสุพรรณ	سوفان	dansuphan
แดเนียล	دانيال	daniel
แตน	الدبور	grass hopper
แต่งงาน	متزوج	wedding, marriage
แต่งตั้ง	عيّن	giving a new title to
แต่งโดย	ألحان	composed by
แต่ใน	ولكن في	but in
แต่ในปัจจุบัน	لكن الآن	in the present
แต่ไม่ประสบความสำเร็จ	لكن بدون نجاح	failed
แต่ไม่สำเร็จ	لكن فاشلة	no success
แถบ	الشريط	flat fish
แทซิทัส	تاسيتوس	tacitus
แทน	بدلاً من ذلك	instead
แทนเจนต์	الظل	tangent
แทยอน	taeyeon	tae yon
แทลเลียม	الثاليوم	thallium
แท็กซี่	سيارة أجرة	taxi
แท็บเล็ต	الكمبيوتر اللوحي	tablet computer
แนท	نات	nat
แนวความคิดที่	المفهوم	idea number...
แนวพระราชดำริ	مبادرة ملكية	royal initiative
แนสแด็ก	ناسداك	nasdaq
แบคทีเรีย	البكتيريا	bacteria
แบงค์	البنك	bank
แบทเทิลบรอลเลอร์	ناقلة المعركة	battle brawlers
แบรนด์แอมบาสเดอร์	سفير العلامة التجارية	brand ambassador
แบ่งประเทศไทยออกเป็น	قسّم تايلاند إلى	dividing thailand into 6 areas
แบ่งออกเป็น	تنقسم إلى	divided into...
แบ่งออกได้เป็น	تنقسم إلى	divided into
แบ่งได้เป็น	يمكن تقسيمها إلى	divided into
แป้ง	الدقيق	pang
แผนที่	الخريطة	map
แผนไพรีพินาศ	خطة الكونسورتيوم	pan pirepinat - a plan to destroy the mobs
แผลศักดิ์สิทธิ์	الجرح المقدس	stigmata
แผลไหม้	بيرنز	burn
แพทย์	طبيب	physician
แพน	عموم	pan
แพร่	phrae	the state of praa
แพลทฟอร์ม	منصة	platform
แพะ	ماعز	goat
แพ้	أن تخسر	to lose
แฟชั่น	الموضة	fashion
แฟนเก่า	صديقته السابقة	ex boyfriend/girlfriend
แฟมิลีที่ไปพักผ่อนที่เกาะมาเฟีย	الأسرة تستريح في جزيرة المافيا	family that went to mafia island for vacation
แฟรงค์	فرانك	frank
แฟรี่	جنية	fairy
แฟรี่เทล	حكاية خرافية	fairy tale
แมกนีเซียม	المغنيسيوم	magnesium
แมคอินทอช	ماكنتوش	mcintosh
แมนดาริน	الماندرين	mandarin
แมนเชสเตอร์	مانشستر	manchester
แมว	القطة	cat
แมวป่า	القط البري	jungle cat
แมวลายหินอ่อน	العانس الرخام	pardofelis marmorata
แมวไทย	قطة تايلاندية	thai cat
แม็คโคร	ماكرو	macro
แม่	الأم	mother
แม่จริม	الام الام	mae charim
แม่ชี	الراهبات	nun
แม่นาคพระโขนง	ماي ناك فرا خانونج	mae nak phra khanong
แม่น้ำ	نهر	river
แม่น้ำชี	نهر تشي	chee river
แม่น้ำทะเลสาบสำคัญ	نهر بحيرة هام	important rivers and lakes
แม่น้ำปิง	نهر بينغ	ping rover
แม่น้ำโขง	نهر ميكونج	kong river from laos
แม่ริม	ماي ريم	amphoe mae rim
แยกจากคลองชักพระฝั่งซ้าย	منفصلة عن قناة تشاك فرا على اليسار	forks from khlong chak phra
แยกจากคลองบางกอกน้อยฝั่งซ้าย	من قناة بانكوك نوي على اليسار	forks from the left branch of khlong bangkok noi
แยกจากคลองบางกอกใหญ่ฝั่งขวา	تقاطع من قناة بانكوك ياي على اليمين	split from the bankok yai canal to the right
แยกจากคลองบางกอกใหญ่ฝั่งซ้าย	تقاطع من قناة بانكوك ياي على اليسار	forked from khlong bangkok yai
แย้มนาม	الاسم	yamnam - a surname
แย้มบุญเรือง	اختيار الجدارة	yaembunrueang
แรงโน้มถ่วง	الجاذبية	gravity
แร็ปเปอร์	مغني الراب	rapper
แลกเปลี่ยนโดยถือ	الصرف عن طريق عقد	exchange, conversion
แลมบ์ดา	لامدا	lampda
และ	و	and
และกลายเป็นอู่ข้าวอู่น้ำที่มีชื่อเสียงของไทย	وأصبحت سلة الخبز الشهيرة في تايلاند	and becoming the futile land
และกัมพูชา	وكمبوديا	and cambodia
และครอบครัว	والعائلة	and family
และคำว่า	والكلمة	"and the word ""......."""
และจังหวัดใกล้เคียง	والمحافظات المجاورة	and nearby state
และดุษฎีบัณฑิต	و دكتور في الفلسفة	honorary degree
และตามสภาพเศรษฐกิจและสังคม	ووفقًا للظروف الاقتصادية والاجتماعية	and following the economy and social conditions
และตำแหน่ง	والموقف	and position
และที่สำคัญคือ	والشيء المهم هو	and important thing is...
และธงของต่างประเทศ	والأعلام الأجنبية	and other countries' flags
และปัจจุบัน	والحاضر	now
และพรรคฟุนซินเปค	وحزب funchinpec	funcinpec
และรถไฟ	وتدرب	and railways
และรัสเซีย	وروسيا	and russia
และสหรัฐอเมริกา	والولايات المتحدة	in america
และสังคม	والمجتمع	and society
และสังคมศาสตร์	والعلوم الاجتماعية	and social science
และสัตว์	والحيوانات	and animal
และสโรชา	وساروتشا	and sarocha - a male's name
และหลังจากสงครามภายใน	وبعد الحرب الداخلية	after inside war
และออกซิเจน	والأكسجين	and oxygen
และอำเภอกันทรารมย์	ومنطقة كانثاراروم	and kanthararom district
และอื่น	وآخرون	etc.
และอเมริกาเหนือ	وأمريكا الشمالية	and north america
และเปียโน	والبيانو	and piano
และเป็น	وهو كذلك	is also
และเป็นสมาชิกราชวงศ์	و هو عضو في العائلة المالكة	in monarchs family
และเมืองเก่า	والمدينة القديمة	old city
และเมื่อวันที่	وعلى	when date
และเรียกว่า	ودعا	and call
และโลก	والعالم	and earth
และในปี	وفي السنة	and in the year
และได้ปรากฏตัวตอนภาค	وظهر في الحلقة	appeared
แล้วเดินเวียนรอบปูชนียสถาน	ثم سار حول الحرم	walk with lighted candles in hand around a temple
แวน	فان	wan
แสงจันทร์	ضوء القمر	saengchan
แสงชูโต	تشوتو	sangchuto - a surname
แสงทอง	sangthong	golden sun ray
แสงสิงแก้ว	سانغ سينجكيو	sangsingkaew
แสงเทียน	ضوء الشموع	saengthian
แสตมป์	ختم	stamp
แสนรัก	حب	saenrak
แสนโภศิก	saen phosik	sankosuk - a surname
แหลมสิงห์	لايم سينغ	lam sing - a famous country singer in thailand
แหล่งท่องเที่ยว	الجذب السياحي	tourist attraction
แหล่งโบราณคดีบ้านเชียง	موقع بان شيانغ الأثري	ban chiang archaeological site
แหวน	خاتم	ring
แหวนธรรมดา	خاتم عادي	ordinary ring
แหวนมาเล่ริง	خاتم ماليلي	ring (faux jewelry)
แห่งบันนัม	بان نام	of bannam
แห่งสหประชาชาติ	الأمم المتحدة	of united nations
แองกวิลลา	أنغيلا	anguilla
แองเจิ้ล	ملاك	angel
แอซิด	حمض	acid
แอด	أضف	add
แอนดรอยด์	android	android
แอนดี้	أندي	andy
แอนด์	و	and
แอนิเมชัน	الرسوم المتحركة	animation
แอนเนลิดา	annelida	annelida phylum
แอนโทนี	أنتوني	anthony
แอฟริกา	إفريقيا	africa
แอฟริกาใต้	جنوب إفريقيا	south africa
แอมะซอน	أمازون	amazon
แอมเวย์	امواى	amway
แอร์ไลน์	الخطوط الجوية	airlines
แอล	لام	letter 'l'
แอลจีเรีย	الجزائر	algeria
แอสกี	asci	ascii
แอสซิสต์	المساعدة	assist
แอสปาร์แตม	الأسبارتام	aspartame
แฮช	هاش	hash
แฮปปี้	سعيد	happy
แฮปปี้และชาร์ล	سعيد وتشارلز	happy and charles
แฮ็ค	القرصنة	hack
โกบอล	عالمي	cobalt
โกร	تنمو	guro
โกรกพระ	الشق	krok-phra
โกลด์	ذهب	gold
โกวิท	الكويت	kowit
โกโก้	كاكاو	cocoa
โขน	pantomime	khon
โคกสำโรง	خوك سامرونج	koksamrong
โคนัน	كونان	conan
โคฟี	كوفي	kofe annan
โครงการ	المشروع	project
โครงการก่อสร้าง	مشروع البناء	project
โครงการนานาชาติ	مشروع دولي	international program
โครงการศิลปินแห่งชาติ	مشروع الفنان الوطني	national artist campaign
โครงการเรียนภาษาอังกฤษแบบเข้ม	برنامج تعلم اللغة الإنجليزية المكثف	intensive english program
โครงสร้างภายใน	الهيكل الداخلي	internal structure
โคราช	كورات	khorat or nakorn rajjasrima state
โครโมโซม	كروموسوم	chromosome
โคล	كول	cold
โคลอมเบีย	كولومبيا	colombia
โคล้ด	كود	claude
โคเคน	الكوكايين	cocain
โคเบะ	كوبي	kobe
โคแทนเจนต์	ظل التمام	cotangent
โคโทเน่ที่	كوتوني في	kotone
โฆษะ	النطق	kosa
โฆษิตพิพัฒน์	kosit phiphat	the surname kopitpipat
โจจิ	جوجي	choji
โจเซฟ	يوسف	joseph
โจโจ้	جوجو	jojo
โช	تشو	sho
โชคดี	بالتوفيق	lucky
โชว์	إظهار	show
โชอิจิ	شويتشي	shoichi
โชแปง	شوبان	chopin
โซน	المنطقة	zone
โซนยอชิแด	جيل الفتيات	senyosede - a japanese name
โซนี่	سوني	sony company
โซล	سيول	seoul
โซลดิ๊ก	سولديك	sol-dig
โซลโซไซตี้	جمعية الروح	soul society
โซเดียม	الصوديوم	sodium
โซเฟีย	صوفيا	sofia
โดจินชิ	هل jinchi	dōjinshi
โดย	بواسطة	by
โดยคำว่า	بالكلمة	by the word
โดยตรง	مباشرة	directly
โดยทรงพระกรุณาโปรดเกล้าฯ	منحه صاحب الجلالة	the king's order
โดยที่	أين	by
โดยบ่งบอกถึงปริมาณและคุณภาพของสิ่งตีพิมพ์อิเล็กทรอนิกส์ของสถาบัน	بالإشارة إلى كمية ونوعية المنشورات الإلكترونية للمعهد	stating the limitation and quality of a product
โดยปกติ	عادة	regular, common, normalcy
โดยปกติตามวัดต่าง	عادة حسب المعابد المختلفة	normally, at the various temples...
โดยปกติแล้ว	عادة	usually
โดยมี	مع	make available
โดยมีตัวอย่างบทพากย์ฉบัง	مع أمثلة القصائد	background movie in music video
โดยมีพระภิกษุสงฆ์นำเวียนเทียน	مع راهب يقود موكب مضاء بالشموع	buddhist monks performing ceremony for vientien buddhist religious holiday
โดยราชบัณฑิตยสถาน	بواسطة المعهد الملكي	by royal institute
โดยสรุป	باختصار	in summary.
โดยเจ้าฟ้าธรรมธิเบศรไชยเชษฐสุริยวงศ์	بقلم الأمير ثاماثيبيت سورنشاى تشيتشاسيرياونج	the name of a king
โดยใช้ชื่อว่า	بالاسم	using name
โดยใช้ทางหลวงแผ่นดินหมายเลข	عن طريق الطرق السريعة الوطنية	using freeway #________
โดยในวันที่	بحلول يوم	on the date of ___
โดราเอมอนฉบับภาพยนตร์	عبقور فيلم الطبعة	doraemon movie
โดเมกิ	دوموم	domagi - a japanese word.
โดเมน	المجال	domain
โต	كبروا	big
โตชิบา	توشيبا	toshiba
โทน	نغمة	tone
โทนะหงษา	tonahahasa	tonahongsa - a surname
โทนี่	توني	tony
โทบรามัยซิน	طوبرامامسين	tobramycin
โทมัส	توماس	thomas
โทรจัน	حصان طروادة	trojan
โทรลล์	ترول	troll
โทริคาบูโตะ	توريكابوتو	torikabuto - a japanese word
โทรโข่ง	مكبر الصوت	a megaphone, portable sound directing equipment.
โน	لا	no
โนบิตะ	نوبيتا	nobita
โนบิตะและอัศวินแดนวิหค	نوبيتا والفارس	nobita and the winged braves
โนรา	نورا	nora
โนะ	دينو	noh - a japanese word
โนเบล	نوبل	nobel prize
โบตั๋นกลีบสุดท้าย	الفاوانيا الأخيرة	botun kleep suttai - a novel
โบราณสถาน	موقع أثري	the ancient place
โบอิง	بوينج	boeing company
โบฮีเมีย	بوهيميا	bohemia
โบแดง	رائع	bodin
โปงลางสะออน	ponglang سا أون	pong langsaoun
โปรดเกล้า	من فضلك	the king's order
โปรตอน	بروتون	proton
โปรตีน	بروتين	protein
โปรเจกต์	المشروع	project
โปรเจกต์พิเศษ	مشروع خاص	special project
โปรแกรมคอมพิวเตอร์	برنامج كمبيوتر	computer programming
โปรโมชั่น	الترويج	promotion
โปเกมอน	بوكيمون	pokemon, a very popular japanese anime.
โป๊	الإباحية	nude
โพธิ์ศรี	فوسري	phosi
โพนพิสัย	فون phisai	phonphisai
โพรทิสต์	البروتستانت	protist
โพแทสเซียม	البوتاسيوم	potassium
โฟลต	تعويم	float
โฟลเอ็ม	فلو م	phloem
โฟโตสเฟียร์	الصور البانورامية	photosphere
โมซาร์ท	موزارت	mozart
โมบิลสูทกันดั้ม	البدلة المتنقلة جاندام	mobile suit gundam
โมรา	العقيق الأبيض	agate
โมร็อกโก	مغربي	morocco
โมลิบดีนัม	الموليبدينوم	molybdenum
โมฮัมหมัด	محمد	mohamad
โมเดิร์น	حديث	modern
โมเต็ต	متاتي	motet (sound)
โมเลกุล	الجزيئات	molecule
โมโคนะ	موكونا	mokona - a japanese word
โมโนไซต์	موقع أحادي	mono site.
โยชิโนะ	يوشينو	yoshino
โยฮันน์	يوهان	johann
โยเซฟ	جوزيف	joseph
โรค	المرض	disease
โรคประจำตัว	مرض خلقي	personal illness
โรคปอดบวม	الالتهاب الرئوي	pneumonia
โรคออทิซึม	التوحد	autism
โรคุโด	روكودو	rokudo
โรคเกาต์	النقرس	gout
โรคไต	أمراض الكلى	kidney disease
โรงพยาบาลกรุงเทพ	مستشفى بانكوك	krung thep hospital
โรงพยาบาลจุฬาลงกรณ์	مستشفى الملك شولالونجكورن التذكاري	king chulalongkorn memorial hospital
โรงพยาบาลรามาธิบดี	مستشفى راماثيبودي	ramathibodi hospital
โรงพยาบาลอานันทมหิดล	مستشفى أنانداماهيدول	ananthamahidol hospital
โรงพยาบาลอุตรดิตถ์	مستشفى أوتاراديت	uttaradit hospital
โรงละคร	المسرح	theater
โรงเรียนการบิน	مدرسة الطيران	aviation school
โรงเรียนดาราวิทยาลัย	كلية دارا	dara academy
โรงเรียนนนทรีวิทยา	مدرسة نونسي ويثايا	nontrivittaya school
โรงเรียนนายเรือ	الأكاديمية البحرية	royal thai naval academy
โรงเรียนนายเรืออากาศ	أكاديمية القوات الجوية الملكية التايلاندية	royal thai air force academy
โรงเรียนบดินทรเดชา	مدرسة بودينتشا	bodindecha school
โรงเรียนประชานิเวศน์	مدرسة prachaniwet	prachanivet school
โรงเรียนปรินส์รอยแยลส์วิทยาลัย	كلية الأمير رويال	the prince royal's college
โรงเรียนพระตำหนักสวนกุหลาบ	مدرسة سوان قليب تمناك	the school in the king's compound.  it is reserved for the princess and the royal family
โรงเรียนมัธยมสาธิตวัดพระศรีมหาธาตุ	مظاهرة مدرسة ثانوية وات فرا سي ماهاتهات	wat phrasri mahadhat secondary demonstration school
โรงเรียนมารีวิทย์	مدرسة ماري فيت	maryvit school
โรงเรียนยุพราชวิทยาลัย	مدرسة yupparat wittayalai	yupparaj wittayalai school
โรงเรียนราชินีบน	مدرسة الملكة العليا	rachinibon school in thailand
โรงเรียนวัฒโนทัยพายัพ	مدرسة watthanothai payap	vattanotaipayup school
โรงเรียนศึกษานารี	مدرسة ناري للتربية	suksanari school
โรงเรียนสาธิต	مدرسة مظاهرة	demonstration school
โรงเรียนสาธิตแห่งมหาวิทยาลัยเกษตรศาสตร์	مدرسة مظاهرة جامعة كاسيتسارت	kasetsart university laboratory school
โรงเรียนห้องสอนศึกษา	غرفة التدريس بالمدرسة	class room in school
โรงเรียนเขมะสิริอนุสสรณ์	مدرسة الخميسي انوسورن	kamasirianussorn school
โรงเรียนเจ้าพระยาวิทยาคม	مدرسة تشاو فرايا ويثياكوم	chao praya vitanakom school
โรงเรียนเฉลิมพระเกียรติสมเด็จพระศรีนครินทร์	مدرسة chaloem phrakiat somdet phra srinagarindra	srinagarindra the princress mother school
โรงเรียนเทศบาล	مدرسة عامة	public schools
โรงเรียนไตรมิตรวิทยาลัย	مدرسة traimit wittayalai	trimittavitayalai school
โรงแรม	الفندق	hotel
โรจูโร่	روجيرو	rojuro - a japanese character
โรตารี	الروتاري	rotary
โรม	روما	rome
โรมัน	رومان	roman
โรลเลอร์เบลด	شفرة الأسطوانة	rollerblade
โรส	روز	rose
โรเจอร์	روجر	"name ""roger"""
โลก	العالم	world
โลกแอมะซอน	عالم الأمازون	world of amazon
โลงหิน	تابوت	sarcophagus
โลโซ	لوسو	lasso
โสณกุล	سوناكول	sonakul
โสน	سيسبانيا	sa-nho, has yellow flower, use in thai sweet/desert
โสภณ	صوفون	sophon
โหมด	الوضع	mode
โหม่ง	يعالج	mong - a thai musical instrument
โอกาส	الفرصة	opportunities
โอบามา	أوباما	obama
โอภาส	سعيد	oh pas - a thai name
โอร์มาน	عمان	oman - country
โอวีเอ	ova	ova
โอสถสภา	osotspa	osotspa
โอสถานุเคราะห์	osathanugrah	social service
โออิชิ	اويشي	oochi - a name of food business in thailand
โอะกินะวะ	أوكيناوا	okinawa
โอเค	حسنًا	ok
โอเอกซ์	تيك تاك تو	ox - a game like tic tac toe
โฮม	المنزل	"english word ""home"""
โฮลดิ้ง	القابضة	houlding
ใจดี	نوع	chaidi
ใช่	نعم	yes
ใช้ขยายความเฉพาะบุคคล	استخدم لتخصيص	to describe
ใช้ชื่อว่า	مسمى	named
ใช้เวลา	خذ وقتك	it takes time
ใต้	الجنوب	south
ในกรณีนี้	في هذه الحالة	in this isituation
ในกลุ่ม	في المجموعة	in group
ในการประเมินผลงานวิจัยของสถาบัน	في تقييم نتائج بحث المعهد	in research evaluating of institute
ในการเลือกตั้ง	في الانتخابات	election
ในกาลต่อมา	في المستقبل	later
ในขณะที่	بينما	while
ในคริสต์ศตวรรษที่	في القرن التاسع عشر	in the #___ century
ในคศ	في السنة	in a.d.
ในชิงร้อยชิงล้าน	في تشينغ تشينغ مليون	game show to compete for 1 million baht
ในช่วงปี	خلال العام	in the year of ________
ในช่วงสงครามเย็น	خلال الحرب الباردة	during the cold war
ในช่วงสงครามโลกครั้งที่	خلال الحرب العالمية	in time of world war
ในช่วงสงครามโลกครั้งที่สอง	خلال الحرب العالمية الثانية	during world war ii
ในช่วงหลัง	لاحقًا	later
ในช่วงแรก	في البداية	in the first part, primarily
ในดาร์ฟูร์	في دارفور	inside dafur
ในต่างประเทศ	في الدول الأجنبية	foreign countries
ในทางกลับกัน	من ناحية أخرى	opposite
ในทางดาราศาสตร์	في علم الفلك	astrology
ในทางตรงกันข้าม	على العكس	oppositely
ในบางฉบับ	في بعض الإصدارات	in a certain issue (of a magazine)
ในประเทศญี่ปุ่น	في اليابان	japan
ในปลายปี	في نهاية العام	at teh end of the year
ในปี	في السنة	in the year
ในปีที่	في السنة	in year
ในปีนี้	هذا العام	in this year
ในปีพศ	في السنة	in b.e. year
ในปีพุทธศักราช	في السنة.	in b.e.
ในปีเดียวกัน	في نفس العام	in the same year
ในปีเดียวกันนั้น	في نفس العام	in that year
ในพระบาทสมเด็จพระพุทธยอดฟ้าจุฬาโลก	في عهد الملك بوذا يودفا شولا لوك	under the reign of one of the thailand's past king
ในพระบาทสมเด็จพระพุทธเลิศหล้านภาลัย	في جلالة الملك ، فرا بوذا lertlah ، napalai	under one of the king of siam
ในภายหลัง	لاحقًا	background
ในภาษาสันสกฤต	في السنسكريتية	in sanskrit language
ในภาษาอังกฤษ	باللغة الإنجليزية	in english
ในภาษาอิตาลี่	باللغة الإيطالية	in italian
ในภาษาไทย	باللغة التايلاندية	in the thai language
ในยุคกลาง	في العصور الوسطى	in the middle ages
ในยุคแรก	في البداية	in early age
ในระบบสุริยะ	في النظام الشمسي	in the solar system
ในระยะหลัง	لاحقًا	at the end
ในระหว่างปี	خلال العام	between the years
ในระหว่างวันที่	خلال النهار	during the dates
ในรัชสมัยพระบาทสมเด็จพระจอมเกล้าเจ้าอยู่หัว	في عهد الملك مونغكوت	in the reign of thailand's 4th king
ในรัฐบาล	في الحكومة	in the government
ในฤดูกาล	في الموسم	in season
ในสมัยกรุงศรีอยุธยา	في فترة أيوثايا	in  ayutthaya kingdom era
ในสมัยก่อน	في الأيام الخوالي	in the past
ในสมัยพุทธกาล	في العصر الحديث	in buddha era
ในสมัยรัชกาลที่	في عهد	in period
ในสหรัฐอเมริกา	في الولايات المتحدة	in united states of america
ในหนังสือ	في الكتاب	in book
ในอดีต	في الماضي	in the past
ในอดีตทุ่งกุลาร้องไห้ในฤดูแล้ง	في الماضي ، بكى ثونغ كولا في موسم الجفاف.	thung kula rong hai in dry season in the past
ในอัลบั้ม	في الألبوم	in the album
ในเกมเดอะซิมส์	في لعبة سيمز	sims game
ในเครือ	تابع	in the area of
ในเดือน	في الشهر	in the month of ...
ในเดือนมิถุนายน	في يونيو	in june
ในเดือนมีนาคม	في مارس	in april
ในเบื้องต้น	في البداية	primarily
ในเรื่อง	فيما يتعلق	in story
ในเหตุการณ์	في الحدث	in the event
ในเอเชียตะวันออกเฉียงใต้	في جنوب شرق آسيا	in southeast asia.
ในแฮร์รี่	هاري	in harry
ในโอกาสครบรอบ	بمناسبة الذكرى	anniversary
ใบเสมา	البطانات	boundary marker of a temple
ใหญ่	كبير	large
ให้พลเอกเปรม	للعامة بريم	general prem - a former military figure
ให้สมเด็จพระเทพรัตนราชสุดาฯ	لصاحبة السمو الملكي الأميرة مها شاكري سيريندهورن	given to the thai's eldest princess
ให้เสียงพากย์	التمثيل الصوتي	dubbed
ให้แก่ประชาชน	للشعب	for the people
ให้ใช้หลัก	استخدم المبدأ	large size
ไกรทอง	krai thong	krei thong - a surname
ไกรลาศ	krailat	krailard
ไกลกังวล	قلق	klai kangwon
ไก่	دجاجة	chicken
ไขมัน	الدهون	lipid, fat
ไขสันหลัง	الحبل الشوكي	spinal cord
ไข่	بيضة	egg
ไข้รากสาดใหญ่	التيفوس	typhus
ไข้สูง	حمى عالية	high fever
ไข้หวัดใหญ่สายพันธุ์ใหม่	سلالة جديدة من الانفلونزا	new flu strain
ไข้หวัดใหญ่สเปน	الانفلونزا الاسبانية	spanish flu
ไคเอ็น	kaien	kaien
ไชยกิตติ	تشاي كيتي	chaikitti
ไชยยงค์	تشايونج	chaiyayong
ไชยวัฒน์	شايوات	chaiwat
ไชยา	تشايا	chaiya
ไชโย	في صحتك	chaiyo
ไซน์	جيب	sine
ไซโทสเกเลตอน	زيتوس جايتيلا	cytoskeleton
ไซโปรเฮปตาดีน	سيبرو هيبتادين	cyproheptadine
ไดคลอกซาซิลลิน	دايكلوك سيلين	dicloxacillin - a drug
ไดดาโนซีน	دينوسين	didanosine - medication
ไดอาน่า	ديانا	diana
ไดโนเสาร์ของโนบิตะ	ديناصور نوبيتا	nobita's dinosaur
ได้	احصل	receive
ได้กล่าวว่า	قال	stating that, commenting on something
ได้ดังนี้	على النحو التالي	these
ได้ทูลเกล้าฯ	قدم	report to the king
ได้มีโอกาสสร้างความสัมพันธ์อันดีต่อกัน	لديك الفرصة لبناء علاقات جيدة مع بعضها البعض	good relationship
ได้รับ	احصل	received
ได้รับฉายาว่า	حصل على لقب	recived the alias
ได้รับรางวัล	احصل على جائزة	awarded
ได้ร่วมกันในภารกิจในด้านต่าง	معا في المهمة في مختلف المجالات.	participated in activities
ได้สำเร็จ	بنجاح	successfully
ได้สู้กับ	قاتل مع	competing against
ได้เคลื่อนไหวตรวจสอบการทำงานของรัฐบาลกัมพูชาอย่างแข็งขัน	انتقلت بنشاط لتفقد عمل الحكومة الكمبودية	underground investigation
ได้เป็น	كن	is
ไต	الكلى	kidney
ไต้หวัน	تايوان	taiwan
ไท	التايلاندية	tai
ไทย	التايلاندية	thai
ไทยทีวีสีช่อง	قناة تلفزيونية ملونة تايلندية	thai tv
ไทยพรีเมียร์ลีก	الدوري التايلاندي الممتاز	thai premiere
ไทยรามา	التايلاندية راما	thairama
ไทยานนท์	ثايانون	taiyanon - a thai surname
ไทรโลจี	ثلاثية	trilogy
ไทลื้อ	التايلاندية لوي	group of laotians that lives on flatlands
ไทโรซีน	التيروسين	thyrosine
ไนท์	الليل	sege
ไนลอน	نايلون	nylon
ไนโตรเจน	النيتروجين	nitrogen
ไปจนถึง	إلى	to
ไปบรรจบแม่น้ำเจ้าพระยา	تعرف على نهر تشاو فرايا	runs to chao phraya river
ไปรษณีย์กาฬสินธุ์	مكتب بريد الكلاسين	kalasin post office
ไปรษณีย์ฉะเชิงเทรา	مكتب بريد chachoengsao	cha cheng sao postal zone
ไปรษณีย์นครศรีธรรมราช	مكتب بريد ناخون سي ثامارات	nakornsritamarat postal station
ไปรษณีย์ภูเวียง	مكتب بريد فو ويانغ	pu weang postal office
ไปรษณีย์ยานนาวา	مكتب بريد ياناوا	yan nawa post office
ไปรษณีย์ร้อยเอ็ด	مكتب بريد روي إت	roi et post office
ไปรษณีย์สามเสนใน	مكتب بريد سامسن ناي	samsen nai post office
ไปรษณีย์หนองหาน	مكتب بريد نونغ هان	nong han postal office
ไปรษณีย์อำนาจเจริญ	مكتب بريد أمنة تشاروين	amnat charoen post office
ไปรษณีย์อุทุมพรพิสัย	مكتب بريد uthumphon phisai	utumporn pisai post office
ไปรษณีย์อุบลราชธานี	مكتب بريد أوبون راتشاثاني	ubon ratchathani post office
ไปรษณีย์เดชอุดม	مكتب بريد det	det udom post office
ไปรษณีย์โพนพิสัย	مكتب بريد phon phisai	phon phisai post office
ไผ่แดง	خيزران أحمر	red bamboo
ไพฑูรย์	اللازورد	phaithun
ไพรบึง	غابة	phrai bueng
ไพรวัลย์	بريوان	phraiwan
ไพศาล	عريض	phaisan
ไฟ	النار	fire
ไฟนอลแฟนตาซี	الخيال النهائي	final fantasy
ไฟร์วอลล์	جدار الحماية	firewall
ไมค์	مايك	mike
ไมอามี่	ميامي	miami
ไมโครซอฟท์	مايكروسوفت	microsoft
ไม่ต่ำกว่า	لا تقل عن	not lower than
ไม่ทราบข้อมูล	معلومات غير معروفة	no background information
ไม่บังคับ	اختياري	not enforced
ไม่ผ่านเข้ารอบ	غير مؤهل	did not make it to the next round, got eliminated in the initial round
ไม่มีบันทึกว่าใครเป็นคนสร้าง	لا يوجد سجل لمن أنشأه.	don't note who make id
ไม่มีแขน	لا أسلحة	armless
ไม่ว่าจะ	سواء	such as
ไม่สามารถทำการเกษตรได้	غير قادر على القيام بالزراعة	unable to practice agriculture
ไม่แตกกิ่ง	غير متفرعة	no chain
ไม่ใช่	لا	no
ไม้	الخشب	mai
ไม้กวาด	مكنسة	broom
ไม้หนีบผ้า	ربط الملابس	clip
ไม้ไม่ผลัดใบ	دائم الخضرة	plants that have leaves all year round
ไรงะ	ريغا	reiya - a character from a japanese story
ไรโบโซม	الريبوسوم	ribosome
ไร่	مزرعة	field, parcel
ไลท์	خفيف	light
ไลบร้า	الميزان	libra
ไลฟ์สไตน์	ليفشتاين	life style
ไลเบรชัน	مكتبة	libration
ไวชาน่า	waichana	baishana - weapon in a japanese story
ไวทยางกูร	vittayangkun	wathaiyangkun
ไวทยานนท์	وايتهيانون	waithayanon
ไวท์สเปล	بياض	white spell
ไวน์	النبيذ	wine
ไวยากรณ์	النحو	waiyakorn
ไวรัส	الفيروس	virus
ไวรัสตับอักเสบ	التهاب الكبد	hepatitis
ไวเซิร์ด	(وايس)	vizard
ไวเปอร์	فايبر	viper
ไวเวิร์น	wvern	wyvern
ไวโอเลต	البنفسجي	violet
ไว้ว่า	قل	as
ไหซอง	اللعوب	haisong
ไหมกัน	معا	maigun - a surname
ไหลจากลาวเข้าสู่ภาคเหนือของกัมพูชาแล้วไหลผ่านเข้าเขตเวียดนาม	تدفقات من لاوس إلى شمال كمبوديا وتتدفق إلى فيتنام	flows from laos into northern cambodia
ไอทีวี	itv	itv
ไอน์สไตน์	أينشتاين	einstein
ไอน์สไตเนียม	آينشتينيوم	einsteinium
ไอพอด	آي بود	ipod
ไอริส	القزحية	iris
ไอร์แลนด์เหนือ	ايرلندا الشمالية	northern ireland
ไอเอ	ia	ia
ไอโมบาย	i-mobile	i-mobile
ไอโอ	io	io - from greek mythology
ไฮยาซินธ์	صفير	hyacinth
ไฮเดรนเยีย	كوبية	hydrangea
ไฮเปอร์มาร์เก็ต	هايبر ماركت	tesco lotus hypermarket chain
ไฮแจ็ค	خطف	hijack
ไฮโดรเจน	الهيدروجين	hydrogen
๑๔	14	14
๑๕	15	15
๑๖	16	16
๑๘	18	18
๒๑	21	21
๒๒	22	22
๒๔๕๐	1907	2450
๒๕๐๒	1962	2502
๒๕๐๓	1963	2503
๒๕๒๓	1980	1980
๒๕๓๔	1991	2534
๒๕๓๕	1992	2535
๒๕๓๖	2536	2536 be (1993 ad)
๒๕๔๗	2004	2547
๒๕๔๘	2005	2548
๒๕๕๐	2007	2550
๒๕๕๔	2011	2554
๒๗	27	27
๒๘	28	28
๓	3	3
๔๘	48	48
๕	5	5
๖๐	60	60
๙	9	nine
ព្រះរាជាណាចក្រកម្ពុជា	ព្រះរាជាណាចក្រ កម្ពុជា	cambodia
疾風伝	疾風 伝	not in thai - cannot translate
