+	+	plus sign
=	=	equal to
 °ซ  °ฟ 	° ц ° ф	เซลเซียส ฟาเรนไฮต์
 ซม	центиметар	cm.
 −°ซ  °ฟ	- ° ц ° ф	thai letters
×	×	letter x
γ	γ	y
π	π	pi
กกกก	кг	a thai letter repeated 4 times
กกกข	кхор кхор	4 thai alphabets - jibberish
กขขข	абц б	4 of thai letters
กขขขขขขข	а б а б б б а	abbbbbbb
กฎ	правило	law, rule
กฎของโคไซน์	козине закон	law of cosines
กฎแห่งกรรม	карма	bad karma
กติกา	правила	rule
กทม	бангкок	agency
กนู	книгхт	gnu - computer related acronym
กบ	жаба	frog
กบฏทหารนอกราชการ	војна побуна	coup de lat
กมล	љиљан	kamon
กมลรัตน์	камонрат	kamolrat - a surname
กรณีที่	случај	case
กรมขุนอิศเรศรังสรรค์	кром кхун исет рангсан	the convention of angels
กรมขุนเพ็ชรบูรณ์อินทราชัย	кромкхунпетцхабоон-индацхаи	department of....
กรมข่าวทหารอากาศ	одељење вести ваздухопловства	communication department of the thai air force
กรมควบคุมโรค	одељење за контролу болести	department of disease control
กรมทหารราบที่	пешадијске пуковније	infantry regiment
กรมรบพิเศษที่	одељење специјалних снага	special force group
กรมศิลปากร	одељење ликовних уметности	fine arts department
กรมหลวงนราธิวาสราชนครินทร์	кром луанг наратхиватратцханакхарин	krom ma loung naratifatrachanakarin - the name of a royal family member
กรมหลวงสงขลานครินทร์	кром луанг сонгкхла накарин	prince of songkla
กรมอุตุนิยมวิทยา	метеоролошки одјел	the meteorology department
กรรชัย	канцхаи	kanchai
กรอง	филтер	screen
กระดูกค้อน	чекић	malleus, hammer bone
กระดูกต้นแขน	хумерус	humerus
กระดูกฝ่ามือ	палме	metacapus
กระดูกสะบัก	сцапула	scapula
กระดูกสะบ้า	пателла	kneecap
กระทรวงกลาโหม	министарство одбране	defense ministry
กระทรวงการคลัง	министарство финансија	ministry of finance
กระทรวงการต่างประเทศ	министарство иностраних послова	ministry of foreign affairs
กระทรวงวัฒนธรรม	министарство културе	ministry of culture
กระทรวงศึกษาธิการ	министарство просвете	ministry of education
กระทรวงสาธารณสุข	министарство за јавно здравље	ministry of public health
กระทรวงอุตสาหกรรม	министарство индустрије	ministry of industry
กระทรวงเกษตรและสหกรณ์	министарство пољопривреде и задруге	ministry of agriculture and cooperatives
กระทรวงเศรษฐการ	министарство за економска питања	ministry of commerce
กระทุ่มแบน	мала корпа	krathum baen district, samut songkram province
กระนวน	висина тона	granuan - location in knon kan province
กระนั้น	ипак	however
กระบวนการสร้าง	процес изградње	anabolism
กระบวนการสร้างและสลาย	процес стварања и распада	metabolism
กระบอง	блацкјацк	club
กระบะทราย	кутија са песком	litter box or sand box
กระบี่กระบอง	такмичење са мачевима	krabi krabong (swordplay)
กระรอก	веверица	squirrel
กระวนกระวาย	забринут	nervous
กระหม่อม	глава	fontanelle
กระเพาะอาหาร	стомацх	stomach
กระแต	цхипмунк	wasp
กรับ	покупити	wooden rhythm clappers
กรับพวง	изаберите гомилу	krap phuang
กรับเสภา	крапао	wooden rhythm clappers
กรัม	грам	gram
กรัยวิเชียร	краивицхиан	krivician - a surname
กรานาดา	гранада	granada
กริม	гримм	grim
กรี	греи	karee
กรุง	главни град	city
กรุงธนบุรี	тхон бури	thonburi city
กรุงลอนดอน	лондон	london
กรุงศรีอยุธยา	аиуттхаиа	sri ayuttaya city - former capital of thailand
กรุงเทพ	бангкок	bangkok
กรุงเทพเชียงใหม่กรุงเทพ	бангкок, цхианг маи, бангкок	bangkok changmai bangkok
กรุงเทพโพลล์	анкета у бангкоку	bangkok poll
กรุ๊ป	група	group
กลอง	бубањ	drum
กลองมโหระทึก	велики бубањ	big drum
กลองยาว	бубањ	tom-tom
กลองสองหน้า	двобојни бубањ	glong songna
กลอน	стих	poem
กลอบูลิน	глосси	globulin
กลาง	средња	in the middle
กลิ่น	мирис	odor
กลุ่มดาวกล้องจุลทรรศน์	сазвежђа микроскопа	microscopium
กลุ่มดาวนกทูแคน	тоуцан	tucana
กลุ่มดาวสิ่ว	длето	siu star
กลุ่มดาวเข็มทิศ	компас сазвежђа	pyxis constellation
กลุ่มดาวเตาหลอม	висока пећ	fornax
กลุ่มดาวแมงป่อง	сцорпион	scorpion constellation
กลุ่มดาวแมลงวัน	мухе	musca
กลุ่มที่	група	group
กลุ่มแสงอุษา	уса лигхт гроуп	light at dawn
กลูคากอน	глуцон	glucagon
กล่าวคือ	односно	that is
กล้วยไม้ดาว	звезда орхидеја	type of orchid that have slim petal like star
กล้องถ่ายภาพ	камера	camera
กล้ามเนื้อ	мусцле	muscle
กวม	гуам	obscure
กวาง	јелени	deer
กวิน	кавин	gwen - a name
กวี	песник	poet
กว่า	него	than
กองกลาง	играч средине терена	headquarter
กองการบินทหารเรือ	дивизија морнаричке авијације	the flying section of the navy
กองการศึกษา	одељење за образовање	education group
กองการเจ้าหน้าที่	одељење за особље	division of personnel
กองกำลังกึ่งทหาร	полу-војне снаге	armforces
กองคลัง	благајна	division of finance
กองทัพ	војска	arm forces
กองทัพบกไทย	тхаи арми	thai army
กองทัพภาคที่	војска регије	army area
กองทัพเรือ	морнарица	navy
กองทัพเรือไทย	тхаи нави	the royal thai navy
กองทัพแห่งความชอบธรรม	војска праведности	army of the righteous
กองทัพไทย	тајландска војска	thai military forces
กองบิน	ратно ваздухопловство	air force
กองบินปีกหมุนที่	винг спиннинг винг	flight corp number __________
กองพลทหารม้าที่	коњичка бригада	cavalry division
กองพันทหารช่างที่	инжењерска бригада	troop unit number ___________`
กอด	загрлити	kord
กอนซาเลซ	гонзалез	gonzales - a name
กอร์ดอน	гордон	gordon
กอลมเบต์	гореме	glombet - a catholic priest
กอล์ฟ	голф	golf
กอล์ฟไมค์	голф микрофон	golf-mike
กะเหรี่ยง	карен	karen
กะโหลก	лобања	skull
กะโหลกศีรษะ	лобања	skull; cranium
กังหันชัยพัฒนา	цхаипаттана турбине	chaipattana's windmill
กันดั้ม	гундам	gundam - a cartoon
กันตัง	кантанг	kuntun in trung state
กันทรลักษ์	кантхаралак	kuntaraluk - an area in thailand
กันฟอร์ม	образац	gun form
กันอริ	канори	gan-ari
กันเอง	љубазно	casual
กับนางสุจาริณี	са госпођом суцхаринее	with mrs. sujarinee
กัมปูเชีย	кампуцхиа	kampuchea
กัมพูชา	камбоџа	cambodia
กัมพูชาประชาธิปไตย	демократска камбоџа	democratic kampuchea
กัมพูชาเป็นประเทศที่มีป่าไม้อุดมสมบูรณ์มากที่สุดหากเปรียบเทียบกับประเทศเพื่อนบ้าน	камбоџа је земља са најбројнијим шумама у поређењу са суседним земљама.	cambodia is the country with nice, healthy forests
กัมพูชาเป็นอดีตประเทศอาณานิคมของฝรั่งเศสในภูมิภาคเอเชียตะวันออกเฉียงใต้เพียงแค่ประเทศเดียวเท่านั้นที่มีการปกครองด้วยระบอบราชาธิปไตยภายใต้รัฐธรรมนูญ	камбоџа је једина бивша француска колонијална земља у југоисточној азији која има монархију према уставу.	cambodia was a former french colony
กัมพูชาเป็นอาณานิคมของฝรั่งเศสมาตั้งแต่พศ	камбоџа је од тада француска колонија.	cambodia was a france colony from year
กัวเตมาลา	гватемала	guatemala
กานซู	гансу	honshu in china
กานต์	кан	kan
กานา	гана	ghana
กานามัยซิน	канамицин	kanamycin
กาบอง	габон	baton
กาพย์ฉบัง	епска песма	poem
กาพย์สุรางคนางค์	песма	gabsuranknang
กาม	вантон	lust
กาย	тело	body
การ	тхе	project
การกีฬา	спорт	sport
การขัดเกลาทางสังคม	социјализација	socialization
การขับถ่าย	излучивање	excretion
การขับไล่	деложација	discharge
การคมนาคม	превоз	transportation department
การคลัง	финансије	public finance
การค้นพบ	откриће	discover
การค้า	трговина	marketing
การจัดการ	менаџмент	project
การจัดการคุณภาพ	управљање квалитетом	quality control
การจัดอันดับ	рангирање	ranking
การจัดให้มี	обезбеђивање	putting together something
การจูบ	пољубац	kissing
การชัก	нападај	the act of pulling the flag wiht string up the pole
การดำเนินการ	операција	progression
การตอบรับ	повратна информација	welcoming
การตั้งถิ่นฐาน	поравнање	start a project
การต่างประเทศ	спољни послови	foreign affairs
การทำงานของ	рад	function
การทำป่าไม้	шумарство	forestry
การท่องเที่ยว	туризам	tourism
การท่าเรือ	порт аутхорити	port authority
การบริการ	услуга	customer service
การบริหารการพัฒนา	управљање развојем	development
การบริหารการศึกษา	образовна администрација	educational administration
การบริหารจัดการ	менаџмент	management
การบริหารราชการแผ่นดิน	државна управа	administration
การบินไทย	тхаи аирваис	thai airways
การปกครองท้องถิ่น	локална самоуправа	local administration
การปกครองส่วนท้องถิ่น	локална самоуправа	local government
การปกครองแบ่งออกเป็น	правило је подељено на	administration
การปฏิรูประบบจัดเก็บภาษีเงินได้	реформа система наплате пореза на доходак	taxation reform
การปฏิรูปศาสนา	реформација	religious reformation
การปฏิวัติฝรั่งเศส	француска револуција	french revolution
การปฏิวัติอุตสาหกรรม	индустријска револуција	industrial revolution
การปฏิสนธิ	гнојидба	fertilisation
การประมง	рибарство	fishery
การพัฒนา	развој	development
การพัฒนาประชาธิปไตย	демократски развој	democratic development
การพูด	говорећи	speaking
การยึดครองมะละกาของโปรตุเกสในปี	португалска окупација мелаке године	portugal took over malaga
การระบาดของไข้หวัดใหญ่สายพันธุ์ใหม่	нови сој грипа	flu pandemic
การรักษาพยาบาล	медицински третман	nursing care
การร่วมเพศทางทวารหนัก	анално јебање	sodomy
การลดรูป	деформисање	reduction
การละเล่นพื้นบ้าน	народне игре	local game
การวิจัย	истраживање	researching
การวิเคราะห์	анализа	analysis
การศึกษา	образовање	study of, education
การสังคายนาครั้งที่	последња наредба	the event of convention of monks
การสั่นพ้อง	резонанца	resonance
การสำเร็จความใคร่ด้วยตนเอง	мастурбација	masturbation
การสืบพันธุ์	репродукција	reproduction
การสื่อสาร	комуникација	communications
การาจ	гаража	garage
การุณ	карун	karoon
การเต้นรำ	плес	dance
การเพิ่มสิทธิประโยชน์แก่นักลงทุนต่างประเทศ	повећање привилегија за стране инвеститоре	increase benefits for foreign investors
การเล่น	да играмо	play
การแข่งขัน	такмичење	competition
การแบ่งพื้นที่	подела	land division
การใช้คำ	употреба речи	terminology
การไฟฟ้าส่วนภูมิภาค	покрајинска управа за електричну енергију	distribution electric transformer
การไหว้	поштовање	thai greeting
การ์ด	картица	guard
กาฬสินธุ์	каласин	katsin - a thai surname
กาเวน	гаваин	gawain
กาเหว่าที่บางเพลง	гавран неких песама	the cuckoo's song.
กำกับการแสดงโดย	режирао	produced by (movie)
กำกับโดยอภิชาติพงศ์	режија: апхицхат понг	produced by apichartpong - a famous thai movie producer
กำมะถัน	црево	sulfur
กำลังจะปรับเปลี่ยนเป็น	идемо на промену у	is changing to
กำหนดตามสภาพภูมิศาสตร์	одређено географијом	geography estimation
กำแพงเพชร	кампхаенг пхет	kamphaeng phet
กำแพงเมืองจีน	велики зид	the great wall of china
กำแพงแสน	кампхаенгсаен	kampangsaen (name of district)
กิจผลิต	производња	kitpalit (last name)
กิมป์	гимб	gimp - gnu image manipulation program
กิโลกรัม	кг	kilogram
กิโลไบต์	кб	kilobyte
กิ่งแก้ว	кингкаев	kingkaeo
กิ้งกือ	миллипеде	millipedes
กิ๊ก	кик	gig
กีฏวิทยา	ентомологија	entomology
กีฬา	спорт	sports
กีฬาทางน้ำ	водени спортови	water sports
กีฬาแหลมทอง	лаем тхонг спорт	seap games
กุดจับ	калуп	good jub - a place
กุลดิลก	кулдилок	kuldilok
กุลละวณิชย์	кулалаванит	kullawanich
กุหลาบ	ружа	kularb (first name)
กุ้ง	козице	shrimp
กุ้งต้ม	куване козице	boiled shrimp
กูเกิล	гоогле	google
ก็คือ	ис	which is
ก็ใช้เป็น	користи као	utilize
ก่อตั้ง	основан	founded
ก่อตั้งโดย	основали	make by
ก่อนที่	пре него што	before
ก่อนที่จะตกเป็นของฝรั่งเศสในเวลาต่อมา	пре него што касније постане француска	belonging to france, under the control of france
ก่อนหน้านั้น	пре тога	before
ก้อย	пинки	koi
ก้าน	стабљика	thorn
ก้านกล้วย	стабљика банане	kankluai
ก๊าซธรรมชาติ	природни гас	natural gas
ก๎ล	поклон	magic
ขขขขขขขขขข	б б б б б б б	repeated letter from thai alphabet
ขณะทรงพระเยาว์	док је био млад	having to do with the young prince or princess
ขณะที่	док	while
ขนม	бомбона	dessert
ขนมกล้วย	банана	banana dessert
ขนมครก	кнмцрк	kind of thai sweetmeat
ขนมปัง	хлеб	bread
ขนมปังขิง	медењак	gingerbread
ขนมเปียกปูน	рхомбус	a type of thai dessert with flour and sugar
ขนมไทย	тајландски десерт	thai dessert
ขนสัตว์	вуна	fur, animal hair
ขนอม	кханом	kanom - location in thailand
ขนาดหน้าตัก	величина круга	length between both knees of buddha statue in posture of meditation
ขนาดใหญ่	великих димензија	l
ขบวนการอ๊บอ๊บป่วนโลก	кретање земље	original name is keroro gunso
ขบวนรถสินค้า	воз	caravan of trucks
ขม	горко	bitter taste
ขรรค์ชัย	кан цхаи	kanchai - a male's name
ขลุ่ยหลิบ	флаута	khlui lib
ขวด	боца	bottle
ขวัญ	морале	morale
ขวัญใจช่างภาพ	вољени фотограф	miss photogenic
ขสมก	миса	an acronym consists of four thai letters
ของ	од	of
ของทุกปี	сваке године	every year
ของประเทศจีน	кина	owned by china
ของมหาวิทยาลัย	универзитета	of university
ของมัน	његово	their
ของร่างกาย	тела	of the body
ของสมเด็จฮุน	сомдеја хуна	houssaine of cambodia
ของสิ่งมีชีวิต	живих ствари	living things
ของสุนทรภู่	сунтхорн пху	belong to soon thong pu (a thai legend)
ของเหลว	течно	liquid
ของโลก	света	of world
ขอนแก่น	кон кен	khon kan - an area in thailand
ขอบคุณที่รักกัน	хвала ти што ме волиш	thank you for loving each other
ขอเช็ดน้ำตา	обришемо сузе	wipe the tears
ขอให้เด็กสมัยปฏิวัติของข้าพเจ้า	нека моја револуционарна деца	i hope that the children in my lifetime will ____________
ขั้นที่	корак	level
ขา	нога	leg
ขาย	продати	sell
ขิง	ђумбир	ginger
ขิม	дулцимер	kim - a thai musical instrument
ขีดเส้นใต้	подвући	underline
ขี้ผึ้ง	восак	wax
ขึ้นเป็น	до	to
ขึ้นไป	горе	next one up
ขุขันธิน	кхан тин	kukuntin
ขุนหาญ	хан	koonhan - a location in thailand
ข้อมูลทั่วไป	опште информације	general information
ข้อมูลประเทศเดนมาร์ก	данска информације	information on denmark
ข้อมูลปรากฏการณ์โลกร้อน	феномен глобалног загревања	global climate change
ข้อมูลปี	подаци о години	information from the year ________
ข้อมูลอื่นๆ	остале информације	other information
ข้อมูลโดย	дата би	information from
ข้อวิพากษ์วิจารณ์	критика	critique reports
ข้ามฉาก	преко сцене	sin(a)
ข้าวสาลี	пшеница	wheat
ข้าวหลาม	кхао лам	bamboo rice
ข้าวเกรียบปากหม้อ	пиринчани крекери	a thai snack
ข้าวเจ้า	неолушан	white rice
ข้าวโพด	кукуруз	corn
ข้าหลวงกำกับราชการเมืองขุขันธ์คนที่	гувернер, гувернер града кхукхан	government worker for ku khan city
ฃ	ฃ	a letter from thai alphabet
คงยิ่ง	врло могуће	kongying
คงเจริญ	вероватно напредује	khongcharoen
คณะครุศาสตร์	педагошки факултет	education department
คณะครุศาสตร์อุตสาหกรรม	факултет за индустријско образовање	faculty of industrial education
คณะที่	факултет у	the current administration
คณะบัญชี	факултет за рачуноводство	accounting department (major)
คณะปฏิรูปการปกครองแผ่นดิน	револуционарни одбор	national administrative reform council
คณะประมง	рибарски факултет	fishery division of the college of farming and agriculture
คณะพยาบาลศาสตร์	факултет за негу	nursing department
คณะมนุษย์ศาสตร์และสังคมศาสตร์	факултет хуманистичких и друштвених наука	humanity department
คณะรัฐมนตรีคณะที่	кабинет	council of ministers
คณะวิทยาการจัดการ	факултет науке о менаџменту	management department
คณะวิศวกรรมศาสตร์	факултет техничких наука	engineering department
คณะศิลปกรรมศาสตร์	факултет ликовних уметности	faculty of fine arts
คณะสถาปัตยกรรมศาสตร์	архитектонски факултет	faculty of architecture
คณะสหเวชศาสตร์	факултет сродних здравствених наука	อังกฤษ   faculty of allied health science
คณะสาธารณสุขศาสตร์	факултет за јавно здравство	faculty of public health
คณะเกษตร	пољопривредни факултет	faculty of agriculture
คณะแพทยศาสตร์ศิริราชพยาบาล	медицински факултет болница сирирај	faculty of medicine siriraj hospital
คณะแพทยศาสตร์โรงพยาบาลรามาธิบดี	медицински факултет, болница раматхибоди	the staff of ramatippadee hospital
คณารศ	канара	kanaros - a surname
คนที่	особа која	person number __________________________
คนที่ไปช่วยรุ่นที่	људи који су помогли генерацији	volunteer group number __________
คนแคระ	патуљак	dwarf
คนแรก	прво лице	first
คปค	година	3 thai letters
คม	оштар	sharp
ครอคโคไดล์	крокодил	crocodile
ครอบครัว	породица	family
ครั้งหนึ่ง	једном	once upon a time
คราประยูร	праиун	karaprayoon - a thai surname
คราม	индиго	indigo
คริส	цхрис	christ
คริสตี	цхристи	christie - a female name
คริสต์ศาสนา	хришћанство	christainity
ครุฑ	гаруда	garuda
ครู	учитељ	teacher
ครูพิเศษจอมป่วน	наставник трола	kru pisat jom poun  - name of a story
คลอง	канал	canal
คลองสาน	кхлонг сан	klongsan
คลองเตย	кхлонг тоеи	klongtoei
คลับ	клуб	club
คลาวิคอร์ด	класа	clavichord
คลิก	кликни	click
คลินิก	клиника	clinic
คลิป	клип	clip
คลื่นสึนามิ	цунами	tsunami wave
ควอน	квон	kwon - a surname of a korean singer
ควอร์เตอร์	четвртина	quarter
ความกว้าง	ширина	width
ความงาม	лепота	beauty
ความจำ	меморија	memory
ความต่างศักย์	разлика потенцијала	potential difference in physics
ความถี่	фреквенција	frequencies
ความนิยม	популарност	popular
ความบริสุทธิ์	чистоћа	purity
ความฝันอันสูงสุด	врхунски сан	the impossible dream
ความพอประมาณ	скромност	estimate
ความยากจน	сиромаштво	poverty
ความยาว	дужина	length
ความยาวคลื่น	таласна дужина	frequencies
ความยาวช่วงคลื่น	таласна дужина	wave length
ความยาวเพลง	дужина песме	the length of the song
ความรัก	љубав	love
ความรู้	знање	knowledge
ความสว่าง	осветљеност	illumination
ความสัมพันธ์กับประเทศไทย	односи са тајландом	relationship with thailand
ความสัมพันธ์ระหว่างจีนกับอเมริกา	односи кине и америке	relationship with china and the usa
ความสูง	висина	height
ความส่องสว่าง	осветљеност	luminance
ความหนาแน่นของประชากร	густина насељености	population density
ความหมาย	значење	meaning
ความหมายโดยพยัญชนะ	сугласничко значење	definition that derived from translation from another language
ความเข้มของการส่องสว่าง	јачина осветљења	luminous intensity
ความเข้าใจ	разумевање	understanding
ความเร่ง	убрзање	acceleration
ความโกรธ	љутња	anger
ความโน้มถ่วง	гравитација	gravity
ควินโต	куинто	quinto
ควีนซี่	краљица	quincy
คอ	врат	neck
คอนสตรัคชั่น	конструкција	construction
คอนเวนชัน	конвенције	convention
คอนเสิร์ตประสานเสียงสามสถาบัน	концерт збора три института	chulalongkorn kasetsart thammasat choral concert
คอมพิวเตอร์ยุคที่	компјутерска ера	_-generation computer (as in frist generation, second generation etc)
คอร์ด	акорд	chord
คอลลิงวูด	цаллингвоод	collingwood
คอสตาริกา	костарика	costa rica
คัง	канг	kan
คัชชินสกี	кутцхински	kaczyński
คัญทัพ	важна војска	main army.
คัทลียา	цаттлеиа	kathaleeya (thai first name)
คันธวงศ์	кантхавонг	kunntavong - a surname
คัพ	цуп	cup
คัมภีร์	писмо	bible
คั่ว	печено	dry roasting
คาคาชิ	какасхи	cacashi
คางาริ	кагари	kagari
คาซัคสถาน	казахстан	kazakhstan
คาถาอัญเชิญ	интантација	a magic spell
คาบ	раздобље	frequency
คาบัคโรเน่	кабакхрооне	kyabarrone
คาบูโตะ	кабуто	kabuto
คาปูชิโน่	капућино	cappuccino
คามิว	камуи	camus
คาราคุระ	каракура	karakura
คาร์ล	царл	karl
คาวทอง	фисхионг	lizard tail
คาเมนไรเดอร์	камен ридер	kamen rider
คาโรลัส	царолас	carolus linnaeus
คำขวัญวันเด็ก	слоган дана детета	quote for kids day
คำถามข้อที่	број питања	the question number_________
คำนวณ	израчунати	calculate
คำนาม	именица	noun
คำพ้องรูป	синоними	hemonym
คำมั่นสัญญา	обећај	agreement
คำม่วง	кхам муанг	kham muang
คำวิลัยศักดิ์	камвилаи сак	important words, magic words
คำศัพท์	вокабулар	word
คำสรรพนาม	заменица	pronoun
คำสร้อย	ворд	kumsoi - a country singer
คำสุดท้ายของวรรคที่	посљедња ријеч одломка	the last word (in a poem)
คำสุภาพ	пристојна реч	formal
คำอธิบาย	опис	explanation
คำเมือง	градска реч	kum meuong - a location in chiang mai
คำแปล	превод	translation
คิง	краљу	king
คิงส์	краљеви	kings
คิงส์คัพ	кинг&#39;с цуп	king's cup
คิงไลเนอร์	кинглинер	kingliner
คิชิเนีย	кисхиниа	kishinia
คิด	мисли	thinking
คินนิคุแมน	кинникуман	kinkiku man
คิมิฮิโระ	кимихиро	kimihiro
คิระ	кира	kira - japanese name
คิเคียว	кикио	kikyo
คีตกวี	композитор	composer
คือประมาณ	је око	estimated to be
คือเพลง	је песма	is the song
คุณ	ти	you
คุณครูจอมเวท	учитељ мађионичара	magister
คุณปลื้ม	кхун плуем	kunpleam
คุณหญิงโม	царица мо	suranaree
คุณากร	ти	khunakon
คุราปิก้า	курапика	kurapika
คุโรซึจิ	куротсуји	kurochiji - a japanese word
คุ้มค่า	добра вредност	worth the money spent on
คูกิมิยะ	кукимииа	kugimiya
คูคาคุ	куку	kukaku (japanese last name)
คูเรียม	цуриум	"chemical element ""curium"""
คูเวต	кувајт	kuwait
คู่กรรม	партнер	soul mate
ค่าความต้านทานตัวที่	вредност отпора која	resistance value of the
ค่าจีดีพี	бдп	gdp - an economics term
ค่าใช้จ่าย	трошкови	expense
ค่ำแล้ว	сумрак	getting dark, at dusk
ค้างคาว	шишмиш	bat
ฆ	јуан	a letter from thai alphabet
ฆ้อง	гонг	gong
ฆ้องวงใหญ่	велики гонг	a group of thai drum music
งดส่งเข้าประกวด	забрањен улаз	enroll in the contest
งาน	посао	work, job
งานอดิเรก	хоби	hobby
งานเขียน	вритингс	writing, composition work
งานเทางามสัมพันธ์	тао нгам однос	public party
งานโมเสก	мозаик	mosaic
งามวงศ์วาน	нгамвонгван	ngamwongwan
งู	змија	snake
งูอนาคอนดา	анаконда	anaconda snake
จดหมายอากาศ	ваздушна пошта	aerogram
จตรัง	транг	trang province (name of province in thailand)
จตุรงค์	цхатуцхак	jaturong - a surname of a comedian
จนกระทั่ง	све док	until
จนกระทั่งปี	до године	until the year
จนกระทั่งเมื่อปี	до прошле године	until the year
จนครปฐม	накхон патхом	nakorn pratom state
จนมีคำกล่าวว่า	све док то није речено	said
จน่าน	пон	nan state
จบุรีรัมย์	бурирам	burerum state
จมูก	нос	nose
จระเข้และแอลลิเกเตอร์	крокодил и алигатор	crocodile and alligator
จรัญญา	цхараниа	jarunya - a surname
จริยธรรม	етика	ethics
จริยศาสตร์	етика	ethics
จริยา	дама	jariya
จลำพูน	лампхун	jalumpoon - a place in thailand
จสตูล	сатун	stoul state
จสุราษฎร์ธานี	сурат тхани	surat thani province
จอมบึง	отечен	chom bueng
จอมพลถนอม	цхом пхон тханом	field marshal thanom
จอมพลสฤษดิ์	фелдмаршал сарит	field marshal sarit
จอมพลเรือ	брод маршал	the general of the navy
จอมเทียน	јомтиен	jom tien - a location in thailand
จอร์เจีย	георгиа	georgia
จะต้องหาตัวแทนลงจากเวที	морате наћи представника који ће сићи са бине	find a teammate to leave the stage, a unique game
จะเขียนว่า	рећи ће	written as
จะเข้	цитер	jakhe
จะได้	ће добити	results in
จักจั่น	цицада	chakkachan
จักรพรรดิเนอร์วา	царева нирвана	emperor nerva
จักรพรรดิไททัส	цара тита	titus (flavius vespa)
จักรพันธุ์	цхаппхан	chakrabhand
จักรวาลวิทยา	козмологија	cosmology
จังหวัด	провинција	province
จังหวัดกระบี่	провинција краби	krabee state
จังหวัดกาญจนบุรี	канцханабури	kanchanaburi province
จังหวัดกาฬสินธุ์	каласин	kalasin province
จังหวัดขอนแก่น	провинција кхон каен	khon kaen province
จังหวัดคยองกี	гиеонгги провинце	the state of kyong gee
จังหวัดคยองซาง	провинција гиеонгсанг	kyongchang province
จังหวัดฉะเชิงเทรา	цхацхоенгсао	chachoengsao province
จังหวัดชุมพร	цхумпхон	chumphon province
จังหวัดตราด	провинција трат	trat province
จังหวัดตาก	так провинција	tak province
จังหวัดนครปฐม	провинција накхон патхом	nakhon pathom province
จังหวัดนครพนม	провинција накхон пханом	nakorn panom state
จังหวัดนครสวรรค์	накхон саван провинце	nakorn sawan province in thailand
จังหวัดน่าน	нан провинција	nan state in the north east of thailand
จังหวัดปัตตานี	паттани провинце	pattani state
จังหวัดพระนครศรีอยุธยา	пхра накхон си аиуттхаиа	nakon sri ahyutthaya province
จังหวัดพังงา	провинција пханг нга	phang nga province
จังหวัดพิษณุโลก	пхитсанулок провинце	pisanulok state
จังหวัดมหาสารคาม	провинција маха саракхам	maha sarakham province
จังหวัดยโสธร	иасотхон	yasothorn province (name of thai province)
จังหวัดระยอง	раионг	rayong province
จังหวัดราชบุรี	ратцхабури	ratchaburi province
จังหวัดลำพูน	лампхун	lamphun province
จังหวัดสงขลา	сонгкхла	songkla province
จังหวัดสมุทรสงคราม	провинција самут сонгкхрам	samut songkhram province
จังหวัดสิงห์บุรี	синг бури провинце	sing buri province
จังหวัดหนองบัวลำภู	провинција нонг буа лампху	nong bua lamphu province
จังหวัดอุดรธานี	провинција удон тхани	udon thani state
จังหวัดเชลลา	схелла	chella city
จังหวัดเชียงราย	цхианг раи	chianrai province
จังหวัดเชียงใหม่	провинце оф цхианг маи	chiang mai province
จังหวัดเพชรบุรี	провинце оф пхетцхабури	petcharaburi state
จังหวัดเพชรบูรณ์	пхетцхабун	petchabun province
จังหวัดเลย	провинција лоеи	loei (name of thai province)
จังหวัดแพร่	пхрае	prae state
จังหาร	јунгхан	changhan
จัดขึ้นเมื่อ	одржаној	occur on the date of _______________
จัดตั้งขึ้นโดย	основао	produced by
จัดอยู่ในภูมิภาค	организовано у региону	in region
จัดเมื่อวันที่	одржаној	็held on the date of ...
จัดโดย	организовао	arrange by
จัน	цхан	chan
จันทบุรี	цхантхабури	juntaburi state
จันทร	месец	chantorn
จันทรุปราคา	помрачење месеца	lunar eclipse
จันทร์	понедељак	chan
จันทร์ภักดี	цхан пхакди	juntapukdee - surname of a famous actor
จันทร์เกษ	цхан кет	juntagaset - a surname
จาก	од	from
จากการพิสูจน์อายุโดยคาร์บอน	из доказа о старости угљеником	from the forensic carbon dating
จากภาษากรีก	из грчке	greek language
จากละคร	из драме	from drama
จากละครเรื่อง	из драме	from the soap opera
จากสารานุกรมบริทานิกา	из енциклопедије британница	from printed information
จากอัลบั้ม	са албума	from the album
จากเรื่อง	из приче	from the story of ...
จากเว็บ	са интернета	from the web
จากเว็บไซต์กระทรวงการต่างประเทศ	са веб странице министарства спољних послова	from the website of foreign department
จากเว็บไซต์กระทรวงต่างประเทศ	са веб странице министарства спољних послова	from the foreign government affairs website
จากโซล	из сеула	from soeul
จาติกวณิช	цхатикаваниј	chatikavanij
จามจุรี	цхамцхури	jamjuri flower
จารีตประเพณี	традиција	tradition from the culture
จารุเสถียร	јару сатхиен	charusathien
จาวตาลเชื่อม	јао тан велд	sweetened palm - a type of thai dessert
จำกัด	лтд.	limited
จำกัดมหาชน	ограничен	public limited
จำนวน	број	amount
จำนวนประชากร	популација	population
จำปาเทศ	цхампа	a specific type of magnolia tree; similar michelia champaca
จำเริญ	просперирати	jamroen
จิกะไบต์	јигтес	gigabyte
จิตรกร	сликар	painter
จิตรกรรม	сликање	arts and craft or music
จิตวิทยา	психологија	psychology
จิตใจ	ум	heart; feelings
จินตหรา	јинтара	jinnara - a female's name who is a singer
จิบูตี	џибути	ji bu dee event on june 27
จิบเบอเรลลิน	гиббереллин	gibberellin
จิม	јим	jim
จิโอวานนี	гиованни	giovanni
จี	ји	g
จีนตัวย่อ	поједностављени кинески	simplified chinese characters
จียอน	јииеон	๋jiyeon (korean name)
จึงทรงพระกรุณาโปรดเกล้า	зато љубазно наређено	be kind enough to
จึงเปิดโอกาสให้	стога је дао прилику	open up opportunities
จึงใช้ธาตุหมอกและเมฆาได้	због тога можете користити елемент маглице и облака	using magic with cloud and spells
จุกนมสีขุ่น	непрозирни чај	corrupted pacifier
จุดกึ่งกลาง	мидпоинт	midpoint
จุดจอมฟ้า	плава тачка	zenith
จุลจอมเกล้าเจ้าอยู่หัว	вајиралонгкорн	phra chunla chom klao chao yu hua
จุฬาลงกรณินทรวรางกูร	цхулалонгкорн нинтхарангрангкун	new title for the princess
จูล	јоуле	joule
จูเซปเป	гиусеппе	giuseppe
จูเนียร์	млађи	junior
จเชียงใหม่	цхианг маи	chiang mai province
จเพชรบุรี	пхетцхабури	pedchaburee province
จเพชรบูรณ์	пхетцхабун	province pechaboon
จ๊กมก	јумкум	jokmok - a surname of a comedian
ฉ	ф	ninth thai alphabet
ฉบับชั่วคราว	привремена верзија	special (temporary) edition
ฉบับวณิพก	бројеви	begger version
ฉลอง	прославити	celebrate
ฉลองพระชนมายุ	прослави 80. годину	celebrated birth anniversary of
ฉันรักคุณ	волим те	i love you
ฉาบ	малтер	cymbal
ฉายเมื่อ	приказана	aired
ฉิ่ง	цимбал	small cup-shaped cymbals
ฉี่	пишкити	qi
ชนะ	победити	winning
ชนิด	тип	kind
ชนิดของเมฆ	облак типа	types of clound
ชม	гледати	chom
ชมชื่น	комплимент	chomchuen
ชมพู	розе	rose apple
ชมพูทวีป	индија	south asia
ชมพู่	розе јабука	syzygium
ชล	језера	chol (first name)
ชลธารวิทยา	цхалоем виттаиа	limnology
ชลบุรี	цхон бури	cholburi state
ชลิต	цхалит	chalit - a male's name
ชวนชื่น	позив	choun cheen - a surname
ชอบ	као	chop
ชะนี	гибон	gibbon
ชะมด	мошус	anteater
ชะอวด	правити се важан	chaoud - location in thailand
ชะอำ	цха-ам	cha-am (name of thai district)
ชัชพล	цхатцхапон	chatchapol - a male's name
ชัย	победа	chai
ชัยชนะ	победа	chaichana
ชัยนาม	цхаи нам	chainam
ชัยบัญชา	цхаи банцха	chaibancha
ชัยมงคล	цхаимонгкол	chaimongkol - a male's name
ชัยยุทธ	цхаииут	chaiyuth (first name)
ชั้น	класа	class
ชั้นที่	под	order
ชั้นประทวน	под	non-commissioned officer
ชั้นมหาวชิรมงกุฎ	класа цровн маха вацхира	order of the king's jewels
ชั้นยศ	ранк	millitary rank
ชั้นสูงสุด	највиши ниво	special class
ชา	чај	tea
ชากะ	схака	shaka
ชาคริต	узбуну	charkrit
ชาญชัย	цханцхаи	chanchai - a thai name
ชาตะ	родити се	born
ชาติ	нација	nation
ชาย	мушки	male
ชาร์ป	оштар	sharp
ชาร์ล	цхарлес	charles
ชาร์ลส	цхарлес	charles
ชาลส์	цхарлес	charles
ชาลี	цхарлие	charlie
ชาวนา	земљорадник	farmer
ชาวไทย	тајланђани	thai
ชาวไทยภูเขา	племе хилл	thai hill tribe
ชำนิ	цхамни	chumni - a location in thailand
ชิคิกามิ	схикиками	shikigami
ชิงร้อย	такмичити се	ching roi
ชิงร้อยล้าน	такмичите се за сто милиона	ching roi lan
ชิซุกะ	схизука	shizuka
ชิดจันทร์	цхидцхан	chidjun (a person's last name)
ชิน	навикли	get used to
ชินวัตร	схинаватра	shinawatra
ชิริว	цхириу	cherew - a japanese character
ชิลี	чиле	chilli
ชิโนะ	цхино	shino
ชีพด็อก	овчар	chief dog
ชีวนิชพันธ์	биолошки	chiwanitphan
ชีวประวัติ	биографија	biography
ชีวมวล	биомаса	alternative (natural) power
ชีวสถิติ	биостатистика	biometry, biostatistics
ชื่อดัง	познато	famous
ชื่อนามสกุล	име презиме	name-lastname
ชื่อภาษาญี่ปุ่น	јапанско име	japanese name
ชื่อภาษาอังกฤษ	енглески назив	english name
ชื่อยศภาษาไทย	тајландски ранг	thai title
ชื่ออัลบั้ม	назив албума	album name
ชื่ออื่น	друга имена	synonym
ชื่อเก่าในวงการ	старо име у индустрији	old stage name
ชื่อเดิม	бивше име	old name
ชื่อเมือง	име град	city's name
ชื่อเรื่อง	наслов	the name of the story
ชื่อเล่น	надимак	nickname
ชุดแพนเค้ก	сет палачинки	pancake
ชุติมา	цхутима	chutima
ชุมชนออนไลน์ชาวจังหวัดสกลนคร	сакон накхон онлине заједница	sakon nakhon people online community
ชุมพลบุรี	цхумпхон бури	chompolburi area
ชุมแพ	цхум пхае	choompa - location in thailand
ชุมแสง	цхум саенг	choomsang - a male's name
ชูมันน์	сцхуманн	schumann
ชูศักดิ์	цхусак	chusak
ชโย	браво	cheer; hurray
ชไนเดอร์	сцхнеидер	schneider
ช็อกโกแลต	чоколада	chocolate
ช่วงปี	период године	between year
ช่อง	канал	channel
ช่องเชิงเทิน	баттлементс	machicolation
ช้อน	кашика	spoon
ซ	ц	the eleventh letter of the thai alphabets
ซน	несташан	crashing into
ซบที่อกฉัน	гнезди ми се у грудима	cry in my arms
ซอมบี้	зомбији	zombie
ซออู้	золошки врт	a woodwind thai instrument
ซันไชน์	сунце	sunshine
ซัลฟานิลาไมด์	сулфаниламид	salfanilamide
ซัลฟาไดอะซีน	сулфадиазин	sulfadiazine
ซัลเฟต	сулфате	sulphate
ซากดึกดำบรรพ์	фосил	fossil
ซาคุโร่	сакуро	zakuro - a japanese character
ซาซางาวะ	сасагава	sasangngawa - a japanese name
ซานกัลโล	сан галло	sangallo family
ซาบุซะ	сабуза	zabuza
ซาลาดิน	саладин	saladin
ซาอิ	саии	chai - a japanese name
ซาโลมอน	саломон	salomon
ซิกนัส	цигнус	signus
ซิงเกอร์	сингер	sinder
ซิงเกิ้ล	синглес	single
ซิทคอม	ситцом	sitcom
ซินเดอเรลล่า	пепељуга	cinderella
ซิมไฟลา	симпхила	class symphyl
ซิโนไทย	сино тхаи	sino-thai
ซี	ц	see
ซีซี	цц	cc
ซีรีเบลลัม	серабеллум	cerebellum
ซีลีเนียม	селен	selenium (chemical element)
ซีสต์	цисте	cyst
ซีเกมส์	сеа гамес	southeast asian game
ซีเจ	цј	cj
ซีเซียม	цезијум	cesium
ซีเนม่า	биоскоп	cinema
ซีแคนต์	сецант	secant
ซีโร่	нула	zero
ซึง	која	feeling touched (by the music or movie)
ซึม	продирати	absorb
ซึ่ง	која	because
ซึ่งประกอบด้วย	који се састоји од	consists of
ซึ่งมี	који има	with
ซึ่งมีความหมายว่า	што значи	meaning
ซึ่งมีทั้งหมด	које има све	in total of
ซึ่งรู้จักกันว่า	која је позната као	called
ซึ่งเกิดจากปัจจัยภายนอก	узрокују га спољни фактори	which is caused by external factors
ซึ่งเรียกว่า	која се зове	called
ซึ่งแท้จริงแล้ว	у истини	real name
ซึ่งได้แก่	који су	such as
ซุง	пријава	sung
ซุน	сунце	son
ซุปเปอร์มาร์เก็ต	супер маркет	supermarket
ซุปเปอร์เซ็นเตอร์	супер центер	super center
ซู	суе	holding up high
ซูจี	сузи	fuji
ซูซูกิ	сузуки	suzuki brand
ซูรินาเม	суринам	suriname
ซูเปอร์เซ็นเตอร์	супер центер	super center
ซ่อมแซม	поправка	repair
ซ่าหริ่ม	буди срецан	a type of thai dessert
ซ้าย	лево	left
ฌอง	јеан	jean - french name
ญ	тхе	a thai alphabet with a y sound
ฐานข้อมูล	база података	database
ฐานทัพ	кантонмент	armforce
ณภัทร	напхат	napat
ณรงค์	кампања	narong - a male's name
ณัฏฐธิดา	наттхида	nattathida - a thai female actress
ณัฐวุฒิ	наттавут	nattawut
ด	м	a letter from thai alphabet
ดง	трза	area, location
ดม	мирис	smell
ดรทรงศักดิ์	др сонгсак	doctor songsuk - a famous person
ดรนิพนธ์	др нипон	doctor nipon
ดรสาโรช	др сарој	dr. sarot
ดรสุชาติ	др суцхарт	dr. suchart
ดราก้อน	змај	dragon
ดราก้อนเควสต์	драгон куест	dragon quest
ดวงพร	фортуне	dwongpol
ดวงอาทิตย์	сунце	sun
ดอก	цвет	flower
ดอกอ้อ	реед цвет	dok aou
ดอกไม้	цвет	flower
ดอกไม้ประจำจังหวัด	провинцијски цвет	state's flower
ดอตคอม	дот цом	dotcom
ดอนเมือง	дон муеанг	don mueang
ดอยอินทนนท์	дои интханон	doi inthanon
ดอร์	врата	door
ดอลลาร์สหรัฐ	амерички долар	united states dollar
ดอว์ขิ่นจี	давин ји	dorkingi
ดังนั้น	тако	for that reason
ดังเช่น	као	such as
ดัชนีการพัฒนามนุษย์	индекс људског развоја	human development index
ดัตช์	холандски	dutch
ดันแฮม	дунхам	dunham, the mother of barrack obama
ดับเบิลยู	в.	letter w
ดา	да	da - a thai nickname
ดาบ	мач	sward
ดาบเขี้ยวฟ้าฟื้น	мач освете	sky fang sword of revival
ดารา	звезда	star
ดารากร	глумац	darakon
ดาราคู่แรกของไทย	прва звезда на тајланду	first movie stars in thailand
ดาราจักร	галаксија	planet in the solar system
ดาราศาสตร์รังสีเอ็กซ์	рендгенска астрономија	xray astronomy
ดาราหญิงไทยยอดนิยม	популарне тајландске женске познате личности	famous actress
ดาวกระจาย	старбурст	star disperse
ดาวคาโนปุส	цанапас	canopus star
ดาวพฤหัสบดี	јупитер	jupiter
ดาวพุธ	меркур	mercury
ดาวยูเรนัส	уран	uranus
ดาวศุกร์	венера	venus
ดาวอาร์คตุรุส	арцтурус	arcturus
ดาวเคราะห์	планета	planet
ดาวเคราะห์แคระ	патуљаста планета	dwarf planet
ดาวเสาร์	сатурн	saturn
ดำรงค์	вимак	dumrong - a male's name
ดำรงตำแหน่ง	држите положај	hold the title of
ดำรงอ่องตระกูล	дамронг онг цлан	dumrongongtrakul
ดำเนินสะดวก	дамноен садуак	damnoen saduak
ดิกชันนารี	речник	dictionary
ดิค	дицк	dick - the name
ดิจิตอล	дигитални	digital
ดิน	земља	soil
ดินเซนฮอฟเฟอร์	зен хоффер	dientzenhofer - as in christoph or leonhard or johannes
ดินแดน	териториј	territory
ดิว	роса	dew - a nickname
ดิวิชั่น	дивизија	division
ดิศ	диск	dis (thai first name)
ดิศกุล	дискун	disakul (last name)
ดิสนีย์	диснеи	disney
ดิสโพรเซียม	диспрозијум	dysprosium
ดี	добро	d.
ดีคอนสตรักทิวิสม์	дцонрак тавист	deconstructivism
ดีน	деан	religion (islamic term)
ดีบุก	калај	tin
ดีเวลลอปเมนท์	развој	development
ดีเวลลอปเม้นท์	развој	development
ดีเอ็นเอ	днк	dna
ดุสิต	дусит	dusit
ดูที่	погледати на	see
ดูเพิ่มเติม	види више	see also
ดูเพิ่มเติมที่	такође видети	see more detail in
ดูเร็กซ์	дурек	durex
ดูแล	нега	take care
ด็อก	пас	dog
ด้วย	са	too, also, together, with
ด้วยเหตุนี้	из тог разлога	for this reason
ด้านการกีฬา	спорт	sports
ด้านการต่างประเทศ	спољни послови	foreign affairs
ด้านการเกษตร	пољопривредне	agriculture
ด้านดนตรี	музика	in music
ด้านหน้า	предњи	front
ด้านหลัง	леђа	backside
ด้านอ่าวไทย	заљевска страна	gulf of thailand side
ต	о	a letter from thai alphabet with th sound
ตกรอบที่	елиминисан	did not make the cut
ตรงกับวันขึ้น	поклапају	on the date of
ตรงกับวันที่	датум утакмице	on the date of _______________
ตระกูล	клан	family
ตระกูลนารา	породица нара	nara lineage
ตระกูลปาร์ค	цлан парк	park family (korean last name)
ตระกูลยามานากะ	породица иаманака	yamanaka clan
ตระกูลอินุซึกะ	породица инузука	inu-tsuka family
ตระกูลเซนจู	породица сењу	chen ju dynasty
ตรัง	транг	trung province
ตรางู	снаке	snake brand
ตราด	трат	trad state
ตรานี้	овај печат	this seal
ตราสัญลักษณ์	грб	symbol
ตรึงใจ	фасцинантно	truengjai
ตรุษจีน	кинеска нова година	chinese festival
ตลาด	тржиште	market
ตลาดโลตัส	лотус тржиште	lotus market
ตอน	када	edition number
ตะกร้อ	њушка	takraw
ตะกั่ว	олово	copper
ตะละภัฏ	талапат	talaput - a surname
ตะลุยอวกาศ	спаце даббле	space trek
ตะวันทอแสง	излазак сунца	tawanthosaeng
ตะวันออก	исток	east
ตะวันออกเฉียงเหนือ	североисток	east
ตันติเวชกุล	тантивејкул	tuntivetchakul - a surname
ตัว	тело	body
ตัวพระ	протагонист	main character
ตัวยักษ์	гиант	giant
ตัวละคร	карактер	character
ตัวละครจากเรื่อง	ликови из приче	soap opera based on a written story
ตัวลิง	мајмун	monkey
ตัวสะกด	правопис	final consonant
ตัวหาร	делитељ	divisor
ตัวอย่าง	пример	example
ตัวอย่างคำบาลี	пали пример	bali example words
ตัวอย่างคำประพันธ์	узорак стиха	sample writing
ตัวอย่างต้นแบบแรก	први пример прототипа	holotype
ตัวอย่างภาพยนตร์	трејлер филма	movie trailer
ตัวอย่างเช่น	на пример	for example
ตัวเลขอย่างเป็นทางการ	званични бројеви	formally number
ตัวแปร	променљива	variable
ตั้งงี่สุ่น	танг нгеон	tang ngee soon
ตั้งอยู่ที่	налази на	located
ตั้งอยู่เลขที่	налази на	at house number
ตั๊กแตน	скакавац	grasshopper
ตา	око	ta (a person's name)
ตาคลี	такхли	ta-klee
ตามตัวสวมเครื่องประดับต่าง	док је носио различите украсе	accessories
ตามตำราพรหมชาติฉบับหลวง	према краљевском уџбенику брахме	by royal botanic manual/handbook
ตาระวา	тарава	square yard
ตาราง	сто	table
ตำนานวายุสลาตัน	легенда о олуји	shippuden
ตำนานแฝงคำสอน	легендарна учења	tales
ตำบลกระเทียม	подређење белог лука	garlic district
ตำบลกังแอน	округ ганг анн	ung gan district
ตำบลตาเมียง	округ та миунг	tambon tameung
ตำบลนางแล	подручна област нанглае	nang lae province
ตำบลนาดี	поддирект нади	na dee district
ตำบลบ้านกง	подручна област бан конг	tambon bankong (name of the district)
ตำบลยะวึก	округ иувак	tambon yawuek
ตำบลระแงง	раханг дистрицт	ra-ngang district
ตำบลสังขะ	сангкха	thambol sangka
ตำบลเมืองบัว	подручна област буа	muangbua district
ตำบลโพนครก	округ пхон накхон	tambon poncrok
ตำบลไพรขลา	подрага пхраи кхла	phrai khla subdistrict
ติณสูลานนท์	тинсуланон	thinasulanon
ติอามัต	тиамат	tiarmut
ตี๋ใหญ่	биг тее	ti yai
ตึก	зграда	building
ตุรกี	турска	turkey
ตุลาคม	октобар	october
ตุ๊กแก	гецко	gecko
ตูน	цртани филм	toon
ต่อกันด้วยพันธะ	наставите с обвезницама	linked by bond
ต่อจาก	наставите од	resulting from
ต่อมา	касније	later
ต่อมาวันที่	следећи датум	later on the date
ต่อมาในปี	касније током године	later in the year
ต่อมาในรัชกาลที่	касније у време владавине	afterwards, in the reign of
ต่อมาในสมัยกรุงธนบุรีและกรุงรัตนโกสินทร์เขมรตกอยู่ภายใต้การควบคุมของจักรวรรดิสยามอย่างเข้มงวด	касније, у периодима тхонбури и раттанакосин, кмер је био под строгом контролом сијамске империје.	later in thonburi period and rattanakosin period
ต่าง	различит	different, various
ต่างๆ	разне	various, different
ต้น	почетак	medication for multi-symptoms
ต้นตอจักรวาลวิทยา	козмологија	cosmogony
ต้นสกุล	род	clan
ถนน	пут	street
ถนนคนเดิน	пешачка улица	kon dern road
ถนนประชาธิปก	пут демократије	prachatiphok road
ถนนมิตรภาพ	пут пријатељства	thanon mittraphap
ถนนสุขุมวิท	сукхумвит роад	sukhumvit road
ถมิตรภาพ	пријатељство	mittraphap road
ถวาย	понуда	presented (royal language)
ถึงกระนั้น	ипак	until
ถึงเดือนกรกฎาคม	до јула	starting july
ถ้วย	шоља	cup
ถ้อยคำ	речи	accent
ทดลอง	пробни поступак	experiment
ทนงศักดิ์	тханонгсак	thanongsak
ทนาย	адвокат	lawyer
ทนายความ	адвокат	attorney
ทรงคล้ายทรงกลม	сферно	spheroid
ทรงถือหุ้นจำนวน	његово височанство има удјеле у	stock ownership
ทรงผนวช	његово височанство	ordain
ทรงพระกรุณาโปรดเกล้าโปรดกระหม่อมให้	милостиво ме посвети	gift (word for the king)
ทรงยี่สิบหน้า	двадесет лица	icosahedron
ทรงลูกบาศก์	коцка	cube
ทรงสี่เหลี่ยมขนมเปียกปูน	рхомбус	rhombohedron shaped
ทรงสี่เหลี่ยมมุมฉาก	правокутник	triangular prism
ทรงห้าหน้า	пет лица	polyhedron
ทรงได้รับการทูลเกล้าฯ	примио је његово величанство краљ	the king of thailand gives out ____ to people
ทรัพยากร	ресурс	wealth
ทรัพยากรน้ำ	водни ресурси	water resources
ทรัพย์วิจิตร	богатство	sapwichit
ทรัพย์เพิ่ม	додатна средства	subpherm
ทรัมเป็ต	труба	trumpet
ทรีทูวัน	три до један	three.two.one
ทวารหนัก	чмар	anus
ทวีป	континент	continent
ทวีปอเมริกา	америка	america continent
ทวีปเอเชีย	азија	asia
ทวีวัฒน์	тхавиват	taweewan
ทว่า	али	however
ทศกัณฐ์	тосакан	ravana
ทศพล	тосапон	thotsaphon
ทหาร	војник	soldier
ทหารหน่วยอาเฟลันดราที่	трупа афеландра	afelandra army
ทหารอากาศ	ратно ваздухопловство	air force man
ทอง	злато	gold
ทองขาว	бело злато	thongkhao
ทองประสม	мешано злато	thongprasom
ทองผาภูมิ	тхонг пха пхум	thong pha phum
ทองหยอด	златан листић	a type of thai dessert
ทองหล่อ	тхонглор	gold
ทองเจือ	голд лацед	tong jea - a surname
ทองแดง	бакар	copper
ทองใหญ่	велико злато	tong yai - a name
ทอม	томе	tom
ทอมสัน	тхомсон	thomson
ทอมัส	тхомас	thomas
ทะเล	море	ocean, sea
ทะเลทราย	пустиња	dessert
ทะเลสาบ	лагуна	lake
ทักษะ	вештине	skill
ทัช	додирните	touch
ทับ	коса црта	thon-rammana
ทัพเรือภาคที่	морнаричко одељење	naval area command
ทัวร์คอนเสิร์ต	концертна турнеја	concert tour
ทั่วไป	генерал	general
ทั้ง	обоје	all
ทั้งหมด	све	all
ทางทิศตะวันออก	исток	east
ทางทิศตะวันออกติดกับเวียดนาม	исток граничи с вијетнамом.	borders vietnam to the east
ทางทิศเหนือติดกับประเทศไทยและลาว	север граничи с тајландом и лаосом.	borders thailand and laos to the north
ทางน้ำ	водени пут	by water
ทางรถไฟ	воз	rail
ทางหลวงพิเศษ	специјални аутопут	motorway
ทางอากาศ	авионом	by air
ทางไอทีวี	на итв-у	via itv ( a television station in thailand)
ทานากะ	танака	tanage - a japanese name
ทาร์ดิกราดา	тардикрада	tardigrada
ทาวเวอร์	торањ	tower
ทำงาน	посао	working
ทำนอง	туне	melody
ทำบุญตักบาตรฯ	заслуге и нудећи монасима храну	put food offerings into a buddhist monk's bowl
ทำหน้าที่	обави дужност	task, function
ทำให้	направити	made
ทิฆัมพรธีรวงศ์	тикампорн тхиравонг	timkamporntiravong (thai last name)
ทิพย์	тхип	thip
ทิฟฟานี่	тиффани	tiffany - female's name
ทิม	тим	tim
ทิวานนท์	тиванон	thiwanon
ทิศตะวันตก	запад	west
ที	т	t.
ทีบีเอส	тбс	tbs
ทีมชาติไทย	репрезентација тајланда	thai national team
ทีมใดที่จำนวนข้อที่ถูกน้อยกว่า	који тим има мањи број од	the team with the least correct answers
ทีวีอินไซด์	тв унутра	tv inside
ทีโอที	тот	tot
ที่จ่ายร้อยละ	плаћено	costing
ที่นี้	ево	here
ที่ประชาชนชอบมากที่สุด	које људи воле највише	people's most favorite
ที่มา	извор	source
ที่มี	која има	possess
ที่มีชื่อว่า	назван	named
ที่สำคัญ	кључ	important
ที่หมายถึง	то значи	explanation
ที่อยู่อาศัย	резиденција	residence
ที่เกิดขึ้น	што се десило	appear
ที่โดดเด่นคือ	изузетно је	notable
ทุก	сваки	every
ทุกครั้ง	сваки пут	every time
ทุติยจุลจอมเกล้าวิเศษ	посуде	tuthit julajomklawwiset - the title of those you received jewelry from the king
ทุ่งตะโก	тхунг тако	thung tako district
ทุ่งสง	тхунг сонг	tong song or nakon sri thamarat state
ทุ่งใหญ่	тхунг иаи	tungyai
ทู	такође	to
ทูล	оруђе	thun
ทเวนตี้	двадесет	twenty
ทโกมลบุตร	т комолабут	komolbut - a surname
ทไย	зашто	thayai
ท่องอาณาจักรโฮ่งเหมียว	рецитирајте краљевство хонг миао	traveling the kingdom of woof-meow
ท่าชนะ	држање	thachana
ท่านอิน	ин	than in
ท่านอ่อง	онг	tan ong - a member of the royal family
ท่านอ้วน	дебели	than uan
ท่าน้ำนนท์	приобаље	nam non pier
ท่ายาง	гумени печат	tha yang
ท่าศาลา	тха сала	sala pier
ท่าอากาศยานเลย	аеродром лоеи	loei airport
ท่าเรือ	лука	pier
ท่าไม้ตาย	сеттлер	deadly move
ท้องสนามหลวง	санам луанг	sanamloung - a landmark in thailand
ธกรุงไทย	крунг тхаи банк	krung thai bank
ธกส	баац	bank for agriculture and agriculture
ธกสิกรไทย	касикорн банка	kasikornbank
ธง	застава	flag
ธงชัย	тхонгцхаи	thongchai
ธงชาติ	национална застава	national flag
ธงธง	застава	thongthong
ธนบุรี	тхонбури	thonburi province
ธนพร	тханапорн	thanaporn
ธนะรัชต์	тханарат	tanarat -a surname
ธนาคาร	банка	bank
ธนาคารกรุงศรีอยุธยา	банка аиудхиа	bank of ayudhya
ธนาคารกรุงไทย	крунг тхаи банк	krung thai bank
ธนาคารทหารไทย	тајландска војна банка	tahanthai bank
ธนาคารทิสโก้	тисцо банка	tisco bank
ธนาคารอิสลามแห่งประเทศไทย	исламска банка тајланда	islamic bank of thailand
ธนาคารเกษตร	пољопривредна банка	farmer's bank
ธนาคารเพื่อการพัฒนาแห่งเอเชีย	азијска развојна банка	patana asia bank
ธนาคารไทยพาณิชย์	комерцијална банка сиам	siam commercial bank
ธนิต	тханит	thanit
ธปท	бот	bot
ธรณินทราธิราช	тхаравинтхаратхират	having to do with the king
ธรณีสัณฐานวิทยา	морфологија тла	geomorphology
ธรรมนูญ	цхартер	law
ธรรมศักดิ์	тхаммасак	tamasak - surname of an elected prime minister
ธรรมศาสตร์	универзитет тхаммасат	thammasat
ธรรมเมกขสถูป	дхарма макк ступа	dhamek stupa
ธานินทร์	тханин	tanin
ธารทิพย์	тхан тхип	tarnthip (first name)
ธำมงรค์	тхамронг	ring
ธิติกานต์	тхитикан	thitikan
ธีม	тема	theme
ธีระ	тхира	teera
ธีรเดช	тхирадеј	theeradej
ธุรกิจ	бизнис	business
ธุรกิจการบิน	авионски посао	airline business
นก	птица	bird
นกกระจอก	врабац	sparrow
นกกระทา	препелице	quail
นกกระทุง	пеликан	pelican
นกกระเต็น	кингфисхер	kingfisher
นกขมิ้น	канаринац	oriole
นกน้อย	мала птица	noknoi
นกแก้ว	папагај	parot
นกแอร์	нок аир	airline
นครนิวยอร์ก	нев иорк	new york city
นครปฐม	накхон патхом	nakhon pathom
นครพนม	накхон пханом	nakhon phanom
นครราชสีมา	накхон ратчасима	nakhon ratchasima
นครสวรรค์	накхон саван	nakhon sawan
นครหลวงเวียงจันทน์	виентиане цапитал	vientiane
นที	притока	natee - a male's name
นปช	удд	three letter acronym
นพจินดา	ноппацхинда	noppajinda - a surname
นพดล	нопадон	noppadol - a male's name
นร	ученик	the ancient and auspicious order of the nine gems
นราธิป	наратхип	naratip - a male's name of a singer
นราธิวาส	наратхиват	narativat state
นวนิยาย	роман	story
นวรัตน์	наварат	navaratna
นวล	бјелокости	noul -  a name
นอกจาก	осим тога	other than, to exclude
นอกจากนี้	додатно	furthermore
นอกจากนี้แล้ว	осим тога	besides
นอกเหนือจากนี้	осим	moreover
นอนไม่หลับ	не могу спавати	insomnia
นอร์ส	норвешки	norse
นะงะซะกิ	нагасаки	nagasaki
นะโม	намо	namo
นักดนตรี	музичар	musician
นักบินของออร์บ	орбов пилот	orb pilot
นักบินอวกาศ	астронаут	astronaut
นักปรัชญา	филозоф	philosophist
นักพากย์	глас глумац	voice actor
นักมวย	боксер	boxer
นักร้อง	певачица	singer
นักร้องชายไทย	тајландски мушки певачи	thai male vocalist
นักร้องนักดนตรี	певач музичар	singer, musician
นักร้องเพลงไทยสากลชาย	међународни мушки тајландски певач	male thai pop singer
นักร้องเสียงหลัก	главни певач	lead singer
นักวิชาการ	академска	i was in for.
นักวิทยาศาสตร์	научник	scientist
นักศึกษาวิชาทหาร	војни студент	army reserve force students
นักสู้อันดับ	ранг борац	fighter rank
นักเขียน	писац	writer
นักเขียนการ์ตูน	цртани филм	cartoonist
นักเต้นนำ	оловни плесач	dancers
นักเศรษฐศาสตร์	економиста	economist
นักแต่งเพลง	композитор	songwriter
นักแสดง	глумци	actor/actress
นักแสดงพิธีกร	глумац	presenter of the show
นักแสดงรับเชิญ	позвани глумац	guest star
นัดกับนัด	датум са	nut kab nut - a thai sitcom
นันทนาการ	рекреација	recreation
นันทนาคร	нантханакорн	nantanakorn
นันทเสน	нантхасен	nanthasen
นันทไกร	нантакраи	nandhakrai
นับตั้งแต่เริ่มก่อตั้งจนถึงปัจจุบัน	од оснивања до данас	from the foundation up to the present
นัยนา	око	naiyana
นั่นคือ	то је	that is
นั่นเอง	тамо	that is
นั้น	то	that
นา	поље	na
นากา	нага	naga
นากิ	наги	nagi
นาคหิรัญกนก	нак хиранканок	nakhirunkanok
นางงามจักรวาล	мис универзума	ms. universe
นางสาวสุวรรณ	мисс суван	miss suwan
นางสุพรรณมัจฉา	гђа супхан матцха	mrs. supanmatja - a character in a thai legend
นางาโตะ	нагато	logo ontario.
นาดี	нади	na di
นาดูน	на дун	nadune (name of district)
นาทวี	натхави	natavee district
นาทาล	натал	"exactly: ""natal;""  proper name: natarle"
นาที	минуту	minute
นานา	бројне	nana
นามิ	нами	nami
นายกรัฐมนตรีของประเทศไทย	премијер тајланда	prime minister of thailand
นายกรัฐมนตรีไทย	тајландски премијер	thai prime minister
นายกำพล	господине кампон	kamphon
นายชลอ	господине цхало	chalo
นายชวน	г. цхуан	mr. chuan
นายชาญชัย	г. цханцхаи	chanchai
นายณรงค์	г. наронг	mr. narong - a male's name
นายดำรง	господине дамронг	mr dumrong - a male's name
นายทวี	г. тхавее	mr.tawee
นายประกอบ	господине скупштине	mr. prakob - a male's name
นายปรีชา	г. преецха	mr.preecha
นายปรีดี	г. приди	pridi - a male's name
นายยงยุทธ	господине ионгиут	mr. yongyut - a male's name
นายศักดา	г. сакда	sakda
นายสมชัย	г. сомцхаи	mr. somchai
นายสมัคร	подносилац захтева	mr. samak - a thai name
นายสวัสดิ์	г. сават	sawat
นายสุชาติ	г. суцхарт	mr. suchat
นายสุนทร	г. сунтхорн	mr. soontorn - a male's name
นายแพทย์	докторе	male doctor
นารูโตะ	наруто	naruto - a japanese cartoon
นาวาอากาศเอกหญิง	вођа ескадриле	woman airforce captain
นาฬิกา	сат	clock
นาโนเทคโนโลยี	нанотехнологија	nanotechnology
นำกลับมาสร้างใหม่อีกครั้ง	враћен да ствара поново	remake (of an old movie)
นำแสดงโดย	улоге	performed by
นำโดย	довести до	led by
นิกาย	секта	sect
นิกเกิล	никл	nickel
นิคมพัฒนา	ником пхаттхана	nikhom phatthana
นิตยสารชีวจิต	хомеопатски магазин	cheewajit magazine
นิตยสารเอเชียวีก	магазин асиа веек	asiaweek magazine
นิตโย	ниттаио	nittayo
นิทาน	прича	tales
นิยม	популарно	niyom, name of a thai country music singer
นิยมจัดขึ้นในเดือน	популарно се одржава током месеца	usually held in the month of
นิยาม	дефинисати	symbols
นิรมิต	дреам	niramit
นิรันดร์กุล	нирункун	nirankun
นิรุกติศาสตร์	етимологија	philology
นิลภิรมย์	нилпхиром	nipinpirom - a surname
นิวคลีโอไทด์	нуклеотид	nucleotide
นิวยอร์ก	њу јорк	new york
นิวัฒน์	ниват	niwat
นิวเคลียร์	нуклеарна	nuclear
นิวเคลียส	језгро	nucleus
นิฮง	нихонг	nippon or nikon, a japanese reading language
นิเทศศาสตรบัณฑิต	бакалавар уметности	communication major graduates
นิ่ม	софт	pangolin
นิ่มสกุล	ним сакул	nimsakun
นีโอ	нео	neo
นี่คือ	ово је	this is
นุช	радост	nucth
นเรศ	нарес	naret - a male's name
นโยบายทางการทูตของจีน	дипломатска политика кине	china;s foreign policies
น็อกซ์	кнок	left.
น้องครีม	нонг крема	nong kreme - a nickname of someone in thai entertainment
น้องชาย	млађи брат	brother
น้อยมาก	веома мало	noimak
น้ำ	вода	water
น้ำค้าง	роса	namkhang
น้ำดื่ม	вода за пиће	beverages
น้ำท่วม	поплава	flooding
น้ำฝน	кишница	rainwater
น้ำพอง	гумењак	nam pong in kon kan province
น้ำมะนาว	сок од лимуна	lemonade
น้ำมัน	уље	oil
น้ำมันสน	терпентин	oil of turpentine
น้ำยืน	стајаћа вода	numyeen - location in ubolthani state
น้ำหนัก	тежина	weight
บทนมัสการนอบน้อมบูชาพระพุทธเจ้า	поглавље богослужења	a prayer to the lord buddha
บทบาททางการเมือง	политичка улога	politic
บทสวดบาลีที่ขึ้นต้นด้วยอรหัง	паличко скандирање које започиње архатом	"pali mantra started with ""arhat"""
บทสวดสรภัญญะที่ขึ้นต้นด้วยธรรมมะคือ	сорапањска пјевања која почињу са дхармом јесу	a buddhist prayer
บนบก	на копну	on land
บรมนาถชาติอาชาวศรัย	боромманацхат ацхан саи	something has to do with the king - too obscure
บรมนาถบพิตร	боромнат бопхит	borommanatbophit
บรรณาธิการ	уредник	editor
บรรพชีวินวิทยา	палеонтологија	paleontology
บราซิเลีย	брасилиа	brazilian
บราเธอร์ส	браћа	brothers
บริบาล	нега	baribal - a famous soccer player
บริพัตร	храна	paribatra
บริวเวอรี่	пивара	brewery
บริสุทธิ์	чисто	pure
บริหารธุรกิจ	пословна администрација	business administration
บริเวณรอบทะเลสาบเขมร	око језера кхмер	area around the lake in cambodia
บริเวณเขตภูเขาทางภาคเหนือ	планински регион на северу	mountain in north of thailand
บรูไน	брунеи	brunei
บลีช	блеацх	bleach
บลู	плави	blue
บลูคอสมอส	блуе цосмос	blue cosmos
บลูเบอร์รี่	боровница	blueberry
บวก	позитивно	positive
บวม	оток	swelling
บวร	дивине	bawon
บอมบ์	бомба	bomb
บอย	дечко	boy
บอยซ์	боиз	boys
บอล	лопта	ball
บอลด์วิน	балдвин	baldwin
บอส	газда	boss
บังคลาเทศ	бангладешу	bangladesh
บังไค	бангкаи	bankai
บัณฑิต	дипломирани	bandit
บัณฑิตวิทยาลัยร่วมด้านพลังงานและสิ่งแวดล้อม	заједничка постдипломска школа за енергију и животну средину	joint graduate school of energy and environment
บันทึก	запис	record
บันทึกการสร้างโลก	светски рекорд	genesis diary
บันทึกความทรงจำ	белешка	diary
บันเทิง	забава	entertainment
บัว	лотус	lotus
บัวลอย	буалои	kind of thai sweetmeat
บัวเชด	лотусов цвијет	cedric dubois.
บัวใหญ่	буа иаи	big lotus
บาคคัส	баццхус	bacchus
บาคุกันธาตุไฟ	бакуган елемент ватре	dragonoid
บาคุกันลูกน้องของนากา	бакуган, присталица наге	bakugan, minion of naga
บางกอกกล๊าส	бангкок гласс	bangkok glass
บางกอกน้อย	бангкок нои	bangkok noi
บางครั้ง	понекад	sometimes
บางซื่อ	банг суе	bang see - a location in thailand
บางปะกอก	банг пакок	bang prakok - an area in bangkok
บางปะหัน	банг пахан	a district in ayutthaya province
บางพลัด	бангплад	bangplad
บางส่วน	неки	some
บางเขน	бангкхен	bang khen
บางแสน	бангсаен	bang saen
บางใหญ่	банг иаи	bang yai - a location in thailand
บานไม่รู้โรย	амарант	gomphrena
บารอมิเตอร์	барометар	barometer
บารัก	барацк	barack
บาร์	бар	bar
บาลี	пали	vatthu
บาอัล	баал	baal - a demon in hebrew
บิน	летјети	bin
บิล	рачун	bill
บิ๊กซี	биг ц	big c
บิ๊กซ้งซุปเปอร์สโตร์	супер сонг суперсторе	big song superstore
บี	б.	b
บีช	плажа	beach
บีบี	бб	bb
บีฟเค้ก	говеђа торта	beef cake
บี้	распадање	flatten
บี้สุกฤษฎิ์	бие сукрит	be- sukasit wisetkeaw - name of a singer
บุคคล	особа	person
บุคคลสำคัญ	важна особа	vip person, very important person
บุคลิกภาพ	личност	mannerism
บุช	бусх	(george) bush
บุญค้ำ	заслуга	bunkham
บุญนะโชติ	буннацхот	bunachot - a surname
บุญนาค	заслуга	boon nak - a famous surname
บุณยเกตุ	буниакет	boonyaket
บุตร	дете	son
บุษบา	цвет	busaba - a woman's name
บูมเมอแรง	бумеранг	boomerang
บ่อทอง	златно рибњак	bothong
บ้านฉาง	бан цханг	bahn shang -a  location in thailand
บ้านปราสาท	дворац замка	castle house
บ้านผือ	бан пхуе	ban phue
บ้านฝันดอตคอม	баан фан цом	bahnfun.com
บ้านลาด	бан лад	ban lat
บ้านเขว้า	кућа	bahn kaywah, an area in thailand
บ้านแพ้ว	кућа	ban paw
บ้านโพธิ์	бан пхо	bahn po - a location in thailand
ปจ	година	two letters acronym
ปช	плажа	two letters acronym
ปฏิทินช่อง	календар канала	calendar
ปฏิภาณ	есприт	male's name patipan
ปตท	птт	three letters from thai alphabets
ปทานุกรม	лексикон	encyclopedia
ปทุมธานี	патхум тхани	pathum thani
ปภ	сигурност	the order of the direkgunabhorn
ปภัสรา	папассара	papatsara
ปม	чвор	knot
ประกอบด้วย	укључују	composed of
ประกอบไปด้วย	састоји се од	included
ประการที่	број	point
ประกาศิต	уредба	command
ประกาศเป็นป่าสงวน	декларисан као шумски резерват	preserve area, the protected forest
ประจวบ	сударати	prachuap
ประจวบคีรีขันธ์	працхуап кхири кхан	prajoubkirikan state
ประจักษ์	манифестовати	mr. prajak
ประจำปี	годишњи	annual
ประชากรประมาณ	процењена популација	population about
ประชากรศาสตร์	демографија	literature subject
ประดิษฐาน	место	placed
ประติมากรรม	скулптура	production of a play
ประติมากรรมไทย	тајландска скулптура	thai sculpture
ประตู	врата	gate
ประตูน้ำ	брана	pratunam
ประตูเสีย	сломљена врата	broken door
ประทีป	лампа	continent
ประธาน	председник	president
ประธานกรรมการ	председавајући	chief executive officer
ประธานศาลฎีกา	председник врховног суда	president of the supreme court
ประธานสภารัฐสภา	председник скупштине	speaker of parliament
ประธานาธิบดี	председник	president
ประมาณ	о томе	about, estimated to be
ประมาณคศ	о томе	christ year
ประมาณปี	око годину дана	approximately in the year
ประยงค์	праионг	prayong
ประวัติศาสตร์	историја	history
ประวัติศาสตร์สเปน	историја шпаније	history of spain
ประวัติศาสตร์ไทย	историја тајланда	history of thailand
ประสาท	нерва	castle
ประสิทธิภาพ	ефикасност	efficiency
ประหยัด	сачувати	thrifty, cheap
ประเด็นที่	питање	point number
ประเทศ	земљу	country
ประเทศกัมพูชา	камбоџа	cambodia
ประเทศซูดาน	судан	sudan
ประเทศทำการค้าขายกับต่างประเทศมากยิ่งขึ้น	земље које тргују више са страним земљама	country that trades with other countries
ประเทศนอร์เวย์	норвешка	norway
ประเทศฝรั่งเศส	француска	france
ประเทศพม่า	мјанмар	burma
ประเทศฟินแลนด์	финска	finland
ประเทศภูฏาน	бутан	bhutan
ประเทศมาเลเซีย	малезија	malaysia
ประเทศราช	краљевска земља	vassal state
ประเทศลาว	лаос	laos
ประเทศสวีเดน	шведска	sweden
ประเทศสเปน	шпанија	spain
ประเทศอียิปต์	египат	egypt
ประเทศเกาหลี	кореја	korea
ประเทศเกาหลีใต้	јужна кореја	south korea
ประเทศเนปาล	непал	nepal
ประเทศเปรู	перу	peru
ประเทศเม็กซิโก	мексико	mexico
ประเทศเวียดนาม	вијетнам	vietnam
ประเทศแคนาดา	канада	canada
ประเทศและดินแดน	земље и територије	natoin and territory
ประเทศไทย	тајланд	thailand
ประเพณีชักพระ	традиција цхак пхра	chak phra festival
ประเภท	категорија	category
ประเภทของ	тип	type of
ประเภทรายการแข่งขันชิงรางวัลดีเด่น	категорија награда изузетно такмичење	award show for
ประโยค	реченица	sentence
ปรัชญา	филозофија	philosophy
ปรัชญาตะวันตก	западна филозофија	western philosophy
ปรากฏการณ์โลกร้อน	глобално загревање	global warming
ปรากฏตัวตอนแรกในตอน	прво се појавило у епизоди	first appear in
ปรากฏตัวในตอน	појавио у	showing their presence
ปราจีนบุรี	працхин бури	prachin-buri
ปราบดาภิเษก	круњен	prapdapisek
ปราสาทเขาพระวิหาร	храм преах вихеар	kao pravihan ancient ruins
ปราโมทย์	усхићење	pramot
ปริญ	прин	parin
ปริญญา	степен	degree
ปริภูมิ	свемир	3 dimensions
ปริมาณการผลิต	обим производње	capacity
ปริศนา	слагалица	puzzle
ปริ๊นซ์	принц	prince
ปรีดา	уживање	prida - a male's name
ปรีดี	при	pridi
ปลา	риба	fish
ปลาบู่ทอง	голден гоби	goldfish
ปลาปอมปาดัวร์	помпадоур	pompadour
ปลาย	крај	at the end
ปลายคริสต์ศตวรรษที่	крајем 19. века	late century
ปลาในสกุลนี้เรียกว่า	риба у овом роду се назива	the fish in this family is called _________
ปลิงทะเล	морски краставац	sea cucumber
ปล่อย	издање	release
ปวดข้อ	бол у зглобовима	joint pain
ปวันรัตน์	паванрат	pavunnarat - a surname
ปวีณา	павеена	paweena
ปักกิ่ง	пекинг	beijing
ปักธงชัย	пак тхонг цхаи	pakthongchai
ปัจจุบัน	поклон	at present
ปัจจุบันนี้	данас	presently
ปัจจุบันประเทศไทยมีภาพยนตร์ที่มุ่งสู่ตลาดโลก	данас на тајланду се налазе филмови који су усмерени на светско тржиште.	currently thailand has international movies
ปัจจุบันมีที่นั่งอยู่ในสภาผู้แทนราษฎร	тренутно имају места у представничком дому	presently have elected representatives
ปัจจุบันเลิกเขียนแล้ว	тренутно више не пишем	presently retired from writing
ปัญจาบ	пуњаб	panjab
ปัญโญภาส	панопас	panyopat - a surname
ปัน	објави	pan
ปั้น	калуп	clay molding
ปั๊บ	одједном	pup
ปาก	уста	mouth
ปากดี	добра уста	be talkative
ปากน้ำ	естуариј	samutpragan province in thailand
ปากีสถาน	пакистан	country of pakistan
ปากเกร็ด	пак крет	pak kret
ปากแม่น้ำสิงคโปร์	сингапурска уста	singapore river delta
ปาน	предрасуда	pan - a thai name
ปานามา	панама	panama
ปานแร่	рођендани	panrae
ปาย	паи	pai
ปาริชาต	парицхат	tiger’s claw
ปารีส	париз	paris
ปาร์ค	парк	park
ปาสกาล	пасцал	pascal - computer language or name
ปาเลสไตน์	палестина	palestine
ปิปเปอราซิลลิน	пипер ациллин	piperacillin
ปิยะพงษ์	пииапонг	piyapong
ปิ่นเกล้า	пинклао	pin glow - an area in thailand
ปีคศ	година	christain era
ปีจอโทศก	година свиње	year of the dog
ปีที่	година	the year
ปีที่วางจำหน่าย	година издавања	the year that the product was on the market
ปีพุทธศักราช	будистичка година	buddhism year
ปีย์	година	pe - a thai music artist
ปีย์ชนิตว์	пииацхит	peechanit
ปีเตอร์	петер	peter
ปี่กลาง	средња торба	a thai woodwind instrument
ปืนพก	пиштољ	handgun
ปืนพกกึ่งอัตโนมัติ	полуаутоматски пиштољ	semi-automatic pistol
ปืนใหญ่	цаннон	cannon
ปืนใหญ่กลางกระสุนวิถีโค้ง	средње кривуље путање топа	cannon
ปืนไร้แรงสะท้อนถอยหลัง	пушка за повратак	recoilless rifle
ปุณณกันต์	пуннакан	bhunnagun
ปุตราจายา	путрајаиа	putrajaya
ปุ๋ย	ђубриво	pui
ปู	краба	crab
ป่าชายหาด	шума на плажи	beach forest
ป่าชายเลน	мангрове шума	mangrove forest
ป่าดิบแล้ง	сува зимзелена шума	dry evergreen forest
ป่าเบญจพรรณ	мешовита шума	mixed forest
ป่าโกงกาง	мангрове шума	mangrove
ป๊อป	поп	pop
ป๊อปปี้	мач	poppy
ผจญภัยเกาะมหาสมบัติ	авантура за острво блага	nobita's south sea adventure
ผดุง	подршка	phadung
ผล	резултата	result
ผลการแข่งขัน	резултати такмичења	result of competition
ผลงานหนังสือ	портфељ књига	publication
ผลงานเพลง	музика	song production
ผลงานโฆษณา	оглашавање	marketing project
ผลประเสริฐ	одлични резултати	polpasert - last name of the 2nd wife of the thai prince
ผลผลิตพลอยได้	нуспроизводи	result, effects
ผลรวม	сум	summation
ผลสำรวจ	резултати анкете	survey results
ผิวขาว	бела кожа	white
ผิวสี	боја коже	skin color
ผี	дух	ghost
ผีน่ารัก	слатки дух	cute ghost
ผู้กำกับ	директор	producer
ผู้จัดการ	менаџер	manager
ผู้จัดการทีม	тим менаџер	manager
ผู้ชนะ	победник	winner
ผู้ชาย	човече	male, man
ผู้ช่วยศาสตราจารย์	доцент	assistant professor
ผู้ดำเนินรายการ	модератор	moderator
ผู้บริหาร	извршни	manager
ผู้ผลิต	произвођач	producer
ผู้ฝึกสอน	траинер	trainer
ผู้พิทักษ์แห่งพิรุณ	чувар невоље	rain defender
ผู้พิทักษ์แห่งอรุณ	чувар зоре	guardian of the dawn.
ผู้ว่าการธนาคารแห่งประเทศไทย	гувернер банке тајланда	governor of the bank of thailand
ผู้ว่าราชการจังหวัด	гувернере	the governor of the city
ผู้สนับสนุน	присталице	supporter
ผู้อำนวยการ	режисер	superintendent
ผู้เล่น	играчи	player
ผู้เล่นชุด	сет плаиер	team
ผู้ใหญ่	одрасла особа	adult
ผ่องศรี	пхонгсри	pongsri
ผ้าขาวม้า	јастук	a special thai cloth that men used to tie around their waists
ผ้าอนามัยโซฟี	сопхие санитарне салвете	sofi sanitary napkin
ฝ	тхе	a letter with ph sound
ฝอยทอง	фузз	foythong - a thai dessert
ฝิ่น	опијум	opium
ฝูงชนวุ่นวาย	хаотична гужва	mob
ฝ่ามือ	палма	palm
ฝ่ายบริหาร	менаџмент	executive branch
ฝ่าเท้า	потплат	sole of foot
ฝ่าแดนเขาวงกต	кроз лавиринт	in the boundaries of kao wonkut
ฝ้าย	памук	fai
พ	т	a thai alphabet
พงศ์ศิลป์พิพัฒน์	понгсилп пхипхат	pongsinpipat
พงศ์เรืองรอง	понгруеангронг	"surname ""pong reuang-rong"""
พงษ์พานิช	понгпаницх	phongphanit
พงษ์เพชร	пхонг пхет	phong phet
พงษ์ไพบูลย์	пхонгпаибун	pongphatboon
พจนานุกรมออนไลน์	интернет речник	online dictionary
พญา	змија	phaya
พญามังราย	пхаиа манграи	mangrai the great
พตท	подручје	three letters acronym
พธม	тх	people's alliance for democracy
พนมไพร	пханом пхраи	phanom phrai
พบหลักฐานของมนุษย์ซึ่งมีอายุเก่าแก่ที่สุดถึงห้าแสนปี	пронађени су докази о људима, најстаријим до пет стотина хиљада година.	found an evidence of the the oldest human that lived in that area
พยัญชนะ	сугласник	consonant
พยัญชนะสะกดควบกล้ำ	сугласници	diphthong's consonant
พยางค์	слог	syllable
พยาธิกำเนิด	патогенеза	pathogenesis
พยาธิวิทยา	патологија	pathology
พยาบาล	медицинска сестра	nurse
พยายามชี้ให้สาธารณชนและนานาชาติ	покушај да се укаже на јавну и међународну	encourage to promote the people and international policies
พร	порно	wishes
พรนารายณ์	нараи	phonnarai
พรบ	закон	act
พรรคการเมืองใหม่	нова политичка странка	kan mai meung political party
พรรคชาติไทย	цхарт тхаи парти	thai nation party
พรรคธรรมาธิปัตย์	тхамматхипат парти	tamatipat political party
พรรคประชาธรรม	працхатхам парти	prachatam political party
พรรคภูมิใจไทย	пхуеа тхаи парти	bhumjaithai party
พรรคสม	парти екуатион	som rangsi political party
พรรคสังคมประชาธิปไตย	социјалдемократска странка	social democratic party
พรรคเพื่อแผ่นดิน	пхеу тхаи парти	puea pandin party
พรอุดมศักดิ์	пхонудомсак	pornudomsak (last name)
พระคาถาชินบัญชร	инцантатион цхиннабанцхон	chinbanchon
พระจันทร์	месец	moon
พระจันทร์สีรุ้ง	раинбов моон	phrachan sirung
พระชนม์	живот	the father of the king
พระตำหนัก	палата	the king's residence
พระที่นั่งจักรพรรดิพิมาน	палата цара пхимана	chakraput piman hall
พระที่นั่งดุสิตมหาปราสาท	дворана трона дусит маха прасат	phra thinang dusit maha prasat
พระที่นั่งบรมพิมาน	боромпхиман мансион	the king's seat
พระธรรมปิฎก	дхаммапитака	phra thampidok
พระธิดา	кћерка	daughter
พระนคร	главни град	phra nakhon
พระนาม	име	name of the king
พระนามต้นราชสกุล	име	the first person in the dynasty
พระนารายณ์	висхну	narayana
พระบรมธาตุไชยา	мошти будине	buddha's relics chaiya
พระบรมราชชนก	краљевско патронатство	the king's sister
พระบรมราชินี	краљица	queen
พระบรมวงศานุวงศ์	роиалти фрее	members of the royal family
พระบาทสมเด็จพระนั่งเกล้าเจ้าอยู่หัว	краљ нанг клао	jessadabodindra
พระบาทสมเด็จพระปกเกล้าเจ้าอยู่หัว	краљ прајадхипок	phrabat somdet phra poramintharamaha - 7th king of thailand
พระบาทสมเด็จพระปรเมนทรมหาอานันทมหิดล	његово величанство краљ бхумибол адулиадеј маха анандамахидол	phra bat somdet phra poramentharamaha ananda mahidol
พระบาทสมเด็จพระพุทธยอดฟ้าจุฬาโลก	пхра буда пхра иот фа, цхулалонгкорн	king rama 1 of chakri monarchy (bangkok)
พระบาทสมเด็จพระเจ้าอยู่หัวภูมิพลอดุลยเดชทรงพระกรุณาโปรดเกล้าฯ	његово величанство краљ бхумибол адулиадеј милостиво је задовољан	the current king of thailand
พระบาทสมเด็จพระเจ้าอยู่หัวอานันทมหิดล	краљ ананда махидол	king ananda mahidol
พระบาทสมเด็จพระเจ้าอยู่หัวเสด็จฯ	његово величанство краљ	the current king
พระปกเกล้าเจ้าอยู่หัว	краљ прајадхипок	king rama vii
พระประแดง	пхра прадаенг	prapadaeng
พระปรางค์สามยอด	пранг сам иот	prapang samyod
พระพรหมคุณาภรณ์	пхра пром кхунапорн	pra prhom kunaporn - a person in thailand
พระพันปีหลวง	миленијум луанг	queen mother
พระพันวัสสาอัยยิกาเจ้า	хиљаду буда	pra paunvatsaeyyigajao - name of a monk
พระพุทธชินราช	пхра буда цхиннарат	phra buddha chinnarat
พระพุทธบาท	будин отисак	phra phutthabat
พระพุทธศาสนา	будизам	buddhism
พระมงกุฏเกล้าเจ้าอยู่หัว	краљ рама ив	phra mongkut klao chao yu hua
พระมเหสี	супруга монарха	the wife of a king
พระยศขณะนั้น	у то време	the current title
พระยาชัยสุนทร	пхраиа цхаи соонтхорн	praya chaisoontorn - first mayor of thailand
พระยาราม	пхраиа рам	prayaram - the governor of sukothai city (the ancient city of thailand)
พระยาวิเศษภักดี	пхраиа висетпхакди	praya wiset pakdi -a  name of a head of state in the ancient time
พระยาสุนทรสงคราม	пхраиа сунтхорнсонгкрам	phraya sonthornsongkram (thai name)
พระยาไกรภักดีศรีนครลำดวน	пхраиа краипхакди сринакхон ламдуан	phraya kraiphakdi sinakhon lamduan
พระราชกรณียกิจ	краљевске дужности	royal duties
พระราชลัญจกรประจำพระองค์	краљевски печат	the king's body guard
พระราชวงศ์	краљевска породица	royal family
พระราชวรวงศ์เธอ	краљевска породица	the title of the princess
พระราชวังดุสิต	палата дусит	dusit palace
พระราชวังเดิม	оригинална палата	phra racha wang derm
พระลอ	пхра лор	phra lo
พระสมเด็จจิตรลดา	пхра сомдеј цхитралада	pra jitlada - something that was built by the king
พระสัมมาสัมพุทธเจ้า	лорд буда	buddha
พระองค์เจ้าสิริวัณณวรีนารีรัตน์	њ.кв принцеза сириваннавари вареерат	the name of one of the king's granddaughter
พระอังสาเบื้องซ้ายประดับเหรียญรัตนาภรณ์	згодан будин амулет на левој страни, украшен раттанапорном	diagonal sash for the princess
พระอัษฎามหาเจดีย์	пхра асада маха цхеди	(royal name/language)
พระอิศวร	схива	the god shiva
พระอิสริยยศ	краљевски наслов	given rank or honor by the monarchy
พระอุโบสถ	будистички храм	the temple
พระเกียรติยศ	част	royal honour
พระเจ้าลูกยาเธอ	божје дете	the royal princess
พระเจ้าหลานเธอ	бог твоја нећака	hmh princess
พระโคตมพุทธเจ้า	буддху амулет	pra kotomputtachao - another name of buddha
พรานกระต่าย	хунтер	prankatai - an area in thai province
พราหมณ์	брахмин	brahman
พริกหยวก	бабура паприка	a type of thai pepper
พริกหวาน	бабура паприка	sweet pepper
พริกไทย	бибер	thai pepper
พฤกษศาสตร์	ботаника	botany
พลตรี	ратно ваздухопловство	major general
พลตรีหญิง	женско ратно ваздухопловство	a female officer
พลตำรวจเอก	генерал полиције	police general
พลทหาร	војници	first class, enlisted men
พลศักดิ์	полсак	polsak
พลอย	драги камен	ploy
พลอสนธิ	полсон јунцтион	sonthi - a famous thai army officer
พลอากาศเอกหญิง	женски ацм	air chief marshal
พลฯ	генерал	private
พลังงานคลื่น	талас снага	wave power
พลังงานนิวเคลียร์	нуклеарна енергија	nuclear power
พลังงานลม	енергија ветра	wind power
พลังงานไฟฟ้า	електрична енергија	electrical energy
พลัส	плус	plus
พลาซา	плаза	plaza
พลาสติก	пластични	plastic
พลาสมา	плазма	plasma
พลเรือเอก	адмирале	admiral
พลเอกสนธิ	генерал сонтхи	sonthi - a thai army officer
พวกสัตว์ลำตัวกลม	животиње округлог тела	animals with no backbones
พศ	пет	b.e.
พอ	довољно	col.
พอตเตอร์	поттер	potter
พอตเตอร์กับเจ้าชายเลือดผสม	потер и полукрвни принц	(harry) potter and the half-blood prince
พอยท์	тачка	point
พอล	паул	paul
พัชรี	пхацхари	pacharee - a female's name
พัฒน์ชัย	пхатцхаи	pattachai - a male's name, famous singer
พัทยาเหนือ	нортх паттаиа	north pattaya
พัทยาใต้	соутх паттаиа	south pattaya - in thailand
พัน	хиљада	pan
พันธมิตร	савез	alliance
พันธุศาสตร์	генетика	genetic
พันธุ์พืช	биљне врсте	seed
พันธุ์สุนัข	раса пса	dogs
พันธเสน	бонд	panthasen (thai last name)
พับลิชชิ่ง	издаваштво	publishing
พัลซาร์	пулсар	pulsar
พากย์เป็น	под називом	subtitle
พายุ	олуја	storm
พารา	пара	parasetamol - a drug
พารามีเซียม	параметриц	paramecium
พาร์ค	парк	park
พาวเวอร์บาย	повер буи	power buy
พาเมล่า	памела	pamela
พิชัย	пхицхаи	pichai
พิชิต	победити	phichit
พิณ	мандолина	harp
พิธีกรรายการ	домаћин	host
พิบูลมังสาหาร	пхибун мангсахан	pi bul mung sa har (province name)
พิพิธภัณฑสถานแห่งชาติ	народни музеј	thailand meseum
พิพิธภัณฑ์	музеј	museum
พิม	пим	type
พิมประภา	пхимпрапа	phimprapha
พิมพ์เล็ก	ситним словима	small photo frame 1.4 cm x 2.1 cm x 0.5 cm thick
พิมลวรรณ	пхимонван	pimonvun - the name of a female anchor person
พิรุณ	киша	rain water
พิสุทธิ์	сјајан	pisut - a male's name
พิออจชา	чај од фијона	piodcha
พิเศษนครกิจ	накорнкит специал	pisetnakornkit - a surname
พีท	пете	pete
พีระมิด	пирамида	pyramid
พีระศรี	пхирасри	balcony
พีอีเอ	пиа	pea
พี่น้อง	браћо	siblings
พี่สาวของ	сестра	the sister of ____________
พึ่งสุนทร	ослоните се на сунтхорн	puangsunthorn
พืช	биљка	plants
พืชที่สำคัญคือ	важне биљке су	important plants are ...
พืชไม่มีท่อลำเลียง	постројења без цевовода	plants without tubelike structures
พื้นฐานทางเศรษฐกิจ	економска основа	base economics
พื้นที่มหาวิทยาลัย	универзитетско подручје	university area
พุฒตาล	путтан	puttan
พุทธคยา	бодх гаиа	bodh gaya
พุทธนิกายเถรวาท	тхеравада будизам	a sect of buddhist religion
พุทธศตวรรษที่	центури буддхист	buddhist era
พุทธศักราช	будистичка ера	buddhist era
พุ่มพวง	жена	poompoang - surname of a famous actor
พู่กัน	четкица за фарбање	pugun
พ่อขุนรามคำแหง	кинг рамкхамхаенг	the leader of sukothai empire
พ่อขุนศรีอินทราทิตย์	кинг интхаратхит	po kun intarathip - the fist king of thailand
พ่อมด	чаробњак	wizard
พ่ายแพ้ให้กับ	изгубио од	lose to
พ๎ร	добродошли	wish
ฟง	фонг	fong - a chinese name
ฟรานซ์	франз	franz
ฟรีดริช	фридрих	friedrich
ฟรีด้อม	фрее снеакинг	freedom
ฟรีแวร์	фрееваре	freeware
ฟลายเวท	фливеигхт	flyweight
ฟลูวาสแตติน	флувастин	fluvastatin - a drug
ฟอน	вон	von - in german name
ฟอร์ด	форд	ford
ฟอสฟอรัส	фосфор	phosphorus
ฟอสเฟต	фосфат	phosphate
ฟังพระธรรมเทศนา	слушајте проповеди	listen to the gospel
ฟังเพลง	слушај музику	listen to music
ฟังไจ	слушај јаиме	fungi
ฟัน	зуби	tooth
ฟาง	сламке	fhang
ฟาน	ван	van - as in the surname
ฟิชเชอร์	фисхер	fisher
ฟินแลนด์	финска	finland
ฟิลิป	пхилип	philip
ฟิลิปปินส์	филипини	philippines
ฟิลิปีโน	пхилиппино	filipino
ฟิวชัน	фусион	fusion
ฟิสิกส์ดาราศาสตร์	астрофизика	astrophysics
ฟิสิกส์อนุภาค	физика честица	physic particle
ฟีนิลคีโตนูเรีย	фенилкетонурија	phenylketonuria
ฟีฟ่าคลับเวิลด์คัพ	фифа цлуб ворлд цуп	fifa world cup
ฟุตซอล	футсал	futsal
ฟุตบอล	фудбал	football
ฟุตบอลอาเซียนเยาวชน	асеан иоутх фоотбалл	asian youth soccer
ฟุตบอลเอเชียเยาวชน	азијски омладински фудбал	asian football club youth championship
ฟู	потпуно	rise up
ฟูจิ	фуји	fuji
ฟูลส์	потпуно	fools
ฟ้อน	плес	fon
ฟ้า	плави	blue
ฟ้าร้อง	гром	thunder
ฟ้าหลัว	излазак сунца	haze
ภมรมนตรี	бамамон монтри	pamornmontri
ภักดี	одан	pakdi
ภัณฑิลา	пантхила	paktila - first name of a female actress
ภาคกลาง	централни регион	central thailand
ภาคคนแสดง	прикажи	human version
ภาคตะวันตก	вестерн регион	west
ภาคตะวันออกเฉียงเหนือ	сјевероисточни регион	northeast region
ภาคพิเศษ	посебна	special program
ภาควิชาคณิตศาสตร์	одељење за математику	department of mathematics
ภาควิชาพยาธิวิทยา	одељење за патологију	department of pathology
ภาควิชาฟิสิกส์	одељење за физику	physics
ภาควิชาวิศวกรรมเครื่องกล	одељење за машинство	engineering division
ภาควิชาวิศวกรรมไฟฟ้า	одељење за електротехнику	engineering department
ภาควิชาสูติศาสตร์และนรีเวชวิทยา	одељење за акушерство и гинекологију	gynecology
ภาควิชาเทคโนโลยีอาหาร	одељење за прехрамбену технологију	faculty of food technology
ภาคเหนือ	север	northern region
ภาคใต้ตอนล่าง	доњи јужни регион	southern thailand
ภาพตรา	слика печата	coat of arms
ภาพถ่าย	фотографија	photograph
ภาพพาโนรามา	панорама	panoramic image
ภาพพิมพ์	штампај слику	lithography
ภาพยนตร์	филмова	movie
ภาพยนตร์การ์ตูนไทย	тајландски цртани филм	thai cartoon
ภาพยนตร์ชุดนี้	овај филмски сет	this series
ภาพยนตร์ตอน	епизода	version of the movie
ภาพยนตร์ลามก	гадни филмови	porn movie
ภาพรวม	преглед	group of pictures
ภายหลัง	после	background
ภายหลังสงคราม	после рата	after the war
ภายใต้ความช่วยเหลือจากกองทุนการเงินระหว่างประเทศ	уз помоћ међународног монетарног фонда	with the financial help, sponsored by
ภายในวงขอบเหรียญเบื้องบนมีข้อความว่า	на врху кованице је изјава која	etching in the medal that ______________
ภารกิจ	мисија	business
ภาวะเศรษฐกิจของกัมพูชาหลังจากมีการเปลี่ยนแปลงการปกครองจากระบอบสังคมนิยมเป็นระบอบประชาธิปไตย	економски услови камбоџе након преласка из демократског социјализма у демократију	cambodia economy after political change
ภาษาญี่ปุ่น	јапански	japanese language
ภาษาบาลี	пали	balese language
ภาษาสเปน	шпански језик	spanish language
ภาษาอังกฤษ	енглески језик	english language
ภาษาอีสาน	североисточни језик	eastern thai language
ภาษาเกชัว	куецхуа	quechua language
ภาษาเฉพาะอาชีพ	жаргон	jargon
ภาษาเบสิก	основни	basic programming lauguage
ภาษาเยอรมัน	немачки	german language
ภาษาโคบอล	цобол	cobol programming language
ภิญโญ	све више	pinyo - a female's name
ภิรมย์	пријатно	philom
ภิรมย์ภักดี	пхиром пхакди	pirompakdee
ภูกระดึง	пхукрадуенг	phu kradueng
ภูกามยาว	пху кам иао	phu kamyao district
ภูธเนศ	бхутанет	putanet - a male's name
ภูพาน	пху пхан	phu phan
ภูมิประเทศและภูมิอากาศ	топографија и клима	geography and climate
ภูมิภาค	регион	region
ภูมิรัตน์	бхумират	poomirath
ภูหลวง	пху луанг	phu luang
ภูเขา	планина	mountain
ภูเขาน้ำแข็ง	санта леда	glacier
ภู่สว่าง	пхоо саванг	poosawang - a surname
ม	м	a thai alphabet with an 'm' sound
มกราคม	јануара	january
มจก	м	the most illustrious order of the royal house of chakri
มณฑลหูหนาน	хунан	hunan in china
มณีวรรณ	маниван	maniwan
มด	мрав	ant
มดลูก	матерница	uterus
มต้น	почети	primary level of secondary school
มธ	ту	abbreviation for thammasat university
มธรรมศาสตร์	универзитет тхаммасат	thammasat university
มน	роунд	two letters acronym
มนุษย์	човече	human
มนุษย์กลายพันธุ์	мутант	human mutant
มนเรศวร	наресуан	naresuan university
มปท	нпс	acronyms
มม	мм	mm
มมหิดล	универзитет махидол	mahidol university
มยุรา	паун	mayura - a female's name
มลายู	малајски	malayu
มวยปล้ำ	рвање	wrestling
มสงขลานครินทร์	принц сонгкла	prince of songkla university
มหัพภาค	уопште	a symbol used in thai writing
มหาชน	јавно	public company
มหาชัย	махацхаи	mahachai - male's name
มหาบัณฑิต	мајсторе	graduates from college
มหาปรมาภรณ์ช้างเผือก	маха парамапорн цханг пхуеак	highest class of the order of white elephant
มหาวชิรมงกุฎ	махавајира цровн	the biggest crown of the king
มหาวรรค	маха буддха	mahavak - a buddhist priest
มหาวิทยาลัย	универзитет	university
มหาวิทยาลัยขอนแก่น	универзитет кхон каен	khon kaen university
มหาวิทยาลัยทักษิณ	универзитет тхаксин	thaksin university
มหาวิทยาลัยนเรศวร	наресуан университи	naresuan university
มหาวิทยาลัยบูรพา	универзитет бурапха	university
มหาวิทยาลัยปทุมธานี	универзитет патхум тхани	pathumthani university
มหาวิทยาลัยพะเยา	универзитет пхаиао	prayao university
มหาวิทยาลัยภูมินทร์พนมเปญ	универзитет пхумин, пном пен	university of phnom penh
มหาวิทยาลัยมหาจุฬาลงกรณราชวิทยาลัย	махацхулалонгкорнрајавидиалаиа университи	chulalongkorn university
มหาวิทยาลัยมหาสารคาม	универзитет маха саракхам	mahasarakham university
มหาวิทยาลัยมหิดล	универзитет махидол	mahidol university
มหาวิทยาลัยรังสิต	универзитет рангсит	rangsit university
มหาวิทยาลัยราชภัฏบ้านสมเด็จเจ้าพระยา	универзитет бансомдејцхаопраиа рајабхат	rajapak bahn somdej jao praya college
มหาวิทยาลัยราชภัฏสงขลา	универзитет сонгкхла рајабхат	songkhla rajabhat university
มหาวิทยาลัยราชภัฏสวนสุนันทา	универзитет суан сунандха рајабхат	suan sunandha rajabhat university
มหาวิทยาลัยราชภัฏอุตรดิตถ์	универзитет уттарадит рајабхат	uttaradit rajabhat university
มหาวิทยาลัยราชภัฏเทพสตรี	универзитет тхепсатри рајабхат	thepsatri rajabhat university
มหาวิทยาลัยราชภัฏเลย	универзитет лоеи рајабхат	loei rajabhat university
มหาวิทยาลัยวงษ์ชวลิตกุล	универзитет вонгцхавалиткун	vongchavalitkul university
มหาวิทยาลัยศรีนครินทรวิโรฒ	универзитет сринакхаринвирот	srinakarinvirot university
มหาวิทยาลัยศรีปทุม	универзитет срипатум	sripatum university
มหาวิทยาลัยศิลปากร	универзитет силпакорн	silapakorn university
มหาวิทยาลัยสุโขทัยธรรมาธิราช	отворени универзитет сукхотхаи тхамматхират	sukhothai thammathirat open university
มหาวิทยาลัยอีสาน	универзитет североисток	issan univbersity
มหาวิทยาลัยอุบลราชธานี	универзитет убон ратцхатхани	ubon ratchathani university
มหาวิทยาลัยอ๊อกซฟอร์ด	универзитет у оксфорду	university of oxford
มหาวิทยาลัยเกษตรศาสตร์	касетсарт универзитет	kasetsart university
มหาวิทยาลัยเทคโนโลยีพระจอมเกล้าพระนครเหนือ	универзитет технолошког универзитета краља монгкут-а, сјеверни бангкок	king mongkut's university of technology.
มหาวิทยาลัยเทคโนโลยีราชมงคลกรุงเทพ	рајамангала университи оф тецхнологи крунгтхеп	rajamangala university of technology krungthep
มหาวิทยาลัยเทคโนโลยีราชมงคลตะวันออก	рајамангала технолошки универзитет таван-ок	the eastern university of teachnology
มหาวิทยาลัยเทคโนโลยีราชมงคลธัญบุรี	рајамангала технолошки универзитет тханиабури	rajamangala university of technology thanyaburi
มหาวิทยาลัยเทคโนโลยีราชมงคลสุวรรณภูมิ	рајамангала университи оф тецхнологи суварнабхуми	techonology university at rajamongkolsuwannapoom
มหาวิทยาลัยเทคโนโลยีราชมงคลอีสาน	рајамангала университи оф тецхнологи исан	rajamangala university of technology isan
มหาวิทยาลัยเปิด	отворени универзитет	open university
มหาวิทยาลัยแม่โจ้	универзитет маејо	mae joe university
มหาวิทยาลัยแห่งแรกของประเทศไทย	први универзитет на тајланду	first university of thailand
มองโกเลียใน	унутрашња монголија	mongolia
มอร์ริส	моррис	morris
มอส	мосс	mos
มอสส์	мосс	moss
มอหาดใหญ่	мор хат иаи	had yai city in southern thailand
มะขาม	тамаринд	tamarind
มะม่วงหิมพานต์	индијских ораха	mango (anacardium occidentale)
มะริด	миеик	myeik
มะเร็ง	рак	cancer
มังกี้	мајмун	monkey
มังคุด	мангостин	mangosteen
มัจฉานุ	матцха	majjanu - the son of the giant in a thai legend.  majanu is half monkey and half fish.
มัชฌิมาปฏิปทา	средњи пут	the middle way
มัทนะพาธา	мутхана пхатха	matthanaphatha
มัธยฐาน	средња вредност	mode (as in statistic)
มัธยมศึกษา	средње образовање	junior high school
มัธยมศึกษาปีที่	9. разред	secondary school year
มันติคอร์	мантицоре	manticore
มัลเจร่า	малера	wonderweiss margera - a cartoon character
มากกว่า	преко	more than
มากที่สุด	највише	most abundant
มากิ	маки	magi osuki - the artist
มาครอส	мацросс	macross
มาจยาร์	маиар	magyar
มาจากภาษาละติน	од латинског	from latin root
มาซากิ	масаки	masaki
มาดริด	мадрид	madrid
มาตรฐาน	стандардно	standard
มาตรา	одељак	article
มานี	мани	mani - a thai name
มายน์ส	мине	mine
มาริสา	мариса	marissa
มาริเบล	марибел	maribel
มาร์ช	марсх	march
มาร์ติน	мартин	martin
มาร์ตินีก	мартиникуе	martinique
มาร์แชล	марсхалл	marshall
มาลัยพร	малаи порн	malaiphon
มาลากุล	малакул	malakul
มาลี	мали	flower
มาสคาร่า	маскара	mascara
มาเก๊า	макао	macao
มาเฟีย	мафија	mafia
มาเรีย	мариа	maria
มาเลเซีย	малезија	malaysia
มาเลเซียตะวันตก	западна малезија	west malaysia
มิจิรุ	мицхиру	mijiru
มิตร	пријатељски	mitr
มิตรชัย	митцхаи	mitchai
มิตรเพชรา	пријатељски	mit pechara - two of famous actors in the old time
มิถุนายน	јуна	june
มินต์	нана	mint
มิลจิ	миљи	mulji
มิลตัน	милтон	milton
มิลฟีโอเล่	милфи оле	millefiore
มิลลิเมตร	мм.	millimeter
มิลินทจินดา	милинтхинда	milinjinda - a surname of a singer
มิล่า	мила	mila
มิว	мев	mu
มิวฟิลโอเล่	муле пхил оле	millefiore
มิวสิกวีดีโอ	спот	music video
มิสทีน	мистине	mistine
มิฮอว์ค	михавк	mihawk - surname of a character in a japanese movie
มิเกล	мигуел	miguel
มิเชล	мицхелле	michelle
มิเตอร์	метар	meter
มิโร	миро	miro - name
มีขนาดใหญ่	велики	big
มีข้อความว่า	означено	inscription reads
มีความยาว	имајте дужину	has length of
มีความหมายว่า	значење	meaning
มีจำนวน	узми број	have the amount of
มีฉายาว่า	са надимком	famous for...
มีชื่อว่า	назван	is called
มีชื่อเล่นว่า	надимак	nick name
มีด	нож	knife
มีดาบฟันวิญญาณ	са мачем духа	have a sword to fight the ghost
มีทั้งสิ้น	све	own, available
มีทิวเขาล้อมรอบทางเหนือ	са планинским венцима на северу	surrounded by the mountains in the north
มีน	мин	min - a nick name
มีนบุรี	мин бури	minburi province
มีนวิทยา	минологија	ichthyology
มีนายกรัฐมนตรี	нека буде премијер	have a prime minister
มีประวัติศาสตร์ยาวนาน	има дугу историју	having a long history
มีพรมแดนทางทิศใต้จรดกับอ่าวไทย	јужно је омеђен тајландским заљевом	having boundaries adjacent to the gulf of thailand
มีภูเขาล้อมรอบอยู่	окружени планинама	surrounded by mountains
มีลักษณะดังนี้	има следеће карактеристике	has following characteristics
มีลักษณะภูมิประเทศคล้ายชามหรืออ่าง	са функцијама попут посуде или умиваоника	have topography like bowl or basin
มีลาภ	имати богатство	milap
มีล่า	нека лови	mila
มีสูตรการคำนวณหาจำนวนฟัน	постоји формула за израчунавање броја зуба.	dental formula
มีอยู่	постоје	possess, present
มีอุณหภูมิเฉลี่ย	просечна температура	average temperature
มีอุทยานแห่งชาติสำคัญหลายแห่ง	постоји много важних националних паркова.	has many important national parks
มีเดีย	медији	media
มีโคลซีน	са цоле сценом	meclozine
มือ	рука	hand
มู	глатко	mu
มูลนิธิชัยพัฒนา	фондација цхаипаттана	chaipattana foundation
มูลนิธิอานันทมหิดล	анандамахидол фондација	the king's charities
มูลสาร	основе	munsan
มเชียงใหม่	цхианг маи	chaing mai university
มโนราห์	манохра	thai dance art
ม้า	коњ	horse
ม้าม	слезине	spleen
ย	тхе	a thai alphabet with the y sound
ยกเว้น	осим	except
ยศ	чин	rank
ยอด	елита	super, great
ยอดนักสืบจิ๋วโคนัน	детектив конан	conan the detective
ยอดเขาสูงที่สุดของกัมพูชาคือ	највиши врх камбоџе је	highest mountain in cambodia
ยอพระกลิ่น	иор пхра клин	yorpaglin - name of a story
ยัง	до	young
ยาขับปัสสาวะ	диуретик	diuretic pills
ยาง	гума	rubber, tire
ยางธรรมชาติ	природна гума	natural rubber
ยางามิ	иагами	yangami
ยานอนหลับ	таблете за спавање	sleeping pills
ยานอวกาศ	свемирски брод	rocket ship
ยาบ้า	амфетамин	ya ba
ยาปฏิชีวนะ	антибиотици	antibiotic
ยามาโตะ	иамато	yamato - a japanese name
ยามาโมโตะ	иамамото	yamamoto
ยามเย็น	вече	sundown, evening time
ยิ่งยง	иингионг	yingyong - a first name
ยิ่งลักษณ์	иинглуцк	yingluck
ยิ้มสู้	осмех	smile fight
ยีน	ген	gene
ยืนยง	подносити	(inthira) yeenyong - lead singer of budogun band
ยุคกลาง	средњи век	middle age
ยุคก่อนประวัติศาสตร์	праисторијско доба	prehistory
ยุคที่	ера	age
ยุคปัจจุบัน	модерна времена	present age
ยุคศตวรรษที่	вековна ера	century
ยุคสามก๊ก	три краљевства	three kingdoms - the legend
ยุคอะซึกะ	асука доба	asuka period
ยุคอาณาจักรเหนือใต้	северно и јужно краљевство	north-south dynasty
ยุคเรเนสซองส์	доба ренесансе	renaissance
ยุคเฮอัง	хеиан доба	heian period of japan
ยุคโบราณ	давнина	ancient history
ยุคโลหะ	метал аге	metal age
ยุคใหม่	ново доба	new age
ยุทธนาวี	битка морнарице	naval battle
ยุวธิดา	млада ћерка	yuwatidah
ยุ้ย	претјеран	yui
ยู	у	u
ยูกิโอ	иукио	yu-gi-oh
ยูฟ่า	уефа	uefa
ยูริ	јуриј	yuri -  a japanese name
ยูโด	јудо	judo
ยูโรเพียม	еуропиум	europium
ยูไนเต็ด	унитед	united
ย่านตาขาว	иан кхао	yan ta khao
รณชัย	роннацхаи	ronnachai
รณภพ	светски	ronapop
รณฤทธิ์	битка	ranariddh
รถด่วนสายทางช้างเผือก	експресни аутобус са млечним путем	galactic express
รถประจำทางสาย	аутобуска линија	bus number
รถยนต์อเนกประสงค์	вишенаменски аутомобил	automobile
รถลาก	рицксхав	pulled rickshaw
รถโดยสารประจำทาง	аутобус	passenger bus
รถโดยสารประจำทางสาย	аутобуска линија	bus
รถไฟฟ้าชานเมืองสายสีแดงอ่อน	предграђе црвеног светла	rapid transit light red line
รถไฟฟ้ามหานคร	мрт	metropolitan rapid transit
รฟม	р.о.	public transit
รวดเร็ว	брзо	rapid
รวม	да укључи	total
รวมกับ	у комбинацији са	add to
รวมทั้ง	укључујући	include
รวมทั้งประเทศที่ให้ความช่วยเหลืออื่นๆ	укључујући земље које пружају другу помоћ	the countries that provided helps
รวมทั้งสิ้น	велико укупно	result
รวมระยะทางทั้งสิ้น	укупна раздаљина	total distance
รศ	стручни сарадник	ratanakosin era
รหัส	код	code
รอก	колут	roack
รองประธานรัฐสภาคนที่หนึ่ง	први потпредседник скупштине	an assistant head of a thai governmental committee
รองประธานสภาคนที่สอง	други потпредседник савета	second vice chairman
รองเท้า	ципеле	shoes
รอญับ	чекати	seventh month of the hijra calendar
รอบ	око	surrounding
รอบคอบ	пажљиво	careful
รอบชิงชนะเลิศระดับประเทศ	национално финале	national final round
รอบที่	роунд	round
รอบเมือง	градом	around town
ระดับกระโดดสูง	скок увис	high jump  height
ระดับการกระโดดสูง	скок увис	high jump
ระดับปริญญาเอก	ниво доктората	doctorate degree level
ระดับปริญญาโท	мастер диплома	master's degree
ระดับมัธยมศึกษา	секундарни	middle school level
ระดับอาชีวศึกษา	професионални ниво	vocational education
ระนอง	ранонг	ranong
ระนาด	ксилофон	ranad - a thai musical instrument
ระนาดทุ้ม	алто ксилофон	a type of thai musical instrument
ระนาดเอก	алто	ranad eg -  a thai musical instrument
ระบบ	систем	system
ระบบกษัตริย์ของกัมพูชา	камбоџанска монархија	cambodian monarchy
ระบบรัฐสภา	парламентарни систем	rajya sabha system of governing
ระบบสืบพันธุ์	репродуктивни систем	reproductive system
ระบบสุริยะ	сунчев систем	solar system
ระบบโครงกระดูก	скелет систем	skeletal system
ระบบใช้อำนาจเด็ดขาด	апсолутни систем напајања	despotism
ระยะ	фаза	phase
ระยะเวลา	трајање	period
ระยะเวลาการดำรงตำแหน่ง	термин услуге	the term in the office
ระวิ	између	rawi
ระหว่างปี	у току године	between the year
ระหว่างสงครามโลกครั้งที่	за време светског рата	during wold war
ระเบียง	балкон	bhirasri
ระเบียบ	наредити	regulation
ระโนด	мртав	ranode (name of district in thailand)
รักษาศีล	придржавајте се правила	keep the precepts
รักษาสิ่งแวดล้อม	заштита животне средине	protect the environment
รักแห่งสยาม	љубав према сиаму	love thailand
รังสิตคลอง	рангсит кхлонг	rangsit canal
รังสี	зрак	radiation
รังสีเอกซ์	кс-зрака	xray
รังสีแกมมา	гама зраци	gamma ray
รัชกาลที่	владавина	rama
รัชกาลสมเด็จพระจุลจอมเกล้าเจ้าอยู่หัว	владавина краља цхулалонгкорна	king chula chomklao's reign
รัชดาภิเษก	ратцхадапхисек	rajada pisek - a location in thailand
รัฐธรรมนูญแห่งราชอาณาจักรไทย	устав краљевине тајланд	constitution of the kingdom of thailand
รัฐบาลไทย	тајландска влада	thai government
รัฐบุรุษ	државник	statesman
รัฐประหาร	дрзавни удар	coup d'état
รัฐประหารในประเทศไทย	државни удар на тајланду	thailand's coup d'état
รัฐมนตรีว่าการกระทรวงคมนาคม	министар саобраћаја	transportation secretary of thailand
รัฐวิสาหกิจ	државно предузеће	financial situation of the country
รัฐวิสาหกิจไทย	тајландска државна предузећа	thai state enterprise
รัฐสภา	парламент	parliament
รัฐสีมาคุณากรปิยชาติ	раттхасима кунакорнпииацхат	ratthasimakhunakonpiyachat
รัฐอิลลินอยส์	иллиноис	state of illinois
รัฐเทกซัส	текас	state of texas
รัตนบุรี	раттанабури	ratanaburi district - a location in thailand
รัตนาธิเบศร์	раттанатхибет	ratana thibet
รับบทโดย	игра	played by
รับพระราชทาน	прихвати	receive
รัศมี	радијус	radius
รัสเซล	русселл	russell
รากแก่น	цоре роот	rakkan
รางวัลนักร้องยอดเยี่ยม	награда за најбољу певачицу	best singer award
รางวัลนักร้องไทยสากลชายยอดนิยม	популарна награда за мушки међународни певач	best thai male singer award
รางวัลนาฏราช	награде роиал данцер	naktarath prize
รางวัลโนเบล	нобелова награда	nobel prize
รางวัลไนน์เอ็นเตอร์เทน	нине ентертаинмент авард	nine entertain awards
ราชตระกูล	краљевска породица	royal family
ราชนาวี	морнарица	royal navy
ราชมังคลากีฬาสถาน	стадион рајамангала	rajamangala national stadium
ราชวงศ์จิ้นตะวันออก	династија источна јин	east jin dynasty
ราชวงศ์ชิง	династија кинг	ching dynasty
ราชวงศ์ถัง	династија танг	tang dynasty
ราชวงศ์ทิพย์จักราธิวงศ์	ратцхавонгтхип цхакратхивонг	thipjaklatiwong dynasty
ราชวงศ์บ้านพลูหลวง	краљевска кућа плу луанг	ban phlu luang dynasty
ราชวงศ์พระร่วง	династи пхра руанг	pra roung dynasty
ราชวงศ์หยวน	династија иуан	yuan dynasty
ราชวงศ์อู่ทอง	у-тхонг династија	utong empire in ancient thailand
ราชสกุล	токени	royal family members
ราชสีมา	ратцхасима	ratchasima
ราชินิกุล	краљичина родбина	relatives of the queen
ราบเป็นหน้ากลอง	будите отворени	flattened like a drum (meaning to be defeated)
รามอินทรา	раминтра	ram inthra
รายการ	листа	show
รายการวันสำคัญทางพุทธศาสนา	листа важних будистичких датума	important days in buddhism
รายชื่อ	листа	list of the names
รายชื่อคำในภาษาไทยที่มักเขียนผิด	списак тајландских речи које су често написане погрешно	common misspelled thai words
รายชื่อภาพยนตร์ไทย	списак тајландских филмова	a list of thai movies
รายชื่อหุ่นยนต์ใน	листа робота у	name of robots
รายชื่ออธิการบดี	списак канцелара	list of presidents
รายชื่อเพลง	списак песама	songs list
รายนามรองอธิการประจำวิทยาเขต	списак имена вицеканцеларки у кампусу	llist of deputy directors of the college
รายนามอธิการบดี	листа председника	chancellor list
รายพระนามพระมหากษัตริย์ไทย	списак краља тајланда	list of thai monarchs
รายะนาค	раиа нак	rayanak
รายได้อื่น	остали приходи	other wages, incomes
ราวพุทธศตวรรษที่	око века	about buddhist era
ราศีธนู	стрелац	sagittarius
รำพันพิลาป	вриштати	poem called rum pan pi lab
ริน	сипати	rin
ริมแม่น้ำเจ้าพระยา	река цхао пхраиа	near chao praya river
ริวซากิ	риузаки	riusaki - from japanese story
ริเอะ	рие	rie tanaga - a japanese singer
รีสอร์ท	одмаралиште	resort
รีเนียม	ренијум	rhenium
รุจิพรรณ	рујипан	pan - a name
รุ่ง	давн	dawn
รุ่งสว่าง	давн	rungsawang
รุ่งเพชร	рунг петцх	roongpetch - a female's name
รูดอล์ฟ	рудолпх	rudolf
รูทีเนียม	рутенијум	ruthenium
รูปภาพ	слика	picture
รูปร่าง	облик	body
รูปวรรณยุกต์	тонални облик	tones
รูปสามเหลี่ยมมุมป้าน	тупи троугао	obtuse
รูปสี่เหลี่ยมด้านขนาน	паралелограм	a paralellogram
รูสเวลต์	роосевелт	roosevelt
ร็อดฟอร์ม	род форм	rock form
ร่วมแสดงกับ	наступите са	costarring
ร้องคู่กับ	певај заједно са	sing a duet with
ร้องร่วมกับ	певај са	featuring
ร้องโดย	отпевано	sung by
ร้อยตรี	потпоручник	second lieutenant
ร้านอาหาร	ресторан	restaurants
ฤดูกาล	сезона	season
ฤดูฝน	кишна сезона	rainy season
ฤดูร้อน	врућа сезона	summer
ล	тхе	a thai alphabet with an l sound
ลงวันที่	датум	on this date
ลพบุรี	лоп бури	lopburi
ลอนดอน	лондон	london
ลอยกระทง	лои кратонг фестивал	loy kratong festival
ลอร์ด	господ	lord
ละคร	драма	play
ละครชาตรี	цхатри драма	lakorn-chatri
ละครวิทยุ	радио драма	soap opera broadcasted on the radio
ละครสั้น	кратка драма	short drama
ละครเพลง	мусицал	stage musical theatre
ละครโทรทัศน์	сапуница	television drama
ละติจูด	ширина	latitude
ลักษณะ	погледај	characteristic
ลักษณะทั่วไป	опште карактеристике	common characteristic
ลักษณะทางกายภาพ	физичке карактеристике	physical characteristics
ลักษณะภูมิอากาศ	клима	the type of climate
ลักษณะสำคัญ	важне карактеристике	main characteristics
ลักเซมเบิร์ก	луксембург	luxembourg
ลัคนา	асцендент	ascendant
ลา	ла	goodbye
ลานจาตุรงคสันนิบาต	четверокут	lan jaturonsunnibat - an ancient place in india
ลามิวูดีน	ламивоодине	lamivudine
ลายน้ำ	водени жиг	watetmark
ลาว	лаос	lao
ลาออก	дај оставку	resign
ลำดับ	наредити	order, sequence
ลำดับพระปฐมวงศ์ในพระบรมราชวงศ์จักรี	ред постанка из династије цхакри	order of the kings
ลำดับพระมหากษัตริย์ไทย	орден тајландског краља	the order of the kings of thailand
ลำตัว	трупек	body
ลำลูกกา	лам лук ка	lumlookka - a location in thailand
ลำลูกกาคลอง	канал лам лук ка	lum luk kak klong
ลำไส้เล็ก	танко црево	small intestine
ลิง	мајмун	monkey
ลิซท์	лисзт	(franz) liszt
ลิปปี	година усана	rippi - a surname
ลิพิด	липид	lipid
ลิฟวิ่งมอลล์	ливинг малл	living mall
ลิเก	музичка народна драма	like
ลิเทียม	литијум	lithium
ลีกคัพ	лига куп	league cup
ลีซอ	лису	lisu
ลีเมอร์	лемур	lemur
ลี้	ли	lee, a district in lumpoon province.
ลี้สุวรรณ	ли суван	lisuwan
ลุงบุญมีระลึกชาติ	ујак боонмее присећајући се нације	uncle boonmee who can recall his past lives
ลูกปัด	перла	beads
ลูกสาว	ћерка	daughter
ลูกอม	бомбона	candies
ลูกอัณฑะ	тестиси	testis
ลูซิเฟอร์	луцифер	lucifer
ลูน่า	луна	luna
ล่าทา	лов	lata
ล่ำซำ	кврга	lumsum
ล้อม	око	lom
ล้อแม็กซ์อัลลอยขนาด	алуминијске фелне	alloy wheel
วง	петља	band
วงจรไฟฟ้า	струјно коло	electrical circuit
วงดนตรี	трака	band
วงศ์กำแหง	породица	wongkumhang - surname of a famous singer
วงศ์ถั่ว	нут породице	fabaceae
วงศ์ปลากดทะเล	фисх фамили	ariidae
วงศ์ปลากะรัง	гроупер	serranidae family
วงศ์ปลายอดม่วง	вонг пла иот муанг	tonguefish
วงศ์ปลาหลังเขียว	зелена риба	clupeidae - a type of fish
วงศ์ปลาเนื้ออ่อน	мека риба	siluridae
วงศ์ปลาเสือตอ	породица тиграстих риба	datnioididae
วงศ์พัวพันธ์	вонгпуа пхан	wongpourpan
วงศ์วิริยะ	вирииа	vongsiriya - a surname
วงศ์เทวัญ	породица	wongthewan
วงศ์แคหางค่าง	вонг кхае ханг конг	plants in kae-hang-kang family
วงษ์คำเหลา	вонг кхам лао	wongkamlao
วงเงิน	лимит	budget
วงเวียน	кружни ток	circle
วงแหวน	прстен	ring form, circle form
วชิรบรรจง	вацхирабањонг	wachibanjong
วทบ	дд	bachelor of science
วนอุทยานถ้ำจัน	парк шума тхам цхан	tham chan forest park
วนิดา	ванида	wanida - the name of a drama
วร	вор	won
วรรณกรรม	литература	literature
วรรณสุทธิ์	вансут	wannasut - surname of an actress
วรรธนพิสิฐกุล	ваттхон пхиситкун	wanthanaphisitkun
วรัทยา	варутиа	varattaya (first name)
วว	дд	office of ____________
วอก	мајмун	wok
วองโกเล่แฟมิลี	породица вонгола	vongola family
วอชิงตัน	васхингтон	washington
วอลท์	валт	walt
วอล์ค	ходати	walk
วะสี	јесам ли ја	wasee
วัง	палата	palace
วังจันทร์	ванг цхан	wang-chan
วังสระปทุม	палата сра патхум	srapathum palace
วังสะพุง	ванг сапхунг	wang saphung
วังหลัง	палата	wang lang
วังหิน	камена палата	rock castle
วัชรพล	ватцхарапол	watcharapol supermarket
วัฒนชัย	ваттханацхаи	wattanachai - a surname
วัฒนธรรม	култура	culture
วัฒนวิทูกูร	ваттанавиткун	watthanawithukun
วัฒนา	ваттана	wattana
วัดกลาง	средњи храм	wat klang
วัดป่าเลไลยก์วรวิหาร	ват па лелаи воравихан	wat palaylay
วัดพระธาตุดอยสุเทพราชวรวิหาร	ват пхра тхат дои сутхеп, ратцхаворавихан	wat pratatdoisuthep rachavoravihan - the temple erected on top of doi suthep in northern thailand
วัดพระฝางสวางคบุรีมุนีนาถ	ват пхра фанг сангкхабури мунинат	prhafangsawangkaburimuninat temple
วัดพระมหาธาตุวรมหาวิหาร	ват пхра махатхат ворамахавихарн	wat phramahathat woramahawihan
วัดพระยืนพุทธบาทยุคล	ват пхра иуен пхуттхаиакхон	the standing buddha temple of puttabatyukol
วัดพระลอย	храм пхра лои	wat phra loi
วัดพระศรีรัตนมหาธาตุ	ват пхра си раттана махатхат	wat phra si rattana mahathat
วัดพระเชตุพนวิมลมังคลารามราชวรมหาวิหาร	ват пхра цхетупхон вимолмангкларарам ратцхаворамахавихан	wat pra chetpnvimolmungklaramrajavoramahavihan
วัดระฆังโฆสิตาราม	храм ракхангкосарам	wat rakang kositaram (name of temple)
วัดสองพี่น้อง	песма храма пхи нонг	two siblings temple
วัดสุทัศนเทพวรารามราชวรมหาวิหาร	храм сутхасан тхеп варарам	wat sutatthepvararamrajavorimahavihan - a temple in thailand
วัดหนองเพียร	храм нонг пхиан	wat nong pien - a temple in thailand
วัดหน้าพระธาตุ	на пхра тај храм	wat na pra tat - a buddhist temple
วัดเจดีย์หลวง	храм цхеди луанг	wat pagoda
วัดโพธิ์	ват пхо	wat po - a thai temple
วัตต์	ват	watt
วัตสัน	ватсон	watson
วัน	дан	day
วันชัย	ванцхаи	wanchai - a male's name
วันที่ขึ้นเครื่องหมาย	датум пријаве	excluding dividend day
วันที่ออกอากาศชื่อตอนแขกรับเชิญ	датум емитовања, име епизоде, наступ госта	when the invitation comes out
วันที่เข้าฉาย	датум изласка	release date
วันนี้ที่รอคอย	чекам данас	the day that one has been waiting for
วันพฤหัสบดี	четвртак	thursday
วันพุธ	среда	wednesday
วันมหาสงกรานต์	дан маха сонгкрана	songkran day
วันละ	дан	per day
วันศุกร์	петак	friday
วันสงกรานต์	дан сонгкрана	songkran day
วันสำคัญ	важан дан	important day
วันสำคัญทางพุทธศาสนา	важан дан будиста	buddhist holidays
วันหยุดราชการ	државни празник	national holiday
วันอังคาร	уторак	tuesday
วันอาทิตย์	недеља	sunday
วันอาสาฬหบูชา	асанха буцха	asalha puja
วันเกิด	рођендан	birthday
วันเสาร์	субота	saturday
วันแรม	дан	the phase of the moon
วัย	старости	age
วัลลิโภดม	валлипходом	wanliphodom
วัสดุฟิสไซล์	фиссиле материал	fissile material
วานูอาตู	вануату	vanuatu, australia
วารินชำราบ	варинцхамрап	warinchamrap
วาลคิรี	валкирие	valkyrie - angel that helped in valhalla war
วาลีน	валине	valine - a type of protein
วาเรีย	вариа	varia
วาเลนไทน์	валентине&#39;с	valentine
วาไรตี้	разноликост	variety
วิกตอร์	вицтор	victor
วิคตอเรีย	вицториа	victoria
วิจัย	истраживање	investigate, study
วิจิตรศิลป์	ликовна уметност	fine art
วิชาการ	академски	academic
วิชาการคอม	академски рачунар	vcharkarn.com
วิชิต	вицхит	wichit - a male's name
วิญญาณ	дух	soul
วิฑูรย์	лазулит	witoon
วิดีโอเกม	видео игре	video game
วิตามินอี	витамин е	vitamin e
วิทยาการคอมพิวเตอร์	информатика	computer courses
วิทยาการระบาด	епидемиологија	epidemiology
วิทยาลัยการจัดการเพื่อการพัฒนา	факултет за менаџмент за развој	management for development college
วิทยาลัยการบริหารรัฐกิจ	колеџ за државну управу	management college
วิทยาลัยครูสวนสุนันทา	суан сунандха теацхер цоллеге	soun sunanta teachers college
วิทยาลัยดุริยางคศิลป์	музички факултет	college of music
วิทยาลัยนวัตกรรมและการจัดการ	факултет за иновације и менаџмент	the college specialized in arts
วิทยาลัยพยาบาลกองทัพเรือ	навал нурсинг цоллеге	royal thai navy college of nursing
วิทยาลัยพยาบาลบรมราชชนนี	боромарајонани колеџ сестринства	nursing university of barom raj chonnani
วิทยาลัยพาณิชยศาสตร์	привредни факултет	panitsat university
วิทยาลัยวิชาการศึกษา	цоллеге оф едуцатион	college of education
วิทยาลัยเทคนิคธนบุรี	технички факултет тхонбури	king mongkut's university of technology thonburi
วิทยาลัยแพทยศาสตร์พระมงกุฎเกล้า	пхрамонгкутклао медицински факултет	phramongkutklao college of medicine
วิทยาศาสตรมหาบัณฑิต	магистар наука	master of science
วิทยาศาสตร์สุขภาพ	наука о здрављу	health science
วิทยาศาสตร์และเทคโนโลยี	наука и технологија	science and technology
วิทยาเขต	кампус	campus
วิทยาเขตกาญจนบุรี	канцханабури цампус	kanchanaburi college
วิทยาเขตนครศรีธรรมราช	кампус накхон си тхаммарат	nakhon si thammarat campus
วิทยาเขตพิษณุโลก	пхитсанулок цампус	pissanulok college
วิทยาเขตสารสนเทศเพชรบุรี	камп пхетцхабури информационе технологије	information technology college of petchaburi
วิทยาเขตสุพรรณบุรี	кампус супханбури	suphanburi campus
วิทยาเขตสุรินทร์	сурин цампус	surin university
วิทยาเขตหนองคาย	нонг кхаи цампус	nong kai university
วิทยาเขตเฉลิมพระเกียรติ	цхалоем пхракиат цампус	vittaya kat chalerm pra kiet - a location at kasetsat university in thailand
วิทยุ	радио	radio
วิธีการหาความสัมพันธ์	како пронаћи везу	formula for the correlation coefficient
วินชี	винци	vinci
วินัย	дисциплина	manners
วินเนอร์	победник	winner
วิบูลย์	збогом	wibul - a male's name
วิมเบิลดัน	вимбледон	wimbledon
วิลลี่	вилли	willy
วิลเลจ	село	village
วิลเลียม	виллиам	williams
วิลเลี่ยม	виллиам	william
วิวัฒนาการ	еволуција	evolution
วิวัฒน์	еволуирати	produce, making up, invent
วิวัฒน์เกียรติ	виват киат	wiwatkiat
วิศว	инжењеринг	engineering
วิศวกร	инжењер	engineer
วิศวกรรมวัสดุ	машинско инжењерство	material engineering
วิศวกรรมสิ่งแวดล้อม	инжењеринг животне средине	environmental engineering
วิศวกรรมเครื่องกล	машинство	engineering
วิศวกรรมไฟฟ้า	електротехника	electrical engineering
วิสา	висиса	wisa
วิสูตร	дијагностичка	wisut
วิหาร	уточиште	vihara
วิเศษ	магија	wiset
วิเศษแก้ว	чаробно стакло	visetkeaw - surname of a singer
วิโนทัย	винотхаи	winothai
วีดีโอ	видео	video
วีดีโอเกม	видео игре	video game
วีรบุรุษ	јунак	hero
วีระ	веера	veera
วีระยุทธ	вираиут	werayut - a male's name
วีออส	виос	vios
วุฒิสภา	сенат	senate
วุฒิเมธี	вуттиметхи	wuttimethi - a surname
ว้าวุ่น	растресен	wawun
ศ	проф	a thai alphabet
ศร	стрелац	arrow
ศรชัย	сорнцхаи	sornchai - a male's name
ศรายุทธ	сараиутх	sarayut - a male's name
ศรีนครินทร์	сринакарин	srinakarin
ศรีนวล	сринуал	sinuan
ศรีบุญเรือง	шри бунруеанг	si bun rueang
ศรีประจวบ	си працхуап	siprachuap
ศรีปาน	шри пан	sri pan - a surname
ศรีมะฆะ	шри макха	sirimaka - a thai name
ศรียาภัย	срииапаи	siyaphai
ศรีสวัสดิ์	срисават	srisawat -  a surname
ศรีสำโรง	си самронг	si samrong
ศรีเมือง	сри муеанг	srimuang
ศรีไพร	сри пхраи	sri prai - a name
ศรเพชร	дијамантна стрелица	sonpet
ศศิธร	саситхорн	sasitorn - a females name
ศักดิ์ศรี	престиж	dignity
ศักย์ไฟฟ้า	електрични потенцијал	electric potential
ศัพท์	терминологију	vocabulary
ศาลชั้นต้น	грађански суд	curcuit court
ศาลหลักเมือง	светиште градског стуба	the old court house
ศาลเจ้าพ่อหลักเมือง	светиште градског стуба	the city's god
ศาสตราจารย์	професор	professor
ศาสนา	религија	religion
ศาสนาพราหมณ์ฮินดู	хиндуизам	hindu religion
ศาสนาฮินดู	хиндуизам	hinduism
ศาสนาโซโรอัสเตอร์	зороастризам	zoroastrianism
ศิริวรรณ	сириван	siriwan - a female's name
ศิลปอาชา	арт арцха	silpa-archa
ศิลปะ	уметност	arts
ศิลปะการแสดง	уметност перформанса	performing arts
ศิลปะลพบุรี	арт лопбури	lopburi art
ศิลปะศรีวิชัย	сривијаиа арт	arts from sri vi chai province
ศิลปะเขมร	кхмер арт	cambodian arts
ศิลปะเครื่องปั้นดินเผา	керамика умјетност	pottery art
ศิลปะเชียงแสน	цхианг саен арт	chaingsan art
ศิลปินแห่งชาติ	народни уметник	national artist
ศิลป์	уметност	silpa
ศิษย์เก่าคณะมนุษยศาสตร์	алумни факултет за хуманистичке науке	former humanity student
ศิษย์เก่าคณะรัฐศาสตร์	алумни факултета политичких наука	faculty of political science alumni
ศิษย์เก่าคณะเศรษฐศาสตร์	алумни економског факултета	economics alumni
ศีรษะ	глава	head
ศึกนันทบุเรง	нантхабуренг баттле	suknuntabureng -  a war in thailand
ศึกษาศาสตร์	образовање	field of education
ศุกลวัฒน์	суконват	sukolawat (a person's name)
ศุภกิจ	супакит	supphakit
ศุภณัฐ	супханат	supanat (first name)
ศูนย์	центар	center
ศูนย์การค้า	шопинг центар	shopping center
ศูนย์การบินทหารบก	војни ваздухопловни центар	marine forces
ศูนย์การศึกษาแม่ฮ่องสอน	образовни центар мае хонг сон-а	maehongsorn learning center
ศูนย์คอมพิวเตอร์	рачунарски центар	computer center
ศูนย์ค้าส่ง	велепродајни центар	wholesale center
ศูนย์บริการวิชาการ	академски сервисни центар	academic service center
ศูนย์ภาษา	језички центар	language center
ศูนย์รังสิต	рангсит центер	rangsit university center
ศูนย์ลำปาง	лампанг центер	lampang center
ศูนย์แพทยศาสตรศึกษาชั้นคลินิก	образовни центар клиничке медицине	medical education center
สก	вијак	abbreviation of two letters
สกว	трф	trf
สกอ	шкотска	office of higher education commission
สกอตแลนด์	шкотска	scotland
สกาย	ски	sky
สกุล	породица	sakun
สกุลหยาดน้ำค้าง	сундев	d. etrythrorhiza - a type of plant
สกุลเพชรหึง	петцхенг	grammatophyllum
สควอโล่	скуало	squalo
สงคราม	рата	war
สงครามครูเสด	крсташки рат	crusades war
สงครามมหาเอเชียบูรพา	велики рат у источној азији	world war two
สงครามอวกาศ	свемирски рат	space war
สงครามเกาหลี	корејски рат	korean war
สงครามเย็น	хладни рат	cold war
สง่าพล	елегантно	sangapol - a thai surname
สด	свеж	fresh
สตรอเบอรี่	јагода	strawberry
สตรีวิทยา	радиологија	satriwithaya
สติปัญญา	интелигенција	intelligence
สตึก	сатун	satuek (name of district)
สตูดิโอ	студио	studio
สถานที่ท่องเที่ยวทางธรรมชาติ	природне атракције	natural attraction
สถานะ	статус	status
สถานีคาราวาน	караванска станица	caravan station
สถานีวิทยุโทรทัศน์ไทยทีวีสีช่อง	тајландске телевизијске станице са тв каналима у боји	thai television station number _____
สถานีโทรทัศน์ไทยพีบีเอส	тхаи пбс телевизијска станица	thai public broadcasting service
สถาบัน	институција	office, department
สถาบันการศึกษา	образовна институција	educational institution
สถาบันบัณฑิตพัฒนบริหารศาสตร์	национални институт за развојну управу	satabunbunthitpakanabarihansart - a university in thailand, as known as nida
สถาบันพระบรมราชชนก	краљевски институт	red cross department
สถาบันวิจัยจุฬาภรณ์	цхулабхорн ресеарцх институте	julapon academy
สถาบันวิจัยและพัฒนา	институт за истраживање и развој	reseach and development institution
สถาบันศูนย์และหน่วยงานในมหาวิทยาลัย	институције, центри и одјели на универзитетима	current faculties/college/school/institutes
สถาบันสมทบ	придружена институција	affiliated institute
สถาบันอาชีวศึกษา	стручни завод	ahchevasuksa academy
สถาบันอุดมศึกษา	високошколска установа	higher education institute
สถาบันเทคโนโลยีนานาชาติสิรินธร	сириндхорн интернатионал институте оф тецхнологи	sirindhorn international institute of technology
สถาบันเทคโนโลยีพระจอมเกล้า	институт за технологију краља монгкута	king mongkut's institute of technology
สถาบันเทคโนโลยีพระจอมเกล้าเจ้าคุณทหารลาดกระบัง	ладкрабанг, технолошки институт краља монгкута	king mongkut's institute of technology ladkrabang
สถาบันเทคโนโลยีราชมงคล	рајамангала институте оф тецхнологи	rajamangala university of technology
สถาบันโภชนาการ	институт за исхрану	institute of nutrition
สถาปนิก	архитекта	architect
สถาปัตยกรรมไทย	тајландска архитектура	architecture of thailand
สถิติศาสตร์	статистика	statistic
สธ	стх	two letters from thai alphabets
สนธยา	сумрак	twilight
สนธิ	спајање	sonti - a male's name
สนธิไชย	сонтхицхаи	sontichai
สนามกีฬากลาง	централни стадион	main athletic field
สนามชัยเขต	санам цхаи кхет	sanamchaikate - a location in thailand
สนามฟุตบอล	фудбалско игралиште	football field
สนามแม่เหล็ก	магнетно поље	magnetic field
สนามไฟฟ้า	електрично поље	electric field
สนิทวงศ์	санит вонг	there are families.
สนิม	рђа	rust
สนเกรวิลเลีย	бор грожђе	grevilea - family of 250 types of plants
สปริงฟิลด์	спрингфиелд	springfield
สปรินเตอร์	спринтер	sprinter
สปาร์ค	искра	spark
สพ	спец	oc
สภานิติบัญญัติแห่งชาติ	национална законодавна скупштина	national diet
สภาผู้แทนนิสิต	савет студената представништва	college student representatives
สภาพอากาศ	време	weather conditions
สมจิตต์	сомцхит	somjit - a female's name
สมจิตร	сомцхит	somjit
สมชัย	сомцхаи	somchai
สมชาย	сомцхаи	somchai - a male's name
สมภพ	рођење	sompob
สมศรี	сомсри	somsi
สมศักดิ์	сомсак	somsak
สมัคร	применити	samak
สมัย	раздобље	era
สมัยกรุงธนบุรี	тхонбури период	thonburi era
สมัยก่อนประวัติศาสตร์	праисторијска времена	prehistory
สมัยที่	када	term
สมัยรัชกาลที่	владавина	in the reign of
สมัยสุโขทัย	сукхотхаи период	sukothai era
สมัยอาณานิคมฝรั่งเศส	француски колонијални период	modern france
สมาคมประชาชาติแห่งเอเชียตะวันออกเฉียงใต้	асоцијација нација југоисточне азије	association of south east asian nations (asean)
สมาชิกรับเชิญตอนพิเศษ	позвани чланови на посебну епизоду	special guests
สมาชิกฤดูกาลที่	чланови сезоне	member of the parliament
สมุทวณิช	самутаваницх	samudavanija
สมเด็จ	њено величанство	your highness
สมเด็จพระนางเจ้ารำไพพรรณี	краљица рамбхаи барни	queen rambhai barni
สมเด็จพระนางเจ้าสิริกิติ์	краљица сирикит	queen sirikit
สมเด็จพระนางเจ้าฯ	њено величанство	the queen of thailand
สมเด็จพระบรมราชาที่	краљ	king
สมเด็จพระบรมโอรสาธิราช	престолонаследник	his highness, royal crowned prince
สมเด็จพระบรมโอรสาธิราชฯ	престолонаследник	the crown prince of thailand
สมเด็จพระมหิตลาธิเบศร	сомдет пхра махидол латибес	somdet phra mahitra thibet
สมเด็จพระรามาธิบดีที่	кинг раматхибоди	som dej pra rama tippadee #_____ , number of the king
สมเด็จพระศรีนครินทราบรมราชชนนี	њ.кв принцеза маха цхакри сириндхорн	queen sirikit
สมเด็จพระอนุชาธิราช	сомдеј ануцхаттхират	som dej pra ah nu cha thi raj - a famous royalty in thailand a long time ago
สมเด็จพระเจ้ากรุงธนบุรี	крунг тхон бури	the king of the thonburi kingdom
สมเด็จพระเจ้าภคินีเธอ	њено краљевско височанство	the king's sister, som dej pra jao pakini ther
สมเด็จพระเจ้าลูกเธอ	њено краљевско височанство	the king's daughter, the princess
สยามดารา	сиам дара	siam stars
สยามบรมราชกุมารี	сиам	the current king's eldest daughter, the eldest princess
สยามพารากอน	сиам парагон	siam paragon
สร	креирај	abbreviation for the royalties' accessories
สรรพสินค้า	робна кућа	department store
สราวุธ	саравут	sarawut
สร้าง	креирај	build
สลักใจ	импресс	salakchai
สวนดุสิตโพล	анкета суан дусит	suan dusit poll
สวนผึ้ง	суан пхуенг	bee garden
สวนสมเด็จพระศรีนครินทร์	парк сомдет пхра сринагариндра	pra sri nakarin - a king of thailand
สวรรคต	умрети	die
สวรรคตหรือ	преминуо	die or ___________
สวรรคโลก	саванкхалок	heaven on earth
สวัสดิ์	сават	sawat - a male's name
สวัสดีปีใหม่	срећна нова година	happy new year
สวิตเซอร์แลนด์	швајцарска	switzerland
สวี	апартмани	sawi
สส	тајна	representatives
สหพันธ์สาธารณรัฐเยอรมนี	федеративна република немачка	germany
สหรัฐอาหรับเอมิเรตส์	уједињени арапски емирати	arab emirate
สหรัฐอเมริกา	у.с.	america, usa
สหราชอาณาจักร	велика британија	united kingdom
สหวงษ์	сахавонг	sawong - a male's name
สองสาย	две жице	double-stranded
สอยดาว	упперцут	soidao
สะดวก	лако	convenient
สะตอ	сато	sator
สะล้อ	кочница	salao
สะเดา	неем	neem, a type of plant
สัจธรรม	истина	normal truth; common knowledge
สัญญา	уговор	sanya
สัญลักษณ์ประจำมหาวิทยาลัย	универзитетски лого	logo of the university
สัดส่วน	пропорција	ratio
สัตว์	животиња	animal
สัตว์มีกระดูกสันหลัง	вертебратес	vertebrate animals
สัตว์มีแกนสันหลัง	кичма	chordata
สัตว์เลี้ยงลูกด้วยน้ำนม	сисари	mammal
สัตว์เลื้อยคลาน	рептиле	reptile
สัตว์เลื้อยคลานในอันดับนี้	рептили овог ранга	reptile in this order
สัทศาสตร์	фонетика	phonetics
สันติ	мир	peace
สันติสุข	мир	santi suk
สัมผัสนอก	спољна рима	outside touch
สัมพันธ์	односа	relationship
สัมมา	јел тако	summa - the buddhist prayer often starts with this
สาขา	огранак	office location
สาขานครราชสีมา	филијала накхон ратцхасима	nakhon ratchasima branch
สาขานครสวรรค์	накхон саван бранцх	nakhon sawan branch
สาขานิเทศศาสตร์	цоммуницатион артс	faculty of communication arts
สาขาประจวบคีรีขันธ์	огранак працхуап кхири кхан	prachuap khiri khan branch
สาขาปราจีนบุรี	працхинбури бранцх	pracheenburi branch
สาขาพิษณุโลก	пхитсанулок бранцх	pisanulok location
สาขามนุษยศาสตร์	хуманистичке науке	humanities
สาขาย่อย	подружница	offices
สาขาลำปาง	филипа лампанг	lumpang location
สาขาวิชานิติศาสตร์	правни факултет	law department
สาขาวิชาบริหารธุรกิจ	програм пословне администрације	business administration program
สาขาวิชารัฐประศาสนศาสตร์	одељење за државну управу	local government
สาขาวิชาวิทยาการคอมพิวเตอร์	програм за рачунарске науке	school of computer science
สาขาวิชาวิศวกรรมคอมพิวเตอร์	програм рачунарског инжењерства	computer engineering
สาขาวิชาวิศวกรรมอาหาร	фоод енгинееринг	food engineering
สาขาวิชาวิศวกรรมอิเล็กทรอนิกส์	програм електронског инжењеринга	major electronic engineering
สาขาวิชาศิลปอุตสาหกรรม	одељење за уметност	arts department
สาขาวิชาเคมี	одељење за хемију	department of chemistry
สาขาวิชาเทคโนโลยีชีวภาพ	биотехнолошки програм	department of biotechnology
สาขาวิชาเศรษฐศาสตร์	економија	finance department
สาขาศิลปะสถาปัตยกรรม	арт арцхитецтуре	art and architecture branch
สาขาสมุย	филија самуи	smui branch
สาขาหัวหิน	огранак хуа хин	hoa hin branch
สาครสินธุ์	сакорн син	sakornsin - a surname
สาทร	сатхорн	sathon
สาธารณรัฐประชาชนจีน	народна република кина	people's republic of china
สาธารณรัฐออสเตรีย	република аустрија	republic of austria
สาธารณรัฐอินโดนีเซีย	република индонезија	republic of indonesia
สาธารณรัฐเช็ก	чешка	czech republic
สาธารณรัฐโดมินิกัน	доминиканска република	republic dominican
สานติวัตร	сантиват	santiwat
สามก๊ก	три краљевства	three kingdom 'sam kok' - a thai legend
สามชัย	сам цхаи	samchai - a location in thailand
สามชุก	сам цхук	sam chuk district
สามพราน	сампран	sam phran
สามอัศวินในจินตนาการ	три фантастична витеза	sam assavin in jintanakan - the name of a japanese story
สามัญ	обичан	common
สายการบิน	авио-компаније	airline
สายรัชกาลที่	касна владавина	family tree of king rama ...
สายรุ้ง	дуга	rainbow
สายสนั่น	громова линија	siasanan
สายสีชมพู	пинк лине	pink line
สายสีน้ำเงิน	плава линија	blue line
สายสีม่วง	љубичаста линија	purple line (rapid transit)
สายหมอก	туман	fog
สายเดียว	једна линија	single helix
สายเมืองทอง	муеанг тхонг лине	muang thong line
สารต้านอนุมูลอิสระ	антиоксиданти	antioxidants
สารพฤกษเคมี	фитохемија	phytochemical
สารภี	сарапхи	saraphi
สารละลาย	решење	solution
สารานุกรมไทย	тхаи енцицлопедиа	saranukromthai
สารานุกรมไทยฉบับราชบัณฑิตยสถาน	тајландска енциклопедија роиал институте едитион	thai's publication
สารีวงษ์	сареевонг	sariwong
สาวิตรี	савитри	sawitri
สาเหตุ	узрок	reasons
สำนวนเก่า	стари идиом	old aphorism
สำนักงานขนส่งกรุงเทพมหานครพื้นที่	канцеларија за саобраћај у бангкоку	thai general transport
สำนักงานคณะกรรมการวัฒนธรรมแห่งชาติ	канцеларија националне комисије за културу	office of arts and culture preservation of thailand
สำนักงานโครงการพัฒนาแห่งสหประชาชาติ	канцеларија за развојни програм уједињених нација	united nations development prograท
สำนักระบาดวิทยา	завод за епидемиологију	bureau of epidemiology
สำนักราชเลขาธิการ	секретаријат	operation department of the king's palace
สำนักวิทยบริการ	уред за академске ресурсе	office of academic services
สำนักหอสมุด	библиотека	library
สำนักหอสมุดกลาง	централна библиотека	the central library
สำรวจ	преглед	investigate
สำราญ	радосно	happily
สำหรับ	за	for
สำหรับประเทศไทย	за тајланд	for thailand
สำหรับใช้เป็นตราหัวหนังสือราชการไทย	за употребу као печат на књижици тајландске владе	emblem thailand garuda
สำหรับในปี	јер у години	for the year
สำเนียง	акценат	dialect
สำโรง	самронг	sumrong - a location in thailand
สิงหาคม	август	august
สิงหไตรภพ	сингха трипоп	sing tri pop - a thai drama
สิงโต	лав	lion
สิทธิ	права	rights
สิทธิมนุษยชน	људска права	human rights
สิน	грех	sihn
สินค้าคงเหลือ	залихе	inventory
สินค้าอุปโภคบริโภค	роба широке потрошње	supplies
สินสมุทร	син самут	sihnsmut
สินิทธา	зитхитха	sinitra - first name of an actor
สิปปภาค	зиппи регион	sippapak
สิเรียม	сириум	syriam (name of city in myanmar)
สิ่ง	ствар	things
สิ่งมีชีวิต	жива бића	living things
สิ่งเสพติด	дрога	addictive substance, drugs
สิ้นพระชนม์ในรัชกาลที่	погинуо за време владавине	died in
สี	боја	color
สีขาว	бела боја	white
สีดำ	црна боја	black color
สีน้ำตาล	браон боје	brown
สีน้ำเงิน	плави	blue
สีฟ้า	плави	blue
สีม่วง	љубичаста	purple
สีลม	ветрењача	silom
สึนะ	тсуна	tsuna
สึนะโยชิ	тсунаиосхи	tsunayoshi
สืบต่อมา	наслеђено	live on
สื่อสารมวลชน	масивна комуникација	mass communication
สื่อสิ่งพิมพ์	штампани медији	printing media
สุกิจ	сукит	sukit
สุขภาพ	здравље	health
สุขสวัสดิ์	суксават	suksawas
สุขาภิบาล	санитарни	sukhapibal (name of district)
สุขุมวิท	сукхумвит	sukhumvit
สุครีพ	сукрее	sugriva
สุจริตกุล	суцхариткун	sucharitkul
สุจาริณี	суцхаринее	sujarinee
สุชิน	суцхин	suchin
สุดท้ายตายด้วยฝีมือ	коначно умри од вештине.	eventually dies at the hand of
สุดสาคร	судсакорн	sootsakorn - a character in a thai legend
สุดารัตน์	сударат	sudarat
สุทธิชัย	суттхицхаи	suttichai - a male's first name
สุทัศนะจินดา	сутасацхинда	sututnajinda - surname of a tv host
สุทัศน์	сутхат	sutas
สุธี	учењак	sutee - a male's name
สุนทร	сунтхорн	sunthon
สุนทรภู่	сунтхорн пху	soontornpoo - a character from a legend
สุนทรเวช	сунтхорнвет	"surname ""sundaravej"""
สุนัขจิ้งจอก	лисица	baby fox
สุปรีย์	супри	supri - a name
สุพจน์	супхот	supot
สุพล	супон	surapol
สุมณทิพย์	сумонтхип	sumonthip
สุรชาติ	сурацхат	surachart - a male's name
สุรพล	сурапон	suraphol
สุรพันธ์	сурапхан	surapan - a male's name
สุรวุฒิ	суравут	surawut
สุรศักดิ์	сурасак	surasak
สุรัสวดี	сурасавадее	suratsawadee - a thai surname
สุราษฎร์ธานี	сурат тхани	surat thani
สุรินทร์	сурин	surin - a place in thailand
สุริยัน	сурииан	suriyan - a male actor
สุริโยไท	сурииотхаи	"movie called ""suriyothai"""
สุลต่าน	султан	sultan
สุวนันท์	суванан	suwanan
สุวรรณรัฐ	суваннарат	suwannarath
สุวรรณานนท์	суваннанон	suwannanon - a surname
สุเทพ	сутхеп	suthep - first name of a famous singer
สุโขทัย	сукхотхаи	sukothai - ancient thailand
สุ่น	сунце	sun
สูง	високо	high
สูงจากระดับน้ำทะเลปานกลาง	изнад средњег нивоа мора	above average sea level
สู่	до	indicate
สเตราส์	страусс	strauss.
สเตอรอล	стерол	steroid anabolic
สเตเดี้ยม	стадион	stadium
สเปน	шпанија	spain
สไตรค์	ударац	strike
สไตล์การเล่น	стил игре	style
ส่งเสริม	промовисати	support, encourage
ส่วนของผู้ถือหุ้น	власнички капитал	shareholder fund
ส่วนต่อขยายบางซื่อท่าพระ	ектенсион банг суе тха пхра	bang sue – tha phra expansion
ส่วนสูง	висина	height
ส่วนส่งกำลังบำรุง	одељак за логистику	supply center
ส่วนหัว	хеадер	top part
ส่วนในฤดูฝนน้ำจะท่วมทุกปี	у кишној сезони вода ће поплавити сваке године.	flooding in the rainy season
ส่วนใหญ่	већина	mostly
ส่วนใหญ่เป็นโรงสีข้าว	већина њих су млинови риже.	most of them are rice refinery
ส่องแสง	сјај	shining light
ส้ม	наранџаста	orange
ส้มเช้ง	наранџаста наранџа	acidless orange
ส้มโอ	грејпфрут	pomelo
หงษ์ทอง	хонг тхонг	hongthong
หงษ์มานพ	хонг маноп	hongmanop
หงสกุล	хонг сакул	hongsakul (a famous surname in thailand), as in harin hongsakul
หญ้าทะเล	морска трава	seagrass
หญ้าฝรั่น	шафран	saffaron
หนองคาย	нонг кхаи	nong kai -  a location in thailand
หนองม่วง	нонг муанг	nong muang
หนองหาน	нонг хан	nong-haan
หนองฮี	нонг хее	nong hi - a location in thailand
หนองแซง	занг	nong sang - area in thailand
หนอน	црв	worm
หนัก	тешка	heavy
หนังสือ	књига	book
หนังสือการ์ตูน	стрип	comic book
หนังสือลามก	порнографске књиге	pornographic magazines
หนังใหญ่	велики филм	nang yai
หนึ่ง	једно	one
หนึ่งธิดา	једна ћерка	nuengthida
หนุมาน	хануман	hanuman - a giant in a thai tale
หนุ่ม	млад	young (used for men)
หน่วยความจำ	меморија	computer memory
หน่วยคำเติม	морпхеме	affix
หน่วยทหารในค่าย	војна јединица у логору	units in camp
หน่วยที่	јединица	order of 1, 2, 3...
หน่วยบัญชาการนาวิกโยธิน	морски штаб	royal thai marine corps
หน่วยประมวลผลกลาง	централна процесорска јединица	central processing unit
หน่วยพันธุกรรม	генетска јединица	gene
หน้าอก	груди	breast
หมวด	група	category
หมวดหมู่	категорија	category
หมวดหมู่กลุ่มดนตรีที่ก่อตั้งในปี	категорија музичке групе основана у	category: music band established in the year
หมวดหมู่กลุ่มดนตรีสัญชาติเกาหลี	категорија музичке групе у кореји	korean musical group
หมวดหมู่กวีชาวไทย	категорија тајландског песника	thai poem category
หมวดหมู่การฉลองปีใหม่	новогодишња категорија прославе	the group in charge of new year celebration
หมวดหมู่การประท้วงในประเทศไทย	категорија протеста на тајланду	category:protests in thailand
หมวดหมู่การ์ตูนญี่ปุ่นแนวโชเน็น	категорија: јапански цртић, схонен стил	the cartoons of japan
หมวดหมู่จุลชีววิทยา	категорија микробиологије	category:microbiology
หมวดหมู่ชาวไทยที่นับถือศาสนาพุทธ	категорија тајландски будисти	category:thai buddhists
หมวดหมู่ชาวไทยที่เกิดในต่างประเทศ	категорија тајланђани рођени у иностранству	thais that were born outside thailand
หมวดหมู่ดาวเคราะห์ชั้นใน	унутрашња категорија планета	group of stars inside
หมวดหมู่ดาวเคราะห์หิน	планет стоне категорија	category:terrestrial planets
หมวดหมู่ทหารอากาศชาวไทย	тхаи аир форце категорија	category:royal thai air force personnel
หมวดหมู่ทหารเรือชาวไทย	категорија тајландске морнарице	group of thai navy officers
หมวดหมู่นักการเมืองไทย	категорија тајландских политичара	politician
หมวดหมู่นักร้องไทย	категорија тајландских певача	singer category
หมวดหมู่นายกรัฐมนตรีไทย	категорија тајландски премијер	category:prime ministers of thailand
หมวดหมู่บริษัทของไทย	категорија компаније из тајланда	group of thai's companies
หมวดหมู่บริษัทที่ก่อตั้งในปี	компанија основана у	category:companies established in
หมวดหมู่บอยแบนด์	категорија дечака	a group of boys band
หมวดหมู่บุคคลจากจุฬาลงกรณ์มหาวิทยาลัย	категорије са универзитета цхулалонгкорн	category:chulalongkorn university alumni
หมวดหมู่บุคคลจากมหาวิทยาลัยธรรมศาสตร์	категорија са универзитета тхаммасат	group of staff from thammasat university
หมวดหมู่บุคคลจากมหาวิทยาลัยสุโขทัยธรรมาธิราช	категорије са отвореног универзитета сукхотхаи тхамматхират	group: person from sukhothai thammathirach university
หมวดหมู่บุคคลจากมหาวิทยาลัยอ๊อกซฟอร์ด	индивидуална категорија са универзитета окфорд	the staff of oxford university, england
หมวดหมู่บุคคลจากสถาบันบัณฑิตพัฒนศิลป์	категорија људи са института бундитпатанасилпа	group of staff from art schools
หมวดหมู่บุคคลจากโรงเรียนนายร้อยพระจุลจอมเกล้า	категорије са краљевске војне академије цхулацхомклао	catagory: people from prchomklhaw academy
หมวดหมู่บุคคลจากโรงเรียนมงฟอร์ตวิทยาลัย	категорија појединаца са монтфорт колеџа	category: people from mongford college
หมวดหมู่บุคคลที่เกี่ยวข้องกับเหตุการณ์	категорија људи повезаних са догађајем	catagory: individuals invovled
หมวดหมู่ประวัติศาสตร์ไทย	категорија историја тајланда	category:history of thailand
หมวดหมู่ประเภทของภาพยนตร์	категорија категорије филма	types of film
หมวดหมู่ปรัชญา	филозофија категорија	category:philosophy
หมวดหมู่พระราชนัดดาในรัชกาลที่	категорија краљевски унук владавине	"catagory: royal heirs during the ""blank"" reign"
หมวดหมู่พระราชปทินัดดาในรัชกาลที่	категорија краљевска владавина у владавини	the king's army
หมวดหมู่พระราชปนัดดาในรัชกาลที่	категорија краљ панадда у владавини	belonging to the king # ________
หมวดหมู่พิธีกรไทย	категорија тајландски излагачи	host for thai shows
หมวดหมู่ฟุตบอลในประเทศไทย	фудбалска категорија на тајланду	category; football in thailand
หมวดหมู่ภัยธรรมชาติ	категорија природне катастрофе	catagory: natural disasters
หมวดหมู่ภัยพิบัติทางการแพทย์	категорија медицинске катастрофе	category: medical disaster
หมวดหมู่มหาวิทยาลัยธรรมศาสตร์	категорија универзитета тхаммасат	thamasat university
หมวดหมู่รัชกาลที่	категорија владавине	reign 9 category
หมวดหมู่รัฐคอมมิวนิสต์	категорија комунистичке државе	communist countries
หมวดหมู่รัฐมนตรีว่าการกระทรวงการต่างประเทศไทย	категорија: тајландски министар спољних послова	category:foreign ministers of thailand
หมวดหมู่รัฐวิสาหกิจไทย	категорија тајландска предузећа	category:government-owned companies of thailand
หมวดหมู่รัฐสิ้นสภาพในทวีปเอเชีย	категорија државе је престала у азији	asian counties in controlled
หมวดหมู่รัฐและดินแดนที่ก่อตั้งในปี	успостављене категорије државе и територије	categories state and territory established in
หมวดหมู่รายการโทรทัศน์ไทย	категорија програма тајландске телевизије	the group of thai television channels
หมวดหมู่ละครโทรทัศน์ไทย	категорија тајландске телевизијске драме	thai drama category
หมวดหมู่วัฒนธรรมไทย	категорија тајландске културе	category:thai culture
หมวดหมู่วันสำคัญทางศาสนาที่นับโดยปฏิทินจันทรคติ	категорије важних верских дана које се рачунају по лунарном календару	group of religious holidays
หมวดหมู่ศิลปินสังกัดจีเอ็มเอ็ม	категорија извођача под гмм	mgm artists
หมวดหมู่สถาบันอุดมศึกษาในกรุงเทพมหานคร	категорије високошколских установа у бангкоку	category:universities in bangkok
หมวดหมู่สมุนไพร	категорија биљака	herbal, herbs
หมวดหมู่สัตว์มีแกนสันหลัง	категорија вертебрална осовина	category:chordates
หมวดหมู่สัตว์เลื้อยคลาน	категорија гмазова	reptilians
หมวดหมู่สิ่งก่อสร้างในพุทธศตวรรษที่	категорија грађевина у 21. веку	development in the century # ____
หมวดหมู่สิ้นสุดในคริสต์ศตวรรษที่	категорија је завршила у 19. веку.	category: ended in xth century
หมวดหมู่สโมสรในพรีเมียร์ลีก	категорија клуба у премиер лиги	group of premier club
หมวดหมู่อดีตอาณานิคมของฝรั่งเศส	француска бивша колонијална категорија	category:former french colonies
หมวดหมู่อดีตอาณานิคมของสเปน	бивша шпанска колонијална категорија	category:former spanish colonies
หมวดหมู่อดีตอาณานิคมของอังกฤษ	британска бивша колонијална категорија	the group of countries that were under british control
หมวดหมู่อวัยวะ	категорија органа	group of organs
หมวดหมู่อวัยวะเพศ	категорија гениталија	category:sex organs
หมวดหมู่เครื่องเทศ	категорија зачина	herbs
หมวดหมู่เพศศึกษา	категорија сексуалног образовања	sex education category
หมวดหมู่แนวพระราชดำริ	категорија иницијативе	the king's words (instruction)
หมวดหมู่โรค	категорија болести	group of disease
หมวดหมู่โรงเรียนที่มีอัตราการแข่งขันสูง	категорија школа са високом стопом такмичења	categories high competition school
หมวดหมู่โรงเรียนบุรุษในประเทศไทย	категорија мушких школа на тајланду	category:boys' schools in thailand
หมอชิต	морцхит	mochit bus station
หมากรุกสากล	међународни шах	chess
หมายความว่า	значи	means
หมู่	свиња	district, group
หมู่ที่	село	moo.
หมู่เกาะเคย์แมน	кајманска острва	cayman island
หมู่เกาะแบลีแอริก	балеарска острва	balearic island in spain
หมู่เกาะโซโลมอน	соломонска острва	solomon islands
หม่อมราชวงศ์ปรีดิยาธร	р. придииатхорн	mom rajawongse pridiyathorn devakula
หม่อมหลวงปิ่น	мама пин	mom luang pin
หม่อมเจ้าจุฑาวัชร	принц јутаватцхаи	his serene highness prince juthawat
หม่อมเจ้าวัชรวีร์	принце ватцхаравее	mom chao vatcharee - a member of the royal family
หม่อมเจ้าวัชรเรศร	мама ватцхарацхорн	watcharaje - a member of royal family
หม้อข้าวหม้อแกงลิง	непентхес	nepenthes - a type of tropical plant
หยุ่น	флексибилан	yun - nickname of a thai newscaster
หรั่ง	ланг	rang
หรือ	или	or
หรือการแสดงธงชาติ	или приказује националну заставу	national flag display
หรือชื่อทางการคือ	или је службено име	official name is
หรือที่รู้จักกันในชื่อ	или познат као	also known as
หรือที่เรียกกันว่า	такође познат као	or what it is called ...
หรือเรียกว่า	или позвано	called
หลวง	краљевски	loung - a thai title for people who services the king
หลอก	псеудо	fake, fooling someone
หลอดอาหาร	једњак	esophagus
หลอดเลือดแดงใหญ่เอออร์ตา	аорта	aorta
หลักจริยธรรม	етика	ethics
หลักทรัพย์	хартије од вредности	property
หลักสี่	лакси	luk sri - a location in bangkok
หลักสูตรการจัดการดุษฏีบัณฑิต	доктор филозофског програма менаџмент	doctor of management program
หลักสูตรที่เปิดสอน	курс	curriculum
หลักสูตรนานาชาติ	међународни курс	international course
หลักสูตรปกติ	нормалан курс	normal program
หลักสูตรภาษาอังกฤษ	курс енглеског језика	english curriculum
หลักสูตรภาษาไทย	курс енглеског језика	thai language curriculum
หลักสูตรวิทยาศาสตรมหาบัณฑิต	мастер оф сциенце програм	degree requirements for a bachelor degree in science
หลังจาก	после	after
หลังสงคราม	после рата	after the war
หลังสงครามโลกครั้งที่	после светског рата	world war
หลังสงครามโลกครั้งที่สอง	после другог светског рата	after world war ii
หลังเหตุการณ์	после догађаја	after the event
หลาย	многи	many, vastly
หลีกภัย	есцапе	mr. cheun leakpai, the former foreign ministor
หลุมดำจิ๋ว	ситна црна рупа	small black hole
หล่มสัก	лом сак	lohmsak
หวาย	ратана	bamboo
หอก	копље	spear
หอประชุมพ่อขุนรามคำแหงมหาราช	краљ рамкхамхаенг велики аудиторијум	pho khun ram khamhaeng convention center
หอมรดกไทย	дворана тајландске баштине	national ancient museum of thailand
หอย	шкољке	shells, clams
หอไอเฟล	ајфелова кула	eiffel tower
หัก	одбити	broken
หัว	глава	head
หัวหิน	хуа хин	hua hin
หัวโขน	маска	khon mask
หัวใจ	срце	heart
หาง	реп	tail
หาดทรายแก้ว	плажа саи каев	glass beach
หาบเร่	хавкер	street vending
หินปูน	кречњак	limestone
หินอ่อน	мермер	marble
หินเชิร์ต	камена кошуља	chert
หินแกรนิต	гранит	granite rock
หินไซอัล	шкриљасти камен	sial
หี	маца	vagina (impolite word)
หุตะสิงห์	хута синг	hutasingha
หุ่น	марионета	model
หุ่นยนต์	робот	robot
หเตุการณ์	ситуација	event
ห่วงใย	брижан	care
ห้วยขวาง	хуаи кхванг	huai khwang
ห้วยทับทัน	хуаи тхап тхан	huai thap than
ห้องน้ำ	тоалет	bathroom
ห้องสมุด	библиотека	library
ห้าง	продавница	mall
ห้างฉัตร	ханг цхат	hang chat
ห้างหุ้นส่วนจำกัด	ограничено партнерство	limited partnership
ฬาพานิช	комерцијални	fapanit - surname of an actor
อก	дојке	chest
อคิลลีส	ахил	achilles
องคชาต	гениталије	penis
องคต	организација	angada
องค์กรปกครองส่วนท้องถิ่น	организација локалне управе	local administration
องค์การนิสิต	студентска организација	student organization
องค์การมหาชน	јавна организација	human services
องค์การสหประชาชาติ	уједињене нације	united nation
องค์บาก	онг бак	ong-bak
องค์ประกันหงสา	хонгса осигурање	prakunhongsa - a famous person from the ancient time
องอาจ	с периком	ongart
อดิศักดิ์	адисак	adisak
อดีต	бивши	the past
อดีตผู้บัญชาการทหารบก	бивши војни командант	ex-commander in chief of the royal thai army
อดีตรองนายกรัฐมนตรี	бивши потпредседник владе	former deputy prime minister
อดีตรองหัวหน้าหน่วยที่	бивши заменик шефа јединице	former lieutenant
อธิการบดี	канцелару	dean of the college
อธิการบดีมหาวิทยาลัยธรรมศาสตร์	председник универзитета тхаммасат	former chanceller of thamasat university
อธิบายว่า	објасните то	explain
อนันตยะ	анантаиа	anantaya
อนันตรัย	анантаи	anuntrai
อนาลโย	аналои	analayo
อนึ่ง	случајно	once
อนุทิน	дневник	diary
อนุสรณ์สถาน	мемориал	monument
อนุสรา	анусара	anusara
อปักธงชัย	пак тхонгцхаи	pak thongchai district
อพอลโล่	аполон	apollo
อพิมาย	апхимаи	phimai district
อภัยนุราช	опрости	aphainurat
อภินันท์	апхинан	ahpinun - a male's name
อภิปรัชญา	метафизика	metaphysics
อภิรักษ์	апхирак	apirak
อมฤต	мртав	ummarit - a male's name
อมาตยกุล	аматаиакун	amattayakun
อยู่	су	is
อยู่วิทยา	наука	yoovidhya
อยู่ห่างออกไปจากชายฝั่ง	далеко од обале	away offshore
อยู่แล้ว	вец	already
อยู่ในเขตอำเภอกุฉินารายณ์	смештен у округу кучинараи	in the kuchinarai district
อย่างต่อเนื่อง	непрекидно	continuously
อย่างแพร่หลาย	широко	many, various
อย่างไรก็ตาม	међутим	however
อร	орн	orn (thai name)
อรทัย	млада девојка	orathai - surname of a thai country singer
อรรถกถา	коментар	atthakatha
อรรถพร	атхапхон	uttapon - a female's name
อรัญประเทศ	араниапратхет	arranyapratet - a location in thailand
อริยสัจ	племенита истина	teaching of buddha
อรุณี	арунее	arunee
อลังการ	украс	alungan - the name of a movie theater in thailand
อลาสก้า	аљаска	alaska
อลิซ	алице	alice
อวอร์ดส	награде	award
อวัยวะสืบพันธุ์สตรีด้านนอก	спољни женски органи	femal reproductive system
อวัยวะสืบพันธุ์หญิง	женски генитални органи	female reproductive system
อวัยวะเพศ	гениталије	sex organ
อศรีประจันต์	асри працхан	master sri prajan - a priest's name
อสมท	мцот	acronym for thai communication companies
อสามชุก	сам цхук	sam chuk district
ออ	или	auu - a thai vowel
ออกฉายครั้งแรกเมื่อวันที่	прво приказано	first screening
ออกมาในอะนิเมะเท่านั้น	излази само у анимеу	only in anime
ออกอากาศ	емитовање	on the air
ออกอากาศครั้งที่	емитовано	airing
ออกอากาศทางช่อง	емитовање даље	aired on channel
ออกัสตัส	аугустус	augustus
ออกเป็น	у	into
ออกแบบตัวละคร	дизајн карактера	character design
ออนไลน์	онлине	online
ออฟ	ван	off
ออลแบนี	савезници	albany
ออสเตรเลีย	аустралија	australia
ออโตทรอพ	аутобот	autotroph
อะ	шта	a
อะซูไรต์	азурите	azurite
อะตอม	атом	atom
อะนิเมะ	аниме	anime
อะบุราเมะ	абураме	aburame
อะพาไทต์	апатите	apartheid
อะมาเดอุส	амадеус	amadeus
อะลูมิเนียม	алуминијум	aluminum
อะโกนิสต์	агонист	agonist
อะโลน	сам	alone
อักษร	писмо	letters, alphabets
อักษรย่อ	скраћенице	abbreviation
อักษรเกาหลี	корејска абецеда	korea alphabet
อังกฤษสมัยแองโกล-นอร์มัน	англо-норман енглески	england anglo-norman era
อังการา	анкара	ankara
อัญมณี	драгуљ	gem
อัฒภาค	тацка зарез	semicolon
อัตราการว่างงาน	стопа незапослености	unemployment rate
อัธฮา	атхха	athha
อันดับ	оцена	order
อันประกอบด้วย	који се састоји од	consists of
อันโตนิโอ	антонио	"name ""antonio"""
อันโตนีโอ	антонио	antonio
อันได้แก่	укључујући	which are
อัฟกานิสถาน	афганистан	afghanistan
อัมพร	ампорн	umpon - a female's name
อัมพาต	парализа	paralysis
อัลบัส	албус	albus in harry potter stories
อัลบั้ม	албум	album
อัลเดบารัน	алдебаран	arudebaran
อัลเฟรด	алфред	alfred
อัสนี	завртањ	thunderbolt
อาการหวาดระแวง	параноиа	paranoid
อากาศ	ваздух	air, weather
อากาศอำนวย	веатхер	akat amnuai
อากาเป	агапе	the word meaning 'love' in greek language
อาคามัตสึ	акаматсу	akamatsi
อาคารส่วนที่	одељење грађевине	part (insert number) of the the building
อาคารอุบลรัตนราชกัญญา	зграда убонратана ратцхаканиа	buildings outside ubon ratana graz contract.
อาคารเฉลิมพระเกียรติ	зграда цхалоем пхракиат	chalermphrakiat building
อาจหมายถึง	може значити	may also mean
อาจารย์	професор	teacher
อาจารย์ใหญ่	директор	headmaster
อาซึกะ	асука	asuka
อาณัตพล	анатапхон	arnattapon
อาณาจักร	краљевство	kingdom
อาณาจักรธนบุรี	тхонбури кингдом	thonburi empire
อาณาจักรสุโขทัย	сукхотхаи кингдом	sukhothai kingdom
อาณาจักรอยุธยาปกครองเขมรเป็นเวลาเกือบปี	аиуттхаиа краљевством је владала камбоџом готово годину дана.	ayutthaya dynasty had colonized khmer for almort 400 years
อาณาจักรอยุธยาเริ่มเสื่อมอำนาจลงราวพุทธศตวรรษที่	аиуттхаиа царство је почело пропадати у будистичком веку.	ayutthaya kingdom had started to downfall around 24 b.e.
อาณาจักรแพกเจ	пакае кингдом	pakja territory
อาณาเขตติดต่อ	контакт подручје	adjoining parcel
อาดัม	адам	adam
อาทิ	као такав	for example
อาทิตย์	недеља	sunday
อานนท์	анон	anon
อานันทมหิดล	ананда махидол	ahnanmahidol - someone with the king's surname
อานุภาพ	снага	power
อานโตนิโอ	антонио	antonio
อาบาราอิ	абараи	abarai
อายุ	старост	age
อารยา	араиа	araya
อาร์	р	r.
อาร์กอน	аргон	argon
อาร์คิมิดีส	архимед	archimedes
อาร์ม	рука	arms
อาร์มาดิลโล	армадилло	armadillo
อาร์เคด	арцаде	arcade
อาร์เมเนีย	јерменија	armenia
อาร์เอ็นเอ	рна	ribonucleic acid - rna
อาร์โนลด์	арнолд	arnold
อาวุธคือ	оружје је	type of weapons
อาวุธประจำกาย	лично оружје	personal weapon
อาหาร	храна	food
อาเจียน	повраћати	vomit
อาเธอร์	артхур	arthur
อาเนีย	ана	anya
อำนาจ	снага	amnat
อำนาจอธิปไตย	суверенитет	sovereignty
อำเภอ	округ	district
อำเภอกมลาไสย	камаласаи дистрицт	kamalasai district
อำเภอกระสัง	округ красанг	krasang district
อำเภอกันทรลักษ์	кантхаралак дистрицт	kantharalak district
อำเภอขุขันธ์	округ кхукхан	khukhan district
อำเภอขุนหาญ	округ кхун хан	amphur kunhan
อำเภอครบุรี	округ кхон бури	amphur kornburi
อำเภอคูเมือง	округ кху муеанг	khu mueang district
อำเภอจอมทอง	округ цхом тхонг	jom thong district
อำเภอดอยสะเก็ด	округ дои сакет	doi saket district
อำเภอด่านขุนทด	округ дан кхун тхот	dan koontod district
อำเภอตะพานหิน	округ тапхан хин	taphan hin district
อำเภอทับคล้อ	округ тхап кхло	amphoe tap khlo
อำเภอทุ่งช้าง	округ тхунг цханг	thung chang district
อำเภอท่าตูม	округ тха тум	ta toom district
อำเภอท่าวังผา	округ тха ванг пха	ta wung pa province
อำเภอท่าวุ้ง	округ тха вунг	ta wung district
อำเภอนครชัยศรี	округ накхон цхаи си	nakhon chai si district
อำเภอนาบอน	на бон дистрицт	nabon district
อำเภอน้ำเกลี้ยง	округ нам клианг	amphur namleang
อำเภอบัวเชด	округ буацхет	buachet district
อำเภอบัวใหญ่	округ буа иаи	amphoe buayai (buayai district)
อำเภอบางบัวทอง	округ банг буа тхонг	bang bua thong district
อำเภอบางบ่อ	округ банг бо	bang bor district
อำเภอบางพลี	округ банг пхли	bang plee district
อำเภอบางละมุง	округ банг ламунг	bang lamung district
อำเภอบางเสาธง	округ банг сао тхонг	bang sao thong district
อำเภอบ้านลาด	округ бан лат	bahn lad district
อำเภอบ้านหมี่	округ бан ми	ban mi district
อำเภอปราสาท	прасат дистрицт	amphor-prasart
อำเภอปากช่อง	округ пак цхонг	pak chong district
อำเภอปากพนัง	округ пак пхананг	pak phanang district
อำเภอปาย	паи дистрицт	pai district
อำเภอฝาง	округ фанг	fang district
อำเภอพระประแดง	округ пхра прадаенг	pra-pradaeng district
อำเภอพระพรหม	округ пхра пхром	pra phrom province
อำเภอพระสมุทรเจดีย์	округ пхра самут цхеди	samutjadee district
อำเภอพลับพลาชัย	округ пхлаппхла цхаи	plubplachai province in thailand
อำเภอพัฒนานิคม	округ пхаттхана никхом	amphur pattananikhom
อำเภอพิปูน	пхипун дистрицт	phipun district
อำเภอพุทธมณฑล	округ футтхамонтхон	ampore phuthamontol
อำเภอภูสิงห์	пху синг дистрикт	aumphor phu sing (name of district)
อำเภอยางชุมน้อย	округ ианг цхум нои	choom noi province
อำเภอรหัสไปรษณีย์หมายเหตุ	округ, поштански број, белешка	district, post code, note
อำเภอรัตนบุรี	округ раттанабури	rhatanaburi district
อำเภอราษีไศล	раси салаи дистрицт	rasi-salai district
อำเภอร่อนพิบูลย์	рон пхибун дистрицт	ronpibul district
อำเภอลาดหลุมแก้ว	округ лат лум каео	lat lum kaeo district
อำเภอลำปลายมาศ	округ лам плаи мат	lum plai maad district in burrirum province
อำเภอศรีณรงค์	округ си наронг	si narong district
อำเภอศรีเมืองใหม่	округ си муеанг маи	sri meung mai district
อำเภอสระโบสถ์	црквени округ сра	sa bot district
อำเภอสหัสขันธ์	округ сахатсакхан	sahuskhan district
อำเภอสองแคว	сонг кхвае	song khwae district
อำเภอสังขะ	сангкха дистрицт	sang ka district
อำเภอสันป่าตอง	округ сан па тонг	sunpathong province in thailand
อำเภอสามพราน	округ сам пхран	sam pran area
อำเภอสารภี	округ сарафи	sarape district
อำเภอสิชล	сицхон дистрицт	sichon district
อำเภอสุไหงโกลก	округ сунгаи колок	amphoe su-ngai kolok
อำเภอหนองกี่	округ нонг ки	nong kee district
อำเภอห้วยราช	округ хуаи рат	huai rat district
อำเภออมก๋อย	омкои дистрицт	om koi district in chiang mai, thailand
อำเภอเกาะคา	округ ко кха	amphoe ko kha
อำเภอเขวาสินรินทร์	округ кхвао синарин	ampore khavasinrin
อำเภอเฉลิมพระเกียรติ	округ цхалоем пхракиат	amphur chalermprakiet
อำเภอเชียงของ	округ чијанг кхонг	chiang khong district
อำเภอเชียงคาน	округ чијанг кан	chiang khan district
อำเภอเชียรใหญ่	округ цхиан иаи	chien yai district in thailand
อำเภอเมืองกาฬสินธุ์	муеанг каласин	mueang kalasin provincial district
อำเภอเมืองนครราชสีมา	округ муеанг накхон ратцхасима	mueang nakhon ratchasima district
อำเภอเมืองนนทบุรี	округ муеанг нонтхабури	nontaburi district
อำเภอเมืองบุรีรัมย์	округ муеанг бури рам	burerum province
อำเภอเมืองพิจิตร	округ муеанг пхицхит	mueang phichit district
อำเภอเมืองพิษณุโลก	муеанг пхитсанулок	ampore maung pisanulok
อำเภอเมืองลพบุรี	округ муеанг лоп бури	lopburi province
อำเภอเมืองสุรินทร์	округ муеанг сурин	surin province
อำเภอเมืองอุตรดิตถ์	округ муеанг уттарадит	mueang uttaradit district
อำเภอเมืองเชียงใหม่	округ муеанг цхианг маи	mung chiang mai district
อำเภอเมืองเพชรบุรี	округ муеанг пхетцхабури	pechaburi province
อำเภอเวียงชัย	округ вианг цхаи	wiang chai district
อำเภอเวียงแก่น	округ вианг каен	wiang kaen district
อำเภอเสริมงาม	округ соем нгам	soem ngam district
อำเภอแจ้ห่ม	округ цхае хом	chae hom district
อำเภอแม่ทะ	округ мае тха	mahta district
อำเภอแม่แจ่ม	округ мае цхаем	mae jam province
อำเภอแม่แตง	округ мае таенг	mae taeng district
อำเภอโนนดินแดง	округ нон дин даенг	din dang sub district
อำเภอโนนสุวรรณ	округ нон суван	none su wan province
อิงค์	инц.	inc.
อิงลิช	енглески језик	english
อิทธิพล	утицај	power
อิน	ин	in
อินทิรา	индира	intira
อินฟราเรด	инфрацрвени	infared
อินฮิบิเตอร์	инхибитор	inhibitors
อินุยาฉะ	инуиасха	inuyacha - a japanese cartoon
อินเซคทิวอรา	инсектура	insectivora
อินเดียน	индијанац	indian
อินเด็กซ์	индекс	index
อินโดนีเซีย	индонезија	indonesia
อิม	имм	im
อิมาจิน	имајин	imagine
อิมแพ็ค	утицај	impact
อิรัก	ирак	iraq
อิริโทรมัยซิน	електролиза	erythromycin
อิสตันบูล	истанбул	istanbul
อิหร่าน	иран	iran
อิเควทอเรียลกินี	екваторијална гвинеја	equitorial
อิโนะ	ја не	ino
อีก	више	more
อีกครั้ง	поново	again
อีกด้วย	такође	also
อึ	срање	poop
อึ๊งภากรณ์	унгпхакорн	ungpakorn - a famous surname
อือ	да!	uu - a thai vowel
อื่น	други	other
อุ	о	ou
อุซึมากิ	узумаки	uzumaki naruto
อุณหภูมิ	температура	temperature
อุณหเคมี	термохемија	using energy and heat in chemical study
อุดม	плодна	udom
อุดรธานี	удон тани	udon thani
อุตตมะโยธิน	уппхарат иотхин	uttamayothin
อุตรดิตถ์	уттарадит	uttaradit
อุทยาน	парк	park
อุทยานประวัติศาสตร์พนมรุ้ง	историјски парк пханом рунг	phanom rung historical park
อุทยานประวัติศาสตร์พิมาย	историјски парк пхимаи	phimai historical park
อุทยานแห่งชาติคลองตรอน	национални парк кхлонг трон	khlong tron national park
อุทยานแห่งชาติดอยภูคา	национални парк дои пху кха	doi phu kha national park
อุทยานแห่งชาติดอยอินทนนท์	национални парк дои интханон	national park doi inthanon in northern thailand
อุทยานแห่งชาติทุ่งแสลงหลวง	национални парк тхунг салаенг луанг	thung salaeng luang national park
อุทยานแห่งชาติธารโบกขรณี	тхан бок кхорани натионал парк	tarabokorani national preserve area
อุทยานแห่งชาติน้ำตกสี่ขีด	национални парк водопада си кхит	namtoksekeed national park
อุทยานแห่งชาติน้ำพอง	нам пхонг натионал парк	nam phong national park
อุทยานแห่งชาติภูผาเหล็ก	национални парк ирон моунтаин	phupalek national park
อุทยานแห่งชาติภูพาน	национални парк пху пхан	phu phan national park
อุทยานแห่งชาติภูสวนทราย	национални парк пху суан саи	pusuansai national preserve
อุทยานแห่งชาติภูสอยดาว	национални парк пху сои дао	soi dao mountain preserve
อุทยานแห่งชาติภูเรือ	национални парк пху руеа	national park pu reau
อุทยานแห่งชาติภูเวียง	национални парк пху вианг	phu wiang national park
อุทยานแห่งชาติภูแลนคา	национални парк пхуланца	phu laenkha national park
อุทยานแห่งชาติหาดนพรัตน์ธาราหมู่เกาะพีพี	национални парк ноппхарат тхара, острва пхи пхи	hat nopparatthara-mu ko phi phi national park
อุทยานแห่งชาติเขาหลวง	национални парк кхао луанг	khao luang national park
อุทยานแห่งชาติไทรทอง	национални парк саи тхонг	sai thong national preserve area
อุทุมพรพิสัย	утхумпхон пхисаи	utompisai - an area in thai province
อุบล	убон	ubol - a place in thailand
อุปกรณ์	опрема	instrument
อุปกรณ์คอมพิวเตอร์	рачунари и опрема	computer hardware
อุปนิสัย	карактер	manners
อุภัยราศี	опрости зодијак	ambivert zodiac
อุรุกวัย	уругвај	urookwai - a location
อุเทน	утхен	utain - a male's name
อู	оу	u (a vowel)
อู๋	ву	auu (first name)
อเมริกัน	американац	american
อเมริกา	америка	america, usa
อเมริกาเหนือ	северна америка	north america
อเล็กซานเดอร์	александра	alexander
อเล็กซ์	алек	alex
อโลหะ	неметални	nonmetal
อ่อนเพลีย	уморан	fatigue
อ่าน	читати	read
อ่าวลึก	ао луек	ao luek
อ้างว่า	тврде да	claim
อ้างว้าง	пустош	loneliness
ฮอกกี้	хокеј	hockey
ฮอท	вруће	hot
ฮอฟมัน	хоффман	hoofman - a name
ฮอยเกนส์	хогенс	huygens
ฮอร์โมน	хормон	hormone
ฮอลแลนด์	холланд	holland
ฮอลโลว์	шупље	hollow (as in dead soul)
ฮอว์ค	морски јастреб, орао рибар	hawk
ฮักบี้	збогом	hugby - an album that received many awards
ฮันกึล	хангул	hangeul
ฮัมบูร์ก	хамбург	hamburg
ฮาจิ	хацхи	haji
ฮาตาเกะ	хатаке	hatake
ฮานอย	ханои	hanoi
ฮายาโตะ	хаиато	hayada - a japanese surname
ฮารุกะ	харука	haruka - a japanese name
ฮาวาย	хаваји	hawaii
ฮิซาชิ	хисасхи	hitachi
ฮิซานะ	хисана	hisana
ฮิตเลอร์	хитлер	hitler
ฮินาตะ	хината	hinada - a japanese story
ฮิมาวาริ	химавари	himawari - a japanese surname
ฮิราโกะ	хирако	hirako (japanese name)
ฮิวงะ	хиуга	hewnga - a japanese name from a story
ฮิโซกะ	хисока	hisoka
ฮิโรชิ	хиросхи	hiroshi
ฮีชอล	хеецхул	heechul
ฮุก	кука	hook
ฮโยยอน	хиоиеон	hyoon - a dancer from japan
ฯพณฯ	његова екселенција	two thai alphabets.  abbreviation that means many things
เกตส์	гатес	gates
เกตุทัต	кеттхат	kettut - a surname
เกมที่	игра	game number _________
เกมบุค	игра	game book
เกรย์	греи	gray
เกษตรกรรม	пољопривреда	farming
เกษตรวิสัย	касет висаи	kasetvisai (name of thai district)
เกษมศรี	касемсри	kasemsri surname
เกอริง	геринг	the name 'gerring'
เกอไทต์	гоетхе	goethite mineral
เกาหลีใต้	јужна кореја	south korea
เกาะ	острво	island
เกาะคา	кауаи	ko kha
เกาะลูซอน	острво лузон	luzon island
เกาะสุมาตรา	суматра	sumatra
เกิด	је рођен	born
เกิดขึ้นหลังจากมหาวิทยาลัยศรีนครินทรวิโรฒวิทยาเขตต่างๆ	настао након универзитета сринакхаринвирот	happened after srinakarinviroj university started
เกิดขึ้นเมื่อวันที่	појавио се дана	birthdate
เกิดจากการรวมชิ้นส่วนที่	настаје комбиновањем делова који	put together to form something
เกิดจากการรวมตัวของ	проузроковано оснивањем	combination of
เกิดจากเชื้อไวรัส	узроковано вирусом	occur from the viral agent
เกิดนิมิตร	створите визију	caused a vision/realization
เกียรติ	част	honour
เกียรติประวัติ	част	biography
เกียรติศักดิ์	слава	reputation.  kietisak can be a male's name
เกียวโตะ	кјото	kyoto
เก็กโค	цхеццо	gecko
เขตคลองสาน	кхлонг сан дистрицт	klongsan district
เขตจอมทอง	округ цхом тхонг	jomthong area
เขตดุสิต	дусит	khet dusit
เขตที่	округ	district number _______
เขตบางกอกใหญ่	округ бангкок иаи	bangkok yai district in thailand
เขตบางซื่อ	округ банг суе	bang sue district
เขตบางแค	банг кхае	bang khae district
เขตปทุมวัน	патхумван	pathum wan district
เขตภาษีเจริญ	округ пхаси цхароен	phasi charoen district
เขตมีนบุรี	округ мин бури	min buri district
เขตรักษาพันธุ์สัตว์ป่า	резерват за животиње	national wildlife preserve
เขตรักษาพันธุ์สัตว์ป่าภูหลวง	уточиште за дивљу природу пху луанг	wildlife preserve
เขตลาดกระบัง	лат крабанг	lad krabang district
เขตวังทองหลาง	округ ванг тхонгланг	wang thonglang district
เขตวัฒนา	ваттана дистрицт	watana district
เขตสวนหลวง	округ суан луанг	suan luang district
เขตสาทร	сатхон	sathorn area
เขตห้วยขวาง	хуаи кхванг	huai khwang district
เขตเลือกตั้งที่	бороугх	election area number
เขมนิจ	империозно	khemanit
เขากล่าวว่า	рекао је	he said
เขาทราย	кхао саи	sand dunes
เขียนว่า	написала је то	wrote
เขียนโดย	написао	written by
เขี้ยวพิษ	отровни очњаци	vemon fangs
เขื่อนกิ่วลม	кио винд дам	kio lom dam
เขื่อนป่าสักชลสิทธิ์	брана пасак цхонласит	parsakchonlasit dam
เขื่อนลำปาว	лампао брана	lum pao dam
เขื่อนแม่งัดสมบูรณ์ชล	мајка нгад сомбоон цхон дам	mae ngud som bul chol dam in chiangmai
เข็มศิลปวิทยา	неедле артс	khem sinlapawitthaya
เข็มอัปสร	игла	kem uppasorn - a thai drama
เข่า	колена	knee
เข้าฉาย	прикажи	release date
เข้าชิงไนน์เอ็นเตอร์เทนอวอร์ดส	номинован за нине ентертаинмент авардс.	compete in entertaining world
เข้ารอบ	финалиста	made it to the next round, selected from the initial round
เข้าเฝ้า	имајте публику	visit (word for the king)
เคน	кен	ken
เคนยา	кенија	kenya
เคมีไฟฟ้า	електрохемија	electrochemistry
เคยสู้กับโกคุเทระ	користи се за борбу са гокудером	fought with gokudera
เครือข่าย	мрежа	network
เครื่องขัตติยราชอิสริยาภรณ์อันมีเกียรติคุณรุ่งเรืองยิ่งมหาจักรีบรมราชวงศ์	у спомен на велику част династије цхакри	something used in a thai ceremony - too obscure
เครื่องดีด	струм	thai string musical instruments
เครื่องตี	беат машина	musical intrument
เครื่องบิน	авион	airplane
เครื่องปั้นดินเผาและเซรามิค	керамика и керамика	pottery and ceramic
เครื่องยนต์	мотор	engine
เครื่องราชอิสริยาภรณ์	инсигниа	the king's accessories for ceremonies
เครื่องราชอิสริยาภรณ์อันเป็นที่เชิดชูยิ่งช้างเผือก	ознаке које слави бели слон	order of the white elephant
เครื่องราชอิสริยาภรณ์อันเป็นสิริยิ่งรามกีรติ	ознаке велике славе киратија	king's accessories
เครื่องราชอิสริยาภรณ์อันเป็นโบราณมงคลนพรัตนราชวราภรณ์	древне ознаке	the ancient and auspicious order of the nine gems
เครื่องสาย	гудачки инструменти	string instrument
เครื่องแต่งกาย	костим	clothes
เคลลี่	келли	kelly
เคอาร์วาย	крии	k.r.y
เค้ก	колач	cake
เงิน	новац	money
เงินทุน	финансирање	fund
เงินในบัญชีธนาคาร	новац на банковном рачуну	balance
เงี้ยว	мучан	shan tribe in northern part of thailand
เจ	ј	j.
เจนี่	јание	jenny
เจมินี่	близанци	gemini
เจริญ	расти	charoen
เจสเปอร์	јеспер	jasper
เจียะแจ	јае јае	nine emperor gods festival
เจี๊ยบ	пиле	jeab (thai name)
เจเน็ต	јанет	janet
เจ็ดเทพโจรสลัด	схицхибукаи	seven warlords of the sea
เจ็บ	чир	pain
เจ้าของจุกนม	власник брадавица	the owner of the baby's bottle
เจ้าจอม	учитељице	king's concubine
เจ้าฟ้ากรมพระยานริศรานุวัดติวงศ์	принц кром пхраиа нарисарану, храм тивонг	refer to a title of a royal family member - jao fa krom pra ya rissanuwattiwong
เจ้าฟ้ากรมพระยานริศรานุวัติวงศ์	принц кром пхраиа нарисара нуватвонг	prince narisara nuvativongse
เจ้าฟ้าจิตรเจริญ	принц јитцхароен	prince chitcharoen
เจ้าฟ้าภาณุรังษีสว่างวงศ์	принц пханурангсеесавангвонг	prince panuragui bright chestnut.
เจ้าฟ้ามหาวชิราลงกรณ	принц маха вајиралонгкорн	thailand's crown prince
เจ้าฟ้ามหาวชิรุณหิศ	принц махавајирунхит	crown prince maha vajirunhis
เจ้าฟ้ามหิดลอดุลยเดช	принц махидол адулиадеј	prince mahidol adulyadej
เจ้าฟ้ามหิดลอดุลเดช	принц махидол адулиадеј	a member of thai royalties
เจ้าฟ้าหญิง	принцезо	princes
เจ้าฟ้าอุบลรัตนราชกัญญา	принц убонраттанарајаканиа	princess ubon ratana graz's' contract.
เจ้าหนี้การค้า	износ обавеза	trade account payable
เจ้าเมือง	гувернере	mayor
เจ้าเมืองขุขันธ์	гувернер кхукхан	a name of the head of the state
เจ้าโลก	хегемонија	world conqueror
เฉพาะด้านตะวันออกเฉียงใต้เท่านั้นที่เป็นที่ราบลุ่มแม่น้ำโขง	само југоисточна страна је слив ријеке меконг.	only south-east area that is in mekhong plateau
เฉลิม	цхалерм	chalerm - a male's name
เฉลิมชัย	цхалермцхаи	chalermchai
เฉลิมชัยเจริญกิจ	цхалермцхаи цхароенкит	chalermchaichareonkij
เฉลิมพระเกียรติ	част	chaloem phra kiat
เฉลิมพล	цхалермпол	shalermpol - a surname
เฉลิมแสน	цхалермсаен	chaloemsaen
เฉลียว	перцептивни	chaleuw - a male's name
เชส	потера	(jp morgan) chase
เชอร์รี่	цхерри	cherry
เชา	цхов	chow -  a chinese name
เชาวน์	интелигенција	chow - a name
เชาวราษฎร์	цхаоварат	chowarat - the surname of a famous actress
เชิญยิ้ม	осмех	smile
เชิดชัย	победити	"name ""churd-chai"""
เชียงกลาง	цхианг кланг	chiang klang
เชียงของ	цхиангкхонг	chiang khong
เชียงดาว	цхианг дао	chiang dao
เชียงปุม	цхианг пум	chiang poom - area in thailand
เชียงยืน	цхианг иуен	chiang yuen
เชียงราย	цхианг раи	chiang rai
เชียงใหม่	цхианг маи	chiang mai
เชี่ยววงศ์กุล	цхиеввонгкун	chiaowongkul
เชื่อมต่อกับรถไฟฟ้ามหานคร	веза са мрт-ом	connect with skytrain
เชื่อมแม่น้ำท่าจีน	спојите реку тха цхин.	confluence to the ta jean river
เชื้อชาติ	трка	helping the country
เชื้อรา	гљива	fungus
เช็ค	проверавати	check
เช่นกัน	такође	as well
เช่นเดียวกัน	исто тако	similar to
เช้ามืดวันที่	зоре дана	in dawn of
เช้าวันรุ่งขึ้น	следећег јутра	next morning
เซกิ	секи	seki
เซน	зен	saint
เซนทอร์	центаур	centaur
เซบาสเตียน	себастиан	sebastian
เซฟ	сачувати	save
เซลล์	ћелија	cell
เซสติโม	сето	settimo
เซอร์	господине	sir
เซอร์วิส	услуга	service
เซอร์เบีย	србија	serbia
เซอวิวาสแตติน	цервивастин	cerivastatin - drug
เซโรกัชเชอร์	серо кутцхер	sero gusher - a type of weapon
เซโรนอส	серонос	zeronos
เซโรไลเนอร์	серолинер	seroliner
เซ็กส์	сек	sex
เซ็นทรัล	централ	central - department stores in thailand
เซ็นทารา	центара	centara
เซ็นเซอร์	сензор	sensor
เณร	неофит	samanera
เดคลิเนชัน	изјава	declination
เดชา	дацха	decha
เดธโน้ต	смрт	death note - a mysterious japanese cartoon
เดนกัชเชอร์	денкуцхер	den gusher - a weapon in japanese movies
เดนโอ	ден о	den-o
เดนโอเบลท์	денобелт	den-o belt
เดย์	дан	day
เดอะซิมส์	симс	the sims
เดอะฮาเดส	тхе хадес	the hades
เดอะฮาเดสแชปเตอร์	поглавље хада	the hades chapter
เดิม	стари	at first
เดิมชื่อ	раније	former name
เดิมที	оригинално	at first
เดิมเรียกว่า	раније познат као	formerly known as
เดียวกัน	исти	same
เดือดทะลุจุดศูนย์	врела кроз средину	zero point breakthrough
เดือนกุมภาพันธ์	фебруара	february
เดือนตุลาคม	октобар	october
เดือนตุลาคมมีฝนตกชุกที่สุด	октобар је најкишнији.	highest amount of rainfall in october
เดือนธันวาคม	децембар	december
เดือนมกราคม	јануара	january
เดือนมิถุนายน	јуна	june
เดือนอ้าย	лунарни месец	first lunar month
เด็กหญิงอายุ	стара девојка	the girl's age
เด็กและเยาวชน	деца и омладина	children and youth
เต่า	корњача	tao (first name)
เต๋อ	до	ter
เถรวาท	доктрина	buddha's teaching
เทคนิคอิลลูชั่น	илузијска техника	technique illusion
เทควันโด้	таеквондо	tai kwon do
เทคโนโลยี	технологија	technology
เทคโนโลยีสารสนเทศ	информациона технологија	san son tej techonology
เทนนิส	тенис	tennis
เทนโจอิน	тењо-ин	tenjoin - a character in a japanese story
เทพพิทักษ์	тхеппитак	theppitak
เทพมรณะ	смрт	bleach
เทพหัสดิน	бог неба	tephussadin (a surname)
เทพอานูบิส	анубис	anubis
เทพอาเตน	атхен	aten
เทพีเธมิส	богиња	themis
เทริโอ	тхерио	terio - surname of a singer
เทวดา	анђео	angel
เทวรูป	идол	graven image
เทศบาล	општина	municipality
เทศบาลนครขอนแก่น	општина кхон каен	khon khan public works
เทศบาลนครนครราชสีมา	накхон ратчасима	nakorn rachasrima province public work
เทศบาลนครนครศรีธรรมราช	накхон си тхаммарат	nakorn sri thamarat city public works
เทศบาลนครเชียงราย	цхианг раи	chiang rai province public works
เทศบาลนครเชียงใหม่	општина чијанг мај	chiang mai municipality
เทศบาลเมืองชัยภูมิ	општина цхаииапхум	mueang chaiyaphum
เทศบาลเมืองบุรีรัมย์	бурирам	bureerum public works
เทศบาลเมืองมหาสารคาม	општина маха саракхам	thesaban mueang maha sarakham
เทศบาลเมืองมุกดาหาร	општина мукдахан	mookdahan public works
เทศบาลเมืองสกลนคร	општина сакон накхон	municipality of sakonnakon
เทศบาลเมืองหนองคาย	општина нонг кхаи	nong khai municipality
เทศบาลเมืองหนองบัวลำภู	општина нонг буа лампху	nong bua lam phu town municipality
เทศวิศาล	експанзиван	tasavisakal - a surname
เทิดศักดิ์	част	therdsak
เทียนทอง	златне свеће	tientong - a male's name
เทียนเงิน	сребрна свећа	tienngern
เทียนโพธิ์สุวรรณ	тхиан пхо суван	tianphosuwan (thai last name)
เทเบิลเทนนิส	стони тенис	table tennis
เทโรศาสน	теро сасана	terosat football club
เท็ดดี้	тедди	teddy
เท็นเท็น	десет десет	tin-tin
เท่ง	тенг	teng (first name)
เท่านั้น	само	only
เธคุนุ	подршка	dhekunu
เธรซ	тракија	thrace - an area in greece
เธอกับฉัน	ти и ја	you and i
เธอจะอยู่กับฉันตลอดไป	остаћеш са мном заувек	you will be with me forever
เธอยัง	ви и даље	tur yung
เธอเป็นเพื่อนอาบาราอิ	она је пријатељица абараи.	she is a friend of arbarae
เนกิ	неги	negi
เนย	путер	butter
เนรมิต	изумети	casting a spell
เนะ	јел тако	ney
เนื่องจาก	од	because
เนื่องจากประเทศเหล่านั้นอยู่ในตำแหน่งบนโลกที่ต่างไปจากประเทศไทย	јер се налазе на положају на земљи који је различит од тајланда	because those countries are in the group of...
เนื้อที่	област	area
เนื้อที่ประมาณ	приближна површина	approximate area
เนื้อร้อง	текст	lyrics
เนื้อเรื่องย่อ	резиме	summary
เนเธอร์แลนด์	холандија	netherlands
เนโกะ	неко	neko
เน็น	нен	nen
เบจิต้า	бецхита	vegeta
เบธเลเฮม	бетлехем	bethleham
เบนจามิน	бењамин	benjamin
เบรกมา	пауза	bregma
เบริธ	беритх	berith
เบลเฟกอล	беллегал	belphegor- a demon in a legend
เบส	басс	bass
เบอร์ลิน	берлин	berlin
เบา	светлост	soft (voice)
เบาท์	баут	(dieric) bouts
เบาหวาน	дијабетес	diabetes
เบื่ออาหาร	досадно је храни	not appetite, eating disorder.
เบื้องหลัง	позадина	behind the sence
เบโทเฟิน	беетховен	beethoven
เบ็นเท็น	бен 10	ben 10
เปรม	задовољан	pream
เปรี้ยว	кисело	sour
เปรู	перу	peru
เปลวไฟ	пламен	flame
เปลี่ยนชื่อเป็น	преименована у	changed the name to
เปลื้อง	одузети	nude
เปล่งพานิช	пленгпаницх	plengpanich
เปอร์เซีย	перзија	persia
เปอร์โตริโก้	порторико	puerto rico
เปิดสอนระดับปริญญาตรี	отворено за додипломски студиј	offer bachelor degree curriculum
เปียงยาง	пјонгјанг	piang yang - in north korea
เปียโตร	пиетро	pietro
เปียโน	клавир	piano
เปโซ	песо	peso
เป็ด	патка	duck
เป็น	су	is
เป็นขนมของชาวไทยมุสลิม	десерт је тајландских муслимана	is a thai-muslim dessert
เป็นครั้งแรก	први пут	first
เป็นงานเขียนในชุด	да ли је дело написано у сету	in the edition of...
เป็นต่อ	против	pen to
เป็นต้น	итд.	for example
เป็นต้นมา	од	onward
เป็นต้นไม้ประจำมหาวิทยาลัย	је дрво универзитета	tree of university
เป็นบัวในสกุล	је лотос у роду	is a lotus in the family
เป็นประธาน	постаните председник	principal of
เป็นปลาตู้สวยงาม	лепа је акваријумска риба	is an ornamental fish
เป็นพระราชโอรสพระองค์เดียวในพระบาทสมเด็จพระปรมินทรมหาภูมิพลอดุลยเดช	једини је син краља бумумибола адулиадеја	is the only son of
เป็นพ่อของ	је ли отац	is the father of
เป็นวิญญาณเทียมเพศชาย	мушки је вештачки дух	the spirit who is a male
เป็นสีประจำ	регуларна боја	official color
เป็นหนึ่งใน	је један од	is one of
เป็นหัวหน้าพรรค	вођа странке	party leader
เป็นอดีตหัวหน้าหน่วยที่	бивши је вођа јединице	is the former leader of the unit
เป็นอาวุธ	као оружје	as a weapon
เป็นเครื่องหมายแสดงว่า	то је знак	indicates that
เป็นเจ้าเมืองปกครอง	гувернере	governor
เป็นเมืองหลวง	је главни град	capital
เป็นเวลา	за	utilized time
เป็นโฮโมโลกัสกับ	да ли је хомолог са	homologous
เป๊ปซี่	пепси	pepsi
เพกาซัส	пегасус	pegasus
เพชร	дијамант	diamond
เพชรบุรี	пхетцхабури	petchaburi province
เพชรบูรณ์	пхетцхабун	prechabun
เพชรพระอุมา	диамонд пхра ума	ancient diamond
เพชรา	старац	petchara - name of a famous actress
เพชรเกษม	петцхкасем	petchakasem area in bangkok
เพดานอ่อน	мекани плафон	gill
เพทาย	циркон	zircon
เพพซิน	пепсин	pepsin
เพราะ	јер	because
เพราะว่า	јер	because
เพรียะ	пирииа	preah - cambodia
เพลงประกอบภาพยนตร์	филмска музика	soundtrack
เพลงประจำจังหวัด	покрајинска песма	province anthem
เพลงประจำมหาวิทยาลัย	универзитетске песме	university song
เพลงปิดเรื่อง	цовер сонг	pid reung song
เพลงพระราชนิพนธ์	роиал мусиц	the king's song
เพลงลูกทุ่ง	кантри музика	folk song
เพลงลูกทุ่งขับร้อง	кантри музика	luk thung song
เพลงอีแซว	мусиц теасе	a type of thai country music
เพลงเปิด	отварање песме	opening song
เพลงเปิดเรื่อง	отварање песме	opening song
เพลย์สเตชัน	плаистатион	playstation
เพลโต	платон	plato
เพศ	секс	sex
เพศชาย	мушки пол	male
เพิ่มมา	више	addition
เพียงพอ	довољно	enough
เพื่อ	за	for
เพื่อเป็นการเผยแผ่พระพุทธศาสนาและประชาสัมพันธ์กิจกรรมทางพระพุทธศาสนาต่าง	у циљу пропагирања будизма и промовисања верских активности	passing knowledge about buddhism
เพื่อใช้ร่วมกับตัวชี้วัดอื่น	да се користи са другим индикаторима	to be used with other indicators
เพ็ชรทาย	пхеттха	petchtai
เฟนิรามีน	фенирамин	pheniramine
เฟย์	фаи	fay
เฟรดริก	фредерицк	fredrick
เฟส	фаза	phase
เฟอร์นิเจอร์	намештај	furniture
เฟื่องอารมย์	фоударом	fueangarom
เภสัชกร	фармацеут	pharmacist
เภสัชจลนศาสตร์	фармакокинетика	pharmacokinetics
เม	може	may
เมกา	мега	mega
เมฆ	облак	clouds
เมฆออร์ต	оорт цлоуд	ash cloud in the space
เมจิ	меији	maji - a nickname
เมตร	м.	metre
เมทริกซ์	матрица	matrix
เมทะนี	метани	metanee - the surname of a famous actor
เมอร์คิวรี	меркур	mercury
เมือง	град	town
เมืองทองฯ	муанг тхонг	muangthong
เมืองนครราชสีมา	накхон ратчасима	nakornrachasrima city
เมืองปทุมธานี	патхум тхани	mueang pathum thani
เมืองปราจีนบุรี	працхинбури	prajinburi city
เมืองพิจิตร	пхицхит	pijit city
เมืองพิษณุโลก	пхитсанулок	phitsanulok
เมืองยอง	стаг цити	mueng-yor
เมืองลำพูน	лампхун	lumpoon province
เมืองสกลนคร	сакон накхон	sakon nakhon
เมืองสิงห์	сингха	muangsing
เมืองสุรินทร์	сурин	surin city
เมืองหลวง	главни град	capital city
เมืองหลวงของอาณาจักรเขมร	главни град царства	capital of cambudia
เมืองเคมบริดจ์	цамбридге цити	city of cambridge
เมืองเอก	аке цити	mueang-ake
เมืองโคราช	корат	muang korat
เมืองใหญ่	велики град	city
เมืองใหญ่ในเขตนี้	велики градови у овом округу	capital presently
เมื่อประมาณ	када	estimate
เมื่อปีพศ	прошле године	in buddhist era
เมื่อปีพุทธศักราช	у години будистичке ере	in b.e.
เมื่อวันจันทร์	у понедељак	on monday
เมื่อเดือนกันยายน	прошлог септембра	in september
เมื่อเดือนมีนาคม	у марту	in march
เม็ดขนุน	јацкфруит	metkhanun
เม่น	бодљикаво прасе	porcupine
เย	да	yay - a sound
เยลโล่	жута	yellow
เยอรมนี	немачка	germany
เยอรมัน	немачки	german
เยาวชน	омладина	youth
เยาวชนอายุ	омладинско доба	youth age of ...
เยาวราช	цхинатовн	yaowaraj
เยื่อหุ้มสมอง	цортек	meninges
เรซูเม	резиме	resume
เรด	црвено	red
เรดวัน	црвени дан	redone
เรย์	зрак	ray
เรวดี	добре вести	rawadee
เราเตอร์	роутер	router
เริ่มการผลิตนำเข้า	покрените увозну производњу	importing
เริ่มก่อสร้าง	започните изградњу	began constuction
เริ่มจากเดือนพฤศจิกายนเมษายน	од новембра до априла	begins from november to april
เริ่มตั้งแต่อาณาจักรอยุธยาได้โจมตีอาณาจักรเขมร	почевши од аиуттхаиа краљевства које напада кмеричко краљевство.	ever since the ayudhya (military) assault...
เรียกกันว่า	зове се	called
เรียกว่า	зове се	call
เรียล	прави	real
เรียว	витко	ryo
เรียวทาโร่	риотаро	totoro - a japanese cartoon
เรียวเฮ	рие хие	reohay - a japanese character
เรียะชอาณาจักร	краљевство	reacheanachak
เรืองรุ่ง	ужарен	rueangrung
เรืองศรี	руеангсри	rueng sri - a surname
เรือตรี	брод	ensign
เรือนนาค	нага хоусе	nak castle
เรือยกพลขึ้นบก	слети брод	boat for advance the army
เรือสำรวจ	анкетни брод	survey vessel
เรือเร็วโจมตี	брзи напад чамцем	fast attack craft
เรือใบ	једрилица	sailboat
เรื่อง	предмет	story
เรื่องย่อ	резиме	synopsis
เรื่องสั้น	приповетка	short story
เร้กเก้	реггае	reggae
เลข	број	mathematics
เลขที่	број	number
เลขาธิการสหประชาชาติ	генерални секретар уједињених нација	united nations secretary-general
เลนส์	сочива	lens
เลออน	леон	lyon
เลิฟ	љубав	love
เลือดออกตามไรฟัน	чврстоћа	bleeding of the gum
เลโอ	лео	alo
เลโอนาร์โด	леонардо	leonardo
เล็ก	мала	small
เล่ม	књига	book
เล่มที่	број књиге	volume
เวทีทอง	златна позорница	golden podium
เวล	ваил	vail
เวลาประมาณ	процењено време	approximate time
เวสต์	запад	west
เวอร์ชัน	верзија	version
เวอร์โก้	верго	virgo
เวิร์คพอยท์	воркпоинт	workpoint company
เวิร์คพอยท์สตูดิโอ	воркпоинт студио	workpoint studio
เวิร์ม	црви	worm
เวิลด์	свет	world
เวียงสระ	вианг са	wiang sa
เวียงสา	вианг са	wiang sa
เวียนเทียนรอบอุโบสถหรือสถูปเจดีย์พุทธสถานต่าง	кружење око капеле или пагоде	a thai religious ceremony
เวโรนา	верона	verona in italy
เว็บ	веб	web
เว็บสเตอร์	вебстер	webster
เว็บเบราว์เซอร์	интернет претраживач	web browser
เว็บไซต์ของเกมส์	веб локација за игре	gaming website
เว็บไซต์ซีไอเอ	веб страница циа	cia website
เว้นวรรค	свемир	space
เศรษฐกิจพอเพียง	економија довољности	sufficiency economy
เศรษฐบุตร	сетхапутра	settabut - the family that started bus system in thailand
เศรษฐศาสตร์จุลภาค	микроекономија	microeconomics
เศรษฐศาสตร์มหภาค	макроекономија	macroeconomics
เสงี่ยม	начин	sa-ngiam
เสชนะ	победити	sechana
เสด็จพระราชสมภพ	краљевско рођење	royal birth
เสนอชื่อเข้าชิงและรับรางวัล	номиновање и примање награде.	nominate and win
เสนา	сена	sena
เสนาเมือง	сена цити	senamuang
เสนีวงศ์	сени вонг	seniwong
เสน่ห์	шарм	sanea
เสมอ	увек	always
เสรี	бесплатно	seri
เสรีภาพ	слобода	freedom
เสียง	звук	sound
เสียงเปิด	отворени звук	approximant, semi-vowel
เสียงเสียดแทรก	фрицативни звук	noise
เสือจากัวร์	јагуар	jaquar
เสื้อครุย	хаљина	gown
เส้นทแยงมุม	дијагонално	diagonal
เส้นพุ่ง	линија	yarn that is used for weaving
เส้นโค้ง	крива	curve
เส้นใย	влакно	polymer, yarn
เหงื่อ	зној	sweat
เหตุการณ์	догађај	situation
เหตุการณ์สำคัญ	важан догађај	important event
เหรียญ	медаља	coin
เหรียญกษาปณ์	нана	coin
เหรียญทอง	златна медаља	gold medal
เหรียญรัตนาภรณ์	раттанапорн цоин	a special thai medallion
เหลือง	жута	yellow
เหลือสมาชิก	преостали чланови	members left
เหล็ก	челика	iron
เหล่านี้	ове	these
เหล่าสุนทร	лаосонтхорн	soontorn group
เห็นภาพลวงตา	види илузију	seeing hallucination
เอก	први	the first tonal marker of thai writing system represented by  '
เอกชน	приватно	private
เอกซ์	икс	x
เอกราช	независност	sovereignty
เอกวาดอร์	еквадор	edwardor
เอกสิทธิ์	привилегија	privilege
เอจิเซ็น	ецхизен	echizen
เอชไอวี	хив	hiv, human immunodevficiency virus
เอซ	асови	letter h
เอตาสีติ	атацати	sesasiti
เอนจิเนียริ่ง	инжењеринг	engineering
เอนไซม์	ензим	enzyme
เอบีซี	абц	abc
เอม	циљ	aim - could be a nickname
เอริค	ериц	eric
เอล	ел	el
เอสปาด้า	еспада	eapada
เอสปาด้าตกชั้น	еспада је испао	aspata
เอสเอ็ม	см	sm entertainment from korea
เอสโตเนีย	естонија	astonia - a country
เออร์โกสเฟียร์	ергосфера	ergosphere
เอี่ยมยิ่ง	ја сам	super, awesome
เอี่ยมสุข	срећан сам	iamsuk
เอื้อย	ури	eay - a thai nickname
เอเชีย	азија	asia
เอเชียตะวันตกเฉียงใต้	југозападна азија	southwest asia
เอเชียเหนือ	северна азија	north asia
เอเชียแปซิฟิก	азија пацифична	asia-pacific
เอเชียใต้	јужна азија	south asia
เอเธนส์	атина	athens
เอเอฟซี	афц	afc
เอเอฟซีแชมเปียนส์ลีก	афц леагуе цхампионс	afc championship
เอ็กซ์โป	екпо	expo
เอ็กโทเดิร์ม	ецтерм	ectoderm, top level of skin layer.
เอ็กโปรพลาซ่า	екпо плаза	expo plaza in thailand
เอ็ดดูเทนเมนท์	образовање	edutainment
เอ็ดเวิร์ด	едвард	edward
เอ็น	лигамент	n
เอ็นบีเอ	нба	nba - national basketball association
เอ็นเตอร์เทนเม้นท์	забава	entertainment
เอ็นเทอร์เทนเมนท์	забава	entertainemnt
เอ็มม่า	емма	emma
เอ๋	ех	ah - a nick name
เฮติ	хаити	haiti
เฮลมุต	хелмут	helmut
เฮสเตีย	хестиа	hestia
เฮอร์เชล	херсцхел	herschel
เฮาส์	кућа	house
เฮียวงะ	хиуга	heonga
แกง	цурри	soup
แกมเบีย	гамбија	cambia
แกรนซ์	одобрити	grantz
แกรมมี่	греми	grammy
แกริซั่น	гаррисон	garrison - an english name
แกลง	клаенг	glang
แกลเลอรี	галерија	gallery
แกสโทรโพดา	гастропода	"name ""gastropoda"""
แกะ	овце	sheep
แกแล็คซี่	галаксија	galaxy
แก่	до	aging
แก้ว	стакло	glass
แก้วทอง	златно стакло	golden cup
แก้วบัวสาย	стакло лотоса	kaeobuasai
แก๊สธรรมชาติ	природни гас	natural gas
แขก	гост	indian
แขน	рука	arm
แขวงจำปาสัก	цхампасак провинце	champasak province
แขวงหลวงพระบาง	подручна област луанг прабанг	luang pra bang province
แคดเมียม	кадмијум	cadnium
แคทแพท	мачка пат	kat - pat kamikaze - the thai famous stars
แคน	цаен	kan - a type of thai music
แคนดี้	цанди	candy
แคนเซอร์	моћи	cancer
แคม	веб камере	cam
แคมป์เบลล์	цампбелл	campbell
แคมเปญ	кампања	campagne
แคมเล็ก	мала камера	vagina fold
แคมใหญ่	велика камера	labia
แคร็กเกอร์	орашчић	crackers
แคลคูลัสเชิงปริพันธ์	интегрално рачунање	integral calculas
แคลคูลัสเชิงอนุพันธ์	диференцијално рачунање	differential calculus
แคลอรี	калорије	calorie
แคลิฟอร์เนีย	цалифорниа	california
แคลิฟอร์เนียม	цалифорниа	californium
แคว้น	регион	kwon - a korean surname
แจ	џем	live purely and clean both in body and mind - from chinese belief
แจ็กสัน	јацксон	jackson
แจ็ค	јацк	jack
แจ๊ค	јацк	jack
แจ๊ส	јазз	jazz
แด	дае	dae
แดงทั้งแผ่นดิน	читава земља црвена	red (political party all over the country
แดนสุพรรณ	супхан	dansuphan
แดเนียล	данијеле	daniel
แตน	стршљен	grass hopper
แต่งงาน	удати се	wedding, marriage
แต่งตั้ง	именовати	giving a new title to
แต่งโดย	састављен од	composed by
แต่ใน	али у	but in
แต่ในปัจจุบัน	али сада	in the present
แต่ไม่ประสบความสำเร็จ	али без успеха	failed
แต่ไม่สำเร็จ	али безуспешно	no success
แถบ	бар	flat fish
แทซิทัส	таситус	tacitus
แทน	заступати	instead
แทนเจนต์	тангента	tangent
แทยอน	таеиеон	tae yon
แทลเลียม	талијум	thallium
แท็กซี่	такси	taxi
แท็บเล็ต	таблет	tablet computer
แนท	нат	nat
แนวความคิดที่	концепт	idea number...
แนวพระราชดำริ	краљевска иницијатива	royal initiative
แนสแด็ก	насдак	nasdaq
แบคทีเรีย	бактерије	bacteria
แบงค์	банка	bank
แบทเทิลบรอลเลอร์	баттле танкер	battle brawlers
แบรนด์แอมบาสเดอร์	бренд амбасадор	brand ambassador
แบ่งประเทศไทยออกเป็น	поделите тајланд на	dividing thailand into 6 areas
แบ่งออกเป็น	подељени у	divided into...
แบ่งออกได้เป็น	подељени у	divided into
แบ่งได้เป็น	може се поделити на	divided into
แป้ง	брашно	pang
แผนที่	мапа	map
แผนไพรีพินาศ	план конзорцијума	pan pirepinat - a plan to destroy the mobs
แผลศักดิ์สิทธิ์	света рана	stigmata
แผลไหม้	бурнс	burn
แพทย์	љекар	physician
แพน	пан	pan
แพร่	ширење	the state of praa
แพลทฟอร์ม	платформа	platform
แพะ	јарац	goat
แพ้	изгубити	to lose
แฟชั่น	мода	fashion
แฟนเก่า	бивша девојка	ex boyfriend/girlfriend
แฟมิลีที่ไปพักผ่อนที่เกาะมาเฟีย	породица се одмара на острву мафије	family that went to mafia island for vacation
แฟรงค์	искрен	frank
แฟรี่	фаири	fairy
แฟรี่เทล	бајка	fairy tale
แมกนีเซียม	магнезијум	magnesium
แมคอินทอช	мацинтосх	mcintosh
แมนดาริน	мандарина	mandarin
แมนเชสเตอร์	манцхестер	manchester
แมว	мачка	cat
แมวป่า	вилдцат	jungle cat
แมวลายหินอ่อน	мермер табби	pardofelis marmorata
แมวไทย	тајландска мачка	thai cat
แม็คโคร	макро	macro
แม่	мајке	mother
แม่จริม	мотхер јим	mae charim
แม่ชี	нунс	nun
แม่นาคพระโขนง	мае нак пхра кханонг	mae nak phra khanong
แม่น้ำ	река	river
แม่น้ำชี	цхи ривер	chee river
แม่น้ำทะเลสาบสำคัญ	важна ријека језера	important rivers and lakes
แม่น้ำปิง	пинг ривер	ping rover
แม่น้ำโขง	река меконг	kong river from laos
แม่ริม	мае рим	amphoe mae rim
แยกจากคลองชักพระฝั่งซ้าย	одвојите од канала цхак пхра на левој страни	forks from khlong chak phra
แยกจากคลองบางกอกน้อยฝั่งซ้าย	са канала бангкок нои с леве стране	forks from the left branch of khlong bangkok noi
แยกจากคลองบางกอกใหญ่ฝั่งขวา	спој са бангкок иаи каналом с десне стране	split from the bankok yai canal to the right
แยกจากคลองบางกอกใหญ่ฝั่งซ้าย	спој са бангкок иаи каналом са леве стране	forked from khlong bangkok yai
แย้มนาม	име	yamnam - a surname
แย้มบุญเรือง	одлуку за заслуге	yaembunrueang
แรงโน้มถ่วง	гравитација	gravity
แร็ปเปอร์	репер	rapper
แลกเปลี่ยนโดยถือ	размена помоћу задржавања	exchange, conversion
แลมบ์ดา	ламбда	lampda
และ	и	and
และกลายเป็นอู่ข้าวอู่น้ำที่มีชื่อเสียงของไทย	и постао је познати крух на тајланду	and becoming the futile land
และกัมพูชา	и камбоџа	and cambodia
และครอบครัว	и породица	and family
และคำว่า	и реч	"and the word ""......."""
และจังหวัดใกล้เคียง	и оближње провинције	and nearby state
และดุษฎีบัณฑิต	и доктор филозофије	honorary degree
และตามสภาพเศรษฐกิจและสังคม	и према економским и социјалним условима	and following the economy and social conditions
และตำแหน่ง	и положај	and position
และที่สำคัญคือ	а важно је	and important thing is...
และธงของต่างประเทศ	и стране заставе	and other countries' flags
และปัจจุบัน	и садашњост	now
และพรรคฟุนซินเปค	и фунцхинпец забава	funcinpec
และรถไฟ	и тренирај	and railways
และรัสเซีย	и русија	and russia
และสหรัฐอเมริกา	и сједињене државе	in america
และสังคม	и друштво	and society
และสังคมศาสตร์	и друштвене науке	and social science
และสัตว์	и животиње	and animal
และสโรชา	и сароцха	and sarocha - a male's name
และหลังจากสงครามภายใน	и после унутрашњег рата	after inside war
และออกซิเจน	и кисеоник	and oxygen
และอำเภอกันทรารมย์	и округ кантхараром	and kanthararom district
และอื่น	и други	etc.
และอเมริกาเหนือ	и северна америка	and north america
และเปียโน	и клавир	and piano
และเป็น	и	is also
และเป็นสมาชิกราชวงศ์	члан је краљевске породице	in monarchs family
และเมืองเก่า	и стари град	old city
และเมื่อวันที่	и на	when date
และเรียกว่า	и позвао	and call
และโลก	и свет	and earth
และในปี	и у години	and in the year
และได้ปรากฏตัวตอนภาค	и појавили су се у епизоди	appeared
แล้วเดินเวียนรอบปูชนียสถาน	затим је обишао светиште	walk with lighted candles in hand around a temple
แวน	ван	wan
แสงจันทร์	месечина	saengchan
แสงชูโต	цхуто	sangchuto - a surname
แสงทอง	сангтхонг	golden sun ray
แสงสิงแก้ว	санг сингкаев	sangsingkaew
แสงเทียน	свећа	saengthian
แสตมป์	печат	stamp
แสนรัก	љубав	saenrak
แสนโภศิก	саен пхосик	sankosuk - a surname
แหลมสิงห์	лаем синг	lam sing - a famous country singer in thailand
แหล่งท่องเที่ยว	туристичка атракција	tourist attraction
แหล่งโบราณคดีบ้านเชียง	археолошко налазиште бан цхианг	ban chiang archaeological site
แหวน	прстен	ring
แหวนธรรมดา	обичан прстен	ordinary ring
แหวนมาเล่ริง	прстен мужјака	ring (faux jewelry)
แห่งบันนัม	бан нам	of bannam
แห่งสหประชาชาติ	уједињене нације	of united nations
แองกวิลลา	ангуилла	anguilla
แองเจิ้ล	ангел	angel
แอซิด	киселина	acid
แอด	додати	add
แอนดรอยด์	андроид	android
แอนดี้	анди	andy
แอนด์	и	and
แอนิเมชัน	анимација	animation
แอนเนลิดา	аннелида	annelida phylum
แอนโทนี	антхони	anthony
แอฟริกา	африка	africa
แอฟริกาใต้	јужна африка	south africa
แอมะซอน	амазон	amazon
แอมเวย์	амваи	amway
แอร์ไลน์	авио-компаније	airlines
แอล	л	letter 'l'
แอลจีเรีย	алжир	algeria
แอสกี	асци	ascii
แอสซิสต์	ассист	assist
แอสปาร์แตม	аспартам	aspartame
แฮช	хасх	hash
แฮปปี้	срецан	happy
แฮปปี้และชาร์ล	срецан и цхарлес	happy and charles
แฮ็ค	хакирање	hack
โกบอล	глобал	cobalt
โกร	расти	guro
โกรกพระ	цревице	krok-phra
โกลด์	злато	gold
โกวิท	ковит	kowit
โกโก้	какао	cocoa
โขน	пантомима	khon
โคกสำโรง	кхок самронг	koksamrong
โคนัน	цонан	conan
โคฟี	кофи	kofe annan
โครงการ	пројекат	project
โครงการก่อสร้าง	грађевински пројекат	project
โครงการนานาชาติ	међународни пројекат	international program
โครงการศิลปินแห่งชาติ	пројекат националног уметника	national artist campaign
โครงการเรียนภาษาอังกฤษแบบเข้ม	интензивни програм учења енглеског језика	intensive english program
โครงสร้างภายใน	унутрашња структура	internal structure
โคราช	корат	khorat or nakorn rajjasrima state
โครโมโซม	хромозом	chromosome
โคล	цоле	cold
โคลอมเบีย	колумбија	colombia
โคล้ด	код	claude
โคเคน	кокаин	cocain
โคเบะ	кобе	kobe
โคแทนเจนต์	котангенс	cotangent
โคโทเน่ที่	котоне ат	kotone
โฆษะ	вокализација	kosa
โฆษิตพิพัฒน์	косит пхипхат	the surname kopitpipat
โจจิ	јоји	choji
โจเซฟ	јосепх	joseph
โจโจ้	јојо	jojo
โช	цхо	sho
โชคดี	срећно	lucky
โชว์	прикажи	show
โชอิจิ	схоицхи	shoichi
โชแปง	цхопин	chopin
โซน	зона	zone
โซนยอชิแด	женска генерација	senyosede - a japanese name
โซนี่	сони	sony company
โซล	сеул	seoul
โซลดิ๊ก	солдицк	sol-dig
โซลโซไซตี้	духовна заједница	soul society
โซเดียม	натријума	sodium
โซเฟีย	софиа	sofia
โดจินชิ	до јинцхи	dōjinshi
โดย	од стране	by
โดยคำว่า	уз реч	by the word
โดยตรง	директно	directly
โดยทรงพระกรุณาโปรดเกล้าฯ	њежно величанство	the king's order
โดยที่	где	by
โดยบ่งบอกถึงปริมาณและคุณภาพของสิ่งตีพิมพ์อิเล็กทรอนิกส์ของสถาบัน	навођењем количине и квалитета електронских публикација установе	stating the limitation and quality of a product
โดยปกติ	нормално	regular, common, normalcy
โดยปกติตามวัดต่าง	обично према различитим храмовима	normally, at the various temples...
โดยปกติแล้ว	нормално	usually
โดยมี	са	make available
โดยมีตัวอย่างบทพากย์ฉบัง	са примерима песама	background movie in music video
โดยมีพระภิกษุสงฆ์นำเวียนเทียน	са монахом који води поворку свећа	buddhist monks performing ceremony for vientien buddhist religious holiday
โดยราชบัณฑิตยสถาน	краљевским институтом	by royal institute
โดยสรุป	укратко	in summary.
โดยเจ้าฟ้าธรรมธิเบศรไชยเชษฐสุริยวงศ์	принц тхаматхибет сорнцхаи цхетцхурииавонг	the name of a king
โดยใช้ชื่อว่า	поименце	using name
โดยใช้ทางหลวงแผ่นดินหมายเลข	националним аутопутем	using freeway #________
โดยในวันที่	до	on the date of ___
โดราเอมอนฉบับภาพยนตร์	дораемон мовие едитион	doraemon movie
โดเมกิ	домоме	domagi - a japanese word.
โดเมน	домен	domain
โต	одрастао	big
โตชิบา	тосхиба	toshiba
โทน	тоне	tone
โทนะหงษา	тонахахаса	tonahongsa - a surname
โทนี่	тони	tony
โทบรามัยซิน	тобамаицин	tobramycin
โทมัส	тхомас	thomas
โทรจัน	тројан	trojan
โทรลล์	тролл	troll
โทริคาบูโตะ	торикабуто	torikabuto - a japanese word
โทรโข่ง	мегафон	a megaphone, portable sound directing equipment.
โน	не	no
โนบิตะ	нобита	nobita
โนบิตะและอัศวินแดนวิหค	нобита и витез	nobita and the winged braves
โนรา	нора	nora
โนะ	дино	noh - a japanese word
โนเบล	нобел	nobel prize
โบตั๋นกลีบสุดท้าย	последњи божур	botun kleep suttai - a novel
โบราณสถาน	археолошко налазиште	the ancient place
โบอิง	боеинг	boeing company
โบฮีเมีย	бохемиа	bohemia
โบแดง	диван	bodin
โปงลางสะออน	понгланг са-он	pong langsaoun
โปรดเกล้า	молимо вас	the king's order
โปรตอน	протон	proton
โปรตีน	беланчевина	protein
โปรเจกต์	пројекат	project
โปรเจกต์พิเศษ	специјални пројекат	special project
โปรแกรมคอมพิวเตอร์	компјутерски програм	computer programming
โปรโมชั่น	промоција	promotion
โปเกมอน	покемон	pokemon, a very popular japanese anime.
โป๊	нуде	nude
โพธิ์ศรี	пхосри	phosi
โพนพิสัย	пхон пхисаи	phonphisai
โพรทิสต์	протист	protist
โพแทสเซียม	калијума	potassium
โฟลต	пловак	float
โฟลเอ็ม	фло м	phloem
โฟโตสเฟียร์	фотосфере	photosphere
โมซาร์ท	мозарт	mozart
โมบิลสูทกันดั้ม	мобиле суит гундам	mobile suit gundam
โมรา	калцедон	agate
โมร็อกโก	марокански	morocco
โมลิบดีนัม	молибден	molybdenum
โมฮัมหมัด	мохаммад	mohamad
โมเดิร์น	модеран	modern
โมเต็ต	мотате	motet (sound)
โมเลกุล	молекуле	molecule
โมโคนะ	мокона	mokona - a japanese word
โมโนไซต์	моно сајт	mono site.
โยชิโนะ	иосхино	yoshino
โยฮันน์	јоханн	johann
โยเซฟ	јосепх	joseph
โรค	болест	disease
โรคประจำตัว	конгенитална болест	personal illness
โรคปอดบวม	упала плућа	pneumonia
โรคออทิซึม	аутизам	autism
โรคุโด	рокудо	rokudo
โรคเกาต์	гихта	gout
โรคไต	обољење бубрега	kidney disease
โรงพยาบาลกรุงเทพ	болница бангкок	krung thep hospital
โรงพยาบาลจุฬาลงกรณ์	меморијална болница краља цхулалонгкорна	king chulalongkorn memorial hospital
โรงพยาบาลรามาธิบดี	болница раматхибоди	ramathibodi hospital
โรงพยาบาลอานันทมหิดล	болница анандамахидол	ananthamahidol hospital
โรงพยาบาลอุตรดิตถ์	болница уттарадит	uttaradit hospital
โรงละคร	позориште	theater
โรงเรียนการบิน	летна школа	aviation school
โรงเรียนดาราวิทยาลัย	дара цоллеге	dara academy
โรงเรียนนนทรีวิทยา	школа нонси виттхаиа	nontrivittaya school
โรงเรียนนายเรือ	морнаричка академија	royal thai naval academy
โรงเรียนนายเรืออากาศ	роиал тхаи аир форце ацадеми	royal thai air force academy
โรงเรียนบดินทรเดชา	бодиндецха сцхоол	bodindecha school
โรงเรียนประชานิเวศน์	працханивет сцхоол	prachanivet school
โรงเรียนปรินส์รอยแยลส์วิทยาลัย	принце роиал&#39;с цоллеге	the prince royal's college
โรงเรียนพระตำหนักสวนกุหลาบ	школа суан куларб тамнак	the school in the king's compound.  it is reserved for the princess and the royal family
โรงเรียนมัธยมสาธิตวัดพระศรีมหาธาตุ	демонстрација ват пхра си махатхата у средњој школи	wat phrasri mahadhat secondary demonstration school
โรงเรียนมารีวิทย์	мари вит сцхоол	maryvit school
โรงเรียนยุพราชวิทยาลัย	иуппарат виттаиалаи сцхоол	yupparaj wittayalai school
โรงเรียนราชินีบน	уппер куеен сцхоол	rachinibon school in thailand
โรงเรียนวัฒโนทัยพายัพ	ваттханотхаи паиап школа	vattanotaipayup school
โรงเรียนศึกษานารี	нарее сцхоол оф едуцатион	suksanari school
โรงเรียนสาธิต	демонстрациона школа	demonstration school
โรงเรียนสาธิตแห่งมหาวิทยาลัยเกษตรศาสตร์	демонстрациона школа универзитета касетсарт	kasetsart university laboratory school
โรงเรียนห้องสอนศึกษา	школска учионица	class room in school
โรงเรียนเขมะสิริอนุสสรณ์	кхемасири анусорн сцхоол	kamasirianussorn school
โรงเรียนเจ้าพระยาวิทยาคม	школа цхао пхраиа виттхаиакхом	chao praya vitanakom school
โรงเรียนเฉลิมพระเกียรติสมเด็จพระศรีนครินทร์	цхалоем пхракиат сомдет пхра сринагариндра школа	srinagarindra the princress mother school
โรงเรียนเทศบาล	јавна школа	public schools
โรงเรียนไตรมิตรวิทยาลัย	траимит виттаиалаи сцхоол	trimittavitayalai school
โรงแรม	хотел	hotel
โรจูโร่	ројеро	rojuro - a japanese character
โรตารี	ротациона	rotary
โรม	рим	rome
โรมัน	роман	roman
โรลเลอร์เบลด	роллер бладе	rollerblade
โรส	росе	rose
โรเจอร์	рогер	"name ""roger"""
โลก	свет	world
โลกแอมะซอน	амазон ворлд	world of amazon
โลงหิน	саркофаг	sarcophagus
โลโซ	лосо	lasso
โสณกุล	сонакул	sonakul
โสน	сесбаниа	sa-nho, has yellow flower, use in thai sweet/desert
โสภณ	љупко	sophon
โหมด	режим	mode
โหม่ง	прибор	mong - a thai musical instrument
โอกาส	шанса	opportunities
โอบามา	обама	obama
โอภาส	сјај	oh pas - a thai name
โอร์มาน	оман	oman - country
โอวีเอ	ова	ova
โอสถสภา	осотспа	osotspa
โอสถานุเคราะห์	осатхануграх	social service
โออิชิ	оисхи	oochi - a name of food business in thailand
โอะกินะวะ	окинава	okinawa
โอเค	ок	ok
โอเอกซ์	тиц-тац-тое	ox - a game like tic tac toe
โฮม	кућа	"english word ""home"""
โฮลดิ้ง	држање	houlding
ใจดี	врста	chaidi
ใช่	да!	yes
ใช้ขยายความเฉพาะบุคคล	користите за персонализацију	to describe
ใช้ชื่อว่า	назван	named
ใช้เวลา	потребно време	it takes time
ใต้	под	south
ในกรณีนี้	у овом случају	in this isituation
ในกลุ่ม	у групи	in group
ในการประเมินผลงานวิจัยของสถาบัน	у евалуацији резултата истраживања института	in research evaluating of institute
ในการเลือกตั้ง	на изборима	election
ในกาลต่อมา	убудуће	later
ในขณะที่	док	while
ในคริสต์ศตวรรษที่	у 19. веку	in the #___ century
ในคศ	у години	in a.d.
ในชิงร้อยชิงล้าน	у милиону цхинг цхинга	game show to compete for 1 million baht
ในช่วงปี	у току године	in the year of ________
ในช่วงสงครามเย็น	за време хладног рата	during the cold war
ในช่วงสงครามโลกครั้งที่	за време светског рата	in time of world war
ในช่วงสงครามโลกครั้งที่สอง	током другог светског рата	during world war ii
ในช่วงหลัง	касније	later
ในช่วงแรก	у почетку	in the first part, primarily
ในดาร์ฟูร์	у дарфуру	inside dafur
ในต่างประเทศ	у страним земљама	foreign countries
ในทางกลับกัน	с друге стране	opposite
ในทางดาราศาสตร์	у астрономији	astrology
ในทางตรงกันข้าม	напротив	oppositely
ในบางฉบับ	у неким издањима	in a certain issue (of a magazine)
ในประเทศญี่ปุ่น	у јапану	japan
ในปลายปี	на крају године	at teh end of the year
ในปี	у години	in the year
ในปีที่	у години	in year
ในปีนี้	ове године	in this year
ในปีพศ	у години	in b.e. year
ในปีพุทธศักราช	у години.	in b.e.
ในปีเดียวกัน	исте године	in the same year
ในปีเดียวกันนั้น	исте године	in that year
ในพระบาทสมเด็จพระพุทธยอดฟ้าจุฬาโลก	у време владавине краља буде иодфа цхула лок	under the reign of one of the thailand's past king
ในพระบาทสมเด็จพระพุทธเลิศหล้านภาลัย	у његово величанство краљ, пхра буда лертлах, напалаи	under one of the king of siam
ในภายหลัง	касније	background
ในภาษาสันสกฤต	на санскрту	in sanskrit language
ในภาษาอังกฤษ	на енглеском	in english
ในภาษาอิตาลี่	на италијанском	in italian
ในภาษาไทย	на тајландском	in the thai language
ในยุคกลาง	у средњем веку	in the middle ages
ในยุคแรก	у почетку	in early age
ในระบบสุริยะ	у сунчевом систему	in the solar system
ในระยะหลัง	у последње време	at the end
ในระหว่างปี	у току године	between the years
ในระหว่างวันที่	током дана	during the dates
ในรัชสมัยพระบาทสมเด็จพระจอมเกล้าเจ้าอยู่หัว	током владавине краља монгкута	in the reign of thailand's 4th king
ในรัฐบาล	у влади	in the government
ในฤดูกาล	у сезони	in season
ในสมัยกรุงศรีอยุธยา	у аиуттхаиа периоду	in  ayutthaya kingdom era
ในสมัยก่อน	у старе дане	in the past
ในสมัยพุทธกาล	у модерно доба	in buddha era
ในสมัยรัชกาลที่	током владавине	in period
ในสหรัฐอเมริกา	у сједињеним америчким државама	in united states of america
ในหนังสือ	у књизи	in book
ในอดีต	у прошлости	in the past
ในอดีตทุ่งกุลาร้องไห้ในฤดูแล้ง	у прошлости је тхунг кула плакао у сушној сезони.	thung kula rong hai in dry season in the past
ในอัลบั้ม	у албуму	in the album
ในเกมเดอะซิมส์	у симс игри	sims game
ในเครือ	придружено	in the area of
ในเดือน	у месецу	in the month of ...
ในเดือนมิถุนายน	у јуну	in june
ในเดือนมีนาคม	у марту	in april
ในเบื้องต้น	у почетку	primarily
ในเรื่อง	у односу на	in story
ในเหตุการณ์	у случају	in the event
ในเอเชียตะวันออกเฉียงใต้	у југоисточној азији	in southeast asia.
ในแฮร์รี่	харри	in harry
ในโอกาสครบรอบ	поводом годишњице	anniversary
ใบเสมา	баттлементс	boundary marker of a temple
ใหญ่	велика	large
ให้พลเอกเปรม	за генерал прем	general prem - a former military figure
ให้สมเด็จพระเทพรัตนราชสุดาฯ	за њ.кв принцеза маха цхакри сириндхорн	given to the thai's eldest princess
ให้เสียงพากย์	гласовна глума	dubbed
ให้แก่ประชาชน	људима	for the people
ให้ใช้หลัก	користите принцип	large size
ไกรทอง	краи тхонг	krei thong - a surname
ไกรลาศ	краилат	krailard
ไกลกังวล	забринути	klai kangwon
ไก่	пилетина	chicken
ไขมัน	дебео	lipid, fat
ไขสันหลัง	рупа	spinal cord
ไข่	јаје	egg
ไข้รากสาดใหญ่	тифус	typhus
ไข้สูง	висока температура	high fever
ไข้หวัดใหญ่สายพันธุ์ใหม่	нови сој грипа	new flu strain
ไข้หวัดใหญ่สเปน	шпански грип	spanish flu
ไคเอ็น	каиен	kaien
ไชยกิตติ	цхаи китти	chaikitti
ไชยยงค์	цхаиионг	chaiyayong
ไชยวัฒน์	цхаиват	chaiwat
ไชยา	цхаииа	chaiya
ไชโย	браво!	chaiyo
ไซน์	син	sine
ไซโทสเกเลตอน	зеитос гатеела	cytoskeleton
ไซโปรเฮปตาดีน	сипро хептадине	cyproheptadine
ไดคลอกซาซิลลิน	даиклок силлин	dicloxacillin - a drug
ไดดาโนซีน	диноцен	didanosine - medication
ไดอาน่า	диана	diana
ไดโนเสาร์ของโนบิตะ	нобитин диносаур	nobita's dinosaur
ได้	имати	receive
ได้กล่าวว่า	рекао	stating that, commenting on something
ได้ดังนี้	као што следи	these
ได้ทูลเกล้าฯ	представљено	report to the king
ได้มีโอกาสสร้างความสัมพันธ์อันดีต่อกัน	имати прилику да изградите добре односе једни са другима	good relationship
ได้รับ	добити	received
ได้รับฉายาว่า	добио је надимак	recived the alias
ได้รับรางวัล	набавите награду	awarded
ได้ร่วมกันในภารกิจในด้านต่าง	заједно у мисији на разним пољима.	participated in activities
ได้สำเร็จ	успешно	successfully
ได้สู้กับ	суочио се са	competing against
ได้เคลื่อนไหวตรวจสอบการทำงานของรัฐบาลกัมพูชาอย่างแข็งขัน	активно је кренуо у инспекцију рада владе камбоџе	underground investigation
ได้เป็น	постани	is
ไต	бубрег	kidney
ไต้หวัน	тајван	taiwan
ไท	независна	tai
ไทย	тајландски	thai
ไทยทีวีสีช่อง	тхаи цолор тв канал	thai tv
ไทยพรีเมียร์ลีก	премијер лига тајланда	thai premiere
ไทยรามา	тхаи рама	thairama
ไทยานนท์	тхаиианон	taiyanon - a thai surname
ไทรโลจี	трилогија	trilogy
ไทลื้อ	тхаи луе	group of laotians that lives on flatlands
ไทโรซีน	тирозин	thyrosine
ไนท์	ноћ	sege
ไนลอน	најлон	nylon
ไนโตรเจน	азот	nitrogen
ไปจนถึง	до	to
ไปบรรจบแม่น้ำเจ้าพระยา	иди у сусрет реци цхао пхраиа	runs to chao phraya river
ไปรษณีย์กาฬสินธุ์	пошта каласин	kalasin post office
ไปรษณีย์ฉะเชิงเทรา	пошта цхацхоенгсао	cha cheng sao postal zone
ไปรษณีย์นครศรีธรรมราช	накхон си тхаммарат пошта	nakornsritamarat postal station
ไปรษณีย์ภูเวียง	пошта пху вианг	pu weang postal office
ไปรษณีย์ยานนาวา	ианнава пост оффице	yan nawa post office
ไปรษณีย์ร้อยเอ็ด	рои ет пошта	roi et post office
ไปรษณีย์สามเสนใน	поштанска канцеларија самсен наи	samsen nai post office
ไปรษณีย์หนองหาน	пошта нонг хан	nong han postal office
ไปรษณีย์อำนาจเจริญ	пошта амнат цхароен	amnat charoen post office
ไปรษณีย์อุทุมพรพิสัย	утхумпхон пхисаи пошта	utumporn pisai post office
ไปรษณีย์อุบลราชธานี	пошта убон ратцхатхани	ubon ratchathani post office
ไปรษณีย์เดชอุดม	дет пошта	det udom post office
ไปรษณีย์โพนพิสัย	пошта пхон пхисаи	phon phisai post office
ไผ่แดง	црвени бамбус	red bamboo
ไพฑูรย์	хризоберил	phaithun
ไพรบึง	шума	phrai bueng
ไพรวัลย์	праиван	phraiwan
ไพศาล	експанзиван	phaisan
ไฟ	ватра	fire
ไฟนอลแฟนตาซี	финал фантаси	final fantasy
ไฟร์วอลล์	ватрени зид	firewall
ไมค์	мике	mike
ไมอามี่	миами	miami
ไมโครซอฟท์	мицрософт	microsoft
ไม่ต่ำกว่า	не мање од	not lower than
ไม่ทราบข้อมูล	непознате информације	no background information
ไม่บังคับ	опционо	not enforced
ไม่ผ่านเข้ารอบ	није квалификован	did not make it to the next round, got eliminated in the initial round
ไม่มีบันทึกว่าใครเป็นคนสร้าง	нема записа ко га је створио.	don't note who make id
ไม่มีแขน	без оружја	armless
ไม่ว่าจะ	да ли је	such as
ไม่สามารถทำการเกษตรได้	није могуће бавити се пољопривредом	unable to practice agriculture
ไม่แตกกิ่ง	није разгранато	no chain
ไม่ใช่	не	no
ไม้	дрво	mai
ไม้กวาด	метла	broom
ไม้หนีบผ้า	штипаљка	clip
ไม้ไม่ผลัดใบ	евергреен	plants that have leaves all year round
ไรงะ	рига	reiya - a character from a japanese story
ไรโบโซม	рибосоме	ribosome
ไร่	фарма	field, parcel
ไลท์	светлост	light
ไลบร้า	вага	libra
ไลฟ์สไตน์	лифстеин	life style
ไลเบรชัน	библиотека	libration
ไวชาน่า	ваицхана	baishana - weapon in a japanese story
ไวทยางกูร	виттаиангкун	wathaiyangkun
ไวทยานนท์	ваитхаианон	waithayanon
ไวท์สเปล	вхитеспелл	white spell
ไวน์	вино	wine
ไวยากรณ์	граматика	waiyakorn
ไวรัส	вирус	virus
ไวรัสตับอักเสบ	хепатитис	hepatitis
ไวเซิร์ด	веисс	vizard
ไวเปอร์	випер	viper
ไวเวิร์น	вверн	wyvern
ไวโอเลต	љубичаста	violet
ไว้ว่า	реци	as
ไหซอง	флирт	haisong
ไหมกัน	заједно	maigun - a surname
ไหลจากลาวเข้าสู่ภาคเหนือของกัมพูชาแล้วไหลผ่านเข้าเขตเวียดนาม	тече из лаоса у северну камбоџу и улива се у вијетнам	flows from laos into northern cambodia
ไอทีวี	итв	itv
ไอน์สไตน์	ајнштајн	einstein
ไอน์สไตเนียม	еинстеиниум	einsteinium
ไอพอด	ипод	ipod
ไอริส	дужица	iris
ไอร์แลนด์เหนือ	северна ирска	northern ireland
ไอเอ	иа	ia
ไอโมบาย	ја мобилни	i-mobile
ไอโอ	ио	io - from greek mythology
ไฮยาซินธ์	хиацинтх	hyacinth
ไฮเดรนเยีย	хидрангеа	hydrangea
ไฮเปอร์มาร์เก็ต	хипермаркет	tesco lotus hypermarket chain
ไฮแจ็ค	отмица	hijack
ไฮโดรเจน	водоник	hydrogen
๑๔	14	14
๑๕	15	15
๑๖	16	16
๑๘	18	18
๒๑	21	21
๒๒	22	22
๒๔๕๐	1907	2450
๒๕๐๒	1962	2502
๒๕๐๓	1963	2503
๒๕๒๓	1980	1980
๒๕๓๔	1991	2534
๒๕๓๕	1992	2535
๒๕๓๖	2536	2536 be (1993 ad)
๒๕๔๗	2004	2547
๒๕๔๘	2005	2548
๒๕๕๐	2007	2550
๒๕๕๔	2011	2554
๒๗	27	27
๒๘	28	28
๓	3	3
๔๘	48	48
๕	5	5
๖๐	60	60
๙	9	nine
ព្រះរាជាណាចក្រកម្ពុជា	កមពជា	cambodia
疾風伝	伝	not in thai - cannot translate
