$ tỉ	$ miliar	$ billion
abc	abc	abc
abdul	abdul	abdul
abkhazia	abkhazia	a name
about	tentang	about
abraham	abraham	abraham
abrams	abrams	abrams
abscbn	abscbn	abscbn
account	akun	account
aceh	aceh	(proper noun) aceh
achilles	achilles	achilles
acia	acia	acia
acid	asam	acid
ada	ada	ada
adams	adams	(proper noun) adams
addisonwesley	addisonwesley	(proper noun) addison-wesley
adn	adn	adn
adobe	adobe	adobe
adrian	adrian	(proper noun) adrian
adsl	adsl	adsl
advanced	lanjut	advanced
aedes	aedes	aedes
aegypti	aegypti	aegypti
aero	aero	(proper noun) aero, as in the aero l-39 albatros jet
afc	afc	afc
aff	aff	aff
afghanistan	afghanistan	afghanistan
africa	afrika	(proper noun) africa
african	afrika	african
ag	ag	ag
agasa	agasa	(proper noun) agasa, as in hiroshi agasa
agassi	agassi	agassi
ai	siapa	who
ailen	orang lrlandia	ailen
aim	bertujuan	aim
air	udara	air
airbus	airbus	airbus
aisne	aisne	aisne
ajax	ajax	ajax
ak	ak	ak
akatsuki	akatsuki	akastuki
akms	akms	akms
akô	halo	ako
al	al	al
alabama	alabama	alabama
alaska	alaska	alaska
albania	albania	albania
albatros	albatros	(proper noun) albatros, as in the aero l-39 albatros
albert	albert	(proper noun) albert
alberto	alberto	(proper noun) alberto
albion	albion	albion, an ancient name for great britain
albuquerque	albuquerque	albuquerque
albus	albus	albus
alexa	alexa	alexa
alexandra	alexandra	alexandra
alexandria	alexandria	alexandria
alexandros	alexandros	alexandros
alexey	alexey	alexey
alfred	alfred	(proper noun) alfred, as in alfred kinsey
algérie	algérie	algerie
ali	ali	ali
alice	alice	this is a name
allan	allan	(proper noun) allan, as in edgar allan poe
allen	allen	(proper noun) allen
allmusic	allmusic	allmusíc
alois	alois	alois
alonso	alonso	alonso
alpher	alpher	(proper noun) alpher
alps	alpen	alps
altai	altai	altai
always	selalu	luon luon
amaravati	amaravati	amaravati
amazon	amazon	amazon
amdo	amdo	(proper noun) amdo
ame	ame	ame
ami	ami	ami
amiens	amiens	amiens
amin	amina	(proper noun) amin, as in nagib amin
amm	amm	amm
amoniac	amonia	ammonium (n.)
amphitrite	amfitrit	(proper noun) amphitrite, a greek sea goddess
an	sebuah	"(should be ""an toàn"") safe"
anand	anand	anand
anata	anata	anata
anatolia	anatolia	anatolia
andalusia	andalusia	andalusia
andaman	andaman	andaman
anderson	anderson	anderson
andes	andes	andes
andorra	andorra	andorra
andrew	andrew	andrew
andré	andré	andre, as in andre morval
andy	andy	(proper noun) andy, as in andy warhol
anfield	anfield	anfield
ang	ang	ang
angkor	angkor	(proper noun) angkor, as in angkor wat, the temple in cambodia
anglosaxon	anglosaxon	anglo-saxon
anh	dia	english
anhmỹ	inggris	"(term should be ""anh mỹ"") english or american"
anhpháp	tuan prancis	england-france
ankara	ankara	ankara
ankyl	pergelangan kaki	ankly
anna	anna	anna
annam	annam	a name the way french called middle vietnam as a colony
annan	annan	annan
anne	anne	anne, a name
anorthosit	anorthosit	anorthosit, a type of igneous rock (n.)
anthony	anthony	anthony
antigua	antigua	(proper noun) antigua
anton	anton	anton
antonov	antonov	antonov
any	apapun	any
anđêhít	aldehida	aldehydes
ao	kolam	pond
aotearoa	aotearoa	aotearoa
apollo	apollo	apollo
apple	apel	apple
aquinas	aquinas	a name
arab	arab	(proper noun) arab
archetypal	pola dasar	archetypal
archive	arsip	archive
arctan	arktan	a function
ares	ares	ares
argentina	argentina	(proper noun) the south american nation of argentina
argo	argo	argo
arias	arias	arias
aringarosa	aringarosa	aringarosa, as in manuel aringarosa
aristotle	aristotle	aristotle
arizona	arizona	arizona, as in the state
ark	bahtera	ark
arkansas	arkansas	arkansas
arlington	arlington	(proper noun) arlington
armenia	armenia	(proper noun) armenia
armstrong	amstrong	(proper noun) armstrong, as in jazz artist louis armstrong
arnold	arnold	arnold
arsenal	gudang senjata	arsenal
artemis	artemis	(proper noun) artemis, the greek goddess of the hunt
aruba	aruba	aruba
arunachal	arunachal	"(term should be ""arunachal pradesh"") a state in india (proper noun)"
asc	asc	asc
ash	abu	a name
ashikaga	ashikaga	ashikaga
ashley	ashley	(proper noun) ashley
asia	asia	asia
asm	asm	asm
asoka	asoka	asoka
association	asosiasi	association
assyria	assyria	assyria
aston	aston	(proper noun) aston, as in aston villa
atkinson	atkinson	atkinson
atlanta	atlanta	atlanta
atlantic	atlantik	atlantic
aua	aua	aua
aubrac	aubrac	aubrac
audition	audisi	audition
auflage	auflage	auflage
auguste	agustus	auguste
australia	australia	(proper noun) australia
austria	austria	(proper noun) the country of austria
austrian	austria	austrian
avar	avar	a name
aviation	penerbangan	aviation
awad	awad	awad
award	penghargaan	award
axit	asam	acid
ayeyarwady	ayeyarwady	ayeyarwady
ayumi	ayumi	(proper noun) ayumi
ayutthaya	ayutthaya	(proper noun) ayutthaya
azerbaijan	azerbaijan	(proper noun) azerbaijan
aztec	aztec	aztec, as in the aztec people (adj.)
ba	tiga	three
babylon	babel	babylon
bacon	daging asap	bacon
baden	baden	baden
baghdad	baghdad	(proper noun) baghdad
bago	bago	bago
bahamas	bahama	bahamas
bahrain	bahrain	bahrain
baháí	baháí	bahai
balearic	balearic	balearic
bali	bali	bali
balkan	balkan	(proper adjective) balkan
balkans	balkan	balkans
ballard	ballard	ballard
bamar	bamar	bamar
ban	larangan	the
bang	bang	state
banh	bola	ball
banner	spanduk	banner
bantam	bantam	bantam
bantu	bantu	bantu
bao	karung	bao giờ= ever
barack	barack	barack
barak	barak	barak
barbados	orang barbar	(proper noun) barbados
barbara	barbara	barbara
barbary	biadab	barbary
barca	barca	barca
barnes	barnes	barnes
barone	barone	barone
baroque	barok	baroque
barquin	barquin	barquin, as in ramon barquin, the cuban military colonel
barrichello	barrichello	barrichello
bartholdi	bartholdi	bartholdi
baryon	baryon	baryon
barça	barca	(proper noun) barca
base	dasar	base
basel	basel	basel, a city in switzerland
basil	kemangi	basil
baskervilles	baskervilles	baskervilles
bass	bass	bass
bator	bator	bator
battambang	battambang	battambang
bauer	bauer	bauer
bay	terbang	"(should be ""tuyến bay"") an airline"
bayern	bayern	bayern
bazan	basal	basalt (n.)
bazơ	dasar	base
bb	bb	bb
bbc	bbc	bbc
bc	bc	bc
bchtư	bchtư	central executive
beat	mengalahkan	beat
beatles	beatles	the beatles
beauty	kecantikan	beauty
beckenbauer	beckenbauer	beckenbauer, as in franz beckenbauer
becker	becker	(proper noun) becker
beckham	beckham	beckam
bedloe	bedloe	bedloe
beethoven	beethoven	beethoven
beethovens	beethovens	beethoven's
beginbmatrix	beginbmatrix	this is a code
behind	di belakang	behind
beijing	beijing	beijing
bel	bel	bel
bell	bel	bell
bella	bella	bella
bellatrix	bellatrix	bellatrix
benedict	benediktus	benedict
benetton	benetton	benetton
benfica	benfica	benfica
benito	benito	benito
benjamin	benjamin	(proper noun) benjamin
bennington	bennington	bennigton
berber	berber	berber
bergen	bergen	(proper noun) bergen
berger	berger	berger
bering	bering	(proper noun) bering, as in the bering strait
berkeley	berkeley	(proper noun) the city of berkeley, california
berman	berman	a name
bermuda	bermuda	(proper noun) bermuda
bernard	bernard	bernard
bertrand	bertrand	bertrand
better	lebih baik	better
betty	betty	betty
bhutan	bhutan	bhutan
bia	bir	beer (n.)
biang	biang	biang
bic	bic	bic
bikini	bikini	bikini
bill	tagihan	(proper noun) bill, as in former president bill clinton
billy	billy	billy
bismarck	bismarck	bismarck, as in otto von bismarck
bitmap	bitmap	bitmap
biên	perbatasan	bien
biếc	teal	a bluish-green color (adj.)
biếm	ceroboh	"(term should be ""biếm họa"") cartoon (n.)"
biến	variabel	other
biếng	malas	lose interest in
biếu	kesopanan	present
biều	bieu	bieu
biển	laut	ocean
biểuthứcđiềukiện	tahu kondisinya	conditional expression
biện	minta maaf	"(term should be ""biện pháp"") a method (n.)"
biệt	berbeda	"(term should be ""khác biệt"") different or distinct"
bkavpro	bkavpro	bkavpro
blackwell	blackwell	this is a name
blair	blair	blair
blaise	blaise	blaise
blanc	blanc	blanc
blues	blues	blues
bo	bo	a curl, as in a biceps curl exercise
bob	bob	bob
bobby	bobby	bobby, as in bobby day
boeing	boeing	boeing
bohemia	bohemia	bohemia
bolivia	bolivia	(proper noun) bolivia
boltzmann	boltzmann	boltzmann
bom	bom	bomb
bonaparte	bonaparte	bonaparte
bong	bong	"(term should be ""bong bóng"") a balloon (n.)"
bonnal	bonnal	bonnal
bonobo	bonobo	bonono
bool	bool	bool
boolean	boolean	(proper adjective) boolean, as in boolean algebra
boom	booming	boom
boong	geladak	a deck (n.)
boongke	bunker	bunker
bop	bop	bop
boris	boris	boris
borland	borland	(proper noun) borland
borussia	borussia	borussia
bose	bose	bose, as in subhas chandra bose
boseeinstein	boseeinstein	bose einstein
bosna	bosna	(proper noun) bosnia
bosnia	bosnia	(proper noun) bosnia
botswana	botswana	botswana
bottom	bawah	bottom
boulder	batu besar	boulder
bourbon	bourbon	bourbon
boxing	tinju	boxing
brain	otak	brain
brandenburg	brandenburg	(proper noun) brandenburg
brandt	brandt	brandt
braun	braun	braun
brazil	brazil	brazil
bremen	bremen	bremen, as in the bremen bank
brestlitovsk	brestlitovsk	brest-litovsk
breton	breton	(proper noun) breton
bretton	bretton	hoi nghi
brezhnev	brezhnev	brezhnev
brian	brian	a name
bridge	jembatan	bridge
britannic	britania	(proper noun) britannic
britney	britney	britney
brooklyn	brooklyn	brooklyn
brot	brot	this is german not vietnamese
brown	coklat	brown
browne	alis	browne
browning	kecoklatan	(proper noun) browning
bruce	bruce	bruce
brunei	brunei	brunei
bruno	bruno	bruno, as in the city of san bruno
brusilov	brusilov	brusilov
brussels	brussel	brussels, the capital of belgium
btr	btr	btr
bubalis	bubalis	bubalis
budapest	budapest	budapest, the capital of hungary
bulgaria	bulgaria	bulgaria
bulletin	buletin	thong bao
bungary	bungary	bungary
bungo	bungo	bungo
buonaparte	buonaparte	(proper noun) buonaparte, as in casa buonaparte
burke	burke	(proper noun) burke, as in edmund burke
burkina	burkina	burkina
burma	burma	burma
burundi	burundi	burundi
busan	busan	a korean city
busby	busby	busby
bush	semak	bush
bushy	lebat	bushy
buôn	grosir	commerce
buông	lepaskan	to release, to let loose
buýt	bus	bus
buốt	dingin	sharp
buồm	berlayar	sail
buồn	sedih	sad
buồng	ruang	chamber
buổi	sesi	session
byzantine	bizantium	byzantine
bà	nenek	woman or lady (n.)
bài	pos	articles
bàn	meja	table
bàng	elang	eagle
bành	peng	armchair
bào	perencanaan	compatriot
bàu	bau	bau
bày	presentasi	"(term should be ""trưng bày"") to display (v.)"
bác	paman	doctor
bách	cemara	"(term should be ""bách khoa"") polytechnic (adj.)"
bái	kultus	to bow (v.)
bám	melekat	cling
bán	dijual	sell
báng	stok	"(term should be ""phỉ báng"") to defame or slander"
báo	koran	newspaper (n.)
bát	mangkuk	eight (n.)
báu	harta karun	valuable
bây	sekarang	now
bã	residu	"(term should be ""buồn bã"") sad (adj.)"
bãi	yard	beach
bão	badai	storm
bèn	lalu	then
bé	sayang	baby
bén	tajam	sharp (adj.)
béo	gendut	fat
bên	pesta	side
bênh	sakit	advocate
bì	kemasan	foreskin (n.)
bìa	penutup	cover
bìu	skrotum	sac (n.)
bí	squash	secret
bính	binh	"(term should be ""bính âm"") romanized chinese words (n.)"
bíró	labu	biro
bò	sapi	beef
bó	banyak	bound (adj.)
bói	meramal	to foretell (v.)
bón	pupuk	"entire term should be ""phan bon""; means ""fertilizer"""
bóng	bolanya	sphere or ball
bóp	memeras	squeeze
bô	toilet	"(term should be ""bôxit"") the mineral bauxite"
bôi	dioleskan	to apply (as in oil)
bông	kapas	flower
bù	berdandan	compensate
bùa	jimat	talisman
bùn	lumpur	mud
bùng	menyala	"(term should be ""bùng nổ"") to break out (v.)"
bú	menyusu	to suck
búa	palu	a hammer
búi	jumbai	tuft
bún	roti	noodle
búng	menjentikkan	snap
bút	pulpen	pseudonym
băm	hash	hash
băn	resah	concerned
băng	es	"(term should be ""băng giá"") freezing (adj.)"
bơ	mentega	"(term should be ""bơ vơ"") desolate (adj.)"
bơi	berenang	swim
bơm	pompa	pump
bưu	ongkos kirim	post office
bước	langkah	a step (n.)
bướm	kupu-kupu	butterfly
bạ	kontak	directory
bạc	perak	meager
bạch	transparan	"(should be ""bạch tuộc"") an octopus"
bại	gagal	defeated
bảng	meja	chart
bảo	bao	protect
bảy	tujuh	seventh
bấm	tekan	press
bất	nyata	"(term should be ""bất cứ"") any (adj.)"
bấy	itu	contemporary
bần	miskin	poor
bầu	memilih	vote
bầy	kawanan	servant
bẩm	bawaan	congenital
bẩn	kotor	the
bẩy	perangkap	"(term should be ""lẩy bẩy"") unsteadily (adv.)"
bẫy	perangkap	a trap (n.)
bậc	gelar	level or class (n.)
bận	sibuk	busy
bật	dihidupkan	outstanding
bắc	utara	beijing
bắcnam	northnam	"(term should be ""bắc-nam"") north-south (adj.)"
bắn	tembak	shoot
bắp	jagung	venter
bắt	untuk menangkap	cross
bằng	sama dengan	by
bẹp	menghancurkan	crush
bẻ	istirahat	break
bẽ	penghinaan	humiliate
bến	berlabuh	wharf
bếp	dapur	kitchen
bề	permukaan	"(should be ""bề mặt"") a surface"
bền	tahan lama	enduring (v.)
bể	rusak	tank
bệ	alas	base
bện	dikepang	braided (adj.)
bệnh	sakit	benh
bỉ	belgia	disgust
bỉnh	nakal	binh
bịch	buk	ridiculous
bịt	tertutup	cover
bọ	bug	insect
bọc	bungkus	to cover or enclose (v.)
bọn	mereka	a group (n.)
bọng	bengkak	bladder
bọt	busa	foam
bỏ	menyerah	to leave (v.)
bỏng	terbakar	hot
bố	ayah	"(term should be ""tuyên bố"") to declare"
bốc	memuat	bốc lửa= on fire
bối	bingung	messy
bốn	empat	four
bồi	kompensasi	"(term should be ""cao bồi"") cowboy (n.)"
bổn	tugas	duty
bổng	beasiswa	"with word luong, means ""salary"" or ""wages"""
bỗng	tiba-tiba	suddently
bộ	diatur	part
bộc	dewan komisaris	"(term should be ""bộc lộ"") to reveal (v.)"
bội	berlipat ganda	betray
bột	adonan	powder or flour (n.)
bớ	mengumpulkan	arrest
bớt	kurang	less
bờ	pantai	coast
bời	gelandangan	profuse
bở	oleh	profitable
bởi	oleh	because
bục	podium	platform
bụng	perut	abdomen
bứt	tanpa sadar	"(term should be ""bứt phá"") power (n.)"
bừa	mengerikan	messy, careless, or topsy-turvy (adj.)
bữa	makan	meal (n.)
bực	frustrasi	bother
ca	ca	praise
ca-lo	ca-lo	a unit of measurement
cabo	cabo	cabo
cacbon	karbon	carbon
cacbonat	karbonat	carbonate
cacbua	karbida	carbides, carbon ions
caesar	caesar	caesar
caffein	kafein	caffeine
café	kopi	coffee
cai	cai	govern
cairo	kairo	cairo, the capital of egypt
cal	kal	cal, a first name
calculus	kalkulus	calculus
calvin	calvin	calvin
cam	oranye	commit
cambodia	kamboja	(proper noun) the country of cambodia
cambridge	cambridge	cambridge
cameo	cameo	cameo part
cameron	kameron	cameron
cameroon	kamera	cameroon
camille	camille	camille
campbell	bel pintu	campbell
campuchia	kamboja	campuchia
canada	kanada	canada
canadian	kanada	canadian
canal	kanal	canal
canary	kenari	canary
cancer	kanker	cancer
canterbury	canterbury	canterbury
canxi	kalsium	calcium
capello	capello	capello
capra	capra	capra
carat	karat	carat
carbine	karabin	carbine
cardcaptor	pemilik kartu	cardcaptor
cardcaptors	cardcaptors	(proper noun) cardcaptors
carey	peduli	(proper noun) carey, as in singer mariah carey
caribe	caribe	caribbean
caribê	karibia	caribbean
carl	carl	carl
carlos	carlos	carlos
carnaval	karnaval	carnaval
carol	carol	carol
caroline	caroline	(proper noun) caroline
carpathia	carpathia	carpathia
carter	carter	carter
carxtơ	karat	karst topography, a geological term (n.)
casa	casa	casa
casablanca	casablanca	casablanca
caspia	caspia	caspia
cassini	cassini	cassini
cast	pemain	cast
castries	castries	castries
castro	castro	castro, as in fidel castro
cathay	cathay	cathay
catherine	catherine	catherine
cau	cau	cau
cbc	cbc	cbc
cbgd	cbgd	educational  officer
cbs	cbs	cbs
ccc	ccc	ccc
ccn	ccn	industrial cluster
cctv	cctv	cctv
cd	cd	cd
cdot	cdot	cdot
cdrom	cdrom	cd-rom
cell	sel	cell
celtic	celtic	centic
cena	cena	(proper noun) cena, as in john cena, the wrestler
centauri	centauri	centauri
ceres	ceres	ceres
cha	ayah	father
chai	botol	bottle
chaillot	chaillot	a name
chamberlain	bendaharawan	chamberlain
champa	champa	champa
champion	juara	champion
chamẹ	mandi	parents
chanel	chanel	chanel
chanh	lemon	lemon or lime (n.)
chao	hai	(proper noun) chao, a name
charles	charles	charles
charlotte	charlotte	charlotte
charlton	charlton	charlton
charon	charon	(proper noun) charon
chase	kejar	chase
chay	vegetarian	fasting
chdcnd	chdcnd	democratic republic
che	penutup	cover
chechnya	chechnya	chechnya
chen	chen	chen
cheo	cheo	"(term should be ""cheo reo"") name of a town"
chi	chi	"(term should be ""chi tiết"") details (n.)"
chia	terbagi	"(term should be ""chia sẻ"") to share"
chiang	chiang	chiang
chicago	chicago	chicago, as in chicago, illinois
chile	chili	(proper noun) the country of chile
chim	burung	bird
china	cina	china
ching	ching	ching
chirac	chirac	chirac, as in former french president jacques chirac
chiêm	astrologi	"(term should be ""chiêm thành"") the ancient kingdom of champa in vietnam"
chiên	digoreng	fry
chiêng	gong	gong
chiếc	pcs	the
chiếm	ditempati	appropriate
chiến	berkelahi	war, fight
chiết	ekstrak	literal
chiếu	proyeksi	show
chiền	banyak	temple
chiều	siang	length
chlamydia	klamidia	chlamydia
chloride	klorida	chloroauric acid
chnd	chnd	chnd
choi	mainkan	choi
chomsky	chomsky	chomsky
chong	chong	chong
chopin	chopin	chopin
chosŏn	pilih	(proper noun) choson
choàng	jubah	coat
choáng	tertegun	dizzy
chris	chris	chris, as in chris hughes
christ	kristus	christ
christian	kristen	christian
christopher	christopher	christopher
chrome	chrome	chrome, as in google chrome
chrysler	chrysler	(proper noun) chrysler, the car company
chu	chu	cycle
chua	masam	tomato
chuck	chuck	(proper noun) chuck, as in chuck norris
chui	bawah tanah	underground
chum	sohib	pot
chun	chun	chun
chung	umum	general
churchill	churchill	churchill
chuyên	terspesialisasi	professional
chuyến	perjalanan	trip
chuyền	lulus	volleyball
chuyển	transfer	to move
chuyện	cerita	nói chuyện= talk
chuôi	mengeluh	handle
chuông	bel	a bell
chuẩn	standar	standard
chuốc	aduk	incur
chuối	pisang	banana
chuốt	menggerutu	refine
chuồng	gudang	cage
chuỗi	tali	series
chuộc	tebus	redeem
chuộng	disukai	favorite
chuột	tikus	a mouse (n.)
chà	gosok	rub
chài	memancing	fish
chàm	nila	indigo
chàng	kawan	"(term should be ""chàng trai"") a young man (n.)"
chào	hai	welcome
chày	baseball	a pestle (n.)
chánh	kepala	"(term should be ""chánh án"") the head of a tribunal (n.)"
cháo	bubur	porridge
cháu	cucu	a term one uses denoting oneself when addressing an aunt or uncle (n.)
cháy	terbakar	fire
châm	tusukan	motto
chân	kaki	a leg
châu	eropa	continental
chè	teh	tea
chèn	masukkan	insert
chém	tebas	to chop
chén	cangkir	bowl
chéo	silang	cross
chép	salinan	written
chê	sial	decry
chênh	perbedaan	difference
chì	memimpin	graphite
chìa	kunci	"(term should be ""chìa khoá"") a key (n.)"
chìm	tenggelam	to become submerged or sink (v.)
chình	belut	eel
chí	kutu	especially
chích	injeksi	shoot
chín	sembilan	ripe
chính	utama	main
chít	chit	dense
chò	tersedak	a type of plant, typically of the parashorea genus (n.)
chòi	tapi	hut
chòm	rasi bintang	constellation
chó	anjing	dog
chóc	haha	killing (giet choc)
chói	silau	bright
chóng	dengan cepat	"entire term should be ""chong mat""; means ""dizzy"""
chóp	tip	the top (n.)
chôm	rambutan	rambutan
chôn	terkubur	bury
chông	suami	thorn
chùa	pagoda	pagoda
chùy	bunga pala	mace
chú	paman	uncle (n.)
chúa	tuhan	god
chúc	berharap	will
chúi	tuu	drop
chúng	mereka	they
chút	sedikit	little
chăm	hati-hati	champa
chămpa	champa	champa
chăng	terjangkau	would it
chĩa	garpu	point
chơi	mainkan	play
chơn	kaki	"a more obscure form of the word ""chân""; means ""genuine"" or ""true"""
chư	chu	lower authorities
chưa	belum	not yet
chưng	dist	steamed
chương	bab	medal
chướng	halangan	grating
chạ	promiscuous	father
chạm	sentuh	touch
chạng	senja	twilight
chạp	goyah	slow
chạy	lari	to run (v.)
chả	gulungan	no
chảo	panci	pan
chảy	mengalir	bleeding
chấm	titik	end
chấp	hipotek	"(term should be ""chấp nhận"") to accept (v.)"
chất	substansi	quality
chấu	cubit	"(term should be ""châu chấu"") a grasshopper (n.)"
chần	pucat	slice
chẩn	mendiagnosis	"(term should be ""chẩn đoán"") to diagnose (v.)"
chậm	lambat	slow
chận	blokir	block
chật	kencang	overcrowded
chậu	pot	pelvic
chắc	tentu	certainly
chằng	alis	ligament
chẵn	bahkan	even
chặn	blokir	prevent
chặng	kaki	journey
chặt	kencang	close
chẻ	terbelah	strick
chẽ	kencang	"(term should be ""chặt chẽ"") tightly or closely (adv.)"
chế	persiapan	produce
chếch	kendur	oblique
chết	mati	to die (v.)
chệch	salah	deviant
chỉ	hanya	just (adv.)
chỉnh	koreksi	adjust
chịt	omong kosong	chằn chịt= complex/tangle
chịu	beruang	tolerate
chọc	menyodok	to poke
chọi	berkelahi	oppose
chọn	pilih	to choose
chỏ	siku	"(term should be ""cùi chỏ"") elbow (n.)"
chốc	momen	single
chối	tolak	refuse
chốn	tempat	place
chống	anti	anti-
chốt	kait	important
chồi	tunas	"(term should be ""đâm chồi"") budding"
chồn	musang	anxious
chồng	suami	husband
chỗ	tempat	where
chội	sial	cramped
chớ	tidak	not
chớp	kilat	flashing (adj.)
chờ	tunggu	to wait
chở	membawa	for
chợ	pasar	market
chợt	tiba-tiba	suddenly
chục	selusin	dozen
chụp	penembakan	capture
chủ	pemilik	"(term should be ""chủ yếu"") main or essential (adj.)"
chủng	strain	strain
chứ	lebih tepatnya	just or only (adv.)
chứa	berisi	contain
chức	fungsi	function
chừ	tunggu	hesitate
chừa	pergi	leave
chừng	sekitar	about or roughly (adv.)
chử	kata	"(term should be ""chử bích"") the vietnamese name for a chinese island"
chửa	hamil	pregnant
chửi	mengutuk	curse
chữ	kata	a letter of the alphabet (n.)
chữa	obat	to cure or treat (v.)
chững	leveling	to totter (v.)
cia	cia	cia
cincinnati	cincinnati	cincinnati
cinderella	cinderella	cinderrella
cip	cip	cip
circus	sirkus	circus
cities	kota	cities
clara	clara	clara
clark	clark	clark
claude	claude	(proper noun) claude
claudius	claudius	(proper noun) claudius
clinton	clinton	clinton, as in former president bill clinton
clip	klip	clip
clips	klip	clips
clo	klorin	chlorine
clow	clow	clow
clyde	clyde	(proper noun) clyde, as in bonnie and clyde
cmc	cmc	cmc
cmt	cmt	cmt
cn	cn	christian era
cnet	cnet	cnet
cntb	cntb	capitalism
cntt	cntt	it
cnxh	cnxh	social republic
co	co	spasm
coburn	coburn	coburn
cocoa	kakao	cocoa
coen	coen	coen
coffea	kopi	coffee
cohen	cohen	cohen
coi	dipertimbangkan	to regard
coleen	coleen	coleen
coleman	kolega	coleman
coli	coli	coli
colin	colin	(proper noun) colin, as in colin powell
colleen	kolega	colleen
college	perguruan tinggi	college
collins	collins	(proper noun) collins
collège	college	college (n.)
colombia	kolombia	colombia
colombo	colombo	(proper noun) colombo
colorado	colorado	(proper noun) colorado, as in the state
columbus	columbus	columbus
comic	komik	comic
common	umum	common
concacaf	concacaf	concacaf
concerto	concerto	concerto
concorde	kerukunan	concorde
condom	kondom	condom
cong	melengkung	curved or bent
congo	congo	congo
congress	kongres	congress, as in library of congress
connecticut	connecticut	connecticut
conrad	conrad	corrad
conservation	konservasi	conservation
constantine	constantine	constantine
contemporary	kontemporer	contemporary
cooper	cooper	(proper noun) cooper
copenhagen	copenhagen	copenhagen
copernic	copernic	corpernic
copperfield	ladang tembaga	(proper noun) copperfield, as in magician david copperfield
coppola	coppola	coppola
copy	salinan	copy
cordyceps	cordyceps	cordyceps
core	inti	core
cornell	cornell	cornell
cosin	cosin	cosine
costa	costa	costa
cotang	cotang	cotangent
cpt	cpt	cpt
craig	craig	(proper noun) craig
crazy	gila	crazy
crespo	crespo	(proper noun) crespo
crest	lambang	crest
crew	kru	crew
crimson	merah tua	crimson
crisis	krisis	crisis
cristiano	cristiano	cristiano, as in portuguese soccer player cristiano ronaldo
croatia	kroasia	croatia
cross	silang	cross
crs	crs	crs
cruz	cruz	cruz
cruzeiro	cruzeiro	cruzeiro
crystal	kristal	crystal
ctc	ctc	ctc
cua	kepiting	crab (n.)
cullen	cullen	a name
cung	membungkuk	circle
cunningham	cunningham	cunningham; proper name
cup	cangkir	cup
cuả	dari	of, from, belonging to
cuốc	cangkul	hoe
cuối	terakhir	last or final (adj.)
cuốn	buku	book
cuống	tangkai	throat
cuồng	gila	crazy (adj.)
cuộc	berkelahi	the
cyanide	sianida	cyanide
cyber	dunia maya	cyber
cyril	cyril	(proper noun) cyril
cyrus	cyrus	cyrus
cyworld	dunia maya	cyword
cà	kopi	ca
cài	instal	install
càn	butuhkan	raid
càng	lebih banyak	cang
cành	cabang	branch
cào	gores	scratch
cày	membajak	plow
các	itu	all (adv.)
cách	jalan	the
cái	itu	"(term should be ""con cái"") children (n.)"
cán	digulung	"(should be ""cán bộ"") an officer, especially in a communist regime"
cánh	sayap	wing
cáo	rubah	report
cáopx|bình	cáopx | rata-rata	not a word
cáp	kabel	cable (n.)
cáy	pemain biola	fiddler
câm	bodoh	mute (adj.)
cân	skala	weight
câu	hukuman	saying
cãi	berdebat	argue
cò	pemicu	stork
còn	kiri	to have left (v.)
có	iya	have
cói	sedge	machine
cót	dipan	cot
cô	dia	girl
côi	yatim piatu	orphaned
côn	lancip	a stick (n.)
công	bekerja	worker
côngtenơ	wadah	container
cõi	alam	entire area
cõng	dukung-dukungan	piggyback
cù	gelitik	cu
cùi	penderita kusta	leprosy
cùng	bersama	together
cú	burung hantu	old
cúi	membungkuk	to bow (v.)
cúm	flu	cum
cúng	nyaman	worship
cúp	pemadaman	cup (n.)
cút	keluar	to kick someone out (v.)
căm	dicolokkan	detest (cam thu)
căn	radikal	"(term should be ""căn bệnh"") cause of a disease (n.)"
căng	meregangkan	tense
cũ	tua	old
cũi	buaian	kennel
cũng	juga	also
cơm	beras	rice
cư	mengisi	resident
cưa	melihat	saw
cưng	sayang	also
cước	pengiriman	megaman
cưới	sudah menikah	marry
cướp	merampok	to rob (v.)
cười	tertawa	smile
cường	intens	strengthen
cưỡi	berkuda	ride
cưỡng	terpaksa	force some body to do some thing. cưỡng dâm=rape
cạc	kartu	card (n.)
cạn	dangkal	shallow
cạnh	tepi	"(term should be ""khía cạnh"") an angle"
cạo	mencukur	shave
cạp	kalajengking	scorpion
cả	keduanya	both
cải	mustard	reform
cảm	dingin	pleasure
cản	terganggu	prevent
cảng	pelabuhan	port
cảnh	pemandangan	situation
cảo	menarik	posthumous
cấm	dilarang	ban
cấn	butuhkan	dramatic
cấp	hibah	level or rank (n.)
cất	disuling	"(term should be ""cất giữ"") to keep safe or store"
cầm	tahan	to hold (v.)
cần	butuhkan	need
cầu	jembatan	request
cầy	musang	farmed
cẩn	hati-hati	carefully
cẩu	crane	"(term should be ""hải cẩu"") a seal (n.)"
cận	pendekatan	close
cập	konter	mention
cậu	dia	a young man (n.)
cậy	bisa diandalkan	reliable
cắm	pasang	to plant (v.)
cắn	menggigit	to bite
cắp	mencuri	steal
cắt	potong	cut
cằm	dagu	chin
cằn	pemarah	exhausted (adj.)
cặp	berpasangan	couple
cọ	telapak tangan	rub
cọc	tumpukan	pile
cọp	harimau	tiger
cỏ	rumput	plant
cố	coba	"(term should be ""cố gắng"") to try one's best (v.)"
cốc	cangkir	cereal
cối	mortar	mortar
cốm	nugget	grilled rice
cống	penghargaan	dedicate
cồn	alkoholik	i
cồng	gong	gong
cổng	gerbang	gate
cỗ	geladak	engine
cỗi	keras kepala	barren
cộ	kendaraan	"(term should be ""xe cộ"") cars or vehicles (n.)"
cội	tua	origin
cộng	plus	to add (v.)
cột	kolom	pole
cớ	alasan	excuse
cờ	bendera	flag
cỡ	ukuran	size
cợt	bercanda	"(term should be ""đùa cợt"") to trifle (v.)"
cục	departemen	department
cụm	gugus	cluster
cụp	diamputasi	down
cụt	diamputasi	"(should be ""xương cụt"") the tailbone or coccyx"
củ	umbi	a bulb, a botanical term
của	dari	of
củi	kayu bakar	firewood
củng	juga	reinforce
cứ	pada	any
cức	coo	"(term should be ""cức Đê"") a character in chinese history"
cứng	sulit	hard
cứngi	hardi	cungi
cừ	tumpukan	nacre
cừu	domba	sheep
cửa	pintu	door
cửu	berkembang biak	nine
cữ	cu	abstinence
cữu	peti mati	nine
cự	jarak	against
cựa	taji	retreat
cực	ekstrim	extreme
cựu	sebelumnya	former
d	d	d.
da	kulit	skin
daegu	daegu	daegu
dahl	dahl	(proper noun) dahl, as in author roald dahl
dai	kenyal	persistent
daily	setiap hari	daily
dakota	dakota	dakota, as in the state of south dakota
dalat	dalat	da lat
dampier	lebih basah	(proper noun) dampier, a last name
dan	dan	dan
dancing	menari	dancing
danger	bahaya	danger
danh	nama	list
daniel	daniel	daniel
dante	dante	dante
dao	pisau	poniard
darwin	darwin	darwin
das	das	das
dassault	dassault	(proper noun) dassault
date	tanggal	date
dau	sakit kepala	dau
dave	dave	(proper noun) dave, as in dave sexton
david	david	david, as in david thomas
davies	davies	davies
davis	davis	davis
dbsk	dbsk	dbsk
dc	dc	d.c.
ddr	ddr	ddr
dean	dekan	a name
degree	gelar	degree
delhi	delhi	delhi
delphi	delphi	(proper noun) delphi, as in the oracle
demeter	demeter	(proper noun) demeter, the greek goddess of the harvest
den	ruang kerja	den
dennis	dennis	dennis
department	departemen	departmen
derek	derek	derek
des	des	des
descartes	deskripsinya	descartes
design	desain	thiet ke
deuterium	deuterium	deuterium
deutschland	deutschland	deutschland
dewan	dewan	dewan, as in dewan rakyat
dewitt	dewitt	(proper noun) dewitt, as in rose dewitt bukater
di	di	move
diana	diana	(proper noun) diana, as in diana ross
die	mati	german
diego	diego	diego
dien	gila	"(term should be ""Điện biên phủ"") a city in northwestern vietnam where a famous battle took place during the vietnam war"
dimaggio	dimaggio	gimaggio
dinh	istana	official residence or palace
dionysus	dionysus	dionysus, as in the greek god
discovery	penemuan	discovery
discussion	diskusi	discussion
disneyland	disneyland	disneyland
division	pembagian	division
divoire	divoire	d'lvoire
diêm	cocok	diem vuong
diên	gila	"(term should be ""kinh diên"") canon (n.)"
diềm	kelambu	matches
diều	layang-layang	kite
diểu	layang-layang	(proper noun) diểu
diễm	diem	beauty; a common vietnamese first name for women
diễu	berbaris	parade
diệc	bangau	a heron (n.)
diệm	diem	(proper noun) diệm, as in ngô Đình diệm, former president of south vietnam
diện	wajah	face to face
diệt	bunuh	to kill or destroy (v.)
diệu	sihir	effective (adj.)
djibouti	djibouti	djibouti, a country in africa
djokovic	djokovic	(proper noun) djokovic, as in novak djokovic
dm	dm	dm
dmitri	dmitri	dmitri
dna	dna	dna
do	oleh	because of
doanh	bersama	"(term should be ""kinh doanh"") business (n.)"
doc	doc	doc
docherty	docherty	docherty
dolly	boneka	(proper noun) dolly, as in singer dolly parton
dome	kubah	nha
dominican	dominikan	(proper noun) dominican, as in the dominican republic
don	don	(proper noun) don
donau	donau	donau
dortmund	dortmund	(proper noun) dortmund
dougherty	dougherty	dougherty
douglas	douglas	douglas
dover	dover	(proper noun) dover, as in the capital of delaware
doyle	doyle	doyle
doãn	doan	doan
doạ	mengancam	threat
dp	dp	dp
dracula	drakula	dracula
draft	konsep	draft
drake	drake	(proper noun) drake
driver	pengemudi	a name
ds	ds	ds
dtd	dtd	dtd
dth	dth	dth
du	du	travel
dubai	dubai	dubai
duiker	duiker	duiker
duk	duk	duk
dumas	duma	dumas
dumbledore	dumbledore	dumbledore
dung	kotoran	portrait
durham	durham	durham
dursley	dursley	dursley
duy	hanya	only
duyên	ditakdirkan	coastal
duyện	bercita-cita tinggi	fellatio
duyệt	browse	browser
duơng	duong	ocean
duẩn	duan	duan
duật	duat	duat
duệ	keturunan	descendants (n.)
duỗi	meluruskan	stretch
dwight	dwight	dwight
dà	dah	gradually
dài	panjang	to lengthen, as in time
dàn	pementasan	to arrange
dàng	mudah	dang
dành	dihabiskan	for
dào	berlimpah	"complement to word ""doi""; entire phrase ""doi dao"" means ""plentiful"""
dày	tebal	thick
dái	kencing	"penis (n.), although some may use the term to mean ""testicles"""
dám	berani	dare
dán	tempel	stick
dáng	bentuk	appearance
dát	bertatahkan	inlay
dâm	cabul	lustful (adj.)
dân	orang-orang	people
dâng	penawaran	dedicate
dây	kawat	nerve
dã	liar	chronicle
dãi	permisif	band
dãn	melebar	extend
dãy	urutan	a row (n.)
dè	hati-hati	tight
défense	défense	defense
dép	sandal	slipper
dê	kambing	goat
dì	bibi	aunt
dìu	dìu	to lead by the hand (v.)
dính	lengket	stick
dò	cari	(with word tham) to survey
dòm	lihat	snoop
dòng	baris	"(term should be ""dòng họ"") family (n.)"
dó	itu	a type of plant used to make paper in vietnam (n.)
dông	badai petir	a storm (n.)
dõi	melacak	monitor
dù	meskipun begitu	though
dùi	pons	awl
dùng	digunakan	use
dăm	serutan	"(term should be ""đá dăm"") pebbles (n.)"
dĩ	tentu saja	why
dĩa	garpu	dish
dũng	gagah	courage
dơ	kotor	dirty
dơi	kelelawar	bat
dư	kelebihan	remnant
dưa	melon	melons
dưng	berhenti	suddently
dương	positif	penis
dường	sepertinya	seem
dưỡng	perawatan	feed
dược	farmasi	having to do with medicine (adj.)
dượng	paman	uncle
dạ	iya	night
dại	bodoh	stupid or idiotic (adj.)
dạn	tanpa rasa takut	"(term should be ""dày dạn"") to be accustomed to, especially some sort of difficult situation (adj.)"
dạng	format	tyoe
dạo	berjalan-jalan	vending
dạt	dicuci bersih	to drift
dạy	mengajar	teach
dải	menelanjangi	range
dấm	cuka	vinegar
dấp	tersandung	shape
dấu	tanda	signal
dấy	membangkitkan	to raise (v.)
dần	secara bertahap	people
dầu	minyak	oil
dẫm	menginjak	step on
dẫn	memimpin	to lead
dẫu	meskipun begitu	though
dận	bibi	to step on
dậu	ayam jago	rooster
dậy	bangun	"(term should be ""dậy thì"") pubescent (adj.)"
dắt	memimpin	lead
dằn	pemberat	"(term should be ""dằn lòng"") to hold yourself in (v.)"
dằng	gigih	dằng dai= long/endless
dẳng	gigih	persist
dặm	mil	mile
dặn	dipesan	to advise (v.)
dặt	memesan	conservative
dẹp	datar keluar	pacify
dẹt	datar	flat
dẻ	kacang kastanye	chestnut
dẻo	plastisitas	flexible
dế	jangkrik	cricket
dền	bayam	beetroot
dể	mudah	easy
dễ	mudah	easy
dệt	menenun	textile
dị	singularitas	simple
dịch	terjemahkan	semen
dịp	kesempatan	occasion
dịu	lembut	ease
dọa	mengancam	to threaten or scare (v.)
dọc	vertikal	along
dỏm	jenaka	witty
dốc	kemiringan	slope
dối	berbohong	lie
dốt	bodoh	stupid or ignorant (adj.)
dồi	berlimpah	"(term should be ""trau dồi"") improve (v.)"
dồn	terpojok	accrue
dỗ	membujuk	dirty
dời	bergerak	leave
dở	buruk	incomplete
dỡ	menurunkan muatan	remove
dụ	misalnya	example
dục	jenis kelamin	sexuality
dụng	gunakan	use
dứa	nanas	pineapple
dứt	dihentikan	to cease
dừa	kelapa	coconut (n.)
dừng	berhenti	to cease
dữ	data	"(term should be ""giận dữ"") anger (n.)"
dự	diproyeksikan	attend
dựa	berdasarkan	base on
dực	laki-laki	dực, as in lê tương dực
dỹ	dỹ	dy
e	e	e.
ea	ea	(proper noun) ea, as in ea kao
earles	anting-anting	earles
eaton	makan	eaton
ebro	ebro	a name
ecmascript	ecmascript	ecmascript
ecw	ecw	ecw
edda	edda	(proper noun) edda
edgar	edgar	edgar, as in author edgar allan poe (n.)
edge	tepi	edge
edinburgh	edinburgh	(proper noun) edinburgh, as in edinburgh, scotland
edison	edison	edison
editor	editor	editor
edmond	edmond	edmond
edo	edo	edo
edward	edward	edward
edwin	edwin	edwin
eea	eea	eea
efron	efron	efron, as in zac efron
egypt	mesir	egypt
eid	lebaran	(proper noun) eid
eiffel	eiffel	eiffel
einstein	einstein	einstein
eisenhower	eisenhower	eisenhower, as in former president dwight d. eisenhower
ekaterina	ekaterina	this is a name
elbe	elbe	(proper noun) the elbe river
electronic	elektronik	electronic
eliane	eliane	(proper noun) eliane
elip	elips	ellipse
elizabeth	elizabeth	elizabeth
ellen	ellen	ellen
ellis	ellis	a name
elton	elton	(proper noun) elton, as in elton john
elvis	elvis	elvis
elíp	elips	ellipse
em	kamu	younger sibling
email	email	email
emily	emily	(proper noun) emily, as in emily dickinson
emir	emir	emir
emmy	emmy	emmy
en	id	erica reef
energy	energi	energy
engels	engels	engels
england	inggris	(proper noun) england, as in new england
eniac	eniac	eniac
entente	entente	entente
entropy	entropi	entropy
enzym	enzim	enzymes
eo	pinggang	eo, as in the film captain eo
ep	ep	a name
erich	erich	erich
erik	erik	erik, as in erik moller
eris	eris	eris
eritrea	eritrea	eritrea
ernest	ernest	(proper noun) ernest
eros	eros	eros, greek god of love
erwin	erwin	(proper noun) erwin, as in erwin rommel
españa	españa	espana
essential	penting	essential
ethernet	ethernet	ethernet
ethiopia	etiopia	(proper noun) ethiopia
euclid	euclid	euclid
eugene	eugene	eugene
eugène	eugène	(proper noun) eugène
euler	euler	euler
euro	euro	euro, as in the european currency
eurofighter	eurofighter	eurofighter
europe	eropa	europe
european	orang eropa	(proper adjective) european
eva	eva	eva
everton	everton	everton
every	setiap	every
exgay	exgay	exgay
explorer	penjelajah	explorer
extensive	luas	extensive
fabio	hebat	(proper noun) fabio
facebook	facebook	(proper noun) facebook
fact	fakta	fact
facto	fakto	this is french not vietnamese
faifo	faifo	(proper noun) faifo
fao	fao	fao
farrell	selamat tinggal	farrell
faso	faso	faso
fbi	fbi	fbi
fca	fca	fca
fdi	fdi	fdi
features	fitur	features
federer	federer	federer
feet	kaki	feet
felipe	felipe	felipe
felis	felis	(proper noun) felis
felix	felix	(proper noun) felix, as in felix klein
ferb	ferb	ferb
ferdinand	ferdinand	ferdinand
ferguson	ferguson	ferguson
fernando	fernando	fernando
ferrari	ferrari	ferrari
fiat	fiat	fiat
fidel	fidel	fidel
field	bidang	field
fifa	fifa	fifa
fifpro	fifpro	fifpro
figo	figo	figo
fiji	fiji	fiji
finish	selesai	finish
firefox	firefox	(proper noun) mozilla firefox
fischer	fischer	fischer, as in louis fischer
fish	ikan	fish
fishbed	fishbed	fishbed
fitzgerald	fitzgerald	(proper noun) fitzgerald
flanker	pematung	flanker
fleming	fleming	fleming
flight	penerbangan	flight
foch	foch	(proper noun) foch
focus	fokus	focus
foden	foden	(proper noun) foden, as in tom foden
fokker	fokker	fokker
food	makanan	food
football	sepak bola	bong da
forbes	forbes	(proper noun) forbes, as in the magazine
ford	ford	(proper noun) ford
fordham	fordham	(proper noun) fordham
forks	garpu	forks
foundation	pondasi	foundation
fox	rubah	fox
fpt	fpt	a company name in vietnam
fracsin	fracsin	a function
franc	franc	franc
france	france	france
frances	frances	frances
francis	francis	francis, as in francis xavier
francisco	francisco	francisco
franco	franco	franco
frank	jujur	frank
frankfurt	frankfurt	(proper noun) frankfurt
franklin	franklin	franklin
franz	franz	(proper noun) franz, as in franz ritter
freud	kebebasan	(proper noun) freud, as in sigmund freud
friedman	orang goreng	friedman
fu	fu	fu
fujiko	fujiko	fujiko, as in japanese writer fujiko fujio
fujimoto	fujimoto	fujimoto
fukuoka	fukuoka	fukuoka
funimation	funimation	(proper noun) funimation
funk	funk	funk
futsal	futsal	futsal
fx	fx	fx
ga	ga	station
gabon	gabon	gabon
gabriel	gabriel	gabriel
gabriella	gabriella	gabriella
gagarin	gagarin	gagarin
gaia	gaia	gaia
gaillard	gaillard	gaillard
galilei	galilei	galilei
galileo	galileo	galileo, the astronomer
gam	gram	gam
gambia	gambia	gambia
gamow	gamow	a name
gan	hati	liver
gandhi	gandhi	gandhi, as in mahatma gandhi
gang	geng	cast iron
ganh	cemburu	to be jealous
gao	gao	strictly
gareth	gareth	a name
garrett	garrett	garrett
gary	gary	gary
gascon	gascon	(proper noun) gascon, a dialect of france
gatt	gatt	gatt
gaule	gaule	gaul, a region in ancient western europe
gaulois	gaulois	gaulois
gay	gay	tense
gaza	gaza	gaza
gdańsk	gdańsk	(proper noun) gdansk, poland
gdp	gdp	gdp
geisha	geisha	geisha
gen	gen	gene
gene	gen	(proper noun) gene, an english first name
genesis	asal	(proper noun) genesis
georg	georg	(proper noun) georg
george	george	george
georges	georges	(proper noun) georges, a french name
gepard	gepard	gepard
ger	ger	ger
gerais	gerais	(proper noun) gerais
gerhard	gerhard	gerhard
german	jerman	german
germany	jerman	germany
gerrard	gerrard	gerrard, a last name
ghana	ghana	(proper noun) the african country of ghana
ghe	perahu	canoe
ghen	cemburu	to be jealous (v.)
ghi	tulis	write
ghim	pin	pin
ghé	berhenti	visit
ghép	graft	fit
ghê	menjijikkan	disgust
ghì	ghì	tighten
ghẻ	kudis	scabies (n.)
ghế	kursi	chair
ghề	jeram	scabby
ghềnh	jeram	waterfall (n.)
gia	gia	date
giai	panggung	period
giam	ditahan	imprison
gian	ruang	"(term should be ""thời gian"") time (n.)"
giang	giang	syphilis
gibraltar	gibraltar	(proper noun) gibraltar
gichin	gichin	gichin
gieo	tabur	sow
gifu	gifu	gifu, a district in northern japan
ginzan	ginzan	ginzan
gio	gio	wind
gioi	gioi	world
giuliani	giuliani	giuliani
giun	cacing	worm
giuse	giuse	giuse
giuộc	giuoc	"entire term should be ""can giuoc""; name of a vietnamese town"
giza	giza	giza
già	tua	old (adj.)
giàn	tiang penopang	"(term should be ""giàn hoa"") a trellis girder"
giành	menang	secure
giàu	kaya	rich or wealthy (adj.)
giày	sepatu	a shoe
giá	harga	estimate
giám	direktur	"(term should be ""giám sát"") to supervise (v.)"
gián	kecoak	"(term should be ""gián tiếp"") indirectly"
giây	detik	seconds
giã	berdebar	"(term should be ""từ giã"") to say farewell to (v.)"
giãn	meregangkan	stretch
gièm	pencela	"(should be ""gièm pha"") to backstab"
giêhôva	giva	jehovah
giêng	serupa	january
giêsu	yesus	jesus
giêxu	nexus	jesus
giò	lumpia	leg
giòi	belatung	maggot (n.)
giòn	renyah	crunchy or crispy (adj.)
gió	angin	wind
gióng	seperti	align
giúp	bantuan	help
giũa	file	sharpen
giơ	macet	raise
giương	menyala	posture
giường	tempat tidur	bed
giả	gadungan	fake (adj.)
giải	hadiah	solution
giảm	kurangi	decrease
giản	disederhanakan	"(term should be ""giản dị"") simple (adj.)"
giấc	tidur	giấc ngủ= the sleep
giấm	cuka	drabble
giấu	bersembunyi	hide
giấy	kertas	paper
giầu	kaya	rich
giận	marah	angry
giằng	menguatkan	pull
giặc	musuh	enemy
giặt	mencuci	to wash (n.)
giếng	sumur	well
giết	bunuh	kill
giềng	tetangga	"(term should be ""láng giềng"") neighboring"
giễu	ejekan	ridicule
giọng	aksen	tone
giọt	tetes	drop
giỏ	keranjang	basket
giỏi	bagus	good
giồng	giong	mound
giỗ	peringatan kematian	anniversaries of deaths
giới	jenis kelamin	gender
giờ	jam	bao giờ=ever
giở	flash	to open or unfold (v.)
giỡn	bercanda	joke
giục	mendesak	urge
giữ	tunggu sebentar	hold
giữa	antara	between
gladys	gladys	gladys
glazer	glazer	glazer
glonass	glonass	glonass
gloria	gloria	gloria
gloster	gloster	(proper noun) gloster, as in gloster meteor
glucose	glukosa	glucose
gmail	gmail	gmail
gnp	gnp	gnp
go	pergi	"(term should be ""gay go"") tense"
goes	pergi	goes
goku	goku	goku
golden	emas	golden
gom	kumpulkan	to gather (v.)
google	google	google
gorbachev	gorbachev	gorbachev
gorbachyov	gorbachyov	gorbachev, as in former soviet president mikhail gorbachev
gordon	gordon	gordon, as in gordon brown
gore	menanduk	gore
gorky	gorky	gorky, as in gorky park
gothic	gothic	gothic
gottfried	gottfried	gottfried
grabeel	ambil	grabeel, a last name
graham	graham	graham
granada	granada	granada
granit	granit	granite
greek	yunani	(proper noun) greek
greenland	tanah hijau	greenland
greenson	greenson	(proper noun) greenson
greenwich	greenwich	(proper noun) greenwich
greg	greg	greg
grenada	granada	grenada
grenadines	grenadines	grenadines
gross	kotor	gross
grumman	grumman	(proper noun) grumman
gruzia	georgia	gruzia
gryffindor	gryffindor	gryffindor
gs	gs	prof.
gsts	gsts	professor- phd
gu	gu	gu
guam	guam	guam
guard	penjaga	guard
guatemala	guatemala	guatemala
gui	gui	gui
guinea	guinea	guinea
guinness	guinness	(proper noun) guinness
guitar	gitar	guitar
gujarat	gujarat	gujarat
gulag	gulag	gulag
gulf	teluk	gulf
gullit	gullit	(proper noun) gullit
gundam	gundam	(proper noun) gundam
gunung	gunung	(proper noun) gunung
gustave	semangat	gustave
gutenberg	gutenberg	gutenberg
guyana	guyana	guyana; proper noun
gà	ayam	chicken
gài	menyelipkan	to fasten (v.)
gào	teriaknya	"(term should be ""thét gào"") to cry out (v.)"
gác	penjaga	guard
gái	perempuan	girl
gán	menugaskan	"entire phrase should be ""gan nhan""; means ""to label"""
gánh	beban	hold
gáy	tengkuk	crow
gân	tendon	tendon
gây	sebab	make
gãy	rusak	break
gì	apa	what
gìn	melestarikan	preserve
gò	gundukan	"(term should be ""gò má"") cheekbone (n.)"
gòn	gòn	gon
góa	janda	widowed
góc	sudut	angle
gói	paket	goi
góp	angsuran	to contribute
gót	tumit	heels
gõ	jenis	type
göbbels	göbbels	gobbels, as in joseph gobbels
găm	menimbun	poniard
găng	sarung tangan	gloves
gũi	tutup	close
gươm	pedang	sword
gương	cermin	mirror
gạc	kain kasa	johnson south reef
gạo	beras	rice
gạt	ditipu	to cheat or trick (v.)
gả	perkawinan	marry
gảy	dipetik	"(term should be ""âm gảy"") a type of phonetic sound found in the japanese language (n.)"
gấc	gac	gac
gấm	brokat	brocade
gấp	cepat	times, as in many times
gấu	beruang	a bear (n.)
gần	dekat	near
gầy	kurus	thin
gẫy	rusak	break
gập	lipat	"(term should be ""gập ghềnh"") bumpy (adj.)"
gậy	tongkat	stick
gắm	kentut	send
gắn	dipasang	mount
gắng	coba	try
gắt	dengan kasar	intense
gặm	mengunyah	rodent
gặp	bertemu	meet
gặt	menuai	harvest
gỉ	berkarat	rust
gọi	panggilan	call
gọn	rapi	neat (adj.)
gọng	berbingkai	gong
gọt	pengupas	cut
gỏi	salad	a vietnamese salad
gốc	root	origin (n.)
gối	bantal	"(should be ""qùy gối"") to kneel"
gốm	keramik	pottery
gồm	termasuk	include
gồng	gong	carry
gỗ	kayu	wood
gội	sampo	shampoo
gộp	dikumpulkan	aggregate
gớm	mengerikan	tremendous
gờ	langkan	edge
gởi	kirim	send
gỡ	turunkan	meet
gợi	sugestif	to evoke (v.)
gục	runtuh	"(term should be ""đánh gục"") crush, as in battle"
gừng	jahe	ginger
gửi	dikirim	send
ha	ha	hectare
habana	habana	(proper noun) habana
habsburg	habsburg	(proper noun) habsburg
haeberle	haeberle	haeberle
hahn	hahn	hahn
hai	dua	two (adj.)
hal	hal	hal
halle	halle	(proper noun) halle
halogen	halogen	halogen (n.)
ham	ham	desire
hamilton	hamilton	(proper noun) hamilton
han	han	han
hang	gua	cave
hangul	hangul	hangul
hanh	hanh	hanh
hanja	hanja	(proper noun) hanja, a type of chinese script
hansen	hanen	hasnen
hao	hao	"(term should be ""hao hụt"") to incur some loss (v.)"
harald	harald	harald
hardy	hardy	hardy
harlem	harlem	harlem
harlow	harlow	harlow
harold	harold	(proper noun) harold
harper	pemain harpa	harper
harpercollins	harpercollins	hapercollins
harrier	harrier	harrier, as in harrier jump jet
harris	harris	harris
harry	harry	harry
harvard	harvard	(proper noun) harvard, the name of a college
harvey	harvey	harvey
havana	havana	(proper noun) havana, cuba
havilland	havilland	havilland
hawker	jajanan	hawker
hawking	menjajakan	(proper noun) hawking, as in physicist stephen hawking
hay	bagus	or
hb	hb	hb
hbv	hbv	hbv
hcl	hcl	hcl
hd	hd	activity
he	dia	he, a korean name
health	kesehatan	health
heath	kesehatan	heath
hee	hee	hee
hegel	hegel	(proper noun) hegel, as in georg wilhelm friedrich hegel
heian	heian	heian
heinrich	heinrich	heinrich
helen	helen	helen
helena	helena	helena
heli	helium	helium
hematocrit	hematokrit	hematocrit
hemoglobin	hemoglobin	hemoglobin
hen	ayam	asthma
henry	henry	(proper noun) henry, as in henry kissinger
heo	babi	dolphin
her	dia	her
herbert	herbert	herbert, as in herbert schandler
hercegovina	hercegovina	hercegovina
hercules	hercules	hercules
hermann	hermann	hermann
hermes	hermes	hermes
hersh	miliknya	hersh, as in seymour hersh
hesiod	hesiod	hesiod
hestia	hestia	hestia
hi	hai	"(term should be ""hi vọng"") alternative spelling for ""hy vọng""; meaning ""hope"" (n.)"
hickam	hickam	(proper noun) hickam
hicks	udik	hicks
hideto	hideto	(proper noun) hideto
hideyoshi	hideyoshi	(proper noun) hideyoshi
hidro	hidrogen	hydrogen
hillsborough	hillsborough	hillsborough
hilton	hilton	hilton
himalaya	himalaya	(proper noun) himalaya
hinata	hinata	hinata
hindenburg	hindenburg	(proper noun) hindenburg
hindi	hindi	hindi
hindu	hindu	hindu, as in the hindu religion
hinh	hinh	(proper noun) a vietnamese first name
hinhtron	hinhtron	circle
hiragana	hiragana	hiragana
hiroshi	hiroshi	hiroshi
hiroshima	hiroshima	(proper noun) hiroshima, the japanese city
hitchcock	pasak	hitchcock
hitler	pembunuh	hitler
hitter	pemukul	hitter
hitters	pemukul	hitters
hiên	teras	(proper noun) hiên, a vietnamese first name
hiđrô	hidrogen	hydrogen
hiếm	jarang	rare
hiến	menyumbang	devote
hiếp	pemerkosaan	rape
hiếu	bakti	pious
hiềm	sakit	grudge
hiền	bijak	sage
hiểm	berbahaya	dangerous
hiểu	mengerti	learn
hiện	muncul	"(term should be ""thực hiện"") to accomplish"
hiệp	setengah	united
hiệu	efek	effective
hlv	pelatih	trainer
hms	hms	hms
hmông	hmong	hmong
hn	hn	hn
hoa	bunga	flower
hoan	festival	welcome
hogwarts	hogwarts	(proper noun) hogwarts, sorcery school from the harry potter series
hoi	hoi	rare
hokage	hokage	hokage
hokusai	hokusai	hokusai
holmes	holmes	a name
holocaust	holocaust	holocause
holocen	holocene	holocen
holt	holt	holt, an english last name
hom	stek	a cutting
homer	homer	(proper noun) homer, the authorof the iliad and the odyssey
hon	hon	"(term should be ""hòn"") rock (n.)"
honduras	honduras	honduras
hong	hong	hong
honolulu	honolulu	honolulu
honshū	honshu	honshu
hopkins	hopkins	(proper noun) hopkins
hornet	lebah	hornet
hotspur	hotspur	(proper noun) hotspur, as in tottenham hotspur
houston	houston	(proper noun) houston, as in whitney houston
howard	howard	(proper noun) howard
however	namun demikian	however
hoà	mengikat	peace
hoài	bernostalgia	always (adv.)
hoàn	lengkap	"(term should be ""hoàn toàn"") completely"
hoàng	kerajaan	royal (adj.)
hoành	diafragma	rife
hoá	kimia	"(term should be ""văn hoá"") culture (n.)"
hoán	perm	refined (adj.)
hoãn	untuk menunda	delay
hoạ	cat	disaster (tham hoa)
hoại	gangren	"(term should be ""phá hoại"") to sabotage (v.)"
hoạt	hentai	work
hoả	api	of
hoảng	panik	panic-stricken (adj.)
hoặc	atau	or
hp	hp	hp
hq	terbaik	hq
hudgens	hudgens	(proper noun) hudgens
hudson	hudson	hudson
huey	rona	huey
hughes	hughes	hughes
hugo	hugo	(proper noun) hugo
hume	hume	hume, as in david hume
hun	hun	(proper noun) hun
hungary	hungary	hungary
hunt	berburu	hunt
hurley	hurley	(proper noun) hurley, as in chad hurley
hussein	hussein	hussein
husserl	husserl	huserl
huston	huston	huston
hutech	hutech	hutech
huy	huy	a common vietnamese first name
huynh	saudara laki-laki	older brother
huyền	mistis	huyền thoại= legend
huyễn	ilusi	huyen
huyện	distrik	district
huyệt	titik akupunktur	lair
huân	huan	"(term should be ""huân chương"") medal (n.)"
huê	hue	"a less common vietnamese word for ""flower"""
huấn	pelatihan	"(term should be ""huận luyện"") to train (v.)"
huế	hue	hue
huệ	hue	favour
huống	kasing	situation
huỳnh	belerang	sulfur
huỷ	batalkan	destroy
hydra	hydra	hydra, a monster in greek mythology
hydro	hidrogen	hydrogen
hyperion	hyperion	hyperion
hà	ha	"(term should be ""hà nội"") the capital of vietnam"
hài	komedi	corpse
hàm	fungsi	"(term should be ""bao hàm"") to imply (v.)"
hàng	barang	row
hào	parit	depreciation
hách	sombong	glorious
hái	memetik	picking
hán	kekeringan	china
háo	bersemangat	eager
hát	bernyanyi	song
hâm	gila	"(term should be ""hâm mộ"") to admire (v.)"
hân	han	le ngoc han
hãi	takut	to be scared (v.)
hãn	khan	to sweat (v.)
hãng	tegas	a company (n.)
hãnh	bangga	proud
hè	musim panas	summer
hé	pecah	reveal
héo	layu	dried-out
hét	teriak	shout
hên	beruntung	luck
hí	ne	game
hít	mengendus	act of kissing (hon hit)
hò	kencan	date
hòa	mengikat	republic
hòe	sial	hoe
hòm	bahtera	box
hòn	pulau	island
hòng	yah	in order to
hóc	hóc	a corner (n.)
hót	bernyanyi	to chirp or sing (v.)
hô	ho	respiration
hôi	busuk	stink
hôm	hari	day (n.)
hôn	cium	propose
hông	pinggul	hip
hù	menakuti	threaten
hùng	pahlawan	hero
húc	menyeruduk	huc
húng	kemangi	"(should be ""húng láng"") water mint"
hút	merokok	to suck (v.)
hăng	pedas	enthusiasm
hđbt	hđbt	hdbt
hđh	hđh	system software
hũ	guci	jar
hơi	sedikit	slightly
hơn	lebih lanjut	more or less
hư	nakal	fictional
hưu	pensiun	huu
hương	dupa	smell
hước	lucu	humor
hướng	arah	trend
hường	huong	huong
hưởng	nikmati	influence
hạ	lebih rendah	lower
hạc	crane	crane
hạch	ganglion	ganglion
hại	salahnya	harm
hạng	peringkat	rank
hạnh	hanh	happy
hạo	hai	hao
hạp	hap	hap
hạt	manik-manik	seed
hải	bea cukai	two
hảo	sempurna	perfect
hấn	han	aggressive gesture
hất	melemparkan	toss
hấu	semangka	"(term should be ""dưa hấu"") watermelon"
hầm	sup	ham
hầu	hampir	most
hận	benci	hatred
hậu	hau	anus
hắc	gelap	black
hắn	dia	he (n.)
hắt	bersin	reject
hằng	konstan	every
hặc	hặc	to criticize (v.)
hẹ	bawang merah	chinese chives
hẹp	sempit	narrow
hẻm	gang	alley (n.)
hẻo	terpencil	outback
hến	kerang	mussel
hết	selesai	most
hề	badut	"(term should be ""không hề"") never"
hễ	eh	whenever
hệ	sistem	relation
hệt	identik	exactly
hỉ	hai	happy
hịch	gedebuk	a proclamation
họ	mereka	they (n.)
họa	seni	picture
họach	rencana	"(term should be ""quy hoạch"") a project (n.)"
học	belajar	study (v.)
họng	tenggorokan	throat
họp	pertemuan	meet
hỏa	api	fire
hỏng	rusak	corruption
hố	lubang	hole
hốc	ceruk	cavity
hồ	danau	ho
hồi	adas manis	muslim
hồn	jiwa	soul
hổ	harimau	tiger
hổi	hah	"(term should be ""nóng hổi"") steaming hot (adj.)"
hổng	menganga	hole
hỗ	dukungan	"(should be ""hỗ trợ"") to support or assist"
hỗn	dicampur	"(term should be ""hỗn tạp"") mish-mash (adj.)"
hội	majelis	society
hộp	kotak	box
hới	buka	hoi
hớn	teriak	"(term should be ""hớn hở"") radiant (adj.)"
hờn	merajuk	hatred
hở	buka	reveal
hỡi	oi	dear
hợi	babi	pig (n.)
hợp	cocok	appropriate
hợpquận	persetujuan	general district
hụt	terjawab	loss
hủi	penderita kusta	reject
hủy	batalkan	to erase or destroy
hứa	janji	promise
hử	ya	hu
hửu	ya	"(term should be ""sở hửu"") to own (v.)"
hữu	properti	(proper noun) hữu, a vietnamese middle name; also means right, as in the direction
hựu	huu	again
hỷ	hy	hy
ian	ian	ian, as in australian swimmer ian thorpe
iau	iau	iau
iberia	iberia	iberia
ibm	ibm	(proper noun) ibm, the computer company
ibmpc	ibmpc	ibm-pc
ic	ic	ic
icc	icc	icc
iceland	islandia	(proper noun) the country of iceland
ide	ide	ide
ieng	ieng	(proper noun) ieng
igor	igor	igor
iii	iii	third
ilene	ilene	ilence
illusion	ilusi	illusion
ilyich	ilyich	ilyich
im	saya	still
imam	imam	(proper noun) imam
imbrium	imbrium	imbriun
immanuel	imanuel	(proper noun) immanuel, as in immanuel kant
impact	dampak	impact
incoterm	incoterm	incoterm
incoterms	incoterms	(proper noun) incoterms
indian	india	indian
indiana	indiana	indiana
indochina	indochina	indochina
indonesia	indonesia	indonesia
indrapura	indrapura	(proper noun) indrapura
info	info	info
innsbruck	losmen	innsbruck
insulin	insulin	insulin
int	int	int
intel	intel	(proper noun) intel, as in the name of the company
interpol	interpol	interpol
inu	inu	(proper noun) inu
inuyasha	inuyasha	inuyasha
inư	inu	(proper noun) inư
io	io	io
ioc	ioc	ioc
ion	ion	ion
iosif	iosif	(proper noun) iosif, as in iosif vissarionovich stalin
iran	iran	the nation of iran
iraq	irak	iraq
ireland	irlandia	ireland
irgun	irgun	irgun
irony	ironi	irony
irving	irving	(proper noun) irving
isaac	isaac	isaac
isla	isla	isla
islam	islam	islam
islamabad	islamabad	(proper noun) islamabad
israeli	israeli	israeli
istanbul	istanbul	istabbul
italia	italia	italy
italiano	italiano	(proper noun) italiano
itanium	itanium	itanium, as in windows xp itanium
ito	ito	ito
itsukushima	itsukushima	itsukushima
itu	itu	itu
itzá	itza	(proper noun) itzá
iv	iv	4 ( greek number)
iwami	iwami	iwami
j	j	j
jack	jack	jack
jackie	jackie	(proper noun) jackie chan
jackson	jackson	(proper noun) jackson, as in michael jackson
jacob	jacobs	jacob
jae	jae	jae
jakarta	jakarta	(proper noun) jakarta
jan	jan	(proper noun) jan
janeiro	janeiro	janeiro
janet	janet	janet
japan	jepang	japan
jared	jared	jared
jarvis	jarvis	(proper noun) jarvis, as in jarvis cocker
jasper	jasper	(proper noun) jasper
jean	jean	jean
jeane	jeane	jeane
jeanjacques	jeanjacques	jean-jacques
jeanpaul	jeanpaul	jeanpaul
jeans	jins	jeans
jeet	jeet	(proper noun) jeet, as in jeet kune do
jeff	jeff	jeff, as in jeff drake
jefferson	jefferson	jefferson
jeffrey	jeffrey	jeffrey
jeju	jeju	jeju
jenda	jenda	jenda
jenny	jenny	jenny
jericho	jericho	jericho, as in wrestler chris jericho
jerome	jerome	jerome, as in fred jerome
jerry	jerry	(proper noun) jerry
jersey	jersey	jersey
jerusalem	jerusalem	jerusalem
jesse	jesse	a name
jesus	yesus	chua jesus
jetstar	jetstar	jetstar
jewish	yahudi	jewish
jiao	jiao	jiao
jimmy	jimmy	jimmy
jin	jin	jin
jing	jing	jing
jiraiya	jiraiya	(proper noun) jiraiya
joachim	joachim	joachin
joan	joan	a name
joe	joe	(proper noun) joe
johan	johan	johan
johann	johann	johann
johannes	johannes	johannes
johannesburg	johannesburg	(proper noun) johannesburg, south africa
johnny	johnny	johnny
johns	hidung belang	johns
johnston	johnston	johnston, as in harry johnston
johor	johor	johor
joint	bersama	joint
jonathan	jonathan	(proper noun) jonathan
jones	jones	jones
jose	jose	(proper noun) jose, a spanish first name
joseon	joseon	(proper noun) joseon
joseph	joseph	joseph
jscript	jscript	(proper noun) jscript
juche	juche	(proper noun) juche
judith	judith	judith
judo	judo	judo, the martial art
julesverne	julesverne	jules verne
julliard	julliard	(proper noun) julliard
jump	lompat	jump
june	juni	june, as in the month
jung	hutan	jung
junsu	junsu	junsu
jupiter	jupiter	(proper noun) jupiter, as in the planet
jura	jura	(proper noun) jura
juventus	juventus	juventus
k	k	k
kaede	kaede	a japanese name
kaffee	kaffee	(proper noun) kaffee, as in kaffee hag
kagome	kagome	kagome, as in higurashi kagome
kahn	kahn	kahn
kai	kai	kai
kakashi	kakashi	kakashi
kaká	kaká	(proper noun) kaka, a brazilian soccer player
kalashnikov	kalashnikov	(proper noun) kalashnikov
kali	potasium	potassium
kama	kama	(proper noun) kama, as in the kama sutra
kamakura	kamakura	kamakura
kamov	kamov	kamov
kampf	kampf	kampf
kampong	kampung	kampong
kampuchea	kampuchea	cambodian
kana	kana	kana, the japanese phonetic alphabet
kangin	kangin	(proper noun) kangin
kanji	kanji	kanji
kant	kant	a name
kar	kar	(proper noun) kar
kara	kara	kara
karaoke	karaoke	karaoke
karate	karate	karate
karatedo	karatedo	karatedo
karen	karen	(proper noun) karen
karim	karim	(proper noun) karim
kashmir	kashmir	kashmir
kaspersky	kaspersky	(proper noun) kaspersky, as in kaspersky anti-virus software
katakana	katakana	katakana, a type of japanese script
kate	kate	(proper noun) kate, as in actress kate winslet
katherine	katherine	katherine
kathmandu	kathmandu	kathmandu
katrina	katrina	(proper noun) katrina, as in hurricane katrina
katz	katz	katz
kauthara	kauthara	kauthara, a part of the ancient kingdom of champa
kavkaz	kaukasus	kavkaz
kawasaki	kawasaki	(proper noun) kawasaki
kay	kay	kay
kazan	kazan	kazan, the name of a city
kcn	kcn	industrial zone
ke	ke	"(term should be ""boong ke"") a bunker (n.)"
kelly	kelly	kelly
kelsi	kelsi	kelsi
kelvin	kelvin	kelvin
kem	es krim	ice cream (n.)
ken	ken	ken
kennedy	kennedy	(proper noun) kennedy, as in john f. kennedy
kenneth	kenneth	(proper noun) kenneth, a name
kenny	kenny	kenny, an english first name
kentucky	kentucky	(proper noun) kentucky
kepler	kepler	kepler
kerala	kerala	(proper noun) kerala
kevin	kevin	kenvin
keynes	keynes	keynes, as in economist john maynard keynes
kg	kg	kilogram
kha	kha	(proper noun) a vietnamese first name
khai	deklarasi	announce
khali	khali	(proper noun) khali
khalip	khalip	(proper noun) khalip
kham	kham	endure
khan	anhidrat	rare
khang	khang	khang
khanh	khanh	khanh
khao	kerinduan	desire
khay	nampan	tray
khe	slot	chink
khem	khem	abstinence
khen	pujian	praise
kheo	di atas panggung	kheo
khi	kapan	when
khieu	khieu	(proper noun) khieu, as in khieu samphan
khiêm	sederhana	khiem
khiên	perisai	a shield
khiêu	erotis	"('khiêu dâm"") pornographic"
khiếm	terganggu	lack
khiến	sebab	control
khiếp	ketakutan	horrible
khiếu	menginap	talent (n.)
khiển	kontrol	control
khleang	khleang	kh'leang
kho	gudang	warehouse
khoa	fakultas	"(term should be ""y khoa"") the study of medicine (n.)"
khoan	bor	drill
khoang	rongga	brag
khoanh	berdering	a slice (n.)
khoe	pamer	to boast
khoá	mengunci	lock
khoác	mantel	coat
khoán	stok	stock
khoáng	mineral	mineral
khoát	pasti	decisive
khoét	potong	carve
khoăn	resah	disturbed
khoả	telanjang	naked
khoản	barang	an item (n.)
khoảng	sekitar	about
khoảnh	momen	moment
khoẻ	baiklah	health
khrushchev	khrushchev	khrushchev
khrushchyov	khrushchyov	khrushchyov
khu	tempat tinggal	section
khung	bingkai	frame
khural	khural	khural
khuynh	kiri	trend
khuyên	saran	advise
khuyết	rusak	lack
khuyển	anjing	khuyen
khuất	disembunyikan	hidden
khuấy	aduk	stir
khuẩn	bakteri	bacteria
khuếch	memperkuat	amplification
khuỷu	siku	elbow
khá	cantik	quite
khác	lainnya	different
khách	tamu	customer
khái	konseptual	concept
khám	pemeriksaan	discover
khán	penonton	audience
kháng	resistensi	appeal
khánh	kemandirian	a type of chime made of stone (n.)
khát	haus	to be thirsty for (adj.)
khâm	khâm	admire
khèn	sayang	a pan-pipe (n.)
khéo	cerdik	cleverly or skillfully (adv.)
khép	ditutup	close
khía	takik	"(term should be ""khía cạnh"") angle (n.)"
khích	dorongan	encourage
khít	kencang	close
khó	sulit	difficulty
khóa	mengunci	a session
khóc	menangis	cry
khói	merokok	smoke
khóm	nanas	a cluster
khô	kering	dry
khôn	bijaksana	clever, intelligent
không	tidak	not
khúc	lagu	song
khăm	gurauan	nasty (adj.)
khăn	handuk	difficult
khơi	lepas pantai	sea
khư	khư	grip
khưu	khưu	khuu
khước	tolak	waive
khả	kemungkinan	"(term should be ""khả năng"") ability (n.)"
khải	wahyu	triumph
khảm	mosaik	to encrust
khảo	pemeriksaan	"(term should be ""tham khảo"") to consult (v.)"
khấm	menusuk	endure
khấn	berdoa	pray
khấu	diskon	"(term should be ""sân khấu"") a stage (n.)"
khẩn	mendesak	"(term should be ""khẩn cấp"") urgent (adj.)"
khắc	ukiran	moment
khắp	semuanya	all over
khẳng	afirmatif	"(term should be ""khẳng định"") to assert (v.)"
khế	belimbing	bond
khỉ	monyet	monkey or ape (n.)
khỏa	telanjang	nude
khỏe	baiklah	health
khỏi	keluar dari	leave
khố	cawat	loincloths
khốc	mengerikan	devastating
khối	blokir	a block or mass of (n.)
khốn	bajingan	miserable
khống	khong	control
khổ	menderita	miserable (adj.)
khổng	raksasa	huge
khởi	inisiat	start
khủng	mengerikan	"(term should be ""khủng bố"") terrorist (n.)"
khủyu	bajingan	elbow
khứu	pastel	olfactory
khử	menghilangkan	reduction
ki	ki	"entire phrase is ""ki lo""; means ""kilometer"""
kia	disana	other
kid	nak	kid
kiel	kiel	(proper noun) kiel
kierkegaard	kierkegaard	kierkegaard, as in soren kierkegaard
kiernan	kiernan	kiernan
kii	kii	kii
kikyo	kikyo	kikyo
kilômét	kilometer	kilometer
kim	jarum	kim
kingdom	kerajaan	kingdom
kinsey	kinsey	kisney
kiribati	kiribati	kiribati
kishimoto	kishimoto	(proper noun) kishimoto
kiss	cium	kiss
kissinger	pencium	kissinger
kitts	kitt	kitts
kitô	kristus	christian
kiêm	cum	cum
kiên	sabar	consistent
kiêng	abstain	abstinence, as in abstaining from eating
kiêu	sombong	showy
kiếp	seumur hidup	a lifetime (n.)
kiết	belenggu	cheap (adj.)
kiềm	basa	"(term should be ""kiềm chế"") to restrain (v.)"
kiểm	periksa	control
kiểu	jenis	type
kiệm	ekonomis	save
kiện	sue	event (su kien)
kiệt	karya agung	exhausted (adv.)
kiệu	tandu	scallion
klaus	klaus	klaus
klein	klein	klein
km	km	kilometer
knesset	knesset	knesset
knuth	knuth	knuth, as in donald knuth
koch	koch	koch
kodansha	kodansha	kodansha
kofun	kofun	kofun, as in the kofun period of japanese history
kogoro	kogoro	kogoro
komodo	komodo	komodo
kon	kon	"(term should be ""kon tum"") a province in the highlands of vietnam"
kong	kong	(proper noun) kong, as in hong kong
konstantin	konstantin	(proper noun) konstantin
konversationslexikon	konversationslexikon	konversation-lexikon
kop	kop	kop
koran	koran	koran
kornai	kornai	(proper noun) kornai, as in janos kornai
koruna	koruna	koruna
kosovo	kosovo	(proper noun) kosovo
kremli	kremli	kremil
kremlin	kremlin	kremlin
kristen	kristen	kristen
krông	krong	krong
ku	ku	is a name
kuala	kuala	(proper noun) kuala, as in kuala lumpur
kubrick	kubrick	kubrick
kuen	kuen	kuen
kuiper	kuiper	(proper noun) kuiper, as in the kuiper belt
kulak	kulak	kulak
kune	kune	(proper noun) kune, as in the martial art jeet kune do
kung	kung	danh vo
kungfu	kungfu	kung fu
kunst	kunst	kunst, as in richard kunst
kurd	kurd	kurd
kurt	kurt	(proper noun) kurt
kuwait	kuwait	kuwait, the country (n.)
kwan	kwan	kwan
kwen	kwen	kwen
kwon	kwon	kwon, as in tae kwon do; proper noun
kyrgyzstan	kyrinkistan	(proper noun) the country of kyrgyzstan
kyushu	kyushu	kyushu
kyūshū	kyūshū	kyushu, a japanese island
kèm	tertutup	included
kèn	terompet	horn
kém	miskin	less
kén	kepompong	selective
kéo	tarik	scissors
kép	ganda	dual
két	aman	"(term should be ""rốc két"") rocket (n.)"
kê	millet	statistics
kênh	saluran	channel
kêu	teriak	appeal
kìa	lihatlah	that
kìm	tang	bar
kình	kacamata	rivalry
kí	tanda	sign
kích	klik	excite
kíchbom	tombol klik	bombers
kín	pribadi	secretive or closed tight (adj.)
kính	gelas	respect
kíp	kru	esoterica
kít	kit	wheelbarrow
ký	ditandatangani	"(""nhật ký"") a diary"
kĩ	hati-hati	technique
kơnia	kia	a tree found in southeast asia; sometimes called wild mango
kạn	kan	kan
kẹo	permen	candy
kẹp	penjepit	to clamp down (v.)
kẹt	macet	jam
kẻ	teman-teman	guy
kẻo	jangan sampai	lest
kẽ	pengantara	crevice
kẽm	seng	zinc
kế	selanjutnya	a scheme (n.)
kết	akhir	combine
kề	berdekatan	adjacent
kềnh	besar	bulky
kệ	rak	ignore
kỉ	abad	"(term should be ""kỉ niệm"") souvenir (n.)"
kị	kavaleri	ki
kịp	tepat waktu	kip
kỵ	kavaleri	taboo
kỷ	abad	"(term should be ""thế kỷ"") century (n.)"
l	l	l.
label	label	label
laboulaye	laboulaye	a name
ladakh	ladakh	(proper noun) ladakh
lai	hibrida	"(term should be ""tương lai"") the future (n.)"
lam	lam	lam
lama	lama	a name
lan	lan	a name
land	tanah	land
landon	landon	a name
lang	lang	lang
langdon	langdon	langdon
lange	lange	lange, as in oscar lange
langue	lesu	langue
lanh	linen	ringing
lanka	lanka	(proper noun) lanka, as in the island of sri lanka
lao	tb	labor
laos	laos	(proper noun) laos
lap	pangkuan	greek
larry	larry	larry
lars	lars	lars
las	las	(proper noun) las, as in las vegas
laser	laser	laser
lateran	lateran	lateran
latinh	latin	latin
latvia	latvia	(proper noun) latvia
lau	bersihkan	lau
laura	laura	(proper noun) laura, as in laura bush
laurence	laurence	(proper noun) laurence
lawrence	lawrence	(proper noun) lawrence
lay	berbaring	lay
lazarus	lazarus	(proper noun) lazarus
leach	pelindian	(proper noun) leach
leaf	daun	leaf
leave	pergi	leave
lebanon	lebanon	(proper noun) lebanon
lee	lee	lee
legacy	warisan	legacy
leiden	leiden	leiden
lem	lem	cinderella
lenin	lenin	lenin
lenins	lenin	lenin's
leo	memanjat	climb
leon	leon	leon
leonard	leonard	leonard
leonardo	leonardo	(proper noun) leonardo, as in leonardo da vinci
leonid	leonid	leonid
les	les	les
leslie	leslie	a name
lesotho	lesotho	lesotho
lg	lg	lg
lhp	lhp	film festival
lhq	lhq	un
libby	libby	(proper noun) libby
libero	libero	libero
libya	libya	libya
lido	lido	lido
liechtenstein	liechtenstein	liechtenstein
liga	liga	a name
lightning	kilat	lightning
lilly	lilly	(proper noun) lilly
linga	lingga	linga
linh	linh	efficacious (adj.)
links	tautan	links
linux	linux	linux server
lionel	lionel	lionel
lisboa	lisboa	lisboa
lisbon	lisbon	a name
litva	lithuania	(proper noun) lithuania
liu	liu	liu
liêm	integritas	good example
liên	usaha	relate
liêng	suci	sacred
liêu	birokrasi	bureaucracy
liềm	sabit	sickle
liều	dosis	daring
liễu	willow	a willow tree (n.)
liệng	lempar	"(term should be ""cánh liệng"") the aileron of a plane (n.)"
liệt	kelumpuhan	impotent
liệu	mentah	document
lleyton	lleyton	lleyton
lo	lihat	to worry (v.)
loa	pembicara	"(term should be ""cổ loa"") an ancient vietnamese city (proper noun)"
loaita	loaita	loaita
loang	licin	patchy
loch	loch	loch
locke	terkunci	(proper noun) locke, as in philosopher john locke
lockheed	lockheed	(proper noun) lockheed, as in lockheed martin
log	log	log
logan	logan	a name
lon	kaleng	lon
london	london	london
long	panjang	dragon
lorenzo	lorenzo	lorenzo
los	los	los, as in los angeles
louis	louis	louis
louisiana	louisiana	(proper noun) the state of louisiana
louvre	kisi-kisi	(proper noun) louvre
love	cinta	yeu
loài	spesies	species
loát	mencolok	overturn
loãng	kurus	wishy-washy
loét	bisul	gaping, as in a wound
loại	jenis	type
loạianh	jenis	not a word
loạianime	ketik anime	type anime
loạibệnh	jenis penyakit	disease
loạichiến	jenis	loaichien
loạicác	jenis	item
loạicâu	jenis	type: club
loạicông	jenis	type: industry
loạicựu	jenis	kind former
loạigia	jenis	loaigia
loạihuân	kindhuan	not a word
loạiluật	jenis hukum	type: law
loạimáy	jenis mesin	kind plane
loạimôn	jenis	type
loạingày	ketik ini	loaingay
loạiphim	jenis film	type movie
loạiphong	jenis	kind of movement
loạiscandal	skandal perang	scandal type
loạithuật	jenis hukum	type: lexicon
loạithành	jenis	kinds of payment
loạithần	jenis	kind myth
loạitrường	jenis sekolah	type of school
loạitín	baik	type: belief
loạitổ	jenis	kind organization
loạivõ	jenis tipe	type: martial art
loạixã	jenis	kind of society
loạn	gangguan	disorderly
loạt	seri	series
lp	lp	lp
lu	lu	dim
luang	luang	a name
lucas	lucas	(proper noun) lucas
lucia	lucia	lucia, as in the island of saint lucia
luciano	luciano	luciano
ludendorff	ludendorff	luđenorff
ludovico	ludovico	ludovico
ludwig	ludwig	ludwig
lui	kembali	withdrawal
luis	luis	(proper noun) luis, a first name
luiz	luiz	luiz
lula	lula	lula
lung	paru-paru	shake
lustig	lustig	lusig
luther	luther	luther
luxembourg	luxembourg	a name
luy	luy	luy
luyến	lampiran	love
luyện	latihan	training
luận	komentar	"(term should be ""xã luận"") an editorial"
luật	hukum	law
luồn	berulir	wriggle
luồng	aliran	lane
luộc	direbus	boiled
luỹ	kumulatif	rampart (n.)
ly	ly	divorce
lydia	lydia	lydia
lympho	limfoma	lymphocyte
lyndon	lyndon	lyndon
lyon	lyon	lyon
là	adalah	the verb to be
làm	lakukan	make
làn	jalur	wave
làng	desa	village
lành	disembuhkan	protestant
lào	laos	laos
lá	pergi	"(term should be ""lá thư"") a letter (n.)"
lác	juling	brag
lách	limpa	to swerve (v.)
lái	berkendara	to drive (v.)
lán	gubuk	shack
láng	halus	neighbours
lâm	lam	lâm, a common vietnamese first name
lân	unicorn	nearby
lâu	panjang	long time
lây	menular	to infect
lãi	bunga	a profit
lãm	menunjukkan	exhibition
lãnh	diterima	to receive
lão	tua	old
lèo	aku	"(term should be ""nước lèo"") broth (n.)"
lén	menyelinap	sneak
lê	pir	le
lêmạc	cahaya	"(term should be ""lê-mạc"") a war between two ruling families in ancient vietnamese history"
lên	naik	on
lênh	perintah	"(should be ""lênh đênh"") adrift"
lênin	lenin	lenin
lìa	pergi	to leave (v.)
lình	tiba-tiba	suddenly
lí	penyimpanan	reason
lính	prajurit	soldier
lít	liter	litre
líu	coo	"(term should be ""dính líu"") to have a connection with"
lò	tungku	release
lòng	menghancurkan	heart
lóc	kepala ular	cry
lóe	melintas	flash
lóng	gaul	"entire term should be ""tieng long""; means ""slang"""
lót	lapisan	undies
lô	banyak	batch
lôi	kesalahan	encourage
lôn	lol	"(term should be ""côn lôn"") a village in vietnam"
lông	bulu	hair
lõi	inti	core
lõm	cekung	concave
lùi	mundur	back
lùn	katai	dwarf
lùng	berburu	hunt
lúa	beras	rice
lúc	di	at the moment
lún	subsidensi	subside
lúng	menyala	confused
lúp	pembesar	uneven
lút	licik	surreptitiously
lăm	lima	tens
lăn	bergulir	attack
lăng	makam	tomb
lĩnh	domain	"(term should be ""thủ lĩnh"") the leader (n.)"
lũ	banjir	a band or gang (n.)
lũng	lembah	valley
lũy	kumulatif	rampart
lơ	lalai	to ignore
lơi	kendurkan	"(term should be ""lả lơi"") to act in a familiar or flirting manner (adv.)"
lư	pedupaan	an urn
lưng	kembali	back
lươn	belut	eel
lương	gaji	conscience
lưới	kisi	a net (n.)
lướt	berselancar	ski
lười	malas	lazy
lưỡi	lidah	tongue
lưỡng	biseksual	"(term should be ""lưỡng tính"") bisexual"
lược	sisir	invasion
lượm	ambil	pick up
lượn	meluncur	to glide over (v.)
lǐ	aku	(proper noun) li, as in jet li
lạ	aneh	strange or unusual (adj.)
lạc	hilang	camel
lạch	sungai kecil	"(term should be ""luồng lạch"") a narrow water passageway"
lại	lagi	reversed
lạn	busuk	bright
lạng	lang	lang
lạp	sosis	"(term should be ""hy lạp"") greek"
lạtma	lamma	lama
lạy	bersujud	kowtow
lấn	perambahan	to encroach on (v.)
lấp	isi	sparkle
lấy	diambil	taken
lầm	salah	wrong
lần	kali	time
lầu	lantai	a story or level of a building (n.)
lầy	berawa	swamp
lẩu	hotpot	hotpot
lẩy	lompat	get
lẫn	bingung	each other
lẫy	cubit	illustrious
lận	menipu	fraudulent
lật	flip	turn
lậy	oh ya	"(term should be ""cai lậy"") the name of a rural district"
lắc	kocok	to shake (v.)
lắm	sangat	do
lắng	untuk menyelesaikan	"(should be ""lo lắ́́ng"") to worry"
lắp	pas	lap
lặng	diam	quiet
lặp	ulangi	repeat
lặt	bermacam-macam	means miscellaneous, part of the word lat vat
lẹ	cepat	quickly (adv.)
lẻ	aneh	"(the term should be ""bán lẻ"") retail"
lẻn	menyelinap	sneak
lẻo	lemah	climb
lề	margin	alignment
lều	tenda	tent
lễ	upacara	ceremony
lệ	nilai	"(term should be ""tỷ lệ"") probability (n.)"
lệch	condong	difference
lệnh	perintah	command
lị	disentri	"(term should be ""tỉnh lị"") a township (n.)"
lịch	kalender	history
lọc	filter	tricked
lọi	juling	brilliant
lọng	payung	rope
lọt	jatuh	enter
lỏi	serat	to enter
lỏng	longgar	loose
lố	selesai	ridiculous
lốc	angin puyuh	tornado
lối	pintu masuk	way or path
lốp	ban	tyre
lốt	kedok	lolot
lồ	raksasa	giant
lồi	cembung	convex
lồng	kandang	cage
lỗ	lubang	hole
lộc	keberuntungan	loc
lội	menyeberang	wade
lộn	membalik	wrong/mistake
lộng	cantik	"(term should be ""cổ lộng"") the name of a vietnamese city"
lột	mengupas	exploit
lớn	besar	large
lớp	kelas	grade (n.)
lờ	abaikan	turbid
lời	kata	advice
lở	luka	to crack
lỡ	kangen	miss
lợi	manfaat	benefit
lợn	babi	pig
lợp	atap	roof
lụa	sutra	silk
lục	hijau	record
lụi	terbakar	ruin
lụt	banjir	flood
lụy	implikasi	consequence
lứa	sampah	peer
lừa	trik	mislead
lừng	termasyhur	well-known
lửng	luak	lơ lửng= not clear/ something in between
lự	ragu-ragu	reluctant
lựa	dipilih	chosen
lựu	delima	grenade
ma	hantu	ma sat (friction), ma thuat (magic), thay ma (zombie)
maastricht	maastricht	maastricht
macarthur	makarthur	macarthur
macclesfield	macclesfield	macclesfield
macedonia	makedonia	(proper noun) macedonia
mach	mach	mach
machiavelli	machiavelli	machiavelli, as in philosopher niccolo machiavelli
machu	machu	machu
macintosh	macintosh	macintosh
macma	magma	magma
macromedia	macromedia	macromedia
madeira	madeira	madeira
madhouse	rumah gila	madhouse
madison	madison	madison
madonna	madonna	(proper noun) madonna
madrid	madrid	madrid, as in the capital of spain
mafia	mafia	mafia
magiê	magnesium	magnesium
mahal	mahal	(proper noun) mahal, as in the taj mahal
mai	besok	"(term should be ""giang mai"") the disease syphilis (n.)"
mainframe	mainframe	mainframe
major	mayor	major
makemake	membuat	makemake
malacca	malaka	malacca
malay	melayu	malaysia
malaysia	malaysia	(proper noun) the country of malaysia
malcolm	malcolm	malcolm
maldini	maldini	maldini
mali	mali	mai
malta	malta	malta
maluku	maluku	maluku
manche	manche	manche
manchester	manchester	manchester
mandela	mandela	mandela, as in nelson mandela
mandy	mandy	mandy
mang	bantalan	to bring (v.)
manga	manga	manga
mangnall	mangnall	(proper noun) mangnall, as in ernest mangnall
manh	manh	fragile
manila	manila	manila, the capital of the philippines
mankiw	mankiw	mankiw, as in gregory mankiw
manti	manti	mantle
manuel	manuel	manuel
mao	mao	capillary
maps	peta	maps
maradona	maradona	(proper noun) maradona, as in soccer player diego maradona of argentina
marat	marat	(proper noun) marat, as in marat safin, a tennis player
marc	marc	marc, as in marc chagall
marcel	marcel	(proper noun) marcel, a french name
marcos	marcos	(proper noun) marcos, as in ferdinand marcos
marcus	marcus	marcus, as in marcus aurelius (n.)
margaret	margaret	(proper noun) margaret
maria	maria	(proper noun) maria
marianne	marianne	(proper noun) marianne
marie	marie	marie
marina	marina	marina
marino	marino	marino
marić	marić	maric
marmara	marmara	(proper noun) marmara, as in the sea of marmara
marne	marne	marne, as in the marne river (n.)
mars	mars	mars
marseille	marseille	marseille
marshall	marshall	marshall
marsu	marsu	(proper noun) marsu
marta	marta	(proper noun) marta, as in the female brazilian soccer player
martin	martin	martin
marx	marx	this is a name
mary	mary	(proper noun) mary
maryland	maryland	a name
maría	maría	maria
mas	mas	mas
massachusetts	massachusetts	massachusetts
mat	mat	mat
mathematica	mathatica	(proper noun) mathematica, as in isaac newton's work, principia mathematica
mats	tikar	mats, as in mats sundin
matthias	matthias	matthias, as in matthias erzberger
mau	dengan cepat	fast
maurice	maurice	(proper noun) maurice
mausolus	mausolus	mausolus
maxim	pepatah	a name
may	menjahit	lucky
maya	maya	(proper noun) maya
mcafee	mcafee	(proper noun) mcafee
mccain	mcain	mccain
mccartney	mccartney	a name
mccullough	mullullough	mccullough
mcdonald	mcdonald	(proper noun) mcdonald
mchc	mchc	mchc
mclaren	mclaren	mclaren
mcmahon	mcmahon	(proper noun) mcmahon
mcnamara	mcnamara	(proper noun) mcnamara, as in robert mcnamara
mcv	mcv	mean corpuscular volume
media	media	media
medici	medici	(proper noun) medici, as in the medici family of italy
medina	medina	(proper noun) medina, as in ernest medina
medvedev	medvedev	medvedev
mekong	mekong	mekong
melbourne	melbourne	melbourne
mendeleev	mendeleev	mendeleev
menes	mens	(proper noun) menes
mercedes	mercedes	a name
messenger	kurir	messanger
messerschmitt	messerschmitt	messerschmitt, as in the messerschmitt me-109, a german plane
messi	messi	(proper noun) messi, as in argentinian soccer player lionel messi
messiah	mesias	messiah
meteora	meteora	meteora
mext	mext	mext
meyer	meyer	(proper noun) meyer, as in stephenie meyer, author of the twilight series
meyers	meyers	meyers
miami	miami	a name
michael	michael	michael
michaels	michaels	michaels
michelangelo	michelangelo	michelangelo
michigan	michigan	a name
micro	mikrofon	micro
microbiology	mikrobiologi	microbiology
microeconomics	ekonomi mikro	microeconomics
micronesia	mikronesia	micronesia
microsoft	microsoft	(proper noun) the microsoft company
miguel	miguel	miguel
mike	mikrofon	mike
mikoyan	mikoyan	mikoyan
mikoyangurevich	mikoyangurevich	(proper noun) mikoyangurevich
milan	milan	milan
milano	milano	milano
miley	mil	miley
mill	pabrik	mill
miller	pabrik	miller
milton	milton	milton
min	min	min
minas	mina	minas
mindanao	mindanao	(proper noun) mindanao
ming	ming	ming
minnesota	minnesota	minnesota
minoa	minoa	minoa; the minoan civilization
miraflores	miraflores	miraflores
mirage	fatamorgana	mirage
miroku	miroku	(proper noun) miroku, a japanese name
misfits	keliru	misfits
mississippi	mississippi	mississippi
missouri	missouri	(proper noun) the state of missouri
mitchel	mitchel	mitchel
mitsubishi	mitsubishi	mitsubishi
miên	hipnosis	mien
miêu	kucing	"(term should be ""miêu tả"") to describe (v.)"
miến	bihun	burma
miếng	potongan	a piece (n.)
miếu	kuil	temple
miền	domain	area
miễn	gratis	to exempt (v.)
miện	mahkota	crown
miệng	mulut	mouth
mm	mm	millimeter
mobile	ponsel	mobile
mode	mode	mode
modul	modul	module
modula	modula	(proper noun) modula, as in modula-2
mohammad	mohammad	mohammad
mohammed	mohammed	mohammed
moi	baru	winkle
molecular	molekuler	molecular
molotov	molotov	molotov
molypden	molibdenum	the element molybdenum (n.)
mongolia	mongolia	mongolia
monique	monique	(proper name) monique, a french first name
mono	mono	mono
monroe	monroe	monroe
mont	mont	(proper noun) mont
montaigne	montaigne	montaigne, as in michel de montaigne
montana	montana	(proper noun) montana, as in the state
montenegro	montenegro	montenegro
montmartre	montmartre	(proper noun) montmartre
montparnasse	montparnasse	montparnasse
montreal	montreal	(proper noun) montreal, quebec
moo	moo	(proper noun) moo, as in cha moo won
moong	moong	moong
mora	mora	mora
moravia	moravia	moravia
morgan	morgan	(proper noun) morgan
mori	mori	(proper noun) mori
moriarty	moriarty	(proper noun) moriarty, as in james moriarty from sherlock holmes
morley	morley	morley
morocco	maroko	morocco
morris	morris	morris
morrison	morrison	(proper noun) morrison
morse	morse	(proper noun) morse, as in morse code
moscow	moscow	moscow
mosin	mosin	mosin
moskva	moskva	moscow
motown	motown	motown
mourinho	mourinho	mourinho
movie	film	movie
mozambique	mozambik	(proper noun) mozambique
mozart	mozart	(proper noun) mozart, as in the composer
mp	mp	mp
ms	ms	metre per second
msdos	msdos	ms-dos
mtv	mtv	mtv
mu	mu	pubis
mua	beli	buy
much	banyak	much
muhammad	muhammad	(proper noun) muhammad, as in muhammad ali
mumbai	mumbai	mumbai
mun	kayu hitam	a vietnamese name
munich	munich	(proper noun) munich
murdoch	murdoch	murdoch
muromachi	muromachi	(proper noun) muromachi
murphy	murphy	murphy
murray	more	(proper noun) murray, as in dr. conrad murray
mustang	mustang	mustang, as in the f-51 mustang
muta	muta	a name
muôn	inginkan	a large number; thousands (adj.)
muối	garam	salt
muốn	ingin	want
muống	sendok	"(term should be ""rau muống"") water spinach (n.)"
muồi	telat	ripe
muỗi	nyamuk	mosquito
muỗng	sendok	spoon
muội	saudara perempuan	confusion
muộn	telat	late (adv.)
myanma	myanmar	the country of myanmar
myanmar	myanmar	(proper noun) myanmar
myspace	myspace	(proper noun) myspace
mà	itu	also
mài	penggilingan	tomorrow
màn	tirai	curtain (n.)
mành	tirai	a bamboo screen (n.)
mào	lambang	a comb or crest, as in the body part of a bird
màu	warna	color
mày	kamu	sew
má	pipi	cheek
mác	label	a name (marx)
mách	tips	tell
máclênin	marxelenin	marxist-leninist
mái	atap	"entire term should be ""thoai mai""; means ""comfortable"""
mát	keren	cool
máu	darah	blood
máy	mesin	a machine (n.)
mâm	nampan	tray
mân	rosario	"entire term should be ""man viet""; a country of ancient asia that now corresponds to a province in southern china"
mâu	kontradiktif	contradiction
mây	awan	cloud
mã	kode	"(term should be ""la mã"") roman (adj.)"
mãi	selamanya	forever (adv.)
mãimại	kode	commerce
mãn	puas diri	satisfy
mãnh	kuat	intense
mão	mahkota	cat
mè	wijen	sesame
mèo	kucing	cat (n.)
mé	saya	a border
méo	terdistorsi	alter
mép	tepi	edge
mét	meter	meter
mênh	luas	vast
mêtan	metana	methane
mì	mie	wheat
mình	dirimu sendiri	me
mía	tongkat	sugar cane (n.)
mò	meraba-raba	to grope (v.)
mòn	usang	trail
móc	kail	"(term should be ""máy móc"") machinery (n.)"
món	makanan	dish
mô	tisu	mo
môi	bibir	lip
môn	mata pelajaran	anus
mông	pantat	mongolia
mônôxít	monoksida	monoxide
môt	satu	"(term should be ""một"") one (n.)"
môtô	sepeda motor	motorcycle
mù	buta	mu
mùa	musim	season
mùi	baunya	smell
múa	menari	dance
mút	mengisap	to suck (v.)
münchen	münchen	(proper noun) munchen
măng	rebung	bamboo shoot (n.)
mĩ	amerika	america
mũ	topi	cap
mũi	hidung	nose
mơ	mimpi	vague
mơn	cakar	caress
mưa	hujan	rain
mưu	licik	"(should be ""tham mưu"") advisors"
mươi	lima puluh	tens
mương	parit	ditch
mướn	menyewa	hire
mướt	halus	smooth (adj.)
mường	muong	(proper noun) mường, a minority people in vietnam (n.)
mượn	dipinjam	borrow
mượt	halus	glossy (adj.)
mạc	gurun	"(should be ""mộc mạc"") simple or natural"
mạch	sirkuit	vessel
mại	berdagang	commerce
mạn	sisi	romantic
mạnh	kuat	strong
mạo	artikel	"(should be ""mạo hiểm"") to brave danger"
mạt	tungau	"(term should be ""lê mạt"") the ending or decline of something (adj.)"
mả	kuburan	tomb or grave (n.)
mải	sibuk	absorbedly
mảng	array	genre
mảnh	bagian	piece
mất	hilang	lose
mấu	tab	key
mấy	sedikit	any
mầm	kuman	kindergarten
mầu	warna	color
mẩu	bagian	piece
mận	prem	plum
mập	gendut	fat
mật	sayang	intimate
mậu	berdagang	mau
mắc	mahal	get
mắm	saus ikan	"(term should be ""nước mắm"") fish sauce (n.)"
mắn	beruntung	"(term should be ""may mắn"") fortunate (adj.)"
mắng	dimarahi	scold
mắt	mata	eye
mặc	pakai	wear
mặn	asin	salt
mặt	wajah	face
mẹ	ibu	mother (n.)
mẹo	tips	trick
mẻ	batch	cool
mẽ	kuat	strong
mến	sayang	to adore or like greatly (v.)
mề	gizzard	locket
mềm	lembut	soft
mệnh	par	revolution
mệt	lelah	tired
mỉ	teliti	meticulous
mỉa	ironi	ironic
mỉm	tersenyumlah	smile
mịch	sial	"(term should be ""tịch mịch"") quiet (adj.)"
mịn	halus	smooth
mịt	mengendus	dim
mọc	tumbuh	to grow (v.)
mọi	setiap	every
mọn	picik	lowly
mỏ	tambang	mine
mỏi	lelah	tired (adj.)
mỏng	kurus	thin
mốc	apak	border
mối	rayap	relationship
mốt	mode	fashion or style (n.)
mồ	kuburan	"(term should be ""mồ hôi"") sweat (n.)"
mồi	umpan	bait (n.)
mổ	operasi	to dissect or perform surgery (v.)
mỗi	masing-masing	every
mộ	kuburan	admire
mộc	pertukangan kayu	simple
mộng	mimpi	dream
một	satu	one
mới	baru	new (adj.)
mờ	kabur	dim
mời	diundang	invite
mở	buka	open
mỡ	gendut	fat or grease (n.)
mục	barang itu	purpose
mụn	jerawat	pimple
mức	level	level
mứt	selai	preserve
mừng	senang	to be happy
mửa	muntah	to vomit (v.)
mực	tinta	"(term should be ""chuẩn mực"") standard (n.)"
mỳ	mie	noodles (n.)
mỹ	baiklah	america
mỹcông	amerika	my private
na	na	"(term should be ""na uy"") the country of norway"
naadam	naadam	naadam
nacional	nasional	nacional
nagant	nagant	nagant
nagar	nagar	nagar, as in champa po nagar
nagasaki	nagasaki	(proper noun) the city of nagasaki, japan
nagoya	nagoya	a name
nagumo	nagumo	nagumo
nai	rusa	a deer
nairobi	nairobi	nairobi, a city in kenya (n.)
nakajima	nakajima	a japanese name
nalbandian	nalbandian	a name
nam	laki-laki	male
nambắc	utara	nambac
namibia	namibia	namibia
namnam	namnam	male-male
namno	namno	nammo
nancy	nancy	nancy, as in nancy pelosi
nang	folikel	"(term should be ""cẩm nang"") a handbook (n.)"
nanh	taring	fang
nano	nano	nano
naomi	naomi	naomi, as in model naomi campbell
napoleon	napoleon	(proper noun) napoleon
napoli	napoli	(proper noun) napoli
napoléon	napoléon	napoleon
nara	nara	nara
nasa	nasa	(proper noun) nasa
nat	nat	nat
nathan	nathan	nathan
natri	natrium	sodium
nauru	nauru	a name
nava	nava	nava
navarre	navarre	navarre
nay	sekarang	this (adj.)
needham	needham	needham
nelson	nelson	(proper noun) nelson, as in nelson mandela
neo	jangkar	"(term should be ""mỏ neo"") an anchor (n.)"
neon	neon	neon
nepal	nepal	nepal
nepomuk	nepomuk	a name
nessie	nessie	(noun) nessie, the nickname of the loch ness monster
net	bersih	net
netbook	netbook	netbook
netscape	netscape	netscape
networks	jaringan	networks
neumann	neumann	(proper noun) neumann
neutrino	neutrino	neutrino
nevada	nevada	nevada
neverland	neverland	neverland
newcastle	newcastle	newcastle
newspaper	koran	newspaper
newton	newton	newton
newtons	newton	(proper noun) newton's
next	selanjutnya	next
nga	rusia	russia
ngai	tahta	crown
ngang	horisontal	horizontal
ngao	kerang	clam (n.)
ngay	sekarang juga	even
nghe	dengar	hear
nghinh	nghinh	welcome
nghiêm	sangat	serious
nghiêng	cenderung	inclined
nghiêu	nghieu	nghiêu, a vietnamese name
nghiền	hancur	crush
nghiễm	sayang sekali	serious
nghiệm	pengalaman	experiment
nghiện	kecanduan	addiction
nghiệp	karma	karma/ sự nghiệp=career
nghiệt	suram	adverse
nghành	industri	faculty
nghèo	miskin	poor
nghé	nghe	to glance out of the corner of one's eye (v.)
nghê	nghe	nghe khuong
nghênh	selamat datang	support
nghìn	ribuan	thousand
nghĩ	berpikir	think
nghĩa	artinya	meaning
nghẽn	kemacetan	jam
nghếch	keras	stupid
nghề	profesi	career
nghệquận	seni	art district
nghỉ	istirahat	relaxation
nghị	rekomendasi	think
ngo	mungil	ngo
ngoan	anak baik	good
ngoc	ngoc	"(term should be ""ngọc"") gem (n.)"
ngon	enak	delicious
ngoài	terpisah	outside of
ngoại	asing	external
ngoạn	hati	spectacular
ngoặc	tanda kurung	bracket
ngoặt	titik balik	landmark
ngu	bodoh	stupid
ngung	ngung	(proper noun) a vietnamese first name
nguyen	nguyen	nguyen
nguyên	asli	reason
nguyền	kutukan	curse
nguyện	sumpah	"(term should be ""mãn nguyện"") to be satisfied (adj.)"
nguyệt	bulan	moon
nguôi	menenangkan	fade away
nguồn	sumber	source
nguời	orang	people
nguỵ	orang bodoh	camouflage
ngà	gading	russian
ngàn	ribuan	thousand
ngàng	ngàng	"(term should be ""ngỡ ngàng"") to be at fault (adj.)"
ngành	industri	sector
ngào	manis	sweet
ngày	hari	day
ngách	niche	"entire term should be ""ngoc ngach""; means ""a small, out-of-the-way road"""
ngái	bodoh	chinese ethnic group living in the vietnamese highlands near the china border
ngán	bosan	to be tired of
ngáng	ngáng	stop
ngát	pingsan	"(term should be ""ngát hương"") fragrant (adj.)"
ngân	bank	money
ngây	kosong	"(term should be ""ngây ngất"") to be in ecstasy"
ngãi	ngai	ngai
ngò	daun ketumbar	coriander
ngó	lihat	to look (v.)
ngói	ubin	tile or shingle
ngón	jari	a finger (n.)
ngót	susut	"(term should be ""rau ngót"") also called sweet leaf, a type of leafy vegetable used to make soup (n.)"
ngôn	bahasa	manifesto
ngông	angsa	eccentric
ngõ	jalur	lane
ngùi	bau	sad
ngút	ngut	"entire term is ""ngut troi""; means ""sky-high"""
ngăn	kompartemen	prevent
ngũ	lima	rank
ngơ	diabaikan	ignored (adj.)
ngơi	istirahat	"(term should be ""nghỉ ngơi"") to rest (v.)"
ngư	fisher	fishermen
ngưng	berhenti	stop
ngưu	lembu	buffalo
ngươi	kamu	an ancient form of address equivalent to thou or thee (n.)
người	orang	people
ngưỡng	ambang batas	religious
ngược	mundur	opposite
ngạc	terkejut	surprise
ngạch	peringkat	"(term should be ""kim ngạch"") turn-over (n.)"
ngạn	bank	bank
ngạnh	duri	self-willed
ngạo	sombong	"(term should be ""ngạo ngược"") insolent (adj.)"
ngạt	sesak napas	stuffy
ngấm	diinfuskan	draw
ngất	pingsan	unconscious
ngầm	bawah tanah	underground
ngần	ragu	hesitate
ngẩn	tercengang	froze
ngẫm	renungkan	think
ngẫu	acak	ngẫu nhiên= random
ngậm	tablet hisap	keep
ngập	kebanjiran	flood
ngắm	menonton	to contemplate or look admiringly at something (v.)
ngắn	pendek	short
ngặt	kencang	strict
ngọ	siang	horse
ngọc	mutiara	pearl
ngọn	puncak	top
ngọt	manis	sweet (adj.)
ngồi	duduk	sit
ngộ	pencerahan	ngo
ngột	tiba-tiba	sudden
ngớ	konyol	silly
ngời	orang	bright
ngỡ	berpikir	surprised
ngợi	pujian	praise
ngợm	nakal	naughty
ngục	penjara bawah tanah	dungeon
ngụm	menyesap	sip
ngụy	wei	puppet
ngủ	tidur	sleep
ngủi	pendek	"(should be ""ngắn ngủi"") short-lived"
ngứa	gatal	itchy
ngừ	tuna	tuna
ngừa	mencegah	prevent
ngừng	berhenti	to cease (v.)
ngửa	menghadap ke atas	supine
ngửi	bau	to smell
ngữ	pidato	term
ngự	tinggal	defend
ngựa	kuda	horse
ngực	dada	chest
nha	dokter gigi	dental
nhakẻ	nak	nha-ke
nham	lahar	"(actual term is ""dung nham"") lava"
nhan	nhan	"(term should be ""dung nhan"") countenance or facial appearance (n.)"
nhang	dupa	incense
nhanh	cepat	fast
nhat	nhat	nhat
nhen	menyalakan kembali	rekindle
nhi	anak-anak	junior
nhiên	tentu saja	tuy nhiên= however
nhiêu	banyak	how many
nhiều	banyak	numerous
nhiễm	terinfeksi	infect
nhiễu	kebisingan	noise
nhiệm	tugas	task
nhiệt	panas	heat
nhk	nhk	nhk
nhs	nhs	nhs
nhu	butuhkan	demand
nhuận	keuntungan	leap year
nhuệ	nhue	elite
nhuộm	dicelup	dye
nhàn	menganggur	leisure
nhàng	dengan lembut	"(term should be ""nhẹ nhàng"") gentle (adj.)"
nhào	remas	to fall headlong
nhác	kendur	coward
nhái	klon	illegal copy
nhánh	cabang	branch
nháp	konsep	draft
nháy	berkedip	to flash or blink (v.)
nhâm	mencelupkan	leap
nhã	gurih	"(term should be ""thanh nhã"") elegant"
nhãn	label	"(term should be ""gán nhãn"") to affix a label"
nhét	terselip	put
nhì	kedua	second (adj.)
nhìn	lihat	to look (v.)
nhí	obrolan	children
nhím	landak	porcupine
nhòm	lihat	to peep (v.)
nhóc	nak	brat
nhóm	grup	group (n.)
nhô	menonjol	emerge
nhôm	aluminium	aluminum (n.)
nhúng	tertanam	embed
nhút	pemalu	shy
nhăn	berkerut	wrinkle
nhĩ	atrium	turkey
nhũ	emulsi	"(term should be ""thạch nhũ"") stalactite (n.)"
nhũng	korupsi	bribery
nhơn	berkembang biak	nhon
như	seperti	like
nhưng	tapi	but
nhương	air liur	(proper noun) vietnamese first name
nhường	hasil	yield
nhưỡng	berminyak	soil
nhược	kelemahan	weak
nhượng	konsesi	concession
nhạ	nhạ	nha
nhạc	musik	music
nhạn	menelan	bird
nhạo	mengejek	ridicule
nhạt	pucat	light
nhạy	sensitif	sensitive
nhảy	menari	jump
nhấc	angkat	lift
nhấm	menyeruput	rodent
nhấn	menekan	to press (v.)
nhất	paling banyak	most
nhầm	salah	misunderstand
nhầy	berlendir	glutinous
nhẫn	berdering	patient
nhậm	dicap	inaugurate
nhập	masuk	penetrate
nhậu	minum	drink
nhậy	sensitif	sensitive
nhắc	cepat	to remind (v.)
nhắm	bertujuan	aim
nhắn	pesannya	message
nhằm	membidik	for the purpose of (adv.)
nhẵn	halus	smooth
nhặt	dijemput	pickup
nhẹ	cahaya	light
nhẹn	lincah	nhanh nhẹn= fast/nimble
nhị	benang sari	sensitive
nhịn	abstain	fasting
nhọ	dioleskan	smear
nhọn	menunjuk	sharp (adj.)
nhỏ	kecil	small
nhỏ|cây	pohon kecil |	small|tree
nhỏ|một	kecil |	small | one
nhỏ|phải|	kecil | kanan |	small|right
nhỏ|phải|px|	kecil | kanan | px |	small | have | px |
nhỏ|phải|px|bức	kecil | kanan | px | foto	grape / fade / px / buc
nhỏ|phải|px|cây	pohon kecil | kanan | px |	px spicy grape fade
nhỏ|phải|px|khu	kecil | kanan | px | zona	small|right|px|area
nhỏ|phải|px|michael	kecil | kanan | px | michael	small|right|px|michael
nhỏ|phải|px|máy	mesin kecil | kanan | px |	small | right|px|machine
nhỏ|phải|px|một	kecil | kanan | px | satu	small|right|px|one
nhỏ|phải|px|quân	kecil | kanan | px | paksa	small|right|px|army
nhỏ|px|	kecil | px |	small
nhỏ|px|các	kecil | px |	small
nhỏ|px|phải|kiến	kecil | px | kanan | semut	small | px | right | patience
nhỏ|quân	kecil | kekuatan	small|army
nhỏ|trái|px|máy	mesin kecil | kiri | px |	small|left|px|plane
nhỏ|tượng	patung kecil	small|statue
nhốt	terkunci	confine
nhồi	diisi	cram
nhổ	meludah	uproot
nhộn	kocak	busy
nhớ	untuk diingat	remember
nhớt	kental	viscid
nhờ	terimakasih	by
nhờn	berminyak	multiplication
nhở	ingatkan	remind
nhụ	cubit	nhu
nhục	dihina	shame
nhủ	pengingat	needs
nhức	sakit	pain
nhứt	pertama	first (n.)
nhừ	seperti	tender
những	ini	the
nhựa	plastik	plastic
nhựt	nhut	"like the word ""nhật""; meaning ""sun"" (n.)"
ni	ni	nun
nia	nia	a flat basket (n.)
nicaea	nicaea	nicaea
nicaragua	nikaragua	(proper noun) nicaragua
niccolò	niccolò	(proper noun) niccolo, as in writer niccolo machiavelli
nicolas	nicolas	(proper noun) nicolas, as in nicolas sarkozy
niels	niels	(proper noun) niels
nigeria	nigeria	nigeria
nikel	nikel	nickel
niken	nikel	nickel
nikita	nikita	(proper noun) nikita, a first name
nikko	nikko	(proper noun) nikko
nikolai	nikolai	nikolai
nikolayevich	nikolayevich	nikolayevich
nil	nihil	nile
nile	nil	(proper noun) the river nile
nimitz	nimitz	(proper noun) nimitz, as in the ship uss nimitz
nin	nin	nin
ninh	keamanan	ninh, as in bắc ninh
nintendo	nintendo	(proper noun) nintendo, the game company
nippon	nippon	nippon
nitơ	nitrogen	nitrogen (n.)
nixon	nixon	(proper noun) nixon, as in former president richard nixon
niên	tahun	youth
niết	niet	nirvana
niềm	kesenangan	trust
niệm	perhatian penuh	concept
niệu	diuresis	urinary
nj	nj	nj
nlf	nlf	nlf
nm	nm	nano-meters
noah	nuh	(proper noun) noah
nobel	mulia	nobel
nobita	nobita	nobita
noel	noel	(proper noun) noel
noi	katakan	imitate
nokia	nokia	(proper noun) nokia, as in the nokia corporation
nol	nol	nol
nom	nom	look after
non	muda	mountain
nonpenetrative	tidak menguntungkan	nonpenetrative
norfolk	norfolk	norfolk
norge	norge	norge
norma	norma	(proper noun) norma, a female first name
norman	norman	norman
normandie	normandie	normandile
northrop	northrop	northrop, as in the northrop f-5 freedom fighter
norton	norton	norton
norway	norak	norway
nou	kamu tidak	nou
novak	novak	novak
now	sekarang	now
nowc	sekarangc	nowc
noãn	ovula	ovule
nsnd	nsnd	people's artist
nst	pertama	chromosome
nubia	nubia	nubia
number	angka	number
nupedia	nupedia	a name
nusa	nusa	nusa
nuôi	pakan	feed
nuối	menelan	"(term should be ""tiếc nuối"") to regret (v.)"
nuốt	menelan	to swallow (v.)
nuớc	air	water
nxb	nxb	publisher
nynorsk	nynorsk	nynorsk
nà	tidak	na
nài	bersikeras	pleading
nàn	mengeluh	poor
nành	kedelai	soy
nào	ayo	would
này	ini	this
ná	tidak	a crossbow (n.)
nách	ketiak	underarm (n.)
náo	gempar	riot
nát	hancur	ruin
náu	bersembunyi	hide
nâng	mengangkat	raise
nâu	coklat	brown
nã	nã	to track down (v.)
não	otak	brain
né	hindari	dodge
ném	melempar	to throw (v.)
nén	terkompresi	compress
nét	stroke	feature
nê	ne	ne
nên	seharusnya	should or ought to
nêu	dinyatakan	mention
nòi	ras	race
nòng	berlaras	barrel
nói	kata	to say or speak (v.)
nón	topi	cone
nóng	panas	hot
nô	budak	slave
nôbita	tobita	nobita
nôi	buaian	cradle
nôm	tidak	ancient vietnamese script that borrowed heavily from han chinese characters
nôn	muntah	vomit
nông	dangkal	farmer
nõn	mengupas	peeled
nùng	nung	nung
núm	kenop	nipple
núp	penutup	hide
nút	tombol	button
năm	tahun	year
năn	bertobat	"(term should be ""ăn năn"") remorse (n.)"
năng	kekuasaan	"(term should be ""khả năng"") ability (n.)"
nơi	tempat	a place
nơtrino	neutino	neutrino
nước	air	country
nước 	air	water
nướng	dipanggang	grill
nǎm	nm	year
nạ	topeng	mask
nạc	ramping	lean (adj.)
nại	mengeluh	complain
nạn	kesusahan	a disaster (n.)
nạo	kuretase	to scrape (v.)
nạp	dimuat	tribute
nản	berkecil hati	depressed
nảy	memantul	"(term should be ""nảy sinh"") to give rise to (v.)"
nấc	cegukan	a hiccup (n.)
nấp	bersembunyi	hide
nấu	masak	cook
nấy	ini	this
nần	menyenggol	debt
nầy	ini	this
nẩy	memantul	"(term should be ""nảy nở"") to sprout or start growing (v.)"
nẫu	dan matahari	"(""giọng nẫu"") a vietnamese accent commonly found in cities such as phú yên"
nậm	nam	"(term should be ""nậm rốm"") the name of a river in vietnam (proper noun)"
nập	panas	busy
nắm	pegang	to grasp or hold (v.)
nắng	cerah	sunlight
nắp	tutupnya	a lid or cover (n.)
nằm	kebohongan	to lie (v.)
nẵng	nang	"(term should be ""Đà nẵng"") a city in central vietnam"
nặc	secara anonim	heavy
nặn	memeras	mould
nặng	berat	heavy
nẻo	lain	turn
nếm	mencicipi	taste
nến	lilin	candle
nếp	lengket	sticky rice (n.)
nếu	jika	if (adv.)
nề	pekerjaan tukang batu	severe
nể	hormat	respect
nện	berdebar	ram
nỉ	terasa	beg
nịnh	lebih datar	flatter
nọ	yang lainnya	the other
nọc	racun	tadpole
nỏ	panah	a crossbow (n.)
nối	terhubung	connection
nốt	perhatikan	to finish off (v.)
nồi	pot	pot
nồm	tengkuk	humid (adj.)
nồng	konsentrasi	heavy
nổ	meledak	explode
nổi	mengambang	nổi tiếng= famous
nỗ	usaha	affort
nỗi	itu	state
nộ	murka	anger
nội	internal	on the paternal side (adj.)
nộn	isian	non
nộp	diajukan	submit
nới	kendurkan	ease
nở	mekar	bloom
nỡ	hati	do you have a heart to
nợ	hutang	debt
nụy	putik	"(term should be ""nụy nhân"") the vietnamesized han term depicting the japanese"
nứa	gabus	a kind of bamboo (n.)
nứt	retak	to crack
nửa	setengah	haft
nữa	lebih lanjut	moreover
oahu	oahu	(proper noun) oahu
oai	takut	heroic
oakland	tanah oak	oakland
oan	ketidakadilan	injustice
oanh	oanh	(with word liet) glorious
obama	obama	obama
oblast	oblast	(proper noun) oblast, as in tomsk oblast
oc	oc	oc
october	oktober	(proper noun) october
oda	oda	oda
oder	oder	oder
odyssey	pengembaraan	odyssey, as in the odyssey, homer's epic
oecd	oecd	oecd
officer	petugas	officer
officers	petugas	officers
ohkawa	ohkawa	ohkawa
okhotsk	okhotsk	okhotsk
oliver	oliver	oliver
olivier	olivier	olivier
olympus	olympus	olympus
om	om	to simmer
omar	omar	a name
ong	lebah	bee
ontario	ontario	ontario
oort	oort	oort
oprah	oprah	(proper noun) oprah, as in oprah winfrey
organ	organ	organ
oricon	oricon	oricon
origin	asal	origin
orion	orion	(proper noun) orion, the hunter
orleans	orleans	(proper noun) orleans, as in new orleans
orochimaru	orochimaru	orochimaru
orton	orton	orton
os	os	os
osaka	osaka	(proper noun) osaka, a city in japan
osama	osama	(proper noun) osama, as in osama bin laden
osamu	osamu	(proper noun) osamu, a japanese first name
oscar	oscar	oscar
osiris	osiris	(proper noun) osiris, as in the egyptian god
oskar	oskar	a name
oslo	oslo	oslo
osment	osment	osment
ospf	ospf	ospf
ossetia	ossetia	(proper noun) ossetia
oswald	oswald	oswald
other	lainnya	other
otto	otto	(proper noun) otto, as in otto von bismarck
ottoman	utsmaniyah	(proper noun) ottoman, as in the ottoman empire
outstanding	luar biasa	xuat sac
owen	owen	(proper noun) owen, as in michael owen
oxford	oxford	oxford
oxy	oksigen	oxygen
ozawa	ozawa	(proper noun) ozawa, as in maria ozawa
oán	kebencian	"(term should be ""oán than"") to complain or whine"
oát	watt	a watt (n.)
oản	ya	"(term should be ""ăn oản"") gratitude and resentment (n.)"
paget	paget	(proper noun) paget
pailin	pailin	pailin
pakistan	pakistan	(proper noun) the country of pakistan
palais	palais	palais, as in grand palais
palawan	palawan	palawan
palenque	palenque	(proper noun) palenque
palestine	palestine	a name
palgrave	palgrave	palgrave
pali	pali	a name
pamir	pamir	pamir
pan	panci	pan, as in peter pan
panama	panama	panama
panamax	panamax	(proper noun) panamax
panduranga	panduranga	(proper noun) panduranga
panthera	panthera	(proper noun) panthera, a genus of felines
panthéon	panthéon	a name
paolo	paolo	paolo
paperback	paperback	paperback
papua	papua	papua
paraguay	paraguay	(proper noun) paraguay
pari	pari	pari
park	taman	park
parton	parton	parton
patel	patel	(proper noun) patel
patrick	patrick	patrick
patriot	patriot	patriot
paul	paul	paul
paula	paula	paula
paulo	paulo	(proper noun) paulo
pavia	pavia	pavia
pbs	pbs	pbs
pda	pda	pda
pdf	pdf	pdf
pedro	pedro	pedro
peers	teman sebaya	peers
pele	pele	(proper noun) pele, as in the soccer player
penang	penang	penang
penh	penh	(proper noun) penh, as in phnom penh
pennsylvania	pennsylvania	pennsylvania
penny	sen	(proper noun) penny, an english first name
pereira	pereira	pereira
perl	perl	(proper noun) perl
pero	pero	pero
perry	perry	(proper noun) perry, as in elizabeth perry
persephone	persephone	presephone
pershing	pershing	pershing
persian	persia	persian
peru	peru	peru, as in the south american country
peters	peters	peter's, possessive of peter
petersburg	petersburg	(proper noun) petersburg, as in saint petersburg
pfm	pfm	a name
pgs	pgs	associate professor
pgđ	hal	associate professor
pha	dicampur	to mix
phaethon	phaethon	phaethon
pham	bohong	pham
phanh	rem	expose
phao	mengapung	float
phaolô	paul	st. paul, the apostle
pharaoh	firaun	pharaoh
pharaon	firaun	pharaoh
phay	berseliweran	mill
phe	faksi	faction
phen	fen	time
phil	phil	(proper noun) phil, a first name
philip	philip	philip
philippe	philippe	philippe
philippines	filipina	(proper noun) philippines
phillip	phillip	(proper noun) phillip
phillips	phillips	philips
philosophiae	filsafat	(proper noun) philosophiae, as in the work philosophiae naturalis principia mathematica
phim	film	phim
phin	filter	coffee filter
phineas	phineas	(proper noun) phineas
phiên	sesi	trial
phiêu	petualangan	adventurous
phiếm	gosip	gossip
phiến	mata pisau	"(should be ""nha phiến"") opium"
phiện	opium	opium
phiệt	phiet	militarism
phnom	phnom	phnom
phnôm	phomom	phnôm pênh= phnom penh(cambodia's capital)
pho	pho	part of a person's name, rat-pho, or ratford
phoenix	phoenix	(proper noun) phoenix
phong	kamar	movement
php	php	php
phrygian	frigia	phrygian
phu	phu	"(term should be ""phu nhân"") wife (n.)"
phui	terungkap	expose
phun	semprotan	to spray or spit (v.)
phà	feri	ferry
phàm	fana	superhuman
phàn	mengeluh	complain
phá	melanggar	destroy
phác	sketsa	"(term should be ""phác thảo"") outline or sketch (n.)"
phách	mengalahkan	manner (n.)
phái	sekte	a party
phán	hakim	judge
pháo	meriam	artillery
pháp	prancis	method
phát	disiarkan	develop
phèn	tawas	alum
phèo	phèo	organs
phép	diizinkan	permit
phê	kopi	"(term should be ""phê bình"") to criticize (v.)"
phêrô	peter	peter
phì	hipertrofi	non-
phình	tonjolan	bulge
phí	biaya	non-
phía	sisi	side
phích	termos	a flask (n.)
phím	kunci	key
phò	phò	"(term should be ""phò mã"") a prince consort"
phòng	kamar	office
phó	wakil	second
phóng	reporter	to launch (v.)
phô	kota	display
phôi	ingot	embryo
phông	fonta	font
phùng	engah	phung
phúc	diberkati	good fortune (n.)
phúclộc	diberkati	phuc-loc
phún	gelandangan	"(term should be ""lún phún"") sparse (adj.)"
phúng	sayang sekali	satire
phút	menit	a minute (n.)
phăn	resah	phan
phăng	phang	knock
phương	phuong	direction
phước	berkah	luck
phường	bangsal	ward
phượng	phoenix	phoenix
phạn	bahasa sansekerta	sanskrit
phạt	penalti	punish
phả	silsilah	pedigree
phải	iya	must
phải 	iya	right
phản	konter	reaction
phảng	datar	subtle
phần	bagian	part
phẩm	produk	food
phẩy	koma	a comma
phẫn	marah	wrathful
phẫu	operasi	surgery
phận	takdir	part
phật	buddha	buddhist
phẳng	datar	flat (adj.)
phế	memo	dismiss
phết	menyebar	to spread or smear (v.)
phỉ	hazel	defame
phỏng	membakar	interview
phố	jalan	city
phối	mengoordinasikan	coordinate
phốt	fosfat	"(term should be ""phốt-phát"") phosphate (n.)"
phồng	meningkat	to swell (v.)
phổ	spektrum	popular
phổi	paru-paru	lung
phộng	kacang tanah	peanut
phới	mengapung	"(term should be ""phơi phới"") mildly exciting (adj.)"
phở	pho	pho
phục	pakaian	convincing
phụng	melayani	worship
phụt	engah	minute
phủ	tertutup	government
phức	kompleks	complex
picchu	picchu	a name
piccolo	piccolo	piccolo
pierre	pierre	pierre
pierrot	tindik	pierrot
pietro	pietro	pietro
pike	tombak	pike
pin	pin	battery
pinlus	pinlus	pinlus
pioneer	pelopor	pioneer
pipes	pipa	pipes
pisa	pisa	a name
piston	piston	piston
pitch	melenggang	pitch
pius	pius	pius
plaaf	plaaf	plaaf
plan	rencana	plan
plasma	plasma	plasma
plate	piring	plate
plato	plato	plato
platon	platon	platon
player	pemain	player
pleiku	pleiku	(proper noun) pleiku
pleistocen	pleistocen	pleistocen
plus	plus	plus
pluto	pluto	pluto
pm	siang	pm
pmu	pmu	pmu
po	po	po
pokémon	pokemon	pokemon
pol	pol	pol
poland	polandia	poland
pollack	pollack	a name
pollux	pollux	a name
polo	polo	(proper noun) polo, as in marco polo
polynésie	polynésie	polynesian
pont	pont	(proper noun) pont, as in pont de normandie
pop	pop	pop
portland	portland	portland
porto	porto	porto
pot	pot	pot
potsdam	potsdam	(proper noun) potsdam
potter	pembuat tembikar	(proper noun) potter, as in harry potter
pour	tuangkan	not vietnamese
powell	powell	(proper noun) powell, as in general colin powell
pradesh	pradesh	pradesh
praha	praha	praha
pratzen	pratzen	pratzen
preah	preah	(proper noun) preah
premier	perdana	premier
preminger	preminger	(proper noun) preminger
preston	preston	(proper noun) preston, as in john preston
prince	pangeran	prince
princeton	pangeran	princeton
printemps	printemps	printemps
printf	printf	printf
prinz	prinz	(proper noun) prinz, as in birgit prinz, the female german soccer player
prix	prix	(proper noun) prix, as in the grand prix
procellarum	procellarum	procellarum, as in oceanus procellarum, the name of a mare on the moon
projekt	projekt	projekt
prometheus	prometheus	(proper noun) prometheus
protein	protein	protein
prôtêin	protein	protein (n.)
ps	ps	ps
psv	psv	psv
ptolemy	ptolemy	ptolemy
ptq	ptq	ptq
puerto	puerto	puerto
pulau	pulau	(proper noun) pulau, as in pulau tekong, an island
pulitzer	pulitzer	(proper noun) pulitzer, as in the pulitzer prize
pulp	bubur kertas	pulp
punjab	punjab	punjab
pusan	pusan	(proper noun) pusan
putin	putin	putin
pyrenees	pyramid	pyrenees
pytago	pytago	(proper noun) pytago
pzl	pzl	pzl
péc	péc	"(term should be ""vịnh péc xích"") the persian gulf"
pérez	pérez	(proper noun) perez, as in javier perez de cuellar
păng	pang	fansipan
pơ	pơ	"(term should be ""pơ kô"") a river in vietnam (n.)"
q	q	q ( a letter)
qatar	qatar	qatar
qd	qd	quantum dots
qing	qing	qing, as in the qing dynasty of  china
qlvnch	qlvnch	army of the republic of vietnam
qua	selesai	transmit
quad	quad	quad
quan	quan	"(term should be ""quan hệ"") relationship (n.)"
quang	optik	bladder
quanh	sekitar	around
quay	berbalik	turn
que	batang	stick
queen	ratu	queen
queens	ratu	(proper noun) queens, as in the new york borough
queensland	queensland	queensland
quen	terbiasa	accustomed to
qui	qui	formal
quincy	quincy	(proper noun) quincy, as in quincy jones
quran	quran	quran
quy	aturan	"(term should be ""quy ước"") agreement"
quyên	fundamental	"(term should be ""quyên góp"") to donate (v.)"
quyến	pesona	"(term should be ""gia quyến"") family"
quyền	benar	right
quyện	bergaul	mix
quyệt	berbahaya	"(should be ""xảo quyệt"") devious"
quá	juga	over
quái	heck	strange or odd
quán	bar	hometown
quáng	buta	blind
quát	teriak	generalize
quân	quan	army (n.)
quãng	sekitar	optical
quét	memindai	to sweep (v.)
quê	pedesaan	countryside
quên	lupa	forget
quý	seperempat	love
quýt	jeruk keprok	tangerine
quăng	lempar	to throw (v.)
quĩ	dana	orbit
quạ	gagak	crow (con qua)
quạt	kipas angin	fan
quản	memerintah	"(entire term is ""cai quản"") to manage"
quảng	promo	guangzhou
quấn	bungkus	wrap around
quất	kumquat	whip
quấy	melecehkan	harass
quần	celana	pants (n.)
quầng	halo	halo
quầy	counter	stall
quẩy	goyang	quay
quẫn	celaka	necessitous
quận	daerah	county (n.)
quật	penggalian	excavation
quẳng	lempar	throw
quặc	aneh	strange (adj.)
quặng	bijih	an ore (n.)
quẻ	heksagram	hexagram
quế	kayu manis	cinnamon (n.)
quết	sampah	knead
quệ	miskin	exhausted
quỉ	iblis	demon
quỳ	berlutut	demon (n.)
quỳnh	quỳnh	quynh
quỵ	stroke	stroke
quỷ	iblis	provided
quỹ	dana	fund
qúy	seperempat	quy
r	r	r
rabindranath	rabindranath	rabindranath
race	ras	race
rafael	rafael	rafael
rafale	rafale	(proper noun) rafale, as in dassault rafale
rai	rai	slowly intake
raleigh	raleigh	raleigh
ralph	ralph	(proper noun) ralph, as in ralph waldo emerson
ram	ram	a name
rama	rama	rama, first name of several rulers of thailand (n.)
ramadan	ramadhan	(proper noun) the fasting month of ramadan
ramayana	ramayana	ramayana
rambus	rambus	rambus
ran	berlari	ran
ranch	peternakan	ranch
randy	randy	randy
rang	berdering	roast
rangers	penjaga	rangers
ranh	batas	border (ranh gioi)
rao	iklan	to announce
rap	rap	rap
raptor	raptor	raptor
rate	nilai	rate
rau	sayuran	vegetable
ray	sinar	rail (n.)
raya	raya	raya
raymond	raymond	raymond
rađa	radar	radar
reagan	reagan	reagan
real	nyata	real
reanimation	penghidupan kembali	reanimation
reap	menuai	reap
reef	karang	reef
regia	regia	regia
reichelt	reichelt	reichelt
ren	renda	lace (n.)
renaissance	kebangkitan	renaissance
renault	renault	renault
rené	rené	rene
reo	berdering	yell
reserve	cadangan	reserve
resort	resor	resort
reverse	mundur	reverse
revolution	revolusi	revolution
rey	rey	rey, as in copa del rey
rfid	rfid	rfid
rhodes	rhodes	rhodes
rica	rica	rica
ricardo	ricardo	ricardo
ricci	ricci	ricci
richard	richard	richard
richardson	richardson	(proper noun) richardson, as in james o. richardson
richie	richie	(proper noun) richie, as in singer lionel richie
rico	rico	rico, as in puerto rico
riemann	riemann	riemann, as in bernhard riemann, a german mathematician
rimjob	rimjob	rimjob
rin	rin	rin
rising	naik	rising
risk	risiko	risk
ritchie	ritchie	a name
rivaldo	rivaldo	rivaldo
rivière	rivière	a name
rizal	rizal	rizal
riêng	sendiri	own
riêu	riêu	crab
riết	riet	urgently
riềng	lengkuas	arrowroot
ro	ro	"entire term is ""rui ro""; means ""risk"""
robert	robert	(proper noun) robert
roberto	roberto	(proper noun) roberto
roberts	robert	roberts
robespierre	jubah	robespierre
robin	robin	a name
robinson	robinson	robinson, as in michelle robinson
rockefeller	rockefeller	rockefeller, as in john d. rockefeller
roddick	roddick	(proper noun) roddick
rodríguez	rodríguez	rodriguez (n.)
roi	cambuk	a stick or switch used for punishment (n.)
roland	roland	roland
romania	romania	romania
rome	roma	rome, as in rome, italy
romeo	roma	(proper noun) romeo, as in romeo and juliet
rommel	rommel	rommel
ron	ron	ron
ronald	ronald	ronald, an english first name
ronaldinho	ronaldinho	ronaldinho
rong	rumput laut	seaweed (n.)
rosen	rosen	rosen, as in nathan rosen
roth	roth	roth
rotterdam	rotterdam	(proper noun) rotterdam
rousseau	rousseau	rousseau
router	router	cong noi
rovers	penemu	rovers
rowling	mendayung	rowling
roy	roy	(proper noun) roy, a name
rpd	rpd	rpd
rtp	rtp	rpt
rudolph	rudolph	rudolph
rue	menyesali	rue, as in rue des vases, a street name
rulin	rulin	(proper noun) rulin
rumani	romanian	romanian
rumiko	rumiko	rumiko, a japanese first name
rummel	rummel	rummel
run	lari	tremble
rung	getaran	to shake or vibrate (v.)
russian	rusia	(proper adjective) russian
russkaya	russkaya	(proper noun) russkaya avionika
ruth	ruth	(proper noun) ruth
rutherford	rutherford	rutherford
rutte	rutte	rutte
ruud	ruud	ruud
ruốc	udang	pemmican
ruồi	terbang	fly
ruổi	ruoi	rong ruổi=wandering
ruộng	bidang	"(term should be ""ruộng đất"") farmland (n.)"
ruột	usus	internals
rzeczpospolita	rzeczpospolita	rzeczpospolia
rà	lihat	finding
ràng	jelas	clear
rành	lancar	exhaustive
rào	pagar	barrier
rác	sampah	gabbage-trash
rách	sobek	tear
rái	berang-berang	colander
rán	goreng	fried (adj.)
ráp	perakitan	to assemble (v.)
râm	teduh	shade
râu	jenggot	beard or mustache (n.)
rã	membusuk	out
rãi	secara luas	"(term should be ""rộng rãi"") generous"
rãnh	alur	groove
räikkönen	räikkönen	raikkonen
rèm	tirai	curtain
rèn	penempaan	train
ré	menjerit	re
république	république	republique
rét	dingin	cold
rê	seret	"(term should be ""rê bóng"") to dribble the ball in soccer (v.)"
rên	erangan	moan
rêu	lumut	moss
rì	berbisik	lush (adj.)
rìa	tepi	edge
rình	memata-matai	to watch for
rìu	kapak	ax
rít	desis	to wail (v.)
rò	kebocoran	leak
ròng	bersih	net
rót	menuang	to pour (v.)
rô	berpetak-petak	diamond
rôbôt	robot	robot
rôma	roma	roman
rông	hampa	rising (adj.)
rõ	jelas	clear
rùa	kura-kura	turtle
rùng	menyeramkan	horror
rút	menarik diri	withdraw
răn	perintah	commandment
răng	gigi	roasted
rōmaji	rōmaji	romaji
rũ	menggoda	charm
rơ	mobil	"(term should be ""rơ măm"") a minority people living in vietnam"
rơi	jatuh	fall
rơm	sedotan	straw
rươi	kamu	sand-worm
rước	prosesi	welcome
rưới	taburi	to sprinkle (v.)
rưỡi	setengah	half
rượt	kejar	pursue
rượu	alkohol	wine
rạ	lalang	straw
rạc	diskrit	discrete
rạch	sayatan	canal
rạng	subuh	break
rạp	teater	theater
rải	tersebar	spread
rảnh	gratis	to be free (adj.)
rất	sangat	very
rầm	kusen	aggressive
rầu	sedih	sorrow
rẫy	dataran tinggi	full
rậm	lebat	jungle
rập	orang arab	"(term should be ""Ả rập"") arab"
rắc	taburi	trouble
rắn	ular	snake
rằm	bulan purnama	a full moon (n.)
rằng	itu	roasted
rặng	batu	a row
rẻ	murah	cheap
rẽ	berbalik	"(term should be ""chia rẽ"") to separate or divide (v.)"
rền	erangan	pealed
rể	menantu	in-law
rễ	akar	root (n.)
rệp	kutu daun	bug
rệt	diucapkan	clearly
rệu	aye	decay
rỉ	karat	leak
rịavũng	rìvà	ria - bay
rỏ	jelas	clearly
rối	kusut	disorder
rốm	terlihat	rom
rồ	gila	"(term should be ""điên rồ"") foolish (adj.)"
rồi	sudah	and
rồng	naga	dragon
rổ	keranjang	basket
rỗi	gratis	savation
rỗng	kosong	hollow
rộ	kesibukan	profuse (adj.)
rộn	sibuk	busy
rộng	lebar	wide
rớt	gagal	drop
rời	kiri	leave
rỡ	brilian	brilliant
rợ	orang barbar	a savage (n.)
rợn	menyeramkan	scary
rụng	jatuh	to drop
rủ	terkulai	ask
rủi	kecelakaan	unlucky or unfortunate (n.)
rứa	rứa	rua
rừng	hutan	forest
rửa	cuci	to wash (v.)
rữa	cuci	to decompose or rot (v.)
sa	sa	to fall or drop (v.)
sabah	sabah	sabah
sachsen	sachsen	sachsen
saddam	saddam	(proper noun) saddam, as in saddam hussein
safari	safari	safari
safin	safin	safin
sahara	sahara	sahara
sai	salah	wrong
saigon	saigon	saigon
saintdenis	orang suci	saint-denis
sakura	sakura	sakura
salem	salem	(proper noun) salem, as in the city
salvador	penyelamat	salvador
salzburg	salzburg	salzburg
samhain	samhain	samhain
samo	samo	samo, the name of the first slavic ruler
samoa	samoa	(proper noun) samoa
samphan	samphan	samphan
samsung	samsung	samsung
samuel	samuel	samuel
samuelson	samuelson	(proper noun) samuelson
samurai	samurai	samurai
samut	samut	(proper noun) samut, as in samut prakan in thailand
san	san	level
sanchez	sanchez	sanchez
sang	untuk	to
sango	sango	sango, a language spoken in africa
sangraal	sangraal	sangraal
sanh	kelahiran	bear
sanktpeterburg	sanktpeterburg	sankt-peterburg
santos	santos	santos, as in footballer cristiano ronaldo dos santos aveiro of portugal
sao	bintang	how
sap	getah	sap
sapa	sapa	sapa
sapiens	sapiens	sapiens
sar	sar	sar
sarah	sarah	sarah, as in sarah pierce
sarawak	sarawak	(proper noun) sarawak, a malaysian state on the island of borneo
sarcoma	sarkoma	sarcoma
sardinia	sardinia	sardinia
sary	sary	(proper noun) sary, as in ieng sary
saturanga	saturanga	saturanga
saturday	sabtu	saturday
sau	nanti	after (adv.)
saudi	saudi	(proper noun) saudi, as in saudi arabia
saunière	sauniere	saunière
scandinavia	skandinavia	scandinavia
schafer	schafer	schafer, as in john c. schafer
schengen	schengen	schengen
schiller	schiller	schiller
schlesinger	schlesinger	schlesinger
schneider	schneider	schneider, a last name
schumacher	schumacher	schumacher, as in michael schumacher
schuschnigg	schuschnigg	(proper noun) schuschnigg, as in kurt schuschnigg of austria
schuster	schuster	schuster
schwarzschild	schwarzschild	schwarzschild
scotland	scotland	scotland
scots	skotlandia	(proper noun) scots
scott	scott	scott
scream	menjerit	scream
scud	cepat	scud
scuderia	scuderia	scuderia
sdram	sdram	sdram
search	cari	search
seattle	seattle	(proper noun) seattle, washington
secret	rahasia	bi mat
sedna	sedna	(proper noun) sedna
see	lihat	see
sejm	sejm	(proper noun) sejm
selena	selena	selena
semit	semit	(proper noun) semit
sen	lotus	lotus
sense	akal	sense
september	september	(proper noun) the month of september
serbia	serbia	serbia
sergeyevich	sergeyevich	(proper noun) sergeyevich
seri	seri	series
service	layanan	service
sesshomaru	sesshomaru	a name
seth	seth	seth
seto	seto	seto
sextus	sextus	sextus
sexy	seksi	sexy
seymour	seymour	seymour
seyssinquart	seyssinquart	(proper noun) seyss-inquart
shah	shah	shah
shaman	dukun	the shaman religion
shan	shan	shan
shane	shane	(proper noun) shane, an english first name
shankly	dgn malu-malu	(proper noun) shankly, as in bill shankly
shaolin	shaolin	shaolin, as in the shaolin temples
sharpay	sharpay	sharpay, as in sharpay evans
shawn	shawn	shawn
sherlock	sherlock	a name
shi	shi	shi
shia	shia	shia
shiite	shiite	shiite
shikoku	shikoku	shikoku, a japanese island (n.)
shinichi	shinichi	shinichi
shinoda	shinoda	shinoda, as in mike shinoda
shirakami	shirakami	(proper noun) shirakami
shirakawago	shirakawago	(proper noun) shirakawa-go
shiva	siwa	shiva
shoal	beting	(proper noun) shoal
shonen	shonen	shonen
shop	toko	shop
short	pendek	short
showcase	showcase	a name
shōnen	shonen	shonen
siberi	siberi	siberi
sicilia	sisilia	sicilia
sicily	sisilia	sicily, a city in italy
sidney	sidney	(proper noun) sidney, as in sidney nolan
siem	siem	siem
siemens	siemens	siemens
sierra	sierra	(proper noun) sierra
sikh	sikh	sikh
sikorsky	sikorsky	a name
silas	silas	silas
silesia	silesia	silesia
silic	silikon	silicon
silicat	silikat	silicate
silva	silva	(proper noun) silva, as in carlos silva
silvestris	silvestris	silvestris
simone	simone	simone
sinai	sinai	sinai, as in mount sinai
sinensis	sinensis	sinensis
sing	bernyanyi	sing
sinh	terlahir	genital
sip	menyesap	sip
sirô	sirup	name of a member
sistema	sistema	(proper noun) sistema
siu	siu	siu
siêu	super	super
siết	kencangkan	to cut off (v.)
sky	langit	sky
skype	skype	skype
skyteam	skyteam	skyteam
sl	sl	sl
slav	slav	(proper noun) slav
slavơ	slav	slavic
slytherin	slytherin	(proper noun) slytherin, as in salazar slytherin of the harry potter series
sm	sm	sm
smg	smg	smg
smith	pandai besi	smith
smithsonian	smithsonian	smithsonian
so	jadi	compare
société	masyarakat	societe
socrates	socrates	socrates
sohee	sohee	a korean name
soho	soho	soho
soi	soi	look/stare soi sáng=enlight
solaris	solaris	(proper noun) solaris
som	som	(proper noun) som, as in kampong som
somme	somme	somme
sonata	sonata	sonata
song	lagu	however (adv.)
sony	sony	sony
soo	soo	soon
sophie	sophie	(proper noun) sophie, a first name
sopwith	sopwith	a name
sorbonne	sorbonne	sorbonne, the university in paris (n.)
sos	sos	sos
soul	jiwa	soul
soát	kontrol	control
soạn	menulis	compose
spears	tombak	spears
spellman	perapal mantra	spellman
spence	spence	(proper noun) spence
spencer	spencer	(proper noun) spencer
spielberg	spielberg	(proper noun) spielberg, as in steven spielberg
sports	olahraga	sports
sri	sri	(proper noun) sri, as in sri lanka
ss	ss	ss
st	st	st.
stalingrad	stalingrad	stalingrad
stamford	stamford	this is a name
stand	berdiri	stand
stanford	stanford	stanford, as in stanford university
stanley	stanley	stanley
starr	starr	a name
startin	mulai	bat dau
status	status	status
stdc	stdc	stdc
stefan	stefan	stefan
steiermark	steiermark	steiermark
steiner	steiner	steiner
stelzer	stelzer	stelzer
stennis	stennis	stennis
stephen	stephen	stephen
stephenie	stephenie	"stephenie, as in stephenie meyer, author of ""twilight"""
sterling	sterling	a name
steve	steve	steve
stevens	stevens	(proper noun) stevens, as in amanda stevens
stevenson	stevenson	stevenson
stevie	stevie	stevie
stewarthannah	stewarthannah	stewart/hannah
stf	stf	stf
stimson	stimson	stimson, as in henry lewis stimson, former secretary of war
stockholm	stockholm	a name
stones	batu	stones
storting	storting	storting
strasberg	strasberg	strasberg
strauss	strauss	strauss
street	jalan	street
struct	struct	struct
stt	stt	order number
stuart	stuart	stuart
stuttgart	stuttgart	(proper noun) stuttgart, a city in germany
styx	styx	(proper noun) styx, as in the river styx
stéfano	stéfano	stefano
su	su	condom
subakhi	subakhi	subakhi
suez	suez	(proper noun) suez
suharto	suharto	suharto
sukarno	sukarno	(proper noun) sukarno,  president of indonesia
sulfua	sulfida	sulfide
sulu	sulu	sulu
sum	jumlah	reunite
sumatera	sumatera	sumatera
sumatra	sumatra	(proper noun) the island of sumatra
sumitomo	sumitomo	sumitomo
summer	musim panas	summer
summerslam	musim panas	(proper noun) summerslam
sun	matahari	sun
sunday	minggu	(proper noun) sunday
sung	buah ara	supplement
sunni	sunni	sunni
sunsilk	berjemur	sunsilk, a hair products company
super	super	super
suriname	suriname	suriname
susan	susan	(proper noun) susan
susilo	susilo	(proper noun) susilo
sutra	sutra	sutra
suub	suub	a name
suvp	suvp	suv-p
suy	terganggu	decrease
suê	jadi	lush
suôn	dengan lancar	smooth
suất	produktivitas	number
suối	aliran	stream
suốt	seluruh	through/all over
suồng	halus	overfamiliar
svd	svd	svd
swan	angsa	swan
swaziland	sewati	swaziland
sweet	manis	sweet
sy	sy	sy
sydney	sydney	(proper noun) sydney, a city in australia
symantec	symantec	symantec
sync	sinkronkan	sync
syria	syria	syria
sài	sai	"(term should be ""sơ sài"") something done without care (adv.)"
sàn	lantai	san
sàng	ayakan	ready
sành	barang pecah belah	"(term should be ""sành sứ"") pottery"
sào	kutub	"(term should be ""sào huyệt"") den or hideout (n.)"
sá	sá	road
sách	buku	list
sái	salah	sai
sám	bertobat	penitent
sáng	pagi	light
sánh	komparatif	compare
sáo	seruling	flute
sáp	lilin	merger
sát	tutup	"(term should be ""quan sát"") to watch or observe (v.)"
sáu	enam	six
sâm	ginseng	sam
sân	halaman	"(should be ""sân khấu"") a stage"
sâu	dalam	deep
sã	sa	flippant
sãi	salah	pagoda warden
são	são	sao, as in sao paolo, brazil
sét	kilat	clay
sê	se	sepon
sêri	seri	series
sêu	lumut	seu tet
sính	siswa	betrothal gifts
síp	siprus	cyprus
sít	kencang	close
sò	tiram	oyster
sòng	kasino	casino
sóc	tupai	"(should be ""sóc trăng"") a vietnamese town"
sói	serigala	wolf
sóng	gelombang	wave
sót	kelalaian	to miss (v.)
sô	angka	than
sôi	mendidih	vibrant
sông	sungai	river
sùng	pengabdian	cult
sú	harimau hitam	a type of mangrove (n.)
súc	ternak	animal
sún	tenggelam	sun
súng	senjata	gun
súp	sup	source
sút	tembakan	reduce
săn	berburu	to hunt
sơn	dicat	a mountain
sư	profesor	lion
sưa	susu	filled with
sưng	pembengkakan	swell
sưu	koleksi	collection
sương	embun	dew (n.)
sướng	bahagia	high
sườn	daging	slope
sưởi	pemanasan	heat
sạch	bersih	clean
sạn	hotel	hotel
sảm	cerah	sam
sản	produksi	reproductive
sảng	segar	sonorous
sảnh	aula	a hall, as in the rock and roll hall of fame
sấm	guntur	ginseng
sấu	buaya	crocodile
sấy	pengeringan	dry
sầm	membanting	crowded
sầu	melankolis	sad
sẩn	papula	coarseness
sẫm	gelap	dark
sập	runtuh	destroy
sắm	belanja	shopping
sắn	singkong	cassava (n.)
sắp	akan	soon
sắt	besi	"(term should be ""sắt son"") constant (adj.)"
sẵn	tersedia	available
sẹo	bekas luka	scar
sẻ	akan	share
sẽ	akan	will
sọ	tengkorak	brain
sọc	garis-garis	stripe
sỏ	lancang	oligarchy
sỏi	kerikil	gravel
số	angka	"(term should be ""số lượng"") quantity (n.)"
sốc	kaget	shock
sống	hidup	live
sốt	demam	fever
sồi	oak	oak
sổ	buku	window
sớ	akan	document
sớm	awal	som
sờ	menyentuh	touch
sỡ	terjawab	colorful
sợ	takut	afraid
sợi	benang	fibers
sục	jacuzzi	"(term should be ""sôi sục"") to boil"
sụn	tulang rawan	cartilage
sụp	runtuh	collapse
sụt	merosot	drop
sủa	menggonggong	bright
sủi	berbuih	sparkling
sủng	karismatik	favored
sứ	porselen	embassy
sứa	ubur-ubur	jellyfish (n.)
sức	kekuatan	strength
sứt	terkelupas	cleft
sừng	klakson	sừng sững= huge
sử	sejarah	"(term should be ""sử dụng"") to use (v.)"
sửa	memperbaiki	repair
sửng	kaget	startling
sửu	lembu	cow
sữa	susu	milk
sự	itu	situation
ta	ta	us or our
tae	tae	(proper noun) tae
tag	tag	tag
tai	telinga	ear
taiji	taiji	(proper noun) taiji
taipei	taipei	taipei
taiwan	taiwan	taiwan
taj	taj	taj, as in taj mahal
tajikistan	tajikistan	tajikistan
tajima	tajima	tajima
tajiri	tajiri	tajiri
takahashi	takahashi	(proper noun) takahashi
taklamakan	taklamakan	taklamakan
tali	tali	thallium
taliban	taliban	taliban
talmud	talmud	talmud
tam	tam	three (n.)
tamoxifen	tamoxifen	tamoxifen
tanaka	tanaka	tanaka
tang	berkabung	funeral
tanh	mencurigakan	deserted
tankōbon	tankōbon	tankobon, as in a type of japanese literature
tanzania	tanzania	tanzania
tao	saya	(proper noun) tao, a chinese name
tarim	tarim	tarim
task	tugas	task
tasman	tasman	tasman, as in abel tasman
tasmania	tasmania	tasmania, a place
tau	tau	tau
taxi	taksi	taxi
tay	tangan	hand
taylor	taylor	taylor
tbt	tbt	tbt
tchad	tchad	tchad
tcm	tcm	tcm
tcp	tcp	tcp
technical	teknis	technical
ted	ted	(proper noun) ted
teddy	teddy	teddy, as in teddy lupin, a character in the harry potter series
telecom	telekomunikasi	telecom
telekom	telekom	telekom
telex	teleks	telex
telnet	telnet	telnet
tem	cap	stamp
temple	kuil	temple
temujin	temujin	temujin
temur	temur	(proper noun) temur, as in temur oljeitu
tenxơ	kartel	tensor
teo	atrofi	atrophy
terengganu	terengganu	(proper noun) terengganu
territories	wilayah	territories
terry	terry	terry
terumbu	terumbu	(proper noun) terumbu
tet	tet	tet
texas	texas	(proper noun) the state of texas
tgv	tgv	tgv
tha	itu	to forgive (v.)
thai	hamil	pregnant
thailand	thailand	thailand
tham	keserakahan	involved
thames	thames	thames
than	batubara	coal
thang	tangga	ladder
thanh	bar	youth
thani	thani	thani
thao	olahraga	sport
thau	kuningan	a basin (n.)
thay	sebagai gantinya	change
thcn	thcn	vocational school
thcs	terima kasih	secondary
thdq	thdq	thdq
thebes	thebes	thebes
their	mereka	their
them	mereka	plus
then	lalu	key
theo	ikuti	according to
theory	teori	thẻoy
theravada	theravada	theravada
theres	ada	there
theseus	ini kita	theseus, the greek hero
thi	ujian	competition (n.)
thich	seperti	explanation
thien	thien	sky
third	ketiga	thỉd
thiu	basi	buồn thiu= sad/boring
thiêm	thiem	thiem
thiêng	suci	"(term should be ""thiêng liêng"") sacred or holy"
thiếc	timah	tin
thiến	pengebirian	castrate
thiếp	kartu nama	concubine
thiết	diatur	"(term should be ""cần thiết"") necessary (adj.)"
thiếu	hilang	lack
thiềm	sabit	crescent
thiền	meditasi	buddhist (adj.)
thiển	tunjukkan	superficial
thiểu	kecil	minimum
thiện	bagus	good
thiệp	kartu	intervene
thiệt	sungguh	damage
thiệu	pengantar	"(term should be ""giới thiệu"") to introduce (v.)"
tho	ya	tho
thoa	oleskan	combination
thoai	thoai	gentle
thomas	thomas	thomas
thompson	thompson	thompson
thong	thong	(proper noun) thong, as in ang thong
those	itu	those
thoái	regresif	deterioration
thoán	tebak	usurpation
thoáng	lapang	"(term should be ""thoáng qua"") to pass quickly"
thoát	keluar	drainage
thoại	suara	telephone
thoạt	sekilas	just (adv.)
thoả	kesepakatan	compromise
thoải	nyaman	"(term should be ""thoải mái"") comfortable or relaxing (adj.)"
thoảng	sesekali	"(term should be ""thỉnh thoảng"") occasionally (adv.)"
thoắt	cepat	suddenly
thpt	terima kasih	high school
thriller	film thriller	thriller
thskts	terima kasih	phd- architect
thua	kalah	defeat
thumb|các	ibu jari |	thumb|many
thunderbolt	petir	thunderbolt
thung	lembah	valley
thuyên	perpindahan	a name
thuyết	teori	theory
thuyền	perahu	boat
thuê	menyewa	employ
thuần	murni	"(term should be ""đơn thuần"") pure (adj.)"
thuẫn	konflik	support
thuận	pro	favourable
thuật	seni	term
thuế	pajak	tax
thuốc	obat-obatan	medicine (n.)
thuộc	milik	belong
thuớc	air	"(term should be ""kích thước"") dimensions of an object"
thuờng	biasanya	usually
thuở	masa kecil	period
thuỵ	thuy	"(term should be ""thụy Điển"") the nation of sweden (proper noun)"
thuỷ	terima kasih	water
thvn	terima kasih	vietnam television
thy	milikmu	thy
thà	lebih suka	honest
thành	untuk	"(term should be ""hình thành"") to take shape"
thày	guru	teacher
thác	kaskade	harvest
thách	tantangan	challenge
thái	thailand	attitude
thám	detektif	to spy (v.)
tháng	bulan	month (n.)
thánh	suci	a holy person; a saint (n.)
tháo	lepaskan	"(term should be ""tháo chạy"") to run with abandon"
tháp	menara	tower
thâm	intensif	penetrate
thâu	direkam	to collect (v.)
thây	lihat	body
thãi	sial	superabundant
thèm	mendambakan	desire
thép	baja	steel
thét	teriaknya	shout
thê	itu	category
thêm	tambah	more
thêu	sulaman	to embroider (v.)
thìa	sendok	spoon
thìn	lalu	(proper noun) thìn, the year of the dragon
thình	tiba-tiba	"(term should be ""thình lình"") suddenly"
thí	percobaan	(with word du) for example
thít	itu	(proper noun) mân thít, a district in vietnam
thò	menyodok	tho
thòi	kerugian	"(term should be ""thiệt thòi"") to cost (adv.)"
thóc	padi	grain (n.)
thói	kebiasaan	a habit (n.)
thô	kasar	rough, old-fashioned
thôi	ayo	only
thông	diinformasikan	"(term should be ""thông thường"") usual (adj.)"
thù	permusuhan	"entire term should be ""ke thu""; means ""enemy"""
thùng	laras	barrel
thùy	lobus	thuy
thú	menarik	"(should be ""thích thú"") pleasurable"
thúc	akhir	push
thúy	thuy	thuy
thăm	kunjungi	visit
thăng	dipromosikan	helicopter
thơm	harum	aromatic
thư	surat	"(term should be ""ung thư"") cancer (n.)"
thưa	sayang	sparse
thương	cinta	love
thước	penguasa	ruler
thường	sering	usually (adv.)
thưởng	hadiah	to reward (v.)
thược	gedebuk	(proper noun) thược
thượng	atas	upper
thạc	tuan	master
thạch	jeli	rock or stone (n.)
thạnh	selain itu	thanh
thạo	ahli	fluent
thả	jatuh	"(term should be ""thả lỏng"") to let loose (v.)"
thải	limbah	waste
thảm	karpet	carpet or rug (n.)
thản	tenteram	calmly
thảo	thao	"(term should be ""hội thảo"") a workshop (n.)"
thấp	rendah	low (adj.)
thấu	penetran	penetrate
thầm	diam-diam	"(term should be ""thì thầm"") to whisper (v.)"
thần	tuhan	"entire term should be ""tinh than""; means ""of the mind"""
thầy	guru	teacher (n.)
thẩm	anggota juri	osmotic/leak
thẫm	gelap	dark
thận	ginjal	careful
thập	silang	tens
thật	benar	true (adj.)
thắm	kelopak	tham
thắn	terus terang	frank
thắng	menang	win
thắngthua	wonthua	win-lose
thắp	cahaya	light
thắt	mengikat	tense
thằn	kadal	"entire term should be ""than lan""; means ""lizard"""
thằng	kawan	a derogatory term for a man (n.)
thẳm	dalam	"(term should be ""thăm thẳm"") extremely deep (adj.)"
thẳng	lurus	horizontal
thặng	surplus	surplus
thẹn	malu	shameful
thẻ	kartu	card
thế	jadi	"with word ""tu,"" means ""posture"" or ""a position"""
thếp	baja	steel
thề	bersumpahlah	swear
thềm	rak	shelf
thể	menjadi	maybe
thỉnh	terkadang	"(term should be ""thỉnh thoảng"") occasionally"
thịnh	mode	prosperous
thịt	daging	meat (n.)
thọ	umur panjang	phu tho
thọc	tusukan	jab
thỏ	kelinci	rabbit
thỏa	kesepakatan	"(term should be ""thoả thuận"") to come to an agreement (v.)"
thỏi	ingot	a bar (n.)
thối	busuk	smelly
thốt	diucapkan	scream
thồ	pak	to transport via horse (v.)
thổ	bumi	"(term should be ""lãnh thổ"") territory (n.)"
thổi	untuk meniup	blow
thớt	talenan	sparse
thời	waktu	period
thở	bernafas	breathe
thợ	pekerja	craftman
thụ	reseptor	"(term should be ""thụ thai"") to become pregnant"
thục	shu	(proper noun) a vietnamese first name
thụt	indentasi	clyster
thủ	prima	masturbate
thủa	thua	during childhood
thủng	perforasi	having holes
thứ	th	no.
thức	bangun	way
thừa	mubazir	redundant
thừng	tali	"(term should be ""thẳng thừng"") mercilessly"
thử	coba	try
thửa	parsel	square
thự	vila	mansion
thực	nyata	perform
ti	ti	titov
tia	sinar	ray
tiananmen	tiananmen	tiananmen
tiara	tiara	tiara
tibet	tibet	(proper noun) tibet
tigris	tigris	tigris
tiliaceus	tiliaceus	hoa dam but
tim	hati	heart
timor	timor	timor
timothy	timothy	timothy
tin	percaya	believe
tinbắc	pesan	file bac
tincầu	jembatan timah	file bridge
tinh	planet	"(term should be ""tinh dịch"") sperm (n.)"
tinnhà	tinhome	folder: house
tinsông	berita	file river
tinthị	tinthị	file: town
tirol	tirol	tirol
tisdale	tisdale	tisdale
tish	tish	(proper noun) tish
tissa	tissa	(proper noun) tissa, as in moggaliputta tissa
tivi	televisi	television
tizard	kadal	(proper noun) tizard
tiên	pertama	first
tiêu	merica	"entire term should be ""tieu chuan""; means ""a requirement"""
tiếc	sayangnya	"(term should be ""tiếc thương"") to pity (v.)"
tiếm	bodoh	seize
tiến	maju	operate
tiếng	jam	language
tiết	sekresi	abstinence/intensity
tiếu	konyol	"(should be ""đàm tiếu"") to sneer"
tiềm	potensial	potential
tiền	uang	money (n.)
tiều	sial	(proper noun) the name of a poet
tiểu	kencing	tiểu sử= biography
tiễu	tuan liu	patrol
tiệc	pesta	party
tiệm	salon	shop
tiện	nyaman	mean
tiệp	ceko	gustav franck
tiệt	sialan	sterilize
tncs	tncs	communist youth union
tngt	tngt	traffic accidents
tnhh	terbatas	limited
toang	toang	fast
tobago	tobago	tobago
toei	toei	toei
tokugawa	tokugawa	tokugawa
tokyo	tokyo	tokyo, the capital of japan
tokyopop	tokyopop	tokyopop
tomas	tomas	(proper noun) tomas
tommy	tommy	tommy
tomoyo	tomoyo	tomoyo
tony	tony	tony
toonami	toonami	(proper noun) toonami
top	atas	top
torino	torino	torino, as in the italian city
toriyama	toriyama	(proper noun) toriyama
tottenham	t tottenham	tottenham
tourism	pariwisata	tourism
tourist	turis	tourist
toyama	toyama	toyama
toyota	toyota	(proper noun) toyota
toà	pengadilan	office
toàn	aman	entire or whole (adj.)
toán	matematika	team
toát	bagus	to exude or emit, as in sweat (v.)
toạ	koordinat	locate
toại	di	satisfaction
toả	memancarkan	spread
tp	tp	city
tphcm	tphcm	ho chi minh city
tphồ	kota	city ho
tpvĩnh	kota	vinh city
tqlc	tqlc	marine
trafalgar	trafalgar	(proper noun) trafalgar
trafford	trafford	trafford in greater manchester
trai	kerang	boy
trang	halaman	a page (n.)
tranh	gambar	to compete (v.)
trao	diberikan	reward
trau	trau	polish
tre	bambu	bamboo (n.)
treo	menggantung	hang
tri	tri	tri
tribune	tribun	a name
trinh	perawan	"(should be ""trinh bạch"") virtuous"
trinidad	trinidad	trinidad
trinity	trinitas	trinity
tristan	tristan	tristan
triết	filsafat	philosophy
triền	trien	"(should be ""triền miên"") endless"
triều	pasang	court
triện	meterai	stamp
triệt	secara menyeluruh	completely
triệu	juta	a million
tro	abu	ashes
troia	troia	troy
trondheim	trondheim	trondheim
trong	masuk	inside (adv.)
true	benar	true
truman	truman	(proper noun) truman
trung	tengah	"(term should be ""trung gian"") agent (n.)"
trungnhật	kejujuran	china-japan
truong	truong	truong
truyên	truyen	story
truyện	cerita	story
truân	benar	arduous
truất	pencela	cancel
truởng	kepala	leader (n.)
truỵ	berbohong	depraved
trà	teh	tea (n.)
tràm	cajuput	melaleuca
tràng	usus besar	"entire term should be ""truc trang""; means ""rectum"""
trào	letusan	movement
trác	trac	trac
trách	menyalahkan	blame
trái	kiri	against
trán	dahi	forehead
tráng	dilapisi	to coat (v.)
tránh	hindari	to avoid (v.)
tráo	secara curang	tráo trở= liar/betrayal/treacherous
tráp	peti mati	casket
trát	surat perintah	pile
trâm	bros	a type of elegant hairpin (n.)
trân	salam	respect
trâu	kerbau	a last name
trãi	tersebar	trai
trèo	memanjat	climb
trên	pada	above
trình	pengajuan	process
trí	pikiran	intellectual
trích	kutipan	to extract (v.)
trò	permainan	role
tròn	bulat	rounding
trói	diikat	tie
trôi	melayang	afloat
trông	terlihat	look
trùm	bos	cover
trùng	bertepatan	"(should be ""tinh trùng"") sperm"
trùy	truy	something to with monk
trú	naik	residence
trúc	bambu	structure
trăm	seratus	hundred
trăn	ular sanca	"(term should be ""trăn trở"") to ponder (v.)"
trăng	bulan	moon
trĩ	wasir	hemorrhoids
trũng	cekung	medium
trơ	lembam	bare
trơn	halus	slippery (adj.)
trư	tru	a pig (n.)
trưa	siang	noon (n.)
trưng	permintaan	symbolic
trưngcông	dipamerkan	truongcong
trương	truong	policy
trước	sebelumnya	front
trước 	sebelumnya	front
trướng	ekspansi	expand
trườn	merangkak	crawl
trường	sekolah	case
trượng	caduceus	a unit of length used in vietnam equal to 4 meters (n.)
trượt	terpeleset	slide
trạch	trach	ze
trại	kemah	camp
trạm	stasiun	station
trạng	kondisi	situation
trạo	tao	trao
trả	bayar	to return
trải	penutup	spread
trảm	cajuput	beheaded
trảo	parang	trao
trấn	kota	town
trấu	sekam padi	rice skin
trầm	bass	depression
trần	telanjang	tran
trầu	sirih	trầu
trầy	tergores	scratch
trẩy	terpental	pilgrimage
trẫm	saya	i
trận	pertandingan	battle
trật	terkilir	order
trắc	biometrik	"(term should be ""trắc ẩn"") to have pity (adj.)"
trắng	putih	white
trặc	cegukan	"entire phrase is ""truc trac""; means ""problem"""
trẻ	muda	youth
trễ	terlambat	late
trệ	stagnan	bamboo
trị	perawatan	cure
trịnh	phnh	trịnh, a vietnamese last name
trọ	penginapan	motel
trọn	penuh	whole
trọng	penting	serious
trỏ	pointer	index
trối	terakhir	last words
trốn	bersembunyi	to hide
trống	kosong	in
trồi	muncul	to emerge (v.)
trồng	penanaman	plant
trổ	tunjukkan	to burst open or display
trỗi	munculnya	rise
trội	dominan	better
trộm	pencuri	theft
trớn	sayang	"(term should be ""mơn trớn"") to fondle or caress (v.)"
trời	tuhan	sun
trợ	dukungan	support
trụ	kantor	universe
trục	poros	"(term should be ""khu trục"") fighter, in reference to planes (adj.)"
trụi	telanjang	"(term should be ""trơ trụi"") bare (adj.)"
trứ	tru	famous
trứng	telur	egg
trừ	kecuali	except
trừng	silau	punish
trừu	abstrak	abstract
trữ	penyimpanan	reserve
trực	bertugas	direct
ts	ts	phd
tt	tt	news
tua	tentakel	fringe
tucker	tucker	tucker, an english last name
tudor	tudor	(proper noun) tudor, as in the tudor family
tukhachevsky	tukhachevsky	(proper noun) tukhachevsky
tulip	tulip	tulip
tum	tum	tum
tung	lempar	release
tupolev	tupolev	tupolev, as in alexei tupolev
tuscan	tuscan	(proper noun) tuscan
tutsi	tutsi	(proper noun) tutsi
tuvalu	tuvalu	(proper noun) tuvalu, a polynesian island nation
tuy	namun demikian	however
tuyên	menyatakan	"(should be ""tuyên ngôn"") a declaration"
tuyết	salju	snow (n.)
tuyền	tuyen	tuyen
tuyển	rekrutmen	recruit
tuyệt	bagus	excellent (adj.)
tuân	patuh	comply
tuông	siram	jealous
tuý	tuyý	drug
tuần	minggu	week
tuế	ikan kecil	years
tuệ	kebijaksanaan	intelligence
tuốc	pencabutan	turbine
tuổi	umur	age
tuộc	gurita	octopus
tuột	lolos	slip
tuỳ	opsional	depend
tv	tv	tv
tvb	tvb	tvb
twin	kembar	twin
twitter	twitter	twitter
ty	ty	company
type	jenis	type
typhon	typhon	typhon
tà	jahat	we
tài	keberuntungan	talent (n.)
tàn	abu	dying
tàng	museum	"(should be ""bảo tàng"") a museum"
tành	tanh	shatter
tàu	kapal	ship
tá	selusin	"(term should be ""thiếu tá"") major (n.)"
tách	cangkir	to separate
tái	kembali	return
tám	delapan	eight
tán	kanopi	support
tánh	tanh	life
táp	ketuk	to lap at (v.)
táu	bersalah	ashton
tâm	pikiran	tâm
tâu	tuanku	peach
tây	barat	western
tâynam	westnam	"(should be ""tây-nam"") southwest"
tã	popok	diaper
tét	pekik	tet
tê	mati rasa	numb
tên	nama	name (n.)
tì	limpa	to lean on (v.)
tìm	temukan	find
tìmdiệt	cari	find-kill
tình	cinta	sex
tía	ungu	dad
tích	produk	"(term should be ""tích cực"") to be zealous (adv.)"
tím	ungu	purple
tín	kredit	"(entire term should be ""tín dụng"") credit"
tít	berita utama	"(term should be ""tít mù"") very far away (adv.)"
tò	rasa ingin tahu	curious
tòa	pengadilan	a court
tòi	barang-barang	"(term should be ""tìm tòi"") to search doggedly for something (v.)"
tòng	tong	tòng, a last name
tóm	ringkasan	summary
tô	mangkuk	car
tôi	saya	i
tôm	udang	shrimp
tôn	bergelombang	venerate
tông	kardus	tông, as in lê thánh tông; first name of an ancient vietnamese emperor
tù	penjara	prison
tùng	cadangan	tung
tùy	opsional	depend on
túc	kecukupan	"(term should be ""bổ túc"") to give a refresher course (v.)"
túi	tas	pocket
túm	ambil	catch
túng	canggung	confuse
túp	tapi	hut
túy	obat-obatan	"(term should be ""thuần túy"") pure (adj.)"
tý	tikus	mouse, as in year of the mouse
tăm	tusuk gigi	"(term should be ""tiếng tăm"") reputation"
tăng	meningkat	increase
tĩnh	statis	calm
tơi	saya	ragged
tư	dari	posture
tưng	goyah	"(term should be ""tưng bừng"") joyously (adv.)"
tươi	segar	fresh
tương	serupa	"(term should be ""tương tự"") to be similar to"
tước	ditelanjangi	title (n.)
tưới	penyiraman	irrigation
tướng	umum	prime minister (thu tuong)
tường	dinding	"a common vietnamese first name; means ""wall"""
tạ	barbel	weight
tạc	memahat	"(term should be ""oanh tạc"") to bomb from the air (v.)"
tại	di	survival
tạm	sementara	temporary
tạo	buat	create
tạp	majalah	"(should be ""hỗn tạp"") a jumble or mish-mash"
tả	deskripsi	describe
tản	disipasi	disperse
tảng	platform	platform
tấc	inci	inch
tấm	piring	mirror
tấn	ton	tan
tấp	ditarik	crowded
tất	kaus kaki	all
tấu	instrumental	tau
tầm	game	range or extent (n.)
tần	frekuensi	"(term should be ""tần số"") frequency (n.)"
tầng	lantai	layer
tầu	melatih	ship
tẩm	diresapi	soak
tẩy	penghapus	to bleach
tận	akhir	dedicated
tật	kecacatan	disease
tắc	sakelar	priciple
tắm	mandi	bathing
tắt	off	initial
tặc	peretas	"(term should be ""hải tặc"") a pirate (n.)"
tặng	menyumbang	donate
tẻ	menjemukan	lẻ tẻ= scattered
tết	tet	(proper noun) the vietnamese new year
tếxã	secara ekonomi	economy - society
tề	qi	tidy
tể	tuan	lord
tệ	buruk	bad
tệp	file	file
tỉa	dipangkas	"(term should be ""bắn tỉa"") to snipe"
tỉnh	provinsi	province
tị	iri	refugee
tịch	presiden	"(""chủ tịch"") president or chairman"
tọa	koordinat	"(term should be ""chủ toạ"") chairman (n.)"
tỏ	diungkapkan	to
tỏa	memancarkan	radiate
tỏi	bawang putih	garlic
tốc	kecepatan	speed
tốn	biaya	to cost (v.)
tống	pengawalan	dispose
tốp	geng	top
tốt	bagus	good
tồi	buruk	bad
tồn	ada	exist
tổn	terluka	damage
tổng	total	president
tộc	klan	"(term should be ""dân tộc"") a race or people"
tội	kejahatan	crime
tột	ekstrim	extreme
tớ	saya	servant
tới	untuk	to the point
tờ	lembar	paper/document
tởm	menjijikkan	disgusting
tục	tidak senonoh	"(term should be ""tập tục"") customs or practices"
tụy	pankreas	"(term should be ""tận tụy"") devoted (adj.)"
tủ	lemari	shelf
tủi	buruk	humiliated
tủy	medula	spine
tức	instan	i.e.
từ	dari	from
từng	masing-masing	each
tử	kematian	lion (su tu)
tửu	minum	wine
tự	diri	"(term should be ""tương tự"") like or similar to (adv.)"
tựa	judul	lean
tựu	prestasi	achievement
tỵ	ular	the han name for the year of the snake, according to the chinese zodiac
tỷ	miliar	billion
u	kamu	tumor
ua	ua	ua
uae	uae	uae
ubuntu	ubuntu	ubuntu
uc	uc	uc
uchiha	uchiha	uchiha
uefa	uefa	uefa
uh	uh	uh
uk	uk	uk
ukiyoe	ukiyoe	ukiyoe
ukraina	ukraina	ukraine
ulsan	ulsan	ulsan
umm	umm	umm
un	un	(proper noun) un, as in chung un chan of korea
und	und	und
under	di bawah	under
unesco	unesco	unesco
ung	ung	cancer
unicorn	unicorn	unicorn
unit	unit	unit
unix	unix	unix
up	up	up
ural	ural	ural, as in the ural mountains
urani	uranium	uranium
uri	uri	uri, a former political party in south korea
uruguay	uruguay	uruguay
usagi	usagi	usagi
usb	usb	usb
uss	kita	uss
utah	utah	utah
utrecht	utrecht	(proper noun) utrecht
uy	kamu	"(term should be ""uy lực"") power (n.)"
uyghur	uyghur	(proper noun) uyghur
uygur	uygur	uygur
uyên	uyen	scholarly
uyển	eufemisme	"(term should be ""uyển chuyển"") flexible (adj.)"
uzbekistan	uzbekistan	uzbekistan
uông	uong	uong
uất	ya	busy
uốn	lentur	to curl (v.)
uống	untuk minum	to drink
uổng	buang-buang	vain
v	v	v
va	va	collide
vaccine	vaksin	vaccine
vai	bahu	shoulder
valencia	valencia	valencia
valentine	valentine	valentine
valley	lembah	valley
van	van	"(term should be ""van xin"") to beg (v.)"
vanessa	vanessa	vanessa
vargas	vargas	(proper noun) vargas
vasari	vasari	vasari
vay	pinjam	borrow
vectơ	vektor	vector
ven	ven	"(term should be ""ven biển"") coastal (adj.)"
vendôme	dendam	vendome
venezia	venezia	venice
venus	venus	venus
verdun	verdun	verdun
vermont	vermont	vermont
verona	verona	(proper noun) the city of verona
versailles	versailles	(proper noun) versailles
vhs	vhs	vhs
vi	id	behavior
viagra	viagra	viagra
victor	pemenang	(proper noun) victor
victoria	victoria	victoria, a province of australia
vienna	vienna	(proper noun) vienna, austria
viet	viet	vietnamese
vietnam	vietnam	vietnam
viettel	viettel	viettel
viii	viii	eighth
vijaya	vijaya	(proper noun) vijaya
viking	viking	viking
villa	vila	villa
villeneuve	villeneuve	(proper noun) villeneuve, a french last name
vinagame	vinagame	vinagame
vinashin	vinashin	vinashin
vince	vince	(proper noun) vince, as in vince mcmahon
vincennes	vincennes	vincennes
vincent	vincent	vincent
vinpearl	vinpearl	vinepeal
viqr	viqr	viqr
virginia	virginia	(proper noun) virginia, as in the state
virus	virus	virus
virút	virus	virus
vissarionovich	vissarionovich	vissarionovich
vista	pemandangan	vista, as in windows vista
vitamin	vitamin	vitamin
vitruvius	vitruvius	vitruvius
viz	yaitu	(proper noun) viz
viêm	peradangan	inflammation
viên	tablet	member
viêng	viang	vientiane
viêt	menulis	vietnam
viếng	kunjungi	visit
viết	tulis	write
việc	bekerja	thing
viện	institut	institute
việt	orang vietnam	viet
việtmường	muong vietnam	muong
việtnga	vietnga	vietnam-russia
việttrung	viettrung	vietnam-china
vn	vn	vietnam
vnexpress	vnekspresikan	(proper noun) vnexpress
vni	vni	vni
vo	vo	"(term should be ""tròn vo"") perfectly round (adj.)"
voi	gajah	elephant
voip	voip	voip
voldemort	voldemort	(proper noun) voldemort, the villain from the harry potter series
von	von	compare
vonfram	tungsten	wolfram
vong	korban	injured
voyager	voyager	voyager
voọc	lutung	a langur (n.)
vtc	vtc	vtc
vu	vu	"entire phrase is ""vu cao""; means ""to accuse wrongly"""
vua	raja	king
vui	menyenangkan	happy
vulcan	vulcan	vulcan
vuông	persegi	square
vuốt	cakar	stroke
vv	dll.	etc.
vy	vy	vy
vyacheslav	vyacheslav	vyacheslav
và	dan	and
vài	sedikit	several
vàm	vm	the mouth of a rivulet (n.)
vàng	emas	gold
vành	pelek	coronary
vào	pada	into
vá	tambalan	patchy
vác	membawa	to shoulder (v.)
vách	dinding	wall
vái	ya	some
ván	papan	game
váng	sampah	film
váy	rok	skirt
vân	begitu seterusnya	"(term should be ""vân vân"") et cetera"
vây	sirip	encircle
vã	bergegas	rush
vãi	sial	to release
vãn	van	save
vè	kencing	to glance slyly (v.)
vé	tiket	ticket
vét	kapal keruk	plunder
vê	tentang	tremolo
vì	karena	because
ví	dompet	example
vía	dompet	soul
vít	sekrup	screw
vò	kusut	jar
vòi	selang	tap
vòm	lengkungan	upper jaw
vòng	bulat	around
vó	hoooo	hooves
vóc	fisik	"(should be ""vóc sương"") dew-like or delicate"
vô	tidak	"(term should be ""vô số"") countless (adj.)"
vôi	jeruk nipis	limestone
võ	bela diri	martial arts (n.)
võng	tempat tidur gantung	hammock
vùi	terkubur	"(term should be ""chôn vùi"") to bury or keep secret (v.)"
vùng	wilayah	region
vú	payudara	breast (n.)
vút	melonjak	"entire term should be ""cong vut""; extreme curling"
văn	diposting	culture
văng	percikan	a name
vĩ	bagus	"(term should be ""vĩ đại"") great (adj.)"
vĩnh	secara permanen	ving
vũ	vu	armed
vũng	genangan air	vung
vơ	tak berdaya	lost
vơi	dengan	ullage
vưu	vưu	"actual term is ""xi vưu""; proper noun; name of a leader of a people in chinese legend"
vươn	mencapai	reach
vương	raja	kingdom
vướng	terjerat	"(term should be ""vướng víu"") to become involved in (v.)"
vườn	taman	garden
vượn	kera	gibbon
vượt	lulus	to overcome
vạ	jadi	unfortunate problem
vạc	kuali	cauldron
vạch	bar	bar
vại	tangki	jar
vạn	sepuluh ribu	thousand
vạng	senja	twilight
vả	gbr	hard
vải	kain	fabric
vảy	sisik	scale
vấn	saran	vấn đề= problem
vấp	tersandung	stumble
vất	buang	hard
vần	sajak	spell
vầng	halo	moon (vang trang)
vẩn	tetap saja	wander
vẩy	serpih	scale
vẫn	tetap saja	still
vẫy	melambai	wave
vận	keberuntungan	active
vắc	vaksin	vaccine
vắcxin	vaksin	vaccine
vắn	singkat	short
vắng	absen	absent
vặn	sekrup	to twist (v.)
vặt	iklan baris	odd
vẹn	integritas	complete
vẹt	burung beo	parrots
vẽ	menggambar	draw
vết	noda	wound
vểnh	hinggap	warping
vệ	pertahanan	"(term should be ""bảo vệ"") to defend (v.)"
vệt	garis-garis	streak
vỉa	jahitan	"(term should be ""vỉa hè"") sidewalk"
vịnh	teluk	bay
vịt	bebek	duck
vọng	harapan	"(term should be ""hy vọng"") hope (n.)"
vọt	meroket	to spurt out (v.)
vỏ	cangkang	shell
vồ	palu	"(term should be ""gạch vồ"") a type of brick"
vỗ	pat	to clap
vội	cepat	hurriedly (adv.)
vớ	kaus kaki	"(term should be ""vớ vẩn"") silly (adj.)"
với	dengan	to
vớt	diselamatkan	salvage
vờ	berpura-pura	"(term should be ""giả vờ"") to pretend (v.)"
vời	bagus	wonderful
vở	notebook	"(term should be ""vở kịch"") a play"
vỡ	rusak	break
vợ	istri	wife
vụn	keripik	debris
vụng	kikuk	covert
vứt	buang	throw away
vừa	sedang	just (adv.)
vừng	wijen	sesame (n.)
vững	tegas	firm (adj.)
vực	bidang	place
vựng	kosakata	"(term should be ""từ vựng"") regional vocabulary (n.)"
vỹ	jadi	majestic
w	w	w
wa	wa	wa
walt	walt	(proper noun) walt, as in walt disney
walter	walter	walter
walther	walther	walther
wan	wan	wan
wang	wang	wang
wankel	wankel	(proper noun) wankel
wanna	mau	wanna
warren	warren	a name
warsaw	warsaw	warsaw
warszawa	warszawa	(proper noun) warsaw
washington	washington	(proper noun) washington
wat	wat	(proper noun) wat, as in angkor wat, the temple in cambodia
watergate	pintu air	watergate
waterloo	burung air	(proper noun) waterloo
waters	perairan	waters
wayne	wayne	wayne
wcdma	wcdma	w-cdma
weasley	weasley	weasley, as in ron weasley in the harry potter series
weblog	weblog	weblog
webmail	webmail	ưebmail
weimar	weimar	(proper noun) weimar
wellington	wellington	wellington
wells	sumur	wells, as in author orson wells
welsh	welsh	(proper noun) welsh, as in the welsh language
wembley	wembley	wembley, as in wembley stadium
werner	werner	werner
westermarck	westermarck	westermarck
western	barat	western
westlife	kehidupan barat	westlife
westview	pandangan barat	westview, as in westview press
wheeler	kendaraan roda	a name
widener	pelebar	widener
wien	wien	wien
wiener	wiener	wiener
wifi	wifi	wi-fi, a technology term
wiki	wiki	wiki
wikia	wikia	a name
wikibooks	wikibooks	(proper noun) wikibooks
wikimapia	wikimapia	wikimapia
wikimedia	wikimedia	wikimedia
wikitravel	perjalanan	a name
wild	liar	wild
wilder	lebih liar	(proper noun) wilder, as in billy wilder
wiley	licik	wiley
willard	willard	willard
wimbledon	wimbledon	wimbledon
windows	windows	windows
winer	pemenang	winer
wisconsin	wisconsin	(proper noun) wisconsin
within	di dalam	within
without	tanpa	without
wolfgang	wolfgang	wolfgang
won	menang	won
wong	wong	wong
woodrow	woodrow	woodrow
woods	hutan	(proper noun) woods, as in tiger woods
would	akan	would
wrestling	gulat	wrestling
wright	wright	a name
wu	wu	wu
wushu	wushu	wushu, a type of martial art
wwf	wwf	wwf
xa	jauh sekali	ancient
xang	xang	"(term should be ""lan xang"") name of an ancient country in southeast asia"
xanh	hijau	green
xao	lemah	xôn xao = chatting
xay	menggiling	grind
xe	mobil	a car (n.)
xem	lihat	watch
xen	interlaced	to insert (v.)
xhcn	xhcn	social republic
xi	xi	xi
xiii	xiii	eighth
xin	tolong	please
xinh	cantik	beautiful
xiv	xiv	fourteenth
xiêm	siam	(proper noun) xiêm, or siam
xiên	miring	oblique
xiêu	xiao	soften
xiếc	sirkus	circus
xiết	kencangkan	to twist tightly (v.)
xiềng	belenggu	chain
xo	xo	spring
xoa	gosok	massage
xoay	putar	turn
xong	selesai	completed
xoàng	biasa-biasa saja	mediocre
xoá	hapus	delete
xoáy	berputar	vortex
xoắn	memutar	coiled
xu	sen	trend
xua	menghilangkan	dispel
xuan	xuan	"(term should be ""xuân"") a common vietnamese middle or first name; means ""the season of spring"""
xui	sial	incite
xuka	xuka	xuka
xum	mewah	a name
xuyên	menusuk	frequently
xuyến	batang tubuh	manage
xuân	musim semi	spring
xuâncông	musim semi	xuan public
xuôi	tersapu	down
xuất	ekspor	ejaculate
xuấtnhập	ekspor	import/export
xuống	bawah	down
xuồng	sampan	boat
xv	xv	fifteenth
xvi	xvi	xvi
xvii	xvii	xvii
xx	xx	xx
xy	xy	cylinder
xài	menghabiskan	use
xào	tumis	stir fry
xách	tas tangan	to carry by the handle (v.)
xám	abu-abu	ustox
xán	digoreng	"(term should be ""xán lạn"") bright (adj.)"
xáo	gangguan	chaos
xát	menggosok	touch
xâm	tato	invasion
xâu	tali	string
xây	membangun	build
xã	komune	society
xãy	berubah-ubah	occur
xèo	xèo	xeo
xé	sobek	tear
xén	tanam	"(term should be ""biếu xén"") to gift (v.)"
xéo	miring	diagonally (adv.)
xét	pertimbangkan	examine
xê	bergerak	"(term should be ""bánh xu xê"") a type of vietnamese cake"
xêkô	suneo	xeko
xì	kentut	scandal
xìu	kentut	to become flaccid (v.)
xí	pabrik	factory (xi nghiep)
xít	menarik	nazi
xíu	mungil	small
xòe	menyebar	spread
xóa	hapus	clear
xói	erosi	erode
xóm	tetangga	village
xót	belas kasihan	mercy
xô	ember	soviet
xôi	ketan	pierce
xôn	aduk	tumultuous
xông	bergegas	rush
xôphần	bagian ember	soviet-poland
xôviết	uni soviet	soviet
xù	mengacak-acak	gigantic
xú	kasar	xu
xúc	kontak	touch
xúi	memprovokasi	induce
xăm	tato	"(term should be ""xa xăm"") far away (adj.)"
xăng	bensin	gasoline
xơ	serat	xo
xưa	tua	old
xưng	mengaku	"(should be ""tự xưng"") self-proclaimed"
xương	tulang	bone (n.)
xước	tergores	scratch
xướng	paduan suara	provoke
xưởng	bengkel	workshop
xạ	radiasi	"(term should be ""phản xạ"") to reflect"
xả	debit	release
xảo	licik	detailed
xảy	terjadi	happen
xấp	sekitar	approximate
xấu	buruk	bad
xẩm	berbulu	a type of traditional vietnamese singing
xẩy	terjadi	occur
xắt	potong	cut
xẻo	sial	cut off
xếp	terlipat	rank
xỉ	terak	approximately
xỉa	benang	to pick (v.)
xỉu	pingsan	to faint
xốc	kaget	to lift up (v.)
xốp	keropos	porous
xổ	undian	rush into
xộn	berantakan	messy
xứ	dibuat	native
xứng	layak	appropriate
xử	mengobati	judge
y	y	medical
y=fracsin	y = fracsin	a function
ya	ya	(proper noun) ya, as in ya trang
yakovlev	yakovlev	yakovlev
yakushima	yakushima	yakushima
yalta	yalta	(proper noun) yalta
yankee	yankee	(proper noun) yankee
yard	halaman	yard
yasha	yasha	a name
yeeun	yeeun	(proper noun) yeeun
yeltsin	yeltsin	yeltsin, as in boris yeltsin
yemen	yemen	yemen
yersin	yersin	(proper noun) yersin, asin alexandre yersin
yi	yi	(proper noun) yi
ying	ying	(proper noun) ying, as in ying yang
ymca	ymca	ymca
yo	yo	yo
yomiuri	yomiuri	yomiuri
yoochun	yoochun	yoochun
york	york	york
yorker	yorker	yorker
yorkshire	yorkshire	yorkshire
youtube	youtube	youtube
ypres	ypres	ypres
ytv	ytv	ytv
yu	kamu	yu
yuan	yuan	(proper noun) yuan, as in yuan mu
yucatán	yucatán	yucatan, as in the yucatan peninsula
yudhoyono	yudhoyono	(proper noun) yudhoyono, as in indonesian president susilo bambang yudhoyono
yugi	yugi	yugi
yukito	yukito	yukito
yume	yume	(proper noun) yume
yunho	yunho	yunho
yuri	yuri	yuri, as in soviet pilot and cosmonaut yuri alekseyevich gagarin
yurt	yurt	yurt
yên	yen	peace or stillness (n.)
yêu	cinta	love
yếm	baju	tender
yến	sarang burung	a type of swallow (n.)
yết	daftar	yet
yếu	lemah	mainly
yểm	penutup	support
yển	yen	"is a name meaning, ""bird"""
yểu	indah	"(term should be ""yểu điệu"") graceful (adj.)"
z	z	z
zac	zac	zac
zambia	zambia	(proper noun) zambia, as in the nation
zealand	selandia	(proper noun) zealand, as in new zealand
zedong	zedong	mao zedong
zero	nol	zero
zeus	zeus	zeus
zheng	zheng	zheng
zhukmse	zhukmse	zhuk-mse
zimbabwe	zimbabwe	zimbabwe
zinedine	zinedine	(proper noun) zinedine
zing	tenaga	zing, as in the website
zoe	zoe	zoe
zurich	zurich	(proper noun) zurich
zürich	zürich	(proper noun) zurich, as in zurich, switzerland
|nguyễn	| nguyen	a common vietnamese last name
|nổi	| mengapung	"(term should be ""nổi"") to float (v.)"
|petya	| petya	(proper noun) petya
|tên	| nama	"(should be ""tên"") name (n.)"
|việt	| vietnam	vietnam
 kg	kg	kg
 triệu	juta	million
 °c	° c	degrees celsius
°đến	° ke	up to
°độ	derajat °	degree
×	×	x
ào	wow	rush
á	á	asia
ác	jahat	evil
ách	kuk	yoke (n.)
ái	keinginan	ai
ám	merender	(with the word chi) to hint at
ánh	kilau	light
áo	mantel	clothe
áohung	aohung	"(term should be ""Áo-hung"") austria-hungary"
áp	tekanan	"(term should be ""huyết áp"") blood pressure (n.)"
áâu	aoi	eurasian
â	â	a vietnamese vowel sound
âm	negatif	vagina
ân	nikmat	deed
én	menelan	swallow
ép	ditekan	press
êgê	ego	aegean
êm	halus	smooth
ích	bermanfaat	benefit
ílam	lamlam	tamil language name for the island of sri lanka
ít	sedikit	less
île	île	Île, as in Île de la cité, france
îledefrance	&quot;kemegahan	ile-de-france
ðiều	artikel	article
ðài	ðài	taiwan
ðường	gula	a road
ðảng	pesta	party
ðức	jerman	"Đức, a common vietnamese first name; means ""virtue"""
ó	ó	(with the word la) to boo down
óc	otak	brain
óng	berwarna-warni	"(term should be ""óng ả"") flexible"
ôi	oh	"vietnamese version of the exclamation ""oh"""
ôm	pelukan	hug
ôn	moderasi	peaceful (on hoa)
ông	tuan	a man (n.)
ôtô	mobil	car
ôxi	oksigen	oxygen
ôxy	oksigen	the element oxygen (n.)
ôxít	oksida	oxide
ôzôn	ozon	ozone
ùn	macet	congest
úng	tergenang air	flood
úp	menghadap ke bawah	upside
úy	letnan	"(term should be ""thiếu úy"") second lieutenant (n.)"
ý	italia	italian
ăn	makan	eat
ăng	semut	antenna
ăngten	antena	antenna
đa	multi	majority
đai	ikat pinggang	"(term should be ""Đai khố"") name of a village"
đak	dak	(proper noun) Đak
đan	merajut	scandal
đau	rasa sakit	painful
đay	rami	jute, a type of vegetation the vietnamese use to make soup (n.)
đb	db	dien ban
đcstq	dcstq	communist party of china
đcsvn	dcsvn	vietnam communist party
đe	landasan	threaten
đem	bawa	to bring (v.)
đen	hitam	black
đentrắng	hitam putih	"(term should be ""đen-trắng"") black-and-white (adj.)"
đeo	pakai	wear
đh	đh	university
đhcn	đcn	university of industry
đhtm	dhtm	university of economics
đhông	timur	dhong
đi	pergi	go
điên	gila	crazy
điêu	hal	sculpture
điôxít	dioksida	dioxide
điạ	dạ	dia
điếc	tuli	heron
điếu	rokok	funeral oration
điềm	pertanda	omen
điền	isi	estate
điều	hal	control
điểm	titik	bearing point
điển	kamus	"(term should be ""từ điển"") a dictionary"
điểu	brengsek	thing
điệp	pesannya	spy
điệu	nada	memorial
đo	mengukur	measure
đoa	doa	doa
đoan	rapi	extreme
đom	kunang-kunang	firefly
đoài	mangga	the west
đoàn	persatuan	an organization or group (n.)
đoái	pertukaran	"(term should be ""hối đoái"") to exchange or trade (v.)"
đoạn	paragraf	a stage or phase (n.)
đt	đt	training
đtđ	ponsel	diabetes
đua	ras	emulate
đui	buta	blind
đun	rebus	cook
đuôi	ekor	tail
đuốc	obor	a torch
đuối	tenggelam	drowning
đuống	batang	(proper noun) Đuống, the name of a river
đuổi	kejar	pursue
đài	radio	statue
đàm	pembicaraan	negotiation
đàn	kawanan	musical instrument
đàng	iya	side
đào	buah persik	train
đày	pengasingan	exile
đá	batu	to kick
đái	kencing	pee
đám	gerombolan	dam
đán	dan	"(term should be ""tết nguyên Đán"") vietnamese new year's day"
đáng	sepadan	deserve
đáo	unik	unique
đáp	jawaban	response
đát	tanah	"(term should be ""bi đát"") lamentable (adj.)"
đâm	menusuk	pierce
đâu	dimana	anywhere
đây	disini	below
đã	adalah	already
đãi	mengobati	"(should be ""bạc đãi"") to ill-treat"
đãng	bejat	dissolute
đè	timpa	to press on
đèn	lampu	light
đèo	lulus	a mountain pass (n.)
đê	tanggul	a dike (n.)
đêm	malam	night
đênh	uang	lênh đênh= float to unknown
đích	tujuan	goal
đính	terlampir	attached (adj.)
đò	feri	a ferry (n.)
đòi	klaim	require
đòn	pukulan	welcome
đó	itu	that or there (adv.)
đóa	nah	"(term should be ""đoá hoa"") a flower bloom"
đói	lapar	hungry
đón	pikap	welcome
đôi	dobel	sometimes
đôla	dolar	dollar
đôn	mendesak	london
đông	timur	eastern
đôngbắc	timur	north-east
đôngnam	dongnam	south-east
đôngtây	timur	"(term should be ""đông-tây"") east-west (adj.)"
đôrêmi	doraemon	(proper noun) Đôrêmi
đôrêmon	doraemon	doreamon
đùa	lelucon	joke
đùi	paha	thigh
đúc	casting	"(term should be ""đúc kết"") to sum up (v.)"
đúng	benar	right
đúp	dobel	double
đút	menyerah	"(term should be ""đút lót"") to bribe"
đăk	dak	dak
đĩ	pelacur	whore/bitch
đĩa	disk	disk
đơ	kaku	stiff or rigid (adj.)
đưa	memberi	girl
đường	gula	pathway
được	oke	is not
đạ	da	da
đại	bagus	eagle
đạm	protein	plain
đạn	peluru	bullet
đạo	agama	vagina
đạp	tendang	to step on
đạt	mencapai	reach
đả	perkelahian	to hit
đảm	dijamin	"(term should be ""đảm nhiệm"") to undertake (v.)"
đản	ulang tahun	a group or flock (n.)
đảng	pesta	party
đảo	pulau	an island (n.)
đấm	meninju	punch
đấng	tuhan	the
đất	tanah	country
đấtmặt	tanah	datmat
đấy	disana	ignore
đầm	pakaian	swamp
đần	bodoh	"(term should be ""đần độn"") stupid or ignorant (adj.)"
đầu	bagian atas	start
đầy	penuh	"(term should be ""đầy đủ"") adequate or enough"
đẩu	kepala	"(entire term is ""khoa đẩu"") ancient phonetic script used in vietnam"
đẩy	mendorong	to push
đẫm	basah kuyup	wet
đậm	berani	dense
đậu	kacang	to park (v.)
đậy	penutup	cover
đắc	mendapatkan	effectively
đắm	hancur	sink
đắn	kesopanan	proper (dung dan)
đắng	pahit	bitter
đắp	naik	"(term should be ""bù đắp"") to compensate (v.)"
đắt	mahal	expensive
đằng	selesai	back
đẳng	isometrik	equality
đặc	spesial	"(term should be ""đặc biệt"") special (adj.)"
đặn	reguler	regularly
đẹp	cantik	beautiful
đẽ	baiklah	beauty
đế	sol	empire
đếm	masuk hitungan	to count (v.)
đến	tiba	come
đề	utas	promote
đền	kuil	"(term should be ""đền thờ"") a religious shrine"
đều	adalah	all
để	untuk	for
đệm	bantal	middle name
đỉnh	puncak	the summit or peak
địch	musuh	enemy
định	ditentukan	appointed
đọ	diadu	compete
đọan	paragraf	period
đọc	baca	read
đọng	stagnan	deposit
đỏ	merah	red (adj.)
đốc	gubernur	admiral
đối	untuk	face
đốm	bintik-bintik	spot
đốn	menebang	"(term should be ""suy đốn:) to be worse off"
đống	tumpukan	line
đốt	terbakar	burn
đồ	peta	thing
đồi	bukit	hill
đồn	rumor	rumour
đồng	co	agreeable
đổ	gudang	dump
đổi	berubah	to change (v.)
đổng	dong	"(term should be ""đồng bằng"") a delta"
đỗ	diparkir	pass
độ	gelar	"term should actually be ""độ cao""; means ""height"""
độc	beracun	alone
độn	empuk	chaos
động	dinamis	action
đột	tiba-tiba	"(term should be ""xung đột"") conflict (n.)"
đới	zen	tropical
đời	seumur hidup	generation
đỡ	dukungan	help
đợi	tunggu	thigh
đợt	batch	fit
đục	buram	turbid
đụn	bukit pasir	dune
đụng	sentuh	encounter
đủ	cukup	enough
đứa	anak-anak	child
đức	jerman	virtue (n.)
đứng	berdiri	to stand (v.)
đứt	rusak	cut off
đừng	jangan	not
đực	laki-laki	male
đựng	terkandung	suffer
đựoc	oke	be
ĩ	oh	"(term should be ""ầm ĩ"") noisy"
ơ	oh	"(term should be ""thờ ơ"") to be indifferent (adj.)"
ơi	hai	"vietnamese equivalent of english ""oh"""
ơn	terima kasih	thank
ư	kamu	vowel sound found in the vietnamese alphabet (n.)
ưa	lebih disukai	to like (v.)
ưng	oh ya	to accept (v.)
ưu	pro	"(term should be ""ưu việt"") preeminent (adj.)"
ươi	orang	orangutan
ươm	kamar bayi	nursery
ương	pusat	central
ướp	diasinkan	mummy
ướt	basah	wet
ạ	pak	a word added to the end of a response to show respect to someone in a position of authority, as in a child to a parent
ạt	buru-buru	(with word o) to crowd
ải	ải	pass
ảnh	foto	picture
ấm	hangat	warm
ấn	tekan	press
ấnâu	cetak	"(term should be ""Ấn Âu"") a grouping of languages including european and indian languages that are thought to have originated from a single earlier language (adj.)"
ấp	dusun	district
ấu	muda	childhood
ấy	itu	that
ẩm	lembab	humidity
ẩn	bersembunyi	hidden
ập	bang	rush
ắt	tentu	sure
ếch	katak	frog
ỏi	mint	little
ố	ooh	"(term should be ""hoen ố"") stained and smeared (adj.)"
ốc	siput	building
ốm	sakit	sick
ống	pipa	tube
ốp	singgung	omelette
ồn	kebisingan	noisy (adj.)
ổ	berkendara	hard drive
ổi	jambu biji	guava (n.)
ổn	baiklah	peace
ớn	besar	posts
ớt	cabai	chili
ở	di	at
ủ	inkubasi	"(term should be ""ủ dột"") gloomy (adj.)"
ủi	besi	"(term should be ""an ủi"") to comfort (v.)"
ủng	sepatu bot	boot
ủy	komisaris	commission
ứ	ya	to pool together (v.)
ức	payudara	memories
ứng	aplikasi	corresponding
−−	−−	__
≠	≠	different
