$ tỉ	$ billion	$ billion
abc	abc	abc
abdul	abdul	abdul
abkhazia	abkhazia	a name
about	ku saabsan	about
abraham	abraham	abraham
abrams	astaamaha	abrams
abscbn	abscbn	abscbn
account	koonto	account
aceh	aceh	(proper noun) aceh
achilles	furuuruc	achilles
acia	acia	acia
acid	aashito	acid
ada	ada	ada
adams	adams	(proper noun) adams
addisonwesley	addisonwesley	(proper noun) addison-wesley
adn	adn	adn
adobe	adobe	adobe
adrian	adrian	(proper noun) adrian
adsl	adsl	adsl
advanced	horumarsan	advanced
aedes	aedes	aedes
aegypti	aegypti	aegypti
aero	aero	(proper noun) aero, as in the aero l-39 albatros jet
afc	afc	afc
aff	xaqiiji	aff
afghanistan	afgaanistaan	afghanistan
africa	afrika	(proper noun) africa
african	african	african
ag	ag	ag
agasa	agasa	(proper noun) agasa, as in hiroshi agasa
agassi	agassi	agassi
ai	hay&#39;ada caafimaadka aduunka	who
ailen	irish	ailen
aim	ujeedada	aim
air	hawo	air
airbus	diyaarad	airbus
aisne	waar	aisne
ajax	ajax	ajax
ak	ak	ak
akatsuki	akatsuki	akastuki
akms	akms	akms
akô	salaan	ako
al	al	al
alabama	alabama	alabama
alaska	alaska	alaska
albania	albania	albania
albatros	albatros	(proper noun) albatros, as in the aero l-39 albatros
albert	albert	(proper noun) albert
alberto	alberto	(proper noun) alberto
albion	albion	albion, an ancient name for great britain
albuquerque	albuquerque	albuquerque
albus	albus	albus
alexa	doorsoomay	alexa
alexandra	alexandra	alexandra
alexandria	alexandria	alexandria
alexandros	alexandros	alexandros
alexey	alexey	alexey
alfred	bakhtiyaa	(proper noun) alfred, as in alfred kinsey
algérie	algérie	algerie
ali	ali	ali
alice	alice	this is a name
allan	allan	(proper noun) allan, as in edgar allan poe
allen	hiil	(proper noun) allen
allmusic	allmusic	allmusíc
alois	alois	alois
alonso	alonso	alonso
alpher	alifa	(proper noun) alpher
alps	alps	alps
altai	altai	altai
always	had iyo jeer	luon luon
amaravati	amaravati	amaravati
amazon	amazon	amazon
amdo	amdo	(proper noun) amdo
ame	iyo	ame
ami	amiin	ami
amiens	amiens	amiens
amin	amine	(proper noun) amin, as in nagib amin
amm	amm	amm
amoniac	ammonia	ammonium (n.)
amphitrite	xifafle	(proper noun) amphitrite, a greek sea goddess
an	a	"(should be ""an toàn"") safe"
anand	anand	anand
anata	anata	anata
anatolia	anatolia	anatolia
andalusia	andalusia	andalusia
andaman	iyo amaan	andaman
anderson	anderson	anderson
andes	iyo	andes
andorra	andorra	andorra
andrew	oo kaxaystay	andrew
andré	andré	andre, as in andre morval
andy	andy	(proper noun) andy, as in andy warhol
anfield	anfield	anfield
ang	gees	ang
angkor	angkor	(proper noun) angkor, as in angkor wat, the temple in cambodia
anglosaxon	anglosaxon	anglo-saxon
anh	walaal	english
anhmỹ	ingiriiska	"(term should be ""anh mỹ"") english or american"
anhpháp	ingiriisiga faransiiska	england-france
ankara	ankara	ankara
ankyl	ankyl	ankly
anna	anna	anna
annam	an nam	a name the way french called middle vietnam as a colony
annan	annan	annan
anne	anne	anne, a name
anorthosit	anorthosit	anorthosit, a type of igneous rock (n.)
anthony	anthony	anthony
antigua	antigua	(proper noun) antigua
anton	anton	anton
antonov	antonov	antonov
any	wax	any
anđêhít	aldehyde	aldehydes
ao	balli	pond
aotearoa	aotearoa	aotearoa
apollo	raali ahaw	apollo
apple	tufaax	apple
aquinas	aquinas	a name
arab	arab	(proper noun) arab
archetypal	archetypal	archetypal
archive	kayd	archive
arctan	arctan	a function
ares	ares	ares
argentina	argentina	(proper noun) the south american nation of argentina
argo	argo	argo
arias	arias	arias
aringarosa	aringarosa	aringarosa, as in manuel aringarosa
aristotle	aristotle	aristotle
arizona	arizona	arizona, as in the state
ark	doonnida	ark
arkansas	arkansas	arkansas
arlington	arlington	(proper noun) arlington
armenia	armenian	(proper noun) armenia
armstrong	cudud	(proper noun) armstrong, as in jazz artist louis armstrong
arnold	gabbaad	arnold
arsenal	arsenal	arsenal
artemis	artemis	(proper noun) artemis, the greek goddess of the hunt
aruba	aruba	aruba
arunachal	arunachal	"(term should be ""arunachal pradesh"") a state in india (proper noun)"
asc	asc	asc
ash	dambaska	a name
ashikaga	ashikaga	ashikaga
ashley	ashley	(proper noun) ashley
asia	aasiya	asia
asm	asm	asm
asoka	asoka	asoka
association	urur	association
assyria	assyria	assyria
aston	yaab	(proper noun) aston, as in aston villa
atkinson	atkinson	atkinson
atlanta	atlanta	atlanta
atlantic	atlantic	atlantic
aua	aua	aua
aubrac	aubrac	aubrac
audition	xisaabinta	audition
auflage	biyo wasakh ah	auflage
auguste	auguste	auguste
australia	australia	(proper noun) australia
austria	austria	(proper noun) the country of austria
austrian	austrian	austrian
avar	avar	a name
aviation	duulista	aviation
awad	awad	awad
award	abaalmarin	award
axit	aashito	acid
ayeyarwady	ayeyarwady	ayeyarwady
ayumi	ayumi	(proper noun) ayumi
ayutthaya	ayutthaya	(proper noun) ayutthaya
azerbaijan	azerbaijan	(proper noun) azerbaijan
aztec	aztec	aztec, as in the aztec people (adj.)
ba	aabe	three
babylon	dhalada	babylon
bacon	hilib doofaar	bacon
baden	baden	baden
baghdad	baghdad	(proper noun) baghdad
bago	bago	bago
bahamas	bahamas	bahamas
bahrain	bahrain	bahrain
baháí	baháí	bahai
balearic	balearic	balearic
bali	bali	bali
balkan	balkan	(proper adjective) balkan
balkans	balkans	balkans
ballard	xardhan	ballard
bamar	bamar	bamar
ban	mamnuuc	the
bang	bangi	state
banh	kubad	ball
banner	calan	banner
bantam	bantam	bantam
bantu	xayiraad	bantu
bao	jooniska	bao giờ= ever
barack	barack	barack
barak	barak	barak
barbados	barbados	(proper noun) barbados
barbara	barbara	barbara
barbary	caaqil	barbary
barca	barca	barca
barnes	baararka	barnes
barone	barone	barone
baroque	baroque	baroque
barquin	barquin	barquin, as in ramon barquin, the cuban military colonel
barrichello	barrichello	barrichello
bartholdi	bartholdi	bartholdi
baryon	baryon	baryon
barça	barça	(proper noun) barca
base	saldhig	base
basel	basel	basel, a city in switzerland
basil	basil	basil
baskervilles	baskervilles	baskervilles
bass	bass	bass
bator	xabad	bator
battambang	battambang	battambang
bauer	bauer	bauer
bay	duusho	"(should be ""tuyến bay"") an airline"
bayern	bayern	bayern
bazan	basal	basalt (n.)
bazơ	aasaasiga ah	base
bb	bb	bb
bbc	bbc	bbc
bc	bc	bc
bchtư	bchtư	central executive
beat	garaacid	beat
beatles	garaacis	the beatles
beauty	qurux	beauty
beckenbauer	beckenbauer	beckenbauer, as in franz beckenbauer
becker	beker	(proper noun) becker
beckham	beckham	beckam
bedloe	sariirta	bedloe
beethoven	dabocase	beethoven
beethovens	digaag	beethoven's
beginbmatrix	bilowga hore	this is a code
behind	gadaal	behind
beijing	beijing	beijing
bel	bel	bel
bell	gambaleel	bell
bella	bella	bella
bellatrix	bellatrix	bellatrix
benedict	benedict	benedict
benetton	benetton	benetton
benfica	benfica	benfica
benito	benito	benito
benjamin	benjamin	(proper noun) benjamin
bennington	bennington	bennigton
berber	berber	berber
bergen	bergen	(proper noun) bergen
berger	berger	berger
bering	laabta	(proper noun) bering, as in the bering strait
berkeley	berkeley	(proper noun) the city of berkeley, california
berman	berman	a name
bermuda	bermuda	(proper noun) bermuda
bernard	bernard	bernard
bertrand	astaan	bertrand
better	ka fiican	better
betty	sharad	betty
bhutan	bhutan	bhutan
bia	biir	beer (n.)
biang	biang	biang
bic	bic	bic
bikini	bikini	bikini
bill	biil	(proper noun) bill, as in former president bill clinton
billy	biil	billy
bismarck	bismark	bismarck, as in otto von bismarck
bitmap	istimaala	bitmap
biên	duub	bien
biếc	teel	a bluish-green color (adj.)
biếm	taxaddar la&#39;aan	"(term should be ""biếm họa"") cartoon (n.)"
biến	dibedda	other
biếng	caajis	lose interest in
biếu	cashuur bixin	present
biều	bieu	bieu
biển	badda	ocean
biểuthứcđiềukiện	ogaadaan shuruudaha	conditional expression
biện	raali gelin	"(term should be ""biện pháp"") a method (n.)"
biệt	kala duwan	"(term should be ""khác biệt"") different or distinct"
bkavpro	bkavpro	bkavpro
blackwell	madoow	this is a name
blair	blair	blair
blaise	cadho	blaise
blanc	madhan	blanc
blues	buluug	blues
bo	booda	a curl, as in a biceps curl exercise
bob	bob	bob
bobby	caajis	bobby, as in bobby day
boeing	caajiska	boeing
bohemia	bohemia	bohemia
bolivia	bolivia	(proper noun) bolivia
boltzmann	boltzmann	boltzmann
bom	bambo	bomb
bonaparte	bonaparte	bonaparte
bong	bong	"(term should be ""bong bóng"") a balloon (n.)"
bonnal	bonnal	bonnal
bonobo	bonobo	bonono
bool	bool	bool
boolean	boolean	(proper adjective) boolean, as in boolean algebra
boom	kacsi	boom
boong	deked	a deck (n.)
boongke	kuwa wax cuna	bunker
bop	booda	bop
boris	boris	boris
borland	xuduuda	(proper noun) borland
borussia	xuduuda	borussia
bose	bose	bose, as in subhas chandra bose
boseeinstein	boseeinstein	bose einstein
bosna	bosna	(proper noun) bosnia
bosnia	bosnia	(proper noun) bosnia
botswana	botswana	botswana
bottom	hoose	bottom
boulder	dhagax weyn	boulder
bourbon	bourbon	bourbon
boxing	feerka	boxing
brain	maskaxda	brain
brandenburg	brandenburg	(proper noun) brandenburg
brandt	sumad	brandt
braun	braun	braun
brazil	brazil	brazil
bremen	bremen	bremen, as in the bremen bank
brestlitovsk	brestlitovsk	brest-litovsk
breton	breton	(proper noun) breton
bretton	bretton	hoi nghi
brezhnev	brezhnev	brezhnev
brian	brian	a name
bridge	buundo	bridge
britannic	britannic	(proper noun) britannic
britney	britney	britney
brooklyn	brooklyn	brooklyn
brot	brot	this is german not vietnamese
brown	bunni	brown
browne	ubax	browne
browning	xoqid	(proper noun) browning
bruce	burush	bruce
brunei	brunei	brunei
bruno	bruno	bruno, as in the city of san bruno
brusilov	brusilov	brusilov
brussels	brussels	brussels, the capital of belgium
btr	btr	btr
bubalis	booriska	bubalis
budapest	budapest	budapest, the capital of hungary
bulgaria	bulgaria	bulgaria
bulletin	qoraal	thong bao
bungary	firidhsan	bungary
bungo	bungo	bungo
buonaparte	buonaparte	(proper noun) buonaparte, as in casa buonaparte
burke	duug	(proper noun) burke, as in edmund burke
burkina	burkina	burkina
burma	burma	burma
burundi	burundi	burundi
busan	busan	a korean city
busby	busby	busby
bush	baadiyaha	bush
bushy	caajis	bushy
buôn	jumlo	commerce
buông	iska daa	to release, to let loose
buýt	bas	bus
buốt	danaynaya	sharp
buồm	shiraac	sail
buồn	murugo leh	sad
buồng	qol	chamber
buổi	kalfadhiga	session
byzantine	byzantine	byzantine
bà	ayeeyo	woman or lady (n.)
bài	qoraallo	articles
bàn	miis	table
bàng	gorgorka	eagle
bành	peng	armchair
bào	shaashadda	compatriot
bàu	bau	bau
bày	soo bandhigid	"(term should be ""trưng bày"") to display (v.)"
bác	adeer	doctor
bách	websaydh	"(term should be ""bách khoa"") polytechnic (adj.)"
bái	dhaqan	to bow (v.)
bám	xajin	cling
bán	iibin	sell
báng	bangi	"(term should be ""phỉ báng"") to defame or slander"
báo	wargeys	newspaper (n.)
bát	baaquli	eight (n.)
báu	khasnad	valuable
bây	hadda	now
bã	haray	"(term should be ""buồn bã"") sad (adj.)"
bãi	yaard	beach
bão	duufaan	storm
bèn	kadib	then
bé	yar	baby
bén	fiiqan	sharp (adj.)
béo	dufan	fat
bên	dhinac	side
bênh	jiran	advocate
bì	baakadaha	foreskin (n.)
bìa	dabool	cover
bìu	xinjirow	sac (n.)
bí	squash	secret
bính	binh	"(term should be ""bính âm"") romanized chinese words (n.)"
bíró	bocor	biro
bò	lo&#39;da	beef
bó	farabadan of	bound (adj.)
bói	nasiib wanaag	to foretell (v.)
bón	bacrimiya	"entire term should be ""phan bon""; means ""fertilizer"""
bóng	kubad	sphere or ball
bóp	tuujin	squeeze
bô	aabe	"(term should be ""bôxit"") the mineral bauxite"
bôi	go&#39;ay	to apply (as in oil)
bông	suuf	flower
bù	isqurxin	compensate
bùa	camal	talisman
bùn	dhoobo	mud
bùng	olol	"(term should be ""bùng nổ"") to break out (v.)"
bú	nuugid	to suck
búa	dubbe	a hammer
búi	suufka	tuft
bún	bariis macaan	noodle
búng	la shiiday	snap
bút	qalin	pseudonym
băm	xardhay	hash
băn	cadho	concerned
băng	baraf	"(term should be ""băng giá"") freezing (adj.)"
bơ	subagga	"(term should be ""bơ vơ"") desolate (adj.)"
bơi	dabaal	swim
bơm	bamgare	pump
bưu	boostada	post office
bước	tallaabo	a step (n.)
bướm	balanbaalis	butterfly
bạ	xiriiryada	directory
bạc	lacag	meager
bạch	caddaan	"(should be ""bạch tuộc"") an octopus"
bại	lumiso	defeated
bảng	gole	chart
bảo	bao	protect
bảy	toddobo	seventh
bấm	riix	press
bất	dhab ah	"(term should be ""bất cứ"") any (adj.)"
bấy	taasi	contemporary
bần	sabool ah	poor
bầu	codee	vote
bầy	adhi	servant
bẩm	lagu dhasho	congenital
bẩn	wasakh ah	the
bẩy	dabin	"(term should be ""lẩy bẩy"") unsteadily (adv.)"
bẫy	dabin	a trap (n.)
bậc	shahaado	level or class (n.)
bận	mashquul	busy
bật	shid	outstanding
bắc	waqooyiga	beijing
bắcnam	woqooyi koonfur	"(term should be ""bắc-nam"") north-south (adj.)"
bắn	toogasho	shoot
bắp	galley	venter
bắt	qabasho	cross
bằng	isleeg	by
bẹp	burburin	crush
bẻ	jab	break
bẽ	dulli	humiliate
bến	wharf	wharf
bếp	jikada	kitchen
bề	dusha	"(should be ""bề mặt"") a surface"
bền	raagaya	enduring (v.)
bể	jalaatada	tank
bệ	lugta	base
bện	geesinimo	braided (adj.)
bệnh	jiran	benh
bỉ	beljamka	disgust
bỉnh	caajis ah	binh
bịch	gargaarka	ridiculous
bịt	daboolay	cover
bọ	cayayaanka	insect
bọc	duub	to cover or enclose (v.)
bọn	iyaga	a group (n.)
bọng	puffness	bladder
bọt	xumbo	foam
bỏ	ka noqoshada	to leave (v.)
bỏng	gubasho	hot
bố	aabe	"(term should be ""tuyên bố"") to declare"
bốc	rakibida	bốc lửa= on fire
bối	wareersan	messy
bốn	afar	four
bồi	magdhow	"(term should be ""cao bồi"") cowboy (n.)"
bổn	waajib	duty
bổng	deeq waxbarasho	"with word luong, means ""salary"" or ""wages"""
bỗng	si lama filaan ah	suddently
bộ	go&#39;an	part
bộc	boc	"(term should be ""bộc lộ"") to reveal (v.)"
bội	badan	betray
bột	bur	powder or flour (n.)
bớ	soo gabagabee	arrest
bớt	ka yar	less
bờ	gees	coast
bời	bumbo	profuse
bở	by	profitable
bởi	by	because
bục	booska	platform
bụng	caloosha	abdomen
bứt	ogayn	"(term should be ""bứt phá"") power (n.)"
bừa	harraadin	messy, careless, or topsy-turvy (adj.)
bữa	cunno	meal (n.)
bực	jahwareer	bother
ca	wareejin	praise
ca-lo	ca-lo	a unit of measurement
cabo	cabo	cabo
cacbon	kaarboon	carbon
cacbonat	kaarboon	carbonate
cacbua	carbide	carbides, carbon ions
caesar	qalliin	caesar
caffein	kafeyn	caffeine
café	kafee	coffee
cai	qaahira	govern
cairo	cairo	cairo, the capital of egypt
cal	kal	cal, a first name
calculus	calculus	calculus
calvin	calvin	calvin
cam	oranji	commit
cambodia	cambodia	(proper noun) the country of cambodia
cambridge	cambridge	cambridge
cameo	yimid	cameo part
cameron	sooroon	cameron
cameroon	yimidroon	cameroon
camille	camille	camille
campbell	cambeel	campbell
campuchia	kamboodiya	campuchia
canada	canada	canada
canadian	kansar	canadian
canal	kanaalka	canal
canary	kanaalka	canary
cancer	kansarka	cancer
canterbury	maktabadda	canterbury
canxi	kaalshiyam	calcium
capello	madax	capello
capra	capra	capra
carat	carat	carat
carbine	karboonka	carbine
cardcaptor	kaarka	cardcaptor
cardcaptors	kaarboorrada	(proper noun) cardcaptors
carey	taxadar	(proper noun) carey, as in singer mariah carey
caribe	caribe	caribbean
caribê	kaaribiyaan	caribbean
carl	carl	carl
carlos	carlos	carlos
carnaval	carnaal	carnaval
carol	carol	carol
caroline	caroline	(proper noun) caroline
carpathia	carpathia	carpathia
carter	kartoon	carter
carxtơ	carat	karst topography, a geological term (n.)
casa	ca sa	casa
casablanca	casablanca	casablanca
caspia	caspia	caspia
cassini	cassini	cassini
cast	kabka	cast
castries	qalcado	castries
castro	castro	castro, as in fidel castro
cathay	cathay	cathay
catherine	kaabash	catherine
cau	cau	cau
cbc	cbc	cbc
cbgd	cbgd	educational  officer
cbs	cbs	cbs
ccc	ccc	ccc
ccn	ccn	industrial cluster
cctv	cctv	cctv
cd	cd	cd
cdot	cdot	cdot
cdrom	cdrom	cd-rom
cell	qolka	cell
celtic	xinjirow	centic
cena	cena	(proper noun) cena, as in john cena, the wrestler
centauri	centauri	centauri
ceres	seeraha	ceres
cha	aabe	father
chai	dhalo	bottle
chaillot	chaillot	a name
chamberlain	gudoomiye	chamberlain
champa	champa	champa
champion	horyaal	champion
chamẹ	waalidiinta	parents
chanel	chanel	chanel
chanh	liin	lemon or lime (n.)
chao	hi	(proper noun) chao, a name
charles	gawaarida	charles
charlotte	charlotte	charlotte
charlton	charlton	charlton
charon	daacad	(proper noun) charon
chase	eryade	chase
chay	khudradda	fasting
chdcnd	chdcnd	democratic republic
che	dabool	cover
chechnya	chechnya	chechnya
chen	chen	chen
cheo	cheo	"(term should be ""cheo reo"") name of a town"
chi	chi	"(term should be ""chi tiết"") details (n.)"
chia	wadaag	"(term should be ""chia sẻ"") to share"
chiang	chiang	chiang
chicago	chicago	chicago, as in chicago, illinois
chile	chile	(proper noun) the country of chile
chim	shimbiraha	bird
china	shiinaha	china
ching	ching	ching
chirac	chirac	chirac, as in former french president jacques chirac
chiêm	astrological	"(term should be ""chiêm thành"") the ancient kingdom of champa in vietnam"
chiên	shiilay	fry
chiêng	gong	gong
chiếc	kumbuyuutar	the
chiếm	xisaabinta	appropriate
chiến	la dagaallama	war, fight
chiết	soo saar	literal
chiếu	mat	show
chiền	farabadan	temple
chiều	pm	length
chlamydia	kalamiidiya	chlamydia
chloride	koloriin	chloroauric acid
chnd	chnd	chnd
choi	ciyaar	choi
chomsky	chomsky	chomsky
chong	chong	chong
chopin	chopin	chopin
chosŏn	chosŏn	(proper noun) choson
choàng	cape	coat
choáng	yaabay	dizzy
chris	chris	chris, as in chris hughes
christ	kiristaan	christ
christian	kiristaanka	christian
christopher	kiristaanka	christopher
chrome	chrome	chrome, as in google chrome
chrysler	chrysler	(proper noun) chrysler, the car company
chu	chu	cycle
chua	dhanaan	tomato
chuck	cuf	(proper noun) chuck, as in chuck norris
chui	tirtir	underground
chum	chum	pot
chun	chun	chun
chung	guud	general
churchill	churchill	churchill
chuyên	takhasus leh	professional
chuyến	safar	trip
chuyền	gudub	volleyball
chuyển	dhaqaaqay	to move
chuyện	sheeko	nói chuyện= talk
chuôi	xajiye	handle
chuông	gambaleel	a bell
chuẩn	heerka	standard
chuốc	poke	incur
chuối	mooska	banana
chuốt	ugaarsiga	refine
chuồng	qafis	cage
chuỗi	silsilad	series
chuộc	furasho	redeem
chuộng	doorbiday	favorite
chuột	jiirka	a mouse (n.)
chà	xoqid	rub
chài	kalluumeysiga	fish
chàm	indigo	indigo
chàng	nin	"(term should be ""chàng trai"") a young man (n.)"
chào	salaan	welcome
chày	kubadda cagta	a pestle (n.)
chánh	madax	"(term should be ""chánh án"") the head of a tribunal (n.)"
cháo	boorash	porridge
cháu	awoowe	a term one uses denoting oneself when addressing an aunt or uncle (n.)
cháy	dabka	fire
châm	sicir	motto
chân	cagta	a leg
châu	yurub	continental
chè	shaah	tea
chèn	gelin	insert
chém	gooyaa	to chop
chén	koob	bowl
chéo	iskutallaabta	cross
chép	nuqul	written
chê	qalalan	decry
chênh	kala duwanaansho	difference
chì	horseed	graphite
chìa	fure	"(term should be ""chìa khoá"") a key (n.)"
chìm	liqday	to become submerged or sink (v.)
chình	eel	eel
chí	injirta	especially
chích	xarig	shoot
chín	sagaal	ripe
chính	ugu weyn	main
chít	xanjo	dense
chò	shiil	a type of plant, typically of the parashorea genus (n.)
chòi	qolka	hut
chòm	astaantii	constellation
chó	eey	dog
chóc	haha	killing (giet choc)
chói	dhalaalaya	bright
chóng	si deg deg ah	"entire term should be ""chong mat""; means ""dizzy"""
chóp	kor	the top (n.)
chôm	rambutan	rambutan
chôn	duug	bury
chông	nin	thorn
chùa	macbadka	pagoda
chùy	naag	mace
chú	adeer	uncle (n.)
chúa	ilaahow	god
chúc	rabaan	will
chúi	tuu	drop
chúng	iyaga	they
chút	xoogaa yar	little
chăm	adag	champa
chămpa	champa	champa
chăng	la awoodi karo	would it
chĩa	fargeeto	point
chơi	ciyaar	play
chơn	cagaha	"a more obscure form of the word ""chân""; means ""genuine"" or ""true"""
chư	chu	lower authorities
chưa	wali	not yet
chưng	fog	steamed
chương	cutubka	medal
chướng	koorso caqabad ah	grating
chạ	hanjabaad ah	father
chạm	taabasho	touch
chạng	fiidkii	twilight
chạp	rux	slow
chạy	orod	to run (v.)
chả	duub	no
chảo	digsi	pan
chảy	orod	bleeding
chấm	dhibic	end
chấp	loolan	"(term should be ""chấp nhận"") to accept (v.)"
chất	arrinta	quality
chấu	qanjaruufo	"(term should be ""châu chấu"") a grasshopper (n.)"
chần	blanch	slice
chẩn	ogaansho	"(term should be ""chẩn đoán"") to diagnose (v.)"
chậm	gaabis	slow
chận	xannib	block
chật	adkeyn	overcrowded
chậu	dheri	pelvic
chắc	hubaal	certainly
chằng	gees	ligament
chẵn	xitaa	even
chặn	xannibaada	prevent
chặng	lugta	journey
chặt	garoocad	close
chẻ	kala go ’	strick
chẽ	adkeyn	"(term should be ""chặt chẽ"") tightly or closely (adv.)"
chế	diyaarinta	produce
chếch	jilicsan	oblique
chết	dhintay	to die (v.)
chệch	khalad	deviant
chỉ	kaliya	just (adv.)
chỉnh	sixitaan	adjust
chịt	gurguurto	chằn chịt= complex/tangle
chịu	adkeysi	tolerate
chọc	si poke	to poke
chọi	dagaal	oppose
chọn	dooro	to choose
chỏ	xusul	"(term should be ""cùi chỏ"") elbow (n.)"
chốc	daqiiqad	single
chối	diido	refuse
chốn	meel	place
chống	anti	anti-
chốt	lugaha	important
chồi	dillaac	"(term should be ""đâm chồi"") budding"
chồn	dawaco	anxious
chồng	nin	husband
chỗ	meel	where
chội	shit	cramped
chớ	ha yeelin	not
chớp	hillaac	flashing (adj.)
chờ	sug	to wait
chở	xambaarsan	for
chợ	suuqa	market
chợt	si lama filaan ah	suddenly
chục	tobaneeyo	dozen
chụp	toogasho qaado	capture
chủ	sayid	"(term should be ""chủ yếu"") main or essential (adj.)"
chủng	noocyada	strain
chứ	halkii	just or only (adv.)
chứa	ka kooban	contain
chức	shaqo	function
chừ	warqad	hesitate
chừa	bixitaanka	leave
chừng	qaar	about or roughly (adv.)
chử	eray	"(term should be ""chử bích"") the vietnamese name for a chinese island"
chửa	uur leh	pregnant
chửi	habaar	curse
chữ	eray	a letter of the alphabet (n.)
chữa	daawo	to cure or treat (v.)
chững	heerka	to totter (v.)
cia	biyaa	cia
cincinnati	cincinnati	cincinnati
cinderella	cinderella	cinderrella
cip	cip	cip
circus	circus	circus
cities	magaalooyinka	cities
clara	clara	clara
clark	cillad	clark
claude	cad	(proper noun) claude
claudius	culaudius	(proper noun) claudius
clinton	clinton	clinton, as in former president bill clinton
clip	cajalad	clip
clips	cajalado	clips
clo	koloriin	chlorine
clow	qulqulaya	clow
clyde	clyde	(proper noun) clyde, as in bonnie and clyde
cmc	cmc	cmc
cmt	cmt	cmt
cn	cn	christian era
cnet	cnet	cnet
cntb	cntb	capitalism
cntt	cntt	it
cnxh	cnxh	social republic
co	co	spasm
coburn	gumaad	coburn
cocoa	kookaha	cocoa
coen	coen	coen
coffea	kafeega	coffee
cohen	cohen	cohen
coi	daawasho	to regard
coleen	coleen	coleen
coleman	coleman	coleman
coli	coli	coli
colin	colin	(proper noun) colin, as in colin powell
colleen	koleej	colleen
college	kulliyad	college
collins	shilalka	(proper noun) collins
collège	shil	college (n.)
colombia	colombia	colombia
colombo	colombo	(proper noun) colombo
colorado	colorado	(proper noun) colorado, as in the state
columbus	columbus	columbus
comic	majaajillo	comic
common	caadi ah	common
concacaf	concacaf	concacaf
concerto	riwaayad	concerto
concorde	qol	concorde
condom	cinjirka galmada	condom
cong	qalooca	curved or bent
congo	congo	congo
congress	shir	congress, as in library of congress
connecticut	isku xirnaanta	connecticut
conrad	conrad	corrad
conservation	ilaalinta	conservation
constantine	constantin	constantine
contemporary	casriga ah	contemporary
cooper	qabow	(proper noun) cooper
copenhagen	copenhagen	copenhagen
copernic	copernic	corpernic
copperfield	copperfield	(proper noun) copperfield, as in magician david copperfield
coppola	kopopola	coppola
copy	nuqul	copy
cordyceps	cordyceps	cordyceps
core	xudunta	core
cornell	galley	cornell
cosin	cosin	cosine
costa	costa	costa
cotang	cotang	cotangent
cpt	cpt	cpt
craig	cillad	(proper noun) craig
crazy	waali	crazy
crespo	guurka	(proper noun) crespo
crest	crest	crest
crew	shaqaale	crew
crimson	casaan	crimson
crisis	qalalaase	crisis
cristiano	cristiano	cristiano, as in portuguese soccer player cristiano ronaldo
croatia	croatia	croatia
cross	iskutallaabta	cross
crs	crs	crs
cruz	cruz	cruz
cruzeiro	cruzeiro	cruzeiro
crystal	krist	crystal
ctc	ctc	ctc
cua	gurguurto	crab (n.)
cullen	cullen	a name
cung	qaanso	circle
cunningham	cunningham	cunningham; proper name
cup	koob	cup
cuả	ee	of, from, belonging to
cuốc	hoes	hoe
cuối	ugu dambeeya	last or final (adj.)
cuốn	xarig	book
cuống	caws	throat
cuồng	waali	crazy (adj.)
cuộc	ah	the
cyanide	cyanide	cyanide
cyber	internetka	cyber
cyril	cirfiid	(proper noun) cyril
cyrus	cirfiid	cyrus
cyworld	dhulbahante	cyword
cà	qaxwada	ca
cài	rakibo	install
càn	baahi	raid
càng	badan	cang
cành	laanta	branch
cào	xoq	scratch
cày	qodaya	plow
các	ah	all (adv.)
cách	dariiqa	the
cái	ah	"(term should be ""con cái"") children (n.)"
cán	duudduubay	"(should be ""cán bộ"") an officer, especially in a communist regime"
cánh	garabka	wing
cáo	dawaco	report
cáopx|bình	celcelis | celcelis	not a word
cáp	fiilo	cable (n.)
cáy	faallood	fiddler
câm	carrab la &#39;	mute (adj.)
cân	miisaanka	weight
câu	xukunka	saying
cãi	doodaan	argue
cò	kicin	stork
còn	wali	to have left (v.)
có	leeyihiin	have
cói	sedge	machine
cót	sariirta	cot
cô	la waayey	girl
côi	agoonta	orphaned
côn	taper	a stick (n.)
công	shaqada	worker
côngtenơ	weel	container
cõi	warshadaha	entire area
cõng	piggyback	piggyback
cù	saxarada	cu
cùi	oo baras qaba	leprosy
cùng	iyo	together
cú	odayga	old
cúi	qaanso	to bow (v.)
cúm	hargab	cum
cúng	raaxo leh	worship
cúp	koob	cup (n.)
cút	bax	to kick someone out (v.)
căm	xirxiray	detest (cam thu)
căn	xagjir ah	"(term should be ""căn bệnh"") cause of a disease (n.)"
căng	kala bixin	tense
cũ	jir	old
cũi	sariirta	kennel
cũng	sidoo kale	also
cơm	bariis	rice
cư	buuxsamid	resident
cưa	arkay	saw
cưng	ilmahayga	also
cước	xamuul	megaman
cưới	guursaday	marry
cướp	dhac	to rob (v.)
cười	qosol	smile
cường	xoog leh	strengthen
cưỡi	gaadhi	ride
cưỡng	qasbay	force some body to do some thing. cưỡng dâm=rape
cạc	kaarka	card (n.)
cạn	gacmeed	shallow
cạnh	gees	"(term should be ""khía cạnh"") an angle"
cạo	xiiro	shave
cạp	scorpion	scorpion
cả	labadaba	both
cải	iniin khardal le&#39;eg	reform
cảm	qabow	pleasure
cản	dhib badan	prevent
cảng	dekeda	port
cảnh	goobta	situation
cảo	jiidaya	posthumous
cấm	mamnuuc	ban
cấn	baahi	dramatic
cấp	deeq	level or rank (n.)
cất	mashquul	"(term should be ""cất giữ"") to keep safe or store"
cầm	qaban	to hold (v.)
cần	baahi	need
cầu	buundo	request
cầy	quusin	farmed
cẩn	taxaddar	carefully
cẩu	wiish	"(term should be ""hải cẩu"") a seal (n.)"
cận	u dhawaansho	close
cập	miiska	mention
cậu	wiil	a young man (n.)
cậy	ku tiirsan	reliable
cắm	gasho	to plant (v.)
cắn	qaniinyo	to bite
cắp	xado	steal
cắt	gooyaa	cut
cằm	garka	chin
cằn	xanaaq	exhausted (adj.)
cặp	boorso	couple
cọ	xoqid	rub
cọc	rakiban	pile
cọp	shabeel	tiger
cỏ	cawska	plant
cố	isku day	"(term should be ""cố gắng"") to try one's best (v.)"
cốc	koobka	cereal
cối	hoobiye	mortar
cốm	nuggets	grilled rice
cống	daadi	dedicate
cồn	khamriga	i
cồng	gong	gong
cổng	irridda	gate
cỗ	deked	engine
cỗi	madax adag	barren
cộ	gawaarida	"(term should be ""xe cộ"") cars or vehicles (n.)"
cội	jir	origin
cộng	lagu daro	to add (v.)
cột	tiirka	pole
cớ	cudur daar	excuse
cờ	calanka	flag
cỡ	cabir	size
cợt	kaftanka	"(term should be ""đùa cợt"") to trifle (v.)"
cục	qeybta	department
cụm	kooxdu	cluster
cụp	la gooyay	down
cụt	la gooyay	"(should be ""xương cụt"") the tailbone or coccyx"
củ	digriiga	a bulb, a botanical term
của	ee	of
củi	xaabada	firewood
củng	sidoo kale	reinforce
cứ	dul	any
cức	qabow	"(term should be ""cức Đê"") a character in chinese history"
cứng	adag	hard
cứngi	hardi	cungi
cừ	guntooda	nacre
cừu	wan	sheep
cửa	albaab	door
cửu	ku dhufo	nine
cữ	cu	abstinence
cữu	jawaan	nine
cự	masaafada	against
cựa	spurs	retreat
cực	cirif	extreme
cựu	hore	former
d	d	d.
da	maqaarka	skin
daegu	daegu	daegu
dahl	dahl	(proper noun) dahl, as in author roald dahl
dai	adag	persistent
daily	maalin kasta	daily
dakota	dakota	dakota, as in the state of south dakota
dalat	da lat	da lat
dampier	dambas	(proper noun) dampier, a last name
dan	dan	dan
dancing	dhaanto	dancing
danger	khatar	danger
danh	magac	list
daniel	daniel	daniel
dante	dante	dante
dao	mindi	poniard
darwin	darwin	darwin
das	das	das
dassault	dhicis	(proper noun) dassault
date	taariikhda	date
dau	saliid	dau
dave	dajin	(proper noun) dave, as in dave sexton
david	david	david, as in david thomas
davies	dav	davies
davis	davis	davis
dbsk	dbsk	dbsk
dc	dc	d.c.
ddr	ddr	ddr
dean	dean	a name
degree	shahaado	degree
delhi	delhi	delhi
delphi	qiso	(proper noun) delphi, as in the oracle
demeter	dhudhun	(proper noun) demeter, the greek goddess of the harvest
den	been	den
dennis	dennis	dennis
department	waaxda	departmen
derek	derek	derek
des	des	des
descartes	soo degid	descartes
design	thiết kế	thiet ke
deuterium	deuterium	deuterium
deutschland	deutschland	deutschland
dewan	dewan	dewan, as in dewan rakyat
dewitt	dewitt	(proper noun) dewitt, as in rose dewitt bukater
di	di	move
diana	diana	(proper noun) diana, as in diana ross
die	dhinto	german
diego	dhinta	diego
dien	waali	"(term should be ""Điện biên phủ"") a city in northwestern vietnam where a famous battle took place during the vietnam war"
dimaggio	dimaggio	gimaggio
dinh	qasriga	official residence or palace
dionysus	dionysus	dionysus, as in the greek god
discovery	daahfurka	discovery
discussion	dood	discussion
disneyland	disneyland	disneyland
division	qaybinta	division
divoire	divoire	d'lvoire
diêm	isbarbardhiga	diem vuong
diên	waali	"(term should be ""kinh diên"") canon (n.)"
diềm	qulqulka	matches
diều	qaniinyada	kite
diểu	fog	(proper noun) diểu
diễm	caano	beauty; a common vietnamese first name for women
diễu	socod	parade
diệc	heron	a heron (n.)
diệm	caano	(proper noun) diệm, as in ngô Đình diệm, former president of south vietnam
diện	waji	face to face
diệt	dilo	to kill or destroy (v.)
diệu	sixir	effective (adj.)
djibouti	djibouti	djibouti, a country in africa
djokovic	djokovic	(proper noun) djokovic, as in novak djokovic
dm	dm	dm
dmitri	dmitri	dmitri
dna	dna	dna
do	by	because of
doanh	wadajirka	"(term should be ""kinh doanh"") business (n.)"
doc	doc	doc
docherty	daroogo	docherty
dolly	baashaal	(proper noun) dolly, as in singer dolly parton
dome	xamar	nha
dominican	dominican	(proper noun) dominican, as in the dominican republic
don	deeq	(proper noun) don
donau	donau	donau
dortmund	dortmund	(proper noun) dortmund
dougherty	dougherty	dougherty
douglas	douglas	douglas
dover	dover	(proper noun) dover, as in the capital of delaware
doyle	doyle	doyle
doãn	doon	doan
doạ	hanjabaad	threat
dp	dp	dp
dracula	dracula	dracula
draft	qabyo qoraal	draft
drake	duugid	(proper noun) drake
driver	darawalka	a name
ds	ds	ds
dtd	dtd	dtd
dth	dth	dth
du	du	travel
dubai	dubai	dubai
duiker	duiker	duiker
duk	dhan	duk
dumas	dumas	dumas
dumbledore	dumbledore	dumbledore
dung	digo	portrait
durham	durham	durham
dursley	dursley	dursley
duy	kaliya	only
duyên	saadaalin	coastal
duyện	hiigsanaya	fellatio
duyệt	browser	browser
duơng	duong	ocean
duẩn	duan	duan
duật	biyo	duat
duệ	faracoodii	descendants (n.)
duỗi	toosi	stretch
dwight	degganaan	dwight
dà	dah	gradually
dài	dheer	to lengthen, as in time
dàn	dhigashada	to arrange
dàng	fududaan	dang
dành	ku qaatay	for
dào	badan	"complement to word ""doi""; entire phrase ""doi dao"" means ""plentiful"""
dày	qaro weyn	thick
dái	piss	"penis (n.), although some may use the term to mean ""testicles"""
dám	ku dhiirran	dare
dán	koollo	stick
dáng	qaab	appearance
dát	inlaid	inlay
dâm	lewd	lustful (adj.)
dân	dadka	people
dâng	bixin	dedicate
dây	xadhig	nerve
dã	duurjoogta ah	chronicle
dãi	ogolaansho	band
dãn	isqarxiyay	extend
dãy	range	a row (n.)
dè	taxaddar	tight
défense	camal	defense
dép	kabo cagaaran	slipper
dê	ari	goat
dì	eedo	aunt
dìu	dìu	to lead by the hand (v.)
dính	dhejis	stick
dò	raadin	(with word tham) to survey
dòm	eegid	snoop
dòng	hadda	"(term should be ""dòng họ"") family (n.)"
dó	taasi	a type of plant used to make paper in vietnam (n.)
dông	onkod	a storm (n.)
dõi	waddo	monitor
dù	in kastoo	though
dùi	feer	awl
dùng	isticmaal	use
dăm	xiirashada	"(term should be ""đá dăm"") pebbles (n.)"
dĩ	dabcan	why
dĩa	saxanka	dish
dũng	xoog leh	courage
dơ	wasakh ah	dirty
dơi	fiidmeerta	bat
dư	haray	remnant
dưa	qaraha	melons
dưng	jooji	suddently
dương	togan	penis
dường	u eg	seem
dưỡng	kalkaaliso caafimaad	feed
dược	farmashiyaha	having to do with medicine (adj.)
dượng	adeer	uncle
dạ	haa	night
dại	nacasnimo	stupid or idiotic (adj.)
dạn	cabsi la&#39;aan	"(term should be ""dày dạn"") to be accustomed to, especially some sort of difficult situation (adj.)"
dạng	qaab	tyoe
dạo	socodsiin	vending
dạt	dhaqday	to drift
dạy	baro	teach
dải	xarig	range
dấm	oo khal	vinegar
dấp	turunturoodid	shape
dấu	saxeex	signal
dấy	firfircoon	to raise (v.)
dần	tartiib tartiib	people
dầu	saliid	oil
dẫm	caloosha	step on
dẫn	hage	to lead
dẫu	in kastoo	though
dận	hooyo	to step on
dậu	diiq	rooster
dậy	kac	"(term should be ""dậy thì"") pubescent (adj.)"
dắt	horseed	lead
dằn	ballaadhan	"(term should be ""dằn lòng"") to hold yourself in (v.)"
dằng	adkeysi leh	dằng dai= long/endless
dẳng	adkeysi leh	persist
dặm	mayl	mile
dặn	amray	to advise (v.)
dặt	amar	conservative
dẹp	fidsan	pacify
dẹt	fidsan	flat
dẻ	xabadka	chestnut
dẻo	caagnimo	flexible
dế	naxashka	cricket
dền	amaranth	beetroot
dể	fududaan	easy
dễ	fududaan	easy
dệt	saqafka	textile
dị	kelinimo	simple
dịch	tarjun	semen
dịp	munaasabad	occasion
dịu	mellow	ease
dọa	hanjabaad	to threaten or scare (v.)
dọc	toosan	along
dỏm	saafi ah	witty
dốc	dhaadheer	slope
dối	been	lie
dốt	jaahil	stupid or ignorant (adj.)
dồi	badan	"(term should be ""trau dồi"") improve (v.)"
dồn	xarig	accrue
dỗ	coax	dirty
dời	dhaqaaq	leave
dở	xun	incomplete
dỡ	soo dejinta	remove
dụ	tusaale ahaan	example
dục	galmada	sexuality
dụng	isticmaal	use
dứa	cananaaska	pineapple
dứt	jooji	to cease
dừa	qumbaha	coconut (n.)
dừng	jooji	to cease
dữ	xogta	"(term should be ""giận dữ"") anger (n.)"
dự	saadaaliyay	attend
dựa	ku saleysan	base on
dực	lab	dực, as in lê tương dực
dỹ	dỹ	dy
e	e	e.
ea	ea	(proper noun) ea, as in ea kao
earles	dhegaha	earles
eaton	cunon	eaton
ebro	ebro	a name
ecmascript	ecmascript	ecmascript
ecw	ecw	ecw
edda	edda	(proper noun) edda
edgar	edgar	edgar, as in author edgar allan poe (n.)
edge	gees	edge
edinburgh	edinburgh	(proper noun) edinburgh, as in edinburgh, scotland
edison	edison	edison
editor	tifaftire	editor
edmond	edmond	edmond
edo	edo	edo
edward	edward	edward
edwin	edwin	edwin
eea	eea	eea
efron	efron	efron, as in zac efron
egypt	egypt	egypt
eid	ciid	(proper noun) eid
eiffel	eiffel	eiffel
einstein	einstein	einstein
eisenhower	eisenhower	eisenhower, as in former president dwight d. eisenhower
ekaterina	ekaterina	this is a name
elbe	elbe	(proper noun) the elbe river
electronic	elektiroonig ah	electronic
eliane	eliane	(proper noun) eliane
elip	xusul	ellipse
elizabeth	elizabeth	elizabeth
ellen	ubax	ellen
ellis	ellis	a name
elton	elton	(proper noun) elton, as in elton john
elvis	elvis	elvis
elíp	xusul	ellipse
em	adiga	younger sibling
email	emayl	email
emily	emily	(proper noun) emily, as in emily dickinson
emir	amiir	emir
emmy	emmy	emmy
en	en	erica reef
energy	tamar	energy
engels	somali	engels
england	england	(proper noun) england, as in new england
eniac	eniac	eniac
entente	entente	entente
entropy	entropy	entropy
enzym	enzyme	enzymes
eo	dhexda	eo, as in the film captain eo
ep	ep	a name
erich	erich	erich
erik	erik	erik, as in erik moller
eris	eris	eris
eritrea	eritrea	eritrea
ernest	qalad ah	(proper noun) ernest
eros	eros	eros, greek god of love
erwin	erwin	(proper noun) erwin, as in erwin rommel
españa	españa	espana
essential	muhiim ah	essential
ethernet	ethernet	ethernet
ethiopia	ethiopia	(proper noun) ethiopia
euclid	euclid	euclid
eugene	eugene	eugene
eugène	eugène	(proper noun) eugène
euler	euler	euler
euro	euro	euro, as in the european currency
eurofighter	eurofighter	eurofighter
europe	europe	europe
european	yurub	(proper adjective) european
eva	uumi	eva
everton	everton	everton
every	kasta	every
exgay	exgay	exgay
explorer	sahamin	explorer
extensive	ballaaran	extensive
fabio	maro	(proper noun) fabio
facebook	facebook	(proper noun) facebook
fact	xaqiiqda	fact
facto	facto	this is french not vietnamese
faifo	faifo	(proper noun) faifo
fao	fao	fao
farrell	farrell	farrell
faso	faso	faso
fbi	fbi	fbi
fca	fca	fca
fdi	fdi	fdi
features	astaamaha	features
federer	feederer	federer
feet	cagaha	feet
felipe	felipe	felipe
felis	felis	(proper noun) felis
felix	felix	(proper noun) felix, as in felix klein
ferb	boob	ferb
ferdinand	ferdinand	ferdinand
ferguson	feranne	ferguson
fernando	fernando	fernando
ferrari	ferrari	ferrari
fiat	fiat	fiat
fidel	aamin	fidel
field	duurka	field
fifa	fifa	fifa
fifpro	konton	fifpro
figo	figo	figo
fiji	fiji	fiji
finish	dhammayn	finish
firefox	firefox	(proper noun) mozilla firefox
fischer	kalluumaysi	fischer, as in louis fischer
fish	kalluun	fish
fishbed	kalluun	fishbed
fitzgerald	fitzgerald	(proper noun) fitzgerald
flanker	booska	flanker
fleming	qarixid	fleming
flight	duulimaad	flight
foch	foch	(proper noun) foch
focus	diiradda	focus
foden	foden	(proper noun) foden, as in tom foden
fokker	fokker	fokker
food	cuntada	food
football	kubada cagta	bong da
forbes	forbes	(proper noun) forbes, as in the magazine
ford	dhaafid	(proper noun) ford
fordham	fordham	(proper noun) fordham
forks	fargeeto	forks
foundation	aasaaska	foundation
fox	dawaco	fox
fpt	fpt	a company name in vietnam
fracsin	fracsin	a function
franc	franc	franc
france	france	france
frances	frances	frances
francis	francis	francis, as in francis xavier
francisco	francisco	francisco
franco	franco	franco
frank	run ah	frank
frankfurt	frankfurt	(proper noun) frankfurt
franklin	franklin	franklin
franz	franz	(proper noun) franz, as in franz ritter
freud	xariir	(proper noun) freud, as in sigmund freud
friedman	friedman	friedman
fu	fu	fu
fujiko	fujiko	fujiko, as in japanese writer fujiko fujio
fujimoto	fujimoto	fujimoto
fukuoka	fukuoka	fukuoka
funimation	baashaal	(proper noun) funimation
funk	funk	funk
futsal	futsal	futsal
fx	fx	fx
ga	ga	station
gabon	gabon	gabon
gabriel	gabriel	gabriel
gabriella	gabriella	gabriella
gagarin	gagarin	gagarin
gaia	gaia	gaia
gaillard	gaillard	gaillard
galilei	galilei	galilei
galileo	galileo	galileo, the astronomer
gam	garaam	gam
gambia	gambiya	gambia
gamow	gamow	a name
gan	beerka	liver
gandhi	gandhi	gandhi, as in mahatma gandhi
gang	burcad	cast iron
ganh	masayr	to be jealous
gao	bariis	strictly
gareth	xero	a name
garrett	garrett	garrett
gary	cajiin	gary
gascon	gaas	(proper noun) gascon, a dialect of france
gatt	gatt	gatt
gaule	gaule	gaul, a region in ancient western europe
gaulois	gaulois	gaulois
gay	khaniis	tense
gaza	gaza	gaza
gdańsk	gdańsk	(proper noun) gdansk, poland
gdp	gdp	gdp
geisha	geisha	geisha
gen	hiddo-wadayaasha	gene
gene	hidde	(proper noun) gene, an english first name
genesis	hidde	(proper noun) genesis
georg	georg	(proper noun) georg
george	george	george
georges	georges	(proper noun) georges, a french name
gepard	cirfiid	gepard
ger	jeermis	ger
gerais	gerais	(proper noun) gerais
gerhard	gerhard	gerhard
german	german	german
germany	jarmalka	germany
gerrard	gerrard	gerrard, a last name
ghana	ghana	(proper noun) the african country of ghana
ghe	doon	canoe
ghen	masayr	to be jealous (v.)
ghi	qor	write
ghim	pin	pin
ghé	jooji	visit
ghép	jab	fit
ghê	naxdin	disgust
ghì	ghì	tighten
ghẻ	isnadaamiska	scabies (n.)
ghế	kursi	chair
ghề	kufsiyo	scabby
ghềnh	kufsiyo	waterfall (n.)
gia	gia	date
giai	marxalad	period
giam	xabsi	imprison
gian	booska	"(term should be ""thời gian"") time (n.)"
giang	giang	syphilis
gibraltar	gibraltar	(proper noun) gibraltar
gichin	gichin	gichin
gieo	beero	sow
gifu	gifu	gifu, a district in northern japan
ginzan	ginzan	ginzan
gio	gio	wind
gioi	gioi	world
giuliani	giuliani	giuliani
giun	gooryaanka	worm
giuse	giuse	giuse
giuộc	giuoc	"entire term should be ""can giuoc""; name of a vietnamese town"
giza	giza	giza
già	jir	old (adj.)
giàn	tusayaasha	"(term should be ""giàn hoa"") a trellis girder"
giành	si xamaasad leh	secure
giàu	hodan ah	rich or wealthy (adj.)
giày	kabaha	a shoe
giá	qiimo	estimate
giám	agaasime	"(term should be ""giám sát"") to supervise (v.)"
gián	baranbarada	"(term should be ""gián tiếp"") indirectly"
giây	ilbidhiqsiyo	seconds
giã	jeexdin	"(term should be ""từ giã"") to say farewell to (v.)"
giãn	kala bixin	stretch
gièm	khaa&#39;imiin	"(should be ""gièm pha"") to backstab"
giêhôva	giva	jehovah
giêng	giong	january
giêsu	ciise	jesus
giêxu	neecow	jesus
giò	duubabkii guga	leg
giòi	digaag	maggot (n.)
giòn	cuqdad	crunchy or crispy (adj.)
gió	dabayl	wind
gióng	jecel	align
giúp	i caawi	help
giũa	feyl	sharpen
giơ	jamac	raise
giương	caddeyn	posture
giường	sariirta	bed
giả	been abuur ah	fake (adj.)
giải	xalka	solution
giảm	yareyn	decrease
giản	la fududeeyay	"(term should be ""giản dị"") simple (adj.)"
giấc	seexo	giấc ngủ= the sleep
giấm	oo khal	drabble
giấu	qari	hide
giấy	warqad	paper
giầu	hodan ah	rich
giận	xanaaqsan	angry
giằng	bracing	pull
giặc	cadowga	enemy
giặt	dhaq	to wash (n.)
giếng	si fiican	well
giết	dilo	kill
giềng	deris	"(term should be ""láng giềng"") neighboring"
giễu	jees jees	ridicule
giọng	cod	tone
giọt	daadasho	drop
giỏ	dambiil	basket
giỏi	weyn	good
giồng	giong	mound
giỗ	sanad guurada dhimashada	anniversaries of deaths
giới	jinsi	gender
giờ	saacado	bao giờ=ever
giở	toosh	to open or unfold (v.)
giỡn	kaftanka	joke
giục	ku booriyay	urge
giữ	qabso	hold
giữa	inta u dhaxaysa	between
gladys	farxad	gladys
glazer	glazer	glazer
glonass	gogosha	glonass
gloria	gloria	gloria
gloster	gloster	(proper noun) gloster, as in gloster meteor
glucose	gulukoos	glucose
gmail	gmail	gmail
gnp	gnp	gnp
go	tag	"(term should be ""gay go"") tense"
goes	tagaa	goes
goku	goku	goku
golden	dahab ah	golden
gom	ururin	to gather (v.)
google	google	google
gorbachev	gorbachev	gorbachev
gorbachyov	gorbachyov	gorbachev, as in former soviet president mikhail gorbachev
gordon	gordon	gordon, as in gordon brown
gore	gore	gore
gorky	gorky	gorky, as in gorky park
gothic	gothic	gothic
gottfried	gottfried	gottfried
grabeel	garaac	grabeel, a last name
graham	graham	graham
granada	granada	granada
granit	granite	granite
greek	cirfiid	(proper noun) greek
greenland	dhul cagaaran	greenland
greenson	cagaarka	(proper noun) greenson
greenwich	cagaaran	(proper noun) greenwich
greg	greg	greg
grenada	bambada	grenada
grenadines	bambaanooyin	grenadines
gross	guud	gross
grumman	grumman	(proper noun) grumman
gruzia	georgia	gruzia
gryffindor	gryffindor	gryffindor
gs	gs	prof.
gsts	gsts	professor- phd
gu	qaabka	gu
guam	guam	guam
guard	ilaali	guard
guatemala	guatemala	guatemala
gui	gui	gui
guinea	guinea	guinea
guinness	guinness	(proper noun) guinness
guitar	gitaarka	guitar
gujarat	gujarat	gujarat
gulag	gulag	gulag
gulf	gundhig	gulf
gullit	gullit	(proper noun) gullit
gundam	gundam	(proper noun) gundam
gunung	rasaas	(proper noun) gunung
gustave	gustave	gustave
gutenberg	gutenberg	gutenberg
guyana	guyana	guyana; proper noun
gà	digaag	chicken
gài	tuug	to fasten (v.)
gào	qayliyay	"(term should be ""thét gào"") to cry out (v.)"
gác	ilaali	guard
gái	gabadh	girl
gán	meelayn	"entire phrase should be ""gan nhan""; means ""to label"""
gánh	qaado	hold
gáy	nape	crow
gân	xir	tendon
gây	sabab	make
gãy	jabay	break
gì	waa maxay	what
gìn	xafido	preserve
gò	buur	"(term should be ""gò má"") cheekbone (n.)"
gòn	haun	gon
góa	carmal	widowed
góc	geeska	angle
gói	xirmo	goi
góp	qayb bixin	to contribute
gót	ciribta	heels
gõ	nooca	type
göbbels	göbbels	gobbels, as in joseph gobbels
găm	hoard	poniard
găng	galoofyada	gloves
gũi	xir	close
gươm	seef	sword
gương	muraayad	mirror
gạc	faashad	johnson south reef
gạo	bariis	rice
gạt	dillaacay	to cheat or trick (v.)
gả	guur	marry
gảy	jab	"(term should be ""âm gảy"") a type of phonetic sound found in the japanese language (n.)"
gấc	gac	gac
gấm	brocade	brocade
gấp	dhaqso	times, as in many times
gấu	orso	a bear (n.)
gần	u dhow	near
gầy	dhuuban	thin
gẫy	jabay	break
gập	laabid	"(term should be ""gập ghềnh"") bumpy (adj.)"
gậy	ul	stick
gắm	fart	send
gắn	dhajiyay	mount
gắng	isku day	try
gắt	si daran	intense
gặm	xoqid	rodent
gặp	la kulan	meet
gặt	goosashada	harvest
gỉ	miridhku	rust
gọi	wacid	call
gọn	nidaamsan	neat (adj.)
gọng	rim	gong
gọt	diirka	cut
gỏi	saladh	a vietnamese salad
gốc	asal ahaan	origin (n.)
gối	barkimo	"(should be ""qùy gối"") to kneel"
gốm	dhoobada	pottery
gồm	oo ay ka mid yihiin	include
gồng	gong	carry
gỗ	qoryaha	wood
gội	shaamboo	shampoo
gộp	isku dar	aggregate
gớm	foosha	tremendous
gờ	qalin	edge
gởi	dir	send
gỡ	ka dejisan	meet
gợi	soo jeedin	to evoke (v.)
gục	hoos	"(term should be ""đánh gục"") crush, as in battle"
gừng	sinjibiil	ginger
gửi	si loo diro	send
ha	ha	hectare
habana	habana	(proper noun) habana
habsburg	habsburg	(proper noun) habsburg
haeberle	haeberle	haeberle
hahn	hahn	hahn
hai	laba	two (adj.)
hal	hal	hal
halle	halle	(proper noun) halle
halogen	halogen	halogen (n.)
ham	ham	desire
hamilton	hamilton	(proper noun) hamilton
han	han	han
hang	god	cave
hangul	hangul	hangul
hanh	hanh	hanh
hanja	hanja	(proper noun) hanja, a type of chinese script
hansen	hansen	hasnen
hao	hao	"(term should be ""hao hụt"") to incur some loss (v.)"
harald	harald	harald
hardy	adag	hardy
harlem	harlem	harlem
harlow	harlow	harlow
harold	harold	(proper noun) harold
harper	harper	harper
harpercollins	harpercollins	hapercollins
harrier	harraad	harrier, as in harrier jump jet
harris	harris	harris
harry	harry	harry
harvard	harvard	(proper noun) harvard, the name of a college
harvey	waxyeello	harvey
havana	havana	(proper noun) havana, cuba
havilland	havilland	havilland
hawker	hawker	hawker
hawking	karsasho	(proper noun) hawking, as in physicist stephen hawking
hay	wanaagsan	or
hb	hb	hb
hbv	hbv	hbv
hcl	hcl	hcl
hd	hd	activity
he	isagu	he, a korean name
health	caafimaadka	health
heath	caafimaad	heath
hee	hee	hee
hegel	hegel	(proper noun) hegel, as in georg wilhelm friedrich hegel
heian	heian	heian
heinrich	heinrich	heinrich
helen	helen	helen
helena	helena	helena
heli	hilibka	helium
hematocrit	hematocrit	hematocrit
hemoglobin	haemoglobin	hemoglobin
hen	digaag	asthma
henry	doofaarka	(proper noun) henry, as in henry kissinger
heo	xarrago leh	dolphin
her	iyada	her
herbert	herbert	herbert, as in herbert schandler
hercegovina	hercegovina	hercegovina
hercules	hercules	hercules
hermann	hermann	hermann
hermes	hermes	hermes
hersh	baraarug	hersh, as in seymour hersh
hesiod	labalaabid	hesiod
hestia	hestia	hestia
hi	hi	"(term should be ""hi vọng"") alternative spelling for ""hy vọng""; meaning ""hope"" (n.)"
hickam	hickam	(proper noun) hickam
hicks	haraad	hicks
hideto	hideto	(proper noun) hideto
hideyoshi	hideyoshi	(proper noun) hideyoshi
hidro	hydrogen	hydrogen
hillsborough	buuraha	hillsborough
hilton	hilton	hilton
himalaya	himalaya	(proper noun) himalaya
hinata	hinata	hinata
hindenburg	hindenburg	(proper noun) hindenburg
hindi	hindi	hindi
hindu	hindu	hindu, as in the hindu religion
hinh	hinh	(proper noun) a vietnamese first name
hinhtron	hiwaaroon	circle
hiragana	hiragana	hiragana
hiroshi	hiroshi	hiroshi
hiroshima	hiroshima	(proper noun) hiroshima, the japanese city
hitchcock	shil	hitchcock
hitler	dhuuni	hitler
hitter	ku dhuftay	hitter
hitters	garaacis	hitters
hiên	balbalaad	(proper noun) hiên, a vietnamese first name
hiđrô	hydrogen	hydrogen
hiếm	naadir	rare
hiến	siin	devote
hiếp	kufsi	rape
hiếu	cadawtinimada filial	pious
hiềm	xanuunsan	grudge
hiền	sage	sage
hiểm	khatar ah	dangerous
hiểu	fahmay	learn
hiện	is tus	"(term should be ""thực hiện"") to accomplish"
hiệp	badh	united
hiệu	saamayn	effective
hlv	tababaraha	trainer
hms	hms	hms
hmông	hmong	hmong
hn	hn	hn
hoa	ubax	flower
hoan	dabaaldag	welcome
hogwarts	hogwarts	(proper noun) hogwarts, sorcery school from the harry potter series
hoi	hoi	rare
hokage	biyo kululaynta	hokage
hokusai	hokusai	hokusai
holmes	holmes	a name
holocaust	holocaust	holocause
holocen	holocene	holocen
holt	holtuu	holt, an english last name
hom	gooyn	a cutting
homer	xoolo	(proper noun) homer, the authorof the iliad and the odyssey
hon	sharaf	"(term should be ""hòn"") rock (n.)"
honduras	honduras	honduras
hong	hong	hong
honolulu	honolulu	honolulu
honshū	honshū	honshu
hopkins	hopkins	(proper noun) hopkins
hornet	hornet	hornet
hotspur	hotspur	(proper noun) hotspur, as in tottenham hotspur
houston	houston	(proper noun) houston, as in whitney houston
howard	howard	(proper noun) howard
however	si kastaba ha noqotee	however
hoà	xerin	peace
hoài	nostalgic	always (adv.)
hoàn	dhameystiran	"(term should be ""hoàn toàn"") completely"
hoàng	boqorka	royal (adj.)
hoành	diaphram	rife
hoá	kimistariga	"(term should be ""văn hoá"") culture (n.)"
hoán	perm	refined (adj.)
hoãn	way cunaan	delay
hoạ	rinjiga	disaster (tham hoa)
hoại	burcad	"(term should be ""phá hoại"") to sabotage (v.)"
hoạt	hentai	work
hoả	dab	of
hoảng	cabsi	panic-stricken (adj.)
hoặc	ama	or
hp	hp	hp
hq	hq	hq
hudgens	hudgens	(proper noun) hudgens
hudson	hudson	hudson
huey	huey	huey
hughes	xijin	hughes
hugo	hugo	(proper noun) hugo
hume	hume	hume, as in david hume
hun	hun	(proper noun) hun
hungary	hunguri	hungary
hunt	ugaarsi	hunt
hurley	hurdi	(proper noun) hurley, as in chad hurley
hussein	hussein	hussein
husserl	husserl	huserl
huston	huston	huston
hutech	hutech	hutech
huy	huy	a common vietnamese first name
huynh	walaal	older brother
huyền	suugaanta	huyền thoại= legend
huyễn	khaldan	huyen
huyện	degmo	district
huyệt	dhibcaha cirbadaha	lair
huân	huan	"(term should be ""huân chương"") medal (n.)"
huê	hue	"a less common vietnamese word for ""flower"""
huấn	tababarka	"(term should be ""huận luyện"") to train (v.)"
huế	hue	hue
huệ	hue	favour
huống	kiis	situation
huỳnh	baaruud	sulfur
huỷ	baajin	destroy
hydra	hydra	hydra, a monster in greek mythology
hydro	hydrogen	hydrogen
hyperion	sicir barar	hyperion
hà	ha	"(term should be ""hà nội"") the capital of vietnam"
hài	majaajilo	corpse
hàm	daanka	"(term should be ""bao hàm"") to imply (v.)"
hàng	saf	row
hào	xayawaan	depreciation
hách	dulqaad	glorious
hái	soo qaado	picking
hán	abaarta	china
háo	xiiseeya	eager
hát	heesaa	song
hâm	waali	"(term should be ""hâm mộ"") to admire (v.)"
hân	han	le ngoc han
hãi	cabsi	to be scared (v.)
hãn	khan	to sweat (v.)
hãng	shirkadda	a company (n.)
hãnh	ku faan	proud
hè	xagaaga	summer
hé	dillaacay	reveal
héo	u engegay	dried-out
hét	qaylin	shout
hên	nasiib	luck
hí	ne	game
hít	neefsasho	act of kissing (hon hit)
hò	shukaansi	date
hòa	xerin	republic
hòe	shit	hoe
hòm	doonnida	box
hòn	jasiirad	island
hòng	si fiican	in order to
hóc	hóc	a corner (n.)
hót	heesaa	to chirp or sing (v.)
hô	ho	respiration
hôi	qalad	stink
hôm	maalin	day (n.)
hôn	dhunkasho	propose
hông	sinta	hip
hù	cabsi gelin	threaten
hùng	geesiyaal	hero
húc	gore	huc
húng	dhiirigelin	"(should be ""húng láng"") water mint"
hút	sigaar cabista	to suck (v.)
hăng	ubax	enthusiasm
hđbt	hđbt	hdbt
hđh	hđh	system software
hũ	dhalooyinka	jar
hơi	xoogaa yar	slightly
hơn	ka badan	more or less
hư	xun	fictional
hưu	hawlgab noqday	huu
hương	fooxa	smell
hước	kaftan	humor
hướng	jihada	trend
hường	huong	huong
hưởng	raaxayso	influence
hạ	xagaaga	lower
hạc	qoryaha ololka leh	crane
hạch	baandada	ganglion
hại	waxyeelo	harm
hạng	fasalka	rank
hạnh	hanh	happy
hạo	hao	hao
hạp	hap	hap
hạt	abuur	seed
hải	caadooyinka	two
hảo	kaamil ah	perfect
hấn	hấn	aggressive gesture
hất	duulaan	toss
hấu	qaraha	"(term should be ""dưa hấu"") watermelon"
hầm	tuneel	ham
hầu	ku dhawaad	most
hận	nacayb	hatred
hậu	boqoradda	anus
hắc	madow	black
hắn	isaga	he (n.)
hắt	hindhisto	reject
hằng	joogto ah	every
hặc	hặc	to criticize (v.)
hẹ	shallot	chinese chives
hẹp	dhuuban	narrow
hẻm	sariirta	alley (n.)
hẻo	go&#39;doon	outback
hến	xameer	mussel
hết	dhaaftay	most
hề	sacab	"(term should be ""không hề"") never"
hễ	haa	whenever
hệ	nidaam	relation
hệt	isku mid ah	exactly
hỉ	afuufid	happy
hịch	thud	a proclamation
họ	magaca awoowe	they (n.)
họa	fanka	picture
họach	qorshe	"(term should be ""quy hoạch"") a project (n.)"
học	baro	study (v.)
họng	cunaha	throat
họp	kulan	meet
hỏa	dab	fire
hỏng	jabay	corruption
hố	god	hole
hốc	naca	cavity
hồ	haro	ho
hồi	anise	muslim
hồn	nafta	soul
hổ	shabeel	tiger
hổi	huh	"(term should be ""nóng hổi"") steaming hot (adj.)"
hổng	fajacid	hole
hỗ	taageero	"(should be ""hỗ trợ"") to support or assist"
hỗn	isku qasan	"(term should be ""hỗn tạp"") mish-mash (adj.)"
hội	dabaaldag	society
hộp	sanduuq	box
hới	fur	hoi
hớn	qayliyey	"(term should be ""hớn hở"") radiant (adj.)"
hờn	sulky	hatred
hở	fur	reveal
hỡi	oi	dear
hợi	doofaar	pig (n.)
hợp	si fiican u habboon	appropriate
hợpquận	oggolaansho	general district
hụt	hoos u dhac	loss
hủi	baras	reject
hủy	baajin	to erase or destroy
hứa	ballan qaad	promise
hử	huh	hu
hửu	huh	"(term should be ""sở hửu"") to own (v.)"
hữu	hanti	(proper noun) hữu, a vietnamese middle name; also means right, as in the direction
hựu	huu	again
hỷ	hy	hy
ian	ian	ian, as in australian swimmer ian thorpe
iau	iau	iau
iberia	iberiya	iberia
ibm	ibm	(proper noun) ibm, the computer company
ibmpc	ibmpc	ibm-pc
ic	ic	ic
icc	icc	icc
iceland	dal baraf ah	(proper noun) the country of iceland
ide	ide	ide
ieng	ieng	(proper noun) ieng
igor	igor	igor
iii	iii	third
ilene	ilene	ilence
illusion	khayaano	illusion
ilyich	ilyich	ilyich
im	im	still
imam	imaam	(proper noun) imam
imbrium	imbrium	imbriun
immanuel	iimaan	(proper noun) immanuel, as in immanuel kant
impact	saamaynta	impact
incoterm	qarsoon	incoterm
incoterms	qarsoon	(proper noun) incoterms
indian	hindi	indian
indiana	indiana	indiana
indochina	indochina	indochina
indonesia	indonesia	indonesia
indrapura	indrapura	(proper noun) indrapura
info	macluumaad	info
innsbruck	dhalanteed	innsbruck
insulin	insulin	insulin
int	int	int
intel	intel	(proper noun) intel, as in the name of the company
interpol	interpol	interpol
inu	gudaha	(proper noun) inu
inuyasha	inuyasha	inuyasha
inư	gudaha	(proper noun) inư
io	io	io
ioc	ioc	ioc
ion	ion	ion
iosif	iosif	(proper noun) iosif, as in iosif vissarionovich stalin
iran	iran	the nation of iran
iraq	ciraaq	iraq
ireland	ireland	ireland
irgun	irgun	irgun
irony	bilaaw ah	irony
irving	furid	(proper noun) irving
isaac	isaaq	isaac
isla	isla	isla
islam	islaam	islam
islamabad	islamabad	(proper noun) islamabad
israeli	israeli	israeli
istanbul	istanbul	istabbul
italia	italia	italy
italiano	italiano	(proper noun) italiano
itanium	itonia	itanium, as in windows xp itanium
ito	waa	ito
itsukushima	itsukushima	itsukushima
itu	itu	itu
itzá	itzá	(proper noun) itzá
iv	iv	4 ( greek number)
iwami	iwami	iwami
j	j	j
jack	jaakad	jack
jackie	jaakad	(proper noun) jackie chan
jackson	jackson	(proper noun) jackson, as in michael jackson
jacob	jacob	jacob
jae	jae	jae
jakarta	jakarta	(proper noun) jakarta
jan	jan	(proper noun) jan
janeiro	janeiro	janeiro
janet	janet	janet
japan	japan	japan
jared	jeexan	jared
jarvis	jarvis	(proper noun) jarvis, as in jarvis cocker
jasper	jasiirad	(proper noun) jasper
jean	jean	jean
jeane	jeane	jeane
jeanjacques	jeanjacques	jean-jacques
jeanpaul	jeanpaul	jeanpaul
jeans	jiinis	jeans
jeet	geesi	(proper noun) jeet, as in jeet kune do
jeff	jeff	jeff, as in jeff drake
jefferson	jefferson	jefferson
jeffrey	jeffrey	jeffrey
jeju	jeju	jeju
jenda	jenda	jenda
jenny	jenny	jenny
jericho	jericho	jericho, as in wrestler chris jericho
jerome	jerome	jerome, as in fred jerome
jerry	jeri	(proper noun) jerry
jersey	maaliyad	jersey
jerusalem	yeruusaalem	jerusalem
jesse	jesse	a name
jesus	ciise	chua jesus
jetstar	jetstar	jetstar
jewish	qurxan	jewish
jiao	jiao	jiao
jimmy	jimmy	jimmy
jin	jin	jin
jing	kaftan	jing
jiraiya	jiraiya	(proper noun) jiraiya
joachim	joachim	joachin
joan	joan	a name
joe	joe	(proper noun) joe
johan	johan	johan
johann	johann	johann
johannes	johannes	johannes
johannesburg	johannesburg	(proper noun) johannesburg, south africa
johnny	johnny	johnny
johns	johns	johns
johnston	johnston	johnston, as in harry johnston
johor	johor	johor
joint	wadajirka	joint
jonathan	jonathan	(proper noun) jonathan
jones	aagag	jones
jose	kaftan	(proper noun) jose, a spanish first name
joseon	joseon	(proper noun) joseon
joseph	joseph	joseph
jscript	jscript	(proper noun) jscript
juche	juche	(proper noun) juche
judith	garsoor	judith
judo	judo	judo, the martial art
julesverne	julesverne	jules verne
julliard	julliard	(proper noun) julliard
jump	bood	jump
june	june	june, as in the month
jung	jung	jung
junsu	junsu	junsu
jupiter	jupiter	(proper noun) jupiter, as in the planet
jura	jura	(proper noun) jura
juventus	juventus	juventus
k	k	k
kaede	kaede	a japanese name
kaffee	kafee	(proper noun) kaffee, as in kaffee hag
kagome	kagome	kagome, as in higurashi kagome
kahn	kahn	kahn
kai	kai	kai
kakashi	kakashi	kakashi
kaká	kaká	(proper noun) kaka, a brazilian soccer player
kalashnikov	kalashnikov	(proper noun) kalashnikov
kali	potassium	potassium
kama	kama	(proper noun) kama, as in the kama sutra
kamakura	kamakura	kamakura
kamov	kamov	kamov
kampf	kampf	kampf
kampong	kampong	kampong
kampuchea	kampuchea	cambodian
kana	kana	kana, the japanese phonetic alphabet
kangin	kangin	(proper noun) kangin
kanji	kanji	kanji
kant	kant	a name
kar	kar	(proper noun) kar
kara	kara	kara
karaoke	karaoke	karaoke
karate	karate	karate
karatedo	karatedo	karatedo
karen	karen	(proper noun) karen
karim	karim	(proper noun) karim
kashmir	kashmir	kashmir
kaspersky	kaspersky	(proper noun) kaspersky, as in kaspersky anti-virus software
katakana	katakana	katakana, a type of japanese script
kate	kate	(proper noun) kate, as in actress kate winslet
katherine	katherine	katherine
kathmandu	kathmandu	kathmandu
katrina	katrina	(proper noun) katrina, as in hurricane katrina
katz	katz	katz
kauthara	kauthara	kauthara, a part of the ancient kingdom of champa
kavkaz	caanood	kavkaz
kawasaki	kawasaki	(proper noun) kawasaki
kay	kay	kay
kazan	kazan	kazan, the name of a city
kcn	kcn	industrial zone
ke	ke	"(term should be ""boong ke"") a bunker (n.)"
kelly	kelly	kelly
kelsi	kelsi	kelsi
kelvin	kelvin	kelvin
kem	kareem	ice cream (n.)
ken	ken	ken
kennedy	kennedy	(proper noun) kennedy, as in john f. kennedy
kenneth	kenneth	(proper noun) kenneth, a name
kenny	kenyan	kenny, an english first name
kentucky	kentucky	(proper noun) kentucky
kepler	adeer	kepler
kerala	kerala	(proper noun) kerala
kevin	kevin	kenvin
keynes	keynes	keynes, as in economist john maynard keynes
kg	kg	kilogram
kha	kha	(proper noun) a vietnamese first name
khai	caddeyn	announce
khali	khali	(proper noun) khali
khalip	khaliif	(proper noun) khalip
kham	kham	endure
khan	fuuq bax	rare
khang	khang	khang
khanh	khanh	khanh
khao	doonis	desire
khay	saxaarad	tray
khe	booska	chink
khem	khem	abstinence
khen	ammaanta	praise
kheo	on stilts	kheo
khi	marka	when
khieu	ma fahmin	(proper noun) khieu, as in khieu samphan
khiêm	dhexdhexaad ah	khiem
khiên	gaashaan	a shield
khiêu	dabacsan	"('khiêu dâm"") pornographic"
khiếm	daciifnimo	lack
khiến	sabab	control
khiếp	argagaxsan	horrible
khiếu	qol	talent (n.)
khiển	xakamayn	control
khleang	khleang	kh'leang
kho	bakhaar	warehouse
khoa	kuliyadaha	"(term should be ""y khoa"") the study of medicine (n.)"
khoan	daloolin	drill
khoang	dalool	brag
khoanh	dhawaaqa	a slice (n.)
khoe	muujinta	to boast
khoá	quful	lock
khoác	dharka sare	coat
khoán	saamiga	stock
khoáng	macdanta	mineral
khoát	qeexan	decisive
khoét	gooyaa	carve
khoăn	cadho	disturbed
khoả	qaawan	naked
khoản	shayga	an item (n.)
khoảng	qiyaastii	about
khoảnh	daqiiqado	moment
khoẻ	ganaax	health
khrushchev	khrushchev	khrushchev
khrushchyov	khrushchyov	khrushchyov
khu	rubuc	section
khung	xarkaha	frame
khural	khural	khural
khuynh	bidix	trend
khuyên	talo	advise
khuyết	cilladaysan	lack
khuyển	eey	khuyen
khuất	qarsoon	hidden
khuấy	kiciyay	stir
khuẩn	bakteeriyada	bacteria
khuếch	xoojin	amplification
khuỷu	xusul	elbow
khá	halkii	quite
khác	kale	different
khách	marti	customer
khái	fikrad ahaan	concept
khám	baaritaan	discover
khán	dhagaystayaasha	audience
kháng	iska caabin	appeal
khánh	madax-bannaanida	a type of chime made of stone (n.)
khát	harraadsan	to be thirsty for (adj.)
khâm	khâm	admire
khèn	hoogay	a pan-pipe (n.)
khéo	xariifnimo	cleverly or skillfully (adv.)
khép	xir	close
khía	feejignaan	"(term should be ""khía cạnh"") angle (n.)"
khích	dhiirigelin	encourage
khít	xir	close
khó	adag	difficulty
khóa	quful	a session
khóc	ooyaya	cry
khói	qiiqa	smoke
khóm	cananaaska	a cluster
khô	qalalan	dry
khôn	caqli badan	clever, intelligent
không	ma ahan	not
khúc	gabal	song
khăm	ur-xun	nasty (adj.)
khăn	shukumaan	difficult
khơi	xeebta	sea
khư	khư	grip
khưu	khưu	khuu
khước	diido	waive
khả	suurtagal	"(term should be ""khả năng"") ability (n.)"
khải	muujinta	triumph
khảm	moos	to encrust
khảo	baaritaan	"(term should be ""tham khảo"") to consult (v.)"
khấm	wareemay	endure
khấn	duceeya	pray
khấu	dhimis	"(term should be ""sân khấu"") a stage (n.)"
khẩn	deg deg ah	"(term should be ""khẩn cấp"") urgent (adj.)"
khắc	feejignaan	moment
khắp	dhammaan	all over
khẳng	qancin	"(term should be ""khẳng định"") to assert (v.)"
khế	miro xiddig	bond
khỉ	daanyeer	monkey or ape (n.)
khỏa	qaawan	nude
khỏe	xoog leh	health
khỏi	ka baxay	leave
khố	loincloth	loincloths
khốc	dir	devastating
khối	heerka fasalka	a block or mass of (n.)
khốn	caajis	miserable
khống	khong	control
khổ	silica	miserable (adj.)
khổng	weyn	huge
khởi	bilaabaa	start
khủng	naxdin leh	"(term should be ""khủng bố"") terrorist (n.)"
khủyu	caajis	elbow
khứu	pastel	olfactory
khử	tirtirid	reduction
ki	ki	"entire phrase is ""ki lo""; means ""kilometer"""
kia	taasi	other
kid	cunug	kid
kiel	kiel	(proper noun) kiel
kierkegaard	kierkegaard	kierkegaard, as in soren kierkegaard
kiernan	kiernan	kiernan
kii	kii	kii
kikyo	kikyo	kikyo
kilômét	kiiloomitir	kilometer
kim	kim	kim
kingdom	boqortooyada	kingdom
kinsey	kinsey	kisney
kiribati	kiribati	kiribati
kishimoto	kishimoto	(proper noun) kishimoto
kiss	dhunkasho	kiss
kissinger	shumis	kissinger
kitts	kitts	kitts
kitô	masiixi ah	christian
kiêm	cum	cum
kiên	bukaan	consistent
kiêng	ka fogaansho	abstinence, as in abstaining from eating
kiêu	kibirsan	showy
kiếp	waqtiga nolosha	a lifetime (n.)
kiết	kiết	cheap (adj.)
kiềm	alkaline	"(term should be ""kiềm chế"") to restrain (v.)"
kiểm	hubin	control
kiểu	nooca	type
kiệm	dhaqaale	save
kiện	in la dacweeyo	event (su kien)
kiệt	masterpiece	exhausted (adv.)
kiệu	palanquin	scallion
klaus	klaus	klaus
klein	klein	klein
km	kiiloomitir	kilometer
knesset	knesset	knesset
knuth	knuth	knuth, as in donald knuth
koch	koch	koch
kodansha	kodansha	kodansha
kofun	kofun	kofun, as in the kofun period of japanese history
kogoro	kogoro	kogoro
komodo	komodo	komodo
kon	kon	"(term should be ""kon tum"") a province in the highlands of vietnam"
kong	kong	(proper noun) kong, as in hong kong
konstantin	konstantin	(proper noun) konstantin
konversationslexikon	konversationslexikon	konversation-lexikon
kop	kop	kop
koran	koran	koran
kornai	kornai	(proper noun) kornai, as in janos kornai
koruna	koruna	koruna
kosovo	kosovo	(proper noun) kosovo
kremli	kremli	kremil
kremlin	kremlin	kremlin
kristen	kristen	kristen
krông	krong	krong
ku	ku	is a name
kuala	kuala	(proper noun) kuala, as in kuala lumpur
kubrick	kubrick	kubrick
kuen	kuen	kuen
kuiper	kuiper	(proper noun) kuiper, as in the kuiper belt
kulak	kulak	kulak
kune	kune	(proper noun) kune, as in the martial art jeet kune do
kung	kung	danh vo
kungfu	kungfu	kung fu
kunst	kunst	kunst, as in richard kunst
kurd	kurd	kurd
kurt	kurt	(proper noun) kurt
kuwait	kuwait	kuwait, the country (n.)
kwan	kwan	kwan
kwen	kwen	kwen
kwon	kwon	kwon, as in tae kwon do; proper noun
kyrgyzstan	kyrinkistan	(proper noun) the country of kyrgyzstan
kyushu	kyushu	kyushu
kyūshū	kyūshū	kyushu, a japanese island
kèm	ku lifaaqan	included
kèn	buunka	horn
kém	ugu yaraan	less
kén	cocoon	selective
kéo	jiidid	scissors
kép	laba	dual
két	amaan	"(term should be ""rốc két"") rocket (n.)"
kê	geedo	statistics
kênh	kanaalka	channel
kêu	dhawaaqa	appeal
kìa	bal eeg	that
kìm	booliyeyaasha	bar
kình	quraarado	rivalry
kí	saxeex	sign
kích	guji	excite
kíchbom	gujibt	bombers
kín	gaar ahaaneed	secretive or closed tight (adj.)
kính	quraarado	respect
kíp	shaqaale	esoterica
kít	xoqday	wheelbarrow
ký	saxeex	"(""nhật ký"") a diary"
kĩ	si taxaddar leh	technique
kơnia	kàia	a tree found in southeast asia; sometimes called wild mango
kạn	kan	kan
kẹo	nacnac	candy
kẹp	cajalad	to clamp down (v.)
kẹt	ku dhegan	jam
kẻ	rag	guy
kẻo	ma aha	lest
kẽ	dhaxal gal	crevice
kẽm	zinc	zinc
kế	ku xiga	a scheme (n.)
kết	dhamaadka	combine
kề	ku xiga	adjacent
kềnh	cufan	bulky
kệ	armaajo	ignore
kỉ	qarnigii	"(term should be ""kỉ niệm"") souvenir (n.)"
kị	fardooley	ki
kịp	hayn	kip
kỵ	fardooley	taboo
kỷ	qarnigii	"(term should be ""thế kỷ"") century (n.)"
l	l	l.
label	sumad	label
laboulaye	laboulaye	a name
ladakh	ladakh	(proper noun) ladakh
lai	hybrid	"(term should be ""tương lai"") the future (n.)"
lam	lam	lam
lama	lama	a name
lan	lan	a name
land	dhul	land
landon	dhulbahante	a name
lang	lang	lang
langdon	langdon	langdon
lange	libaax	lange, as in oscar lange
langue	luuq	langue
lanh	linen	ringing
lanka	lanka	(proper noun) lanka, as in the island of sri lanka
lao	qaaxada	labor
laos	laos	(proper noun) laos
lap	dhabta	greek
larry	dirxiga	larry
lars	maansooyinka	lars
las	las	(proper noun) las, as in las vegas
laser	laser	laser
lateran	lateran	lateran
latinh	laatiin	latin
latvia	latvia	(proper noun) latvia
lau	tirtir	lau
laura	laura	(proper noun) laura, as in laura bush
laurence	laurence	(proper noun) laurence
lawrence	sharciyeynta	(proper noun) lawrence
lay	jiifay	lay
lazarus	lazarus	(proper noun) lazarus
leach	leach	(proper noun) leach
leaf	caleen	leaf
leave	bax	leave
lebanon	lebanon	(proper noun) lebanon
lee	lee	lee
legacy	dhaxalka	legacy
leiden	leeden	leiden
lem	lem	cinderella
lenin	lenin	lenin
lenins	muraayadaha indhaha	lenin's
leo	fuulid	climb
leon	leon	leon
leonard	leonard	leonard
leonardo	leonardo	(proper noun) leonardo, as in leonardo da vinci
leonid	leonid	leonid
les	les	les
leslie	leslie	a name
lesotho	lesotho	lesotho
lg	lg	lg
lhp	lhp	film festival
lhq	lhq	un
libby	libby	(proper noun) libby
libero	xorreyn	libero
libya	libya	libya
lido	lido	lido
liechtenstein	liechtenstein	liechtenstein
liga	liga	a name
lightning	hillaac	lightning
lilly	lilly	(proper noun) lilly
linga	lingaxan	linga
linh	linh	efficacious (adj.)
links	xiriirada	links
linux	linux	linux server
lionel	libaax	lionel
lisboa	lisboa	lisboa
lisbon	lisbon	a name
litva	lithuania	(proper noun) lithuania
liu	liu	liu
liêm	daacadnimo	good example
liên	ganacsi	relate
liêng	muqadas ah	sacred
liêu	bureaucracy	bureaucracy
liềm	jiran	sickle
liều	qaadasho	daring
liễu	safsaf	a willow tree (n.)
liệng	tuur	"(term should be ""cánh liệng"") the aileron of a plane (n.)"
liệt	curyaannimo	impotent
liệu	bal	document
lleyton	lleyton	lleyton
lo	walwal	to worry (v.)
loa	hadal	"(term should be ""cổ loa"") an ancient vietnamese city (proper noun)"
loaita	loaita	loaita
loang	riixid	patchy
loch	loch	loch
locke	xayawaan	(proper noun) locke, as in philosopher john locke
lockheed	xirtay	(proper noun) lockheed, as in lockheed martin
log	qor	log
logan	logan	a name
lon	karaa	lon
london	london	london
long	dheer	dragon
lorenzo	lorenzo	lorenzo
los	los	los, as in los angeles
louis	louis	louis
louisiana	louisiana	(proper noun) the state of louisiana
louvre	louvre	(proper noun) louvre
love	jacayl	yeu
loài	noocyada	species
loát	dhaldhalaalaan	overturn
loãng	washy	wishy-washy
loét	boogta	gaping, as in a wound
loại	noocyada	type
loạianh	nooca	not a word
loạianime	nooca anime	type anime
loạibệnh	nooca cudurka	disease
loạichiến	nooca	loaichien
loạicác	nooca	item
loạicâu	nooca	type: club
loạicông	nooca	type: industry
loạicựu	nooca	kind former
loạigia	nooca	loaigia
loạihuân	kindhuan	not a word
loạiluật	nooca sharciga	type: law
loạimáy	nooca mashiinka	kind plane
loạimôn	nooca	type
loạingày	noocaan ah	loaingay
loạiphim	nooca filimka	type movie
loạiphong	nooca	kind of movement
loạiscandal	fleaiscandal	scandal type
loạithuật	nooca sharciga	type: lexicon
loạithành	nooca	kinds of payment
loạithần	nooca	kind myth
loạitrường	nooca iskuulka	type of school
loạitín	noocee ah	type: belief
loạitổ	nooca	kind organization
loạivõ	nooca nooca	type: martial art
loạixã	nooca	kind of society
loạn	jahwareer	disorderly
loạt	taxanaha	series
lp	lp	lp
lu	lu	dim
luang	luang	a name
lucas	lucas	(proper noun) lucas
lucia	lucia	lucia, as in the island of saint lucia
luciano	luciano	luciano
ludendorff	ludendorff	luđenorff
ludovico	ludovico	ludovico
ludwig	ludwig	ludwig
lui	dib	withdrawal
luis	luis	(proper noun) luis, a first name
luiz	luiz	luiz
lula	lula	lula
lung	sambabka	shake
lustig	lustig	lusig
luther	luther	luther
luxembourg	luxembourg	a name
luy	luy	luy
luyến	lifaaq	love
luyện	tababarka	training
luận	faallo	"(term should be ""xã luận"") an editorial"
luật	sharciga	law
luồn	duub	wriggle
luồng	durdur	lane
luộc	la kariyey	boiled
luỹ	isugeyn	rampart (n.)
ly	galaas	divorce
lydia	ludiya	lydia
lympho	qanjiro	lymphocyte
lyndon	lndon	lyndon
lyon	lyon	lyon
là	ahaa	the verb to be
làm	samee	make
làn	haadka	wave
làng	tuulo	village
lành	bogsiiyey	protestant
lào	laos	laos
lá	caleemaha	"(term should be ""lá thư"") a letter (n.)"
lác	squint	brag
lách	caajisnimo	to swerve (v.)
lái	wadid	to drive (v.)
lán	xirsi	shack
láng	dhalaalaya	neighbours
lâm	lam	lâm, a common vietnamese first name
lân	unicorn	nearby
lâu	dheer	long time
lây	faafitaan badan	to infect
lãi	dan	a profit
lãm	muujinaya	exhibition
lãnh	helay	to receive
lão	jir	old
lèo	lèo	"(term should be ""nước lèo"") broth (n.)"
lén	isku shaandheyn	sneak
lê	luul	le
lêmạc	iftiin	"(term should be ""lê-mạc"") a war between two ruling families in ancient vietnamese history"
lên	kor	on
lênh	amar	"(should be ""lênh đênh"") adrift"
lênin	lenin	lenin
lìa	bax	to leave (v.)
lình	si lama filaan ah	suddenly
lí	kaydinta	reason
lính	askari	soldier
lít	litir	litre
líu	qabow	"(term should be ""dính líu"") to have a connection with"
lò	foornada	release
lòng	burburin	heart
lóc	abeeso	cry
lóe	gilgiley	flash
lóng	dharbaaxo	"entire term should be ""tieng long""; means ""slang"""
lót	daadka	undies
lô	badan	batch
lôi	qalad	encourage
lôn	lol	"(term should be ""côn lôn"") a village in vietnam"
lông	timo	hair
lõi	xudunta	core
lõm	rakhiis	concave
lùi	gadaal	back
lùn	gaaban	dwarf
lùng	ugaarsi	hunt
lúa	paddy	rice
lúc	at	at the moment
lún	deganaansho	subside
lúng	olol	confused
lúp	weyneynta	uneven
lút	waalan	surreptitiously
lăm	shan	tens
lăn	rogid	attack
lăng	mooshin	tomb
lĩnh	domains	"(term should be ""thủ lĩnh"") the leader (n.)"
lũ	daad	a band or gang (n.)
lũng	dooxada	valley
lũy	isugeyn	rampart
lơ	dayacaad	to ignore
lơi	dabacsan	"(term should be ""lả lơi"") to act in a familiar or flirting manner (adv.)"
lư	faafreeb	an urn
lưng	dib	back
lươn	eel	eel
lương	mushahar	conscience
lưới	grid	a net (n.)
lướt	surf	ski
lười	caajis	lazy
lưỡi	carrab	tongue
lưỡng	bisexual	"(term should be ""lưỡng tính"") bisexual"
lược	shanlo	invasion
lượm	ururin	pick up
lượn	soo boodid	to glide over (v.)
lǐ	lǐ	(proper noun) li, as in jet li
lạ	yaab leh	strange or unusual (adj.)
lạc	lumay	camel
lạch	creek	"(term should be ""luồng lạch"") a narrow water passageway"
lại	mar labaad	reversed
lạn	qurmay	bright
lạng	lang	lang
lạp	bolse	"(term should be ""hy lạp"") greek"
lạtma	lamma	lama
lạy	sujuud	kowtow
lấn	xayiraad	to encroach on (v.)
lấp	buuxi	sparkle
lấy	soo qaado	taken
lầm	khalad	wrong
lần	jeer	time
lầu	dabaqa	a story or level of a building (n.)
lầy	harraad	swamp
lẩu	dheriga kulul	hotpot
lẩy	bood	get
lẫn	wareersan	each other
lẫy	qanjaruufo	illustrious
lận	khiyaamo	fraudulent
lật	flip	turn
lậy	oh haa	"(term should be ""cai lậy"") the name of a rural district"
lắc	rux	to shake (v.)
lắm	aad	do
lắng	si loo dejiyo	"(should be ""lo lắ́́ng"") to worry"
lắp	ku habboon	lap
lặng	xasilloon	quiet
lặp	ku celi	repeat
lặt	kala duwan	means miscellaneous, part of the word lat vat
lẹ	dhakhso	quickly (adv.)
lẻ	odd	"(the term should be ""bán lẻ"") retail"
lẻn	dhuuqaan	sneak
lẻo	lax	climb
lề	margin	alignment
lều	teendho	tent
lễ	xaflad	ceremony
lệ	heerka	"(term should be ""tỷ lệ"") probability (n.)"
lệch	skew	difference
lệnh	comeinand	command
lị	caafimad	"(term should be ""tỉnh lị"") a township (n.)"
lịch	kalandarka	history
lọc	filter	tricked
lọi	squint	brilliant
lọng	parasol	rope
lọt	dhicid	enter
lỏi	lint	to enter
lỏng	dabacsan	loose
lố	dhaaftay	ridiculous
lốc	dabayl	tornado
lối	irridda	way or path
lốp	daal	tyre
lốt	khiyaamo	lolot
lồ	weyn	giant
lồi	convex	convex
lồng	qafis	cage
lỗ	dalool	hole
lộc	nasiib	loc
lội	dabaal	wade
lộn	ruxay	wrong/mistake
lộng	qurux badan	"(term should be ""cổ lộng"") the name of a vietnamese city"
lột	xaraashka	exploit
lớn	weyn	large
lớp	fasalka	grade (n.)
lờ	iska ilow	turbid
lời	eray	advice
lở	seegto	to crack
lỡ	la waayey	miss
lợi	faa&#39;iido	benefit
lợn	doofaarka	pig
lợp	saqafka	roof
lụa	xariir	silk
lục	cagaaran	record
lụi	gubay	ruin
lụt	ka badin	flood
lụy	saameynta	consequence
lứa	qashin	peer
lừa	khiyaamo	mislead
lừng	muuqaal	well-known
lửng	summad	lơ lửng= not clear/ something in between
lự	ka gaabsaday	reluctant
lựa	la xushay	chosen
lựu	pomegranate	grenade
ma	cirfiid	ma sat (friction), ma thuat (magic), thay ma (zombie)
maastricht	maastricht	maastricht
macarthur	mac-macaan	macarthur
macclesfield	macclesfield	macclesfield
macedonia	macedonia	(proper noun) macedonia
mach	mashiinka	mach
machiavelli	machiavelli	machiavelli, as in philosopher niccolo machiavelli
machu	machu	machu
macintosh	macintosh	macintosh
macma	magma	magma
macromedia	macromedia	macromedia
madeira	madeira	madeira
madhouse	guri madhan	madhouse
madison	madison	madison
madonna	madonna	(proper noun) madonna
madrid	madrid	madrid, as in the capital of spain
mafia	mafia	mafia
magiê	magnesium	magnesium
mahal	mahal	(proper noun) mahal, as in the taj mahal
mai	saqafka	"(term should be ""giang mai"") the disease syphilis (n.)"
mainframe	bartilmaameedka	mainframe
major	weyn	major
makemake	sameysan	makemake
malacca	malak	malacca
malay	malay	malaysia
malaysia	malaysia	(proper noun) the country of malaysia
malcolm	malcolm	malcolm
maldini	maldini	maldini
mali	mali	mai
malta	malta	malta
maluku	maluku	maluku
manche	manche	manche
manchester	manchester	manchester
mandela	mandela	mandela, as in nelson mandela
mandy	maahmaah	mandy
mang	qaado	to bring (v.)
manga	manga	manga
mangnall	mangnall	(proper noun) mangnall, as in ernest mangnall
manh	manh	fragile
manila	manila	manila, the capital of the philippines
mankiw	mankiw	mankiw, as in gregory mankiw
manti	manti	mantle
manuel	manuel	manuel
mao	mao	capillary
maps	khariidadaha	maps
maradona	maradona	(proper noun) maradona, as in soccer player diego maradona of argentina
marat	marat	(proper noun) marat, as in marat safin, a tennis player
marc	marc	marc, as in marc chagall
marcel	marcel	(proper noun) marcel, a french name
marcos	maryo	(proper noun) marcos, as in ferdinand marcos
marcus	marcus	marcus, as in marcus aurelius (n.)
margaret	margaret	(proper noun) margaret
maria	guur	(proper noun) maria
marianne	marianne	(proper noun) marianne
marie	guur	marie
marina	badda	marina
marino	marino	marino
marić	marić	maric
marmara	marmara	(proper noun) marmara, as in the sea of marmara
marne	marin	marne, as in the marne river (n.)
mars	mars	mars
marseille	marsiille	marseille
marshall	marshall	marshall
marsu	marsu	(proper noun) marsu
marta	marta	(proper noun) marta, as in the female brazilian soccer player
martin	martin	martin
marx	marx	this is a name
mary	maryo	(proper noun) mary
maryland	maryland	a name
maría	maría	maria
mas	mas	mas
massachusetts	duco	massachusetts
mat	mat	mat
mathematica	xisaabta	(proper noun) mathematica, as in isaac newton's work, principia mathematica
mats	gogosha	mats, as in mats sundin
matthias	matthias	matthias, as in matthias erzberger
mau	si deg deg ah	fast
maurice	maurice	(proper noun) maurice
mausolus	mausolus	mausolus
maxim	maxim	a name
may	tolo	lucky
maya	maya	(proper noun) maya
mcafee	mcafee	(proper noun) mcafee
mccain	goos goos	mccain
mccartney	mccartney	a name
mccullough	cillad la&#39;aan	mccullough
mcdonald	mcdonald	(proper noun) mcdonald
mchc	mchc	mchc
mclaren	mclaren	mclaren
mcmahon	mcmahon	(proper noun) mcmahon
mcnamara	mcnamara	(proper noun) mcnamara, as in robert mcnamara
mcv	mcv	mean corpuscular volume
media	warbaahinta	media
medici	medici	(proper noun) medici, as in the medici family of italy
medina	medina	(proper noun) medina, as in ernest medina
medvedev	medvedev	medvedev
mekong	mekong	mekong
melbourne	melborne	melbourne
mendeleev	mendeleev	mendeleev
menes	ragga	(proper noun) menes
mercedes	ka tanaasulay	a name
messenger	rasuul	messanger
messerschmitt	messerschmitt	messerschmitt, as in the messerschmitt me-109, a german plane
messi	messi	(proper noun) messi, as in argentinian soccer player lionel messi
messiah	masiixa	messiah
meteora	meteora	meteora
mext	mext	mext
meyer	meyer	(proper noun) meyer, as in stephenie meyer, author of the twilight series
meyers	iibiyeyaal	meyers
miami	miami	a name
michael	michael	michael
michaels	michael	michaels
michelangelo	michelangelo	michelangelo
michigan	michigan	a name
micro	micro	micro
microbiology	microbiology	microbiology
microeconomics	microeconomics	microeconomics
micronesia	nafaqeeyayaalka yar yar	micronesia
microsoft	microsoft	(proper noun) the microsoft company
miguel	miguel	miguel
mike	moo	mike
mikoyan	mikoyan	mikoyan
mikoyangurevich	mikoyangurevich	(proper noun) mikoyangurevich
milan	milan	milan
milano	milano	milano
miley	miley	miley
mill	dhagxaan	mill
miller	miller	miller
milton	milton	milton
min	daq	min
minas	nus	minas
mindanao	mindanao	(proper noun) mindanao
ming	ming	ming
minnesota	minnesota	minnesota
minoa	minoa	minoa; the minoan civilization
miraflores	miraflores	miraflores
mirage	xaraash	mirage
miroku	miroku	(proper noun) miroku, a japanese name
misfits	misfits	misfits
mississippi	mississippi	mississippi
missouri	missouri	(proper noun) the state of missouri
mitchel	mithel	mitchel
mitsubishi	mitsubishi	mitsubishi
miên	hypnosis	mien
miêu	bisad	"(term should be ""miêu tả"") to describe (v.)"
miến	bariis macaan	burma
miếng	gogo &#39;	a piece (n.)
miếu	macbudka	temple
miền	domain	area
miễn	ka dhaafid	to exempt (v.)
miện	taaj	crown
miệng	afka	mouth
mm	mm	millimeter
mobile	mobilada	mobile
mode	hab	mode
modul	module	module
modula	modula	(proper noun) modula, as in modula-2
mohammad	mohammad	mohammad
mohammed	mohammed	mohammed
moi	cusub	winkle
molecular	moodeel	molecular
molotov	molotov	molotov
molypden	molybdenum	the element molybdenum (n.)
mongolia	mongolia	mongolia
monique	monique	(proper name) monique, a french first name
mono	mono	mono
monroe	monroe	monroe
mont	mont	(proper noun) mont
montaigne	montaigne	montaigne, as in michel de montaigne
montana	montana	(proper noun) montana, as in the state
montenegro	montenegro	montenegro
montmartre	montmartre	(proper noun) montmartre
montparnasse	montparnasse	montparnasse
montreal	montreal	(proper noun) montreal, quebec
moo	moo	(proper noun) moo, as in cha moo won
moong	moong	moong
mora	mora	mora
moravia	moravia	moravia
morgan	morgan	(proper noun) morgan
mori	mori	(proper noun) mori
moriarty	caafimad	(proper noun) moriarty, as in james moriarty from sherlock holmes
morley	morley	morley
morocco	morocco	morocco
morris	morris	morris
morrison	xabsi guri	(proper noun) morrison
morse	cirroole	(proper noun) morse, as in morse code
moscow	moscow	moscow
mosin	mosin	mosin
moskva	kansar	moscow
motown	motown	motown
mourinho	mourinho	mourinho
movie	filim	movie
mozambique	mozambique	(proper noun) mozambique
mozart	mozart	(proper noun) mozart, as in the composer
mp	mp	mp
ms	m	metre per second
msdos	msdos	ms-dos
mtv	mtv	mtv
mu	mu	pubis
mua	iibso	buy
much	badan	much
muhammad	muhammad	(proper noun) muhammad, as in muhammad ali
mumbai	mumbai	mumbai
mun	dhalanteed	a vietnamese name
munich	munich	(proper noun) munich
murdoch	murdoch	murdoch
muromachi	muromachi	(proper noun) muromachi
murphy	dil	murphy
murray	murray	(proper noun) murray, as in dr. conrad murray
mustang	mustang	mustang, as in the f-51 mustang
muta	muta	a name
muôn	raba	a large number; thousands (adj.)
muối	cusbo	salt
muốn	raba	want
muống	qaaddo	"(term should be ""rau muống"") water spinach (n.)"
muồi	soo daahay	ripe
muỗi	kaneecada	mosquito
muỗng	qaaddo	spoon
muội	walaasha	confusion
muộn	soo daahay	late (adv.)
myanma	myanmar	the country of myanmar
myanmar	midin	(proper noun) myanmar
myspace	myspace	(proper noun) myspace
mà	laakiin	also
mài	shiidi	tomorrow
màn	shaashadda	curtain (n.)
mành	indhooleyaal	a bamboo screen (n.)
mào	crest	a comb or crest, as in the body part of a bird
màu	midab	color
mày	adiga	sew
má	hooyo	cheek
mác	sumad	a name (marx)
mách	talooyin	tell
máclênin	marxel	marxist-leninist
mái	saqafka	"entire term should be ""thoai mai""; means ""comfortable"""
mát	qabow	cool
máu	dhiig	blood
máy	mashiinka	a machine (n.)
mâm	saxaarad	tray
mân	rosary	"entire term should be ""man viet""; a country of ancient asia that now corresponds to a province in southern china"
mâu	is burinaya	contradiction
mây	daruur	cloud
mã	koodh	"(term should be ""la mã"") roman (adj.)"
mãi	weligiis	forever (adv.)
mãimại	koodh	commerce
mãn	soo jiidasho leh	satisfy
mãnh	xoog leh	intense
mão	taaj	cat
mè	sisinta	sesame
mèo	bisad	cat (n.)
mé	aniga	a border
méo	qalloocan	alter
mép	gees	edge
mét	mitir	meter
mênh	si kadis ah	vast
mêtan	methane	methane
mì	hilib doofaar	wheat
mình	naftaada	me
mía	bakoorad	sugar cane (n.)
mò	ruxay	to grope (v.)
mòn	raad raac	trail
móc	jillaab	"(term should be ""máy móc"") machinery (n.)"
món	cuntada	dish
mô	unug	mo
môi	mid kasta	lip
môn	maaddooyinka	anus
mông	dabada	mongolia
mônôxít	monoxide	monoxide
môt	mid	"(term should be ""một"") one (n.)"
môtô	mooto	motorcycle
mù	indhoole	mu
mùa	xilli	season
mùi	ur	smell
múa	dhaanto	dance
mút	nuugid	to suck (v.)
münchen	münchen	(proper noun) munchen
măng	bamboo dillaac	bamboo shoot (n.)
mĩ	ameerika	america
mũ	koofiyad	cap
mũi	sanka	nose
mơ	riyo	vague
mơn	lugaha	caress
mưa	roob	rain
mưu	xeelad	"(should be ""tham mưu"") advisors"
mươi	konton	tens
mương	daadi	ditch
mướn	kiro	hire
mướt	xariir	smooth (adj.)
mường	muong	(proper noun) mường, a minority people in vietnam (n.)
mượn	deynsato	borrow
mượt	jilicsan	glossy (adj.)
mạc	cidlada	"(should be ""mộc mạc"") simple or natural"
mạch	wareeg	vessel
mại	ganacsiga	commerce
mạn	dhinac	romantic
mạnh	xoog leh	strong
mạo	maqaal	"(should be ""mạo hiểm"") to brave danger"
mạt	caarada	"(term should be ""lê mạt"") the ending or decline of something (adj.)"
mả	xabaalaha	tomb or grave (n.)
mải	mashquul	absorbedly
mảng	diyaarin	genre
mảnh	jiiska	piece
mất	lumay	lose
mấu	tab	key
mấy	yar	any
mầm	jeermiga	kindergarten
mầu	midab	color
mẩu	gogo &#39;	piece
mận	rifle	plum
mập	dufan	fat
mật	malab	intimate
mậu	ganacsiga	mau
mắc	qaali ah	get
mắm	maraqa kalluunka	"(term should be ""nước mắm"") fish sauce (n.)"
mắn	nasiib	"(term should be ""may mắn"") fortunate (adj.)"
mắng	canaantay	scold
mắt	isha	eye
mặc	xidho	wear
mặn	cusbada	salt
mặt	waji	face
mẹ	hooyo	mother (n.)
mẹo	talooyin	trick
mẻ	dufcaddii	cool
mẽ	xoog leh	strong
mến	gacaliye	to adore or like greatly (v.)
mề	gizzard	locket
mềm	jilicsan	soft
mệnh	qaddar	revolution
mệt	daalay	tired
mỉ	xariifnimo leh	meticulous
mỉa	caydhis	ironic
mỉm	dhoola cadeyn	smile
mịch	shit	"(term should be ""tịch mịch"") quiet (adj.)"
mịn	jilicsan	smooth
mịt	qiiq	dim
mọc	koraya	to grow (v.)
mọi	kasta	every
mọn	yar	lowly
mỏ	miinooyinka	mine
mỏi	daalay	tired (adj.)
mỏng	dhuuban	thin
mốc	musty	border
mối	eray bixin	relationship
mốt	moodada	fashion or style (n.)
mồ	qabriga	"(term should be ""mồ hôi"") sweat (n.)"
mồi	sed	bait (n.)
mổ	qalliinka	to dissect or perform surgery (v.)
mỗi	kasta	every
mộ	xabaal	admire
mộc	nijaarnimo	simple
mộng	riyo	dream
một	mid	one
mới	cusub	new (adj.)
mờ	qaawan	dim
mời	casuumad	invite
mở	fur	open
mỡ	dufan	fat or grease (n.)
mục	shayga	purpose
mụn	nabar	pimple
mức	heer	level
mứt	macaanka	preserve
mừng	farxad	to be happy
mửa	matagid	to vomit (v.)
mực	khad	"(term should be ""chuẩn mực"") standard (n.)"
mỳ	nuux	noodles (n.)
mỹ	ameerika	america
mỹcông	ameerika	my private
na	na	"(term should be ""na uy"") the country of norway"
naadam	naadam	naadam
nacional	nacional	nacional
nagant	caajis	nagant
nagar	nagar	nagar, as in champa po nagar
nagasaki	nagasaki	(proper noun) the city of nagasaki, japan
nagoya	nagoya	a name
nagumo	nagumo	nagumo
nai	deerada	a deer
nairobi	nairobi	nairobi, a city in kenya (n.)
nakajima	nakajima	a japanese name
nalbandian	nalbandian	a name
nam	lab	male
nambắc	waqooyiga	nambac
namibia	namibia	namibia
namnam	nam nam	male-male
namno	namno	nammo
nancy	naaqus	nancy, as in nancy pelosi
nang	follicle	"(term should be ""cẩm nang"") a handbook (n.)"
nanh	marawaxado	fang
nano	nano	nano
naomi	naomi	naomi, as in model naomi campbell
napoleon	napoleon	(proper noun) napoleon
napoli	napoli	(proper noun) napoli
napoléon	napoléon	napoleon
nara	nara	nara
nasa	nasa	(proper noun) nasa
nat	nat	nat
nathan	nathan	nathan
natri	sodium	sodium
nauru	nauru	a name
nava	nawaaxad	nava
navarre	navarre	navarre
nay	hadda	this (adj.)
needham	baaham	needham
nelson	nelson	(proper noun) nelson, as in nelson mandela
neo	baraf	"(term should be ""mỏ neo"") an anchor (n.)"
neon	neon	neon
nepal	nepal	nepal
nepomuk	nepomuk	a name
nessie	nessie	(noun) nessie, the nickname of the loch ness monster
net	shabaq	net
netbook	netbook	netbook
netscape	netscape	netscape
networks	shabakadaha	networks
neumann	neumann	(proper noun) neumann
neutrino	neutrino	neutrino
nevada	nevada	nevada
neverland	waligaa	neverland
newcastle	newelka	newcastle
newspaper	wargeys	newspaper
newton	newton	newton
newtons	newtons	(proper noun) newton's
next	ku xiga	next
nga	ruushka	russia
ngai	carshiga	crown
ngang	toosan	horizontal
ngao	clam	clam (n.)
ngay	sax	even
nghe	dhageyso	hear
nghinh	nghinh	welcome
nghiêm	si daran	serious
nghiêng	u janjeedha	inclined
nghiêu	nghieu	nghiêu, a vietnamese name
nghiền	midab leh	crush
nghiễm	naxariis	serious
nghiệm	khibrad	experiment
nghiện	qabatimay	addiction
nghiệp	karma	karma/ sự nghiệp=career
nghiệt	murugo leh	adverse
nghành	warshadaha	faculty
nghèo	sabool ah	poor
nghé	nghe	to glance out of the corner of one's eye (v.)
nghê	nghe	nghe khuong
nghênh	soo dhawow	support
nghìn	kun	thousand
nghĩ	ka fikir	think
nghĩa	macnaheedu	meaning
nghẽn	ciriiri	jam
nghếch	cod dheer	stupid
nghề	xirfad	career
nghệquận	fanka	art district
nghỉ	fasaxyada	relaxation
nghị	talooyin	think
ngo	dainty	ngo
ngoan	wiil wanaagsan	good
ngoc	ngoc	"(term should be ""ngọc"") gem (n.)"
ngon	dhadhan fiican leh	delicious
ngoài	banaanka	outside of
ngoại	shisheeye	external
ngoạn	neefta	spectacular
ngoặc	xaashiyaha	bracket
ngoặt	leexo	landmark
ngu	seexo	stupid
ngung	ngung	(proper noun) a vietnamese first name
nguyen	nguyen	nguyen
nguyên	asalka ah	reason
nguyền	habaar	curse
nguyện	nidar	"(term should be ""mãn nguyện"") to be satisfied (adj.)"
nguyệt	dayaxa	moon
nguôi	xasilloonida	fade away
nguồn	isha	source
nguời	dadka	people
nguỵ	nacasyada	camouflage
ngà	fool maroodi	russian
ngàn	kun	thousand
ngàng	ngàng	"(term should be ""ngỡ ngàng"") to be at fault (adj.)"
ngành	laanta	sector
ngào	macaan	sweet
ngày	maalin	day
ngách	niche	"entire term should be ""ngoc ngach""; means ""a small, out-of-the-way road"""
ngái	doqon ah	chinese ethnic group living in the vietnamese highlands near the china border
ngán	caajis	to be tired of
ngáng	ngáng	stop
ngát	suuxdin	"(term should be ""ngát hương"") fragrant (adj.)"
ngân	bangiga	money
ngây	madhan	"(term should be ""ngây ngất"") to be in ecstasy"
ngãi	ngai	ngai
ngò	cilantro	coriander
ngó	eegid	to look (v.)
ngói	tile	tile or shingle
ngón	farta	a finger (n.)
ngót	xoqid	"(term should be ""rau ngót"") also called sweet leaf, a type of leafy vegetable used to make soup (n.)"
ngôn	af	manifesto
ngông	goose	eccentric
ngõ	haadka	lane
ngùi	ur	sad
ngút	ngut	"entire term is ""ngut troi""; means ""sky-high"""
ngăn	qolka	prevent
ngũ	seexo	rank
ngơ	la iloobey	ignored (adj.)
ngơi	nasasho	"(term should be ""nghỉ ngơi"") to rest (v.)"
ngư	kalluumaysato	fishermen
ngưng	jooji	stop
ngưu	ox	buffalo
ngươi	adiga	an ancient form of address equivalent to thou or thee (n.)
người	dadka	people
ngưỡng	marinka	religious
ngược	gadaal	opposite
ngạc	yaab	surprise
ngạch	darajo	"(term should be ""kim ngạch"") turn-over (n.)"
ngạn	bangiga	bank
ngạnh	baararka	self-willed
ngạo	kibirsan	"(term should be ""ngạo ngược"") insolent (adj.)"
ngạt	neefsasho	stuffy
ngấm	noole	draw
ngất	suuxsan	unconscious
ngầm	cadayn	underground
ngần	ka waaban	hesitate
ngẩn	ceebeeyay	froze
ngẫm	ka fikir	think
ngẫu	random	ngẫu nhiên= random
ngậm	lozenges	keep
ngập	daadadku	flood
ngắm	ka fikir	to contemplate or look admiringly at something (v.)
ngắn	gaaban	short
ngặt	adkeyn	strict
ngọ	duhurkii	horse
ngọc	qurxinta	pearl
ngọn	kor	top
ngọt	macaan	sweet (adj.)
ngồi	fadhiiso	sit
ngộ	iftiin	ngo
ngột	si lama filaan ah	sudden
ngớ	nacasnimo ah	silly
ngời	dadka	bright
ngỡ	fikir	surprised
ngợi	ammaanta	praise
ngợm	caajis ah	naughty
ngục	xabsi	dungeon
ngụm	kabasho	sip
ngụy	wei	puppet
ngủ	seexo	sleep
ngủi	gaaban	"(should be ""ngắn ngủi"") short-lived"
ngứa	cuncun	itchy
ngừ	tuna	tuna
ngừa	ka hortag	prevent
ngừng	jooji	to cease (v.)
ngửa	waji	supine
ngửi	ur	to smell
ngữ	hadalka	term
ngự	degid	defend
ngựa	faras	horse
ngực	xabadka	chest
nha	dhakhtarka ilkaha	dental
nhakẻ	cunug	nha-ke
nham	lava	"(actual term is ""dung nham"") lava"
nhan	nhan	"(term should be ""dung nhan"") countenance or facial appearance (n.)"
nhang	fooxa	incense
nhanh	soon	fast
nhat	nhat	nhat
nhen	dib u bilaabay	rekindle
nhi	caruurta	junior
nhiên	dabcan	tuy nhiên= however
nhiêu	badan	how many
nhiều	badan	numerous
nhiễm	qaadey	infect
nhiễu	buuq	noise
nhiệm	waajib	task
nhiệt	kuleyl	heat
nhk	nhk	nhk
nhs	nhs	nhs
nhu	jecel	demand
nhuận	faa&#39;iido	leap year
nhuệ	nhue	elite
nhuộm	dheeh	dye
nhàn	shaqo la’aan	leisure
nhàng	si tartiib ah	"(term should be ""nhẹ nhàng"") gentle (adj.)"
nhào	cajiin	to fall headlong
nhác	jilicsan	coward
nhái	xarkaha	illegal copy
nhánh	laanta	branch
nháp	qabyo qoraal	draft
nháy	olol	to flash or blink (v.)
nhâm	quusin	leap
nhã	dhadhan fiican leh	"(term should be ""thanh nhã"") elegant"
nhãn	sumad	"(term should be ""gán nhãn"") to affix a label"
nhét	gelin	put
nhì	labaad	second (adj.)
nhìn	eegid	to look (v.)
nhí	sheekeysi	children
nhím	hedgehog	porcupine
nhòm	eegid	to peep (v.)
nhóc	cunug	brat
nhóm	koox	group (n.)
nhô	leexinta	emerge
nhôm	aluminium	aluminum (n.)
nhúng	dhajin	embed
nhút	xishood	shy
nhăn	duuduub	wrinkle
nhĩ	atrial	turkey
nhũ	kacsi	"(term should be ""thạch nhũ"") stalactite (n.)"
nhũng	musuqmaasuq	bribery
nhơn	ku dhufo	nhon
như	sida	like
nhưng	laakiin	but
nhương	candhuufta	(proper noun) vietnamese first name
nhường	siiyey	yield
nhưỡng	dufan	soil
nhược	daciifnimo	weak
nhượng	tanaasulid	concession
nhạ	nhạ	nha
nhạc	muusig	music
nhạn	liqid	bird
nhạo	jees jees	ridicule
nhạt	cirro leh	light
nhạy	xasaasi ah	sensitive
nhảy	dhaanto	jump
nhấc	kor u qaadid	lift
nhấm	tuugid	rodent
nhấn	riixaya	to press (v.)
nhất	ugufiican	most
nhầm	khalad	misunderstand
nhầy	caato ah	glutinous
nhẫn	fardaha	patient
nhậm	shaabadaysan	inaugurate
nhập	soo dejin	penetrate
nhậu	cabitaanka	drink
nhậy	xasaasi ah	sensitive
nhắc	isla markiiba	to remind (v.)
nhắm	ujeedada	aim
nhắn	fariinta	message
nhằm	ujeedo	for the purpose of (adv.)
nhẵn	jilicsan	smooth
nhặt	soo qaado	pickup
nhẹ	iftiin	light
nhẹn	agile	nhanh nhẹn= fast/nimble
nhị	adkeeyay	sensitive
nhịn	ka fogaansho	fasting
nhọ	nasiib darro	smear
nhọn	fiiqan	sharp (adj.)
nhỏ	yar	small
nhỏ|cây	yar | geed	small|tree
nhỏ|một	yar | mid	small | one
nhỏ|phải|	yar | xaq |	small|right
nhỏ|phải|px|	yar | xaq | px |	small | have | px |
nhỏ|phải|px|bức	yar | right | px | sawiro	grape / fade / px / buc
nhỏ|phải|px|cây	yar | midig | px | geed	px spicy grape fade
nhỏ|phải|px|khu	yar | right | px | zone	small|right|px|area
nhỏ|phải|px|michael	yar | xaq | px | michael	small|right|px|michael
nhỏ|phải|px|máy	yar | sax | px | mashiin	small | right|px|machine
nhỏ|phải|px|một	yar | midig | px | mid	small|right|px|one
nhỏ|phải|px|quân	yar | xaq | px | xoog	small|right|px|army
nhỏ|px|	yar | px |	small
nhỏ|px|các	yar | px | the	small
nhỏ|px|phải|kiến	yar | px | right | ant	small | px | right | patience
nhỏ|quân	yar | xoog	small|army
nhỏ|trái|px|máy	yar | bidix | px | mashiinka	small|left|px|plane
nhỏ|tượng	astaamo yaryar	small|statue
nhốt	quful	confine
nhồi	cufan	cram
nhổ	rujin	uproot
nhộn	qosol badan	busy
nhớ	maanka	remember
nhớt	viscous	viscid
nhờ	mahadsanid	by
nhờn	dufan	multiplication
nhở	xasuusin	remind
nhụ	qanjaruufo	nhu
nhục	ceebeeyay	shame
nhủ	xusuusin	needs
nhức	xanuun	pain
nhứt	marka hore	first (n.)
nhừ	mushy	tender
những	kuwan	the
nhựa	balaastig ah	plastic
nhựt	nutut	"like the word ""nhật""; meaning ""sun"" (n.)"
ni	ni	nun
nia	nia	a flat basket (n.)
nicaea	nicaea	nicaea
nicaragua	nicaragua	(proper noun) nicaragua
niccolò	niccolò	(proper noun) niccolo, as in writer niccolo machiavelli
nicolas	nicolas	(proper noun) nicolas, as in nicolas sarkozy
niels	niels	(proper noun) niels
nigeria	nigeria	nigeria
nikel	nikel	nickel
niken	nickel	nickel
nikita	nikita	(proper noun) nikita, a first name
nikko	nikko	(proper noun) nikko
nikolai	nikolai	nikolai
nikolayevich	nikolayevich	nikolayevich
nil	eber	nile
nile	nile	(proper noun) the river nile
nimitz	nimitz	(proper noun) nimitz, as in the ship uss nimitz
nin	sagaalaad	nin
ninh	amniga	ninh, as in bắc ninh
nintendo	nintendo	(proper noun) nintendo, the game company
nippon	nippon	nippon
nitơ	nitrogen	nitrogen (n.)
nixon	nixon	(proper noun) nixon, as in former president richard nixon
niên	sanadka	youth
niết	niet	nirvana
niềm	raaxo	trust
niệm	maskaxda	concept
niệu	diuresis	urinary
nj	nj	nj
nlf	nlf	nlf
nm	nm	nano-meters
noah	maya	(proper noun) noah
nobel	abaal marin	nobel
nobita	nobita	nobita
noel	noel	(proper noun) noel
noi	dheh	imitate
nokia	nokia	(proper noun) nokia, as in the nokia corporation
nol	nol	nol
nom	nom	look after
non	dhalinyaro ah	mountain
nonpenetrative	isqurxin la&#39;aan	nonpenetrative
norfolk	norfolk	norfolk
norge	norge	norge
norma	norma	(proper noun) norma, a female first name
norman	norman	norman
normandie	normandie	normandile
northrop	waqooyiga	northrop, as in the northrop f-5 freedom fighter
norton	waqooyi	norton
norway	norway	norway
nou	maya	nou
novak	novak	novak
now	hadda	now
nowc	nowc	nowc
noãn	ovule	ovule
nsnd	nsnd	people's artist
nst	nst	chromosome
nubia	nubia	nubia
number	tirada	number
nupedia	nupedia	a name
nusa	nusa	nusa
nuôi	quudin	feed
nuối	liqid	"(term should be ""tiếc nuối"") to regret (v.)"
nuốt	liqid	to swallow (v.)
nuớc	biyo	water
nxb	nxb	publisher
nynorsk	nyj	nynorsk
nà	nà	na
nài	ku adkeyso	pleading
nàn	ka cawday	poor
nành	soy	soy
nào	kaalay	would
này	tan	this
ná	ná	a crossbow (n.)
nách	kilkilaha	underarm (n.)
náo	rabshado	riot
nát	jabay	ruin
náu	qari	hide
nâng	kor u qaadid	raise
nâu	bunni	brown
nã	nã	to track down (v.)
não	maskaxda	brain
né	dhejis	dodge
ném	tuur	to throw (v.)
nén	isku buuqsan	compress
nét	istaroog	feature
nê	ne	ne
nên	kacaanka	should or ought to
nêu	sheeg	mention
nòi	tartan	race
nòng	gorgortan	barrel
nói	inuu hadlo	to say or speak (v.)
nón	koofiyad	cone
nóng	kulul	hot
nô	addoonsiga	slave
nôbita	tobita	nobita
nôi	sariirta	cradle
nôm	nm	ancient vietnamese script that borrowed heavily from han chinese characters
nôn	matag	vomit
nông	gacmeed	farmer
nõn	diirka	peeled
nùng	buur	nung
núm	garabka	nipple
núp	qari	hide
nút	garabka	button
năm	sanadka	year
năn	toobad keena	"(term should be ""ăn năn"") remorse (n.)"
năng	awood	"(term should be ""khả năng"") ability (n.)"
nơi	meel	a place
nơtrino	neutino	neutrino
nước	wadanka	country
nước 	wadanka	water
nướng	shiil	grill
nǎm	nǎm	year
nạ	maaskaro	mask
nạc	jilicsan	lean (adj.)
nại	cabasho	complain
nạn	cidhiidhi	a disaster (n.)
nạo	daawo daawo	to scrape (v.)
nạp	xirmay	tribute
nản	niyad jab	depressed
nảy	boodboodid	"(term should be ""nảy sinh"") to give rise to (v.)"
nấc	isqarxin	a hiccup (n.)
nấp	qari	hide
nấu	kariye	cook
nấy	tan	this
nần	nudge	debt
nầy	tan	this
nẩy	boodboodid	"(term should be ""nảy nở"") to sprout or start growing (v.)"
nẫu	n qorrax	"(""giọng nẫu"") a vietnamese accent commonly found in cities such as phú yên"
nậm	nam	"(term should be ""nậm rốm"") the name of a river in vietnam (proper noun)"
nập	kulul	busy
nắm	qaban	to grasp or hold (v.)
nắng	qoraxdu	sunlight
nắp	dabool	a lid or cover (n.)
nằm	been	to lie (v.)
nẵng	nang	"(term should be ""Đà nẵng"") a city in central vietnam"
nặc	si qarsoodi ah	heavy
nặn	tuujin	mould
nặng	culus	heavy
nẻo	mid kale	turn
nếm	dhadhan	taste
nến	shumac	candle
nếp	dhejis	sticky rice (n.)
nếu	haddii	if (adv.)
nề	dhagax dhigis	severe
nể	ixtiraam	respect
nện	jeexdin	ram
nỉ	dareemay	beg
nịnh	sasabasho	flatter
nọ	tan kale	the other
nọc	matoor	tadpole
nỏ	iskutallaabta	a crossbow (n.)
nối	ku xidhan	connection
nốt	ogeysiis	to finish off (v.)
nồi	dheri	pot
nồm	nape	humid (adj.)
nồng	kulul	heavy
nổ	waxyaabaha qarxa	explode
nổi	sabayn	nổi tiếng= famous
nỗ	isku day	affort
nỗi	taasi	state
nộ	cadho	anger
nội	gudaha	on the paternal side (adj.)
nộn	cufan	non
nộp	xareeyay	submit
nới	dabacsan	ease
nở	ubaxu	bloom
nỡ	qalbi furan	do you have a heart to
nợ	deyn	debt
nụy	bastoolad	"(term should be ""nụy nhân"") the vietnamesized han term depicting the japanese"
nứa	guf	a kind of bamboo (n.)
nứt	dillaacday	to crack
nửa	badh	haft
nữa	mar labaad	moreover
oahu	oahu	(proper noun) oahu
oai	cabsi	heroic
oakland	oakland	oakland
oan	cadaalad darro	injustice
oanh	oanh	(with word liet) glorious
obama	obama	obama
oblast	oblast	(proper noun) oblast, as in tomsk oblast
oc	oc	oc
october	october	(proper noun) october
oda	o da	oda
oder	oder	oder
odyssey	odyssey	odyssey, as in the odyssey, homer's epic
oecd	oecd	oecd
officer	sarkaal	officer
officers	saraakiisha	officers
ohkawa	ohkawa	ohkawa
okhotsk	okhotsk	okhotsk
oliver	oliver	oliver
olivier	olivier	olivier
olympus	olympus	olympus
om	geesinimo leh	to simmer
omar	omar	a name
ong	shinni	bee
ontario	ontario	ontario
oort	oort	oort
oprah	oprah	(proper noun) oprah, as in oprah winfrey
organ	xubin	organ
oricon	oricon	oricon
origin	asal ahaan	origin
orion	orion	(proper noun) orion, the hunter
orleans	orleans	(proper noun) orleans, as in new orleans
orochimaru	orochimaru	orochimaru
orton	orton	orton
os	os	os
osaka	osaka	(proper noun) osaka, a city in japan
osama	osama	(proper noun) osama, as in osama bin laden
osamu	osamu	(proper noun) osamu, a japanese first name
oscar	oscar	oscar
osiris	osiris	(proper noun) osiris, as in the egyptian god
oskar	oskar	a name
oslo	oslo	oslo
osment	osment	osment
ospf	ospf	ospf
ossetia	ossetia	(proper noun) ossetia
oswald	oswald	oswald
other	kale	other
otto	otto	(proper noun) otto, as in otto von bismarck
ottoman	ottoman	(proper noun) ottoman, as in the ottoman empire
outstanding	cajiib ah	xuat sac
owen	deyn	(proper noun) owen, as in michael owen
oxford	oxford	oxford
oxy	oksijiin	oxygen
ozawa	ozawa	(proper noun) ozawa, as in maria ozawa
oán	xanaaq	"(term should be ""oán than"") to complain or whine"
oát	watts	a watt (n.)
oản	oàn	"(term should be ""ăn oản"") gratitude and resentment (n.)"
paget	budo	(proper noun) paget
pailin	pailin	pailin
pakistan	pakistan	(proper noun) the country of pakistan
palais	palais	palais, as in grand palais
palawan	palawan	palawan
palenque	palenque	(proper noun) palenque
palestine	palestine	a name
palgrave	palgrave	palgrave
pali	pali	a name
pamir	pamir	pamir
pan	digsi	pan, as in peter pan
panama	panama	panama
panamax	panamax	(proper noun) panamax
panduranga	panduranga	(proper noun) panduranga
panthera	panthera	(proper noun) panthera, a genus of felines
panthéon	panthéon	a name
paolo	paolo	paolo
paperback	warqad waraaqeed	paperback
papua	papua	papua
paraguay	paraguay	(proper noun) paraguay
pari	dhama	pari
park	baarkin	park
parton	qayb	parton
patel	patel	(proper noun) patel
patrick	patrick	patrick
patriot	waddaniyad	patriot
paul	paul	paul
paula	paula	paula
paulo	paulo	(proper noun) paulo
pavia	pavia	pavia
pbs	pbs	pbs
pda	pda	pda
pdf	pdf	pdf
pedro	pedro	pedro
peers	facooda	peers
pele	diirka	(proper noun) pele, as in the soccer player
penang	penang	penang
penh	penh	(proper noun) penh, as in phnom penh
pennsylvania	pennsalinta	pennsylvania
penny	qalin	(proper noun) penny, an english first name
pereira	pereira	pereira
perl	perl	(proper noun) perl
pero	pero	pero
perry	dhalanteed	(proper noun) perry, as in elizabeth perry
persephone	persephone	presephone
pershing	adkeysi	pershing
persian	dhejis	persian
peru	peru	peru, as in the south american country
peters	xayawaanada	peter's, possessive of peter
petersburg	petersburg	(proper noun) petersburg, as in saint petersburg
pfm	pfm	a name
pgs	pgs	associate professor
pgđ	pgđ	associate professor
pha	isku qasan	to mix
phaethon	phaethon	phaethon
pham	pham	pham
phanh	fariin	expose
phao	sabayn	float
phaolô	bawlos	st. paul, the apostle
pharaoh	fircoon	pharaoh
pharaon	xumaha	pharaoh
phay	dhaloobid	mill
phe	koox	faction
phen	dhacdo	time
phil	phil	(proper noun) phil, a first name
philip	falal	philip
philippe	sawir	philippe
philippines	filibiin	(proper noun) philippines
phillip	phillip	(proper noun) phillip
phillips	phillips	philips
philosophiae	falsafada	(proper noun) philosophiae, as in the work philosophiae naturalis principia mathematica
phim	filim	phim
phin	filter	coffee filter
phineas	phineas	(proper noun) phineas
phiên	kalfadhiga	trial
phiêu	tacabur	adventurous
phiếm	xanta	gossip
phiến	daab	"(should be ""nha phiến"") opium"
phiện	opium	opium
phiệt	deeq	militarism
phnom	phnom	phnom
phnôm	phomom	phnôm pênh= phnom penh(cambodia's capital)
pho	pho	part of a person's name, rat-pho, or ratford
phoenix	phoenix	(proper noun) phoenix
phong	qol	movement
php	php	php
phrygian	afka hooyo	phrygian
phu	phu	"(term should be ""phu nhân"") wife (n.)"
phui	daahfuray	expose
phun	buufin	to spray or spit (v.)
phà	markab	ferry
phàm	dhinta	superhuman
phàn	cabasho	complain
phá	jabinta	destroy
phác	sawir	"(term should be ""phác thảo"") outline or sketch (n.)"
phách	garaacid	manner (n.)
phái	dariiqo	a party
phán	xukumaan	judge
pháo	cannon	artillery
pháp	faransiiska	method
phát	baahin	develop
phèn	caalim	alum
phèo	phèo	organs
phép	loo oggol yahay	permit
phê	kor u kac	"(term should be ""phê bình"") to criticize (v.)"
phêrô	butros	peter
phì	weynaaday	non-
phình	bulug	bulge
phí	dacwad	non-
phía	dhinac	side
phích	kuleylka	a flask (n.)
phím	fure	key
phò	phò	"(term should be ""phò mã"") a prince consort"
phòng	qol	office
phó	ku xigeen	second
phóng	bilaabid	to launch (v.)
phô	magaalada	display
phôi	uurjiifka	embryo
phông	font	font
phùng	puff	phung
phúc	barakeeyey	good fortune (n.)
phúclộc	duco	phuc-loc
phún	bumbo	"(term should be ""lún phún"") sparse (adj.)"
phúng	naxariis	satire
phút	daqiiqad	a minute (n.)
phăn	cadho	phan
phăng	phang	knock
phương	phuong	direction
phước	duco	luck
phường	ward	ward
phượng	phoenix	phoenix
phạn	sanskrit	sanskrit
phạt	ciqaab	punish
phả	pedigree	pedigree
phải	sax	must
phải 	sax	right
phản	miiska	reaction
phảng	fidsan	subtle
phần	qayb	part
phẩm	alaabada	food
phẩy	comma	a comma
phẫn	xanaaq	wrathful
phẫu	qalliinka	surgery
phận	qaddar	part
phật	buddha	buddhist
phẳng	diyaarad	flat (adj.)
phế	xoqid	dismiss
phết	faafitaan	to spread or smear (v.)
phỉ	hazel	defame
phỏng	gubasho	interview
phố	magaalada	city
phối	isku duwe	coordinate
phốt	fosfooras	"(term should be ""phốt-phát"") phosphate (n.)"
phồng	faafiyay	to swell (v.)
phổ	muuqaal	popular
phổi	sambabka	lung
phộng	lowska	peanut
phới	sabayn	"(term should be ""phơi phới"") mildly exciting (adj.)"
phở	maraq soodh	pho
phục	dharka	convincing
phụng	u adeeg	worship
phụt	puff	minute
phủ	daboolay	government
phức	adag	complex
picchu	picchu	a name
piccolo	pcololo	piccolo
pierre	deked	pierre
pierrot	pierrot	pierrot
pietro	pietro	pietro
pike	pike	pike
pin	baytariga	battery
pinlus	qanjaruufo	pinlus
pioneer	hormuud	pioneer
pipes	tuubooyinka	pipes
pisa	pisa	a name
piston	bastoolad	piston
pitch	garoonka	pitch
pius	pius	pius
plaaf	boog	plaaf
plan	qorshe	plan
plasma	plasma	plasma
plate	saxanka	plate
plato	plato	plato
platon	platon	platon
player	ciyaaryahan	player
pleiku	pleiku	(proper noun) pleiku
pleistocen	pleistocen	pleistocen
plus	lagu daro	plus
pluto	pluto	pluto
pm	pm	pm
pmu	pmu	pmu
po	po	po
pokémon	pokemon	pokemon
pol	pol	pol
poland	dalka poland	poland
pollack	dabool	a name
pollux	pollux	a name
polo	polo	(proper noun) polo, as in marco polo
polynésie	polynésie	polynesian
pont	barkad	(proper noun) pont, as in pont de normandie
pop	pop	pop
portland	xeebta	portland
porto	porto	porto
pot	dheri	pot
potsdam	potsdam	(proper noun) potsdam
potter	dheryasameeyaha	(proper noun) potter, as in harry potter
pour	ku shub	not vietnamese
powell	budo	(proper noun) powell, as in general colin powell
pradesh	pradesh	pradesh
praha	praha	praha
pratzen	xanaaqay	pratzen
preah	preah	(proper noun) preah
premier	premier	premier
preminger	preminger	(proper noun) preminger
preston	preston	(proper noun) preston, as in john preston
prince	amiir	prince
princeton	princeton	princeton
printemps	waraaqaha daabacaadda	printemps
printf	daabacaad	printf
prinz	prinz	(proper noun) prinz, as in birgit prinz, the female german soccer player
prix	prix	(proper noun) prix, as in the grand prix
procellarum	soo jeedin	procellarum, as in oceanus procellarum, the name of a mare on the moon
projekt	projekt	projekt
prometheus	balanqaad	(proper noun) prometheus
protein	borotiinka	protein
prôtêin	borotiin	protein (n.)
ps	ps	ps
psv	psv	psv
ptolemy	cayda	ptolemy
ptq	ptq	ptq
puerto	puerto	puerto
pulau	pulau	(proper noun) pulau, as in pulau tekong, an island
pulitzer	pulitzer	(proper noun) pulitzer, as in the pulitzer prize
pulp	saxarka	pulp
punjab	dharbaaxo	punjab
pusan	pusan	(proper noun) pusan
putin	putin	putin
pyrenees	pyrenees	pyrenees
pytago	pytago	(proper noun) pytago
pzl	pzl	pzl
péc	pec	"(term should be ""vịnh péc xích"") the persian gulf"
pérez	perez	(proper noun) perez, as in javier perez de cuellar
păng	pangal	fansipan
pơ	pơ	"(term should be ""pơ kô"") a river in vietnam (n.)"
q	q	q ( a letter)
qatar	qatar	qatar
qd	qd	quantum dots
qing	qing	qing, as in the qing dynasty of  china
qlvnch	qlvnch	army of the republic of vietnam
qua	by	transmit
quad	quad	quad
quan	quan	"(term should be ""quan hệ"") relationship (n.)"
quang	indhaha	bladder
quanh	hareeraha	around
quay	leexday	turn
que	ulaha	stick
queen	boqorad	queen
queens	boqorada	(proper noun) queens, as in the new york borough
queensland	wadanka	queensland
quen	yaqaan	accustomed to
qui	qui	formal
quincy	quincy	(proper noun) quincy, as in quincy jones
quran	quran	quran
quy	xeerarka	"(term should be ""quy ước"") agreement"
quyên	aasaasiga ah	"(term should be ""quyên góp"") to donate (v.)"
quyến	soo jiidashada	"(term should be ""gia quyến"") family"
quyền	ogolaansho	right
quyện	isku qasan	mix
quyệt	caaqil	"(should be ""xảo quyệt"") devious"
quá	sidoo kale	over
quái	hektar	strange or odd
quán	bar	hometown
quáng	indhoole	blind
quát	qayliyey	generalize
quân	quan	army (n.)
quãng	qiyaastii	optical
quét	si loosameeyo	to sweep (v.)
quê	tuulo	countryside
quên	hilmaam	forget
quý	qaali ah	love
quýt	tangerine	tangerine
quăng	tuurid	to throw (v.)
quĩ	maal	orbit
quạ	yaxaas	crow (con qua)
quạt	fan	fan
quản	xukumid	"(entire term is ""cai quản"") to manage"
quảng	dalacsiin	guangzhou
quấn	duub	wrap around
quất	kumquat	whip
quấy	walaaq	harass
quần	surwaal	pants (n.)
quầng	halo	halo
quầy	miiska	stall
quẩy	ruxid	quay
quẫn	xumaaday	necessitous
quận	degmo	county (n.)
quật	qodis	excavation
quẳng	tuurid	throw
quặc	cajiib ah	strange (adj.)
quặng	macaan	an ore (n.)
quẻ	hexagram	hexagram
quế	qorfe	cinnamon (n.)
quết	nabar	knead
quệ	sabool ah	exhausted
quỉ	ibliis	demon
quỳ	jilbaha	demon (n.)
quỳnh	quỳnh	quynh
quỵ	istaroog	stroke
quỷ	ibliis	provided
quỹ	maal	fund
qúy	rubuc	quy
r	r	r
rabindranath	rabindranath	rabindranath
race	tartan	race
rafael	rafael	rafael
rafale	rafale	(proper noun) rafale, as in dassault rafale
rai	rai	slowly intake
raleigh	kacsi	raleigh
ralph	rafph	(proper noun) ralph, as in ralph waldo emerson
ram	wan	a name
rama	rama	rama, first name of several rulers of thailand (n.)
ramadan	ramadan	(proper noun) the fasting month of ramadan
ramayana	ramayana	ramayana
rambus	rambus	rambus
ran	orday	ran
ranch	haraati	ranch
randy	orod	randy
rang	buuq	roast
rangers	ilaaliyeyaasha	rangers
ranh	soohdin	border (ranh gioi)
rao	xayeysiis	to announce
rap	rap	rap
raptor	raptor	raptor
rate	heerka	rate
rau	khudradda	vegetable
ray	raajo	rail (n.)
raya	raya	raya
raymond	raajo	raymond
rađa	radar	radar
reagan	reagan	reagan
real	dhab ah	real
reanimation	isu tanaasul	reanimation
reap	goosashada	reap
reef	reef	reef
regia	regia	regia
reichelt	hanti badan	reichelt
ren	xargaha	lace (n.)
renaissance	nooleynta	renaissance
renault	renault	renault
rené	rené	rene
reo	garaac	yell
reserve	keyd	reserve
resort	dalxiis	resort
reverse	gadaal	reverse
revolution	kacaan	revolution
rey	rey	rey, as in copa del rey
rfid	rfid	rfid
rhodes	rhodes	rhodes
rica	rica	rica
ricardo	ricardo	ricardo
ricci	ricci	ricci
richard	richard	richard
richardson	richardson	(proper noun) richardson, as in james o. richardson
richie	richie	(proper noun) richie, as in singer lionel richie
rico	rico	rico, as in puerto rico
riemann	riemann	riemann, as in bernhard riemann, a german mathematician
rimjob	rimjob	rimjob
rin	biyo raaci	rin
rising	kacaya	rising
risk	khatar	risk
ritchie	ritchie	a name
rivaldo	tartan	rivaldo
rivière	rivière	a name
rizal	rizal	rizal
riêng	gaar ahaaneed	own
riêu	riêu	crab
riết	riyo	urgently
riềng	galangal	arrowroot
ro	ro	"entire term is ""rui ro""; means ""risk"""
robert	robert	(proper noun) robert
roberto	roberto	(proper noun) roberto
roberts	khamiiska	roberts
robespierre	dhacayo	robespierre
robin	robin	a name
robinson	boob	robinson, as in michelle robinson
rockefeller	rockefeller	rockefeller, as in john d. rockefeller
roddick	roddick	(proper noun) roddick
rodríguez	rodríguez	rodriguez (n.)
roi	ul	a stick or switch used for punishment (n.)
roland	qurxan	roland
romania	romania	romania
rome	baraf	rome, as in rome, italy
romeo	romeo	(proper noun) romeo, as in romeo and juliet
rommel	rommel	rommel
ron	ron	ron
ronald	ronald	ronald, an english first name
ronaldinho	ronaldinho	ronaldinho
rong	algae	seaweed (n.)
rosen	rosen	rosen, as in nathan rosen
roth	caaro	roth
rotterdam	rotterdam	(proper noun) rotterdam
rousseau	rousseau	rousseau
router	router	cong noi
rovers	rovers	rovers
rowling	isku xigxiga	rowling
roy	roy	(proper noun) roy, a name
rpd	rpd	rpd
rtp	rtp	rpt
rudolph	rudolph	rudolph
rue	rue	rue, as in rue des vases, a street name
rulin	rulin	(proper noun) rulin
rumani	romaniga	romanian
rumiko	rumiko	rumiko, a japanese first name
rummel	rummel	rummel
run	orod	tremble
rung	gariirid	to shake or vibrate (v.)
russian	ruushka	(proper adjective) russian
russkaya	russkaya	(proper noun) russkaya avionika
ruth	ruth	(proper noun) ruth
rutherford	rutherford	rutherford
rutte	rutte	rutte
ruud	ruud	ruud
ruốc	shiir	pemmican
ruồi	duqsigu	fly
ruổi	ruoi	rong ruổi=wandering
ruộng	beerta bariiska	"(term should be ""ruộng đất"") farmland (n.)"
ruột	xiidmaha	internals
rzeczpospolita	rzeczpospolita	rzeczpospolia
rà	baadhid	finding
ràng	caddee	clear
rành	si fiican u yaqaan	exhaustive
rào	deedka	barrier
rác	qashinka	gabbage-trash
rách	jeexjeexday	tear
rái	otter	colander
rán	shiil	fried (adj.)
ráp	shirkii	to assemble (v.)
râm	xiiran	shade
râu	gadhka	beard or mustache (n.)
rã	burburka	out
rãi	cobble	"(term should be ""rộng rãi"") generous"
rãnh	xabaal	groove
räikkönen	räikkönen	raikkonen
rèm	daah	curtain
rèn	been abuur	train
ré	squeal	re
république	république	republique
rét	qabow	cold
rê	jiidid	"(term should be ""rê bóng"") to dribble the ball in soccer (v.)"
rên	dhuuqid	moan
rêu	ajada	moss
rì	qeylinaya	lush (adj.)
rìa	gees	edge
rình	basaas	to watch for
rìu	faas	ax
rít	qayladiisa	to wail (v.)
rò	daadinta	leak
ròng	shabaq	net
rót	shubista	to pour (v.)
rô	khiyaamay	diamond
rôbôt	robot	robot
rôma	baraf	roman
rông	bannaan	rising (adj.)
rõ	caddee	clear
rùa	qoolley	turtle
rùng	musiibo	horror
rút	kala bixid	withdraw
răn	amarkii	commandment
răng	ilig	roasted
rōmaji	rōmaji	romaji
rũ	khiyaamo leh	charm
rơ	baabuur	"(term should be ""rơ măm"") a minority people living in vietnam"
rơi	dhicid	fall
rơm	caws	straw
rươi	adiga	sand-worm
rước	socodsiinta	welcome
rưới	saydhis	to sprinkle (v.)
rưỡi	badh	half
rượt	eryade	pursue
rượu	khamriga	wine
rạ	farqigaas	straw
rạc	cajiib ah	discrete
rạch	kanaalka	canal
rạng	waaberiga	break
rạp	tiyaatarada	theater
rải	kala firidhsan	spread
rảnh	bilaash ah	to be free (adj.)
rất	aad	very
rầm	jamb	aggressive
rầu	murugo leh	sorrow
rẫy	beerista	full
rậm	caajis	jungle
rập	carab	"(term should be ""Ả rập"") arab"
rắc	saydhis	trouble
rắn	abeeso	snake
rằm	dayaxa buuxa	a full moon (n.)
rằng	taasi	roasted
rặng	dhagaxii	a row
rẻ	raqiis ah	cheap
rẽ	leexo	"(term should be ""chia rẽ"") to separate or divide (v.)"
rền	oohin	pealed
rể	soddog	in-law
rễ	xididdada	root (n.)
rệp	cayayaanka	bug
rệt	dhawaaqay	clearly
rệu	aye	decay
rỉ	miridhku	leak
rịavũng	rìvà	ria - bay
rỏ	caddee	clearly
rối	isqarxiyay	disorder
rốm	daruuro leh	rom
rồ	waali	"(term should be ""điên rồ"") foolish (adj.)"
rồi	durba	and
rồng	masduulaagii	dragon
rổ	dambiil	basket
rỗi	bilaash ah	savation
rỗng	bannaan	hollow
rộ	fuuq bax	profuse (adj.)
rộn	mashquul	busy
rộng	ballaaran	wide
rớt	dhicid	drop
rời	bidix	leave
rỡ	qurux badan	brilliant
rợ	bahdilaada	a savage (n.)
rợn	musiibo	scary
rụng	daadiyay	to drop
rủ	casuumad	ask
rủi	mishap	unlucky or unfortunate (n.)
rứa	rứa	rua
rừng	duur	forest
rửa	dhaq	to wash (v.)
rữa	dhaq	to decompose or rot (v.)
sa	sa	to fall or drop (v.)
sabah	sabah	sabah
sachsen	sachsen	sachsen
saddam	saddam	(proper noun) saddam, as in saddam hussein
safari	safari	safari
safin	safin	safin
sahara	sahara	sahara
sai	khalad	wrong
saigon	saigon	saigon
saintdenis	saintdenis	saint-denis
sakura	sakura	sakura
salem	salem	(proper noun) salem, as in the city
salvador	salvador	salvador
salzburg	salzburg	salzburg
samhain	samhain	samhain
samo	samo	samo, the name of the first slavic ruler
samoa	samoa	(proper noun) samoa
samphan	samof	samphan
samsung	samsung	samsung
samuel	samuel	samuel
samuelson	samuelson	(proper noun) samuelson
samurai	samurai	samurai
samut	samut	(proper noun) samut, as in samut prakan in thailand
san	san	level
sanchez	sanchez	sanchez
sang	ku	to
sango	sango	sango, a language spoken in africa
sangraal	sangraal	sangraal
sanh	dhalasho	bear
sanktpeterburg	sanktpeterburg	sankt-peterburg
santos	santos	santos, as in footballer cristiano ronaldo dos santos aveiro of portugal
sao	xiddig	how
sap	dheecaan	sap
sapa	sapa	sapa
sapiens	sapiens	sapiens
sar	sar	sar
sarah	sarah	sarah, as in sarah pierce
sarawak	sarawak	(proper noun) sarawak, a malaysian state on the island of borneo
sarcoma	sarcoma	sarcoma
sardinia	sardinia	sardinia
sary	sary	(proper noun) sary, as in ieng sary
saturanga	saturanga	saturanga
saturday	sabtiga	saturday
sau	ka dib	after (adv.)
saudi	saudi	(proper noun) saudi, as in saudi arabia
saunière	saunière	saunière
scandinavia	scandinavia	scandinavia
schafer	qoto dheer	schafer, as in john c. schafer
schengen	schengen	schengen
schiller	giijiye	schiller
schlesinger	schlesinger	schlesinger
schneider	caajis	schneider, a last name
schumacher	schumacher	schumacher, as in michael schumacher
schuschnigg	schuschnigg	(proper noun) schuschnigg, as in kurt schuschnigg of austria
schuster	schuster	schuster
schwarzschild	schwarzschild	schwarzschild
scotland	iskodland	scotland
scots	scots	(proper noun) scots
scott	scott	scott
scream	qayli	scream
scud	cabudhin	scud
scuderia	scuderia	scuderia
sdram	sdram	sdram
search	raadin	search
seattle	seattle	(proper noun) seattle, washington
secret	sirta	bi mat
sedna	sedna	(proper noun) sedna
see	arag	see
sejm	sejm	(proper noun) sejm
selena	selena	selena
semit	qayb	(proper noun) semit
sen	bakhtiyaa	lotus
sense	dareen	sense
september	sebtember	(proper noun) the month of september
serbia	serbia	serbia
sergeyevich	sergeyevich	(proper noun) sergeyevich
seri	taxanaha	series
service	adeeg	service
sesshomaru	sesshomaru	a name
seth	seth	seth
seto	seto	seto
sextus	sextus	sextus
sexy	sexy	sexy
seymour	seymour	seymour
seyssinquart	seisinin cibiya	(proper noun) seyss-inquart
shah	shah	shah
shaman	shaman	the shaman religion
shan	shan	shan
shane	xishood	(proper noun) shane, an english first name
shankly	shanqadh	(proper noun) shankly, as in bill shankly
shaolin	shaolin	shaolin, as in the shaolin temples
sharpay	fiiqan	sharpay, as in sharpay evans
shawn	ruxay	shawn
sherlock	sherlock	a name
shi	shi	shi
shia	shia	shia
shiite	shiite	shiite
shikoku	shikoku	shikoku, a japanese island (n.)
shinichi	shinichi	shinichi
shinoda	shinoda	shinoda, as in mike shinoda
shirakami	shirakami	(proper noun) shirakami
shirakawago	shirakawago	(proper noun) shirakawa-go
shiva	shiva	shiva
shoal	shoal	(proper noun) shoal
shonen	shonen	shonen
shop	dukaan	shop
short	gaaban	short
showcase	bandhig	a name
shōnen	shōnen	shonen
siberi	siberi	siberi
sicilia	sicilia	sicilia
sicily	caajisnimo ah	sicily, a city in italy
sidney	sidney	(proper noun) sidney, as in sidney nolan
siem	siem	siem
siemens	siemens	siemens
sierra	sierra	(proper noun) sierra
sikh	sikh	sikh
sikorsky	sikorsky	a name
silas	silas	silas
silesia	silesia	silesia
silic	silicon	silicon
silicat	silicate	silicate
silva	silva	(proper noun) silva, as in carlos silva
silvestris	silvestris	silvestris
simone	simone	simone
sinai	sinai	sinai, as in mount sinai
sinensis	sinensis	sinensis
sing	heesaa	sing
sinh	ku dhashay	genital
sip	kabasho	sip
sirô	sharoobada	name of a member
sistema	sistema	(proper noun) sistema
siu	siu	siu
siêu	super	super
siết	adkeyn	to cut off (v.)
sky	cirka	sky
skype	skype	skype
skyteam	skyteam	skyteam
sl	sl	sl
slav	slav	(proper noun) slav
slavơ	slav	slavic
slytherin	slytherin	(proper noun) slytherin, as in salazar slytherin of the harry potter series
sm	sm	sm
smg	smg	smg
smith	smith	smith
smithsonian	smithsonian	smithsonian
so	sidaas	compare
société	bulshada	societe
socrates	dhaqan	socrates
sohee	sohee	a korean name
soho	soho	soho
soi	soi	look/stare soi sáng=enlight
solaris	solaris	(proper noun) solaris
som	som	(proper noun) som, as in kampong som
somme	somme	somme
sonata	sonata	sonata
song	heesta	however (adv.)
sony	sony	sony
soo	soo	soon
sophie	sophie	(proper noun) sophie, a first name
sopwith	sopwith	a name
sorbonne	sorbonne	sorbonne, the university in paris (n.)
sos	sos	sos
soul	nafta	soul
soát	xakamayn	control
soạn	curiyay	compose
spears	warmo	spears
spellman	higaadle	spellman
spence	dahsoon	(proper noun) spence
spencer	spencer	(proper noun) spencer
spielberg	spielberg	(proper noun) spielberg, as in steven spielberg
sports	isboorti	sports
sri	sri	(proper noun) sri, as in sri lanka
ss	ss	ss
st	st	st.
stalingrad	stalingrad	stalingrad
stamford	stadium	this is a name
stand	istaag	stand
stanford	stanford	stanford, as in stanford university
stanley	dhagxaan	stanley
starr	xiddig	a name
startin	bilaw	bat dau
status	xaalad	status
stdc	stdc	stdc
stefan	stefan	stefan
steiermark	steiermark	steiermark
steiner	steiner	steiner
stelzer	stelzer	stelzer
stennis	stennis	stennis
stephen	gabadh	stephen
stephenie	steenie	"stephenie, as in stephenie meyer, author of ""twilight"""
sterling	dhalo	a name
steve	steve	steve
stevens	stevens	(proper noun) stevens, as in amanda stevens
stevenson	stevenson	stevenson
stevie	stevie	stevie
stewarthannah	stewarthannah	stewart/hannah
stf	stf	stf
stimson	kiciye	stimson, as in henry lewis stimson, former secretary of war
stockholm	stockholm	a name
stones	dhagxaanta	stones
storting	xaraashka	storting
strasberg	strasberg	strasberg
strauss	xargaha	strauss
street	wadada	street
struct	qaab	struct
stt	stt	order number
stuart	stuart	stuart
stuttgart	stuttgart	(proper noun) stuttgart, a city in germany
styx	styx	(proper noun) styx, as in the river styx
stéfano	stéfano	stefano
su	su	condom
subakhi	subakhi	subakhi
suez	suez	(proper noun) suez
suharto	suharto	suharto
sukarno	sukarno	(proper noun) sukarno,  president of indonesia
sulfua	baaruud	sulfide
sulu	sulu	sulu
sum	isugeyn	reunite
sumatera	sumatera	sumatera
sumatra	sumatra	(proper noun) the island of sumatra
sumitomo	sumitomo	sumitomo
summer	xagaaga	summer
summerslam	summerslam	(proper noun) summerslam
sun	qorrax	sun
sunday	sunday	(proper noun) sunday
sung	berde	supplement
sunni	sunni	sunni
sunsilk	sunsilk	sunsilk, a hair products company
super	super	super
suriname	suriname	suriname
susan	susan	(proper noun) susan
susilo	susilo	(proper noun) susilo
sutra	sutra	sutra
suub	suub	a name
suvp	suvp	suv-p
suy	fashil	decrease
suê	sidaas	lush
suôn	si habsami leh	smooth
suất	wax soo saar	number
suối	kululaynta	stream
suốt	dhan	through/all over
suồng	jilicsan	overfamiliar
svd	svd	svd
swan	swan	swan
swaziland	swaziland	swaziland
sweet	macaan	sweet
sy	s	sy
sydney	sydney	(proper noun) sydney, a city in australia
symantec	symantec	symantec
sync	isku xir	sync
syria	shareecada	syria
sài	sai	"(term should be ""sơ sài"") something done without care (adv.)"
sàn	dabaqa	san
sàng	go&#39;doomin	ready
sành	terracotta	"(term should be ""sành sứ"") pottery"
sào	cirif	"(term should be ""sào huyệt"") den or hideout (n.)"
sá	sipunculus	road
sách	buugga	list
sái	khalad	sai
sám	toobad keena	penitent
sáng	dhalaalaya	light
sánh	isbarbar dhig	compare
sáo	duulaan	flute
sáp	wax	merger
sát	xir	"(term should be ""quan sát"") to watch or observe (v.)"
sáu	lix	six
sâm	ginseng	sam
sân	yard	"(should be ""sân khấu"") a stage"
sâu	qoto dheer	deep
sã	hala	flippant
sãi	khalad	pagoda warden
são	são	sao, as in sao paolo, brazil
sét	nalka	clay
sê	se	sepon
sêri	taxanaha	series
sêu	ajada	seu tet
sính	arday	betrothal gifts
síp	qubrus	cyprus
sít	adkeyn	close
sò	clam	oyster
sòng	khamaarka	casino
sóc	dabayl	"(should be ""sóc trăng"") a vietnamese town"
sói	yeey	wolf
sóng	mowjad	wave
sót	halista	to miss (v.)
sô	tirada	than
sôi	karkaraya	vibrant
sông	wabiga	river
sùng	cibaadada	cult
sú	shabeel madow	a type of mangrove (n.)
súc	lo &#39;	animal
sún	waaskada	sun
súng	qoryaha	gun
súp	maraq	source
sút	toogasho	reduce
săn	ugaarsi	to hunt
sơn	rinjiga	a mountain
sư	aqoonyahan	lion
sưa	caano	filled with
sưng	barar	swell
sưu	ururinta	collection
sương	dharab	dew (n.)
sướng	faraxsan	high
sườn	dhinac	slope
sưởi	kululaynta	heat
sạch	nadiif ah	clean
sạn	hudheel	hotel
sảm	dhalaalaya	sam
sản	wax soo saar	reproductive
sảng	cusub	sonorous
sảnh	hoolka	a hall, as in the rock and roll hall of fame
sấm	onkod	ginseng
sấu	yaxaas	crocodile
sấy	qalajinta	dry
sầm	dharbaaxo	crowded
sầu	melancholy	sad
sẩn	papules	coarseness
sẫm	mugdi ah	dark
sập	dumin	destroy
sắm	dukaamaysiga	shopping
sắn	kaabsal	cassava (n.)
sắp	ku dhawaad	soon
sắt	birta	"(term should be ""sắt son"") constant (adj.)"
sẵn	la heli karo	available
sẹo	nabar	scar
sẻ	doonaan	share
sẽ	doonaa	will
sọ	qalfoofka	brain
sọc	xargaha	stripe
sỏ	safaarad	oligarchy
sỏi	jug	gravel
số	tirada	"(term should be ""số lượng"") quantity (n.)"
sốc	naxdin leh	shock
sống	nool	live
sốt	qandho	fever
sồi	oak	oak
sổ	buugga	window
sớ	doonaa	document
sớm	goor dhaw	som
sờ	taabasho	touch
sỡ	seegay	colorful
sợ	cabsi	afraid
sợi	yarns	fibers
sục	jacuzzi	"(term should be ""sôi sục"") to boil"
sụn	carjawda	cartilage
sụp	dumin	collapse
sụt	gogosha	drop
sủa	jilif	bright
sủi	firfircoonaanta	sparkling
sủng	sixiroole	favored
sứ	dhoobada	embassy
sứa	jellyfish	jellyfish (n.)
sức	xoog	strength
sứt	jajabay	cleft
sừng	gees	sừng sững= huge
sử	taariikhda	"(term should be ""sử dụng"") to use (v.)"
sửa	hagaajin	repair
sửng	naxdin leh	startling
sửu	ox	cow
sữa	caano	milk
sự	ah	situation
ta	ta	us or our
tae	tae	(proper noun) tae
tag	sumad	tag
tai	dhegta	ear
taiji	taiji	(proper noun) taiji
taipei	taipei	taipei
taiwan	taiwan	taiwan
taj	taj	taj, as in taj mahal
tajikistan	tajikistan	tajikistan
tajima	tajima	tajima
tajiri	tajiri	tajiri
takahashi	takahashi	(proper noun) takahashi
taklamakan	taklamakan	taklamakan
tali	tali	thallium
taliban	taliban	taliban
talmud	talmud	talmud
tam	tam	three (n.)
tamoxifen	tamoxifen	tamoxifen
tanaka	tanaka	tanaka
tang	baroorta	funeral
tanh	kalluun	deserted
tankōbon	taangiga	tankobon, as in a type of japanese literature
tanzania	tanzania	tanzania
tao	aniga	(proper noun) tao, a chinese name
tarim	jajab	tarim
task	hawl	task
tasman	tasman	tasman, as in abel tasman
tasmania	tasmania	tasmania, a place
tau	tau	tau
taxi	tagsi	taxi
tay	gacanta	hand
taylor	taylor	taylor
tbt	tbt	tbt
tchad	tchad	tchad
tcm	tcm	tcm
tcp	tcp	tcp
technical	farsamo	technical
ted	ted	(proper noun) ted
teddy	teddy	teddy, as in teddy lupin, a character in the harry potter series
telecom	isgaarsiinta	telecom
telekom	telekom	telekom
telex	telex	telex
telnet	telnet	telnet
tem	shaabad	stamp
temple	macbudka	temple
temujin	temujin	temujin
temur	temur	(proper noun) temur, as in temur oljeitu
tenxơ	kartoon	tensor
teo	atrophic	atrophy
terengganu	terengganu	(proper noun) terengganu
territories	xuduudaha	territories
terry	terry	terry
terumbu	terumbu	(proper noun) terumbu
tet	tet	tet
texas	texas	(proper noun) the state of texas
tgv	tgv	tgv
tha	cudur daar	to forgive (v.)
thai	uur leh	pregnant
thailand	thailand	thailand
tham	hunguri	involved
thames	thames	thames
than	dhuxusha	coal
thang	jaranjarada	ladder
thanh	bar	youth
thani	ka badan	thani
thao	isboorti	sport
thau	naxaas	a basin (n.)
thay	halkii	change
thcn	thcn	vocational school
thcs	thc	secondary
thdq	thdq	thdq
thebes	thebes	thebes
their	iyaga	their
them	iyaga	plus
then	markaa	key
theo	sida uu sheegayo	according to
theory	aragti	thẻoy
theravada	theravada	theravada
theres	feeraha	there
theseus	kuwan	theseus, the greek hero
thi	imtixaan	competition (n.)
thich	jecel	explanation
thien	soddon	sky
third	saddexaad	thỉd
thiu	xarrago leh	buồn thiu= sad/boring
thiêm	thiêm	thiem
thiêng	muqadas ah	"(term should be ""thiêng liêng"") sacred or holy"
thiếc	tin	tin
thiến	neuter	castrate
thiếp	kaarka	concubine
thiết	dhigay	"(term should be ""cần thiết"") necessary (adj.)"
thiếu	gaaban	lack
thiềm	jiran	crescent
thiền	ka fiirsasho	buddhist (adj.)
thiển	show	superficial
thiểu	yar	minimum
thiện	wanaagsan	good
thiệp	kaarka	intervene
thiệt	runtii	damage
thiệu	hordhac	"(term should be ""giới thiệu"") to introduce (v.)"
tho	tho	tho
thoa	dab	combination
thoai	thoai	gentle
thomas	thomas	thomas
thompson	thompson	thompson
thong	thong	(proper noun) thong, as in ang thong
those	kuwa	those
thoái	kacsan	deterioration
thoán	qiyaase	usurpation
thoáng	hawo badan	"(term should be ""thoáng qua"") to pass quickly"
thoát	bixitaan	drainage
thoại	taleefanka	telephone
thoạt	jaleecada hore	just (adv.)
thoả	heshiis	compromise
thoải	raaxo leh	"(term should be ""thoải mái"") comfortable or relaxing (adj.)"
thoảng	mar mar	"(term should be ""thỉnh thoảng"") occasionally (adv.)"
thoắt	isla markiiba	suddenly
thpt	thpt	high school
thriller	sarre	thriller
thskts	xabad	phd- architect
thua	lumiso	defeat
thumb|các	suulka | the	thumb|many
thunderbolt	onkod	thunderbolt
thung	dooxada	valley
thuyên	barakac	a name
thuyết	aragti	theory
thuyền	doon	boat
thuê	si loo kireeyo	employ
thuần	saafi ah	"(term should be ""đơn thuần"") pure (adj.)"
thuẫn	isku dhac	support
thuận	barwaaqo	favourable
thuật	farshaxanka	term
thuế	cashuurta	tax
thuốc	daawo	medicine (n.)
thuộc	iska leh	belong
thuớc	biyo	"(term should be ""kích thước"") dimensions of an object"
thuờng	sida caadiga ah	usually
thuở	caruurnimada	period
thuỵ	thuy	"(term should be ""thụy Điển"") the nation of sweden (proper noun)"
thuỷ	thuy	water
thvn	thvn	vietnam television
thy	kaaga	thy
thà	jeclaan lahaa	honest
thành	fort	"(term should be ""hình thành"") to take shape"
thày	macallin	teacher
thác	cascade	harvest
thách	loolan	challenge
thái	thai	attitude
thám	dambi baadhe	to spy (v.)
tháng	bishii	month (n.)
thánh	st	a holy person; a saint (n.)
tháo	ka saar	"(term should be ""tháo chạy"") to run with abandon"
tháp	munaarad	tower
thâm	qoto dheer	penetrate
thâu	duuban	to collect (v.)
thây	arag	body
thãi	shit	superabundant
thèm	damac	desire
thép	birta	steel
thét	qayliyay	shout
thê	ah	category
thêm	inbadan	more
thêu	kirada	to embroider (v.)
thìa	qaaddo	spoon
thìn	markaa	(proper noun) thìn, the year of the dragon
thình	si lama filaan ah	"(term should be ""thình lình"") suddenly"
thí	tijaabooyin	(with word du) for example
thít	caato	(proper noun) mân thít, a district in vietnam
thò	jeexay	tho
thòi	khasaare	"(term should be ""thiệt thòi"") to cost (adv.)"
thóc	paddy	grain (n.)
thói	caado	a habit (n.)
thô	qallafsan	rough, old-fashioned
thôi	kaalay	only
thông	lagu wargaliyay	"(term should be ""thông thường"") usual (adj.)"
thù	buuq	"entire term should be ""ke thu""; means ""enemy"""
thùng	qashinka	barrel
thùy	lobe	thuy
thú	xiiso leh	"(should be ""thích thú"") pleasurable"
thúc	dhamaadka	push
thúy	thuy	thuy
thăm	booqasho	visit
thăng	dallacsiiyay	helicopter
thơm	udgoon	aromatic
thư	xuruuf	"(term should be ""ung thư"") cancer (n.)"
thưa	gacaliye	sparse
thương	jacayl	love
thước	taliye	ruler
thường	badanaa	usually (adv.)
thưởng	abaalmarin	to reward (v.)
thược	thud	(proper noun) thược
thượng	sare	upper
thạc	sayid	master
thạch	jelly	rock or stone (n.)
thạnh	ka badan	thanh
thạo	khabiir	fluent
thả	daadasho	"(term should be ""thả lỏng"") to let loose (v.)"
thải	qashin	waste
thảm	rooga	carpet or rug (n.)
thản	xasilloon	calmly
thảo	qurux badan	"(term should be ""hội thảo"") a workshop (n.)"
thấp	gaaban	low (adj.)
thấu	xubinta taranka	penetrate
thầm	aamusnaan	"(term should be ""thì thầm"") to whisper (v.)"
thần	ilaahow	"entire term should be ""tinh than""; means ""of the mind"""
thầy	macallin	teacher (n.)
thẩm	garsoorayaasha	osmotic/leak
thẫm	mugdi ah	dark
thận	kelyaha	careful
thập	iskutallaabta	tens
thật	dhab ah	true (adj.)
thắm	petal	tham
thắn	si daacad ah	frank
thắng	guuleystay	win
thắngthua	guuleysta	win-lose
thắp	iftiin	light
thắt	isku xir	tense
thằn	libaax	"entire term should be ""than lan""; means ""lizard"""
thằng	guy	a derogatory term for a man (n.)
thẳm	qoto dheer	"(term should be ""thăm thẳm"") extremely deep (adj.)"
thẳng	toosan	horizontal
thặng	dheeri ah	surplus
thẹn	xishood	shameful
thẻ	kaarka	card
thế	marka	"with word ""tu,"" means ""posture"" or ""a position"""
thếp	birta	steel
thề	dhaar	swear
thềm	shelf	shelf
thể	noqon	maybe
thỉnh	casuumad	"(term should be ""thỉnh thoảng"") occasionally"
thịnh	cod bixin	prosperous
thịt	hilib	meat (n.)
thọ	cimri dheer	phu tho
thọc	jab	jab
thỏ	bakayle	rabbit
thỏa	heshiis	"(term should be ""thoả thuận"") to come to an agreement (v.)"
thỏi	dhalid	a bar (n.)
thối	qurmay	smelly
thốt	ku hadlay	scream
thồ	xirmo	to transport via horse (v.)
thổ	dhulka	"(term should be ""lãnh thổ"") territory (n.)"
thổi	afuufid	blow
thớt	guddiga goynta	sparse
thời	waqti	period
thở	neef	breathe
thợ	shaqaale	craftman
thụ	soo dhoweeye	"(term should be ""thụ thai"") to become pregnant"
thục	shu	(proper noun) a vietnamese first name
thụt	ku saleysan	clyster
thủ	raiisel wasaare	masturbate
thủa	thua	during childhood
thủng	daloolin	having holes
thứ	waxyaabaha	no.
thức	soo jeed	way
thừa	dib u dhigid	redundant
thừng	xarig	"(term should be ""thẳng thừng"") mercilessly"
thử	in la isku dayo	try
thửa	buqshad	square
thự	villa	mansion
thực	dhab ah	perform
ti	ti	titov
tia	raajo	ray
tiananmen	tiananmen	tiananmen
tiara	tiara	tiara
tibet	tibet	(proper noun) tibet
tigris	tigris	tigris
tiliaceus	tiliaceus	hoa dam but
tim	wadnaha	heart
timor	timir	timor
timothy	timothy	timothy
tin	aamin	believe
tinbắc	farriin	file bac
tincầu	buundada tin	file bridge
tinh	meeraha	"(term should be ""tinh dịch"") sperm (n.)"
tinnhà	tinhome	folder: house
tinsông	news	file river
tinthị	tinth karo	file: town
tirol	tirol	tirol
tisdale	tisdale	tisdale
tish	jeexdin	(proper noun) tish
tissa	tissa	(proper noun) tissa, as in moggaliputta tissa
tivi	telefishan	television
tizard	tijir	(proper noun) tizard
tiên	marka hore	first
tiêu	basbaas	"entire term should be ""tieu chuan""; means ""a requirement"""
tiếc	qoomameyn	"(term should be ""tiếc thương"") to pity (v.)"
tiếm	goofy	seize
tiến	kor	operate
tiếng	af	language
tiết	sirta	abstinence/intensity
tiếu	goofy	"(should be ""đàm tiếu"") to sneer"
tiềm	suurtagal	potential
tiền	lacag	money (n.)
tiều	shit	(proper noun) the name of a poet
tiểu	isir	tiểu sử= biography
tiễu	mudane liu	patrol
tiệc	iid	party
tiệm	dukaan	shop
tiện	ku habboon	mean
tiệp	czech	gustav franck
tiệt	fucking	sterilize
tncs	tncs	communist youth union
tngt	tngt	traffic accidents
tnhh	xaddidan	limited
toang	toang	fast
tobago	tobago	tobago
toei	toei	toei
tokugawa	tokugawa	tokugawa
tokyo	tokyo	tokyo, the capital of japan
tokyopop	tokyopop	tokyopop
tomas	tomas	(proper noun) tomas
tommy	tommy	tommy
tomoyo	tomoyo	tomoyo
tony	toy	tony
toonami	toonami	(proper noun) toonami
top	kor	top
torino	torino	torino, as in the italian city
toriyama	toriyama	(proper noun) toriyama
tottenham	t tottenham	tottenham
tourism	dalxiiska	tourism
tourist	dalxiis	tourist
toyama	toyama	toyama
toyota	toyota	(proper noun) toyota
toà	maxkamada	office
toàn	aamin ah	entire or whole (adj.)
toán	xisaabta	team
toát	wanaagsan	to exude or emit, as in sweat (v.)
toạ	isku duwayaasha	locate
toại	at	satisfaction
toả	iftiin	spread
tp	tp	city
tphcm	tphcm	ho chi minh city
tphồ	magaalada	city ho
tpvĩnh	magaalada	vinh city
tqlc	tqlc	marine
trafalgar	trafalgar	(proper noun) trafalgar
trafford	tahriibka	trafford in greater manchester
trai	xameer	boy
trang	bog	a page (n.)
tranh	sawirro	to compete (v.)
trao	dhiibtay	reward
trau	trau	polish
tre	bamboo	bamboo (n.)
treo	sudhan	hang
tri	tri	tri
tribune	tribune	a name
trinh	bikro	"(should be ""trinh bạch"") virtuous"
trinidad	trinidad	trinidad
trinity	midnimada	trinity
tristan	tristan	tristan
triết	falsafada	philosophy
triền	trien	"(should be ""triền miên"") endless"
triều	taayirid	court
triện	shaabad	stamp
triệt	si buuxda	completely
triệu	milyan	a million
tro	dambaska	ashes
troia	troia	troy
trondheim	trondheim	trondheim
trong	gudaha	inside (adv.)
true	run	true
truman	truman	(proper noun) truman
trung	dhexe	"(term should be ""trung gian"") agent (n.)"
trungnhật	daacadnimo	china-japan
truong	xamuul	truong
truyên	truyen	story
truyện	sheeko	story
truân	truân	arduous
truất	khaa&#39;imiin	cancel
truởng	madax	leader (n.)
truỵ	been	depraved
trà	shaah	tea (n.)
tràm	cajuput	melaleuca
tràng	xiidanka	"entire term should be ""truc trang""; means ""rectum"""
trào	qarxis	movement
trác	trac	trac
trách	eedayn	blame
trái	bidix	against
trán	wejiga hore	forehead
tráng	dahaarka leh	to coat (v.)
tránh	iska ilaali	to avoid (v.)
tráo	si been abuur ah	tráo trở= liar/betrayal/treacherous
tráp	sanduuq	casket
trát	amar maxkamadeed	pile
trâm	xaashi	a type of elegant hairpin (n.)
trân	salaan wanaagsan	respect
trâu	digaag	a last name
trãi	kala firidhsan	trai
trèo	fuulid	climb
trên	dul	above
trình	gudbi	process
trí	maanka	intellectual
trích	sixi	to extract (v.)
trò	khiyaamo	role
tròn	wareega	rounding
trói	xidhxidhan	tie
trôi	qulqulaya	afloat
trông	muuqaal	look
trùm	madax	cover
trùng	isku beegan	"(should be ""tinh trùng"") sperm"
trùy	calool	something to with monk
trú	fuushan	residence
trúc	bamboo	structure
trăm	boqol	hundred
trăn	bayaan	"(term should be ""trăn trở"") to ponder (v.)"
trăng	dayaxa	moon
trĩ	babaasiirta	hemorrhoids
trũng	sunay	medium
trơ	inert	bare
trơn	dabacsan	slippery (adj.)
trư	tru	a pig (n.)
trưa	duhurkii	noon (n.)
trưng	weydiisasho	symbolic
trưngcông	muujiyey	truongcong
trương	truong	policy
trước	kahor	front
trước 	kahor	front
trướng	fidinta	expand
trườn	gurguurto	crawl
trường	dugsiga	case
trượng	caduceus	a unit of length used in vietnam equal to 4 meters (n.)
trượt	si loo riixo	slide
trạch	tareenka	ze
trại	xero	camp
trạm	saldhigga	station
trạng	xaalad	situation
trạo	tao	trao
trả	bixin	to return
trải	dabool	spread
trảm	cajuput	beheaded
trảo	dhegaha	trao
trấn	magaalada	town
trấu	bariis cad	rice skin
trầm	qoto dheer	depression
trần	qaawan	tran
trầu	khiyaamo	trầu
trầy	xoqmay	scratch
trẩy	boodboodid	pilgrimage
trẫm	aniga	i
trận	ciyaarta	battle
trật	kala daadgureeyay	order
trắc	cilmiga noolaha	"(term should be ""trắc ẩn"") to have pity (adj.)"
trắng	cad	white
trặc	isqarxin	"entire phrase is ""truc trac""; means ""problem"""
trẻ	dhalinyaro ah	youth
trễ	soo daahay	late
trệ	joogsan	bamboo
trị	daaweynta	cure
trịnh	zigzag	trịnh, a vietnamese last name
trọ	hudheel	motel
trọn	buuxa	whole
trọng	muhiim ah	serious
trỏ	tilmaamayaasha	index
trối	ugu dambeeya	last words
trốn	qari	to hide
trống	madhan	in
trồi	soo baxaya	to emerge (v.)
trồng	koraan	plant
trổ	show	to burst open or display
trỗi	soo bixid	rise
trội	xukumaa	better
trộm	tuug	theft
trớn	xanaaq	"(term should be ""mơn trớn"") to fondle or caress (v.)"
trời	ilaahow	sun
trợ	taageero	support
trụ	xafiiska	universe
trục	dhidibka	"(term should be ""khu trục"") fighter, in reference to planes (adj.)"
trụi	qaawan	"(term should be ""trơ trụi"") bare (adj.)"
trứ	tru	famous
trứng	ukun	egg
trừ	laga jaro	except
trừng	dhalaalaya	punish
trừu	adhiga	abstract
trữ	kaydinta	reserve
trực	shaqada	direct
ts	ts	phd
tt	tt	news
tua	gogol dhaaf	fringe
tucker	tuker	tucker, an english last name
tudor	tudor	(proper noun) tudor, as in the tudor family
tukhachevsky	tukhachevsky	(proper noun) tukhachevsky
tulip	tulip	tulip
tum	tum	tum
tung	tuurid	release
tupolev	tupolev	tupolev, as in alexei tupolev
tuscan	tuscan	(proper noun) tuscan
tutsi	tutsi	(proper noun) tutsi
tuvalu	tuvalu	(proper noun) tuvalu, a polynesian island nation
tuy	si kastaba ha noqotee	however
tuyên	caddee	"(should be ""tuyên ngôn"") a declaration"
tuyết	baraf	snow (n.)
tuyền	tuyen	tuyen
tuyển	qorista	recruit
tuyệt	weyn	excellent (adj.)
tuân	addeec	comply
tuông	daadasho	jealous
tuý	tuyý	drug
tuần	toddobaad	week
tuế	yar-yar	years
tuệ	xikmad	intelligence
tuốc	jiidista	turbine
tuổi	sano jir	age
tuộc	octopus	octopus
tuột	iska dhig	slip
tuỳ	ikhtiyaari ah	depend
tv	telefishan	tv
tvb	tvb	tvb
twin	mataano	twin
twitter	twitter	twitter
ty	ty	company
type	nooca	type
typhon	tufaax	typhon
tà	shar	we
tài	nasiib	talent (n.)
tàn	dambas	dying
tàng	madxafka	"(should be ""bảo tàng"") a museum"
tành	tanh	shatter
tàu	markab	ship
tá	tobaneeyo	"(term should be ""thiếu tá"") major (n.)"
tách	koob	to separate
tái	re	return
tám	sideed	eight
tán	daarad	support
tánh	tanh	life
táp	tuubada	to lap at (v.)
táu	dambiil	ashton
tâm	xarunta	tâm
tâu	eebahay	peach
tây	galbeed	western
tâynam	galbeedka	"(should be ""tây-nam"") southwest"
tã	xafaayadda	diaper
tét	xoqid	tet
tê	kabuubyo	numb
tên	magaca	name (n.)
tì	caajisnimo	to lean on (v.)
tìm	soo hel	find
tìmdiệt	raadin	find-kill
tình	jacayl	sex
tía	guduud	dad
tích	sheyga	"(term should be ""tích cực"") to be zealous (adv.)"
tím	fudud	purple
tín	dhibcaha	"(entire term should be ""tín dụng"") credit"
tít	cinwaanka	"(term should be ""tít mù"") very far away (adv.)"
tò	cajiib	curious
tòa	maxkamada	a court
tòi	alaab	"(term should be ""tìm tòi"") to search doggedly for something (v.)"
tòng	tong	tòng, a last name
tóm	compendium	summary
tô	baaquli	car
tôi	aniga	i
tôm	shiir	shrimp
tôn	xoqan	venerate
tông	kartoon	tông, as in lê thánh tông; first name of an ancient vietnamese emperor
tù	xabsi	prison
tùng	habeyn	tung
tùy	ikhtiyaari ah	depend on
túc	isku filnaansho	"(term should be ""bổ túc"") to give a refresher course (v.)"
túi	boorsada gacanta	pocket
túm	qabasho	catch
túng	naxdin leh	confuse
túp	aqal	hut
túy	daroogada	"(term should be ""thuần túy"") pure (adj.)"
tý	qiime	mouse, as in year of the mouse
tăm	cadayga ilkaha	"(term should be ""tiếng tăm"") reputation"
tăng	kordhiyo	increase
tĩnh	taagan	calm
tơi	aniga	ragged
tư	ka	posture
tưng	rux	"(term should be ""tưng bừng"") joyously (adv.)"
tươi	cusub	fresh
tương	la mid ah	"(term should be ""tương tự"") to be similar to"
tước	xarig	title (n.)
tưới	waraabinta	irrigation
tướng	guud	prime minister (thu tuong)
tường	darbiga	"a common vietnamese first name; means ""wall"""
tạ	miiq	weight
tạc	farshaxan	"(term should be ""oanh tạc"") to bomb from the air (v.)"
tại	gudaha	survival
tạm	ku meelgaar ah	temporary
tạo	abuuraan	create
tạp	joornaal	"(should be ""hỗn tạp"") a jumble or mish-mash"
tả	sharraxaad	describe
tản	kala go &#39;	disperse
tảng	madal	platform
tấc	inji	inch
tấm	taarikada	mirror
tấn	tan	tan
tấp	jiiday	crowded
tất	sharaabaad	all
tấu	qalab	tau
tầm	ciyaaraha	range or extent (n.)
tần	inta jeer	"(term should be ""tần số"") frequency (n.)"
tầng	dabaqa	layer
tầu	tareen	ship
tẩm	uurjiifka	soak
tẩy	tirtirid	to bleach
tận	dhamaadka	dedicated
tật	itaal darrida	disease
tắc	beddelaya	priciple
tắm	qubeys	bathing
tắt	dami	initial
tặc	haakariska	"(term should be ""hải tặc"") a pirate (n.)"
tặng	tabaruc	donate
tẻ	drab	lẻ tẻ= scattered
tết	taag	(proper noun) the vietnamese new year
tếxã	dhaqaale ahaan	economy - society
tề	qi	tidy
tể	mister	lord
tệ	xun	bad
tệp	feyl	file
tỉa	jar	"(term should be ""bắn tỉa"") to snipe"
tỉnh	gobolka	province
tị	masayr	refugee
tịch	madaxweynaha	"(""chủ tịch"") president or chairman"
tọa	isku duwayaasha	"(term should be ""chủ toạ"") chairman (n.)"
tỏ	muujiyey	to
tỏa	iftiin	radiate
tỏi	toon	garlic
tốc	xawaare	speed
tốn	qiimaha	to cost (v.)
tống	wehel	dispose
tốp	koox	top
tốt	wanaagsan	good
tồi	xun	bad
tồn	jiraan	exist
tổn	dhaawacan	damage
tổng	wadarta	president
tộc	qabiil	"(term should be ""dân tộc"") a race or people"
tội	dembiga	crime
tột	xad dhaaf ah	extreme
tớ	aniga	servant
tới	ku xiga	to the point
tờ	xaashi	paper/document
tởm	karaahiyo ah	disgusting
tục	nijaas ah	"(term should be ""tập tục"") customs or practices"
tụy	beeryarada	"(term should be ""tận tụy"") devoted (adj.)"
tủ	armaajo	shelf
tủi	xun	humiliated
tủy	dhuuxa	spine
tức	isla markiiba	i.e.
từ	ka	from
từng	waligaa	each
tử	geeri	lion (su tu)
tửu	u dulqaadashada khamriga	wine
tự	naftaada	"(term should be ""tương tự"") like or similar to (adv.)"
tựa	cinwaanka	lean
tựu	guulaha	achievement
tỵ	masaska	the han name for the year of the snake, according to the chinese zodiac
tỷ	bilyan	billion
u	aad	tumor
ua	haa	ua
uae	uae	uae
ubuntu	ubuntu	ubuntu
uc	uc	uc
uchiha	uchiha	uchiha
uefa	uefa	uefa
uh	haye	uh
uk	uk	uk
ukiyoe	ukiyoe	ukiyoe
ukraina	ukraina	ukraine
ulsan	ulsan	ulsan
umm	um	umm
un	un	(proper noun) un, as in chung un chan of korea
und	iyo	und
under	ka hooseeya	under
unesco	unesco	unesco
ung	qurmay	cancer
unicorn	unicorn	unicorn
unit	cutub	unit
unix	halbeeg	unix
up	kor	up
ural	afka	ural, as in the ural mountains
urani	uranium	uranium
uri	uri	uri, a former political party in south korea
uruguay	urruce	uruguay
usagi	usagi	usagi
usb	usb	usb
uss	noo	uss
utah	utah	utah
utrecht	utrecht	(proper noun) utrecht
uy	uy	"(term should be ""uy lực"") power (n.)"
uyghur	uyghur	(proper noun) uyghur
uygur	uygur	uygur
uyên	uyen	scholarly
uyển	xumaha	"(term should be ""uyển chuyển"") flexible (adj.)"
uzbekistan	uzbekistan	uzbekistan
uông	uong	uong
uất	uất	busy
uốn	curling	to curl (v.)
uống	in la cabbo	to drink
uổng	lumin	vain
v	v	v
va	va	collide
vaccine	tallaal	vaccine
vai	garabka	shoulder
valencia	valencia	valencia
valentine	jacayl	valentine
valley	dooxada	valley
van	waalka	"(term should be ""van xin"") to beg (v.)"
vanessa	vanessa	vanessa
vargas	vargas	(proper noun) vargas
vasari	vasari	vasari
vay	deynsato	borrow
vectơ	vector	vector
ven	weheliya	"(term should be ""ven biển"") coastal (adj.)"
vendôme	iibôme	vendome
venezia	venezia	venice
venus	venus	venus
verdun	verdun	verdun
vermont	vermont	vermont
verona	verona	(proper noun) the city of verona
versailles	weheliya	(proper noun) versailles
vhs	vhs	vhs
vi	sababta oo ah	behavior
viagra	viagra	viagra
victor	guuleyste	(proper noun) victor
victoria	guul	victoria, a province of australia
vienna	vienna	(proper noun) vienna, austria
viet	viet	vietnamese
vietnam	vietnam	vietnam
viettel	viettel	viettel
viii	viii	eighth
vijaya	vijaya	(proper noun) vijaya
viking	viking	viking
villa	villa	villa
villeneuve	villeneuve	(proper noun) villeneuve, a french last name
vinagame	vinagame	vinagame
vinashin	vinashin	vinashin
vince	mansab	(proper noun) vince, as in vince mcmahon
vincennes	vincennes	vincennes
vincent	vincent	vincent
vinpearl	vinpearl	vinepeal
viqr	viqr	viqr
virginia	bikro	(proper noun) virginia, as in the state
virus	fayruus	virus
virút	fayruus	virus
vissarionovich	vissarionovich	vissarionovich
vista	fiisooyinka	vista, as in windows vista
vitamin	fitamiin	vitamin
vitruvius	vitruvius	vitruvius
viz	viz	(proper noun) viz
viêm	caabuq	inflammation
viên	kiniiniyada	member
viêng	viang	vientiane
viêt	qoraal	vietnam
viếng	booqasho	visit
viết	qor	write
việc	shaqo	thing
viện	machadka	institute
việt	fiyatnaam	viet
việtmường	fiyatnaamiis muong	muong
việtnga	vietnga	vietnam-russia
việttrung	viettrung	vietnam-china
vn	vn	vietnam
vnexpress	vnexpress	(proper noun) vnexpress
vni	vni	vni
vo	vo	"(term should be ""tròn vo"") perfectly round (adj.)"
voi	maroodiyaal	elephant
voip	voip	voip
voldemort	voldemort	(proper noun) voldemort, the villain from the harry potter series
von	von	compare
vonfram	tungsten	wolfram
vong	khasaare	injured
voyager	socdaal	voyager
voọc	afafka	a langur (n.)
vtc	vtc	vtc
vu	vu	"entire phrase is ""vu cao""; means ""to accuse wrongly"""
vua	boqorka	king
vui	madadaalo	happy
vulcan	siil	vulcan
vuông	labajibaaran	square
vuốt	xajin	stroke
vv	iwm.	etc.
vy	vy	vy
vyacheslav	vyacheslav	vyacheslav
và	iyo	and
vài	yar	several
vàm	vm	the mouth of a rivulet (n.)
vàng	jaalle ah	gold
vành	rim	coronary
vào	galay	into
vá	balastar	patchy
vác	xambaarsan	to shoulder (v.)
vách	darbiga	wall
vái	haa	some
ván	loox	game
váng	nabar	film
váy	labiska	skirt
vân	sidaas	"(term should be ""vân vân"") et cetera"
vây	fin	encircle
vã	cararay	rush
vãi	shit	to release
vãn	van	save
vè	isir	to glance slyly (v.)
vé	tigidhada	ticket
vét	dredge	plunder
vê	ku saabsan	tremolo
vì	maxaa yeelay	because
ví	boorso	example
vía	boorso	soul
vít	xoqid	screw
vò	burburay	jar
vòi	tuubada	tap
vòm	saqafka	upper jaw
vòng	garaac	around
vó	hoooo	hooves
vóc	cabir	"(should be ""vóc sương"") dew-like or delicate"
vô	maya	"(term should be ""vô số"") countless (adj.)"
vôi	lime	limestone
võ	dagaal	martial arts (n.)
võng	xabad	hammock
vùi	aasay	"(term should be ""chôn vùi"") to bury or keep secret (v.)"
vùng	gobolka	region
vú	naas	breast (n.)
vút	kor u kaca	"entire term should be ""cong vut""; extreme curling"
văn	suugaanta	culture
văng	buufin	a name
vĩ	weyn	"(term should be ""vĩ đại"") great (adj.)"
vĩnh	joogto ah	ving
vũ	vu	armed
vũng	boorso	vung
vơ	kaalmeyn	lost
vơi	leh	ullage
vưu	vưu	"actual term is ""xi vưu""; proper noun; name of a leader of a people in chinese legend"
vươn	gaadho	reach
vương	boqorka	kingdom
vướng	isku dhegan	"(term should be ""vướng víu"") to become involved in (v.)"
vườn	beerta	garden
vượn	daanyeer	gibbon
vượt	gudub	to overcome
vạ	sidaas	unfortunate problem
vạc	xabad	cauldron
vạch	bar	bar
vại	dhalo	jar
vạn	toban kun	thousand
vạng	fiidkii	twilight
vả	fig	hard
vải	dhar	fabric
vảy	miisaanka	scale
vấn	talo	vấn đề= problem
vấp	dib udhac	stumble
vất	tuur	hard
vần	laxanka	spell
vầng	halo	moon (vang trang)
vẩn	wali	wander
vẩy	jajabyada	scale
vẫn	wali	still
vẫy	ruxaya	wave
vận	nasiib	active
vắc	tallaal	vaccine
vắcxin	tallaal	vaccine
vắn	gaaban	short
vắng	maqan	absent
vặn	xoqid	to twist (v.)
vặt	noocyada	odd
vẹn	daacadnimo	complete
vẹt	parrots	parrots
vẽ	rinjiyeynta	draw
vết	balastar	wound
vểnh	dhiillo	warping
vệ	difaaca	"(term should be ""bảo vệ"") to defend (v.)"
vệt	streaks	streak
vỉa	xarkaha	"(term should be ""vỉa hè"") sidewalk"
vịnh	bay	bay
vịt	digaag	duck
vọng	rajo	"(term should be ""hy vọng"") hope (n.)"
vọt	cirka	to spurt out (v.)
vỏ	jilif	shell
vồ	maul	"(term should be ""gạch vồ"") a type of brick"
vỗ	pat	to clap
vội	dhaqso	hurriedly (adv.)
vớ	sharaabaad	"(term should be ""vớ vẩn"") silly (adj.)"
với	leh	to
vớt	kalluun	salvage
vờ	iska dhigid	"(term should be ""giả vờ"") to pretend (v.)"
vời	weyn	wonderful
vở	buugga xusuus qorka	"(term should be ""vở kịch"") a play"
vỡ	jabay	break
vợ	naag	wife
vụn	qolof	debris
vụng	cuqdad	covert
vứt	tuur	throw away
vừa	ku habboon	just (adv.)
vừng	sisinta	sesame (n.)
vững	adag	firm (adj.)
vực	duurka	place
vựng	ereyada	"(term should be ""từ vựng"") regional vocabulary (n.)"
vỹ	sidaas	majestic
w	w	w
wa	wa	wa
walt	walt	(proper noun) walt, as in walt disney
walter	walter	walter
walther	walwal	walther
wan	wan	wan
wang	wang	wang
wankel	wankel	(proper noun) wankel
wanna	raba	wanna
warren	warren	a name
warsaw	warsaw	warsaw
warszawa	warszawa	(proper noun) warsaw
washington	dhar dhaqid	(proper noun) washington
wat	wat	(proper noun) wat, as in angkor wat, the temple in cambodia
watergate	biyo-galeen	watergate
waterloo	waterloo	(proper noun) waterloo
waters	biyo	waters
wayne	dariiqa	wayne
wcdma	wcdma	w-cdma
weasley	weasley	weasley, as in ron weasley in the harry potter series
weblog	websaydh	weblog
webmail	websaydhka	ưebmail
weimar	weimar	(proper noun) weimar
wellington	wellington	wellington
wells	ceelal	wells, as in author orson wells
welsh	welsh	(proper noun) welsh, as in the welsh language
wembley	jilicsan	wembley, as in wembley stadium
werner	werner	werner
westermarck	westermarck	westermarck
western	galbeed	western
westlife	reer galbeedka	westlife
westview	aragti galbeed	westview, as in westview press
wheeler	socodka	a name
widener	balaadhin	widener
wien	wien	wien
wiener	wiener	wiener
wifi	wifi	wi-fi, a technology term
wiki	wiki	wiki
wikia	wikia	a name
wikibooks	wikibooks	(proper noun) wikibooks
wikimapia	wikimapia	wikimapia
wikimedia	wikimedia	wikimedia
wikitravel	wikitravel	a name
wild	duurjoogta ah	wild
wilder	weld	(proper noun) wilder, as in billy wilder
wiley	wiley	wiley
willard	willard	willard
wimbledon	wimbledon	wimbledon
windows	daaqadaha	windows
winer	guuleyste	winer
wisconsin	wisconsin	(proper noun) wisconsin
within	gudahood	within
without	la’aan	without
wolfgang	wolfgang	wolfgang
won	guuleystay	won
wong	waayey	wong
woodrow	qoryo	woodrow
woods	qoryaha	(proper noun) woods, as in tiger woods
would	jeclaan lahaa	would
wrestling	halganka	wrestling
wright	caqli	a name
wu	wu	wu
wushu	wushu	wushu, a type of martial art
wwf	wwf	wwf
xa	fog	ancient
xang	xang	"(term should be ""lan xang"") name of an ancient country in southeast asia"
xanh	buluug	green
xao	flabby	xôn xao = chatting
xay	shiidi	grind
xe	baabuur	a car (n.)
xem	arag	watch
xen	xen	to insert (v.)
xhcn	xhcn	social republic
xi	xi	xi
xiii	xiii	eighth
xin	fadlan	please
xinh	qurux badan	beautiful
xiv	xiv	fourteenth
xiêm	siamese	(proper noun) xiêm, or siam
xiên	slant	oblique
xiêu	xiao	soften
xiếc	circus	circus
xiết	adkeyn	to twist tightly (v.)
xiềng	xarkaha	chain
xo	xo	spring
xoa	xoqid	massage
xoay	leexo	turn
xong	dhammaystiray	completed
xoàng	mediocre	mediocre
xoá	tirtir	delete
xoáy	eddi	vortex
xoắn	maroojin	coiled
xu	qadaadiic	trend
xua	kala qaad	dispel
xuan	xuan	"(term should be ""xuân"") a common vietnamese middle or first name; means ""the season of spring"""
xui	nasiib darro	incite
xuka	xuka	xuka
xum	raaxo leh	a name
xuyên	daloolinta	frequently
xuyến	jijimooyin	manage
xuân	guga	spring
xuâncông	guga	xuan public
xuôi	xaaqday	down
xuất	dhoofinta	ejaculate
xuấtnhập	dhoofinta - soo dejinta	import/export
xuống	hoos	down
xuồng	doon yar	boat
xv	xv	fifteenth
xvi	xvi	xvi
xvii	xvii	xvii
xx	xx	xx
xy	xy	cylinder
xài	kharash garee	use
xào	shiil	stir fry
xách	boorsada gacanta	to carry by the handle (v.)
xám	cirro	ustox
xán	shiilay	"(term should be ""xán lạn"") bright (adj.)"
xáo	khalkhal	chaos
xát	xoqidda	touch
xâm	xardho	invasion
xâu	xarig	string
xây	dhisaan	build
xã	commune	society
xãy	dillaac	occur
xèo	xèo	xeo
xé	jeexdin	tear
xén	abuurka	"(term should be ""biếu xén"") to gift (v.)"
xéo	dhinac	diagonally (adv.)
xét	tixgelin	examine
xê	dhaqaaq	"(term should be ""bánh xu xê"") a type of vietnamese cake"
xêkô	suneo	xeko
xì	fart	scandal
xìu	fart	to become flaccid (v.)
xí	warshad	factory (xi nghiep)
xít	fascin	nazi
xíu	yar	small
xòe	faafin	spread
xóa	tirtirid	clear
xói	nabaad guur	erode
xóm	deriska	village
xót	naxariis	mercy
xô	ruxid	soviet
xôi	bariis dheg dheg leh	pierce
xôn	walaaq	tumultuous
xông	cararay	rush
xôphần	baaldi qaybta	soviet-poland
xôviết	midowgii sofyeeti	soviet
xù	ruxay	gigantic
xú	aflagaado ah	xu
xúc	xiriir	touch
xúi	kadhig	induce
xăm	tattoo	"(term should be ""xa xăm"") far away (adj.)"
xăng	shidaal	gasoline
xơ	fiber	xo
xưa	jir	old
xưng	qiran	"(should be ""tự xưng"") self-proclaimed"
xương	laf	bone (n.)
xước	xoqmay	scratch
xướng	chorus	provoke
xưởng	aqoon isweydaarsi	workshop
xạ	shucaac	"(term should be ""phản xạ"") to reflect"
xả	dheecaan	release
xảo	xeelad	detailed
xảy	dhacdo	happen
xấp	qiyaastii	approximate
xấu	xun	bad
xẩm	shaggy	a type of traditional vietnamese singing
xẩy	dhacdo	occur
xắt	laadhuu	cut
xẻo	nasiib darro	cut off
xếp	laalaabaa	rank
xỉ	slag	approximately
xỉa	floss	to pick (v.)
xỉu	suuxsan	to faint
xốc	naxdin	to lift up (v.)
xốp	styrofoam	porous
xổ	raffle	rush into
xộn	wasakh	messy
xứ	dhul	native
xứng	mudan yahay	appropriate
xử	dawee	judge
y	y	medical
y=fracsin	y = fracsin	a function
ya	ya	(proper noun) ya, as in ya trang
yakovlev	yakovlev	yakovlev
yakushima	yakushima	yakushima
yalta	yalta	(proper noun) yalta
yankee	yankee	(proper noun) yankee
yard	dayrka	yard
yasha	yasha	a name
yeeun	yeun	(proper noun) yeeun
yeltsin	yeltsin	yeltsin, as in boris yeltsin
yemen	yemen	yemen
yersin	yersin	(proper noun) yersin, asin alexandre yersin
yi	yi	(proper noun) yi
ying	ying	(proper noun) ying, as in ying yang
ymca	ymca	ymca
yo	yo	yo
yomiuri	yomiuri	yomiuri
yoochun	yoochun	yoochun
york	york	york
yorker	yorker	yorker
yorkshire	yorkshire	yorkshire
youtube	youtube	youtube
ypres	ypres	ypres
ytv	ytv	ytv
yu	yu	yu
yuan	yuan	(proper noun) yuan, as in yuan mu
yucatán	yucatán	yucatan, as in the yucatan peninsula
yudhoyono	yudhoyono	(proper noun) yudhoyono, as in indonesian president susilo bambang yudhoyono
yugi	yugi	yugi
yukito	yukito	yukito
yume	yume	(proper noun) yume
yunho	yunho	yunho
yuri	yuri	yuri, as in soviet pilot and cosmonaut yuri alekseyevich gagarin
yurt	yurte	yurt
yên	yen	peace or stillness (n.)
yêu	in la jeclaado	love
yếm	coveralls	tender
yến	buul shimbireedka	a type of swallow (n.)
yết	liistada	yet
yếu	daciif ah	mainly
yểm	dabool	support
yển	haa	"is a name meaning, ""bird"""
yểu	qurxoon	"(term should be ""yểu điệu"") graceful (adj.)"
z	z	z
zac	zac	zac
zambia	zambiya	(proper noun) zambia, as in the nation
zealand	dalka xamar	(proper noun) zealand, as in new zealand
zedong	zedong	mao zedong
zero	eber	zero
zeus	zeus	zeus
zheng	zheng	zheng
zhukmse	zhukmse	zhuk-mse
zimbabwe	zimbabwe	zimbabwe
zinedine	zinedine	(proper noun) zinedine
zing	zing	zing, as in the website
zoe	zoe	zoe
zurich	zurich	(proper noun) zurich
zürich	zürich	(proper noun) zurich, as in zurich, switzerland
|nguyễn	| nguyen	a common vietnamese last name
|nổi	| sabeeya	"(term should be ""nổi"") to float (v.)"
|petya	| petya	(proper noun) petya
|tên	| magac	"(should be ""tên"") name (n.)"
|việt	| vietnamese	vietnam
 kg	kg	kg
 triệu	milyan	million
 °c	° c	degrees celsius
°đến	° to	up to
°độ	° digrii	degree
×	×	x
ào	wow	rush
á	aasiya	asia
ác	shar	evil
ách	harqood	yoke (n.)
ái	damac	ai
ám	gudbiya	(with the word chi) to hint at
ánh	luster	light
áo	shaati	clothe
áohung	aohung	"(term should be ""Áo-hung"") austria-hungary"
áp	cadaadis	"(term should be ""huyết áp"") blood pressure (n.)"
áâu	aoi	eurasian
â	â	a vietnamese vowel sound
âm	laga jaro	vagina
ân	nimco	deed
én	liqaa	swallow
ép	tuujin	press
êgê	ego	aegean
êm	jilicsan	smooth
ích	waxtar leh	benefit
ílam	ílam	tamil language name for the island of sri lanka
ít	yar	less
île	.le	Île, as in Île de la cité, france
îledefrance	xaq-u-dirir	ile-de-france
ðiều	qodobka	article
ðài	ài	taiwan
ðường	sonkorta	a road
ðảng	xisbi	party
ðức	jarmalka	"Đức, a common vietnamese first name; means ""virtue"""
ó	it	(with the word la) to boo down
óc	maskaxda	brain
óng	istaaga	"(term should be ""óng ả"") flexible"
ôi	oh	"vietnamese version of the exclamation ""oh"""
ôm	dhunkasho	hug
ôn	dhexdhexaadnimo	peaceful (on hoa)
ông	isagu	a man (n.)
ôtô	baabuur	car
ôxi	oksijiin	oxygen
ôxy	oksijiin	the element oxygen (n.)
ôxít	oxide	oxide
ôzôn	ozone	ozone
ùn	xirmooyinka	congest
úng	biyomareen	flood
úp	wejiga hoos	upside
úy	lahaayee	"(term should be ""thiếu úy"") second lieutenant (n.)"
ý	talyaaniga	italian
ăn	cun	eat
ăng	quraanjo	antenna
ăngten	anteeno	antenna
đa	badan	majority
đai	guuto	"(term should be ""Đai khố"") name of a village"
đak	dak	(proper noun) Đak
đan	xadhig	scandal
đau	xanuun	painful
đay	kaftan	jute, a type of vegetation the vietnamese use to make soup (n.)
đb	db	dien ban
đcstq	dcstq	communist party of china
đcsvn	dcsvn	vietnam communist party
đe	anvil	threaten
đem	keen	to bring (v.)
đen	madow	black
đentrắng	madow iyo caddaan	"(term should be ""đen-trắng"") black-and-white (adj.)"
đeo	xidho	wear
đh	.h	university
đhcn	đcn	university of industry
đhtm	dhtm	university of economics
đhông	bari	dhong
đi	tag	go
điên	waali	crazy
điêu	shay	sculpture
điôxít	dioxide	dioxide
điạ	dạ	dia
điếc	dhagoole	heron
điếu	sigaar	funeral oration
điềm	saxeex	omen
điền	buuxi	estate
điều	shay	control
điểm	barta	bearing point
điển	qaamuus	"(term should be ""từ điển"") a dictionary"
điểu	fuck	thing
điệp	fariinta	spy
điệu	cod	memorial
đo	cabir	measure
đoa	doa	doa
đoan	koox	extreme
đom	dab-damiyeyaal	firefly
đoài	mangoon	the west
đoàn	koox	an organization or group (n.)
đoái	sarrifka	"(term should be ""hối đoái"") to exchange or trade (v.)"
đoạn	sadarka	a stage or phase (n.)
đt	telefoon	training
đtđ	taleefanka gacantu	diabetes
đua	tartan	emulate
đui	indhoole	blind
đun	kuleyl	cook
đuôi	dabada	tail
đuốc	toosh	a torch
đuối	haraad	drowning
đuống	jirridda	(proper noun) Đuống, the name of a river
đuổi	eryade	pursue
đài	raadiyaha	statue
đàm	wadahadal	negotiation
đàn	adhi	musical instrument
đàng	haa	side
đào	qodo	train
đày	masaafuris	exile
đá	dhagax weyn	to kick
đái	pee	pee
đám	koox	dam
đán	dan	"(term should be ""tết nguyên Đán"") vietnamese new year's day"
đáng	mudan	deserve
đáo	gaar ah	unique
đáp	jawaab	response
đát	dhul	"(term should be ""bi đát"") lamentable (adj.)"
đâm	xasil	pierce
đâu	halkee	anywhere
đây	halkan	below
đã	durba	already
đãi	dawee	"(should be ""bạc đãi"") to ill-treat"
đãng	lecherous	dissolute
đè	dhaafid	to press on
đèn	laambad	light
đèo	gudub	a mountain pass (n.)
đê	quusin	a dike (n.)
đêm	habeen	night
đênh	dillaac	lênh đênh= float to unknown
đích	halka loo socdo	goal
đính	ku lifaaqan	attached (adj.)
đò	markab	a ferry (n.)
đòi	sheegasho	require
đòn	afuufid	welcome
đó	halkaas	that or there (adv.)
đóa	nah	"(term should be ""đoá hoa"") a flower bloom"
đói	gaajaysan	hungry
đón	soo qaado	welcome
đôi	labanlaab	sometimes
đôla	dollar	dollar
đôn	lugta	london
đông	naxaas	eastern
đôngbắc	waqooyi-bari	north-east
đôngnam	koonfur bari	south-east
đôngtây	bari galbeed	"(term should be ""đông-tây"") east-west (adj.)"
đôrêmi	doraemon	(proper noun) Đôrêmi
đôrêmon	doraemon	doreamon
đùa	kaftan	joke
đùi	femasin	thigh
đúc	tuuraya	"(term should be ""đúc kết"") to sum up (v.)"
đúng	waa sax	right
đúp	labanlaab	double
đút	gelin	"(term should be ""đút lót"") to bribe"
đăk	dak	dak
đĩ	jeexan	whore/bitch
đĩa	saxanka	disk
đơ	jooji	stiff or rigid (adj.)
đưa	gudub	girl
đường	wadada	pathway
được	waa hagaag	is not
đạ	da	da
đại	weyn	eagle
đạm	borotiin	plain
đạn	xabbad	bullet
đạo	diinta	vagina
đạp	baaskiil	to step on
đạt	gaadho	reach
đả	dagaalo	to hit
đảm	damaanad qaaday	"(term should be ""đảm nhiệm"") to undertake (v.)"
đản	dhalasho	a group or flock (n.)
đảng	xaflad	party
đảo	jasiirad	an island (n.)
đấm	in la garaaco	punch
đấng	ilaahow	the
đất	dhul	country
đấtmặt	dhulka	datmat
đấy	halkaas	ignore
đầm	labiska	swamp
đần	carrab la &#39;	"(term should be ""đần độn"") stupid or ignorant (adj.)"
đầu	madaxa	start
đầy	buuxa	"(term should be ""đầy đủ"") adequate or enough"
đẩu	madaxa	"(entire term is ""khoa đẩu"") ancient phonetic script used in vietnam"
đẩy	riixid	to push
đẫm	xoqmay	wet
đậm	mugdi ah	dense
đậu	digir	to park (v.)
đậy	dabool	cover
đắc	kasban	effectively
đắm	burburay	sink
đắn	hufnaan	proper (dung dan)
đắng	qadhaadh	bitter
đắp	kor	"(term should be ""bù đắp"") to compensate (v.)"
đắt	qaali ah	expensive
đằng	dhaaftay	back
đẳng	fasalka	equality
đặc	gaar ah	"(term should be ""đặc biệt"") special (adj.)"
đặn	joogto ah	regularly
đẹp	quruxsan	beautiful
đẽ	ganaax	beauty
đế	soles	empire
đếm	tirin	to count (v.)
đến	kaalay	come
đề	dunta	promote
đền	macbudka	"(term should be ""đền thờ"") a religious shrine"
đều	waa	all
để	ku	for
đệm	barkinta	middle name
đỉnh	kor	the summit or peak
địch	cadowga	enemy
định	cayiman	appointed
đọ	booska	compete
đọan	sadarka	period
đọc	akhri	read
đọng	joogsan	deposit
đỏ	casaan	red (adj.)
đốc	gudoomiye	admiral
đối	ee	face
đốm	kaalinta	spot
đốn	goyn	"(term should be ""suy đốn:) to be worse off"
đống	rakiban	line
đốt	gubasho	burn
đồ	shay	thing
đồi	buur	hill
đồn	xanta	rumour
đồng	naxaas	agreeable
đổ	ku shubid	dump
đổi	beddel	to change (v.)
đổng	dong	"(term should be ""đồng bằng"") a delta"
đỗ	la dhigay	pass
độ	shahaado	"term should actually be ""độ cao""; means ""height"""
độc	sunta	alone
độn	jeexan	chaos
động	firfircoon	action
đột	si lama filaan ah	"(term should be ""xung đột"") conflict (n.)"
đới	maqaaxi	tropical
đời	waqtiga nolosha	generation
đỡ	taageero	help
đợi	sug	thigh
đợt	dufcaddii	fit
đục	opaque	turbid
đụn	dun	dune
đụng	taabasho	encounter
đủ	ku filan	enough
đứa	carruurta	child
đức	wanaag	virtue (n.)
đứng	istaag	to stand (v.)
đứt	jabay	cut off
đừng	maya	not
đực	lab	male
đựng	ka kooban	suffer
đựoc	hagaag	be
ĩ	oh	"(term should be ""ầm ĩ"") noisy"
ơ	oh	"(term should be ""thờ ơ"") to be indifferent (adj.)"
ơi	hey	"vietnamese equivalent of english ""oh"""
ơn	mahadsanid	thank
ư	aad	vowel sound found in the vietnamese alphabet (n.)
ưa	doorbiday	to like (v.)
ưng	oh haa	to accept (v.)
ưu	barwaaqo	"(term should be ""ưu việt"") preeminent (adj.)"
ươi	orang	orangutan
ươm	xanaanada	nursery
ương	bartamaha	central
ướp	kululay	mummy
ướt	qoyan	wet
ạ	sayid	a word added to the end of a response to show respect to someone in a position of authority, as in a child to a parent
ạt	deg deg	(with word o) to crowd
ải	.i	pass
ảnh	muuqaal	picture
ấm	diiran	warm
ấn	riix	press
ấnâu	daabacan	"(term should be ""Ấn Âu"") a grouping of languages including european and indian languages that are thought to have originated from a single earlier language (adj.)"
ấp	xabad	district
ấu	dhalinyaro ah	childhood
ấy	taasi	that
ẩm	diiran	humidity
ẩn	qari	hidden
ập	bangi	rush
ắt	hubaal	sure
ếch	xayawaan	frog
ỏi	reexaanta	little
ố	ooh	"(term should be ""hoen ố"") stained and smeared (adj.)"
ốc	snails	building
ốm	jirro	sick
ống	tuubbo	tube
ốp	xardhan	omelette
ồn	buuq	noisy (adj.)
ổ	wadid	hard drive
ổi	guava	guava (n.)
ổn	wuu fiican yahay	peace
ớn	weyn	posts
ớt	chili	chili
ở	gudaha	at
ủ	suuxdin	"(term should be ""ủ dột"") gloomy (adj.)"
ủi	bir	"(term should be ""an ủi"") to comfort (v.)"
ủng	kabaha	boot
ủy	gudoomiyaha	commission
ứ	haa	to pool together (v.)
ức	naas	memories
ứng	codsi	corresponding
−−	-	__
≠	≠	different
