$ tỉ	milliarden dollar	$ billion
abc	abc	abc
abdul	abdul	abdul
abkhazia	abkhazia	a name
about	über	about
abraham	abraham	abraham
abrams	abrams	abrams
abscbn	abscbn	abscbn
account	konto	account
aceh	aceh	(proper noun) aceh
achilles	achilles	achilles
acia	acia	acia
acid	säure	acid
ada	ada	ada
adams	adams	(proper noun) adams
addisonwesley	addisonwesley	(proper noun) addison-wesley
adn	adn	adn
adobe	adobe	adobe
adrian	adrian	(proper noun) adrian
adsl	adsl	adsl
advanced	fortgeschritten	advanced
aedes	aedes	aedes
aegypti	aegypti	aegypti
aero	aero	(proper noun) aero, as in the aero l-39 albatros jet
afc	afc	afc
aff	aff	aff
afghanistan	afghanistan	afghanistan
africa	afrika	(proper noun) africa
african	afrikanisch	african
ag	ag	ag
agasa	agasa	(proper noun) agasa, as in hiroshi agasa
agassi	agassi	agassi
ai	wer	who
ailen	irisch	ailen
aim	zielen	aim
air	luft	air
airbus	airbus	airbus
aisne	aisne	aisne
ajax	ajax	ajax
ak	ak	ak
akatsuki	akatsuki	akastuki
akms	akms	akms
akô	hallo	ako
al	al	al
alabama	alabama	alabama
alaska	alaska	alaska
albania	albanien	albania
albatros	albatros	(proper noun) albatros, as in the aero l-39 albatros
albert	albert	(proper noun) albert
alberto	alberto	(proper noun) alberto
albion	albion	albion, an ancient name for great britain
albuquerque	albuquerque	albuquerque
albus	albus	albus
alexa	alexa	alexa
alexandra	alexandra	alexandra
alexandria	alexandria	alexandria
alexandros	alexandros	alexandros
alexey	alexey	alexey
alfred	alfred	(proper noun) alfred, as in alfred kinsey
algérie	algérie	algerie
ali	ali	ali
alice	alice	this is a name
allan	allan	(proper noun) allan, as in edgar allan poe
allen	allen	(proper noun) allen
allmusic	allmusic	allmusíc
alois	alois	alois
alonso	alonso	alonso
alpher	alpher	(proper noun) alpher
alps	alpen	alps
altai	altai	altai
always	immer	luon luon
amaravati	amaravati	amaravati
amazon	amazon	amazon
amdo	amdo	(proper noun) amdo
ame	ame	ame
ami	ami	ami
amiens	amiens	amiens
amin	amin	(proper noun) amin, as in nagib amin
amm	amm	amm
amoniac	ammoniak	ammonium (n.)
amphitrite	amphitrit	(proper noun) amphitrite, a greek sea goddess
an	an	"(should be ""an toàn"") safe"
anand	anand	anand
anata	anata	anata
anatolia	anatolie	anatolia
andalusia	andalusien	andalusia
andaman	andaman	andaman
anderson	anderson	anderson
andes	anden	andes
andorra	andorra	andorra
andrew	andrew	andrew
andré	andré	andre, as in andre morval
andy	andy	(proper noun) andy, as in andy warhol
anfield	anfield	anfield
ang	ang	ang
angkor	angkor	(proper noun) angkor, as in angkor wat, the temple in cambodia
anglosaxon	angelsächsisch	anglo-saxon
anh	ihn	english
anhmỹ	briten	"(term should be ""anh mỹ"") english or american"
anhpháp	herr frankreich	england-france
ankara	ankara	ankara
ankyl	ankyl	ankly
anna	anna	anna
annam	annam	a name the way french called middle vietnam as a colony
annan	annan	annan
anne	anne	anne, a name
anorthosit	anorthosit	anorthosit, a type of igneous rock (n.)
anthony	anthony	anthony
antigua	antigua	(proper noun) antigua
anton	anton	anton
antonov	antonov	antonov
any	beliebig	any
anđêhít	aldehyd	aldehydes
ao	teich	pond
aotearoa	aotearoa	aotearoa
apollo	apollo	apollo
apple	apfel	apple
aquinas	aquin	a name
arab	arab	(proper noun) arab
archetypal	archetypisch	archetypal
archive	archiv	archive
arctan	arctan	a function
ares	ares	ares
argentina	argentinien	(proper noun) the south american nation of argentina
argo	argo	argo
arias	arien	arias
aringarosa	aringarosa	aringarosa, as in manuel aringarosa
aristotle	aristoteles	aristotle
arizona	arizona	arizona, as in the state
ark	arche	ark
arkansas	arkansas	arkansas
arlington	arlington	(proper noun) arlington
armenia	armenisch	(proper noun) armenia
armstrong	armstrong	(proper noun) armstrong, as in jazz artist louis armstrong
arnold	arnold	arnold
arsenal	arsenal	arsenal
artemis	artemis	(proper noun) artemis, the greek goddess of the hunt
aruba	aruba	aruba
arunachal	arunachal	"(term should be ""arunachal pradesh"") a state in india (proper noun)"
asc	asc	asc
ash	asche	a name
ashikaga	ashikaga	ashikaga
ashley	ashley	(proper noun) ashley
asia	asien	asia
asm	asm	asm
asoka	asoka	asoka
association	verein	association
assyria	assyrien	assyria
aston	erstaunen	(proper noun) aston, as in aston villa
atkinson	atkinson	atkinson
atlanta	atlanta	atlanta
atlantic	atlantisch	atlantic
aua	aua	aua
aubrac	aubrac	aubrac
audition	vorsprechen	audition
auflage	auflage	auflage
auguste	auguste	auguste
australia	australien	(proper noun) australia
austria	österreich	(proper noun) the country of austria
austrian	österreichisch	austrian
avar	avar	a name
aviation	luftfahrt	aviation
awad	awad	awad
award	auszeichnung	award
axit	säure	acid
ayeyarwady	ayeyarwady	ayeyarwady
ayumi	ayumi	(proper noun) ayumi
ayutthaya	ayutthaya	(proper noun) ayutthaya
azerbaijan	aserbaidschan	(proper noun) azerbaijan
aztec	aztekisch	aztec, as in the aztec people (adj.)
ba	drei	three
babylon	babylon	babylon
bacon	speck	bacon
baden	baden	baden
baghdad	bagdad	(proper noun) baghdad
bago	bago	bago
bahamas	bahamas	bahamas
bahrain	bahrain	bahrain
baháí	baháí	bahai
balearic	balearisch	balearic
bali	bali	bali
balkan	balkan	(proper adjective) balkan
balkans	balkans	balkans
ballard	ballard	ballard
bamar	bamar	bamar
ban	verbot	the
bang	knall	state
banh	ball	ball
banner	banner	banner
bantam	zwerghuhn	bantam
bantu	bantu	bantu
bao	sack	bao giờ= ever
barack	barack	barack
barak	barak	barak
barbados	barbados	(proper noun) barbados
barbara	barbara	barbara
barbary	barbary	barbary
barca	barca	barca
barnes	barnes	barnes
barone	barone	barone
baroque	barock	baroque
barquin	barquin	barquin, as in ramon barquin, the cuban military colonel
barrichello	barrichello	barrichello
bartholdi	bartholdi	bartholdi
baryon	baryon	baryon
barça	barça	(proper noun) barca
base	basis	base
basel	basel	basel, a city in switzerland
basil	basilikum	basil
baskervilles	baskervilles	baskervilles
bass	bass	bass
bator	bator	bator
battambang	battambang	battambang
bauer	bauer	bauer
bay	fliegen	"(should be ""tuyến bay"") an airline"
bayern	bayern	bayern
bazan	basalt	basalt (n.)
bazơ	grundlegend	base
bb	bb	bb
bbc	bbc	bbc
bc	bc	bc
bchtư	bchtư	central executive
beat	schlagen	beat
beatles	beatles	the beatles
beauty	schönheit	beauty
beckenbauer	beckenbauer	beckenbauer, as in franz beckenbauer
becker	becker	(proper noun) becker
beckham	beckham	beckam
bedloe	bedloe	bedloe
beethoven	beethoven	beethoven
beethovens	beethovens	beethoven's
beginbmatrix	beginbmatrix	this is a code
behind	dahinter	behind
beijing	peking	beijing
bel	bel	bel
bell	glocke	bell
bella	bella	bella
bellatrix	bellatrix	bellatrix
benedict	benedikt	benedict
benetton	benetton	benetton
benfica	benfica	benfica
benito	benito	benito
benjamin	benjamin	(proper noun) benjamin
bennington	bennington	bennigton
berber	berber	berber
bergen	bergen	(proper noun) bergen
berger	berger	berger
bering	bering	(proper noun) bering, as in the bering strait
berkeley	berkeley	(proper noun) the city of berkeley, california
berman	berman	a name
bermuda	bermuda	(proper noun) bermuda
bernard	bernard	bernard
bertrand	bertrand	bertrand
better	besser	better
betty	betty	betty
bhutan	bhutan	bhutan
bia	bier	beer (n.)
biang	biang	biang
bic	bic	bic
bikini	bikini	bikini
bill	rechnung	(proper noun) bill, as in former president bill clinton
billy	billy	billy
bismarck	bismarck	bismarck, as in otto von bismarck
bitmap	bitmap	bitmap
biên	grenze	bien
biếc	blaugrün	a bluish-green color (adj.)
biếm	nachlässig	"(term should be ""biếm họa"") cartoon (n.)"
biến	variabel	other
biếng	faul	lose interest in
biếu	mit freundlicher genehmigung	present
biều	bieu	bieu
biển	das meer	ocean
biểuthứcđiềukiện	kenne die bedingungen	conditional expression
biện	entschuldige dich	"(term should be ""biện pháp"") a method (n.)"
biệt	deutlich	"(term should be ""khác biệt"") different or distinct"
bkavpro	bkavpro	bkavpro
blackwell	blackwell	this is a name
blair	blair	blair
blaise	blaise	blaise
blanc	blanc	blanc
blues	blues	blues
bo	bo	a curl, as in a biceps curl exercise
bob	bob	bob
bobby	bobby	bobby, as in bobby day
boeing	boeing	boeing
bohemia	böhmen	bohemia
bolivia	bolivien	(proper noun) bolivia
boltzmann	boltzmann	boltzmann
bom	bombe	bomb
bonaparte	bonaparte	bonaparte
bong	bong	"(term should be ""bong bóng"") a balloon (n.)"
bonnal	bonnal	bonnal
bonobo	bonobo	bonono
bool	bool	bool
boolean	boolescher wert	(proper adjective) boolean, as in boolean algebra
boom	boom	boom
boong	deck	a deck (n.)
boongke	bunker	bunker
bop	bop	bop
boris	boris	boris
borland	borland	(proper noun) borland
borussia	borussia	borussia
bose	bose	bose, as in subhas chandra bose
boseeinstein	boseeinstein	bose einstein
bosna	bosna	(proper noun) bosnia
bosnia	bosnien	(proper noun) bosnia
botswana	botswana	botswana
bottom	unten	bottom
boulder	felsbrocken	boulder
bourbon	bourbon	bourbon
boxing	boxen	boxing
brain	gehirn	brain
brandenburg	brandenburg	(proper noun) brandenburg
brandt	brandt	brandt
braun	braun	braun
brazil	brasilien	brazil
bremen	bremen	bremen, as in the bremen bank
brestlitovsk	brestlitovsk	brest-litovsk
breton	bretonisch	(proper noun) breton
bretton	bretton	hoi nghi
brezhnev	breschnew	brezhnev
brian	brian	a name
bridge	brücke	bridge
britannic	britannisch	(proper noun) britannic
britney	britney	britney
brooklyn	brooklyn	brooklyn
brot	brot	this is german not vietnamese
brown	braun	brown
browne	browne	browne
browning	bräunung	(proper noun) browning
bruce	bruce	bruce
brunei	brunei	brunei
bruno	bruno	bruno, as in the city of san bruno
brusilov	brusilov	brusilov
brussels	brüssel	brussels, the capital of belgium
btr	btr	btr
bubalis	bubalis	bubalis
budapest	budapest	budapest, the capital of hungary
bulgaria	bulgarien	bulgaria
bulletin	bulletin	thong bao
bungary	bungary	bungary
bungo	bungo	bungo
buonaparte	buonaparte	(proper noun) buonaparte, as in casa buonaparte
burke	burke	(proper noun) burke, as in edmund burke
burkina	burkina	burkina
burma	burma	burma
burundi	burundi	burundi
busan	busan	a korean city
busby	busby	busby
bush	busch	bush
bushy	buschig	bushy
buôn	großhandel	commerce
buông	lass los	to release, to let loose
buýt	bus	bus
buốt	kalt	sharp
buồm	segel	sail
buồn	traurig	sad
buồng	kammer	chamber
buổi	sitzung	session
byzantine	byzantinisch	byzantine
bà	großmutter	woman or lady (n.)
bài	post	articles
bàn	tabelle	table
bàng	adler	eagle
bành	peng	armchair
bào	hobeln	compatriot
bàu	bau	bau
bày	präsentation	"(term should be ""trưng bày"") to display (v.)"
bác	onkel	doctor
bách	zypresse	"(term should be ""bách khoa"") polytechnic (adj.)"
bái	kult	to bow (v.)
bám	klammern	cling
bán	verkauft	sell
báng	lager	"(term should be ""phỉ báng"") to defame or slander"
báo	zeitung	newspaper (n.)
bát	schüssel	eight (n.)
báu	schatz	valuable
bây	jetzt	now
bã	rückstand	"(term should be ""buồn bã"") sad (adj.)"
bãi	meter	beach
bão	sturm	storm
bèn	dann	then
bé	baby	baby
bén	scharf	sharp (adj.)
béo	fett	fat
bên	party	side
bênh	krank	advocate
bì	verpackung	foreskin (n.)
bìa	abdeckung	cover
bìu	hodensack	sac (n.)
bí	squash	secret
bính	binh	"(term should be ""bính âm"") romanized chinese words (n.)"
bíró	kürbis	biro
bò	kuh	beef
bó	haufen	bound (adj.)
bói	wahrsagerei	to foretell (v.)
bón	düngen	"entire term should be ""phan bon""; means ""fertilizer"""
bóng	der ball	sphere or ball
bóp	drücken	squeeze
bô	töpfchen	"(term should be ""bôxit"") the mineral bauxite"
bôi	verschmiert	to apply (as in oil)
bông	baumwolle	flower
bù	schminken	compensate
bùa	amulett	talisman
bùn	schlamm	mud
bùng	fackel	"(term should be ""bùng nổ"") to break out (v.)"
bú	saugen	to suck
búa	hammer	a hammer
búi	büschel	tuft
bún	brötchen	noodle
búng	schnippte	snap
bút	stift	pseudonym
băm	gehasht	hash
băn	bund	concerned
băng	eis	"(term should be ""băng giá"") freezing (adj.)"
bơ	butter	"(term should be ""bơ vơ"") desolate (adj.)"
bơi	schwimmen	swim
bơm	pumpe	pump
bưu	porto	post office
bước	schritt	a step (n.)
bướm	schmetterling	butterfly
bạ	kontakte	directory
bạc	silber	meager
bạch	transparent	"(should be ""bạch tuộc"") an octopus"
bại	fehlgeschlagen	defeated
bảng	tabellen	chart
bảo	bao	protect
bảy	sieben	seventh
bấm	drücken sie	press
bất	echt	"(term should be ""bất cứ"") any (adj.)"
bấy	das	contemporary
bần	arm	poor
bầu	abstimmen	vote
bầy	herde	servant
bẩm	angeboren	congenital
bẩn	schmutzig	the
bẩy	falle	"(term should be ""lẩy bẩy"") unsteadily (adv.)"
bẫy	falle	a trap (n.)
bậc	abschluss	level or class (n.)
bận	beschäftigt	busy
bật	eingeschaltet	outstanding
bắc	norden	beijing
bắcnam	northnam	"(term should be ""bắc-nam"") north-south (adj.)"
bắn	schießen	shoot
bắp	mais	venter
bắt	zu fangen	cross
bằng	gleich	by
bẹp	zerquetschen	crush
bẻ	pause	break
bẽ	demütigung	humiliate
bến	dock	wharf
bếp	küche	kitchen
bề	oberfläche	"(should be ""bề mặt"") a surface"
bền	langlebig	enduring (v.)
bể	kaputt	tank
bệ	sockel	base
bện	geflochten	braided (adj.)
bệnh	krank	benh
bỉ	belgien	disgust
bỉnh	ungezogen	binh
bịch	schlag	ridiculous
bịt	abgedeckt	cover
bọ	fehler	insect
bọc	wickeln	to cover or enclose (v.)
bọn	sie	a group (n.)
bọng	schwellungen	bladder
bọt	schaum	foam
bỏ	gib auf	to leave (v.)
bỏng	brennt	hot
bố	vater	"(term should be ""tuyên bố"") to declare"
bốc	laden	bốc lửa= on fire
bối	verwirrt	messy
bốn	vier	four
bồi	entschädigung	"(term should be ""cao bồi"") cowboy (n.)"
bổn	pflicht	duty
bổng	stipendium	"with word luong, means ""salary"" or ""wages"""
bỗng	plötzlich	suddently
bộ	einstellen	part
bộc	boc	"(term should be ""bộc lộ"") to reveal (v.)"
bội	vielfache	betray
bột	teig	powder or flour (n.)
bớ	aufrunden	arrest
bớt	weniger	less
bờ	ufer	coast
bời	penner	profuse
bở	von	profitable
bởi	von	because
bục	podium	platform
bụng	bauch	abdomen
bứt	unwissentlich	"(term should be ""bứt phá"") power (n.)"
bừa	erschütternd	messy, careless, or topsy-turvy (adj.)
bữa	mahlzeit	meal (n.)
bực	frustriert	bother
ca	ca.	praise
ca-lo	ca-lo	a unit of measurement
cabo	cabo	cabo
cacbon	kohlenstoff	carbon
cacbonat	carbonat	carbonate
cacbua	hartmetall	carbides, carbon ions
caesar	caesar	caesar
caffein	koffein	caffeine
café	kaffee	coffee
cai	cai	govern
cairo	kairo	cairo, the capital of egypt
cal	cal	cal, a first name
calculus	kalkül	calculus
calvin	calvin	calvin
cam	orange	commit
cambodia	kambodscha	(proper noun) the country of cambodia
cambridge	cambridge	cambridge
cameo	cameo	cameo part
cameron	cameron	cameron
cameroon	kamerun	cameroon
camille	camille	camille
campbell	campbell	campbell
campuchia	kambodscha	campuchia
canada	kanada	canada
canadian	kanadisch	canadian
canal	kanal	canal
canary	kanarienvogel	canary
cancer	krebs	cancer
canterbury	canterbury	canterbury
canxi	kalzium	calcium
capello	capello	capello
capra	capra	capra
carat	karat	carat
carbine	karabiner	carbine
cardcaptor	kartenfänger	cardcaptor
cardcaptors	kartenfänger	(proper noun) cardcaptors
carey	vorsichtig	(proper noun) carey, as in singer mariah carey
caribe	karibik	caribbean
caribê	karibik	caribbean
carl	carl	carl
carlos	carlos	carlos
carnaval	karneval	carnaval
carol	weihnachtslied	carol
caroline	caroline	(proper noun) caroline
carpathia	karpaten	carpathia
carter	carter	carter
carxtơ	karat	karst topography, a geological term (n.)
casa	casa	casa
casablanca	casablanca	casablanca
caspia	caspia	caspia
cassini	cassini	cassini
cast	besetzung	cast
castries	gebäck	castries
castro	castro	castro, as in fidel castro
cathay	cathay	cathay
catherine	catherine	catherine
cau	cau	cau
cbc	cbc	cbc
cbgd	cbgd	educational  officer
cbs	cbs	cbs
ccc	ccc	ccc
ccn	ccn	industrial cluster
cctv	cctv	cctv
cd	cd	cd
cdot	cdot	cdot
cdrom	cdrom	cd-rom
cell	zelle	cell
celtic	keltisch	centic
cena	cena	(proper noun) cena, as in john cena, the wrestler
centauri	centauri	centauri
ceres	ceres	ceres
cha	vater	father
chai	flasche	bottle
chaillot	chaillot	a name
chamberlain	kammerherr	chamberlain
champa	champa	champa
champion	meister	champion
chamẹ	bad	parents
chanel	chanel	chanel
chanh	zitrone	lemon or lime (n.)
chao	hallo	(proper noun) chao, a name
charles	charles	charles
charlotte	charlotte	charlotte
charlton	charlton	charlton
charon	charon	(proper noun) charon
chase	jagd	chase
chay	vegetarier	fasting
chdcnd	chdcnd	democratic republic
che	abdeckung	cover
chechnya	chechnya	chechnya
chen	chen	chen
cheo	cheo	"(term should be ""cheo reo"") name of a town"
chi	chi	"(term should be ""chi tiết"") details (n.)"
chia	geteilt	"(term should be ""chia sẻ"") to share"
chiang	chiang	chiang
chicago	chicago	chicago, as in chicago, illinois
chile	chile	(proper noun) the country of chile
chim	der vogel	bird
china	china	china
ching	ching	ching
chirac	chirac	chirac, as in former french president jacques chirac
chiêm	astrologisch	"(term should be ""chiêm thành"") the ancient kingdom of champa in vietnam"
chiên	gebraten	fry
chiêng	gong	gong
chiếc	stk	the
chiếm	besetzt	appropriate
chiến	kämpfen	war, fight
chiết	extrahieren	literal
chiếu	projektion	show
chiền	haufen	temple
chiều	uhr	length
chlamydia	chlamydien	chlamydia
chloride	chlorid	chloroauric acid
chnd	chnd	chnd
choi	spielen	choi
chomsky	chomsky	chomsky
chong	chong	chong
chopin	chopin	chopin
chosŏn	chosŏn	(proper noun) choson
choàng	umhang	coat
choáng	fassungslos	dizzy
chris	chris	chris, as in chris hughes
christ	christus	christ
christian	christian	christian
christopher	christopher	christopher
chrome	chrom	chrome, as in google chrome
chrysler	chrysler	(proper noun) chrysler, the car company
chu	chu	cycle
chua	sauer	tomato
chuck	chuck	(proper noun) chuck, as in chuck norris
chui	unterirdisch	underground
chum	kumpel	pot
chun	chun	chun
chung	allgemein	general
churchill	churchill	churchill
chuyên	spezialisiert	professional
chuyến	reise	trip
chuyền	passieren	volleyball
chuyển	übertragen	to move
chuyện	geschichte	nói chuyện= talk
chuôi	meckern	handle
chuông	glocke	a bell
chuẩn	standard	standard
chuốc	poke	incur
chuối	bananen	banana
chuốt	räumen	refine
chuồng	scheune	cage
chuỗi	zeichenfolge	series
chuộc	einlösen	redeem
chuộng	bevorzugt	favorite
chuột	maus	a mouse (n.)
chà	reiben	rub
chài	angeln	fish
chàm	indigo	indigo
chàng	mann	"(term should be ""chàng trai"") a young man (n.)"
chào	hallo	welcome
chày	baseball	a pestle (n.)
chánh	chef	"(term should be ""chánh án"") the head of a tribunal (n.)"
cháo	brei	porridge
cháu	enkelkinder	a term one uses denoting oneself when addressing an aunt or uncle (n.)
cháy	brennen	fire
châm	stechen	motto
chân	füße	a leg
châu	europa	continental
chè	tee	tea
chèn	einfügen	insert
chém	schrägstrich	to chop
chén	tasse	bowl
chéo	kreuz	cross
chép	kopie	written
chê	verdammt	decry
chênh	unterschied	difference
chì	führen	graphite
chìa	schlüssel	"(term should be ""chìa khoá"") a key (n.)"
chìm	sinken	to become submerged or sink (v.)
chình	aal	eel
chí	läuse	especially
chích	injektion	shoot
chín	neun	ripe
chính	haupt	main
chít	scheiße	dense
chò	ersticken	a type of plant, typically of the parashorea genus (n.)
chòi	hütte	hut
chòm	konstellation	constellation
chó	hunde	dog
chóc	haha	killing (giet choc)
chói	blendung	bright
chóng	schnell	"entire term should be ""chong mat""; means ""dizzy"""
chóp	tipp	the top (n.)
chôm	rambutan	rambutan
chôn	begraben	bury
chông	ehemann	thorn
chùa	pagode	pagoda
chùy	streitkolben	mace
chú	onkel	uncle (n.)
chúa	gott	god
chúc	zu wünschen	will
chúi	tuu	drop
chúng	sie	they
chút	ein bisschen	little
chăm	pass auf dich auf	champa
chămpa	champa	champa
chăng	erschwinglich	would it
chĩa	gabeln	point
chơi	spielen	play
chơn	füße	"a more obscure form of the word ""chân""; means ""genuine"" or ""true"""
chư	chu	lower authorities
chưa	noch nicht	not yet
chưng	dist	steamed
chương	kapitel	medal
chướng	hindernisparcours	grating
chạ	promiskuitiv	father
chạm	berühren	touch
chạng	dämmerung	twilight
chạp	wackelig	slow
chạy	laufen	to run (v.)
chả	brötchen	no
chảo	pfanne	pan
chảy	fließend	bleeding
chấm	punkt	end
chấp	hypothek	"(term should be ""chấp nhận"") to accept (v.)"
chất	substanz	quality
chấu	prise	"(term should be ""châu chấu"") a grasshopper (n.)"
chần	blanchieren	slice
chẩn	diagnostizieren	"(term should be ""chẩn đoán"") to diagnose (v.)"
chậm	langsam	slow
chận	block	block
chật	eng	overcrowded
chậu	töpfe	pelvic
chắc	sicher	certainly
chằng	stirn	ligament
chẵn	sogar	even
chặn	block	prevent
chặng	bein	journey
chặt	eng	close
chẻ	teilen	strick
chẽ	eng	"(term should be ""chặt chẽ"") tightly or closely (adv.)"
chế	vorbereitungen	produce
chếch	schlaff	oblique
chết	sterben	to die (v.)
chệch	falsch	deviant
chỉ	nur	just (adv.)
chỉnh	korrektur	adjust
chịt	mist	chằn chịt= complex/tangle
chịu	bär	tolerate
chọc	stupsen	to poke
chọi	kämpfen	oppose
chọn	wähle	to choose
chỏ	ellbogen	"(term should be ""cùi chỏ"") elbow (n.)"
chốc	moment	single
chối	leugnen	refuse
chốn	ort	place
chống	anti	anti-
chốt	riegel	important
chồi	schießt	"(term should be ""đâm chồi"") budding"
chồn	wiesel	anxious
chồng	ehemann	husband
chỗ	ort	where
chội	scheiße	cramped
chớ	nicht	not
chớp	blitz	flashing (adj.)
chờ	warte	to wait
chở	tragen	for
chợ	markt	market
chợt	plötzlich	suddenly
chục	dutzend	dozen
chụp	schießen	capture
chủ	besitzer	"(term should be ""chủ yếu"") main or essential (adj.)"
chủng	stämme	strain
chứ	eher	just or only (adv.)
chứa	enthält	contain
chức	funktion	function
chừ	warte	hesitate
chừa	verlassen	leave
chừng	ca.	about or roughly (adv.)
chử	wort	"(term should be ""chử bích"") the vietnamese name for a chinese island"
chửa	schwanger	pregnant
chửi	fluchen	curse
chữ	wort	a letter of the alphabet (n.)
chữa	heilen	to cure or treat (v.)
chững	nivellierung	to totter (v.)
cia	cia	cia
cincinnati	cincinnati	cincinnati
cinderella	aschenputtel	cinderrella
cip	cip	cip
circus	zirkus	circus
cities	städte	cities
clara	clara	clara
clark	clark	clark
claude	claude	(proper noun) claude
claudius	claudius	(proper noun) claudius
clinton	clinton	clinton, as in former president bill clinton
clip	clip	clip
clips	clips	clips
clo	chlor	chlorine
clow	clow	clow
clyde	clyde	(proper noun) clyde, as in bonnie and clyde
cmc	cmc	cmc
cmt	cmt	cmt
cn	cn	christian era
cnet	cnet	cnet
cntb	cntb	capitalism
cntt	cntt	it
cnxh	cnxh	social republic
co	co	spasm
coburn	coburn	coburn
cocoa	kakao	cocoa
coen	coen	coen
coffea	coffea	coffee
cohen	cohen	cohen
coi	berücksichtigt	to regard
coleen	coleen	coleen
coleman	coleman	coleman
coli	coli	coli
colin	colin	(proper noun) colin, as in colin powell
colleen	colleen	colleen
college	college	college
collins	collins	(proper noun) collins
collège	collège	college (n.)
colombia	kolumbien	colombia
colombo	colombo	(proper noun) colombo
colorado	colorado	(proper noun) colorado, as in the state
columbus	columbus	columbus
comic	comic	comic
common	gemeinsam	common
concacaf	concacaf	concacaf
concerto	konzert	concerto
concorde	concorde	concorde
condom	kondom	condom
cong	gebogen	curved or bent
congo	kongo	congo
congress	kongress	congress, as in library of congress
connecticut	connecticut	connecticut
conrad	conrad	corrad
conservation	erhaltung	conservation
constantine	konstantin	constantine
contemporary	zeitgenössisch	contemporary
cooper	cooper	(proper noun) cooper
copenhagen	kopenhagen	copenhagen
copernic	kopernisch	corpernic
copperfield	kupferfeld	(proper noun) copperfield, as in magician david copperfield
coppola	coppola	coppola
copy	kopie	copy
cordyceps	cordyceps	cordyceps
core	kern	core
cornell	cornell	cornell
cosin	cosin	cosine
costa	costa	costa
cotang	cotang	cotangent
cpt	cpt	cpt
craig	craig	(proper noun) craig
crazy	verrückt	crazy
crespo	crespo	(proper noun) crespo
crest	wappen	crest
crew	besatzung	crew
crimson	purpur	crimson
crisis	krise	crisis
cristiano	cristiano	cristiano, as in portuguese soccer player cristiano ronaldo
croatia	kroatien	croatia
cross	kreuz	cross
crs	crs	crs
cruz	cruz	cruz
cruzeiro	cruzeiro	cruzeiro
crystal	kristall	crystal
ctc	ctc	ctc
cua	krabbe	crab (n.)
cullen	cullen	a name
cung	bogen	circle
cunningham	cunningham	cunningham; proper name
cup	tasse	cup
cuả	von	of, from, belonging to
cuốc	hacken	hoe
cuối	zuletzt	last or final (adj.)
cuốn	buch	book
cuống	stiel	throat
cuồng	verrückt	crazy (adj.)
cuộc	kämpfen	the
cyanide	cyanid	cyanide
cyber	cyber	cyber
cyril	cyril	(proper noun) cyril
cyrus	cyrus	cyrus
cyworld	cyworld	cyword
cà	kaffee	ca
cài	installieren	install
càn	brauchen	raid
càng	desto mehr	cang
cành	zweig	branch
cào	kratzer	scratch
cày	pflügen	plow
các	die	all (adv.)
cách	der weg	the
cái	die	"(term should be ""con cái"") children (n.)"
cán	gerollt	"(should be ""cán bộ"") an officer, especially in a communist regime"
cánh	flügel	wing
cáo	fuchs	report
cáopx|bình	cáopx | durchschnitt	not a word
cáp	kabel	cable (n.)
cáy	geiger	fiddler
câm	dumm	mute (adj.)
cân	skala	weight
câu	satz	saying
cãi	argumentieren	argue
cò	auslösen	stork
còn	links	to have left (v.)
có	ja	have
cói	segge	machine
cót	kinderbett	cot
cô	sie	girl
côi	verwaist	orphaned
côn	verjüngung	a stick (n.)
công	arbeit	worker
côngtenơ	behälter	container
cõi	bereiche	entire area
cõng	huckepack	piggyback
cù	kitzeln	cu
cùi	aussätzige	leprosy
cùng	zusammen	together
cú	eule	old
cúi	bogen	to bow (v.)
cúm	grippe	cum
cúng	gemütlich	worship
cúp	ausfall	cup (n.)
cút	raus	to kick someone out (v.)
căm	eingesteckt	detest (cam thu)
căn	radikal	"(term should be ""căn bệnh"") cause of a disease (n.)"
căng	dehnen	tense
cũ	alt	old
cũi	krippe	kennel
cũng	auch	also
cơm	reis	rice
cư	bevölkern	resident
cưa	sah	saw
cưng	liebling	also
cước	fracht	megaman
cưới	verheiratet	marry
cướp	rob	to rob (v.)
cười	lache	smile
cường	intensiv	strengthen
cưỡi	reiten	ride
cưỡng	gezwungen	force some body to do some thing. cưỡng dâm=rape
cạc	karte	card (n.)
cạn	flach	shallow
cạnh	kante	"(term should be ""khía cạnh"") an angle"
cạo	rasieren	shave
cạp	skorpion	scorpion
cả	beides	both
cải	senf	reform
cảm	kalt	pleasure
cản	geplagt	prevent
cảng	hafen	port
cảnh	szene	situation
cảo	abzieher	posthumous
cấm	verboten	ban
cấn	brauchen	dramatic
cấp	gewähren	level or rank (n.)
cất	destilliert	"(term should be ""cất giữ"") to keep safe or store"
cầm	halten	to hold (v.)
cần	brauchen	need
cầu	brücke	request
cầy	zibet	farmed
cẩn	sei vorsichtig	carefully
cẩu	kran	"(term should be ""hải cẩu"") a seal (n.)"
cận	ansatz	close
cập	zähler	mention
cậu	ihn	a young man (n.)
cậy	abhängen	reliable
cắm	einstecken	to plant (v.)
cắn	beißen	to bite
cắp	stehlen	steal
cắt	schneiden	cut
cằm	kinn	chin
cằn	mürrisch	exhausted (adj.)
cặp	paar	couple
cọ	handfläche	rub
cọc	haufen	pile
cọp	tiger	tiger
cỏ	gras	plant
cố	versuche es	"(term should be ""cố gắng"") to try one's best (v.)"
cốc	tasse	cereal
cối	mörtel	mortar
cốm	nuggets	grilled rice
cống	tribut	dedicate
cồn	alkoholisch	i
cồng	gong	gong
cổng	das tor	gate
cỗ	deck	engine
cỗi	stur	barren
cộ	fahrzeug	"(term should be ""xe cộ"") cars or vehicles (n.)"
cội	alt	origin
cộng	plus	to add (v.)
cột	spalte	pole
cớ	entschuldigung	excuse
cờ	flagge	flag
cỡ	größe	size
cợt	scherz	"(term should be ""đùa cợt"") to trifle (v.)"
cục	abteilung	department
cụm	cluster	cluster
cụp	amputiert	down
cụt	amputiert	"(should be ""xương cụt"") the tailbone or coccyx"
củ	knollen	a bulb, a botanical term
của	von	of
củi	brennholz	firewood
củng	auch	reinforce
cứ	auf	any
cức	gurren	"(term should be ""cức Đê"") a character in chinese history"
cứng	schwer	hard
cứngi	hardi	cungi
cừ	stapel	nacre
cừu	schafe	sheep
cửa	die tür	door
cửu	multiplizieren	nine
cữ	cu	abstinence
cữu	sarg	nine
cự	entfernung	against
cựa	sporen	retreat
cực	extrem	extreme
cựu	ehemalige	former
d	d	d.
da	haut	skin
daegu	daegu	daegu
dahl	dahl	(proper noun) dahl, as in author roald dahl
dai	zäh	persistent
daily	täglich	daily
dakota	dakota	dakota, as in the state of south dakota
dalat	dalat	da lat
dampier	feuchter	(proper noun) dampier, a last name
dan	dan	dan
dancing	tanzen	dancing
danger	gefahr	danger
danh	name	list
daniel	daniel	daniel
dante	dante	dante
dao	messer	poniard
darwin	darwin	darwin
das	das	das
dassault	dassault	(proper noun) dassault
date	datum	date
dau	kopfschmerzen	dau
dave	dave	(proper noun) dave, as in dave sexton
david	david	david, as in david thomas
davies	davies	davies
davis	davis	davis
dbsk	dbsk	dbsk
dc	dc	d.c.
ddr	ddr	ddr
dean	dekan	a name
degree	abschluss	degree
delhi	delhi	delhi
delphi	delphi	(proper noun) delphi, as in the oracle
demeter	demeter	(proper noun) demeter, the greek goddess of the harvest
den	den	den
dennis	dennis	dennis
department	abteilung	departmen
derek	derek	derek
des	des	des
descartes	descartes	descartes
design	design	thiet ke
deuterium	deuterium	deuterium
deutschland	deutschland	deutschland
dewan	dewan	dewan, as in dewan rakyat
dewitt	dewitt	(proper noun) dewitt, as in rose dewitt bukater
di	di	move
diana	diana	(proper noun) diana, as in diana ross
die	sterben	german
diego	diego	diego
dien	verrückt	"(term should be ""Điện biên phủ"") a city in northwestern vietnam where a famous battle took place during the vietnam war"
dimaggio	dimaggio	gimaggio
dinh	palast	official residence or palace
dionysus	dionysos	dionysus, as in the greek god
discovery	entdeckung	discovery
discussion	diskussion	discussion
disneyland	disneyland	disneyland
division	teilung	division
divoire	divoire	d'lvoire
diêm	streichhölzer	diem vuong
diên	verrückt	"(term should be ""kinh diên"") canon (n.)"
diềm	volants	matches
diều	drachen	kite
diểu	drachen	(proper noun) diểu
diễm	diem	beauty; a common vietnamese first name for women
diễu	märz	parade
diệc	reiher	a heron (n.)
diệm	diem	(proper noun) diệm, as in ngô Đình diệm, former president of south vietnam
diện	gesicht	face to face
diệt	töten	to kill or destroy (v.)
diệu	magie	effective (adj.)
djibouti	dschibuti	djibouti, a country in africa
djokovic	djokovic	(proper noun) djokovic, as in novak djokovic
dm	dm	dm
dmitri	dmitri	dmitri
dna	dna	dna
do	von	because of
doanh	gelenk	"(term should be ""kinh doanh"") business (n.)"
doc	doc	doc
docherty	docherty	docherty
dolly	dolly	(proper noun) dolly, as in singer dolly parton
dome	kuppel	nha
dominican	dominikaner	(proper noun) dominican, as in the dominican republic
don	don	(proper noun) don
donau	donau	donau
dortmund	dortmund	(proper noun) dortmund
dougherty	dougherty	dougherty
douglas	douglas	douglas
dover	dover	(proper noun) dover, as in the capital of delaware
doyle	doyle	doyle
doãn	doan	doan
doạ	bedrohlich	threat
dp	dp	dp
dracula	dracula	dracula
draft	entwurf	draft
drake	drake	(proper noun) drake
driver	fahrer	a name
ds	ds	ds
dtd	dtd	dtd
dth	dth	dth
du	du	travel
dubai	dubai	dubai
duiker	duiker	duiker
duk	duk	duk
dumas	dumas	dumas
dumbledore	dumbledore	dumbledore
dung	mist	portrait
durham	durham	durham
dursley	dursley	dursley
duy	nur	only
duyên	prädestiniert	coastal
duyện	streben	fellatio
duyệt	durchsuchen	browser
duơng	duong	ocean
duẩn	duan	duan
duật	duat	duat
duệ	nachkommen	descendants (n.)
duỗi	begradigen	stretch
dwight	dwight	dwight
dà	dah	gradually
dài	lang	to lengthen, as in time
dàn	inszenierung	to arrange
dàng	einfach	dang
dành	ausgegeben	for
dào	reichlich vorhanden	"complement to word ""doi""; entire phrase ""doi dao"" means ""plentiful"""
dày	dick	thick
dái	pissen	"penis (n.), although some may use the term to mean ""testicles"""
dám	wage es zu	dare
dán	einfügen	stick
dáng	form	appearance
dát	eingelegt	inlay
dâm	unzüchtig	lustful (adj.)
dân	menschen	people
dâng	angebot	dedicate
dây	draht	nerve
dã	wild	chronicle
dãi	freizügig	band
dãn	erweitert	extend
dãy	sequenz	a row (n.)
dè	sei vorsichtig	tight
défense	verteidigung	defense
dép	sandalen	slipper
dê	ziege	goat
dì	tante	aunt
dìu	dìu	to lead by the hand (v.)
dính	klebrig	stick
dò	suche	(with word tham) to survey
dòm	schau	snoop
dòng	linie	"(term should be ""dòng họ"") family (n.)"
dó	das	a type of plant used to make paper in vietnam (n.)
dông	gewitter	a storm (n.)
dõi	verfolgen	monitor
dù	obwohl	though
dùi	puncher	awl
dùng	gebraucht	use
dăm	späne	"(term should be ""đá dăm"") pebbles (n.)"
dĩ	natürlich	why
dĩa	gabeln	dish
dũng	tapfer	courage
dơ	schmutzig	dirty
dơi	fledermäuse	bat
dư	überschuss	remnant
dưa	melone	melons
dưng	hör auf	suddently
dương	positiv	penis
dường	scheinen	seem
dưỡng	krankenpflege	feed
dược	apotheke	having to do with medicine (adj.)
dượng	onkel	uncle
dạ	ja	night
dại	dumm	stupid or idiotic (adj.)
dạn	furchtlos	"(term should be ""dày dạn"") to be accustomed to, especially some sort of difficult situation (adj.)"
dạng	format	tyoe
dạo	spazieren gehen	vending
dạt	abgewaschen	to drift
dạy	lehren	teach
dải	streifen	range
dấm	essig	vinegar
dấp	stolpern	shape
dấu	das zeichen	signal
dấy	erregend	to raise (v.)
dần	allmählich	people
dầu	öl	oil
dẫm	stampfen	step on
dẫn	führen	to lead
dẫu	obwohl	though
dận	tante	to step on
dậu	hahn	rooster
dậy	steh auf	"(term should be ""dậy thì"") pubescent (adj.)"
dắt	führen	lead
dằn	ballast	"(term should be ""dằn lòng"") to hold yourself in (v.)"
dằng	hartnäckig	dằng dai= long/endless
dẳng	hartnäckig	persist
dặm	meilen	mile
dặn	bestellt	to advise (v.)
dặt	bestellen	conservative
dẹp	platt	pacify
dẹt	flach	flat
dẻ	kastanien	chestnut
dẻo	plastizität	flexible
dế	grillen	cricket
dền	amaranth	beetroot
dể	einfach	easy
dễ	einfach	easy
dệt	weben	textile
dị	singularität	simple
dịch	übersetzen	semen
dịp	anlass	occasion
dịu	sanft	ease
dọa	bedrohlich	to threaten or scare (v.)
dọc	vertikal	along
dỏm	witzig	witty
dốc	hang	slope
dối	lügen	lie
dốt	unwissend	stupid or ignorant (adj.)
dồi	reichlich vorhanden	"(term should be ""trau dồi"") improve (v.)"
dồn	in die enge getrieben	accrue
dỗ	koax	dirty
dời	bewegen	leave
dở	schlecht	incomplete
dỡ	entladen	remove
dụ	zum beispiel	example
dục	sex	sexuality
dụng	verwenden	use
dứa	ananas	pineapple
dứt	beendet	to cease
dừa	kokosnuss	coconut (n.)
dừng	hör auf	to cease
dữ	daten	"(term should be ""giận dữ"") anger (n.)"
dự	projiziert	attend
dựa	basiert	base on
dực	männlich	dực, as in lê tương dực
dỹ	dỹ	dy
e	e	e.
ea	ea	(proper noun) ea, as in ea kao
earles	earles	earles
eaton	eaton	eaton
ebro	ebro	a name
ecmascript	ecmascript	ecmascript
ecw	ecw	ecw
edda	edda	(proper noun) edda
edgar	edgar	edgar, as in author edgar allan poe (n.)
edge	kante	edge
edinburgh	edinburgh	(proper noun) edinburgh, as in edinburgh, scotland
edison	edison	edison
editor	herausgeber	editor
edmond	edmond	edmond
edo	edo	edo
edward	edward	edward
edwin	edwin	edwin
eea	eea	eea
efron	efron	efron, as in zac efron
egypt	ägypten	egypt
eid	eid	(proper noun) eid
eiffel	eiffel	eiffel
einstein	einstein	einstein
eisenhower	eisenhower	eisenhower, as in former president dwight d. eisenhower
ekaterina	ekaterina	this is a name
elbe	elbe	(proper noun) the elbe river
electronic	elektronisch	electronic
eliane	eliane	(proper noun) eliane
elip	ellipse	ellipse
elizabeth	elizabeth	elizabeth
ellen	ellen	ellen
ellis	ellis	a name
elton	elton	(proper noun) elton, as in elton john
elvis	elvis	elvis
elíp	ellipse	ellipse
em	du	younger sibling
email	e-mail	email
emily	emily	(proper noun) emily, as in emily dickinson
emir	emir	emir
emmy	emmy	emmy
en	en	erica reef
energy	energie	energy
engels	engel	engels
england	england	(proper noun) england, as in new england
eniac	eniac	eniac
entente	entente	entente
entropy	entropie	entropy
enzym	enzym	enzymes
eo	taille	eo, as in the film captain eo
ep	ep	a name
erich	erich	erich
erik	erik	erik, as in erik moller
eris	eris	eris
eritrea	eritrea	eritrea
ernest	ernest	(proper noun) ernest
eros	eros	eros, greek god of love
erwin	erwin	(proper noun) erwin, as in erwin rommel
españa	españa	espana
essential	wesentlich	essential
ethernet	ethernet	ethernet
ethiopia	äthiopien	(proper noun) ethiopia
euclid	euklid	euclid
eugene	eugene	eugene
eugène	eugène	(proper noun) eugène
euler	euler	euler
euro	euro	euro, as in the european currency
eurofighter	eurofighter	eurofighter
europe	europa	europe
european	europäisch	(proper adjective) european
eva	eva	eva
everton	everton	everton
every	jeder	every
exgay	exgay	exgay
explorer	entdecker	explorer
extensive	umfangreich	extensive
fabio	fabio	(proper noun) fabio
facebook	facebook	(proper noun) facebook
fact	tatsache	fact
facto	facto	this is french not vietnamese
faifo	faifo	(proper noun) faifo
fao	fao	fao
farrell	farrell	farrell
faso	faso	faso
fbi	fbi	fbi
fca	fca	fca
fdi	fdi	fdi
features	funktionen	features
federer	föderer	federer
feet	füße	feet
felipe	felipe	felipe
felis	felis	(proper noun) felis
felix	felix	(proper noun) felix, as in felix klein
ferb	ferb	ferb
ferdinand	ferdinand	ferdinand
ferguson	ferguson	ferguson
fernando	fernando	fernando
ferrari	ferrari	ferrari
fiat	fiat	fiat
fidel	fidel	fidel
field	feld	field
fifa	fifa	fifa
fifpro	fifpro	fifpro
figo	figo	figo
fiji	fidschi	fiji
finish	beenden	finish
firefox	firefox	(proper noun) mozilla firefox
fischer	fischer	fischer, as in louis fischer
fish	fisch	fish
fishbed	fischbett	fishbed
fitzgerald	fitzgerald	(proper noun) fitzgerald
flanker	flanker	flanker
fleming	flämisch	fleming
flight	flug	flight
foch	foch	(proper noun) foch
focus	fokus	focus
foden	foden	(proper noun) foden, as in tom foden
fokker	fokker	fokker
food	essen	food
football	fußball	bong da
forbes	forbes	(proper noun) forbes, as in the magazine
ford	ford	(proper noun) ford
fordham	fordham	(proper noun) fordham
forks	gabeln	forks
foundation	stiftung	foundation
fox	fuchs	fox
fpt	fpt	a company name in vietnam
fracsin	fracsin	a function
franc	franken	franc
france	frankreich	france
frances	frankreich	frances
francis	francis	francis, as in francis xavier
francisco	francisco	francisco
franco	franco	franco
frank	frank	frank
frankfurt	frankfurt	(proper noun) frankfurt
franklin	franklin	franklin
franz	franz	(proper noun) franz, as in franz ritter
freud	freud	(proper noun) freud, as in sigmund freud
friedman	friedman	friedman
fu	fu	fu
fujiko	fujiko	fujiko, as in japanese writer fujiko fujio
fujimoto	fujimoto	fujimoto
fukuoka	fukuoka	fukuoka
funimation	funimation	(proper noun) funimation
funk	funk	funk
futsal	futsal	futsal
fx	fx	fx
ga	ga	station
gabon	gabon	gabon
gabriel	gabriel	gabriel
gabriella	gabriella	gabriella
gagarin	gagarin	gagarin
gaia	gaia	gaia
gaillard	gaillard	gaillard
galilei	galilei	galilei
galileo	galileo	galileo, the astronomer
gam	gramm	gam
gambia	gambia	gambia
gamow	gamow	a name
gan	leber	liver
gandhi	gandhi	gandhi, as in mahatma gandhi
gang	bande	cast iron
ganh	eifersüchtig	to be jealous
gao	gao	strictly
gareth	gareth	a name
garrett	garrett	garrett
gary	gary	gary
gascon	gascon	(proper noun) gascon, a dialect of france
gatt	gatt	gatt
gaule	gaule	gaul, a region in ancient western europe
gaulois	gaulois	gaulois
gay	schwul	tense
gaza	gaza	gaza
gdańsk	danzig	(proper noun) gdansk, poland
gdp	gdp	gdp
geisha	geisha	geisha
gen	gene	gene
gene	gen.	(proper noun) gene, an english first name
genesis	entstehung	(proper noun) genesis
georg	georg	(proper noun) georg
george	george	george
georges	georges	(proper noun) georges, a french name
gepard	gepard	gepard
ger	ger	ger
gerais	gerais	(proper noun) gerais
gerhard	gerhard	gerhard
german	deutsch	german
germany	deutschland	germany
gerrard	gerrard	gerrard, a last name
ghana	ghana	(proper noun) the african country of ghana
ghe	boot	canoe
ghen	eifersüchtig	to be jealous (v.)
ghi	schreibe	write
ghim	stifte	pin
ghé	hör auf	visit
ghép	transplantat	fit
ghê	ekelhaft	disgust
ghì	ghì	tighten
ghẻ	krätze	scabies (n.)
ghế	sitz	chair
ghề	stromschnellen	scabby
ghềnh	stromschnellen	waterfall (n.)
gia	gia	date
giai	bühne	period
giam	festgenommen	imprison
gian	raum	"(term should be ""thời gian"") time (n.)"
giang	giang	syphilis
gibraltar	gibraltar	(proper noun) gibraltar
gichin	gichin	gichin
gieo	säen	sow
gifu	gifu	gifu, a district in northern japan
ginzan	ginzan	ginzan
gio	gio	wind
gioi	gioi	world
giuliani	giuliani	giuliani
giun	würmer	worm
giuse	giuse	giuse
giuộc	giuoc	"entire term should be ""can giuoc""; name of a vietnamese town"
giza	gizeh	giza
già	alt	old (adj.)
giàn	fachwerk	"(term should be ""giàn hoa"") a trellis girder"
giành	gewonnen	secure
giàu	reich	rich or wealthy (adj.)
giày	schuhe	a shoe
giá	preis	estimate
giám	regisseur	"(term should be ""giám sát"") to supervise (v.)"
gián	kakerlaken	"(term should be ""gián tiếp"") indirectly"
giây	sekunden	seconds
giã	stampfen	"(term should be ""từ giã"") to say farewell to (v.)"
giãn	dehnen	stretch
gièm	kritiker	"(should be ""gièm pha"") to backstab"
giêhôva	giva	jehovah
giêng	giong	january
giêsu	jesus	jesus
giêxu	nexus	jesus
giò	frühlingsrollen	leg
giòi	maden	maggot (n.)
giòn	knusprig	crunchy or crispy (adj.)
gió	wind	wind
gióng	wie	align
giúp	hilfe	help
giũa	datei	sharpen
giơ	jammen	raise
giương	abfackeln	posture
giường	bett	bed
giả	fälschung	fake (adj.)
giải	preis	solution
giảm	reduzieren	decrease
giản	vereinfacht	"(term should be ""giản dị"") simple (adj.)"
giấc	schlafen	giấc ngủ= the sleep
giấm	essig	drabble
giấu	verstecken	hide
giấy	papier	paper
giầu	reich	rich
giận	wütend	angry
giằng	aussteifung	pull
giặc	feind	enemy
giặt	waschen	to wash (n.)
giếng	der brunnen	well
giết	töten	kill
giềng	nachbar	"(term should be ""láng giềng"") neighboring"
giễu	lächerlich machen	ridicule
giọng	akzent	tone
giọt	tropfen	drop
giỏ	korb	basket
giỏi	gut	good
giồng	giong	mound
giỗ	todestag	anniversaries of deaths
giới	geschlecht	gender
giờ	die stunde	bao giờ=ever
giở	blinken	to open or unfold (v.)
giỡn	scherz	joke
giục	gedrängt	urge
giữ	warte	hold
giữa	zwischen	between
gladys	gladys	gladys
glazer	glaser	glazer
glonass	glonass	glonass
gloria	gloria	gloria
gloster	gloster	(proper noun) gloster, as in gloster meteor
glucose	glukose	glucose
gmail	google mail	gmail
gnp	gnp	gnp
go	geh	"(term should be ""gay go"") tense"
goes	geht	goes
goku	goku	goku
golden	golden	golden
gom	sammeln	to gather (v.)
google	google	google
gorbachev	gorbatschow	gorbachev
gorbachyov	gorbachyov	gorbachev, as in former soviet president mikhail gorbachev
gordon	gordon	gordon, as in gordon brown
gore	gore	gore
gorky	gorky	gorky, as in gorky park
gothic	gotisch	gothic
gottfried	gottfried	gottfried
grabeel	grabeel	grabeel, a last name
graham	graham	graham
granada	granada	granada
granit	granit	granite
greek	griechisch	(proper noun) greek
greenland	grönland	greenland
greenson	greenson	(proper noun) greenson
greenwich	greenwich	(proper noun) greenwich
greg	greg	greg
grenada	grenada	grenada
grenadines	grenadinen	grenadines
gross	brutto	gross
grumman	grumman	(proper noun) grumman
gruzia	georgia	gruzia
gryffindor	gryffindor	gryffindor
gs	gs	prof.
gsts	gsts	professor- phd
gu	gu	gu
guam	guam	guam
guard	wache	guard
guatemala	guatemala	guatemala
gui	gui	gui
guinea	guinea	guinea
guinness	guinness	(proper noun) guinness
guitar	gitarre	guitar
gujarat	gujarat	gujarat
gulag	gulag	gulag
gulf	golf	gulf
gullit	gullit	(proper noun) gullit
gundam	gundam	(proper noun) gundam
gunung	gunung	(proper noun) gunung
gustave	gustave	gustave
gutenberg	gutenberg	gutenberg
guyana	guyana	guyana; proper noun
gà	huhn	chicken
gài	verstauen	to fasten (v.)
gào	schrie	"(term should be ""thét gào"") to cry out (v.)"
gác	wache	guard
gái	mädchen	girl
gán	zuweisen	"entire phrase should be ""gan nhan""; means ""to label"""
gánh	belastung	hold
gáy	nacken	crow
gân	sehne	tendon
gây	ursache	make
gãy	kaputt	break
gì	was	what
gìn	bewahren	preserve
gò	hügel	"(term should be ""gò má"") cheekbone (n.)"
gòn	gòn	gon
góa	witwe	widowed
góc	ecke	angle
gói	paket	goi
góp	ratenzahlung	to contribute
gót	ferse	heels
gõ	typ	type
göbbels	göbbels	gobbels, as in joseph gobbels
găm	horten	poniard
găng	handschuhe	gloves
gũi	schließen	close
gươm	schwert	sword
gương	spiegel	mirror
gạc	gaze	johnson south reef
gạo	reis	rice
gạt	abgezockt	to cheat or trick (v.)
gả	ehe	marry
gảy	gezupft	"(term should be ""âm gảy"") a type of phonetic sound found in the japanese language (n.)"
gấc	gac	gac
gấm	brokat	brocade
gấp	beeilen sie sich	times, as in many times
gấu	der bär	a bear (n.)
gần	in der nähe	near
gầy	dünn	thin
gẫy	kaputt	break
gập	falten	"(term should be ""gập ghềnh"") bumpy (adj.)"
gậy	stöcke	stick
gắm	furz	send
gắn	montiert	mount
gắng	versuche es	try
gắt	hart	intense
gặm	nagen	rodent
gặp	treffen	meet
gặt	ernten	harvest
gỉ	rostig	rust
gọi	anrufen	call
gọn	ordentlich	neat (adj.)
gọng	umrandet	gong
gọt	schälchen	cut
gỏi	salat	a vietnamese salad
gốc	wurzel	origin (n.)
gối	kissen	"(should be ""qùy gối"") to kneel"
gốm	keramik	pottery
gồm	einschließen	include
gồng	gong	carry
gỗ	holz	wood
gội	shampoo	shampoo
gộp	gepoolt	aggregate
gớm	schrecklich	tremendous
gờ	leiste	edge
gởi	senden	send
gỡ	entladen	meet
gợi	suggestiv	to evoke (v.)
gục	zusammengebrochen	"(term should be ""đánh gục"") crush, as in battle"
gừng	ingwer	ginger
gửi	gesendet	send
ha	ha	hectare
habana	habana	(proper noun) habana
habsburg	habsburg	(proper noun) habsburg
haeberle	haeberle	haeberle
hahn	hahn	hahn
hai	zwei	two (adj.)
hal	hal	hal
halle	halle	(proper noun) halle
halogen	halogen	halogen (n.)
ham	schinken	desire
hamilton	hamilton	(proper noun) hamilton
han	han	han
hang	höhle	cave
hangul	hangul	hangul
hanh	hanh	hanh
hanja	hanja	(proper noun) hanja, a type of chinese script
hansen	hansen	hasnen
hao	hao	"(term should be ""hao hụt"") to incur some loss (v.)"
harald	harald	harald
hardy	winterhart	hardy
harlem	harlem	harlem
harlow	harlow	harlow
harold	harold	(proper noun) harold
harper	harper	harper
harpercollins	harpercollins	hapercollins
harrier	harrier	harrier, as in harrier jump jet
harris	harris	harris
harry	harry	harry
harvard	harvard	(proper noun) harvard, the name of a college
harvey	harvey	harvey
havana	havanna	(proper noun) havana, cuba
havilland	havilland	havilland
hawker	straßenhändler	hawker
hawking	falken	(proper noun) hawking, as in physicist stephen hawking
hay	gut	or
hb	hb	hb
hbv	hbv	hbv
hcl	hcl	hcl
hd	hd	activity
he	er	he, a korean name
health	gesundheit	health
heath	heide	heath
hee	hee	hee
hegel	hegel	(proper noun) hegel, as in georg wilhelm friedrich hegel
heian	heian	heian
heinrich	heinrich	heinrich
helen	helen	helen
helena	helena	helena
heli	helium	helium
hematocrit	hämatokrit	hematocrit
hemoglobin	hämoglobin	hemoglobin
hen	henne	asthma
henry	henry	(proper noun) henry, as in henry kissinger
heo	schwein	dolphin
her	sie	her
herbert	herbert	herbert, as in herbert schandler
hercegovina	hercegovina	hercegovina
hercules	herkules	hercules
hermann	hermann	hermann
hermes	hermes	hermes
hersh	ihrs	hersh, as in seymour hersh
hesiod	hesiod	hesiod
hestia	hestia	hestia
hi	hallo	"(term should be ""hi vọng"") alternative spelling for ""hy vọng""; meaning ""hope"" (n.)"
hickam	hickam	(proper noun) hickam
hicks	hicks	hicks
hideto	hideto	(proper noun) hideto
hideyoshi	hideyoshi	(proper noun) hideyoshi
hidro	wasserstoff	hydrogen
hillsborough	hillsborough	hillsborough
hilton	hilton	hilton
himalaya	himalaya	(proper noun) himalaya
hinata	hinata	hinata
hindenburg	hindenburg	(proper noun) hindenburg
hindi	hindi	hindi
hindu	hindu	hindu, as in the hindu religion
hinh	hinh	(proper noun) a vietnamese first name
hinhtron	hinhtron	circle
hiragana	hiragana	hiragana
hiroshi	hiroshi	hiroshi
hiroshima	hiroshima	(proper noun) hiroshima, the japanese city
hitchcock	anhalter	hitchcock
hitler	hitler	hitler
hitter	schlagmann	hitter
hitters	schläger	hitters
hiên	veranda	(proper noun) hiên, a vietnamese first name
hiđrô	wasserstoff	hydrogen
hiếm	selten	rare
hiến	spenden	devote
hiếp	vergewaltigung	rape
hiếu	kindliche frömmigkeit	pious
hiềm	krank	grudge
hiền	salbei	sage
hiểm	gefährlich	dangerous
hiểu	verstehen	learn
hiện	auftauchen	"(term should be ""thực hiện"") to accomplish"
hiệp	halb	united
hiệu	wirkung	effective
hlv	trainer	trainer
hms	hms	hms
hmông	hmong	hmong
hn	hn	hn
hoa	blume	flower
hoan	festival	welcome
hogwarts	hogwarts	(proper noun) hogwarts, sorcery school from the harry potter series
hoi	hoi	rare
hokage	hokage	hokage
hokusai	hokusai	hokusai
holmes	holmes	a name
holocaust	holocaust	holocause
holocen	holozän	holocen
holt	holt	holt, an english last name
hom	stecklinge	a cutting
homer	homer	(proper noun) homer, the authorof the iliad and the odyssey
hon	hon	"(term should be ""hòn"") rock (n.)"
honduras	honduras	honduras
hong	hong	hong
honolulu	honolulu	honolulu
honshū	honshū	honshu
hopkins	hopkins	(proper noun) hopkins
hornet	hornisse	hornet
hotspur	hotspur	(proper noun) hotspur, as in tottenham hotspur
houston	houston	(proper noun) houston, as in whitney houston
howard	howard	(proper noun) howard
however	jedoch	however
hoà	krawatte	peace
hoài	nostalgisch	always (adv.)
hoàn	vollständig	"(term should be ""hoàn toàn"") completely"
hoàng	königlich	royal (adj.)
hoành	membran	rife
hoá	chemie	"(term should be ""văn hoá"") culture (n.)"
hoán	perm	refined (adj.)
hoãn	verschieben	delay
hoạ	malen	disaster (tham hoa)
hoại	brandwunde	"(term should be ""phá hoại"") to sabotage (v.)"
hoạt	hentai	work
hoả	feuer	of
hoảng	panik	panic-stricken (adj.)
hoặc	oder	or
hp	hp	hp
hq	hq	hq
hudgens	hudgens	(proper noun) hudgens
hudson	hudson	hudson
huey	huey	huey
hughes	hughes	hughes
hugo	hugo	(proper noun) hugo
hume	hume	hume, as in david hume
hun	hun	(proper noun) hun
hungary	ungarn	hungary
hunt	jagen	hunt
hurley	hurley	(proper noun) hurley, as in chad hurley
hussein	hussein	hussein
husserl	husserl	huserl
huston	houston	huston
hutech	hutech	hutech
huy	huy	a common vietnamese first name
huynh	bruder	older brother
huyền	mystisch	huyền thoại= legend
huyễn	illusorisch	huyen
huyện	bezirk	district
huyệt	akupunkturpunkte	lair
huân	huan	"(term should be ""huân chương"") medal (n.)"
huê	farbton	"a less common vietnamese word for ""flower"""
huấn	ausbildung	"(term should be ""huận luyện"") to train (v.)"
huế	farbton	hue
huệ	farbton	favour
huống	fall	situation
huỳnh	schwefel	sulfur
huỷ	abbrechen	destroy
hydra	hydra	hydra, a monster in greek mythology
hydro	wasserstoff	hydrogen
hyperion	hyperion	hyperion
hà	ha	"(term should be ""hà nội"") the capital of vietnam"
hài	komödie	corpse
hàm	funktion	"(term should be ""bao hàm"") to imply (v.)"
hàng	waren	row
hào	wassergraben	depreciation
hách	anmaßend	glorious
hái	pflücken	picking
hán	dürre	china
háo	eifrig	eager
hát	singen	song
hâm	verrückt	"(term should be ""hâm mộ"") to admire (v.)"
hân	han	le ngoc han
hãi	angst	to be scared (v.)
hãn	khan	to sweat (v.)
hãng	fest	a company (n.)
hãnh	stolz	proud
hè	sommer	summer
hé	geknackt	reveal
héo	welken	dried-out
hét	schrie	shout
hên	glück	luck
hí	ne	game
hít	einatmen	act of kissing (hon hit)
hò	dating	date
hòa	krawatte	republic
hòe	scheiße	hoe
hòm	arche	box
hòn	insel	island
hòng	gut	in order to
hóc	hóc	a corner (n.)
hót	singen	to chirp or sing (v.)
hô	ho	respiration
hôi	foul	stink
hôm	tag	day (n.)
hôn	kuss	propose
hông	hüften	hip
hù	erschrecken	threaten
hùng	helden	hero
húc	stoßen	huc
húng	basilikum	"(should be ""húng láng"") water mint"
hút	rauchen	to suck (v.)
hăng	scharf	enthusiasm
hđbt	hđbt	hdbt
hđh	hđh	system software
hũ	gläser	jar
hơi	leicht	slightly
hơn	mehr	more or less
hư	ungezogen	fictional
hưu	im ruhestand	huu
hương	weihrauch	smell
hước	humorvoll	humor
hướng	richtung	trend
hường	huong	huong
hưởng	genießen	influence
hạ	niedriger	lower
hạc	kran	crane
hạch	ganglion	ganglion
hại	schaden	harm
hạng	rang	rank
hạnh	hanh	happy
hạo	hao	hao
hạp	hap	hap
hạt	perlen	seed
hải	zoll	two
hảo	perfekt	perfect
hấn	han	aggressive gesture
hất	schleudern	toss
hấu	wassermelone	"(term should be ""dưa hấu"") watermelon"
hầm	eintopf	ham
hầu	fast	most
hận	hass	hatred
hậu	hau	anus
hắc	schwarz	black
hắn	ihn	he (n.)
hắt	niesen	reject
hằng	konstant	every
hặc	hặc	to criticize (v.)
hẹ	schalotten	chinese chives
hẹp	schmal	narrow
hẻm	gasse	alley (n.)
hẻo	abgelegen	outback
hến	muscheln	mussel
hết	vorbei	most
hề	clown	"(term should be ""không hề"") never"
hễ	eh	whenever
hệ	system	relation
hệt	identisch	exactly
hỉ	hei	happy
hịch	thud	a proclamation
họ	sie	they (n.)
họa	kunst	picture
họach	planen	"(term should be ""quy hoạch"") a project (n.)"
học	lernen	study (v.)
họng	hals	throat
họp	treffen	meet
hỏa	feuer	fire
hỏng	kaputt	corruption
hố	grube	hole
hốc	nischen	cavity
hồ	see	ho
hồi	anis	muslim
hồn	seele	soul
hổ	tiger	tiger
hổi	huh	"(term should be ""nóng hổi"") steaming hot (adj.)"
hổng	klaffend	hole
hỗ	unterstützung	"(should be ""hỗ trợ"") to support or assist"
hỗn	gemischt	"(term should be ""hỗn tạp"") mish-mash (adj.)"
hội	montage	society
hộp	box	box
hới	offen	hoi
hớn	schrie	"(term should be ""hớn hở"") radiant (adj.)"
hờn	mürrisch	hatred
hở	offen	reveal
hỡi	oi	dear
hợi	schwein	pig (n.)
hợp	geeignet	appropriate
hợpquận	zustimmung	general district
hụt	verpasst	loss
hủi	aussätziger	reject
hủy	abbrechen	to erase or destroy
hứa	versprechen	promise
hử	huh	hu
hửu	huh	"(term should be ""sở hửu"") to own (v.)"
hữu	eigentum	(proper noun) hữu, a vietnamese middle name; also means right, as in the direction
hựu	huu	again
hỷ	hy	hy
ian	ian	ian, as in australian swimmer ian thorpe
iau	iau	iau
iberia	iberia	iberia
ibm	ibm	(proper noun) ibm, the computer company
ibmpc	ibmpc	ibm-pc
ic	ic	ic
icc	icc	icc
iceland	island	(proper noun) the country of iceland
ide	ide	ide
ieng	ieng	(proper noun) ieng
igor	igor	igor
iii	iii	third
ilene	ilene	ilence
illusion	illusion	illusion
ilyich	ilyich	ilyich
im	im	still
imam	imam	(proper noun) imam
imbrium	imbrium	imbriun
immanuel	immanuel	(proper noun) immanuel, as in immanuel kant
impact	auswirkungen	impact
incoterm	incoterm	incoterm
incoterms	incoterms	(proper noun) incoterms
indian	indisch	indian
indiana	indiana	indiana
indochina	indochina	indochina
indonesia	indonesien	indonesia
indrapura	indrapura	(proper noun) indrapura
info	info	info
innsbruck	innsbruck	innsbruck
insulin	insulin	insulin
int	int	int
intel	intel	(proper noun) intel, as in the name of the company
interpol	interpol	interpol
inu	inu	(proper noun) inu
inuyasha	inuyasha	inuyasha
inư	inu	(proper noun) inư
io	io	io
ioc	ioc	ioc
ion	ion	ion
iosif	iosif	(proper noun) iosif, as in iosif vissarionovich stalin
iran	iran	the nation of iran
iraq	irak	iraq
ireland	irland	ireland
irgun	irgun	irgun
irony	ironie	irony
irving	irving	(proper noun) irving
isaac	isaac	isaac
isla	isla	isla
islam	islam	islam
islamabad	islamabad	(proper noun) islamabad
israeli	israelisch	israeli
istanbul	istanbul	istabbul
italia	italien	italy
italiano	italiano	(proper noun) italiano
itanium	itanium	itanium, as in windows xp itanium
ito	ito	ito
itsukushima	itsukushima	itsukushima
itu	itu	itu
itzá	itzá	(proper noun) itzá
iv	iv	4 ( greek number)
iwami	iwami	iwami
j	j	j
jack	jack	jack
jackie	jackie	(proper noun) jackie chan
jackson	jackson	(proper noun) jackson, as in michael jackson
jacob	jacob	jacob
jae	jae	jae
jakarta	jakarta	(proper noun) jakarta
jan	jan	(proper noun) jan
janeiro	janeiro	janeiro
janet	janet	janet
japan	japan	japan
jared	jared	jared
jarvis	jarvis	(proper noun) jarvis, as in jarvis cocker
jasper	jaspis	(proper noun) jasper
jean	jean	jean
jeane	jeane	jeane
jeanjacques	jeanjacques	jean-jacques
jeanpaul	jeanpaul	jeanpaul
jeans	jeans	jeans
jeet	jeet	(proper noun) jeet, as in jeet kune do
jeff	jeff	jeff, as in jeff drake
jefferson	jefferson	jefferson
jeffrey	jeffrey	jeffrey
jeju	jeju	jeju
jenda	jenda	jenda
jenny	jenny	jenny
jericho	jericho	jericho, as in wrestler chris jericho
jerome	jerome	jerome, as in fred jerome
jerry	jerry	(proper noun) jerry
jersey	trikot	jersey
jerusalem	jerusalem	jerusalem
jesse	jesse	a name
jesus	jesus	chua jesus
jetstar	jetstar	jetstar
jewish	jüdisch	jewish
jiao	jiao	jiao
jimmy	jimmy	jimmy
jin	jin	jin
jing	jing	jing
jiraiya	jiraiya	(proper noun) jiraiya
joachim	joachim	joachin
joan	joan	a name
joe	joe	(proper noun) joe
johan	johan	johan
johann	johann	johann
johannes	johannes	johannes
johannesburg	johannesburg	(proper noun) johannesburg, south africa
johnny	johnny	johnny
johns	johns	johns
johnston	johnston	johnston, as in harry johnston
johor	johor	johor
joint	gelenk	joint
jonathan	jonathan	(proper noun) jonathan
jones	jones	jones
jose	jose	(proper noun) jose, a spanish first name
joseon	joseon	(proper noun) joseon
joseph	joseph	joseph
jscript	jscript	(proper noun) jscript
juche	juche	(proper noun) juche
judith	judith	judith
judo	judo	judo, the martial art
julesverne	julesverne	jules verne
julliard	julliard	(proper noun) julliard
jump	springen	jump
june	juni	june, as in the month
jung	jung	jung
junsu	junsu	junsu
jupiter	jupiter	(proper noun) jupiter, as in the planet
jura	jura	(proper noun) jura
juventus	juventus	juventus
k	k	k
kaede	kaede	a japanese name
kaffee	kaffee	(proper noun) kaffee, as in kaffee hag
kagome	kagome	kagome, as in higurashi kagome
kahn	kahn	kahn
kai	kai	kai
kakashi	kakashi	kakashi
kaká	kaká	(proper noun) kaka, a brazilian soccer player
kalashnikov	kalaschnikow	(proper noun) kalashnikov
kali	kalium	potassium
kama	kama	(proper noun) kama, as in the kama sutra
kamakura	kamakura	kamakura
kamov	kamov	kamov
kampf	kampf	kampf
kampong	kampong	kampong
kampuchea	kampuchea	cambodian
kana	kana	kana, the japanese phonetic alphabet
kangin	kangin	(proper noun) kangin
kanji	kanji	kanji
kant	kant	a name
kar	kar	(proper noun) kar
kara	kara	kara
karaoke	karaoke	karaoke
karate	karate	karate
karatedo	karatedo	karatedo
karen	karen	(proper noun) karen
karim	karim	(proper noun) karim
kashmir	kaschmir	kashmir
kaspersky	kaspersky	(proper noun) kaspersky, as in kaspersky anti-virus software
katakana	katakana	katakana, a type of japanese script
kate	kate	(proper noun) kate, as in actress kate winslet
katherine	katherine	katherine
kathmandu	kathmandu	kathmandu
katrina	katrina	(proper noun) katrina, as in hurricane katrina
katz	katz	katz
kauthara	kauthara	kauthara, a part of the ancient kingdom of champa
kavkaz	kaukasus	kavkaz
kawasaki	kawasaki	(proper noun) kawasaki
kay	kay	kay
kazan	kazan	kazan, the name of a city
kcn	kcn	industrial zone
ke	ke	"(term should be ""boong ke"") a bunker (n.)"
kelly	kelly	kelly
kelsi	kelsi	kelsi
kelvin	kelvin	kelvin
kem	eis	ice cream (n.)
ken	ken	ken
kennedy	kennedy	(proper noun) kennedy, as in john f. kennedy
kenneth	kenneth	(proper noun) kenneth, a name
kenny	kenny	kenny, an english first name
kentucky	kentucky	(proper noun) kentucky
kepler	kepler	kepler
kerala	kerala	(proper noun) kerala
kevin	kevin	kenvin
keynes	keynes	keynes, as in economist john maynard keynes
kg	kg	kilogram
kha	kha	(proper noun) a vietnamese first name
khai	erklärung	announce
khali	khali	(proper noun) khali
khalip	khalip	(proper noun) khalip
kham	kham	endure
khan	wasserfrei	rare
khang	khang	khang
khanh	khanh	khanh
khao	sehnsucht	desire
khay	tablett	tray
khe	steckplatz	chink
khem	khem	abstinence
khen	kompliment	praise
kheo	auf stelzen	kheo
khi	wann	when
khieu	khieu	(proper noun) khieu, as in khieu samphan
khiêm	bescheiden	khiem
khiên	schild	a shield
khiêu	erotisch	"('khiêu dâm"") pornographic"
khiếm	beeinträchtigt	lack
khiến	ursache	control
khiếp	erschrocken	horrible
khiếu	lodge	talent (n.)
khiển	kontrolle	control
khleang	khleang	kh'leang
kho	lager	warehouse
khoa	fakultät	"(term should be ""y khoa"") the study of medicine (n.)"
khoan	bohren	drill
khoang	hohlraum	brag
khoanh	klingeln	a slice (n.)
khoe	vorführen	to boast
khoá	schloss	lock
khoác	mantel	coat
khoán	lager	stock
khoáng	mineral	mineral
khoát	endgültig	decisive
khoét	schneiden	carve
khoăn	bund	disturbed
khoả	nackt	naked
khoản	artikel	an item (n.)
khoảng	ca.	about
khoảnh	momente	moment
khoẻ	gut	health
khrushchev	chruschtschow	khrushchev
khrushchyov	chruschtschow	khrushchyov
khu	viertel	section
khung	rahmen	frame
khural	khural	khural
khuynh	links	trend
khuyên	beratung	advise
khuyết	defekt	lack
khuyển	hund	khuyen
khuất	versteckt	hidden
khuấy	rühren	stir
khuẩn	bakterien	bacteria
khuếch	verstärken	amplification
khuỷu	ellbogen	elbow
khá	hübsch	quite
khác	andere	different
khách	gäste	customer
khái	konzeptionell	concept
khám	prüfung	discover
khán	das publikum	audience
kháng	widerstand	appeal
khánh	unabhängigkeit	a type of chime made of stone (n.)
khát	durstig	to be thirsty for (adj.)
khâm	khâm	admire
khèn	leider	a pan-pipe (n.)
khéo	genial	cleverly or skillfully (adv.)
khép	geschlossen	close
khía	kerbe	"(term should be ""khía cạnh"") angle (n.)"
khích	ermutigung	encourage
khít	eng	close
khó	schwer	difficulty
khóa	schloss	a session
khóc	weinen	cry
khói	rauch	smoke
khóm	ananas	a cluster
khô	trocken	dry
khôn	weise	clever, intelligent
không	nein	not
khúc	lied	song
khăm	streich	nasty (adj.)
khăn	handtuch	difficult
khơi	offshore	sea
khư	khư	grip
khưu	khưu	khuu
khước	leugnen	waive
khả	möglichkeit	"(term should be ""khả năng"") ability (n.)"
khải	offenbarung	triumph
khảm	mosaik	to encrust
khảo	prüfung	"(term should be ""tham khảo"") to consult (v.)"
khấm	durchbohrt	endure
khấn	bete	pray
khấu	rabatt	"(term should be ""sân khấu"") a stage (n.)"
khẩn	dringend	"(term should be ""khẩn cấp"") urgent (adj.)"
khắc	gravur	moment
khắp	überall	all over
khẳng	bejahend	"(term should be ""khẳng định"") to assert (v.)"
khế	sternfrucht	bond
khỉ	affe	monkey or ape (n.)
khỏa	nackt	nude
khỏe	gut	health
khỏi	aus	leave
khố	lendenschurz	loincloths
khốc	schrecklich	devastating
khối	block	a block or mass of (n.)
khốn	bastard	miserable
khống	khong	control
khổ	leiden	miserable (adj.)
khổng	riese	huge
khởi	initiiert	start
khủng	schrecklich	"(term should be ""khủng bố"") terrorist (n.)"
khủyu	bastard	elbow
khứu	pastell	olfactory
khử	beseitigen	reduction
ki	ki	"entire phrase is ""ki lo""; means ""kilometer"""
kia	dort	other
kid	kind	kid
kiel	kiel	(proper noun) kiel
kierkegaard	kierkegaard	kierkegaard, as in soren kierkegaard
kiernan	kiernan	kiernan
kii	kii	kii
kikyo	kikyo	kikyo
kilômét	kilometer	kilometer
kim	nadel	kim
kingdom	königreich	kingdom
kinsey	kinsey	kisney
kiribati	kiribati	kiribati
kishimoto	kishimoto	(proper noun) kishimoto
kiss	kuss	kiss
kissinger	kissinger	kissinger
kitts	kätzchen	kitts
kitô	christus	christian
kiêm	cum	cum
kiên	patient	consistent
kiêng	sich enthalten	abstinence, as in abstaining from eating
kiêu	arrogant	showy
kiếp	lebenszeit	a lifetime (n.)
kiết	fesseln	cheap (adj.)
kiềm	alkalisch	"(term should be ""kiềm chế"") to restrain (v.)"
kiểm	überprüfen	control
kiểu	typ	type
kiệm	wirtschaftlich	save
kiện	sue	event (su kien)
kiệt	meisterwerk	exhausted (adv.)
kiệu	sänfte	scallion
klaus	klaus	klaus
klein	klein	klein
km	km	kilometer
knesset	knesset	knesset
knuth	knuth	knuth, as in donald knuth
koch	koch	koch
kodansha	kodansha	kodansha
kofun	kofun	kofun, as in the kofun period of japanese history
kogoro	kogoro	kogoro
komodo	komodo	komodo
kon	kon	"(term should be ""kon tum"") a province in the highlands of vietnam"
kong	kong	(proper noun) kong, as in hong kong
konstantin	konstantin	(proper noun) konstantin
konversationslexikon	konversationslexikon	konversation-lexikon
kop	kop	kop
koran	koran	koran
kornai	kornai	(proper noun) kornai, as in janos kornai
koruna	koruna	koruna
kosovo	kosovo	(proper noun) kosovo
kremli	kremli	kremil
kremlin	kreml	kremlin
kristen	kristen	kristen
krông	krong	krong
ku	ku	is a name
kuala	kuala	(proper noun) kuala, as in kuala lumpur
kubrick	kubrick	kubrick
kuen	kuen	kuen
kuiper	kuiper	(proper noun) kuiper, as in the kuiper belt
kulak	kulak	kulak
kune	kune	(proper noun) kune, as in the martial art jeet kune do
kung	kung	danh vo
kungfu	kung fu	kung fu
kunst	kunst	kunst, as in richard kunst
kurd	kurd	kurd
kurt	kurt	(proper noun) kurt
kuwait	kuwait	kuwait, the country (n.)
kwan	kwan	kwan
kwen	kwen	kwen
kwon	kwon	kwon, as in tae kwon do; proper noun
kyrgyzstan	kyrinkistan	(proper noun) the country of kyrgyzstan
kyushu	kyushu	kyushu
kyūshū	kyūshū	kyushu, a japanese island
kèm	beigefügt	included
kèn	trompete	horn
kém	arm	less
kén	kokon	selective
kéo	ziehen	scissors
kép	dual	dual
két	sicher	"(term should be ""rốc két"") rocket (n.)"
kê	hirse	statistics
kênh	kanal	channel
kêu	weinte	appeal
kìa	siehe,	that
kìm	zangen	bar
kình	brille	rivalry
kí	zeichen	sign
kích	klicken sie auf	excite
kíchbom	klick-taste	bombers
kín	privat	secretive or closed tight (adj.)
kính	glas	respect
kíp	besatzung	esoterica
kít	kit	wheelbarrow
ký	unterschrieben	"(""nhật ký"") a diary"
kĩ	vorsichtig	technique
kơnia	kàia	a tree found in southeast asia; sometimes called wild mango
kạn	kan	kan
kẹo	süßigkeiten	candy
kẹp	klemme	to clamp down (v.)
kẹt	stecken	jam
kẻ	jungs	guy
kẻo	damit nicht	lest
kẽ	interstitial	crevice
kẽm	zink	zinc
kế	als nächstes	a scheme (n.)
kết	ende	combine
kề	benachbart	adjacent
kềnh	sperrig	bulky
kệ	regale	ignore
kỉ	jahrhundert	"(term should be ""kỉ niệm"") souvenir (n.)"
kị	kavallerie	ki
kịp	rechtzeitig	kip
kỵ	kavallerie	taboo
kỷ	jahrhundert	"(term should be ""thế kỷ"") century (n.)"
l	l	l.
label	etikett	label
laboulaye	laboulaye	a name
ladakh	ladakh	(proper noun) ladakh
lai	hybrid	"(term should be ""tương lai"") the future (n.)"
lam	lam	lam
lama	lama	a name
lan	lan	a name
land	land	land
landon	landon	a name
lang	lang	lang
langdon	langdon	langdon
lange	lange	lange, as in oscar lange
langue	sprache	langue
lanh	leinen	ringing
lanka	lanka	(proper noun) lanka, as in the island of sri lanka
lao	tb	labor
laos	laos	(proper noun) laos
lap	runde	greek
larry	larry	larry
lars	lars	lars
las	las	(proper noun) las, as in las vegas
laser	laser	laser
lateran	lateran	lateran
latinh	latein	latin
latvia	lettland	(proper noun) latvia
lau	wischen	lau
laura	laura	(proper noun) laura, as in laura bush
laurence	laurence	(proper noun) laurence
lawrence	lawrence	(proper noun) lawrence
lay	lag	lay
lazarus	lazarus	(proper noun) lazarus
leach	auslaugen	(proper noun) leach
leaf	blatt	leaf
leave	geh	leave
lebanon	libanon	(proper noun) lebanon
lee	lee	lee
legacy	vermächtnis	legacy
leiden	leiden	leiden
lem	lem	cinderella
lenin	lenin	lenin
lenins	lenine	lenin's
leo	klettern	climb
leon	leon	leon
leonard	leonard	leonard
leonardo	leonardo	(proper noun) leonardo, as in leonardo da vinci
leonid	leonid	leonid
les	les	les
leslie	leslie	a name
lesotho	lesotho	lesotho
lg	lg	lg
lhp	lhp	film festival
lhq	lhq	un
libby	libby	(proper noun) libby
libero	libero	libero
libya	libyen	libya
lido	lido	lido
liechtenstein	liechtenstein	liechtenstein
liga	liga	a name
lightning	blitz	lightning
lilly	lilly	(proper noun) lilly
linga	linga	linga
linh	linh	efficacious (adj.)
links	links	links
linux	linux	linux server
lionel	löwe	lionel
lisboa	lisboa	lisboa
lisbon	lissabon	a name
litva	litauen	(proper noun) lithuania
liu	liu	liu
liêm	integrität	good example
liên	venture	relate
liêng	heilig	sacred
liêu	bürokratie	bureaucracy
liềm	sichel	sickle
liều	dosis	daring
liễu	weide	a willow tree (n.)
liệng	werfen	"(term should be ""cánh liệng"") the aileron of a plane (n.)"
liệt	lähmung	impotent
liệu	roh	document
lleyton	lleyton	lleyton
lo	siehe da	to worry (v.)
loa	lautsprecher	"(term should be ""cổ loa"") an ancient vietnamese city (proper noun)"
loaita	loaita	loaita
loang	glatt	patchy
loch	loch	loch
locke	locke	(proper noun) locke, as in philosopher john locke
lockheed	lockheed	(proper noun) lockheed, as in lockheed martin
log	log	log
logan	logan	a name
lon	dosen	lon
london	london	london
long	lang	dragon
lorenzo	lorenzo	lorenzo
los	los	los, as in los angeles
louis	louis	louis
louisiana	louisiana	(proper noun) the state of louisiana
louvre	jalousie	(proper noun) louvre
love	liebe	yeu
loài	arten	species
loát	auffällig	overturn
loãng	dünn	wishy-washy
loét	geschwür	gaping, as in a wound
loại	typ	type
loạianh	typ	not a word
loạianime	typ anime	type anime
loạibệnh	art der krankheit	disease
loạichiến	typ	loaichien
loạicác	typ	item
loạicâu	typ	type: club
loạicông	typ	type: industry
loạicựu	typ	kind former
loạigia	typ	loaigia
loạihuân	kindhuan	not a word
loạiluật	art des gesetzes	type: law
loạimáy	maschinentyp	kind plane
loạimôn	typ	type
loạingày	geben sie dies ein	loaingay
loạiphim	filmtyp	type movie
loạiphong	typ	kind of movement
loạiscandal	typ	scandal type
loạithuật	art des gesetzes	type: lexicon
loạithành	typ	kinds of payment
loạithần	typ	kind myth
loạitrường	art der schule	type of school
loạitín	art	type: belief
loạitổ	typ	kind organization
loạivõ	art von	type: martial art
loạixã	typ	kind of society
loạn	störung	disorderly
loạt	serie	series
lp	lp	lp
lu	lu	dim
luang	luang	a name
lucas	lucas	(proper noun) lucas
lucia	lucia	lucia, as in the island of saint lucia
luciano	luciano	luciano
ludendorff	ludendorff	luđenorff
ludovico	ludovico	ludovico
ludwig	ludwig	ludwig
lui	zurück	withdrawal
luis	luis	(proper noun) luis, a first name
luiz	luiz	luiz
lula	lula	lula
lung	lunge	shake
lustig	lustig	lusig
luther	luther	luther
luxembourg	luxemburg	a name
luy	luy	luy
luyến	anhang	love
luyện	üben	training
luận	kommentar	"(term should be ""xã luận"") an editorial"
luật	das gesetz	law
luồn	gewinde	wriggle
luồng	stream	lane
luộc	gekocht	boiled
luỹ	kumulativ	rampart (n.)
ly	ly	divorce
lydia	lydia	lydia
lympho	lymphom	lymphocyte
lyndon	lyndon	lyndon
lyon	lyon	lyon
là	ist	the verb to be
làm	tun	make
làn	spur	wave
làng	dorf	village
lành	geheilt	protestant
lào	laos	laos
lá	blätter	"(term should be ""lá thư"") a letter (n.)"
lác	schielen	brag
lách	milz	to swerve (v.)
lái	fahren	to drive (v.)
lán	hütte	shack
láng	glatt	neighbours
lâm	lam	lâm, a common vietnamese first name
lân	einhorn	nearby
lâu	lang	long time
lây	ansteckend	to infect
lãi	interesse	a profit
lãm	zeigt	exhibition
lãnh	erhalten	to receive
lão	alt	old
lèo	lèo	"(term should be ""nước lèo"") broth (n.)"
lén	schleichen	sneak
lê	birnen	le
lêmạc	licht	"(term should be ""lê-mạc"") a war between two ruling families in ancient vietnamese history"
lên	auf	on
lênh	befehl	"(should be ""lênh đênh"") adrift"
lênin	lenin	lenin
lìa	geh	to leave (v.)
lình	plötzlich	suddenly
lí	lagerung	reason
lính	soldat	soldier
lít	liter	litre
líu	gurren	"(term should be ""dính líu"") to have a connection with"
lò	ofen	release
lòng	zerquetschen	heart
lóc	schlangenkopf	cry
lóe	blitzte	flash
lóng	slang	"entire term should be ""tieng long""; means ""slang"""
lót	futter	undies
lô	viel	batch
lôi	fehler	encourage
lôn	lol	"(term should be ""côn lôn"") a village in vietnam"
lông	fell	hair
lõi	kern	core
lõm	konkav	concave
lùi	rückwärts	back
lùn	zwerg	dwarf
lùng	jagen	hunt
lúa	reis	rice
lúc	bei	at the moment
lún	senkung	subside
lúng	fackel	confused
lúp	vergrößerung	uneven
lút	hinterhältig	surreptitiously
lăm	fünf	tens
lăn	rollen	attack
lăng	mausoleum	tomb
lĩnh	domänen	"(term should be ""thủ lĩnh"") the leader (n.)"
lũ	flut	a band or gang (n.)
lũng	tal	valley
lũy	kumulativ	rampart
lơ	vernachlässigen	to ignore
lơi	lockern	"(term should be ""lả lơi"") to act in a familiar or flirting manner (adv.)"
lư	räuchergefäß	an urn
lưng	zurück	back
lươn	aal	eel
lương	gehalt	conscience
lưới	gitter	a net (n.)
lướt	surfen	ski
lười	faul	lazy
lưỡi	zunge	tongue
lưỡng	bisexuell	"(term should be ""lưỡng tính"") bisexual"
lược	kamm	invasion
lượm	abholen	pick up
lượn	gleiten	to glide over (v.)
lǐ	lǐ	(proper noun) li, as in jet li
lạ	seltsam	strange or unusual (adj.)
lạc	verloren	camel
lạch	bach	"(term should be ""luồng lạch"") a narrow water passageway"
lại	wieder	reversed
lạn	faul	bright
lạng	lang	lang
lạp	wurst	"(term should be ""hy lạp"") greek"
lạtma	lamma	lama
lạy	niederwerfen	kowtow
lấn	eingriff	to encroach on (v.)
lấp	füllen	sparkle
lấy	genommen	taken
lầm	falsch	wrong
lần	mal	time
lầu	boden	a story or level of a building (n.)
lầy	sumpfig	swamp
lẩu	hotpot	hotpot
lẩy	springen	get
lẫn	verwirrt	each other
lẫy	prise	illustrious
lận	betrügen	fraudulent
lật	flip	turn
lậy	oh ja	"(term should be ""cai lậy"") the name of a rural district"
lắc	schütteln	to shake (v.)
lắm	sehr	do
lắng	sich niederlassen	"(should be ""lo lắ́́ng"") to worry"
lắp	passend	lap
lặng	still	quiet
lặp	wiederholen	repeat
lặt	verschiedenes	means miscellaneous, part of the word lat vat
lẹ	schnell	quickly (adv.)
lẻ	seltsam	"(the term should be ""bán lẻ"") retail"
lẻn	schleichen	sneak
lẻo	lax	climb
lề	marge	alignment
lều	zelt	tent
lễ	zeremonie	ceremony
lệ	rate	"(term should be ""tỷ lệ"") probability (n.)"
lệch	schief	difference
lệnh	der befehl	command
lị	ruhr	"(term should be ""tỉnh lị"") a township (n.)"
lịch	kalender	history
lọc	filter	tricked
lọi	schielen	brilliant
lọng	sonnenschirme	rope
lọt	fallen	enter
lỏi	flusen	to enter
lỏng	locker	loose
lố	vorbei	ridiculous
lốc	wirbelwind	tornado
lối	eingang	way or path
lốp	reifen	tyre
lốt	verkleidung	lolot
lồ	riese	giant
lồi	konvex	convex
lồng	käfig	cage
lỗ	loch	hole
lộc	glück	loc
lội	waten	wade
lộn	umgedreht	wrong/mistake
lộng	wunderschön	"(term should be ""cổ lộng"") the name of a vietnamese city"
lột	schälen	exploit
lớn	groß	large
lớp	klasse	grade (n.)
lờ	ignorieren	turbid
lời	wort	advice
lở	wunden	to crack
lỡ	fräulein	miss
lợi	nutzen	benefit
lợn	schweine	pig
lợp	überdachung	roof
lụa	seide	silk
lục	grün	record
lụi	niedergebrannt	ruin
lụt	flut	flood
lụy	implikationen	consequence
lứa	müll	peer
lừa	trick	mislead
lừng	berühmt	well-known
lửng	dachs	lơ lửng= not clear/ something in between
lự	zögernd	reluctant
lựa	ausgewählt	chosen
lựu	granatapfel	grenade
ma	geist	ma sat (friction), ma thuat (magic), thay ma (zombie)
maastricht	maastricht	maastricht
macarthur	macarthur	macarthur
macclesfield	macclesfield	macclesfield
macedonia	mazedonien	(proper noun) macedonia
mach	mach	mach
machiavelli	machiavelli	machiavelli, as in philosopher niccolo machiavelli
machu	machu	machu
macintosh	macintosh	macintosh
macma	magma	magma
macromedia	makromedie	macromedia
madeira	madeira	madeira
madhouse	irrenhaus	madhouse
madison	madison	madison
madonna	madonna	(proper noun) madonna
madrid	madrid	madrid, as in the capital of spain
mafia	mafia	mafia
magiê	magnesium	magnesium
mahal	mahal	(proper noun) mahal, as in the taj mahal
mai	morgen	"(term should be ""giang mai"") the disease syphilis (n.)"
mainframe	mainframe	mainframe
major	hauptfach	major
makemake	makemake	makemake
malacca	malakka	malacca
malay	malaiisch	malaysia
malaysia	malaysia	(proper noun) the country of malaysia
malcolm	malcolm	malcolm
maldini	maledini	maldini
mali	mali	mai
malta	malta	malta
maluku	maluku	maluku
manche	manche	manche
manchester	manchester	manchester
mandela	mandela	mandela, as in nelson mandela
mandy	mandy	mandy
mang	lager	to bring (v.)
manga	manga	manga
mangnall	mangnall	(proper noun) mangnall, as in ernest mangnall
manh	manh	fragile
manila	manila	manila, the capital of the philippines
mankiw	mankiw	mankiw, as in gregory mankiw
manti	manti	mantle
manuel	manuel	manuel
mao	mao	capillary
maps	karten	maps
maradona	maradona	(proper noun) maradona, as in soccer player diego maradona of argentina
marat	marat	(proper noun) marat, as in marat safin, a tennis player
marc	marc	marc, as in marc chagall
marcel	marcel	(proper noun) marcel, a french name
marcos	marcos	(proper noun) marcos, as in ferdinand marcos
marcus	marcus	marcus, as in marcus aurelius (n.)
margaret	margaret	(proper noun) margaret
maria	maria	(proper noun) maria
marianne	marianne	(proper noun) marianne
marie	marie	marie
marina	yachthafen	marina
marino	marino	marino
marić	marić	maric
marmara	marma	(proper noun) marmara, as in the sea of marmara
marne	marne	marne, as in the marne river (n.)
mars	mars	mars
marseille	marseille	marseille
marshall	marshall	marshall
marsu	marsu	(proper noun) marsu
marta	marta	(proper noun) marta, as in the female brazilian soccer player
martin	martin	martin
marx	marx	this is a name
mary	mary	(proper noun) mary
maryland	maryland	a name
maría	maría	maria
mas	mas	mas
massachusetts	massachusetts	massachusetts
mat	mat	mat
mathematica	mathematica	(proper noun) mathematica, as in isaac newton's work, principia mathematica
mats	matten	mats, as in mats sundin
matthias	matthias	matthias, as in matthias erzberger
mau	schnell	fast
maurice	maurice	(proper noun) maurice
mausolus	mausolus	mausolus
maxim	maxime	a name
may	nähen	lucky
maya	maya	(proper noun) maya
mcafee	mcafee	(proper noun) mcafee
mccain	mccain	mccain
mccartney	mccartney	a name
mccullough	mccullough	mccullough
mcdonald	mcdonald	(proper noun) mcdonald
mchc	mchc	mchc
mclaren	mclaren	mclaren
mcmahon	mcmahon	(proper noun) mcmahon
mcnamara	mcnamara	(proper noun) mcnamara, as in robert mcnamara
mcv	mcv	mean corpuscular volume
media	medien	media
medici	medici	(proper noun) medici, as in the medici family of italy
medina	medina	(proper noun) medina, as in ernest medina
medvedev	medwedew	medvedev
mekong	mekong	mekong
melbourne	melbourne	melbourne
mendeleev	mendeleev	mendeleev
menes	menes	(proper noun) menes
mercedes	mercedes	a name
messenger	bote	messanger
messerschmitt	messerschmitt	messerschmitt, as in the messerschmitt me-109, a german plane
messi	messi	(proper noun) messi, as in argentinian soccer player lionel messi
messiah	messias	messiah
meteora	meteora	meteora
mext	mext	mext
meyer	meyer	(proper noun) meyer, as in stephenie meyer, author of the twilight series
meyers	meyers	meyers
miami	miami	a name
michael	michael	michael
michaels	michaels	michaels
michelangelo	michelangelo	michelangelo
michigan	michigan	a name
micro	mikrofon	micro
microbiology	mikrobiologie	microbiology
microeconomics	mikroökonomie	microeconomics
micronesia	mikronesien	micronesia
microsoft	microsoft	(proper noun) the microsoft company
miguel	miguel	miguel
mike	mike	mike
mikoyan	mikoyan	mikoyan
mikoyangurevich	mikoyangurevich	(proper noun) mikoyangurevich
milan	mailand	milan
milano	milano	milano
miley	miley	miley
mill	mühle	mill
miller	müller	miller
milton	milton	milton
min	min	min
minas	minas	minas
mindanao	mindanao	(proper noun) mindanao
ming	ming	ming
minnesota	minnesota	minnesota
minoa	minoa	minoa; the minoan civilization
miraflores	miraflores	miraflores
mirage	trugbild	mirage
miroku	miroku	(proper noun) miroku, a japanese name
misfits	außenseiter	misfits
mississippi	mississippi	mississippi
missouri	missouri	(proper noun) the state of missouri
mitchel	mitchell	mitchel
mitsubishi	mitsubishi	mitsubishi
miên	hypnose	mien
miêu	katze	"(term should be ""miêu tả"") to describe (v.)"
miến	fadennudeln	burma
miếng	stücke	a piece (n.)
miếu	tempel	temple
miền	domain	area
miễn	kostenlos	to exempt (v.)
miện	krone	crown
miệng	mund	mouth
mm	mm	millimeter
mobile	mobil	mobile
mode	modus	mode
modul	modul	module
modula	modula	(proper noun) modula, as in modula-2
mohammad	mohammad	mohammad
mohammed	mohammed	mohammed
moi	neu	winkle
molecular	molekular	molecular
molotov	molotow	molotov
molypden	molybdän	the element molybdenum (n.)
mongolia	mongolei	mongolia
monique	monique	(proper name) monique, a french first name
mono	mono	mono
monroe	monroe	monroe
mont	mont	(proper noun) mont
montaigne	montaigne	montaigne, as in michel de montaigne
montana	montana	(proper noun) montana, as in the state
montenegro	montenegro	montenegro
montmartre	montmartre	(proper noun) montmartre
montparnasse	montparnasse	montparnasse
montreal	montreal	(proper noun) montreal, quebec
moo	moo	(proper noun) moo, as in cha moo won
moong	moong	moong
mora	mora	mora
moravia	mähren	moravia
morgan	morgan	(proper noun) morgan
mori	mori	(proper noun) mori
moriarty	moriarty	(proper noun) moriarty, as in james moriarty from sherlock holmes
morley	morley	morley
morocco	marokko	morocco
morris	morris	morris
morrison	morrison	(proper noun) morrison
morse	morse	(proper noun) morse, as in morse code
moscow	moskau	moscow
mosin	mosin	mosin
moskva	moskva	moscow
motown	motown	motown
mourinho	mourinho	mourinho
movie	film	movie
mozambique	mozambique	(proper noun) mozambique
mozart	mozart	(proper noun) mozart, as in the composer
mp	mp	mp
ms	ms	metre per second
msdos	msdos	ms-dos
mtv	mtv	mtv
mu	mu	pubis
mua	kaufen	buy
much	viel	much
muhammad	muhammad	(proper noun) muhammad, as in muhammad ali
mumbai	mumbai	mumbai
mun	ebenholz	a vietnamese name
munich	münchen	(proper noun) munich
murdoch	murdoch	murdoch
muromachi	muromachi	(proper noun) muromachi
murphy	murphy	murphy
murray	murray	(proper noun) murray, as in dr. conrad murray
mustang	mustang	mustang, as in the f-51 mustang
muta	muta	a name
muôn	wollen	a large number; thousands (adj.)
muối	salz	salt
muốn	würde gerne	want
muống	löffel	"(term should be ""rau muống"") water spinach (n.)"
muồi	spät	ripe
muỗi	mücke	mosquito
muỗng	löffel	spoon
muội	schwester	confusion
muộn	spät	late (adv.)
myanma	myanmar	the country of myanmar
myanmar	myanmar	(proper noun) myanmar
myspace	myspace	(proper noun) myspace
mà	das	also
mài	schleifen	tomorrow
màn	vorhang	curtain (n.)
mành	jalousien	a bamboo screen (n.)
mào	wappen	a comb or crest, as in the body part of a bird
màu	farbe	color
mày	du	sew
má	wangen	cheek
mác	etikett	a name (marx)
mách	tipps	tell
máclênin	marxelenin	marxist-leninist
mái	dach	"entire term should be ""thoai mai""; means ""comfortable"""
mát	cool	cool
máu	blut	blood
máy	die maschine	a machine (n.)
mâm	tablett	tray
mân	rosenkranz	"entire term should be ""man viet""; a country of ancient asia that now corresponds to a province in southern china"
mâu	widersprüchlich	contradiction
mây	wolke	cloud
mã	code	"(term should be ""la mã"") roman (adj.)"
mãi	für immer	forever (adv.)
mãimại	code	commerce
mãn	selbstgefällig	satisfy
mãnh	stark	intense
mão	kronen	cat
mè	sesam	sesame
mèo	katze	cat (n.)
mé	mé	a border
méo	verzerrt	alter
mép	kante	edge
mét	meter	meter
mênh	riesig	vast
mêtan	methan	methane
mì	nudeln	wheat
mình	dich selbst	me
mía	zuckerrohr	sugar cane (n.)
mò	fummelte	to grope (v.)
mòn	abgenutzt	trail
móc	haken	"(term should be ""máy móc"") machinery (n.)"
món	essen	dish
mô	gewebe	mo
môi	lippen	lip
môn	themen	anus
mông	gesäß	mongolia
mônôxít	monoxid	monoxide
môt	eins	"(term should be ""một"") one (n.)"
môtô	motorrad	motorcycle
mù	blind	mu
mùa	jahreszeit	season
mùi	der geruch	smell
múa	tanzen	dance
mút	saugen	to suck (v.)
münchen	münchen	(proper noun) munchen
măng	bambussprossen	bamboo shoot (n.)
mĩ	amerika	america
mũ	kappen	cap
mũi	nase	nose
mơ	träume	vague
mơn	pfoten	caress
mưa	regen	rain
mưu	list	"(should be ""tham mưu"") advisors"
mươi	fünfzig	tens
mương	graben	ditch
mướn	mieten	hire
mướt	glatt	smooth (adj.)
mường	muong	(proper noun) mường, a minority people in vietnam (n.)
mượn	ausgeliehen	borrow
mượt	glatt	glossy (adj.)
mạc	wüste	"(should be ""mộc mạc"") simple or natural"
mạch	schaltung	vessel
mại	handel	commerce
mạn	seite	romantic
mạnh	stark	strong
mạo	artikel	"(should be ""mạo hiểm"") to brave danger"
mạt	milben	"(term should be ""lê mạt"") the ending or decline of something (adj.)"
mả	gräber	tomb or grave (n.)
mải	beschäftigt	absorbedly
mảng	array	genre
mảnh	stück	piece
mất	verloren	lose
mấu	registerkarte	key
mấy	wenige	any
mầm	keim	kindergarten
mầu	farbe	color
mẩu	stück	piece
mận	pflaumen	plum
mập	fett	fat
mật	schatz	intimate
mậu	handel	mau
mắc	teuer	get
mắm	fischsauce	"(term should be ""nước mắm"") fish sauce (n.)"
mắn	glück	"(term should be ""may mắn"") fortunate (adj.)"
mắng	schimpfen	scold
mắt	augen	eye
mặc	tragen	wear
mặn	salzig	salt
mặt	gesicht	face
mẹ	mama	mother (n.)
mẹo	tipps	trick
mẻ	charge	cool
mẽ	stark	strong
mến	liebes	to adore or like greatly (v.)
mề	muskelmagen	locket
mềm	weich	soft
mệnh	abs	revolution
mệt	müde	tired
mỉ	akribisch	meticulous
mỉa	ironie	ironic
mỉm	lächeln	smile
mịch	scheiße	"(term should be ""tịch mịch"") quiet (adj.)"
mịn	glatt	smooth
mịt	schnüffeln	dim
mọc	wächst	to grow (v.)
mọi	jeder	every
mọn	kleinlich	lowly
mỏ	minen	mine
mỏi	müde	tired (adj.)
mỏng	dünn	thin
mốc	muffig	border
mối	termite	relationship
mốt	modeerscheinung	fashion or style (n.)
mồ	grab	"(term should be ""mồ hôi"") sweat (n.)"
mồi	köder	bait (n.)
mổ	chirurgie	to dissect or perform surgery (v.)
mỗi	jeweils	every
mộ	grab	admire
mộc	zimmerei	simple
mộng	träume	dream
một	eins	one
mới	neu	new (adj.)
mờ	verschwommen	dim
mời	eingeladen	invite
mở	offen	open
mỡ	fett	fat or grease (n.)
mục	der artikel	purpose
mụn	akne	pimple
mức	niveau	level
mứt	marmelade	preserve
mừng	freut mich	to be happy
mửa	erbrechen	to vomit (v.)
mực	tinte	"(term should be ""chuẩn mực"") standard (n.)"
mỳ	nudeln	noodles (n.)
mỹ	gut	america
mỹcông	amerika	my private
na	na	"(term should be ""na uy"") the country of norway"
naadam	naadam	naadam
nacional	nacional	nacional
nagant	nagant	nagant
nagar	nagar	nagar, as in champa po nagar
nagasaki	nagasaki	(proper noun) the city of nagasaki, japan
nagoya	nagoya	a name
nagumo	nagumo	nagumo
nai	hirsche	a deer
nairobi	nairobi	nairobi, a city in kenya (n.)
nakajima	nakajima	a japanese name
nalbandian	nalbandian	a name
nam	männlich	male
nambắc	norden	nambac
namibia	namibia	namibia
namnam	namnam	male-male
namno	namno	nammo
nancy	nancy	nancy, as in nancy pelosi
nang	follikel	"(term should be ""cẩm nang"") a handbook (n.)"
nanh	reißzähne	fang
nano	nano	nano
naomi	naomi	naomi, as in model naomi campbell
napoleon	napoleon	(proper noun) napoleon
napoli	napoli	(proper noun) napoli
napoléon	napoléon	napoleon
nara	nara	nara
nasa	nasa	(proper noun) nasa
nat	nat	nat
nathan	nathan	nathan
natri	natrium	sodium
nauru	nauru	a name
nava	nava	nava
navarre	navarre	navarre
nay	jetzt	this (adj.)
needham	needham	needham
nelson	nelson	(proper noun) nelson, as in nelson mandela
neo	anker	"(term should be ""mỏ neo"") an anchor (n.)"
neon	neon	neon
nepal	nepal	nepal
nepomuk	nepomuk	a name
nessie	nessie	(noun) nessie, the nickname of the loch ness monster
net	netto	net
netbook	netbook	netbook
netscape	netzlandschaft	netscape
networks	netzwerke	networks
neumann	neumann	(proper noun) neumann
neutrino	neutrino	neutrino
nevada	nevada	nevada
neverland	nimmerland	neverland
newcastle	newcastle	newcastle
newspaper	zeitung	newspaper
newton	newton	newton
newtons	newton	(proper noun) newton's
next	als nächstes	next
nga	russland	russia
ngai	thron	crown
ngang	horizontal	horizontal
ngao	muschel	clam (n.)
ngay	gerade jetzt	even
nghe	hören	hear
nghinh	nghinh	welcome
nghiêm	streng	serious
nghiêng	geneigt	inclined
nghiêu	nghieu	nghiêu, a vietnamese name
nghiền	zerquetscht	crush
nghiễm	mitleid	serious
nghiệm	erfahrung	experiment
nghiện	süchtig	addiction
nghiệp	karma	karma/ sự nghiệp=career
nghiệt	grimmig	adverse
nghành	industrie	faculty
nghèo	arm	poor
nghé	nghe	to glance out of the corner of one's eye (v.)
nghê	nghe	nghe khuong
nghênh	willkommen	support
nghìn	tausend	thousand
nghĩ	dachte	think
nghĩa	bedeutung	meaning
nghẽn	überlastung	jam
nghếch	laut	stupid
nghề	beruf	career
nghệquận	kunst	art district
nghỉ	pause	relaxation
nghị	empfehlungen	think
ngo	zierlich	ngo
ngoan	guter junge	good
ngoc	ngoc	"(term should be ""ngọc"") gem (n.)"
ngon	lecker	delicious
ngoài	auseinander	outside of
ngoại	fremd	external
ngoạn	atemberaubend	spectacular
ngoặc	klammern	bracket
ngoặt	wendepunkt	landmark
ngu	dumm	stupid
ngung	ngung	(proper noun) a vietnamese first name
nguyen	nguyen	nguyen
nguyên	original	reason
nguyền	fluch	curse
nguyện	gelübde	"(term should be ""mãn nguyện"") to be satisfied (adj.)"
nguyệt	mond	moon
nguôi	beruhigend	fade away
nguồn	quelle	source
nguời	menschen	people
nguỵ	dummköpfe	camouflage
ngà	elfenbein	russian
ngàn	tausend	thousand
ngàng	ngàng	"(term should be ""ngỡ ngàng"") to be at fault (adj.)"
ngành	industrie	sector
ngào	süß	sweet
ngày	tag	day
ngách	nische	"entire term should be ""ngoc ngach""; means ""a small, out-of-the-way road"""
ngái	dumm	chinese ethnic group living in the vietnamese highlands near the china border
ngán	gelangweilt	to be tired of
ngáng	ngáng	stop
ngát	ohnmacht	"(term should be ""ngát hương"") fragrant (adj.)"
ngân	bank	money
ngây	leer	"(term should be ""ngây ngất"") to be in ecstasy"
ngãi	ngai	ngai
ngò	koriander	coriander
ngó	schau	to look (v.)
ngói	fliese	tile or shingle
ngón	finger	a finger (n.)
ngót	schrumpfung	"(term should be ""rau ngót"") also called sweet leaf, a type of leafy vegetable used to make soup (n.)"
ngôn	sprache	manifesto
ngông	gans	eccentric
ngõ	spur	lane
ngùi	riechen	sad
ngút	ngut	"entire term is ""ngut troi""; means ""sky-high"""
ngăn	fach	prevent
ngũ	fünf	rank
ngơ	ignoriert	ignored (adj.)
ngơi	ruhe	"(term should be ""nghỉ ngơi"") to rest (v.)"
ngư	fischer	fishermen
ngưng	hör auf	stop
ngưu	ox	buffalo
ngươi	du	an ancient form of address equivalent to thou or thee (n.)
người	menschen	people
ngưỡng	schwelle	religious
ngược	rückwärts	opposite
ngạc	überrascht	surprise
ngạch	rang	"(term should be ""kim ngạch"") turn-over (n.)"
ngạn	bank	bank
ngạnh	widerhaken	self-willed
ngạo	arrogant	"(term should be ""ngạo ngược"") insolent (adj.)"
ngạt	erstickung	stuffy
ngấm	infundiert	draw
ngất	ohnmacht	unconscious
ngầm	unterirdisch	underground
ngần	zögern sie	hesitate
ngẩn	verblüfft	froze
ngẫm	nachdenken	think
ngẫu	zufällig	ngẫu nhiên= random
ngậm	lutschtabletten	keep
ngập	überflutet	flood
ngắm	zuschauen	to contemplate or look admiringly at something (v.)
ngắn	kurz	short
ngặt	eng	strict
ngọ	mittag	horse
ngọc	perle	pearl
ngọn	spitzen	top
ngọt	süß	sweet (adj.)
ngồi	sitzen	sit
ngộ	erleuchtung	ngo
ngột	abrupt	sudden
ngớ	dumm	silly
ngời	menschen	bright
ngỡ	dachte	surprised
ngợi	lob	praise
ngợm	ungezogen	naughty
ngục	verlies	dungeon
ngụm	schluck	sip
ngụy	wei	puppet
ngủ	schlafen	sleep
ngủi	kurz	"(should be ""ngắn ngủi"") short-lived"
ngứa	juckreiz	itchy
ngừ	thunfisch	tuna
ngừa	verhindern	prevent
ngừng	hör auf	to cease (v.)
ngửa	offen	supine
ngửi	riechen	to smell
ngữ	rede	term
ngự	wohnen	defend
ngựa	pferde	horse
ngực	brust	chest
nha	zahnarzt	dental
nhakẻ	kind	nha-ke
nham	lava	"(actual term is ""dung nham"") lava"
nhan	nhan	"(term should be ""dung nhan"") countenance or facial appearance (n.)"
nhang	weihrauch	incense
nhanh	schnell	fast
nhat	nhat	nhat
nhen	neu entfacht	rekindle
nhi	kinder	junior
nhiên	natürlich	tuy nhiên= however
nhiêu	viel	how many
nhiều	viel	numerous
nhiễm	infiziert	infect
nhiễu	lärm	noise
nhiệm	pflicht	task
nhiệt	hitze	heat
nhk	nhk	nhk
nhs	nhs	nhs
nhu	wie	demand
nhuận	gewinn	leap year
nhuệ	nhue	elite
nhuộm	gefärbt	dye
nhàn	leerlauf	leisure
nhàng	sanft	"(term should be ""nhẹ nhàng"") gentle (adj.)"
nhào	kneten	to fall headlong
nhác	schlaff	coward
nhái	klone	illegal copy
nhánh	zweig	branch
nháp	entwurf	draft
nháy	blinkt	to flash or blink (v.)
nhâm	eintauchen	leap
nhã	geschmackvoll	"(term should be ""thanh nhã"") elegant"
nhãn	etikett	"(term should be ""gán nhãn"") to affix a label"
nhét	versteckt	put
nhì	zweitens	second (adj.)
nhìn	schau	to look (v.)
nhí	geschwätz	children
nhím	igel	porcupine
nhòm	schau	to peep (v.)
nhóc	kind	brat
nhóm	gruppe	group (n.)
nhô	hervorstehend	emerge
nhôm	aluminium	aluminum (n.)
nhúng	eingebettet	embed
nhút	schüchtern	shy
nhăn	faltig	wrinkle
nhĩ	atrial	turkey
nhũ	emulsion	"(term should be ""thạch nhũ"") stalactite (n.)"
nhũng	korruption	bribery
nhơn	multiplizieren	nhon
như	wie	like
nhưng	aber	but
nhương	speichel	(proper noun) vietnamese first name
nhường	ausbeute	yield
nhưỡng	fettig	soil
nhược	schwäche	weak
nhượng	zugeständnisse	concession
nhạ	nhạ	nha
nhạc	musik	music
nhạn	schlucken	bird
nhạo	verspotten	ridicule
nhạt	blass	light
nhạy	empfindlich	sensitive
nhảy	tanzen	jump
nhấc	heben	lift
nhấm	nippen	rodent
nhấn	drücken	to press (v.)
nhất	am meisten	most
nhầm	falsch	misunderstand
nhầy	schleimig	glutinous
nhẫn	ringe	patient
nhậm	gestempelt	inaugurate
nhập	eingeben	penetrate
nhậu	trinken	drink
nhậy	empfindlich	sensitive
nhắc	eingabeaufforderung	to remind (v.)
nhắm	zielen	aim
nhắn	die nachricht	message
nhằm	zielen	for the purpose of (adv.)
nhẵn	glatt	smooth
nhặt	abgeholt	pickup
nhẹ	licht	light
nhẹn	agil	nhanh nhẹn= fast/nimble
nhị	staubblatt	sensitive
nhịn	sich enthalten	fasting
nhọ	verschmiert	smear
nhọn	spitz	sharp (adj.)
nhỏ	klein	small
nhỏ|cây	kleiner baum	small|tree
nhỏ|một	klein | eins	small | one
nhỏ|phải|	klein | rechts |	small|right
nhỏ|phải|px|	klein | rechts | px |	small | have | px |
nhỏ|phải|px|bức	kleine | rechte | px | bilder	grape / fade / px / buc
nhỏ|phải|px|cây	kleiner | rechter | px | baum	px spicy grape fade
nhỏ|phải|px|khu	kleine | rechte | px | zone	small|right|px|area
nhỏ|phải|px|michael	klein | rechts | px | michael	small|right|px|michael
nhỏ|phải|px|máy	kleine | rechte | px | maschine	small | right|px|machine
nhỏ|phải|px|một	klein | rechts | px | eins	small|right|px|one
nhỏ|phải|px|quân	klein | rechts | px | kraft	small|right|px|army
nhỏ|px|	klein | px |	small
nhỏ|px|các	klein | px | the	small
nhỏ|px|phải|kiến	kleine | px | rechte | ameise	small | px | right | patience
nhỏ|quân	kleine kraft	small|army
nhỏ|trái|px|máy	kleine | linke | px | maschine	small|left|px|plane
nhỏ|tượng	kleine statuen	small|statue
nhốt	eingesperrt	confine
nhồi	vollgestopft	cram
nhổ	spucken	uproot
nhộn	komisch	busy
nhớ	sich erinnern	remember
nhớt	viskos	viscid
nhờ	danke	by
nhờn	fettig	multiplication
nhở	erinnern	remind
nhụ	prise	nhu
nhục	gedemütigt	shame
nhủ	erinnerungen	needs
nhức	schmerzen	pain
nhứt	zuerst	first (n.)
nhừ	wie	tender
những	diese	the
nhựa	kunststoff	plastic
nhựt	nhut	"like the word ""nhật""; meaning ""sun"" (n.)"
ni	ni	nun
nia	nia	a flat basket (n.)
nicaea	nicaea	nicaea
nicaragua	nicaragua	(proper noun) nicaragua
niccolò	niccolò	(proper noun) niccolo, as in writer niccolo machiavelli
nicolas	nicolas	(proper noun) nicolas, as in nicolas sarkozy
niels	niels	(proper noun) niels
nigeria	nigeria	nigeria
nikel	nikel	nickel
niken	nickel	nickel
nikita	nikita	(proper noun) nikita, a first name
nikko	nikko	(proper noun) nikko
nikolai	nikolai	nikolai
nikolayevich	nikolayevich	nikolayevich
nil	null	nile
nile	nil	(proper noun) the river nile
nimitz	nimitz	(proper noun) nimitz, as in the ship uss nimitz
nin	nin	nin
ninh	sicherheit	ninh, as in bắc ninh
nintendo	nintendo	(proper noun) nintendo, the game company
nippon	nippon	nippon
nitơ	stickstoff	nitrogen (n.)
nixon	nixon	(proper noun) nixon, as in former president richard nixon
niên	jahr	youth
niết	niet	nirvana
niềm	vergnügen	trust
niệm	achtsamkeit	concept
niệu	diurese	urinary
nj	nj	nj
nlf	nlf	nlf
nm	nm	nano-meters
noah	noah	(proper noun) noah
nobel	nobel	nobel
nobita	nobita	nobita
noel	noel	(proper noun) noel
noi	sagen	imitate
nokia	nokia	(proper noun) nokia, as in the nokia corporation
nol	nol	nol
nom	nom	look after
non	jung	mountain
nonpenetrative	nicht durchdringend	nonpenetrative
norfolk	norfolk	norfolk
norge	norge	norge
norma	norma	(proper noun) norma, a female first name
norman	norman	norman
normandie	normandie	normandile
northrop	northrop	northrop, as in the northrop f-5 freedom fighter
norton	norton	norton
norway	norwegen	norway
nou	nein	nou
novak	novak	novak
now	jetzt	now
nowc	nowc	nowc
noãn	eizelle	ovule
nsnd	nsnd	people's artist
nst	nst	chromosome
nubia	nubien	nubia
number	nummer	number
nupedia	nupedia	a name
nusa	nusa	nusa
nuôi	füttern	feed
nuối	schlucken	"(term should be ""tiếc nuối"") to regret (v.)"
nuốt	schlucken	to swallow (v.)
nuớc	wasser	water
nxb	nxb	publisher
nynorsk	nynorsk	nynorsk
nà	nà	na
nài	darauf bestehen	pleading
nàn	beschwerte sich	poor
nành	soja	soy
nào	komm schon	would
này	das	this
ná	ná	a crossbow (n.)
nách	achselhöhlen	underarm (n.)
náo	aufruhr	riot
nát	zerquetscht	ruin
náu	verstecken	hide
nâng	heben	raise
nâu	braun	brown
nã	nã	to track down (v.)
não	gehirn	brain
né	vermeiden	dodge
ném	werfen	to throw (v.)
nén	komprimiert	compress
nét	schlaganfälle	feature
nê	ne	ne
nên	sollte	should or ought to
nêu	angegeben	mention
nòi	rennen	race
nòng	fass	barrel
nói	sagte	to say or speak (v.)
nón	hüte	cone
nóng	heiß	hot
nô	sklave	slave
nôbita	tobita	nobita
nôi	krippe	cradle
nôm	nein	ancient vietnamese script that borrowed heavily from han chinese characters
nôn	erbrechen	vomit
nông	flach	farmer
nõn	schälen	peeled
nùng	nung	nung
núm	knopf	nipple
núp	abdeckung	hide
nút	taste	button
năm	jahr	year
năn	reuig	"(term should be ""ăn năn"") remorse (n.)"
năng	macht	"(term should be ""khả năng"") ability (n.)"
nơi	ort	a place
nơtrino	neutino	neutrino
nước	wasser	country
nước 	wasser	water
nướng	gebacken	grill
nǎm	nǎm	year
nạ	maske	mask
nạc	schlank	lean (adj.)
nại	sich beschweren	complain
nạn	not	a disaster (n.)
nạo	kürettage	to scrape (v.)
nạp	geladen	tribute
nản	entmutigt	depressed
nảy	hüpfen	"(term should be ""nảy sinh"") to give rise to (v.)"
nấc	schluckauf	a hiccup (n.)
nấp	verstecken	hide
nấu	kochen	cook
nấy	das	this
nần	stupsen	debt
nầy	das	this
nẩy	hüpfen	"(term should be ""nảy nở"") to sprout or start growing (v.)"
nẫu	n sonne	"(""giọng nẫu"") a vietnamese accent commonly found in cities such as phú yên"
nậm	nam	"(term should be ""nậm rốm"") the name of a river in vietnam (proper noun)"
nập	heiß	busy
nắm	greifen	to grasp or hold (v.)
nắng	sonnig	sunlight
nắp	deckel	a lid or cover (n.)
nằm	lügen	to lie (v.)
nẵng	nang	"(term should be ""Đà nẵng"") a city in central vietnam"
nặc	anonym	heavy
nặn	drücken	mould
nặng	schwer	heavy
nẻo	ein anderer	turn
nếm	verkostung	taste
nến	kerzen	candle
nếp	klebrig	sticky rice (n.)
nếu	wenn	if (adv.)
nề	mauerwerk	severe
nể	respekt	respect
nện	stampfen	ram
nỉ	fühlte	beg
nịnh	flacher	flatter
nọ	der andere	the other
nọc	gift	tadpole
nỏ	armbrust	a crossbow (n.)
nối	verbunden	connection
nốt	hinweis	to finish off (v.)
nồi	topf	pot
nồm	nacken	humid (adj.)
nồng	konzentration	heavy
nổ	explodieren	explode
nổi	schwebend	nổi tiếng= famous
nỗ	versuch	affort
nỗi	das	state
nộ	zorn	anger
nội	intern	on the paternal side (adj.)
nộn	füllung	non
nộp	abgelegt	submit
nới	lockern	ease
nở	blühen	bloom
nỡ	herzhaft	do you have a heart to
nợ	schulden	debt
nụy	stempel	"(term should be ""nụy nhân"") the vietnamesized han term depicting the japanese"
nứa	kork	a kind of bamboo (n.)
nứt	geknackt	to crack
nửa	halb	haft
nữa	mehr	moreover
oahu	oahu	(proper noun) oahu
oai	angst	heroic
oakland	oakland	oakland
oan	ungerechtigkeit	injustice
oanh	oanh	(with word liet) glorious
obama	obama	obama
oblast	oblast	(proper noun) oblast, as in tomsk oblast
oc	oc	oc
october	oktober	(proper noun) october
oda	oda	oda
oder	oder	oder
odyssey	odyssee	odyssey, as in the odyssey, homer's epic
oecd	oecd	oecd
officer	offizier	officer
officers	offiziere	officers
ohkawa	ohkawa	ohkawa
okhotsk	okhotsk	okhotsk
oliver	oliver	oliver
olivier	olivier	olivier
olympus	olympus	olympus
om	om	to simmer
omar	omar	a name
ong	biene	bee
ontario	ontario	ontario
oort	oort	oort
oprah	oprah	(proper noun) oprah, as in oprah winfrey
organ	orgel	organ
oricon	oricon	oricon
origin	herkunft	origin
orion	orion	(proper noun) orion, the hunter
orleans	orleans	(proper noun) orleans, as in new orleans
orochimaru	orochimaru	orochimaru
orton	orton	orton
os	os	os
osaka	osaka	(proper noun) osaka, a city in japan
osama	osama	(proper noun) osama, as in osama bin laden
osamu	osamu	(proper noun) osamu, a japanese first name
oscar	oscar	oscar
osiris	osiris	(proper noun) osiris, as in the egyptian god
oskar	oskar	a name
oslo	oslo	oslo
osment	osment	osment
ospf	ospf	ospf
ossetia	ossetien	(proper noun) ossetia
oswald	oswald	oswald
other	andere	other
otto	otto	(proper noun) otto, as in otto von bismarck
ottoman	ottomane	(proper noun) ottoman, as in the ottoman empire
outstanding	hervorragend	xuat sac
owen	owen	(proper noun) owen, as in michael owen
oxford	oxford	oxford
oxy	sauerstoff	oxygen
ozawa	ozawa	(proper noun) ozawa, as in maria ozawa
oán	ressentiments	"(term should be ""oán than"") to complain or whine"
oát	watt	a watt (n.)
oản	oàn	"(term should be ""ăn oản"") gratitude and resentment (n.)"
paget	paget	(proper noun) paget
pailin	pailin	pailin
pakistan	pakistan	(proper noun) the country of pakistan
palais	palais	palais, as in grand palais
palawan	palawan	palawan
palenque	palenque	(proper noun) palenque
palestine	palästina	a name
palgrave	palgrave	palgrave
pali	pali	a name
pamir	pamir	pamir
pan	pfanne	pan, as in peter pan
panama	panama	panama
panamax	panamax	(proper noun) panamax
panduranga	panduranga	(proper noun) panduranga
panthera	panthera	(proper noun) panthera, a genus of felines
panthéon	panthéon	a name
paolo	paolo	paolo
paperback	taschenbuch	paperback
papua	papua	papua
paraguay	paraguay	(proper noun) paraguay
pari	pari	pari
park	park	park
parton	parton	parton
patel	patel	(proper noun) patel
patrick	patrick	patrick
patriot	patriot	patriot
paul	paul	paul
paula	paula	paula
paulo	paulo	(proper noun) paulo
pavia	pavia	pavia
pbs	pbs	pbs
pda	pda	pda
pdf	pdf	pdf
pedro	pedro	pedro
peers	gleichaltrige	peers
pele	pele	(proper noun) pele, as in the soccer player
penang	penang	penang
penh	penh	(proper noun) penh, as in phnom penh
pennsylvania	pennsylvania	pennsylvania
penny	penny	(proper noun) penny, an english first name
pereira	pereira	pereira
perl	perl	(proper noun) perl
pero	pero	pero
perry	perry	(proper noun) perry, as in elizabeth perry
persephone	persephone	presephone
pershing	pershing	pershing
persian	persisch	persian
peru	peru	peru, as in the south american country
peters	peters	peter's, possessive of peter
petersburg	petersburg	(proper noun) petersburg, as in saint petersburg
pfm	pfm	a name
pgs	pgs	associate professor
pgđ	pgđ	associate professor
pha	gemischt	to mix
phaethon	phaethon	phaethon
pham	pham	pham
phanh	bremse	expose
phao	float	float
phaolô	paul	st. paul, the apostle
pharaoh	pharao	pharaoh
pharaon	pharaon	pharaoh
phay	fräsen	mill
phe	fraktion	faction
phen	phen	time
phil	phil	(proper noun) phil, a first name
philip	philip	philip
philippe	philippe	philippe
philippines	philippinen	(proper noun) philippines
phillip	phillips	(proper noun) phillip
phillips	phillips	philips
philosophiae	philosophiae	(proper noun) philosophiae, as in the work philosophiae naturalis principia mathematica
phim	film	phim
phin	filter	coffee filter
phineas	phineas	(proper noun) phineas
phiên	sitzung	trial
phiêu	abenteuer	adventurous
phiếm	klatsch	gossip
phiến	klinge	"(should be ""nha phiến"") opium"
phiện	opium	opium
phiệt	phiet	militarism
phnom	phnom	phnom
phnôm	phomom	phnôm pênh= phnom penh(cambodia's capital)
pho	pho	part of a person's name, rat-pho, or ratford
phoenix	phönix	(proper noun) phoenix
phong	zimmer	movement
php	php	php
phrygian	phrygisch	phrygian
phu	phu	"(term should be ""phu nhân"") wife (n.)"
phui	aufgedeckt	expose
phun	sprühen	to spray or spit (v.)
phà	fähre	ferry
phàm	sterblich	superhuman
phàn	sich beschweren	complain
phá	brechen	destroy
phác	skizze	"(term should be ""phác thảo"") outline or sketch (n.)"
phách	schlagen	manner (n.)
phái	sekte	a party
phán	richter	judge
pháo	kanone	artillery
pháp	frankreich	method
phát	sendung	develop
phèn	alaun	alum
phèo	phèo	organs
phép	erlaubt	permit
phê	kaffee	"(term should be ""phê bình"") to criticize (v.)"
phêrô	peter	peter
phì	hypertrophie	non-
phình	ausbuchtung	bulge
phí	aufladen	non-
phía	seite	side
phích	thermoskanne	a flask (n.)
phím	schlüssel	key
phò	phò	"(term should be ""phò mã"") a prince consort"
phòng	zimmer	office
phó	stellvertreter	second
phóng	reporter	to launch (v.)
phô	stadt	display
phôi	barren	embryo
phông	schriftart	font
phùng	puff	phung
phúc	gesegnet	good fortune (n.)
phúclộc	gesegnet	phuc-loc
phún	penner	"(term should be ""lún phún"") sparse (adj.)"
phúng	mitleid	satire
phút	minute	a minute (n.)
phăn	bund	phan
phăng	phang	knock
phương	phuong	direction
phước	segen	luck
phường	station	ward
phượng	phönix	phoenix
phạn	sanskrit	sanskrit
phạt	strafe	punish
phả	stammbaum	pedigree
phải	ja	must
phải 	ja	right
phản	zähler	reaction
phảng	flach	subtle
phần	abschnitt	part
phẩm	produkte	food
phẩy	komma	a comma
phẫn	empört	wrathful
phẫu	chirurgie	surgery
phận	schicksal	part
phật	buddha	buddhist
phẳng	flach	flat (adj.)
phế	schrott	dismiss
phết	verbreiten	to spread or smear (v.)
phỉ	hasel	defame
phỏng	brennen	interview
phố	straße	city
phối	koordinieren	coordinate
phốt	phosphate	"(term should be ""phốt-phát"") phosphate (n.)"
phồng	aufgeblasen	to swell (v.)
phổ	spektrum	popular
phổi	lungen	lung
phộng	erdnüsse	peanut
phới	float	"(term should be ""phơi phới"") mildly exciting (adj.)"
phở	pho	pho
phục	bekleidung	convincing
phụng	servieren	worship
phụt	puff	minute
phủ	abgedeckt	government
phức	komplex	complex
picchu	picchu	a name
piccolo	piccolo	piccolo
pierre	pierre	pierre
pierrot	pierrot	pierrot
pietro	pietro	pietro
pike	hecht	pike
pin	stift	battery
pinlus	pinlus	pinlus
pioneer	pionier	pioneer
pipes	rohre	pipes
pisa	pisa	a name
piston	kolben	piston
pitch	tonhöhe	pitch
pius	pius	pius
plaaf	plaaf	plaaf
plan	planen	plan
plasma	plasma	plasma
plate	platte	plate
plato	plato	plato
platon	platon	platon
player	spieler	player
pleiku	pleiku	(proper noun) pleiku
pleistocen	pleistozän	pleistocen
plus	plus	plus
pluto	pluto	pluto
pm	uhr	pm
pmu	pmu	pmu
po	po	po
pokémon	pokemon	pokemon
pol	pol	pol
poland	polen	poland
pollack	pollack	a name
pollux	pollux	a name
polo	polo	(proper noun) polo, as in marco polo
polynésie	polynésie	polynesian
pont	pont	(proper noun) pont, as in pont de normandie
pop	pop	pop
portland	portland	portland
porto	porto	porto
pot	topf	pot
potsdam	potsdam	(proper noun) potsdam
potter	töpfer	(proper noun) potter, as in harry potter
pour	gießen	not vietnamese
powell	powell	(proper noun) powell, as in general colin powell
pradesh	pradesh	pradesh
praha	praha	praha
pratzen	pratzen	pratzen
preah	predigen	(proper noun) preah
premier	premier	premier
preminger	preminger	(proper noun) preminger
preston	preston	(proper noun) preston, as in john preston
prince	prinz	prince
princeton	princeton	princeton
printemps	printemps	printemps
printf	printf	printf
prinz	prinz	(proper noun) prinz, as in birgit prinz, the female german soccer player
prix	prix	(proper noun) prix, as in the grand prix
procellarum	procellarum	procellarum, as in oceanus procellarum, the name of a mare on the moon
projekt	projekt	projekt
prometheus	prometheus	(proper noun) prometheus
protein	protein	protein
prôtêin	protein	protein (n.)
ps	ps	ps
psv	psv	psv
ptolemy	ptolemaios	ptolemy
ptq	ptq	ptq
puerto	puerto	puerto
pulau	pulau	(proper noun) pulau, as in pulau tekong, an island
pulitzer	pulitzer	(proper noun) pulitzer, as in the pulitzer prize
pulp	fruchtfleisch	pulp
punjab	punjab	punjab
pusan	pusan	(proper noun) pusan
putin	putin	putin
pyrenees	pyrenäen	pyrenees
pytago	pytago	(proper noun) pytago
pzl	pzl	pzl
péc	péc	"(term should be ""vịnh péc xích"") the persian gulf"
pérez	pérez	(proper noun) perez, as in javier perez de cuellar
păng	pang	fansipan
pơ	pơ	"(term should be ""pơ kô"") a river in vietnam (n.)"
q	q	q ( a letter)
qatar	katar	qatar
qd	qd	quantum dots
qing	qing	qing, as in the qing dynasty of  china
qlvnch	qlvnch	army of the republic of vietnam
qua	vorbei	transmit
quad	quad	quad
quan	quan	"(term should be ""quan hệ"") relationship (n.)"
quang	optisch	bladder
quanh	herum	around
quay	drehte sich um	turn
que	stangen	stick
queen	königin	queen
queens	königinnen	(proper noun) queens, as in the new york borough
queensland	queensland	queensland
quen	gewöhnt	accustomed to
qui	qui	formal
quincy	quincy	(proper noun) quincy, as in quincy jones
quran	koran	quran
quy	regeln	"(term should be ""quy ước"") agreement"
quyên	grundlagen	"(term should be ""quyên góp"") to donate (v.)"
quyến	charme	"(term should be ""gia quyến"") family"
quyền	richtig	right
quyện	mischen	mix
quyệt	heimtückisch	"(should be ""xảo quyệt"") devious"
quá	auch	over
quái	zum teufel	strange or odd
quán	bar	hometown
quáng	blind	blind
quát	schrie	generalize
quân	quan	army (n.)
quãng	ca.	optical
quét	scannen	to sweep (v.)
quê	landschaft	countryside
quên	vergessen	forget
quý	quartal	love
quýt	mandarine	tangerine
quăng	werfen	to throw (v.)
quĩ	fonds	orbit
quạ	krähen	crow (con qua)
quạt	lüfter	fan
quản	regieren	"(entire term is ""cai quản"") to manage"
quảng	promo	guangzhou
quấn	wickeln	wrap around
quất	kumquat	whip
quấy	rühren	harass
quần	hosen	pants (n.)
quầng	heiligenschein	halo
quầy	zähler	stall
quẩy	schaukeln	quay
quẫn	elend	necessitous
quận	grafschaft	county (n.)
quật	ausgrabung	excavation
quẳng	werfen	throw
quặc	komisch	strange (adj.)
quặng	erz	an ore (n.)
quẻ	hexagramm	hexagram
quế	zimt	cinnamon (n.)
quết	abschaum	knead
quệ	arm	exhausted
quỉ	der teufel	demon
quỳ	knie nieder	demon (n.)
quỳnh	quỳnh	quynh
quỵ	schlaganfall	stroke
quỷ	der teufel	provided
quỹ	fonds	fund
qúy	quartal	quy
r	r	r
rabindranath	rabindranath	rabindranath
race	rennen	race
rafael	rafael	rafael
rafale	rafale	(proper noun) rafale, as in dassault rafale
rai	rai	slowly intake
raleigh	raleigh	raleigh
ralph	ralph	(proper noun) ralph, as in ralph waldo emerson
ram	widder	a name
rama	rama	rama, first name of several rulers of thailand (n.)
ramadan	ramadan	(proper noun) the fasting month of ramadan
ramayana	ramayana	ramayana
rambus	rambus	rambus
ran	lief	ran
ranch	ranch	ranch
randy	geil	randy
rang	klingelte	roast
rangers	ranger	rangers
ranh	grenze	border (ranh gioi)
rao	ad	to announce
rap	rap	rap
raptor	raubvogel	raptor
rate	rate	rate
rau	gemüse	vegetable
ray	strahl	rail (n.)
raya	raya	raya
raymond	raymond	raymond
rađa	radar	radar
reagan	reagan	reagan
real	echt	real
reanimation	wiederbelebung	reanimation
reap	ernten	reap
reef	riff	reef
regia	regia	regia
reichelt	reichelt	reichelt
ren	spitze	lace (n.)
renaissance	renaissance	renaissance
renault	renault	renault
rené	rené	rene
reo	klingelte	yell
reserve	reservieren	reserve
resort	resort	resort
reverse	umgekehrt	reverse
revolution	revolution	revolution
rey	rey	rey, as in copa del rey
rfid	rfid	rfid
rhodes	rhodos	rhodes
rica	rica	rica
ricardo	ricardo	ricardo
ricci	ricci	ricci
richard	richard	richard
richardson	richardson	(proper noun) richardson, as in james o. richardson
richie	richie	(proper noun) richie, as in singer lionel richie
rico	rico	rico, as in puerto rico
riemann	riemann	riemann, as in bernhard riemann, a german mathematician
rimjob	rimjob	rimjob
rin	rin	rin
rising	aufsteigend	rising
risk	risiko	risk
ritchie	ritchie	a name
rivaldo	rivaldo	rivaldo
rivière	rivière	a name
rizal	rizal	rizal
riêng	eigene	own
riêu	riêu	crab
riết	riet	urgently
riềng	galangal	arrowroot
ro	ro	"entire term is ""rui ro""; means ""risk"""
robert	robert	(proper noun) robert
roberto	roberto	(proper noun) roberto
roberts	roberts	roberts
robespierre	robespierre	robespierre
robin	robin	a name
robinson	robinson	robinson, as in michelle robinson
rockefeller	rockefeller	rockefeller, as in john d. rockefeller
roddick	roddick	(proper noun) roddick
rodríguez	rodríguez	rodriguez (n.)
roi	peitsche	a stick or switch used for punishment (n.)
roland	roland	roland
romania	rumänien	romania
rome	rom	rome, as in rome, italy
romeo	romeo	(proper noun) romeo, as in romeo and juliet
rommel	rommel	rommel
ron	ron	ron
ronald	ronald	ronald, an english first name
ronaldinho	ronaldinho	ronaldinho
rong	seetang	seaweed (n.)
rosen	rosen	rosen, as in nathan rosen
roth	roth	roth
rotterdam	rotterdam	(proper noun) rotterdam
rousseau	rousseau	rousseau
router	router	cong noi
rovers	rover	rovers
rowling	rudern	rowling
roy	roy	(proper noun) roy, a name
rpd	rpd	rpd
rtp	rtp	rpt
rudolph	rudolph	rudolph
rue	rue	rue, as in rue des vases, a street name
rulin	rulin	(proper noun) rulin
rumani	rumänisch	romanian
rumiko	rumiko	rumiko, a japanese first name
rummel	rummeln	rummel
run	laufen	tremble
rung	vibration	to shake or vibrate (v.)
russian	russisch	(proper adjective) russian
russkaya	russkaya	(proper noun) russkaya avionika
ruth	ruth	(proper noun) ruth
rutherford	rutherford	rutherford
rutte	rutte	rutte
ruud	ruud	ruud
ruốc	garnelen	pemmican
ruồi	fliegt	fly
ruổi	ruoi	rong ruổi=wandering
ruộng	feld	"(term should be ""ruộng đất"") farmland (n.)"
ruột	darm	internals
rzeczpospolita	rzeczpospolita	rzeczpospolia
rà	auschecken	finding
ràng	klar	clear
rành	fließend	exhaustive
rào	zaun	barrier
rác	müll	gabbage-trash
rách	zerrissen	tear
rái	otter	colander
rán	braten	fried (adj.)
ráp	montage	to assemble (v.)
râm	schattig	shade
râu	bart	beard or mustache (n.)
rã	verfall	out
rãi	weit verbreitet	"(term should be ""rộng rãi"") generous"
rãnh	nut	groove
räikkönen	räikkönen	raikkonen
rèm	vorhang	curtain
rèn	schmieden	train
ré	quietschen	re
république	république	republique
rét	kalt	cold
rê	ziehen	"(term should be ""rê bóng"") to dribble the ball in soccer (v.)"
rên	stöhnen	moan
rêu	moos	moss
rì	flüstern	lush (adj.)
rìa	kante	edge
rình	spion	to watch for
rìu	axt	ax
rít	zischen	to wail (v.)
rò	leckage	leak
ròng	netto	net
rót	gießen	to pour (v.)
rô	kariert	diamond
rôbôt	roboter	robot
rôma	rom	roman
rông	hohl	rising (adj.)
rõ	klar	clear
rùa	schildkröte	turtle
rùng	gruselig	horror
rút	zurückziehen	withdraw
răn	gebot	commandment
răng	zähne	roasted
rōmaji	rōmaji	romaji
rũ	verführerisch	charm
rơ	auto	"(term should be ""rơ măm"") a minority people living in vietnam"
rơi	fallen	fall
rơm	stroh	straw
rươi	dich	sand-worm
rước	prozession	welcome
rưới	bestreuen	to sprinkle (v.)
rưỡi	halb	half
rượt	jagd	pursue
rượu	alkohol	wine
rạ	stroh	straw
rạc	diskret	discrete
rạch	einschnitt	canal
rạng	morgendämmerung	break
rạp	theater	theater
rải	verstreut	spread
rảnh	kostenlos	to be free (adj.)
rất	sehr	very
rầm	pfosten	aggressive
rầu	traurig	sorrow
rẫy	hochland	full
rậm	buschig	jungle
rập	araber	"(term should be ""Ả rập"") arab"
rắc	bestreuen	trouble
rắn	schlangen	snake
rằm	vollmond	a full moon (n.)
rằng	das	roasted
rặng	der felsen	a row
rẻ	billig	cheap
rẽ	drehen	"(term should be ""chia rẽ"") to separate or divide (v.)"
rền	stöhnen	pealed
rể	schwiegersohn	in-law
rễ	wurzeln	root (n.)
rệp	blattläuse	bug
rệt	ausgesprochen	clearly
rệu	ja	decay
rỉ	rost	leak
rịavũng	rìvà	ria - bay
rỏ	klar	clearly
rối	verheddert	disorder
rốm	entdeckt	rom
rồ	verrückt	"(term should be ""điên rồ"") foolish (adj.)"
rồi	schon	and
rồng	drache	dragon
rổ	korb	basket
rỗi	kostenlos	savation
rỗng	leer	hollow
rộ	trubel	profuse (adj.)
rộn	beschäftigt	busy
rộng	breit	wide
rớt	scheitern	drop
rời	links	leave
rỡ	brillant	brilliant
rợ	barbaren	a savage (n.)
rợn	gruselig	scary
rụng	herausfallen	to drop
rủ	hängend	ask
rủi	missgeschick	unlucky or unfortunate (n.)
rứa	rứa	rua
rừng	wald	forest
rửa	waschen	to wash (v.)
rữa	waschen	to decompose or rot (v.)
sa	sa	to fall or drop (v.)
sabah	sabah	sabah
sachsen	sachsen	sachsen
saddam	saddam	(proper noun) saddam, as in saddam hussein
safari	safari	safari
safin	safin	safin
sahara	sahara	sahara
sai	falsch	wrong
saigon	saigon	saigon
saintdenis	saintdenis	saint-denis
sakura	sakura	sakura
salem	salem	(proper noun) salem, as in the city
salvador	salvador	salvador
salzburg	salzburg	salzburg
samhain	samhain	samhain
samo	samo	samo, the name of the first slavic ruler
samoa	samoa	(proper noun) samoa
samphan	samphan	samphan
samsung	samsung	samsung
samuel	samuel	samuel
samuelson	samuelson	(proper noun) samuelson
samurai	samurai	samurai
samut	samut	(proper noun) samut, as in samut prakan in thailand
san	san	level
sanchez	sanchez	sanchez
sang	zu	to
sango	sango	sango, a language spoken in africa
sangraal	sangraal	sangraal
sanh	geburt	bear
sanktpeterburg	sanktpeterburg	sankt-peterburg
santos	santos	santos, as in footballer cristiano ronaldo dos santos aveiro of portugal
sao	sterne	how
sap	saft	sap
sapa	sapa	sapa
sapiens	sapiens	sapiens
sar	sar	sar
sarah	sarah	sarah, as in sarah pierce
sarawak	sarawak	(proper noun) sarawak, a malaysian state on the island of borneo
sarcoma	sarkom	sarcoma
sardinia	sardinien	sardinia
sary	sary	(proper noun) sary, as in ieng sary
saturanga	saturanga	saturanga
saturday	samstag	saturday
sau	später	after (adv.)
saudi	saudi	(proper noun) saudi, as in saudi arabia
saunière	saunière	saunière
scandinavia	skandinavien	scandinavia
schafer	schafer	schafer, as in john c. schafer
schengen	schengen	schengen
schiller	schiller	schiller
schlesinger	schlesinger	schlesinger
schneider	schneider	schneider, a last name
schumacher	schumacher	schumacher, as in michael schumacher
schuschnigg	schuschnigg	(proper noun) schuschnigg, as in kurt schuschnigg of austria
schuster	schuster	schuster
schwarzschild	schwarzschild	schwarzschild
scotland	schottland	scotland
scots	schotten	(proper noun) scots
scott	scott	scott
scream	schreien	scream
scud	scud	scud
scuderia	scuderia	scuderia
sdram	sdram	sdram
search	suche	search
seattle	seattle	(proper noun) seattle, washington
secret	geheimnis	bi mat
sedna	sedna	(proper noun) sedna
see	siehe	see
sejm	sejm	(proper noun) sejm
selena	selena	selena
semit	semit	(proper noun) semit
sen	lotus	lotus
sense	sinn	sense
september	september	(proper noun) the month of september
serbia	serbien	serbia
sergeyevich	sergeyevich	(proper noun) sergeyevich
seri	serie	series
service	service	service
sesshomaru	sesshomaru	a name
seth	seth	seth
seto	seto	seto
sextus	sextus	sextus
sexy	sexy	sexy
seymour	seymour	seymour
seyssinquart	seyssinquart	(proper noun) seyss-inquart
shah	shah	shah
shaman	schamane	the shaman religion
shan	shan	shan
shane	shane	(proper noun) shane, an english first name
shankly	schlaksig	(proper noun) shankly, as in bill shankly
shaolin	shaolin	shaolin, as in the shaolin temples
sharpay	sharpay	sharpay, as in sharpay evans
shawn	shawn	shawn
sherlock	sherlock	a name
shi	shi	shi
shia	shia	shia
shiite	schiitisch	shiite
shikoku	shikoku	shikoku, a japanese island (n.)
shinichi	shinichi	shinichi
shinoda	shinoda	shinoda, as in mike shinoda
shirakami	shirakami	(proper noun) shirakami
shirakawago	shirakawago	(proper noun) shirakawa-go
shiva	shiva	shiva
shoal	schwarm	(proper noun) shoal
shonen	shonen	shonen
shop	einkaufen	shop
short	kurz	short
showcase	schaufenster	a name
shōnen	shōnen	shonen
siberi	siberi	siberi
sicilia	sicilia	sicilia
sicily	sizilien	sicily, a city in italy
sidney	sidney	(proper noun) sidney, as in sidney nolan
siem	siem	siem
siemens	siemens	siemens
sierra	sierra	(proper noun) sierra
sikh	sikh	sikh
sikorsky	sikorsky	a name
silas	silas	silas
silesia	schlesien	silesia
silic	silizium	silicon
silicat	silikat	silicate
silva	silva	(proper noun) silva, as in carlos silva
silvestris	silvestris	silvestris
simone	simone	simone
sinai	sinai	sinai, as in mount sinai
sinensis	sinensis	sinensis
sing	singen	sing
sinh	geboren	genital
sip	schluck	sip
sirô	sirup	name of a member
sistema	sistema	(proper noun) sistema
siu	siu	siu
siêu	super	super
siết	festziehen	to cut off (v.)
sky	himmel	sky
skype	skype	skype
skyteam	skyteam	skyteam
sl	sl	sl
slav	slaw	(proper noun) slav
slavơ	slaw	slavic
slytherin	slytherin	(proper noun) slytherin, as in salazar slytherin of the harry potter series
sm	sm	sm
smg	smg	smg
smith	schmied	smith
smithsonian	smithsonian	smithsonian
so	so	compare
société	société	societe
socrates	sokrates	socrates
sohee	sohee	a korean name
soho	soho	soho
soi	soi	look/stare soi sáng=enlight
solaris	solaris	(proper noun) solaris
som	som	(proper noun) som, as in kampong som
somme	somme	somme
sonata	sonate	sonata
song	lied	however (adv.)
sony	sony	sony
soo	soo	soon
sophie	sophie	(proper noun) sophie, a first name
sopwith	sopwith	a name
sorbonne	sorbonne	sorbonne, the university in paris (n.)
sos	sos	sos
soul	seele	soul
soát	kontrolle	control
soạn	komponieren	compose
spears	speere	spears
spellman	zauberer	spellman
spence	spence	(proper noun) spence
spencer	spencer	(proper noun) spencer
spielberg	spielberg	(proper noun) spielberg, as in steven spielberg
sports	sport	sports
sri	sri	(proper noun) sri, as in sri lanka
ss	ss	ss
st	st	st.
stalingrad	stalingrad	stalingrad
stamford	stamford	this is a name
stand	stehen	stand
stanford	stanford	stanford, as in stanford university
stanley	stanley	stanley
starr	stern	a name
startin	anfangen	bat dau
status	status	status
stdc	stdc	stdc
stefan	stefan	stefan
steiermark	steiermark	steiermark
steiner	steiner	steiner
stelzer	stelzer	stelzer
stennis	stennis	stennis
stephen	stephen	stephen
stephenie	stephenie	"stephenie, as in stephenie meyer, author of ""twilight"""
sterling	sterling	a name
steve	steve	steve
stevens	stevens	(proper noun) stevens, as in amanda stevens
stevenson	stevenson	stevenson
stevie	stevie	stevie
stewarthannah	stewarthannah	stewart/hannah
stf	stf	stf
stimson	stimson	stimson, as in henry lewis stimson, former secretary of war
stockholm	stockholm	a name
stones	steine	stones
storting	storting	storting
strasberg	straßberg	strasberg
strauss	strauss	strauss
street	straße	street
struct	struct	struct
stt	stt	order number
stuart	stuart	stuart
stuttgart	stuttgart	(proper noun) stuttgart, a city in germany
styx	styx	(proper noun) styx, as in the river styx
stéfano	stéfano	stefano
su	su	condom
subakhi	subakhi	subakhi
suez	suez	(proper noun) suez
suharto	suharto	suharto
sukarno	sukarno	(proper noun) sukarno,  president of indonesia
sulfua	sulfid	sulfide
sulu	sulu	sulu
sum	summe	reunite
sumatera	sumatera	sumatera
sumatra	sumatra	(proper noun) the island of sumatra
sumitomo	sumitomo	sumitomo
summer	sommer	summer
summerslam	summerslam	(proper noun) summerslam
sun	sonne	sun
sunday	sonntag	(proper noun) sunday
sung	feigen	supplement
sunni	sunnitisch	sunni
sunsilk	sonnenseide	sunsilk, a hair products company
super	super	super
suriname	suriname	suriname
susan	susan	(proper noun) susan
susilo	susilo	(proper noun) susilo
sutra	sutra	sutra
suub	suub	a name
suvp	suvp	suv-p
suy	beeinträchtigt	decrease
suê	so	lush
suôn	reibungslos	smooth
suất	produktivität	number
suối	stream	stream
suốt	überall	through/all over
suồng	glatt	overfamiliar
svd	svd	svd
swan	schwan	swan
swaziland	swasiland	swaziland
sweet	süß	sweet
sy	sy	sy
sydney	sydney	(proper noun) sydney, a city in australia
symantec	symantec	symantec
sync	synchronisieren	sync
syria	syrien	syria
sài	sai	"(term should be ""sơ sài"") something done without care (adv.)"
sàn	boden	san
sàng	sieb	ready
sành	geschirr	"(term should be ""sành sứ"") pottery"
sào	stange	"(term should be ""sào huyệt"") den or hideout (n.)"
sá	sá	road
sách	bücher	list
sái	falsch	sai
sám	reuig	penitent
sáng	bin	light
sánh	vergleichend	compare
sáo	flöte	flute
sáp	wachs	merger
sát	schließen	"(term should be ""quan sát"") to watch or observe (v.)"
sáu	sechs	six
sâm	ginseng	sam
sân	hof	"(should be ""sân khấu"") a stage"
sâu	tief	deep
sã	sã	flippant
sãi	falsch	pagoda warden
são	são	sao, as in sao paolo, brazil
sét	blitz	clay
sê	se	sepon
sêri	serie	series
sêu	moos	seu tet
sính	student	betrothal gifts
síp	zypern	cyprus
sít	eng	close
sò	austern	oyster
sòng	casino	casino
sóc	eichhörnchen	"(should be ""sóc trăng"") a vietnamese town"
sói	wolf	wolf
sóng	welle	wave
sót	auslassung	to miss (v.)
sô	nummer	than
sôi	kochen	vibrant
sông	fluss	river
sùng	hingabe	cult
sú	schwarzer tiger	a type of mangrove (n.)
súc	rinder	animal
sún	sinken	sun
súng	waffe	gun
súp	suppe	source
sút	schuss	reduce
săn	jagen	to hunt
sơn	gemalt	a mountain
sư	professor	lion
sưa	milch	filled with
sưng	schwellung	swell
sưu	sammlerstücke	collection
sương	tau	dew (n.)
sướng	glücklich	high
sườn	koteletts	slope
sưởi	heizung	heat
sạch	sauber	clean
sạn	hotel	hotel
sảm	hell	sam
sản	produktion	reproductive
sảng	frisch	sonorous
sảnh	halle	a hall, as in the rock and roll hall of fame
sấm	donner	ginseng
sấu	krokodil	crocodile
sấy	trocknen	dry
sầm	knallt	crowded
sầu	melancholie	sad
sẩn	papeln	coarseness
sẫm	dunkel	dark
sập	zusammenbruch	destroy
sắm	einkaufen	shopping
sắn	maniok	cassava (n.)
sắp	kurz davor	soon
sắt	eisen	"(term should be ""sắt son"") constant (adj.)"
sẵn	verfügbar	available
sẹo	narbe	scar
sẻ	wird	share
sẽ	wird	will
sọ	schädel	brain
sọc	streifen	stripe
sỏ	frech	oligarchy
sỏi	kies	gravel
số	nummer	"(term should be ""số lượng"") quantity (n.)"
sốc	schockiert	shock
sống	leben	live
sốt	fieber	fever
sồi	eiche	oak
sổ	buch	window
sớ	wird	document
sớm	früh	som
sờ	berühren	touch
sỡ	verpasst	colorful
sợ	hab angst	afraid
sợi	garn	fibers
sục	whirlpool	"(term should be ""sôi sục"") to boil"
sụn	knorpel	cartilage
sụp	zusammenbruch	collapse
sụt	einbruch	drop
sủa	bellen	bright
sủi	brausetabletten	sparkling
sủng	charismatisch	favored
sứ	porzellan	embassy
sứa	quallen	jellyfish (n.)
sức	stärke	strength
sứt	abgebrochen	cleft
sừng	horn	sừng sững= huge
sử	geschichte	"(term should be ""sử dụng"") to use (v.)"
sửa	beheben	repair
sửng	schockiert	startling
sửu	ox	cow
sữa	milch	milk
sự	die	situation
ta	ta	us or our
tae	tae	(proper noun) tae
tag	tag	tag
tai	ohr	ear
taiji	taiji	(proper noun) taiji
taipei	taipei	taipei
taiwan	taiwan	taiwan
taj	taj	taj, as in taj mahal
tajikistan	tadschikistan	tajikistan
tajima	tajima	tajima
tajiri	tajiri	tajiri
takahashi	takahashi	(proper noun) takahashi
taklamakan	taklamakan	taklamakan
tali	tali	thallium
taliban	taliban	taliban
talmud	talmud	talmud
tam	tam	three (n.)
tamoxifen	tamoxifen	tamoxifen
tanaka	tanaka	tanaka
tang	trauer	funeral
tanh	fischig	deserted
tankōbon	tankōbon	tankobon, as in a type of japanese literature
tanzania	tansania	tanzania
tao	ich	(proper noun) tao, a chinese name
tarim	tarim	tarim
task	aufgabe	task
tasman	tasman	tasman, as in abel tasman
tasmania	tasmanien	tasmania, a place
tau	tau	tau
taxi	taxi	taxi
tay	hände	hand
taylor	taylor	taylor
tbt	tbt	tbt
tchad	tchad	tchad
tcm	tcm	tcm
tcp	tcp	tcp
technical	technisch	technical
ted	ted	(proper noun) ted
teddy	teddy	teddy, as in teddy lupin, a character in the harry potter series
telecom	telekommunikation	telecom
telekom	telekom	telekom
telex	telex	telex
telnet	telnet	telnet
tem	stempel	stamp
temple	tempel	temple
temujin	temujin	temujin
temur	temur	(proper noun) temur, as in temur oljeitu
tenxơ	kartell	tensor
teo	atrophie	atrophy
terengganu	terengganu	(proper noun) terengganu
territories	gebiete	territories
terry	frottee	terry
terumbu	terumbu	(proper noun) terumbu
tet	tet	tet
texas	texas	(proper noun) the state of texas
tgv	tgv	tgv
tha	tha	to forgive (v.)
thai	schwanger	pregnant
thailand	thailand	thailand
tham	gier	involved
thames	themse	thames
than	kohle	coal
thang	leiter	ladder
thanh	bar	youth
thani	thani	thani
thao	sport	sport
thau	messing	a basin (n.)
thay	stattdessen	change
thcn	thcn	vocational school
thcs	thcs	secondary
thdq	thdq	thdq
thebes	thebes	thebes
their	ihre	their
them	sie	plus
then	dann	key
theo	folgen	according to
theory	theorie	thẻoy
theravada	theravada	theravada
theres	theres	there
theseus	theseus	theseus, the greek hero
thi	prüfung	competition (n.)
thich	wie	explanation
thien	thien	sky
third	drittens	thỉd
thiu	abgestanden	buồn thiu= sad/boring
thiêm	thiêm	thiem
thiêng	heilig	"(term should be ""thiêng liêng"") sacred or holy"
thiếc	zinn	tin
thiến	kastration	castrate
thiếp	visitenkarte	concubine
thiết	einstellen	"(term should be ""cần thiết"") necessary (adj.)"
thiếu	fehlt	lack
thiềm	sichel	crescent
thiền	meditation	buddhist (adj.)
thiển	zeigen	superficial
thiểu	moll	minimum
thiện	gut	good
thiệp	karten	intervene
thiệt	wirklich	damage
thiệu	einführung	"(term should be ""giới thiệu"") to introduce (v.)"
tho	tho	tho
thoa	tupfen	combination
thoai	thoai	gentle
thomas	thomas	thomas
thompson	thompson	thompson
thong	tanga	(proper noun) thong, as in ang thong
those	diese	those
thoái	regressiv	deterioration
thoán	rate mal	usurpation
thoáng	luftig	"(term should be ""thoáng qua"") to pass quickly"
thoát	ausfahrt	drainage
thoại	stimme	telephone
thoạt	auf den ersten blick	just (adv.)
thoả	deal	compromise
thoải	bequem	"(term should be ""thoải mái"") comfortable or relaxing (adj.)"
thoảng	gelegentlich	"(term should be ""thỉnh thoảng"") occasionally (adv.)"
thoắt	eingabeaufforderung	suddenly
thpt	thpt	high school
thriller	thriller	thriller
thskts	thskts	phd- architect
thua	verlieren	defeat
thumb|các	daumen | der	thumb|many
thunderbolt	blitz	thunderbolt
thung	tal	valley
thuyên	verschiebung	a name
thuyết	theorie	theory
thuyền	boot	boat
thuê	mieten	employ
thuần	rein	"(term should be ""đơn thuần"") pure (adj.)"
thuẫn	konflikt	support
thuận	profis	favourable
thuật	art	term
thuế	steuer	tax
thuốc	medizin	medicine (n.)
thuộc	gehören dazu	belong
thuớc	wasser	"(term should be ""kích thước"") dimensions of an object"
thuờng	normalerweise	usually
thuở	kindheit	period
thuỵ	thuy	"(term should be ""thụy Điển"") the nation of sweden (proper noun)"
thuỷ	thuy	water
thvn	thvn	vietnam television
thy	dein	thy
thà	würde lieber	honest
thành	zu	"(term should be ""hình thành"") to take shape"
thày	lehrer	teacher
thác	kaskade	harvest
thách	herausforderung	challenge
thái	thailändisch	attitude
thám	detektiv	to spy (v.)
tháng	monat	month (n.)
thánh	heilig	a holy person; a saint (n.)
tháo	lösen	"(term should be ""tháo chạy"") to run with abandon"
tháp	turm	tower
thâm	intensiv	penetrate
thâu	geklebt	to collect (v.)
thây	siehe	body
thãi	scheiße	superabundant
thèm	sehnen sich	desire
thép	stahl	steel
thét	schrie	shout
thê	die	category
thêm	hinzufügen	more
thêu	stickerei	to embroider (v.)
thìa	löffel	spoon
thìn	dann	(proper noun) thìn, the year of the dragon
thình	plötzlich	"(term should be ""thình lình"") suddenly"
thí	experimente	(with word du) for example
thít	thit	(proper noun) mân thít, a district in vietnam
thò	stocherte	tho
thòi	nachteil	"(term should be ""thiệt thòi"") to cost (adv.)"
thóc	reisfeld	grain (n.)
thói	gewohnheit	a habit (n.)
thô	rau	rough, old-fashioned
thôi	komm schon	only
thông	informiert	"(term should be ""thông thường"") usual (adj.)"
thù	fehde	"entire term should be ""ke thu""; means ""enemy"""
thùng	fass	barrel
thùy	lappen	thuy
thú	interessant	"(should be ""thích thú"") pleasurable"
thúc	ende	push
thúy	thuy	thuy
thăm	besuchen	visit
thăng	gefördert	helicopter
thơm	duftend	aromatic
thư	brief	"(term should be ""ung thư"") cancer (n.)"
thưa	liebes	sparse
thương	liebe	love
thước	lineal	ruler
thường	oft	usually (adv.)
thưởng	belohnung	to reward (v.)
thược	thud	(proper noun) thược
thượng	oben	upper
thạc	meister	master
thạch	gelee	rock or stone (n.)
thạnh	thanh	thanh
thạo	experte	fluent
thả	fallen lassen	"(term should be ""thả lỏng"") to let loose (v.)"
thải	abfall	waste
thảm	teppich	carpet or rug (n.)
thản	ruhig	calmly
thảo	thao	"(term should be ""hội thảo"") a workshop (n.)"
thấp	niedrig	low (adj.)
thấu	eindringmittel	penetrate
thầm	lautlos	"(term should be ""thì thầm"") to whisper (v.)"
thần	gott	"entire term should be ""tinh than""; means ""of the mind"""
thầy	lehrer	teacher (n.)
thẩm	juroren	osmotic/leak
thẫm	dunkel	dark
thận	nieren	careful
thập	kreuz	tens
thật	wahr	true (adj.)
thắm	blütenblatt	tham
thắn	ehrlich gesagt	frank
thắng	gewonnen	win
thắngthua	wonthua	win-lose
thắp	licht	light
thắt	fesseln	tense
thằn	eidechse	"entire term should be ""than lan""; means ""lizard"""
thằng	guy	a derogatory term for a man (n.)
thẳm	tief	"(term should be ""thăm thẳm"") extremely deep (adj.)"
thẳng	gerade	horizontal
thặng	überschuss	surplus
thẹn	beschämt	shameful
thẻ	karte	card
thế	also	"with word ""tu,"" means ""posture"" or ""a position"""
thếp	stahl	steel
thề	schwöre es	swear
thềm	regal	shelf
thể	sein	maybe
thỉnh	manchmal	"(term should be ""thỉnh thoảng"") occasionally"
thịnh	mode	prosperous
thịt	fleisch	meat (n.)
thọ	langlebigkeit	phu tho
thọc	jab	jab
thỏ	kaninchen	rabbit
thỏa	vereinbarung	"(term should be ""thoả thuận"") to come to an agreement (v.)"
thỏi	barren	a bar (n.)
thối	faul	smelly
thốt	geäußert	scream
thồ	packen	to transport via horse (v.)
thổ	erde	"(term should be ""lãnh thổ"") territory (n.)"
thổi	blasen	blow
thớt	schneidebrett	sparse
thời	zeit	period
thở	atme	breathe
thợ	arbeiter	craftman
thụ	rezeptor	"(term should be ""thụ thai"") to become pregnant"
thục	shu	(proper noun) a vietnamese first name
thụt	eingerückt	clyster
thủ	prime	masturbate
thủa	thua	during childhood
thủng	perforation	having holes
thứ	dinge	no.
thức	wach	way
thừa	redundant	redundant
thừng	seil	"(term should be ""thẳng thừng"") mercilessly"
thử	versuche es	try
thửa	paket	square
thự	villa	mansion
thực	echt	perform
ti	ti	titov
tia	strahlen	ray
tiananmen	tiananmen	tiananmen
tiara	tiara	tiara
tibet	tibet	(proper noun) tibet
tigris	tigris	tigris
tiliaceus	tiliaceus	hoa dam but
tim	herz	heart
timor	timor	timor
timothy	timothy	timothy
tin	glaube	believe
tinbắc	nachricht	file bac
tincầu	zinnbrücke	file bridge
tinh	planet	"(term should be ""tinh dịch"") sperm (n.)"
tinnhà	tinhome	folder: house
tinsông	nachrichten	file river
tinthị	zehntel	file: town
tirol	tirol	tirol
tisdale	tisdale	tisdale
tish	tish	(proper noun) tish
tissa	tissa	(proper noun) tissa, as in moggaliputta tissa
tivi	fernsehen	television
tizard	assistent	(proper noun) tizard
tiên	zuerst	first
tiêu	pfeffer	"entire term should be ""tieu chuan""; means ""a requirement"""
tiếc	leider	"(term should be ""tiếc thương"") to pity (v.)"
tiếm	goofy	seize
tiến	vorwärts	operate
tiếng	stunden	language
tiết	sekretion	abstinence/intensity
tiếu	doof	"(should be ""đàm tiếu"") to sneer"
tiềm	potenzial	potential
tiền	geld	money (n.)
tiều	scheiße	(proper noun) the name of a poet
tiểu	pinkeln	tiểu sử= biography
tiễu	herr liu	patrol
tiệc	party	party
tiệm	salon	shop
tiện	bequem	mean
tiệp	tschechisch	gustav franck
tiệt	verdammt	sterilize
tncs	tncs	communist youth union
tngt	tngt	traffic accidents
tnhh	begrenzt	limited
toang	toang	fast
tobago	tobago	tobago
toei	toei	toei
tokugawa	tokugawa	tokugawa
tokyo	tokio	tokyo, the capital of japan
tokyopop	tokyopop	tokyopop
tomas	tomas	(proper noun) tomas
tommy	tommy	tommy
tomoyo	tomoyo	tomoyo
tony	tony	tony
toonami	toonami	(proper noun) toonami
top	oben	top
torino	turin	torino, as in the italian city
toriyama	toriyama	(proper noun) toriyama
tottenham	t tottenham	tottenham
tourism	tourismus	tourism
tourist	tourist	tourist
toyama	toyama	toyama
toyota	toyota	(proper noun) toyota
toà	gericht	office
toàn	sicher	entire or whole (adj.)
toán	mathe	team
toát	gut	to exude or emit, as in sweat (v.)
toạ	koordinaten	locate
toại	bei	satisfaction
toả	ausstrahlen	spread
tp	tp	city
tphcm	tphcm	ho chi minh city
tphồ	stadt	city ho
tpvĩnh	stadt	vinh city
tqlc	tqlc	marine
trafalgar	trafalgar	(proper noun) trafalgar
trafford	trafford	trafford in greater manchester
trai	muscheln	boy
trang	seite	a page (n.)
tranh	bilder	to compete (v.)
trao	ausgezeichnet	reward
trau	trau	polish
tre	bambus	bamboo (n.)
treo	hängen	hang
tri	tri	tri
tribune	tribüne	a name
trinh	jungfrau	"(should be ""trinh bạch"") virtuous"
trinidad	trinidad	trinidad
trinity	dreifaltigkeit	trinity
tristan	tristan	tristan
triết	philosophie	philosophy
triền	trien	"(should be ""triền miên"") endless"
triều	flut	court
triện	dichtung	stamp
triệt	gründlich	completely
triệu	millionen	a million
tro	asche	ashes
troia	troia	troy
trondheim	trondheim	trondheim
trong	in	inside (adv.)
true	wahr	true
truman	truman	(proper noun) truman
trung	mitte	"(term should be ""trung gian"") agent (n.)"
trungnhật	ehrlichkeit	china-japan
truong	wahr	truong
truyên	truyen	story
truyện	geschichte	story
truân	wahr	arduous
truất	kritiker	cancel
truởng	chef	leader (n.)
truỵ	lügen	depraved
trà	tee	tea (n.)
tràm	cajuput	melaleuca
tràng	doppelpunkt	"entire term should be ""truc trang""; means ""rectum"""
trào	eruption	movement
trác	trac	trac
trách	schuld	blame
trái	links	against
trán	stirn	forehead
tráng	beschichtet	to coat (v.)
tránh	vermeiden	to avoid (v.)
tráo	krabbeln	tráo trở= liar/betrayal/treacherous
tráp	schatullen	casket
trát	gewähr	pile
trâm	brosche	a type of elegant hairpin (n.)
trân	viele grüße	respect
trâu	büffel	a last name
trãi	verstreut	trai
trèo	klettern	climb
trên	auf	above
trình	einreichung	process
trí	geist	intellectual
trích	auszug	to extract (v.)
trò	spiele	role
tròn	rund	rounding
trói	gefesselt	tie
trôi	treiben	afloat
trông	sieht aus	look
trùm	chef	cover
trùng	zusammenfallen	"(should be ""tinh trùng"") sperm"
trùy	truy	something to with monk
trú	einsteigen	residence
trúc	bambus	structure
trăm	hundert	hundred
trăn	python	"(term should be ""trăn trở"") to ponder (v.)"
trăng	mond	moon
trĩ	hämorrhoiden	hemorrhoids
trũng	versunken	medium
trơ	inert	bare
trơn	glatt	slippery (adj.)
trư	tru	a pig (n.)
trưa	mittag	noon (n.)
trưng	anforderung	symbolic
trưngcông	ausgestellt	truongcong
trương	truong	policy
trước	vorher	front
trước 	vorher	front
trướng	erweiterung	expand
trườn	kriechen	crawl
trường	schule	case
trượng	caduceus	a unit of length used in vietnam equal to 4 meters (n.)
trượt	rutschen	slide
trạch	trach	ze
trại	lager	camp
trạm	station	station
trạng	zustand	situation
trạo	tao	trao
trả	bezahlen	to return
trải	abdeckung	spread
trảm	cajuput	beheaded
trảo	macheten	trao
trấn	stadt	town
trấu	reisschale	rice skin
trầm	bass	depression
trần	nackt	tran
trầu	betel	trầu
trầy	zerkratzt	scratch
trẩy	springen	pilgrimage
trẫm	ich bin	i
trận	das spiel	battle
trật	ausgerenkt	order
trắc	biometrie	"(term should be ""trắc ẩn"") to have pity (adj.)"
trắng	weiß	white
trặc	schluckauf	"entire phrase is ""truc trac""; means ""problem"""
trẻ	jung	youth
trễ	sei zu spät	late
trệ	stagniert	bamboo
trị	behandlung	cure
trịnh	phnh	trịnh, a vietnamese last name
trọ	gasthaus	motel
trọn	voll	whole
trọng	wichtig	serious
trỏ	zeiger	index
trối	finale	last words
trốn	verstecken	to hide
trống	leer	in
trồi	entstehen	to emerge (v.)
trồng	pflanzen	plant
trổ	zeigen	to burst open or display
trỗi	entstehung	rise
trội	dominant	better
trộm	dieb	theft
trớn	liebkosung	"(term should be ""mơn trớn"") to fondle or caress (v.)"
trời	gott	sun
trợ	unterstützung	support
trụ	büro	universe
trục	achse	"(term should be ""khu trục"") fighter, in reference to planes (adj.)"
trụi	nackt	"(term should be ""trơ trụi"") bare (adj.)"
trứ	tru	famous
trứng	eier	egg
trừ	außer	except
trừng	blendung	punish
trừu	abstrakt	abstract
trữ	lagerung	reserve
trực	im dienst	direct
ts	ts	phd
tt	tt	news
tua	tentakel	fringe
tucker	tucker	tucker, an english last name
tudor	tudor	(proper noun) tudor, as in the tudor family
tukhachevsky	tukhachevsky	(proper noun) tukhachevsky
tulip	tulpe	tulip
tum	tum	tum
tung	werfen	release
tupolev	tupolev	tupolev, as in alexei tupolev
tuscan	toskanisch	(proper noun) tuscan
tutsi	tutsi	(proper noun) tutsi
tuvalu	tuvalu	(proper noun) tuvalu, a polynesian island nation
tuy	jedoch	however
tuyên	erklären	"(should be ""tuyên ngôn"") a declaration"
tuyết	schnee	snow (n.)
tuyền	tuyen	tuyen
tuyển	rekrutierung	recruit
tuyệt	großartig	excellent (adj.)
tuân	gehorche	comply
tuông	spülen	jealous
tuý	tuyý	drug
tuần	woche	week
tuế	minnows	years
tuệ	weisheit	intelligence
tuốc	zupfen	turbine
tuổi	alter	age
tuộc	krake	octopus
tuột	abrutschen	slip
tuỳ	optional	depend
tv	tv	tv
tvb	tvb	tvb
twin	zwilling	twin
twitter	twitter	twitter
ty	ty	company
type	typ	type
typhon	taifun	typhon
tà	böse	we
tài	glück	talent (n.)
tàn	asche	dying
tàng	museum	"(should be ""bảo tàng"") a museum"
tành	tanh	shatter
tàu	schiff	ship
tá	dutzend	"(term should be ""thiếu tá"") major (n.)"
tách	tasse	to separate
tái	re	return
tám	acht	eight
tán	baldachin	support
tánh	tanh	life
táp	tippen sie auf	to lap at (v.)
táu	schuldig	ashton
tâm	geist	tâm
tâu	mein herr	peach
tây	westen	western
tâynam	westnam	"(should be ""tây-nam"") southwest"
tã	windeln	diaper
tét	kreischen	tet
tê	taub	numb
tên	der name	name (n.)
tì	milz	to lean on (v.)
tìm	finden	find
tìmdiệt	suche	find-kill
tình	liebe	sex
tía	lila	dad
tích	produkt	"(term should be ""tích cực"") to be zealous (adv.)"
tím	lila	purple
tín	credits	"(entire term should be ""tín dụng"") credit"
tít	überschrift	"(term should be ""tít mù"") very far away (adv.)"
tò	neugier	curious
tòa	gericht	a court
tòi	zeug	"(term should be ""tìm tòi"") to search doggedly for something (v.)"
tòng	tong	tòng, a last name
tóm	kompendium	summary
tô	schüssel	car
tôi	ich	i
tôm	garnelen	shrimp
tôn	gewellt	venerate
tông	karton	tông, as in lê thánh tông; first name of an ancient vietnamese emperor
tù	gefängnis	prison
tùng	ersatz	tung
tùy	optional	depend on
túc	genügsamkeit	"(term should be ""bổ túc"") to give a refresher course (v.)"
túi	tasche	pocket
túm	greifen	catch
túng	umständlich	confuse
túp	hütte	hut
túy	droge	"(term should be ""thuần túy"") pure (adj.)"
tý	ratte	mouse, as in year of the mouse
tăm	zahnstocher	"(term should be ""tiếng tăm"") reputation"
tăng	erhöhen	increase
tĩnh	statisch	calm
tơi	ich	ragged
tư	von	posture
tưng	wackelig	"(term should be ""tưng bừng"") joyously (adv.)"
tươi	frisch	fresh
tương	ähnlich	"(term should be ""tương tự"") to be similar to"
tước	ausgezogen	title (n.)
tưới	gießen	irrigation
tướng	allgemein	prime minister (thu tuong)
tường	wand	"a common vietnamese first name; means ""wall"""
tạ	langhantel	weight
tạc	skulptur	"(term should be ""oanh tạc"") to bomb from the air (v.)"
tại	bei	survival
tạm	vorläufig	temporary
tạo	erstellen	create
tạp	magazin	"(should be ""hỗn tạp"") a jumble or mish-mash"
tả	beschreibung	describe
tản	dissipation	disperse
tảng	plattform	platform
tấc	zoll	inch
tấm	teller	mirror
tấn	tonnen	tan
tấp	gezogen	crowded
tất	socken	all
tấu	instrumental	tau
tầm	spiele	range or extent (n.)
tần	frequenz	"(term should be ""tần số"") frequency (n.)"
tầng	boden	layer
tầu	zug	ship
tẩm	imprägniert	soak
tẩy	radiergummi	to bleach
tận	ende	dedicated
tật	behinderung	disease
tắc	schalter	priciple
tắm	nimm ein bad	bathing
tắt	aus	initial
tặc	hacker	"(term should be ""hải tặc"") a pirate (n.)"
tặng	spenden	donate
tẻ	eintönig	lẻ tẻ= scattered
tết	tet	(proper noun) the vietnamese new year
tếxã	wirtschaftlich	economy - society
tề	qi	tidy
tể	herr	lord
tệ	schlecht	bad
tệp	datei	file
tỉa	getrimmt	"(term should be ""bắn tỉa"") to snipe"
tỉnh	provinz	province
tị	neid	refugee
tịch	präsident	"(""chủ tịch"") president or chairman"
tọa	koordinaten	"(term should be ""chủ toạ"") chairman (n.)"
tỏ	ausgedrückt	to
tỏa	ausstrahlen	radiate
tỏi	knoblauch	garlic
tốc	geschwindigkeit	speed
tốn	kosten	to cost (v.)
tống	eskorte	dispose
tốp	bande	top
tốt	gut	good
tồi	schlecht	bad
tồn	existieren	exist
tổn	verletzt	damage
tổng	insgesamt	president
tộc	clan	"(term should be ""dân tộc"") a race or people"
tội	verbrechen	crime
tột	extrem	extreme
tớ	ich	servant
tới	zu	to the point
tờ	blatt	paper/document
tởm	widerlich	disgusting
tục	profan	"(term should be ""tập tục"") customs or practices"
tụy	bauchspeicheldrüse	"(term should be ""tận tụy"") devoted (adj.)"
tủ	schränke	shelf
tủi	schlecht	humiliated
tủy	medulla	spine
tức	sofort	i.e.
từ	von	from
từng	jeweils	each
tử	tod	lion (su tu)
tửu	trinken	wine
tự	selbst	"(term should be ""tương tự"") like or similar to (adv.)"
tựa	titel	lean
tựu	erfolge	achievement
tỵ	schlange	the han name for the year of the snake, according to the chinese zodiac
tỷ	milliarden	billion
u	u	tumor
ua	ua	ua
uae	vae	uae
ubuntu	ubuntu	ubuntu
uc	uc	uc
uchiha	uchiha	uchiha
uefa	uefa	uefa
uh	äh	uh
uk	großbritannien	uk
ukiyoe	ukiyoe	ukiyoe
ukraina	ukraine	ukraine
ulsan	ulsan	ulsan
umm	umm	umm
un	un	(proper noun) un, as in chung un chan of korea
und	und	und
under	unter	under
unesco	unesco	unesco
ung	ung	cancer
unicorn	einhorn	unicorn
unit	einheit	unit
unix	unix	unix
up	ups	up
ural	ural	ural, as in the ural mountains
urani	uran	uranium
uri	uri	uri, a former political party in south korea
uruguay	uruguay	uruguay
usagi	usagi	usagi
usb	usb	usb
uss	uss	uss
utah	utah	utah
utrecht	utrecht	(proper noun) utrecht
uy	uy	"(term should be ""uy lực"") power (n.)"
uyghur	uigurisch	(proper noun) uyghur
uygur	uygur	uygur
uyên	uyen	scholarly
uyển	euphemismus	"(term should be ""uyển chuyển"") flexible (adj.)"
uzbekistan	usbekistan	uzbekistan
uông	uong	uong
uất	uất	busy
uốn	biegen	to curl (v.)
uống	zu trinken	to drink
uổng	verschwenden	vain
v	v	v
va	va	collide
vaccine	impfstoff	vaccine
vai	schulter	shoulder
valencia	valencia	valencia
valentine	valentinstag	valentine
valley	tal	valley
van	van	"(term should be ""van xin"") to beg (v.)"
vanessa	vanessa	vanessa
vargas	vargas	(proper noun) vargas
vasari	vasari	vasari
vay	ausleihen	borrow
vectơ	vektor	vector
ven	ven	"(term should be ""ven biển"") coastal (adj.)"
vendôme	vendôme	vendome
venezia	venezia	venice
venus	venus	venus
verdun	verdun	verdun
vermont	vermont	vermont
verona	verona	(proper noun) the city of verona
versailles	versailles	(proper noun) versailles
vhs	vhs	vhs
vi	en	behavior
viagra	viagra	viagra
victor	sieger	(proper noun) victor
victoria	victoria	victoria, a province of australia
vienna	wien	(proper noun) vienna, austria
viet	viet	vietnamese
vietnam	vietnam	vietnam
viettel	viettel	viettel
viii	viii	eighth
vijaya	vijaya	(proper noun) vijaya
viking	wikinger	viking
villa	villa	villa
villeneuve	villeneuve	(proper noun) villeneuve, a french last name
vinagame	vinagame	vinagame
vinashin	vinashin	vinashin
vince	vince	(proper noun) vince, as in vince mcmahon
vincennes	vincennes	vincennes
vincent	vincent	vincent
vinpearl	vinpearl	vinepeal
viqr	viqr	viqr
virginia	virginia	(proper noun) virginia, as in the state
virus	virus	virus
virút	virus	virus
vissarionovich	vissarionovich	vissarionovich
vista	aussicht	vista, as in windows vista
vitamin	vitamine	vitamin
vitruvius	vitruvius	vitruvius
viz	nämlich	(proper noun) viz
viêm	entzündung	inflammation
viên	tabletten	member
viêng	viang	vientiane
viêt	schreiben	vietnam
viếng	besuchen	visit
viết	schreibe	write
việc	arbeit	thing
viện	institut	institute
việt	vietnamesisch	viet
việtmường	vietnamesischer muong	muong
việtnga	vietnga	vietnam-russia
việttrung	viettrung	vietnam-china
vn	vn	vietnam
vnexpress	vnexpress	(proper noun) vnexpress
vni	vni	vni
vo	vo	"(term should be ""tròn vo"") perfectly round (adj.)"
voi	elefant	elephant
voip	voip	voip
voldemort	voldemort	(proper noun) voldemort, the villain from the harry potter series
von	von	compare
vonfram	wolfram	wolfram
vong	opfer	injured
voyager	reisende	voyager
voọc	languren	a langur (n.)
vtc	vtc	vtc
vu	vu	"entire phrase is ""vu cao""; means ""to accuse wrongly"""
vua	könig	king
vui	spaß	happy
vulcan	vulkanisch	vulcan
vuông	quadrat	square
vuốt	krallen	stroke
vv	usw.	etc.
vy	vy	vy
vyacheslav	vyacheslav	vyacheslav
và	und	and
vài	wenige	several
vàm	vm	the mouth of a rivulet (n.)
vàng	gold	gold
vành	felge	coronary
vào	auf	into
vá	patch	patchy
vác	tragen	to shoulder (v.)
vách	wand	wall
vái	ja	some
ván	planke	game
váng	abschaum	film
váy	rock	skirt
vân	so weiter	"(term should be ""vân vân"") et cetera"
vây	fin	encircle
vã	eilte	rush
vãi	scheiße	to release
vãn	van	save
vè	pinkeln	to glance slyly (v.)
vé	tickets	ticket
vét	bagger	plunder
vê	über	tremolo
vì	wegen	because
ví	geldbörse	example
vía	brieftasche	soul
vít	schraube	screw
vò	zerknittert	jar
vòi	schlauch	tap
vòm	bögen	upper jaw
vòng	rund	around
vó	hoooo	hooves
vóc	körperbau	"(should be ""vóc sương"") dew-like or delicate"
vô	nein	"(term should be ""vô số"") countless (adj.)"
vôi	kalk	limestone
võ	kriegerisch	martial arts (n.)
võng	hängematte	hammock
vùi	begraben	"(term should be ""chôn vùi"") to bury or keep secret (v.)"
vùng	region	region
vú	brüste	breast (n.)
vút	hochfliegend	"entire term should be ""cong vut""; extreme curling"
văn	gepostet	culture
văng	spritzen	a name
vĩ	großartig	"(term should be ""vĩ đại"") great (adj.)"
vĩnh	dauerhaft	ving
vũ	vu	armed
vũng	pfütze	vung
vơ	hilflos	lost
vơi	mit	ullage
vưu	vưu	"actual term is ""xi vưu""; proper noun; name of a leader of a people in chinese legend"
vươn	erreichen	reach
vương	könig	kingdom
vướng	verwickelt	"(term should be ""vướng víu"") to become involved in (v.)"
vườn	garten	garden
vượn	affen	gibbon
vượt	passieren	to overcome
vạ	so	unfortunate problem
vạc	kessel	cauldron
vạch	bar	bar
vại	tank	jar
vạn	zehntausend	thousand
vạng	dämmerung	twilight
vả	abb	hard
vải	tuch	fabric
vảy	skalen	scale
vấn	beratung	vấn đề= problem
vấp	stolperte	stumble
vất	wegwerfen	hard
vần	reim	spell
vầng	heiligenschein	moon (vang trang)
vẩn	immer noch	wander
vẩy	flocken	scale
vẫn	immer noch	still
vẫy	winken	wave
vận	glück	active
vắc	impfstoff	vaccine
vắcxin	impfstoff	vaccine
vắn	kurz	short
vắng	abwesend	absent
vặn	schraube	to twist (v.)
vặt	kleinanzeigen	odd
vẹn	integrität	complete
vẹt	papageien	parrots
vẽ	zeichnen	draw
vết	fleck	wound
vểnh	barsch	warping
vệ	verteidigung	"(term should be ""bảo vệ"") to defend (v.)"
vệt	streifen	streak
vỉa	nähte	"(term should be ""vỉa hè"") sidewalk"
vịnh	bucht	bay
vịt	ente	duck
vọng	hoffnung	"(term should be ""hy vọng"") hope (n.)"
vọt	explodieren	to spurt out (v.)
vỏ	shell	shell
vồ	hammer	"(term should be ""gạch vồ"") a type of brick"
vỗ	pat	to clap
vội	beeilen sie sich	hurriedly (adv.)
vớ	socken	"(term should be ""vớ vẩn"") silly (adj.)"
với	mit	to
vớt	gerettet	salvage
vờ	so tun als ob	"(term should be ""giả vờ"") to pretend (v.)"
vời	großartig	wonderful
vở	notizbuch	"(term should be ""vở kịch"") a play"
vỡ	kaputt	break
vợ	frau	wife
vụn	chips	debris
vụng	ungeschickt	covert
vứt	wegwerfen	throw away
vừa	mittel	just (adv.)
vừng	sesam	sesame (n.)
vững	fest	firm (adj.)
vực	feld	place
vựng	wortschatz	"(term should be ""từ vựng"") regional vocabulary (n.)"
vỹ	so	majestic
w	w	w
wa	wa	wa
walt	walzer	(proper noun) walt, as in walt disney
walter	walter	walter
walther	walther	walther
wan	wan	wan
wang	wang	wang
wankel	wankel	(proper noun) wankel
wanna	will wollen	wanna
warren	warren	a name
warsaw	warschau	warsaw
warszawa	warszawa	(proper noun) warsaw
washington	washington	(proper noun) washington
wat	wat	(proper noun) wat, as in angkor wat, the temple in cambodia
watergate	wassertor	watergate
waterloo	waterloo	(proper noun) waterloo
waters	wasser	waters
wayne	wayne	wayne
wcdma	wcdma	w-cdma
weasley	weasley	weasley, as in ron weasley in the harry potter series
weblog	weblog	weblog
webmail	webmail	ưebmail
weimar	weimar	(proper noun) weimar
wellington	wellington	wellington
wells	brunnen	wells, as in author orson wells
welsh	walisisch	(proper noun) welsh, as in the welsh language
wembley	wembley	wembley, as in wembley stadium
werner	werner	werner
westermarck	westermarck	westermarck
western	westlich	western
westlife	westleben	westlife
westview	westview	westview, as in westview press
wheeler	wheeler	a name
widener	verbreiterung	widener
wien	wien	wien
wiener	wiener	wiener
wifi	wifi	wi-fi, a technology term
wiki	wiki	wiki
wikia	wikia	a name
wikibooks	wikibooks	(proper noun) wikibooks
wikimapia	wikimapia	wikimapia
wikimedia	wikimedia	wikimedia
wikitravel	wikitravel	a name
wild	wild	wild
wilder	wilder	(proper noun) wilder, as in billy wilder
wiley	wiley	wiley
willard	willard	willard
wimbledon	wimbledon	wimbledon
windows	fenster	windows
winer	weiner	winer
wisconsin	wisconsin	(proper noun) wisconsin
within	innerhalb	within
without	ohne	without
wolfgang	wolfgang	wolfgang
won	gewonnen	won
wong	wong	wong
woodrow	woodrow	woodrow
woods	wald	(proper noun) woods, as in tiger woods
would	würde	would
wrestling	wrestling	wrestling
wright	wright	a name
wu	wu	wu
wushu	wushu	wushu, a type of martial art
wwf	wwf	wwf
xa	weit weg	ancient
xang	xang	"(term should be ""lan xang"") name of an ancient country in southeast asia"
xanh	grün	green
xao	schlaff	xôn xao = chatting
xay	mahlen	grind
xe	auto	a car (n.)
xem	siehe	watch
xen	interlaced	to insert (v.)
xhcn	xhcn	social republic
xi	xi	xi
xiii	xiii	eighth
xin	bitte	please
xinh	schön	beautiful
xiv	xiv	fourteenth
xiêm	siamesisch	(proper noun) xiêm, or siam
xiên	schräg	oblique
xiêu	xiao	soften
xiếc	zirkus	circus
xiết	festziehen	to twist tightly (v.)
xiềng	fesseln	chain
xo	xo	spring
xoa	reiben	massage
xoay	drehen	turn
xong	fertig	completed
xoàng	mittelmäßig	mediocre
xoá	löschen	delete
xoáy	wirbeln	vortex
xoắn	verdreht	coiled
xu	cent	trend
xua	zerstreuen	dispel
xuan	xuan	"(term should be ""xuân"") a common vietnamese middle or first name; means ""the season of spring"""
xui	pech gehabt	incite
xuka	xuka	xuka
xum	üppig	a name
xuyên	piercing	frequently
xuyến	torso	manage
xuân	frühling	spring
xuâncông	frühling	xuan public
xuôi	gefegt	down
xuất	exportieren	ejaculate
xuấtnhập	exportieren	import/export
xuống	runter	down
xuồng	kanu	boat
xv	xv	fifteenth
xvi	xvi	xvi
xvii	xvii	xvii
xx	xx	xx
xy	xy	cylinder
xài	ausgeben	use
xào	sautiert	stir fry
xách	handtasche	to carry by the handle (v.)
xám	grau	ustox
xán	gebraten	"(term should be ""xán lạn"") bright (adj.)"
xáo	störung	chaos
xát	reiben	touch
xâm	tätowiert	invasion
xâu	zeichenfolge	string
xây	bauen	build
xã	kommune	society
xãy	launisch	occur
xèo	xèo	xeo
xé	reißen	tear
xén	zuschneiden	"(term should be ""biếu xén"") to gift (v.)"
xéo	schräg	diagonally (adv.)
xét	überlegen	examine
xê	bewegen	"(term should be ""bánh xu xê"") a type of vietnamese cake"
xêkô	suneo	xeko
xì	furz	scandal
xìu	furz	to become flaccid (v.)
xí	fabrik	factory (xi nghiep)
xít	faszinierend	nazi
xíu	winzig	small
xòe	verbreiten	spread
xóa	löschen	clear
xói	erosion	erode
xóm	nachbarn	village
xót	gnade	mercy
xô	eimer	soviet
xôi	klebreis	pierce
xôn	rühren	tumultuous
xông	eilte	rush
xôphần	schaufelabschnitt	soviet-poland
xôviết	sowjetunion	soviet
xù	gekräuselt	gigantic
xú	unhöflich	xu
xúc	kontakt	touch
xúi	provozieren	induce
xăm	tätowierung	"(term should be ""xa xăm"") far away (adj.)"
xăng	benzin	gasoline
xơ	faser	xo
xưa	alt	old
xưng	gestehen	"(should be ""tự xưng"") self-proclaimed"
xương	knochen	bone (n.)
xước	zerkratzt	scratch
xướng	chor	provoke
xưởng	werkstatt	workshop
xạ	strahlung	"(term should be ""phản xạ"") to reflect"
xả	entladung	release
xảo	schlau	detailed
xảy	auftreten	happen
xấp	ca.	approximate
xấu	schlecht	bad
xẩm	zottelig	a type of traditional vietnamese singing
xẩy	auftreten	occur
xắt	schneiden	cut
xẻo	pech gehabt	cut off
xếp	gefaltet	rank
xỉ	schlacke	approximately
xỉa	zahnseide	to pick (v.)
xỉu	schwach	to faint
xốc	schock	to lift up (v.)
xốp	porös	porous
xổ	verlosung	rush into
xộn	chaotisch	messy
xứ	gemacht	native
xứng	würdig	appropriate
xử	behandeln	judge
y	y	medical
y=fracsin	y = fracsin	a function
ya	ya	(proper noun) ya, as in ya trang
yakovlev	yakovlev	yakovlev
yakushima	yakushima	yakushima
yalta	jalta	(proper noun) yalta
yankee	yankee	(proper noun) yankee
yard	hof	yard
yasha	yasha	a name
yeeun	yeeun	(proper noun) yeeun
yeltsin	jelzin	yeltsin, as in boris yeltsin
yemen	jemen	yemen
yersin	yersin	(proper noun) yersin, asin alexandre yersin
yi	yi	(proper noun) yi
ying	ying	(proper noun) ying, as in ying yang
ymca	ymca	ymca
yo	yo	yo
yomiuri	yomiuri	yomiuri
yoochun	yoochun	yoochun
york	york	york
yorker	yorker	yorker
yorkshire	yorkshire	yorkshire
youtube	youtube	youtube
ypres	ypres	ypres
ytv	ytv	ytv
yu	yu	yu
yuan	yuan	(proper noun) yuan, as in yuan mu
yucatán	yucatán	yucatan, as in the yucatan peninsula
yudhoyono	yudhoyono	(proper noun) yudhoyono, as in indonesian president susilo bambang yudhoyono
yugi	yugi	yugi
yukito	yukito	yukito
yume	yume	(proper noun) yume
yunho	yunho	yunho
yuri	yuri	yuri, as in soviet pilot and cosmonaut yuri alekseyevich gagarin
yurt	jurte	yurt
yên	yen	peace or stillness (n.)
yêu	liebe	love
yếm	overalls	tender
yến	vogelnest	a type of swallow (n.)
yết	auflistung	yet
yếu	schwach	mainly
yểm	abdeckung	support
yển	yen	"is a name meaning, ""bird"""
yểu	schön	"(term should be ""yểu điệu"") graceful (adj.)"
z	z	z
zac	zac	zac
zambia	sambia	(proper noun) zambia, as in the nation
zealand	neuseeland	(proper noun) zealand, as in new zealand
zedong	zedong	mao zedong
zero	null	zero
zeus	zeus	zeus
zheng	zheng	zheng
zhukmse	zhukmse	zhuk-mse
zimbabwe	simbabwe	zimbabwe
zinedine	zinedine	(proper noun) zinedine
zing	zing	zing, as in the website
zoe	zoe	zoe
zurich	zürich	(proper noun) zurich
zürich	zürich	(proper noun) zurich, as in zurich, switzerland
|nguyễn	| nguyen	a common vietnamese last name
|nổi	schwimmt	"(term should be ""nổi"") to float (v.)"
|petya	petya	(proper noun) petya
|tên	name	"(should be ""tên"") name (n.)"
|việt	vietnamesisch	vietnam
 kg	kg	kg
 triệu	millionen	million
 °c	° c	degrees celsius
°đến	° bis	up to
°độ	° grad	degree
×	×	x
ào	wow	rush
á	á	asia
ác	böse	evil
ách	joch	yoke (n.)
ái	verlangen	ai
ám	rendert	(with the word chi) to hint at
ánh	glanz	light
áo	mantel	clothe
áohung	aohung	"(term should be ""Áo-hung"") austria-hungary"
áp	druck	"(term should be ""huyết áp"") blood pressure (n.)"
áâu	aoi	eurasian
â	â	a vietnamese vowel sound
âm	negativ	vagina
ân	gunst	deed
én	schluckt	swallow
ép	gedrückt	press
êgê	ego	aegean
êm	glatt	smooth
ích	nützlich	benefit
ílam	ílam	tamil language name for the island of sri lanka
ít	wenig	less
île	île	Île, as in Île de la cité, france
îledefrance	îledefrance	ile-de-france
ðiều	artikel	article
ðài	ðài	taiwan
ðường	zucker	a road
ðảng	party	party
ðức	deutschland	"Đức, a common vietnamese first name; means ""virtue"""
ó	ó	(with the word la) to boo down
óc	gehirn	brain
óng	schillernd	"(term should be ""óng ả"") flexible"
ôi	oh	"vietnamese version of the exclamation ""oh"""
ôm	umarmung	hug
ôn	moderation	peaceful (on hoa)
ông	herr	a man (n.)
ôtô	autos	car
ôxi	sauerstoff	oxygen
ôxy	sauerstoff	the element oxygen (n.)
ôxít	oxid	oxide
ôzôn	ozon	ozone
ùn	marmeladen	congest
úng	durchnässt	flood
úp	verdeckt	upside
úy	leutnant	"(term should be ""thiếu úy"") second lieutenant (n.)"
ý	italien	italian
ăn	essen	eat
ăng	ameise	antenna
ăngten	antenne	antenna
đa	multi	majority
đai	gürtel	"(term should be ""Đai khố"") name of a village"
đak	dak	(proper noun) Đak
đan	stricken	scandal
đau	schmerz	painful
đay	jute	jute, a type of vegetation the vietnamese use to make soup (n.)
đb	db	dien ban
đcstq	dcstq	communist party of china
đcsvn	dcsvn	vietnam communist party
đe	amboss	threaten
đem	bringen	to bring (v.)
đen	schwarz	black
đentrắng	schwarzweiß	"(term should be ""đen-trắng"") black-and-white (adj.)"
đeo	tragen	wear
đh	đh	university
đhcn	đcn	university of industry
đhtm	dhtm	university of economics
đhông	osten	dhong
đi	geh	go
điên	verrückt	crazy
điêu	sache	sculpture
điôxít	dioxid	dioxide
điạ	dạ	dia
điếc	taub	heron
điếu	zigarette	funeral oration
điềm	omen	omen
điền	füllen	estate
điều	sache	control
điểm	punkt	bearing point
điển	wörterbuch	"(term should be ""từ điển"") a dictionary"
điểu	ficken	thing
điệp	die nachricht	spy
điệu	ton	memorial
đo	messen	measure
đoa	doa	doa
đoan	vorzeigbar	extreme
đom	glühwürmchen	firefly
đoài	mango	the west
đoàn	gewerkschaft	an organization or group (n.)
đoái	austauschen	"(term should be ""hối đoái"") to exchange or trade (v.)"
đoạn	absatz	a stage or phase (n.)
đt	đt	training
đtđ	handy	diabetes
đua	rennen	emulate
đui	blind	blind
đun	kochen	cook
đuôi	schwanz	tail
đuốc	fackel	a torch
đuối	ertrinken	drowning
đuống	stiel	(proper noun) Đuống, the name of a river
đuổi	jagd	pursue
đài	radio	statue
đàm	gespräche	negotiation
đàn	herde	musical instrument
đàng	ja	side
đào	pfirsiche	train
đày	exil	exile
đá	stein	to kick
đái	pee	pee
đám	horde	dam
đán	dan	"(term should be ""tết nguyên Đán"") vietnamese new year's day"
đáng	es lohnt sich	deserve
đáo	einzigartig	unique
đáp	antworte	response
đát	land	"(term should be ""bi đát"") lamentable (adj.)"
đâm	stich	pierce
đâu	wo	anywhere
đây	hier	below
đã	waren	already
đãi	behandeln	"(should be ""bạc đãi"") to ill-treat"
đãng	geil	dissolute
đè	überschreiben	to press on
đèn	lichter	light
đèo	pass	a mountain pass (n.)
đê	deich	a dike (n.)
đêm	die nacht	night
đênh	buck	lênh đênh= float to unknown
đích	ziel	goal
đính	beigefügt	attached (adj.)
đò	fähre	a ferry (n.)
đòi	anspruch	require
đòn	schlag	welcome
đó	das	that or there (adv.)
đóa	nah	"(term should be ""đoá hoa"") a flower bloom"
đói	hungrig	hungry
đón	abholung	welcome
đôi	doppelt	sometimes
đôla	dollar	dollar
đôn	drang	london
đông	osten	eastern
đôngbắc	osten	north-east
đôngnam	dongnam	south-east
đôngtây	osten	"(term should be ""đông-tây"") east-west (adj.)"
đôrêmi	doraemon	(proper noun) Đôrêmi
đôrêmon	doraemon	doreamon
đùa	witz	joke
đùi	oberschenkel	thigh
đúc	gießen	"(term should be ""đúc kết"") to sum up (v.)"
đúng	richtig	right
đúp	doppelt	double
đút	gib auf	"(term should be ""đút lót"") to bribe"
đăk	dak	dak
đĩ	schlampe	whore/bitch
đĩa	festplatte	disk
đơ	steif	stiff or rigid (adj.)
đưa	geben	girl
đường	zucker	pathway
được	okay	is not
đạ	da	da
đại	großartig	eagle
đạm	protein	plain
đạn	kugel	bullet
đạo	religion	vagina
đạp	treten	to step on
đạt	erreichen	reach
đả	kämpfe	to hit
đảm	garantiert	"(term should be ""đảm nhiệm"") to undertake (v.)"
đản	geburtstag	a group or flock (n.)
đảng	party	party
đảo	insel	an island (n.)
đấm	schlagen	punch
đấng	gott	the
đất	boden	country
đấtmặt	boden	datmat
đấy	dort	ignore
đầm	kleid	swamp
đần	dumm	"(term should be ""đần độn"") stupid or ignorant (adj.)"
đầu	die spitze	start
đầy	voll	"(term should be ""đầy đủ"") adequate or enough"
đẩu	kopf	"(entire term is ""khoa đẩu"") ancient phonetic script used in vietnam"
đẩy	drücken	to push
đẫm	durchnässt	wet
đậm	fett	dense
đậu	bohnen	to park (v.)
đậy	abdeckung	cover
đắc	gewinnen	effectively
đắm	zerstört	sink
đắn	anstand	proper (dung dan)
đắng	bitter	bitter
đắp	auf	"(term should be ""bù đắp"") to compensate (v.)"
đắt	teuer	expensive
đằng	vorbei	back
đẳng	isometrisch	equality
đặc	speziell	"(term should be ""đặc biệt"") special (adj.)"
đặn	regelmäßig	regularly
đẹp	schön	beautiful
đẽ	gut	beauty
đế	sohlen	empire
đếm	zählen	to count (v.)
đến	angekommen	come
đề	fäden	promote
đền	tempel	"(term should be ""đền thờ"") a religious shrine"
đều	sind	all
để	zu	for
đệm	kissen	middle name
đỉnh	spitze	the summit or peak
địch	der feind	enemy
định	angegeben	appointed
đọ	entkernt	compete
đọan	absatz	period
đọc	lesen	read
đọng	stagniert	deposit
đỏ	rot	red (adj.)
đốc	gouverneur	admiral
đối	für	face
đốm	flecken	spot
đốn	abschneiden	"(term should be ""suy đốn:) to be worse off"
đống	haufen	line
đốt	brennen	burn
đồ	karte	thing
đồi	hügel	hill
đồn	gerücht	rumour
đồng	co	agreeable
đổ	schuppen	dump
đổi	ändern	to change (v.)
đổng	dong	"(term should be ""đồng bằng"") a delta"
đỗ	geparkt	pass
độ	abschluss	"term should actually be ""độ cao""; means ""height"""
độc	giftig	alone
độn	gepolstert	chaos
động	dynamisch	action
đột	plötzlich	"(term should be ""xung đột"") conflict (n.)"
đới	zen	tropical
đời	lebenszeit	generation
đỡ	unterstützung	help
đợi	warte	thigh
đợt	charge	fit
đục	undurchsichtig	turbid
đụn	dünen	dune
đụng	berühren	encounter
đủ	genug	enough
đứa	kinder	child
đức	deutschland	virtue (n.)
đứng	stehen	to stand (v.)
đứt	kaputt	cut off
đừng	nicht	not
đực	männlich	male
đựng	enthalten	suffer
đựoc	okay	be
ĩ	oh	"(term should be ""ầm ĩ"") noisy"
ơ	oh	"(term should be ""thờ ơ"") to be indifferent (adj.)"
ơi	hey	"vietnamese equivalent of english ""oh"""
ơn	danke	thank
ư	u	vowel sound found in the vietnamese alphabet (n.)
ưa	bevorzugt	to like (v.)
ưng	oh ja	to accept (v.)
ưu	profis	"(term should be ""ưu việt"") preeminent (adj.)"
ươi	orang	orangutan
ươm	kindergarten	nursery
ương	zentral	central
ướp	mariniert	mummy
ướt	nass	wet
ạ	sir	a word added to the end of a response to show respect to someone in a position of authority, as in a child to a parent
ạt	eile	(with word o) to crowd
ải	ải	pass
ảnh	foto	picture
ấm	warm	warm
ấn	drücken sie	press
ấnâu	drucken	"(term should be ""Ấn Âu"") a grouping of languages including european and indian languages that are thought to have originated from a single earlier language (adj.)"
ấp	weiler	district
ấu	jung	childhood
ấy	das	that
ẩm	feucht	humidity
ẩn	verstecken	hidden
ập	knall	rush
ắt	sicher	sure
ếch	frosch	frog
ỏi	minze	little
ố	ooh	"(term should be ""hoen ố"") stained and smeared (adj.)"
ốc	schnecken	building
ốm	krank	sick
ống	rohr	tube
ốp	tangente	omelette
ồn	lärm	noisy (adj.)
ổ	fahren	hard drive
ổi	guave	guava (n.)
ổn	in ordnung	peace
ớn	groß	posts
ớt	chili	chili
ở	bei	at
ủ	inkubation	"(term should be ""ủ dột"") gloomy (adj.)"
ủi	eisen	"(term should be ""an ủi"") to comfort (v.)"
ủng	stiefel	boot
ủy	kommissar	commission
ứ	ja	to pool together (v.)
ức	brust	memories
ứng	anwendung	corresponding
−−	−−	__
≠	≠	different
