$ tỉ	en milliards de dollars	$ billion
abc	abc	abc
abdul	abdul	abdul
abkhazia	abkhazie	a name
about	à propos	about
abraham	abraham	abraham
abrams	abrams	abrams
abscbn	abscbn	abscbn
account	compte	account
aceh	aceh	(proper noun) aceh
achilles	achille	achilles
acia	acia	acia
acid	acide	acid
ada	ada	ada
adams	adams	(proper noun) adams
addisonwesley	addisonwesley	(proper noun) addison-wesley
adn	adn	adn
adobe	adobe	adobe
adrian	adrian	(proper noun) adrian
adsl	adsl	adsl
advanced	avancé	advanced
aedes	aedes	aedes
aegypti	aegypti	aegypti
aero	aéro	(proper noun) aero, as in the aero l-39 albatros jet
afc	afc	afc
aff	aff	aff
afghanistan	afghanistan	afghanistan
africa	afrique	(proper noun) africa
african	africain	african
ag	ag	ag
agasa	agasa	(proper noun) agasa, as in hiroshi agasa
agassi	agassi	agassi
ai	qui	who
ailen	irlandais	ailen
aim	viser	aim
air	l&#39;air	air
airbus	airbus	airbus
aisne	aisne	aisne
ajax	ajax	ajax
ak	ak	ak
akatsuki	akatsuki	akastuki
akms	akms	akms
akô	bonjour	ako
al	al	al
alabama	alabama	alabama
alaska	alaska	alaska
albania	albanie	albania
albatros	albatros	(proper noun) albatros, as in the aero l-39 albatros
albert	albert	(proper noun) albert
alberto	alberto	(proper noun) alberto
albion	albion	albion, an ancient name for great britain
albuquerque	albuquerque	albuquerque
albus	albus	albus
alexa	alexa	alexa
alexandra	alexandra	alexandra
alexandria	alexandrie	alexandria
alexandros	alexandros	alexandros
alexey	alexey	alexey
alfred	alfred	(proper noun) alfred, as in alfred kinsey
algérie	algérie	algerie
ali	ali	ali
alice	alice	this is a name
allan	allan	(proper noun) allan, as in edgar allan poe
allen	allen	(proper noun) allen
allmusic	allmusic	allmusíc
alois	alois	alois
alonso	alonso	alonso
alpher	alpher	(proper noun) alpher
alps	alpes	alps
altai	altai	altai
always	toujours	luon luon
amaravati	amaravati	amaravati
amazon	amazone	amazon
amdo	amdo	(proper noun) amdo
ame	ame	ame
ami	ami	ami
amiens	amiens	amiens
amin	amine	(proper noun) amin, as in nagib amin
amm	amm	amm
amoniac	l&#39;ammoniac	ammonium (n.)
amphitrite	amphitrite	(proper noun) amphitrite, a greek sea goddess
an	un	"(should be ""an toàn"") safe"
anand	anand	anand
anata	anata	anata
anatolia	anatolie	anatolia
andalusia	andalousie	andalusia
andaman	andaman	andaman
anderson	anderson	anderson
andes	andes	andes
andorra	andorre	andorra
andrew	andrew	andrew
andré	andré	andre, as in andre morval
andy	andy	(proper noun) andy, as in andy warhol
anfield	anfield	anfield
ang	ang	ang
angkor	angkor	(proper noun) angkor, as in angkor wat, the temple in cambodia
anglosaxon	anglosaxon	anglo-saxon
anh	lui	english
anhmỹ	britannique	"(term should be ""anh mỹ"") english or american"
anhpháp	monsieur france	england-france
ankara	ankara	ankara
ankyl	ankyl	ankly
anna	anna	anna
annam	annam	a name the way french called middle vietnam as a colony
annan	annan	annan
anne	anne	anne, a name
anorthosit	anorthosit	anorthosit, a type of igneous rock (n.)
anthony	anthony	anthony
antigua	antigua	(proper noun) antigua
anton	anton	anton
antonov	antonov	antonov
any	tout	any
anđêhít	aldéhyde	aldehydes
ao	étang	pond
aotearoa	aotearoa	aotearoa
apollo	apollo	apollo
apple	pomme	apple
aquinas	aquinas	a name
arab	arabe	(proper noun) arab
archetypal	archétypal	archetypal
archive	archiver	archive
arctan	arctan	a function
ares	ares	ares
argentina	argentine	(proper noun) the south american nation of argentina
argo	argo	argo
arias	arias	arias
aringarosa	aringarosa	aringarosa, as in manuel aringarosa
aristotle	aristote	aristotle
arizona	arizona	arizona, as in the state
ark	arche	ark
arkansas	arkansas	arkansas
arlington	arlington	(proper noun) arlington
armenia	arménien	(proper noun) armenia
armstrong	armstrong	(proper noun) armstrong, as in jazz artist louis armstrong
arnold	arnold	arnold
arsenal	arsenal	arsenal
artemis	artemis	(proper noun) artemis, the greek goddess of the hunt
aruba	aruba	aruba
arunachal	arunachal	"(term should be ""arunachal pradesh"") a state in india (proper noun)"
asc	asc	asc
ash	cendre	a name
ashikaga	ashikaga	ashikaga
ashley	ashley	(proper noun) ashley
asia	asie	asia
asm	asm	asm
asoka	asoka	asoka
association	association	association
assyria	assyrie	assyria
aston	aston	(proper noun) aston, as in aston villa
atkinson	atkinson	atkinson
atlanta	atlanta	atlanta
atlantic	atlantique	atlantic
aua	aua	aua
aubrac	aubrac	aubrac
audition	audition	audition
auflage	auflage	auflage
auguste	auguste	auguste
australia	australie	(proper noun) australia
austria	autriche	(proper noun) the country of austria
austrian	autrichien	austrian
avar	avar	a name
aviation	aviation	aviation
awad	awad	awad
award	récompense	award
axit	acide	acid
ayeyarwady	ayeyarwady	ayeyarwady
ayumi	ayumi	(proper noun) ayumi
ayutthaya	ayutthaya	(proper noun) ayutthaya
azerbaijan	azerbaïdjan	(proper noun) azerbaijan
aztec	aztèque	aztec, as in the aztec people (adj.)
ba	trois	three
babylon	babylon	babylon
bacon	bacon	bacon
baden	baden	baden
baghdad	bagdad	(proper noun) baghdad
bago	bago	bago
bahamas	bahamas	bahamas
bahrain	bahreïn	bahrain
baháí	baháí	bahai
balearic	baléares	balearic
bali	bali	bali
balkan	balkan	(proper adjective) balkan
balkans	balkans	balkans
ballard	ballard	ballard
bamar	bamar	bamar
ban	interdire	the
bang	coup	state
banh	balle	ball
banner	bannière	banner
bantam	bantam	bantam
bantu	bantou	bantu
bao	sac	bao giờ= ever
barack	barack	barack
barak	barak	barak
barbados	barbade	(proper noun) barbados
barbara	barbara	barbara
barbary	barbary	barbary
barca	barca	barca
barnes	barnes	barnes
barone	barone	barone
baroque	baroque	baroque
barquin	barquin	barquin, as in ramon barquin, the cuban military colonel
barrichello	barrichello	barrichello
bartholdi	bartholdi	bartholdi
baryon	baryon	baryon
barça	barça	(proper noun) barca
base	base	base
basel	bâle	basel, a city in switzerland
basil	basilic	basil
baskervilles	baskerville	baskervilles
bass	basse	bass
bator	bator	bator
battambang	battambang	battambang
bauer	bauer	bauer
bay	voler	"(should be ""tuyến bay"") an airline"
bayern	bayern	bayern
bazan	basalte	basalt (n.)
bazơ	basique	base
bb	bb	bb
bbc	bbc	bbc
bc	bc	bc
bchtư	bchtư	central executive
beat	battre	beat
beatles	beatles	the beatles
beauty	la beauté	beauty
beckenbauer	beckenbauer	beckenbauer, as in franz beckenbauer
becker	becker	(proper noun) becker
beckham	beckham	beckam
bedloe	bedloe	bedloe
beethoven	beethoven	beethoven
beethovens	beethovens	beethoven's
beginbmatrix	beginbmatrix	this is a code
behind	derrière	behind
beijing	pékin	beijing
bel	bel	bel
bell	cloche	bell
bella	bella	bella
bellatrix	bellatrix	bellatrix
benedict	benedict	benedict
benetton	benetton	benetton
benfica	benfica	benfica
benito	benito	benito
benjamin	benjamin	(proper noun) benjamin
bennington	bennington	bennigton
berber	berbère	berber
bergen	bergen	(proper noun) bergen
berger	berger	berger
bering	bering	(proper noun) bering, as in the bering strait
berkeley	berkeley	(proper noun) the city of berkeley, california
berman	berman	a name
bermuda	bermudes	(proper noun) bermuda
bernard	bernard	bernard
bertrand	bertrand	bertrand
better	mieux	better
betty	betty	betty
bhutan	bhoutan	bhutan
bia	la bière	beer (n.)
biang	biang	biang
bic	bic	bic
bikini	bikini	bikini
bill	facture	(proper noun) bill, as in former president bill clinton
billy	billy	billy
bismarck	bismarck	bismarck, as in otto von bismarck
bitmap	bitmap	bitmap
biên	frontière	bien
biếc	turquoise	a bluish-green color (adj.)
biếm	insouciant	"(term should be ""biếm họa"") cartoon (n.)"
biến	variable	other
biếng	paresseux	lose interest in
biếu	courtoisie	present
biều	bieu	bieu
biển	la mer	ocean
biểuthứcđiềukiện	connaître les conditions	conditional expression
biện	s&#39;excuser	"(term should be ""biện pháp"") a method (n.)"
biệt	distinct	"(term should be ""khác biệt"") different or distinct"
bkavpro	bkavpro	bkavpro
blackwell	blackwell	this is a name
blair	blair	blair
blaise	blaise	blaise
blanc	blanc	blanc
blues	blues	blues
bo	bo	a curl, as in a biceps curl exercise
bob	bob	bob
bobby	bobby	bobby, as in bobby day
boeing	boeing	boeing
bohemia	bohème	bohemia
bolivia	la bolivie	(proper noun) bolivia
boltzmann	boltzmann	boltzmann
bom	bombe	bomb
bonaparte	bonaparte	bonaparte
bong	bong	"(term should be ""bong bóng"") a balloon (n.)"
bonnal	bonnal	bonnal
bonobo	bonobo	bonono
bool	bool	bool
boolean	booléen	(proper adjective) boolean, as in boolean algebra
boom	boum	boom
boong	pont	a deck (n.)
boongke	bunkers	bunker
bop	bop	bop
boris	boris	boris
borland	borland	(proper noun) borland
borussia	borussia	borussia
bose	bose	bose, as in subhas chandra bose
boseeinstein	boseeinstein	bose einstein
bosna	bosna	(proper noun) bosnia
bosnia	bosnie	(proper noun) bosnia
botswana	botswana	botswana
bottom	en bas	bottom
boulder	rocher	boulder
bourbon	bourbon	bourbon
boxing	boxe	boxing
brain	cerveau	brain
brandenburg	brandebourg	(proper noun) brandenburg
brandt	brandt	brandt
braun	braun	braun
brazil	brésil	brazil
bremen	bremen	bremen, as in the bremen bank
brestlitovsk	brestlitovsk	brest-litovsk
breton	breton	(proper noun) breton
bretton	bretton	hoi nghi
brezhnev	brejnev	brezhnev
brian	brian	a name
bridge	pont	bridge
britannic	britannique	(proper noun) britannic
britney	britney	britney
brooklyn	brooklyn	brooklyn
brot	brot	this is german not vietnamese
brown	brun	brown
browne	browne	browne
browning	brunir	(proper noun) browning
bruce	bruce	bruce
brunei	brunei	brunei
bruno	bruno	bruno, as in the city of san bruno
brusilov	brusilov	brusilov
brussels	bruxelles	brussels, the capital of belgium
btr	btr	btr
bubalis	bubalis	bubalis
budapest	budapest	budapest, the capital of hungary
bulgaria	bulgarie	bulgaria
bulletin	bulletin	thong bao
bungary	bungary	bungary
bungo	bungo	bungo
buonaparte	buonaparte	(proper noun) buonaparte, as in casa buonaparte
burke	burke	(proper noun) burke, as in edmund burke
burkina	burkina	burkina
burma	birmanie	burma
burundi	burundi	burundi
busan	busan	a korean city
busby	fougueux	busby
bush	buisson	bush
bushy	touffue	bushy
buôn	en gros	commerce
buông	lâchez prise	to release, to let loose
buýt	bus	bus
buốt	froid	sharp
buồm	voile	sail
buồn	triste	sad
buồng	chambre	chamber
buổi	session	session
byzantine	byzantin	byzantine
bà	grand-mère	woman or lady (n.)
bài	poster	articles
bàn	table	table
bàng	aigle	eagle
bành	peng	armchair
bào	rabotage	compatriot
bàu	bau	bau
bày	présentation	"(term should be ""trưng bày"") to display (v.)"
bác	oncle	doctor
bách	cyprès	"(term should be ""bách khoa"") polytechnic (adj.)"
bái	culte	to bow (v.)
bám	s&#39;accrocher	cling
bán	vendu	sell
báng	stock	"(term should be ""phỉ báng"") to defame or slander"
báo	journal	newspaper (n.)
bát	bol	eight (n.)
báu	trésor	valuable
bây	maintenant	now
bã	résidu	"(term should be ""buồn bã"") sad (adj.)"
bãi	yards	beach
bão	tempête	storm
bèn	alors	then
bé	bébé	baby
bén	tranchant	sharp (adj.)
béo	graisse	fat
bên	fête	side
bênh	malade	advocate
bì	emballage	foreskin (n.)
bìa	couverture	cover
bìu	scrotum	sac (n.)
bí	courge	secret
bính	binh	"(term should be ""bính âm"") romanized chinese words (n.)"
bíró	citrouille	biro
bò	vache	beef
bó	tas	bound (adj.)
bói	voyance	to foretell (v.)
bón	fertiliser	"entire term should be ""phan bon""; means ""fertilizer"""
bóng	le ballon	sphere or ball
bóp	serrer	squeeze
bô	pot	"(term should be ""bôxit"") the mineral bauxite"
bôi	enduit	to apply (as in oil)
bông	coton	flower
bù	maquiller	compensate
bùa	amulette	talisman
bùn	boue	mud
bùng	flare	"(term should be ""bùng nổ"") to break out (v.)"
bú	téter	to suck
búa	marteau	a hammer
búi	touffes	tuft
bún	chignon	noodle
búng	effleuré	snap
bút	stylo	pseudonym
băm	haché	hash
băn	frette	concerned
băng	glace	"(term should be ""băng giá"") freezing (adj.)"
bơ	beurre	"(term should be ""bơ vơ"") desolate (adj.)"
bơi	nager	swim
bơm	pompe	pump
bưu	affranchissement	post office
bước	pas	a step (n.)
bướm	papillon	butterfly
bạ	les contacts	directory
bạc	argent	meager
bạch	transparent	"(should be ""bạch tuộc"") an octopus"
bại	a échoué	defeated
bảng	tables	chart
bảo	bao	protect
bảy	sept	seventh
bấm	presse	press
bất	réel	"(term should be ""bất cứ"") any (adj.)"
bấy	ça	contemporary
bần	pauvre	poor
bầu	voter	vote
bầy	troupeau	servant
bẩm	congénital	congenital
bẩn	sale	the
bẩy	piège	"(term should be ""lẩy bẩy"") unsteadily (adv.)"
bẫy	piège	a trap (n.)
bậc	degré	level or class (n.)
bận	occupé	busy
bật	allumé	outstanding
bắc	au nord	beijing
bắcnam	northnam	"(term should be ""bắc-nam"") north-south (adj.)"
bắn	tirer	shoot
bắp	maïs	venter
bắt	attraper	cross
bằng	est égal	by
bẹp	écraser	crush
bẻ	casser	break
bẽ	l&#39;humiliation	humiliate
bến	quai	wharf
bếp	cuisine	kitchen
bề	surface	"(should be ""bề mặt"") a surface"
bền	durable	enduring (v.)
bể	cassé	tank
bệ	piédestal	base
bện	tressé	braided (adj.)
bệnh	malade	benh
bỉ	la belgique	disgust
bỉnh	coquine	binh
bịch	coup	ridiculous
bịt	couvert	cover
bọ	bugs	insect
bọc	envelopper	to cover or enclose (v.)
bọn	eux	a group (n.)
bọng	gonflement	bladder
bọt	mousse	foam
bỏ	abandonner	to leave (v.)
bỏng	brûlures	hot
bố	père	"(term should be ""tuyên bố"") to declare"
bốc	chargement	bốc lửa= on fire
bối	confus	messy
bốn	quatre	four
bồi	compensation	"(term should be ""cao bồi"") cowboy (n.)"
bổn	devoir	duty
bổng	bourse	"with word luong, means ""salary"" or ""wages"""
bỗng	soudain	suddently
bộ	ensemble	part
bộc	boc	"(term should be ""bộc lộ"") to reveal (v.)"
bội	multiples	betray
bột	la pâte	powder or flour (n.)
bớ	rassembler	arrest
bớt	moins	less
bờ	rivage	coast
bời	clochard	profuse
bở	par	profitable
bởi	par	because
bục	podium	platform
bụng	ventre	abdomen
bứt	sans le savoir	"(term should be ""bứt phá"") power (n.)"
bừa	déchirant	messy, careless, or topsy-turvy (adj.)
bữa	repas	meal (n.)
bực	frustré	bother
ca	ca	praise
ca-lo	ca-lo	a unit of measurement
cabo	cabo	cabo
cacbon	carbone	carbon
cacbonat	carbonate	carbonate
cacbua	carbure	carbides, carbon ions
caesar	césar	caesar
caffein	la caféine	caffeine
café	café	coffee
cai	cai	govern
cairo	caire	cairo, the capital of egypt
cal	cal	cal, a first name
calculus	calcul	calculus
calvin	calvin	calvin
cam	orange	commit
cambodia	cambodge	(proper noun) the country of cambodia
cambridge	cambridge	cambridge
cameo	camée	cameo part
cameron	cameron	cameron
cameroon	cameroun	cameroon
camille	camille	camille
campbell	campbell	campbell
campuchia	cambodge	campuchia
canada	canada	canada
canadian	canadien	canadian
canal	canal	canal
canary	canari	canary
cancer	cancer	cancer
canterbury	canterbury	canterbury
canxi	calcium	calcium
capello	capello	capello
capra	capra	capra
carat	carat	carat
carbine	carabine	carbine
cardcaptor	cardcaptor	cardcaptor
cardcaptors	cardcaptors	(proper noun) cardcaptors
carey	carey	(proper noun) carey, as in singer mariah carey
caribe	caribe	caribbean
caribê	caraïbes	caribbean
carl	carl	carl
carlos	carlos	carlos
carnaval	carnaval	carnaval
carol	carol	carol
caroline	caroline	(proper noun) caroline
carpathia	carpathie	carpathia
carter	charretier	carter
carxtơ	carat	karst topography, a geological term (n.)
casa	casa	casa
casablanca	casablanca	casablanca
caspia	caspia	caspia
cassini	cassini	cassini
cast	cast	cast
castries	castries	castries
castro	castro	castro, as in fidel castro
cathay	cathay	cathay
catherine	catherine	catherine
cau	cau	cau
cbc	cbc	cbc
cbgd	cbgd	educational  officer
cbs	cbs	cbs
ccc	ccc	ccc
ccn	ccn	industrial cluster
cctv	vidéosurveillance	cctv
cd	cd	cd
cdot	cdot	cdot
cdrom	cdrom	cd-rom
cell	cellule	cell
celtic	celtique	centic
cena	cena	(proper noun) cena, as in john cena, the wrestler
centauri	centauri	centauri
ceres	ceres	ceres
cha	père	father
chai	bouteille	bottle
chaillot	chaillot	a name
chamberlain	chambellan	chamberlain
champa	champa	champa
champion	champion	champion
chamẹ	bain	parents
chanel	chanel	chanel
chanh	citron	lemon or lime (n.)
chao	salut	(proper noun) chao, a name
charles	charles	charles
charlotte	charlotte	charlotte
charlton	charlton	charlton
charon	charon	(proper noun) charon
chase	chasser	chase
chay	végétarien	fasting
chdcnd	chdcnd	democratic republic
che	couverture	cover
chechnya	tchétchénie	chechnya
chen	chen	chen
cheo	cheo	"(term should be ""cheo reo"") name of a town"
chi	chi	"(term should be ""chi tiết"") details (n.)"
chia	divisée	"(term should be ""chia sẻ"") to share"
chiang	chiang	chiang
chicago	chicago	chicago, as in chicago, illinois
chile	chili	(proper noun) the country of chile
chim	l&#39;oiseau	bird
china	porcelaine	china
ching	ching	ching
chirac	chirac	chirac, as in former french president jacques chirac
chiêm	astrologique	"(term should be ""chiêm thành"") the ancient kingdom of champa in vietnam"
chiên	frit	fry
chiêng	gong	gong
chiếc	pièces	the
chiếm	occupé	appropriate
chiến	se battre	war, fight
chiết	extraire	literal
chiếu	projection	show
chiền	tas	temple
chiều	après-midi	length
chlamydia	chlamydia	chlamydia
chloride	chlorure	chloroauric acid
chnd	chnd	chnd
choi	jouer	choi
chomsky	chomsky	chomsky
chong	chong	chong
chopin	chopin	chopin
chosŏn	chosŏn	(proper noun) choson
choàng	cape	coat
choáng	abasourdi	dizzy
chris	chris	chris, as in chris hughes
christ	christ	christ
christian	chrétien	christian
christopher	christopher	christopher
chrome	chromé	chrome, as in google chrome
chrysler	chrysler	(proper noun) chrysler, the car company
chu	chu	cycle
chua	sour	tomato
chuck	chuck	(proper noun) chuck, as in chuck norris
chui	souterrain	underground
chum	copain	pot
chun	chun	chun
chung	général	general
churchill	churchill	churchill
chuyên	spécialisé	professional
chuyến	voyage	trip
chuyền	passer	volleyball
chuyển	transfert	to move
chuyện	histoire	nói chuyện= talk
chuôi	râler	handle
chuông	cloche	a bell
chuẩn	standard	standard
chuốc	poke	incur
chuối	les bananes	banana
chuốt	aborder	refine
chuồng	grange	cage
chuỗi	chaîne	series
chuộc	racheter	redeem
chuộng	favorisé	favorite
chuột	souris	a mouse (n.)
chà	frotter	rub
chài	la pêche	fish
chàm	indigo	indigo
chàng	mec	"(term should be ""chàng trai"") a young man (n.)"
chào	salut	welcome
chày	baseball	a pestle (n.)
chánh	chef	"(term should be ""chánh án"") the head of a tribunal (n.)"
cháo	bouillie	porridge
cháu	petits-enfants	a term one uses denoting oneself when addressing an aunt or uncle (n.)
cháy	brûlant	fire
châm	piquer	motto
chân	les pieds	a leg
châu	l&#39;europe	continental
chè	thé	tea
chèn	insérer	insert
chém	slash	to chop
chén	tasse	bowl
chéo	traverser	cross
chép	copier	written
chê	putain	decry
chênh	différence	difference
chì	plomb	graphite
chìa	clé	"(term should be ""chìa khoá"") a key (n.)"
chìm	évier	to become submerged or sink (v.)
chình	anguille	eel
chí	les poux	especially
chích	injection	shoot
chín	neuf	ripe
chính	principal	main
chít	chit	dense
chò	étouffer	a type of plant, typically of the parashorea genus (n.)
chòi	cabane	hut
chòm	constellation	constellation
chó	les chiens	dog
chóc	haha	killing (giet choc)
chói	éblouissement	bright
chóng	vite	"entire term should be ""chong mat""; means ""dizzy"""
chóp	pourboire	the top (n.)
chôm	ramboutan	rambutan
chôn	enterré	bury
chông	mari	thorn
chùa	pagode	pagoda
chùy	macis	mace
chú	oncle	uncle (n.)
chúa	dieu	god
chúc	souhaiter	will
chúi	tuu	drop
chúng	eux	they
chút	peu	little
chăm	prendre soin	champa
chămpa	champa	champa
chăng	abordable	would it
chĩa	fourchettes	point
chơi	jouer	play
chơn	les pieds	"a more obscure form of the word ""chân""; means ""genuine"" or ""true"""
chư	chu	lower authorities
chưa	pas encore	not yet
chưng	dist	steamed
chương	chapitre	medal
chướng	parcours d&#39;obstacles	grating
chạ	promiscuité	father
chạm	toucher	touch
chạng	crépuscule	twilight
chạp	fragile	slow
chạy	courir	to run (v.)
chả	rouleaux	no
chảo	casserole	pan
chảy	coulant	bleeding
chấm	point	end
chấp	hypothèque	"(term should be ""chấp nhận"") to accept (v.)"
chất	substance	quality
chấu	pincer	"(term should be ""châu chấu"") a grasshopper (n.)"
chần	blanchiment	slice
chẩn	diagnostiquer	"(term should be ""chẩn đoán"") to diagnose (v.)"
chậm	lentement	slow
chận	bloquer	block
chật	serré	overcrowded
chậu	des pots	pelvic
chắc	bien sûr	certainly
chằng	front	ligament
chẵn	même	even
chặn	bloquer	prevent
chặng	jambe	journey
chặt	serré	close
chẻ	diviser	strick
chẽ	serré	"(term should be ""chặt chẽ"") tightly or closely (adv.)"
chế	préparations	produce
chếch	mou	oblique
chết	mourir	to die (v.)
chệch	mauvais	deviant
chỉ	seulement	just (adv.)
chỉnh	correction	adjust
chịt	merde	chằn chịt= complex/tangle
chịu	ours	tolerate
chọc	piquer	to poke
chọi	combat	oppose
chọn	choisir	to choose
chỏ	coude	"(term should be ""cùi chỏ"") elbow (n.)"
chốc	moment	single
chối	nier	refuse
chốn	lieu	place
chống	anti	anti-
chốt	verrou	important
chồi	pousses	"(term should be ""đâm chồi"") budding"
chồn	belette	anxious
chồng	mari	husband
chỗ	lieu	where
chội	merde	cramped
chớ	ne pas	not
chớp	foudre	flashing (adj.)
chờ	attends	to wait
chở	porter	for
chợ	marché	market
chợt	soudain	suddenly
chục	douzaine	dozen
chụp	tir	capture
chủ	propriétaire	"(term should be ""chủ yếu"") main or essential (adj.)"
chủng	souches	strain
chứ	plutôt	just or only (adv.)
chứa	contient	contain
chức	fonction	function
chừ	attends	hesitate
chừa	partir	leave
chừng	environ	about or roughly (adv.)
chử	mot	"(term should be ""chử bích"") the vietnamese name for a chinese island"
chửa	enceinte	pregnant
chửi	maudire	curse
chữ	mot	a letter of the alphabet (n.)
chữa	guérir	to cure or treat (v.)
chững	nivellement	to totter (v.)
cia	cia	cia
cincinnati	cincinnati	cincinnati
cinderella	cendrillon	cinderrella
cip	cip	cip
circus	cirque	circus
cities	les villes	cities
clara	clara	clara
clark	clark	clark
claude	claude	(proper noun) claude
claudius	claudius	(proper noun) claudius
clinton	clinton	clinton, as in former president bill clinton
clip	clip	clip
clips	clips	clips
clo	chlore	chlorine
clow	clow	clow
clyde	clyde	(proper noun) clyde, as in bonnie and clyde
cmc	cmc	cmc
cmt	cmt	cmt
cn	cn	christian era
cnet	cnet	cnet
cntb	cntb	capitalism
cntt	cntt	it
cnxh	cnxh	social republic
co	co	spasm
coburn	coburn	coburn
cocoa	cacao	cocoa
coen	coen	coen
coffea	coffea	coffee
cohen	cohen	cohen
coi	considéré	to regard
coleen	coleen	coleen
coleman	coleman	coleman
coli	coli	coli
colin	colin	(proper noun) colin, as in colin powell
colleen	colleen	colleen
college	collège	college
collins	collins	(proper noun) collins
collège	collège	college (n.)
colombia	colombie	colombia
colombo	colombo	(proper noun) colombo
colorado	colorado	(proper noun) colorado, as in the state
columbus	columbus	columbus
comic	bande dessinée	comic
common	commun	common
concacaf	concacaf	concacaf
concerto	concerto	concerto
concorde	concorde	concorde
condom	préservatif	condom
cong	courbé	curved or bent
congo	congo	congo
congress	congrès	congress, as in library of congress
connecticut	connecticut	connecticut
conrad	conrad	corrad
conservation	conservation	conservation
constantine	constantine	constantine
contemporary	contemporain	contemporary
cooper	tonnelier	(proper noun) cooper
copenhagen	copenhague	copenhagen
copernic	copernique	corpernic
copperfield	champ de cuivre	(proper noun) copperfield, as in magician david copperfield
coppola	coppola	coppola
copy	copier	copy
cordyceps	cordyceps	cordyceps
core	noyau	core
cornell	cornell	cornell
cosin	cosin	cosine
costa	costa	costa
cotang	cotang	cotangent
cpt	cpt	cpt
craig	craig	(proper noun) craig
crazy	fou	crazy
crespo	crespo	(proper noun) crespo
crest	crête	crest
crew	équipage	crew
crimson	cramoisi	crimson
crisis	crise	crisis
cristiano	cristiano	cristiano, as in portuguese soccer player cristiano ronaldo
croatia	la croatie	croatia
cross	traverser	cross
crs	crs	crs
cruz	cruz	cruz
cruzeiro	cruzeiro	cruzeiro
crystal	cristal	crystal
ctc	ctc	ctc
cua	crabe	crab (n.)
cullen	cullen	a name
cung	arc	circle
cunningham	cunningham	cunningham; proper name
cup	tasse	cup
cuả	de	of, from, belonging to
cuốc	houes	hoe
cuối	dernier	last or final (adj.)
cuốn	réserver	book
cuống	tige	throat
cuồng	fou	crazy (adj.)
cuộc	se battre	the
cyanide	cyanure	cyanide
cyber	cyber	cyber
cyril	cyril	(proper noun) cyril
cyrus	cyrus	cyrus
cyworld	cyworld	cyword
cà	le café	ca
cài	installer	install
càn	besoin	raid
càng	le plus	cang
cành	branche	branch
cào	gratter	scratch
cày	labourer	plow
các	le	all (adv.)
cách	le chemin	the
cái	le	"(term should be ""con cái"") children (n.)"
cán	roulé	"(should be ""cán bộ"") an officer, especially in a communist regime"
cánh	ailes	wing
cáo	renard	report
cáopx|bình	cáopx | moyenne	not a word
cáp	câble	cable (n.)
cáy	violoneux	fiddler
câm	stupide	mute (adj.)
cân	échelle	weight
câu	phrase	saying
cãi	argumenter	argue
cò	déclencher	stork
còn	à gauche	to have left (v.)
có	oui	have
cói	carex	machine
cót	lit bébé	cot
cô	elle	girl
côi	orphelin	orphaned
côn	effiler	a stick (n.)
công	travailler	worker
côngtenơ	conteneur	container
cõi	royaumes	entire area
cõng	ferroutage	piggyback
cù	chatouiller	cu
cùi	lépreux	leprosy
cùng	ensemble	together
cú	chouette	old
cúi	arc	to bow (v.)
cúm	grippe	cum
cúng	confortable	worship
cúp	panne	cup (n.)
cút	sortir	to kick someone out (v.)
căm	branché	detest (cam thu)
căn	radical	"(term should be ""căn bệnh"") cause of a disease (n.)"
căng	étirer	tense
cũ	vieux	old
cũi	crèche	kennel
cũng	aussi	also
cơm	riz	rice
cư	remplir	resident
cưa	vu	saw
cưng	chéri	also
cước	fret	megaman
cưới	marié	marry
cướp	voler	to rob (v.)
cười	rire	smile
cường	intense	strengthen
cưỡi	équitation	ride
cưỡng	forcé	force some body to do some thing. cưỡng dâm=rape
cạc	carte	card (n.)
cạn	peu profond	shallow
cạnh	bord	"(term should be ""khía cạnh"") an angle"
cạo	se raser	shave
cạp	scorpion	scorpion
cả	les deux	both
cải	moutarde	reform
cảm	froid	pleasure
cản	tourmenté	prevent
cảng	port	port
cảnh	scène	situation
cảo	tire	posthumous
cấm	interdit	ban
cấn	besoin	dramatic
cấp	accorder	level or rank (n.)
cất	distillé	"(term should be ""cất giữ"") to keep safe or store"
cầm	tenir	to hold (v.)
cần	besoin	need
cầu	pont	request
cầy	civette	farmed
cẩn	fais attention	carefully
cẩu	grue	"(term should be ""hải cẩu"") a seal (n.)"
cận	approche	close
cập	compteur	mention
cậu	lui	a young man (n.)
cậy	fiable	reliable
cắm	brancher	to plant (v.)
cắn	mordre	to bite
cắp	voler	steal
cắt	couper	cut
cằm	menton	chin
cằn	grincheux	exhausted (adj.)
cặp	paire	couple
cọ	paume	rub
cọc	pile	pile
cọp	tigre	tiger
cỏ	herbe	plant
cố	essayer	"(term should be ""cố gắng"") to try one's best (v.)"
cốc	tasse	cereal
cối	mortier	mortar
cốm	pépites	grilled rice
cống	hommage	dedicate
cồn	alcoolique	i
cồng	gong	gong
cổng	la porte	gate
cỗ	pont	engine
cỗi	têtu	barren
cộ	véhicule	"(term should be ""xe cộ"") cars or vehicles (n.)"
cội	vieux	origin
cộng	plus	to add (v.)
cột	colonne	pole
cớ	excuse	excuse
cờ	drapeau	flag
cỡ	taille	size
cợt	plaisanter	"(term should be ""đùa cợt"") to trifle (v.)"
cục	département	department
cụm	cluster	cluster
cụp	amputé	down
cụt	amputé	"(should be ""xương cụt"") the tailbone or coccyx"
củ	tubercules	a bulb, a botanical term
của	de	of
củi	bois de chauffage	firewood
củng	aussi	reinforce
cứ	sur	any
cức	roucouler	"(term should be ""cức Đê"") a character in chinese history"
cứng	dur	hard
cứngi	hardi	cungi
cừ	piles	nacre
cừu	mouton	sheep
cửa	la porte	door
cửu	multiplier	nine
cữ	cu	abstinence
cữu	cercueil	nine
cự	distance	against
cựa	éperons	retreat
cực	extrême	extreme
cựu	ancien	former
d	d	d.
da	peau	skin
daegu	daegu	daegu
dahl	dahl	(proper noun) dahl, as in author roald dahl
dai	moelleux	persistent
daily	tous les jours	daily
dakota	dakota	dakota, as in the state of south dakota
dalat	dalat	da lat
dampier	plus humide	(proper noun) dampier, a last name
dan	dan	dan
dancing	danse	dancing
danger	danger	danger
danh	nom	list
daniel	daniel	daniel
dante	dante	dante
dao	couteau	poniard
darwin	darwin	darwin
das	das	das
dassault	dassault	(proper noun) dassault
date	date	date
dau	maux de tête	dau
dave	dave	(proper noun) dave, as in dave sexton
david	david	david, as in david thomas
davies	davies	davies
davis	davis	davis
dbsk	dbsk	dbsk
dc	dc	d.c.
ddr	ddr	ddr
dean	doyen	a name
degree	degré	degree
delhi	delhi	delhi
delphi	delphi	(proper noun) delphi, as in the oracle
demeter	déméter	(proper noun) demeter, the greek goddess of the harvest
den	repaire	den
dennis	dennis	dennis
department	département	departmen
derek	derek	derek
des	des	des
descartes	descartes	descartes
design	conception	thiet ke
deuterium	le deutérium	deuterium
deutschland	deutschland	deutschland
dewan	dewan	dewan, as in dewan rakyat
dewitt	dewitt	(proper noun) dewitt, as in rose dewitt bukater
di	di	move
diana	diane	(proper noun) diana, as in diana ross
die	mourir	german
diego	diego	diego
dien	fou	"(term should be ""Điện biên phủ"") a city in northwestern vietnam where a famous battle took place during the vietnam war"
dimaggio	dimaggio	gimaggio
dinh	palais	official residence or palace
dionysus	dionysos	dionysus, as in the greek god
discovery	découverte	discovery
discussion	discussion	discussion
disneyland	disneyland	disneyland
division	division	division
divoire	divoire	d'lvoire
diêm	matchs	diem vuong
diên	fou	"(term should be ""kinh diên"") canon (n.)"
diềm	cantonnières	matches
diều	cerf-volant	kite
diểu	cerf-volant	(proper noun) diểu
diễm	diem	beauty; a common vietnamese first name for women
diễu	mars	parade
diệc	héron	a heron (n.)
diệm	diem	(proper noun) diệm, as in ngô Đình diệm, former president of south vietnam
diện	le visage	face to face
diệt	tuer	to kill or destroy (v.)
diệu	la magie	effective (adj.)
djibouti	djibouti	djibouti, a country in africa
djokovic	djokovic	(proper noun) djokovic, as in novak djokovic
dm	dm	dm
dmitri	dmitri	dmitri
dna	adn	dna
do	par	because of
doanh	joint	"(term should be ""kinh doanh"") business (n.)"
doc	doc	doc
docherty	docherty	docherty
dolly	chariot	(proper noun) dolly, as in singer dolly parton
dome	coupole	nha
dominican	dominicain	(proper noun) dominican, as in the dominican republic
don	don	(proper noun) don
donau	donau	donau
dortmund	dortmund	(proper noun) dortmund
dougherty	dougherty	dougherty
douglas	douglas	douglas
dover	dover	(proper noun) dover, as in the capital of delaware
doyle	doyle	doyle
doãn	doan	doan
doạ	menaçant	threat
dp	dp	dp
dracula	dracula	dracula
draft	brouillon	draft
drake	drake	(proper noun) drake
driver	chauffeur	a name
ds	ds	ds
dtd	dtd	dtd
dth	dth	dth
du	du	travel
dubai	dubaï	dubai
duiker	duiker	duiker
duk	canard	duk
dumas	dumas	dumas
dumbledore	dumbledore	dumbledore
dung	crottin	portrait
durham	durham	durham
dursley	dursley	dursley
duy	seulement	only
duyên	prédestiné	coastal
duyện	aspirant	fellatio
duyệt	parcourir	browser
duơng	duong	ocean
duẩn	duan	duan
duật	duat	duat
duệ	descendants	descendants (n.)
duỗi	redresser	stretch
dwight	dwight	dwight
dà	dah	gradually
dài	longue	to lengthen, as in time
dàn	mise en scène	to arrange
dàng	facile	dang
dành	dépensé	for
dào	abondant	"complement to word ""doi""; entire phrase ""doi dao"" means ""plentiful"""
dày	épais	thick
dái	pisser	"penis (n.), although some may use the term to mean ""testicles"""
dám	oser	dare
dán	coller	stick
dáng	forme	appearance
dát	incrusté	inlay
dâm	obscène	lustful (adj.)
dân	les gens	people
dâng	offrir	dedicate
dây	fil	nerve
dã	sauvage	chronicle
dãi	baver	band
dãn	dilaté	extend
dãy	séquence	a row (n.)
dè	fais attention	tight
défense	défense	defense
dép	sandales	slipper
dê	chèvre	goat
dì	tante	aunt
dìu	dìu	to lead by the hand (v.)
dính	collant	stick
dò	recherche	(with word tham) to survey
dòm	regarde	snoop
dòng	ligne	"(term should be ""dòng họ"") family (n.)"
dó	ça	a type of plant used to make paper in vietnam (n.)
dông	orage	a storm (n.)
dõi	suivre	monitor
dù	pourtant	though
dùi	perforateur	awl
dùng	utilisé	use
dăm	copeaux	"(term should be ""đá dăm"") pebbles (n.)"
dĩ	bien sûr	why
dĩa	fourchettes	dish
dũng	vaillant	courage
dơ	sale	dirty
dơi	chauves-souris	bat
dư	excès	remnant
dưa	melon	melons
dưng	arrêter	suddently
dương	positif	penis
dường	sembler	seem
dưỡng	soins infirmiers	feed
dược	pharmacie	having to do with medicine (adj.)
dượng	oncle	uncle
dạ	oui	night
dại	insensé	stupid or idiotic (adj.)
dạn	courageux	"(term should be ""dày dạn"") to be accustomed to, especially some sort of difficult situation (adj.)"
dạng	format	tyoe
dạo	balade	vending
dạt	lavé	to drift
dạy	enseigner	teach
dải	bande	range
dấm	vinaigre	vinegar
dấp	trébucher	shape
dấu	le signe	signal
dấy	éveiller	to raise (v.)
dần	progressivement	people
dầu	huile	oil
dẫm	piétiner	step on
dẫn	plomb	to lead
dẫu	pourtant	though
dận	tante	to step on
dậu	coq	rooster
dậy	se lever	"(term should be ""dậy thì"") pubescent (adj.)"
dắt	plomb	lead
dằn	ballast	"(term should be ""dằn lòng"") to hold yourself in (v.)"
dằng	persistant	dằng dai= long/endless
dẳng	persistant	persist
dặm	miles	mile
dặn	ordonné	to advise (v.)
dặt	commander	conservative
dẹp	à plat	pacify
dẹt	plat	flat
dẻ	châtaignes	chestnut
dẻo	plasticité	flexible
dế	grillons	cricket
dền	amarante	beetroot
dể	facile	easy
dễ	facile	easy
dệt	tissage	textile
dị	singularité	simple
dịch	traduire	semen
dịp	occasion	occasion
dịu	moelleux	ease
dọa	menaçant	to threaten or scare (v.)
dọc	vertical	along
dỏm	plein d&#39;esprit	witty
dốc	pente	slope
dối	mentir	lie
dốt	ignorant	stupid or ignorant (adj.)
dồi	abondant	"(term should be ""trau dồi"") improve (v.)"
dồn	acculé	accrue
dỗ	coaxial	dirty
dời	bouger	leave
dở	mauvais	incomplete
dỡ	déchargement	remove
dụ	par exemple	example
dục	sexe	sexuality
dụng	utiliser	use
dứa	ananas	pineapple
dứt	terminé	to cease
dừa	noix de coco	coconut (n.)
dừng	arrêter	to cease
dữ	les données	"(term should be ""giận dữ"") anger (n.)"
dự	projeté	attend
dựa	basé	base on
dực	mâle	dực, as in lê tương dực
dỹ	dỹ	dy
e	e	e.
ea	ea	(proper noun) ea, as in ea kao
earles	les oreilles	earles
eaton	eaton	eaton
ebro	ebro	a name
ecmascript	ecmascript	ecmascript
ecw	ecw	ecw
edda	edda	(proper noun) edda
edgar	edgar	edgar, as in author edgar allan poe (n.)
edge	bord	edge
edinburgh	édimbourg	(proper noun) edinburgh, as in edinburgh, scotland
edison	edison	edison
editor	rédacteur	editor
edmond	edmond	edmond
edo	edo	edo
edward	edward	edward
edwin	edwin	edwin
eea	eea	eea
efron	efron	efron, as in zac efron
egypt	egypte	egypt
eid	eid	(proper noun) eid
eiffel	eiffel	eiffel
einstein	einstein	einstein
eisenhower	eisenhower	eisenhower, as in former president dwight d. eisenhower
ekaterina	ekaterina	this is a name
elbe	elbe	(proper noun) the elbe river
electronic	électronique	electronic
eliane	eliane	(proper noun) eliane
elip	ellipse	ellipse
elizabeth	elizabeth	elizabeth
ellen	ellen	ellen
ellis	ellis	a name
elton	elton	(proper noun) elton, as in elton john
elvis	elvis	elvis
elíp	ellipse	ellipse
em	toi	younger sibling
email	e-mail	email
emily	emily	(proper noun) emily, as in emily dickinson
emir	émir	emir
emmy	emmy	emmy
en	en	erica reef
energy	énergie	energy
engels	engels	engels
england	angleterre	(proper noun) england, as in new england
eniac	éniaque	eniac
entente	entente	entente
entropy	entropie	entropy
enzym	enzyme	enzymes
eo	taille	eo, as in the film captain eo
ep	ep	a name
erich	erich	erich
erik	erik	erik, as in erik moller
eris	eris	eris
eritrea	érythrée	eritrea
ernest	ernest	(proper noun) ernest
eros	eros	eros, greek god of love
erwin	erwin	(proper noun) erwin, as in erwin rommel
españa	españa	espana
essential	essentiel	essential
ethernet	ethernet	ethernet
ethiopia	ethiopie	(proper noun) ethiopia
euclid	euclide	euclid
eugene	eugène	eugene
eugène	eugène	(proper noun) eugène
euler	euler	euler
euro	euro	euro, as in the european currency
eurofighter	eurofighter	eurofighter
europe	europe	europe
european	européen	(proper adjective) european
eva	eva	eva
everton	everton	everton
every	tous	every
exgay	exgay	exgay
explorer	explorateur	explorer
extensive	extensif	extensive
fabio	fabio	(proper noun) fabio
facebook	facebook	(proper noun) facebook
fact	fait	fact
facto	facto	this is french not vietnamese
faifo	faifo	(proper noun) faifo
fao	fao	fao
farrell	farrell	farrell
faso	faso	faso
fbi	fbi	fbi
fca	fca	fca
fdi	fdi	fdi
features	caractéristiques	features
federer	federer	federer
feet	les pieds	feet
felipe	felipe	felipe
felis	felis	(proper noun) felis
felix	felix	(proper noun) felix, as in felix klein
ferb	ferb	ferb
ferdinand	ferdinand	ferdinand
ferguson	ferguson	ferguson
fernando	fernando	fernando
ferrari	ferrari	ferrari
fiat	fiat	fiat
fidel	fidel	fidel
field	champ	field
fifa	fifa	fifa
fifpro	fifpro	fifpro
figo	figo	figo
fiji	fidji	fiji
finish	finir	finish
firefox	firefox	(proper noun) mozilla firefox
fischer	fischer	fischer, as in louis fischer
fish	poisson	fish
fishbed	lit de poisson	fishbed
fitzgerald	fitzgerald	(proper noun) fitzgerald
flanker	flanker	flanker
fleming	fleming	fleming
flight	vol	flight
foch	foch	(proper noun) foch
focus	se concentrer	focus
foden	foden	(proper noun) foden, as in tom foden
fokker	fokker	fokker
food	la nourriture	food
football	le football	bong da
forbes	forbes	(proper noun) forbes, as in the magazine
ford	gué	(proper noun) ford
fordham	fordham	(proper noun) fordham
forks	fourchettes	forks
foundation	fondation	foundation
fox	renard	fox
fpt	fpt	a company name in vietnam
fracsin	fracsin	a function
franc	franc	franc
france	france	france
frances	frances	frances
francis	francis	francis, as in francis xavier
francisco	francisco	francisco
franco	franco	franco
frank	franc	frank
frankfurt	francfort	(proper noun) frankfurt
franklin	franklin	franklin
franz	franz	(proper noun) franz, as in franz ritter
freud	freud	(proper noun) freud, as in sigmund freud
friedman	friedman	friedman
fu	fu	fu
fujiko	fujiko	fujiko, as in japanese writer fujiko fujio
fujimoto	fujimoto	fujimoto
fukuoka	fukuoka	fukuoka
funimation	funimation	(proper noun) funimation
funk	funk	funk
futsal	futsal	futsal
fx	fx	fx
ga	ga	station
gabon	gabon	gabon
gabriel	gabriel	gabriel
gabriella	gabriella	gabriella
gagarin	gagarine	gagarin
gaia	gaia	gaia
gaillard	gaillard	gaillard
galilei	galilei	galilei
galileo	galileo	galileo, the astronomer
gam	grammes	gam
gambia	gambie	gambia
gamow	gamow	a name
gan	foie	liver
gandhi	gandhi	gandhi, as in mahatma gandhi
gang	gang	cast iron
ganh	jaloux	to be jealous
gao	gao	strictly
gareth	gareth	a name
garrett	garrett	garrett
gary	gary	gary
gascon	gascon	(proper noun) gascon, a dialect of france
gatt	gatt	gatt
gaule	gaule	gaul, a region in ancient western europe
gaulois	gaulois	gaulois
gay	gay	tense
gaza	gaza	gaza
gdańsk	gdańsk	(proper noun) gdansk, poland
gdp	gdp	gdp
geisha	geisha	geisha
gen	les gènes	gene
gene	gène	(proper noun) gene, an english first name
genesis	genèse	(proper noun) genesis
georg	georg	(proper noun) georg
george	george	george
georges	georges	(proper noun) georges, a french name
gepard	gepard	gepard
ger	ger	ger
gerais	gerais	(proper noun) gerais
gerhard	gerhard	gerhard
german	allemand	german
germany	allemagne	germany
gerrard	gerrard	gerrard, a last name
ghana	ghana	(proper noun) the african country of ghana
ghe	bateau	canoe
ghen	jaloux	to be jealous (v.)
ghi	écrire	write
ghim	épingles	pin
ghé	arrêter	visit
ghép	greffe	fit
ghê	dégoûtant	disgust
ghì	ghì	tighten
ghẻ	gale	scabies (n.)
ghế	siège	chair
ghề	rapides	scabby
ghềnh	rapides	waterfall (n.)
gia	gia	date
giai	étape	period
giam	détenu	imprison
gian	l&#39;espace	"(term should be ""thời gian"") time (n.)"
giang	giang	syphilis
gibraltar	gibraltar	(proper noun) gibraltar
gichin	gichin	gichin
gieo	semer	sow
gifu	gifu	gifu, a district in northern japan
ginzan	ginzan	ginzan
gio	gio	wind
gioi	gioi	world
giuliani	giuliani	giuliani
giun	vers	worm
giuse	giuse	giuse
giuộc	giuoc	"entire term should be ""can giuoc""; name of a vietnamese town"
giza	gizeh	giza
già	vieux	old (adj.)
giàn	treillis	"(term should be ""giàn hoa"") a trellis girder"
giành	gagné	secure
giàu	riche	rich or wealthy (adj.)
giày	chaussures	a shoe
giá	prix	estimate
giám	réalisateur	"(term should be ""giám sát"") to supervise (v.)"
gián	cafards	"(term should be ""gián tiếp"") indirectly"
giây	secondes	seconds
giã	battant	"(term should be ""từ giã"") to say farewell to (v.)"
giãn	étirer	stretch
gièm	détracteurs	"(should be ""gièm pha"") to backstab"
giêhôva	giva	jehovah
giêng	giong	january
giêsu	jésus	jesus
giêxu	nexus	jesus
giò	rouleaux de printemps	leg
giòi	asticots	maggot (n.)
giòn	croquant	crunchy or crispy (adj.)
gió	le vent	wind
gióng	comme	align
giúp	aider	help
giũa	fichier	sharpen
giơ	brouiller	raise
giương	torchage	posture
giường	lit	bed
giả	faux	fake (adj.)
giải	prix	solution
giảm	réduire	decrease
giản	simplifié	"(term should be ""giản dị"") simple (adj.)"
giấc	dormir	giấc ngủ= the sleep
giấm	vinaigre	drabble
giấu	cacher	hide
giấy	papier	paper
giầu	riche	rich
giận	fâché	angry
giằng	contreventement	pull
giặc	ennemi	enemy
giặt	lavage	to wash (n.)
giếng	le puits	well
giết	tuer	kill
giềng	voisin	"(term should be ""láng giềng"") neighboring"
giễu	ridicule	ridicule
giọng	accent	tone
giọt	gouttes	drop
giỏ	panier	basket
giỏi	bon	good
giồng	giong	mound
giỗ	anniversaire de la mort	anniversaries of deaths
giới	sexe	gender
giờ	l&#39;heure	bao giờ=ever
giở	flash	to open or unfold (v.)
giỡn	plaisanter	joke
giục	a exhorté	urge
giữ	attends	hold
giữa	entre	between
gladys	gladys	gladys
glazer	glazer	glazer
glonass	glonass	glonass
gloria	gloria	gloria
gloster	gloster	(proper noun) gloster, as in gloster meteor
glucose	glucose	glucose
gmail	gmail	gmail
gnp	gnp	gnp
go	aller	"(term should be ""gay go"") tense"
goes	va	goes
goku	goku	goku
golden	doré	golden
gom	recueillir	to gather (v.)
google	google	google
gorbachev	gorbachev	gorbachev
gorbachyov	gorbachyov	gorbachev, as in former soviet president mikhail gorbachev
gordon	gordon	gordon, as in gordon brown
gore	gore	gore
gorky	gorky	gorky, as in gorky park
gothic	gothique	gothic
gottfried	gottfried	gottfried
grabeel	saisir	grabeel, a last name
graham	graham	graham
granada	grenade	granada
granit	granit	granite
greek	grec	(proper noun) greek
greenland	groenland	greenland
greenson	greenson	(proper noun) greenson
greenwich	greenwich	(proper noun) greenwich
greg	greg	greg
grenada	grenade	grenada
grenadines	grenadines	grenadines
gross	brut	gross
grumman	grumman	(proper noun) grumman
gruzia	géorgie	gruzia
gryffindor	gryffondor	gryffindor
gs	gs	prof.
gsts	gsts	professor- phd
gu	gu	gu
guam	guam	guam
guard	garde	guard
guatemala	guatemala	guatemala
gui	gui	gui
guinea	guinée	guinea
guinness	guinness	(proper noun) guinness
guitar	guitare	guitar
gujarat	gujarat	gujarat
gulag	goulag	gulag
gulf	golfe	gulf
gullit	gullit	(proper noun) gullit
gundam	gundam	(proper noun) gundam
gunung	gunung	(proper noun) gunung
gustave	gustave	gustave
gutenberg	gutenberg	gutenberg
guyana	guyane	guyana; proper noun
gà	poulet	chicken
gài	rentrer	to fasten (v.)
gào	a crié	"(term should be ""thét gào"") to cry out (v.)"
gác	garde	guard
gái	fille	girl
gán	attribuer	"entire phrase should be ""gan nhan""; means ""to label"""
gánh	fardeau	hold
gáy	nuque	crow
gân	tendon	tendon
gây	provoquer	make
gãy	cassé	break
gì	quoi	what
gìn	conserver	preserve
gò	monticule	"(term should be ""gò má"") cheekbone (n.)"
gòn	gòn	gon
góa	veuve	widowed
góc	coin	angle
gói	paquet	goi
góp	versement	to contribute
gót	talon	heels
gõ	type	type
göbbels	göbbels	gobbels, as in joseph gobbels
găm	thésauriser	poniard
găng	des gants	gloves
gũi	fermer	close
gươm	épée	sword
gương	miroir	mirror
gạc	gaze	johnson south reef
gạo	riz	rice
gạt	arraché	to cheat or trick (v.)
gả	mariage	marry
gảy	arraché	"(term should be ""âm gảy"") a type of phonetic sound found in the japanese language (n.)"
gấc	gac	gac
gấm	brocart	brocade
gấp	pressé	times, as in many times
gấu	l&#39;ours	a bear (n.)
gần	près	near
gầy	mince	thin
gẫy	cassé	break
gập	plier	"(term should be ""gập ghềnh"") bumpy (adj.)"
gậy	bâtons	stick
gắm	pet	send
gắn	monté	mount
gắng	essayer	try
gắt	durement	intense
gặm	ronger	rodent
gặp	rencontrer	meet
gặt	récolter	harvest
gỉ	rouillé	rust
gọi	appeler	call
gọn	soigné	neat (adj.)
gọng	bordé	gong
gọt	éplucher	cut
gỏi	salade	a vietnamese salad
gốc	racine	origin (n.)
gối	oreillers	"(should be ""qùy gối"") to kneel"
gốm	céramique	pottery
gồm	inclure	include
gồng	gong	carry
gỗ	bois	wood
gội	shampoing	shampoo
gộp	regroupé	aggregate
gớm	hideux	tremendous
gờ	rebord	edge
gởi	envoyer	send
gỡ	décharger	meet
gợi	suggestif	to evoke (v.)
gục	effondré	"(term should be ""đánh gục"") crush, as in battle"
gừng	gingembre	ginger
gửi	envoyé	send
ha	ha	hectare
habana	habana	(proper noun) habana
habsburg	habsburg	(proper noun) habsburg
haeberle	haeberle	haeberle
hahn	hahn	hahn
hai	deux	two (adj.)
hal	hal	hal
halle	halle	(proper noun) halle
halogen	halogène	halogen (n.)
ham	jambon	desire
hamilton	hamilton	(proper noun) hamilton
han	han	han
hang	grotte	cave
hangul	hangul	hangul
hanh	hanh	hanh
hanja	hanja	(proper noun) hanja, a type of chinese script
hansen	hansen	hasnen
hao	hao	"(term should be ""hao hụt"") to incur some loss (v.)"
harald	harald	harald
hardy	robuste	hardy
harlem	harlem	harlem
harlow	harlow	harlow
harold	harold	(proper noun) harold
harper	harper	harper
harpercollins	harpercollins	hapercollins
harrier	plus dur	harrier, as in harrier jump jet
harris	harris	harris
harry	harry	harry
harvard	harvard	(proper noun) harvard, the name of a college
harvey	harvey	harvey
havana	la havane	(proper noun) havana, cuba
havilland	havilland	havilland
hawker	colporteur	hawker
hawking	colportage	(proper noun) hawking, as in physicist stephen hawking
hay	bon	or
hb	hb	hb
hbv	hbv	hbv
hcl	hcl	hcl
hd	hd	activity
he	il	he, a korean name
health	santé	health
heath	bruyère	heath
hee	salut	hee
hegel	hegel	(proper noun) hegel, as in georg wilhelm friedrich hegel
heian	heian	heian
heinrich	heinrich	heinrich
helen	helen	helen
helena	helena	helena
heli	l&#39;hélium	helium
hematocrit	hématocrite	hematocrit
hemoglobin	l&#39;hémoglobine	hemoglobin
hen	poule	asthma
henry	henry	(proper noun) henry, as in henry kissinger
heo	cochon	dolphin
her	elle	her
herbert	herbert	herbert, as in herbert schandler
hercegovina	hercegovina	hercegovina
hercules	hercules	hercules
hermann	hermann	hermann
hermes	hermes	hermes
hersh	hersh	hersh, as in seymour hersh
hesiod	hesiod	hesiod
hestia	hestia	hestia
hi	salut	"(term should be ""hi vọng"") alternative spelling for ""hy vọng""; meaning ""hope"" (n.)"
hickam	hickam	(proper noun) hickam
hicks	hicks	hicks
hideto	hideto	(proper noun) hideto
hideyoshi	hideyoshi	(proper noun) hideyoshi
hidro	l&#39;hydrogène	hydrogen
hillsborough	hillsborough	hillsborough
hilton	hilton	hilton
himalaya	himalaya	(proper noun) himalaya
hinata	hinata	hinata
hindenburg	hindenburg	(proper noun) hindenburg
hindi	hindi	hindi
hindu	hindou	hindu, as in the hindu religion
hinh	hinh	(proper noun) a vietnamese first name
hinhtron	hinhtron	circle
hiragana	hiragana	hiragana
hiroshi	hiroshi	hiroshi
hiroshima	hiroshima	(proper noun) hiroshima, the japanese city
hitchcock	hitchcock	hitchcock
hitler	hitler	hitler
hitter	frappeur	hitter
hitters	frappeurs	hitters
hiên	porche	(proper noun) hiên, a vietnamese first name
hiđrô	l&#39;hydrogène	hydrogen
hiếm	rare	rare
hiến	faire un don	devote
hiếp	viol	rape
hiếu	piété filiale	pious
hiềm	malade	grudge
hiền	sauge	sage
hiểm	dangereux	dangerous
hiểu	comprendre	learn
hiện	se montrer	"(term should be ""thực hiện"") to accomplish"
hiệp	la moitié	united
hiệu	effet	effective
hlv	entraîneur	trainer
hms	hms	hms
hmông	hmong	hmong
hn	hn	hn
hoa	fleur	flower
hoan	festival	welcome
hogwarts	poudlard	(proper noun) hogwarts, sorcery school from the harry potter series
hoi	hoi	rare
hokage	hokage	hokage
hokusai	hokusai	hokusai
holmes	holmes	a name
holocaust	holocauste	holocause
holocen	holocène	holocen
holt	holt	holt, an english last name
hom	boutures	a cutting
homer	homer	(proper noun) homer, the authorof the iliad and the odyssey
hon	hon	"(term should be ""hòn"") rock (n.)"
honduras	honduras	honduras
hong	hong	hong
honolulu	honolulu	honolulu
honshū	honshū	honshu
hopkins	hopkins	(proper noun) hopkins
hornet	frelon	hornet
hotspur	hotspur	(proper noun) hotspur, as in tottenham hotspur
houston	houston	(proper noun) houston, as in whitney houston
howard	howard	(proper noun) howard
however	cependant	however
hoà	cravate	peace
hoài	nostalgique	always (adv.)
hoàn	complet	"(term should be ""hoàn toàn"") completely"
hoàng	royal	royal (adj.)
hoành	diaphragme	rife
hoá	chimie	"(term should be ""văn hoá"") culture (n.)"
hoán	perm	refined (adj.)
hoãn	reporter	delay
hoạ	peindre	disaster (tham hoa)
hoại	gangrène	"(term should be ""phá hoại"") to sabotage (v.)"
hoạt	hentai	work
hoả	le feu	of
hoảng	panique	panic-stricken (adj.)
hoặc	ou	or
hp	hp	hp
hq	siège	hq
hudgens	hudgens	(proper noun) hudgens
hudson	hudson	hudson
huey	huey	huey
hughes	hughes	hughes
hugo	hugo	(proper noun) hugo
hume	hume	hume, as in david hume
hun	hun	(proper noun) hun
hungary	hongrie	hungary
hunt	chasser	hunt
hurley	hurley	(proper noun) hurley, as in chad hurley
hussein	hussein	hussein
husserl	husserl	huserl
huston	huston	huston
hutech	hutech	hutech
huy	huy	a common vietnamese first name
huynh	frère	older brother
huyền	mystique	huyền thoại= legend
huyễn	illusoire	huyen
huyện	quartier	district
huyệt	points d&#39;acupuncture	lair
huân	huan	"(term should be ""huân chương"") medal (n.)"
huê	teinte	"a less common vietnamese word for ""flower"""
huấn	formation	"(term should be ""huận luyện"") to train (v.)"
huế	teinte	hue
huệ	teinte	favour
huống	cas	situation
huỳnh	soufre	sulfur
huỷ	annuler	destroy
hydra	hydre	hydra, a monster in greek mythology
hydro	l&#39;hydrogène	hydrogen
hyperion	hyperion	hyperion
hà	ha	"(term should be ""hà nội"") the capital of vietnam"
hài	comédie	corpse
hàm	fonction	"(term should be ""bao hàm"") to imply (v.)"
hàng	marchandises	row
hào	fossé	depreciation
hách	dominateur	glorious
hái	cueillette	picking
hán	sécheresse	china
háo	avide	eager
hát	chanter	song
hâm	fou	"(term should be ""hâm mộ"") to admire (v.)"
hân	han	le ngoc han
hãi	effrayé	to be scared (v.)
hãn	khan	to sweat (v.)
hãng	ferme	a company (n.)
hãnh	fier	proud
hè	été	summer
hé	craqué	reveal
héo	flétrir	dried-out
hét	cria	shout
hên	chanceux	luck
hí	ne	game
hít	renifler	act of kissing (hon hit)
hò	rencontres	date
hòa	cravate	republic
hòe	merde	hoe
hòm	arche	box
hòn	île	island
hòng	bien	in order to
hóc	hóc	a corner (n.)
hót	chanter	to chirp or sing (v.)
hô	ho	respiration
hôi	faute	stink
hôm	jour	day (n.)
hôn	baiser	propose
hông	hanches	hip
hù	effrayer	threaten
hùng	des héros	hero
húc	butter	huc
húng	basilic	"(should be ""húng láng"") water mint"
hút	fumer	to suck (v.)
hăng	piquant	enthusiasm
hđbt	hđbt	hdbt
hđh	hđh	system software
hũ	pots	jar
hơi	légèrement	slightly
hơn	plus	more or less
hư	coquine	fictional
hưu	retraité	huu
hương	encens	smell
hước	humoristique	humor
hướng	direction	trend
hường	huong	huong
hưởng	profiter	influence
hạ	plus bas	lower
hạc	grue	crane
hạch	ganglion	ganglion
hại	mal	harm
hạng	rang	rank
hạnh	hanh	happy
hạo	hao	hao
hạp	hap	hap
hạt	des perles	seed
hải	les douanes	two
hảo	parfait	perfect
hấn	hấn	aggressive gesture
hất	lancer	toss
hấu	pastèque	"(term should be ""dưa hấu"") watermelon"
hầm	ragoût	ham
hầu	presque	most
hận	déteste	hatred
hậu	hau	anus
hắc	noir	black
hắn	lui	he (n.)
hắt	éternuer	reject
hằng	constant	every
hặc	hặc	to criticize (v.)
hẹ	échalotes	chinese chives
hẹp	étroit	narrow
hẻm	ruelle	alley (n.)
hẻo	isolé	outback
hến	moules	mussel
hết	sur	most
hề	clown	"(term should be ""không hề"") never"
hễ	hein	whenever
hệ	système	relation
hệt	identique	exactly
hỉ	hei	happy
hịch	thud	a proclamation
họ	eux	they (n.)
họa	art	picture
họach	planifier	"(term should be ""quy hoạch"") a project (n.)"
học	apprendre	study (v.)
họng	la gorge	throat
họp	réunion	meet
hỏa	feu	fire
hỏng	cassé	corruption
hố	fosse	hole
hốc	niches	cavity
hồ	lac	ho
hồi	anis	muslim
hồn	âme	soul
hổ	tigre	tiger
hổi	huh	"(term should be ""nóng hổi"") steaming hot (adj.)"
hổng	béant	hole
hỗ	soutien	"(should be ""hỗ trợ"") to support or assist"
hỗn	mixte	"(term should be ""hỗn tạp"") mish-mash (adj.)"
hội	assemblage	society
hộp	boîte	box
hới	ouvert	hoi
hớn	cria	"(term should be ""hớn hở"") radiant (adj.)"
hờn	boudeur	hatred
hở	ouvert	reveal
hỡi	oi	dear
hợi	cochon	pig (n.)
hợp	convenable	appropriate
hợpquận	consentement	general district
hụt	manqué	loss
hủi	lépreux	reject
hủy	annuler	to erase or destroy
hứa	promesse	promise
hử	hein	hu
hửu	hein	"(term should be ""sở hửu"") to own (v.)"
hữu	propriété	(proper noun) hữu, a vietnamese middle name; also means right, as in the direction
hựu	huu	again
hỷ	hy	hy
ian	ian	ian, as in australian swimmer ian thorpe
iau	iau	iau
iberia	ibérique	iberia
ibm	ibm	(proper noun) ibm, the computer company
ibmpc	ibmpc	ibm-pc
ic	ic	ic
icc	icc	icc
iceland	islande	(proper noun) the country of iceland
ide	ide	ide
ieng	ieng	(proper noun) ieng
igor	igor	igor
iii	iii	third
ilene	ilene	ilence
illusion	illusion	illusion
ilyich	ilyich	ilyich
im	im	still
imam	imam	(proper noun) imam
imbrium	imbrium	imbriun
immanuel	immanuel	(proper noun) immanuel, as in immanuel kant
impact	impact	impact
incoterm	incoterm	incoterm
incoterms	incoterms	(proper noun) incoterms
indian	indien	indian
indiana	indiana	indiana
indochina	indochine	indochina
indonesia	l&#39;indonésie	indonesia
indrapura	indrapura	(proper noun) indrapura
info	info	info
innsbruck	innsbruck	innsbruck
insulin	insuline	insulin
int	int	int
intel	intel	(proper noun) intel, as in the name of the company
interpol	interpoler	interpol
inu	inu	(proper noun) inu
inuyasha	inuyasha	inuyasha
inư	inu	(proper noun) inư
io	io	io
ioc	ioc	ioc
ion	ion	ion
iosif	iosif	(proper noun) iosif, as in iosif vissarionovich stalin
iran	iran	the nation of iran
iraq	irak	iraq
ireland	irlande	ireland
irgun	irgun	irgun
irony	ironie	irony
irving	irving	(proper noun) irving
isaac	isaac	isaac
isla	isla	isla
islam	l&#39;islam	islam
islamabad	islamabad	(proper noun) islamabad
israeli	israélien	israeli
istanbul	istanbul	istabbul
italia	italia	italy
italiano	italiano	(proper noun) italiano
itanium	itanium	itanium, as in windows xp itanium
ito	ito	ito
itsukushima	itsukushima	itsukushima
itu	itu	itu
itzá	itzá	(proper noun) itzá
iv	iv	4 ( greek number)
iwami	iwami	iwami
j	j	j
jack	cric	jack
jackie	jackie	(proper noun) jackie chan
jackson	jackson	(proper noun) jackson, as in michael jackson
jacob	jacob	jacob
jae	jae	jae
jakarta	jakarta	(proper noun) jakarta
jan	jan	(proper noun) jan
janeiro	janeiro	janeiro
janet	janet	janet
japan	japon	japan
jared	jared	jared
jarvis	jarvis	(proper noun) jarvis, as in jarvis cocker
jasper	jaspe	(proper noun) jasper
jean	jean	jean
jeane	jeane	jeane
jeanjacques	jeanjacques	jean-jacques
jeanpaul	jeanpaul	jeanpaul
jeans	jeans	jeans
jeet	jeet	(proper noun) jeet, as in jeet kune do
jeff	jeff	jeff, as in jeff drake
jefferson	jefferson	jefferson
jeffrey	jeffrey	jeffrey
jeju	jeju	jeju
jenda	jenda	jenda
jenny	jenny	jenny
jericho	jericho	jericho, as in wrestler chris jericho
jerome	jerome	jerome, as in fred jerome
jerry	jerry	(proper noun) jerry
jersey	maillot	jersey
jerusalem	jérusalem	jerusalem
jesse	jesse	a name
jesus	jésus	chua jesus
jetstar	jetstar	jetstar
jewish	juif	jewish
jiao	jiao	jiao
jimmy	jimmy	jimmy
jin	jin	jin
jing	jing	jing
jiraiya	jiraiya	(proper noun) jiraiya
joachim	joachim	joachin
joan	joan	a name
joe	joe	(proper noun) joe
johan	johan	johan
johann	johann	johann
johannes	johannes	johannes
johannesburg	johannesburg	(proper noun) johannesburg, south africa
johnny	johnny	johnny
johns	johns	johns
johnston	johnston	johnston, as in harry johnston
johor	johor	johor
joint	joint	joint
jonathan	jonathan	(proper noun) jonathan
jones	jones	jones
jose	jose	(proper noun) jose, a spanish first name
joseon	joseon	(proper noun) joseon
joseph	joseph	joseph
jscript	jscript	(proper noun) jscript
juche	juche	(proper noun) juche
judith	judith	judith
judo	judo	judo, the martial art
julesverne	julesverne	jules verne
julliard	julliard	(proper noun) julliard
jump	sauter	jump
june	juin	june, as in the month
jung	jung	jung
junsu	junsu	junsu
jupiter	jupiter	(proper noun) jupiter, as in the planet
jura	jura	(proper noun) jura
juventus	juventus	juventus
k	k	k
kaede	kaede	a japanese name
kaffee	kaffee	(proper noun) kaffee, as in kaffee hag
kagome	kagome	kagome, as in higurashi kagome
kahn	kahn	kahn
kai	kai	kai
kakashi	kakashi	kakashi
kaká	kaká	(proper noun) kaka, a brazilian soccer player
kalashnikov	kalashnikov	(proper noun) kalashnikov
kali	potassium	potassium
kama	kama	(proper noun) kama, as in the kama sutra
kamakura	kamakura	kamakura
kamov	kamov	kamov
kampf	kampf	kampf
kampong	kampong	kampong
kampuchea	kampuchea	cambodian
kana	kana	kana, the japanese phonetic alphabet
kangin	kangin	(proper noun) kangin
kanji	kanji	kanji
kant	kant	a name
kar	kar	(proper noun) kar
kara	kara	kara
karaoke	karaoké	karaoke
karate	karaté	karate
karatedo	karatedo	karatedo
karen	karen	(proper noun) karen
karim	karim	(proper noun) karim
kashmir	cachemire	kashmir
kaspersky	kaspersky	(proper noun) kaspersky, as in kaspersky anti-virus software
katakana	katakana	katakana, a type of japanese script
kate	kate	(proper noun) kate, as in actress kate winslet
katherine	catherine	katherine
kathmandu	katmandou	kathmandu
katrina	katrina	(proper noun) katrina, as in hurricane katrina
katz	katz	katz
kauthara	kauthara	kauthara, a part of the ancient kingdom of champa
kavkaz	caucase	kavkaz
kawasaki	kawasaki	(proper noun) kawasaki
kay	kay	kay
kazan	kazan	kazan, the name of a city
kcn	kcn	industrial zone
ke	ke	"(term should be ""boong ke"") a bunker (n.)"
kelly	kelly	kelly
kelsi	kelsi	kelsi
kelvin	kelvin	kelvin
kem	glace	ice cream (n.)
ken	ken	ken
kennedy	kennedy	(proper noun) kennedy, as in john f. kennedy
kenneth	kenneth	(proper noun) kenneth, a name
kenny	kenny	kenny, an english first name
kentucky	kentucky	(proper noun) kentucky
kepler	kepler	kepler
kerala	kerala	(proper noun) kerala
kevin	kevin	kenvin
keynes	keynes	keynes, as in economist john maynard keynes
kg	kg	kilogram
kha	kha	(proper noun) a vietnamese first name
khai	déclaration	announce
khali	khali	(proper noun) khali
khalip	khalip	(proper noun) khalip
kham	kham	endure
khan	anhydre	rare
khang	khang	khang
khanh	khanh	khanh
khao	nostalgie	desire
khay	plateau	tray
khe	fente	chink
khem	khem	abstinence
khen	compliment	praise
kheo	sur pilotis	kheo
khi	quand	when
khieu	khieu	(proper noun) khieu, as in khieu samphan
khiêm	modeste	khiem
khiên	bouclier	a shield
khiêu	érotique	"('khiêu dâm"") pornographic"
khiếm	altéré	lack
khiến	provoquer	control
khiếp	terrifié	horrible
khiếu	loge	talent (n.)
khiển	contrôle	control
khleang	khleang	kh'leang
kho	entrepôt	warehouse
khoa	faculté	"(term should be ""y khoa"") the study of medicine (n.)"
khoan	percer	drill
khoang	cavité	brag
khoanh	sonner	a slice (n.)
khoe	montrer	to boast
khoá	verrouiller	lock
khoác	pardessus	coat
khoán	stock	stock
khoáng	minéral	mineral
khoát	définitif	decisive
khoét	couper	carve
khoăn	frette	disturbed
khoả	nu	naked
khoản	objet	an item (n.)
khoảng	environ	about
khoảnh	moments	moment
khoẻ	bien	health
khrushchev	khrouchtchev	khrushchev
khrushchyov	khrushchyov	khrushchyov
khu	trimestres	section
khung	cadre	frame
khural	khural	khural
khuynh	à gauche	trend
khuyên	des conseils	advise
khuyết	défectueux	lack
khuyển	chien	khuyen
khuất	caché	hidden
khuấy	remuer	stir
khuẩn	les bactéries	bacteria
khuếch	amplifier	amplification
khuỷu	coude	elbow
khá	jolie	quite
khác	autre	different
khách	invités	customer
khái	conceptuel	concept
khám	examen	discover
khán	le public	audience
kháng	résistance	appeal
khánh	l&#39;indépendance	a type of chime made of stone (n.)
khát	soif	to be thirsty for (adj.)
khâm	khâm	admire
khèn	hélas	a pan-pipe (n.)
khéo	ingénieux	cleverly or skillfully (adv.)
khép	fermé	close
khía	encoche	"(term should be ""khía cạnh"") angle (n.)"
khích	encouragement	encourage
khít	serré	close
khó	dur	difficulty
khóa	verrouiller	a session
khóc	pleurer	cry
khói	fumer	smoke
khóm	ananas	a cluster
khô	sec	dry
khôn	sage	clever, intelligent
không	non	not
khúc	chanson	song
khăm	farce	nasty (adj.)
khăn	une serviette	difficult
khơi	offshore	sea
khư	khư	grip
khưu	khưu	khuu
khước	nier	waive
khả	possibilité	"(term should be ""khả năng"") ability (n.)"
khải	révélation	triumph
khảm	mosaïque	to encrust
khảo	examen	"(term should be ""tham khảo"") to consult (v.)"
khấm	percé	endure
khấn	prier	pray
khấu	remise	"(term should be ""sân khấu"") a stage (n.)"
khẩn	urgent	"(term should be ""khẩn cấp"") urgent (adj.)"
khắc	gravure	moment
khắp	partout	all over
khẳng	affirmative	"(term should be ""khẳng định"") to assert (v.)"
khế	fruit étoilé	bond
khỉ	singe	monkey or ape (n.)
khỏa	nu	nude
khỏe	bien	health
khỏi	sur	leave
khố	pagne	loincloths
khốc	terrible	devastating
khối	bloquer	a block or mass of (n.)
khốn	bâtard	miserable
khống	khong	control
khổ	souffrance	miserable (adj.)
khổng	géant	huge
khởi	initie	start
khủng	terrible	"(term should be ""khủng bố"") terrorist (n.)"
khủyu	bâtard	elbow
khứu	pastel	olfactory
khử	éliminer	reduction
ki	ki	"entire phrase is ""ki lo""; means ""kilometer"""
kia	là	other
kid	enfant	kid
kiel	kiel	(proper noun) kiel
kierkegaard	kierkegaard	kierkegaard, as in soren kierkegaard
kiernan	kiernan	kiernan
kii	kii	kii
kikyo	kikyo	kikyo
kilômét	kilomètres	kilometer
kim	aiguille	kim
kingdom	royaume	kingdom
kinsey	kinsey	kisney
kiribati	kiribati	kiribati
kishimoto	kishimoto	(proper noun) kishimoto
kiss	baiser	kiss
kissinger	kissinger	kissinger
kitts	kitts	kitts
kitô	christ	christian
kiêm	jouir	cum
kiên	patient	consistent
kiêng	s&#39;abstenir	abstinence, as in abstaining from eating
kiêu	arrogant	showy
kiếp	à vie	a lifetime (n.)
kiết	kiết	cheap (adj.)
kiềm	alcaline	"(term should be ""kiềm chế"") to restrain (v.)"
kiểm	vérifier	control
kiểu	type	type
kiệm	économique	save
kiện	sue	event (su kien)
kiệt	chef-d&#39;œuvre	exhausted (adv.)
kiệu	palanquin	scallion
klaus	klaus	klaus
klein	klein	klein
km	km	kilometer
knesset	knesset	knesset
knuth	knuth	knuth, as in donald knuth
koch	koch	koch
kodansha	kodansha	kodansha
kofun	kofun	kofun, as in the kofun period of japanese history
kogoro	kogoro	kogoro
komodo	komodo	komodo
kon	kon	"(term should be ""kon tum"") a province in the highlands of vietnam"
kong	kong	(proper noun) kong, as in hong kong
konstantin	konstantin	(proper noun) konstantin
konversationslexikon	konversationslexikon	konversation-lexikon
kop	kop	kop
koran	coran	koran
kornai	kornai	(proper noun) kornai, as in janos kornai
koruna	couronne	koruna
kosovo	kosovo	(proper noun) kosovo
kremli	kremli	kremil
kremlin	kremlin	kremlin
kristen	kristen	kristen
krông	krong	krong
ku	ku	is a name
kuala	kuala	(proper noun) kuala, as in kuala lumpur
kubrick	kubrick	kubrick
kuen	kuen	kuen
kuiper	kuiper	(proper noun) kuiper, as in the kuiper belt
kulak	kulak	kulak
kune	kune	(proper noun) kune, as in the martial art jeet kune do
kung	kung	danh vo
kungfu	kungfu	kung fu
kunst	kunst	kunst, as in richard kunst
kurd	kurd	kurd
kurt	kurt	(proper noun) kurt
kuwait	koweït	kuwait, the country (n.)
kwan	kwan	kwan
kwen	kwen	kwen
kwon	kwon	kwon, as in tae kwon do; proper noun
kyrgyzstan	kirinkistan	(proper noun) the country of kyrgyzstan
kyushu	kyushu	kyushu
kyūshū	kyūshū	kyushu, a japanese island
kèm	attaché	included
kèn	trompette	horn
kém	pauvre	less
kén	cocon	selective
kéo	tirer	scissors
kép	double	dual
két	sûr	"(term should be ""rốc két"") rocket (n.)"
kê	le mil	statistics
kênh	canal	channel
kêu	pleura	appeal
kìa	voici	that
kìm	une pince	bar
kình	lunettes	rivalry
kí	signe	sign
kích	cliquer	excite
kíchbom	bouton de clic	bombers
kín	privé	secretive or closed tight (adj.)
kính	verre	respect
kíp	équipage	esoterica
kít	kit	wheelbarrow
ký	signé	"(""nhật ký"") a diary"
kĩ	soigneusement	technique
kơnia	kàia	a tree found in southeast asia; sometimes called wild mango
kạn	kan	kan
kẹo	bonbon	candy
kẹp	pince	to clamp down (v.)
kẹt	coincé	jam
kẻ	les gars	guy
kẻo	de peur	lest
kẽ	interstitiel	crevice
kẽm	zinc	zinc
kế	suivant	a scheme (n.)
kết	fin	combine
kề	adjacent	adjacent
kềnh	encombrant	bulky
kệ	étagères	ignore
kỉ	siècle	"(term should be ""kỉ niệm"") souvenir (n.)"
kị	cavalerie	ki
kịp	à temps	kip
kỵ	cavalerie	taboo
kỷ	siècle	"(term should be ""thế kỷ"") century (n.)"
l	l	l.
label	étiquette	label
laboulaye	laboulaye	a name
ladakh	ladakh	(proper noun) ladakh
lai	hybride	"(term should be ""tương lai"") the future (n.)"
lam	lam	lam
lama	lama	a name
lan	lan	a name
land	terre	land
landon	landon	a name
lang	lang	lang
langdon	langdon	langdon
lange	lange	lange, as in oscar lange
langue	langue	langue
lanh	lin	ringing
lanka	lanka	(proper noun) lanka, as in the island of sri lanka
lao	tb	labor
laos	laos	(proper noun) laos
lap	tour	greek
larry	larry	larry
lars	lars	lars
las	las	(proper noun) las, as in las vegas
laser	laser	laser
lateran	latéran	lateran
latinh	latin	latin
latvia	lettonie	(proper noun) latvia
lau	essuyer	lau
laura	laura	(proper noun) laura, as in laura bush
laurence	laurence	(proper noun) laurence
lawrence	lawrence	(proper noun) lawrence
lay	jeter	lay
lazarus	lazarus	(proper noun) lazarus
leach	lessiver	(proper noun) leach
leaf	feuille	leaf
leave	partir	leave
lebanon	liban	(proper noun) lebanon
lee	lee	lee
legacy	héritage	legacy
leiden	leiden	leiden
lem	lem	cinderella
lenin	lénine	lenin
lenins	lénines	lenin's
leo	grimper	climb
leon	leon	leon
leonard	léonard	leonard
leonardo	leonardo	(proper noun) leonardo, as in leonardo da vinci
leonid	leonid	leonid
les	les	les
leslie	leslie	a name
lesotho	lesotho	lesotho
lg	lg	lg
lhp	lhp	film festival
lhq	lhq	un
libby	libby	(proper noun) libby
libero	libero	libero
libya	la libye	libya
lido	lido	lido
liechtenstein	liechtenstein	liechtenstein
liga	liga	a name
lightning	foudre	lightning
lilly	lilly	(proper noun) lilly
linga	linga	linga
linh	linh	efficacious (adj.)
links	liens	links
linux	linux	linux server
lionel	lionel	lionel
lisboa	lisboa	lisboa
lisbon	lisbonne	a name
litva	lituanie	(proper noun) lithuania
liu	liu	liu
liêm	intégrité	good example
liên	s&#39;aventurer	relate
liêng	sacré	sacred
liêu	bureaucratie	bureaucracy
liềm	faucille	sickle
liều	dose	daring
liễu	saule	a willow tree (n.)
liệng	lancer	"(term should be ""cánh liệng"") the aileron of a plane (n.)"
liệt	paralysie	impotent
liệu	brut	document
lleyton	lleyton	lleyton
lo	lo	to worry (v.)
loa	haut-parleur	"(term should be ""cổ loa"") an ancient vietnamese city (proper noun)"
loaita	loaita	loaita
loang	lisse	patchy
loch	loch	loch
locke	locke	(proper noun) locke, as in philosopher john locke
lockheed	lockheed	(proper noun) lockheed, as in lockheed martin
log	journal	log
logan	logan	a name
lon	canettes	lon
london	londres	london
long	longue	dragon
lorenzo	lorenzo	lorenzo
los	los	los, as in los angeles
louis	louis	louis
louisiana	louisiane	(proper noun) the state of louisiana
louvre	persienne	(proper noun) louvre
love	l&#39;amour	yeu
loài	espèce	species
loát	flashy	overturn
loãng	mince	wishy-washy
loét	ulcère	gaping, as in a wound
loại	type	type
loạianh	type	not a word
loạianime	type anime	type anime
loạibệnh	type de maladie	disease
loạichiến	type	loaichien
loạicác	type	item
loạicâu	type	type: club
loạicông	type	type: industry
loạicựu	type	kind former
loạigia	type	loaigia
loạihuân	kindhuan	not a word
loạiluật	type de loi	type: law
loạimáy	type de machine	kind plane
loạimôn	type	type
loạingày	tapez ceci	loaingay
loạiphim	type de film	type movie
loạiphong	type	kind of movement
loạiscandal	fleaiscandal	scandal type
loạithuật	type de loi	type: lexicon
loạithành	type	kinds of payment
loạithần	type	kind myth
loạitrường	type d&#39;école	type of school
loạitín	gentil	type: belief
loạitổ	type	kind organization
loạivõ	type type	type: martial art
loạixã	type	kind of society
loạn	trouble	disorderly
loạt	série	series
lp	lp	lp
lu	lu	dim
luang	luang	a name
lucas	lucas	(proper noun) lucas
lucia	lucia	lucia, as in the island of saint lucia
luciano	luciano	luciano
ludendorff	ludendorff	luđenorff
ludovico	ludovico	ludovico
ludwig	ludwig	ludwig
lui	retour	withdrawal
luis	luis	(proper noun) luis, a first name
luiz	luiz	luiz
lula	lula	lula
lung	poumon	shake
lustig	lustig	lusig
luther	luther	luther
luxembourg	luxembourg	a name
luy	luy	luy
luyến	attachement	love
luyện	pratiquer	training
luận	commentaire	"(term should be ""xã luận"") an editorial"
luật	la loi	law
luồn	fileté	wriggle
luồng	stream	lane
luộc	bouilli	boiled
luỹ	cumulatif	rampart (n.)
ly	ly	divorce
lydia	lydia	lydia
lympho	lymphome	lymphocyte
lyndon	lyndon	lyndon
lyon	lyon	lyon
là	est	the verb to be
làm	faire	make
làn	voie	wave
làng	village	village
lành	guéri	protestant
lào	laos	laos
lá	les feuilles	"(term should be ""lá thư"") a letter (n.)"
lác	plisser les yeux	brag
lách	rate	to swerve (v.)
lái	conduire	to drive (v.)
lán	cabane	shack
láng	lisse	neighbours
lâm	lam	lâm, a common vietnamese first name
lân	licorne	nearby
lâu	longue	long time
lây	contagieux	to infect
lãi	intérêt	a profit
lãm	montre	exhibition
lãnh	reçu	to receive
lão	vieux	old
lèo	lèo	"(term should be ""nước lèo"") broth (n.)"
lén	se faufiler	sneak
lê	les poires	le
lêmạc	lumière	"(term should be ""lê-mạc"") a war between two ruling families in ancient vietnamese history"
lên	en haut	on
lênh	commande	"(should be ""lênh đênh"") adrift"
lênin	lénine	lenin
lìa	partir	to leave (v.)
lình	soudain	suddenly
lí	stockage	reason
lính	soldat	soldier
lít	litre	litre
líu	roucouler	"(term should be ""dính líu"") to have a connection with"
lò	four	release
lòng	écraser	heart
lóc	tête de serpent	cry
lóe	flashé	flash
lóng	argot	"entire term should be ""tieng long""; means ""slang"""
lót	doublure	undies
lô	beaucoup	batch
lôi	erreur	encourage
lôn	lol	"(term should be ""côn lôn"") a village in vietnam"
lông	fourrure	hair
lõi	noyau	core
lõm	concave	concave
lùi	en arrière	back
lùn	nain	dwarf
lùng	chasser	hunt
lúa	riz	rice
lúc	à	at the moment
lún	affaissement	subside
lúng	flare	confused
lúp	grossissant	uneven
lút	sournois	surreptitiously
lăm	cinq	tens
lăn	rouler	attack
lăng	mausolée	tomb
lĩnh	domaines	"(term should be ""thủ lĩnh"") the leader (n.)"
lũ	inondation	a band or gang (n.)
lũng	vallée	valley
lũy	cumulatif	rampart
lơ	négligence	to ignore
lơi	se détendre	"(term should be ""lả lơi"") to act in a familiar or flirting manner (adv.)"
lư	encensoir	an urn
lưng	retour	back
lươn	anguille	eel
lương	salaire	conscience
lưới	grille	a net (n.)
lướt	surf	ski
lười	paresseux	lazy
lưỡi	la langue	tongue
lưỡng	bisexuel	"(term should be ""lưỡng tính"") bisexual"
lược	peigne	invasion
lượm	ramasser	pick up
lượn	glisser	to glide over (v.)
lǐ	lǐ	(proper noun) li, as in jet li
lạ	étrange	strange or unusual (adj.)
lạc	perdu	camel
lạch	ruisseau	"(term should be ""luồng lạch"") a narrow water passageway"
lại	encore	reversed
lạn	pourri	bright
lạng	lang	lang
lạp	saucisse	"(term should be ""hy lạp"") greek"
lạtma	lamma	lama
lạy	prosterné	kowtow
lấn	empiètement	to encroach on (v.)
lấp	remplir	sparkle
lấy	pris	taken
lầm	mal	wrong
lần	fois	time
lầu	étage	a story or level of a building (n.)
lầy	marécageux	swamp
lẩu	hotpot	hotpot
lẩy	sauter	get
lẫn	confus	each other
lẫy	pincer	illustrious
lận	tricher	fraudulent
lật	retourner	turn
lậy	oh ouais	"(term should be ""cai lậy"") the name of a rural district"
lắc	secouer	to shake (v.)
lắm	très	do
lắng	s&#39;installer	"(should be ""lo lắ́́ng"") to worry"
lắp	raccord	lap
lặng	silencieux	quiet
lặp	répéter	repeat
lặt	divers	means miscellaneous, part of the word lat vat
lẹ	rapide	quickly (adv.)
lẻ	bizarre	"(the term should be ""bán lẻ"") retail"
lẻn	se faufiler	sneak
lẻo	laxiste	climb
lề	marge	alignment
lều	tente	tent
lễ	cérémonie	ceremony
lệ	taux	"(term should be ""tỷ lệ"") probability (n.)"
lệch	asymétrique	difference
lệnh	la commande	command
lị	dysenterie	"(term should be ""tỉnh lị"") a township (n.)"
lịch	calendrier	history
lọc	filtrer	tricked
lọi	plisser les yeux	brilliant
lọng	parasols	rope
lọt	tomber	enter
lỏi	peluche	to enter
lỏng	lâche	loose
lố	sur	ridiculous
lốc	tourbillon	tornado
lối	entrée	way or path
lốp	pneu	tyre
lốt	déguisement	lolot
lồ	géant	giant
lồi	convexe	convex
lồng	cage	cage
lỗ	trou	hole
lộc	fortune	loc
lội	patauger	wade
lộn	retourné	wrong/mistake
lộng	magnifique	"(term should be ""cổ lộng"") the name of a vietnamese city"
lột	éplucher	exploit
lớn	grand	large
lớp	classe	grade (n.)
lờ	ignorer	turbid
lời	mot	advice
lở	plaies	to crack
lỡ	manquer	miss
lợi	avantage	benefit
lợn	porcs	pig
lợp	toiture	roof
lụa	la soie	silk
lục	vert	record
lụi	brûlé	ruin
lụt	inondation	flood
lụy	implications	consequence
lứa	litière	peer
lừa	tromper	mislead
lừng	illustre	well-known
lửng	blaireau	lơ lửng= not clear/ something in between
lự	hésitant	reluctant
lựa	sélectionné	chosen
lựu	grenade	grenade
ma	fantôme	ma sat (friction), ma thuat (magic), thay ma (zombie)
maastricht	maastricht	maastricht
macarthur	macarthur	macarthur
macclesfield	macclesfield	macclesfield
macedonia	macédoine	(proper noun) macedonia
mach	mach	mach
machiavelli	machiavelli	machiavelli, as in philosopher niccolo machiavelli
machu	machu	machu
macintosh	macintosh	macintosh
macma	magma	magma
macromedia	macromedia	macromedia
madeira	madère	madeira
madhouse	madhouse	madhouse
madison	madison	madison
madonna	madonna	(proper noun) madonna
madrid	madrid	madrid, as in the capital of spain
mafia	mafia	mafia
magiê	magnésium	magnesium
mahal	mahal	(proper noun) mahal, as in the taj mahal
mai	demain	"(term should be ""giang mai"") the disease syphilis (n.)"
mainframe	mainframe	mainframe
major	majeur	major
makemake	makemake	makemake
malacca	malacca	malacca
malay	malais	malaysia
malaysia	malaisie	(proper noun) the country of malaysia
malcolm	malcolm	malcolm
maldini	maldini	maldini
mali	mali	mai
malta	malte	malta
maluku	maluku	maluku
manche	manche	manche
manchester	manchester	manchester
mandela	mandela	mandela, as in nelson mandela
mandy	mandy	mandy
mang	roulement	to bring (v.)
manga	manga	manga
mangnall	mangnall	(proper noun) mangnall, as in ernest mangnall
manh	manh	fragile
manila	manille	manila, the capital of the philippines
mankiw	mankiw	mankiw, as in gregory mankiw
manti	manti	mantle
manuel	manuel	manuel
mao	mao	capillary
maps	des cartes	maps
maradona	maradona	(proper noun) maradona, as in soccer player diego maradona of argentina
marat	marat	(proper noun) marat, as in marat safin, a tennis player
marc	marc	marc, as in marc chagall
marcel	marcel	(proper noun) marcel, a french name
marcos	marcos	(proper noun) marcos, as in ferdinand marcos
marcus	marcus	marcus, as in marcus aurelius (n.)
margaret	margaret	(proper noun) margaret
maria	maria	(proper noun) maria
marianne	marianne	(proper noun) marianne
marie	marie	marie
marina	marina	marina
marino	marino	marino
marić	marić	maric
marmara	marmara	(proper noun) marmara, as in the sea of marmara
marne	marne	marne, as in the marne river (n.)
mars	mars	mars
marseille	marseille	marseille
marshall	marshall	marshall
marsu	marsu	(proper noun) marsu
marta	marta	(proper noun) marta, as in the female brazilian soccer player
martin	martin	martin
marx	marx	this is a name
mary	marie	(proper noun) mary
maryland	maryland	a name
maría	maría	maria
mas	mas	mas
massachusetts	massachusetts	massachusetts
mat	tapis	mat
mathematica	mathématique	(proper noun) mathematica, as in isaac newton's work, principia mathematica
mats	tapis	mats, as in mats sundin
matthias	matthias	matthias, as in matthias erzberger
mau	vite	fast
maurice	maurice	(proper noun) maurice
mausolus	mausole	mausolus
maxim	maxime	a name
may	coudre	lucky
maya	maya	(proper noun) maya
mcafee	mcafee	(proper noun) mcafee
mccain	mccain	mccain
mccartney	mccartney	a name
mccullough	mccullough	mccullough
mcdonald	mcdonald	(proper noun) mcdonald
mchc	mchc	mchc
mclaren	mclaren	mclaren
mcmahon	mcmahon	(proper noun) mcmahon
mcnamara	mcnamara	(proper noun) mcnamara, as in robert mcnamara
mcv	mcv	mean corpuscular volume
media	médias	media
medici	medici	(proper noun) medici, as in the medici family of italy
medina	médina	(proper noun) medina, as in ernest medina
medvedev	medvedev	medvedev
mekong	mekong	mekong
melbourne	melbourne	melbourne
mendeleev	mendeleev	mendeleev
menes	menes	(proper noun) menes
mercedes	mercedes	a name
messenger	messager	messanger
messerschmitt	messerschmitt	messerschmitt, as in the messerschmitt me-109, a german plane
messi	messi	(proper noun) messi, as in argentinian soccer player lionel messi
messiah	messie	messiah
meteora	météore	meteora
mext	mext	mext
meyer	meyer	(proper noun) meyer, as in stephenie meyer, author of the twilight series
meyers	meyers	meyers
miami	miami	a name
michael	michael	michael
michaels	michael	michaels
michelangelo	michelangelo	michelangelo
michigan	michigan	a name
micro	microphone	micro
microbiology	microbiologie	microbiology
microeconomics	microéconomie	microeconomics
micronesia	micronésie	micronesia
microsoft	microsoft	(proper noun) the microsoft company
miguel	miguel	miguel
mike	mike	mike
mikoyan	mikoyan	mikoyan
mikoyangurevich	mikoyangurevich	(proper noun) mikoyangurevich
milan	milan	milan
milano	milano	milano
miley	miley	miley
mill	moulin	mill
miller	miller	miller
milton	milton	milton
min	min	min
minas	minas	minas
mindanao	mindanao	(proper noun) mindanao
ming	ming	ming
minnesota	minnesota	minnesota
minoa	minoa	minoa; the minoan civilization
miraflores	miraflores	miraflores
mirage	mirage	mirage
miroku	miroku	(proper noun) miroku, a japanese name
misfits	inadaptés	misfits
mississippi	mississippi	mississippi
missouri	missouri	(proper noun) the state of missouri
mitchel	mitchel	mitchel
mitsubishi	mitsubishi	mitsubishi
miên	l&#39;hypnose	mien
miêu	chat	"(term should be ""miêu tả"") to describe (v.)"
miến	vermicelles	burma
miếng	pièces	a piece (n.)
miếu	temple	temple
miền	domaine	area
miễn	gratuit	to exempt (v.)
miện	couronne	crown
miệng	la bouche	mouth
mm	mm	millimeter
mobile	mobile	mobile
mode	mode	mode
modul	module	module
modula	module	(proper noun) modula, as in modula-2
mohammad	mohammad	mohammad
mohammed	mohammed	mohammed
moi	nouveau	winkle
molecular	moléculaire	molecular
molotov	molotov	molotov
molypden	molybdène	the element molybdenum (n.)
mongolia	mongolie	mongolia
monique	monique	(proper name) monique, a french first name
mono	mono	mono
monroe	monroe	monroe
mont	mont	(proper noun) mont
montaigne	montaigne	montaigne, as in michel de montaigne
montana	montana	(proper noun) montana, as in the state
montenegro	monténégro	montenegro
montmartre	montmartre	(proper noun) montmartre
montparnasse	montparnasse	montparnasse
montreal	montréal	(proper noun) montreal, quebec
moo	moo	(proper noun) moo, as in cha moo won
moong	moong	moong
mora	mora	mora
moravia	moravie	moravia
morgan	morgan	(proper noun) morgan
mori	mori	(proper noun) mori
moriarty	moriarty	(proper noun) moriarty, as in james moriarty from sherlock holmes
morley	morley	morley
morocco	maroc	morocco
morris	morris	morris
morrison	morrison	(proper noun) morrison
morse	morse	(proper noun) morse, as in morse code
moscow	moscou	moscow
mosin	mosin	mosin
moskva	moskva	moscow
motown	motown	motown
mourinho	mourinho	mourinho
movie	film	movie
mozambique	mozambique	(proper noun) mozambique
mozart	mozart	(proper noun) mozart, as in the composer
mp	mp	mp
ms	ms	metre per second
msdos	msdos	ms-dos
mtv	mtv	mtv
mu	mu	pubis
mua	acheter	buy
much	beaucoup	much
muhammad	mohammed	(proper noun) muhammad, as in muhammad ali
mumbai	mumbai	mumbai
mun	ébène	a vietnamese name
munich	munich	(proper noun) munich
murdoch	murdoch	murdoch
muromachi	muromachi	(proper noun) muromachi
murphy	murphy	murphy
murray	murray	(proper noun) murray, as in dr. conrad murray
mustang	mustang	mustang, as in the f-51 mustang
muta	muta	a name
muôn	vouloir	a large number; thousands (adj.)
muối	du sel	salt
muốn	aimerait	want
muống	cuillère	"(term should be ""rau muống"") water spinach (n.)"
muồi	tard	ripe
muỗi	moustique	mosquito
muỗng	cuillère	spoon
muội	soeur	confusion
muộn	tard	late (adv.)
myanma	myanmar	the country of myanmar
myanmar	myanmar	(proper noun) myanmar
myspace	myspace	(proper noun) myspace
mà	ça	also
mài	broyage	tomorrow
màn	rideau	curtain (n.)
mành	stores	a bamboo screen (n.)
mào	huppé	a comb or crest, as in the body part of a bird
màu	couleur	color
mày	toi	sew
má	joues	cheek
mác	étiquette	a name (marx)
mách	conseils	tell
máclênin	marxelenin	marxist-leninist
mái	toit	"entire term should be ""thoai mai""; means ""comfortable"""
mát	cool	cool
máu	sang	blood
máy	la machine	a machine (n.)
mâm	plateau	tray
mân	chapelet	"entire term should be ""man viet""; a country of ancient asia that now corresponds to a province in southern china"
mâu	contradictoire	contradiction
mây	nuage	cloud
mã	code	"(term should be ""la mã"") roman (adj.)"
mãi	pour toujours	forever (adv.)
mãimại	code	commerce
mãn	complaisant	satisfy
mãnh	fort	intense
mão	couronnes	cat
mè	sésame	sesame
mèo	chat	cat (n.)
mé	mé	a border
méo	déformé	alter
mép	bord	edge
mét	mètre	meter
mênh	vaste	vast
mêtan	méthane	methane
mì	des nouilles	wheat
mình	toi	me
mía	canne	sugar cane (n.)
mò	tâtonné	to grope (v.)
mòn	usé	trail
móc	crochet	"(term should be ""máy móc"") machinery (n.)"
món	la nourriture	dish
mô	tissu	mo
môi	les lèvres	lip
môn	sujets	anus
mông	les fesses	mongolia
mônôxít	monoxyde	monoxide
môt	un	"(term should be ""một"") one (n.)"
môtô	moto	motorcycle
mù	aveugle	mu
mùa	saison	season
mùi	l&#39;odeur	smell
múa	danse	dance
mút	sucer	to suck (v.)
münchen	münchen	(proper noun) munchen
măng	pousses de bambou	bamboo shoot (n.)
mĩ	amérique	america
mũ	casquettes	cap
mũi	nez	nose
mơ	rêver	vague
mơn	pattes	caress
mưa	la pluie	rain
mưu	rusé	"(should be ""tham mưu"") advisors"
mươi	cinquante	tens
mương	fossé	ditch
mướn	embaucher	hire
mướt	lisse	smooth (adj.)
mường	muong	(proper noun) mường, a minority people in vietnam (n.)
mượn	emprunté	borrow
mượt	lisse	glossy (adj.)
mạc	désert	"(should be ""mộc mạc"") simple or natural"
mạch	circuit	vessel
mại	commerce	commerce
mạn	côté	romantic
mạnh	fort	strong
mạo	article	"(should be ""mạo hiểm"") to brave danger"
mạt	acariens	"(term should be ""lê mạt"") the ending or decline of something (adj.)"
mả	tombes	tomb or grave (n.)
mải	occupé	absorbedly
mảng	tableau	genre
mảnh	pièce	piece
mất	perdu	lose
mấu	onglet	key
mấy	peu	any
mầm	germe	kindergarten
mầu	couleur	color
mẩu	pièce	piece
mận	prunes	plum
mập	graisse	fat
mật	le miel	intimate
mậu	commerce	mau
mắc	cher	get
mắm	sauce de poisson	"(term should be ""nước mắm"") fish sauce (n.)"
mắn	chanceux	"(term should be ""may mắn"") fortunate (adj.)"
mắng	gronder	scold
mắt	les yeux	eye
mặc	porter	wear
mặn	salé	salt
mặt	le visage	face
mẹ	maman	mother (n.)
mẹo	conseils	trick
mẻ	lot	cool
mẽ	fort	strong
mến	cher	to adore or like greatly (v.)
mề	gésier	locket
mềm	doux	soft
mệnh	par	revolution
mệt	fatigué	tired
mỉ	méticuleux	meticulous
mỉa	ironie	ironic
mỉm	sourire	smile
mịch	merde	"(term should be ""tịch mịch"") quiet (adj.)"
mịn	lisse	smooth
mịt	renifler	dim
mọc	grandit	to grow (v.)
mọi	tous	every
mọn	mesquin	lowly
mỏ	les mines	mine
mỏi	fatigué	tired (adj.)
mỏng	mince	thin
mốc	moisi	border
mối	termite	relationship
mốt	mode	fashion or style (n.)
mồ	tombe	"(term should be ""mồ hôi"") sweat (n.)"
mồi	appât	bait (n.)
mổ	la chirurgie	to dissect or perform surgery (v.)
mỗi	chacun	every
mộ	tombe	admire
mộc	menuiserie	simple
mộng	rêver	dream
một	un	one
mới	nouveau	new (adj.)
mờ	floue	dim
mời	invité	invite
mở	ouvert	open
mỡ	graisse	fat or grease (n.)
mục	l&#39;article	purpose
mụn	l&#39;acné	pimple
mức	niveau	level
mứt	confiture	preserve
mừng	heureux	to be happy
mửa	vomissements	to vomit (v.)
mực	encre	"(term should be ""chuẩn mực"") standard (n.)"
mỳ	des nouilles	noodles (n.)
mỹ	bien	america
mỹcông	amérique	my private
na	na	"(term should be ""na uy"") the country of norway"
naadam	naadam	naadam
nacional	nacional	nacional
nagant	nagant	nagant
nagar	nagar	nagar, as in champa po nagar
nagasaki	nagasaki	(proper noun) the city of nagasaki, japan
nagoya	nagoya	a name
nagumo	nagumo	nagumo
nai	cerf	a deer
nairobi	nairobi	nairobi, a city in kenya (n.)
nakajima	nakajima	a japanese name
nalbandian	nalbandian	a name
nam	mâle	male
nambắc	au nord	nambac
namibia	namibie	namibia
namnam	namnam	male-male
namno	namno	nammo
nancy	nancy	nancy, as in nancy pelosi
nang	capsule	"(term should be ""cẩm nang"") a handbook (n.)"
nanh	crocs	fang
nano	nano	nano
naomi	naomi	naomi, as in model naomi campbell
napoleon	napoléon	(proper noun) napoleon
napoli	napoli	(proper noun) napoli
napoléon	napoléon	napoleon
nara	nara	nara
nasa	nasa	(proper noun) nasa
nat	nat	nat
nathan	nathan	nathan
natri	sodium	sodium
nauru	nauru	a name
nava	nava	nava
navarre	navarre	navarre
nay	maintenant	this (adj.)
needham	needham	needham
nelson	nelson	(proper noun) nelson, as in nelson mandela
neo	ancre	"(term should be ""mỏ neo"") an anchor (n.)"
neon	néon	neon
nepal	népal	nepal
nepomuk	nepomuk	a name
nessie	nessie	(noun) nessie, the nickname of the loch ness monster
net	net	net
netbook	netbook	netbook
netscape	netscape	netscape
networks	réseaux	networks
neumann	neumann	(proper noun) neumann
neutrino	neutrino	neutrino
nevada	nevada	nevada
neverland	neverland	neverland
newcastle	newcastle	newcastle
newspaper	journal	newspaper
newton	newton	newton
newtons	newtons	(proper noun) newton's
next	suivant	next
nga	la russie	russia
ngai	trône	crown
ngang	horizontal	horizontal
ngao	palourde	clam (n.)
ngay	maintenant	even
nghe	entendre	hear
nghinh	nghinh	welcome
nghiêm	sévèrement	serious
nghiêng	incliné	inclined
nghiêu	nghieu	nghiêu, a vietnamese name
nghiền	écrasé	crush
nghiễm	dommage	serious
nghiệm	expérience	experiment
nghiện	accro	addiction
nghiệp	karma	karma/ sự nghiệp=career
nghiệt	sinistre	adverse
nghành	l&#39;industrie	faculty
nghèo	pauvre	poor
nghé	nghe	to glance out of the corner of one's eye (v.)
nghê	nghe	nghe khuong
nghênh	bienvenue	support
nghìn	mille	thousand
nghĩ	pensé	think
nghĩa	sens	meaning
nghẽn	congestion	jam
nghếch	fort	stupid
nghề	profession	career
nghệquận	art	art district
nghỉ	casser	relaxation
nghị	recommandations	think
ngo	délicat	ngo
ngoan	bon garçon	good
ngoc	ngoc	"(term should be ""ngọc"") gem (n.)"
ngon	délicieux	delicious
ngoài	à part	outside of
ngoại	étranger	external
ngoạn	à couper le souffle	spectacular
ngoặc	parenthèses	bracket
ngoặt	tournant	landmark
ngu	stupide	stupid
ngung	ngung	(proper noun) a vietnamese first name
nguyen	nguyen	nguyen
nguyên	original	reason
nguyền	malédiction	curse
nguyện	vœu	"(term should be ""mãn nguyện"") to be satisfied (adj.)"
nguyệt	lune	moon
nguôi	apaisant	fade away
nguồn	source	source
nguời	les gens	people
nguỵ	imbéciles	camouflage
ngà	ivoire	russian
ngàn	mille	thousand
ngàng	ngàng	"(term should be ""ngỡ ngàng"") to be at fault (adj.)"
ngành	l&#39;industrie	sector
ngào	doux	sweet
ngày	jour	day
ngách	niche	"entire term should be ""ngoc ngach""; means ""a small, out-of-the-way road"""
ngái	stupide	chinese ethnic group living in the vietnamese highlands near the china border
ngán	s&#39;ennuyer	to be tired of
ngáng	ngáng	stop
ngát	évanouissement	"(term should be ""ngát hương"") fragrant (adj.)"
ngân	banque	money
ngây	vierge	"(term should be ""ngây ngất"") to be in ecstasy"
ngãi	ngai	ngai
ngò	coriandre	coriander
ngó	regarde	to look (v.)
ngói	tuile	tile or shingle
ngón	doigt	a finger (n.)
ngót	rétrécissement	"(term should be ""rau ngót"") also called sweet leaf, a type of leafy vegetable used to make soup (n.)"
ngôn	la langue	manifesto
ngông	oie	eccentric
ngõ	voie	lane
ngùi	sentir	sad
ngút	ngut	"entire term is ""ngut troi""; means ""sky-high"""
ngăn	compartiment	prevent
ngũ	cinq	rank
ngơ	ignoré	ignored (adj.)
ngơi	repos	"(term should be ""nghỉ ngơi"") to rest (v.)"
ngư	pêcheur	fishermen
ngưng	arrêter	stop
ngưu	ox	buffalo
ngươi	toi	an ancient form of address equivalent to thou or thee (n.)
người	les gens	people
ngưỡng	seuil	religious
ngược	en arrière	opposite
ngạc	surpris	surprise
ngạch	rang	"(term should be ""kim ngạch"") turn-over (n.)"
ngạn	banque	bank
ngạnh	barbes	self-willed
ngạo	arrogant	"(term should be ""ngạo ngược"") insolent (adj.)"
ngạt	asphyxie	stuffy
ngấm	infusé	draw
ngất	évanouissement	unconscious
ngầm	souterrain	underground
ngần	hésiter	hesitate
ngẩn	abasourdi	froze
ngẫm	méditer	think
ngẫu	aléatoire	ngẫu nhiên= random
ngậm	pastilles	keep
ngập	inondé	flood
ngắm	regarder	to contemplate or look admiringly at something (v.)
ngắn	court	short
ngặt	serré	strict
ngọ	midi	horse
ngọc	perle	pearl
ngọn	hauts	top
ngọt	doux	sweet (adj.)
ngồi	assis	sit
ngộ	illumination	ngo
ngột	brusquement	sudden
ngớ	idiot	silly
ngời	les gens	bright
ngỡ	pensé	surprised
ngợi	louange	praise
ngợm	coquine	naughty
ngục	donjon	dungeon
ngụm	siroter	sip
ngụy	wei	puppet
ngủ	dormir	sleep
ngủi	court	"(should be ""ngắn ngủi"") short-lived"
ngứa	démangeaisons	itchy
ngừ	thon	tuna
ngừa	prévenir	prevent
ngừng	arrêter	to cease (v.)
ngửa	faire face	supine
ngửi	sentir	to smell
ngữ	discours	term
ngự	habiter	defend
ngựa	chevaux	horse
ngực	poitrine	chest
nha	dentiste	dental
nhakẻ	enfant	nha-ke
nham	lave	"(actual term is ""dung nham"") lava"
nhan	nhan	"(term should be ""dung nhan"") countenance or facial appearance (n.)"
nhang	encens	incense
nhanh	rapide	fast
nhat	nhat	nhat
nhen	ravivé	rekindle
nhi	les enfants	junior
nhiên	cours	tuy nhiên= however
nhiêu	beaucoup	how many
nhiều	beaucoup	numerous
nhiễm	infecté	infect
nhiễu	bruit	noise
nhiệm	devoir	task
nhiệt	chaleur	heat
nhk	nhk	nhk
nhs	nhs	nhs
nhu	comme	demand
nhuận	saut	leap year
nhuệ	nhue	elite
nhuộm	teint	dye
nhàn	inactif	leisure
nhàng	doucement	"(term should be ""nhẹ nhàng"") gentle (adj.)"
nhào	pétrir	to fall headlong
nhác	mou	coward
nhái	clones	illegal copy
nhánh	branche	branch
nháp	brouillon	draft
nháy	clignote	to flash or blink (v.)
nhâm	trempage	leap
nhã	de bon goût	"(term should be ""thanh nhã"") elegant"
nhãn	étiquette	"(term should be ""gán nhãn"") to affix a label"
nhét	niché	put
nhì	seconde	second (adj.)
nhìn	regarde	to look (v.)
nhí	bavardage	children
nhím	hérisson	porcupine
nhòm	regarde	to peep (v.)
nhóc	enfant	brat
nhóm	groupe	group (n.)
nhô	en saillie	emerge
nhôm	aluminium	aluminum (n.)
nhúng	intégré	embed
nhút	timide	shy
nhăn	ridée	wrinkle
nhĩ	auriculaire	turkey
nhũ	émulsion	"(term should be ""thạch nhũ"") stalactite (n.)"
nhũng	la corruption	bribery
nhơn	multiplier	nhon
như	comme	like
nhưng	mais	but
nhương	salive	(proper noun) vietnamese first name
nhường	rendement	yield
nhưỡng	grasse	soil
nhược	faiblesse	weak
nhượng	concessions	concession
nhạ	nhạ	nha
nhạc	la musique	music
nhạn	avaler	bird
nhạo	se moquer	ridicule
nhạt	pâle	light
nhạy	sensible	sensitive
nhảy	danse	jump
nhấc	soulever	lift
nhấm	siroter	rodent
nhấn	en appuyant	to press (v.)
nhất	le plus	most
nhầm	mal	misunderstand
nhầy	visqueux	glutinous
nhẫn	anneaux	patient
nhậm	estampillé	inaugurate
nhập	entrer	penetrate
nhậu	boire	drink
nhậy	sensible	sensitive
nhắc	invite	to remind (v.)
nhắm	viser	aim
nhắn	le message	message
nhằm	viser	for the purpose of (adv.)
nhẵn	lisse	smooth
nhặt	ramassé	pickup
nhẹ	lumière	light
nhẹn	agile	nhanh nhẹn= fast/nimble
nhị	étamine	sensitive
nhịn	s&#39;abstenir	fasting
nhọ	enduit	smear
nhọn	pointu	sharp (adj.)
nhỏ	petit	small
nhỏ|cây	petit | arbre	small|tree
nhỏ|một	petit | un	small | one
nhỏ|phải|	petit | droit |	small|right
nhỏ|phải|px|	petit | droit | px |	small | have | px |
nhỏ|phải|px|bức	petite | droite | px | photos	grape / fade / px / buc
nhỏ|phải|px|cây	petit | droit | px | arbre	px spicy grape fade
nhỏ|phải|px|khu	petite | droite | px | zone	small|right|px|area
nhỏ|phải|px|michael	petit | droit | px | michael	small|right|px|michael
nhỏ|phải|px|máy	petite | droite | px | machine	small | right|px|machine
nhỏ|phải|px|một	petit | droit | px | un	small|right|px|one
nhỏ|phải|px|quân	petit | droit | px | force	small|right|px|army
nhỏ|px|	petit | px |	small
nhỏ|px|các	petit | px | le	small
nhỏ|px|phải|kiến	petite | px | droite | fourmi	small | px | right | patience
nhỏ|quân	petit | force	small|army
nhỏ|trái|px|máy	petite | gauche | px | machine	small|left|px|plane
nhỏ|tượng	petites statues	small|statue
nhốt	enfermé	confine
nhồi	farci	cram
nhổ	cracher	uproot
nhộn	hilarant	busy
nhớ	se souvenir	remember
nhớt	visqueux	viscid
nhờ	merci	by
nhờn	grasse	multiplication
nhở	rappeler	remind
nhụ	pincer	nhu
nhục	humilié	shame
nhủ	rappels	needs
nhức	des courbatures	pain
nhứt	d&#39;abord	first (n.)
nhừ	comme	tender
những	ces	the
nhựa	plastique	plastic
nhựt	nhut	"like the word ""nhật""; meaning ""sun"" (n.)"
ni	ni	nun
nia	nia	a flat basket (n.)
nicaea	nicée	nicaea
nicaragua	nicaragua	(proper noun) nicaragua
niccolò	niccolò	(proper noun) niccolo, as in writer niccolo machiavelli
nicolas	nicolas	(proper noun) nicolas, as in nicolas sarkozy
niels	niels	(proper noun) niels
nigeria	nigeria	nigeria
nikel	nikel	nickel
niken	nickel	nickel
nikita	nikita	(proper noun) nikita, a first name
nikko	nikko	(proper noun) nikko
nikolai	nikolai	nikolai
nikolayevich	nikolayevich	nikolayevich
nil	nul	nile
nile	nil	(proper noun) the river nile
nimitz	nimitz	(proper noun) nimitz, as in the ship uss nimitz
nin	nin	nin
ninh	la sécurité	ninh, as in bắc ninh
nintendo	nintendo	(proper noun) nintendo, the game company
nippon	nippon	nippon
nitơ	azote	nitrogen (n.)
nixon	nixon	(proper noun) nixon, as in former president richard nixon
niên	année	youth
niết	niet	nirvana
niềm	plaisir	trust
niệm	pleine conscience	concept
niệu	diurèse	urinary
nj	nj	nj
nlf	nlf	nlf
nm	nm	nano-meters
noah	noah	(proper noun) noah
nobel	nobel	nobel
nobita	nobita	nobita
noel	noel	(proper noun) noel
noi	dire	imitate
nokia	nokia	(proper noun) nokia, as in the nokia corporation
nol	nol	nol
nom	nom	look after
non	jeune	mountain
nonpenetrative	non pénétrante	nonpenetrative
norfolk	norfolk	norfolk
norge	norge	norge
norma	norma	(proper noun) norma, a female first name
norman	norman	norman
normandie	normandie	normandile
northrop	northrop	northrop, as in the northrop f-5 freedom fighter
norton	norton	norton
norway	norvège	norway
nou	nou	nou
novak	novak	novak
now	maintenant	now
nowc	nowc	nowc
noãn	ovule	ovule
nsnd	nsnd	people's artist
nst	nst	chromosome
nubia	nubie	nubia
number	nombre	number
nupedia	nupedia	a name
nusa	nusa	nusa
nuôi	nourrir	feed
nuối	avaler	"(term should be ""tiếc nuối"") to regret (v.)"
nuốt	avaler	to swallow (v.)
nuớc	de l&#39;eau	water
nxb	nxb	publisher
nynorsk	nynorsk	nynorsk
nà	nà	na
nài	insister	pleading
nàn	plaint	poor
nành	soja	soy
nào	allez	would
này	ça	this
ná	ná	a crossbow (n.)
nách	aisselles	underarm (n.)
náo	dérangeant	riot
nát	écrasé	ruin
náu	cacher	hide
nâng	levage	raise
nâu	brun	brown
nã	nã	to track down (v.)
não	cerveau	brain
né	éviter	dodge
ném	jeter	to throw (v.)
nén	compressé	compress
nét	coups	feature
nê	ne	ne
nên	devrait	should or ought to
nêu	déclaré	mention
nòi	course	race
nòng	baril	barrel
nói	dit	to say or speak (v.)
nón	chapeaux	cone
nóng	chaud	hot
nô	esclave	slave
nôbita	tobita	nobita
nôi	crèche	cradle
nôm	nôm	ancient vietnamese script that borrowed heavily from han chinese characters
nôn	vomissements	vomit
nông	peu profond	farmer
nõn	éplucher	peeled
nùng	nung	nung
núm	bouton	nipple
núp	couverture	hide
nút	bouton	button
năm	année	year
năn	repentant	"(term should be ""ăn năn"") remorse (n.)"
năng	puissance	"(term should be ""khả năng"") ability (n.)"
nơi	lieu	a place
nơtrino	neutino	neutrino
nước	de l&#39;eau	country
nước 	de l&#39;eau	water
nướng	cuit	grill
nǎm	nǎm	year
nạ	masque	mask
nạc	maigre	lean (adj.)
nại	se plaindre	complain
nạn	détresse	a disaster (n.)
nạo	curetage	to scrape (v.)
nạp	chargé	tribute
nản	découragé	depressed
nảy	rebondir	"(term should be ""nảy sinh"") to give rise to (v.)"
nấc	hoquet	a hiccup (n.)
nấp	cacher	hide
nấu	cuisiner	cook
nấy	ça	this
nần	pousser	debt
nầy	ça	this
nẩy	rebondir	"(term should be ""nảy nở"") to sprout or start growing (v.)"
nẫu	n soleil	"(""giọng nẫu"") a vietnamese accent commonly found in cities such as phú yên"
nậm	nam	"(term should be ""nậm rốm"") the name of a river in vietnam (proper noun)"
nập	chaud	busy
nắm	saisir	to grasp or hold (v.)
nắng	ensoleillé	sunlight
nắp	couvercle	a lid or cover (n.)
nằm	mensonges	to lie (v.)
nẵng	nang	"(term should be ""Đà nẵng"") a city in central vietnam"
nặc	anonymement	heavy
nặn	serrer	mould
nặng	lourd	heavy
nẻo	un autre	turn
nếm	dégustation	taste
nến	bougies	candle
nếp	collant	sticky rice (n.)
nếu	si	if (adv.)
nề	maçonnerie	severe
nể	respect	respect
nện	battant	ram
nỉ	feutre	beg
nịnh	plus plat	flatter
nọ	l&#39;autre	the other
nọc	venin	tadpole
nỏ	arbalète	a crossbow (n.)
nối	connecté	connection
nốt	note	to finish off (v.)
nồi	pot	pot
nồm	nuque	humid (adj.)
nồng	concentration	heavy
nổ	exploser	explode
nổi	flottant	nổi tiếng= famous
nỗ	tenter	affort
nỗi	ça	state
nộ	courroux	anger
nội	interne	on the paternal side (adj.)
nộn	farce	non
nộp	déposé	submit
nới	se détendre	ease
nở	floraison	bloom
nỡ	chaleureux	do you have a heart to
nợ	dette	debt
nụy	pistil	"(term should be ""nụy nhân"") the vietnamesized han term depicting the japanese"
nứa	liège	a kind of bamboo (n.)
nứt	fissuré	to crack
nửa	la moitié	haft
nữa	plus	moreover
oahu	oahu	(proper noun) oahu
oai	effroi	heroic
oakland	oakland	oakland
oan	l&#39;injustice	injustice
oanh	oanh	(with word liet) glorious
obama	obama	obama
oblast	oblast	(proper noun) oblast, as in tomsk oblast
oc	oc	oc
october	octobre	(proper noun) october
oda	oda	oda
oder	plus	oder
odyssey	odyssée	odyssey, as in the odyssey, homer's epic
oecd	ocde	oecd
officer	officier	officer
officers	officiers	officers
ohkawa	ohkawa	ohkawa
okhotsk	okhotsk	okhotsk
oliver	oliver	oliver
olivier	olivier	olivier
olympus	olympus	olympus
om	om	to simmer
omar	omar	a name
ong	abeille	bee
ontario	ontario	ontario
oort	oort	oort
oprah	oprah	(proper noun) oprah, as in oprah winfrey
organ	orgue	organ
oricon	oricon	oricon
origin	origine	origin
orion	orion	(proper noun) orion, the hunter
orleans	orléans	(proper noun) orleans, as in new orleans
orochimaru	orochimaru	orochimaru
orton	orton	orton
os	os	os
osaka	osaka	(proper noun) osaka, a city in japan
osama	osama	(proper noun) osama, as in osama bin laden
osamu	osamu	(proper noun) osamu, a japanese first name
oscar	oscar	oscar
osiris	osiris	(proper noun) osiris, as in the egyptian god
oskar	oskar	a name
oslo	oslo	oslo
osment	osment	osment
ospf	ospf	ospf
ossetia	ossétie	(proper noun) ossetia
oswald	oswald	oswald
other	autre	other
otto	otto	(proper noun) otto, as in otto von bismarck
ottoman	pouf	(proper noun) ottoman, as in the ottoman empire
outstanding	remarquable	xuat sac
owen	owen	(proper noun) owen, as in michael owen
oxford	oxford	oxford
oxy	oxygène	oxygen
ozawa	ozawa	(proper noun) ozawa, as in maria ozawa
oán	ressentiment	"(term should be ""oán than"") to complain or whine"
oát	watt	a watt (n.)
oản	oàn	"(term should be ""ăn oản"") gratitude and resentment (n.)"
paget	paget	(proper noun) paget
pailin	pailin	pailin
pakistan	pakistan	(proper noun) the country of pakistan
palais	palais	palais, as in grand palais
palawan	palawan	palawan
palenque	palenque	(proper noun) palenque
palestine	palestine	a name
palgrave	palgrave	palgrave
pali	pali	a name
pamir	pamir	pamir
pan	casserole	pan, as in peter pan
panama	panama	panama
panamax	panamax	(proper noun) panamax
panduranga	panduranga	(proper noun) panduranga
panthera	panthera	(proper noun) panthera, a genus of felines
panthéon	panthéon	a name
paolo	paolo	paolo
paperback	livre de poche	paperback
papua	papouasie	papua
paraguay	paraguay	(proper noun) paraguay
pari	pari	pari
park	parc	park
parton	parton	parton
patel	patel	(proper noun) patel
patrick	patrick	patrick
patriot	patriote	patriot
paul	paul	paul
paula	paula	paula
paulo	paulo	(proper noun) paulo
pavia	pavie	pavia
pbs	pbs	pbs
pda	pda	pda
pdf	pdf	pdf
pedro	pedro	pedro
peers	pairs	peers
pele	pele	(proper noun) pele, as in the soccer player
penang	penang	penang
penh	penh	(proper noun) penh, as in phnom penh
pennsylvania	pennsylvanie	pennsylvania
penny	penny	(proper noun) penny, an english first name
pereira	pereira	pereira
perl	perl	(proper noun) perl
pero	pero	pero
perry	poiré	(proper noun) perry, as in elizabeth perry
persephone	perséphone	presephone
pershing	pershing	pershing
persian	persan	persian
peru	pérou	peru, as in the south american country
peters	peters	peter's, possessive of peter
petersburg	pétersbourg	(proper noun) petersburg, as in saint petersburg
pfm	pfm	a name
pgs	pgs	associate professor
pgđ	pgđ	associate professor
pha	mixte	to mix
phaethon	phaethon	phaethon
pham	pham	pham
phanh	frein	expose
phao	flotter	float
phaolô	paul	st. paul, the apostle
pharaoh	pharaon	pharaoh
pharaon	pharaon	pharaoh
phay	fraisage	mill
phe	faction	faction
phen	phén	time
phil	phil	(proper noun) phil, a first name
philip	philip	philip
philippe	philippe	philippe
philippines	philippines	(proper noun) philippines
phillip	phillip	(proper noun) phillip
phillips	phillips	philips
philosophiae	philosophiae	(proper noun) philosophiae, as in the work philosophiae naturalis principia mathematica
phim	film	phim
phin	filtrer	coffee filter
phineas	phineas	(proper noun) phineas
phiên	session	trial
phiêu	aventure	adventurous
phiếm	potins	gossip
phiến	lame	"(should be ""nha phiến"") opium"
phiện	l&#39;opium	opium
phiệt	phiet	militarism
phnom	phnom	phnom
phnôm	phomom	phnôm pênh= phnom penh(cambodia's capital)
pho	pho	part of a person's name, rat-pho, or ratford
phoenix	phénix	(proper noun) phoenix
phong	chambre	movement
php	php	php
phrygian	phrygien	phrygian
phu	phu	"(term should be ""phu nhân"") wife (n.)"
phui	découvert	expose
phun	vaporiser	to spray or spit (v.)
phà	ferry	ferry
phàm	mortel	superhuman
phàn	se plaindre	complain
phá	briser	destroy
phác	croquis	"(term should be ""phác thảo"") outline or sketch (n.)"
phách	battre	manner (n.)
phái	secte	a party
phán	juge	judge
pháo	canon	artillery
pháp	la france	method
phát	diffuser	develop
phèn	alun	alum
phèo	phèo	organs
phép	autorisé	permit
phê	café	"(term should be ""phê bình"") to criticize (v.)"
phêrô	peter	peter
phì	hypertrophie	non-
phình	renflement	bulge
phí	charger	non-
phía	côté	side
phích	thermos	a flask (n.)
phím	clé	key
phò	phò	"(term should be ""phò mã"") a prince consort"
phòng	chambre	office
phó	député	second
phóng	reporter	to launch (v.)
phô	ville	display
phôi	lingot	embryo
phông	police	font
phùng	bouffée	phung
phúc	béni	good fortune (n.)
phúclộc	béni	phuc-loc
phún	clochard	"(term should be ""lún phún"") sparse (adj.)"
phúng	dommage	satire
phút	minute	a minute (n.)
phăn	frette	phan
phăng	phang	knock
phương	phuong	direction
phước	bénédiction	luck
phường	pupille	ward
phượng	phénix	phoenix
phạn	sanskrit	sanskrit
phạt	pénalité	punish
phả	pedigree	pedigree
phải	oui	must
phải 	oui	right
phản	compteur	reaction
phảng	plat	subtle
phần	section	part
phẩm	les produits	food
phẩy	virgule	a comma
phẫn	indigné	wrathful
phẫu	la chirurgie	surgery
phận	le destin	part
phật	bouddha	buddhist
phẳng	plat	flat (adj.)
phế	débris	dismiss
phết	se propager	to spread or smear (v.)
phỉ	noisette	defame
phỏng	brûler	interview
phố	rue	city
phối	coordonner	coordinate
phốt	phosphates	"(term should be ""phốt-phát"") phosphate (n.)"
phồng	gonflé	to swell (v.)
phổ	spectre	popular
phổi	poumons	lung
phộng	arachides	peanut
phới	flotter	"(term should be ""phơi phới"") mildly exciting (adj.)"
phở	pho	pho
phục	vêtements	convincing
phụng	servir	worship
phụt	bouffée	minute
phủ	couvert	government
phức	complexe	complex
picchu	picchu	a name
piccolo	piccolo	piccolo
pierre	pierre	pierre
pierrot	pierrot	pierrot
pietro	pietro	pietro
pike	brochet	pike
pin	épingle	battery
pinlus	pinlus	pinlus
pioneer	pionnier	pioneer
pipes	tuyaux	pipes
pisa	pise	a name
piston	piston	piston
pitch	pas	pitch
pius	pie	pius
plaaf	plaaf	plaaf
plan	planifier	plan
plasma	plasma	plasma
plate	assiette	plate
plato	platon	plato
platon	platon	platon
player	joueur	player
pleiku	pleiku	(proper noun) pleiku
pleistocen	pleistocen	pleistocen
plus	plus	plus
pluto	pluton	pluto
pm	après-midi	pm
pmu	pmu	pmu
po	po	po
pokémon	pokémon	pokemon
pol	pol	pol
poland	pologne	poland
pollack	lieu jaune	a name
pollux	pollux	a name
polo	polo	(proper noun) polo, as in marco polo
polynésie	polynésie	polynesian
pont	pont	(proper noun) pont, as in pont de normandie
pop	pop	pop
portland	portland	portland
porto	porto	porto
pot	pot	pot
potsdam	potsdam	(proper noun) potsdam
potter	potier	(proper noun) potter, as in harry potter
pour	verser	not vietnamese
powell	powell	(proper noun) powell, as in general colin powell
pradesh	pradesh	pradesh
praha	praha	praha
pratzen	pratzen	pratzen
preah	preah	(proper noun) preah
premier	premier	premier
preminger	preminger	(proper noun) preminger
preston	preston	(proper noun) preston, as in john preston
prince	prince	prince
princeton	princeton	princeton
printemps	printemps	printemps
printf	printf	printf
prinz	prinz	(proper noun) prinz, as in birgit prinz, the female german soccer player
prix	prix	(proper noun) prix, as in the grand prix
procellarum	procellarum	procellarum, as in oceanus procellarum, the name of a mare on the moon
projekt	projekt	projekt
prometheus	prométhée	(proper noun) prometheus
protein	protéine	protein
prôtêin	protéine	protein (n.)
ps	ps	ps
psv	psv	psv
ptolemy	ptolémée	ptolemy
ptq	ptq	ptq
puerto	puerto	puerto
pulau	pulau	(proper noun) pulau, as in pulau tekong, an island
pulitzer	pulitzer	(proper noun) pulitzer, as in the pulitzer prize
pulp	pulpe	pulp
punjab	punjab	punjab
pusan	pusan	(proper noun) pusan
putin	putin	putin
pyrenees	pyrénées	pyrenees
pytago	pytago	(proper noun) pytago
pzl	pzl	pzl
péc	péc	"(term should be ""vịnh péc xích"") the persian gulf"
pérez	pérez	(proper noun) perez, as in javier perez de cuellar
păng	pang	fansipan
pơ	pơ	"(term should be ""pơ kô"") a river in vietnam (n.)"
q	q	q ( a letter)
qatar	qatar	qatar
qd	qd	quantum dots
qing	qing	qing, as in the qing dynasty of  china
qlvnch	qlvnch	army of the republic of vietnam
qua	sur	transmit
quad	quad	quad
quan	quan	"(term should be ""quan hệ"") relationship (n.)"
quang	optique	bladder
quanh	aux alentours	around
quay	tourné	turn
que	tiges	stick
queen	reine	queen
queens	reines	(proper noun) queens, as in the new york borough
queensland	queensland	queensland
quen	habitué	accustomed to
qui	qui	formal
quincy	quincy	(proper noun) quincy, as in quincy jones
quran	coran	quran
quy	règles	"(term should be ""quy ước"") agreement"
quyên	fondamentaux	"(term should be ""quyên góp"") to donate (v.)"
quyến	charme	"(term should be ""gia quyến"") family"
quyền	à droite	right
quyện	se mêler	mix
quyệt	insidieux	"(should be ""xảo quyệt"") devious"
quá	aussi	over
quái	diable	strange or odd
quán	bar	hometown
quáng	aveugle	blind
quát	cria	generalize
quân	quan	army (n.)
quãng	environ	optical
quét	scanner	to sweep (v.)
quê	campagne	countryside
quên	oublié	forget
quý	trimestre	love
quýt	mandarine	tangerine
quăng	lancer	to throw (v.)
quĩ	fonds	orbit
quạ	corbeaux	crow (con qua)
quạt	fan	fan
quản	régissant	"(entire term is ""cai quản"") to manage"
quảng	promo	guangzhou
quấn	envelopper	wrap around
quất	kumquat	whip
quấy	remuer	harass
quần	pantalon	pants (n.)
quầng	halo	halo
quầy	compteurs	stall
quẩy	bascule	quay
quẫn	misérable	necessitous
quận	comté	county (n.)
quật	fouille	excavation
quẳng	lancer	throw
quặc	bizarre	strange (adj.)
quặng	minerai	an ore (n.)
quẻ	hexagramme	hexagram
quế	cannelle	cinnamon (n.)
quết	écume	knead
quệ	pauvre	exhausted
quỉ	le diable	demon
quỳ	s&#39;agenouiller	demon (n.)
quỳnh	quỳnh	quynh
quỵ	avc	stroke
quỷ	le diable	provided
quỹ	fonds	fund
qúy	trimestre	quy
r	r	r
rabindranath	rabindranath	rabindranath
race	course	race
rafael	rafael	rafael
rafale	rafale	(proper noun) rafale, as in dassault rafale
rai	rai	slowly intake
raleigh	raleigh	raleigh
ralph	ralph	(proper noun) ralph, as in ralph waldo emerson
ram	bélier	a name
rama	rama	rama, first name of several rulers of thailand (n.)
ramadan	ramadan	(proper noun) the fasting month of ramadan
ramayana	ramayana	ramayana
rambus	rambus	rambus
ran	couru	ran
ranch	ranch	ranch
randy	randy	randy
rang	a sonné	roast
rangers	rangers	rangers
ranh	limite	border (ranh gioi)
rao	annonce	to announce
rap	rap	rap
raptor	rapace	raptor
rate	taux	rate
rau	légumes	vegetable
ray	rayon	rail (n.)
raya	raya	raya
raymond	raymond	raymond
rađa	radar	radar
reagan	reagan	reagan
real	réel	real
reanimation	réanimation	reanimation
reap	récolter	reap
reef	récif	reef
regia	regia	regia
reichelt	reichelt	reichelt
ren	dentelle	lace (n.)
renaissance	renaissance	renaissance
renault	renault	renault
rené	rené	rene
reo	a sonné	yell
reserve	réserver	reserve
resort	station	resort
reverse	inverser	reverse
revolution	révolution	revolution
rey	rey	rey, as in copa del rey
rfid	rfid	rfid
rhodes	rhodes	rhodes
rica	rica	rica
ricardo	ricardo	ricardo
ricci	ricci	ricci
richard	richard	richard
richardson	richardson	(proper noun) richardson, as in james o. richardson
richie	richie	(proper noun) richie, as in singer lionel richie
rico	rico	rico, as in puerto rico
riemann	riemann	riemann, as in bernhard riemann, a german mathematician
rimjob	rimjob	rimjob
rin	rin	rin
rising	montant	rising
risk	risque	risk
ritchie	ritchie	a name
rivaldo	rivaldo	rivaldo
rivière	rivière	a name
rizal	rizal	rizal
riêng	propre	own
riêu	riêu	crab
riết	riet	urgently
riềng	galanga	arrowroot
ro	ro	"entire term is ""rui ro""; means ""risk"""
robert	robert	(proper noun) robert
roberto	roberto	(proper noun) roberto
roberts	roberts	roberts
robespierre	robespierre	robespierre
robin	robin	a name
robinson	robinson	robinson, as in michelle robinson
rockefeller	rockefeller	rockefeller, as in john d. rockefeller
roddick	roddick	(proper noun) roddick
rodríguez	rodríguez	rodriguez (n.)
roi	fouet	a stick or switch used for punishment (n.)
roland	roland	roland
romania	roumanie	romania
rome	rome	rome, as in rome, italy
romeo	romeo	(proper noun) romeo, as in romeo and juliet
rommel	rommel	rommel
ron	ron	ron
ronald	ronald	ronald, an english first name
ronaldinho	ronaldinho	ronaldinho
rong	algues	seaweed (n.)
rosen	rosé	rosen, as in nathan rosen
roth	roth	roth
rotterdam	rotterdam	(proper noun) rotterdam
rousseau	rousseau	rousseau
router	routeur	cong noi
rovers	rovers	rovers
rowling	râle	rowling
roy	roy	(proper noun) roy, a name
rpd	rpd	rpd
rtp	rtp	rpt
rudolph	rudolph	rudolph
rue	rue	rue, as in rue des vases, a street name
rulin	rulin	(proper noun) rulin
rumani	roumain	romanian
rumiko	rumiko	rumiko, a japanese first name
rummel	rummel	rummel
run	courir	tremble
rung	secouer	to shake or vibrate (v.)
russian	russe	(proper adjective) russian
russkaya	russkaya	(proper noun) russkaya avionika
ruth	ruth	(proper noun) ruth
rutherford	rutherford	rutherford
rutte	rutte	rutte
ruud	ruud	ruud
ruốc	crevettes	pemmican
ruồi	vole	fly
ruổi	ruoi	rong ruổi=wandering
ruộng	champ	"(term should be ""ruộng đất"") farmland (n.)"
ruột	intestin	internals
rzeczpospolita	rzeczpospolita	rzeczpospolia
rà	vérifier	finding
ràng	clair	clear
rành	courant	exhaustive
rào	clôture	barrier
rác	ordures	gabbage-trash
rách	déchiré	tear
rái	loutre	colander
rán	faire frire	fried (adj.)
ráp	assemblage	to assemble (v.)
râm	ombragé	shade
râu	barbe	beard or mustache (n.)
rã	décomposition	out
rãi	largement	"(term should be ""rộng rãi"") generous"
rãnh	groove	groove
räikkönen	räikkönen	raikkonen
rèm	rideau	curtain
rèn	forger	train
ré	crissement	re
république	république	republique
rét	froid	cold
rê	faire glisser	"(term should be ""rê bóng"") to dribble the ball in soccer (v.)"
rên	gémissant	moan
rêu	mousse	moss
rì	chuchoter	lush (adj.)
rìa	bord	edge
rình	espionner	to watch for
rìu	hache	ax
rít	sifflement	to wail (v.)
rò	fuite	leak
ròng	net	net
rót	verser	to pour (v.)
rô	damier	diamond
rôbôt	robot	robot
rôma	rome	roman
rông	creux	rising (adj.)
rõ	clair	clear
rùa	tortue	turtle
rùng	effrayant	horror
rút	retirer	withdraw
răn	commandement	commandment
răng	les dents	roasted
rōmaji	rōmaji	romaji
rũ	séduisant	charm
rơ	voiture	"(term should be ""rơ măm"") a minority people living in vietnam"
rơi	tomber	fall
rơm	paille	straw
rươi	toi	sand-worm
rước	procession	welcome
rưới	saupoudrer	to sprinkle (v.)
rưỡi	la moitié	half
rượt	chasser	pursue
rượu	alcool	wine
rạ	chaume	straw
rạc	discret	discrete
rạch	incision	canal
rạng	aube	break
rạp	théâtres	theater
rải	dispersé	spread
rảnh	gratuit	to be free (adj.)
rất	très	very
rầm	montant	aggressive
rầu	triste	sorrow
rẫy	montagne	full
rậm	touffue	jungle
rập	arabe	"(term should be ""Ả rập"") arab"
rắc	saupoudrer	trouble
rắn	serpents	snake
rằm	pleine lune	a full moon (n.)
rằng	ça	roasted
rặng	le rocher	a row
rẻ	pas cher	cheap
rẽ	tourner	"(term should be ""chia rẽ"") to separate or divide (v.)"
rền	gémir	pealed
rể	gendre	in-law
rễ	racines	root (n.)
rệp	pucerons	bug
rệt	prononcé	clearly
rệu	oui	decay
rỉ	rouille	leak
rịavũng	rìvà	ria - bay
rỏ	clair	clearly
rối	emmêlé	disorder
rốm	nuageux	rom
rồ	fou	"(term should be ""điên rồ"") foolish (adj.)"
rồi	déjà	and
rồng	dragon	dragon
rổ	panier	basket
rỗi	gratuit	savation
rỗng	vide	hollow
rộ	agitation	profuse (adj.)
rộn	occupé	busy
rộng	large	wide
rớt	échouer	drop
rời	à gauche	leave
rỡ	brillant	brilliant
rợ	barbares	a savage (n.)
rợn	effrayant	scary
rụng	tomber	to drop
rủ	retombant	ask
rủi	mésaventure	unlucky or unfortunate (n.)
rứa	rứa	rua
rừng	forêt	forest
rửa	laver	to wash (v.)
rữa	laver	to decompose or rot (v.)
sa	sa	to fall or drop (v.)
sabah	sabah	sabah
sachsen	sachsen	sachsen
saddam	saddam	(proper noun) saddam, as in saddam hussein
safari	safari	safari
safin	safin	safin
sahara	sahara	sahara
sai	mal	wrong
saigon	saigon	saigon
saintdenis	saintdenis	saint-denis
sakura	sakura	sakura
salem	salem	(proper noun) salem, as in the city
salvador	salvador	salvador
salzburg	salzbourg	salzburg
samhain	samhain	samhain
samo	samo	samo, the name of the first slavic ruler
samoa	samoa	(proper noun) samoa
samphan	samphan	samphan
samsung	samsung	samsung
samuel	samuel	samuel
samuelson	samuelson	(proper noun) samuelson
samurai	samouraï	samurai
samut	samut	(proper noun) samut, as in samut prakan in thailand
san	san	level
sanchez	sanchez	sanchez
sang	à	to
sango	sango	sango, a language spoken in africa
sangraal	sangraal	sangraal
sanh	naissance	bear
sanktpeterburg	sanktpeterburg	sankt-peterburg
santos	santos	santos, as in footballer cristiano ronaldo dos santos aveiro of portugal
sao	les étoiles	how
sap	sève	sap
sapa	sapa	sapa
sapiens	sapiens	sapiens
sar	sar	sar
sarah	sarah	sarah, as in sarah pierce
sarawak	sarawak	(proper noun) sarawak, a malaysian state on the island of borneo
sarcoma	sarcome	sarcoma
sardinia	sardaigne	sardinia
sary	sary	(proper noun) sary, as in ieng sary
saturanga	saturanga	saturanga
saturday	samedi	saturday
sau	plus tard	after (adv.)
saudi	saoudien	(proper noun) saudi, as in saudi arabia
saunière	saunière	saunière
scandinavia	scandinavie	scandinavia
schafer	schafer	schafer, as in john c. schafer
schengen	schengen	schengen
schiller	schiller	schiller
schlesinger	schlesinger	schlesinger
schneider	schneider	schneider, a last name
schumacher	schumacher	schumacher, as in michael schumacher
schuschnigg	schuschnigg	(proper noun) schuschnigg, as in kurt schuschnigg of austria
schuster	schuster	schuster
schwarzschild	schwarzschild	schwarzschild
scotland	ecosse	scotland
scots	écossais	(proper noun) scots
scott	scott	scott
scream	crier	scream
scud	scud	scud
scuderia	scuderia	scuderia
sdram	sdram	sdram
search	recherche	search
seattle	seattle	(proper noun) seattle, washington
secret	secret	bi mat
sedna	sedna	(proper noun) sedna
see	voir	see
sejm	sejm	(proper noun) sejm
selena	selena	selena
semit	semit	(proper noun) semit
sen	lotus	lotus
sense	sens	sense
september	septembre	(proper noun) the month of september
serbia	la serbie	serbia
sergeyevich	sergeyevich	(proper noun) sergeyevich
seri	série	series
service	service	service
sesshomaru	sesshomaru	a name
seth	seth	seth
seto	seto	seto
sextus	sextus	sextus
sexy	sexy	sexy
seymour	seymour	seymour
seyssinquart	seyssinquart	(proper noun) seyss-inquart
shah	shah	shah
shaman	chaman	the shaman religion
shan	shan	shan
shane	shane	(proper noun) shane, an english first name
shankly	shankly	(proper noun) shankly, as in bill shankly
shaolin	shaolin	shaolin, as in the shaolin temples
sharpay	sharpay	sharpay, as in sharpay evans
shawn	shawn	shawn
sherlock	sherlock	a name
shi	shi	shi
shia	chiite	shia
shiite	chiite	shiite
shikoku	shikoku	shikoku, a japanese island (n.)
shinichi	shinichi	shinichi
shinoda	shinoda	shinoda, as in mike shinoda
shirakami	shirakami	(proper noun) shirakami
shirakawago	shirakawago	(proper noun) shirakawa-go
shiva	shiva	shiva
shoal	haut-fond	(proper noun) shoal
shonen	shonen	shonen
shop	boutique	shop
short	court	short
showcase	vitrine	a name
shōnen	shōnen	shonen
siberi	sibérie	siberi
sicilia	sicilia	sicilia
sicily	sicile	sicily, a city in italy
sidney	sidney	(proper noun) sidney, as in sidney nolan
siem	siem	siem
siemens	siemens	siemens
sierra	sierra	(proper noun) sierra
sikh	sikh	sikh
sikorsky	sikorsky	a name
silas	silas	silas
silesia	silésie	silesia
silic	silicium	silicon
silicat	silicate	silicate
silva	silva	(proper noun) silva, as in carlos silva
silvestris	silvestris	silvestris
simone	simone	simone
sinai	sinaï	sinai, as in mount sinai
sinensis	sinensis	sinensis
sing	chanter	sing
sinh	né	genital
sip	siroter	sip
sirô	sirop	name of a member
sistema	sistema	(proper noun) sistema
siu	siu	siu
siêu	super	super
siết	resserrer	to cut off (v.)
sky	ciel	sky
skype	skype	skype
skyteam	skyteam	skyteam
sl	sl	sl
slav	slave	(proper noun) slav
slavơ	slave	slavic
slytherin	serpentard	(proper noun) slytherin, as in salazar slytherin of the harry potter series
sm	sm	sm
smg	smg	smg
smith	forgeron	smith
smithsonian	smithsonian	smithsonian
so	donc	compare
société	société	societe
socrates	socrate	socrates
sohee	sohee	a korean name
soho	soho	soho
soi	soi	look/stare soi sáng=enlight
solaris	solaris	(proper noun) solaris
som	som	(proper noun) som, as in kampong som
somme	somme	somme
sonata	sonate	sonata
song	chanson	however (adv.)
sony	sony	sony
soo	soo	soon
sophie	sophie	(proper noun) sophie, a first name
sopwith	sopwith	a name
sorbonne	sorbonne	sorbonne, the university in paris (n.)
sos	sos	sos
soul	âme	soul
soát	contrôle	control
soạn	composer	compose
spears	des lances	spears
spellman	sortilège	spellman
spence	spence	(proper noun) spence
spencer	spencer	(proper noun) spencer
spielberg	spielberg	(proper noun) spielberg, as in steven spielberg
sports	sports	sports
sri	sri	(proper noun) sri, as in sri lanka
ss	ss	ss
st	st	st.
stalingrad	stalingrad	stalingrad
stamford	stamford	this is a name
stand	se tenir	stand
stanford	stanford	stanford, as in stanford university
stanley	stanley	stanley
starr	starr	a name
startin	commencer	bat dau
status	statut	status
stdc	stdc	stdc
stefan	stefan	stefan
steiermark	steiermark	steiermark
steiner	steiner	steiner
stelzer	stelzer	stelzer
stennis	stennis	stennis
stephen	stephen	stephen
stephenie	stephenie	"stephenie, as in stephenie meyer, author of ""twilight"""
sterling	sterling	a name
steve	steve	steve
stevens	steven	(proper noun) stevens, as in amanda stevens
stevenson	stevenson	stevenson
stevie	stevie	stevie
stewarthannah	stewarthannah	stewart/hannah
stf	stf	stf
stimson	stimson	stimson, as in henry lewis stimson, former secretary of war
stockholm	stockholm	a name
stones	pierres	stones
storting	storting	storting
strasberg	strasberg	strasberg
strauss	strauss	strauss
street	rue	street
struct	struct	struct
stt	stt	order number
stuart	stuart	stuart
stuttgart	stuttgart	(proper noun) stuttgart, a city in germany
styx	styx	(proper noun) styx, as in the river styx
stéfano	stéfano	stefano
su	su	condom
subakhi	subakhi	subakhi
suez	suez	(proper noun) suez
suharto	suharto	suharto
sukarno	sukarno	(proper noun) sukarno,  president of indonesia
sulfua	sulfure	sulfide
sulu	sulu	sulu
sum	somme	reunite
sumatera	sumatera	sumatera
sumatra	sumatra	(proper noun) the island of sumatra
sumitomo	sumitomo	sumitomo
summer	été	summer
summerslam	summerslam	(proper noun) summerslam
sun	soleil	sun
sunday	dimanche	(proper noun) sunday
sung	figues	supplement
sunni	sunnite	sunni
sunsilk	sunsilk	sunsilk, a hair products company
super	super	super
suriname	suriname	suriname
susan	susan	(proper noun) susan
susilo	susilo	(proper noun) susilo
sutra	sutra	sutra
suub	suub	a name
suvp	suvp	suv-p
suy	altéré	decrease
suê	donc	lush
suôn	en douceur	smooth
suất	la productivité	number
suối	stream	stream
suốt	partout	through/all over
suồng	lisse	overfamiliar
svd	svd	svd
swan	cygne	swan
swaziland	swaziland	swaziland
sweet	doux	sweet
sy	sy	sy
sydney	sydney	(proper noun) sydney, a city in australia
symantec	symantec	symantec
sync	synchroniser	sync
syria	la syrie	syria
sài	sai	"(term should be ""sơ sài"") something done without care (adv.)"
sàn	étage	san
sàng	tamis	ready
sành	vaisselle	"(term should be ""sành sứ"") pottery"
sào	poteau	"(term should be ""sào huyệt"") den or hideout (n.)"
sá	sá	road
sách	livres	list
sái	mauvais	sai
sám	repentant	penitent
sáng	suis	light
sánh	comparatif	compare
sáo	flûte	flute
sáp	cire	merger
sát	fermer	"(term should be ""quan sát"") to watch or observe (v.)"
sáu	six	six
sâm	ginseng	sam
sân	cour	"(should be ""sân khấu"") a stage"
sâu	profond	deep
sã	sã	flippant
sãi	mal	pagoda warden
são	são	sao, as in sao paolo, brazil
sét	foudre	clay
sê	se	sepon
sêri	série	series
sêu	mousse	seu tet
sính	étudiant	betrothal gifts
síp	chypre	cyprus
sít	serré	close
sò	huîtres	oyster
sòng	casino	casino
sóc	écureuil	"(should be ""sóc trăng"") a vietnamese town"
sói	loup	wolf
sóng	vague	wave
sót	omission	to miss (v.)
sô	nombre	than
sôi	bouillante	vibrant
sông	rivière	river
sùng	dévotion	cult
sú	tigre noir	a type of mangrove (n.)
súc	bétail	animal
sún	évier	sun
súng	pistolets	gun
súp	soupe	source
sút	tir	reduce
săn	chasser	to hunt
sơn	peint	a mountain
sư	professeur	lion
sưa	lait	filled with
sưng	enflure	swell
sưu	objets de collection	collection
sương	rosée	dew (n.)
sướng	heureux	high
sườn	côtelettes	slope
sưởi	chauffage	heat
sạch	propre	clean
sạn	hôtel	hotel
sảm	brillant	sam
sản	la production	reproductive
sảng	frais	sonorous
sảnh	salle	a hall, as in the rock and roll hall of fame
sấm	tonnerre	ginseng
sấu	crocodile	crocodile
sấy	séchage	dry
sầm	claque	crowded
sầu	mélancolie	sad
sẩn	papules	coarseness
sẫm	sombre	dark
sập	s&#39;effondrer	destroy
sắm	achats	shopping
sắn	manioc	cassava (n.)
sắp	sur le point de	soon
sắt	fer	"(term should be ""sắt son"") constant (adj.)"
sẵn	disponible	available
sẹo	cicatrice	scar
sẻ	sera	share
sẽ	sera	will
sọ	crâne	brain
sọc	rayures	stripe
sỏ	impertinent	oligarchy
sỏi	gravier	gravel
số	nombre	"(term should be ""số lượng"") quantity (n.)"
sốc	choqué	shock
sống	vivre	live
sốt	fièvre	fever
sồi	chêne	oak
sổ	réserver	window
sớ	sera	document
sớm	tôt	som
sờ	touchant	touch
sỡ	manqué	colorful
sợ	avoir peur	afraid
sợi	fil	fibers
sục	jacuzzi	"(term should be ""sôi sục"") to boil"
sụn	cartilage	cartilage
sụp	s&#39;effondrer	collapse
sụt	effondrement	drop
sủa	aboyer	bright
sủi	effervescent	sparkling
sủng	charismatique	favored
sứ	porcelaine	embassy
sứa	méduse	jellyfish (n.)
sức	force	strength
sứt	ébréché	cleft
sừng	corne	sừng sững= huge
sử	histoire	"(term should be ""sử dụng"") to use (v.)"
sửa	réparer	repair
sửng	choqué	startling
sửu	ox	cow
sữa	lait	milk
sự	le	situation
ta	ta	us or our
tae	tae	(proper noun) tae
tag	balise	tag
tai	l&#39;oreille	ear
taiji	taiji	(proper noun) taiji
taipei	taipei	taipei
taiwan	taiwan	taiwan
taj	taj	taj, as in taj mahal
tajikistan	le tadjikistan	tajikistan
tajima	tajima	tajima
tajiri	tajiri	tajiri
takahashi	takahashi	(proper noun) takahashi
taklamakan	taklamakan	taklamakan
tali	tali	thallium
taliban	talibans	taliban
talmud	talmud	talmud
tam	tam	three (n.)
tamoxifen	tamoxifène	tamoxifen
tanaka	tanaka	tanaka
tang	le deuil	funeral
tanh	poisson	deserted
tankōbon	tankōbon	tankobon, as in a type of japanese literature
tanzania	tanzanie	tanzania
tao	moi	(proper noun) tao, a chinese name
tarim	tarim	tarim
task	tâche	task
tasman	tasman	tasman, as in abel tasman
tasmania	tasmanie	tasmania, a place
tau	tau	tau
taxi	taxi	taxi
tay	les mains	hand
taylor	taylor	taylor
tbt	tbt	tbt
tchad	tchad	tchad
tcm	tcm	tcm
tcp	tcp	tcp
technical	technique	technical
ted	ted	(proper noun) ted
teddy	nounours	teddy, as in teddy lupin, a character in the harry potter series
telecom	télécom	telecom
telekom	telekom	telekom
telex	télex	telex
telnet	telnet	telnet
tem	tampon	stamp
temple	temple	temple
temujin	temujin	temujin
temur	temur	(proper noun) temur, as in temur oljeitu
tenxơ	cartel	tensor
teo	atrophie	atrophy
terengganu	terengganu	(proper noun) terengganu
territories	territoires	territories
terry	éponge	terry
terumbu	terumbu	(proper noun) terumbu
tet	tet	tet
texas	texas	(proper noun) the state of texas
tgv	tgv	tgv
tha	tha	to forgive (v.)
thai	enceinte	pregnant
thailand	thaïlande	thailand
tham	avidité	involved
thames	tamise	thames
than	charbon	coal
thang	échelle	ladder
thanh	bar	youth
thani	thani	thani
thao	sports	sport
thau	laiton	a basin (n.)
thay	à la place	change
thcn	thcn	vocational school
thcs	thcs	secondary
thdq	thdq	thdq
thebes	thèbes	thebes
their	leur	their
them	eux	plus
then	alors	key
theo	suivre	according to
theory	la théorie	thẻoy
theravada	theravada	theravada
theres	theres	there
theseus	thésée	theseus, the greek hero
thi	examen	competition (n.)
thich	comme	explanation
thien	thien	sky
third	troisième	thỉd
thiu	rassis	buồn thiu= sad/boring
thiêm	thiêm	thiem
thiêng	sacré	"(term should be ""thiêng liêng"") sacred or holy"
thiếc	étain	tin
thiến	castration	castrate
thiếp	carte de visite	concubine
thiết	ensemble	"(term should be ""cần thiết"") necessary (adj.)"
thiếu	manquant	lack
thiềm	faucille	crescent
thiền	méditation	buddhist (adj.)
thiển	montrer	superficial
thiểu	mineur	minimum
thiện	bon	good
thiệp	carte de voeux	intervene
thiệt	vraiment	damage
thiệu	introduction	"(term should be ""giới thiệu"") to introduce (v.)"
tho	tho	tho
thoa	tamponner	combination
thoai	thoai	gentle
thomas	thomas	thomas
thompson	thompson	thompson
thong	string	(proper noun) thong, as in ang thong
those	ces	those
thoái	régressif	deterioration
thoán	deviner	usurpation
thoáng	aéré	"(term should be ""thoáng qua"") to pass quickly"
thoát	sortir	drainage
thoại	voix	telephone
thoạt	à première vue	just (adv.)
thoả	traiter	compromise
thoải	confortable	"(term should be ""thoải mái"") comfortable or relaxing (adj.)"
thoảng	occasionnellement	"(term should be ""thỉnh thoảng"") occasionally (adv.)"
thoắt	invite	suddenly
thpt	thpt	high school
thriller	suspense	thriller
thskts	thskts	phd- architect
thua	perdre	defeat
thumb|các	le pouce |	thumb|many
thunderbolt	coup de foudre	thunderbolt
thung	vallée	valley
thuyên	déplacement	a name
thuyết	la théorie	theory
thuyền	bateau	boat
thuê	embaucher	employ
thuần	pur	"(term should be ""đơn thuần"") pure (adj.)"
thuẫn	conflit	support
thuận	pros	favourable
thuật	l&#39;art	term
thuế	taxe	tax
thuốc	médecine	medicine (n.)
thuộc	appartenir	belong
thuớc	de l&#39;eau	"(term should be ""kích thước"") dimensions of an object"
thuờng	habituellement	usually
thuở	enfance	period
thuỵ	thuy	"(term should be ""thụy Điển"") the nation of sweden (proper noun)"
thuỷ	thuy	water
thvn	thvn	vietnam television
thy	ton	thy
thà	préférerait	honest
thành	à	"(term should be ""hình thành"") to take shape"
thày	enseignant	teacher
thác	cascade	harvest
thách	défi	challenge
thái	thai	attitude
thám	détective	to spy (v.)
tháng	mois	month (n.)
thánh	saint	a holy person; a saint (n.)
tháo	délier	"(term should be ""tháo chạy"") to run with abandon"
tháp	tour	tower
thâm	intensif	penetrate
thâu	enregistré	to collect (v.)
thây	voir	body
thãi	merde	superabundant
thèm	envie	desire
thép	acier	steel
thét	a crié	shout
thê	le	category
thêm	ajouter	more
thêu	broderie	to embroider (v.)
thìa	cuillère	spoon
thìn	alors	(proper noun) thìn, the year of the dragon
thình	soudain	"(term should be ""thình lình"") suddenly"
thí	expériences	(with word du) for example
thít	thit	(proper noun) mân thít, a district in vietnam
thò	fourré	tho
thòi	désavantage	"(term should be ""thiệt thòi"") to cost (adv.)"
thóc	paddy	grain (n.)
thói	habitude	a habit (n.)
thô	rugueux	rough, old-fashioned
thôi	allez	only
thông	informé	"(term should be ""thông thường"") usual (adj.)"
thù	querelle	"entire term should be ""ke thu""; means ""enemy"""
thùng	baril	barrel
thùy	lobe	thuy
thú	intéressant	"(should be ""thích thú"") pleasurable"
thúc	fin	push
thúy	thuy	thuy
thăm	visite	visit
thăng	promu	helicopter
thơm	parfumé	aromatic
thư	lettre	"(term should be ""ung thư"") cancer (n.)"
thưa	cher	sparse
thương	l&#39;amour	love
thước	règle	ruler
thường	souvent	usually (adv.)
thưởng	récompense	to reward (v.)
thược	thud	(proper noun) thược
thượng	supérieur	upper
thạc	maîtres	master
thạch	gelée	rock or stone (n.)
thạnh	merci	thanh
thạo	expert	fluent
thả	laisser tomber	"(term should be ""thả lỏng"") to let loose (v.)"
thải	déchets	waste
thảm	moquette	carpet or rug (n.)
thản	serein	calmly
thảo	thao	"(term should be ""hội thảo"") a workshop (n.)"
thấp	faible	low (adj.)
thấu	pénétrant	penetrate
thầm	silencieusement	"(term should be ""thì thầm"") to whisper (v.)"
thần	dieu	"entire term should be ""tinh than""; means ""of the mind"""
thầy	enseignant	teacher (n.)
thẩm	jurés	osmotic/leak
thẫm	sombre	dark
thận	reins	careful
thập	traverser	tens
thật	vrai	true (adj.)
thắm	pétale	tham
thắn	franchement	frank
thắng	gagné	win
thắngthua	wonthua	win-lose
thắp	lumière	light
thắt	attacher	tense
thằn	lézard	"entire term should be ""than lan""; means ""lizard"""
thằng	guy	a derogatory term for a man (n.)
thẳm	profond	"(term should be ""thăm thẳm"") extremely deep (adj.)"
thẳng	droit	horizontal
thặng	surplus	surplus
thẹn	honte	shameful
thẻ	carte	card
thế	alors	"with word ""tu,"" means ""posture"" or ""a position"""
thếp	acier	steel
thề	jure	swear
thềm	étagère	shelf
thể	être	maybe
thỉnh	parfois	"(term should be ""thỉnh thoảng"") occasionally"
thịnh	vogue	prosperous
thịt	viande	meat (n.)
thọ	longévité	phu tho
thọc	jab	jab
thỏ	lapin	rabbit
thỏa	accord	"(term should be ""thoả thuận"") to come to an agreement (v.)"
thỏi	lingot	a bar (n.)
thối	pourri	smelly
thốt	prononcé	scream
thồ	emballer	to transport via horse (v.)
thổ	la terre	"(term should be ""lãnh thổ"") territory (n.)"
thổi	souffler	blow
thớt	planche à découper	sparse
thời	le temps	period
thở	respirer	breathe
thợ	ouvrier	craftman
thụ	récepteur	"(term should be ""thụ thai"") to become pregnant"
thục	shu	(proper noun) a vietnamese first name
thụt	échancré	clyster
thủ	premier	masturbate
thủa	thua	during childhood
thủng	perforation	having holes
thứ	les choses	no.
thức	éveillé	way
thừa	redondant	redundant
thừng	corde	"(term should be ""thẳng thừng"") mercilessly"
thử	essayer	try
thửa	colis	square
thự	villa	mansion
thực	réel	perform
ti	ti	titov
tia	rayons	ray
tiananmen	tiananmen	tiananmen
tiara	diadème	tiara
tibet	tibet	(proper noun) tibet
tigris	tigre	tigris
tiliaceus	tiliaceus	hoa dam but
tim	coeur	heart
timor	timor	timor
timothy	fléole	timothy
tin	croire	believe
tinbắc	message	file bac
tincầu	pont d&#39;étain	file bridge
tinh	planète	"(term should be ""tinh dịch"") sperm (n.)"
tinnhà	tinhome	folder: house
tinsông	actualités	file river
tinthị	tinthị	file: town
tirol	tirol	tirol
tisdale	tisdale	tisdale
tish	tish	(proper noun) tish
tissa	tissa	(proper noun) tissa, as in moggaliputta tissa
tivi	télévision	television
tizard	assistant	(proper noun) tizard
tiên	d&#39;abord	first
tiêu	poivre	"entire term should be ""tieu chuan""; means ""a requirement"""
tiếc	malheureusement	"(term should be ""tiếc thương"") to pity (v.)"
tiếm	dingo	seize
tiến	en avant	operate
tiếng	heures	language
tiết	sécrétion	abstinence/intensity
tiếu	maladroit	"(should be ""đàm tiếu"") to sneer"
tiềm	potentiel	potential
tiền	l&#39;argent	money (n.)
tiều	merde	(proper noun) the name of a poet
tiểu	faire pipi	tiểu sử= biography
tiễu	m. liu	patrol
tiệc	fête	party
tiệm	salon	shop
tiện	pratique	mean
tiệp	tchèque	gustav franck
tiệt	putain	sterilize
tncs	tncs	communist youth union
tngt	tngt	traffic accidents
tnhh	limité	limited
toang	toang	fast
tobago	tobago	tobago
toei	toei	toei
tokugawa	tokugawa	tokugawa
tokyo	tokyo	tokyo, the capital of japan
tokyopop	tokyopop	tokyopop
tomas	tomas	(proper noun) tomas
tommy	tommy	tommy
tomoyo	tomoyo	tomoyo
tony	tony	tony
toonami	toonami	(proper noun) toonami
top	haut	top
torino	torino	torino, as in the italian city
toriyama	toriyama	(proper noun) toriyama
tottenham	t tottenham	tottenham
tourism	le tourisme	tourism
tourist	touriste	tourist
toyama	toyama	toyama
toyota	toyota	(proper noun) toyota
toà	cour	office
toàn	sûr	entire or whole (adj.)
toán	mathématiques	team
toát	bon	to exude or emit, as in sweat (v.)
toạ	coordonnées	locate
toại	à	satisfaction
toả	rayonner	spread
tp	tp	city
tphcm	tphcm	ho chi minh city
tphồ	ville	city ho
tpvĩnh	ville	vinh city
tqlc	tqlc	marine
trafalgar	trafalgar	(proper noun) trafalgar
trafford	trafic	trafford in greater manchester
trai	moules	boy
trang	page	a page (n.)
tranh	photos	to compete (v.)
trao	récompensé	reward
trau	trau	polish
tre	bambou	bamboo (n.)
treo	pendaison	hang
tri	tri	tri
tribune	tribune	a name
trinh	vierge	"(should be ""trinh bạch"") virtuous"
trinidad	trinidad	trinidad
trinity	trinité	trinity
tristan	tristan	tristan
triết	la philosophie	philosophy
triền	trien	"(should be ""triền miên"") endless"
triều	marée	court
triện	joint	stamp
triệt	bien	completely
triệu	millions	a million
tro	cendre	ashes
troia	troia	troy
trondheim	trondheim	trondheim
trong	dans	inside (adv.)
true	vrai	true
truman	truman	(proper noun) truman
trung	milieu	"(term should be ""trung gian"") agent (n.)"
trungnhật	l&#39;honnêteté	china-japan
truong	truong	truong
truyên	truyen	story
truyện	histoire	story
truân	truân	arduous
truất	détracteurs	cancel
truởng	chef	leader (n.)
truỵ	mentir	depraved
trà	thé	tea (n.)
tràm	cajuput	melaleuca
tràng	colon	"entire term should be ""truc trang""; means ""rectum"""
trào	éruption	movement
trác	trac	trac
trách	blâmer	blame
trái	à gauche	against
trán	le front	forehead
tráng	enduit	to coat (v.)
tránh	éviter	to avoid (v.)
tráo	brouiller	tráo trở= liar/betrayal/treacherous
tráp	cercueils	casket
trát	mandat	pile
trâm	broche	a type of elegant hairpin (n.)
trân	cordialement	respect
trâu	buffle	a last name
trãi	dispersé	trai
trèo	grimper	climb
trên	sur	above
trình	soumission	process
trí	esprit	intellectual
trích	extrait	to extract (v.)
trò	jeux	role
tròn	rond	rounding
trói	ligoté	tie
trôi	dérive	afloat
trông	regarde	look
trùm	patron	cover
trùng	coïncider	"(should be ""tinh trùng"") sperm"
trùy	truy	something to with monk
trú	embarquement	residence
trúc	bambou	structure
trăm	cent	hundred
trăn	python	"(term should be ""trăn trở"") to ponder (v.)"
trăng	lune	moon
trĩ	hémorroïdes	hemorrhoids
trũng	coulé	medium
trơ	inerte	bare
trơn	lisse	slippery (adj.)
trư	tru	a pig (n.)
trưa	midi	noon (n.)
trưng	réquisition	symbolic
trưngcông	exposé	truongcong
trương	truong	policy
trước	avant	front
trước 	avant	front
trướng	expansion	expand
trườn	ramper	crawl
trường	l&#39;école	case
trượng	caducée	a unit of length used in vietnam equal to 4 meters (n.)
trượt	glisser	slide
trạch	trach	ze
trại	camp	camp
trạm	station	station
trạng	condition	situation
trạo	trạo	trao
trả	payer	to return
trải	couverture	spread
trảm	cajuput	beheaded
trảo	machettes	trao
trấn	ville	town
trấu	cosse de riz	rice skin
trầm	basse	depression
trần	nu	tran
trầu	bétel	trầu
trầy	rayé	scratch
trẩy	rebondir	pilgrimage
trẫm	je suis	i
trận	le match	battle
trật	disloquée	order
trắc	biométrie	"(term should be ""trắc ẩn"") to have pity (adj.)"
trắng	blanc	white
trặc	hoquet	"entire phrase is ""truc trac""; means ""problem"""
trẻ	jeune	youth
trễ	être en retard	late
trệ	stagnant	bamboo
trị	traitement	cure
trịnh	phnh	trịnh, a vietnamese last name
trọ	auberge	motel
trọn	plein	whole
trọng	important	serious
trỏ	pointeurs	index
trối	finale	last words
trốn	cacher	to hide
trống	vide	in
trồi	émergente	to emerge (v.)
trồng	plantation	plant
trổ	montrer	to burst open or display
trỗi	émergence	rise
trội	dominant	better
trộm	voleur	theft
trớn	caresse	"(term should be ""mơn trớn"") to fondle or caress (v.)"
trời	dieu	sun
trợ	soutien	support
trụ	bureau	universe
trục	axe	"(term should be ""khu trục"") fighter, in reference to planes (adj.)"
trụi	nu	"(term should be ""trơ trụi"") bare (adj.)"
trứ	tru	famous
trứng	oeufs	egg
trừ	sauf	except
trừng	éblouissement	punish
trừu	résumé	abstract
trữ	stockage	reserve
trực	en service	direct
ts	ts	phd
tt	tt	news
tua	tentacule	fringe
tucker	tucker	tucker, an english last name
tudor	tudor	(proper noun) tudor, as in the tudor family
tukhachevsky	tukhachevsky	(proper noun) tukhachevsky
tulip	tulipe	tulip
tum	tum	tum
tung	lancer	release
tupolev	tupolev	tupolev, as in alexei tupolev
tuscan	toscan	(proper noun) tuscan
tutsi	tutsi	(proper noun) tutsi
tuvalu	tuvalu	(proper noun) tuvalu, a polynesian island nation
tuy	cependant	however
tuyên	déclarer	"(should be ""tuyên ngôn"") a declaration"
tuyết	neige	snow (n.)
tuyền	tuyen	tuyen
tuyển	recrutement	recruit
tuyệt	super	excellent (adj.)
tuân	obéir	comply
tuông	rincer	jealous
tuý	tuyý	drug
tuần	semaine	week
tuế	vairons	years
tuệ	la sagesse	intelligence
tuốc	plumer	turbine
tuổi	l&#39;âge	age
tuộc	poulpe	octopus
tuột	glisser	slip
tuỳ	en option	depend
tv	tv	tv
tvb	tvb	tvb
twin	jumeau	twin
twitter	twitter	twitter
ty	ty	company
type	type	type
typhon	typhon	typhon
tà	mal	we
tài	fortune	talent (n.)
tàn	cendres	dying
tàng	musée	"(should be ""bảo tàng"") a museum"
tành	tanh	shatter
tàu	navire	ship
tá	douzaine	"(term should be ""thiếu tá"") major (n.)"
tách	tasse	to separate
tái	re	return
tám	huit	eight
tán	auvent	support
tánh	tanh	life
táp	taper	to lap at (v.)
táu	coupable	ashton
tâm	esprit	tâm
tâu	mon seigneur	peach
tây	ouest	western
tâynam	westnam	"(should be ""tây-nam"") southwest"
tã	couches	diaper
tét	hurler	tet
tê	engourdi	numb
tên	le nom	name (n.)
tì	rate	to lean on (v.)
tìm	trouver	find
tìmdiệt	recherche	find-kill
tình	l&#39;amour	sex
tía	pourpre	dad
tích	produit	"(term should be ""tích cực"") to be zealous (adv.)"
tím	pourpre	purple
tín	crédits	"(entire term should be ""tín dụng"") credit"
tít	titre	"(term should be ""tít mù"") very far away (adv.)"
tò	curiosité	curious
tòa	cour	a court
tòi	truc	"(term should be ""tìm tòi"") to search doggedly for something (v.)"
tòng	tong	tòng, a last name
tóm	recueil	summary
tô	bol	car
tôi	moi	i
tôm	crevettes	shrimp
tôn	ondulé	venerate
tông	carton	tông, as in lê thánh tông; first name of an ancient vietnamese emperor
tù	prison	prison
tùng	de rechange	tung
tùy	en option	depend on
túc	suffisance	"(term should be ""bổ túc"") to give a refresher course (v.)"
túi	sac	pocket
túm	saisir	catch
túng	maladroit	confuse
túp	cabane	hut
túy	drogue	"(term should be ""thuần túy"") pure (adj.)"
tý	rat	mouse, as in year of the mouse
tăm	cure-dent	"(term should be ""tiếng tăm"") reputation"
tăng	augmenter	increase
tĩnh	statique	calm
tơi	je	ragged
tư	de	posture
tưng	fragile	"(term should be ""tưng bừng"") joyously (adv.)"
tươi	frais	fresh
tương	similaire	"(term should be ""tương tự"") to be similar to"
tước	dépouillé	title (n.)
tưới	arrosage	irrigation
tướng	général	prime minister (thu tuong)
tường	mur	"a common vietnamese first name; means ""wall"""
tạ	barbell	weight
tạc	sculpter	"(term should be ""oanh tạc"") to bomb from the air (v.)"
tại	à	survival
tạm	provisoire	temporary
tạo	créer	create
tạp	magazine	"(should be ""hỗn tạp"") a jumble or mish-mash"
tả	description	describe
tản	dissipation	disperse
tảng	plate-forme	platform
tấc	pouce	inch
tấm	assiettes	mirror
tấn	tonnes	tan
tấp	tiré	crowded
tất	chaussettes	all
tấu	instrumental	tau
tầm	jeux	range or extent (n.)
tần	fréquence	"(term should be ""tần số"") frequency (n.)"
tầng	étage	layer
tầu	train	ship
tẩm	imprégné	soak
tẩy	gomme	to bleach
tận	fin	dedicated
tật	handicap	disease
tắc	interrupteurs	priciple
tắm	prendre un bain	bathing
tắt	éteint	initial
tặc	les pirates	"(term should be ""hải tặc"") a pirate (n.)"
tặng	faire un don	donate
tẻ	terne	lẻ tẻ= scattered
tết	tet	(proper noun) the vietnamese new year
tếxã	économiquement	economy - society
tề	qi	tidy
tể	monsieur	lord
tệ	mauvais	bad
tệp	fichier	file
tỉa	paré	"(term should be ""bắn tỉa"") to snipe"
tỉnh	province	province
tị	envie	refugee
tịch	président	"(""chủ tịch"") president or chairman"
tọa	coordonnées	"(term should be ""chủ toạ"") chairman (n.)"
tỏ	exprimé	to
tỏa	rayonner	radiate
tỏi	l&#39;ail	garlic
tốc	vitesse	speed
tốn	coût	to cost (v.)
tống	escorte	dispose
tốp	gang	top
tốt	bon	good
tồi	mauvais	bad
tồn	exister	exist
tổn	mal	damage
tổng	au total	president
tộc	clan	"(term should be ""dân tộc"") a race or people"
tội	crime	crime
tột	extrême	extreme
tớ	moi	servant
tới	à	to the point
tờ	fiche	paper/document
tởm	dégoûtant	disgusting
tục	profane	"(term should be ""tập tục"") customs or practices"
tụy	pancréas	"(term should be ""tận tụy"") devoted (adj.)"
tủ	armoires	shelf
tủi	mauvais	humiliated
tủy	moelle	spine
tức	instantané	i.e.
từ	de	from
từng	chacun	each
tử	la mort	lion (su tu)
tửu	boire	wine
tự	moi	"(term should be ""tương tự"") like or similar to (adv.)"
tựa	titre	lean
tựu	réalisations	achievement
tỵ	serpent	the han name for the year of the snake, according to the chinese zodiac
tỷ	milliards	billion
u	u	tumor
ua	ua	ua
uae	eau	uae
ubuntu	ubuntu	ubuntu
uc	uc	uc
uchiha	uchiha	uchiha
uefa	uefa	uefa
uh	euh	uh
uk	royaume-uni	uk
ukiyoe	ukiyoe	ukiyoe
ukraina	ukraina	ukraine
ulsan	ulsan	ulsan
umm	euh	umm
un	un	(proper noun) un, as in chung un chan of korea
und	und	und
under	sous	under
unesco	unesco	unesco
ung	ung	cancer
unicorn	licorne	unicorn
unit	unité	unit
unix	unix	unix
up	ups	up
ural	ural	ural, as in the ural mountains
urani	l&#39;uranium	uranium
uri	uri	uri, a former political party in south korea
uruguay	uruguay	uruguay
usagi	usagi	usagi
usb	usb	usb
uss	uss	uss
utah	utah	utah
utrecht	utrecht	(proper noun) utrecht
uy	uy	"(term should be ""uy lực"") power (n.)"
uyghur	ouïghour	(proper noun) uyghur
uygur	ouïgour	uygur
uyên	uyen	scholarly
uyển	euphémisme	"(term should be ""uyển chuyển"") flexible (adj.)"
uzbekistan	ouzbékistan	uzbekistan
uông	uong	uong
uất	uất	busy
uốn	pliage	to curl (v.)
uống	boire	to drink
uổng	gaspillage	vain
v	v	v
va	va	collide
vaccine	vaccin	vaccine
vai	épaule	shoulder
valencia	valence	valencia
valentine	valentin	valentine
valley	vallée	valley
van	van	"(term should be ""van xin"") to beg (v.)"
vanessa	vanessa	vanessa
vargas	vargas	(proper noun) vargas
vasari	vasari	vasari
vay	emprunter	borrow
vectơ	vecteur	vector
ven	ven	"(term should be ""ven biển"") coastal (adj.)"
vendôme	vendôme	vendome
venezia	venezia	venice
venus	vénus	venus
verdun	verdun	verdun
vermont	vermont	vermont
verona	vérone	(proper noun) the city of verona
versailles	versailles	(proper noun) versailles
vhs	vhs	vhs
vi	en	behavior
viagra	viagra	viagra
victor	vainqueur	(proper noun) victor
victoria	victoria	victoria, a province of australia
vienna	vienne	(proper noun) vienna, austria
viet	viet	vietnamese
vietnam	vietnam	vietnam
viettel	viettel	viettel
viii	viii	eighth
vijaya	vijaya	(proper noun) vijaya
viking	viking	viking
villa	villa	villa
villeneuve	villeneuve	(proper noun) villeneuve, a french last name
vinagame	vinagame	vinagame
vinashin	vinashin	vinashin
vince	vince	(proper noun) vince, as in vince mcmahon
vincennes	vincennes	vincennes
vincent	vincent	vincent
vinpearl	vinpearl	vinepeal
viqr	viqr	viqr
virginia	virginie	(proper noun) virginia, as in the state
virus	virus	virus
virút	virus	virus
vissarionovich	vissarionovich	vissarionovich
vista	vue	vista, as in windows vista
vitamin	vitamines	vitamin
vitruvius	vitruve	vitruvius
viz	à savoir	(proper noun) viz
viêm	inflammation	inflammation
viên	comprimés	member
viêng	viang	vientiane
viêt	écrit	vietnam
viếng	visite	visit
viết	écrire	write
việc	travailler	thing
viện	institut	institute
việt	vietnamien	viet
việtmường	muong vietnamien	muong
việtnga	vietnga	vietnam-russia
việttrung	viettrung	vietnam-china
vn	vn	vietnam
vnexpress	vnexpress	(proper noun) vnexpress
vni	vni	vni
vo	vo	"(term should be ""tròn vo"") perfectly round (adj.)"
voi	éléphant	elephant
voip	voip	voip
voldemort	voldemort	(proper noun) voldemort, the villain from the harry potter series
von	von	compare
vonfram	tungstène	wolfram
vong	victimes	injured
voyager	voyager	voyager
voọc	langurs	a langur (n.)
vtc	vtc	vtc
vu	vu	"entire phrase is ""vu cao""; means ""to accuse wrongly"""
vua	roi	king
vui	amusant	happy
vulcan	vulcan	vulcan
vuông	carré	square
vuốt	griffes	stroke
vv	etc.	etc.
vy	vy	vy
vyacheslav	vyacheslav	vyacheslav
và	et	and
vài	peu	several
vàm	vm	the mouth of a rivulet (n.)
vàng	or	gold
vành	jante	coronary
vào	sur	into
vá	patch	patchy
vác	porter	to shoulder (v.)
vách	mur	wall
vái	oui	some
ván	planche	game
váng	écume	film
váy	jupe	skirt
vân	ainsi de suite	"(term should be ""vân vân"") et cetera"
vây	nageoire	encircle
vã	précipité	rush
vãi	merde	to release
vãn	van	save
vè	faire pipi	to glance slyly (v.)
vé	billets	ticket
vét	draguer	plunder
vê	à propos	tremolo
vì	à cause de	because
ví	sac à main	example
vía	portefeuille	soul
vít	vis	screw
vò	froissé	jar
vòi	tuyau	tap
vòm	arches	upper jaw
vòng	rond	around
vó	hoooo	hooves
vóc	physique	"(should be ""vóc sương"") dew-like or delicate"
vô	non	"(term should be ""vô số"") countless (adj.)"
vôi	citron vert	limestone
võ	martial	martial arts (n.)
võng	hamac	hammock
vùi	enterré	"(term should be ""chôn vùi"") to bury or keep secret (v.)"
vùng	région	region
vú	les seins	breast (n.)
vút	planant	"entire term should be ""cong vut""; extreme curling"
văn	publié	culture
văng	éclabousser	a name
vĩ	super	"(term should be ""vĩ đại"") great (adj.)"
vĩnh	en permanence	ving
vũ	vu	armed
vũng	flaque	vung
vơ	impuissant	lost
vơi	avec	ullage
vưu	vưu	"actual term is ""xi vưu""; proper noun; name of a leader of a people in chinese legend"
vươn	atteindre	reach
vương	roi	kingdom
vướng	empêtré	"(term should be ""vướng víu"") to become involved in (v.)"
vườn	jardin	garden
vượn	singes	gibbon
vượt	passer	to overcome
vạ	donc	unfortunate problem
vạc	chaudron	cauldron
vạch	bar	bar
vại	réservoir	jar
vạn	dix mille	thousand
vạng	crépuscule	twilight
vả	figue	hard
vải	tissu	fabric
vảy	écailles	scale
vấn	des conseils	vấn đề= problem
vấp	trébuché	stumble
vất	jeter	hard
vần	rime	spell
vầng	halo	moon (vang trang)
vẩn	encore	wander
vẩy	flocons	scale
vẫn	encore	still
vẫy	agitant	wave
vận	fortune	active
vắc	vaccin	vaccine
vắcxin	vaccin	vaccine
vắn	bref	short
vắng	absent	absent
vặn	vis	to twist (v.)
vặt	petites annonces	odd
vẹn	l&#39;intégrité	complete
vẹt	perroquets	parrots
vẽ	dessiner	draw
vết	tache	wound
vểnh	perche	warping
vệ	défense	"(term should be ""bảo vệ"") to defend (v.)"
vệt	stries	streak
vỉa	coutures	"(term should be ""vỉa hè"") sidewalk"
vịnh	baie	bay
vịt	canard	duck
vọng	espérer	"(term should be ""hy vọng"") hope (n.)"
vọt	monter en flèche	to spurt out (v.)
vỏ	coquille	shell
vồ	maillet	"(term should be ""gạch vồ"") a type of brick"
vỗ	tapoter	to clap
vội	pressé	hurriedly (adv.)
vớ	chaussettes	"(term should be ""vớ vẩn"") silly (adj.)"
với	avec	to
vớt	récupéré	salvage
vờ	faire semblant	"(term should be ""giả vờ"") to pretend (v.)"
vời	super	wonderful
vở	cahier	"(term should be ""vở kịch"") a play"
vỡ	cassé	break
vợ	femme	wife
vụn	jetons	debris
vụng	maladroit	covert
vứt	jeter	throw away
vừa	moyen	just (adv.)
vừng	sésame	sesame (n.)
vững	ferme	firm (adj.)
vực	champ	place
vựng	vocabulaire	"(term should be ""từ vựng"") regional vocabulary (n.)"
vỹ	donc	majestic
w	w	w
wa	wa	wa
walt	walt	(proper noun) walt, as in walt disney
walter	walter	walter
walther	walther	walther
wan	blême	wan
wang	wang	wang
wankel	branlette	(proper noun) wankel
wanna	veux	wanna
warren	warren	a name
warsaw	varsovie	warsaw
warszawa	varsovie	(proper noun) warsaw
washington	washington	(proper noun) washington
wat	wat	(proper noun) wat, as in angkor wat, the temple in cambodia
watergate	watergate	watergate
waterloo	waterloo	(proper noun) waterloo
waters	les eaux	waters
wayne	wayne	wayne
wcdma	wcdma	w-cdma
weasley	weasley	weasley, as in ron weasley in the harry potter series
weblog	blog	weblog
webmail	webmail	ưebmail
weimar	weimar	(proper noun) weimar
wellington	wellington	wellington
wells	puits	wells, as in author orson wells
welsh	gallois	(proper noun) welsh, as in the welsh language
wembley	wembley	wembley, as in wembley stadium
werner	werner	werner
westermarck	westermarck	westermarck
western	ouest	western
westlife	westlife	westlife
westview	westview	westview, as in westview press
wheeler	wheeler	a name
widener	élargisseur	widener
wien	wien	wien
wiener	saucisse	wiener
wifi	wifi	wi-fi, a technology term
wiki	wiki	wiki
wikia	wikia	a name
wikibooks	wikibooks	(proper noun) wikibooks
wikimapia	wikimapia	wikimapia
wikimedia	wikimedia	wikimedia
wikitravel	wikitravel	a name
wild	sauvage	wild
wilder	plus sauvage	(proper noun) wilder, as in billy wilder
wiley	wiley	wiley
willard	willard	willard
wimbledon	wimbledon	wimbledon
windows	fenêtres	windows
winer	vin	winer
wisconsin	wisconsin	(proper noun) wisconsin
within	à l&#39;intérieur	within
without	sans	without
wolfgang	wolfgang	wolfgang
won	gagné	won
wong	wong	wong
woodrow	woodrow	woodrow
woods	bois	(proper noun) woods, as in tiger woods
would	serait	would
wrestling	lutte	wrestling
wright	wright	a name
wu	wu	wu
wushu	wushu	wushu, a type of martial art
wwf	wwf	wwf
xa	loin	ancient
xang	xang	"(term should be ""lan xang"") name of an ancient country in southeast asia"
xanh	vert	green
xao	flasque	xôn xao = chatting
xay	broyer	grind
xe	voiture	a car (n.)
xem	voir	watch
xen	xen	to insert (v.)
xhcn	xhcn	social republic
xi	xi	xi
xiii	xiii	eighth
xin	s&#39;il te plait	please
xinh	beau	beautiful
xiv	xiv	fourteenth
xiêm	siamois	(proper noun) xiêm, or siam
xiên	oblique	oblique
xiêu	xiao	soften
xiếc	cirque	circus
xiết	resserrer	to twist tightly (v.)
xiềng	manilles	chain
xo	xo	spring
xoa	frotter	massage
xoay	tourner	turn
xong	fait	completed
xoàng	médiocre	mediocre
xoá	effacer	delete
xoáy	tourbillonner	vortex
xoắn	tordu	coiled
xu	cents	trend
xua	dissiper	dispel
xuan	xuan	"(term should be ""xuân"") a common vietnamese middle or first name; means ""the season of spring"""
xui	malchanceux	incite
xuka	xuka	xuka
xum	luxuriant	a name
xuyên	perçant	frequently
xuyến	torse	manage
xuân	printemps	spring
xuâncông	printemps	xuan public
xuôi	balayé	down
xuất	exporter	ejaculate
xuấtnhập	exporter	import/export
xuống	vers le bas	down
xuồng	canoë	boat
xv	xv	fifteenth
xvi	xvi	xvi
xvii	xvii	xvii
xx	xx	xx
xy	xy	cylinder
xài	passer	use
xào	sauté	stir fry
xách	sac à main	to carry by the handle (v.)
xám	gris	ustox
xán	frit	"(term should be ""xán lạn"") bright (adj.)"
xáo	dérangement	chaos
xát	frotter	touch
xâm	tatoué	invasion
xâu	chaîne	string
xây	construire	build
xã	commune	society
xãy	volage	occur
xèo	xèo	xeo
xé	déchirer	tear
xén	recadrage	"(term should be ""biếu xén"") to gift (v.)"
xéo	aslant	diagonally (adv.)
xét	considérer	examine
xê	bouger	"(term should be ""bánh xu xê"") a type of vietnamese cake"
xêkô	suneo	xeko
xì	pet	scandal
xìu	pet	to become flaccid (v.)
xí	usine	factory (xi nghiep)
xít	fascinant	nazi
xíu	minuscule	small
xòe	diffusion	spread
xóa	effacer	clear
xói	l&#39;érosion	erode
xóm	voisins	village
xót	miséricorde	mercy
xô	seau	soviet
xôi	riz gluant	pierce
xôn	remuer	tumultuous
xông	précipité	rush
xôphần	section de godet	soviet-poland
xôviết	union soviétique	soviet
xù	ébouriffé	gigantic
xú	grossier	xu
xúc	contact	touch
xúi	provoquer	induce
xăm	tatouage	"(term should be ""xa xăm"") far away (adj.)"
xăng	essence	gasoline
xơ	fibre	xo
xưa	vieux	old
xưng	avouer	"(should be ""tự xưng"") self-proclaimed"
xương	os	bone (n.)
xước	rayé	scratch
xướng	choeur	provoke
xưởng	atelier	workshop
xạ	rayonnement	"(term should be ""phản xạ"") to reflect"
xả	décharge	release
xảo	rusé	detailed
xảy	se produire	happen
xấp	environ	approximate
xấu	mauvais	bad
xẩm	hirsute	a type of traditional vietnamese singing
xẩy	se produire	occur
xắt	couper	cut
xẻo	malchanceux	cut off
xếp	plié	rank
xỉ	scories	approximately
xỉa	soie dentaire	to pick (v.)
xỉu	faible	to faint
xốc	choc	to lift up (v.)
xốp	poreux	porous
xổ	tirage au sort	rush into
xộn	désordre	messy
xứ	fabriqué	native
xứng	digne	appropriate
xử	traiter	judge
y	y	medical
y=fracsin	y = fracsin	a function
ya	ouais	(proper noun) ya, as in ya trang
yakovlev	yakovlev	yakovlev
yakushima	yakushima	yakushima
yalta	yalta	(proper noun) yalta
yankee	yankee	(proper noun) yankee
yard	cour	yard
yasha	yasha	a name
yeeun	yeeun	(proper noun) yeeun
yeltsin	eltsine	yeltsin, as in boris yeltsin
yemen	yémen	yemen
yersin	yersin	(proper noun) yersin, asin alexandre yersin
yi	yi	(proper noun) yi
ying	ying	(proper noun) ying, as in ying yang
ymca	ymca	ymca
yo	yo	yo
yomiuri	yomiuri	yomiuri
yoochun	yoochun	yoochun
york	york	york
yorker	yorker	yorker
yorkshire	yorkshire	yorkshire
youtube	youtube	youtube
ypres	ypres	ypres
ytv	ytv	ytv
yu	yu	yu
yuan	yuan	(proper noun) yuan, as in yuan mu
yucatán	yucatán	yucatan, as in the yucatan peninsula
yudhoyono	yudhoyono	(proper noun) yudhoyono, as in indonesian president susilo bambang yudhoyono
yugi	yugi	yugi
yukito	yukito	yukito
yume	yume	(proper noun) yume
yunho	yunho	yunho
yuri	yuri	yuri, as in soviet pilot and cosmonaut yuri alekseyevich gagarin
yurt	yourte	yurt
yên	yen	peace or stillness (n.)
yêu	l&#39;amour	love
yếm	combinaison	tender
yến	nid d&#39;oiseau	a type of swallow (n.)
yết	annonce	yet
yếu	faible	mainly
yểm	couverture	support
yển	yen	"is a name meaning, ""bird"""
yểu	adorable	"(term should be ""yểu điệu"") graceful (adj.)"
z	z	z
zac	zac	zac
zambia	zambie	(proper noun) zambia, as in the nation
zealand	zélande	(proper noun) zealand, as in new zealand
zedong	zedong	mao zedong
zero	zéro	zero
zeus	zeus	zeus
zheng	zheng	zheng
zhukmse	zhukmse	zhuk-mse
zimbabwe	zimbabwe	zimbabwe
zinedine	zinedine	(proper noun) zinedine
zing	zing	zing, as in the website
zoe	zoé	zoe
zurich	zurich	(proper noun) zurich
zürich	zurich	(proper noun) zurich, as in zurich, switzerland
|nguyễn	| nguyen	a common vietnamese last name
|nổi	| flotteurs	"(term should be ""nổi"") to float (v.)"
|petya	| petya	(proper noun) petya
|tên	| nom	"(should be ""tên"") name (n.)"
|việt	| vietnamien	vietnam
 kg	kg	kg
 triệu	millions	million
 °c	° c	degrees celsius
°đến	° à	up to
°độ	° degrés	degree
×	×	x
ào	wow	rush
á	á	asia
ác	mal	evil
ách	joug	yoke (n.)
ái	envie	ai
ám	rend	(with the word chi) to hint at
ánh	lustre	light
áo	manteau	clothe
áohung	aohung	"(term should be ""Áo-hung"") austria-hungary"
áp	pression	"(term should be ""huyết áp"") blood pressure (n.)"
áâu	aoi	eurasian
â	â	a vietnamese vowel sound
âm	négatif	vagina
ân	faveur	deed
én	avale	swallow
ép	pressé	press
êgê	ego	aegean
êm	lisse	smooth
ích	utile	benefit
ílam	ílam	tamil language name for the island of sri lanka
ít	peu	less
île	île	Île, as in Île de la cité, france
îledefrance	îledefrance	ile-de-france
ðiều	article	article
ðài	ðài	taiwan
ðường	le sucre	a road
ðảng	la fête	party
ðức	allemagne	"Đức, a common vietnamese first name; means ""virtue"""
ó	ó	(with the word la) to boo down
óc	cerveau	brain
óng	irisé	"(term should be ""óng ả"") flexible"
ôi	oh	"vietnamese version of the exclamation ""oh"""
ôm	câlin	hug
ôn	modération	peaceful (on hoa)
ông	monsieur	a man (n.)
ôtô	les voitures	car
ôxi	oxygène	oxygen
ôxy	oxygène	the element oxygen (n.)
ôxít	oxyde	oxide
ôzôn	l&#39;ozone	ozone
ùn	confitures	congest
úng	gorgé d&#39;eau	flood
úp	face cachée	upside
úy	lieutenant	"(term should be ""thiếu úy"") second lieutenant (n.)"
ý	italie	italian
ăn	manger	eat
ăng	fourmi	antenna
ăngten	antenne	antenna
đa	multi	majority
đai	ceinture	"(term should be ""Đai khố"") name of a village"
đak	dak	(proper noun) Đak
đan	tricot	scandal
đau	la douleur	painful
đay	jute	jute, a type of vegetation the vietnamese use to make soup (n.)
đb	db	dien ban
đcstq	dcstq	communist party of china
đcsvn	dcsvn	vietnam communist party
đe	enclume	threaten
đem	apporter	to bring (v.)
đen	noir	black
đentrắng	noirblanc	"(term should be ""đen-trắng"") black-and-white (adj.)"
đeo	porter	wear
đh	đh	university
đhcn	đcn	university of industry
đhtm	dhtm	university of economics
đhông	est	dhong
đi	aller	go
điên	fou	crazy
điêu	chose	sculpture
điôxít	dioxyde	dioxide
điạ	dạ	dia
điếc	sourd	heron
điếu	cigarette	funeral oration
điềm	présage	omen
điền	remplir	estate
điều	chose	control
điểm	pointer	bearing point
điển	dictionnaire	"(term should be ""từ điển"") a dictionary"
điểu	baiser	thing
điệp	le message	spy
điệu	ton	memorial
đo	mesurer	measure
đoa	doa	doa
đoan	présentable	extreme
đom	lucioles	firefly
đoài	mangue	the west
đoàn	union	an organization or group (n.)
đoái	échange	"(term should be ""hối đoái"") to exchange or trade (v.)"
đoạn	paragraphe	a stage or phase (n.)
đt	đt	training
đtđ	téléphone portable	diabetes
đua	course	emulate
đui	aveugle	blind
đun	faire bouillir	cook
đuôi	queue	tail
đuốc	torche	a torch
đuối	noyade	drowning
đuống	tige	(proper noun) Đuống, the name of a river
đuổi	chasser	pursue
đài	la radio	statue
đàm	discussions	negotiation
đàn	troupeau	musical instrument
đàng	oui	side
đào	les pêches	train
đày	exil	exile
đá	pierre	to kick
đái	pipi	pee
đám	horde	dam
đán	dan	"(term should be ""tết nguyên Đán"") vietnamese new year's day"
đáng	ça vaut le coup	deserve
đáo	unique	unique
đáp	répondre	response
đát	terre	"(term should be ""bi đát"") lamentable (adj.)"
đâm	poignarder	pierce
đâu	où	anywhere
đây	ici	below
đã	étaient	already
đãi	traiter	"(should be ""bạc đãi"") to ill-treat"
đãng	lubrique	dissolute
đè	remplacer	to press on
đèn	lumières	light
đèo	passe	a mountain pass (n.)
đê	digue	a dike (n.)
đêm	la nuit	night
đênh	mâle	lênh đênh= float to unknown
đích	destination	goal
đính	attaché	attached (adj.)
đò	ferry	a ferry (n.)
đòi	réclamer	require
đòn	souffler	welcome
đó	ça	that or there (adv.)
đóa	non	"(term should be ""đoá hoa"") a flower bloom"
đói	faim	hungry
đón	ramassage	welcome
đôi	double	sometimes
đôla	dollars	dollar
đôn	envie	london
đông	est	eastern
đôngbắc	est	north-east
đôngnam	dongnam	south-east
đôngtây	est	"(term should be ""đông-tây"") east-west (adj.)"
đôrêmi	doraemon	(proper noun) Đôrêmi
đôrêmon	doraemon	doreamon
đùa	plaisanterie	joke
đùi	cuisse	thigh
đúc	coulée	"(term should be ""đúc kết"") to sum up (v.)"
đúng	à droite	right
đúp	double	double
đút	abandonner	"(term should be ""đút lót"") to bribe"
đăk	dak	dak
đĩ	salope	whore/bitch
đĩa	disque	disk
đơ	raide	stiff or rigid (adj.)
đưa	donner	girl
đường	le sucre	pathway
được	d&#39;accord	is not
đạ	da	da
đại	super	eagle
đạm	protéine	plain
đạn	balle	bullet
đạo	la religion	vagina
đạp	coup de pied	to step on
đạt	atteindre	reach
đả	se bat	to hit
đảm	garanti	"(term should be ""đảm nhiệm"") to undertake (v.)"
đản	anniversaire	a group or flock (n.)
đảng	fête	party
đảo	île	an island (n.)
đấm	frapper	punch
đấng	dieu	the
đất	le sol	country
đấtmặt	au sol	datmat
đấy	là	ignore
đầm	robe	swamp
đần	stupide	"(term should be ""đần độn"") stupid or ignorant (adj.)"
đầu	le haut	start
đầy	plein	"(term should be ""đầy đủ"") adequate or enough"
đẩu	tête	"(entire term is ""khoa đẩu"") ancient phonetic script used in vietnam"
đẩy	pousser	to push
đẫm	trempé	wet
đậm	gras	dense
đậu	haricots	to park (v.)
đậy	couverture	cover
đắc	gagner	effectively
đắm	détruit	sink
đắn	convenance	proper (dung dan)
đắng	amer	bitter
đắp	en haut	"(term should be ""bù đắp"") to compensate (v.)"
đắt	cher	expensive
đằng	sur	back
đẳng	isométrique	equality
đặc	spécial	"(term should be ""đặc biệt"") special (adj.)"
đặn	régulier	regularly
đẹp	beau	beautiful
đẽ	bien	beauty
đế	semelles	empire
đếm	compter	to count (v.)
đến	arrivé	come
đề	fils	promote
đền	temple	"(term should be ""đền thờ"") a religious shrine"
đều	sont	all
để	à	for
đệm	coussin	middle name
đỉnh	pic	the summit or peak
địch	l&#39;ennemi	enemy
định	spécifié	appointed
đọ	dénoyauté	compete
đọan	paragraphe	period
đọc	lire	read
đọng	stagnant	deposit
đỏ	rouge	red (adj.)
đốc	gouverneur	admiral
đối	pour	face
đốm	taches	spot
đốn	couper	"(term should be ""suy đốn:) to be worse off"
đống	pile	line
đốt	brûlant	burn
đồ	carte	thing
đồi	colline	hill
đồn	rumeur	rumour
đồng	co	agreeable
đổ	cabanon	dump
đổi	changer	to change (v.)
đổng	dong	"(term should be ""đồng bằng"") a delta"
đỗ	garé	pass
độ	degré	"term should actually be ""độ cao""; means ""height"""
độc	toxique	alone
độn	rembourré	chaos
động	dynamique	action
đột	soudain	"(term should be ""xung đột"") conflict (n.)"
đới	zen	tropical
đời	à vie	generation
đỡ	soutien	help
đợi	attends	thigh
đợt	lot	fit
đục	opaque	turbid
đụn	les dunes	dune
đụng	toucher	encounter
đủ	assez	enough
đứa	les enfants	child
đức	allemagne	virtue (n.)
đứng	se tenir	to stand (v.)
đứt	cassé	cut off
đừng	ne le fais pas	not
đực	mâle	male
đựng	contenue	suffer
đựoc	d&#39;accord	be
ĩ	oh	"(term should be ""ầm ĩ"") noisy"
ơ	oh	"(term should be ""thờ ơ"") to be indifferent (adj.)"
ơi	hé	"vietnamese equivalent of english ""oh"""
ơn	merci	thank
ư	u	vowel sound found in the vietnamese alphabet (n.)
ưa	préféré	to like (v.)
ưng	oh oui	to accept (v.)
ưu	pros	"(term should be ""ưu việt"") preeminent (adj.)"
ươi	orang	orangutan
ươm	crèche	nursery
ương	central	central
ướp	mariné	mummy
ướt	mouillé	wet
ạ	monsieur	a word added to the end of a response to show respect to someone in a position of authority, as in a child to a parent
ạt	se précipiter	(with word o) to crowd
ải	ải	pass
ảnh	photo	picture
ấm	chaud	warm
ấn	presse	press
ấnâu	imprimer	"(term should be ""Ấn Âu"") a grouping of languages including european and indian languages that are thought to have originated from a single earlier language (adj.)"
ấp	hameau	district
ấu	jeune	childhood
ấy	ça	that
ẩm	humide	humidity
ẩn	cacher	hidden
ập	coup	rush
ắt	bien sûr	sure
ếch	grenouille	frog
ỏi	menthe	little
ố	ooh	"(term should be ""hoen ố"") stained and smeared (adj.)"
ốc	escargots	building
ốm	malade	sick
ống	pipe	tube
ốp	tangente	omelette
ồn	bruit	noisy (adj.)
ổ	conduire	hard drive
ổi	goyave	guava (n.)
ổn	bien	peace
ớn	grand	posts
ớt	piment	chili
ở	à	at
ủ	incubation	"(term should be ""ủ dột"") gloomy (adj.)"
ủi	fer	"(term should be ""an ủi"") to comfort (v.)"
ủng	bottes	boot
ủy	commissaire	commission
ứ	oui	to pool together (v.)
ức	poitrine	memories
ứng	application	corresponding
−−	−−	__
≠	≠	different
