$ tỉ	$ अरब	$ billion
abc	एबीसी	abc
abdul	अब्दुल	abdul
abkhazia	अब्खाज़िया	a name
about	के बारे में	about
abraham	अब्राहम	abraham
abrams	अब्राम	abrams
abscbn	abscbn	abscbn
account	खातों	account
aceh	आचे	(proper noun) aceh
achilles	achilles	achilles
acia	acia	acia
acid	अम्ल	acid
ada	ada	ada
adams	एडम्स	(proper noun) adams
addisonwesley	addisonwesley	(proper noun) addison-wesley
adn	ए डी एन	adn
adobe	एडोब	adobe
adrian	एड्रियन	(proper noun) adrian
adsl	एडीएसएल	adsl
advanced	उन्नत	advanced
aedes	एडीज	aedes
aegypti	एजिप्टी	aegypti
aero	हवाई	(proper noun) aero, as in the aero l-39 albatros jet
afc	एएफसी	afc
aff	एएफएफ	aff
afghanistan	अफ़ग़ानिस्तान	afghanistan
africa	अफ्रीका	(proper noun) africa
african	अफ़्रीकी	african
ag	एजी	ag
agasa	agasa	(proper noun) agasa, as in hiroshi agasa
agassi	अगासी	agassi
ai	कौन	who
ailen	ailen	ailen
aim	लक्ष्य	aim
air	हवा	air
airbus	एयरबस	airbus
aisne	ऐसने	aisne
ajax	ajax	ajax
ak	एके	ak
akatsuki	अकात्सुकी	akastuki
akms	akms	akms
akô	एको	ako
al	अल	al
alabama	अलाबामा	alabama
alaska	अलास्का	alaska
albania	अल्बानिया	albania
albatros	albatros	(proper noun) albatros, as in the aero l-39 albatros
albert	अल्बर्ट	(proper noun) albert
alberto	अल्बर्टो	(proper noun) alberto
albion	albion	albion, an ancient name for great britain
albuquerque	अल्बुकर्क	albuquerque
albus	albus	albus
alexa	एलेक्सा	alexa
alexandra	एलेक्जेंड्रा	alexandra
alexandria	सिकंदरिया	alexandria
alexandros	एलेक्ज़ेंड्रोस	alexandros
alexey	एलेक्सी	alexey
alfred	अल्फ्रेड	(proper noun) alfred, as in alfred kinsey
algérie	algérie	algerie
ali	अली	ali
alice	ऐलिस	this is a name
allan	एलन	(proper noun) allan, as in edgar allan poe
allen	एलन	(proper noun) allen
allmusic	ऑलम्यूज़िक	allmusíc
alois	alois	alois
alonso	अलोंसो	alonso
alpher	alpher	(proper noun) alpher
alps	आल्पस	alps
altai	अल्ताई	altai
always	सदैव	luon luon
amaravati	अमरावती	amaravati
amazon	वीरांगना	amazon
amdo	amdo	(proper noun) amdo
ame	एएमई	ame
ami	अमी	ami
amiens	एमियेन्ज़	amiens
amin	अमाइन	(proper noun) amin, as in nagib amin
amm	amm	amm
amoniac	अमोनिया	ammonium (n.)
amphitrite	amphitrite	(proper noun) amphitrite, a greek sea goddess
an	सुरक्षा	"(should be ""an toàn"") safe"
anand	आनंद	anand
anata	अनत	anata
anatolia	अनातोलिया	anatolia
andalusia	andalusia	andalusia
andaman	अंडमान	andaman
anderson	एंडरसन	anderson
andes	एंडीज	andes
andorra	एंडोरा	andorra
andrew	एंड्रयू	andrew
andré	आंद्रे	andre, as in andre morval
andy	एंडी	(proper noun) andy, as in andy warhol
anfield	एनफील्ड	anfield
ang	आंग	ang
angkor	अंगकोर	(proper noun) angkor, as in angkor wat, the temple in cambodia
anglosaxon	एंग्लोसेक्सॉन	anglo-saxon
anh	आप	english
anhmỹ	anhmy	"(term should be ""anh mỹ"") english or american"
anhpháp	फ्रांस के मि	england-france
ankara	अंकारा	ankara
ankyl	एल्काइल	ankly
anna	अन्ना	anna
annam	अन्नम	a name the way french called middle vietnam as a colony
annan	अन्नान	annan
anne	ऐनी	anne, a name
anorthosit	anorthosite	anorthosit, a type of igneous rock (n.)
anthony	एंथोनी	anthony
antigua	एंटीगुआ	(proper noun) antigua
anton	एंटोन	anton
antonov	एंटोनोव	antonov
any	कोई	any
anđêhít	एल्डिहाइड	aldehydes
ao	तालाब	pond
aotearoa	aotearoa	aotearoa
apollo	अपोलो	apollo
apple	सेब	apple
aquinas	एक्विनास	a name
arab	अरब	(proper noun) arab
archetypal	ठेठ	archetypal
archive	पुरालेख	archive
arctan	arctan	a function
ares	एरेस	ares
argentina	अर्जेंटीना	(proper noun) the south american nation of argentina
argo	argo	argo
arias	एरियस	arias
aringarosa	aringarosa	aringarosa, as in manuel aringarosa
aristotle	अरस्तू	aristotle
arizona	एरिज़ोना	arizona, as in the state
ark	संदूक	ark
arkansas	अर्कांसस	arkansas
arlington	arlington	(proper noun) arlington
armenia	आर्मीनिया	(proper noun) armenia
armstrong	आर्मस्ट्रांग	(proper noun) armstrong, as in jazz artist louis armstrong
arnold	अर्नोल्ड	arnold
arsenal	शस्त्रागार	arsenal
artemis	आर्टेमिस	(proper noun) artemis, the greek goddess of the hunt
aruba	अरूबा	aruba
arunachal	अरुणाचल	"(term should be ""arunachal pradesh"") a state in india (proper noun)"
asc	एएससी	asc
ash	एश	a name
ashikaga	आशिकागा	ashikaga
ashley	एशले	(proper noun) ashley
asia	एशिया	asia
asm	एएसएम	asm
asoka	अशोका	asoka
association	संगति	association
assyria	असीरियन	assyria
aston	एस्टन	(proper noun) aston, as in aston villa
atkinson	एटकिंसन	atkinson
atlanta	अटलांटा	atlanta
atlantic	अटलांटिक	atlantic
aua	aua	aua
aubrac	aubrac	aubrac
audition	श्रवण	audition
auflage	auflage	auflage
auguste	अगस्टे	auguste
australia	ऑस्ट्रेलिया	(proper noun) australia
austria	ऑस्ट्रिया	(proper noun) the country of austria
austrian	ऑस्ट्रिया	austrian
avar	avar	a name
aviation	विमानन	aviation
awad	अवाद	awad
award	पुरस्कार	award
axit	अम्ल	acid
ayeyarwady	एइयारवादी	ayeyarwady
ayumi	अयूमी	(proper noun) ayumi
ayutthaya	अयूथया	(proper noun) ayutthaya
azerbaijan	आज़रबाइजान	(proper noun) azerbaijan
aztec	एज़्टेक	aztec, as in the aztec people (adj.)
ba	तीन	three
babylon	बेबीलोन	babylon
bacon	बेकन	bacon
baden	बाडेन	baden
baghdad	बगदाद	(proper noun) baghdad
bago	बैगो	bago
bahamas	बहामा	bahamas
bahrain	बहरीन	bahrain
baháí	बहाई	bahai
balearic	balearic	balearic
bali	बाली	bali
balkan	बलकानी	(proper adjective) balkan
balkans	बलकान	balkans
ballard	बेलार्ड	ballard
bamar	bamar	bamar
ban	विभाग	the
bang	राज्यों	state
banh	गेंद	ball
banner	बैनर	banner
bantam	बैंटम	bantam
bantu	बंटू	bantu
bao	बैग	bao giờ= ever
barack	बराक	barack
barak	बराक	barak
barbados	बारबाडोस	(proper noun) barbados
barbara	बारबरा	barbara
barbary	बार्बरी	barbary
barca	barca	barca
barnes	बार्न्स	barnes
barone	barone	barone
baroque	बारोक	baroque
barquin	barquin	barquin, as in ramon barquin, the cuban military colonel
barrichello	barrichello	barrichello
bartholdi	bartholdi	bartholdi
baryon	बेरिऑनों	baryon
barça	बार्का	(proper noun) barca
base	आधार	base
basel	बेसल	basel, a city in switzerland
basil	तुलसी	basil
baskervilles	baskervilles	baskervilles
bass	बास	bass
bator	बतोर	bator
battambang	बट्टमबैंग	battambang
bauer	bauer	bauer
bay	मक्खी	"(should be ""tuyến bay"") an airline"
bayern	बेयर्न	bayern
bazan	बाजालत	basalt (n.)
bazơ	अड्डों	base
bb	bb	bb
bbc	बीबीसी	bbc
bc	बीसी	bc
bchtư	केंद्रीय समिति	central executive
beat	हरा	beat
beatles	बीटल्स	the beatles
beauty	सुंदरता	beauty
beckenbauer	बेकनबावर	beckenbauer, as in franz beckenbauer
becker	बेकर	(proper noun) becker
beckham	बेकहम	beckam
bedloe	bedloe	bedloe
beethoven	बीथोवेन	beethoven
beethovens	beethovens	beethoven's
beginbmatrix	beginbmatrix	this is a code
behind	पीछे	behind
beijing	बीजिंग	beijing
bel	बेल	bel
bell	घंटी	bell
bella	बेला	bella
bellatrix	बेलाट्रिक्स	bellatrix
benedict	बेनिदिक्त	benedict
benetton	बेनेटन	benetton
benfica	बेनफिका	benfica
benito	बेनिटो	benito
benjamin	बेंजामिन	(proper noun) benjamin
bennington	बेनिंगटन	bennigton
berber	हज्जाम	berber
bergen	बर्गन	(proper noun) bergen
berger	बर्जर	berger
bering	बेरिंग	(proper noun) bering, as in the bering strait
berkeley	बर्कले	(proper noun) the city of berkeley, california
berman	बर्मन	a name
bermuda	बरमूडा	(proper noun) bermuda
bernard	बर्नार्ड	bernard
bertrand	बर्ट्रेंड	bertrand
better	बेहतर	better
betty	बेट्टी	betty
bhutan	भूटान	bhutan
bia	बियर	beer (n.)
biang	biang	biang
bic	बीआईसी	bic
bikini	बिकिनी	bikini
bill	बिल	(proper noun) bill, as in former president bill clinton
billy	बील्ली	billy
bismarck	बिस्मार्क	bismarck, as in otto von bismarck
bitmap	बिटमैप्स	bitmap
biên	अभिलेख	bien
biếc	नीला सा	a bluish-green color (adj.)
biếm	हास्य चित्र	"(term should be ""biếm họa"") cartoon (n.)"
biến	परिवर्तनशील	other
biếng	आलसी	lose interest in
biếu	प्रस्ताव	present
biều	टेबल और	bieu
biển	समुद्र	ocean
biểuthứcđiềukiện	स्थितियों को जानें	conditional expression
biện	उपायों	"(term should be ""biện pháp"") a method (n.)"
biệt	विशेष	"(term should be ""khác biệt"") different or distinct"
bkavpro	bkavpro	bkavpro
blackwell	ब्लैकवेल	this is a name
blair	ब्लेयर	blair
blaise	blaise	blaise
blanc	ब्लॉन्क	blanc
blues	ब्लूज़	blues
bo	बो	a curl, as in a biceps curl exercise
bob	बॉब	bob
bobby	पुलिसमैन	bobby, as in bobby day
boeing	बोइंग	boeing
bohemia	बोहेमिया	bohemia
bolivia	बोलीविया	(proper noun) bolivia
boltzmann	बोल्ट्जमान	boltzmann
bom	बम	bomb
bonaparte	बोनापार्ट	bonaparte
bong	बुलबुला	"(term should be ""bong bóng"") a balloon (n.)"
bonnal	bonnal	bonnal
bonobo	बोनोबो	bonono
bool	bool	bool
boolean	बूलियन	(proper adjective) boolean, as in boolean algebra
boom	उछाल	boom
boong	डेक	a deck (n.)
boongke	बंकर	bunker
bop	बोप	bop
boris	बोरिस	boris
borland	borland	(proper noun) borland
borussia	बोरुसिया	borussia
bose	बोस	bose, as in subhas chandra bose
boseeinstein	boseeinstein	bose einstein
bosna	bosna	(proper noun) bosnia
bosnia	बोस्निया	(proper noun) bosnia
botswana	बोत्सवाना	botswana
bottom	तल	bottom
boulder	बोल्डर	boulder
bourbon	बर्बन	bourbon
boxing	मुक्केबाज़ी	boxing
brain	मस्तिष्क	brain
brandenburg	ब्रांडेनबर्ग	(proper noun) brandenburg
brandt	brandt	brandt
braun	ब्रौन	braun
brazil	ब्राज़िल	brazil
bremen	ब्रेमेन	bremen, as in the bremen bank
brestlitovsk	brestlitovsk	brest-litovsk
breton	ब्रेटन	(proper noun) breton
bretton	ब्रेटन	hoi nghi
brezhnev	ब्रेजनेव	brezhnev
brian	ब्रायन	a name
bridge	पुल	bridge
britannic	ब्रीटन्नीअ का	(proper noun) britannic
britney	ब्रिटनी	britney
brooklyn	ब्रुकलीन	brooklyn
brot	brot	this is german not vietnamese
brown	भूरा	brown
browne	ब्राउन	browne
browning	तमंचा	(proper noun) browning
bruce	ब्रूस	bruce
brunei	ब्रुनेई	brunei
bruno	ब्रूनो	bruno, as in the city of san bruno
brusilov	brusilov	brusilov
brussels	ब्रसेल्स	brussels, the capital of belgium
btr	btr	btr
bubalis	bubalis	bubalis
budapest	बुडापेस्ट	budapest, the capital of hungary
bulgaria	बुल्गारिया	bulgaria
bulletin	बुलेटिन	thong bao
bungary	बल्गेरियाई	bungary
bungo	बुंगो	bungo
buonaparte	buonaparte	(proper noun) buonaparte, as in casa buonaparte
burke	मना करना	(proper noun) burke, as in edmund burke
burkina	बुर्किना	burkina
burma	बर्मा	burma
burundi	बुस्र्न्दी	burundi
busan	बुसान	a korean city
busby	बस्बी	busby
bush	झाड़ी	bush
bushy	जंगली	bushy
buôn	तस्करी	commerce
buông	जाने दो	to release, to let loose
buýt	बस	bus
buốt	उत्सुक	sharp
buồm	पाल	sail
buồn	उदास	sad
buồng	मंत्रिमंडल	chamber
buổi	दिन	session
byzantine	बीजान्टिन	byzantine
bà	वह	woman or lady (n.)
bài	पोस्ट	articles
bàn	तालिका	table
bàng	ईगल	eagle
bành	पैक	armchair
bào	सेल	compatriot
bàu	bau	bau
bày	प्रस्तुत करता है	"(term should be ""trưng bày"") to display (v.)"
bác	चाचा	doctor
bách	सरो	"(term should be ""bách khoa"") polytechnic (adj.)"
bái	पंथ	to bow (v.)
bám	चिपटना	cling
bán	बेचने	sell
báng	क्रुप	"(term should be ""phỉ báng"") to defame or slander"
báo	अख़बार	newspaper (n.)
bát	कटोरा	eight (n.)
báu	खजाना	valuable
bây	अब	now
bã	तलछट	"(term should be ""buồn bã"") sad (adj.)"
bãi	पार्क	beach
bão	आंधी	storm
bèn	तो	then
bé	छोटा	baby
bén	तेज़	sharp (adj.)
béo	वसा	fat
bên	पक्ष	side
bênh	बचाव किया	advocate
bì	पैकिंग	foreskin (n.)
bìa	आवरण	cover
bìu	अंडकोश की थैली	sac (n.)
bí	कद्दू	secret
bính	पिनयिन	"(term should be ""bính âm"") romanized chinese words (n.)"
bíró	पेन	biro
bò	गाय	beef
bó	समूह	bound (adj.)
bói	भाग्य बताने वाला	to foretell (v.)
bón	उर्वरक	"entire term should be ""phan bon""; means ""fertilizer"""
bóng	गेंद	sphere or ball
bóp	निचोड़	squeeze
bô	उन्माद	"(term should be ""bôxit"") the mineral bauxite"
bôi	साबुन का झाग	to apply (as in oil)
bông	कपास	flower
bù	बना लेना	compensate
bùa	ताबीज़	talisman
bùn	कीचड़	mud
bùng	उछाल	"(term should be ""bùng nổ"") to break out (v.)"
bú	चूसना	to suck
búa	हथौड़ा	a hammer
búi	गुच्छा	tuft
bún	सिर	noodle
búng	flicking	snap
bút	लेखनी	pseudonym
băm	हैश	hash
băn	आश्चर्य	concerned
băng	बर्फ़	"(term should be ""băng giá"") freezing (adj.)"
bơ	मक्खन	"(term should be ""bơ vơ"") desolate (adj.)"
bơi	तैरना	swim
bơm	पंप	pump
bưu	डाक का	post office
bước	चरणों	a step (n.)
bướm	तितली	butterfly
bạ	निर्देशिका	directory
bạc	चांदी	meager
bạch	सफेद	"(should be ""bạch tuộc"") an octopus"
bại	पक्षाघात	defeated
bảng	तालिका	chart
bảo	सुरक्षा	protect
bảy	सात	seventh
bấm	प्रेस	press
bất	असली	"(term should be ""bất cứ"") any (adj.)"
bấy	तो	contemporary
bần	धर्मशाला	poor
bầu	निर्वाचित	vote
bầy	झुंड	servant
bẩm	जन्मजात	congenital
bẩn	गंदा	the
bẩy	फंदा	"(term should be ""lẩy bẩy"") unsteadily (adv.)"
bẫy	फंदा	a trap (n.)
bậc	हद	level or class (n.)
bận	व्यस्त	busy
bật	चालू किया	outstanding
bắc	उत्तर	beijing
bắcnam	bacnam	"(term should be ""bắc-nam"") north-south (adj.)"
bắn	शूटिंग	shoot
bắp	मकई	venter
bắt	पकड़ने के लिए	cross
bằng	बराबर	by
bẹp	कुचल	crush
bẻ	ब्रेक	break
bẽ	अपमानित	humiliate
bến	बर्थ	wharf
bếp	कुकर	kitchen
bề	सतह	"(should be ""bề mặt"") a surface"
bền	तक चलने वाले	enduring (v.)
bể	सुलभ	tank
bệ	मंच	base
bện	लट	braided (adj.)
bệnh	बीमार	benh
bỉ	बेल्जियम	disgust
bỉnh	बिन्ह	binh
bịch	बैग	ridiculous
bịt	सीलेंट	cover
bọ	बग	insect
bọc	चादर	to cover or enclose (v.)
bọn	हमें	a group (n.)
bọng	सूजन	bladder
bọt	झाग	foam
bỏ	छोड़ देना	to leave (v.)
bỏng	जलाना	hot
bố	पिता	"(term should be ""tuyên bố"") to declare"
bốc	लदान	bốc lửa= on fire
bối	दिए गए	messy
bốn	चार	four
bồi	मुआवज़ा	"(term should be ""cao bồi"") cowboy (n.)"
bổn	उत्तरदायित्व	duty
bổng	सीटी	"with word luong, means ""salary"" or ""wages"""
bỗng	अचानक	suddently
bộ	विभाग	part
bộc	चढ़ाव	"(term should be ""bộc lộ"") to reveal (v.)"
bội	विभिन्न	betray
bột	आटा	powder or flour (n.)
bớ	गोल करना	arrest
bớt	कमी	less
bờ	धार	coast
bời	बोई	profuse
bở	भुरभुरा	profitable
bởi	द्वारा	because
bục	मंच	platform
bụng	पेट	abdomen
bứt	लेखनी	"(term should be ""bứt phá"") power (n.)"
bừa	हेंगा	messy, careless, or topsy-turvy (adj.)
bữa	सुलभ	meal (n.)
bực	परेशान	bother
ca	मंत्र	praise
ca-lo	कैलोरी	a unit of measurement
cabo	काबो	cabo
cacbon	कार्बन	carbon
cacbonat	कार्बोनेट	carbonate
cacbua	carbides	carbides, carbon ions
caesar	सीज़र	caesar
caffein	कैफीन	caffeine
café	कैफे	coffee
cai	वापसी	govern
cairo	काहिरा	cairo, the capital of egypt
cal	कैलोरी	cal, a first name
calculus	गणना	calculus
calvin	केल्विन	calvin
cam	संतरे	commit
cambodia	कंबोडिया	(proper noun) the country of cambodia
cambridge	कैंब्रिज	cambridge
cameo	कैमिया	cameo part
cameron	कैमरून	cameron
cameroon	कैमरून	cameroon
camille	केमिली	camille
campbell	कैंपबेल	campbell
campuchia	campuchia	campuchia
canada	कनाडा	canada
canadian	कैनेडियन	canadian
canal	नहर	canal
canary	पीतचटकी	canary
cancer	कैंसर	cancer
canterbury	कैंटरबरी	canterbury
canxi	कैल्शियम	calcium
capello	कैपेलो	capello
capra	काप्रा	capra
carat	कैरट	carat
carbine	काबैन	carbine
cardcaptor	cardcaptor	cardcaptor
cardcaptors	cardcaptors	(proper noun) cardcaptors
carey	केरी	(proper noun) carey, as in singer mariah carey
caribe	caribe	caribbean
caribê	कैरेबियन	caribbean
carl	कार्ल	carl
carlos	कार्लोस	carlos
carnaval	कार्निवाल	carnaval
carol	तराना	carol
caroline	कैरलाइन	(proper noun) caroline
carpathia	carpathia	carpathia
carter	गाड़ीवान	carter
carxtơ	कार्स्ट	karst topography, a geological term (n.)
casa	कासा	casa
casablanca	कैसाब्लांका	casablanca
caspia	कैस्पियन	caspia
cassini	कैसिनी	cassini
cast	डाली	cast
castries	केस्ट्रीज़	castries
castro	कास्त्रो	castro, as in fidel castro
cathay	कैथे	cathay
catherine	कैथरीन	catherine
cau	cau	cau
cbc	सीबीसी	cbc
cbgd	व्याख्याता	educational  officer
cbs	सीबीएस	cbs
ccc	सीसीसी	ccc
ccn	ccn	industrial cluster
cctv	सीसीटीवी	cctv
cd	सीडी	cd
cdot	सी-डॉट	cdot
cdrom	सीडीरॉम	cd-rom
cell	सेल	cell
celtic	केल्टिक	centic
cena	सीना	(proper noun) cena, as in john cena, the wrestler
centauri	सेंतौरी	centauri
ceres	सायरस	ceres
cha	पिता	father
chai	बोतल	bottle
chaillot	chaillot	a name
chamberlain	चैमबलेन	chamberlain
champa	चंपा	champa
champion	चैंपियन	champion
chamẹ	chame	parents
chanel	चैनल	chanel
chanh	नींबू	lemon or lime (n.)
chao	चाओ	(proper noun) chao, a name
charles	चार्ल्स	charles
charlotte	चालट	charlotte
charlton	चार्लटन	charlton
charon	कैरन	(proper noun) charon
chase	पीछा	chase
chay	शाकाहारी	fasting
chdcnd	उत्तर	democratic republic
che	आवरण	cover
chechnya	चेचन्या	chechnya
chen	chen	chen
cheo	कृसियन	"(term should be ""cheo reo"") name of a town"
chi	व्यय	"(term should be ""chi tiết"") details (n.)"
chia	विभाजन	"(term should be ""chia sẻ"") to share"
chiang	च्यांग	chiang
chicago	शिकागो	chicago, as in chicago, illinois
chile	चिली	(proper noun) the country of chile
chim	पक्षी	bird
china	चीन	china
ching	चिंग	ching
chirac	शिराक	chirac, as in former french president jacques chirac
chiêm	सपना	"(term should be ""chiêm thành"") the ancient kingdom of champa in vietnam"
chiên	तला हुआ	fry
chiêng	घंटा	gong
chiếc		the
chiếm	अधिकृत	appropriate
chiến	लड़ाई	war, fight
chiết	निष्कर्षण	literal
chiếu	चटाई	show
chiền	मंदिरों	temple
chiều	शाम	length
chlamydia	क्लैमाइडिया	chlamydia
chloride	क्लोराइड	chloroauric acid
chnd	pdr	chnd
choi	चोई	choi
chomsky	चोमस्की	chomsky
chong	चोंग	chong
chopin	चोपिन	chopin
chosŏn	त्रिनिदाद का ध्वज	(proper noun) choson
choàng	ओढ़ना	coat
choáng	अचेत	dizzy
chris	क्रिस	chris, as in chris hughes
christ	ईसा मसीह	christ
christian	ईसाई	christian
christopher	क्रिस्टोफर	christopher
chrome	क्रोम	chrome, as in google chrome
chrysler	क्रिसलर	(proper noun) chrysler, the car company
chu	चक्र	cycle
chua	खट्टा	tomato
chuck	चक	(proper noun) chuck, as in chuck norris
chui	चूई	underground
chum	दोस्त	pot
chun	चुन	chun
chung	सामान्य	general
churchill	चर्चिल	churchill
chuyên	विशेष	professional
chuyến	यात्रा	trip
chuyền	वालीबाल	volleyball
chuyển	आगे	to move
chuyện	बात	nói chuyện= talk
chuôi	कष्ट	handle
chuông	घंटी	a bell
chuẩn	मानक	standard
chuốc	पूछ	incur
chuối	केले	banana
chuốt	broaching	refine
chuồng	पिंजरा	cage
chuỗi	श्रृंखला	series
chuộc	प्रायश्चित	redeem
chuộng	लोकप्रिय	favorite
chuột	माउस	a mouse (n.)
chà	रगड़	rub
chài	मछली पकड़ना	fish
chàm	नील	indigo
chàng	पुरुष	"(term should be ""chàng trai"") a young man (n.)"
chào	हाय	welcome
chày	बेसबॉल	a pestle (n.)
chánh	प्रमुख	"(term should be ""chánh án"") the head of a tribunal (n.)"
cháo	दलिया	porridge
cháu	पोते	a term one uses denoting oneself when addressing an aunt or uncle (n.)
cháy	आग	fire
châm	चुभन	motto
chân	पैर	a leg
châu	महाद्वीपीय	continental
chè	चाय	tea
chèn	डालने	insert
chém	कमी	to chop
chén	कप	bowl
chéo	पार	cross
chép	प्रतिलिपि	written
chê	लानत	decry
chênh	अंतर	difference
chì	नेतृत्व	graphite
chìa	कुंजी	"(term should be ""chìa khoá"") a key (n.)"
chìm	पनडुब्बी	to become submerged or sink (v.)
chình	एक प्रकार की मछली	eel
chí	विज्ञप्ति	especially
chích	चुभन	shoot
chín	नौ	ripe
chính	मुख्य	main
chít	चिट	dense
chò	चो	a type of plant, typically of the parashorea genus (n.)
chòi	केबिन	hut
chòm	नक्षत्र	constellation
chó	कुत्ता	dog
chóc	choc	killing (giet choc)
chói	ज्वलंत	bright
chóng	जल्दी से	"entire term should be ""chong mat""; means ""dizzy"""
chóp	चोटी	the top (n.)
chôm	chom	rambutan
chôn	दफनाना	bury
chông	पति	thorn
chùa	मंदिर	pagoda
chùy	panicles	mace
chú	चाचा	uncle (n.)
chúa	भगवान	god
chúc	इच्छा करने के लिए	will
chúi	डुबकी	drop
chúng	वे	they
chút	थोड़ा सा	little
chăm	ध्यान रखना	champa
chămpa	चंपा	champa
chăng	सस्ती	would it
chĩa	नुकीला	point
chơi	खेलने	play
chơn	चोन	"a more obscure form of the word ""chân""; means ""genuine"" or ""true"""
chư	जागीरदार	lower authorities
chưa	अभी तक नहीं	not yet
chưng	आसवन	steamed
chương	प्रदर्शन	medal
chướng	बाधा कोर्स	grating
chạ	संकीर्णता	father
chạm	स्पर्श	touch
chạng	चांग	twilight
chạp	सुस्त	slow
chạy	रन	to run (v.)
chả	रोल	no
chảo	कड़ाही	pan
chảy	गलन	bleeding
chấm	डॉट	end
chấp	स्वीकार	"(term should be ""chấp nhận"") to accept (v.)"
chất	बात	quality
chấu	पिन	"(term should be ""châu chấu"") a grasshopper (n.)"
chần	blanched	slice
chẩn	नैदानिक	"(term should be ""chẩn đoán"") to diagnose (v.)"
chậm	धीमा	slow
chận	अवरुद्ध	block
chật	तंग	overcrowded
chậu	पॉट	pelvic
chắc	यकीन	certainly
chằng	पलकें	ligament
chẵn	समानता	even
chặn	अवरुद्ध	prevent
chặng	पैर	journey
chặt	काटना	close
chẻ	विभाजन	strick
chẽ	पास	"(term should be ""chặt chẽ"") tightly or closely (adv.)"
chế	प्रसंस्करण	produce
chếch	बारी	oblique
chết	मृत	to die (v.)
chệch	विचलित	deviant
chỉ	प्रदर्शन	just (adv.)
chỉnh	सुधार	adjust
chịt	इंटरलेस्ड	chằn chịt= complex/tangle
chịu	भालू	tolerate
chọc	को छेड़ा,	to poke
chọi	लड़ाई	oppose
chọn	चुनना	to choose
chỏ	कोहनी	"(term should be ""cùi chỏ"") elbow (n.)"
chốc	पल	single
chối	इनकार	refuse
chốn	जगह	place
chống	लड़ाई	anti-
chốt	कुंडी	important
chồi	गोली मारता है	"(term should be ""đâm chồi"") budding"
chồn	लोमड़ी	anxious
chồng	पति	husband
chỗ	सीट	where
chội	यम-यम	cramped
chớ	मत करो	not
chớp	प्रकाश	flashing (adj.)
chờ	इंतजार	to wait
chở	कैरी	for
chợ	बाजार	market
chợt	अचानक	suddenly
chục	दर्जन	dozen
chụp	शूटिंग	capture
chủ	स्वामी	"(term should be ""chủ yếu"") main or essential (adj.)"
chủng	तनाव	strain
chứ	बल्कि	just or only (adv.)
chứa	शामिल	contain
chức	अधिकारियों	function
chừ	पिच	hesitate
chừa	छुट्टी	leave
chừng	कुछ	about or roughly (adv.)
chử	चू	"(term should be ""chử bích"") the vietnamese name for a chinese island"
chửa	गर्भावस्था	pregnant
chửi	मौखिक रूप से	curse
chữ	शब्द	a letter of the alphabet (n.)
chữa	इलाज	to cure or treat (v.)
chững	समतल	to totter (v.)
cia	सीआईए	cia
cincinnati	सिनसिनाटी	cincinnati
cinderella	सिंडिरेल्ला	cinderrella
cip	सीआईपी	cip
circus	सर्कस	circus
cities	शहरों	cities
clara	क्लारा	clara
clark	क्लार्क	clark
claude	क्लाउड	(proper noun) claude
claudius	क्लोडिअस	(proper noun) claudius
clinton	क्लिंटन	clinton, as in former president bill clinton
clip	क्लिप	clip
clips	क्लिप	clips
clo	क्लोरीन	chlorine
clow	स्लूस का द्वार	clow
clyde	क्लाइड	(proper noun) clyde, as in bonnie and clyde
cmc	सीएमसी	cmc
cmt	cmt	cmt
cn	cn	christian era
cnet	cnet	cnet
cntb	पूंजीवाद	capitalism
cntt	cntt	it
cnxh	cnxh	social republic
co	सह	spasm
coburn	कोबर्न	coburn
cocoa	कोको	cocoa
coen	कोएन	coen
coffea	coffea	coffee
cohen	कोहेन	cohen
coi	माना	to regard
coleen	कोलीन	coleen
coleman	कोलमैन	coleman
coli	कोलाई	coli
colin	कॉलिन	(proper noun) colin, as in colin powell
colleen	कोलीन	colleen
college	कॉलेज	college
collins	कोलिन्स	(proper noun) collins
collège	कॉलेज	college (n.)
colombia	कोलंबिया	colombia
colombo	कोलंबो	(proper noun) colombo
colorado	कोलोराडो	(proper noun) colorado, as in the state
columbus	कोलंबस	columbus
comic	हास्य	comic
common	सामान्य	common
concacaf	concacaf	concacaf
concerto	concertos	concerto
concorde	कॉनकॉर्ड	concorde
condom	कंडोम	condom
cong	वक्र	curved or bent
congo	कांगो	congo
congress	सम्मेलन	congress, as in library of congress
connecticut	कनेक्टिकट	connecticut
conrad	कॉनरोड	corrad
conservation	संरक्षण	conservation
constantine	constantine	constantine
contemporary	समकालीन	contemporary
cooper	कूपर	(proper noun) cooper
copenhagen	कोपेनहेगन	copenhagen
copernic	copernic	corpernic
copperfield	कॉपरफील्ड	(proper noun) copperfield, as in magician david copperfield
coppola	कोपोला	coppola
copy	प्रतिलिपि	copy
cordyceps	cordyceps	cordyceps
core	कोर	core
cornell	कॉर्नेल	cornell
cosin	कोज्या	cosine
costa	कोस्टा	costa
cotang	cotangent	cotangent
cpt	cpt	cpt
craig	क्रेग	(proper noun) craig
crazy	पागल	crazy
crespo	क्रेस्पो	(proper noun) crespo
crest	शिखा	crest
crew	कर्मीदल	crew
crimson	गहरा लाल	crimson
crisis	संकट	crisis
cristiano	क्रिस्टियानो	cristiano, as in portuguese soccer player cristiano ronaldo
croatia	क्रोएशिया	croatia
cross	पार	cross
crs	सीआरएस	crs
cruz	क्रूज़	cruz
cruzeiro	क्रुजेरो	cruzeiro
crystal	क्रिस्टल	crystal
ctc	सीटीसी	ctc
cua	केकड़ा	crab (n.)
cullen	कलन	a name
cung	सप्लाई	circle
cunningham	कनिंघम	cunningham; proper name
cup	कप	cup
cuả	की	of, from, belonging to
cuốc	चुनना	hoe
cuối	अंतिम	last or final (adj.)
cuốn	रोल	book
cuống	डंठल	throat
cuồng	मनमौजी	crazy (adj.)
cuộc		the
cyanide	साइनाइड	cyanide
cyber	साइबर	cyber
cyril	सिरिल	(proper noun) cyril
cyrus	साइरस	cyrus
cyworld	साईवर्ल्ड	cyword
cà	कॉफ़ी	ca
cài	स्थापित	install
càn	छापा	raid
càng	अधिक	cang
cành	कील	branch
cào	पंजा	scratch
cày	जुताई	plow
các		all (adv.)
cách	रास्ता	the
cái		"(term should be ""con cái"") children (n.)"
cán	रोलिंग	"(should be ""cán bộ"") an officer, especially in a communist regime"
cánh	विंग	wing
cáo	लोमड़ी	report
cáopx|bình	cáopx | औसत |	not a word
cáp	केबल	cable (n.)
cáy	सारंगी बजानेवाला	fiddler
câm	गूंगा	mute (adj.)
cân	तराजू	weight
câu	v	saying
cãi	लोगों का तर्क है	argue
cò	सारस	stork
còn	अब तक	to have left (v.)
có	है	have
cói	समुद्री घास	machine
cót	bamboomat	cot
cô	चाची	girl
côi	पितृहीन	orphaned
côn	कीट	a stick (n.)
công		worker
côngtenơ	पात्र	container
cõi	लोकों	entire area
cõng	पिग्गीबैक	piggyback
cù	मेहनत	cu
cùi	कोढ़ी	leprosy
cùng	और	together
cú	शॉट	old
cúi	धनुष	to bow (v.)
cúm	फ़्लू	cum
cúng	प्रसाद	worship
cúp	कप	cup (n.)
cút	बाहर निकलो	to kick someone out (v.)
căm	में प्लग किया गया	detest (cam thu)
căn	अपार्टमेंट	"(term should be ""căn bệnh"") cause of a disease (n.)"
căng	तनावपूर्ण	tense
cũ	पुराना	old
cũi	पालना	kennel
cũng	साथ ही	also
cơm	चावल	rice
cư	आवासीय	resident
cưa	काटने का कार्य	saw
cưng	प्रिय	also
cước	प्रभार	megaman
cưới	शादी	marry
cướp	लूटना	to rob (v.)
cười	हंसी	smile
cường	तीव्रता	strengthen
cưỡi	सवारी	ride
cưỡng	मजबूर	force some body to do some thing. cưỡng dâm=rape
cạc	कार्ड	card (n.)
cạn	सूखा	shallow
cạnh	धार	"(term should be ""khía cạnh"") an angle"
cạo	स्ट्रिपर्स	shave
cạp	लेगिंग	scorpion
cả	दोनों	both
cải	सुधार	reform
cảm	ठंड	pleasure
cản	निकासी	prevent
cảng	बंदरगाहों	port
cảnh	स्थल	situation
cảo	डांड़ी	posthumous
cấm	निषिद्ध	ban
cấn	दिल	dramatic
cấp	ग्रेड	level or rank (n.)
cất	निर्माण	"(term should be ""cất giữ"") to keep safe or store"
cầm	पकड़	to hold (v.)
cần	ज़रूरी	need
cầu	पुल	request
cầy	सीविट	farmed
cẩn	सावधान रहो	carefully
cẩu	क्रेन	"(term should be ""hải cẩu"") a seal (n.)"
cận	पहुंच	close
cập	अद्यतन	mention
cậu	उसकी	a young man (n.)
cậy	भरोसे का	reliable
cắm	में प्लग करें	to plant (v.)
cắn	काटना	to bite
cắp	चोरी	steal
cắt	कमी	cut
cằm	ठोड़ी	chin
cằn	कर सकते हैं	exhausted (adj.)
cặp	जोड़ा	couple
cọ	हथेली	rub
cọc	जमा	pile
cọp	बाघ	tiger
cỏ	घास	plant
cố	कोशिश	"(term should be ""cố gắng"") to try one's best (v.)"
cốc	कांच	cereal
cối	मोर्टारों	mortar
cốm	कॉम	grilled rice
cống	नाली	dedicate
cồn	शराब	i
cồng	घंटा	gong
cổng	गेट	gate
cỗ	डेक	engine
cỗi	बांझ	barren
cộ	ढोने का	"(term should be ""xe cộ"") cars or vehicles (n.)"
cội	जड़ों	origin
cộng	समुदाय	to add (v.)
cột	स्तंभ	pole
cớ	बहाना	excuse
cờ	शतरंज	flag
cỡ	आकार	size
cợt	मज़ा	"(term should be ""đùa cợt"") to trifle (v.)"
cục	विभाग	department
cụm	समूह	cluster
cụp	बह	down
cụt	पेंगुइन	"(should be ""xương cụt"") the tailbone or coccyx"
củ	कंद	a bulb, a botanical term
của	की	of
củi	जलाऊ लकड़ी	firewood
củng	वृद्धि हुई	reinforce
cứ	अपने	any
cức	अप्रमाणित ब्लॉक	"(term should be ""cức Đê"") a character in chinese history"
cứng	कठिन	hard
cứngi	cungi	cungi
cừ	धन	nacre
cừu	भेड़ का बच्चा	sheep
cửa	दरवाजा	door
cửu	गुणन	nine
cữ	कारावास	abstinence
cữu	सनातन	nine
cự	फोकस	against
cựa	अरगट	retreat
cực	खंभा	extreme
cựu	भूतपूर्व	former
d	घ	d.
da	चमड़ा	skin
daegu	डेगू	daegu
dahl	डाहल	(proper noun) dahl, as in author roald dahl
dai	कड़ा	persistent
daily	दैनिक	daily
dakota	डकोटा	dakota, as in the state of south dakota
dalat	dalat	da lat
dampier	डैम्पियर	(proper noun) dampier, a last name
dan	सज्जन	dan
dancing	नृत्य	dancing
danger	ख़तरा	danger
danh	नाम	list
daniel	डैनियल	daniel
dante	डांटे	dante
dao	चाकू	poniard
darwin	डार्विन	darwin
das	दास	das
dassault	डासौल्ट	(proper noun) dassault
date	तिथि	date
dau	दाउ	dau
dave	डेव	(proper noun) dave, as in dave sexton
david	डेविड	david, as in david thomas
davies	डेविस	davies
davis	डेविस	davis
dbsk	dbsk	dbsk
dc	डीसी	d.c.
ddr	डीडीआर	ddr
dean	डीन	a name
degree	हद	degree
delhi	दिल्ली	delhi
delphi	डेल्फी	(proper noun) delphi, as in the oracle
demeter	demeter	(proper noun) demeter, the greek goddess of the harvest
den	मांद	den
dennis	डेनिस	dennis
department	विभाग	departmen
derek	डेरेक	derek
des	डेस	des
descartes	डेसकार्टेस	descartes
design	डिज़ाइन	thiet ke
deuterium	ड्यूटेरियम	deuterium
deutschland	deutschland	deutschland
dewan	दीवान	dewan, as in dewan rakyat
dewitt	डेविट	(proper noun) dewitt, as in rose dewitt bukater
di	सेल	move
diana	डायना	(proper noun) diana, as in diana ross
die	मरना	german
diego	डिएगो	diego
dien	डिएन	"(term should be ""Điện biên phủ"") a city in northwestern vietnam where a famous battle took place during the vietnam war"
dimaggio	dimaggio	gimaggio
dinh	मुख्यालय	official residence or palace
dionysus	dionysus	dionysus, as in the greek god
discovery	खोज	discovery
discussion	विचार-विमर्श	discussion
disneyland	डिज्नीलैंड	disneyland
division	विभाजन	division
divoire	divoire	d'lvoire
diêm	माचिस	diem vuong
diên	diên	"(term should be ""kinh diên"") canon (n.)"
diềm	लैंबेड़कीन	matches
diều	पतंग	kite
diểu	स्वांग	(proper noun) diểu
diễm	diễm	beauty; a common vietnamese first name for women
diễu	जुलूस	parade
diệc	बगला	a heron (n.)
diệm	डिएम	(proper noun) diệm, as in ngô Đình diệm, former president of south vietnam
diện	व्यापक	face to face
diệt	निष्कासन	to kill or destroy (v.)
diệu	जादू	effective (adj.)
djibouti	जिबूती	djibouti, a country in africa
djokovic	जोकोविच	(proper noun) djokovic, as in novak djokovic
dm	dm	dm
dmitri	दमित्री	dmitri
dna	डीएनए	dna
do	द्वारा	because of
doanh	व्यापार	"(term should be ""kinh doanh"") business (n.)"
doc	दस्तावेज़	doc
docherty	डोकर्टी	docherty
dolly	नादान	(proper noun) dolly, as in singer dolly parton
dome	गुंबद	nha
dominican	डोमिनिकन	(proper noun) dominican, as in the dominican republic
don	डॉन	(proper noun) don
donau	डेन्यूब	donau
dortmund	डॉर्टमुंड	(proper noun) dortmund
dougherty	dougherty	dougherty
douglas	डगलस	douglas
dover	डोवर	(proper noun) dover, as in the capital of delaware
doyle	डोयले	doyle
doãn	डोआन	doan
doạ	धमकी दी	threat
dp	डी पी	dp
dracula	ड्रेकुला	dracula
draft	मसौदा	draft
drake	मक्खी	(proper noun) drake
driver	ड्राइवर	a name
ds	डी एस	ds
dtd	dtd	dtd
dth	डीटीएच	dth
du	यात्रियों	travel
dubai	दुबई	dubai
duiker	डुइकर	duiker
duk	डुक	duk
dumas	dumas	dumas
dumbledore	डंबलडोर	dumbledore
dung	क्षमता	portrait
durham	डरहम	durham
dursley	डर्स्ली	dursley
duy	केवल	only
duyên	तट	coastal
duyện	yanzhou	fellatio
duyệt	अनुमोदन	browser
duơng	सराहना	ocean
duẩn	डुआन	duan
duật	duat	duat
duệ	वंशज	descendants (n.)
duỗi	प्रसारक	stretch
dwight	ड्वाइट	dwight
dà	दा	gradually
dài	लंबे समय तक	to lengthen, as in time
dàn	ऑर्केस्ट्रा	to arrange
dàng	आसान	dang
dành	आरक्षित	for
dào	dào	"complement to word ""doi""; entire phrase ""doi dao"" means ""plentiful"""
dày	गाढ़ा	thick
dái	दाई	"penis (n.), although some may use the term to mean ""testicles"""
dám	करने की हिम्मत	dare
dán	पेस्ट	stick
dáng	आकार	appearance
dát	जड़े	inlay
dâm	लिंग	lustful (adj.)
dân	लोग	people
dâng	समर्पित	dedicate
dây	रस्सी	nerve
dã	वन्यजीव	chronicle
dãi	सहनशीलता	band
dãn	फैलाव	extend
dãy	पंक्ति	a row (n.)
dè	सावधान रहो	tight
défense	डिफैंस	defense
dép	हवाई चप्पलें	slipper
dê	बकरा	goat
dì	चाची	aunt
dìu	दीव	to lead by the hand (v.)
dính	चिपचिपा	stick
dò	जांच	(with word tham) to survey
dòm	व्यक्त एक	snoop
dòng	वर्तमान	"(term should be ""dòng họ"") family (n.)"
dó	poonah	a type of plant used to make paper in vietnam (n.)
dông	आंधी	a storm (n.)
dõi	सदस्यता लें	monitor
dù	यद्यपि	though
dùi	आलोचना करना	awl
dùng	उपयोग	use
dăm	कुचल	"(term should be ""đá dăm"") pebbles (n.)"
dĩ	बेशक	why
dĩa	चक्र	dish
dũng	साहस	courage
dơ	अशुद्ध	dirty
dơi	चमगादड़	bat
dư	अवशिष्ट	remnant
dưa	ख़रबूज़े	melons
dưng	अचानक	suddently
dương	सकारात्मक	penis
dường	लगता है	seem
dưỡng	नर्सिंग	feed
dược	दवा	having to do with medicine (adj.)
dượng	चाचा	uncle
dạ	हां	night
dại	पागल	stupid or idiotic (adj.)
dạn	साहसी	"(term should be ""dày dạn"") to be accustomed to, especially some sort of difficult situation (adj.)"
dạng	आकार	tyoe
dạo	घूमना	vending
dạt	धुल गया	to drift
dạy	सिखाने	teach
dải	पट्टी	range
dấm	सिरका	vinegar
dấp	पिटाई	shape
dấu	संकेत	signal
dấy	वृद्धि	to raise (v.)
dần	धीरे-धीरे	people
dầu	तेल	oil
dẫm	चाल	step on
dẫn	गाइड	to lead
dẫu	यद्यपि	though
dận	मार पड़ी है	to step on
dậu	मुरग़ा	rooster
dậy	उठो	"(term should be ""dậy thì"") pubescent (adj.)"
dắt	गाइड	lead
dằn	गिट्टी	"(term should be ""dằn lòng"") to hold yourself in (v.)"
dằng	अनंत	dằng dai= long/endless
dẳng	अनंत	persist
dặm	मील	mile
dặn	आज्ञा	to advise (v.)
dặt	आरक्षित	conservative
dẹp	बाहर फ्लैट	pacify
dẹt	समतल	flat
dẻ	गोलियां	chestnut
dẻo	plasticizer	flexible
dế	क्रिकेट	cricket
dền	अम्लान रंगीन पुष्प का पौध	beetroot
dể	आसान	easy
dễ	आसान	easy
dệt	बुनाई	textile
dị	आतंक	simple
dịch	अनुवाद करना	semen
dịp	अवसरों	occasion
dịu	शांत करना	ease
dọa	धमकी दी	to threaten or scare (v.)
dọc	खड़ा	along
dỏm	डोम	witty
dốc	पहाड़ी	slope
dối	झूठा	lie
dốt	बेवक़ूफ़	stupid or ignorant (adj.)
dồi	सॉसेज	"(term should be ""trau dồi"") improve (v.)"
dồn	कोनों	accrue
dỗ	समाक्ष	dirty
dời	विस्थापन	leave
dở	बुरा	incomplete
dỡ	उतराई	remove
dụ	उदाहरण के लिए	example
dục	फिटनेस	sexuality
dụng	इसके	use
dứa	अनानास	pineapple
dứt	अंत	to cease
dừa	नारियल	coconut (n.)
dừng	बंद	to cease
dữ	डेटा	"(term should be ""giận dữ"") anger (n.)"
dự	अनुमान	attend
dựa	आधारित	base on
dực	एक आधारित	dực, as in lê tương dực
dỹ	उप	dy
e	ई	e.
ea	ईए	(proper noun) ea, as in ea kao
earles	अर्लेस	earles
eaton	ईटन	eaton
ebro	ebro	a name
ecmascript	ecmascript	ecmascript
ecw	ईसीडब्ल्यू	ecw
edda	edda	(proper noun) edda
edgar	एडगर	edgar, as in author edgar allan poe (n.)
edge	धार	edge
edinburgh	एडिनबर्ग	(proper noun) edinburgh, as in edinburgh, scotland
edison	एडिसन	edison
editor	संपादक	editor
edmond	एडमंड	edmond
edo	ईदो	edo
edward	एडवर्ड	edward
edwin	एडविन	edwin
eea	ईईए	eea
efron	एफ्रोन	efron, as in zac efron
egypt	मिस्र	egypt
eid	ईद	(proper noun) eid
eiffel	एफिल	eiffel
einstein	आइंस्टीन	einstein
eisenhower	आइजनहावर	eisenhower, as in former president dwight d. eisenhower
ekaterina	एकातेरिना	this is a name
elbe	एल्बे	(proper noun) the elbe river
electronic	इलेक्ट्रोनिक	electronic
eliane	एलिएन	(proper noun) eliane
elip	अंडाकार	ellipse
elizabeth	एलिज़ाबेथ	elizabeth
ellen	एलेन	ellen
ellis	एलिस	a name
elton	एल्टन	(proper noun) elton, as in elton john
elvis	एल्विस	elvis
elíp	अंडाकार	ellipse
em	बच्चे	younger sibling
email	ईमेल	email
emily	एमिली	(proper noun) emily, as in emily dickinson
emir	अमीर	emir
emmy	एमी	emmy
en	en	erica reef
energy	शक्ति	energy
engels	एंगेल्स	engels
england	इंगलैंड	(proper noun) england, as in new england
eniac	eniac	eniac
entente	अंतंत	entente
entropy	एन्ट्रापी	entropy
enzym	एंजाइमों	enzymes
eo	कमर	eo, as in the film captain eo
ep	ईपी	a name
erich	erich	erich
erik	एरिक	erik, as in erik moller
eris	एरीस	eris
eritrea	इरिट्रिया	eritrea
ernest	अर्नेस्ट	(proper noun) ernest
eros	एरोस	eros, greek god of love
erwin	इरविन	(proper noun) erwin, as in erwin rommel
españa	españa	espana
essential	आवश्यक	essential
ethernet	ईथरनेट	ethernet
ethiopia	इथियोपिया	(proper noun) ethiopia
euclid	यूक्लिड	euclid
eugene	यूजीन	eugene
eugène	यूजीन	(proper noun) eugène
euler	यूलर	euler
euro	यूरो	euro, as in the european currency
eurofighter	यूरोफाइटर	eurofighter
europe	यूरोप	europe
european	यूरोपीय	(proper adjective) european
eva	ईवा	eva
everton	एवर्टन	everton
every	प्रत्येक	every
exgay	exgay	exgay
explorer	एक्सप्लोरर	explorer
extensive	व्यापक	extensive
fabio	फैबियो	(proper noun) fabio
facebook	फेसबुक	(proper noun) facebook
fact	तथ्य	fact
facto	वास्तविक	this is french not vietnamese
faifo	faifo	(proper noun) faifo
fao	एफएओ	fao
farrell	फैरेल	farrell
faso	फासो	faso
fbi	एफबीआई	fbi
fca	एफसीए	fca
fdi	प्रत्यक्ष विदेशी निवेश	fdi
features	सुविधाओं	features
federer	फेडरर	federer
feet	पैर	feet
felipe	फेलिप	felipe
felis	फेलिस	(proper noun) felis
felix	फेलिक्स	(proper noun) felix, as in felix klein
ferb	ferb	ferb
ferdinand	फर्डिनेंड	ferdinand
ferguson	फर्ग्यूसन	ferguson
fernando	फर्नांडो	fernando
ferrari	फेरारी	ferrari
fiat	व्यवस्थापत्र	fiat
fidel	फिदेल	fidel
field	क्षेत्र	field
fifa	फीफा	fifa
fifpro	fifpro	fifpro
figo	फिगो	figo
fiji	फिजी	fiji
finish	अंत	finish
firefox	फ़ायरफ़ॉक्स	(proper noun) mozilla firefox
fischer	फिशर	fischer, as in louis fischer
fish	मछली	fish
fishbed	fishbed	fishbed
fitzgerald	fitzgerald	(proper noun) fitzgerald
flanker	गढ़	flanker
fleming	फ्लेमिंग	fleming
flight	उड़ान	flight
foch	फोच	(proper noun) foch
focus	फोकस	focus
foden	foden	(proper noun) foden, as in tom foden
fokker	फोकर	fokker
food	भोजन	food
football	फ़ुटबॉल	bong da
forbes	फोर्ब्स	(proper noun) forbes, as in the magazine
ford	पायाब	(proper noun) ford
fordham	फोर्धम	(proper noun) fordham
forks	कांटे	forks
foundation	आधार	foundation
fox	लोमड़ी	fox
fpt	एफ़टीपी	a company name in vietnam
fracsin	fracsin	a function
franc	फ्रैंक	franc
france	फ्रांस	france
frances	फ्रांसिस	frances
francis	फ्रांसिस	francis, as in francis xavier
francisco	फ्रांसिस्को	francisco
franco	फ्रेंको	franco
frank	खुलकर	frank
frankfurt	फ्रैंकफर्ट	(proper noun) frankfurt
franklin	फ्रेंकलिन	franklin
franz	फ्रांज	(proper noun) franz, as in franz ritter
freud	फ्रायड	(proper noun) freud, as in sigmund freud
friedman	फ्राइडमैन	friedman
fu	फू	fu
fujiko	fujiko	fujiko, as in japanese writer fujiko fujio
fujimoto	fujimoto	fujimoto
fukuoka	फुकुओका	fukuoka
funimation	फनिमेशन	(proper noun) funimation
funk	दुर्गंध	funk
futsal	फुटसल	futsal
fx	fx	fx
ga	गा	station
gabon	गैबॉन	gabon
gabriel	गेब्रियल	gabriel
gabriella	गैब्रिएला	gabriella
gagarin	गागरिन	gagarin
gaia	गैया	gaia
gaillard	गैलार्ड	gaillard
galilei	गैलीली	galilei
galileo	गैलीलियो	galileo, the astronomer
gam	गम	gam
gambia	गाम्बिया	gambia
gamow	gamow	a name
gan	जिगर	liver
gandhi	गांधी	gandhi, as in mahatma gandhi
gang	कच्चा लोहा	cast iron
ganh	विवाद	to be jealous
gao	गाओ	strictly
gareth	गैरेथ	a name
garrett	गैरेट	garrett
gary	गैरी	gary
gascon	डींगमार	(proper noun) gascon, a dialect of france
gatt	गैट	gatt
gaule	फ्रांसीसी	gaul, a region in ancient western europe
gaulois	gaulois	gaulois
gay	समलैंगिक	tense
gaza	गाजा	gaza
gdańsk	डांस्क	(proper noun) gdansk, poland
gdp	सकल घरेलू उत्पाद	gdp
geisha	गीशा	geisha
gen	जीन	gene
gene	जीन	(proper noun) gene, an english first name
genesis	उत्पत्ति	(proper noun) genesis
georg	जोर्ज	(proper noun) georg
george	जॉर्ज	george
georges	जार्ज	(proper noun) georges, a french name
gepard	gepard	gepard
ger	जर	ger
gerais	गेरैस	(proper noun) gerais
gerhard	गेरहार्ड	gerhard
german	जर्मन	german
germany	जर्मनी	germany
gerrard	गेरार्ड	gerrard, a last name
ghana	घाना	(proper noun) the african country of ghana
ghe	wherry	canoe
ghen	ईर्ष्या	to be jealous (v.)
ghi	अभिलेख	write
ghim	पिन	pin
ghé	आगंतुकों	visit
ghép	में शामिल होने के	fit
ghê	सीटों	disgust
ghì	दबाया	tighten
ghẻ	नीच	scabies (n.)
ghế	सीट	chair
ghề	असभ्य	scabby
ghềnh	उतार	waterfall (n.)
gia	परिवार	date
giai	अवधि	period
giam	जेल	imprison
gian	समय	"(term should be ""thời gian"") time (n.)"
giang	ग्यांग	syphilis
gibraltar	जिब्राल्टर	(proper noun) gibraltar
gichin	गिचिन	gichin
gieo	बीज बोना	sow
gifu	gifu	gifu, a district in northern japan
ginzan	ginzan	ginzan
gio	gio	wind
gioi	gioi	world
giuliani	गियूलियानी	giuliani
giun	कीड़े	worm
giuse	यूसुफ	giuse
giuộc	जैसे लोग	"entire term should be ""can giuoc""; name of a vietnamese town"
giza	गीज़ा	giza
già	पुराना	old (adj.)
giàn	पाड़	"(term should be ""giàn hoa"") a trellis girder"
giành	वोन	secure
giàu	धनी	rich or wealthy (adj.)
giày	जूता	a shoe
giá	कीमत	estimate
giám	निदेशक	"(term should be ""giám sát"") to supervise (v.)"
gián	तिलचट्टे	"(term should be ""gián tiếp"") indirectly"
giây	सेकंड	seconds
giã	अलविदा	"(term should be ""từ giã"") to say farewell to (v.)"
giãn	आराम	stretch
gièm	रूढ़िबद्धता	"(should be ""gièm pha"") to backstab"
giêhôva	जेनोवा	jehovah
giêng	जनवरी	january
giêsu	giêsu	jesus
giêxu	यीशु	jesus
giò	स्प्रिंग रोल	leg
giòi	कीड़ों	maggot (n.)
giòn	कुरकुरे	crunchy or crispy (adj.)
gió	हवा	wind
gióng	कल्म	align
giúp	मदद	help
giũa	दाखिल	sharpen
giơ	जाम	raise
giương	बढ़ाया	posture
giường	बिस्तर	bed
giả	झूठा	fake (adj.)
giải	समाधान	solution
giảm	कमी	decrease
giản	सरलीकृत	"(term should be ""giản dị"") simple (adj.)"
giấc	सपना	giấc ngủ= the sleep
giấm	सिरका	drabble
giấu	छिपाने	hide
giấy	कागज़	paper
giầu	धनी	rich
giận	क्रोधित	angry
giằng	ब्रेसिंग	pull
giặc	दुश्मन	enemy
giặt	धुलाई	to wash (n.)
giếng	कुआँ	well
giết	मार	kill
giềng	पड़ोसियों	"(term should be ""láng giềng"") neighboring"
giễu	उपहास	ridicule
giọng	उच्चारण	tone
giọt	ड्रॉप	drop
giỏ	टोकरी	basket
giỏi	अच्छा	good
giồng	टीले	mound
giỗ	पुण्यतिथि	anniversaries of deaths
giới	दुनिया	gender
giờ	घंटा	bao giờ=ever
giở	उठा लिया	to open or unfold (v.)
giỡn	मजाक कर रहा	joke
giục	शीघ्र	urge
giữ	पकड़े रहो	hold
giữa	के बीच	between
gladys	ग्लेडिस	gladys
glazer	ग्लेज़र	glazer
glonass	ग्लोनास	glonass
gloria	ग्लोरिया	gloria
gloster	ग्लॉस्टर	(proper noun) gloster, as in gloster meteor
glucose	शर्करा	glucose
gmail	जीमेल	gmail
gnp	जीएनपी	gnp
go	जाने	"(term should be ""gay go"") tense"
goes	चला जाता है	goes
goku	गोकू	goku
golden	सोने का	golden
gom	समेकन	to gather (v.)
google	गूगल	google
gorbachev	गोर्बाचेव	gorbachev
gorbachyov	गोर्बाचेव	gorbachev, as in former soviet president mikhail gorbachev
gordon	गॉर्डन	gordon, as in gordon brown
gore	तिकोना कपड़ा	gore
gorky	गोर्की	gorky, as in gorky park
gothic	गोथिक	gothic
gottfried	गोटफ्राइड	gottfried
grabeel	grabeel	grabeel, a last name
graham	ग्राहम	graham
granada	ग्रेनेडा	granada
granit	ग्रेनाइट	granite
greek	यूनानी	(proper noun) greek
greenland	ग्रीनलैंड	greenland
greenson	greenson	(proper noun) greenson
greenwich	ग्रीनविच	(proper noun) greenwich
greg	ग्रेग	greg
grenada	ग्रेनेडा	grenada
grenadines	ग्रेनेडाइंस	grenadines
gross	कुल	gross
grumman	grumman	(proper noun) grumman
gruzia	जॉर्जिया	gruzia
gryffindor	ग्राईफिंडर	gryffindor
gs	gs	prof.
gsts	प्रोफ़ेसर	professor- phd
gu	gu	gu
guam	गुआम	guam
guard	गार्ड	guard
guatemala	ग्वाटेमाला	guatemala
gui	जीयूआई	gui
guinea	गिन्नी	guinea
guinness	गिनीज	(proper noun) guinness
guitar	गिटार	guitar
gujarat	गुजरात	gujarat
gulag	गुलाग	gulag
gulf	खाड़ी	gulf
gullit	गुलिट	(proper noun) gullit
gundam	gundam	(proper noun) gundam
gunung	गुनुंग	(proper noun) gunung
gustave	गुस्ताव	gustave
gutenberg	गुटेनबर्ग	gutenberg
guyana	गुयाना	guyana; proper noun
gà	चिकन	chicken
gài	टक	to fasten (v.)
gào	चिल्लाया	"(term should be ""thét gào"") to cry out (v.)"
gác	ऊपर	guard
gái	लड़की	girl
gán	सौंपा	"entire phrase should be ""gan nhan""; means ""to label"""
gánh	बोझ	hold
gáy	डब	crow
gân	पट्टा	tendon
gây	कारण	make
gãy	भंग	break
gì	क्या	what
gìn	की रक्षा	preserve
gò	पहाड़ी	"(term should be ""gò má"") cheekbone (n.)"
gòn	gòn	gon
góa	विधवा	widowed
góc	कोना	angle
gói	पैकेज	goi
góp	योगदान	to contribute
gót	हील	heels
gõ	दस्तक	type
göbbels	gobbels	gobbels, as in joseph gobbels
găm	कटार	poniard
găng	दस्ताने	gloves
gũi	अनुकूल	close
gươm	तलवार	sword
gương	आईना	mirror
gạc	धुंध	johnson south reef
gạo	चावल	rice
gạt	चीर दिया	to cheat or trick (v.)
gả	शादी	marry
gảy	ब्रेक	"(term should be ""âm gảy"") a type of phonetic sound found in the japanese language (n.)"
gấc	गाक	gac
gấm	गम	brocade
gấp	तत्काल	times, as in many times
gấu	भालू	a bear (n.)
gần	पास	near
gầy	पतला	thin
gẫy	भंग	break
gập	तह	"(term should be ""gập ghềnh"") bumpy (adj.)"
gậy	छड़ी	stick
gắm	गाम	send
gắn	लागू	mount
gắng	को	try
gắt	झुलसानेवाला	intense
gặm	दांत से काटना	rodent
gặp	मिलना	meet
gặt	काटना	harvest
gỉ	स्टेनलेस	rust
gọi	कॉल	call
gọn	कम	neat (adj.)
gọng	rimmed	gong
gọt	छीलना	cut
gỏi	सलाद	a vietnamese salad
gốc	माता-पिता	origin (n.)
gối	तकिया	"(should be ""qùy gối"") to kneel"
gốm	मिट्टी के बर्तनों	pottery
gồm	सहित	include
gồng	घंटा	carry
gỗ	लकड़ी	wood
gội	शैम्पू	shampoo
gộp	कुल	aggregate
gớm	घृणा करना	tremendous
gờ	हद	edge
gởi	भेजने	send
gỡ	स्थापना रद्द करें	meet
gợi	शीघ्र	to evoke (v.)
gục	नीचे	"(term should be ""đánh gục"") crush, as in battle"
gừng	अदरक	ginger
gửi	पदों	send
ha	हा	hectare
habana	हबाना	(proper noun) habana
habsburg	हैब्सबर्ग	(proper noun) habsburg
haeberle	haeberle	haeberle
hahn	हैन	hahn
hai	दो	two (adj.)
hal	hal	hal
halle	हाले	(proper noun) halle
halogen	हलोजन	halogen (n.)
ham	का आनंद	desire
hamilton	हैमिल्टन	(proper noun) hamilton
han	हान	han
hang	गुफा	cave
hangul	हंगुल	hangul
hanh	आर्केड	hanh
hanja	हंजा	(proper noun) hanja, a type of chinese script
hansen	हैनसेन	hasnen
hao	मूल्यह्रास	"(term should be ""hao hụt"") to incur some loss (v.)"
harald	हेराल्ड	harald
hardy	साहसी	hardy
harlem	हार्लेम	harlem
harlow	हार्लो	harlow
harold	हेरोल्ड	(proper noun) harold
harper	बीन बजानेवाला	harper
harpercollins	हार्पर	hapercollins
harrier	हैरियर	harrier, as in harrier jump jet
harris	हैरिस	harris
harry	सताना	harry
harvard	हार्वर्ड	(proper noun) harvard, the name of a college
harvey	हार्वे	harvey
havana	हवाना	(proper noun) havana, cuba
havilland	हैविलैंड	havilland
hawker	फेरीवाला	hawker
hawking	फेरी	(proper noun) hawking, as in physicist stephen hawking
hay	या	or
hb	मॉडिफ़ाइड अमेरिकन प्लान	hb
hbv	एचबीवी	hbv
hcl	एचसीएल	hcl
hd	hd	activity
he	हे	he, a korean name
health	स्वास्थ्य	health
heath	हीथ	heath
hee	ही	hee
hegel	हेगेल	(proper noun) hegel, as in georg wilhelm friedrich hegel
heian	हीयान	heian
heinrich	हेनरिक	heinrich
helen	हेलेन	helen
helena	हेलेना	helena
heli	हीलियम	helium
hematocrit	हेमाटोक्रिट	hematocrit
hemoglobin	हीमोग्लोबिन	hemoglobin
hen	दमा	asthma
henry	हेनरी	(proper noun) henry, as in henry kissinger
heo	सुअर	dolphin
her	उसके	her
herbert	हर्बर्ट	herbert, as in herbert schandler
hercegovina	hercegovina	hercegovina
hercules	पहलवान	hercules
hermann	हरमन	hermann
hermes	हेमीज़	hermes
hersh	हर्ष	hersh, as in seymour hersh
hesiod	हेसिओड	hesiod
hestia	hestia	hestia
hi	हाय	"(term should be ""hi vọng"") alternative spelling for ""hy vọng""; meaning ""hope"" (n.)"
hickam	hickam	(proper noun) hickam
hicks	हिक्स	hicks
hideto	hideto	(proper noun) hideto
hideyoshi	हिदेयोशी	(proper noun) hideyoshi
hidro	हाइड्रोजन	hydrogen
hillsborough	hillsborough	hillsborough
hilton	हिल्टन	hilton
himalaya	हिमालय	(proper noun) himalaya
hinata	hinata	hinata
hindenburg	हिंडनबर्ग	(proper noun) hindenburg
hindi	हिन्दी	hindi
hindu	हिन्दू	hindu, as in the hindu religion
hinh	hinh	(proper noun) a vietnamese first name
hinhtron	hinhtron	circle
hiragana	हीरागाना	hiragana
hiroshi	हिरोशी	hiroshi
hiroshima	हिरोशिमा	(proper noun) hiroshima, the japanese city
hitchcock	हिचकॉक	hitchcock
hitler	हिटलर	hitler
hitter	मारने वाला	hitter
hitters	hitters	hitters
hiên	बरामदा	(proper noun) hiên, a vietnamese first name
hiđrô	हाइड्रोजन	hydrogen
hiếm	विरल	rare
hiến	देना	devote
hiếp	बलात्कार	rape
hiếu	तंतुमय उपासना	pious
hiềm	hiem	grudge
hiền	नम्र	sage
hiểm	बीमा	dangerous
hiểu	समझना	learn
hiện	दिखाओ	"(term should be ""thực hiện"") to accomplish"
hiệp	संयुक्त	united
hiệu	मार्क	effective
hlv	hlv	trainer
hms	एचएमएस	hms
hmông	हमोंग	hmong
hn	hn	hn
hoa	फूल	flower
hoan	त्योहार	welcome
hogwarts	हॉगवर्ट्स	(proper noun) hogwarts, sorcery school from the harry potter series
hoi	होई	rare
hokage	होकज	hokage
hokusai	होकुसाई	hokusai
holmes	होम्स	a name
holocaust	प्रलय	holocause
holocen	अभिनव युग	holocen
holt	उपवन	holt, an english last name
hom	कलमों	a cutting
homer	डाक का कबूतर	(proper noun) homer, the authorof the iliad and the odyssey
hon	माननीय	"(term should be ""hòn"") rock (n.)"
honduras	होंडुरस	honduras
hong	hong	hong
honolulu	होनोलुलु	honolulu
honshū	honshū	honshu
hopkins	हॉपकिंस	(proper noun) hopkins
hornet	हॉरनेट	hornet
hotspur	चिड़चिड़ा व्यक्ति	(proper noun) hotspur, as in tottenham hotspur
houston	ह्यूस्टन	(proper noun) houston, as in whitney houston
howard	हावर्ड	(proper noun) howard
however	टु nhiên	however
hoà	कंडीशनिंग	peace
hoài	उदासीन	always (adv.)
hoàn	पूर्ण	"(term should be ""hoàn toàn"") completely"
hoàng	रानी	royal (adj.)
hoành	डायाफ्राम	rife
hoá	माल	"(term should be ""văn hoá"") culture (n.)"
hoán	विनिमेय	refined (adj.)
hoãn	स्थगित करना	delay
hoạ	चित्रकार	disaster (tham hoa)
hoại	विषाक्त	"(term should be ""phá hoại"") to sabotage (v.)"
hoạt	गतिविधि	work
hoả	आग	of
hoảng	मंदी	panic-stricken (adj.)
hoặc	या	or
hp	अश्वशक्ति	hp
hq	मुख्यालय	hq
hudgens	हजेंस	(proper noun) hudgens
hudson	हडसन	hudson
huey	ह्युई	huey
hughes	ह्यूजेस	hughes
hugo	ह्यूगो	(proper noun) hugo
hume	ह्यूम	hume, as in david hume
hun	हुन	(proper noun) hun
hungary	हंगरी	hungary
hunt	शिकार	hunt
hurley	हर्ले	(proper noun) hurley, as in chad hurley
hussein	हुसैन	hussein
husserl	husserl	huserl
huston	हस्टन	huston
hutech	hutech	hutech
huy	कमांडर	a common vietnamese first name
huynh	माता-पिता	older brother
huyền	जेट	huyền thoại= legend
huyễn	मोह का	huyen
huyện	जिलों	district
huyệt	एक्यूपंक्चर बिंदु	lair
huân	क्रम	"(term should be ""huân chương"") medal (n.)"
huê	वृद्धि	"a less common vietnamese word for ""flower"""
huấn	ट्रेनिंग	"(term should be ""huận luyện"") to train (v.)"
huế	रंग	hue
huệ	इष्ट	favour
huống	मामला	situation
huỳnh	फ्लोरोसेंट	sulfur
huỷ	रद्द करना	destroy
hydra	हीड्रा	hydra, a monster in greek mythology
hydro	हाइड्रोजन	hydrogen
hyperion	हाइपीरियन	hyperion
hà	आकाशगंगा	"(term should be ""hà nội"") the capital of vietnam"
hài	कॉमेडी	corpse
hàm	जबड़ा	"(term should be ""bao hàm"") to imply (v.)"
hàng	पंक्ति	row
hào	ट्रेंच	depreciation
hách	रोबदार	glorious
hái	चुनना	picking
hán	सूखा	china
háo	दर्शकों	eager
hát	गाओ	song
hâm	प्रशंसक	"(term should be ""hâm mộ"") to admire (v.)"
hân	प्रसन्न	le ngoc han
hãi	डर	to be scared (v.)
hãn	भीड़	to sweat (v.)
hãng	कंपनी	a company (n.)
hãnh	घमंडी	proud
hè	गर्मी	summer
hé	फटा	reveal
héo	मुरझाना	dried-out
hét	चिल्लाना	shout
hên	मुर्गी	luck
hí	थिएटर	game
hít	साँस लेना	act of kissing (hon hit)
hò	डेटिंग	date
hòa	हवा	republic
hòe	कुदाल	hoe
hòm	ताबूत	box
hòn	छोटा सा टाप	island
hòng	प्रयास	in order to
hóc	हॉक	a corner (n.)
hót	गायन	to chirp or sing (v.)
hô	मूंगा	respiration
hôi	बेईमानी से	stink
hôm	बृहस्पतिवार	day (n.)
hôn	चुंबन	propose
hông	कमर	hip
hù	डराना	threaten
hùng	नायक	hero
húc	तिकोना कपड़ा	huc
húng	तुलसी	"(should be ""húng láng"") water mint"
hút	अवशोषित	to suck (v.)
hăng	हिसात्मक आचरण	enthusiasm
hđbt	hđbt	hdbt
hđh	ओएस	system software
hũ	जार	jar
hơi	भाप	slightly
hơn	अधिक	more or less
hư	भ्रष्ट	fictional
hưu	पेंशन	huu
hương	धूप	smell
hước	हास्य	humor
hướng	दिशा	trend
hường	hường	huong
hưởng	से सम्मानित किया	influence
hạ	कम	lower
hạc	क्रेन	crane
hạch	नाड़ीग्रन्थि	ganglion
hại	हानिकारक	harm
hạng	वर्ग	rank
hạnh	सुख	happy
hạo	hạo	hao
hạp	लिली बल्ब	hap
hạt	काउंटी	seed
hải	कस्टम्स	two
hảo	उत्तम	perfect
hấn	आक्रमण	aggressive gesture
hất	टोपी	toss
hấu	तरबूज़	"(term should be ""dưa hấu"") watermelon"
hầm	पिट	ham
hầu	लगभग	most
hận	नफरत	hatred
hậu	मौसम	anus
hắc	अंधेरा	black
hắn	उसकी	he (n.)
hắt	भूमि के ऊपर	reject
hằng	स्थिर	every
hặc	hac	to criticize (v.)
hẹ	chives	chinese chives
hẹp	संकीर्ण	narrow
hẻm	कण्ठ	alley (n.)
hẻo	प्रकृति	outback
hến	सीपी	mussel
hết	ऊपर	most
hề	विदूषक	"(term should be ""không hề"") never"
hễ	हर	whenever
hệ	संपर्क	relation
hệt	हूबहू	exactly
hỉ	झटका	happy
hịch	hich	a proclamation
họ	वे	they (n.)
họa	रंग	picture
họach	फसल	"(term should be ""quy hoạch"") a project (n.)"
học	सीखना	study (v.)
họng	गला	throat
họp	बैठकों	meet
hỏa	आग	fire
hỏng	विफल	corruption
hố	पिट	hole
hốc	आलों	cavity
hồ	झील	ho
hồi	समय	muslim
hồn	आत्मा	soul
hổ	बाघ	tiger
hổi	होई	"(term should be ""nóng hổi"") steaming hot (adj.)"
hổng	भारी	hole
hỗ	समर्थन	"(should be ""hỗ trợ"") to support or assist"
hỗn	मिश्रित	"(term should be ""hỗn tạp"") mish-mash (adj.)"
hội	सभा	society
hộp	डिब्बा	box
hới	होई	hoi
hớn	माननीय	"(term should be ""hớn hở"") radiant (adj.)"
hờn	hờn	hatred
hở	खुला	reveal
hỡi	हे	dear
hợi	दबाव	pig (n.)
hợp	मामला	appropriate
hợpquận	hopquan	general district
hụt	घाटा	loss
hủi	कुष्ठ	reject
hủy	रद्द करना	to erase or destroy
hứa	वादा	promise
hử	हाशिया	hu
hửu	अधिकार-संबंधी	"(term should be ""sở hửu"") to own (v.)"
hữu	संपत्ति	(proper noun) hữu, a vietnamese middle name; also means right, as in the direction
hựu	huu	again
hỷ	hy	hy
ian	इआन	ian, as in australian swimmer ian thorpe
iau	आईएयू	iau
iberia	iberia	iberia
ibm	आईबीएम	(proper noun) ibm, the computer company
ibmpc	ibmpc	ibm-pc
ic	आईसी	ic
icc	आईसीसी	icc
iceland	आइसलैंड	(proper noun) the country of iceland
ide	आईडीई	ide
ieng	ieng	(proper noun) ieng
igor	इगोर	igor
iii	iii	third
ilene	ilene	ilence
illusion	माया	illusion
ilyich	इलिच	ilyich
im	im	still
imam	ईमाम	(proper noun) imam
imbrium	imbrium	imbriun
immanuel	इम्मानुअल	(proper noun) immanuel, as in immanuel kant
impact	प्रभाव	impact
incoterm	incoterm	incoterm
incoterms	incoterms	(proper noun) incoterms
indian	भारतीय	indian
indiana	इंडियाना	indiana
indochina	इंडोचीन	indochina
indonesia	इंडोनेशिया	indonesia
indrapura	indrapura	(proper noun) indrapura
info	जानकारी	info
innsbruck	इंसब्रुक	innsbruck
insulin	इंसुलिन	insulin
int	पूर्णांक	int
intel	इंटेल	(proper noun) intel, as in the name of the company
interpol	इंटरपोल	interpol
inu	इनु	(proper noun) inu
inuyasha	inuyasha	inuyasha
inư	इनु	(proper noun) inư
io	कब	io
ioc	आईओसी	ioc
ion	आयनों	ion
iosif	लोफिस	(proper noun) iosif, as in iosif vissarionovich stalin
iran	ईरान	the nation of iran
iraq	इराक	iraq
ireland	आयरलैंड	ireland
irgun	इरगुन	irgun
irony	व्यंग्य	irony
irving	इरविंग	(proper noun) irving
isaac	इसहाक	isaac
isla	इस्ला	isla
islam	इसलाम	islam
islamabad	इस्लामाबाद	(proper noun) islamabad
israeli	इजरायल	israeli
istanbul	इस्तांबुल	istabbul
italia	इटली	italy
italiano	italiano	(proper noun) italiano
itanium	इटेनियम	itanium, as in windows xp itanium
ito	ito	ito
itsukushima	itsukushima	itsukushima
itu	आईटीयू	itu
itzá	itzá	(proper noun) itzá
iv	iv	4 ( greek number)
iwami	iwami	iwami
j	j	j
jack	जैक	jack
jackie	जैकी	(proper noun) jackie chan
jackson	जैक्सन	(proper noun) jackson, as in michael jackson
jacob	याकूब	jacob
jae	जे	jae
jakarta	जकार्ता	(proper noun) jakarta
jan	जनवरी	(proper noun) jan
janeiro	जनेरियो	janeiro
janet	जेनेट	janet
japan	जापान	japan
jared	jared	jared
jarvis	जार्विस	(proper noun) jarvis, as in jarvis cocker
jasper	सूर्यकांत मणि	(proper noun) jasper
jean	जीन	jean
jeane	जीन	jeane
jeanjacques	jeanjacques	jean-jacques
jeanpaul	jeanpaul	jeanpaul
jeans	जीन्स	jeans
jeet	जीत	(proper noun) jeet, as in jeet kune do
jeff	जेफ	jeff, as in jeff drake
jefferson	जेफरसन	jefferson
jeffrey	जेफरी	jeffrey
jeju	जाजू	jeju
jenda	jenda	jenda
jenny	विंच	jenny
jericho	जेरिको	jericho, as in wrestler chris jericho
jerome	जेरोम	jerome, as in fred jerome
jerry	जेरी	(proper noun) jerry
jersey	जर्सी	jersey
jerusalem	यरूशलेम	jerusalem
jesse	जेसी	a name
jesus	यीशु	chua jesus
jetstar	जेटस्टार	jetstar
jewish	kla	jewish
jiao	झाओ	jiao
jimmy	सर्व-कुंची	jimmy
jin	जिन	jin
jing	जिंग	jing
jiraiya	jiraiya	(proper noun) jiraiya
joachim	जोआचिम	joachin
joan	joan	a name
joe	जो	(proper noun) joe
johan	जोहान	johan
johann	जोहान	johann
johannes	जोहानिस	johannes
johannesburg	जोहानसबर्ग	(proper noun) johannesburg, south africa
johnny	छोकरा	johnny
johns	जॉन्स	johns
johnston	जॉनसन	johnston, as in harry johnston
johor	जोहोर	johor
joint	संयुक्त	joint
jonathan	जोनाथन	(proper noun) jonathan
jones	jones	jones
jose	जोस	(proper noun) jose, a spanish first name
joseon	जोसियन	(proper noun) joseon
joseph	जोसफ	joseph
jscript	jscript	(proper noun) jscript
juche	juche	(proper noun) juche
judith	जूडिथ	judith
judo	जूदो	judo, the martial art
julesverne	जूल्स वर्न	jules verne
julliard	julliard	(proper noun) julliard
jump	कूदता	jump
june	जून	june, as in the month
jung	जंग	jung
junsu	junsu	junsu
jupiter	बृहस्पति	(proper noun) jupiter, as in the planet
jura	जुरा	(proper noun) jura
juventus	जुवेंटस	juventus
k	कश्मीर	k
kaede	kaede	a japanese name
kaffee	kaffee	(proper noun) kaffee, as in kaffee hag
kagome	kagome	kagome, as in higurashi kagome
kahn	क्हान	kahn
kai	काई	kai
kakashi	काकाशी	kakashi
kaká	काका	(proper noun) kaka, a brazilian soccer player
kalashnikov	कलाश्निकोव	(proper noun) kalashnikov
kali	पोटैशियम	potassium
kama	कामदेव	(proper noun) kama, as in the kama sutra
kamakura	कामाकुरा	kamakura
kamov	कामोव	kamov
kampf	kampf	kampf
kampong	kampong	kampong
kampuchea	kampuchea	cambodian
kana	काना	kana, the japanese phonetic alphabet
kangin	kangin	(proper noun) kangin
kanji	कांजी	kanji
kant	कांत	a name
kar	कर	(proper noun) kar
kara	काड़ा	kara
karaoke	कराओके	karaoke
karate	कराटे	karate
karatedo	karatedo	karatedo
karen	करेन	(proper noun) karen
karim	करीम	(proper noun) karim
kashmir	काश्मीर	kashmir
kaspersky	kaspersky	(proper noun) kaspersky, as in kaspersky anti-virus software
katakana	काटाकना	katakana, a type of japanese script
kate	केट	(proper noun) kate, as in actress kate winslet
katherine	कैथरीन	katherine
kathmandu	काठमांडू	kathmandu
katrina	कैटरीना	(proper noun) katrina, as in hurricane katrina
katz	katz	katz
kauthara	kauthara	kauthara, a part of the ancient kingdom of champa
kavkaz	kavkaz	kavkaz
kawasaki	कावासाकी	(proper noun) kawasaki
kay	kay	kay
kazan	कज़ान	kazan, the name of a city
kcn	iz	industrial zone
ke	ke	"(term should be ""boong ke"") a bunker (n.)"
kelly	केली	kelly
kelsi	kelsi	kelsi
kelvin	केल्विन	kelvin
kem	आइसक्रीम	ice cream (n.)
ken	केन	ken
kennedy	कैनेडी	(proper noun) kennedy, as in john f. kennedy
kenneth	केनेथ	(proper noun) kenneth, a name
kenny	केनी	kenny, an english first name
kentucky	केंटकी	(proper noun) kentucky
kepler	केपलर	kepler
kerala	केरल	(proper noun) kerala
kevin	केविन	kenvin
keynes	कीन्स	keynes, as in economist john maynard keynes
kg	किलो	kilogram
kha	खा	(proper noun) a vietnamese first name
khai	घोषित	announce
khali	खली	(proper noun) khali
khalip	खलीफा	(proper noun) khalip
kham	kham	endure
khan	निर्जल	rare
khang	शर्त	khang
khanh	सचिव	khanh
khao	खाओ	desire
khay	ट्रे	tray
khe	स्लॉट्स	chink
khem	खेम	abstinence
khen	योग्यता	praise
kheo	stilts पर	kheo
khi	पर	when
khieu	khieu	(proper noun) khieu, as in khieu samphan
khiêm	विनम्रता	khiem
khiên	ढाल	a shield
khiêu	यौन	"('khiêu dâm"") pornographic"
khiếm	अंधा	lack
khiến	निर्माण	control
khiếp	आतंक	horrible
khiếu	शिकायतों	talent (n.)
khiển	नियंत्रण	control
khleang	khleang	kh'leang
kho	गोदाम	warehouse
khoa	संकाय	"(term should be ""y khoa"") the study of medicine (n.)"
khoan	छेद	drill
khoang	गुहा	brag
khoanh	बजना	a slice (n.)
khoe	दिखावा करना	to boast
khoá	कोर्स	lock
khoác	जैकेट	coat
khoán	स्टॉक	stock
khoáng	खनिज	mineral
khoát	दृढ़ता से	decisive
khoét	प्रवेश करना	carve
khoăn	आश्चर्य	disturbed
khoả	खोआ	naked
khoản	धारा	an item (n.)
khoảng	अंतरिक्ष	about
khoảnh	क्षणों	moment
khoẻ	स्वास्थ्य	health
khrushchev	ख्रुश्चेव	khrushchev
khrushchyov	ख्रुश्चेव	khrushchyov
khu	क्षेत्र	section
khung	ढांचा	frame
khural	khural	khural
khuynh	इच्छुक	trend
khuyên	की सिफारिश	advise
khuyết	सुलभ	lack
khuyển	कुत्ते का	khuyen
khuất	अस्पष्ट	hidden
khuấy	हलचल	stir
khuẩn	बैक्टीरियल	bacteria
khuếch	प्रोमोशनल	amplification
khuỷu	कोहनी	elbow
khá	बल्कि	quite
khác	अन्य	different
khách	अतिथि	customer
khái	सिंहावलोकन	concept
khám	जांच	discover
khán	दर्शक	audience
kháng	प्रतिरोध	appeal
khánh	का उद्घाटन	a type of chime made of stone (n.)
khát	प्यासा	to be thirsty for (adj.)
khâm	प्रशंसा	admire
khèn	khen	a pan-pipe (n.)
khéo	निपुण	cleverly or skillfully (adv.)
khép	बंद	close
khía	सम्मान	"(term should be ""khía cạnh"") angle (n.)"
khích	सांत्वना	encourage
khít	पास	close
khó	कठिन	difficulty
khóa	ताला	a session
khóc	रोने के लिए	cry
khói	धुआं	smoke
khóm	अनानास	a cluster
khô	सूखा	dry
khôn	बुद्धिमान	clever, intelligent
không	नहीं	not
khúc	गीत	song
khăm	शरारत	nasty (adj.)
khăn	तौलिए	difficult
khơi	तट	sea
khư	थपथपाना	grip
khưu	khưu	khuu
khước	त्याग	waive
khả	उपलब्धता	"(term should be ""khả năng"") ability (n.)"
khải	प्रकट	triumph
khảm	मौज़ेक	to encrust
khảo	संदर्भ	"(term should be ""tham khảo"") to consult (v.)"
khấm	समृद्ध	endure
khấn	व्रत	pray
khấu	नाटकीय	"(term should be ""sân khấu"") a stage (n.)"
khẩn	आपात स्थिति	"(term should be ""khẩn cấp"") urgent (adj.)"
khắc	एनग्रेविंग	moment
khắp	सब खत्म हो गया	all over
khẳng	इस बात की पुष्टि	"(term should be ""khẳng định"") to assert (v.)"
khế	तारा फल	bond
khỉ	बंदर	monkey or ape (n.)
khỏa	नुमाइशबाजी	nude
khỏe	स्वास्थ्य	health
khỏi	से बाहर	leave
khố	ख़ज़ाना	loincloths
khốc	बलपूर्वक	devastating
khối	इकाई	a block or mass of (n.)
khốn	शोक	miserable
khống	अशक्त	control
khổ	पीड़ा	miserable (adj.)
khổng	विशाल	huge
khởi	लांच	start
khủng	संकट	"(term should be ""khủng bố"") terrorist (n.)"
khủyu	कोहनी	elbow
khứu	सूंघनेवाला	olfactory
khử	को खत्म	reduction
ki	की	"entire phrase is ""ki lo""; means ""kilometer"""
kia	अन्य	other
kid	बच्चा	kid
kiel	कील	(proper noun) kiel
kierkegaard	कियर्केगार्ड	kierkegaard, as in soren kierkegaard
kiernan	कीयरनन	kiernan
kii	kii	kii
kikyo	kikyo	kikyo
kilômét	किलोमीटर की दूरी पर	kilometer
kim	किम	kim
kingdom	राज्य	kingdom
kinsey	किन्से	kisney
kiribati	किरिबाती	kiribati
kishimoto	किशिमोतो	(proper noun) kishimoto
kiss	चुंबन	kiss
kissinger	किसिंजर	kissinger
kitts	किट्स	kitts
kitô	ईसाई	christian
kiêm	सह	cum
kiên	कंपनी	consistent
kiêng	संयम	abstinence, as in abstaining from eating
kiêu	घमंडी	showy
kiếp	जीवनकाल	a lifetime (n.)
kiết	बेड़ी	cheap (adj.)
kiềm	क्षार	"(term should be ""kiềm chế"") to restrain (v.)"
kiểm	निरीक्षण	control
kiểu	टाइप	type
kiệm	सेव	save
kiện	घटनाओं	event (su kien)
kiệt	उत्कृष्ट कृति	exhausted (adv.)
kiệu	डोली	scallion
klaus	क्लाउस	klaus
klein	क्लीन	klein
km	किमी	kilometer
knesset	knesset	knesset
knuth	नुथ	knuth, as in donald knuth
koch	कोच	koch
kodansha	कोदंषा	kodansha
kofun	kofun	kofun, as in the kofun period of japanese history
kogoro	kogoro	kogoro
komodo	कोमोडो	komodo
kon	kon	"(term should be ""kon tum"") a province in the highlands of vietnam"
kong	कांग	(proper noun) kong, as in hong kong
konstantin	konstantin	(proper noun) konstantin
konversationslexikon	konversationslexikon	konversation-lexikon
kop	kop	kop
koran	कुरान	koran
kornai	kornai	(proper noun) kornai, as in janos kornai
koruna	कोरुना	koruna
kosovo	कोसोवो	(proper noun) kosovo
kremli	क्रेमलिन	kremil
kremlin	क्रेमलिन	kremlin
kristen	क्रिस्टन	kristen
krông	क्रोंग	krong
ku	कू	is a name
kuala	कुआला	(proper noun) kuala, as in kuala lumpur
kubrick	कुब्रिक	kubrick
kuen	kuen	kuen
kuiper	क्विपर	(proper noun) kuiper, as in the kuiper belt
kulak	कूलाक	kulak
kune	कुन डो	(proper noun) kune, as in the martial art jeet kune do
kung	कुंग	danh vo
kungfu	कुंगफू	kung fu
kunst	कुंस्ट	kunst, as in richard kunst
kurd	कुर्दों	kurd
kurt	कर्ट	(proper noun) kurt
kuwait	कुवैट	kuwait, the country (n.)
kwan	क्वान	kwan
kwen	kwen	kwen
kwon	क्वोन	kwon, as in tae kwon do; proper noun
kyrgyzstan	किर्गिज़स्तान	(proper noun) the country of kyrgyzstan
kyushu	क्यूशू	kyushu
kyūshū	क्यूशू	kyushu, a japanese island
kèm	एक साथ	included
kèn	तुरही	horn
kém	कम से कम	less
kén	कोकून	selective
kéo	पुल	scissors
kép	दोहरी	dual
két	तिजोरियां	"(term should be ""rốc két"") rocket (n.)"
kê	आंकड़े	statistics
kênh	चैनलों	channel
kêu	रोना	appeal
kìa	निहारना	that
kìm	आंखें	bar
kình	व्हेल	rivalry
kí	रजिस्टर	sign
kích	आग	excite
kíchbom	kichbom	bombers
kín	गुप्त	secretive or closed tight (adj.)
kính	चश्मा	respect
kíp	रात बिताने का स्थान	esoterica
kít	रुकी	wheelbarrow
ký	संकेत	"(""nhật ký"") a diary"
kĩ	ध्यान से	technique
kơnia	konia	a tree found in southeast asia; sometimes called wild mango
kạn	कान	kan
kẹo	कैंडी	candy
kẹp	चिमटा	to clamp down (v.)
kẹt	फंस	jam
kẻ	कौन	guy
kẻo	ऐसा न हो कि	lest
kẽ	फांक	crevice
kẽm	जस्ता	zinc
kế	डिज़ाइन	a scheme (n.)
kết	लिंक	combine
kề	समीपता	adjacent
kềnh	बोझिल	bulky
kệ	अलमारियों	ignore
kỉ	सदी	"(term should be ""kỉ niệm"") souvenir (n.)"
kị	घुड़सवार सेना	ki
kịp	समय में	kip
kỵ	घुड़सवार सेना	taboo
kỷ	वें	"(term should be ""thế kỷ"") century (n.)"
l	एल	l.
label	लेबल	label
laboulaye	laboulaye	a name
ladakh	लद्दाख	(proper noun) ladakh
lai	संकर	"(term should be ""tương lai"") the future (n.)"
lam	पीटना	lam
lama	लामा	a name
lan	विस्तार	a name
land	भूमि	land
landon	लंदन	a name
lang	लैंग	lang
langdon	लैंगडन	langdon
lange	लैंग	lange, as in oscar lange
langue	लैंगुए	langue
lanh	लिनन	ringing
lanka	श्रीलंका	(proper noun) lanka, as in the island of sri lanka
lao	लाओ	labor
laos	लाओस	(proper noun) laos
lap	गोद	greek
larry	लैरी	larry
lars	लार्स	lars
las	लास	(proper noun) las, as in las vegas
laser	लेज़र	laser
lateran	लैटर्न	lateran
latinh	लैटिन	latin
latvia	लातविया	(proper noun) latvia
lau	पोंछ	lau
laura	लौरा	(proper noun) laura, as in laura bush
laurence	लारेंस	(proper noun) laurence
lawrence	लॉरेंस	(proper noun) lawrence
lay	शेक	lay
lazarus	लाजास्र्स	(proper noun) lazarus
leach	नमकीन पानी	(proper noun) leach
leaf	पत्ती	leaf
leave	छुट्टी	leave
lebanon	लेबनान	(proper noun) lebanon
lee	ली	lee
legacy	विरासत	legacy
leiden	लाइदेन	leiden
lem	एलईएम	cinderella
lenin	लेनिन	lenin
lenins	lenins	lenin's
leo	चढ़ाई	climb
leon	लियोन	leon
leonard	लियोनार्ड	leonard
leonardo	लियोनार्डो	(proper noun) leonardo, as in leonardo da vinci
leonid	लियोनिद	leonid
les	लेस	les
leslie	लेस्ली	a name
lesotho	लिसोटो	lesotho
lg	एलजी	lg
lhp	lhp	film festival
lhq	संयुक्त राष्ट्र	un
libby	लिब्बी	(proper noun) libby
libero	libero	libero
libya	लीबिया	libya
lido	लीडो	lido
liechtenstein	लिकटेंस्टीन	liechtenstein
liga	लिगा	a name
lightning	बिजली	lightning
lilly	लिली	(proper noun) lilly
linga	लिंग	linga
linh	लचीलापन	efficacious (adj.)
links	लिंक:	links
linux	linux	linux server
lionel	लियोनेल	lionel
lisboa	लिस्बन	lisboa
lisbon	लिस्बन	a name
litva	लिथुआनिया	(proper noun) lithuania
liu	लियू	liu
liêm	ईमानदारी	good example
liên	उद्यम	relate
liêng	पहचाना	sacred
liêu	नौकरशाही	bureaucracy
liềm	दरांती	sickle
liều	खुराक	daring
liễu	विलो	a willow tree (n.)
liệng	फेंक दिया	"(term should be ""cánh liệng"") the aileron of a plane (n.)"
liệt	पक्षाघात	impotent
liệu	चाहे	document
lleyton	लीटन	lleyton
lo	चिंता	to worry (v.)
loa	वक्ता	"(term should be ""cổ loa"") an ancient vietnamese city (proper noun)"
loaita	loaita	loaita
loang	rippling	patchy
loch	झील	loch
locke	लोके	(proper noun) locke, as in philosopher john locke
lockheed	लॉकहीड	(proper noun) lockheed, as in lockheed martin
log	लॉग	log
logan	लोगन	a name
lon	कर सकते हैं	lon
london	लंडन	london
long	अजगर	dragon
lorenzo	लोरेंजो	lorenzo
los	लॉस	los, as in los angeles
louis	लुइस	louis
louisiana	लुइसियाना	(proper noun) the state of louisiana
louvre	लौवर	(proper noun) louvre
love	प्यार	yeu
loài	जाति	species
loát	धाराप्रवाह	overturn
loãng	पतला	wishy-washy
loét	अल्सर	gaping, as in a wound
loại	तरह	type
loạianh	loaianh	not a word
loạianime	एनीमे टाइप करें	type anime
loạibệnh	बीमारी का प्रकार	disease
loạichiến	loaichien	loaichien
loạicác	loaicac	item
loạicâu	loaicau	type: club
loạicông	loaicong	type: industry
loạicựu	loaicuu	kind former
loạigia	loaigia	loaigia
loạihuân	loaihuan	not a word
loạiluật	कानून का प्रकार	type: law
loạimáy	मशीन का प्रकार	kind plane
loạimôn	loaimon	type
loạingày	इसे टाइप करें	loaingay
loạiphim	फिल्म प्रकार	type movie
loạiphong	loaiphong	kind of movement
loạiscandal	loaiscandal	scandal type
loạithuật	कानून का प्रकार	type: lexicon
loạithành	loaithanh	kinds of payment
loạithần	loaithan	kind myth
loạitrường	स्कूल का प्रकार	type of school
loạitín	loaitin	type: belief
loạitổ	loaito	kind organization
loạivõ	की तरह	type: martial art
loạixã	loaixa	kind of society
loạn	विकार	disorderly
loạt	शृंखला	series
lp	एल.पी.	lp
lu	लू	dim
luang	लुआंग	a name
lucas	लुकास	(proper noun) lucas
lucia	लूसिया	lucia, as in the island of saint lucia
luciano	लुसियानो	luciano
ludendorff	ludendorff	luđenorff
ludovico	लुडोविको	ludovico
ludwig	लुडविग	ludwig
lui	पीछे हटना	withdrawal
luis	लुइस	(proper noun) luis, a first name
luiz	लुइज़	luiz
lula	लूला	lula
lung	फेफड़ा	shake
lustig	lustig	lusig
luther	लूथर	luther
luxembourg	लक्ज़मबर्ग	a name
luy	ढाल	luy
luyến	लोगाटो	love
luyện	गाड़ी	training
luận	टिप्पणियाँ	"(term should be ""xã luận"") an editorial"
luật	कानून	law
luồn	लड़ी पिरोया हुआ	wriggle
luồng	धारा	lane
luộc	उबला हुआ	boiled
luỹ	कमाई	rampart (n.)
ly	कांच	divorce
lydia	लिडा	lydia
lympho	लिंफोमा	lymphocyte
lyndon	लिंडन	lyndon
lyon	ल्यों	lyon
là	था	the verb to be
làm	करना	make
làn	लेन	wave
làng	गांव	village
lành	स्वस्थ	protestant
lào	लाओस	laos
lá	पत्ती	"(term should be ""lá thư"") a letter (n.)"
lác	तिर्यकदृष्टि	brag
lách	तिल्ली	to swerve (v.)
lái	ड्राइविंग	to drive (v.)
lán	झोंपड़ी	shack
láng	चमकदार	neighbours
lâm	वानिकी	lâm, a common vietnamese first name
lân	निकट	nearby
lâu	लंबे समय तक	long time
lây	विस्तार	to infect
lãi	ब्याज	a profit
lãm	शो	exhibition
lãnh	प्राप्त	to receive
lão	उम्र बढ़ने	old
lèo	लियो	"(term should be ""nước lèo"") broth (n.)"
lén	छल	sneak
lê	रहिला	le
lêmạc	lemac	"(term should be ""lê-mạc"") a war between two ruling families in ancient vietnamese history"
lên	ऊपर	on
lênh	आदेशों	"(should be ""lênh đênh"") adrift"
lênin	लेनिनवाद	lenin
lìa	रवाना	to leave (v.)
lình	linh	suddenly
lí	धागा	reason
lính	सैनिक	soldier
lít	लीटर	litre
líu	भांजनेवाला	"(term should be ""dính líu"") to have a connection with"
lò	ओवन	release
lòng	दिल	heart
lóc	snakehead	cry
lóe	फ्लैश	flash
lóng	के बीच का नाजुक	"entire term should be ""tieng long""; means ""slang"""
lót	अंडरवियर	undies
lô	पार्सल	batch
lôi	ढुलाई	encourage
lôn	बेबीलोन	"(term should be ""côn lôn"") a village in vietnam"
lông	बाल	hair
lõi	कोर	core
lõm	नतोदर	concave
lùi	पिछड़ा	back
lùn	बौना	dwarf
lùng	नीचे	hunt
lúa	धान	rice
lúc	समय	at the moment
lún	घटाव	subside
lúng	scratching	confused
lúp	आवर्धक	uneven
lút	डरपोक	surreptitiously
lăm	पांच	tens
lăn	रोलिंग	attack
lăng	मंदिर	tomb
lĩnh	नेता	"(term should be ""thủ lĩnh"") the leader (n.)"
lũ	बाढ़	a band or gang (n.)
lũng	घाटी	valley
lũy	संचित	rampart
lơ	उपेक्षित	to ignore
lơi	ढीला हो गया	"(term should be ""lả lơi"") to act in a familiar or flirting manner (adv.)"
lư	बर्नर	an urn
lưng	वापस	back
lươn	एक प्रकार की मछली	eel
lương	वेतन	conscience
lưới	ग्रिड	a net (n.)
lướt	सर्फ़िंग	ski
lười	आलसी	lazy
lưỡi	जीभ	tongue
lưỡng	उभयलिंगी	"(term should be ""lưỡng tính"") bisexual"
lược	रणनीति	invasion
lượm	उठा लो	pick up
lượn	ग्लाइडर	to glide over (v.)
lǐ	lǐ	(proper noun) li, as in jet li
lạ	अजीब	strange or unusual (adj.)
lạc	संचार	camel
lạch	क्रीक	"(term should be ""luồng lạch"") a narrow water passageway"
lại	फिर	reversed
lạn	सड़ा हुआ	bright
lạng	कटा हुआ	lang
lạp	यूनानी	"(term should be ""hy lạp"") greek"
lạtma	लामा	lama
lạy	प्रोस्ट्रेट	kowtow
lấn	अतिक्रमण	to encroach on (v.)
lấp	भरण	sparkle
lấy	लेना	taken
lầm	चूक	wrong
lần	समय	time
lầu	ऊपर	a story or level of a building (n.)
lầy	धँसाऊ	swamp
lẩu	होट पोट	hotpot
lẩy	कटमरैन	get
lẫn	और	each other
lẫy	गिलास	illustrious
lận	छल	fraudulent
lật	फ्लिप	turn
lậy	अरे हाँ!	"(term should be ""cai lậy"") the name of a rural district"
lắc	शेक	to shake (v.)
lắm	बहुत	do
lắng	बसना	"(should be ""lo lắ́́ng"") to worry"
lắp	बढ़ते	lap
lặng	शांत	quiet
lặp	दोहराना	repeat
lặt	कल्पना	means miscellaneous, part of the word lat vat
lẹ	तीव्र	quickly (adv.)
lẻ	खुदरा	"(the term should be ""bán lẻ"") retail"
lẻn	चोरी	sneak
lẻo	ढीला	climb
lề	हाशिया	alignment
lều	तंबू	tent
lễ	दावत	ceremony
lệ	चार्टर	"(term should be ""tỷ lệ"") probability (n.)"
lệch	विचलन	difference
lệnh	आज्ञा	command
lị	ली	"(term should be ""tỉnh lị"") a township (n.)"
lịch	कैलेंडर	history
lọc	फिल्टर	tricked
lọi	चमकते हुए	brilliant
lọng	छत्र	rope
lọt	पकड़ा	enter
lỏi	अपना रास्ता	to enter
lỏng	तरल	loose
lố	आरे	ridiculous
lốc	बवंडर	tornado
lối	ढंग	way or path
lốp	टायर	tyre
lốt	क्लोडिअस	lolot
lồ	कोलोसी	giant
lồi	उत्तल	convex
lồng	पिंजरा	cage
lỗ	छेद	hole
lộc	loc	loc
lội	तैरना	wade
lộn	उलझन में	wrong/mistake
lộng	नदी के किनारे पर	"(term should be ""cổ lộng"") the name of a vietnamese city"
lột	unstuck	exploit
lớn	महान	large
lớp	वर्ग	grade (n.)
lờ	पर ध्यान नहीं दिया	turbid
lời	लाभ	advice
lở	हिमस्खलन	to crack
lỡ	कमी	miss
lợi	लाभ	benefit
lợn	सूअर	pig
lợp	छत	roof
lụa	रेशम	silk
lục	ग्रीन	record
lụi	जल गया	ruin
lụt	बाढ़	flood
lụy	निहितार्थ	consequence
lứa	कूड़े	peer
lừa	चाल	mislead
lừng	मशहूर	well-known
lửng	परछत्ती	lơ lửng= not clear/ something in between
lự	ढुलमुल	reluctant
lựa	चुना गया	chosen
lựu	अनार	grenade
ma	भूत	ma sat (friction), ma thuat (magic), thay ma (zombie)
maastricht	मास्ट्रिच	maastricht
macarthur	मैकआर्थर	macarthur
macclesfield	macclesfield	macclesfield
macedonia	मैसेडोनिया	(proper noun) macedonia
mach	मच	mach
machiavelli	मैकियावेली	machiavelli, as in philosopher niccolo machiavelli
machu	माचू	machu
macintosh	लबादा	macintosh
macma	मैग्मा	magma
macromedia	macromedia	macromedia
madeira	madeira	madeira
madhouse	हंगामा	madhouse
madison	मैडिसन	madison
madonna	ईसा की माता	(proper noun) madonna
madrid	मैड्रिड	madrid, as in the capital of spain
mafia	माफिया	mafia
magiê	मैग्नीशियम	magnesium
mahal	महल	(proper noun) mahal, as in the taj mahal
mai	कल	"(term should be ""giang mai"") the disease syphilis (n.)"
mainframe	mainframes	mainframe
major	प्रमुख	major
makemake	मेक्मेक	makemake
malacca	मलक्का	malacca
malay	मलय	malaysia
malaysia	मलेशिया	(proper noun) the country of malaysia
malcolm	मैल्कम	malcolm
maldini	माल्डिनी	maldini
mali	माली	mai
malta	माल्टा	malta
maluku	मालुकु	maluku
manche	मांचे	manche
manchester	मैनचेस्टर	manchester
mandela	मंडेला	mandela, as in nelson mandela
mandy	मैंडी	mandy
mang	कैरी	to bring (v.)
manga	मंगा	manga
mangnall	मेंगनेल	(proper noun) mangnall, as in ernest mangnall
manh	भेद्य	fragile
manila	मनीला	manila, the capital of the philippines
mankiw	mankiw	mankiw, as in gregory mankiw
manti	manti	mantle
manuel	मैनुअल	manuel
mao	माओ	capillary
maps	नक्शे	maps
maradona	माराडोना	(proper noun) maradona, as in soccer player diego maradona of argentina
marat	मरात	(proper noun) marat, as in marat safin, a tennis player
marc	न घुलनेवाली तलछट	marc, as in marc chagall
marcel	कृत्रिम रूप से बालों को घुंघराला करना	(proper noun) marcel, a french name
marcos	मार्कोस	(proper noun) marcos, as in ferdinand marcos
marcus	मार्कस	marcus, as in marcus aurelius (n.)
margaret	मार्गरेट	(proper noun) margaret
maria	मारिया	(proper noun) maria
marianne	मैरियन	(proper noun) marianne
marie	marie	marie
marina	मरीना	marina
marino	मैरिनो	marino
marić	marić	maric
marmara	मरमारा	(proper noun) marmara, as in the sea of marmara
marne	मार्ने	marne, as in the marne river (n.)
mars	मंगल ग्रह	mars
marseille	मार्सिले	marseille
marshall	मार्शल	marshall
marsu	marsu	(proper noun) marsu
marta	मार्ता	(proper noun) marta, as in the female brazilian soccer player
martin	मार्टिन	martin
marx	मार्क्स	this is a name
mary	मेरी	(proper noun) mary
maryland	मैरीलैंड	a name
maría	मारिया	maria
mas	मास	mas
massachusetts	मैसाचुसेट्स	massachusetts
mat	चटाई	mat
mathematica	mathematica	(proper noun) mathematica, as in isaac newton's work, principia mathematica
mats	मैट	mats, as in mats sundin
matthias	मथायस	matthias, as in matthias erzberger
mau	जल्दी से	fast
maurice	मौरिस	(proper noun) maurice
mausolus	मौसोलस	mausolus
maxim	कहावत	a name
may	सिलाई	lucky
maya	माया	(proper noun) maya
mcafee	mcafee	(proper noun) mcafee
mccain	मैक्केन	mccain
mccartney	मेकार्टनी	a name
mccullough	मैककुल्लौघ	mccullough
mcdonald	मैकडॉनल्ड्स	(proper noun) mcdonald
mchc	mchc	mchc
mclaren	मैकलारेन	mclaren
mcmahon	मैकमोहन	(proper noun) mcmahon
mcnamara	मैकन्मारा	(proper noun) mcnamara, as in robert mcnamara
mcv	mcv	mean corpuscular volume
media	मीडिया	media
medici	मेडिसी	(proper noun) medici, as in the medici family of italy
medina	मेडिना	(proper noun) medina, as in ernest medina
medvedev	मेदवेदेव	medvedev
mekong	मेकांग	mekong
melbourne	मेलबोर्न	melbourne
mendeleev	मेंडलीव	mendeleev
menes	मेनेस	(proper noun) menes
mercedes	मर्सिडीज	a name
messenger	दूत	messanger
messerschmitt	messerschmitt	messerschmitt, as in the messerschmitt me-109, a german plane
messi	मेस्सी	(proper noun) messi, as in argentinian soccer player lionel messi
messiah	मसीहा	messiah
meteora	meteora	meteora
mext	mext	mext
meyer	मेयर	(proper noun) meyer, as in stephenie meyer, author of the twilight series
meyers	मेयर्स	meyers
miami	मियामी	a name
michael	माइकल	michael
michaels	माइकल्स	michaels
michelangelo	माइकल एंजेलो	michelangelo
michigan	मिशिगन	a name
micro	माइक्रोफोन	micro
microbiology	कीटाणु-विज्ञान	microbiology
microeconomics	सूक्ष्म अर्थशास्त्र	microeconomics
micronesia	माइक्रोनेशिया	micronesia
microsoft	माइक्रोसॉफ्ट	(proper noun) the microsoft company
miguel	मिगुएल	miguel
mike	माइक	mike
mikoyan	मिकोयान	mikoyan
mikoyangurevich	mikoyangurevich	(proper noun) mikoyangurevich
milan	मिलान	milan
milano	मिलानो	milano
miley	माइली	miley
mill	चक्की	mill
miller	चक्कीवाला	miller
milton	मिल्टन	milton
min	मिनट	min
minas	मिनस	minas
mindanao	मिंडानाओ	(proper noun) mindanao
ming	मिंग	ming
minnesota	मिनेसोटा	minnesota
minoa	minoa	minoa; the minoan civilization
miraflores	miraflores	miraflores
mirage	मृगतृष्णा	mirage
miroku	miroku	(proper noun) miroku, a japanese name
misfits	मिसफिट्स	misfits
mississippi	मिसीसिपी	mississippi
missouri	मिसौरी	(proper noun) the state of missouri
mitchel	मिशेल	mitchel
mitsubishi	मित्सुबिशी	mitsubishi
miên	सम्मोहन	mien
miêu	mieu	"(term should be ""miêu tả"") to describe (v.)"
miến	सेंवई	burma
miếng	बिट	a piece (n.)
miếu	मंदिर	temple
miền	डोमेन	area
miễn	मुक्त	to exempt (v.)
miện	ताज	crown
miệng	मुंह	mouth
mm	मिमी	millimeter
mobile	मोबाइल	mobile
mode	मोड	mode
modul	मॉड्यूलर	module
modula	मॉड्यूलर	(proper noun) modula, as in modula-2
mohammad	मोहम्मद	mohammad
mohammed	मुहम्मद	mohammed
moi	moi	winkle
molecular	आणविक	molecular
molotov	molotov	molotov
molypden	मोलिब्डेनम	the element molybdenum (n.)
mongolia	मंगोलिया	mongolia
monique	मोनिक	(proper name) monique, a french first name
mono	मोनो	mono
monroe	मोनरो	monroe
mont	मोंट	(proper noun) mont
montaigne	montaigne	montaigne, as in michel de montaigne
montana	मोंटाना	(proper noun) montana, as in the state
montenegro	मोंटेनेग्रो	montenegro
montmartre	montmartre	(proper noun) montmartre
montparnasse	montparnasse	montparnasse
montreal	मॉन्ट्रियल	(proper noun) montreal, quebec
moo	राँभना	(proper noun) moo, as in cha moo won
moong	गड्ढों	moong
mora	मोरा	mora
moravia	मोराविया	moravia
morgan	मॉर्गन	(proper noun) morgan
mori	मोरी	(proper noun) mori
moriarty	मोरियार्टी	(proper noun) moriarty, as in james moriarty from sherlock holmes
morley	मॉर्ले	morley
morocco	मोरक्को	morocco
morris	मोरिस	morris
morrison	मॉरिसन	(proper noun) morrison
morse	बकल	(proper noun) morse, as in morse code
moscow	मास्को	moscow
mosin	मोसिन	mosin
moskva	मास्को	moscow
motown	मोटाउन	motown
mourinho	मुरिन्हो	mourinho
movie	चलचित्र	movie
mozambique	मोजाम्बिक	(proper noun) mozambique
mozart	मोजार्ट	(proper noun) mozart, as in the composer
mp	mp	mp
ms	एमएस	metre per second
msdos	msdos	ms-dos
mtv	एमटीवी	mtv
mu	म्यू	pubis
mua	खरीद	buy
much	बहुत	much
muhammad	मुहम्मद	(proper noun) muhammad, as in muhammad ali
mumbai	मुंबई	mumbai
mun	मुन	a vietnamese name
munich	म्यूनिख	(proper noun) munich
murdoch	मर्डोक	murdoch
muromachi	मुरोमाची	(proper noun) muromachi
murphy	मर्फी	murphy
murray	मुरे	(proper noun) murray, as in dr. conrad murray
mustang	अमेरिका देश का जंगली घोड़ा	mustang, as in the f-51 mustang
muta	म्युटा	a name
muôn	सब	a large number; thousands (adj.)
muối	नमक	salt
muốn	करना चाहेंगे	want
muống	एक प्रकार का पौधा	"(term should be ""rau muống"") water spinach (n.)"
muồi	परिपक्वता	ripe
muỗi	मच्छर	mosquito
muỗng	चम्मच	spoon
muội	कालिख	confusion
muộn	देर से	late (adv.)
myanma	म्यांमार	the country of myanmar
myanmar	म्यांमार	(proper noun) myanmar
myspace	माइस्पेस	(proper noun) myspace
mà	लेकिन	also
mài	पिसाई	tomorrow
màn	स्क्रीन	curtain (n.)
mành	अंधा	a bamboo screen (n.)
mào	चढाई	a comb or crest, as in the body part of a bird
màu	रंग	color
mày	आप	sew
má	मां	cheek
mác	अंक	a name (marx)
mách	युक्तियाँ	tell
máclênin	maclenin	marxist-leninist
mái	छत	"entire term should be ""thoai mai""; means ""comfortable"""
mát	ठंडा	cool
máu	रक्त	blood
máy	मशीन	a machine (n.)
mâm	ट्रे	tray
mân	स्पष्ट अर्थ का	"entire term should be ""man viet""; a country of ancient asia that now corresponds to a province in southern china"
mâu	विरोधाभासों	contradiction
mây	धुंधला	cloud
mã	कोड	"(term should be ""la mã"") roman (adj.)"
mãi	सदैव	forever (adv.)
mãimại	maimai	commerce
mãn	शालीनता	satisfy
mãnh	मान्ह	intense
mão	ताज	cat
mè	तिल	sesame
mèo	बिल्लियों	cat (n.)
mé	धार	a border
méo	विकृति	alter
mép	धार	edge
mét	मीटर की दूरी पर	meter
mênh	विशालता	vast
mêtan	मीथेन	methane
mì	सिर	wheat
mình	उसकी	me
mía	बेंत	sugar cane (n.)
mò	जिज्ञासु	to grope (v.)
mòn	पहना हुआ	trail
móc	कांटा	"(term should be ""máy móc"") machinery (n.)"
món	थाली	dish
mô	ऊतक	mo
môi	ओंठ	lip
môn	विषयों	anus
mông	बट	mongolia
mônôxít	मोनोऑक्साइड	monoxide
môt	बेजोड़	"(term should be ""một"") one (n.)"
môtô	मोटरसाइकिल	motorcycle
mù	अंधा	mu
mùa	ऋतु	season
mùi	गंध	smell
múa	नृत्य	dance
mút	अनुभवहीन	to suck (v.)
münchen	म्यूनिख	(proper noun) munchen
măng	बाँस की गोली	bamboo shoot (n.)
mĩ	mi	america
mũ	टोपी	cap
mũi	नाक	nose
mơ	खुबानी	vague
mơn	मोन	caress
mưa	बारिश	rain
mưu	स्टाफ़	"(should be ""tham mưu"") advisors"
mươi	पचास	tens
mương	नाली	ditch
mướn	किराए	hire
mướt	रेशम की भांति मुलायम	smooth (adj.)
mường	muong	(proper noun) mường, a minority people in vietnam (n.)
mượn	उधार	borrow
mượt	चिकनी	glossy (adj.)
mạc	तंबू	"(should be ""mộc mạc"") simple or natural"
mạch	सर्किट	vessel
mại	व्यापार	commerce
mạn	रोमानी	romantic
mạnh	मज़बूत	strong
mạo	दिखावट	"(should be ""mạo hiểm"") to brave danger"
mạt	धैर्य	"(term should be ""lê mạt"") the ending or decline of something (adj.)"
mả	गंभीर	tomb or grave (n.)
mải	माई	absorbedly
mảng	प्लेट	genre
mảnh	टुकड़े	piece
mất	खोया	lose
mấu	लाइन	key
mấy	कुछ	any
mầm	रोगाणु	kindergarten
mầu	रहस्य	color
mẩu	टुकड़े	piece
mận	बेर	plum
mập	स्थूल	fat
mật	सुरक्षित	intimate
mậu	व्यापार	mau
mắc	भुगतना	get
mắm	मछली की चटनी	"(term should be ""nước mắm"") fish sauce (n.)"
mắn	सौभाग्य से	"(term should be ""may mắn"") fortunate (adj.)"
mắng	डांटा	scold
mắt	आंख	eye
mặc	कपड़ा	wear
mặn	नमक	salt
mặt	चेहरा	face
mẹ	मां	mother (n.)
mẹo	युक्तियाँ	trick
mẻ	खरोंच	cool
mẽ	मज़बूत	strong
mến	प्रिय	to adore or like greatly (v.)
mề	कंठ	locket
mềm	मुलायम	soft
mệnh	सममूल्य	revolution
mệt	बीमार	tired
mỉ	विस्तृत	meticulous
mỉa	ताना	ironic
mỉm	मुस्कुरा	smile
mịch	मीच	"(term should be ""tịch mịch"") quiet (adj.)"
mịn	चिकनी	smooth
mịt	गाढ़ा	dim
mọc	बढ़ने	to grow (v.)
mọi	सब	every
mọn	नाबालिग	lowly
mỏ	बिल	mine
mỏi	थकान	tired (adj.)
mỏng	पतला	thin
mốc	बासी	border
mối	दीमक	relationship
mốt	फ़ैशन	fashion or style (n.)
mồ	पसीना	"(term should be ""mồ hôi"") sweat (n.)"
mồi	शिकार	bait (n.)
mổ	सर्जरी	to dissect or perform surgery (v.)
mỗi	प्रत्येक	every
mộ	समाधि	admire
mộc	बढ़ईगीरी	simple
mộng	सपना	dream
một	एक	one
mới	नई	new (adj.)
mờ	अपारदर्शी	dim
mời	आमंत्रण	invite
mở	खुला	open
mỡ	ग्रीज़	fat or grease (n.)
mục	आइटम	purpose
mụn	मुँहासे	pimple
mức	स्तरों	level
mứt	जाम	preserve
mừng	स्वागत	to be happy
mửa	क़ै	to vomit (v.)
mực	स्याही	"(term should be ""chuẩn mực"") standard (n.)"
mỳ	गेहूँ	noodles (n.)
mỹ	जुर्माना	america
mỹcông	mycong	my private
na	na	"(term should be ""na uy"") the country of norway"
naadam	नादाम	naadam
nacional	nacional	nacional
nagant	nagant	nagant
nagar	नगर	nagar, as in champa po nagar
nagasaki	नागासाकी	(proper noun) the city of nagasaki, japan
nagoya	नागोया	a name
nagumo	nagumo	nagumo
nai	मृग	a deer
nairobi	नैरोबी	nairobi, a city in kenya (n.)
nakajima	नाकाजिमा	a japanese name
nalbandian	नलबैंडियन	a name
nam	दक्षिण	male
nambắc	nambac	nambac
namibia	नामीबिया	namibia
namnam	namnam	male-male
namno	namno	nammo
nancy	नैंसी	nancy, as in nancy pelosi
nang	कूप	"(term should be ""cẩm nang"") a handbook (n.)"
nanh	कुत्ते का	fang
nano	नैनो	nano
naomi	नाओमी	naomi, as in model naomi campbell
napoleon	नेपोलियन	(proper noun) napoleon
napoli	नपोली	(proper noun) napoli
napoléon	नेपोलियन	napoleon
nara	नारा	nara
nasa	नासा	(proper noun) nasa
nat	नेट	nat
nathan	नाथन	nathan
natri	सोडियम	sodium
nauru	नाउरू	a name
nava	नवा	nava
navarre	navarre	navarre
nay	वर्तमान	this (adj.)
needham	needham	needham
nelson	नेल्सन	(proper noun) nelson, as in nelson mandela
neo	लंगर	"(term should be ""mỏ neo"") an anchor (n.)"
neon	नीयन	neon
nepal	नेपाल	nepal
nepomuk	nepomuk	a name
nessie	nessie	(noun) nessie, the nickname of the loch ness monster
net	जाल	net
netbook	नेटबुक	netbook
netscape	नेटस्केप	netscape
networks	नेटवर्क	networks
neumann	न्यूमन	(proper noun) neumann
neutrino	न्युट्रीनो	neutrino
nevada	नेवादा	nevada
neverland	नेवरलैंड	neverland
newcastle	न्यूकासल	newcastle
newspaper	अख़बार	newspaper
newton	न्यूटन	newton
newtons	न्यूटन	(proper noun) newton's
next	अगला	next
nga	रूस	russia
ngai	सिंहासन	crown
ngang	आड़ा	horizontal
ngao	क्लैम	clam (n.)
ngay	अभी	even
nghe	सुनना	hear
nghinh	nghinh	welcome
nghiêm	गंभीरता से	serious
nghiêng	इच्छुक	inclined
nghiêu	ईएफए	nghiêu, a vietnamese name
nghiền	चक्की	crush
nghiễm	स्वचालित रूप से	serious
nghiệm	अनुभव	experiment
nghiện	व्यसन	addiction
nghiệp	उद्योग	karma/ sự nghiệp=career
nghiệt	कठोर	adverse
nghành	उद्योग	faculty
nghèo	दरिद्र	poor
nghé	नाघे	to glance out of the corner of one's eye (v.)
nghê	शेर	nghe khuong
nghênh	स्वागत	support
nghìn	हज़ार	thousand
nghĩ	सोच	think
nghĩa	अर्थ	meaning
nghẽn	भीड़	jam
nghếch	nghếch	stupid
nghề	कब्जे	career
nghệquận	nghequan	art district
nghỉ	छुट्टी	relaxation
nghị	सम्मेलन	think
ngo	मिठाइयां	ngo
ngoan	अच्छा लड़का	good
ngoc	ngoc	"(term should be ""ngọc"") gem (n.)"
ngon	स्वादिष्ट	delicious
ngoài	बाहर	outside of
ngoại	विनिमय	external
ngoạn	लुभावनी	spectacular
ngoặc	कोष्टक	bracket
ngoặt	मोड़	landmark
ngu	मूर्खतापूर्ण	stupid
ngung	ngung	(proper noun) a vietnamese first name
nguyen	गुयेन	nguyen
nguyên	मूल	reason
nguyền	शाप	curse
nguyện	व्रत	"(term should be ""mãn nguyện"") to be satisfied (adj.)"
nguyệt	तिमाही	moon
nguôi	शांतिदायक	fade away
nguồn	स्रोत	source
nguời	व्यक्ति	people
nguỵ	nguy	camouflage
ngà	हाथी दांत	russian
ngàn	हज़ार	thousand
ngàng	आने वाले	"(term should be ""ngỡ ngàng"") to be at fault (adj.)"
ngành	शाखा	sector
ngào	मीठा	sweet
ngày	दिन	day
ngách	गली	"entire term should be ""ngoc ngach""; means ""a small, out-of-the-way road"""
ngái	घबड़ाया हुआ	chinese ethnic group living in the vietnamese highlands near the china border
ngán	ऊब	to be tired of
ngáng	फैलानेवाला	stop
ngát	पुष्प प्रदर्शन	"(term should be ""ngát hương"") fragrant (adj.)"
ngân	बैंकिंग	money
ngây	उदास से	"(term should be ""ngây ngất"") to be in ecstasy"
ngãi	ngai	ngai
ngò	धनिया	coriander
ngó	नज़र	to look (v.)
ngói	टाइल	tile or shingle
ngón	उंगली	a finger (n.)
ngót	संकोचन	"(term should be ""rau ngót"") also called sweet leaf, a type of leafy vegetable used to make soup (n.)"
ngôn	प्रवचन	manifesto
ngông	हंस	eccentric
ngõ	लेन	lane
ngùi	कृपापूर्वक	sad
ngút	ngut	"entire term is ""ngut troi""; means ""sky-high"""
ngăn	कम्पार्टमेंट	prevent
ngũ	नींद	rank
ngơ	अंधा	ignored (adj.)
ngơi	व्यापार	"(term should be ""nghỉ ngơi"") to rest (v.)"
ngư	मछुआरों	fishermen
ngưng	संघर्ष	stop
ngưu	बुल्स	buffalo
ngươi	तेरा	an ancient form of address equivalent to thou or thee (n.)
người	लोग	people
ngưỡng	द्वार	religious
ngược	उलटा	opposite
ngạc	सुख से	surprise
ngạch	कोटा	"(term should be ""kim ngạch"") turn-over (n.)"
ngạn	दाहिने किनारे	bank
ngạnh	कंटिया	self-willed
ngạo	अभिमानी	"(term should be ""ngạo ngược"") insolent (adj.)"
ngạt	asphyxiated	stuffy
ngấm	नमकीन पानी	draw
ngất	बेहोशी	unconscious
ngầm	अंतर्निहित	underground
ngần	संकोच	hesitate
ngẩn	मूर्खतापूर्ण	froze
ngẫm	ngam	think
ngẫu	बिना सोचे समझे	ngẫu nhiên= random
ngậm	हाइड्रेटेड	keep
ngập	बाढ़ आ गई	flood
ngắm	मनन	to contemplate or look admiringly at something (v.)
ngắn	कम	short
ngặt	कठोर	strict
ngọ	दोपहर	horse
ngọc	मणि	pearl
ngọn	चोटी	top
ngọt	मीठा	sweet (adj.)
ngồi	बैठ	sit
ngộ	इलाज	ngo
ngột	अप्रत्याशित रूप से	sudden
ngớ	मूर्खतापूर्ण	silly
ngời	चमकते हुए	bright
ngỡ	सोचा	surprised
ngợi	प्रशंसा	praise
ngợm	शरारती	naughty
ngục	नरक	dungeon
ngụm	घूंट	sip
ngụy	कठपुतली	puppet
ngủ	सोने के लिए	sleep
ngủi	रहते थे	"(should be ""ngắn ngủi"") short-lived"
ngứa	खुजली	itchy
ngừ	टूना	tuna
ngừa	निवारक	prevent
ngừng	संघर्ष	to cease (v.)
ngửa	सामना करो	supine
ngửi	गंध	to smell
ngữ	भाषा	term
ngự	आसीन	defend
ngựa	घोड़ा	horse
ngực	छाती	chest
nha	न्हा	dental
nhakẻ	nhake	nha-ke
nham	लावा	"(actual term is ""dung nham"") lava"
nhan	हकदार	"(term should be ""dung nhan"") countenance or facial appearance (n.)"
nhang	धूप	incense
nhanh	उपवास	fast
nhat	nhat	nhat
nhen	संदीप्त	rekindle
nhi	बच्चे	junior
nhiên	कोर्स	tuy nhiên= however
nhiêu	बहुत	how many
nhiều	बहुत	numerous
nhiễm	संक्रमण	infect
nhiễu	हस्तक्षेप	noise
nhiệm	उत्तरदायित्व	task
nhiệt	गर्मी	heat
nhk	एनएचके	nhk
nhs	एन एच एस	nhs
nhu	जरूरत	demand
nhuận	लाभ	leap year
nhuệ	अभिजात वर्ग	elite
nhuộm	रंगाई	dye
nhàn	आराम से	leisure
nhàng	सज्जन	"(term should be ""nhẹ nhàng"") gentle (adj.)"
nhào	गूंध	to fall headlong
nhác	आलसी	coward
nhái	नक़ली	illegal copy
nhánh	शाखा	branch
nháp	ड्राफ्ट	draft
nháy	झपकी	to flash or blink (v.)
nhâm	घूंट	leap
nhã	सुंदर ढंग से	"(term should be ""thanh nhã"") elegant"
nhãn	लेबल	"(term should be ""gán nhãn"") to affix a label"
nhét	रखना	put
nhì	दूसरा	second (adj.)
nhìn	नज़र	to look (v.)
nhí	लड़कों	children
nhím	नटखट लड़का	porcupine
nhòm	दूरबीन	to peep (v.)
nhóc	बच्चा	brat
nhóm	समूह	group (n.)
nhô	आगे निकलना	emerge
nhôm	अल्युमीनियम	aluminum (n.)
nhúng	डुबकी	embed
nhút	संकोच	shy
nhăn	झुर्रियों	wrinkle
nhĩ	आलिंद	turkey
nhũ	इमल्शन	"(term should be ""thạch nhũ"") stalactite (n.)"
nhũng	दूषण	bribery
nhơn	भलाई	nhon
như	जैसे कि	like
nhưng	लेकिन	but
nhương	निष्कासित	(proper noun) vietnamese first name
nhường	सौंप दिया	yield
nhưỡng	मिट्टी	soil
nhược	दुर्बलता	weak
nhượng	रियायतें	concession
nhạ	न्हा	nha
nhạc	संगीत	music
nhạn	स्वैलोज़	bird
nhạo	मज़ा	ridicule
nhạt	पीला	light
nhạy	संवेदनशीलता	sensitive
nhảy	नृत्य	jump
nhấc	उठा लिया	lift
nhấm	nham	rodent
nhấn	प्रेस	to press (v.)
nhất	सबसे ज्यादा	most
nhầm	उलझन में	misunderstand
nhầy	चिपचिपा	glutinous
nhẫn	के छल्ले	patient
nhậm	लेने	inaugurate
nhập	आयात	penetrate
nhậu	nhau	drink
nhậy	संवेदनशीलता	sensitive
nhắc	के लिए प्रेरित किया	to remind (v.)
nhắm	लक्ष्य	aim
nhắn	संदेश	message
nhằm	को	for the purpose of (adv.)
nhẵn	चिकनी	smooth
nhặt	उठा लिया	pickup
nhẹ	प्रकाश	light
nhẹn	गतिशीलता	nhanh nhẹn= fast/nimble
nhị	द्वितीय	sensitive
nhịn	उपवास	fasting
nhọ	nhớ	smear
nhọn	नुकीला	sharp (adj.)
nhỏ	छोटा	small
nhỏ|cây	छोटा | पेड़	small|tree
nhỏ|một	छोटा | एक	small | one
nhỏ|phải|	छोटा | सही |	small|right
nhỏ|phải|px|	छोटा | सही | px |	small | have | px |
nhỏ|phải|px|bức	छोटा | सही | px | pics	grape / fade / px / buc
nhỏ|phải|px|cây	छोटा | सही | px | पेड़ |	px spicy grape fade
nhỏ|phải|px|khu	छोटा | सही | px | क्षेत्र |	small|right|px|area
nhỏ|phải|px|michael	छोटा | सही | px | माइकल |	small|right|px|michael
nhỏ|phải|px|máy	छोटा | सही | px | मशीन |	small | right|px|machine
nhỏ|phải|px|một	छोटा | सही | px | एक |	small|right|px|one
nhỏ|phải|px|quân	छोटा | सही | px | बल |	small|right|px|army
nhỏ|px|	छोटा | px |	small
nhỏ|px|các	छोटा | px |	small
nhỏ|px|phải|kiến	छोटा | px | सही | चींटी |	small | px | right | patience
nhỏ|quân	छोटा | बल	small|army
nhỏ|trái|px|máy	छोटा | बायां | px | मशीन |	small|left|px|plane
nhỏ|tượng	छोटी मूर्तियाँ	small|statue
nhốt	बंद कर दिया	confine
nhồi	भरवां	cram
nhổ	साहस	uproot
nhộn	पॉप	busy
nhớ	याद करना	remember
nhớt	चिपचिपा	viscid
nhờ	धन्यवाद	by
nhờn	चिकनी	multiplication
nhở	सावधानियों	remind
nhụ	खासियत	nhu
nhục	अपमानित	shame
nhủ	जैसा	needs
nhức	दर्द	pain
nhứt	nhut	first (n.)
nhừ	जेली	tender
những		the
nhựa	प्लास्टिक	plastic
nhựt	रविवार	"like the word ""nhật""; meaning ""sun"" (n.)"
ni	नी	nun
nia	एनआईए	a flat basket (n.)
nicaea	नाइसिया	nicaea
nicaragua	निकारागुआ	(proper noun) nicaragua
niccolò	निकोलो	(proper noun) niccolo, as in writer niccolo machiavelli
nicolas	निकोलस	(proper noun) nicolas, as in nicolas sarkozy
niels	नील्स	(proper noun) niels
nigeria	नाइजीरिया	nigeria
nikel	निकल	nickel
niken	निकल	nickel
nikita	निकिता	(proper noun) nikita, a first name
nikko	निक्को	(proper noun) nikko
nikolai	निकोलाई	nikolai
nikolayevich	nikolayevich	nikolayevich
nil	शून्य	nile
nile	नील	(proper noun) the river nile
nimitz	निमित्ज	(proper noun) nimitz, as in the ship uss nimitz
nin	निन	nin
ninh	सुरक्षा	ninh, as in bắc ninh
nintendo	nintendo	(proper noun) nintendo, the game company
nippon	निप्पॉन	nippon
nitơ	नाइट्रोजन	nitrogen (n.)
nixon	निक्सन	(proper noun) nixon, as in former president richard nixon
niên	युवा	youth
niết	पासिंग	nirvana
niềm	दोषसिद्धि	trust
niệm	सालगिरह	concept
niệu	मूत्र	urinary
nj	न्यू जर्सी	nj
nlf	nlf	nlf
nm	एनएम	nano-meters
noah	नूह	(proper noun) noah
nobel	नोबेल	nobel
nobita	nobita	nobita
noel	नोएल	(proper noun) noel
noi	नोई	imitate
nokia	नोकिया	(proper noun) nokia, as in the nokia corporation
nol	nol	nol
nom	nom	look after
non	युवा	mountain
nonpenetrative	nonpenetrative	nonpenetrative
norfolk	norfolk	norfolk
norge	norge	norge
norma	नोर्मा	(proper noun) norma, a female first name
norman	नॉर्मन	norman
normandie	नोर्मंडी	normandile
northrop	northrop	northrop, as in the northrop f-5 freedom fighter
norton	नॉर्टन	norton
norway	नॉर्वे	norway
nou	nou	nou
novak	नोवाक	novak
now	अब	now
nowc	nowc	nowc
noãn	बीजाणु	ovule
nsnd	पीपुल्स कलाकार	people's artist
nst	nst	chromosome
nubia	नूबिया	nubia
number	संख्या	number
nupedia	न्यूपीडिया	a name
nusa	नुसा	nusa
nuôi	चारा	feed
nuối	nuối	"(term should be ""tiếc nuối"") to regret (v.)"
nuốt	निगल	to swallow (v.)
nuớc	पानी	water
nxb	प्रकाशक	publisher
nynorsk	नाइनोर्स्क	nynorsk
nà	nà	na
nài	जोर देते हैं	pleading
nàn	शिकायत	poor
nành	सोया	soy
nào	चलो	would
này	यह	this
ná	गुलेल	a crossbow (n.)
nách	कांख	underarm (n.)
náo	कोलाहल	riot
nát	कुचल	ruin
náu	आश्रय	hide
nâng	उत्तोलक	raise
nâu	भूरा	brown
nã	चाहता था	to track down (v.)
não	मस्तिष्क	brain
né	बचना	dodge
ném	फेंक	to throw (v.)
nén	संकुचित	compress
nét	स्ट्रोक	feature
nê	गिन्नी	ne
nên	चाहिए	should or ought to
nêu	कहा गया है	mention
nòi	दौड़	race
nòng	बैरल	barrel
nói	कहते हैं	to say or speak (v.)
nón	टोपी	cone
nóng	गरम	hot
nô	दासत्व	slave
nôbita	nobita	nobita
nôi	पालना	cradle
nôm	nom	ancient vietnamese script that borrowed heavily from han chinese characters
nôn	उल्टी	vomit
nông	उथला	farmer
nõn	खुली	peeled
nùng	nung	nung
núm	दस्ता	nipple
núp	पृथ्वी	hide
nút	गांठ	button
năm	साल	year
năn	पछतावा	"(term should be ""ăn năn"") remorse (n.)"
năng	शक्ति	"(term should be ""khả năng"") ability (n.)"
nơi	जगह	a place
nơtrino	न्युट्रीनो	neutrino
nước	देश	country
nước 	देश	water
nướng	ग्रिल	grill
nǎm	nǎm	year
nạ	मास्क	mask
nạc	दुबला	lean (adj.)
nại	शिकायतों	complain
nạn	पीड़ितों	a disaster (n.)
nạo	curette	to scrape (v.)
nạp	लोड	tribute
nản	हतोत्साहित	depressed
nảy	उछाल वाली	"(term should be ""nảy sinh"") to give rise to (v.)"
nấc	पायदान	a hiccup (n.)
nấp	छिपने	hide
nấu	पकाना	cook
nấy	अस्वीकार	this
nần	ऋण	debt
nầy	यह	this
nẩy	उछाल वाली	"(term should be ""nảy nở"") to sprout or start growing (v.)"
nẫu	n सूरज	"(""giọng nẫu"") a vietnamese accent commonly found in cities such as phú yên"
nậm	वियतनाम	"(term should be ""nậm rốm"") the name of a river in vietnam (proper noun)"
nập	सबसे व्यस्त	busy
nắm	पकड़	to grasp or hold (v.)
nắng	धूप	sunlight
nắp	ढक्कन	a lid or cover (n.)
nằm	स्थित	to lie (v.)
nẵng	नांग	"(term should be ""Đà nẵng"") a city in central vietnam"
nặc	गुमनामी	heavy
nặn	मोडलिंग	mould
nặng	भारी	heavy
nẻo	नियति	turn
nếm	स्वाद	taste
nến	मोमबत्ती	candle
nếp	शिकन	sticky rice (n.)
nếu	अगर	if (adv.)
nề	चिनाई	severe
nể	सम्मानित	respect
nện	तेज़	ram
nỉ	अनुभूत	beg
nịnh	चापलूसी	flatter
nọ	दूसरा	the other
nọc	पाबाँसा	tadpole
nỏ	धनुष	a crossbow (n.)
nối	लिंक	connection
nốt	नोट	to finish off (v.)
nồi	पॉट	pot
nồm	मानसून	humid (adj.)
nồng	एकाग्रता	heavy
nổ	विस्फोटक	explode
nổi	अच्छी तरह से	nổi tiếng= famous
nỗ	प्रयासों	affort
nỗi	कि	state
nộ	कोप	anger
nội	आंतरिक	on the paternal side (adj.)
nộn	टोपी	non
nộp	प्रस्तुत	submit
nới	ढीला हो गया	ease
nở	प्रस्फुटन	bloom
nỡ	करने के लिए दिल	do you have a heart to
nợ	देना है	debt
nụy	नंगा	"(term should be ""nụy nhân"") the vietnamesized han term depicting the japanese"
nứa	काग	a kind of bamboo (n.)
nứt	फटकारा	to crack
nửa	आधा	haft
nữa	एक और	moreover
oahu	oahu	(proper noun) oahu
oai	भय	heroic
oakland	ओकलैंड	oakland
oan	oan	injustice
oanh	oanh	(with word liet) glorious
obama	ओबामा	obama
oblast	ओब्लास्ट	(proper noun) oblast, as in tomsk oblast
oc	oc	oc
october	अक्टूबर	(proper noun) october
oda	oda	oda
oder	ओडर	oder
odyssey	ओडिसी	odyssey, as in the odyssey, homer's epic
oecd	ओईसीडी	oecd
officer	अफ़सर	officer
officers	अधिकारियों	officers
ohkawa	ohkawa	ohkawa
okhotsk	ओखोट्सक	okhotsk
oliver	ओलिवर	oliver
olivier	ओलिवियर	olivier
olympus	ओलिंप	olympus
om	ब्रेज़्ड	to simmer
omar	उमर	a name
ong	ओंग	bee
ontario	ओंटारियो	ontario
oort	ऊर्ट	oort
oprah	oprah	(proper noun) oprah, as in oprah winfrey
organ	अरगनिस्ट	organ
oricon	oricon	oricon
origin	मूल	origin
orion	ओरियन	(proper noun) orion, the hunter
orleans	ऑरलियन्स	(proper noun) orleans, as in new orleans
orochimaru	ओरोचिमारू	orochimaru
orton	orton	orton
os	ओएस	os
osaka	ओसाका	(proper noun) osaka, a city in japan
osama	ओसामा	(proper noun) osama, as in osama bin laden
osamu	ओसामू	(proper noun) osamu, a japanese first name
oscar	ऑस्कर	oscar
osiris	ओसीरसि	(proper noun) osiris, as in the egyptian god
oskar	ऑस्कर	a name
oslo	ओस्लो	oslo
osment	osment	osment
ospf	ospf	ospf
ossetia	ओसेशिया	(proper noun) ossetia
oswald	ओसवाल्ड	oswald
other	अन्य	other
otto	ओटो	(proper noun) otto, as in otto von bismarck
ottoman	तुर्क	(proper noun) ottoman, as in the ottoman empire
outstanding	बकाया	xuat sac
owen	ओवेन	(proper noun) owen, as in michael owen
oxford	ऑक्सफ़ोर्ड	oxford
oxy	ऑक्सीजन	oxygen
ozawa	ozawa	(proper noun) ozawa, as in maria ozawa
oán	नाराज़गी	"(term should be ""oán than"") to complain or whine"
oát	वाट	a watt (n.)
oản	बसने में	"(term should be ""ăn oản"") gratitude and resentment (n.)"
paget	पेजेट	(proper noun) paget
pailin	पैलिन	pailin
pakistan	पाकिस्तान	(proper noun) the country of pakistan
palais	पेले	palais, as in grand palais
palawan	पालावान	palawan
palenque	palenque	(proper noun) palenque
palestine	फिलिस्तीन	a name
palgrave	पालग्रेव	palgrave
pali	पाली	a name
pamir	पामीर	pamir
pan	कड़ाही	pan, as in peter pan
panama	पनामा	panama
panamax	पेनामेक्स	(proper noun) panamax
panduranga	पांडुरंग	(proper noun) panduranga
panthera	panthera	(proper noun) panthera, a genus of felines
panthéon	panthéon	a name
paolo	पाओलो	paolo
paperback	किताबचा	paperback
papua	पापुआ	papua
paraguay	परागुआ	(proper noun) paraguay
pari	pari	pari
park	पार्क	park
parton	पार्टन	parton
patel	पटेल	(proper noun) patel
patrick	पैट्रिक	patrick
patriot	देश-भक्त	patriot
paul	पॉल	paul
paula	पॉला	paula
paulo	पाउलो	(proper noun) paulo
pavia	pavia	pavia
pbs	पीबीएस	pbs
pda	पीडीए	pda
pdf	पीडीएफ	pdf
pedro	पेड्रो	pedro
peers	साथियों	peers
pele	पेले	(proper noun) pele, as in the soccer player
penang	पेनांग	penang
penh	पेन्ह	(proper noun) penh, as in phnom penh
pennsylvania	पेंसिल्वेनिया	pennsylvania
penny	पैसे	(proper noun) penny, an english first name
pereira	परेरा	pereira
perl	पर्ल	(proper noun) perl
pero	पेरो	pero
perry	नाशपाती की मदिरा	(proper noun) perry, as in elizabeth perry
persephone	persephone	presephone
pershing	पर्शिंग	pershing
persian	फ़ारसी	persian
peru	पेरू	peru, as in the south american country
peters	पीटर्स	peter's, possessive of peter
petersburg	पीटर्सबर्ग	(proper noun) petersburg, as in saint petersburg
pfm	pfm	a name
pgs	पृ	associate professor
pgđ	उप निदेशक	associate professor
pha	मिश्रण	to mix
phaethon	phaethon	phaethon
pham	फाम	pham
phanh	ब्रेक	expose
phao	नाव	float
phaolô	पॉल	st. paul, the apostle
pharaoh	फिरौन	pharaoh
pharaon	फैरो	pharaoh
phay	पिसाई	mill
phe	पार्टी	faction
phen	phen	time
phil	फिल	(proper noun) phil, a first name
philip	फिलिप	philip
philippe	फिलिप	philippe
philippines	फिलीपींस	(proper noun) philippines
phillip	फिलिप	(proper noun) phillip
phillips	फिलिप्स	philips
philosophiae	फिलोसोफी	(proper noun) philosophiae, as in the work philosophiae naturalis principia mathematica
phim	चलचित्र	phim
phin	olefins	coffee filter
phineas	phineas	(proper noun) phineas
phiên	बारी	trial
phiêu	एडवेंचर्स	adventurous
phiếm	बकवास	gossip
phiến	ब्लेड	"(should be ""nha phiến"") opium"
phiện	अफ़ीम	opium
phiệt	टाइकून	militarism
phnom	नोम	phnom
phnôm	phnum	phnôm pênh= phnom penh(cambodia's capital)
pho	पनीर	part of a person's name, rat-pho, or ratford
phoenix	अचंभा	(proper noun) phoenix
phong	कक्ष	movement
php	php	php
phrygian	phrygia	phrygian
phu	अलंकृत	"(term should be ""phu nhân"") wife (n.)"
phui	प्रकटीकरण	expose
phun	कश	to spray or spit (v.)
phà	नौका	ferry
phàm	अशिक्षित	superhuman
phàn	शिकायत	complain
phá	तोड़ना	destroy
phác	चिकित्सा	"(term should be ""phác thảo"") outline or sketch (n.)"
phách	हरा	manner (n.)
phái	संप्रदाय	a party
phán	वार्ता	judge
pháo	आतिशबाजी	artillery
pháp	फ्रांस	method
phát	रिहाई	develop
phèn	फिटकिरी	alum
phèo	phèo	organs
phép	परमिट	permit
phê	कॉफ़ी	"(term should be ""phê bình"") to criticize (v.)"
phêrô	पीटर	peter
phì	मोटापा	non-
phình	धमनीविस्फार	bulge
phí	मुक्त	non-
phía		side
phích	थरमस	a flask (n.)
phím	कुंजी	key
phò	समर्थक	"(term should be ""phò mã"") a prince consort"
phòng	कक्ष	office
phó	सौदा	second
phóng	लांच	to launch (v.)
phô	शहर	display
phôi	भ्रूण	embryo
phông	फ़ॉन्ट	font
phùng	कश	phung
phúc	सुख	good fortune (n.)
phúclộc	phucloc	phuc-loc
phún	sputtering	"(term should be ""lún phún"") sparse (adj.)"
phúng	अतिशयोक्तिपूर्ण	satire
phút	मिनट	a minute (n.)
phăn	फ़ान	phan
phăng	फांग	knock
phương		direction
phước	आशीर्वाद	luck
phường	परवरिश	ward
phượng	अचंभा	phoenix
phạn	संस्कृत	sanskrit
phạt	सज़ा देना	punish
phả	वंशावली	pedigree
phải	सही	must
phải 	सही	right
phản	प्रतिक्रिया	reaction
phảng	आसानी से	subtle
phần	भाग	part
phẩm	है	food
phẩy	अर्धविराम	a comma
phẫn	रोष	wrathful
phẫu	सर्जरी	surgery
phận	विभाग	part
phật	बुद्धा	buddhist
phẳng	विमान	flat (adj.)
phế	बेकार	dismiss
phết	spreadable	to spread or smear (v.)
phỉ	हेज़लनट	defame
phỏng	साक्षात्कार	interview
phố	सड़क	city
phối	समन्वयक	coordinate
phốt	विषाक्त	"(term should be ""phốt-phát"") phosphate (n.)"
phồng	कश	to swell (v.)
phổ	लोकप्रिय	popular
phổi	फेफड़ा	lung
phộng	मूंगफली	peanut
phới	मोट	"(term should be ""phơi phới"") mildly exciting (adj.)"
phở	फो	pho
phục	रों	convincing
phụng	पूजा	worship
phụt	बेदखलदार	minute
phủ	सरकार	government
phức	विभिन्न	complex
picchu	पिचू	a name
piccolo	छोटा पियानो	piccolo
pierre	पियरे	pierre
pierrot	pierrot	pierrot
pietro	पिएत्रो	pietro
pike	पाइक	pike
pin	सेल	battery
pinlus	pinlus	pinlus
pioneer	अगुआ	pioneer
pipes	पाइप	pipes
pisa	पीसा	a name
piston	पिस्टन	piston
pitch	पिच	pitch
pius	पायस	pius
plaaf	plaaf	plaaf
plan	योजना	plan
plasma	प्लाज्मा	plasma
plate	प्लेट	plate
plato	प्लेटो	plato
platon	platon	platon
player	खिलाड़ी	player
pleiku	प्लेकू	(proper noun) pleiku
pleistocen	pleistocen	pleistocen
plus	प्लस	plus
pluto	प्लूटो	pluto
pm	बजे	pm
pmu	पीएमयू	pmu
po	पो	po
pokémon	पोकीमोन	pokemon
pol	पोल	pol
poland	पोलैंड	poland
pollack	एक प्रकार की समुद्री मछली	a name
pollux	पोलक्स	a name
polo	पोलो	(proper noun) polo, as in marco polo
polynésie	polynésie	polynesian
pont	पोंट	(proper noun) pont, as in pont de normandie
pop	पॉप	pop
portland	पोर्टलैंड	portland
porto	पोर्टो	porto
pot	पॉट	pot
potsdam	पॉट्सडैम	(proper noun) potsdam
potter	कुम्हार	(proper noun) potter, as in harry potter
pour	बहना	not vietnamese
powell	पॉवेल	(proper noun) powell, as in general colin powell
pradesh	प्रदेश	pradesh
praha	प्राहा	praha
pratzen	pratzen	pratzen
preah	प्रेअह	(proper noun) preah
premier	प्रधान	premier
preminger	preminger	(proper noun) preminger
preston	प्रेस्टन	(proper noun) preston, as in john preston
prince	सरदार	prince
princeton	प्रिंसटन	princeton
printemps	printemps	printemps
printf	printf	printf
prinz	प्रिंज़	(proper noun) prinz, as in birgit prinz, the female german soccer player
prix	प्रिक्स	(proper noun) prix, as in the grand prix
procellarum	procellarum	procellarum, as in oceanus procellarum, the name of a mare on the moon
projekt	प्रॉजेक्ट	projekt
prometheus	प्रोमेथियस	(proper noun) prometheus
protein	प्रोटीन	protein
prôtêin	प्रोटीन	protein (n.)
ps	ps	ps
psv	पीएसवी	psv
ptolemy	टॉलेमी	ptolemy
ptq	ptq	ptq
puerto	पर्टो	puerto
pulau	pulau	(proper noun) pulau, as in pulau tekong, an island
pulitzer	पुलित्जर	(proper noun) pulitzer, as in the pulitzer prize
pulp	गूदा	pulp
punjab	पंजाब	punjab
pusan	पुसान	(proper noun) pusan
putin	पुतिन	putin
pyrenees	pyrenees	pyrenees
pytago	पाइथागोरस	(proper noun) pytago
pzl	pzl	pzl
péc	पीईसी	"(term should be ""vịnh péc xích"") the persian gulf"
pérez	पेरेस	(proper noun) perez, as in javier perez de cuellar
păng	वेदना	fansipan
pơ	पो	"(term should be ""pơ kô"") a river in vietnam (n.)"
q	क्ष	q ( a letter)
qatar	कतर	qatar
qd	qd	quantum dots
qing	किंग	qing, as in the qing dynasty of  china
qlvnch	arvn	army of the republic of vietnam
qua	द्वारा	transmit
quad	ट्रैक्टर	quad
quan	कार्यालयों	"(term should be ""quan hệ"") relationship (n.)"
quang	ऑप्टिकल	bladder
quanh	चारों ओर	around
quay	रोटरी	turn
que	छड़	stick
queen	रानी	queen
queens	क्वीन्स	(proper noun) queens, as in the new york borough
queensland	क्वींसलैंड	queensland
quen	परिचित	accustomed to
qui	कुई	formal
quincy	quincy	(proper noun) quincy, as in quincy jones
quran	कुरान	quran
quy	प्रदान की	"(term should be ""quy ước"") agreement"
quyên	दान	"(term should be ""quyên góp"") to donate (v.)"
quyến	आकर्षण	"(term should be ""gia quyến"") family"
quyền	प्राधिकारी	right
quyện	quyên	mix
quyệt	बेवफ़ा	"(should be ""xảo quyệt"") devious"
quá	बहुत	over
quái	नरक	strange or odd
quán	दुकान	hometown
quáng	हितैषी	blind
quát	व्यापक	generalize
quân	सैन्य	army (n.)
quãng	दूरी	optical
quét	घुमाव	to sweep (v.)
quê	ग्रामीण इलाकों	countryside
quên	भूलना	forget
quý	तिमाही	love
quýt	कीनू	tangerine
quăng	टॉस	to throw (v.)
quĩ	धन	orbit
quạ	कौआ	crow (con qua)
quạt	प्रशंसक	fan
quản	प्रबंध	"(entire term is ""cai quản"") to manage"
quảng	विज्ञापन	guangzhou
quấn	चादर	wrap around
quất	ब्लूबेरी	whip
quấy	उत्पीड़न	harass
quần	पैंट	pants (n.)
quầng	प्रभामंडल	halo
quầy	काउंटरों	stall
quẩy	घाट	quay
quẫn	व्याकुल	necessitous
quận	काउंटी	county (n.)
quật	excavating	excavation
quẳng	फेंक दिया	throw
quặc	अपमानजनक	strange (adj.)
quặng	अयस्क	an ore (n.)
quẻ	hexagram	hexagram
quế	दालचीनी	cinnamon (n.)
quết	गूंध	knead
quệ	दिवालिया	exhausted
quỉ	शैतान	demon
quỳ	घुटना टेककर	demon (n.)
quỳnh	quỳnh	quynh
quỵ	स्ट्रोक	stroke
quỷ	शैतान	provided
quỹ	धन	fund
qúy	तिमाही	quy
r	आर	r
rabindranath	रवीन्द्रनाथ	rabindranath
race	दौड़	race
rafael	राफेल	rafael
rafale	गोलीकांड	(proper noun) rafale, as in dassault rafale
rai	राय	slowly intake
raleigh	रैले	raleigh
ralph	राल्फ	(proper noun) ralph, as in ralph waldo emerson
ram	भेड़ा	a name
rama	रामा	rama, first name of several rulers of thailand (n.)
ramadan	रमजान	(proper noun) the fasting month of ramadan
ramayana	रामायण	ramayana
rambus	rambus	rambus
ran	ईरान	ran
ranch	खेत	ranch
randy	भिखारिन	randy
rang	भुना हुआ	roast
rangers	रेंजर लोग	rangers
ranh	सीमा	border (ranh gioi)
rao	विज्ञापन	to announce
rap	खटखटाना	rap
raptor	रैप्टर	raptor
rate	दर	rate
rau	सब्जियों	vegetable
ray	रे	rail (n.)
raya	राया	raya
raymond	रेमंड	raymond
rađa	राडार	radar
reagan	रीगन	reagan
real	असली	real
reanimation	रीएनिमेशन	reanimation
reap	काटना	reap
reef	चट्टान	reef
regia	regia	regia
reichelt	reichelt	reichelt
ren	फीता	lace (n.)
renaissance	नवजागरण	renaissance
renault	रेनॉल्ट	renault
rené	रेने	rene
reo	बजाई	yell
reserve	रिज़र्व	reserve
resort	रिसॉर्ट्स	resort
reverse	उलटा	reverse
revolution	क्रांति	revolution
rey	रे	rey, as in copa del rey
rfid	आरएफआईडी	rfid
rhodes	रोड्स	rhodes
rica	रिका	rica
ricardo	रिकार्डो	ricardo
ricci	रिक्की	ricci
richard	रिचर्ड	richard
richardson	रिचर्डसन	(proper noun) richardson, as in james o. richardson
richie	रिची	(proper noun) richie, as in singer lionel richie
rico	रिको	rico, as in puerto rico
riemann	riemann	riemann, as in bernhard riemann, a german mathematician
rimjob	rimjob	rimjob
rin	रिन	rin
rising	वृद्धि	rising
risk	जोखिम	risk
ritchie	रिची	a name
rivaldo	रिवाल्डो	rivaldo
rivière	rivière	a name
rizal	rizal	rizal
riêng	अलग	own
riêu	रियू	crab
riết	तत्काल	urgently
riềng	galangal	arrowroot
ro	ro	"entire term is ""rui ro""; means ""risk"""
robert	रॉबर्ट	(proper noun) robert
roberto	रॉबर्टो	(proper noun) roberto
roberts	रॉबर्ट्स	roberts
robespierre	रोबेस्पिएर्रे	robespierre
robin	रोबिन	a name
robinson	रॉबिन्सन	robinson, as in michelle robinson
rockefeller	रॉकफेलर	rockefeller, as in john d. rockefeller
roddick	रोडिक	(proper noun) roddick
rodríguez	rodríguez	rodriguez (n.)
roi	छड़ी	a stick or switch used for punishment (n.)
roland	रॉलेंड	roland
romania	रोमानिया	romania
rome	रोम	rome, as in rome, italy
romeo	रोमियो	(proper noun) romeo, as in romeo and juliet
rommel	रोमेल	rommel
ron	रॉन	ron
ronald	रोनाल्ड	ronald, an english first name
ronaldinho	रोनाल्डिन्हो	ronaldinho
rong	शैवाल	seaweed (n.)
rosen	रोजेन	rosen, as in nathan rosen
roth	रोथ	roth
rotterdam	रॉटरडैम	(proper noun) rotterdam
rousseau	रूसो	rousseau
router	रूटर	cong noi
rovers	रोवर्स	rovers
rowling	राउलिंग	rowling
roy	रॉय	(proper noun) roy, a name
rpd	rpd	rpd
rtp	आरटीपी	rpt
rudolph	रूडोल्फ	rudolph
rue	पछताना	rue, as in rue des vases, a street name
rulin	rulin	(proper noun) rulin
rumani	रोमानियाई	romanian
rumiko	rumiko	rumiko, a japanese first name
rummel	rummel	rummel
run	तरकस	tremble
rung	कांपना	to shake or vibrate (v.)
russian	रूसी	(proper adjective) russian
russkaya	russkaya	(proper noun) russkaya avionika
ruth	दया	(proper noun) ruth
rutherford	रदरफोर्ड	rutherford
rutte	rutte	rutte
ruud	रुड	ruud
ruốc	ruốc	pemmican
ruồi	मक्खी	fly
ruổi	जंगली घास	rong ruổi=wandering
ruộng	खेतों	"(term should be ""ruộng đất"") farmland (n.)"
ruột	आंत	internals
rzeczpospolita	rzeczpospolita	rzeczpospolia
rà	जांच करें	finding
ràng	स्पष्ट	clear
rành	ranh	exhaustive
rào	बाधा	barrier
rác	कचरा	gabbage-trash
rách	आंसू	tear
rái	ऊद	colander
rán	तलना	fried (adj.)
ráp	खुलने और बंधनेवाला	to assemble (v.)
râm	छायादार	shade
râu	दाढ़ी	beard or mustache (n.)
rã	अलग	out
rãi	व्यापक रूप से	"(term should be ""rộng rãi"") generous"
rãnh	ट्रेंच	groove
räikkönen	राइकोनेन	raikkonen
rèm	अंधा	curtain
rèn	जाली	train
ré	चिल्लाहट	re
république	république	republique
rét	ठंड	cold
rê	एंड्रयू	"(term should be ""rê bóng"") to dribble the ball in soccer (v.)"
rên	रिरियाना	moan
rêu	काई	moss
rì	री	lush (adj.)
rìa	धार	edge
rình	घात में रहना	to watch for
rìu	कुल्हाड़ी	ax
rít	विशेषज्ञ	to wail (v.)
rò	रिसाव	leak
ròng	जाल	net
rót	डालने का कार्य	to pour (v.)
rô	विचित्र	diamond
rôbôt	रोबोट	robot
rôma	रोम	roman
rông	रोंग	rising (adj.)
rõ	स्पष्ट	clear
rùa	कछुआ	turtle
rùng	डरावने	horror
rút	निकालना	withdraw
răn	आज्ञाओं	commandment
răng	दांत	roasted
rōmaji	रोमाजी	romaji
rũ	शेक	charm
rơ	टायर	"(term should be ""rơ măm"") a minority people living in vietnam"
rơi	पड़ना	fall
rơm	पुआल	straw
rươi	आधा	sand-worm
rước	उठाना	welcome
rưới	चोटना	to sprinkle (v.)
rưỡi	आधा	half
rượt	जल्दबाज़ी से	pursue
rượu	शराब	wine
rạ	चेचक	straw
rạc	अलग	discrete
rạch	नहर	canal
rạng	rạng	break
rạp	थिएटर	theater
rải	विस्तार	spread
rảnh	मुक्त	to be free (adj.)
rất	बहुत	very
rầm	धरन	aggressive
rầu	morosely	sorrow
rẫy	ऊंचे-ऊंचे	full
rậm	जंगली	jungle
rập	अरबी भाषा	"(term should be ""Ả rập"") arab"
rắc	छिड़कना	trouble
rắn	साँप	snake
rằm	पूर्णिमा	a full moon (n.)
rằng	कि	roasted
rặng	चट्टान	a row
rẻ	सस्ता	cheap
rẽ	बारी	"(term should be ""chia rẽ"") to separate or divide (v.)"
rền	गिनगिनानेवाला	pealed
rể	दूल्हा	in-law
rễ	जड़ों	root (n.)
rệp	खटमल	bug
rệt	असाधारण	clearly
rệu	काई	decay
rỉ	ज़ंग खाया हुआ	leak
rịavũng	riavung	ria - bay
rỏ	स्पष्ट रूप से	clearly
rối	कठपुतली	disorder
rốm	रोम	rom
rồ	पागलपन	"(term should be ""điên rồ"") foolish (adj.)"
rồi	पहले ही	and
rồng	अजगर	dragon
rổ	बास्केटबाल	basket
rỗi	उपलब्ध	savation
rỗng	खोखला	hollow
rộ	ro	profuse (adj.)
rộn	व्यस्त	busy
rộng	चौड़ा	wide
rớt	पड़ना	drop
rời	छुट्टी	leave
rỡ	चमकते हुए	brilliant
rợ	जंगली	a savage (n.)
rợn	एकदम	scary
rụng	गिर जाना	to drop
rủ	आमंत्रण	ask
rủi	जोखिम	unlucky or unfortunate (n.)
rứa	रुआ	rua
rừng	वन	forest
rửa	धुलाई	to wash (v.)
rữa	धुलाई	to decompose or rot (v.)
sa	सा	to fall or drop (v.)
sabah	सबा	sabah
sachsen	साचसेन	sachsen
saddam	सद्दाम	(proper noun) saddam, as in saddam hussein
safari	सफारी	safari
safin	सफ़िन	safin
sahara	सहारा	sahara
sai	झूठा	wrong
saigon	saigon	saigon
saintdenis	सैंट -डेनिस	saint-denis
sakura	sakura	sakura
salem	सलेम	(proper noun) salem, as in the city
salvador	साल्वाडोर	salvador
salzburg	साल्ज़बर्ग	salzburg
samhain	samhain	samhain
samo	samo	samo, the name of the first slavic ruler
samoa	समोआ	(proper noun) samoa
samphan	samphan	samphan
samsung	सैमसंग	samsung
samuel	शमूएल	samuel
samuelson	सैमुएलसन	(proper noun) samuelson
samurai	समुराई	samurai
samut	सामट	(proper noun) samut, as in samut prakan in thailand
san	सान	level
sanchez	सांचेज़	sanchez
sang	को	to
sango	सांगो	sango, a language spoken in africa
sangraal	sangraal	sangraal
sanh	जन्म	bear
sanktpeterburg	sanktpeterburg	sankt-peterburg
santos	सैंटोस	santos, as in footballer cristiano ronaldo dos santos aveiro of portugal
sao	कैसे	how
sap	पौधों का रस	sap
sapa	सापा	sapa
sapiens	सेपियंस	sapiens
sar	खोज एवं बचाव	sar
sarah	sarah	sarah, as in sarah pierce
sarawak	सरवाक	(proper noun) sarawak, a malaysian state on the island of borneo
sarcoma	सार्कोमा	sarcoma
sardinia	सार्डीनिया	sardinia
sary	sary	(proper noun) sary, as in ieng sary
saturanga	चतुरंग	saturanga
saturday	शनिवार	saturday
sau	बाद में	after (adv.)
saudi	सऊदी	(proper noun) saudi, as in saudi arabia
saunière	सौनिअर	saunière
scandinavia	स्कैंडेनेविया	scandinavia
schafer	schafer	schafer, as in john c. schafer
schengen	शेंगेन	schengen
schiller	शिलर	schiller
schlesinger	श्लेसिंगर	schlesinger
schneider	श्नाइडर	schneider, a last name
schumacher	शूमाकर	schumacher, as in michael schumacher
schuschnigg	schuschnigg	(proper noun) schuschnigg, as in kurt schuschnigg of austria
schuster	शूस्टर	schuster
schwarzschild	स्च्वार्ज़स्चिल्ड	schwarzschild
scotland	स्कॉटलैंड	scotland
scots	स्कॉट्स	(proper noun) scots
scott	स्कॉट	scott
scream	चीख	scream
scud	वेग से चलना	scud
scuderia	स्क्यूडेरिया	scuderia
sdram	sdram	sdram
search	खोज	search
seattle	सिएटल	(proper noun) seattle, washington
secret	गुप्त	bi mat
sedna	सदना	(proper noun) sedna
see	देखना	see
sejm	sejm	(proper noun) sejm
selena	सेलेना	selena
semit	यहूदी	(proper noun) semit
sen	कमल	lotus
sense	भावना	sense
september	सितंबर	(proper noun) the month of september
serbia	सर्बिया	serbia
sergeyevich	sergeyevich	(proper noun) sergeyevich
seri	सेरी	series
service	सेवा	service
sesshomaru	sesshomaru	a name
seth	सेठ	seth
seto	सेटो	seto
sextus	सेक्सटस	sextus
sexy	कामुक	sexy
seymour	seymour	seymour
seyssinquart	seyssinquart	(proper noun) seyss-inquart
shah	शाह	shah
shaman	जादूगर	the shaman religion
shan	शान	shan
shane	शेन	(proper noun) shane, an english first name
shankly	shankly	(proper noun) shankly, as in bill shankly
shaolin	शाओलिन	shaolin, as in the shaolin temples
sharpay	शार्पे	sharpay, as in sharpay evans
shawn	शॉन	shawn
sherlock	शर्लक	a name
shi	शि	shi
shia	शिया	shia
shiite	शियाओं	shiite
shikoku	शिकोकू	shikoku, a japanese island (n.)
shinichi	शिनिची	shinichi
shinoda	शिनोडा	shinoda, as in mike shinoda
shirakami	shirakami	(proper noun) shirakami
shirakawago	shirakawago	(proper noun) shirakawa-go
shiva	शिव	shiva
shoal	छिछला हो जाना	(proper noun) shoal
shonen	शोनेन	shonen
shop	दुकान	shop
short	कम	short
showcase	शोकेस	a name
shōnen	शोनेन	shonen
siberi	साइबेरियाई	siberi
sicilia	सिसिलिया	sicilia
sicily	सिसिली	sicily, a city in italy
sidney	सिडनी	(proper noun) sidney, as in sidney nolan
siem	सिएम	siem
siemens	सीमेंस	siemens
sierra	पहाड़ों का सिलसिला	(proper noun) sierra
sikh	सिखों	sikh
sikorsky	सिकोरस्की	a name
silas	सिलास	silas
silesia	सिलेसिया	silesia
silic	सिलिकॉन	silicon
silicat	सिलिकेट	silicate
silva	सिल्वा	(proper noun) silva, as in carlos silva
silvestris	silvestris	silvestris
simone	सिमोन	simone
sinai	सिनाई	sinai, as in mount sinai
sinensis	साइनेसिस	sinensis
sing	गाओ	sing
sinh	का जन्म	genital
sip	घूंट	sip
sirô	सिरप	name of a member
sistema	सिस्टम	(proper noun) sistema
siu	सिउ	siu
siêu	सुपर	super
siết	कड़ी कर दी गई	to cut off (v.)
sky	आकाश	sky
skype	स्काइप	skype
skyteam	skyteam	skyteam
sl	sl	sl
slav	स्लाव	(proper noun) slav
slavơ	स्लाव	slavic
slytherin	स्लाइदरिन	(proper noun) slytherin, as in salazar slytherin of the harry potter series
sm	एस.एम.	sm
smg	smg	smg
smith	लोहार	smith
smithsonian	स्मिथसोनियन	smithsonian
so	तुलना	compare
société	सोसाइटी	societe
socrates	सुकरात	socrates
sohee	sohee	a korean name
soho	सोहो	soho
soi	सोइ	look/stare soi sáng=enlight
solaris	सोलारिस	(proper noun) solaris
som	som	(proper noun) som, as in kampong som
somme	सोम्मे	somme
sonata	सोनाटा	sonata
song	अभी तक	however (adv.)
sony	सोनी	sony
soo	सू	soon
sophie	सोफी	(proper noun) sophie, a first name
sopwith	sopwith	a name
sorbonne	सोरबोन	sorbonne, the university in paris (n.)
sos	मुसीबत का इशारा	sos
soul	आत्मा	soul
soát	नियंत्रण	control
soạn	संगीतकार	compose
spears	भाले	spears
spellman	spellman	spellman
spence	स्पेंस	(proper noun) spence
spencer	विग	(proper noun) spencer
spielberg	स्पीलबर्ग	(proper noun) spielberg, as in steven spielberg
sports	खेल	sports
sri	श्री	(proper noun) sri, as in sri lanka
ss	एस एस	ss
st	सेंट	st.
stalingrad	स्टेलिनग्राद	stalingrad
stamford	स्टैमफोर्ड	this is a name
stand	स्टैंड	stand
stanford	स्टैनफोर्ड	stanford, as in stanford university
stanley	स्टेनली	stanley
starr	स्टार	a name
startin	startin	bat dau
status	स्थिति	status
stdc	stdc	stdc
stefan	स्टीफन	stefan
steiermark	steiermark	steiermark
steiner	स्टेनर	steiner
stelzer	stelzer	stelzer
stennis	stennis	stennis
stephen	स्टीफन	stephen
stephenie	स्टेफेनी	"stephenie, as in stephenie meyer, author of ""twilight"""
sterling	वास्तविक	a name
steve	स्टीव	steve
stevens	स्टीवंस	(proper noun) stevens, as in amanda stevens
stevenson	स्टीवेंसन	stevenson
stevie	स्टीव	stevie
stewarthannah	stewarthannah	stewart/hannah
stf	एसटीएफ	stf
stimson	स्टिमसन	stimson, as in henry lewis stimson, former secretary of war
stockholm	स्टॉकहोम	a name
stones	पत्थर	stones
storting	स्टोर्टिंग	storting
strasberg	स्ट्रासबर्ग	strasberg
strauss	स्ट्रॉस	strauss
street	सड़क	street
struct	struct	struct
stt	एसटीटी	order number
stuart	स्टुअर्ट	stuart
stuttgart	स्टटगर्ट	(proper noun) stuttgart, a city in germany
styx	वैतरणी नदी	(proper noun) styx, as in the river styx
stéfano	stefano	stefano
su	सु	condom
subakhi	subakhi	subakhi
suez	स्वेज	(proper noun) suez
suharto	सुहार्तो	suharto
sukarno	सुकर्णो	(proper noun) sukarno,  president of indonesia
sulfua	सल्फाइड	sulfide
sulu	सुलु	sulu
sum	योग	reunite
sumatera	सुमात्रा	sumatera
sumatra	सुमात्रा	(proper noun) the island of sumatra
sumitomo	सुमितोमो	sumitomo
summer	गर्मी	summer
summerslam	समरस्लैम	(proper noun) summerslam
sun	सूरज	sun
sunday	रविवार	(proper noun) sunday
sung	अंजीर	supplement
sunni	सुन्नी	sunni
sunsilk	सनसिल्क	sunsilk, a hair products company
super	सुपर	super
suriname	सूरीनाम	suriname
susan	सुसान	(proper noun) susan
susilo	सुसिलो	(proper noun) susilo
sutra	सूत्र	sutra
suub	suub	a name
suvp	suvp	suv-p
suy	असफलता	decrease
suê	यहोशू	lush
suôn	सुचारू रूप से	smooth
suất	उत्पादकता	number
suối	धारा	stream
suốt	भर	through/all over
suồng	ओस	overfamiliar
svd	svd	svd
swan	हंस	swan
swaziland	स्वाजीलैंड	swaziland
sweet	मीठा	sweet
sy	एसवाई	sy
sydney	सिडनी	(proper noun) sydney, a city in australia
symantec	सिमेंटेक	symantec
sync	सिंक	sync
syria	सीरिया	syria
sài	sài	"(term should be ""sơ sài"") something done without care (adv.)"
sàn	फर्श	san
sàng	तैयार	ready
sành	टेरकोटा	"(term should be ""sành sứ"") pottery"
sào	निगल	"(term should be ""sào huyệt"") den or hideout (n.)"
sá	sá	road
sách	पुस्तक	list
sái	हटाना	sai
sám	पछतावा	penitent
sáng	उज्ज्वल	light
sánh	तुलना	compare
sáo	बांसुरी	flute
sáp	मोम	merger
sát	पास	"(term should be ""quan sát"") to watch or observe (v.)"
sáu	छह	six
sâm	जिनसेंग	sam
sân	आंगन	"(should be ""sân khấu"") a stage"
sâu	गहरा	deep
sã	साओ	flippant
sãi	खमेर क्रोम	pagoda warden
são	साओ	sao, as in sao paolo, brazil
sét	प्रकाश	clay
sê	धारावाहिक	sepon
sêri	धारावाहिक	series
sêu	seu	seu tet
sính	प्रिय	betrothal gifts
síp	साइप्रस	cyprus
sít	बाल बाल	close
sò	क्लैम	oyster
sòng	कैसीनो	casino
sóc	गिलहरी	"(should be ""sóc trăng"") a vietnamese town"
sói	भेड़िया	wolf
sóng	लहर	wave
sót	कमियों	to miss (v.)
sô	चॉकलेट	than
sôi	उबलना	vibrant
sông	नदी	river
sùng	कीड़ा	cult
sú	काला बाघ	a type of mangrove (n.)
súc	मवेशी	animal
sún	सूरज	sun
súng	बंदूक	gun
súp	सूप	source
sút	शॉट	reduce
săn	शिकार	to hunt
sơn	रंग	a mountain
sư	प्रोफ़ेसर	lion
sưa	स्किम्ड	filled with
sưng	सूजन	swell
sưu	गैलरी	collection
sương	ओस	dew (n.)
sướng	प्रशंसा	high
sườn	पक्ष	slope
sưởi	हीटिंग	heat
sạch	स्वच्छ	clean
sạn	होटल	hotel
sảm	गड़गड़ाहट	sam
sản	है	reproductive
sảng	प्रलाप	sonorous
sảnh	लॉबी	a hall, as in the rock and roll hall of fame
sấm	गड़गड़ाहट	ginseng
sấu	मगर	crocodile
sấy	ड्रायर	dry
sầm	पटक दिया	crowded
sầu	शोक	sad
sẩn	papules	coarseness
sẫm	अंधेरा	dark
sập	गिरावट	destroy
sắm	क्रय	shopping
sắn	कसावा	cassava (n.)
sắp	के बारे में	soon
sắt	लोहा	"(term should be ""sắt son"") constant (adj.)"
sẵn	उपलब्ध	available
sẹo	घाव का निशान	scar
sẻ	शेयर	share
sẽ	होगा	will
sọ	खोपड़ी	brain
sọc	अस्थिर	stripe
sỏ	कुलीनतंत्र	oligarchy
sỏi	कंकड़	gravel
số	संख्या	"(term should be ""số lượng"") quantity (n.)"
sốc	झटका	shock
sống	लाइव	live
sốt	तापमान	fever
sồi	बलूत	oak
sổ	रजिस्टर	window
sớ	बनावट	document
sớm	जल्दी	som
sờ	स्पर्श	touch
sỡ	टेक्नीकलर	colorful
sợ	भयभीत होना	afraid
sợi	रेशा	fibers
sục	जकूज़ी	"(term should be ""sôi sục"") to boil"
sụn	उपास्थि	cartilage
sụp	गिरावट	collapse
sụt	हानि	drop
sủa	छाल	bright
sủi	एल्डर	sparkling
sủng	उपहार	favored
sứ	चीनी मिट्टी के बरतन	embassy
sứa	जेलीफ़िश	jellyfish (n.)
sức	स्वास्थ्य	strength
sứt	फांक	cleft
sừng	सींग	sừng sững= huge
sử	इतिहास	"(term should be ""sử dụng"") to use (v.)"
sửa	मरम्मत	repair
sửng	हक्का-बक्का हुआ	startling
sửu	माया	cow
sữa	दूध	milk
sự		situation
ta	यह	us or our
tae	ताय	(proper noun) tae
tag	टैग	tag
tai	कान	ear
taiji	ताईजी	(proper noun) taiji
taipei	ताइपेई	taipei
taiwan	ताइवान	taiwan
taj	ताज	taj, as in taj mahal
tajikistan	तजाकिस्तान	tajikistan
tajima	tajima	tajima
tajiri	tajiri	tajiri
takahashi	ताकाहाशी	(proper noun) takahashi
taklamakan	तक्लामाकन	taklamakan
tali	थालियम	thallium
taliban	तालिबान	taliban
talmud	तल्मूड	talmud
tam	त्रिकोण	three (n.)
tamoxifen	टेमोक्सीफेन	tamoxifen
tanaka	तनाका	tanaka
tang	शोक	funeral
tanh	मछली का	deserted
tankōbon	टंकोबोन	tankobon, as in a type of japanese literature
tanzania	तंजानिया	tanzania
tao	मैं	(proper noun) tao, a chinese name
tarim	तारिम	tarim
task	कार्य	task
tasman	तस्मान	tasman, as in abel tasman
tasmania	तस्मानिया	tasmania, a place
tau	ताऊ	tau
taxi	टैक्सी	taxi
tay	हाथ	hand
taylor	टेलर	taylor
tbt	tbt	tbt
tchad	tchad	tchad
tcm	टीसीएम	tcm
tcp	टीसीपी	tcp
technical	तकनीकी	technical
ted	टेड	(proper noun) ted
teddy	टेडी	teddy, as in teddy lupin, a character in the harry potter series
telecom	दूरसंचार	telecom
telekom	टेलीकॉम	telekom
telex	टेलिक्स	telex
telnet	टेलनेट	telnet
tem	डाक टिकट	stamp
temple	मंदिर	temple
temujin	temujin	temujin
temur	temur	(proper noun) temur, as in temur oljeitu
tenxơ	टेन्सर	tensor
teo	शोष	atrophy
terengganu	terengganu	(proper noun) terengganu
territories	प्रदेशों	territories
terry	टेरी	terry
terumbu	terumbu	(proper noun) terumbu
tet	टीईटी	tet
texas	टेक्सास	(proper noun) the state of texas
tgv	टीजीवी	tgv
tha	बहाना	to forgive (v.)
thai	थाई	pregnant
thailand	थाईलैंड	thailand
tham	लेने	involved
thames	टेम्स	thames
than	लकड़ी का कोयला	coal
thang	सीढ़ी	ladder
thanh	बार	youth
thani	थानी	thani
thao	खेल	sport
thau	पीतल	a basin (n.)
thay	बल्कि	change
thcn	thcn	vocational school
thcs	thcs	secondary
thdq	आरओसी	thdq
thebes	थेबेस	thebes
their	chúng	their
them	जोड़ा	plus
then	एथेंस	key
theo	का पालन करें	according to
theory	सिद्धांत	thẻoy
theravada	थेरवाद	theravada
theres	थेरेस	there
theseus	theseus	theseus, the greek hero
thi	परीक्षा	competition (n.)
thich	thich	explanation
thien	थिएन	sky
third	तीसरा	thỉd
thiu	बासी	buồn thiu= sad/boring
thiêm	thiem	thiem
thiêng	धार्मिक	"(term should be ""thiêng liêng"") sacred or holy"
thiếc	टिन	tin
thiến	नपुंसक लिंग	castrate
thiếp	व्यवसाय कार्ड	concubine
thiết	सुविधाएं	"(term should be ""cần thiết"") necessary (adj.)"
thiếu	कम	lack
thiềm	thiem	crescent
thiền	ध्यान	buddhist (adj.)
thiển	अदूरदर्शा	superficial
thiểu	कम से कम	minimum
thiện	अनुकूल	good
thiệp	ecard	intervene
thiệt	असली	damage
thiệu	की सिफारिश	"(term should be ""giới thiệu"") to introduce (v.)"
tho	यद्यपि	tho
thoa	साबुन का झाग	combination
thoai	रोलिंग	gentle
thomas	थॉमस	thomas
thompson	थॉम्पसन	thompson
thong	पेटी	(proper noun) thong, as in ang thong
those	những	those
thoái	छोड़ना	deterioration
thoán	thoan	usurpation
thoáng	हवादार	"(term should be ""thoáng qua"") to pass quickly"
thoát	निकास	drainage
thoại	फ़ोन	telephone
thoạt	पहली नज़र में	just (adv.)
thoả	सहमति	compromise
thoải	आरामदायक	"(term should be ""thoải mái"") comfortable or relaxing (adj.)"
thoảng	कभी कभी	"(term should be ""thỉnh thoảng"") occasionally (adv.)"
thoắt	thoát	suddenly
thpt	thpt	high school
thriller	थ्रिलर	thriller
thskts	thskts	phd- architect
thua	खोया	defeat
thumb|các	अंगूठा |	thumb|many
thunderbolt	वज्र	thunderbolt
thung	thung	valley
thuyên	विस्थापन	a name
thuyết	सिद्धांत	theory
thuyền	नाव	boat
thuê	किराए	employ
thuần	विशुद्ध	"(term should be ""đơn thuần"") pure (adj.)"
thuẫn	विरोधाभासों	support
thuận	सुविधाजनक	favourable
thuật	कला	term
thuế	कर	tax
thuốc	दवा	medicine (n.)
thuộc	की	belong
thuớc	दवा	"(term should be ""kích thước"") dimensions of an object"
thuờng	अक्सर	usually
thuở	जवानी	period
thuỵ	thuỵ	"(term should be ""thụy Điển"") the nation of sweden (proper noun)"
thuỷ	हाइड्रो	water
thvn	thvn	vietnam television
thy	तेरा	thy
thà	बल्कि होगा	honest
thành	सफलता	"(term should be ""hình thành"") to take shape"
thày	शिक्षक	teacher
thác	झरना	harvest
thách	चुनौती	challenge
thái	स्थिति	attitude
thám	जासूसी	to spy (v.)
tháng	माह	month (n.)
thánh	संत	a holy person; a saint (n.)
tháo	निकालें	"(term should be ""tháo chạy"") to run with abandon"
tháp	मीनार	tower
thâm	गहरा	penetrate
thâu	इकट्ठा	to collect (v.)
thây	देखना	body
thãi	शहरी अपवाह	superabundant
thèm	cravings	desire
thép	इस्पात	steel
thét	thet	shout
thê	मार्था	category
thêm	अधिक	more
thêu	कढ़ाई	to embroider (v.)
thìa	चम्मच	spoon
thìn	पतला	(proper noun) thìn, the year of the dragon
thình	अचानक	"(term should be ""thình lình"") suddenly"
thí	प्रतियोगियों	(with word du) for example
thít	thit	(proper noun) mân thít, a district in vietnam
thò	चिपचिपा	tho
thòi	वंचित	"(term should be ""thiệt thòi"") to cost (adv.)"
thóc	धान	grain (n.)
thói	आदतों	a habit (n.)
thô	असभ्य	rough, old-fashioned
thôi	चलो	only
thông	सूचना	"(term should be ""thông thường"") usual (adj.)"
thù	सामंत	"entire term should be ""ke thu""; means ""enemy"""
thùng	टोकरा	barrel
thùy	भाग	thuy
thú	दिलचस्प	"(should be ""thích thú"") pleasurable"
thúc	समाप्त होता है	push
thúy	thuy	thuy
thăm	यात्रा	visit
thăng	ascend	helicopter
thơm	सुगंधित	aromatic
thư	पत्र	"(term should be ""ung thư"") cancer (n.)"
thưa	श्रीमान	sparse
thương	प्यार	love
thước	आकार	ruler
thường	अक्सर	usually (adv.)
thưởng	बोनस	to reward (v.)
thược	thuốc	(proper noun) thược
thượng	छत	upper
thạc	मास्टर्स	master
thạch	जेली	rock or stone (n.)
thạnh	थान	thanh
thạo	विशेषज्ञ	fluent
thả	ड्रॉप	"(term should be ""thả lỏng"") to let loose (v.)"
thải	बर्बाद	waste
thảm	गलीचा	carpet or rug (n.)
thản	आराम	calmly
thảo	कार्यशाला	"(term should be ""hội thảo"") a workshop (n.)"
thấp	कम	low (adj.)
thấu	लेंस	penetrate
thầm	चुपचाप	"(term should be ""thì thầm"") to whisper (v.)"
thần	देवता	"entire term should be ""tinh than""; means ""of the mind"""
thầy	शिक्षक	teacher (n.)
thẩm	सक्षम	osmotic/leak
thẫm	अंधेरा	dark
thận	गुर्दा	careful
thập	सभा	tens
thật	असली	true (adj.)
thắm	पत्ती	tham
thắn	खुलकर	frank
thắng	प्रबल	win
thắngthua	thangthua	win-lose
thắp	ज्योतिर्मय	light
thắt	बाँध लेना	tense
thằn	छिपकली	"entire term should be ""than lan""; means ""lizard"""
thằng	पुरुष	a derogatory term for a man (n.)
thẳm	रसातल	"(term should be ""thăm thẳm"") extremely deep (adj.)"
thẳng	सीधे	horizontal
thặng	अतिरिक्त	surplus
thẹn	धमकी से	shameful
thẻ	कार्ड	card
thế	कैसे	"with word ""tu,"" means ""posture"" or ""a position"""
thếp	ढेरों	steel
thề	कसम खाओ	swear
thềm	शेल्फ	shelf
thể	कर सकते हैं	maybe
thỉnh	आमंत्रण	"(term should be ""thỉnh thoảng"") occasionally"
thịnh	समृद्धि	prosperous
thịt	मांस	meat (n.)
thọ	जीवन	phu tho
thọc	जोर	jab
thỏ	ख़रगोश	rabbit
thỏa	सौदा	"(term should be ""thoả thuận"") to come to an agreement (v.)"
thỏi	सिल्लियां	a bar (n.)
thối	सड़ांध	smelly
thốt	उगल दिया	scream
thồ	पैक	to transport via horse (v.)
thổ	वेश्यालय	"(term should be ""lãnh thổ"") territory (n.)"
thổi	उड़ाने के लिए	blow
thớt	काटने का बोर्ड	sparse
thời	समय	period
thở	साँस लेना	breathe
thợ	शिल्पकार	craftman
thụ	रिसेप्टर	"(term should be ""thụ thai"") to become pregnant"
thục	स्वतंत्र	(proper noun) a vietnamese first name
thụt	एनीमा	clyster
thủ	मुख्य	masturbate
thủa	भूखंडों	during childhood
thủng	वेध	having holes
thứ	तरह	no.
thức	जाग	way
thừa	अतिरिक्त	redundant
thừng	रस्सी	"(term should be ""thẳng thừng"") mercilessly"
thử	कोशिश	try
thửa	भूखंडों	square
thự	विला	mansion
thực	असली	perform
ti	ti	titov
tia	रे	ray
tiananmen	त्यानआनमेन	tiananmen
tiara	टिअरा	tiara
tibet	तिब्बत	(proper noun) tibet
tigris	tigris	tigris
tiliaceus	tiliaceus	hoa dam but
tim	दिल	heart
timor	तिमोर	timor
timothy	टिमोथी	timothy
tin	मानना	believe
tinbắc	tinbac	file bac
tincầu	टिन का पुल	file bridge
tinh	परिष्कृत	"(term should be ""tinh dịch"") sperm (n.)"
tinnhà	tinnha	folder: house
tinsông	tinsong	file river
tinthị	tinthi	file: town
tirol	टिरोल	tirol
tisdale	tisdale	tisdale
tish	टिश	(proper noun) tish
tissa	टिस्सा	(proper noun) tissa, as in moggaliputta tissa
tivi	टीवी	television
tizard	tizard	(proper noun) tizard
tiên	पहले	first
tiêu	काली मिर्च	"entire term should be ""tieu chuan""; means ""a requirement"""
tiếc	खेद	"(term should be ""tiếc thương"") to pity (v.)"
tiếm	usurping	seize
tiến	प्रगति	operate
tiếng	घंटा	language
tiết	अधिक	abstinence/intensity
tiếu	नासमझ	"(should be ""đàm tiếu"") to sneer"
tiềm	संभावित	potential
tiền	पैसा	money (n.)
tiều	tiểu	(proper noun) the name of a poet
tiểu	प्राथमिक	tiểu sử= biography
tiễu	श्री लियू	patrol
tiệc	दावत	party
tiệm	दुकान	shop
tiện	सुविधा	mean
tiệp	आकर्षण	gustav franck
tiệt	स्टेरिलाइज़र्स	sterilize
tncs	जवानी	communist youth union
tngt	दुर्घटनाओं	traffic accidents
tnhh	लि	limited
toang	दराज	fast
tobago	टोबैगो	tobago
toei	toei	toei
tokugawa	तोकुगावा	tokugawa
tokyo	टोक्यो	tokyo, the capital of japan
tokyopop	टोक्योपोप	tokyopop
tomas	टॉमस	(proper noun) tomas
tommy	मामूली सिपाही	tommy
tomoyo	tomoyo	tomoyo
tony	टोनी	tony
toonami	तूनामी	(proper noun) toonami
top	चोटी	top
torino	टोरिनो	torino, as in the italian city
toriyama	तोरियामा	(proper noun) toriyama
tottenham	टी टॉटनहम	tottenham
tourism	पर्यटन	tourism
tourist	पर्यटक	tourist
toyama	तोयामा	toyama
toyota	टोयोटा	(proper noun) toyota
toà	कोर्ट	office
toàn	पूर्ण	entire or whole (adj.)
toán	लेखांकन	team
toát	exudes	to exude or emit, as in sweat (v.)
toạ	अंदर	locate
toại	संतोष	satisfaction
toả	radiating	spread
tp	tp	city
tphcm	tphcm	ho chi minh city
tphồ	tpho	city ho
tpvĩnh	tpvinh	vinh city
tqlc	मरीन	marine
trafalgar	ट्राफलगर	(proper noun) trafalgar
trafford	ट्रैफर्ड	trafford in greater manchester
trai	क्लैम	boy
trang	पेज	a page (n.)
tranh	चित्रों	to compete (v.)
trao	प्रदान करना	reward
trau	में सुधार	polish
tre	बांस	bamboo (n.)
treo	लटकना	hang
tri	त्रि	tri
tribune	ट्रिब्यून	a name
trinh	रों	"(should be ""trinh bạch"") virtuous"
trinidad	त्रिनिदाद	trinidad
trinity	त्रिमूर्ति	trinity
tristan	ट्रिस्टन	tristan
triết	दर्शन	philosophy
triền	ढलानों	"(should be ""triền miên"") endless"
triều	वंश	court
triện	टिकटों	stamp
triệt	बिलकुल	completely
triệu	दस लाख	a million
tro	एश	ashes
troia	troia	troy
trondheim	ट्रॉनहैम	trondheim
trong	में	inside (adv.)
true	सच	true
truman	ट्रूमैन	(proper noun) truman
trung	मध्य	"(term should be ""trung gian"") agent (n.)"
trungnhật	trungnhat	china-japan
truong	truong	truong
truyên	हस्तांतरण	story
truyện	कहानी	story
truân	संकट	arduous
truất	कमी	cancel
truởng	खंड सिर	leader (n.)
truỵ	truỵ	depraved
trà	चाय	tea (n.)
tràm	melaleuca	melaleuca
tràng	पेट	"entire term should be ""truc trang""; means ""rectum"""
trào	आंदोलन	movement
trác	zhuo	trac
trách	जवाबदेही	blame
trái	बाएं	against
trán	माथा	forehead
tráng	लेपित	to coat (v.)
tránh	से बचने	to avoid (v.)
tráo	कपट	tráo trở= liar/betrayal/treacherous
tráp	seabream	casket
trát	वारंट	pile
trâm	ब्रोच	a type of elegant hairpin (n.)
trân	सबसे अच्छा संबंध है	respect
trâu	भैंस	a last name
trãi	बिखरे	trai
trèo	चढ़ाई	climb
trên	पर	above
trình		process
trí	मन	intellectual
trích	उद्धरण	to extract (v.)
trò	खेल	role
tròn	दौर	rounding
trói	बंधा हुआ	tie
trôi	अभिप्राय	afloat
trông	दिखता है	look
trùm	नकाबपोश	cover
trùng	संयोग	"(should be ""tinh trùng"") sperm"
trùy	truy	something to with monk
trú	ठहरने	residence
trúc	संरचनाओं	structure
trăm	सौ	hundred
trăn	अजगर	"(term should be ""trăn trở"") to ponder (v.)"
trăng	चंद्रमा	moon
trĩ	बवासीर	hemorrhoids
trũng	धँसा	medium
trơ	निष्क्रिय	bare
trơn	फिसलाऊ	slippery (adj.)
trư	विद्यालय	a pig (n.)
trưa	दोपहर	noon (n.)
trưng	जनमत-संग्रह	symbolic
trưngcông	trungcong	truongcong
trương	नीति	policy
trước	से पहले	front
trước 	से पहले	front
trướng	फैलावट	expand
trườn	क्रॉल	crawl
trường	स्कूलों	case
trượng	लाठी	a unit of length used in vietnam equal to 4 meters (n.)
trượt	फिसलन	slide
trạch	trach	ze
trại	शिविर	camp
trạm	स्टेशन	station
trạng	शर्त	situation
trạo	trao	trao
trả	वेतन	to return
trải	विस्तार	spread
trảm	मौत की सजा दी	beheaded
trảo	प्रदान करना	trao
trấn	शहर	town
trấu	भूसी	rice skin
trầm	गहरा	depression
trần	नंगा	tran
trầu	पान	trầu
trầy	खरोंच	scratch
trẩy	तीर्थयात्रा	pilgrimage
trẫm	मैं हूं	i
trận	मैच	battle
trật	कमी	order
trắc	निगरानी	"(term should be ""trắc ẩn"") to have pity (adj.)"
trắng	सफेद	white
trặc	मुसीबत	"entire phrase is ""truc trac""; means ""problem"""
trẻ	युवा	youth
trễ	देर से आना	late
trệ	देरी	bamboo
trị	इलाज	cure
trịnh	समारोह	trịnh, a vietnamese last name
trọ	निवास	motel
trọn	संपूर्ण	whole
trọng	भार	serious
trỏ	इशारा	index
trối	स्वर्ग	last words
trốn	छिपाने	to hide
trống	ड्रम	in
trồi	protruded	to emerge (v.)
trồng	लगाए	plant
trổ	भालू	to burst open or display
trỗi	उद्भव	rise
trội	एक्सेल	better
trộm	चोरी	theft
trớn	गति	"(term should be ""mơn trớn"") to fondle or caress (v.)"
trời	स्वर्ग	sun
trợ	सरल उपयोग	support
trụ	स्तंभ	universe
trục	अक्ष	"(term should be ""khu trục"") fighter, in reference to planes (adj.)"
trụi	नंगा	"(term should be ""trơ trụi"") bare (adj.)"
trứ	ट्रू	famous
trứng	अंडे	egg
trừ	ऋण	except
trừng	दंडित	punish
trừu	भेड़	abstract
trữ	रिज़र्व	reserve
trực	कर्तव्य पर	direct
ts	ts	phd
tt	टीटी	news
tua	मूंछ	fringe
tucker	टकर	tucker, an english last name
tudor	ट्यूडर	(proper noun) tudor, as in the tudor family
tukhachevsky	tukhachevsky	(proper noun) tukhachevsky
tulip	ट्यूलिप	tulip
tum	tum	tum
tung	का शुभारंभ किया	release
tupolev	टुपोलेव	tupolev, as in alexei tupolev
tuscan	टस्कन	(proper noun) tuscan
tutsi	तुत्सी	(proper noun) tutsi
tuvalu	तुवालु	(proper noun) tuvalu, a polynesian island nation
tuy	यद्यपि	however
tuyên	राज्यों	"(should be ""tuyên ngôn"") a declaration"
tuyết	हिमपात	snow (n.)
tuyền	tuyền	tuyen
tuyển	चुना गया	recruit
tuyệt	महान	excellent (adj.)
tuân	अनुपालन	comply
tuông	ईर्ष्या	jealous
tuý	दवा	drug
tuần	सप्ताह	week
tuế	मछलियां	years
tuệ	संपत्ति	intelligence
tuốc	टरबाइन	turbine
tuổi	आयु	age
tuộc	ऑक्टोपस	octopus
tuột	खिसकना	slip
tuỳ	अनुकूलन	depend
tv	टीवी	tv
tvb	tvb	tvb
twin	जुड़वां	twin
twitter	चहचहाना	twitter
ty	कंपनियों	company
type	टाइप	type
typhon	typhon	typhon
tà	deviant	we
tài	उपयोगकर्ता	talent (n.)
tàn	विकलांग	dying
tàng	संग्रहालय	"(should be ""bảo tàng"") a museum"
tành	मंच	shatter
tàu	जहाज़	ship
tá	दर्जन	"(term should be ""thiếu tá"") major (n.)"
tách	कप	to separate
tái	फिर से	return
tám	आठ	eight
tán	विस्तार	support
tánh	प्रकृति	life
táp	गोद	to lap at (v.)
táu	जहाज़	ashton
tâm	केंद्र	tâm
tâu	मेरे भगवान!	peach
tây	पश्चिम	western
tâynam	taynam	"(should be ""tây-nam"") southwest"
tã	डायपर	diaper
tét	टीईटी	tet
tê	सुन्न	numb
tên	नाम	name (n.)
tì	विश्राम किया	to lean on (v.)
tìm	तलाश	find
tìmdiệt	timdiet	find-kill
tình	प्यार	sex
tía	बैंगनी	dad
tích	एकीकृत	"(term should be ""tích cực"") to be zealous (adv.)"
tím	बैंगनी	purple
tín	श्रेय	"(entire term should be ""tín dụng"") credit"
tít	शीर्षक	"(term should be ""tít mù"") very far away (adv.)"
tò	जिज्ञासु	curious
tòa	कोर्ट	a court
tòi	सामग्री	"(term should be ""tìm tòi"") to search doggedly for something (v.)"
tòng	नव-धर्मांतरितों	tòng, a last name
tóm	सारांश	summary
tô	कार	car
tôi	मैं	i
tôm	झींगा	shrimp
tôn	धार्मिक	venerate
tông	गत्ता	tông, as in lê thánh tông; first name of an ancient vietnamese emperor
tù	जेल	prison
tùng	अतिरिक्त	tung
tùy	रिवाज	depend on
túc	प्रचुरता	"(term should be ""bổ túc"") to give a refresher course (v.)"
túi	बैग	pocket
túm	पकड़ा	catch
túng	जरूरत में	confuse
túp	tuff	hut
túy	प्राप्त	"(term should be ""thuần túy"") pure (adj.)"
tý	बहुत	mouse, as in year of the mouse
tăm	दंर्तखोदनी	"(term should be ""tiếng tăm"") reputation"
tăng	वृद्धि	increase
tĩnh	स्थिर	calm
tơi	को	ragged
tư	निवेश	posture
tưng	तुंग	"(term should be ""tưng bừng"") joyously (adv.)"
tươi	ताज़ा	fresh
tương	अपेक्षाकृत	"(term should be ""tương tự"") to be similar to"
tước	शासक	title (n.)
tưới	सिंचाई	irrigation
tướng	मंत्री	prime minister (thu tuong)
tường	दीवार	"a common vietnamese first name; means ""wall"""
tạ	भारोत्तोलन	weight
tạc	नक़्क़ाशीदार	"(term should be ""oanh tạc"") to bomb from the air (v.)"
tại	पर	survival
tạm	अनंतिम	temporary
tạo	बनाने	create
tạp	जटिल	"(should be ""hỗn tạp"") a jumble or mish-mash"
tả	विवरण	describe
tản	रेडिएटर	disperse
tảng	आधार	platform
tấc	बाल बाल	inch
tấm	चादर	mirror
tấn	टन	tan
tấp	एक तरफ घुमाएं	crowded
tất	सब	all
tấu	ताउ	tau
tầm	खेल	range or extent (n.)
tần	आवृत्ति	"(term should be ""tần số"") frequency (n.)"
tầng	फर्श	layer
tầu	जहाजों	ship
tẩm	गर्भवती	soak
tẩy	निकालें	to bleach
tận	लेना	dedicated
tật	पार्किंग	disease
tắc	स्विच	priciple
tắm	स्नान करो	bathing
tắt	बंद कर देते हैं	initial
tặc	अपहर्ताओं	"(term should be ""hải tặc"") a pirate (n.)"
tặng	दान करना	donate
tẻ	कुंठित	lẻ tẻ= scattered
tết	plaited	(proper noun) the vietnamese new year
tếxã	texa	economy - society
tề	आकर्षक	tidy
tể	की अनुमति देता है	lord
tệ	मुद्रा	bad
tệp	फ़ाइल	file
tỉa	ट्रिम	"(term should be ""bắn tỉa"") to snipe"
tỉnh	प्रांत	province
tị	शरणार्थी	refugee
tịch	अध्यक्ष	"(""chủ tịch"") president or chairman"
tọa	निर्देशांक	"(term should be ""chủ toạ"") chairman (n.)"
tỏ	प्रदर्शन	to
tỏa	चमक	radiate
tỏi	लहसुन	garlic
tốc	एक्सप्रेसवे	speed
tốn	उपभोक्ता	to cost (v.)
tống	सेवा की	dispose
tốp	समूह	top
tốt	अच्छा	good
tồi	ग़लत	bad
tồn	एन	exist
tổn	हानि	damage
tổng	संपूर्ण	president
tộc	जातीय	"(term should be ""dân tộc"") a race or people"
tội	पाप	crime
tột	चरम	extreme
tớ	मैं	servant
tới	आने वाले	to the point
tờ	चादर	paper/document
tởm	घृणा करना	disgusting
tục	जारी रखने के लिए	"(term should be ""tập tục"") customs or practices"
tụy	अग्न्याशय	"(term should be ""tận tụy"") devoted (adj.)"
tủ	छाती	shelf
tủi	दया	humiliated
tủy	मज्जा	spine
tức	समाचार	i.e.
từ	से	from
từng	प्रत्येक	each
tử	मौत	lion (su tu)
tửu	शराब	wine
tự	स्वयं	"(term should be ""tương tự"") like or similar to (adv.)"
tựa	सीट	lean
tựu	उपलब्धियों	achievement
tỵ	शरणार्थी	the han name for the year of the snake, according to the chinese zodiac
tỷ	एक अरब	billion
u	यू	tumor
ua	ua	ua
uae	संयुक्त अरब अमीरात	uae
ubuntu	ubuntu	ubuntu
uc	यूसी	uc
uchiha	उचिहा	uchiha
uefa	यूईएफए	uefa
uh	उह	uh
uk	यूके	uk
ukiyoe	ukiyoe	ukiyoe
ukraina	ukraina	ukraine
ulsan	उल्सान	ulsan
umm	उम्म	umm
un	संयुक्त राष्ट्र	(proper noun) un, as in chung un chan of korea
und	und	und
under	अंडर	under
unesco	यूनेस्को	unesco
ung	सड़ा हुआ	cancer
unicorn	एक तंगावाला	unicorn
unit	इकाई	unit
unix	यूनिक्स	unix
up	अप	up
ural	यूराल	ural, as in the ural mountains
urani	यूरेनियम	uranium
uri	uri	uri, a former political party in south korea
uruguay	उरुग्वे	uruguay
usagi	usagi	usagi
usb	यूएसबी	usb
uss	यूएसएस	uss
utah	यूटा	utah
utrecht	उट्रेच	(proper noun) utrecht
uy	uy	"(term should be ""uy lực"") power (n.)"
uyghur	उईघुर	(proper noun) uyghur
uygur	uygur	uygur
uyên	uyên	scholarly
uyển	लचीलापन	"(term should be ""uyển chuyển"") flexible (adj.)"
uzbekistan	उज़्बेकिस्तान	uzbekistan
uông	परोसें	uong
uất	uat	busy
uốn	कर्लिंग	to curl (v.)
uống	पीने के लिए	to drink
uổng	uống	vain
v	v	v
va	और	collide
vaccine	टीका	vaccine
vai	कंधा	shoulder
valencia	वालेंसिया	valencia
valentine	वेलेंटाइन	valentine
valley	घाटी	valley
van	वाल्व	"(term should be ""van xin"") to beg (v.)"
vanessa	वैनेसा	vanessa
vargas	वर्गास	(proper noun) vargas
vasari	वसारी	vasari
vay	उधार	borrow
vectơ	वेक्टर	vector
ven	साथ में	"(term should be ""ven biển"") coastal (adj.)"
vendôme	vendôme	vendome
venezia	venezia	venice
venus	शुक्र	venus
verdun	वर्दन	verdun
vermont	वरमोंट	vermont
verona	वेरोना	(proper noun) the city of verona
versailles	वर्साय	(proper noun) versailles
vhs	वीएचएस	vhs
vi	vi	behavior
viagra	वियाग्रा	viagra
victor	विजेता	(proper noun) victor
victoria	विक्टोरिया	victoria, a province of australia
vienna	वियना	(proper noun) vienna, austria
viet	वियतनामी	vietnamese
vietnam	वियतनाम	vietnam
viettel	viettel	viettel
viii	viii	eighth
vijaya	विजया	(proper noun) vijaya
viking	वाइकिंग	viking
villa	विला	villa
villeneuve	villeneuve	(proper noun) villeneuve, a french last name
vinagame	vinagames	vinagame
vinashin	vinashin	vinashin
vince	विन्स	(proper noun) vince, as in vince mcmahon
vincennes	vincennes	vincennes
vincent	विंसेंट	vincent
vinpearl	vinpearl	vinepeal
viqr	viqr	viqr
virginia	वर्जीनिया	(proper noun) virginia, as in the state
virus	वाइरस	virus
virút	वायरस	virus
vissarionovich	vissarionovich	vissarionovich
vista	विस्टा	vista, as in windows vista
vitamin	विटामिन	vitamin
vitruvius	विट्रूवियस	vitruvius
viz	यानी	(proper noun) viz
viêm	सूजन	inflammation
viên	सदस्य	member
viêng	वियनतियाने	vientiane
viêt	लेखन	vietnam
viếng	यात्रा	visit
viết	लिखने	write
việc	काम	thing
viện	अस्पताल	institute
việt	वियतनाम	viet
việtmường	वियतनामी मूंग	muong
việtnga	vietnga	vietnam-russia
việttrung	viettrung	vietnam-china
vn	वीएन	vietnam
vnexpress	vnexpress	(proper noun) vnexpress
vni	vni	vni
vo	vo	"(term should be ""tròn vo"") perfectly round (adj.)"
voi	हाथी	elephant
voip	वीओआईपी	voip
voldemort	वोल्डेमॉर्ट	(proper noun) voldemort, the villain from the harry potter series
von	वॉन	compare
vonfram	टंगस्टन	wolfram
vong	लोगों की मृत्यु	injured
voyager	नाविक	voyager
voọc	लंगूर	a langur (n.)
vtc	vtc	vtc
vu	vu	"entire phrase is ""vu cao""; means ""to accuse wrongly"""
vua	राजा	king
vui	मनोरंजक	happy
vulcan	वालकैन	vulcan
vuông	वर्ग	square
vuốt	पंजा	stroke
vv	आदि	etc.
vy	vy	vy
vyacheslav	व्याचेस्लाव	vyacheslav
và	और	and
vài	कुछ	several
vàm	vam	the mouth of a rivulet (n.)
vàng	पीला	gold
vành	कोरोनरी	coronary
vào	में	into
vá	पैच	patchy
vác	स्लोवाक	to shoulder (v.)
vách	दीवार	wall
vái	व्रत	some
ván	बोर्डिंग	game
váng	चंचल	film
váy	स्कर्ट	skirt
vân	इतने पर	"(term should be ""vân vân"") et cetera"
vây	मुहासिरा करना	encircle
vã	va	rush
vãi	scatterings	to release
vãn	प्रेमालाप	save
vè	crambo	to glance slyly (v.)
vé	टिकट	ticket
vét	निकर्षण	plunder
vê	पेज	tremolo
vì	की वजह से	because
ví	बटुआ	example
vía	chickened	soul
vít	स्क्रू	screw
vò	घड़ा	jar
vòi	नल	tap
vòm	छत	upper jaw
vòng	अंगूठी	around
vó	खुरों	hooves
vóc	डील-डौल	"(should be ""vóc sương"") dew-like or delicate"
vô	धन	"(term should be ""vô số"") countless (adj.)"
vôi	चूना	limestone
võ	सामरिक	martial arts (n.)
võng	खाट	hammock
vùi	दफन	"(term should be ""chôn vùi"") to bury or keep secret (v.)"
vùng	क्षेत्र	region
vú	स्तन	breast (n.)
vút	सोरिंग	"entire term should be ""cong vut""; extreme curling"
văn	लेखक	culture
văng	सोफे	a name
vĩ	महान	"(term should be ""vĩ đại"") great (adj.)"
vĩnh	स्थायी	ving
vũ	जगत	armed
vũng	पोखर	vung
vơ	मालदीव	lost
vơi	साथ	ullage
vưu	आप क्वान	"actual term is ""xi vưu""; proper noun; name of a leader of a people in chinese legend"
vươn	अपने	reach
vương	राजा	kingdom
vướng	पकड़ा	"(term should be ""vướng víu"") to become involved in (v.)"
vườn	उद्यान	garden
vượn	गिब्बन	gibbon
vượt	पर पहुंच गया	to overcome
vạ	va	unfortunate problem
vạc	देग़	cauldron
vạch	बार	bar
vại	जार	jar
vạn	दस हजार	thousand
vạng	सांझ	twilight
vả	अंजीर	hard
vải	कपड़ा	fabric
vảy	तराजू	scale
vấn	मुद्दों	vấn đề= problem
vấp	ठोकर	stumble
vất	फेंक देना	hard
vần	तुक	spell
vầng	vầng	moon (vang trang)
vẩn	निलंबन	wander
vẩy	परत	scale
vẫn	अब तक	still
vẫy	लहराया	wave
vận	अभियान	active
vắc	टीका	vaccine
vắcxin	टीका	vaccine
vắn	कम	short
vắng	अनुपस्थित	absent
vặn	मरोड़	to twist (v.)
vặt	वर्गीकृत	odd
vẹn	ईमानदारी	complete
vẹt	तोता	parrots
vẽ	रंग	draw
vết	घाव	wound
vểnh	चुभ	warping
vệ	सुरक्षा	"(term should be ""bảo vệ"") to defend (v.)"
vệt	लकीर	streak
vỉa	तेजी	"(term should be ""vỉa hè"") sidewalk"
vịnh	खाड़ी	bay
vịt	बतख़	duck
vọng	दृष्टिकोण	"(term should be ""hy vọng"") hope (n.)"
vọt	सीमा	to spurt out (v.)
vỏ	छाल	shell
vồ	आलोचना करना	"(term should be ""gạch vồ"") a type of brick"
vỗ	थपथपाना	to clap
vội	जल्दी	hurriedly (adv.)
vớ	मौज़ा	"(term should be ""vớ vẩn"") silly (adj.)"
với	साथ	to
vớt	मछली	salvage
vờ	नाटक	"(term should be ""giả vờ"") to pretend (v.)"
vời	महान	wonderful
vở	नोटबुक	"(term should be ""vở kịch"") a play"
vỡ	तोड़ना	break
vợ	पत्नी	wife
vụn	टुकड़ा	debris
vụng	अनाड़ी	covert
vứt	फेंक देना	throw away
vừa	मध्यम	just (adv.)
vừng	तिल	sesame (n.)
vững	कंपनी	firm (adj.)
vực	क्षेत्र	place
vựng	शब्दावली	"(term should be ""từ vựng"") regional vocabulary (n.)"
vỹ	vy	majestic
w	w	w
wa	वा	wa
walt	वॉल्ट	(proper noun) walt, as in walt disney
walter	वाल्टर	walter
walther	वाल्थर	walther
wan	ज़र्द	wan
wang	वैंग	wang
wankel	वान्केल	(proper noun) wankel
wanna	चाहते हैं	wanna
warren	ख़रगोश पालने का बाड़ा	a name
warsaw	वारसॉ	warsaw
warszawa	warszawa	(proper noun) warsaw
washington	वाशिंगटन	(proper noun) washington
wat	वाट	(proper noun) wat, as in angkor wat, the temple in cambodia
watergate	watergate	watergate
waterloo	वाटरलू	(proper noun) waterloo
waters	पानी	waters
wayne	वेन	wayne
wcdma	wcdma	w-cdma
weasley	वीसली	weasley, as in ron weasley in the harry potter series
weblog	वेबलॉग	weblog
webmail	वेबमेल	ưebmail
weimar	weimar	(proper noun) weimar
wellington	वेलिंग्टन	wellington
wells	कुओं	wells, as in author orson wells
welsh	welsh	(proper noun) welsh, as in the welsh language
wembley	वेम्बली	wembley, as in wembley stadium
werner	वर्नर	werner
westermarck	westermarck	westermarck
western	पश्चिमी	western
westlife	वेस्टलाइफ	westlife
westview	वेस्टव्यू	westview, as in westview press
wheeler	व्हीलर	a name
widener	विडनर	widener
wien	वियेना	wien
wiener	वीनर	wiener
wifi	वाईफ़ाई	wi-fi, a technology term
wiki	विकि	wiki
wikia	विकिया	a name
wikibooks	विकिबुक्स	(proper noun) wikibooks
wikimapia	विकिमपिया	wikimapia
wikimedia	विकिमीडिया	wikimedia
wikitravel	wikitravel	a name
wild	जंगली	wild
wilder	वाइल्डर	(proper noun) wilder, as in billy wilder
wiley	विले	wiley
willard	विलार्ड	willard
wimbledon	विंबलडन	wimbledon
windows	खिड़कियां	windows
winer	winer	winer
wisconsin	विस्कॉन्सिन	(proper noun) wisconsin
within	ट्रोंग	within
without	बिना	without
wolfgang	वोल्फगैंग	wolfgang
won	वोन	won
wong	वोंग	wong
woodrow	woodrow	woodrow
woods	जंगल	(proper noun) woods, as in tiger woods
would	चाहेंगे	would
wrestling	कुश्ती	wrestling
wright	राइट	a name
wu	वू	wu
wushu	वुशु	wushu, a type of martial art
wwf	डब्ल्यूडब्ल्यूएफ	wwf
xa	बहुत दूर	ancient
xang	गैस	"(term should be ""lan xang"") name of an ancient country in southeast asia"
xanh	ग्रीन	green
xao	हलचल	xôn xao = chatting
xay	कचरा	grind
xe	कार	a car (n.)
xem	देखना	watch
xen	intercropping	to insert (v.)
xhcn	समाजवादी	social republic
xi	xi	xi
xiii	xiii	eighth
xin	कृपया	please
xinh	सुंदर	beautiful
xiv	xiv	fourteenth
xiêm	स्याम देश की भाषा	(proper noun) xiêm, or siam
xiên	टेढ़ा	oblique
xiêu	xieu	soften
xiếc	सर्कस	circus
xiết	clamping	to twist tightly (v.)
xiềng	बंधन	chain
xo	xo	spring
xoa	रगड़	massage
xoay	कुंडा	turn
xong	पूरा	completed
xoàng	औसत दर्जे का	mediocre
xoá	हटाए गए	delete
xoáy	बवंडर	vortex
xoắn	मुड़	coiled
xu	प्रवृत्ति	trend
xua	डराना	dispel
xuan	xuan	"(term should be ""xuân"") a common vietnamese middle or first name; means ""the season of spring"""
xui	बुरा	incite
xuka	xuka	xuka
xum	विलासी	a name
xuyên	ट्रांस	frequently
xuyến	टोरस्र्स	manage
xuân	वसंत	spring
xuâncông	xuancong	xuan public
xuôi	नीचे	down
xuất	अनुशंसित	ejaculate
xuấtnhập	xuatnhap	import/export
xuống	नीचे	down
xuồng	डोंगी	boat
xv	xv	fifteenth
xvi	xvi	xvi
xvii	xvii	xvii
xx	xx	xx
xy	xy	cylinder
xài	बिताना	use
xào	तलना	stir fry
xách	हैंडबैग	to carry by the handle (v.)
xám	धूसर	ustox
xán	xan	"(term should be ""xán lạn"") bright (adj.)"
xáo	अशांति	chaos
xát	रगड़	touch
xâm	आक्रमण	invasion
xâu	तार	string
xây	निर्माण	build
xã	कम्यून	society
xãy	हुआ	occur
xèo	पैनकेक	xeo
xé	उखड़ना	tear
xén	क्लिप	"(term should be ""biếu xén"") to gift (v.)"
xéo	ढालू	diagonally (adv.)
xét	समीक्षा	examine
xê	चाल	"(term should be ""bánh xu xê"") a type of vietnamese cake"
xêkô	suneo	xeko
xì	झटका	scandal
xìu	बेहोश	to become flaccid (v.)
xí	कुरूप	factory (xi nghiep)
xít	नाजी	nazi
xíu	क्ज़िउ	small
xòe	विस्तार	spread
xóa	मिटा	clear
xói	कटाव	erode
xóm	पड़ोसियों	village
xót	दया	mercy
xô	धक्का	soviet
xôi	चिपचिपा चावल	pierce
xôn	कुंडल	tumultuous
xông	भाप	rush
xôphần	बाल्टी अनुभाग	soviet-poland
xôviết	सोवियत संघ	soviet
xù	टेरी	gigantic
xú	वाल्व	xu
xúc	संपर्क	touch
xúi	प्रेरित करना	induce
xăm	टटू	"(term should be ""xa xăm"") far away (adj.)"
xăng	पेट्रोल	gasoline
xơ	रेशा	xo
xưa	पुराना	old
xưng	कबूल	"(should be ""tự xưng"") self-proclaimed"
xương	हड्डी	bone (n.)
xước	खरोंच	scratch
xướng	कोरस	provoke
xưởng	कार्यशाला	workshop
xạ	विकिरण	"(term should be ""phản xạ"") to reflect"
xả	निकास	release
xảo	जादू	detailed
xảy	हुआ	happen
xấp	लगभग	approximate
xấu	बुरा	bad
xẩm	xam	a type of traditional vietnamese singing
xẩy	हुआ	occur
xắt	काटना	cut
xẻo	छांटना	cut off
xếp	रेटिंग्स	rank
xỉ	लावा	approximately
xỉa	सोता	to pick (v.)
xỉu	बेहोश	to faint
xốc	झटका	to lift up (v.)
xốp	झरझरा	porous
xổ	लॉटरी	rush into
xộn	गड़बड़	messy
xứ	देश	native
xứng	मूल्य	appropriate
xử	इलाज	judge
y	स्वास्थ्य	medical
y=fracsin	y = फ्रैस्किन	a function
ya	फिर	(proper noun) ya, as in ya trang
yakovlev	yakovlev	yakovlev
yakushima	याकुशिमा	yakushima
yalta	याल्टा	(proper noun) yalta
yankee	यांकी	(proper noun) yankee
yard	यार्ड	yard
yasha	yasha	a name
yeeun	yeeun	(proper noun) yeeun
yeltsin	येल्तसिन	yeltsin, as in boris yeltsin
yemen	यमन	yemen
yersin	yersin	(proper noun) yersin, asin alexandre yersin
yi	यी	(proper noun) yi
ying	यिंग	(proper noun) ying, as in ying yang
ymca	वायएमसीए	ymca
yo	यो	yo
yomiuri	योमिउरी	yomiuri
yoochun	yoochun	yoochun
york	यॉर्क	york
yorker	यॉर्कर	yorker
yorkshire	यॉर्कशायर	yorkshire
youtube	यूट्यूब	youtube
ypres	ypres	ypres
ytv	वाईटीवी	ytv
yu	यू	yu
yuan	युआन	(proper noun) yuan, as in yuan mu
yucatán	युकाटन	yucatan, as in the yucatan peninsula
yudhoyono	युधोयोनो	(proper noun) yudhoyono, as in indonesian president susilo bambang yudhoyono
yugi	yugi	yugi
yukito	yukito	yukito
yume	yume	(proper noun) yume
yunho	yunho	yunho
yuri	यूरी	yuri, as in soviet pilot and cosmonaut yuri alekseyevich gagarin
yurt	yurt	yurt
yên	येन	peace or stillness (n.)
yêu	प्यार	love
yếm	छाती पर पहनने का कपड़ा	tender
yến	चिड़िया का घोंसला	a type of swallow (n.)
yết	सूचीबद्ध	yet
yếu	कमज़ोर	mainly
yểm	आवरण	support
yển	धनराशि स्थानांतरित	"is a name meaning, ""bird"""
yểu	असामयिक	"(term should be ""yểu điệu"") graceful (adj.)"
z	z	z
zac	zac	zac
zambia	जाम्बिया	(proper noun) zambia, as in the nation
zealand	न्यूज़ीलैंड	(proper noun) zealand, as in new zealand
zedong	तुंग	mao zedong
zero	शून्य	zero
zeus	ज़ीउस	zeus
zheng	झेंग	zheng
zhukmse	zhukmse	zhuk-mse
zimbabwe	जिम्बाब्वे	zimbabwe
zinedine	जिनेदीन	(proper noun) zinedine
zing	जिंग	zing, as in the website
zoe	झो	zoe
zurich	ज़्यूरिख	(proper noun) zurich
zürich	ज़्यूरिख़	(proper noun) zurich, as in zurich, switzerland
|nguyễn	| गुयेन	a common vietnamese last name
|nổi	| तैरता है	"(term should be ""nổi"") to float (v.)"
|petya	| पेट्या	(proper noun) petya
|tên	| नाम	"(should be ""tên"") name (n.)"
|việt	|	vietnam
 kg	किलो	kg
 triệu	दस लाख	million
 °c	° सी	degrees celsius
°đến	को °	up to
°độ	° डिग्री	degree
×	×	x
ào	जोर	rush
á	á	asia
ác	बुराई	evil
ách	घोड़े का अंसबंध	yoke (n.)
ái	परोपकार	ai
ám	संकेत दिया	(with the word chi) to hint at
ánh	प्रकाश	light
áo	कोट	clothe
áohung	aohung	"(term should be ""Áo-hung"") austria-hungary"
áp	दबाव	"(term should be ""huyết áp"") blood pressure (n.)"
áâu	aau	eurasian
â	एक	a vietnamese vowel sound
âm	ध्वनि	vagina
ân	अनुग्रह	deed
én	निगल	swallow
ép	निचोड़	press
êgê	ege	aegean
êm	सुचारू रूप से	smooth
ích	अतिरिक्त	benefit
ílam	इलम	tamil language name for the island of sri lanka
ít	कुछ	less
île	इल	Île, as in Île de la cité, france
îledefrance	इले-डे-फ्रांस	ile-de-france
ðiều	लेख	article
ðài	दाई	taiwan
ðường	हाइवे	a road
ðảng	सराहनीय	party
ðức	जर्मनी	"Đức, a common vietnamese first name; means ""virtue"""
ó	ó	(with the word la) to boo down
óc	मस्तिष्क	brain
óng	ओंग	"(term should be ""óng ả"") flexible"
ôi	बासी होना	"vietnamese version of the exclamation ""oh"""
ôm	आलिंगन	hug
ôn	समीक्षा	peaceful (on hoa)
ông	आप	a man (n.)
ôtô	मोटर	car
ôxi	ऑक्सीजन	oxygen
ôxy	ऑक्सीजन	the element oxygen (n.)
ôxít	ऑक्साइड	oxide
ôzôn	ओजोन	ozone
ùn	जाम	congest
úng	जलभराव	flood
úp	नीचे का सामना करो	upside
úy	कप्तान	"(term should be ""thiếu úy"") second lieutenant (n.)"
ý	समीक्षा	italian
ăn	खाना	eat
ăng	एंटीना	antenna
ăngten	एंटीना	antenna
đa	बहु	majority
đai	बैंड	"(term should be ""Đai khố"") name of a village"
đak	डाक	(proper noun) Đak
đan	बुनी	scandal
đau	दर्द	painful
đay	जूट	jute, a type of vegetation the vietnamese use to make soup (n.)
đb	ne	dien ban
đcstq	सीसीपी	communist party of china
đcsvn	सीपीवी	vietnam communist party
đe	निहाई	threaten
đem	लाया	to bring (v.)
đen	काला	black
đentrắng	dentrang	"(term should be ""đen-trắng"") black-and-white (adj.)"
đeo	पहनने	wear
đh	djh	university
đhcn	coltech	university of industry
đhtm	dhtm	university of economics
đhông	dhong	dhong
đi	जाने	go
điên	पागल	crazy
điêu	मूर्ति	sculpture
điôxít	डाइऑक्साइड	dioxide
điạ	बंदरगाह	dia
điếc	बहरा	heron
điếu	सिगरेट	funeral oration
điềm	शकुन	omen
điền	में भरें	estate
điều	बात	control
điểm	बिंदु	bearing point
điển	शब्दकोश	"(term should be ""từ điển"") a dictionary"
điểu	điểu	thing
điệp	संदेश	spy
điệu	लहजा	memorial
đo	उपाय	measure
đoa	doa	doa
đoan	आकर्षक	extreme
đom	đơm	firefly
đoài	đoài	the west
đoàn	समूह	an organization or group (n.)
đoái	मुद्रा	"(term should be ""hối đoái"") to exchange or trade (v.)"
đoạn	खंड	a stage or phase (n.)
đt	डीटी	training
đtđ	मधुमेह	diabetes
đua	दौड़	emulate
đui	अंधा	blind
đun	गर्मी	cook
đuôi	पीछे	tail
đuốc	मशाल	a torch
đuối	डूबता हुआ	drowning
đuống	डुओंग	(proper noun) Đuống, the name of a river
đuổi	बेदखल	pursue
đài	स्टेशनों	statue
đàm	कफ	negotiation
đàn	मंच	musical instrument
đàng	ईडन	side
đào	आड़ू	train
đày	समाज से बाहर निकालना	exile
đá	पत्थर	to kick
đái	पेशाब	pee
đám	समूह	dam
đán	शानदार	"(term should be ""tết nguyên Đán"") vietnamese new year's day"
đáng	इसके लायक	deserve
đáo	मौलिकता	unique
đáp	उत्तर	response
đát	अप्रचलित	"(term should be ""bi đát"") lamentable (adj.)"
đâm	छिद्र	pierce
đâu	जहाँ	anywhere
đây	यहां	below
đã	है	already
đãi	इलाज	"(should be ""bạc đãi"") to ill-treat"
đãng	स्पष्ट	dissolute
đè	ओवरराइड	to press on
đèn	दीपक	light
đèo	कण्ठ	a mountain pass (n.)
đê	तटबंध	a dike (n.)
đêm	रात	night
đênh	hovers	lênh đênh= float to unknown
đích	गंतव्य	goal
đính	संलग्न	attached (adj.)
đò	नौका	a ferry (n.)
đòi	दावा	require
đòn	झटका	welcome
đó	वहाँ	that or there (adv.)
đóa	फूल	"(term should be ""đoá hoa"") a flower bloom"
đói	भूख	hungry
đón	स्वागत	welcome
đôi	दोहरा	sometimes
đôla	डॉलर	dollar
đôn	कुरसी	london
đông	पूर्व	eastern
đôngbắc	dongbac	north-east
đôngnam	dongnam	south-east
đôngtây	dongtay	"(term should be ""đông-tây"") east-west (adj.)"
đôrêmi	doremi	(proper noun) Đôrêmi
đôrêmon	doraemon	doreamon
đùa	अजीब	joke
đùi	और्विक	thigh
đúc	ढलाई	"(term should be ""đúc kết"") to sum up (v.)"
đúng	सही	right
đúp	दोहरा	double
đút	छोड़ देना	"(term should be ""đút lót"") to bribe"
đăk	đăk	dak
đĩ	रंडी	whore/bitch
đĩa	प्लेट	disk
đơ	lod	stiff or rigid (adj.)
đưa	रखना	girl
đường	चीनी	pathway
được	प्राप्त	is not
đạ	डीजीए	da
đại	समकालीन	eagle
đạm	प्रोटीन	plain
đạn	गोली	bullet
đạo	निदेशक	vagina
đạp	साइकिल	to step on
đạt	पर पहुंच गया	reach
đả	ख़ामख़ाह	to hit
đảm	मेकअप	"(term should be ""đảm nhiệm"") to undertake (v.)"
đản	जन्मदिन	a group or flock (n.)
đảng	पार्टी	party
đảo	द्वीप	an island (n.)
đấm	पंच करने के लिए	punch
đấng	प्राणियों	the
đất	भूमि	country
đấtmặt	datmat	datmat
đấy	वहाँ	ignore
đầm	पोशाक	swamp
đần	đan	"(term should be ""đần độn"") stupid or ignorant (adj.)"
đầu	सबसे ऊपर	start
đầy	पूर्ण	"(term should be ""đầy đủ"") adequate or enough"
đẩu	दस्त	"(entire term is ""khoa đẩu"") ancient phonetic script used in vietnam"
đẩy	धक्का	to push
đẫm	रक्तरंजित	wet
đậm	अंधेरा	dense
đậu	फलियां	to park (v.)
đậy	आवरण	cover
đắc	मुख्य	effectively
đắm	बर्बाद	sink
đắn	ध्वनि	proper (dung dan)
đắng	कड़वा	bitter
đắp	ऊपर	"(term should be ""bù đắp"") to compensate (v.)"
đắt	महंगा	expensive
đằng	पीछे	back
đẳng	वर्ग	equality
đặc	विशेष	"(term should be ""đặc biệt"") special (adj.)"
đặn	लगा	regularly
đẹp	सुंदर	beautiful
đẽ	तटबंध	beauty
đế	धूप में सुखाना	empire
đếm	गिनती	to count (v.)
đến	को	come
đề	की सिफारिश की	promote
đền	मंदिर	"(term should be ""đền thờ"") a religious shrine"
đều	कर रहे हैं	all
để	को	for
đệm	बफर	middle name
đỉnh	शिखर	the summit or peak
địch	दुश्मन	enemy
định	नहीं।	appointed
đọ	मुठभेड़	compete
đọan	मार्ग	period
đọc	पढ़ना	read
đọng	निक्षेप	deposit
đỏ	लाल	red (adj.)
đốc	निदेशक	admiral
đối	के लिए	face
đốm	स्थान	spot
đốn	काट दिया	"(term should be ""suy đốn:) to be worse off"
đống	ढेर	line
đốt	जला दिया	burn
đồ	नक्शा	thing
đồi	पहाड़ी	hill
đồn	गढ़	rumour
đồng	तांबा	agreeable
đổ	बहना	dump
đổi	परिवर्तन	to change (v.)
đổng	घुड़सिरा	"(term should be ""đồng bằng"") a delta"
đỗ	पार्क	pass
độ	बिंदु	"term should actually be ""độ cao""; means ""height"""
độc	विषैला	alone
độn	गुदगुदा	chaos
động	चलती	action
đột	छापा	"(term should be ""xung đột"") conflict (n.)"
đới	उष्णकटिबंधीय	tropical
đời	अस्तित्व	generation
đỡ	समर्थन	help
đợi	इंतजार	thigh
đợt	दौर	fit
đục	अपारदर्शी	turbid
đụn	टिब्बा	dune
đụng	टक्कर	encounter
đủ	काफी	enough
đứa	बच्चे	child
đức	गुण	virtue (n.)
đứng	स्टैंड	to stand (v.)
đứt	बंद	cut off
đừng	नहीं	not
đực	नर	male
đựng	शामिल	suffer
đựoc	ट्वीक	be
ĩ	ऊंचे स्वर से	"(term should be ""ầm ĩ"") noisy"
ơ	मैट	"(term should be ""thờ ơ"") to be indifferent (adj.)"
ơi	मेरी	"vietnamese equivalent of english ""oh"""
ơn	एहसान	thank
ư	यू	vowel sound found in the vietnamese alphabet (n.)
ưa	लोकप्रियता	to like (v.)
ưng	अरे हाँ	to accept (v.)
ưu	प्राथमिकता	"(term should be ""ưu việt"") preeminent (adj.)"
ươi	utans	orangutan
ươm	नर्सरी	nursery
ương	केंद्रीय	central
ướp	मसालेदार	mummy
ướt	गीला	wet
ạ	श्रीमान	a word added to the end of a response to show respect to someone in a position of authority, as in a child to a parent
ạt	बड़े पैमाने पर	(with word o) to crowd
ải	ऐ	pass
ảnh	छवि	picture
ấm	थोड़े थोड़े गरम	warm
ấn	प्रकाशनों	press
ấnâu	anau	"(term should be ""Ấn Âu"") a grouping of languages including european and indian languages that are thought to have originated from a single earlier language (adj.)"
ấp	छोटा गांव	district
ấu	जल्दी	childhood
ấy	वह	that
ẩm	नम	humidity
ẩn	छिपा हुआ	hidden
ập	हमले	rush
ắt	निश्चित रूप से	sure
ếch	मेढक	frog
ỏi	अल्प	little
ố	घिनौना	"(term should be ""hoen ố"") stained and smeared (adj.)"
ốc	असली एस्टेट	building
ốm	पतला	sick
ống	नली	tube
ốp	आवरण	omelette
ồn	शोर	noisy (adj.)
ổ	ड्राइव	hard drive
ổi	अमरूद	guava (n.)
ổn	स्थिर	peace
ớn	ठंड लगना	posts
ớt	मिर्च	chili
ở	में	at
ủ	खाद	"(term should be ""ủ dột"") gloomy (adj.)"
ủi	लोहा	"(term should be ""an ủi"") to comfort (v.)"
ủng	समर्थकों	boot
ủy	आयुक्त	commission
ứ	अवधारण	to pool together (v.)
ức	मंदी	memories
ứng	आवेदन	corresponding
−−	-	__
≠	≠	different
