$ tỉ	十亿美元	$ billion
abc	abc	abc
abdul	阿卜杜勒	abdul
abkhazia	阿布哈兹	a name
about	关于	about
abraham	亚伯拉罕	abraham
abrams	阿布拉姆斯	abrams
abscbn	绝对	abscbn
account	户口	account
aceh	ace	(proper noun) aceh
achilles	阿喀琉斯	achilles
acia	相思	acia
acid	酸	acid
ada	阿达	ada
adams	亚当斯	(proper noun) adams
addisonwesley	addisonwesley	(proper noun) addison-wesley
adn	adn	adn
adobe	土坯	adobe
adrian	阿德里安	(proper noun) adrian
adsl	adsl	adsl
advanced	进阶的	advanced
aedes	伊蚊	aedes
aegypti	埃及	aegypti
aero	航空	(proper noun) aero, as in the aero l-39 albatros jet
afc	非洲联盟	afc
aff	事后	aff
afghanistan	阿富汗	afghanistan
africa	非洲	(proper noun) africa
african	非洲的	african
ag	g	ag
agasa	阿加萨	(proper noun) agasa, as in hiroshi agasa
agassi	阿加西	agassi
ai	谁	who
ailen	爱尔兰人	ailen
aim	瞄准	aim
air	空气	air
airbus	空客	airbus
aisne	埃森	aisne
ajax	阿贾克斯	ajax
ak	ak	ak
akatsuki	赤月	akastuki
akms	阿克姆斯	akms
akô	你好	ako
al	人	al
alabama	阿拉巴马州	alabama
alaska	阿拉斯加	alaska
albania	阿尔巴尼亚	albania
albatros	信天翁	(proper noun) albatros, as in the aero l-39 albatros
albert	阿尔伯特	(proper noun) albert
alberto	阿尔贝托	(proper noun) alberto
albion	阿尔比恩	albion, an ancient name for great britain
albuquerque	阿尔伯克基	albuquerque
albus	阿不思	albus
alexa	亚历克斯	alexa
alexandra	亚历山德拉	alexandra
alexandria	亚历山大	alexandria
alexandros	亚历山德罗斯	alexandros
alexey	亚历克斯	alexey
alfred	阿尔弗雷德	(proper noun) alfred, as in alfred kinsey
algérie	阿尔及利亚	algerie
ali	阿里	ali
alice	爱丽丝	this is a name
allan	艾伦	(proper noun) allan, as in edgar allan poe
allen	艾伦	(proper noun) allen
allmusic	音乐	allmusíc
alois	阿洛瓦	alois
alonso	阿隆索	alonso
alpher	阿尔法	(proper noun) alpher
alps	阿尔卑斯山	alps
altai	阿尔泰	altai
always	总是	luon luon
amaravati	阿马拉瓦蒂	amaravati
amazon	亚马逊	amazon
amdo	安多	(proper noun) amdo
ame	阿美	ame
ami	ami	ami
amiens	亚眠	amiens
amin	胺类	(proper noun) amin, as in nagib amin
amm	嗯	amm
amoniac	氨水	ammonium (n.)
amphitrite	闪石	(proper noun) amphitrite, a greek sea goddess
an	安全	"(should be ""an toàn"") safe"
anand	阿南德	anand
anata	阿纳塔	anata
anatolia	安那托利亚	anatolia
andalusia	安大路西亚	andalusia
andaman	安达曼	andaman
anderson	安德森	anderson
andes	安第斯山脉	andes
andorra	安道尔	andorra
andrew	安德鲁	andrew
andré	安德烈	andre, as in andre morval
andy	安迪	(proper noun) andy, as in andy warhol
anfield	安菲尔德	anfield
ang	ang	ang
angkor	吴哥	(proper noun) angkor, as in angkor wat, the temple in cambodia
anglosaxon	盎格鲁撒克逊	anglo-saxon
anh	他	english
anhmỹ	英式	"(term should be ""anh mỹ"") english or american"
anhpháp	法国先生	england-france
ankara	安卡拉	ankara
ankyl	烷基	ankly
anna	安娜	anna
annam	安南	a name the way french called middle vietnam as a colony
annan	安南	annan
anne	安妮	anne, a name
anorthosit	厌食症	anorthosit, a type of igneous rock (n.)
anthony	安东尼	anthony
antigua	安提瓜岛	(proper noun) antigua
anton	安东	anton
antonov	安东诺夫	antonov
any	任何	any
anđêhít	醛类	aldehydes
ao	池塘	pond
aotearoa	奥泰罗阿	aotearoa
apollo	阿波罗	apollo
apple	苹果	apple
aquinas	阿奎那	a name
arab	阿拉伯人	(proper noun) arab
archetypal	原型的	archetypal
archive	封存	archive
arctan	arctan	a function
ares	战神	ares
argentina	阿根廷	(proper noun) the south american nation of argentina
argo	argo	argo
arias	咏叹调	arias
aringarosa	阿林加洛萨	aringarosa, as in manuel aringarosa
aristotle	亚里士多德	aristotle
arizona	亚利桑那州	arizona, as in the state
ark	方舟	ark
arkansas	阿肯色州	arkansas
arlington	阿灵顿	(proper noun) arlington
armenia	亚美尼亚人	(proper noun) armenia
armstrong	阿姆斯特朗	(proper noun) armstrong, as in jazz artist louis armstrong
arnold	阿诺德	arnold
arsenal	兵工厂	arsenal
artemis	阿耳emi弥斯	(proper noun) artemis, the greek goddess of the hunt
aruba	阿鲁巴岛	aruba
arunachal	阿鲁纳恰尔	"(term should be ""arunachal pradesh"") a state in india (proper noun)"
asc	升序	asc
ash	灰	a name
ashikaga	足鹿	ashikaga
ashley	阿什利	(proper noun) ashley
asia	亚洲	asia
asm	汇编	asm
asoka	朝冈	asoka
association	协会	association
assyria	亚述	assyria
aston	阿斯顿	(proper noun) aston, as in aston villa
atkinson	阿特金森	atkinson
atlanta	亚特兰大	atlanta
atlantic	大西洋的	atlantic
aua	ua	aua
aubrac	奥布拉克	aubrac
audition	试镜	audition
auflage	伪装	auflage
auguste	奥古斯特	auguste
australia	澳洲	(proper noun) australia
austria	奥地利	(proper noun) the country of austria
austrian	奥地利人	austrian
avar	阿瓦尔	a name
aviation	航空业	aviation
awad	唤醒	awad
award	奖	award
axit	酸	acid
ayeyarwady	伊洛瓦底省	ayeyarwady
ayumi	umi	(proper noun) ayumi
ayutthaya	大城府	(proper noun) ayutthaya
azerbaijan	阿塞拜疆	(proper noun) azerbaijan
aztec	阿兹台克人	aztec, as in the aztec people (adj.)
ba	三	three
babylon	巴比伦	babylon
bacon	培根	bacon
baden	巴登	baden
baghdad	巴格达	(proper noun) baghdad
bago	巴哥	bago
bahamas	巴哈马	bahamas
bahrain	巴林	bahrain
baháí	巴哈伊	bahai
balearic	巴利阿里语	balearic
bali	巴厘岛	bali
balkan	巴尔干	(proper adjective) balkan
balkans	巴尔干半岛	balkans
ballard	巴拉德	ballard
bamar	巴马尔	bamar
ban	禁令	the
bang	bang	state
banh	球	ball
banner	横幅	banner
bantam	矮脚鸡	bantam
bantu	班图	bantu
bao	麻袋	bao giờ= ever
barack	巴拉克	barack
barak	巴拉克	barak
barbados	巴巴多斯	(proper noun) barbados
barbara	芭芭拉	barbara
barbary	巴巴里	barbary
barca	巴萨	barca
barnes	巴恩斯	barnes
barone	男爵	barone
baroque	巴洛克式	baroque
barquin	巴昆	barquin, as in ramon barquin, the cuban military colonel
barrichello	巴里切罗	barrichello
bartholdi	巴托尔迪	bartholdi
baryon	重子	baryon
barça	巴萨	(proper noun) barca
base	基地	base
basel	巴塞尔	basel, a city in switzerland
basil	罗勒	basil
baskervilles	巴斯克维尔	baskervilles
bass	低音	bass
bator	巴托	bator
battambang	马德望	battambang
bauer	鲍尔	bauer
bay	飞	"(should be ""tuyến bay"") an airline"
bayern	拜仁	bayern
bazan	玄武岩	basalt (n.)
bazơ	基本的	base
bb	bb	bb
bbc	英国广播公司	bbc
bc	公元前	bc
bchtư	ch	central executive
beat	拍子	beat
beatles	披头士乐队	the beatles
beauty	美女	beauty
beckenbauer	本肯鲍尔	beckenbauer, as in franz beckenbauer
becker	贝克	(proper noun) becker
beckham	贝克汉姆	beckam
bedloe	贝德洛	bedloe
beethoven	贝多芬	beethoven
beethovens	贝托芬	beethoven's
beginbmatrix	初学者矩阵	this is a code
behind	在后面	behind
beijing	北京	beijing
bel	贝尔	bel
bell	铃铛	bell
bella	贝拉	bella
bellatrix	贝拉特里克斯	bellatrix
benedict	本尼迪克特	benedict
benetton	贝纳通	benetton
benfica	本菲卡	benfica
benito	贝尼托	benito
benjamin	本杰明	(proper noun) benjamin
bennington	本宁顿	bennigton
berber	柏柏尔人	berber
bergen	卑尔根	(proper noun) bergen
berger	贝格	berger
bering	ring	(proper noun) bering, as in the bering strait
berkeley	伯克利	(proper noun) the city of berkeley, california
berman	伯曼	a name
bermuda	百慕大	(proper noun) bermuda
bernard	伯纳德	bernard
bertrand	贝特朗	bertrand
better	更好的	better
betty	贝蒂	betty
bhutan	不丹	bhutan
bia	啤酒	beer (n.)
biang	比昂	biang
bic	比克	bic
bikini	比基尼	bikini
bill	帐单	(proper noun) bill, as in former president bill clinton
billy	比利	billy
bismarck	mar斯麦	bismarck, as in otto von bismarck
bitmap	位图	bitmap
biên	边界	bien
biếc	蓝绿色	a bluish-green color (adj.)
biếm	粗心	"(term should be ""biếm họa"") cartoon (n.)"
biến	变数	other
biếng	懒惰的	lose interest in
biếu	礼貌	present
biều	比厄	bieu
biển	海	ocean
biểuthứcđiềukiện	知道条件	conditional expression
biện	道歉	"(term should be ""biện pháp"") a method (n.)"
biệt	独特的	"(term should be ""khác biệt"") different or distinct"
bkavpro	bkavpro	bkavpro
blackwell	布莱克威尔	this is a name
blair	布莱尔	blair
blaise	责备	blaise
blanc	布兰奇	blanc
blues	布鲁斯	blues
bo	博	a curl, as in a biceps curl exercise
bob	鲍勃	bob
bobby	鲍比	bobby, as in bobby day
boeing	波音	boeing
bohemia	波希米亚	bohemia
bolivia	玻利维亚	(proper noun) bolivia
boltzmann	博尔兹曼	boltzmann
bom	炸弹	bomb
bonaparte	波拿巴	bonaparte
bong	ong	"(term should be ""bong bóng"") a balloon (n.)"
bonnal	邦纳尔	bonnal
bonobo	no黑猩猩	bonono
bool	布尔	bool
boolean	布尔值	(proper adjective) boolean, as in boolean algebra
boom	繁荣	boom
boong	甲板	a deck (n.)
boongke	堡	bunker
bop	p	bop
boris	鲍里斯	boris
borland	borland	(proper noun) borland
borussia	白俄罗斯	borussia
bose	玻色	bose, as in subhas chandra bose
boseeinstein	boseeinstein	bose einstein
bosna	波斯纳	(proper noun) bosnia
bosnia	波斯尼亚	(proper noun) bosnia
botswana	博茨瓦纳	botswana
bottom	底	bottom
boulder	巨石	boulder
bourbon	波旁威士忌	bourbon
boxing	拳击	boxing
brain	脑子	brain
brandenburg	布兰登堡	(proper noun) brandenburg
brandt	布兰特	brandt
braun	布劳恩	braun
brazil	巴西	brazil
bremen	不来梅	bremen, as in the bremen bank
brestlitovsk	布雷斯托夫斯克	brest-litovsk
breton	不列塔尼	(proper noun) breton
bretton	布雷顿	hoi nghi
brezhnev	勃列日涅夫	brezhnev
brian	布莱恩	a name
bridge	桥	bridge
britannic	大不列颠	(proper noun) britannic
britney	布兰妮	britney
brooklyn	布鲁克林区	brooklyn
brot	t	this is german not vietnamese
brown	棕褐色	brown
browne	布朗	browne
browning	褐变	(proper noun) browning
bruce	布鲁斯	bruce
brunei	文莱	brunei
bruno	布鲁诺	bruno, as in the city of san bruno
brusilov	布鲁西洛夫	brusilov
brussels	布鲁塞尔	brussels, the capital of belgium
btr	btr	btr
bubalis	泡	bubalis
budapest	布达佩斯	budapest, the capital of hungary
bulgaria	保加利亚	bulgaria
bulletin	公告	thong bao
bungary	邦吉	bungary
bungo	邦戈	bungo
buonaparte	布纳帕	(proper noun) buonaparte, as in casa buonaparte
burke	伯克	(proper noun) burke, as in edmund burke
burkina	布基纳	burkina
burma	缅甸	burma
burundi	布隆迪	burundi
busan	釜山	a korean city
busby	巴斯比	busby
bush	灌木丛	bush
bushy	浓密的	bushy
buôn	批发价	commerce
buông	放开	to release, to let loose
buýt	公车	bus
buốt	冷的	sharp
buồm	航行	sail
buồn	伤心的	sad
buồng	室	chamber
buổi	会议	session
byzantine	拜占庭	byzantine
bà	祖母	woman or lady (n.)
bài	发布	articles
bàn	桌子	table
bàng	鹰	eagle
bành	包	armchair
bào	刨	compatriot
bàu	包	bau
bày	简报	"(term should be ""trưng bày"") to display (v.)"
bác	叔叔	doctor
bách	柏树	"(term should be ""bách khoa"") polytechnic (adj.)"
bái	邪教	to bow (v.)
bám	坚持	cling
bán	已卖出	sell
báng	存货	"(term should be ""phỉ báng"") to defame or slander"
báo	报纸	newspaper (n.)
bát	碗	eight (n.)
báu	宝	valuable
bây	现在	now
bã	残渣	"(term should be ""buồn bã"") sad (adj.)"
bãi	码	beach
bão	暴风雨	storm
bèn	然后	then
bé	宝贝	baby
bén	尖锐的	sharp (adj.)
béo	胖子	fat
bên	派对	side
bênh	生病了	advocate
bì	包装方式	foreskin (n.)
bìa	遮盖	cover
bìu	阴囊	sac (n.)
bí	西葫芦	secret
bính	平	"(term should be ""bính âm"") romanized chinese words (n.)"
bíró	南瓜	biro
bò	牛	beef
bó	一堆	bound (adj.)
bói	算命	to foretell (v.)
bón	施肥	"entire term should be ""phan bon""; means ""fertilizer"""
bóng	球	sphere or ball
bóp	挤压	squeeze
bô	便盆	"(term should be ""bôxit"") the mineral bauxite"
bôi	涂抹	to apply (as in oil)
bông	棉布	flower
bù	弥补	compensate
bùa	护身符	talisman
bùn	泥	mud
bùng	耀斑	"(term should be ""bùng nổ"") to break out (v.)"
bú	哺乳	to suck
búa	锤子	a hammer
búi	簇绒	tuft
bún	包子	noodle
búng	轻弹	snap
bút	笔	pseudonym
băm	散列	hash
băn	苦恼	concerned
băng	冰块	"(term should be ""băng giá"") freezing (adj.)"
bơ	黄油	"(term should be ""bơ vơ"") desolate (adj.)"
bơi	游泳	swim
bơm	抽水机	pump
bưu	邮资	post office
bước	一步	a step (n.)
bướm	蝴蝶	butterfly
bạ	联络人	directory
bạc	银	meager
bạch	透明的	"(should be ""bạch tuộc"") an octopus"
bại	失败了	defeated
bảng	桌子	chart
bảo	宝	protect
bảy	七	seventh
bấm	按	press
bất	真实的	"(term should be ""bất cứ"") any (adj.)"
bấy	那	contemporary
bần	可怜的	poor
bầu	投票	vote
bầy	牛群	servant
bẩm	先天的	congenital
bẩn	脏的	the
bẩy	陷阱	"(term should be ""lẩy bẩy"") unsteadily (adv.)"
bẫy	陷阱	a trap (n.)
bậc	学位	level or class (n.)
bận	忙	busy
bật	开启	outstanding
bắc	北	beijing
bắcnam	诺斯南	"(term should be ""bắc-nam"") north-south (adj.)"
bắn	射击	shoot
bắp	玉米	venter
bắt	赶上	cross
bằng	等于	by
bẹp	暗恋	crush
bẻ	打破	break
bẽ	屈辱	humiliate
bến	码头	wharf
bếp	厨房	kitchen
bề	表面	"(should be ""bề mặt"") a surface"
bền	经久耐用	enduring (v.)
bể	坏了	tank
bệ	基座	base
bện	编织	braided (adj.)
bệnh	生病了	benh
bỉ	比利时	disgust
bỉnh	顽皮的	binh
bịch	重击	ridiculous
bịt	覆盖的	cover
bọ	虫子	insect
bọc	包裹	to cover or enclose (v.)
bọn	他们	a group (n.)
bọng	浮肿	bladder
bọt	泡沫	foam
bỏ	放弃	to leave (v.)
bỏng	烧伤	hot
bố	父亲	"(term should be ""tuyên bố"") to declare"
bốc	装货	bốc lửa= on fire
bối	困惑的	messy
bốn	四	four
bồi	补偿金	"(term should be ""cao bồi"") cowboy (n.)"
bổn	职责	duty
bổng	奖学金	"with word luong, means ""salary"" or ""wages"""
bỗng	突然间	suddently
bộ	设置	part
bộc	中银	"(term should be ""bộc lộ"") to reveal (v.)"
bội	倍数	betray
bột	面团	powder or flour (n.)
bớ	四舍五入	arrest
bớt	少一点	less
bờ	岸边	coast
bời	烧伤	profuse
bở	由	profitable
bởi	由	because
bục	讲台	platform
bụng	肚皮	abdomen
bứt	在不知不觉中	"(term should be ""bứt phá"") power (n.)"
bừa	悲惨的	messy, careless, or topsy-turvy (adj.)
bữa	餐	meal (n.)
bực	沮丧的	bother
ca	钙	praise
ca-lo	卡罗	a unit of measurement
cabo	卡波	cabo
cacbon	碳	carbon
cacbonat	碳酸盐	carbonate
cacbua	硬质合金	carbides, carbon ions
caesar	凯撒	caesar
caffein	咖啡因	caffeine
café	咖啡	coffee
cai	停药	govern
cairo	开罗	cairo, the capital of egypt
cal	卡	cal, a first name
calculus	微积分	calculus
calvin	加尔文	calvin
cam	橙色	commit
cambodia	柬埔寨	(proper noun) the country of cambodia
cambridge	剑桥	cambridge
cameo	客串	cameo part
cameron	卡梅伦	cameron
cameroon	喀麦隆	cameroon
camille	卡米尔	camille
campbell	坎贝尔	campbell
campuchia	柬埔寨	campuchia
canada	加拿大	canada
canadian	加拿大人	canadian
canal	运河	canal
canary	金丝雀	canary
cancer	癌	cancer
canterbury	坎特伯雷	canterbury
canxi	钙	calcium
capello	卡佩罗	capello
capra	卡普拉	capra
carat	克拉	carat
carbine	卡宾枪	carbine
cardcaptor	持卡人	cardcaptor
cardcaptors	持卡人	(proper noun) cardcaptors
carey	凯里	(proper noun) carey, as in singer mariah carey
caribe	加勒比人	caribbean
caribê	加勒比海	caribbean
carl	卡尔	carl
carlos	卡洛斯	carlos
carnaval	狂欢节	carnaval
carol	颂歌	carol
caroline	卡罗琳	(proper noun) caroline
carpathia	喀尔巴阡山脉	carpathia
carter	卡特	carter
carxtơ	克拉	karst topography, a geological term (n.)
casa	卡萨	casa
casablanca	卡萨布兰卡	casablanca
caspia	里海	caspia
cassini	卡西尼号	cassini
cast	演员表	cast
castries	卡斯特里	castries
castro	卡斯特罗	castro, as in fidel castro
cathay	国泰航空	cathay
catherine	凯瑟琳	catherine
cau	au	cau
cbc	cbc	cbc
cbgd	cbgd	educational  officer
cbs	立方英尺	cbs
ccc	抄送	ccc
ccn	ccn	industrial cluster
cctv	中央电视台	cctv
cd	光盘	cd
cdot	点	cdot
cdrom	光盘	cd-rom
cell	细胞	cell
celtic	凯尔特人	centic
cena	塞纳	(proper noun) cena, as in john cena, the wrestler
centauri	半人马座	centauri
ceres	蜡膜	ceres
cha	父亲	father
chai	瓶子	bottle
chaillot	夏洛特	a name
chamberlain	张伯伦	chamberlain
champa	尚帕	champa
champion	冠军	champion
chamẹ	按摩	parents
chanel	香奈儿	chanel
chanh	柠檬	lemon or lime (n.)
chao	你好	(proper noun) chao, a name
charles	查尔斯	charles
charlotte	夏洛特	charlotte
charlton	查尔顿	charlton
charon	卡龙	(proper noun) charon
chase	追逐	chase
chay	素食主义者	fasting
chdcnd	chdcnd	democratic republic
che	遮盖	cover
chechnya	车臣	chechnya
chen	陈	chen
cheo	o	"(term should be ""cheo reo"") name of a town"
chi	支出	"(term should be ""chi tiết"") details (n.)"
chia	分开的	"(term should be ""chia sẻ"") to share"
chiang	清	chiang
chicago	芝加哥	chicago, as in chicago, illinois
chile	智利	(proper noun) the country of chile
chim	鸟	bird
china	中国	china
ching	ching	ching
chirac	希拉克	chirac, as in former french president jacques chirac
chiêm	占星术	"(term should be ""chiêm thành"") the ancient kingdom of champa in vietnam"
chiên	炒	fry
chiêng	锣	gong
chiếc	个	the
chiếm	占领	appropriate
chiến	打架	war, fight
chiết	提取物	literal
chiếu	投影	show
chiền	一堆	temple
chiều	下午	length
chlamydia	衣原体	chlamydia
chloride	氯化物	chloroauric acid
chnd	chnd	chnd
choi	玩	choi
chomsky	乔姆斯基	chomsky
chong	冲	chong
chopin	肖邦	chopin
chosŏn	chosŏn	(proper noun) choson
choàng	斗篷	coat
choáng	惊呆了	dizzy
chris	克里斯	chris, as in chris hughes
christ	基督	christ
christian	基督教徒	christian
christopher	克里斯托弗	christopher
chrome	镀铬	chrome, as in google chrome
chrysler	克莱斯勒	(proper noun) chrysler, the car company
chu	周期	cycle
chua	酸味	tomato
chuck	卡盘	(proper noun) chuck, as in chuck norris
chui	地下的	underground
chum	um	pot
chun	春	chun
chung	一般	general
churchill	丘吉尔	churchill
chuyên	专业的	professional
chuyến	旅行	trip
chuyền	通过	volleyball
chuyển	调动	to move
chuyện	故事	nói chuyện= talk
chuôi	抓地力	handle
chuông	铃铛	a bell
chuẩn	标准	standard
chuốc	oke	incur
chuối	香蕉	banana
chuốt	拉削	refine
chuồng	谷仓	cage
chuỗi	弦	series
chuộc	赎回	redeem
chuộng	偏爱	favorite
chuột	滑鼠	a mouse (n.)
chà	擦	rub
chài	钓鱼	fish
chàm	靛蓝	indigo
chàng	家伙	"(term should be ""chàng trai"") a young man (n.)"
chào	你好	welcome
chày	棒球棒	a pestle (n.)
chánh	首席	"(term should be ""chánh án"") the head of a tribunal (n.)"
cháo	稀饭	porridge
cháu	孙子	a term one uses denoting oneself when addressing an aunt or uncle (n.)
cháy	燃烧的	fire
châm	刺	motto
chân	脚	a leg
châu	欧洲	continental
chè	茶	tea
chèn	插入	insert
chém	斜线	to chop
chén	杯子	bowl
chéo	交叉	cross
chép	复制	written
chê	该死的	decry
chênh	差异	difference
chì	铅	graphite
chìa	关键	"(term should be ""chìa khoá"") a key (n.)"
chìm	下沉	to become submerged or sink (v.)
chình	鳗鱼	eel
chí	虱子	especially
chích	注射剂	shoot
chín	九	ripe
chính	主要的	main
chít	t	dense
chò	ke	a type of plant, typically of the parashorea genus (n.)
chòi	小屋	hut
chòm	星座	constellation
chó	狗	dog
chóc	哈哈	killing (giet choc)
chói	眩光	bright
chóng	迅速地	"entire term should be ""chong mat""; means ""dizzy"""
chóp	小费	the top (n.)
chôm	红毛丹	rambutan
chôn	埋葬	bury
chông	老公	thorn
chùa	宝塔	pagoda
chùy	钉头锤	mace
chú	叔叔	uncle (n.)
chúa	上帝	god
chúc	希望	will
chúi	u	drop
chúng	他们	they
chút	一点点	little
chăm	保重	champa
chămpa	占巴	champa
chăng	负担得起的	would it
chĩa	叉子	point
chơi	玩	play
chơn	脚	"a more obscure form of the word ""chân""; means ""genuine"" or ""true"""
chư	附庸	lower authorities
chưa	还没	not yet
chưng	dist	steamed
chương	章	medal
chướng	障碍路线	grating
chạ	混杂的	father
chạm	触碰	touch
chạng	暮光之城	twilight
chạp	摇摇欲坠	slow
chạy	运行	to run (v.)
chả	卷	no
chảo	锅	pan
chảy	流动	bleeding
chấm	点	end
chấp	按揭	"(term should be ""chấp nhận"") to accept (v.)"
chất	实质	quality
chấu	捏	"(term should be ""châu chấu"") a grasshopper (n.)"
chần	热烫	slice
chẩn	诊断	"(term should be ""chẩn đoán"") to diagnose (v.)"
chậm	慢慢地	slow
chận	挡	block
chật	紧	overcrowded
chậu	盆	pelvic
chắc	当然	certainly
chằng	眉头	ligament
chẵn	甚至	even
chặn	挡	prevent
chặng	腿	journey
chặt	紧	close
chẻ	分裂	strick
chẽ	紧	"(term should be ""chặt chẽ"") tightly or closely (adv.)"
chế	准备工作	produce
chếch	松弛	oblique
chết	死	to die (v.)
chệch	错了	deviant
chỉ	只	just (adv.)
chỉnh	更正	adjust
chịt	废话	chằn chịt= complex/tangle
chịu	熊	tolerate
chọc	戳	to poke
chọi	打架	oppose
chọn	选择	to choose
chỏ	肘部	"(term should be ""cùi chỏ"") elbow (n.)"
chốc	瞬间	single
chối	否认	refuse
chốn	地方	place
chống	反	anti-
chốt	闩锁	important
chồi	芽	"(term should be ""đâm chồi"") budding"
chồn	黄鼠狼	anxious
chồng	老公	husband
chỗ	地方	where
chội	狗屎	cramped
chớ	不要啦	not
chớp	雷电	flashing (adj.)
chờ	等一下	to wait
chở	携带	for
chợ	市场	market
chợt	突然间	suddenly
chục	打	dozen
chụp	射击	capture
chủ	拥有者	"(term should be ""chủ yếu"") main or essential (adj.)"
chủng	毒株	strain
chứ	宁可	just or only (adv.)
chứa	包含	contain
chức	机能	function
chừ	等一下	hesitate
chừa	离开	leave
chừng	大约	about or roughly (adv.)
chử	字	"(term should be ""chử bích"") the vietnamese name for a chinese island"
chửa	怀孕的	pregnant
chửi	诅咒	curse
chữ	字	a letter of the alphabet (n.)
chữa	治愈	to cure or treat (v.)
chững	调平	to totter (v.)
cia	cia	cia
cincinnati	辛辛那提	cincinnati
cinderella	灰姑娘	cinderrella
cip	密码	cip
circus	马戏团	circus
cities	城市	cities
clara	克拉拉	clara
clark	克拉克	clark
claude	克劳德	(proper noun) claude
claudius	克劳迪乌斯	(proper noun) claudius
clinton	克林顿	clinton, as in former president bill clinton
clip	夹	clip
clips	短片	clips
clo	氯气	chlorine
clow	low	clow
clyde	克莱德	(proper noun) clyde, as in bonnie and clyde
cmc	电脑	cmc
cmt	cmt	cmt
cn	cn	christian era
cnet	网络	cnet
cntb	中央电视台	capitalism
cntt	cntt	it
cnxh	cnxh	social republic
co	合作	spasm
coburn	科本	coburn
cocoa	可可	cocoa
coen	科恩	coen
coffea	咖啡	coffee
cohen	科恩	cohen
coi	考虑过	to regard
coleen	科琳	coleen
coleman	科尔曼	coleman
coli	大肠杆菌	coli
colin	科林	(proper noun) colin, as in colin powell
colleen	科琳	colleen
college	大学	college
collins	柯林斯	(proper noun) collins
collège	大学	college (n.)
colombia	哥伦比亚	colombia
colombo	科伦坡	(proper noun) colombo
colorado	科罗拉多州	(proper noun) colorado, as in the state
columbus	哥伦布	columbus
comic	可笑的	comic
common	普通的	common
concacaf	康卡卡夫	concacaf
concerto	协奏曲	concerto
concorde	协和	concorde
condom	安全套	condom
cong	弯曲的	curved or bent
congo	刚果	congo
congress	国会	congress, as in library of congress
connecticut	康涅狄格州	connecticut
conrad	康拉德	corrad
conservation	养护	conservation
constantine	君士坦丁	constantine
contemporary	当代的	contemporary
cooper	库珀	(proper noun) cooper
copenhagen	哥本哈根	copenhagen
copernic	哥白尼	corpernic
copperfield	copperfield	(proper noun) copperfield, as in magician david copperfield
coppola	科波拉	coppola
copy	复制	copy
cordyceps	虫草	cordyceps
core	核心	core
cornell	康奈尔	cornell
cosin	余弦	cosine
costa	哥斯达黎加	costa
cotang	共塘	cotangent
cpt	cpt	cpt
craig	克雷格	(proper noun) craig
crazy	疯了	crazy
crespo	克雷斯波	(proper noun) crespo
crest	波峰	crest
crew	船员	crew
crimson	深红色	crimson
crisis	危机	crisis
cristiano	克里斯蒂亚诺	cristiano, as in portuguese soccer player cristiano ronaldo
croatia	克罗地亚	croatia
cross	交叉	cross
crs	crs	crs
cruz	克鲁兹	cruz
cruzeiro	克鲁塞罗	cruzeiro
crystal	水晶	crystal
ctc	ctc	ctc
cua	蟹	crab (n.)
cullen	卡伦	a name
cung	弓	circle
cunningham	坎宁安	cunningham; proper name
cup	杯子	cup
cuả	的	of, from, belonging to
cuốc	头	hoe
cuối	最后	last or final (adj.)
cuốn	书	book
cuống	茎	throat
cuồng	疯了	crazy (adj.)
cuộc	打架	the
cyanide	氰化物	cyanide
cyber	网络	cyber
cyril	西里尔	(proper noun) cyril
cyrus	赛勒斯	cyrus
cyworld	cyworld	cyword
cà	咖啡	ca
cài	安装	install
càn	需要	raid
càng	越多	cang
cành	分行	branch
cào	从头开始	scratch
cày	耕作	plow
các	的	all (adv.)
cách	方式	the
cái	的	"(term should be ""con cái"") children (n.)"
cán	卷起	"(should be ""cán bộ"") an officer, especially in a communist regime"
cánh	翅膀	wing
cáo	狐狸	report
cáopx|bình	cáopx|平均	not a word
cáp	电缆	cable (n.)
cáy	提琴手	fiddler
câm	哑巴	mute (adj.)
cân	规模	weight
câu	句子	saying
cãi	争论	argue
cò	触发	stork
còn	向左	to have left (v.)
có	是的	have
cói	莎草	machine
cót	婴儿床	cot
cô	她的	girl
côi	孤儿	orphaned
côn	锥度	a stick (n.)
công	工作	worker
côngtenơ	货柜	container
cõi	领域	entire area
cõng	背back式	piggyback
cù	挠痒痒的	cu
cùi	麻风病人	leprosy
cùng	在一起	together
cú	猫头鹰	old
cúi	弓	to bow (v.)
cúm	感冒	cum
cúng	舒适的	worship
cúp	断电	cup (n.)
cút	下车	to kick someone out (v.)
căm	已插入	detest (cam thu)
căn	激进的	"(term should be ""căn bệnh"") cause of a disease (n.)"
căng	伸展	tense
cũ	旧的	old
cũi	婴儿床	kennel
cũng	以及	also
cơm	饭	rice
cư	填充	resident
cưa	锯	saw
cưng	亲爱的	also
cước	货运	megaman
cưới	已婚	marry
cướp	抢劫	to rob (v.)
cười	大笑	smile
cường	激烈的	strengthen
cưỡi	骑马	ride
cưỡng	被迫	force some body to do some thing. cưỡng dâm=rape
cạc	卡	card (n.)
cạn	浅的	shallow
cạnh	边缘	"(term should be ""khía cạnh"") an angle"
cạo	刮胡子	shave
cạp	蝎子	scorpion
cả	两者	both
cải	芥末酱	reform
cảm	冷的	pleasure
cản	困扰	prevent
cảng	港口	port
cảnh	场景	situation
cảo	拉	posthumous
cấm	禁止的	ban
cấn	需要	dramatic
cấp	授予	level or rank (n.)
cất	蒸馏的	"(term should be ""cất giữ"") to keep safe or store"
cầm	保持	to hold (v.)
cần	需要	need
cầu	桥	request
cầy	灵猫	farmed
cẩn	小心一点	carefully
cẩu	吊车	"(term should be ""hải cẩu"") a seal (n.)"
cận	方法	close
cập	柜台	mention
cậu	他	a young man (n.)
cậy	依靠	reliable
cắm	插入	to plant (v.)
cắn	咬	to bite
cắp	偷	steal
cắt	切	cut
cằm	下巴	chin
cằn	脾气暴躁	exhausted (adj.)
cặp	一对	couple
cọ	手掌	rub
cọc	堆	pile
cọp	虎	tiger
cỏ	草	plant
cố	试一试	"(term should be ""cố gắng"") to try one's best (v.)"
cốc	杯子	cereal
cối	砂浆	mortar
cốm	块金	grilled rice
cống	致敬	dedicate
cồn	酒鬼	i
cồng	锣	gong
cổng	门	gate
cỗ	甲板	engine
cỗi	固执	barren
cộ	车辆	"(term should be ""xe cộ"") cars or vehicles (n.)"
cội	旧的	origin
cộng	加号	to add (v.)
cột	专栏	pole
cớ	借口	excuse
cờ	旗	flag
cỡ	大小	size
cợt	开玩笑的	"(term should be ""đùa cợt"") to trifle (v.)"
cục	部门	department
cụm	集群	cluster
cụp	截肢	down
cụt	截肢	"(should be ""xương cụt"") the tailbone or coccyx"
củ	块茎	a bulb, a botanical term
của	的	of
củi	柴火	firewood
củng	也	reinforce
cứ	在	any
cức	咕	"(term should be ""cức Đê"") a character in chinese history"
cứng	辛苦	hard
cứngi	哈迪	cungi
cừ	堆	nacre
cừu	羊	sheep
cửa	门	door
cửu	相乘	nine
cữ	铜	abstinence
cữu	棺材	nine
cự	距离	against
cựa	马刺	retreat
cực	极端的	extreme
cựu	前者	former
d	d	d.
da	皮肤	skin
daegu	大邱	daegu
dahl	达尔	(proper noun) dahl, as in author roald dahl
dai	耐嚼的	persistent
daily	每天	daily
dakota	达科他州	dakota, as in the state of south dakota
dalat	大叻	da lat
dampier	阻尼器	(proper noun) dampier, a last name
dan	丹	dan
dancing	跳舞	dancing
danger	危险的	danger
danh	名	list
daniel	丹尼尔	daniel
dante	但丁	dante
dao	刀	poniard
darwin	达尔文	darwin
das	达斯	das
dassault	达索	(proper noun) dassault
date	日期	date
dau	头疼	dau
dave	戴夫	(proper noun) dave, as in dave sexton
david	大卫	david, as in david thomas
davies	戴维斯	davies
davis	戴维斯	davis
dbsk	数据库	dbsk
dc	直流电	d.c.
ddr	ddr	ddr
dean	院长	a name
degree	学位	degree
delhi	德里	delhi
delphi	德尔菲	(proper noun) delphi, as in the oracle
demeter	德米特	(proper noun) demeter, the greek goddess of the harvest
den	窝	den
dennis	丹尼斯	dennis
department	部门	departmen
derek	德里克	derek
des	des	des
descartes	笛卡尔	descartes
design	设计图	thiet ke
deuterium	氘	deuterium
deutschland	德国	deutschland
dewan	德万	dewan, as in dewan rakyat
dewitt	德威特	(proper noun) dewitt, as in rose dewitt bukater
di	细胞	move
diana	戴安娜	(proper noun) diana, as in diana ross
die	死	german
diego	迭戈	diego
dien	疯了	"(term should be ""Điện biên phủ"") a city in northwestern vietnam where a famous battle took place during the vietnam war"
dimaggio	迪马乔	gimaggio
dinh	宫	official residence or palace
dionysus	狄俄尼索斯	dionysus, as in the greek god
discovery	发现	discovery
discussion	讨论区	discussion
disneyland	迪士尼乐园	disneyland
division	师	division
divoire	神职人员	d'lvoire
diêm	火柴	diem vuong
diên	疯了	"(term should be ""kinh diên"") canon (n.)"
diềm	价	matches
diều	风筝	kite
diểu	风筝	(proper noun) diểu
diễm	diem	beauty; a common vietnamese first name for women
diễu	行军	parade
diệc	苍鹭	a heron (n.)
diệm	diem	(proper noun) diệm, as in ngô Đình diệm, former president of south vietnam
diện	面子	face to face
diệt	杀死	to kill or destroy (v.)
diệu	魔术	effective (adj.)
djibouti	吉布提	djibouti, a country in africa
djokovic	乔科维奇	(proper noun) djokovic, as in novak djokovic
dm	dm	dm
dmitri	德米特里	dmitri
dna	脱氧核糖核酸	dna
do	由	because of
doanh	联合	"(term should be ""kinh doanh"") business (n.)"
doc	doc	doc
docherty	多切蒂	docherty
dolly	多莉	(proper noun) dolly, as in singer dolly parton
dome	圆顶	nha
dominican	多米尼加	(proper noun) dominican, as in the dominican republic
don	不要	(proper noun) don
donau	多瑙河	donau
dortmund	多特蒙德	(proper noun) dortmund
dougherty	发酵	dougherty
douglas	道格拉斯	douglas
dover	多佛	(proper noun) dover, as in the capital of delaware
doyle	道尔	doyle
doãn	杜安	doan
doạ	威胁	threat
dp	dp	dp
dracula	德古拉	dracula
draft	草稿	draft
drake	德雷克	(proper noun) drake
driver	司机	a name
ds	ds	ds
dtd	dtd	dtd
dth	dth	dth
du	旅客	travel
dubai	杜拜	dubai
duiker	杜克	duiker
duk	杜克	duk
dumas	杜马	dumas
dumbledore	邓布利多	dumbledore
dung	粪	portrait
durham	杜伦	durham
dursley	达斯利	dursley
duy	只	only
duyên	注定的	coastal
duyện	有抱负的	fellatio
duyệt	浏览	browser
duơng	阳阳	ocean
duẩn	段	duan
duật	杜阿特	duat
duệ	后裔	descendants (n.)
duỗi	拉直	stretch
dwight	德怀特	dwight
dà	h	gradually
dài	长	to lengthen, as in time
dàn	分期	to arrange
dàng	容易的	dang
dành	花了	for
dào	丰富的	"complement to word ""doi""; entire phrase ""doi dao"" means ""plentiful"""
dày	浓密的	thick
dái	小便	"penis (n.), although some may use the term to mean ""testicles"""
dám	敢于	dare
dán	贴上	stick
dáng	形状	appearance
dát	镶嵌	inlay
dâm	淫荡的	lustful (adj.)
dân	人	people
dâng	提供	dedicate
dây	电线	nerve
dã	野性的	chronicle
dãi	宽容的	band
dãn	扩张的	extend
dãy	顺序	a row (n.)
dè	小心一点	tight
défense	防御	defense
dép	凉鞋	slipper
dê	山羊	goat
dì	阿姨	aunt
dìu	ì	to lead by the hand (v.)
dính	粘性的	stick
dò	搜寻	(with word tham) to survey
dòm	看	snoop
dòng	线	"(term should be ""dòng họ"") family (n.)"
dó	那	a type of plant used to make paper in vietnam (n.)
dông	雷雨	a storm (n.)
dõi	追踪	monitor
dù	虽然	though
dùi	打孔器	awl
dùng	用过的	use
dăm	刨花	"(term should be ""đá dăm"") pebbles (n.)"
dĩ	当然可以	why
dĩa	叉子	dish
dũng	英勇	courage
dơ	脏的	dirty
dơi	蝙蝠	bat
dư	多余的	remnant
dưa	甜瓜	melons
dưng	停止	suddently
dương	正面的	penis
dường	好像	seem
dưỡng	护理学	feed
dược	药房	having to do with medicine (adj.)
dượng	叔叔	uncle
dạ	是的	night
dại	愚蠢的	stupid or idiotic (adj.)
dạn	无所畏惧	"(term should be ""dày dạn"") to be accustomed to, especially some sort of difficult situation (adj.)"
dạng	格式	tyoe
dạo	漫步	vending
dạt	冲了	to drift
dạy	教书	teach
dải	剥离	range
dấm	醋	vinegar
dấp	绊脚	shape
dấu	标志	signal
dấy	引起	to raise (v.)
dần	逐渐地	people
dầu	油	oil
dẫm	脚	step on
dẫn	铅	to lead
dẫu	虽然	though
dận	阿姨	to step on
dậu	公鸡	rooster
dậy	起床	"(term should be ""dậy thì"") pubescent (adj.)"
dắt	铅	lead
dằn	压载物	"(term should be ""dằn lòng"") to hold yourself in (v.)"
dằng	持久的	dằng dai= long/endless
dẳng	持久的	persist
dặm	英里	mile
dặn	下令	to advise (v.)
dặt	订单	conservative
dẹp	平整	pacify
dẹt	平的	flat
dẻ	栗子	chestnut
dẻo	可塑性	flexible
dế	蟋蟀	cricket
dền	mar菜	beetroot
dể	容易的	easy
dễ	容易的	easy
dệt	编织	textile
dị	奇点	simple
dịch	翻译	semen
dịp	场合	occasion
dịu	圆润的	ease
dọa	威胁	to threaten or scare (v.)
dọc	垂直的	along
dỏm	机智的	witty
dốc	斜率	slope
dối	说谎	lie
dốt	无知的	stupid or ignorant (adj.)
dồi	丰富的	"(term should be ""trau dồi"") improve (v.)"
dồn	陷入困境	accrue
dỗ	哄	dirty
dời	移动	leave
dở	不好	incomplete
dỡ	卸货	remove
dụ	例如	example
dục	性爱	sexuality
dụng	使用	use
dứa	凤梨	pineapple
dứt	已终止	to cease
dừa	椰子	coconut (n.)
dừng	停止	to cease
dữ	资料	"(term should be ""giận dữ"") anger (n.)"
dự	投射的	attend
dựa	基于	base on
dực	男	dực, as in lê tương dực
dỹ	ỹ	dy
e	ë	e.
ea	ea	(proper noun) ea, as in ea kao
earles	伯爵	earles
eaton	伊顿	eaton
ebro	埃布罗	a name
ecmascript	ecmascript	ecmascript
ecw	电磁波	ecw
edda	埃达	(proper noun) edda
edgar	埃德加	edgar, as in author edgar allan poe (n.)
edge	边缘	edge
edinburgh	爱丁堡	(proper noun) edinburgh, as in edinburgh, scotland
edison	爱迪生	edison
editor	编者	editor
edmond	埃德蒙	edmond
edo	江户	edo
edward	爱德华	edward
edwin	埃德温	edwin
eea	ea	eea
efron	埃夫隆	efron, as in zac efron
egypt	埃及	egypt
eid	开斋节	(proper noun) eid
eiffel	埃菲尔铁塔	eiffel
einstein	爱因斯坦	einstein
eisenhower	艾森豪威尔	eisenhower, as in former president dwight d. eisenhower
ekaterina	叶卡捷琳娜	this is a name
elbe	易北河	(proper noun) the elbe river
electronic	电子的	electronic
eliane	伊莲娜	(proper noun) eliane
elip	椭圆形	ellipse
elizabeth	伊丽莎白	elizabeth
ellen	爱伦	ellen
ellis	埃利斯	a name
elton	埃尔顿	(proper noun) elton, as in elton john
elvis	猫王	elvis
elíp	椭圆形	ellipse
em	你	younger sibling
email	电邮	email
emily	艾米莉	(proper noun) emily, as in emily dickinson
emir	埃米尔	emir
emmy	艾美奖	emmy
en	恩	erica reef
energy	能量	energy
engels	英格	engels
england	英国	(proper noun) england, as in new england
eniac	ac	eniac
entente	协约	entente
entropy	熵	entropy
enzym	酵素	enzymes
eo	腰围	eo, as in the film captain eo
ep	ep	a name
erich	富裕的	erich
erik	埃里克	erik, as in erik moller
eris	埃里斯	eris
eritrea	厄立特里亚	eritrea
ernest	欧内斯特	(proper noun) ernest
eros	爱神	eros, greek god of love
erwin	欧文	(proper noun) erwin, as in erwin rommel
españa	西班牙文	espana
essential	必不可少的	essential
ethernet	乙太网路	ethernet
ethiopia	埃塞俄比亚	(proper noun) ethiopia
euclid	欧几里得	euclid
eugene	尤金	eugene
eugène	欧仁	(proper noun) eugène
euler	欧拉	euler
euro	欧元	euro, as in the european currency
eurofighter	欧洲战斗机	eurofighter
europe	欧洲	europe
european	欧洲人	(proper adjective) european
eva	eva	eva
everton	埃弗顿	everton
every	每一个	every
exgay	妖精	exgay
explorer	探险家	explorer
extensive	广泛的	extensive
fabio	法比奥	(proper noun) fabio
facebook	脸书	(proper noun) facebook
fact	事实	fact
facto	事实	this is french not vietnamese
faifo	faifo	(proper noun) faifo
fao	o	fao
farrell	法雷尔	farrell
faso	法索	faso
fbi	联邦调查局	fbi
fca	fca	fca
fdi	外国直接投资	fdi
features	特点	features
federer	费德勒	federer
feet	脚	feet
felipe	费利佩	felipe
felis	费利斯	(proper noun) felis
felix	费利克斯	(proper noun) felix, as in felix klein
ferb	b	ferb
ferdinand	费迪南德	ferdinand
ferguson	弗格森	ferguson
fernando	费尔南多	fernando
ferrari	法拉利	ferrari
fiat	菲亚特	fiat
fidel	菲德尔	fidel
field	场	field
fifa	国际足联	fifa
fifpro	fifpro	fifpro
figo	菲戈	figo
fiji	斐济	fiji
finish	完成	finish
firefox	火狐	(proper noun) mozilla firefox
fischer	菲舍尔	fischer, as in louis fischer
fish	鱼	fish
fishbed	鱼床	fishbed
fitzgerald	菲茨杰拉德	(proper noun) fitzgerald
flanker	侧翼	flanker
fleming	em	fleming
flight	飞行	flight
foch	och	(proper noun) foch
focus	重点	focus
foden	福登	(proper noun) foden, as in tom foden
fokker	福克	fokker
food	食物	food
football	足球	bong da
forbes	福布斯	(proper noun) forbes, as in the magazine
ford	福特汽车	(proper noun) ford
fordham	福特汉姆	(proper noun) fordham
forks	叉子	forks
foundation	基础	foundation
fox	狐狸	fox
fpt	fpt	a company name in vietnam
fracsin	弗拉辛	a function
franc	法郎	franc
france	法国	france
frances	法郎	frances
francis	弗朗西斯	francis, as in francis xavier
francisco	弗朗西斯科	francisco
franco	佛朗哥	franco
frank	坦率的	frank
frankfurt	法兰克福	(proper noun) frankfurt
franklin	富兰克林	franklin
franz	弗朗兹	(proper noun) franz, as in franz ritter
freud	弗洛伊德	(proper noun) freud, as in sigmund freud
friedman	弗里德曼	friedman
fu	fu	fu
fujiko	藤子	fujiko, as in japanese writer fujiko fujio
fujimoto	藤本	fujimoto
fukuoka	福冈	fukuoka
funimation	功能化	(proper noun) funimation
funk	放克	funk
futsal	五人制足球	futsal
fx	外汇	fx
ga	ga	station
gabon	加蓬	gabon
gabriel	加百利	gabriel
gabriella	加布里埃拉	gabriella
gagarin	加加林	gagarin
gaia	盖亚	gaia
gaillard	盖拉德	gaillard
galilei	加利利	galilei
galileo	伽利略	galileo, the astronomer
gam	克	gam
gambia	冈比亚	gambia
gamow	ow	a name
gan	肝	liver
gandhi	甘地	gandhi, as in mahatma gandhi
gang	帮派	cast iron
ganh	嫉妒	to be jealous
gao	高	strictly
gareth	加雷斯	a name
garrett	加勒特	garrett
gary	加里	gary
gascon	加斯康	(proper noun) gascon, a dialect of france
gatt	加特	gatt
gaule	高卢	gaul, a region in ancient western europe
gaulois	高卢瓦	gaulois
gay	同性恋者	tense
gaza	加沙	gaza
gdańsk	格但斯克	(proper noun) gdansk, poland
gdp	国内生产总值	gdp
geisha	艺ish	geisha
gen	基因	gene
gene	基因	(proper noun) gene, an english first name
genesis	成因	(proper noun) genesis
georg	乔治	(proper noun) georg
george	乔治	george
georges	乔治	(proper noun) georges, a french name
gepard	吉帕德	gepard
ger	ger	ger
gerais	吉拉斯州	(proper noun) gerais
gerhard	格哈德	gerhard
german	德文	german
germany	德国	germany
gerrard	杰拉德	gerrard, a last name
ghana	加纳	(proper noun) the african country of ghana
ghe	船	canoe
ghen	嫉妒	to be jealous (v.)
ghi	写	write
ghim	别针	pin
ghé	停止	visit
ghép	嫁接	fit
ghê	恶心的	disgust
ghì	ghì	tighten
ghẻ	ab疮	scabies (n.)
ghế	座位	chair
ghề	急流	scabby
ghềnh	急流	waterfall (n.)
gia	贾	date
giai	舞台	period
giam	被拘留	imprison
gian	空间	"(term should be ""thời gian"") time (n.)"
giang	江	syphilis
gibraltar	gibraltar	(proper noun) gibraltar
gichin	吉钦	gichin
gieo	母猪	sow
gifu	岐阜	gifu, a district in northern japan
ginzan	银山	ginzan
gio	焦	wind
gioi	菊井	world
giuliani	朱利亚尼	giuliani
giun	蠕虫	worm
giuse	use	giuse
giuộc	朱奥克	"entire term should be ""can giuoc""; name of a vietnamese town"
giza	吉萨	giza
già	旧的	old (adj.)
giàn	桁架	"(term should be ""giàn hoa"") a trellis girder"
giành	赢了	secure
giàu	有钱	rich or wealthy (adj.)
giày	鞋子	a shoe
giá	价格	estimate
giám	导演	"(term should be ""giám sát"") to supervise (v.)"
gián	蟑螂	"(term should be ""gián tiếp"") indirectly"
giây	秒	seconds
giã	猛击	"(term should be ""từ giã"") to say farewell to (v.)"
giãn	伸展	stretch
gièm	tract毁者	"(should be ""gièm pha"") to backstab"
giêhôva	吉瓦	jehovah
giêng	工	january
giêsu	耶稣	jesus
giêxu	连结	jesus
giò	春卷	leg
giòi	mag	maggot (n.)
giòn	松脆的	crunchy or crispy (adj.)
gió	风	wind
gióng	喜欢	align
giúp	帮忙	help
giũa	档案	sharpen
giơ	堵塞	raise
giương	扩口	posture
giường	床	bed
giả	假的	fake (adj.)
giải	奖品	solution
giảm	减少	decrease
giản	简化版	"(term should be ""giản dị"") simple (adj.)"
giấc	睡觉	giấc ngủ= the sleep
giấm	醋	drabble
giấu	隐藏	hide
giấy	纸	paper
giầu	有钱	rich
giận	生气	angry
giằng	支撑	pull
giặc	敌人	enemy
giặt	洗涤	to wash (n.)
giếng	井	well
giết	杀死	kill
giềng	邻居	"(term should be ""láng giềng"") neighboring"
giễu	嘲笑	ridicule
giọng	口音	tone
giọt	掉落	drop
giỏ	篮子	basket
giỏi	好	good
giồng	工	mound
giỗ	死亡纪念日	anniversaries of deaths
giới	性别	gender
giờ	小时	bao giờ=ever
giở	快闪	to open or unfold (v.)
giỡn	开玩笑的	joke
giục	督促	urge
giữ	等一下	hold
giữa	介于	between
gladys	林间空地	gladys
glazer	玻璃	glazer
glonass	格洛纳斯	glonass
gloria	荣耀	gloria
gloster	格洛斯特	(proper noun) gloster, as in gloster meteor
glucose	葡萄糖	glucose
gmail	gmail	gmail
gnp	gnp	gnp
go	去	"(term should be ""gay go"") tense"
goes	去	goes
goku	悟空	goku
golden	金色的	golden
gom	收集	to gather (v.)
google	谷歌	google
gorbachev	戈尔巴乔夫	gorbachev
gorbachyov	戈尔巴乔夫	gorbachev, as in former soviet president mikhail gorbachev
gordon	戈登	gordon, as in gordon brown
gore	血腥	gore
gorky	高大的	gorky, as in gorky park
gothic	哥特式	gothic
gottfried	炸了	gottfried
grabeel	抓斗	grabeel, a last name
graham	格雷厄姆	graham
granada	格拉纳达	granada
granit	花岗石	granite
greek	希腊语	(proper noun) greek
greenland	格陵兰岛	greenland
greenson	格林森	(proper noun) greenson
greenwich	格林威治	(proper noun) greenwich
greg	格雷格	greg
grenada	格林纳达	grenada
grenadines	手榴弹	grenadines
gross	总价	gross
grumman	格鲁曼	(proper noun) grumman
gruzia	佐治亚州	gruzia
gryffindor	格兰芬多	gryffindor
gs	s	prof.
gsts	消费税	professor- phd
gu	gu	gu
guam	关关	guam
guard	守卫	guard
guatemala	危地马拉	guatemala
gui	gui	gui
guinea	几内亚	guinea
guinness	健力士	(proper noun) guinness
guitar	结他	guitar
gujarat	古吉拉特邦	gujarat
gulag	古拉格	gulag
gulf	海湾	gulf
gullit	古利特	(proper noun) gullit
gundam	高达	(proper noun) gundam
gunung	古龙	(proper noun) gunung
gustave	古斯塔夫	gustave
gutenberg	古腾堡	gutenberg
guyana	圭亚那	guyana; proper noun
gà	鸡	chicken
gài	uck	to fasten (v.)
gào	尖叫	"(term should be ""thét gào"") to cry out (v.)"
gác	守卫	guard
gái	女孩	girl
gán	分配	"entire phrase should be ""gan nhan""; means ""to label"""
gánh	负担	hold
gáy	颈背	crow
gân	肌腱	tendon
gây	原因	make
gãy	坏了	break
gì	什么	what
gìn	保存	preserve
gò	土堆	"(term should be ""gò má"") cheekbone (n.)"
gòn	ò	gon
góa	寡妇	widowed
góc	角落	angle
gói	包装	goi
góp	分期付款	to contribute
gót	脚跟	heels
gõ	类型	type
göbbels	戈贝斯	gobbels, as in joseph gobbels
găm	ard积	poniard
găng	手套	gloves
gũi	关闭	close
gươm	剑	sword
gương	镜	mirror
gạc	纱布	johnson south reef
gạo	饭	rice
gạt	扯掉	to cheat or trick (v.)
gả	结婚	marry
gảy	采摘	"(term should be ""âm gảy"") a type of phonetic sound found in the japanese language (n.)"
gấc	加克	gac
gấm	锦	brocade
gấp	赶快	times, as in many times
gấu	熊	a bear (n.)
gần	在附近	near
gầy	薄	thin
gẫy	坏了	break
gập	折	"(term should be ""gập ghềnh"") bumpy (adj.)"
gậy	棍棒	stick
gắm	放屁	send
gắn	已安装	mount
gắng	试一试	try
gắt	严厉地	intense
gặm	gna	rodent
gặp	见面	meet
gặt	收割	harvest
gỉ	生锈的	rust
gọi	叫	call
gọn	整洁的	neat (adj.)
gọng	镶边	gong
gọt	削皮	cut
gỏi	色拉	a vietnamese salad
gốc	根	origin (n.)
gối	枕头	"(should be ""qùy gối"") to kneel"
gốm	陶瓷的	pottery
gồm	包括	include
gồng	锣	carry
gỗ	木	wood
gội	洗发水	shampoo
gộp	汇集	aggregate
gớm	可怕的	tremendous
gờ	壁架	edge
gởi	发送	send
gỡ	卸货	meet
gợi	暗示性的	to evoke (v.)
gục	崩溃了	"(term should be ""đánh gục"") crush, as in battle"
gừng	生姜	ginger
gửi	已发送	send
ha	哈	hectare
habana	哈瓦那	(proper noun) habana
habsburg	哈布斯堡	(proper noun) habsburg
haeberle	海伯尔	haeberle
hahn	哈恩	hahn
hai	两个	two (adj.)
hal	哈尔	hal
halle	哈雷	(proper noun) halle
halogen	卤素灯	halogen (n.)
ham	火腿	desire
hamilton	汉密尔顿	(proper noun) hamilton
han	han	han
hang	洞穴	cave
hangul	韩文	hangul
hanh	h	hanh
hanja	忍者	(proper noun) hanja, a type of chinese script
hansen	汉森	hasnen
hao	hao	"(term should be ""hao hụt"") to incur some loss (v.)"
harald	哈拉尔德	harald
hardy	强壮的	hardy
harlem	哈林区	harlem
harlow	哈洛	harlow
harold	哈罗德	(proper noun) harold
harper	哈珀	harper
harpercollins	哈珀科林斯	hapercollins
harrier	har	harrier, as in harrier jump jet
harris	哈里斯	harris
harry	哈里	harry
harvard	哈佛大学	(proper noun) harvard, the name of a college
harvey	哈维	harvey
havana	哈瓦那	(proper noun) havana, cuba
havilland	哈维兰	havilland
hawker	小贩	hawker
hawking	叫卖	(proper noun) hawking, as in physicist stephen hawking
hay	好	or
hb	血红蛋白	hb
hbv	乙肝病毒	hbv
hcl	盐酸	hcl
hd	高清	activity
he	嘿嘿	he, a korean name
health	健康状况	health
heath	荒地	heath
hee	嘻	hee
hegel	黑格尔	(proper noun) hegel, as in georg wilhelm friedrich hegel
heian	平安	heian
heinrich	海因里希	heinrich
helen	海伦	helen
helena	海伦娜	helena
heli	氦气	helium
hematocrit	血细胞比容	hematocrit
hemoglobin	血红蛋白	hemoglobin
hen	母鸡	asthma
henry	亨利	(proper noun) henry, as in henry kissinger
heo	猪	dolphin
her	她的	her
herbert	赫伯特	herbert, as in herbert schandler
hercegovina	黑塞哥维那	hercegovina
hercules	大力神	hercules
hermann	赫尔曼	hermann
hermes	爱马仕	hermes
hersh	赫什	hersh, as in seymour hersh
hesiod	hesiod	hesiod
hestia	赫斯提亚	hestia
hi	你好	"(term should be ""hi vọng"") alternative spelling for ""hy vọng""; meaning ""hope"" (n.)"
hickam	希卡姆	(proper noun) hickam
hicks	希克斯	hicks
hideto	秀人	(proper noun) hideto
hideyoshi	秀吉	(proper noun) hideyoshi
hidro	氢	hydrogen
hillsborough	希尔斯伯勒	hillsborough
hilton	希尔顿	hilton
himalaya	喜马拉雅山	(proper noun) himalaya
hinata	日向	hinata
hindenburg	兴登堡	(proper noun) hindenburg
hindi	印地语	hindi
hindu	印度教	hindu, as in the hindu religion
hinh	欣	(proper noun) a vietnamese first name
hinhtron	欣创	circle
hiragana	平假名	hiragana
hiroshi	广史	hiroshi
hiroshima	广岛	(proper noun) hiroshima, the japanese city
hitchcock	希克科克	hitchcock
hitler	希特勒	hitler
hitter	打手	hitter
hitters	击球手	hitters
hiên	门廊	(proper noun) hiên, a vietnamese first name
hiđrô	氢	hydrogen
hiếm	难得的	rare
hiến	给	devote
hiếp	强奸	rape
hiếu	孝顺	pious
hiềm	生病了	grudge
hiền	鼠尾草	sage
hiểm	危险的	dangerous
hiểu	明白	learn
hiện	出现	"(term should be ""thực hiện"") to accomplish"
hiệp	一半	united
hiệu	效果	effective
hlv	教练	trainer
hms	hms	hms
hmông	苗族	hmong
hn	hn	hn
hoa	花	flower
hoan	节庆	welcome
hogwarts	霍格沃茨	(proper noun) hogwarts, sorcery school from the harry potter series
hoi	i	rare
hokage	招呼	hokage
hokusai	北斋	hokusai
holmes	福尔摩斯	a name
holocaust	大屠杀	holocause
holocen	全新	holocen
holt	lt	holt, an english last name
hom	插	a cutting
homer	荷马	(proper noun) homer, the authorof the iliad and the odyssey
hon	hon	"(term should be ""hòn"") rock (n.)"
honduras	洪都拉斯	honduras
hong	红	hong
honolulu	火奴鲁鲁	honolulu
honshū	本顺	honshu
hopkins	霍普金斯	(proper noun) hopkins
hornet	大黄蜂	hornet
hotspur	热刺	(proper noun) hotspur, as in tottenham hotspur
houston	休斯顿	(proper noun) houston, as in whitney houston
howard	霍华德	(proper noun) howard
however	但是	however
hoà	领带	peace
hoài	怀旧的	always (adv.)
hoàn	完成	"(term should be ""hoàn toàn"") completely"
hoàng	皇家的	royal (adj.)
hoành	膜片	rife
hoá	化学	"(term should be ""văn hoá"") culture (n.)"
hoán	烫发	refined (adj.)
hoãn	推迟	delay
hoạ	油漆	disaster (tham hoa)
hoại	坏疽	"(term should be ""phá hoại"") to sabotage (v.)"
hoạt	无尽的	work
hoả	火	of
hoảng	恐慌	panic-stricken (adj.)
hoặc	或	or
hp	马力	hp
hq	总部	hq
hudgens	udge	(proper noun) hudgens
hudson	哈德森	hudson
huey	休伊	huey
hughes	拥抱	hughes
hugo	雨果	(proper noun) hugo
hume	休ume	hume, as in david hume
hun	hun	(proper noun) hun
hungary	匈牙利的	hungary
hunt	狩猎	hunt
hurley	赫利	(proper noun) hurley, as in chad hurley
hussein	侯赛因	hussein
husserl	胡塞尔	huserl
huston	休斯顿	huston
hutech	高科技	hutech
huy	hu	a common vietnamese first name
huynh	兄弟	older brother
huyền	神秘的	huyền thoại= legend
huyễn	虚幻的	huyen
huyện	区	district
huyệt	穴位	lair
huân	uan	"(term should be ""huân chương"") medal (n.)"
huê	色相	"a less common vietnamese word for ""flower"""
huấn	训练	"(term should be ""huận luyện"") to train (v.)"
huế	色相	hue
huệ	色相	favour
huống	案子	situation
huỳnh	硫磺	sulfur
huỷ	取消	destroy
hydra	九头蛇	hydra, a monster in greek mythology
hydro	氢	hydrogen
hyperion	超离子	hyperion
hà	哈	"(term should be ""hà nội"") the capital of vietnam"
hài	喜剧片	corpse
hàm	机能	"(term should be ""bao hàm"") to imply (v.)"
hàng	商品	row
hào	护城河	depreciation
hách	霸道	glorious
hái	采摘	picking
hán	干旱	china
háo	渴望	eager
hát	唱歌	song
hâm	疯了	"(term should be ""hâm mộ"") to admire (v.)"
hân	满意	le ngoc han
hãi	害怕	to be scared (v.)
hãn	可汗	to sweat (v.)
hãng	坚定的	a company (n.)
hãnh	骄傲的	proud
hè	夏天	summer
hé	破解	reveal
héo	枯萎	dried-out
hét	大喊	shout
hên	幸运的	luck
hí	剧院	game
hít	吸气	act of kissing (hon hit)
hò	约会	date
hòa	领带	republic
hòe	狗屎	hoe
hòm	方舟	box
hòn	岛	island
hòng	好吧	in order to
hóc	ó	a corner (n.)
hót	唱歌	to chirp or sing (v.)
hô	珊瑚	respiration
hôi	犯规	stink
hôm	日	day (n.)
hôn	接吻	propose
hông	臀部	hip
hù	吓e	threaten
hùng	英雄	hero
húc	对接	huc
húng	罗勒	"(should be ""húng láng"") water mint"
hút	抽烟	to suck (v.)
hăng	辛辣的	enthusiasm
hđbt	đ	hdbt
hđh	đ	system software
hũ	罐子	jar
hơi	略	slightly
hơn	更多	more or less
hư	顽皮的	fictional
hưu	退休的	huu
hương	香	smell
hước	幽默的	humor
hướng	方向	trend
hường	香	huong
hưởng	享受	influence
hạ	降低	lower
hạc	吊车	crane
hạch	神经节	ganglion
hại	伤害	harm
hạng	等级	rank
hạnh	汉	happy
hạo	o	hao
hạp	百合	hap
hạt	珠子	seed
hải	习俗	two
hảo	完美的	perfect
hấn	侵略	aggressive gesture
hất	猛扑	toss
hấu	西瓜	"(term should be ""dưa hấu"") watermelon"
hầm	炖	ham
hầu	差不多	most
hận	讨厌	hatred
hậu	天气	anus
hắc	黑暗的	black
hắn	他	he (n.)
hắt	打喷嚏	reject
hằng	不变的	every
hặc	ặ	to criticize (v.)
hẹ	葱	chinese chives
hẹp	狭窄的	narrow
hẻm	胡同	alley (n.)
hẻo	僻静的	outback
hến	贻贝	mussel
hết	超过	most
hề	小丑	"(term should be ""không hề"") never"
hễ	eh	whenever
hệ	系统	relation
hệt	相同的	exactly
hỉ	i	happy
hịch	ud	a proclamation
họ	他们	they (n.)
họa	艺术	picture
họach	计划	"(term should be ""quy hoạch"") a project (n.)"
học	学习	study (v.)
họng	喉咙	throat
họp	会面	meet
hỏa	火	fire
hỏng	坏了	corruption
hố	坑	hole
hốc	壁	cavity
hồ	湖	ho
hồi	茴香	muslim
hồn	灵魂	soul
hổ	虎	tiger
hổi	海	"(term should be ""nóng hổi"") steaming hot (adj.)"
hổng	张开	hole
hỗ	支持	"(should be ""hỗ trợ"") to support or assist"
hỗn	混合的	"(term should be ""hỗn tạp"") mish-mash (adj.)"
hội	组装方式	society
hộp	盒子	box
hới	开	hoi
hớn	大喊	"(term should be ""hớn hở"") radiant (adj.)"
hờn	闷闷不乐	hatred
hở	开	reveal
hỡi	大井	dear
hợi	猪	pig (n.)
hợp	适合的	appropriate
hợpquận	同意书	general district
hụt	错过了	loss
hủi	麻风病人	reject
hủy	取消	to erase or destroy
hứa	答应	promise
hử	余量	hu
hửu	占有	"(term should be ""sở hửu"") to own (v.)"
hữu	财产	(proper noun) hữu, a vietnamese middle name; also means right, as in the direction
hựu	u	again
hỷ	海兰	hy
ian	ian	ian, as in australian swimmer ian thorpe
iau	au	iau
iberia	伊比利亚	iberia
ibm	ibm	(proper noun) ibm, the computer company
ibmpc	ibmpc	ibm-pc
ic	集成电路	ic
icc	集成电路	icc
iceland	冰岛	(proper noun) the country of iceland
ide	ide	ide
ieng	eng	(proper noun) ieng
igor	伊戈尔	igor
iii	iii	third
ilene	伊莱恩	ilence
illusion	幻觉	illusion
ilyich	伊里奇	ilyich
im	即时通讯	still
imam	阿am	(proper noun) imam
imbrium	br	imbriun
immanuel	伊曼纽尔	(proper noun) immanuel, as in immanuel kant
impact	影响	impact
incoterm	贸易术语	incoterm
incoterms	国际贸易术语	(proper noun) incoterms
indian	印度人	indian
indiana	印第安纳州	indiana
indochina	印度支那	indochina
indonesia	印尼	indonesia
indrapura	indrapura	(proper noun) indrapura
info	资讯	info
innsbruck	因斯布鲁克	innsbruck
insulin	胰岛素	insulin
int	整型	int
intel	英特尔	(proper noun) intel, as in the name of the company
interpol	刑警	interpol
inu	犬	(proper noun) inu
inuyasha	犬夜叉	inuyasha
inư	犬	(proper noun) inư
io	io	io
ioc	国际奥委会	ioc
ion	离子	ion
iosif	iosif	(proper noun) iosif, as in iosif vissarionovich stalin
iran	伊朗	the nation of iran
iraq	伊拉克	iraq
ireland	爱尔兰	ireland
irgun	伊尔贡	irgun
irony	讽刺的	irony
irving	生气	(proper noun) irving
isaac	艾萨克	isaac
isla	岛	isla
islam	伊斯兰教	islam
islamabad	伊斯兰堡	(proper noun) islamabad
israeli	以色列	israeli
istanbul	伊斯坦布尔	istabbul
italia	意大利	italy
italiano	italiano	(proper noun) italiano
itanium	钛	itanium, as in windows xp itanium
ito	伊藤	ito
itsukushima	严岛	itsukushima
itu	itu	itu
itzá	伊扎	(proper noun) itzá
iv	iv	4 ( greek number)
iwami	岩见	iwami
j	ĵ	j
jack	杰克	jack
jackie	杰基	(proper noun) jackie chan
jackson	杰克逊	(proper noun) jackson, as in michael jackson
jacob	雅各布	jacob
jae	宰	jae
jakarta	雅加达	(proper noun) jakarta
jan	简	(proper noun) jan
janeiro	耶内罗	janeiro
janet	珍妮特	janet
japan	日本	japan
jared	震撼	jared
jarvis	贾维斯	(proper noun) jarvis, as in jarvis cocker
jasper	碧玉	(proper noun) jasper
jean	吉恩	jean
jeane	简	jeane
jeanjacques	让雅克	jean-jacques
jeanpaul	让保	jeanpaul
jeans	牛仔裤	jeans
jeet	je	(proper noun) jeet, as in jeet kune do
jeff	杰夫	jeff, as in jeff drake
jefferson	杰斐逊	jefferson
jeffrey	杰弗里	jeffrey
jeju	济州	jeju
jenda	珍达	jenda
jenny	珍妮	jenny
jericho	耶利哥	jericho, as in wrestler chris jericho
jerome	杰罗姆	jerome, as in fred jerome
jerry	杰瑞	(proper noun) jerry
jersey	球衣	jersey
jerusalem	耶路撒冷	jerusalem
jesse	杰西	a name
jesus	耶稣	chua jesus
jetstar	捷星	jetstar
jewish	犹太人的	jewish
jiao	iao	jiao
jimmy	吉米	jimmy
jin	金	jin
jing	jing	jing
jiraiya	吉来耶	(proper noun) jiraiya
joachim	约阿希姆	joachin
joan	琼	a name
joe	乔	(proper noun) joe
johan	约翰	johan
johann	约翰	johann
johannes	约翰尼斯	johannes
johannesburg	约翰内斯堡	(proper noun) johannesburg, south africa
johnny	强尼	johnny
johns	约翰斯	johns
johnston	约翰斯顿	johnston, as in harry johnston
johor	柔佛州	johor
joint	联合	joint
jonathan	乔纳森	(proper noun) jonathan
jones	琼斯	jones
jose	乔瑟	(proper noun) jose, a spanish first name
joseon	朝鲜	(proper noun) joseon
joseph	约瑟夫	joseph
jscript	脚本	(proper noun) jscript
juche	主体	(proper noun) juche
judith	朱迪思	judith
judo	柔道	judo, the martial art
julesverne	朱尔斯韦恩	jules verne
julliard	蜥蜴	(proper noun) julliard
jump	跳	jump
june	六月	june, as in the month
jung	荣	jung
junsu	俊素	junsu
jupiter	木星	(proper noun) jupiter, as in the planet
jura	朱拉	(proper noun) jura
juventus	尤文图斯	juventus
k	ķ	k
kaede	枫	a japanese name
kaffee	卡菲	(proper noun) kaffee, as in kaffee hag
kagome	鹿儿	kagome, as in higurashi kagome
kahn	卡恩	kahn
kai	kai	kai
kakashi	卡卡西	kakashi
kaká	卡卡	(proper noun) kaka, a brazilian soccer player
kalashnikov	卡拉什尼科夫	(proper noun) kalashnikov
kali	钾盐	potassium
kama	卡马	(proper noun) kama, as in the kama sutra
kamakura	镰仓	kamakura
kamov	卡莫夫	kamov
kampf	坎普夫	kampf
kampong	甘榜	kampong
kampuchea	甘榜	cambodian
kana	假名	kana, the japanese phonetic alphabet
kangin	坎金	(proper noun) kangin
kanji	汉字	kanji
kant	康德	a name
kar	kar	(proper noun) kar
kara	卡拉	kara
karaoke	卡拉ok	karaoke
karate	空手道	karate
karatedo	空手道	karatedo
karen	卡伦	(proper noun) karen
karim	卡里姆	(proper noun) karim
kashmir	克什米尔	kashmir
kaspersky	卡巴斯基	(proper noun) kaspersky, as in kaspersky anti-virus software
katakana	片假名	katakana, a type of japanese script
kate	凯特	(proper noun) kate, as in actress kate winslet
katherine	凯瑟琳	katherine
kathmandu	加德满都	kathmandu
katrina	卡特里娜	(proper noun) katrina, as in hurricane katrina
katz	卡兹	katz
kauthara	卡托拉	kauthara, a part of the ancient kingdom of champa
kavkaz	高加索	kavkaz
kawasaki	川崎	(proper noun) kawasaki
kay	y	kay
kazan	喀山	kazan, the name of a city
kcn	kcn	industrial zone
ke	ke	"(term should be ""boong ke"") a bunker (n.)"
kelly	凯莉	kelly
kelsi	凯尔西	kelsi
kelvin	开尔文	kelvin
kem	冰淇淋	ice cream (n.)
ken	ken	ken
kennedy	肯尼迪	(proper noun) kennedy, as in john f. kennedy
kenneth	肯尼斯	(proper noun) kenneth, a name
kenny	肯尼	kenny, an english first name
kentucky	肯塔基州	(proper noun) kentucky
kepler	开普勒	kepler
kerala	喀拉拉邦	(proper noun) kerala
kevin	凯文	kenvin
keynes	凯恩斯	keynes, as in economist john maynard keynes
kg	公斤	kilogram
kha	卡	(proper noun) a vietnamese first name
khai	声明书	announce
khali	哈利	(proper noun) khali
khalip	哈立普	(proper noun) khalip
kham	康	endure
khan	无水的	rare
khang	hang	khang
khanh	han	khanh
khao	向往	desire
khay	托盘	tray
khe	插槽	chink
khem	khem	abstinence
khen	称赞	praise
kheo	高跷	kheo
khi	什么时候	when
khieu	hi	(proper noun) khieu, as in khieu samphan
khiêm	谦虚	khiem
khiên	盾牌	a shield
khiêu	好色之徒	"('khiêu dâm"") pornographic"
khiếm	受损的	lack
khiến	原因	control
khiếp	吓坏了	horrible
khiếu	寄宿	talent (n.)
khiển	控制	control
khleang	le	kh'leang
kho	仓库	warehouse
khoa	师资	"(term should be ""y khoa"") the study of medicine (n.)"
khoan	钻	drill
khoang	腔	brag
khoanh	响了	a slice (n.)
khoe	炫耀	to boast
khoá	锁	lock
khoác	大衣	coat
khoán	存货	stock
khoáng	矿物质	mineral
khoát	确定的	decisive
khoét	切	carve
khoăn	苦恼	disturbed
khoả	裸体的	naked
khoản	项	an item (n.)
khoảng	大约	about
khoảnh	片刻	moment
khoẻ	很好	health
khrushchev	赫鲁晓夫	khrushchev
khrushchyov	赫鲁乔夫	khrushchyov
khu	宿舍	section
khung	框架	frame
khural	胡拉尔	khural
khuynh	向左	trend
khuyên	忠告	advise
khuyết	有缺陷的	lack
khuyển	狗	khuyen
khuất	隐藏的	hidden
khuấy	搅动	stir
khuẩn	细菌	bacteria
khuếch	放大	amplification
khuỷu	肘部	elbow
khá	漂亮的	quite
khác	其他	different
khách	来宾	customer
khái	概念的	concept
khám	考试	discover
khán	听众	audience
kháng	抵抗	appeal
khánh	独立性	a type of chime made of stone (n.)
khát	口渴	to be thirsty for (adj.)
khâm	卡姆	admire
khèn	las	a pan-pipe (n.)
khéo	巧妙的	cleverly or skillfully (adv.)
khép	封闭的	close
khía	缺口	"(term should be ""khía cạnh"") angle (n.)"
khích	鼓励	encourage
khít	紧	close
khó	辛苦	difficulty
khóa	锁	a session
khóc	哭	cry
khói	烟	smoke
khóm	凤梨	a cluster
khô	干	dry
khôn	明智的	clever, intelligent
không	没有啦	not
khúc	歌	song
khăm	恶作剧	nasty (adj.)
khăn	毛巾	difficult
khơi	离岸	sea
khư	ư	grip
khưu	ư	khuu
khước	否认	waive
khả	可能性	"(term should be ""khả năng"") ability (n.)"
khải	启示录	triumph
khảm	马赛克	to encrust
khảo	考试	"(term should be ""tham khảo"") to consult (v.)"
khấm	刺穿	endure
khấn	祈祷	pray
khấu	打折	"(term should be ""sân khấu"") a stage (n.)"
khẩn	紧急的	"(term should be ""khẩn cấp"") urgent (adj.)"
khắc	雕刻	moment
khắp	到处	all over
khẳng	肯定的	"(term should be ""khẳng định"") to assert (v.)"
khế	杨桃	bond
khỉ	猴子	monkey or ape (n.)
khỏa	裸体的	nude
khỏe	很好	health
khỏi	出于	leave
khố	缠腰布	loincloths
khốc	可怕的	devastating
khối	挡	a block or mass of (n.)
khốn	混蛋	miserable
khống	孔	control
khổ	受苦	miserable (adj.)
khổng	巨人	huge
khởi	发起人	start
khủng	糟透了	"(term should be ""khủng bố"") terrorist (n.)"
khủyu	混蛋	elbow
khứu	粉彩	olfactory
khử	消除	reduction
ki	ki	"entire phrase is ""ki lo""; means ""kilometer"""
kia	在那里	other
kid	小子	kid
kiel	基尔	(proper noun) kiel
kierkegaard	基尔凯郭尔	kierkegaard, as in soren kierkegaard
kiernan	基尔南	kiernan
kii	ii	kii
kikyo	奇京	kikyo
kilômét	公里	kilometer
kim	针	kim
kingdom	王国	kingdom
kinsey	金西	kisney
kiribati	基里巴斯	kiribati
kishimoto	岸本	(proper noun) kishimoto
kiss	接吻	kiss
kissinger	接吻者	kissinger
kitts	小猫	kitts
kitô	基督	christian
kiêm	兼	cum
kiên	耐心的	consistent
kiêng	弃权	abstinence, as in abstaining from eating
kiêu	傲慢自大	showy
kiếp	一生	a lifetime (n.)
kiết	ế	cheap (adj.)
kiềm	碱性的	"(term should be ""kiềm chế"") to restrain (v.)"
kiểm	检查	control
kiểu	类型	type
kiệm	经济的	save
kiện	苏	event (su kien)
kiệt	杰作	exhausted (adv.)
kiệu	轿子	scallion
klaus	克劳斯	klaus
klein	克莱因	klein
km	公里	kilometer
knesset	以色列议会	knesset
knuth	克努斯	knuth, as in donald knuth
koch	科赫	koch
kodansha	讲谈社	kodansha
kofun	科芬	kofun, as in the kofun period of japanese history
kogoro	小五郎	kogoro
komodo	科莫多	komodo
kon	kon	"(term should be ""kon tum"") a province in the highlands of vietnam"
kong	孔	(proper noun) kong, as in hong kong
konstantin	康斯坦丁	(proper noun) konstantin
konversationslexikon	知识分子	konversation-lexikon
kop	op	kop
koran	古兰经	koran
kornai	科尔奈	(proper noun) kornai, as in janos kornai
koruna	科鲁纳	koruna
kosovo	科索沃	(proper noun) kosovo
kremli	克里姆利	kremil
kremlin	克里姆林宫	kremlin
kristen	克里斯汀	kristen
krông	rong	krong
ku	ku	is a name
kuala	瓜拉	(proper noun) kuala, as in kuala lumpur
kubrick	库布里克	kubrick
kuen	en	kuen
kuiper	库珀	(proper noun) kuiper, as in the kuiper belt
kulak	库拉克	kulak
kune	坤	(proper noun) kune, as in the martial art jeet kune do
kung	功	danh vo
kungfu	功夫	kung fu
kunst	昆斯特	kunst, as in richard kunst
kurd	库德	kurd
kurt	库尔特	(proper noun) kurt
kuwait	科威特	kuwait, the country (n.)
kwan	关	kwan
kwen	wen	kwen
kwon	权	kwon, as in tae kwon do; proper noun
kyrgyzstan	kyrinkistan	(proper noun) the country of kyrgyzstan
kyushu	九州	kyushu
kyūshū	九州	kyushu, a japanese island
kèm	封闭的	included
kèn	小号	horn
kém	可怜的	less
kén	茧	selective
kéo	拉	scissors
kép	双重的	dual
két	安全的	"(term should be ""rốc két"") rocket (n.)"
kê	小米	statistics
kênh	频道	channel
kêu	哭了	appeal
kìa	看哪	that
kìm	钳子	bar
kình	眼镜	rivalry
kí	标志	sign
kích	点击	excite
kíchbom	点击按钮	bombers
kín	私人的	secretive or closed tight (adj.)
kính	玻璃杯	respect
kíp	船员	esoterica
kít	套件	wheelbarrow
ký	签名的	"(""nhật ký"") a diary"
kĩ	小心地	technique
kơnia	卡亚	a tree found in southeast asia; sometimes called wild mango
kạn	菅直人	kan
kẹo	糖果	candy
kẹp	夹钳	to clamp down (v.)
kẹt	卡住	jam
kẻ	伙计们	guy
kẻo	唯恐	lest
kẽ	插页式	crevice
kẽm	锌	zinc
kế	下一个	a scheme (n.)
kết	结束	combine
kề	邻近的	adjacent
kềnh	笨重的	bulky
kệ	货架	ignore
kỉ	世纪	"(term should be ""kỉ niệm"") souvenir (n.)"
kị	骑兵	ki
kịp	及时地	kip
kỵ	骑兵	taboo
kỷ	世纪	"(term should be ""thế kỷ"") century (n.)"
l	升	l.
label	标签	label
laboulaye	拉布拉耶	a name
ladakh	拉达克	(proper noun) ladakh
lai	杂种	"(term should be ""tương lai"") the future (n.)"
lam	lam	lam
lama	喇嘛	a name
lan	lan	a name
land	土地	land
landon	兰登	a name
lang	郎	lang
langdon	兰登	langdon
lange	兰格	lange, as in oscar lange
langue	朗格	langue
lanh	亚麻布	ringing
lanka	兰卡	(proper noun) lanka, as in the island of sri lanka
lao	结核病	labor
laos	老挝	(proper noun) laos
lap	圈数	greek
larry	拉里	larry
lars	拉尔斯	lars
las	拉斯	(proper noun) las, as in las vegas
laser	雷射	laser
lateran	拉特兰	lateran
latinh	拉丁文	latin
latvia	拉脱维亚	(proper noun) latvia
lau	擦	lau
laura	劳拉	(proper noun) laura, as in laura bush
laurence	劳伦斯	(proper noun) laurence
lawrence	劳伦斯	(proper noun) lawrence
lay	躺下	lay
lazarus	拉扎鲁斯	(proper noun) lazarus
leach	浸出	(proper noun) leach
leaf	叶	leaf
leave	离开	leave
lebanon	黎巴嫩	(proper noun) lebanon
lee	李	lee
legacy	遗留物	legacy
leiden	莱顿	leiden
lem	莱姆	cinderella
lenin	列宁	lenin
lenins	列宁	lenin's
leo	爬上	climb
leon	里昂	leon
leonard	伦纳德	leonard
leonardo	莱昂纳多	(proper noun) leonardo, as in leonardo da vinci
leonid	狮子座	leonid
les	莱斯	les
leslie	莱斯利	a name
lesotho	莱索托	lesotho
lg	lg	lg
lhp	升力	film festival
lhq	h	un
libby	利比	(proper noun) libby
libero	利比罗	libero
libya	利比亚	libya
lido	丽都	lido
liechtenstein	列支敦士登	liechtenstein
liga	西甲	a name
lightning	雷电	lightning
lilly	礼来公司	(proper noun) lilly
linga	林加	linga
linh	林氏	efficacious (adj.)
links	连结	links
linux	linux	linux server
lionel	里奥内尔	lionel
lisboa	里斯本	lisboa
lisbon	里斯本	a name
litva	立陶宛	(proper noun) lithuania
liu	u	liu
liêm	廉正	good example
liên	冒险	relate
liêng	神圣的	sacred
liêu	官僚主义	bureaucracy
liềm	镰刀	sickle
liều	剂量	daring
liễu	柳树	a willow tree (n.)
liệng	折腾	"(term should be ""cánh liệng"") the aileron of a plane (n.)"
liệt	麻痹	impotent
liệu	生的	document
lleyton	莱顿	lleyton
lo	忧	to worry (v.)
loa	讲者	"(term should be ""cổ loa"") an ancient vietnamese city (proper noun)"
loaita	洛阿塔	loaita
loang	圆滑的	patchy
loch	尼斯湖	loch
locke	洛克	(proper noun) locke, as in philosopher john locke
lockheed	洛克希德	(proper noun) lockheed, as in lockheed martin
log	日志	log
logan	洛根	a name
lon	罐头	lon
london	伦敦	london
long	长	dragon
lorenzo	劳伦佐	lorenzo
los	洛斯	los, as in los angeles
louis	路易斯	louis
louisiana	路易斯安那州	(proper noun) the state of louisiana
louvre	百叶窗	(proper noun) louvre
love	爱	yeu
loài	种类	species
loát	浮华的	overturn
loãng	薄	wishy-washy
loét	溃疡	gaping, as in a wound
loại	类型	type
loạianh	类型	not a word
loạianime	动漫类型	type anime
loạibệnh	疾病类型	disease
loạichiến	类型	loaichien
loạicác	类型	item
loạicâu	类型	type: club
loạicông	类型	type: industry
loạicựu	类型	kind former
loạigia	类型	loaigia
loạihuân	善欢	not a word
loạiluật	法律类型	type: law
loạimáy	机器类型	kind plane
loạimôn	类型	type
loạingày	输入这个	loaingay
loạiphim	电影类型	type movie
loạiphong	类型	kind of movement
loạiscandal	类型	scandal type
loạithuật	法律类型	type: lexicon
loạithành	类型	kinds of payment
loạithần	类型	kind myth
loạitrường	学校类型	type of school
loạitín	亲切的	type: belief
loạitổ	类型	kind organization
loạivõ	类型类型	type: martial art
loạixã	类型	kind of society
loạn	无序	disorderly
loạt	系列	series
lp	lp	lp
lu	鲁	dim
luang	ang	a name
lucas	卢卡斯	(proper noun) lucas
lucia	露西亚	lucia, as in the island of saint lucia
luciano	卢西亚诺	luciano
ludendorff	吕登道夫	luđenorff
ludovico	卢多维科	ludovico
ludwig	路德维希	ludwig
lui	回去	withdrawal
luis	路易斯	(proper noun) luis, a first name
luiz	路易斯	luiz
lula	露拉	lula
lung	肺	shake
lustig	卢斯蒂格	lusig
luther	路德	luther
luxembourg	卢森堡	a name
luy	y	luy
luyến	依恋	love
luyện	练习	training
luận	留言	"(term should be ""xã luận"") an editorial"
luật	法律	law
luồn	螺纹的	wriggle
luồng	流	lane
luộc	煮的	boiled
luỹ	累积的	rampart (n.)
ly	ly	divorce
lydia	莉迪亚	lydia
lympho	淋巴瘤	lymphocyte
lyndon	林登	lyndon
lyon	里昂	lyon
là	是	the verb to be
làm	做	make
làn	车道	wave
làng	村落	village
lành	ed愈	protestant
lào	老挝	laos
lá	叶	"(term should be ""lá thư"") a letter (n.)"
lác	斜视	brag
lách	脾脏	to swerve (v.)
lái	开车	to drive (v.)
lán	棚屋	shack
láng	顺利	neighbours
lâm	林	lâm, a common vietnamese first name
lân	独角兽	nearby
lâu	长	long time
lây	传染性的	to infect
lãi	利息	a profit
lãm	表演	exhibition
lãnh	已收到	to receive
lão	旧的	old
lèo	è	"(term should be ""nước lèo"") broth (n.)"
lén	偷偷摸摸	sneak
lê	梨子	le
lêmạc	轻的	"(term should be ""lê-mạc"") a war between two ruling families in ancient vietnamese history"
lên	上	on
lênh	命令	"(should be ""lênh đênh"") adrift"
lênin	列宁	lenin
lìa	离开	to leave (v.)
lình	突然间	suddenly
lí	贮藏	reason
lính	军人	soldier
lít	升	litre
líu	咕	"(term should be ""dính líu"") to have a connection with"
lò	炉子	release
lòng	暗恋	heart
lóc	蛇头	cry
lóe	闪现	flash
lóng	语	"entire term should be ""tieng long""; means ""slang"""
lót	衬里	undies
lô	很多	batch
lôi	错误	encourage
lôn	哈哈	"(term should be ""côn lôn"") a village in vietnam"
lông	皮毛	hair
lõi	核心	core
lõm	凹的	concave
lùi	后退	back
lùn	矮人	dwarf
lùng	狩猎	hunt
lúa	饭	rice
lúc	在	at the moment
lún	沉陷	subside
lúng	耀斑	confused
lúp	放大	uneven
lút	偷偷摸摸的	surreptitiously
lăm	五	tens
lăn	滚动	attack
lăng	陵墓	tomb
lĩnh	域	"(term should be ""thủ lĩnh"") the leader (n.)"
lũ	洪水	a band or gang (n.)
lũng	山谷	valley
lũy	累积的	rampart
lơ	忽视	to ignore
lơi	放松	"(term should be ""lả lơi"") to act in a familiar or flirting manner (adv.)"
lư	香炉	an urn
lưng	回去	back
lươn	鳗鱼	eel
lương	薪水	conscience
lưới	格线	a net (n.)
lướt	冲浪	ski
lười	懒惰的	lazy
lưỡi	舌头	tongue
lưỡng	双性恋	"(term should be ""lưỡng tính"") bisexual"
lược	梳子	invasion
lượm	拿起	pick up
lượn	滑行	to glide over (v.)
lǐ	ǐ	(proper noun) li, as in jet li
lạ	奇怪的	strange or unusual (adj.)
lạc	迷路了	camel
lạch	小河	"(term should be ""luồng lạch"") a narrow water passageway"
lại	再来一次	reversed
lạn	烂	bright
lạng	郎郎	lang
lạp	香肠	"(term should be ""hy lạp"") greek"
lạtma	南丫岛	lama
lạy	strate	kowtow
lấn	侵占	to encroach on (v.)
lấp	填满	sparkle
lấy	已采取	taken
lầm	错的	wrong
lần	次	time
lầu	地板	a story or level of a building (n.)
lầy	沼泽的	swamp
lẩu	火锅	hotpot
lẩy	跳	get
lẫn	困惑的	each other
lẫy	捏	illustrious
lận	作弊	fraudulent
lật	翻转	turn
lậy	哦耶	"(term should be ""cai lậy"") the name of a rural district"
lắc	摇	to shake (v.)
lắm	非常	do
lắng	安顿下来	"(should be ""lo lắ́́ng"") to worry"
lắp	合身	lap
lặng	无声的	quiet
lặp	重复	repeat
lặt	杂项	means miscellaneous, part of the word lat vat
lẹ	快	quickly (adv.)
lẻ	奇怪的	"(the term should be ""bán lẻ"") retail"
lẻn	偷偷摸摸	sneak
lẻo	松懈	climb
lề	保证金	alignment
lều	帐篷	tent
lễ	典礼	ceremony
lệ	率	"(term should be ""tỷ lệ"") probability (n.)"
lệch	歪斜	difference
lệnh	命令	command
lị	痢疾	"(term should be ""tỉnh lị"") a township (n.)"
lịch	日历	history
lọc	过滤器	tricked
lọi	斜视	brilliant
lọng	阳伞	rope
lọt	跌倒	enter
lỏi	皮棉	to enter
lỏng	松散的	loose
lố	超过	ridiculous
lốc	旋风	tornado
lối	入口	way or path
lốp	轮胎	tyre
lốt	伪装	lolot
lồ	巨人	giant
lồi	凸的	convex
lồng	笼子	cage
lỗ	洞	hole
lộc	财富	loc
lội	涉水	wade
lộn	翻转	wrong/mistake
lộng	华丽的	"(term should be ""cổ lộng"") the name of a vietnamese city"
lột	剥皮	exploit
lớn	大的	large
lớp	类	grade (n.)
lờ	忽略	turbid
lời	字	advice
lở	疮	to crack
lỡ	想念	miss
lợi	好处	benefit
lợn	猪	pig
lợp	屋面	roof
lụa	真丝	silk
lục	绿色的	record
lụi	被烧毁	ruin
lụt	洪水	flood
lụy	含意	consequence
lứa	垃圾	peer
lừa	把戏	mislead
lừng	杰出的	well-known
lửng	夹层	lơ lửng= not clear/ something in between
lự	犹豫不决	reluctant
lựa	已选	chosen
lựu	石榴	grenade
ma	幽灵	ma sat (friction), ma thuat (magic), thay ma (zombie)
maastricht	马斯特里赫特	maastricht
macarthur	麦克阿瑟	macarthur
macclesfield	麦克尔斯菲尔德	macclesfield
macedonia	马其顿	(proper noun) macedonia
mach	马赫	mach
machiavelli	machiavelli	machiavelli, as in philosopher niccolo machiavelli
machu	马丘	machu
macintosh	麦金托什	macintosh
macma	岩浆	magma
macromedia	宏媒体	macromedia
madeira	马德拉	madeira
madhouse	疯人院	madhouse
madison	麦迪逊	madison
madonna	麦当娜	(proper noun) madonna
madrid	马德里	madrid, as in the capital of spain
mafia	黑手党	mafia
magiê	镁	magnesium
mahal	玛哈尔	(proper noun) mahal, as in the taj mahal
mai	明天	"(term should be ""giang mai"") the disease syphilis (n.)"
mainframe	大型机	mainframe
major	专业	major
makemake	制作	makemake
malacca	马六甲	malacca
malay	马来语	malaysia
malaysia	马来西亚	(proper noun) the country of malaysia
malcolm	马尔科姆	malcolm
maldini	马尔蒂尼	maldini
mali	马里	mai
malta	马耳他	malta
maluku	马鲁古	maluku
manche	满族	manche
manchester	曼彻斯特	manchester
mandela	曼德拉	mandela, as in nelson mandela
mandy	曼迪	mandy
mang	轴承	to bring (v.)
manga	漫画	manga
mangnall	曼格纳尔	(proper noun) mangnall, as in ernest mangnall
manh	h	fragile
manila	马尼拉	manila, the capital of the philippines
mankiw	mankiw	mankiw, as in gregory mankiw
manti	曼蒂	mantle
manuel	曼努埃尔	manuel
mao	毛	capillary
maps	地图	maps
maradona	马拉多纳	(proper noun) maradona, as in soccer player diego maradona of argentina
marat	马拉	(proper noun) marat, as in marat safin, a tennis player
marc	马克	marc, as in marc chagall
marcel	马塞尔	(proper noun) marcel, a french name
marcos	马科斯	(proper noun) marcos, as in ferdinand marcos
marcus	马库斯	marcus, as in marcus aurelius (n.)
margaret	玛格丽特	(proper noun) margaret
maria	玛丽亚	(proper noun) maria
marianne	玛丽安	(proper noun) marianne
marie	玛丽	marie
marina	码头	marina
marino	马里诺	marino
marić	马里奇	maric
marmara	马尔马拉	(proper noun) marmara, as in the sea of marmara
marne	马恩河	marne, as in the marne river (n.)
mars	火星	mars
marseille	马赛	marseille
marshall	马歇尔	marshall
marsu	马苏	(proper noun) marsu
marta	玛尔塔	(proper noun) marta, as in the female brazilian soccer player
martin	马丁	martin
marx	马克思	this is a name
mary	玛丽	(proper noun) mary
maryland	马里兰	a name
maría	玛丽亚	maria
mas	马斯	mas
massachusetts	马萨诸塞州	massachusetts
mat	垫子	mat
mathematica	数学	(proper noun) mathematica, as in isaac newton's work, principia mathematica
mats	垫子	mats, as in mats sundin
matthias	马蒂亚斯	matthias, as in matthias erzberger
mau	迅速地	fast
maurice	莫里斯	(proper noun) maurice
mausolus	us	mausolus
maxim	格言	a name
may	缝	lucky
maya	玛雅人	(proper noun) maya
mcafee	麦菲	(proper noun) mcafee
mccain	麦凯恩	mccain
mccartney	麦卡尼	a name
mccullough	麦卡洛	mccullough
mcdonald	麦当劳	(proper noun) mcdonald
mchc	电脑	mchc
mclaren	迈凯轮	mclaren
mcmahon	麦克马洪	(proper noun) mcmahon
mcnamara	麦克纳马拉	(proper noun) mcnamara, as in robert mcnamara
mcv	mv	mean corpuscular volume
media	媒体	media
medici	梅迪奇	(proper noun) medici, as in the medici family of italy
medina	麦地那	(proper noun) medina, as in ernest medina
medvedev	梅德韦杰夫	medvedev
mekong	湄公河	mekong
melbourne	墨尔本	melbourne
mendeleev	门捷列夫	mendeleev
menes	膜	(proper noun) menes
mercedes	奔驰	a name
messenger	信使	messanger
messerschmitt	梅施施密特	messerschmitt, as in the messerschmitt me-109, a german plane
messi	梅西	(proper noun) messi, as in argentinian soccer player lionel messi
messiah	弥赛亚	messiah
meteora	流星	meteora
mext	下一个	mext
meyer	迈耶	(proper noun) meyer, as in stephenie meyer, author of the twilight series
meyers	迈耶斯	meyers
miami	迈阿密	a name
michael	迈克尔	michael
michaels	迈克尔斯	michaels
michelangelo	米开朗基罗	michelangelo
michigan	密歇根州	a name
micro	麦克风	micro
microbiology	微生物学	microbiology
microeconomics	微观经济学	microeconomics
micronesia	密克罗尼西亚	micronesia
microsoft	微软	(proper noun) the microsoft company
miguel	米格尔	miguel
mike	迈克	mike
mikoyan	米科扬	mikoyan
mikoyangurevich	mikoyangurevich	(proper noun) mikoyangurevich
milan	米兰	milan
milano	米兰	milano
miley	麦莉	miley
mill	磨	mill
miller	米勒	miller
milton	米尔顿	milton
min	分	min
minas	米纳斯	minas
mindanao	心脑	(proper noun) mindanao
ming	ming	ming
minnesota	明尼苏达州	minnesota
minoa	米诺阿	minoa; the minoan civilization
miraflores	米拉弗洛雷斯	miraflores
mirage	海市rage楼	mirage
miroku	miroku	(proper noun) miroku, a japanese name
misfits	失配	misfits
mississippi	密西西比州	mississippi
missouri	密苏里州	(proper noun) the state of missouri
mitchel	米切尔	mitchel
mitsubishi	三菱	mitsubishi
miên	催眠	mien
miêu	猫	"(term should be ""miêu tả"") to describe (v.)"
miến	粉条	burma
miếng	件	a piece (n.)
miếu	庙宇	temple
miền	领域	area
miễn	免费的	to exempt (v.)
miện	冠	crown
miệng	嘴巴	mouth
mm	毫米	millimeter
mobile	流动的	mobile
mode	模式	mode
modul	模组	module
modula	模数	(proper noun) modula, as in modula-2
mohammad	穆罕默德	mohammad
mohammed	穆罕默德	mohammed
moi	新的	winkle
molecular	分子的	molecular
molotov	莫洛托夫	molotov
molypden	钼	the element molybdenum (n.)
mongolia	蒙古国	mongolia
monique	莫妮克	(proper name) monique, a french first name
mono	单声道	mono
monroe	门罗	monroe
mont	蒙特	(proper noun) mont
montaigne	蒙太尼	montaigne, as in michel de montaigne
montana	蒙大拿州	(proper noun) montana, as in the state
montenegro	黑山共和国	montenegro
montmartre	蒙马特	(proper noun) montmartre
montparnasse	蒙帕纳斯	montparnasse
montreal	蒙特利尔	(proper noun) montreal, quebec
moo	哞	(proper noun) moo, as in cha moo won
moong	g	moong
mora	莫拉	mora
moravia	摩拉维亚	moravia
morgan	摩根	(proper noun) morgan
mori	森	(proper noun) mori
moriarty	莫里亚蒂	(proper noun) moriarty, as in james moriarty from sherlock holmes
morley	莫雷	morley
morocco	摩洛哥	morocco
morris	莫里斯	morris
morrison	莫里森	(proper noun) morrison
morse	莫尔斯	(proper noun) morse, as in morse code
moscow	莫斯科	moscow
mosin	莫辛	mosin
moskva	莫斯科	moscow
motown	莫敦	motown
mourinho	穆里尼奥	mourinho
movie	电影	movie
mozambique	莫桑比克	(proper noun) mozambique
mozart	莫扎特	(proper noun) mozart, as in the composer
mp	mp	mp
ms	毫秒	metre per second
msdos	msdos	ms-dos
mtv	音乐电视	mtv
mu	亩	pubis
mua	买	buy
much	很多	much
muhammad	穆罕默德	(proper noun) muhammad, as in muhammad ali
mumbai	孟买	mumbai
mun	乌木	a vietnamese name
munich	慕尼黑	(proper noun) munich
murdoch	默多克	murdoch
muromachi	室町	(proper noun) muromachi
murphy	墨菲	murphy
murray	墨累	(proper noun) murray, as in dr. conrad murray
mustang	野马	mustang, as in the f-51 mustang
muta	突变	a name
muôn	想要	a large number; thousands (adj.)
muối	盐	salt
muốn	想	want
muống	汤匙	"(term should be ""rau muống"") water spinach (n.)"
muồi	晚了	ripe
muỗi	蚊子	mosquito
muỗng	汤匙	spoon
muội	姐姐	confusion
muộn	晚了	late (adv.)
myanma	缅甸	the country of myanmar
myanmar	缅甸	(proper noun) myanmar
myspace	myspace	(proper noun) myspace
mà	那	also
mài	打磨	tomorrow
màn	窗帘	curtain (n.)
mành	百叶窗	a bamboo screen (n.)
mào	波峰	a comb or crest, as in the body part of a bird
màu	颜色	color
mày	你	sew
má	脸颊	cheek
mác	标签	a name (marx)
mách	秘诀	tell
máclênin	马赛列宁	marxist-leninist
mái	屋顶	"entire term should be ""thoai mai""; means ""comfortable"""
mát	酷	cool
máu	鲜血	blood
máy	机器	a machine (n.)
mâm	托盘	tray
mân	念珠	"entire term should be ""man viet""; a country of ancient asia that now corresponds to a province in southern china"
mâu	矛盾的	contradiction
mây	云	cloud
mã	代号	"(term should be ""la mã"") roman (adj.)"
mãi	永远	forever (adv.)
mãimại	代号	commerce
mãn	自满的	satisfy
mãnh	强壮的	intense
mão	冠	cat
mè	芝麻	sesame
mèo	猫	cat (n.)
mé	梅	a border
méo	扭曲的	alter
mép	边缘	edge
mét	仪表	meter
mênh	广阔的	vast
mêtan	甲烷	methane
mì	面条	wheat
mình	你自己	me
mía	甘蔗	sugar cane (n.)
mò	摸索	to grope (v.)
mòn	破旧	trail
móc	勾子	"(term should be ""máy móc"") machinery (n.)"
món	食物	dish
mô	组织	mo
môi	嘴唇	lip
môn	科目	anus
mông	臀部	mongolia
mônôxít	一氧化碳	monoxide
môt	一个	"(term should be ""một"") one (n.)"
môtô	摩托车	motorcycle
mù	盲目的	mu
mùa	季节	season
mùi	气味	smell
múa	跳舞	dance
mút	吸吮	to suck (v.)
münchen	慕尼黑	(proper noun) munchen
măng	竹笋	bamboo shoot (n.)
mĩ	美国	america
mũ	瓶盖	cap
mũi	鼻子	nose
mơ	梦想	vague
mơn	爪子	caress
mưa	下雨	rain
mưu	狡猾	"(should be ""tham mưu"") advisors"
mươi	五十	tens
mương	沟渠	ditch
mướn	聘请	hire
mướt	顺利	smooth (adj.)
mường	孟	(proper noun) mường, a minority people in vietnam (n.)
mượn	借来的	borrow
mượt	顺利	glossy (adj.)
mạc	荒漠	"(should be ""mộc mạc"") simple or natural"
mạch	电路	vessel
mại	贸易	commerce
mạn	侧面	romantic
mạnh	强壮的	strong
mạo	文章	"(should be ""mạo hiểm"") to brave danger"
mạt	螨虫	"(term should be ""lê mạt"") the ending or decline of something (adj.)"
mả	坟墓	tomb or grave (n.)
mải	忙	absorbedly
mảng	数组	genre
mảnh	件	piece
mất	迷路了	lose
mấu	标签	key
mấy	几个	any
mầm	细菌	kindergarten
mầu	颜色	color
mẩu	件	piece
mận	李子	plum
mập	胖子	fat
mật	亲爱的	intimate
mậu	贸易	mau
mắc	贵的	get
mắm	鱼露	"(term should be ""nước mắm"") fish sauce (n.)"
mắn	幸运的	"(term should be ""may mắn"") fortunate (adj.)"
mắng	责骂	scold
mắt	眼睛	eye
mặc	穿	wear
mặn	咸的	salt
mặt	面子	face
mẹ	妈	mother (n.)
mẹo	秘诀	trick
mẻ	批处理	cool
mẽ	强壮的	strong
mến	亲爱的	to adore or like greatly (v.)
mề	izz	locket
mềm	软的	soft
mệnh	平价	revolution
mệt	累了	tired
mỉ	一丝不苟	meticulous
mỉa	讽刺的	ironic
mỉm	微笑	smile
mịch	狗屎	"(term should be ""tịch mịch"") quiet (adj.)"
mịn	顺利	smooth
mịt	嗅	dim
mọc	成长	to grow (v.)
mọi	每一个	every
mọn	小资	lowly
mỏ	地雷	mine
mỏi	累了	tired (adj.)
mỏng	薄	thin
mốc	发霉的	border
mối	白蚁	relationship
mốt	时尚	fashion or style (n.)
mồ	严重的	"(term should be ""mồ hôi"") sweat (n.)"
mồi	诱饵	bait (n.)
mổ	手术	to dissect or perform surgery (v.)
mỗi	每个	every
mộ	严重的	admire
mộc	木工	simple
mộng	梦想	dream
một	一个	one
mới	新的	new (adj.)
mờ	模糊的	dim
mời	被邀请	invite
mở	开	open
mỡ	胖子	fat or grease (n.)
mục	该项目	purpose
mụn	痤疮	pimple
mức	等级	level
mứt	卡纸	preserve
mừng	很高兴	to be happy
mửa	呕吐	to vomit (v.)
mực	墨水	"(term should be ""chuẩn mực"") standard (n.)"
mỳ	面条	noodles (n.)
mỹ	很好	america
mỹcông	美国	my private
na	呐	"(term should be ""na uy"") the country of norway"
naadam	那达姆	naadam
nacional	国民	nacional
nagant	g	nagant
nagar	纳加尔	nagar, as in champa po nagar
nagasaki	长崎	(proper noun) the city of nagasaki, japan
nagoya	名古屋	a name
nagumo	mo	nagumo
nai	鹿	a deer
nairobi	内罗毕	nairobi, a city in kenya (n.)
nakajima	中岛	a japanese name
nalbandian	纳尔班迪安	a name
nam	男	male
nambắc	北	nambac
namibia	纳米比亚	namibia
namnam	南南	male-male
namno	南野	nammo
nancy	南希	nancy, as in nancy pelosi
nang	胶囊	"(term should be ""cẩm nang"") a handbook (n.)"
nanh	fang牙	fang
nano	纳米	nano
naomi	直美	naomi, as in model naomi campbell
napoleon	拿破仑	(proper noun) napoleon
napoli	那不勒斯	(proper noun) napoli
napoléon	拿破仑	napoleon
nara	奈良	nara
nasa	美国航空航天局	(proper noun) nasa
nat	t	nat
nathan	内森	nathan
natri	钠盐	sodium
nauru	瑙鲁	a name
nava	导航	nava
navarre	纳瓦拉	navarre
nay	现在	this (adj.)
needham	李约瑟	needham
nelson	纳尔逊	(proper noun) nelson, as in nelson mandela
neo	锚点	"(term should be ""mỏ neo"") an anchor (n.)"
neon	霓虹灯	neon
nepal	尼泊尔	nepal
nepomuk	内波穆克	a name
nessie	内西	(noun) nessie, the nickname of the loch ness monster
net	网	net
netbook	上网本	netbook
netscape	网景	netscape
networks	网路	networks
neumann	纽曼	(proper noun) neumann
neutrino	中微子	neutrino
nevada	内华达州	nevada
neverland	梦幻岛	neverland
newcastle	纽卡斯尔	newcastle
newspaper	报纸	newspaper
newton	牛顿	newton
newtons	牛顿	(proper noun) newton's
next	下一个	next
nga	俄罗斯	russia
ngai	王位	crown
ngang	水平的	horizontal
ngao	蛤	clam (n.)
ngay	现在	even
nghe	听到	hear
nghinh	恩欣	welcome
nghiêm	严厉地	serious
nghiêng	倾斜的	inclined
nghiêu	恩吉厄	nghiêu, a vietnamese name
nghiền	压碎	crush
nghiễm	可惜	serious
nghiệm	经验	experiment
nghiện	沉迷	addiction
nghiệp	业力	karma/ sự nghiệp=career
nghiệt	冷酷	adverse
nghành	行业	faculty
nghèo	可怜的	poor
nghé	he	to glance out of the corner of one's eye (v.)
nghê	he	nghe khuong
nghênh	欢迎你	support
nghìn	一千	thousand
nghĩ	思想	think
nghĩa	意思	meaning
nghẽn	拥挤	jam
nghếch	大声	stupid
nghề	职业	career
nghệquận	艺术	art district
nghỉ	打破	relaxation
nghị	建议	think
ngo	精致的	ngo
ngoan	好孩子	good
ngoc	ngoc	"(term should be ""ngọc"") gem (n.)"
ngon	好吃	delicious
ngoài	分开	outside of
ngoại	外来的	external
ngoạn	惊人的	spectacular
ngoặc	括号	bracket
ngoặt	转折点	landmark
ngu	愚蠢的	stupid
ngung	恩贡	(proper noun) a vietnamese first name
nguyen	阮	nguyen
nguyên	原始的	reason
nguyền	诅咒	curse
nguyện	发誓	"(term should be ""mãn nguyện"") to be satisfied (adj.)"
nguyệt	月亮	moon
nguôi	镇定	fade away
nguồn	来源	source
nguời	人	people
nguỵ	傻瓜	camouflage
ngà	象牙色	russian
ngàn	一千	thousand
ngàng	ngàng	"(term should be ""ngỡ ngàng"") to be at fault (adj.)"
ngành	行业	sector
ngào	甜蜜的	sweet
ngày	日	day
ngách	利基市场	"entire term should be ""ngoc ngach""; means ""a small, out-of-the-way road"""
ngái	愚蠢的	chinese ethnic group living in the vietnamese highlands near the china border
ngán	无聊	to be tired of
ngáng	ngáng	stop
ngát	晕倒	"(term should be ""ngát hương"") fragrant (adj.)"
ngân	银行	money
ngây	空白	"(term should be ""ngây ngất"") to be in ecstasy"
ngãi	义井	ngai
ngò	香菜	coriander
ngó	看	to look (v.)
ngói	瓦	tile or shingle
ngón	手指	a finger (n.)
ngót	收缩	"(term should be ""rau ngót"") also called sweet leaf, a type of leafy vegetable used to make soup (n.)"
ngôn	语言	manifesto
ngông	鹅	eccentric
ngõ	车道	lane
ngùi	闻到	sad
ngút	恩古特	"entire term is ""ngut troi""; means ""sky-high"""
ngăn	隔间	prevent
ngũ	五	rank
ngơ	被忽略	ignored (adj.)
ngơi	休息	"(term should be ""nghỉ ngơi"") to rest (v.)"
ngư	渔民	fishermen
ngưng	停止	stop
ngưu	牛	buffalo
ngươi	你	an ancient form of address equivalent to thou or thee (n.)
người	人	people
ngưỡng	门槛	religious
ngược	向后	opposite
ngạc	惊讶的	surprise
ngạch	等级	"(term should be ""kim ngạch"") turn-over (n.)"
ngạn	银行	bank
ngạnh	倒钩	self-willed
ngạo	傲慢自大	"(term should be ""ngạo ngược"") insolent (adj.)"
ngạt	窒息	stuffy
ngấm	注入	draw
ngất	晕倒	unconscious
ngầm	地下的	underground
ngần	犹豫	hesitate
ngẩn	傻眼了	froze
ngẫm	思考	think
ngẫu	随机的	ngẫu nhiên= random
ngậm	锭剂	keep
ngập	被淹	flood
ngắm	看	to contemplate or look admiringly at something (v.)
ngắn	短的	short
ngặt	紧	strict
ngọ	中午	horse
ngọc	珍珠色	pearl
ngọn	上衣	top
ngọt	甜蜜的	sweet (adj.)
ngồi	坐着	sit
ngộ	启蒙运动	ngo
ngột	突然	sudden
ngớ	傻的	silly
ngời	人	bright
ngỡ	思想	surprised
ngợi	赞美	praise
ngợm	顽皮的	naughty
ngục	地牢	dungeon
ngụm	s	sip
ngụy	木偶	puppet
ngủ	睡觉	sleep
ngủi	短的	"(should be ""ngắn ngủi"") short-lived"
ngứa	发痒	itchy
ngừ	金枪鱼	tuna
ngừa	防止	prevent
ngừng	停止	to cease (v.)
ngửa	面朝上	supine
ngửi	闻到	to smell
ngữ	演说	term
ngự	居住	defend
ngựa	马匹	horse
ngực	胸部	chest
nha	牙医	dental
nhakẻ	小子	nha-ke
nham	熔岩	"(actual term is ""dung nham"") lava"
nhan	han	"(term should be ""dung nhan"") countenance or facial appearance (n.)"
nhang	香	incense
nhanh	快	fast
nhat	hat	nhat
nhen	重新点燃	rekindle
nhi	小孩儿	junior
nhiên	课程	tuy nhiên= however
nhiêu	很多	how many
nhiều	很多	numerous
nhiễm	被感染	infect
nhiễu	杂音	noise
nhiệm	职责	task
nhiệt	热度	heat
nhk	nhk	nhk
nhs	nhs	nhs
nhu	喜欢	demand
nhuận	飞跃	leap year
nhuệ	hu	elite
nhuộm	染过的	dye
nhàn	闲置	leisure
nhàng	轻轻地	"(term should be ""nhẹ nhàng"") gentle (adj.)"
nhào	揉	to fall headlong
nhác	松弛	coward
nhái	克隆	illegal copy
nhánh	分行	branch
nháp	草稿	draft
nháy	眨眼	to flash or blink (v.)
nhâm	浸	leap
nhã	有品位	"(term should be ""thanh nhã"") elegant"
nhãn	标签	"(term should be ""gán nhãn"") to affix a label"
nhét	塞	put
nhì	第二	second (adj.)
nhìn	看	to look (v.)
nhí	不休	children
nhím	刺猬	porcupine
nhòm	看	to peep (v.)
nhóc	小子	brat
nhóm	组	group (n.)
nhô	突出的	emerge
nhôm	铝制	aluminum (n.)
nhúng	嵌入式的	embed
nhút	害羞的	shy
nhăn	皱纹的	wrinkle
nhĩ	心房的	turkey
nhũ	乳状液	"(term should be ""thạch nhũ"") stalactite (n.)"
nhũng	腐败	bribery
nhơn	相乘	nhon
như	如	like
nhưng	但是	but
nhương	唾液	(proper noun) vietnamese first name
nhường	产量	yield
nhưỡng	油腻的	soil
nhược	弱点	weak
nhượng	优惠	concession
nhạ	ạ	nha
nhạc	乐曲	music
nhạn	吞下	bird
nhạo	嘲笑	ridicule
nhạt	苍白的	light
nhạy	敏感的	sensitive
nhảy	跳舞	jump
nhấc	升降机	lift
nhấm	饮	rodent
nhấn	紧迫	to press (v.)
nhất	最	most
nhầm	错的	misunderstand
nhầy	黏糊糊的	glutinous
nhẫn	戒指	patient
nhậm	盖章	inaugurate
nhập	进入	penetrate
nhậu	喝酒	drink
nhậy	敏感的	sensitive
nhắc	提示	to remind (v.)
nhắm	瞄准	aim
nhắn	讯息	message
nhằm	瞄准	for the purpose of (adv.)
nhẵn	顺利	smooth
nhặt	拿起	pickup
nhẹ	轻的	light
nhẹn	敏捷的	nhanh nhẹn= fast/nimble
nhị	雄蕊	sensitive
nhịn	弃权	fasting
nhọ	涂抹	smear
nhọn	尖的	sharp (adj.)
nhỏ	小	small
nhỏ|cây	小|树	small|tree
nhỏ|một	小|一	small | one
nhỏ|phải|	小|对|	small|right
nhỏ|phải|px|	小|右| px |	small | have | px |
nhỏ|phải|px|bức	小|右| px |图片	grape / fade / px / buc
nhỏ|phải|px|cây	小|右| px |树	px spicy grape fade
nhỏ|phải|px|khu	小|右| px |区域	small|right|px|area
nhỏ|phải|px|michael	小|右| px |迈克尔	small|right|px|michael
nhỏ|phải|px|máy	小|右| px |机器	small | right|px|machine
nhỏ|phải|px|một	小|右| px |个	small|right|px|one
nhỏ|phải|px|quân	小|右| px |力	small|right|px|army
nhỏ|px|	小| px |	small
nhỏ|px|các	小| px |的	small
nhỏ|px|phải|kiến	小| px |对|蚂蚁	small | px | right | patience
nhỏ|quân	小|力	small|army
nhỏ|trái|px|máy	小|左| px |机器	small|left|px|plane
nhỏ|tượng	小雕像	small|statue
nhốt	锁起来	confine
nhồi	塞满	cram
nhổ	吐	uproot
nhộn	搞笑	busy
nhớ	要记住	remember
nhớt	粘性的	viscid
nhờ	谢谢你	by
nhờn	油腻的	multiplication
nhở	提醒	remind
nhụ	捏	nhu
nhục	丢脸的	shame
nhủ	提醒	needs
nhức	疼痛	pain
nhứt	首先	first (n.)
nhừ	喜欢	tender
những	这些	the
nhựa	塑胶的	plastic
nhựt	努特	"like the word ""nhật""; meaning ""sun"" (n.)"
ni	ni	nun
nia	尼亚	a flat basket (n.)
nicaea	尼西亚	nicaea
nicaragua	尼加拉瓜	(proper noun) nicaragua
niccolò	尼科洛	(proper noun) niccolo, as in writer niccolo machiavelli
nicolas	尼古拉斯	(proper noun) nicolas, as in nicolas sarkozy
niels	尼尔斯	(proper noun) niels
nigeria	尼日利亚	nigeria
nikel	尼克尔	nickel
niken	镍	nickel
nikita	尼基塔	(proper noun) nikita, a first name
nikko	日光	(proper noun) nikko
nikolai	尼古拉	nikolai
nikolayevich	尼古拉耶维奇	nikolayevich
nil	无	nile
nile	尼罗河	(proper noun) the river nile
nimitz	尼米兹	(proper noun) nimitz, as in the ship uss nimitz
nin	宁	nin
ninh	安全性	ninh, as in bắc ninh
nintendo	任天堂	(proper noun) nintendo, the game company
nippon	日本	nippon
nitơ	氮	nitrogen (n.)
nixon	尼克松	(proper noun) nixon, as in former president richard nixon
niên	年份	youth
niết	尼特	nirvana
niềm	享乐	trust
niệm	正念	concept
niệu	利尿剂	urinary
nj	新泽西州	nj
nlf	nlf	nlf
nm	纳米	nano-meters
noah	诺亚	(proper noun) noah
nobel	诺贝尔奖	nobel
nobita	大雄	nobita
noel	诺埃尔	(proper noun) noel
noi	说	imitate
nokia	诺基亚	(proper noun) nokia, as in the nokia corporation
nol	诺尔	nol
nom	标称	look after
non	年轻的	mountain
nonpenetrative	非穿透性	nonpenetrative
norfolk	诺福克	norfolk
norge	挪威	norge
norma	规范	(proper noun) norma, a female first name
norman	诺曼	norman
normandie	诺曼底	normandile
northrop	诺斯罗普	northrop, as in the northrop f-5 freedom fighter
norton	诺顿	norton
norway	挪威	norway
nou	努	nou
novak	新星	novak
now	现在	now
nowc	现在	nowc
noãn	胚珠	ovule
nsnd	nsnd	people's artist
nst	nst	chromosome
nubia	努比亚	nubia
number	数	number
nupedia	ped	a name
nusa	努沙	nusa
nuôi	喂	feed
nuối	吞下	"(term should be ""tiếc nuối"") to regret (v.)"
nuốt	吞下	to swallow (v.)
nuớc	水	water
nxb	nxb	publisher
nynorsk	尼诺斯克	nynorsk
nà	à	na
nài	坚持	pleading
nàn	抱怨	poor
nành	黄豆	soy
nào	来吧	would
này	这个	this
ná	纳	a crossbow (n.)
nách	腋窝	underarm (n.)
náo	骚动的	riot
nát	压碎	ruin
náu	隐藏	hide
nâng	起重	raise
nâu	棕褐色	brown
nã	ã	to track down (v.)
não	脑子	brain
né	避开	dodge
ném	扔	to throw (v.)
nén	压缩的	compress
nét	中风	feature
nê	几内亚	ne
nên	应该	should or ought to
nêu	陈述	mention
nòi	种族	race
nòng	桶装的	barrel
nói	说过	to say or speak (v.)
nón	帽子	cone
nóng	热的	hot
nô	奴隶	slave
nôbita	bit田	nobita
nôi	婴儿床	cradle
nôm	ô	ancient vietnamese script that borrowed heavily from han chinese characters
nôn	呕吐	vomit
nông	浅的	farmer
nõn	剥皮	peeled
nùng	嫩	nung
núm	旋钮	nipple
núp	遮盖	hide
nút	纽扣	button
năm	年份	year
năn	pent悔	"(term should be ""ăn năn"") remorse (n.)"
năng	威力	"(term should be ""khả năng"") ability (n.)"
nơi	地方	a place
nơtrino	中野	neutrino
nước	水	country
nước 	水	water
nướng	烤的	grill
nǎm	nǎm	year
nạ	面膜	mask
nạc	瘦	lean (adj.)
nại	抱怨	complain
nạn	苦恼	a disaster (n.)
nạo	刮宫	to scrape (v.)
nạp	已加载	tribute
nản	气	depressed
nảy	弹跳	"(term should be ""nảy sinh"") to give rise to (v.)"
nấc	打ic	a hiccup (n.)
nấp	隐藏	hide
nấu	做饭	cook
nấy	这个	this
nần	轻推	debt
nầy	这个	this
nẩy	弹跳	"(term should be ""nảy nở"") to sprout or start growing (v.)"
nẫu	太阳	"(""giọng nẫu"") a vietnamese accent commonly found in cities such as phú yên"
nậm	南	"(term should be ""nậm rốm"") the name of a river in vietnam (proper noun)"
nập	热的	busy
nắm	掌握	to grasp or hold (v.)
nắng	阳光明媚	sunlight
nắp	盖	a lid or cover (n.)
nằm	谎言	to lie (v.)
nẵng	ang	"(term should be ""Đà nẵng"") a city in central vietnam"
nặc	匿名地	heavy
nặn	挤压	mould
nặng	沉重的	heavy
nẻo	另一个	turn
nếm	品尝	taste
nến	蜡烛	candle
nếp	粘性的	sticky rice (n.)
nếu	如果	if (adv.)
nề	石工	severe
nể	尊敬	respect
nện	猛击	ram
nỉ	感到	beg
nịnh	奉承	flatter
nọ	另一个	the other
nọc	毒液	tadpole
nỏ	长弓	a crossbow (n.)
nối	已连接	connection
nốt	注意	to finish off (v.)
nồi	锅	pot
nồm	颈背	humid (adj.)
nồng	专心	heavy
nổ	爆炸	explode
nổi	漂浮的	nổi tiếng= famous
nỗ	企图	affort
nỗi	那	state
nộ	愤怒	anger
nội	内部的	on the paternal side (adj.)
nộn	馅	non
nộp	提起	submit
nới	放松	ease
nở	盛开	bloom
nỡ	心地	do you have a heart to
nợ	债务	debt
nụy	雌蕊	"(term should be ""nụy nhân"") the vietnamesized han term depicting the japanese"
nứa	软木塞	a kind of bamboo (n.)
nứt	破解	to crack
nửa	一半	haft
nữa	更多	moreover
oahu	瓦胡岛	(proper noun) oahu
oai	恐惧	heroic
oakland	奥克兰	oakland
oan	不公正	injustice
oanh	oanh	(with word liet) glorious
obama	奥巴马	obama
oblast	州	(proper noun) oblast, as in tomsk oblast
oc	oc	oc
october	十月	(proper noun) october
oda	小田	oda
oder	奥德尔	oder
odyssey	奥德赛	odyssey, as in the odyssey, homer's epic
oecd	oecd	oecd
officer	军官	officer
officers	军官	officers
ohkawa	大川	ohkawa
okhotsk	鄂霍次克	okhotsk
oliver	奥利弗	oliver
olivier	奥利维尔	olivier
olympus	奥林巴斯	olympus
om	om	to simmer
omar	奥马尔	a name
ong	蜜蜂	bee
ontario	安大略省	ontario
oort	麦汁	oort
oprah	奥普拉	(proper noun) oprah, as in oprah winfrey
organ	器官	organ
oricon	oricon	oricon
origin	起源	origin
orion	猎户座	(proper noun) orion, the hunter
orleans	奥尔良	(proper noun) orleans, as in new orleans
orochimaru	orochimaru	orochimaru
orton	奥顿	orton
os	操作系统	os
osaka	大阪	(proper noun) osaka, a city in japan
osama	大ama	(proper noun) osama, as in osama bin laden
osamu	奥萨姆	(proper noun) osamu, a japanese first name
oscar	奥斯卡	oscar
osiris	奥西里斯	(proper noun) osiris, as in the egyptian god
oskar	奥斯卡	a name
oslo	奥斯陆	oslo
osment	os	osment
ospf	ospf	ospf
ossetia	奥塞梯	(proper noun) ossetia
oswald	奥斯瓦尔德	oswald
other	其他	other
otto	奥托	(proper noun) otto, as in otto von bismarck
ottoman	脚凳	(proper noun) ottoman, as in the ottoman empire
outstanding	杰出的	xuat sac
owen	欧文	(proper noun) owen, as in michael owen
oxford	牛津	oxford
oxy	氧气	oxygen
ozawa	小泽	(proper noun) ozawa, as in maria ozawa
oán	怨恨	"(term should be ""oán than"") to complain or whine"
oát	瓦特	a watt (n.)
oản	à	"(term should be ""ăn oản"") gratitude and resentment (n.)"
paget	佩吉特	(proper noun) paget
pailin	拜林	pailin
pakistan	巴基斯坦	(proper noun) the country of pakistan
palais	宫	palais, as in grand palais
palawan	巴拉望	palawan
palenque	巴伦克	(proper noun) palenque
palestine	巴勒斯坦	a name
palgrave	帕尔格雷夫	palgrave
pali	巴利语	a name
pamir	帕米尔	pamir
pan	锅	pan, as in peter pan
panama	巴拿马	panama
panamax	巴拿马型	(proper noun) panamax
panduranga	潘杜兰加	(proper noun) panduranga
panthera	豹	(proper noun) panthera, a genus of felines
panthéon	万神殿	a name
paolo	保罗	paolo
paperback	平装本	paperback
papua	巴布亚	papua
paraguay	巴拉圭	(proper noun) paraguay
pari	帕里	pari
park	公园	park
parton	帕顿	parton
patel	tel	(proper noun) patel
patrick	帕特里克	patrick
patriot	爱国者	patriot
paul	保罗	paul
paula	保拉	paula
paulo	保罗	(proper noun) paulo
pavia	帕维亚	pavia
pbs	铅	pbs
pda	pda	pda
pdf	pdf格式	pdf
pedro	佩德罗	pedro
peers	同行	peers
pele	贝利	(proper noun) pele, as in the soccer player
penang	槟城	penang
penh	h	(proper noun) penh, as in phnom penh
pennsylvania	宾夕法尼亚州	pennsylvania
penny	一分钱	(proper noun) penny, an english first name
pereira	佩雷拉	pereira
perl	佩尔	(proper noun) perl
pero	佩罗	pero
perry	佩里	(proper noun) perry, as in elizabeth perry
persephone	波斯语电话	presephone
pershing	潘兴	pershing
persian	波斯语	persian
peru	秘鲁	peru, as in the south american country
peters	彼得	peter's, possessive of peter
petersburg	彼得斯堡	(proper noun) petersburg, as in saint petersburg
pfm	pfm	a name
pgs	pgs	associate professor
pgđ	đ	associate professor
pha	混合的	to mix
phaethon	费森	phaethon
pham	范	pham
phanh	煞车	expose
phao	飘浮	float
phaolô	保罗	st. paul, the apostle
pharaoh	法老王	pharaoh
pharaon	法老	pharaoh
phay	铣削	mill
phe	派系	faction
phen	苯酚	time
phil	菲尔	(proper noun) phil, a first name
philip	菲利普	philip
philippe	菲利普	philippe
philippines	菲律宾人	(proper noun) philippines
phillip	菲利普	(proper noun) phillip
phillips	菲利普斯	philips
philosophiae	哲学家	(proper noun) philosophiae, as in the work philosophiae naturalis principia mathematica
phim	电影	phim
phin	过滤器	coffee filter
phineas	披风	(proper noun) phineas
phiên	会议	trial
phiêu	冒险	adventurous
phiếm	八卦	gossip
phiến	刀刃	"(should be ""nha phiến"") opium"
phiện	鸦片	opium
phiệt	菲特	militarism
phnom	金边	phnom
phnôm	幽灵	phnôm pênh= phnom penh(cambodia's capital)
pho	河粉	part of a person's name, rat-pho, or ratford
phoenix	凤凰城	(proper noun) phoenix
phong	房间	movement
php	的php	php
phrygian	phr	phrygian
phu	富	"(term should be ""phu nhân"") wife (n.)"
phui	揭露的	expose
phun	喷	to spray or spit (v.)
phà	轮渡	ferry
phàm	凡人	superhuman
phàn	抱怨	complain
phá	破	destroy
phác	素描	"(term should be ""phác thảo"") outline or sketch (n.)"
phách	拍子	manner (n.)
phái	宗派	a party
phán	评判	judge
pháo	大炮	artillery
pháp	法国	method
phát	广播的	develop
phèn	明矾	alum
phèo	è	organs
phép	允许的	permit
phê	咖啡	"(term should be ""phê bình"") to criticize (v.)"
phêrô	彼得	peter
phì	肥大	non-
phình	隆起	bulge
phí	收费	non-
phía	侧面	side
phích	热水瓶	a flask (n.)
phím	关键	key
phò	ò	"(term should be ""phò mã"") a prince consort"
phòng	房间	office
phó	副手	second
phóng	记者	to launch (v.)
phô	城市名	display
phôi	锭	embryo
phông	字形	font
phùng	泡芙	phung
phúc	有福	good fortune (n.)
phúclộc	有福	phuc-loc
phún	烧伤	"(term should be ""lún phún"") sparse (adj.)"
phúng	可惜	satire
phút	分钟	a minute (n.)
phăn	苦恼	phan
phăng	hang	knock
phương	丰	direction
phước	祝福	luck
phường	病房	ward
phượng	凤凰城	phoenix
phạn	梵文	sanskrit
phạt	罚款	punish
phả	血统书	pedigree
phải	是的	must
phải 	是的	right
phản	柜台	reaction
phảng	平的	subtle
phần	部分	part
phẩm	产品展示	food
phẩy	逗号	a comma
phẫn	愤慨	wrathful
phẫu	手术	surgery
phận	缘分	part
phật	佛陀	buddhist
phẳng	平的	flat (adj.)
phế	废料	dismiss
phết	传播	to spread or smear (v.)
phỉ	淡褐色	defame
phỏng	烧伤	interview
phố	街	city
phối	协调	coordinate
phốt	磷酸盐	"(term should be ""phốt-phát"") phosphate (n.)"
phồng	膨胀的	to swell (v.)
phổ	频谱	popular
phổi	肺	lung
phộng	花生米	peanut
phới	飘浮	"(term should be ""phơi phới"") mildly exciting (adj.)"
phở	河粉	pho
phục	服饰类	convincing
phụng	服务	worship
phụt	泡芙	minute
phủ	覆盖的	government
phức	复杂的	complex
picchu	皮丘	a name
piccolo	短笛	piccolo
pierre	皮埃尔	pierre
pierrot	皮埃罗	pierrot
pietro	彼得罗	pietro
pike	派克	pike
pin	别针	battery
pinlus	平鲁斯	pinlus
pioneer	开拓者	pioneer
pipes	管道	pipes
pisa	比萨	a name
piston	活塞	piston
pitch	音高	pitch
pius	皮乌斯	pius
plaaf	pla	plaaf
plan	计划	plan
plasma	等离子	plasma
plate	板块	plate
plato	铂金	plato
platon	铂金	platon
player	播放器	player
pleiku	pleiku	(proper noun) pleiku
pleistocen	更新世	pleistocen
plus	加号	plus
pluto	冥王星	pluto
pm	下午	pm
pmu	mu	pmu
po	po	po
pokémon	宠物小精灵	pokemon
pol	波尔	pol
poland	波兰	poland
pollack	波拉克	a name
pollux	pollux	a name
polo	马球	(proper noun) polo, as in marco polo
polynésie	波利尼西	polynesian
pont	蓬	(proper noun) pont, as in pont de normandie
pop	流行音乐	pop
portland	波特兰	portland
porto	波尔图	porto
pot	锅	pot
potsdam	波茨坦	(proper noun) potsdam
potter	波特	(proper noun) potter, as in harry potter
pour	倒	not vietnamese
powell	鲍威尔	(proper noun) powell, as in general colin powell
pradesh	布拉格	pradesh
praha	普拉哈	praha
pratzen	普拉森	pratzen
preah	圣剑	(proper noun) preah
premier	总理	premier
preminger	预言者	(proper noun) preminger
preston	普雷斯顿	(proper noun) preston, as in john preston
prince	王子	prince
princeton	普林斯顿	princeton
printemps	印刷经验	printemps
printf	打印	printf
prinz	王子	(proper noun) prinz, as in birgit prinz, the female german soccer player
prix	大奖赛	(proper noun) prix, as in the grand prix
procellarum	procellarum	procellarum, as in oceanus procellarum, the name of a mare on the moon
projekt	项目	projekt
prometheus	普罗米修斯	(proper noun) prometheus
protein	蛋白质	protein
prôtêin	蛋白质	protein (n.)
ps	ps	ps
psv	psv	psv
ptolemy	托勒密	ptolemy
ptq	q	ptq
puerto	波多黎各	puerto
pulau	普劳	(proper noun) pulau, as in pulau tekong, an island
pulitzer	普利策	(proper noun) pulitzer, as in the pulitzer prize
pulp	纸浆	pulp
punjab	旁遮普语	punjab
pusan	釜山	(proper noun) pusan
putin	普京	putin
pyrenees	ene	pyrenees
pytago	皮塔哥	(proper noun) pytago
pzl	z	pzl
péc	佩奇	"(term should be ""vịnh péc xích"") the persian gulf"
pérez	佩雷斯	(proper noun) perez, as in javier perez de cuellar
păng	g	fansipan
pơ	ơ	"(term should be ""pơ kô"") a river in vietnam (n.)"
q	q	q ( a letter)
qatar	卡塔尔	qatar
qd	d	quantum dots
qing	清	qing, as in the qing dynasty of  china
qlvnch	qlvnch	army of the republic of vietnam
qua	超过	transmit
quad	四边形	quad
quan	办事处	"(term should be ""quan hệ"") relationship (n.)"
quang	光学的	bladder
quanh	周围	around
quay	转过身	turn
que	棒	stick
queen	皇后	queen
queens	皇后区	(proper noun) queens, as in the new york borough
queensland	昆士兰州	queensland
quen	习惯的	accustomed to
qui	qui	formal
quincy	昆西	(proper noun) quincy, as in quincy jones
quran	古兰经	quran
quy	规则	"(term should be ""quy ước"") agreement"
quyên	基本面	"(term should be ""quyên góp"") to donate (v.)"
quyến	魅力	"(term should be ""gia quyến"") family"
quyền	对的	right
quyện	混合	mix
quyệt	阴险的	"(should be ""xảo quyệt"") devious"
quá	也一样	over
quái	赫克	strange or odd
quán	吧	hometown
quáng	盲目的	blind
quát	大喊	generalize
quân	军事	army (n.)
quãng	大约	optical
quét	扫描	to sweep (v.)
quê	农村	countryside
quên	忘了	forget
quý	四分之一	love
quýt	橘子	tangerine
quăng	折腾	to throw (v.)
quĩ	基金	orbit
quạ	乌鸦	crow (con qua)
quạt	风扇	fan
quản	治国	"(entire term is ""cai quản"") to manage"
quảng	促销	guangzhou
quấn	包裹	wrap around
quất	金橘	whip
quấy	搅动	harass
quần	裤子	pants (n.)
quầng	光环	halo
quầy	柜台	stall
quẩy	摇摆	quay
quẫn	琐	necessitous
quận	县	county (n.)
quật	开挖	excavation
quẳng	折腾	throw
quặc	怪异的	strange (adj.)
quặng	矿石	an ore (n.)
quẻ	卦	hexagram
quế	肉桂粉	cinnamon (n.)
quết	败类	knead
quệ	可怜的	exhausted
quỉ	魔鬼	demon
quỳ	跪下	demon (n.)
quỳnh	ỳ	quynh
quỵ	中风	stroke
quỷ	魔鬼	provided
quỹ	基金	fund
qúy	四分之一	quy
r	[r	r
rabindranath	拉宾达纳斯	rabindranath
race	种族	race
rafael	拉斐尔	rafael
rafale	粗鲁	(proper noun) rafale, as in dassault rafale
rai	莱	slowly intake
raleigh	罗利	raleigh
ralph	拉尔夫	(proper noun) ralph, as in ralph waldo emerson
ram	公羊	a name
rama	喇嘛	rama, first name of several rulers of thailand (n.)
ramadan	斋月	(proper noun) the fasting month of ramadan
ramayana	罗摩衍那	ramayana
rambus	rambus	rambus
ran	跑了	ran
ranch	牧场	ranch
randy	兰迪	randy
rang	响了	roast
rangers	游骑兵	rangers
ranh	界线	border (ranh gioi)
rao	广告	to announce
rap	说唱	rap
raptor	猛禽	raptor
rate	率	rate
rau	蔬菜	vegetable
ray	射线	rail (n.)
raya	拉雅	raya
raymond	雷蒙德	raymond
rađa	雷达	radar
reagan	里根	reagan
real	真实的	real
reanimation	复活	reanimation
reap	收割	reap
reef	礁石	reef
regia	雷贾	regia
reichelt	菜谱	reichelt
ren	蕾丝	lace (n.)
renaissance	文艺复兴	renaissance
renault	雷诺	renault
rené	仁	rene
reo	响了	yell
reserve	储备	reserve
resort	渡假胜地	resort
reverse	倒转	reverse
revolution	革命	revolution
rey	雷	rey, as in copa del rey
rfid	射频识别	rfid
rhodes	罗得岛	rhodes
rica	里卡	rica
ricardo	里卡多	ricardo
ricci	里奇	ricci
richard	理查德	richard
richardson	理查森	(proper noun) richardson, as in james o. richardson
richie	里奇	(proper noun) richie, as in singer lionel richie
rico	里科	rico, as in puerto rico
riemann	里曼	riemann, as in bernhard riemann, a german mathematician
rimjob	rimjob	rimjob
rin	rin	rin
rising	上升	rising
risk	冒风险	risk
ritchie	里奇	a name
rivaldo	对手	rivaldo
rivière	里维耶尔	a name
rizal	里扎尔	rizal
riêng	自己的	own
riêu	ê	crab
riết	et	urgently
riềng	高良姜	arrowroot
ro	ro	"entire term is ""rui ro""; means ""risk"""
robert	罗伯特	(proper noun) robert
roberto	罗伯托	(proper noun) roberto
roberts	罗伯茨	roberts
robespierre	罗伯斯皮尔	robespierre
robin	知更鸟	a name
robinson	罗宾逊	robinson, as in michelle robinson
rockefeller	洛克菲勒	rockefeller, as in john d. rockefeller
roddick	罗迪克	(proper noun) roddick
rodríguez	罗德里格斯	rodriguez (n.)
roi	鞭子	a stick or switch used for punishment (n.)
roland	罗兰	roland
romania	罗马尼亚	romania
rome	罗马	rome, as in rome, italy
romeo	罗密欧	(proper noun) romeo, as in romeo and juliet
rommel	罗梅尔	rommel
ron	罗恩	ron
ronald	罗纳德	ronald, an english first name
ronaldinho	罗纳尔迪尼奥	ronaldinho
rong	海藻	seaweed (n.)
rosen	罗森	rosen, as in nathan rosen
roth	罗斯	roth
rotterdam	鹿特丹	(proper noun) rotterdam
rousseau	卢梭	rousseau
router	路由器	cong noi
rovers	流浪者	rovers
rowling	划船	rowling
roy	罗伊	(proper noun) roy, a name
rpd	rpd	rpd
rtp	rtp	rpt
rudolph	鲁道夫	rudolph
rue	芸香	rue, as in rue des vases, a street name
rulin	鲁林	(proper noun) rulin
rumani	罗马尼亚语	romanian
rumiko	留美子	rumiko, a japanese first name
rummel	朗梅尔	rummel
run	运行	tremble
rung	摇	to shake or vibrate (v.)
russian	俄文	(proper adjective) russian
russkaya	鲁斯卡娅	(proper noun) russkaya avionika
ruth	露丝	(proper noun) ruth
rutherford	卢瑟福	rutherford
rutte	tte	rutte
ruud	粗鲁	ruud
ruốc	虾	pemmican
ruồi	苍蝇	fly
ruổi	鲁伊	rong ruổi=wandering
ruộng	场	"(term should be ""ruộng đất"") farmland (n.)"
ruột	小肠	internals
rzeczpospolita	热泽波利斯波塔	rzeczpospolia
rà	签出	finding
ràng	清除	clear
rành	流利的	exhaustive
rào	围栏	barrier
rác	垃圾	gabbage-trash
rách	撕裂	tear
rái	水獭	colander
rán	炒	fried (adj.)
ráp	组装	to assemble (v.)
râm	阴暗的	shade
râu	胡须	beard or mustache (n.)
rã	衰变	out
rãi	广泛地	"(term should be ""rộng rãi"") generous"
rãnh	凹槽	groove
räikkönen	莱科宁	raikkonen
rèm	窗帘	curtain
rèn	锻造	train
ré	尖叫	re
république	共和国	republique
rét	冷的	cold
rê	拖曳	"(term should be ""rê bóng"") to dribble the ball in soccer (v.)"
rên	吟	moan
rêu	苔藓	moss
rì	耳语	lush (adj.)
rìa	边缘	edge
rình	间谍	to watch for
rìu	斧头	ax
rít	嘶嘶声	to wail (v.)
rò	漏水	leak
ròng	网	net
rót	倒	to pour (v.)
rô	方格的	diamond
rôbôt	机械手	robot
rôma	罗马	roman
rông	空心的	rising (adj.)
rõ	清除	clear
rùa	乌龟	turtle
rùng	令人毛骨悚然的	horror
rút	退出	withdraw
răn	戒律	commandment
răng	牙齿	roasted
rōmaji	罗玛吉	romaji
rũ	诱人的	charm
rơ	车	"(term should be ""rơ măm"") a minority people living in vietnam"
rơi	下降	fall
rơm	稻草	straw
rươi	你	sand-worm
rước	游行队伍	welcome
rưới	撒	to sprinkle (v.)
rưỡi	一半	half
rượt	追逐	pursue
rượu	酒类	wine
rạ	茅草	straw
rạc	离散的	discrete
rạch	切口	canal
rạng	天亮	break
rạp	剧院	theater
rải	分散的	spread
rảnh	免费的	to be free (adj.)
rất	非常	very
rầm	门框	aggressive
rầu	伤心的	sorrow
rẫy	高地	full
rậm	浓密的	jungle
rập	阿拉伯的	"(term should be ""Ả rập"") arab"
rắc	撒	trouble
rắn	蛇	snake
rằm	满月	a full moon (n.)
rằng	那	roasted
rặng	岩石	a row
rẻ	便宜的	cheap
rẽ	转	"(term should be ""chia rẽ"") to separate or divide (v.)"
rền	an吟	pealed
rể	女	in-law
rễ	根源	root (n.)
rệp	蚜虫	bug
rệt	明显的	clearly
rệu	ye	decay
rỉ	生锈	leak
rịavũng	ì	ria - bay
rỏ	清除	clearly
rối	纠结	disorder
rốm	阴天	rom
rồ	疯了	"(term should be ""điên rồ"") foolish (adj.)"
rồi	已经	and
rồng	龙	dragon
rổ	篮子	basket
rỗi	免费的	savation
rỗng	空的	hollow
rộ	喧嚣	profuse (adj.)
rộn	忙	busy
rộng	宽广的	wide
rớt	不及格	drop
rời	向左	leave
rỡ	辉煌的	brilliant
rợ	野蛮人	a savage (n.)
rợn	令人毛骨悚然的	scary
rụng	掉下来	to drop
rủ	下垂	ask
rủi	不幸的事	unlucky or unfortunate (n.)
rứa	ứ	rua
rừng	森林	forest
rửa	洗	to wash (v.)
rữa	洗	to decompose or rot (v.)
sa	sa	to fall or drop (v.)
sabah	沙巴	sabah
sachsen	萨克森	sachsen
saddam	萨达姆	(proper noun) saddam, as in saddam hussein
safari	野生动物园	safari
safin	沙芬	safin
sahara	撒哈拉沙漠	sahara
sai	错的	wrong
saigon	西贡	saigon
saintdenis	圣丹尼斯	saint-denis
sakura	樱花	sakura
salem	塞勒姆	(proper noun) salem, as in the city
salvador	萨尔瓦多	salvador
salzburg	萨尔茨堡	salzburg
samhain	三海	samhain
samo	萨摩	samo, the name of the first slavic ruler
samoa	萨摩亚	(proper noun) samoa
samphan	桑潘	samphan
samsung	三星	samsung
samuel	塞缪尔	samuel
samuelson	萨缪尔森	(proper noun) samuelson
samurai	武士	samurai
samut	萨穆特	(proper noun) samut, as in samut prakan in thailand
san	san	level
sanchez	桑切斯	sanchez
sang	到	to
sango	三乡	sango, a language spoken in africa
sangraal	sangraal	sangraal
sanh	出生	bear
sanktpeterburg	圣彼得堡	sankt-peterburg
santos	桑托斯	santos, as in footballer cristiano ronaldo dos santos aveiro of portugal
sao	星星	how
sap	汁液	sap
sapa	沙巴	sapa
sapiens	智者	sapiens
sar	萨尔	sar
sarah	莎拉	sarah, as in sarah pierce
sarawak	砂拉越	(proper noun) sarawak, a malaysian state on the island of borneo
sarcoma	肉瘤	sarcoma
sardinia	撒丁岛	sardinia
sary	沙里	(proper noun) sary, as in ieng sary
saturanga	萨图兰加	saturanga
saturday	周六	saturday
sau	以后	after (adv.)
saudi	沙特	(proper noun) saudi, as in saudi arabia
saunière	索尼埃	saunière
scandinavia	斯堪的纳维亚半岛	scandinavia
schafer	沙弗尔	schafer, as in john c. schafer
schengen	申根	schengen
schiller	席勒	schiller
schlesinger	施莱辛格	schlesinger
schneider	施耐德	schneider, a last name
schumacher	舒马赫	schumacher, as in michael schumacher
schuschnigg	舒斯尼格	(proper noun) schuschnigg, as in kurt schuschnigg of austria
schuster	舒斯特	schuster
schwarzschild	施瓦兹希尔德	schwarzschild
scotland	苏格兰	scotland
scots	苏格兰人	(proper noun) scots
scott	斯科特	scott
scream	尖叫	scream
scud	飞毛腿	scud
scuderia	法式烤面包	scuderia
sdram	斯德拉姆	sdram
search	搜寻	search
seattle	西雅图	(proper noun) seattle, washington
secret	秘密的	bi mat
sedna	塞德娜	(proper noun) sedna
see	看	see
sejm	塞姆	(proper noun) sejm
selena	瑟琳娜	selena
semit	semit	(proper noun) semit
sen	荷花	lotus
sense	感官	sense
september	九月	(proper noun) the month of september
serbia	塞尔维亚	serbia
sergeyevich	谢尔盖耶维奇	(proper noun) sergeyevich
seri	系列	series
service	服务项目	service
sesshomaru	濑正丸	a name
seth	赛斯	seth
seto	濑户	seto
sextus	性爱	sextus
sexy	性感的	sexy
seymour	西摩	seymour
seyssinquart	塞辛夸特	(proper noun) seyss-inquart
shah	h	shah
shaman	萨满祭司	the shaman religion
shan	shan	shan
shane	沙恩	(proper noun) shane, an english first name
shankly	小腿	(proper noun) shankly, as in bill shankly
shaolin	少林	shaolin, as in the shaolin temples
sharpay	sharpay	sharpay, as in sharpay evans
shawn	肖恩	shawn
sherlock	夏洛克	a name
shi	shi	shi
shia	什叶派	shia
shiite	什叶派	shiite
shikoku	四国	shikoku, a japanese island (n.)
shinichi	信一	shinichi
shinoda	信田	shinoda, as in mike shinoda
shirakami	白神	(proper noun) shirakami
shirakawago	白川乡	(proper noun) shirakawa-go
shiva	湿婆	shiva
shoal	浅滩	(proper noun) shoal
shonen	少年	shonen
shop	铺	shop
short	短的	short
showcase	展示柜	a name
shōnen	少年	shonen
siberi	西伯利亚	siberi
sicilia	西西里	sicilia
sicily	西西里岛	sicily, a city in italy
sidney	西德尼	(proper noun) sidney, as in sidney nolan
siem	暹	siem
siemens	西门子	siemens
sierra	塞拉	(proper noun) sierra
sikh	锡克教徒	sikh
sikorsky	西科斯基	a name
silas	西拉斯	silas
silesia	西里西亚	silesia
silic	矽	silicon
silicat	硅酸盐	silicate
silva	西尔瓦	(proper noun) silva, as in carlos silva
silvestris	西尔韦斯特里斯	silvestris
simone	西蒙	simone
sinai	西奈	sinai, as in mount sinai
sinensis	中华	sinensis
sing	唱歌	sing
sinh	天生的	genital
sip	s	sip
sirô	糖浆	name of a member
sistema	气肿	(proper noun) sistema
siu	iu	siu
siêu	超级	super
siết	收紧	to cut off (v.)
sky	天空	sky
skype	skype的	skype
skyteam	天合联盟	skyteam
sl	sl	sl
slav	斯拉夫	(proper noun) slav
slavơ	斯拉夫	slavic
slytherin	斯莱特林	(proper noun) slytherin, as in salazar slytherin of the harry potter series
sm	短信	sm
smg	smg	smg
smith	史密斯	smith
smithsonian	史密森尼	smithsonian
so	所以	compare
société	社会	societe
socrates	苏格拉底	socrates
sohee	苏希	a korean name
soho	苏豪	soho
soi	i	look/stare soi sáng=enlight
solaris	日光浴	(proper noun) solaris
som	索姆	(proper noun) som, as in kampong som
somme	索姆	somme
sonata	奏鸣曲	sonata
song	歌	however (adv.)
sony	索尼	sony
soo	o	soon
sophie	苏菲	(proper noun) sophie, a first name
sopwith	p	a name
sorbonne	山梨醇	sorbonne, the university in paris (n.)
sos	s	sos
soul	灵魂	soul
soát	控制	control
soạn	组成	compose
spears	长矛	spears
spellman	斯派曼	spellman
spence	斯彭	(proper noun) spence
spencer	斯宾塞	(proper noun) spencer
spielberg	施皮尔贝格	(proper noun) spielberg, as in steven spielberg
sports	体育	sports
sri	斯里	(proper noun) sri, as in sri lanka
ss	ss	ss
st	st	st.
stalingrad	斯大林格勒	stalingrad
stamford	史丹福	this is a name
stand	站立	stand
stanford	斯坦福大学	stanford, as in stanford university
stanley	斯坦利	stanley
starr	斯塔尔	a name
startin	起始	bat dau
status	状态	status
stdc	stdc	stdc
stefan	斯蒂芬	stefan
steiermark	斯蒂马克	steiermark
steiner	施泰纳	steiner
stelzer	斯泰策	stelzer
stennis	斯坦尼斯	stennis
stephen	斯蒂芬	stephen
stephenie	斯蒂芬妮	"stephenie, as in stephenie meyer, author of ""twilight"""
sterling	英镑	a name
steve	史蒂夫	steve
stevens	史蒂文斯	(proper noun) stevens, as in amanda stevens
stevenson	史蒂文森	stevenson
stevie	斯蒂维	stevie
stewarthannah	stewarthannah	stewart/hannah
stf	stf	stf
stimson	斯汀森	stimson, as in henry lewis stimson, former secretary of war
stockholm	斯德哥尔摩	a name
stones	石头	stones
storting	储存	storting
strasberg	施特拉斯堡	strasberg
strauss	施特劳斯	strauss
street	街	street
struct	结构	struct
stt	t	order number
stuart	斯图尔特	stuart
stuttgart	斯图加特	(proper noun) stuttgart, a city in germany
styx	止血针	(proper noun) styx, as in the river styx
stéfano	斯特凡诺	stefano
su	su	condom
subakhi	苏巴基	subakhi
suez	苏伊士	(proper noun) suez
suharto	苏哈托	suharto
sukarno	苏卡诺	(proper noun) sukarno,  president of indonesia
sulfua	硫化物	sulfide
sulu	苏鲁	sulu
sum	总和	reunite
sumatera	苏门答腊	sumatera
sumatra	苏门答腊	(proper noun) the island of sumatra
sumitomo	住友	sumitomo
summer	夏天	summer
summerslam	summerslam	(proper noun) summerslam
sun	太阳	sun
sunday	周日	(proper noun) sunday
sung	无花果	supplement
sunni	逊尼派	sunni
sunsilk	太阳丝	sunsilk, a hair products company
super	超级	super
suriname	苏里南	suriname
susan	苏珊	(proper noun) susan
susilo	苏西洛	(proper noun) susilo
sutra	经	sutra
suub	ub	a name
suvp	suvp	suv-p
suy	受损的	decrease
suê	所以	lush
suôn	顺利地	smooth
suất	生产力	number
suối	流	stream
suốt	整个	through/all over
suồng	顺利	overfamiliar
svd	svd	svd
swan	天鹅	swan
swaziland	斯威士兰	swaziland
sweet	甜蜜的	sweet
sy	sy	sy
sydney	悉尼	(proper noun) sydney, a city in australia
symantec	赛门铁克	symantec
sync	同步处理	sync
syria	叙利亚	syria
sài	赛	"(term should be ""sơ sài"") something done without care (adv.)"
sàn	地板	san
sàng	筛子	ready
sành	陶器	"(term should be ""sành sứ"") pottery"
sào	极点	"(term should be ""sào huyệt"") den or hideout (n.)"
sá	á	road
sách	书籍	list
sái	错了	sai
sám	pent悔	penitent
sáng	我是	light
sánh	比较的	compare
sáo	长笛	flute
sáp	蜡	merger
sát	关闭	"(term should be ""quan sát"") to watch or observe (v.)"
sáu	六	six
sâm	人参	sam
sân	码	"(should be ""sân khấu"") a stage"
sâu	深	deep
sã	桑	flippant
sãi	错的	pagoda warden
são	圣地	sao, as in sao paolo, brazil
sét	雷电	clay
sê	串行	sepon
sêri	系列	series
sêu	苔藓	seu tet
sính	学生	betrothal gifts
síp	塞浦路斯	cyprus
sít	紧	close
sò	牡蛎	oyster
sòng	娱乐场	casino
sóc	松鼠	"(should be ""sóc trăng"") a vietnamese town"
sói	狼	wolf
sóng	挥手	wave
sót	遗漏	to miss (v.)
sô	数	than
sôi	沸腾的	vibrant
sông	河	river
sùng	奉献	cult
sú	黑老虎	a type of mangrove (n.)
súc	牛	animal
sún	下沉	sun
súng	枪	gun
súp	汤	source
sút	开枪	reduce
săn	狩猎	to hunt
sơn	涂上	a mountain
sư	教授	lion
sưa	牛奶	filled with
sưng	肿胀	swell
sưu	收藏品	collection
sương	露水	dew (n.)
sướng	快乐的	high
sườn	排骨	slope
sưởi	加热	heat
sạch	干净的	clean
sạn	旅馆	hotel
sảm	明亮的	sam
sản	生产量	reproductive
sảng	新鲜的	sonorous
sảnh	礼堂	a hall, as in the rock and roll hall of fame
sấm	雷声	ginseng
sấu	鳄鱼皮	crocodile
sấy	干燥的	dry
sầm	大满贯	crowded
sầu	忧郁的	sad
sẩn	丘疹	coarseness
sẫm	黑暗的	dark
sập	崩溃	destroy
sắm	购物	shopping
sắn	木薯	cassava (n.)
sắp	即将	soon
sắt	铁	"(term should be ""sắt son"") constant (adj.)"
sẵn	可用的	available
sẹo	疤痕	scar
sẻ	将	share
sẽ	将	will
sọ	骷髅头	brain
sọc	条纹	stripe
sỏ	厚颜无耻	oligarchy
sỏi	碎石	gravel
số	数	"(term should be ""số lượng"") quantity (n.)"
sốc	震惊	shock
sống	活着	live
sốt	发烧	fever
sồi	橡树	oak
sổ	书	window
sớ	将	document
sớm	早	som
sờ	感动	touch
sỡ	错过了	colorful
sợ	害怕	afraid
sợi	纱线	fibers
sục	水力按摩池	"(term should be ""sôi sục"") to boil"
sụn	软骨	cartilage
sụp	崩溃	collapse
sụt	暴跌	drop
sủa	吠叫	bright
sủi	泡腾的	sparkling
sủng	有魅力的	favored
sứ	瓷器	embassy
sứa	水母	jellyfish (n.)
sức	实力	strength
sứt	碎裂	cleft
sừng	喇叭	sừng sững= huge
sử	历史	"(term should be ""sử dụng"") to use (v.)"
sửa	修复	repair
sửng	震惊	startling
sửu	牛	cow
sữa	牛奶	milk
sự	的	situation
ta	它	us or our
tae	太太	(proper noun) tae
tag	标签	tag
tai	耳	ear
taiji	太极拳	(proper noun) taiji
taipei	台北市	taipei
taiwan	台湾	taiwan
taj	泰姬陵	taj, as in taj mahal
tajikistan	塔吉克斯坦	tajikistan
tajima	田岛	tajima
tajiri	田aj	tajiri
takahashi	高桥	(proper noun) takahashi
taklamakan	塔克拉玛干	taklamakan
tali	塔里	thallium
taliban	塔利班	taliban
talmud	塔尔穆德	talmud
tam	担	three (n.)
tamoxifen	他莫昔芬	tamoxifen
tanaka	田中	tanaka
tang	哀悼	funeral
tanh	腥	deserted
tankōbon	坦克邦	tankobon, as in a type of japanese literature
tanzania	坦桑尼亚	tanzania
tao	我	(proper noun) tao, a chinese name
tarim	塔里木	tarim
task	任务	task
tasman	塔斯曼	tasman, as in abel tasman
tasmania	塔斯马尼亚	tasmania, a place
tau	头	tau
taxi	的士	taxi
tay	手	hand
taylor	泰勒	taylor
tbt	国债	tbt
tchad	乍得	tchad
tcm	厘米	tcm
tcp	tcp	tcp
technical	技术的	technical
ted	泰德	(proper noun) ted
teddy	泰迪	teddy, as in teddy lupin, a character in the harry potter series
telecom	电讯	telecom
telekom	电信	telekom
telex	电传	telex
telnet	远程登录	telnet
tem	印章	stamp
temple	庙宇	temple
temujin	铁木真	temujin
temur	泰米尔	(proper noun) temur, as in temur oljeitu
tenxơ	卡特尔	tensor
teo	萎缩	atrophy
terengganu	登嘉楼	(proper noun) terengganu
territories	领地	territories
terry	毛圈	terry
terumbu	特伦布	(proper noun) terumbu
tet	春节	tet
texas	得克萨斯州	(proper noun) the state of texas
tgv	电视	tgv
tha	tha	to forgive (v.)
thai	怀孕的	pregnant
thailand	泰国	thailand
tham	贪婪	involved
thames	泰晤士河	thames
than	煤	coal
thang	梯子	ladder
thanh	吧	youth
thani	坦尼	thani
thao	体育	sport
thau	黄铜的	a basin (n.)
thay	代替	change
thcn	cn	vocational school
thcs	cs	secondary
thdq	d	thdq
thebes	底比斯	thebes
their	他们的	their
them	他们	plus
then	然后	key
theo	跟随	according to
theory	理论	thẻoy
theravada	上座部	theravada
theres	那里	there
theseus	us修斯	theseus, the greek hero
thi	考试	competition (n.)
thich	喜欢	explanation
thien	天	sky
third	第三	thỉd
thiu	过时的	buồn thiu= sad/boring
thiêm	提姆	thiem
thiêng	神圣的	"(term should be ""thiêng liêng"") sacred or holy"
thiếc	锡	tin
thiến	去势	castrate
thiếp	名片	concubine
thiết	设置	"(term should be ""cần thiết"") necessary (adj.)"
thiếu	不见了	lack
thiềm	镰刀	crescent
thiền	冥想	buddhist (adj.)
thiển	展示	superficial
thiểu	小调	minimum
thiện	好	good
thiệp	贺卡	intervene
thiệt	真的	damage
thiệu	引言	"(term should be ""giới thiệu"") to introduce (v.)"
tho	tho	tho
thoa	轻拍	combination
thoai	ai	gentle
thomas	托马斯	thomas
thompson	汤普森	thompson
thong	丁字裤	(proper noun) thong, as in ang thong
those	那些	those
thoái	回归的	deterioration
thoán	猜	usurpation
thoáng	通风的	"(term should be ""thoáng qua"") to pass quickly"
thoát	退出	drainage
thoại	声音	telephone
thoạt	乍看之下	just (adv.)
thoả	成交	compromise
thoải	舒服的	"(term should be ""thoải mái"") comfortable or relaxing (adj.)"
thoảng	偶尔	"(term should be ""thỉnh thoảng"") occasionally (adv.)"
thoắt	提示	suddenly
thpt	pt	high school
thriller	惊悚片	thriller
thskts	sk	phd- architect
thua	输	defeat
thumb|các	拇指|	thumb|many
thunderbolt	雷电	thunderbolt
thung	山谷	valley
thuyên	排量	a name
thuyết	理论	theory
thuyền	船	boat
thuê	聘请	employ
thuần	纯净的	"(term should be ""đơn thuần"") pure (adj.)"
thuẫn	冲突	support
thuận	优点	favourable
thuật	艺术作品	term
thuế	税款	tax
thuốc	药	medicine (n.)
thuộc	属于	belong
thuớc	水	"(term should be ""kích thước"") dimensions of an object"
thuờng	通常	usually
thuở	童年	period
thuỵ	翠	"(term should be ""thụy Điển"") the nation of sweden (proper noun)"
thuỷ	翠	water
thvn	v	vietnam television
thy	你的	thy
thà	宁愿	honest
thành	到	"(term should be ""hình thành"") to take shape"
thày	老师	teacher
thác	级联	harvest
thách	挑战	challenge
thái	泰国人	attitude
thám	侦探	to spy (v.)
tháng	月	month (n.)
thánh	圣洁的	a holy person; a saint (n.)
tháo	解开	"(term should be ""tháo chạy"") to run with abandon"
tháp	塔楼	tower
thâm	密集的	penetrate
thâu	已记录	to collect (v.)
thây	看	body
thãi	狗屎	superabundant
thèm	渴望	desire
thép	钢铁	steel
thét	尖叫	shout
thê	的	category
thêm	加	more
thêu	绣花	to embroider (v.)
thìa	汤匙	spoon
thìn	然后	(proper noun) thìn, the year of the dragon
thình	突然间	"(term should be ""thình lình"") suddenly"
thí	实验	(with word du) for example
thít	thit	(proper noun) mân thít, a district in vietnam
thò	戳	tho
thòi	劣势	"(term should be ""thiệt thòi"") to cost (adv.)"
thóc	稻田	grain (n.)
thói	习惯	a habit (n.)
thô	粗糙的	rough, old-fashioned
thôi	来吧	only
thông	知情的	"(term should be ""thông thường"") usual (adj.)"
thù	仇	"entire term should be ""ke thu""; means ""enemy"""
thùng	桶	barrel
thùy	耳垂	thuy
thú	有趣的	"(should be ""thích thú"") pleasurable"
thúc	结束	push
thúy	翠	thuy
thăm	拜访	visit
thăng	晋升	helicopter
thơm	香	aromatic
thư	信	"(term should be ""ung thư"") cancer (n.)"
thưa	亲爱的	sparse
thương	爱	love
thước	标尺	ruler
thường	经常	usually (adv.)
thưởng	奖赏	to reward (v.)
thược	ud	(proper noun) thược
thượng	上层	upper
thạc	大师	master
thạch	果冻	rock or stone (n.)
thạnh	桑	thanh
thạo	专家级	fluent
thả	下降	"(term should be ""thả lỏng"") to let loose (v.)"
thải	浪费	waste
thảm	地毯	carpet or rug (n.)
thản	宁静的	calmly
thảo	邵	"(term should be ""hội thảo"") a workshop (n.)"
thấp	低	low (adj.)
thấu	渗透剂	penetrate
thầm	默默地	"(term should be ""thì thầm"") to whisper (v.)"
thần	上帝	"entire term should be ""tinh than""; means ""of the mind"""
thầy	老师	teacher (n.)
thẩm	陪审员	osmotic/leak
thẫm	黑暗的	dark
thận	肾脏	careful
thập	交叉	tens
thật	是真的	true (adj.)
thắm	花瓣	tham
thắn	坦白地说	frank
thắng	赢了	win
thắngthua	文塔	win-lose
thắp	轻的	light
thắt	绑起来	tense
thằn	蜥蜴	"entire term should be ""than lan""; means ""lizard"""
thằng	盖伊	a derogatory term for a man (n.)
thẳm	深	"(term should be ""thăm thẳm"") extremely deep (adj.)"
thẳng	直的	horizontal
thặng	剩余	surplus
thẹn	ham愧	shameful
thẻ	卡	card
thế	所以	"with word ""tu,"" means ""posture"" or ""a position"""
thếp	钢铁	steel
thề	发誓	swear
thềm	架子	shelf
thể	成为	maybe
thỉnh	有时	"(term should be ""thỉnh thoảng"") occasionally"
thịnh	时尚	prosperous
thịt	肉类	meat (n.)
thọ	长寿	phu tho
thọc	刺戳	jab
thỏ	兔子	rabbit
thỏa	协议书	"(term should be ""thoả thuận"") to come to an agreement (v.)"
thỏi	锭	a bar (n.)
thối	烂	smelly
thốt	发出	scream
thồ	包	to transport via horse (v.)
thổ	大地	"(term should be ""lãnh thổ"") territory (n.)"
thổi	吹	blow
thớt	切菜板	sparse
thời	时间	period
thở	呼吸	breathe
thợ	工人	craftman
thụ	受体	"(term should be ""thụ thai"") to become pregnant"
thục	独立	(proper noun) a vietnamese first name
thụt	缩进	clyster
thủ	素数	masturbate
thủa	hua	during childhood
thủng	穿孔	having holes
thứ	东西	no.
thức	醒着	way
thừa	多余的	redundant
thừng	绳子	"(term should be ""thẳng thừng"") mercilessly"
thử	试一试	try
thửa	包裹	square
thự	别墅	mansion
thực	真实的	perform
ti	ti	titov
tia	射线	ray
tiananmen	天安门	tiananmen
tiara	头饰	tiara
tibet	西藏	(proper noun) tibet
tigris	底格里斯河	tigris
tiliaceus	虫	hoa dam but
tim	心	heart
timor	帝汶	timor
timothy	蒂莫西	timothy
tin	相信	believe
tinbắc	讯息	file bac
tincầu	锡桥	file bridge
tinh	星球	"(term should be ""tinh dịch"") sperm (n.)"
tinnhà	tinhome	folder: house
tinsông	新闻	file river
tinthị	ị	file: town
tirol	提洛尔	tirol
tisdale	提斯代尔	tisdale
tish	菜	(proper noun) tish
tissa	蒂莎	(proper noun) tissa, as in moggaliputta tissa
tivi	电视台	television
tizard	蜥蜴	(proper noun) tizard
tiên	首先	first
tiêu	胡椒粉	"entire term should be ""tieu chuan""; means ""a requirement"""
tiếc	不幸的是	"(term should be ""tiếc thương"") to pity (v.)"
tiếm	高飞	seize
tiến	向前	operate
tiếng	小时	language
tiết	分泌物	abstinence/intensity
tiếu	高飞的	"(should be ""đàm tiếu"") to sneer"
tiềm	潜力	potential
tiền	钱	money (n.)
tiều	狗屎	(proper noun) the name of a poet
tiểu	小便	tiểu sử= biography
tiễu	刘先生	patrol
tiệc	派对	party
tiệm	沙龙	shop
tiện	方便的	mean
tiệp	捷克文	gustav franck
tiệt	他妈的	sterilize
tncs	跨国公司	communist youth union
tngt	ng	traffic accidents
tnhh	有限的	limited
toang	汤	fast
tobago	多巴哥	tobago
toei	都营	toei
tokugawa	德川	tokugawa
tokyo	东京	tokyo, the capital of japan
tokyopop	东京流行音乐	tokyopop
tomas	托马斯	(proper noun) tomas
tommy	汤米	tommy
tomoyo	友代	tomoyo
tony	托尼	tony
toonami	香浪	(proper noun) toonami
top	顶	top
torino	都灵	torino, as in the italian city
toriyama	鸟山	(proper noun) toriyama
tottenham	t热刺	tottenham
tourism	旅游	tourism
tourist	旅游者	tourist
toyama	富山	toyama
toyota	丰田	(proper noun) toyota
toà	法院	office
toàn	安全的	entire or whole (adj.)
toán	数学	team
toát	好	to exude or emit, as in sweat (v.)
toạ	座标	locate
toại	在	satisfaction
toả	散发	spread
tp	p	city
tphcm	tphcm	ho chi minh city
tphồ	城市	city ho
tpvĩnh	城市	vinh city
tqlc	tqlc	marine
trafalgar	特拉法加	(proper noun) trafalgar
trafford	特拉福德	trafford in greater manchester
trai	贻贝	boy
trang	页面	a page (n.)
tranh	图片	to compete (v.)
trao	授予	reward
trau	特劳	polish
tre	竹子	bamboo (n.)
treo	悬挂式	hang
tri	三	tri
tribune	论坛报	a name
trinh	处女	"(should be ""trinh bạch"") virtuous"
trinidad	特立尼达	trinidad
trinity	三位一体	trinity
tristan	特里斯坦	tristan
triết	哲学	philosophy
triền	特里恩	"(should be ""triền miên"") endless"
triều	潮汐	court
triện	印章	stamp
triệt	彻底地	completely
triệu	万	a million
tro	灰	ashes
troia	特罗亚	troy
trondheim	特隆赫姆	trondheim
trong	在	inside (adv.)
true	是真的	true
truman	杜鲁门	(proper noun) truman
trung	中间的	"(term should be ""trung gian"") agent (n.)"
trungnhật	诚实	china-japan
truong	ong	truong
truyên	特鲁安	story
truyện	故事	story
truân	特鲁恩	arduous
truất	tract毁者	cancel
truởng	首席	leader (n.)
truỵ	说谎	depraved
trà	茶	tea (n.)
tràm	cajuput	melaleuca
tràng	冒号	"entire term should be ""truc trang""; means ""rectum"""
trào	喷发	movement
trác	trac	trac
trách	怪	blame
trái	向左	against
trán	额头	forehead
tráng	涂层的	to coat (v.)
tránh	避开	to avoid (v.)
tráo	争夺	tráo trở= liar/betrayal/treacherous
tráp	棺材	casket
trát	认股权证	pile
trâm	胸针	a type of elegant hairpin (n.)
trân	最好的问候	respect
trâu	水牛城	a last name
trãi	分散的	trai
trèo	爬上	climb
trên	在	above
trình	服从	process
trí	心智	intellectual
trích	摘录	to extract (v.)
trò	游戏	role
tròn	圆的	rounding
trói	绑起来	tie
trôi	漂流	afloat
trông	看起来	look
trùm	老板	cover
trùng	巧合	"(should be ""tinh trùng"") sperm"
trùy	truy	something to with monk
trú	登机	residence
trúc	竹子	structure
trăm	一百	hundred
trăn	蟒蛇	"(term should be ""trăn trở"") to ponder (v.)"
trăng	月亮	moon
trĩ	痔疮	hemorrhoids
trũng	下沉的	medium
trơ	惰性的	bare
trơn	顺利	slippery (adj.)
trư	特鲁	a pig (n.)
trưa	中午	noon (n.)
trưng	申请书	symbolic
trưngcông	展出	truongcong
trương	特龙	policy
trước	之前	front
trước 	之前	front
trướng	扩展	expand
trườn	爬行	crawl
trường	学校	case
trượng	手杖	a unit of length used in vietnam equal to 4 meters (n.)
trượt	滑	slide
trạch	ch	ze
trại	营地	camp
trạm	站	station
trạng	条件	situation
trạo	trao	trao
trả	支付	to return
trải	遮盖	spread
trảm	cajuput	beheaded
trảo	砍刀	trao
trấn	镇	town
trấu	稻壳	rice skin
trầm	低音	depression
trần	裸露的	tran
trầu	槟榔	trầu
trầy	抓	scratch
trẩy	弹跳	pilgrimage
trẫm	我是	i
trận	比赛	battle
trật	脱臼	order
trắc	生物识别	"(term should be ""trắc ẩn"") to have pity (adj.)"
trắng	白色	white
trặc	打ic	"entire phrase is ""truc trac""; means ""problem"""
trẻ	年轻的	youth
trễ	迟到	late
trệ	停滞不前	bamboo
trị	治疗	cure
trịnh	hn	trịnh, a vietnamese last name
trọ	旅馆	motel
trọn	满满的	whole
trọng	重要的	serious
trỏ	指针	index
trối	最后的	last words
trốn	隐藏	to hide
trống	空的	in
trồi	新兴的	to emerge (v.)
trồng	种植	plant
trổ	展示	to burst open or display
trỗi	出现	rise
trội	显性的	better
trộm	小偷	theft
trớn	深情地	"(term should be ""mơn trớn"") to fondle or caress (v.)"
trời	神	sun
trợ	支持	support
trụ	办公室	universe
trục	轴心	"(term should be ""khu trục"") fighter, in reference to planes (adj.)"
trụi	裸体的	"(term should be ""trơ trụi"") bare (adj.)"
trứ	特鲁	famous
trứng	鸡蛋	egg
trừ	除了	except
trừng	眩光	punish
trừu	抽象的	abstract
trữ	贮藏	reserve
trực	值班	direct
ts	ts	phd
tt	tt	news
tua	触手	fringe
tucker	塔克	tucker, an english last name
tudor	都铎王朝	(proper noun) tudor, as in the tudor family
tukhachevsky	图哈切夫斯基	(proper noun) tukhachevsky
tulip	郁金香	tulip
tum	tum	tum
tung	折腾	release
tupolev	图波列夫	tupolev, as in alexei tupolev
tuscan	托斯卡纳	(proper noun) tuscan
tutsi	图西	(proper noun) tutsi
tuvalu	图瓦卢	(proper noun) tuvalu, a polynesian island nation
tuy	但是	however
tuyên	宣告	"(should be ""tuyên ngôn"") a declaration"
tuyết	大雪	snow (n.)
tuyền	图恩	tuyen
tuyển	招募	recruit
tuyệt	太好了	excellent (adj.)
tuân	服从	comply
tuông	齐平	jealous
tuý	图伊	drug
tuần	周	week
tuế	小鱼	years
tuệ	智慧	intelligence
tuốc	拔毛	turbine
tuổi	年龄	age
tuộc	章鱼	octopus
tuột	滑落	slip
tuỳ	可选的	depend
tv	电视	tv
tvb	电视台	tvb
twin	双胞胎	twin
twitter	叽叽喳喳	twitter
ty	ty	company
type	类型	type
typhon	台风	typhon
tà	邪恶的	we
tài	财富	talent (n.)
tàn	灰烬	dying
tàng	博物馆	"(should be ""bảo tàng"") a museum"
tành	h	shatter
tàu	船	ship
tá	打	"(term should be ""thiếu tá"") major (n.)"
tách	杯子	to separate
tái	再	return
tám	八	eight
tán	天篷	support
tánh	h	life
táp	轻拍	to lap at (v.)
táu	有罪的	ashton
tâm	心智	tâm
tâu	我的主	peach
tây	西	western
tâynam	westnam	"(should be ""tây-nam"") southwest"
tã	尿布	diaper
tét	尖叫声	tet
tê	麻木	numb
tên	名字	name (n.)
tì	脾脏	to lean on (v.)
tìm	找	find
tìmdiệt	搜寻	find-kill
tình	爱	sex
tía	紫色的	dad
tích	产品展示	"(term should be ""tích cực"") to be zealous (adv.)"
tím	紫色的	purple
tín	学分	"(entire term should be ""tín dụng"") credit"
tít	标题	"(term should be ""tít mù"") very far away (adv.)"
tò	好奇心	curious
tòa	法院	a court
tòi	东西	"(term should be ""tìm tòi"") to search doggedly for something (v.)"
tòng	慕道	tòng, a last name
tóm	纲要	summary
tô	碗	car
tôi	我	i
tôm	虾	shrimp
tôn	瓦楞纸	venerate
tông	硬纸板	tông, as in lê thánh tông; first name of an ancient vietnamese emperor
tù	监狱	prison
tùng	备用	tung
tùy	可选的	depend on
túc	充足性	"(term should be ""bổ túc"") to give a refresher course (v.)"
túi	包袋	pocket
túm	抢	catch
túng	尴尬的	confuse
túp	小屋	hut
túy	药	"(term should be ""thuần túy"") pure (adj.)"
tý	老鼠	mouse, as in year of the mouse
tăm	牙签	"(term should be ""tiếng tăm"") reputation"
tăng	增加	increase
tĩnh	静态的	calm
tơi	我	ragged
tư	来自	posture
tưng	摇摇欲坠	"(term should be ""tưng bừng"") joyously (adv.)"
tươi	新鲜的	fresh
tương	类似的	"(term should be ""tương tự"") to be similar to"
tước	剥离	title (n.)
tưới	浇水	irrigation
tướng	一般	prime minister (thu tuong)
tường	墙	"a common vietnamese first name; means ""wall"""
tạ	杠铃	weight
tạc	雕刻	"(term should be ""oanh tạc"") to bomb from the air (v.)"
tại	在	survival
tạm	临时的	temporary
tạo	创造	create
tạp	杂志	"(should be ""hỗn tạp"") a jumble or mish-mash"
tả	说明	describe
tản	耗散	disperse
tảng	平台	platform
tấc	英寸	inch
tấm	盘子	mirror
tấn	吨	tan
tấp	拉	crowded
tất	袜子	all
tấu	工具性的	tau
tầm	游戏类	range or extent (n.)
tần	频次	"(term should be ""tần số"") frequency (n.)"
tầng	地板	layer
tầu	火车	ship
tẩm	浸渍的	soak
tẩy	橡皮擦	to bleach
tận	结束	dedicated
tật	残疾	disease
tắc	开关	priciple
tắm	洗个澡	bathing
tắt	关	initial
tặc	骇客	"(term should be ""hải tặc"") a pirate (n.)"
tặng	捐赠	donate
tẻ	单调的	lẻ tẻ= scattered
tết	春节	(proper noun) the vietnamese new year
tếxã	经济地	economy - society
tề	像样	tidy
tể	先生	lord
tệ	不好	bad
tệp	档案	file
tỉa	修剪	"(term should be ""bắn tỉa"") to snipe"
tỉnh	省	province
tị	羡慕	refugee
tịch	社长	"(""chủ tịch"") president or chairman"
tọa	座标	"(term should be ""chủ toạ"") chairman (n.)"
tỏ	表达的	to
tỏa	散发	radiate
tỏi	蒜	garlic
tốc	速度	speed
tốn	费用	to cost (v.)
tống	护送	dispose
tốp	帮派	top
tốt	好	good
tồi	不好	bad
tồn	存在	exist
tổn	伤了	damage
tổng	合计	president
tộc	氏族	"(term should be ""dân tộc"") a race or people"
tội	犯罪	crime
tột	极端的	extreme
tớ	我	servant
tới	到	to the point
tờ	床单	paper/document
tởm	恶心的	disgusting
tục	亵渎	"(term should be ""tập tục"") customs or practices"
tụy	胰腺	"(term should be ""tận tụy"") devoted (adj.)"
tủ	橱柜	shelf
tủi	不好	humiliated
tủy	延髓	spine
tức	瞬间	i.e.
từ	来自	from
từng	每个	each
tử	死亡	lion (su tu)
tửu	喝酒	wine
tự	自我	"(term should be ""tương tự"") like or similar to (adv.)"
tựa	头衔	lean
tựu	成就	achievement
tỵ	蛇类	the han name for the year of the snake, according to the chinese zodiac
tỷ	十亿	billion
u	ü	tumor
ua	ua	ua
uae	阿联酋	uae
ubuntu	ubuntu	ubuntu
uc	uc	uc
uchiha	宇智波	uchiha
uefa	uefa	uefa
uh	嗯	uh
uk	英国	uk
ukiyoe	浮世绘	ukiyoe
ukraina	乌克兰语	ukraine
ulsan	蔚山	ulsan
umm	嗯	umm
un	联合国	(proper noun) un, as in chung un chan of korea
und	和	und
under	在...之下	under
unesco	联合国教科文组织	unesco
ung	ung	cancer
unicorn	独角兽	unicorn
unit	单位	unit
unix	unix	unix
up	起伏	up
ural	乌拉尔	ural, as in the ural mountains
urani	铀	uranium
uri	乌里	uri, a former political party in south korea
uruguay	乌拉圭	uruguay
usagi	宇佐木	usagi
usb	usb	usb
uss	美国	uss
utah	犹他州	utah
utrecht	乌得勒支	(proper noun) utrecht
uy	y	"(term should be ""uy lực"") power (n.)"
uyghur	维吾尔族	(proper noun) uyghur
uygur	维吾尔族	uygur
uyên	乌en	scholarly
uyển	委婉语	"(term should be ""uyển chuyển"") flexible (adj.)"
uzbekistan	乌兹别克斯坦	uzbekistan
uông	翁	uong
uất	ấ	busy
uốn	弯曲	to curl (v.)
uống	喝	to drink
uổng	浪费	vain
v	v	v
va	va	collide
vaccine	疫苗	vaccine
vai	肩	shoulder
valencia	巴伦西亚	valencia
valentine	情人	valentine
valley	山谷	valley
van	货车	"(term should be ""van xin"") to beg (v.)"
vanessa	凡妮莎	vanessa
vargas	瓦加斯	(proper noun) vargas
vasari	瓦萨里	vasari
vay	借	borrow
vectơ	向量	vector
ven	文	"(term should be ""ven biển"") coastal (adj.)"
vendôme	旺多姆	vendome
venezia	威尼斯	venice
venus	金星	venus
verdun	凡尔登	verdun
vermont	佛蒙特州	vermont
verona	维罗纳	(proper noun) the city of verona
versailles	凡尔赛宫	(proper noun) versailles
vhs	甚高频	vhs
vi	六	behavior
viagra	伟哥	viagra
victor	胜利者	(proper noun) victor
victoria	维多利亚	victoria, a province of australia
vienna	维也纳	(proper noun) vienna, austria
viet	越	vietnamese
vietnam	越南	vietnam
viettel	维特尔	viettel
viii	八	eighth
vijaya	维贾亚	(proper noun) vijaya
viking	维京人	viking
villa	别墅	villa
villeneuve	维尔纽夫	(proper noun) villeneuve, a french last name
vinagame	vinagame	vinagame
vinashin	vinashin	vinashin
vince	文斯	(proper noun) vince, as in vince mcmahon
vincennes	万森纳	vincennes
vincent	文森特	vincent
vinpearl	珍珠贝	vinepeal
viqr	viqr	viqr
virginia	弗吉尼亚州	(proper noun) virginia, as in the state
virus	病毒	virus
virút	病毒	virus
vissarionovich	维萨里奥诺维奇	vissarionovich
vista	远景	vista, as in windows vista
vitamin	维他命	vitamin
vitruvius	维特鲁威	vitruvius
viz	即	(proper noun) viz
viêm	发炎	inflammation
viên	平板电脑	member
viêng	ng	vientiane
viêt	写作	vietnam
viếng	拜访	visit
viết	写	write
việc	工作	thing
viện	研究所	institute
việt	越南文	viet
việtmường	越南孟人	muong
việtnga	越南	vietnam-russia
việttrung	越南	vietnam-china
vn	n	vietnam
vnexpress	vnexpress	(proper noun) vnexpress
vni	vni	vni
vo	vo	"(term should be ""tròn vo"") perfectly round (adj.)"
voi	象	elephant
voip	语音	voip
voldemort	伏地魔	(proper noun) voldemort, the villain from the harry potter series
von	冯	compare
vonfram	钨	wolfram
vong	伤亡人数	injured
voyager	航海家	voyager
voọc	叶猴	a langur (n.)
vtc	录像机	vtc
vu	u	"entire phrase is ""vu cao""; means ""to accuse wrongly"""
vua	国王	king
vui	好玩	happy
vulcan	火神	vulcan
vuông	方	square
vuốt	爪子	stroke
vv	等	etc.
vy	维	vy
vyacheslav	维亚切斯拉夫	vyacheslav
và	和	and
vài	几个	several
vàm	虚拟机	the mouth of a rivulet (n.)
vàng	金币	gold
vành	轮辋	coronary
vào	在	into
vá	补丁	patchy
vác	携带	to shoulder (v.)
vách	墙	wall
vái	是的	some
ván	木板	game
váng	败类	film
váy	裙子	skirt
vân	依此类推	"(term should be ""vân vân"") et cetera"
vây	鳍	encircle
vã	冲了	rush
vãi	狗屎	to release
vãn	范	save
vè	小便	to glance slyly (v.)
vé	车票	ticket
vét	疏edge	plunder
vê	关于	tremolo
vì	因为	because
ví	钱包	example
vía	钱包	soul
vít	螺丝	screw
vò	皱巴巴的	jar
vòi	胶管	tap
vòm	拱门	upper jaw
vòng	圆的	around
vó	hoo	hooves
vóc	体质	"(should be ""vóc sương"") dew-like or delicate"
vô	没有啦	"(term should be ""vô số"") countless (adj.)"
vôi	青柠	limestone
võ	武术	martial arts (n.)
võng	吊床	hammock
vùi	埋葬	"(term should be ""chôn vùi"") to bury or keep secret (v.)"
vùng	地区	region
vú	乳房	breast (n.)
vút	飙升	"entire term should be ""cong vut""; extreme curling"
văn	发表于	culture
văng	飞溅	a name
vĩ	太好了	"(term should be ""vĩ đại"") great (adj.)"
vĩnh	永久地	ving
vũ	u	armed
vũng	水坑	vung
vơ	无助	lost
vơi	与	ullage
vưu	ư	"actual term is ""xi vưu""; proper noun; name of a leader of a people in chinese legend"
vươn	达到	reach
vương	金王	kingdom
vướng	纠缠	"(term should be ""vướng víu"") to become involved in (v.)"
vườn	花园	garden
vượn	猿类	gibbon
vượt	通过	to overcome
vạ	所以	unfortunate problem
vạc	大锅	cauldron
vạch	吧	bar
vại	战车	jar
vạn	一万	thousand
vạng	暮光之城	twilight
vả	无花果	hard
vải	布	fabric
vảy	秤	scale
vấn	忠告	vấn đề= problem
vấp	迷迷糊糊	stumble
vất	丢掉	hard
vần	韵	spell
vầng	光环	moon (vang trang)
vẩn	还是	wander
vẩy	片状	scale
vẫn	还是	still
vẫy	挥手	wave
vận	财富	active
vắc	疫苗	vaccine
vắcxin	疫苗	vaccine
vắn	简短的	short
vắng	缺席的	absent
vặn	螺丝	to twist (v.)
vặt	分类	odd
vẹn	正直	complete
vẹt	鹦鹉	parrots
vẽ	画	draw
vết	污点	wound
vểnh	栖息	warping
vệ	防御	"(term should be ""bảo vệ"") to defend (v.)"
vệt	条纹	streak
vỉa	接缝	"(term should be ""vỉa hè"") sidewalk"
vịnh	海湾	bay
vịt	鸭子	duck
vọng	希望	"(term should be ""hy vọng"") hope (n.)"
vọt	暴涨	to spurt out (v.)
vỏ	贝壳	shell
vồ	木槌	"(term should be ""gạch vồ"") a type of brick"
vỗ	拍拍	to clap
vội	赶快	hurriedly (adv.)
vớ	袜子	"(term should be ""vớ vẩn"") silly (adj.)"
với	与	to
vớt	打捞	salvage
vờ	假装	"(term should be ""giả vờ"") to pretend (v.)"
vời	太好了	wonderful
vở	笔记本	"(term should be ""vở kịch"") a play"
vỡ	坏了	break
vợ	老婆	wife
vụn	筹码	debris
vụng	笨拙的	covert
vứt	丢掉	throw away
vừa	中等	just (adv.)
vừng	芝麻	sesame (n.)
vững	坚定的	firm (adj.)
vực	场	place
vựng	词汇量	"(term should be ""từ vựng"") regional vocabulary (n.)"
vỹ	所以	majestic
w	w	w
wa	wa	wa
walt	沃尔特	(proper noun) walt, as in walt disney
walter	沃尔特	walter
walther	沃尔特	walther
wan	wan	wan
wang	王	wang
wankel	旺克尔	(proper noun) wankel
wanna	想	wanna
warren	沃伦	a name
warsaw	华沙	warsaw
warszawa	华沙	(proper noun) warsaw
washington	华盛顿	(proper noun) washington
wat	at	(proper noun) wat, as in angkor wat, the temple in cambodia
watergate	水门	watergate
waterloo	滑铁卢	(proper noun) waterloo
waters	水域	waters
wayne	韦恩	wayne
wcdma	wcdma	w-cdma
weasley	韦斯莱	weasley, as in ron weasley in the harry potter series
weblog	网志	weblog
webmail	网络邮件	ưebmail
weimar	魏玛	(proper noun) weimar
wellington	惠灵顿	wellington
wells	井	wells, as in author orson wells
welsh	威尔士语	(proper noun) welsh, as in the welsh language
wembley	温布利	wembley, as in wembley stadium
werner	维纳	werner
westermarck	韦斯特马克	westermarck
western	西方的	western
westlife	西部生活	westlife
westview	西景	westview, as in westview press
wheeler	惠勒	a name
widener	加宽	widener
wien	维恩	wien
wiener	维纳	wiener
wifi	无线网络	wi-fi, a technology term
wiki	维基	wiki
wikia	维基	a name
wikibooks	维基书籍	(proper noun) wikibooks
wikimapia	维基百科	wikimapia
wikimedia	维基媒体	wikimedia
wikitravel	维基旅行	a name
wild	野性的	wild
wilder	更狂野	(proper noun) wilder, as in billy wilder
wiley	威利	wiley
willard	威拉德	willard
wimbledon	温布尔登	wimbledon
windows	窗户	windows
winer	温纳	winer
wisconsin	威斯康星州	(proper noun) wisconsin
within	内	within
without	没有	without
wolfgang	沃尔夫冈	wolfgang
won	赢了	won
wong	黄	wong
woodrow	伍德罗	woodrow
woods	树林	(proper noun) woods, as in tiger woods
would	会	would
wrestling	摔角	wrestling
wright	赖特	a name
wu	wu	wu
wushu	武术	wushu, a type of martial art
wwf	万维网	wwf
xa	很远	ancient
xang	ang	"(term should be ""lan xang"") name of an ancient country in southeast asia"
xanh	绿色的	green
xao	松弛	xôn xao = chatting
xay	磨	grind
xe	车	a car (n.)
xem	看	watch
xen	en	to insert (v.)
xhcn	h	social republic
xi	xi	xi
xiii	十三	eighth
xin	拜托	please
xinh	美丽的	beautiful
xiv	十四	fourteenth
xiêm	连体	(proper noun) xiêm, or siam
xiên	倾斜的	oblique
xiêu	小	soften
xiếc	马戏团	circus
xiết	收紧	to twist tightly (v.)
xiềng	ckle锁	chain
xo	o	spring
xoa	擦	massage
xoay	旋转	turn
xong	做完了	completed
xoàng	平庸的	mediocre
xoá	删除	delete
xoáy	旋流	vortex
xoắn	扭曲的	coiled
xu	美分	trend
xua	驱散	dispel
xuan	uan	"(term should be ""xuân"") a common vietnamese middle or first name; means ""the season of spring"""
xui	倒霉的	incite
xuka	徐卡	xuka
xum	茂盛的	a name
xuyên	刺穿	frequently
xuyến	躯干	manage
xuân	春天	spring
xuâncông	春天	xuan public
xuôi	扫过	down
xuất	出口	ejaculate
xuấtnhập	出口	import/export
xuống	下来	down
xuồng	独木舟	boat
xv	十五	fifteenth
xvi	十六	xvi
xvii	vi	xvii
xx	xx	xx
xy	y	cylinder
xài	花费	use
xào	炒	stir fry
xách	手袋	to carry by the handle (v.)
xám	灰色的	ustox
xán	炒	"(term should be ""xán lạn"") bright (adj.)"
xáo	扰动	chaos
xát	擦	touch
xâm	纹身	invasion
xâu	弦	string
xây	建立	build
xã	公社	society
xãy	善变的	occur
xèo	è	xeo
xé	眼泪	tear
xén	裁剪	"(term should be ""biếu xén"") to gift (v.)"
xéo	倾斜的	diagonally (adv.)
xét	考虑	examine
xê	移动	"(term should be ""bánh xu xê"") a type of vietnamese cake"
xêkô	顺野	xeko
xì	放屁	scandal
xìu	放屁	to become flaccid (v.)
xí	工厂	factory (xi nghiep)
xít	令人着迷	nazi
xíu	细小	small
xòe	传播	spread
xóa	删除	clear
xói	侵蚀	erode
xóm	邻居们	village
xót	怜悯	mercy
xô	斗	soviet
xôi	糯米	pierce
xôn	搅动	tumultuous
xông	冲了	rush
xôphần	铲斗部分	soviet-poland
xôviết	苏联	soviet
xù	uffle	gigantic
xú	粗鲁的	xu
xúc	联系方式	touch
xúi	招惹	induce
xăm	刺青	"(term should be ""xa xăm"") far away (adj.)"
xăng	汽油	gasoline
xơ	纤维	xo
xưa	旧的	old
xưng	认罪	"(should be ""tự xưng"") self-proclaimed"
xương	骨头	bone (n.)
xước	抓	scratch
xướng	合唱团	provoke
xưởng	车间	workshop
xạ	放射线	"(term should be ""phản xạ"") to reflect"
xả	放电	release
xảo	狡猾的	detailed
xảy	发生	happen
xấp	大约	approximate
xấu	不好	bad
xẩm	毛茸茸的	a type of traditional vietnamese singing
xẩy	发生	occur
xắt	切	cut
xẻo	倒霉的	cut off
xếp	折叠的	rank
xỉ	炉渣	approximately
xỉa	牙线	to pick (v.)
xỉu	微弱	to faint
xốc	震惊	to lift up (v.)
xốp	多孔的	porous
xổ	抽奖	rush into
xộn	凌乱的	messy
xứ	制成的	native
xứng	值得	appropriate
xử	对待	judge
y	健康	medical
y=fracsin	y =果胶	a function
ya	亚	(proper noun) ya, as in ya trang
yakovlev	亚科夫列夫	yakovlev
yakushima	屋久岛	yakushima
yalta	雅尔塔	(proper noun) yalta
yankee	扬基	(proper noun) yankee
yard	码	yard
yasha	雅莎	a name
yeeun	艺恩	(proper noun) yeeun
yeltsin	叶绿素	yeltsin, as in boris yeltsin
yemen	也门	yemen
yersin	叶尔辛	(proper noun) yersin, asin alexandre yersin
yi	yi	(proper noun) yi
ying	ying	(proper noun) ying, as in ying yang
ymca	伊姆卡	ymca
yo	哟	yo
yomiuri	读卖	yomiuri
yoochun	chun春	yoochun
york	约克	york
yorker	约克	yorker
yorkshire	约克郡	yorkshire
youtube	youtube	youtube
ypres	伊普尔	ypres
ytv	电视台	ytv
yu	宇	yu
yuan	元	(proper noun) yuan, as in yuan mu
yucatán	尤卡坦州	yucatan, as in the yucatan peninsula
yudhoyono	尤多约诺	(proper noun) yudhoyono, as in indonesian president susilo bambang yudhoyono
yugi	汤木	yugi
yukito	幸人	yukito
yume	梦	(proper noun) yume
yunho	云浩	yunho
yuri	尤里	yuri, as in soviet pilot and cosmonaut yuri alekseyevich gagarin
yurt	蒙古包	yurt
yên	日元	peace or stillness (n.)
yêu	爱	love
yếm	工作服	tender
yến	燕窝	a type of swallow (n.)
yết	上市	yet
yếu	弱	mainly
yểm	遮盖	support
yển	en	"is a name meaning, ""bird"""
yểu	可爱的	"(term should be ""yểu điệu"") graceful (adj.)"
z	ž	z
zac	扎克	zac
zambia	赞比亚	(proper noun) zambia, as in the nation
zealand	新西兰	(proper noun) zealand, as in new zealand
zedong	泽东	mao zedong
zero	零	zero
zeus	宙斯	zeus
zheng	heng	zheng
zhukmse	朱克塞	zhuk-mse
zimbabwe	津巴布韦	zimbabwe
zinedine	齐尼丁	(proper noun) zinedine
zing	zing	zing, as in the website
zoe	佐伊	zoe
zurich	苏黎世	(proper noun) zurich
zürich	苏黎世	(proper noun) zurich, as in zurich, switzerland
|nguyễn	|阮	a common vietnamese last name
|nổi	|浮点数	"(term should be ""nổi"") to float (v.)"
|petya	| petya	(proper noun) petya
|tên	|名称	"(should be ""tên"") name (n.)"
|việt	|越南语	vietnam
 kg	公斤	kg
 triệu	万	million
 °c	°c	degrees celsius
°đến	°至	up to
°độ	°度	degree
×	×	x
ào	哇	rush
á	á	asia
ác	邪恶的	evil
ách	轭	yoke (n.)
ái	渴望	ai
ám	渲染	(with the word chi) to hint at
ánh	光泽	light
áo	外套	clothe
áohung	奥雄	"(term should be ""Áo-hung"") austria-hungary"
áp	压力	"(term should be ""huyết áp"") blood pressure (n.)"
áâu	葵	eurasian
â	â	a vietnamese vowel sound
âm	负面的	vagina
ân	宠爱	deed
én	燕子	swallow
ép	压	press
êgê	自我	aegean
êm	顺利	smooth
ích	有用的	benefit
ílam	伊兰	tamil language name for the island of sri lanka
ít	小	less
île	île	Île, as in Île de la cité, france
îledefrance	îledefrance	ile-de-france
ðiều	文章	article
ðài	ðài	taiwan
ðường	糖	a road
ðảng	派对	party
ðức	德国	"Đức, a common vietnamese first name; means ""virtue"""
ó	ó	(with the word la) to boo down
óc	脑子	brain
óng	虹彩的	"(term should be ""óng ả"") flexible"
ôi	哦	"vietnamese version of the exclamation ""oh"""
ôm	拥抱	hug
ôn	适度	peaceful (on hoa)
ông	先生	a man (n.)
ôtô	汽车	car
ôxi	氧气	oxygen
ôxy	氧气	the element oxygen (n.)
ôxít	氧化物	oxide
ôzôn	臭氧	ozone
ùn	卡纸	congest
úng	浸水的	flood
úp	面朝下	upside
úy	中尉	"(term should be ""thiếu úy"") second lieutenant (n.)"
ý	义大利	italian
ăn	吃	eat
ăng	蚂蚁	antenna
ăngten	天线	antenna
đa	多	majority
đai	皮带	"(term should be ""Đai khố"") name of a village"
đak	达克	(proper noun) Đak
đan	针织	scandal
đau	痛	painful
đay	黄麻	jute, a type of vegetation the vietnamese use to make soup (n.)
đb	分贝	dien ban
đcstq	dcstq	communist party of china
đcsvn	dcsvn	vietnam communist party
đe	铁砧	threaten
đem	带上	to bring (v.)
đen	黑色的	black
đentrắng	黑白色	"(term should be ""đen-trắng"") black-and-white (adj.)"
đeo	穿	wear
đh	đh	university
đhcn	đcn	university of industry
đhtm	dhtm	university of economics
đhông	东区	dhong
đi	去	go
điên	疯了	crazy
điêu	东西	sculpture
điôxít	二氧化碳	dioxide
điạ	ạ	dia
điếc	聋人	heron
điếu	卷烟	funeral oration
điềm	预兆	omen
điền	填写	estate
điều	东西	control
điểm	点	bearing point
điển	辞典	"(term should be ""từ điển"") a dictionary"
điểu	操	thing
điệp	讯息	spy
điệu	语气	memorial
đo	量度	measure
đoa	杜阿	doa
đoan	可表现的	extreme
đom	萤火虫	firefly
đoài	芒果	the west
đoàn	联合会	an organization or group (n.)
đoái	交换	"(term should be ""hối đoái"") to exchange or trade (v.)"
đoạn	段落	a stage or phase (n.)
đt	đt	training
đtđ	手机	diabetes
đua	种族	emulate
đui	盲目的	blind
đun	烧开	cook
đuôi	尾巴	tail
đuốc	火炬	a torch
đuối	淹死	drowning
đuống	干	(proper noun) Đuống, the name of a river
đuổi	追逐	pursue
đài	广播电台	statue
đàm	会谈	negotiation
đàn	牛群	musical instrument
đàng	是的	side
đào	桃子	train
đày	流放	exile
đá	石头	to kick
đái	小便	pee
đám	部落	dam
đán	丹	"(term should be ""tết nguyên Đán"") vietnamese new year's day"
đáng	值得	deserve
đáo	独特的	unique
đáp	回答	response
đát	土地	"(term should be ""bi đát"") lamentable (adj.)"
đâm	刺	pierce
đâu	在哪里	anywhere
đây	在这里	below
đã	是	already
đãi	对待	"(should be ""bạc đãi"") to ill-treat"
đãng	好色的	dissolute
đè	覆写	to press on
đèn	灯	light
đèo	通行证	a mountain pass (n.)
đê	堤	a dike (n.)
đêm	夜晚	night
đênh	降压	lênh đênh= float to unknown
đích	目的地	goal
đính	附上	attached (adj.)
đò	轮渡	a ferry (n.)
đòi	声称	require
đòn	吹	welcome
đó	那	that or there (adv.)
đóa	h	"(term should be ""đoá hoa"") a flower bloom"
đói	饿了	hungry
đón	皮卡	welcome
đôi	双倍	sometimes
đôla	美元	dollar
đôn	敦促	london
đông	东	eastern
đôngbắc	东	north-east
đôngnam	东南	south-east
đôngtây	东	"(term should be ""đông-tây"") east-west (adj.)"
đôrêmi	ra啦a梦	(proper noun) Đôrêmi
đôrêmon	ra啦a梦	doreamon
đùa	开玩笑	joke
đùi	大腿	thigh
đúc	铸件	"(term should be ""đúc kết"") to sum up (v.)"
đúng	对的	right
đúp	双倍	double
đút	放弃	"(term should be ""đút lót"") to bribe"
đăk	达克	dak
đĩ	荡妇	whore/bitch
đĩa	磁碟	disk
đơ	僵硬	stiff or rigid (adj.)
đưa	给予	girl
đường	糖	pathway
được	好吧	is not
đạ	贾	da
đại	太好了	eagle
đạm	蛋白质	plain
đạn	子弹头	bullet
đạo	宗教信仰	vagina
đạp	踢	to step on
đạt	达到	reach
đả	打架	to hit
đảm	保证的	"(term should be ""đảm nhiệm"") to undertake (v.)"
đản	生日	a group or flock (n.)
đảng	派对	party
đảo	岛	an island (n.)
đấm	打孔	punch
đấng	神	the
đất	土	country
đấtmặt	地面	datmat
đấy	在那里	ignore
đầm	着装	swamp
đần	哑巴	"(term should be ""đần độn"") stupid or ignorant (adj.)"
đầu	顶部	start
đầy	满满的	"(term should be ""đầy đủ"") adequate or enough"
đẩu	头	"(entire term is ""khoa đẩu"") ancient phonetic script used in vietnam"
đẩy	推	to push
đẫm	湿透了	wet
đậm	粗体	dense
đậu	豆类	to park (v.)
đậy	遮盖	cover
đắc	获得	effectively
đắm	破坏	sink
đắn	礼仪	proper (dung dan)
đắng	苦	bitter
đắp	上	"(term should be ""bù đắp"") to compensate (v.)"
đắt	贵的	expensive
đằng	超过	back
đẳng	等距	equality
đặc	特别的	"(term should be ""đặc biệt"") special (adj.)"
đặn	定期的	regularly
đẹp	美丽的	beautiful
đẽ	很好	beauty
đế	鞋底	empire
đếm	算	to count (v.)
đến	到了	come
đề	线程数	promote
đền	庙宇	"(term should be ""đền thờ"") a religious shrine"
đều	是	all
để	到	for
đệm	坐垫	middle name
đỉnh	顶峰	the summit or peak
địch	敌人	enemy
định	指定的	appointed
đọ	进站	compete
đọan	段落	period
đọc	已读	read
đọng	停滞不前	deposit
đỏ	红色的	red (adj.)
đốc	总督	admiral
đối	为	face
đốm	斑点	spot
đốn	减少	"(term should be ""suy đốn:) to be worse off"
đống	堆	line
đốt	燃烧的	burn
đồ	地图	thing
đồi	丘陵	hill
đồn	传闻	rumour
đồng	铜	agreeable
đổ	棚	dump
đổi	改变	to change (v.)
đổng	马头	"(term should be ""đồng bằng"") a delta"
đỗ	停放	pass
độ	学位	"term should actually be ""độ cao""; means ""height"""
độc	有毒的	alone
độn	填充	chaos
động	动态的	action
đột	突然间	"(term should be ""xung đột"") conflict (n.)"
đới	禅	tropical
đời	一生	generation
đỡ	支持	help
đợi	等一下	thigh
đợt	批处理	fit
đục	不透明的	turbid
đụn	沙丘	dune
đụng	触碰	encounter
đủ	足够	enough
đứa	孩子们	child
đức	德国	virtue (n.)
đứng	站立	to stand (v.)
đứt	坏了	cut off
đừng	不要	not
đực	男	male
đựng	包含	suffer
đựoc	好吧	be
ĩ	喔喔	"(term should be ""ầm ĩ"") noisy"
ơ	喔喔	"(term should be ""thờ ơ"") to be indifferent (adj.)"
ơi	y	"vietnamese equivalent of english ""oh"""
ơn	谢谢啦	thank
ư	ü	vowel sound found in the vietnamese alphabet (n.)
ưa	首选	to like (v.)
ưng	哦对了	to accept (v.)
ưu	优点	"(term should be ""ưu việt"") preeminent (adj.)"
ươi	红毛猩猩	orangutan
ươm	苗圃	nursery
ương	中环	central
ướp	腌制	mummy
ướt	湿的	wet
ạ	先生	a word added to the end of a response to show respect to someone in a position of authority, as in a child to a parent
ạt	赶	(with word o) to crowd
ải	ả	pass
ảnh	照片	picture
ấm	温暖的	warm
ấn	按	press
ấnâu	打印	"(term should be ""Ấn Âu"") a grouping of languages including european and indian languages that are thought to have originated from a single earlier language (adj.)"
ấp	小村庄	district
ấu	年轻的	childhood
ấy	那	that
ẩm	湿润的	humidity
ẩn	隐藏	hidden
ập	bang	rush
ắt	当然可以	sure
ếch	青蛙	frog
ỏi	薄荷的	little
ố	哦	"(term should be ""hoen ố"") stained and smeared (adj.)"
ốc	蜗牛	building
ốm	生病了	sick
ống	管子	tube
ốp	切线	omelette
ồn	杂音	noisy (adj.)
ổ	开车	hard drive
ổi	番石榴	guava (n.)
ổn	好吧	peace
ớn	大的	posts
ớt	辣椒	chili
ở	在	at
ủ	孵化	"(term should be ""ủ dột"") gloomy (adj.)"
ủi	铁	"(term should be ""an ủi"") to comfort (v.)"
ủng	靴子	boot
ủy	专员	commission
ứ	是的	to pool together (v.)
ức	乳房	memories
ứng	申请书	corresponding
−−	--	__
≠	≠	different
