$ tỉ	$ miljard	$ billion
abc	abc	abc
abdul	abdul	abdul
abkhazia	abchazië	a name
about	over	about
abraham	abraham	abraham
abrams	abrams	abrams
abscbn	abscbn	abscbn
account	account	account
aceh	aceh	(proper noun) aceh
achilles	achilles	achilles
acia	acia	acia
acid	zuur	acid
ada	ada	ada
adams	adams	(proper noun) adams
addisonwesley	addisonwesley	(proper noun) addison-wesley
adn	adn	adn
adobe	adobe	adobe
adrian	adrian	(proper noun) adrian
adsl	adsl	adsl
advanced	geavanceerd	advanced
aedes	aedes	aedes
aegypti	aegypti	aegypti
aero	aero	(proper noun) aero, as in the aero l-39 albatros jet
afc	afc	afc
aff	aff	aff
afghanistan	afghanistan	afghanistan
africa	afrika	(proper noun) africa
african	afrikaanse	african
ag	ag	ag
agasa	agasa	(proper noun) agasa, as in hiroshi agasa
agassi	agassi	agassi
ai	who	who
ailen	iers	ailen
aim	doel	aim
air	lucht	air
airbus	luchtbus	airbus
aisne	aisne	aisne
ajax	ajax	ajax
ak	ak	ak
akatsuki	akatsuki	akastuki
akms	akms	akms
akô	hallo	ako
al	al	al
alabama	alabama	alabama
alaska	alaska	alaska
albania	albanië	albania
albatros	albatros	(proper noun) albatros, as in the aero l-39 albatros
albert	albert	(proper noun) albert
alberto	alberto	(proper noun) alberto
albion	albion	albion, an ancient name for great britain
albuquerque	albuquerque	albuquerque
albus	albus	albus
alexa	alexa	alexa
alexandra	alexandra	alexandra
alexandria	alexandrië	alexandria
alexandros	alexandros	alexandros
alexey	alexey	alexey
alfred	alfred	(proper noun) alfred, as in alfred kinsey
algérie	algérie	algerie
ali	ali	ali
alice	alice	this is a name
allan	allan	(proper noun) allan, as in edgar allan poe
allen	allen	(proper noun) allen
allmusic	alle muziek	allmusíc
alois	alois	alois
alonso	alonso	alonso
alpher	alfer	(proper noun) alpher
alps	alpen	alps
altai	altai	altai
always	altijd	luon luon
amaravati	amaravati	amaravati
amazon	amazon	amazon
amdo	amdo	(proper noun) amdo
ame	ame	ame
ami	ami	ami
amiens	amiens	amiens
amin	amine	(proper noun) amin, as in nagib amin
amm	amm	amm
amoniac	ammoniak	ammonium (n.)
amphitrite	amphitrite	(proper noun) amphitrite, a greek sea goddess
an	een	"(should be ""an toàn"") safe"
anand	anand	anand
anata	anata	anata
anatolia	anatolië	anatolia
andalusia	andalusië	andalusia
andaman	andaman	andaman
anderson	anderson	anderson
andes	andes	andes
andorra	andorra	andorra
andrew	andrew	andrew
andré	andré	andre, as in andre morval
andy	andy	(proper noun) andy, as in andy warhol
anfield	anfield	anfield
ang	ang	ang
angkor	angkor	(proper noun) angkor, as in angkor wat, the temple in cambodia
anglosaxon	anglosaxon	anglo-saxon
anh	broer	english
anhmỹ	brits	"(term should be ""anh mỹ"") english or american"
anhpháp	engels frans	england-france
ankara	ankara	ankara
ankyl	ankyl	ankly
anna	anna	anna
annam	an nam	a name the way french called middle vietnam as a colony
annan	annan	annan
anne	anne	anne, a name
anorthosit	anorthosit	anorthosit, a type of igneous rock (n.)
anthony	anthony	anthony
antigua	antigua	(proper noun) antigua
anton	anton	anton
antonov	antonov	antonov
any	ieder	any
anđêhít	aldehyde	aldehydes
ao	vijver	pond
aotearoa	aotearoa	aotearoa
apollo	apollo	apollo
apple	appel	apple
aquinas	aquinas	a name
arab	arab	(proper noun) arab
archetypal	archetypisch	archetypal
archive	archief	archive
arctan	arctan	a function
ares	ares	ares
argentina	argentinië	(proper noun) the south american nation of argentina
argo	argo	argo
arias	aria&#39;s	arias
aringarosa	aringarosa	aringarosa, as in manuel aringarosa
aristotle	aristoteles	aristotle
arizona	arizona	arizona, as in the state
ark	ark	ark
arkansas	arkansas	arkansas
arlington	arlington	(proper noun) arlington
armenia	armeens	(proper noun) armenia
armstrong	armstrong	(proper noun) armstrong, as in jazz artist louis armstrong
arnold	arnold	arnold
arsenal	arsenaal	arsenal
artemis	artemis	(proper noun) artemis, the greek goddess of the hunt
aruba	aruba	aruba
arunachal	arunachal	"(term should be ""arunachal pradesh"") a state in india (proper noun)"
asc	asc	asc
ash	as	a name
ashikaga	ashikaga	ashikaga
ashley	ashley	(proper noun) ashley
asia	azië	asia
asm	asm	asm
asoka	asoka	asoka
association	vereniging	association
assyria	assyrië	assyria
aston	aston	(proper noun) aston, as in aston villa
atkinson	atkinson	atkinson
atlanta	atlanta	atlanta
atlantic	atlantisch	atlantic
aua	aua	aua
aubrac	aubrac	aubrac
audition	auditie	audition
auflage	auflage	auflage
auguste	auguste	auguste
australia	australië	(proper noun) australia
austria	oostenrijk	(proper noun) the country of austria
austrian	oostenrijks	austrian
avar	avar	a name
aviation	luchtvaart	aviation
awad	awad	awad
award	prijs	award
axit	zuur	acid
ayeyarwady	ayeyarwady	ayeyarwady
ayumi	ayumi	(proper noun) ayumi
ayutthaya	ayutthaya	(proper noun) ayutthaya
azerbaijan	azerbeidzjan	(proper noun) azerbaijan
aztec	aztec	aztec, as in the aztec people (adj.)
ba	vader	three
babylon	babylon	babylon
bacon	spek	bacon
baden	baden	baden
baghdad	bagdad	(proper noun) baghdad
bago	bago	bago
bahamas	bahamas	bahamas
bahrain	bahrein	bahrain
baháí	baháí	bahai
balearic	baleaar	balearic
bali	bali	bali
balkan	balkan	(proper adjective) balkan
balkans	balkan	balkans
ballard	ballard	ballard
bamar	bamar	bamar
ban	verbod	the
bang	knal	state
banh	bal	ball
banner	banner	banner
bantam	kriel	bantam
bantu	tu ban	bantu
bao	zak	bao giờ= ever
barack	barack	barack
barak	barak	barak
barbados	barbados	(proper noun) barbados
barbara	barbara	barbara
barbary	barbarije	barbary
barca	barca	barca
barnes	barnes	barnes
barone	barone	barone
baroque	barok	baroque
barquin	barquin	barquin, as in ramon barquin, the cuban military colonel
barrichello	barrichello	barrichello
bartholdi	bartholdi	bartholdi
baryon	baryon	baryon
barça	barça	(proper noun) barca
base	baseren	base
basel	bazel	basel, a city in switzerland
basil	basilicum	basil
baskervilles	baskervilles	baskervilles
bass	bas	bass
bator	bator	bator
battambang	battambang	battambang
bauer	bauer	bauer
bay	vlieg	"(should be ""tuyến bay"") an airline"
bayern	bayern	bayern
bazan	basalt	basalt (n.)
bazơ	eenvoudig	base
bb	bb	bb
bbc	bbc	bbc
bc	bc	bc
bchtư	bchtư	central executive
beat	ritme	beat
beatles	beatles	the beatles
beauty	schoonheid	beauty
beckenbauer	beckenbauer	beckenbauer, as in franz beckenbauer
becker	becker	(proper noun) becker
beckham	beckham	beckam
bedloe	bedloe	bedloe
beethoven	beethoven	beethoven
beethovens	beethovens	beethoven's
beginbmatrix	beginbmatrix	this is a code
behind	achter	behind
beijing	peking	beijing
bel	bel	bel
bell	klok	bell
bella	bella	bella
bellatrix	bellatrix	bellatrix
benedict	benedict	benedict
benetton	benetton	benetton
benfica	benfica	benfica
benito	benito	benito
benjamin	benjamin	(proper noun) benjamin
bennington	bennington	bennigton
berber	berber	berber
bergen	bergen	(proper noun) bergen
berger	berger	berger
bering	bering	(proper noun) bering, as in the bering strait
berkeley	berkeley	(proper noun) the city of berkeley, california
berman	berman	a name
bermuda	bermuda	(proper noun) bermuda
bernard	bernard	bernard
bertrand	bertrand	bertrand
better	beter	better
betty	betty	betty
bhutan	bhutan	bhutan
bia	bier	beer (n.)
biang	biang	biang
bic	bic	bic
bikini	bikini	bikini
bill	bill	(proper noun) bill, as in former president bill clinton
billy	billy	billy
bismarck	bismarck	bismarck, as in otto von bismarck
bitmap	bitmap	bitmap
biên	vermelding	bien
biếc	groenblauw	a bluish-green color (adj.)
biếm	zorgeloos	"(term should be ""biếm họa"") cartoon (n.)"
biến	uit	other
biếng	lui	lose interest in
biếu	hulde brengen	present
biều	bieu	bieu
biển	zee	ocean
biểuthứcđiềukiện	ken de voorwaarden	conditional expression
biện	verontschuldigen	"(term should be ""biện pháp"") a method (n.)"
biệt	verschillend	"(term should be ""khác biệt"") different or distinct"
bkavpro	bkavpro	bkavpro
blackwell	blackwell	this is a name
blair	blair	blair
blaise	blaise	blaise
blanc	blanc	blanc
blues	blues	blues
bo	bo	a curl, as in a biceps curl exercise
bob	bob	bob
bobby	bobby	bobby, as in bobby day
boeing	boeing	boeing
bohemia	bohemen	bohemia
bolivia	bolivia	(proper noun) bolivia
boltzmann	boltzmann	boltzmann
bom	bom	bomb
bonaparte	bonaparte	bonaparte
bong	bong	"(term should be ""bong bóng"") a balloon (n.)"
bonnal	bonnal	bonnal
bonobo	bonobo	bonono
bool	bool	bool
boolean	boolean	(proper adjective) boolean, as in boolean algebra
boom	boom	boom
boong	dek	a deck (n.)
boongke	bunkers	bunker
bop	bop	bop
boris	boris	boris
borland	borland	(proper noun) borland
borussia	borussia	borussia
bose	bose	bose, as in subhas chandra bose
boseeinstein	boseeinstein	bose einstein
bosna	bosna	(proper noun) bosnia
bosnia	bosnië	(proper noun) bosnia
botswana	botswana	botswana
bottom	bodem	bottom
boulder	kei	boulder
bourbon	bourbon	bourbon
boxing	boksen	boxing
brain	hersenen	brain
brandenburg	brandenburg	(proper noun) brandenburg
brandt	brandt	brandt
braun	braun	braun
brazil	brazilië	brazil
bremen	bremen	bremen, as in the bremen bank
brestlitovsk	brestlitovsk	brest-litovsk
breton	breton	(proper noun) breton
bretton	bretton	hoi nghi
brezhnev	brezhnev	brezhnev
brian	brian	a name
bridge	brug	bridge
britannic	britannic	(proper noun) britannic
britney	britney	britney
brooklyn	brooklyn	brooklyn
brot	brot	this is german not vietnamese
brown	bruin	brown
browne	browne	browne
browning	bruinen	(proper noun) browning
bruce	bruce	bruce
brunei	brunei	brunei
bruno	bruno	bruno, as in the city of san bruno
brusilov	brusilov	brusilov
brussels	brussel	brussels, the capital of belgium
btr	btr	btr
bubalis	bubalis	bubalis
budapest	boedapest	budapest, the capital of hungary
bulgaria	bulgarije	bulgaria
bulletin	bulletin	thong bao
bungary	bungary	bungary
bungo	bungo	bungo
buonaparte	buonaparte	(proper noun) buonaparte, as in casa buonaparte
burke	burke	(proper noun) burke, as in edmund burke
burkina	burkina	burkina
burma	birma	burma
burundi	burundi	burundi
busan	busan	a korean city
busby	kolbak	busby
bush	struik	bush
bushy	bossig	bushy
buôn	groothandel	commerce
buông	loslaten	to release, to let loose
buýt	bus	bus
buốt	enthousiast	sharp
buồm	zeil	sail
buồn	verdrietig	sad
buồng	kamer	chamber
buổi	sessie	session
byzantine	byzantijns	byzantine
bà	grootmoeder	woman or lady (n.)
bài	berichten	articles
bàn	tafel	table
bàng	adelaar	eagle
bành	peng	armchair
bào	schaven	compatriot
bàu	bau	bau
bày	presentatie	"(term should be ""trưng bày"") to display (v.)"
bác	oom	doctor
bách	cipres	"(term should be ""bách khoa"") polytechnic (adj.)"
bái	cultus	to bow (v.)
bám	vasthouden	cling
bán	verkopen	sell
báng	knal	"(term should be ""phỉ báng"") to defame or slander"
báo	krant-	newspaper (n.)
bát	kom	eight (n.)
báu	schat	valuable
bây	nu	now
bã	residu	"(term should be ""buồn bã"") sad (adj.)"
bãi	werven	beach
bão	storm	storm
bèn	vervolgens	then
bé	weinig	baby
bén	scherp	sharp (adj.)
béo	vet	fat
bên	kant	side
bênh	ziek	advocate
bì	verpakking	foreskin (n.)
bìa	hoes	cover
bìu	scrotum	sac (n.)
bí	squash	secret
bính	binh	"(term should be ""bính âm"") romanized chinese words (n.)"
bíró	pompoen	biro
bò	koe	beef
bó	stelletje	bound (adj.)
bói	waarzeggen	to foretell (v.)
bón	bevruchten	"entire term should be ""phan bon""; means ""fertilizer"""
bóng	bal	sphere or ball
bóp	knijpen	squeeze
bô	vader	"(term should be ""bôxit"") the mineral bauxite"
bôi	besmeurd	to apply (as in oil)
bông	katoen	flower
bù	bedenken	compensate
bùa	amulet	talisman
bùn	modder	mud
bùng	gloed	"(term should be ""bùng nổ"") to break out (v.)"
bú	zogen	to suck
búa	hamer	a hammer
búi	plukjes	tuft
bún	rijstnoedel	noodle
búng	flikkerde	snap
bút	pen	pseudonym
băm	gehasht	hash
băn	tobben	concerned
băng	ijs	"(term should be ""băng giá"") freezing (adj.)"
bơ	boter	"(term should be ""bơ vơ"") desolate (adj.)"
bơi	zwemmen	swim
bơm	pomp	pump
bưu	port	post office
bước	stap	a step (n.)
bướm	vlinder	butterfly
bạ	contacten	directory
bạc	zilver	meager
bạch	wit	"(should be ""bạch tuộc"") an octopus"
bại	verliezen	defeated
bảng	bord	chart
bảo	bao	protect
bảy	zeven	seventh
bấm	druk op	press
bất	echt	"(term should be ""bất cứ"") any (adj.)"
bấy	dat	contemporary
bần	arm	poor
bầu	stemmen	vote
bầy	kudde	servant
bẩm	aangeboren	congenital
bẩn	vuil	the
bẩy	val	"(term should be ""lẩy bẩy"") unsteadily (adv.)"
bẫy	val	a trap (n.)
bậc	mate	level or class (n.)
bận	druk	busy
bật	opgewonden	outstanding
bắc	noorden	beijing
bắcnam	noord zuid	"(term should be ""bắc-nam"") north-south (adj.)"
bắn	schieten	shoot
bắp	maïs	venter
bắt	vangst	cross
bằng	gelijk	by
bẹp	verpletteren	crush
bẻ	breken	break
bẽ	vernedering	humiliate
bến	werf	wharf
bếp	een keuken	kitchen
bề	oppervlakte	"(should be ""bề mặt"") a surface"
bền	duurzaam	enduring (v.)
bể	balg	tank
bệ	voetstuk	base
bện	gevlochten	braided (adj.)
bệnh	ziek	benh
bỉ	belgië	disgust
bỉnh	ondeugend	binh
bịch	thump	ridiculous
bịt	gedekt	cover
bọ	bug	insect
bọc	inpakken	to cover or enclose (v.)
bọn	hen	a group (n.)
bọng	wallen	bladder
bọt	schuim	foam
bỏ	intrekken	to leave (v.)
bỏng	brandwond	hot
bố	vader	"(term should be ""tuyên bố"") to declare"
bốc	bezig met laden	bốc lửa= on fire
bối	verward	messy
bốn	vier	four
bồi	een vergoeding	"(term should be ""cao bồi"") cowboy (n.)"
bổn	plicht	duty
bổng	beurs	"with word luong, means ""salary"" or ""wages"""
bỗng	plotseling	suddently
bộ	de set	part
bộc	boc	"(term should be ""bộc lộ"") to reveal (v.)"
bội	meerdere	betray
bột	meel	powder or flour (n.)
bớ	naar boven afronden	arrest
bớt	minder	less
bờ	rand	coast
bời	kont	profuse
bở	door	profitable
bởi	door	because
bục	podium	platform
bụng	maag	abdomen
bứt	onbewust	"(term should be ""bứt phá"") power (n.)"
bừa	schrijnend	messy, careless, or topsy-turvy (adj.)
bữa	maaltijd	meal (n.)
bực	gefrustreerd	bother
ca	verschuiving	praise
ca-lo	ca-lo	a unit of measurement
cabo	cabo	cabo
cacbon	koolstof	carbon
cacbonat	carbonaat	carbonate
cacbua	hardmetaal	carbides, carbon ions
caesar	caesar	caesar
caffein	cafeïne	caffeine
café	koffie	coffee
cai	cai	govern
cairo	cairo	cairo, the capital of egypt
cal	cal	cal, a first name
calculus	calculus	calculus
calvin	calvin	calvin
cam	sinaasappels	commit
cambodia	cambodja	(proper noun) the country of cambodia
cambridge	cambridge	cambridge
cameo	cameo	cameo part
cameron	cameron	cameron
cameroon	kameroen	cameroon
camille	camille	camille
campbell	campbell	campbell
campuchia	cambodja	campuchia
canada	canada	canada
canadian	canadees	canadian
canal	kanaal	canal
canary	kanarie	canary
cancer	kanker	cancer
canterbury	canterbury	canterbury
canxi	calcium	calcium
capello	capello	capello
capra	capra	capra
carat	karaat	carat
carbine	karabijn	carbine
cardcaptor	cardcaptor	cardcaptor
cardcaptors	cardcaptors	(proper noun) cardcaptors
carey	zorgzaam	(proper noun) carey, as in singer mariah carey
caribe	caribe	caribbean
caribê	caraïben	caribbean
carl	carl	carl
carlos	carlos	carlos
carnaval	carnaval	carnaval
carol	carol	carol
caroline	caroline	(proper noun) caroline
carpathia	carpathia	carpathia
carter	voerman	carter
carxtơ	karaat	karst topography, a geological term (n.)
casa	ca sa	casa
casablanca	casablanca	casablanca
caspia	caspia	caspia
cassini	cassini	cassini
cast	gips	cast
castries	castries	castries
castro	castro	castro, as in fidel castro
cathay	cathay	cathay
catherine	catherine	catherine
cau	cau	cau
cbc	cbc	cbc
cbgd	cbgd	educational  officer
cbs	cbs	cbs
ccc	ccc	ccc
ccn	ccn	industrial cluster
cctv	cctv	cctv
cd	cd	cd
cdot	cdot	cdot
cdrom	cd-rom	cd-rom
cell	cel	cell
celtic	keltisch	centic
cena	cena	(proper noun) cena, as in john cena, the wrestler
centauri	centauri	centauri
ceres	ceres	ceres
cha	vader	father
chai	fles	bottle
chaillot	chaillot	a name
chamberlain	kamerheer	chamberlain
champa	champa	champa
champion	kampioen	champion
chamẹ	ouders	parents
chanel	chanel	chanel
chanh	citroen	lemon or lime (n.)
chao	hoi	(proper noun) chao, a name
charles	charles	charles
charlotte	charlotte	charlotte
charlton	charlton	charlton
charon	charon	(proper noun) charon
chase	jacht	chase
chay	vegetarisch	fasting
chdcnd	chdcnd	democratic republic
che	hoes	cover
chechnya	tsjetsjenië	chechnya
chen	chen	chen
cheo	cheo	"(term should be ""cheo reo"") name of a town"
chi	chi	"(term should be ""chi tiết"") details (n.)"
chia	delen	"(term should be ""chia sẻ"") to share"
chiang	chiang	chiang
chicago	chicago	chicago, as in chicago, illinois
chile	chili	(proper noun) the country of chile
chim	vogel	bird
china	china	china
ching	ching	ching
chirac	chirac	chirac, as in former french president jacques chirac
chiêm	astrologisch	"(term should be ""chiêm thành"") the ancient kingdom of champa in vietnam"
chiên	gebakken	fry
chiêng	gong	gong
chiếc	st	the
chiếm	goed voor	appropriate
chiến	strijd	war, fight
chiết	extract	literal
chiếu	mat	show
chiền	bundel	temple
chiều	p.m	length
chlamydia	chlamydia	chlamydia
chloride	chloride	chloroauric acid
chnd	chnd	chnd
choi	speel	choi
chomsky	chomsky	chomsky
chong	chong	chong
chopin	chopin	chopin
chosŏn	gekozen	(proper noun) choson
choàng	kaap	coat
choáng	verbijsterd	dizzy
chris	chris	chris, as in chris hughes
christ	christus	christ
christian	christen	christian
christopher	christopher	christopher
chrome	chroom	chrome, as in google chrome
chrysler	chrysler	(proper noun) chrysler, the car company
chu	chu	cycle
chua	zuur	tomato
chuck	chuck	(proper noun) chuck, as in chuck norris
chui	veeg	underground
chum	vriend	pot
chun	chun	chun
chung	algemeen	general
churchill	churchill	churchill
chuyên	gespecialiseerd	professional
chuyến	reis	trip
chuyền	slagen voor	volleyball
chuyển	verder gegaan	to move
chuyện	verhaal	nói chuyện= talk
chuôi	klacht	handle
chuông	klok	a bell
chuẩn	standaard-	standard
chuốc	por	incur
chuối	banaan	banana
chuốt	aansnijden	refine
chuồng	kooi	cage
chuỗi	ketting	series
chuộc	inwisselen	redeem
chuộng	begunstigd	favorite
chuột	muis	a mouse (n.)
chà	wrijven	rub
chài	vissen	fish
chàm	indigo	indigo
chàng	kerel	"(term should be ""chàng trai"") a young man (n.)"
chào	hallo	welcome
chày	basketbal	a pestle (n.)
chánh	chef	"(term should be ""chánh án"") the head of a tribunal (n.)"
cháo	pap	porridge
cháu	kleinkinderen	a term one uses denoting oneself when addressing an aunt or uncle (n.)
cháy	brand	fire
châm	prik	motto
chân	voet	a leg
châu	europa	continental
chè	thee	tea
chèn	invoegen	insert
chém	besnoeiing	to chop
chén	kop	bowl
chéo	kruis	cross
chép	kopiëren	written
chê	verdomme	decry
chênh	verschil	difference
chì	lood	graphite
chìa	sleutel	"(term should be ""chìa khoá"") a key (n.)"
chìm	zonken	to become submerged or sink (v.)
chình	paling	eel
chí	luizen	especially
chích	steek	shoot
chín	negen	ripe
chính	hoofd	main
chít	chit	dense
chò	stikken	a type of plant, typically of the parashorea genus (n.)
chòi	cabine	hut
chòm	sterrenbeeld	constellation
chó	hond	dog
chóc	haha	killing (giet choc)
chói	schittering	bright
chóng	snel	"entire term should be ""chong mat""; means ""dizzy"""
chóp	top	the top (n.)
chôm	ramboetan	rambutan
chôn	begraven	bury
chông	man	thorn
chùa	tempel	pagoda
chùy	foelie	mace
chú	oom	uncle (n.)
chúa	god	god
chúc	wensen	will
chúi	tuu	drop
chúng	hen	they
chút	beetje	little
chăm	moeilijk	champa
chămpa	champa	champa
chăng	betaalbaar	would it
chĩa	vorken	point
chơi	speel	play
chơn	voeten	"a more obscure form of the word ""chân""; means ""genuine"" or ""true"""
chư	chu	lower authorities
chưa	nog niet	not yet
chưng	dist	steamed
chương	hoofdstuk	medal
chướng	hindernisbaan	grating
chạ	promiscue	father
chạm	aanraken	touch
chạng	schemering	twilight
chạp	wankel	slow
chạy	rennen	to run (v.)
chả	broodjes	no
chảo	pan	pan
chảy	rennen	bleeding
chấm	punt	end
chấp	uitdaging	"(term should be ""chấp nhận"") to accept (v.)"
chất	er toe doen	quality
chấu	snuifje	"(term should be ""châu chấu"") a grasshopper (n.)"
chần	blancheren	slice
chẩn	diagnostiseren	"(term should be ""chẩn đoán"") to diagnose (v.)"
chậm	langzaam	slow
chận	blok	block
chật	strak	overcrowded
chậu	pot	pelvic
chắc	zeker	certainly
chằng	voorhoofd	ligament
chẵn	zelfs	even
chặn	blokkeren	prevent
chặng	been	journey
chặt	karbonade	close
chẻ	splitsen	strick
chẽ	strak	"(term should be ""chặt chẽ"") tightly or closely (adv.)"
chế	voorbereidende werkzaamheden	produce
chếch	speling	oblique
chết	ging dood	to die (v.)
chệch	mis	deviant
chỉ	alleen maar	just (adv.)
chỉnh	correctie	adjust
chịt	onzin	chằn chịt= complex/tangle
chịu	beer	tolerate
chọc	porren	to poke
chọi	vechten	oppose
chọn	kiezen	to choose
chỏ	elleboog	"(term should be ""cùi chỏ"") elbow (n.)"
chốc	moment	single
chối	ontkennen	refuse
chốn	plaats	place
chống	anti	anti-
chốt	klink	important
chồi	schiet	"(term should be ""đâm chồi"") budding"
chồn	vos	anxious
chồng	man	husband
chỗ	plaats	where
chội	shit	cramped
chớ	niet doen	not
chớp	bliksem	flashing (adj.)
chờ	wacht	to wait
chở	dragen	for
chợ	markt	market
chợt	plotseling	suddenly
chục	dozijn	dozen
chụp	maak een schot	capture
chủ	meester	"(term should be ""chủ yếu"") main or essential (adj.)"
chủng	stammen	strain
chứ	liever	just or only (adv.)
chứa	bevatten	contain
chức	functie	function
chừ	brief	hesitate
chừa	weggaan	leave
chừng	sommige	about or roughly (adv.)
chử	woord	"(term should be ""chử bích"") the vietnamese name for a chinese island"
chửa	zwanger	pregnant
chửi	vloeken	curse
chữ	woord	a letter of the alphabet (n.)
chữa	genezen	to cure or treat (v.)
chững	nivelleren	to totter (v.)
cia	cia	cia
cincinnati	cincinnati	cincinnati
cinderella	assepoester	cinderrella
cip	cip	cip
circus	circus	circus
cities	steden	cities
clara	clara	clara
clark	clark	clark
claude	claude	(proper noun) claude
claudius	claudius	(proper noun) claudius
clinton	clinton	clinton, as in former president bill clinton
clip	klem	clip
clips	clips	clips
clo	chloor-	chlorine
clow	clow	clow
clyde	clyde	(proper noun) clyde, as in bonnie and clyde
cmc	cmc	cmc
cmt	cmt	cmt
cn	cn	christian era
cnet	cnet	cnet
cntb	cntb	capitalism
cntt	cntt	it
cnxh	cnxh	social republic
co	co	spasm
coburn	coburn	coburn
cocoa	cacao	cocoa
coen	coen	coen
coffea	coffea	coffee
cohen	cohen	cohen
coi	kijk maar	to regard
coleen	coleen	coleen
coleman	coleman	coleman
coli	coli	coli
colin	colin	(proper noun) colin, as in colin powell
colleen	colleen	colleen
college	college	college
collins	collins	(proper noun) collins
collège	college	college (n.)
colombia	colombia	colombia
colombo	colombo	(proper noun) colombo
colorado	colorado	(proper noun) colorado, as in the state
columbus	columbus	columbus
comic	grappig	comic
common	gemeenschappelijk	common
concacaf	concacaf	concacaf
concerto	concerto	concerto
concorde	concorde	concorde
condom	condoom	condom
cong	gebogen	curved or bent
congo	congo	congo
congress	congres	congress, as in library of congress
connecticut	connecticut	connecticut
conrad	conrad	corrad
conservation	behoud	conservation
constantine	constantine	constantine
contemporary	hedendaags	contemporary
cooper	kuiper	(proper noun) cooper
copenhagen	kopenhagen	copenhagen
copernic	copernisch	corpernic
copperfield	copperfield	(proper noun) copperfield, as in magician david copperfield
coppola	coppola	coppola
copy	kopiëren	copy
cordyceps	cordyceps	cordyceps
core	kern	core
cornell	cornell	cornell
cosin	cosin	cosine
costa	costa	costa
cotang	cotang	cotangent
cpt	cpt	cpt
craig	craig	(proper noun) craig
crazy	gek	crazy
crespo	crespo	(proper noun) crespo
crest	kam	crest
crew	bemanning	crew
crimson	karmozijn	crimson
crisis	crisis	crisis
cristiano	cristiano	cristiano, as in portuguese soccer player cristiano ronaldo
croatia	kroatië	croatia
cross	kruis	cross
crs	crs	crs
cruz	cruz	cruz
cruzeiro	cruzeiro	cruzeiro
crystal	kristal	crystal
ctc	ctc	ctc
cua	krab	crab (n.)
cullen	cullen	a name
cung	boog	circle
cunningham	cunningham	cunningham; proper name
cup	kop	cup
cuả	van	of, from, belonging to
cuốc	schoffels	hoe
cuối	laatste	last or final (adj.)
cuốn	spoel	book
cuống	stengel	throat
cuồng	gek	crazy (adj.)
cuộc	de	the
cyanide	cyanide	cyanide
cyber	cyber	cyber
cyril	cyril	(proper noun) cyril
cyrus	cyrus	cyrus
cyworld	cyworld	cyword
cà	koffie	ca
cài	installeren	install
càn	nodig hebben	raid
càng	meer	cang
cành	afdeling	branch
cào	krassen	scratch
cày	ploegen	plow
các	de	all (adv.)
cách	manier	the
cái	de	"(term should be ""con cái"") children (n.)"
cán	gerold	"(should be ""cán bộ"") an officer, especially in a communist regime"
cánh	vleugel	wing
cáo	vos	report
cáopx|bình	cáopx | gemiddeld	not a word
cáp	kabel	cable (n.)
cáy	viool	fiddler
câm	stom	mute (adj.)
cân	weegschaal	weight
câu	de zin	saying
cãi	ruzie maken	argue
cò	trekker	stork
còn	nog steeds	to have left (v.)
có	hebben	have
cói	zegge	machine
cót	kinderbed	cot
cô	mevrouw	girl
côi	wees	orphaned
côn	taps toelopend	a stick (n.)
công	werk	worker
côngtenơ	container	container
cõi	rijken	entire area
cõng	meeliften	piggyback
cù	kietelen	cu
cùi	melaatsen	leprosy
cùng	en	together
cú	uil	old
cúi	boog	to bow (v.)
cúm	griep	cum
cúng	knus	worship
cúp	kop	cup (n.)
cút	eruit	to kick someone out (v.)
căm	ingeplugd	detest (cam thu)
căn	radicaal	"(term should be ""căn bệnh"") cause of a disease (n.)"
căng	uitrekken	tense
cũ	oud	old
cũi	wieg	kennel
cũng	ook	also
cơm	rijst-	rice
cư	bevolken	resident
cưa	zag	saw
cưng	mijn babe	also
cước	vracht	megaman
cưới	getrouwd	marry
cướp	beroven	to rob (v.)
cười	lach	smile
cường	sterk	strengthen
cưỡi	rijden	ride
cưỡng	gedwongen	force some body to do some thing. cưỡng dâm=rape
cạc	kaart	card (n.)
cạn	oppervlakkig	shallow
cạnh	rand	"(term should be ""khía cạnh"") an angle"
cạo	scheren	shave
cạp	schorpioen	scorpion
cả	beide	both
cải	mosterd	reform
cảm	verkoudheid	pleasure
cản	geplaagd	prevent
cảng	haven	port
cảnh	tafereel	situation
cảo	trekt	posthumous
cấm	verbieden	ban
cấn	nodig hebben	dramatic
cấp	verlenen	level or rank (n.)
cất	gedistilleerd	"(term should be ""cất giữ"") to keep safe or store"
cầm	houden	to hold (v.)
cần	nodig hebben	need
cầu	brug	request
cầy	civet	farmed
cẩn	doe voorzichtig	carefully
cẩu	kraan	"(term should be ""hải cẩu"") a seal (n.)"
cận	nadering	close
cập	teller	mention
cậu	jongen	a young man (n.)
cậy	afhangen	reliable
cắm	inpluggen	to plant (v.)
cắn	beet	to bite
cắp	stelen	steal
cắt	besnoeiing	cut
cằm	kin	chin
cằn	knorrig	exhausted (adj.)
cặp	zak	couple
cọ	wrijven	rub
cọc	stapel	pile
cọp	tijger	tiger
cỏ	gras	plant
cố	proberen	"(term should be ""cố gắng"") to try one's best (v.)"
cốc	de beker	cereal
cối	mortier	mortar
cốm	nuggets	grilled rice
cống	afvoer	dedicate
cồn	alcohol	i
cồng	gong	gong
cổng	poort	gate
cỗ	dek	engine
cỗi	eigenwijs	barren
cộ	voertuig	"(term should be ""xe cộ"") cars or vehicles (n.)"
cội	oud	origin
cộng	plus	to add (v.)
cột	kolom	pole
cớ	excuus	excuse
cờ	vlag	flag
cỡ	grootte	size
cợt	een grapje	"(term should be ""đùa cợt"") to trifle (v.)"
cục	afdeling	department
cụm	tros	cluster
cụp	geamputeerd	down
cụt	geamputeerd	"(should be ""xương cụt"") the tailbone or coccyx"
củ	knollen	a bulb, a botanical term
của	van de	of
củi	brandhout	firewood
củng	ook	reinforce
cứ	aan	any
cức	coo	"(term should be ""cức Đê"") a character in chinese history"
cứng	moeilijk	hard
cứngi	hardi	cungi
cừ	palen	nacre
cừu	lam	sheep
cửa	deur	door
cửu	vermenigvuldigen	nine
cữ	cu	abstinence
cữu	kist	nine
cự	afstand	against
cựa	sporen	retreat
cực	pool	extreme
cựu	voormalig	former
d	d	d.
da	huid	skin
daegu	daegu	daegu
dahl	dahl	(proper noun) dahl, as in author roald dahl
dai	moeilijk	persistent
daily	dagelijks	daily
dakota	dakota	dakota, as in the state of south dakota
dalat	da lat	da lat
dampier	vochtiger	(proper noun) dampier, a last name
dan	dan	dan
dancing	dansen	dancing
danger	gevaar	danger
danh	naam	list
daniel	daniel	daniel
dante	dante	dante
dao	mes	poniard
darwin	darwin	darwin
das	das	das
dassault	dassault	(proper noun) dassault
date	datum	date
dau	olie	dau
dave	dave	(proper noun) dave, as in dave sexton
david	david	david, as in david thomas
davies	davies	davies
davis	davis	davis
dbsk	dbsk	dbsk
dc	dc	d.c.
ddr	ddr	ddr
dean	decaan	a name
degree	mate	degree
delhi	delhi	delhi
delphi	delphi	(proper noun) delphi, as in the oracle
demeter	demeter	(proper noun) demeter, the greek goddess of the harvest
den	den	den
dennis	dennis	dennis
department	afdeling	departmen
derek	derek	derek
des	des	des
descartes	descartes	descartes
design	dat is kế	thiet ke
deuterium	deuterium	deuterium
deutschland	deutschland	deutschland
dewan	dewan	dewan, as in dewan rakyat
dewitt	dauw	(proper noun) dewitt, as in rose dewitt bukater
di	di	move
diana	diana	(proper noun) diana, as in diana ross
die	dood gaan	german
diego	diego	diego
dien	gek	"(term should be ""Điện biên phủ"") a city in northwestern vietnam where a famous battle took place during the vietnam war"
dimaggio	dimaggio	gimaggio
dinh	paleis	official residence or palace
dionysus	dionysus	dionysus, as in the greek god
discovery	ontdekking	discovery
discussion	discussie	discussion
disneyland	disneyland	disneyland
division	afdeling	division
divoire	divoire	d'lvoire
diêm	wedstrijden	diem vuong
diên	gek	"(term should be ""kinh diên"") canon (n.)"
diềm	valletjes	matches
diều	vlieger	kite
diểu	klucht	(proper noun) diểu
diễm	diem	beauty; a common vietnamese first name for women
diễu	maart	parade
diệc	reiger	a heron (n.)
diệm	diem	(proper noun) diệm, as in ngô Đình diệm, former president of south vietnam
diện	gezicht	face to face
diệt	doden	to kill or destroy (v.)
diệu	magie	effective (adj.)
djibouti	djibouti	djibouti, a country in africa
djokovic	djokovic	(proper noun) djokovic, as in novak djokovic
dm	dm	dm
dmitri	dmitri	dmitri
dna	dna	dna
do	door	because of
doanh	gewricht	"(term should be ""kinh doanh"") business (n.)"
doc	doc	doc
docherty	docherty	docherty
dolly	dolly	(proper noun) dolly, as in singer dolly parton
dome	koepel	nha
dominican	dominicaans	(proper noun) dominican, as in the dominican republic
don	don	(proper noun) don
donau	donau	donau
dortmund	dortmund	(proper noun) dortmund
dougherty	dougherty	dougherty
douglas	douglas	douglas
dover	dover	(proper noun) dover, as in the capital of delaware
doyle	doyle	doyle
doãn	doan	doan
doạ	bedreigend	threat
dp	dp	dp
dracula	dracula	dracula
draft	droogte	draft
drake	mannetjeseend	(proper noun) drake
driver	bestuurder	a name
ds	ds	ds
dtd	dtd	dtd
dth	dth	dth
du	du	travel
dubai	dubai	dubai
duiker	duiker	duiker
duk	duk	duk
dumas	dumas	dumas
dumbledore	perkamentus	dumbledore
dung	mest	portrait
durham	durham	durham
dursley	duffel	dursley
duy	enkel en alleen	only
duyên	voorbestemd	coastal
duyện	ambitieus	fellatio
duyệt	browser	browser
duơng	duong	ocean
duẩn	duan	duan
duật	duat	duat
duệ	afstammelingen	descendants (n.)
duỗi	rechtzetten	stretch
dwight	dwight	dwight
dà	dah	gradually
dài	lang	to lengthen, as in time
dàn	enscenering	to arrange
dàng	gemakkelijk	dang
dành	uitgegeven	for
dào	overvloedig	"complement to word ""doi""; entire phrase ""doi dao"" means ""plentiful"""
dày	dik	thick
dái	pissen	"penis (n.), although some may use the term to mean ""testicles"""
dám	durven	dare
dán	plakken	stick
dáng	vorm	appearance
dát	ingelegd	inlay
dâm	onzedelijk	lustful (adj.)
dân	mensen	people
dâng	aanbod	dedicate
dây	koord	nerve
dã	wild	chronicle
dãi	toegeeflijk	band
dãn	verwijd	extend
dãy	bereik	a row (n.)
dè	doe voorzichtig	tight
défense	verdediging	defense
dép	sandalen	slipper
dê	geit	goat
dì	tante	aunt
dìu	dìu	to lead by the hand (v.)
dính	kleverig	stick
dò	zoeken	(with word tham) to survey
dòm	kijken	snoop
dòng	actueel	"(term should be ""dòng họ"") family (n.)"
dó	dat	a type of plant used to make paper in vietnam (n.)
dông	onweersbui	a storm (n.)
dõi	spoor	monitor
dù	hoewel	though
dùi	puncher	awl
dùng	gebruik	use
dăm	krullen	"(term should be ""đá dăm"") pebbles (n.)"
dĩ	natuurlijk	why
dĩa	bord	dish
dũng	moedig	courage
dơ	vuil	dirty
dơi	vleermuizen	bat
dư	rest	remnant
dưa	meloenen	melons
dưng	hou op	suddently
dương	positief	penis
dường	lijken	seem
dưỡng	verpleging	feed
dược	apotheek	having to do with medicine (adj.)
dượng	oom	uncle
dạ	ja	night
dại	dwaas	stupid or idiotic (adj.)
dạn	onverschrokken	"(term should be ""dày dạn"") to be accustomed to, especially some sort of difficult situation (adj.)"
dạng	formaat	tyoe
dạo	wandeling	vending
dạt	aangespoeld	to drift
dạy	onderwijzen	teach
dải	strip	range
dấm	azijn	vinegar
dấp	struikelen	shape
dấu	teken	signal
dấy	opwindend	to raise (v.)
dần	geleidelijk	people
dầu	olie	oil
dẫm	stampen	step on
dẫn	gids	to lead
dẫu	hoewel	though
dận	tante	to step on
dậu	haan	rooster
dậy	sta op	"(term should be ""dậy thì"") pubescent (adj.)"
dắt	lood	lead
dằn	ballast	"(term should be ""dằn lòng"") to hold yourself in (v.)"
dằng	aanhoudend	dằng dai= long/endless
dẳng	aanhoudend	persist
dặm	mijl	mile
dặn	besteld	to advise (v.)
dặt	bestellen	conservative
dẹp	plat	pacify
dẹt	vlak	flat
dẻ	kastanjes	chestnut
dẻo	plasticiteit	flexible
dế	krekels	cricket
dền	amarant	beetroot
dể	gemakkelijk	easy
dễ	gemakkelijk	easy
dệt	weven	textile
dị	eigenheid	simple
dịch	vertalen	semen
dịp	gelegenheid	occasion
dịu	zacht	ease
dọa	bedreigend	to threaten or scare (v.)
dọc	verticaal	along
dỏm	geestig	witty
dốc	helling	slope
dối	liggen	lie
dốt	onwetend	stupid or ignorant (adj.)
dồi	overvloedig	"(term should be ""trau dồi"") improve (v.)"
dồn	in het nauw gedreven	accrue
dỗ	coax	dirty
dời	actie	leave
dở	slecht	incomplete
dỡ	lossen	remove
dụ	bijvoorbeeld	example
dục	seks	sexuality
dụng	gebruik	use
dứa	ananas	pineapple
dứt	hou op	to cease
dừa	kokosnoot	coconut (n.)
dừng	hou op	to cease
dữ	gegevens	"(term should be ""giận dữ"") anger (n.)"
dự	geprojecteerd	attend
dựa	gebaseerd	base on
dực	mannetje	dực, as in lê tương dực
dỹ	dỹ	dy
e	e	e.
ea	ea	(proper noun) ea, as in ea kao
earles	earles	earles
eaton	eaton	eaton
ebro	ebro	a name
ecmascript	ecmascript	ecmascript
ecw	ecw	ecw
edda	edda	(proper noun) edda
edgar	edgar	edgar, as in author edgar allan poe (n.)
edge	rand	edge
edinburgh	edinburgh	(proper noun) edinburgh, as in edinburgh, scotland
edison	edison	edison
editor	editor	editor
edmond	edmond	edmond
edo	edo	edo
edward	edward	edward
edwin	edwin	edwin
eea	eea	eea
efron	efron	efron, as in zac efron
egypt	egypte	egypt
eid	eid	(proper noun) eid
eiffel	eiffel	eiffel
einstein	einstein	einstein
eisenhower	eisenhower	eisenhower, as in former president dwight d. eisenhower
ekaterina	ekaterina	this is a name
elbe	elbe	(proper noun) the elbe river
electronic	elektronisch	electronic
eliane	eliane	(proper noun) eliane
elip	ovaal	ellipse
elizabeth	elizabeth	elizabeth
ellen	ellen	ellen
ellis	ellis	a name
elton	elton	(proper noun) elton, as in elton john
elvis	elvis	elvis
elíp	ovaal	ellipse
em	u	younger sibling
email	e-mail	email
emily	emily	(proper noun) emily, as in emily dickinson
emir	emir	emir
emmy	emmy	emmy
en	nl	erica reef
energy	energie	energy
engels	engels	engels
england	engeland	(proper noun) england, as in new england
eniac	eniac	eniac
entente	entente	entente
entropy	entropie	entropy
enzym	enzym	enzymes
eo	taille	eo, as in the film captain eo
ep	ep	a name
erich	erich	erich
erik	erik	erik, as in erik moller
eris	eris	eris
eritrea	eritrea	eritrea
ernest	ernest	(proper noun) ernest
eros	eros	eros, greek god of love
erwin	erwin	(proper noun) erwin, as in erwin rommel
españa	españa	espana
essential	essentieel	essential
ethernet	ethernet	ethernet
ethiopia	ethiopië	(proper noun) ethiopia
euclid	euclid	euclid
eugene	eugene	eugene
eugène	eugène	(proper noun) eugène
euler	euler	euler
euro	euro	euro, as in the european currency
eurofighter	eurofighter	eurofighter
europe	europa	europe
european	europese	(proper adjective) european
eva	eva	eva
everton	everton	everton
every	elk	every
exgay	exgay	exgay
explorer	ontdekkingsreiziger	explorer
extensive	uitgebreid	extensive
fabio	fabio	(proper noun) fabio
facebook	facebook	(proper noun) facebook
fact	feit	fact
facto	facto	this is french not vietnamese
faifo	faifo	(proper noun) faifo
fao	fao	fao
farrell	farrell	farrell
faso	faso	faso
fbi	fbi	fbi
fca	fca	fca
fdi	fdi	fdi
features	kenmerken	features
federer	federer	federer
feet	voeten	feet
felipe	felipe	felipe
felis	felis	(proper noun) felis
felix	felix	(proper noun) felix, as in felix klein
ferb	ferb	ferb
ferdinand	ferdinand	ferdinand
ferguson	ferguson	ferguson
fernando	fernando	fernando
ferrari	ferrari	ferrari
fiat	fiat	fiat
fidel	trouw	fidel
field	veld-	field
fifa	fifa	fifa
fifpro	fifpro	fifpro
figo	figo	figo
fiji	fiji	fiji
finish	af hebben	finish
firefox	firefox	(proper noun) mozilla firefox
fischer	fischer	fischer, as in louis fischer
fish	vis	fish
fishbed	visbed	fishbed
fitzgerald	fitzgerald	(proper noun) fitzgerald
flanker	flanker	flanker
fleming	vlaming	fleming
flight	vlucht	flight
foch	foch	(proper noun) foch
focus	focus	focus
foden	foden	(proper noun) foden, as in tom foden
fokker	fokker	fokker
food	eten	food
football	amerikaans voetbal	bong da
forbes	forbes	(proper noun) forbes, as in the magazine
ford	doorwaadbare plaats	(proper noun) ford
fordham	fordham	(proper noun) fordham
forks	vorken	forks
foundation	fundament	foundation
fox	vos	fox
fpt	fpt	a company name in vietnam
fracsin	fracsin	a function
franc	frank	franc
france	frankrijk	france
frances	frances	frances
francis	francis	francis, as in francis xavier
francisco	francisco	francisco
franco	franco	franco
frank	openhartig	frank
frankfurt	frankfurt	(proper noun) frankfurt
franklin	franklin	franklin
franz	franz	(proper noun) franz, as in franz ritter
freud	freud	(proper noun) freud, as in sigmund freud
friedman	friedman	friedman
fu	fu	fu
fujiko	fujiko	fujiko, as in japanese writer fujiko fujio
fujimoto	fujimoto	fujimoto
fukuoka	fukuoka	fukuoka
funimation	funimatie	(proper noun) funimation
funk	funk	funk
futsal	zaalvoetbal	futsal
fx	fx	fx
ga	ga	station
gabon	gabon	gabon
gabriel	gabriel	gabriel
gabriella	gabriella	gabriella
gagarin	gagarin	gagarin
gaia	gaia	gaia
gaillard	gaillard	gaillard
galilei	galilei	galilei
galileo	galileo	galileo, the astronomer
gam	gram	gam
gambia	gambia	gambia
gamow	gamow	a name
gan	lever	liver
gandhi	gandhi	gandhi, as in mahatma gandhi
gang	bende	cast iron
ganh	jaloers	to be jealous
gao	rijst-	strictly
gareth	gareth	a name
garrett	garrett	garrett
gary	gary	gary
gascon	gascon	(proper noun) gascon, a dialect of france
gatt	gatt	gatt
gaule	gaule	gaul, a region in ancient western europe
gaulois	gaulois	gaulois
gay	homo	tense
gaza	gaza	gaza
gdańsk	gdańsk	(proper noun) gdansk, poland
gdp	bbp	gdp
geisha	geisha	geisha
gen	genen	gene
gene	gen	(proper noun) gene, an english first name
genesis	genesis	(proper noun) genesis
georg	georg	(proper noun) georg
george	george	george
georges	georges	(proper noun) georges, a french name
gepard	gepard	gepard
ger	ger	ger
gerais	gerais	(proper noun) gerais
gerhard	gerhard	gerhard
german	duitse	german
germany	duitsland	germany
gerrard	gerrard	gerrard, a last name
ghana	ghana	(proper noun) the african country of ghana
ghe	boot	canoe
ghen	jaloers	to be jealous (v.)
ghi	schrijf de	write
ghim	pin	pin
ghé	hou op	visit
ghép	enten	fit
ghê	verschrikking	disgust
ghì	ghì	tighten
ghẻ	schurft	scabies (n.)
ghế	stoel	chair
ghề	stroomversnellingen	scabby
ghềnh	stroomversnellingen	waterfall (n.)
gia	gia	date
giai	stadium	period
giam	gevangenis	imprison
gian	ruimte	"(term should be ""thời gian"") time (n.)"
giang	giang	syphilis
gibraltar	gibraltar	(proper noun) gibraltar
gichin	gichin	gichin
gieo	zeug	sow
gifu	gifu	gifu, a district in northern japan
ginzan	ginzan	ginzan
gio	gio	wind
gioi	gioi	world
giuliani	giuliani	giuliani
giun	wormen	worm
giuse	giuse	giuse
giuộc	giuoc	"entire term should be ""can giuoc""; name of a vietnamese town"
giza	gizeh	giza
già	oud	old (adj.)
giàn	truss	"(term should be ""giàn hoa"") a trellis girder"
giành	gretig	secure
giàu	rijk	rich or wealthy (adj.)
giày	schoenen	a shoe
giá	prijs	estimate
giám	regisseur	"(term should be ""giám sát"") to supervise (v.)"
gián	kakkerlakken	"(term should be ""gián tiếp"") indirectly"
giây	seconden	seconds
giã	beukende	"(term should be ""từ giã"") to say farewell to (v.)"
giãn	uitrekken	stretch
gièm	tegenstanders	"(should be ""gièm pha"") to backstab"
giêhôva	giva	jehovah
giêng	giong	january
giêsu	jezus	jesus
giêxu	nexus	jesus
giò	loempia&#39;s	leg
giòi	maden	maggot (n.)
giòn	knapperig	crunchy or crispy (adj.)
gió	wind	wind
gióng	leuk vinden	align
giúp	helpen	help
giũa	het dossier	sharpen
giơ	vastlopen	raise
giương	affakkelen	posture
giường	bed	bed
giả	nep	fake (adj.)
giải	oplossing	solution
giảm	vermindering	decrease
giản	vereenvoudigd	"(term should be ""giản dị"") simple (adj.)"
giấc	slaap	giấc ngủ= the sleep
giấm	azijn	drabble
giấu	zich verstoppen	hide
giấy	papier	paper
giầu	rijk	rich
giận	boos	angry
giằng	verkwikkende	pull
giặc	vijand	enemy
giặt	wassen	to wash (n.)
giếng	goed	well
giết	doden	kill
giềng	buurman	"(term should be ""láng giềng"") neighboring"
giễu	belachelijk maken	ridicule
giọng	toon	tone
giọt	laten vallen	drop
giỏ	mand	basket
giỏi	super goed	good
giồng	giong	mound
giỗ	sterfdag	anniversaries of deaths
giới	geslacht	gender
giờ	uren	bao giờ=ever
giở	flash	to open or unfold (v.)
giỡn	een grapje	joke
giục	aangedrongen	urge
giữ	houden	hold
giữa	tussen	between
gladys	gladys	gladys
glazer	glazer	glazer
glonass	glonass	glonass
gloria	gloria	gloria
gloster	gloster	(proper noun) gloster, as in gloster meteor
glucose	glucose	glucose
gmail	gmail	gmail
gnp	b.n.p	gnp
go	gaan	"(term should be ""gay go"") tense"
goes	gaat	goes
goku	goku	goku
golden	gouden	golden
gom	verzamelen	to gather (v.)
google	google	google
gorbachev	gorbachev	gorbachev
gorbachyov	gorbachyov	gorbachev, as in former soviet president mikhail gorbachev
gordon	gordon	gordon, as in gordon brown
gore	gore	gore
gorky	gorky	gorky, as in gorky park
gothic	gotisch	gothic
gottfried	gottfried	gottfried
grabeel	grabeel	grabeel, a last name
graham	graham	graham
granada	granada	granada
granit	graniet	granite
greek	grieks	(proper noun) greek
greenland	groenland	greenland
greenson	greenson	(proper noun) greenson
greenwich	greenwich	(proper noun) greenwich
greg	greg	greg
grenada	grenada	grenada
grenadines	grenadines	grenadines
gross	bruto	gross
grumman	grumman	(proper noun) grumman
gruzia	georgië	gruzia
gryffindor	gryffindor	gryffindor
gs	gs	prof.
gsts	gsts	professor- phd
gu	stijl	gu
guam	guam	guam
guard	bewaker	guard
guatemala	guatemala	guatemala
gui	gui	gui
guinea	guinea	guinea
guinness	guinness	(proper noun) guinness
guitar	gitaar	guitar
gujarat	gujarat	gujarat
gulag	goelag	gulag
gulf	golf	gulf
gullit	gullit	(proper noun) gullit
gundam	gundam	(proper noun) gundam
gunung	gunung	(proper noun) gunung
gustave	gustave	gustave
gutenberg	gutenberg	gutenberg
guyana	guyana	guyana; proper noun
gà	kip	chicken
gài	plooi	to fasten (v.)
gào	schreeuwde	"(term should be ""thét gào"") to cry out (v.)"
gác	bewaker	guard
gái	meisje	girl
gán	toewijzen	"entire phrase should be ""gan nhan""; means ""to label"""
gánh	dragen	hold
gáy	nek	crow
gân	dichtbij	tendon
gây	oorzaak	make
gãy	gebroken	break
gì	wat	what
gìn	behouden	preserve
gò	heuvel	"(term should be ""gò má"") cheekbone (n.)"
gòn	gòn	gon
góa	weduwe	widowed
góc	hoek	angle
gói	pakket	goi
góp	termijn	to contribute
gót	hiel-	heels
gõ	type	type
göbbels	göbbels	gobbels, as in joseph gobbels
găm	schat	poniard
găng	handschoenen	gloves
gũi	dichtbij	close
gươm	zwaard	sword
gương	spiegel	mirror
gạc	gaas	johnson south reef
gạo	rijst-	rice
gạt	opgelicht	to cheat or trick (v.)
gả	huwelijk	marry
gảy	breken	"(term should be ""âm gảy"") a type of phonetic sound found in the japanese language (n.)"
gấc	gac	gac
gấm	brokaat	brocade
gấp	haast je	times, as in many times
gấu	de beer	a bear (n.)
gần	in de buurt van de	near
gầy	dun	thin
gẫy	gebroken	break
gập	vouwen	"(term should be ""gập ghềnh"") bumpy (adj.)"
gậy	stok	stick
gắm	scheet	send
gắn	gemonteerd	mount
gắng	proberen	try
gắt	hard	intense
gặm	knagen	rodent
gặp	ontmoeten	meet
gặt	oogsten	harvest
gỉ	roestig	rust
gọi	bellen	call
gọn	netjes	neat (adj.)
gọng	omrand	gong
gọt	pel	cut
gỏi	salade	a vietnamese salad
gốc	oorsprong	origin (n.)
gối	hoofdkussen	"(should be ""qùy gối"") to kneel"
gốm	keramiek	pottery
gồm	inclusief	include
gồng	gong	carry
gỗ	het hout	wood
gội	shampoo	shampoo
gộp	samenvoegen	aggregate
gớm	afschuwelijk	tremendous
gờ	richel	edge
gởi	sturen	send
gỡ	lossen	meet
gợi	suggestief	to evoke (v.)
gục	beneden	"(term should be ""đánh gục"") crush, as in battle"
gừng	gember	ginger
gửi	versturen	send
ha	ha	hectare
habana	habana	(proper noun) habana
habsburg	habsburg	(proper noun) habsburg
haeberle	haeberle	haeberle
hahn	hahn	hahn
hai	twee	two (adj.)
hal	hal	hal
halle	halle	(proper noun) halle
halogen	halogeen	halogen (n.)
ham	ham	desire
hamilton	hamilton	(proper noun) hamilton
han	han	han
hang	grot	cave
hangul	hangul	hangul
hanh	hanh	hanh
hanja	hanja	(proper noun) hanja, a type of chinese script
hansen	hansen	hasnen
hao	hao	"(term should be ""hao hụt"") to incur some loss (v.)"
harald	harald	harald
hardy	winterhard	hardy
harlem	harlem	harlem
harlow	harlow	harlow
harold	harold	(proper noun) harold
harper	harper	harper
harpercollins	harpercollins	hapercollins
harrier	kiekendief	harrier, as in harrier jump jet
harris	harris	harris
harry	harry	harry
harvard	harvard	(proper noun) harvard, the name of a college
harvey	harvey	harvey
havana	havana	(proper noun) havana, cuba
havilland	havilland	havilland
hawker	venter	hawker
hawking	hawking	(proper noun) hawking, as in physicist stephen hawking
hay	goed	or
hb	hb	hb
hbv	hbv	hbv
hcl	hcl	hcl
hd	hd	activity
he	hij	he, a korean name
health	gezondheid	health
heath	heide	heath
hee	hee	hee
hegel	hegel	(proper noun) hegel, as in georg wilhelm friedrich hegel
heian	heian	heian
heinrich	heinrich	heinrich
helen	helen	helen
helena	helena	helena
heli	helium	helium
hematocrit	hematocriet	hematocrit
hemoglobin	hemoglobine	hemoglobin
hen	kip	asthma
henry	henry	(proper noun) henry, as in henry kissinger
heo	muf	dolphin
her	haar	her
herbert	herbert	herbert, as in herbert schandler
hercegovina	hercegovina	hercegovina
hercules	hercules	hercules
hermann	hermann	hermann
hermes	hermes	hermes
hersh	hersh	hersh, as in seymour hersh
hesiod	hesiod	hesiod
hestia	hestia	hestia
hi	hoi	"(term should be ""hi vọng"") alternative spelling for ""hy vọng""; meaning ""hope"" (n.)"
hickam	hickam	(proper noun) hickam
hicks	hicks	hicks
hideto	verborgen	(proper noun) hideto
hideyoshi	hideyoshi	(proper noun) hideyoshi
hidro	waterstof	hydrogen
hillsborough	hillsborough	hillsborough
hilton	hilton	hilton
himalaya	himalaya	(proper noun) himalaya
hinata	hinata	hinata
hindenburg	hindenburg	(proper noun) hindenburg
hindi	hindi	hindi
hindu	hindoe	hindu, as in the hindu religion
hinh	hinh	(proper noun) a vietnamese first name
hinhtron	hinhtron	circle
hiragana	hiragana	hiragana
hiroshi	hiroshi	hiroshi
hiroshima	hiroshima	(proper noun) hiroshima, the japanese city
hitchcock	hitchcock	hitchcock
hitler	hitler	hitler
hitter	slagman	hitter
hitters	slagmensen	hitters
hiên	veranda	(proper noun) hiên, a vietnamese first name
hiđrô	waterstof	hydrogen
hiếm	bijzonder	rare
hiến	geven	devote
hiếp	verkrachting	rape
hiếu	kinderlijke vroomheid	pious
hiềm	ziek	grudge
hiền	salie	sage
hiểm	gevaarlijk	dangerous
hiểu	begrijpen	learn
hiện	opdagen	"(term should be ""thực hiện"") to accomplish"
hiệp	voor de helft	united
hiệu	effect	effective
hlv	trainer	trainer
hms	hms	hms
hmông	hmong	hmong
hn	hn	hn
hoa	bloem	flower
hoan	festival	welcome
hogwarts	zweinstein	(proper noun) hogwarts, sorcery school from the harry potter series
hoi	hoi	rare
hokage	hokage	hokage
hokusai	hokusai	hokusai
holmes	holmes	a name
holocaust	holocaust	holocause
holocen	holoceen	holocen
holt	holt	holt, an english last name
hom	stekken	a cutting
homer	homerus	(proper noun) homer, the authorof the iliad and the odyssey
hon	hon	"(term should be ""hòn"") rock (n.)"
honduras	honduras	honduras
hong	hong	hong
honolulu	honolulu	honolulu
honshū	honshū	honshu
hopkins	hopkins	(proper noun) hopkins
hornet	horzel	hornet
hotspur	hotspur	(proper noun) hotspur, as in tottenham hotspur
houston	houston	(proper noun) houston, as in whitney houston
howard	howard	(proper noun) howard
however	echter	however
hoà	stropdas	peace
hoài	nostalgisch	always (adv.)
hoàn	compleet	"(term should be ""hoàn toàn"") completely"
hoàng	koning	royal (adj.)
hoành	diafragma	rife
hoá	chemie	"(term should be ""văn hoá"") culture (n.)"
hoán	permanent	refined (adj.)
hoãn	ze eten	delay
hoạ	verf	disaster (tham hoa)
hoại	gangreen	"(term should be ""phá hoại"") to sabotage (v.)"
hoạt	hentai	work
hoả	brand	of
hoảng	paniek	panic-stricken (adj.)
hoặc	of	or
hp	hp	hp
hq	hq	hq
hudgens	hudgens	(proper noun) hudgens
hudson	hudson	hudson
huey	huey	huey
hughes	hughes	hughes
hugo	hugo	(proper noun) hugo
hume	hume	hume, as in david hume
hun	hun	(proper noun) hun
hungary	hongarije	hungary
hunt	jacht	hunt
hurley	hurley	(proper noun) hurley, as in chad hurley
hussein	hussein	hussein
husserl	husserl	huserl
huston	huston	huston
hutech	hutech	hutech
huy	huy	a common vietnamese first name
huynh	broer	older brother
huyền	mystiek	huyền thoại= legend
huyễn	denkbeeldig	huyen
huyện	wijk	district
huyệt	acupunctuurpunten	lair
huân	huan	"(term should be ""huân chương"") medal (n.)"
huê	tint	"a less common vietnamese word for ""flower"""
huấn	opleiding	"(term should be ""huận luyện"") to train (v.)"
huế	tint	hue
huệ	tint	favour
huống	geval	situation
huỳnh	zwavel	sulfur
huỷ	annuleer	destroy
hydra	hydra	hydra, a monster in greek mythology
hydro	waterstof	hydrogen
hyperion	hyperion	hyperion
hà	ha	"(term should be ""hà nội"") the capital of vietnam"
hài	komedie	corpse
hàm	kaak	"(term should be ""bao hàm"") to imply (v.)"
hàng	rij	row
hào	gracht	depreciation
hách	aanmatigend	glorious
hái	kiezen	picking
hán	droogte	china
háo	gretig	eager
hát	zingen	song
hâm	gek	"(term should be ""hâm mộ"") to admire (v.)"
hân	han	le ngoc han
hãi	bang	to be scared (v.)
hãn	khan	to sweat (v.)
hãng	de firma	a company (n.)
hãnh	trots	proud
hè	zomer	summer
hé	gekraakt	reveal
héo	verdorren	dried-out
hét	roepen	shout
hên	lucky	luck
hí	ne	game
hít	ademen	act of kissing (hon hit)
hò	dating	date
hòa	stropdas	republic
hòe	shit	hoe
hòm	ark	box
hòn	eiland	island
hòng	goed	in order to
hóc	hóc	a corner (n.)
hót	zingen	to chirp or sing (v.)
hô	ho	respiration
hôi	vals	stink
hôm	dag	day (n.)
hôn	kus	propose
hông	heup	hip
hù	laten schrikken	threaten
hùng	helden	hero
húc	gore	huc
húng	inspiratie	"(should be ""húng láng"") water mint"
hút	roken	to suck (v.)
hăng	scherp	enthusiasm
hđbt	hđbt	hdbt
hđh	hđh	system software
hũ	potten	jar
hơi	een klein beetje	slightly
hơn	dan	more or less
hư	slecht	fictional
hưu	gepensioneerd	huu
hương	wierook	smell
hước	humoristisch	humor
hướng	richting	trend
hường	huong	huong
hưởng	genieten	influence
hạ	zomer	lower
hạc	flamingo&#39;s	crane
hạch	ganglion	ganglion
hại	kwaad	harm
hạng	klasse	rank
hạnh	hanh	happy
hạo	hao	hao
hạp	hap	hap
hạt	zaad	seed
hải	douane	two
hảo	perfect	perfect
hấn	hấn	aggressive gesture
hất	gooien	toss
hấu	watermeloen	"(term should be ""dưa hấu"") watermelon"
hầm	tunnel	ham
hầu	bijna	most
hận	een hekel hebben aan	hatred
hậu	koningin	anus
hắc	zwart	black
hắn	hem	he (n.)
hắt	niezen	reject
hằng	constante	every
hặc	hặc	to criticize (v.)
hẹ	sjalotten	chinese chives
hẹp	smal	narrow
hẻm	steeg	alley (n.)
hẻo	afgelegen	outback
hến	mosselen	mussel
hết	over-	most
hề	clown	"(term should be ""không hề"") never"
hễ	eh	whenever
hệ	systeem	relation
hệt	identiek	exactly
hỉ	blazen	happy
hịch	plof	a proclamation
họ	achternaam	they (n.)
họa	kunst	picture
họach	plan	"(term should be ""quy hoạch"") a project (n.)"
học	leren	study (v.)
họng	keel	throat
họp	vergadering	meet
hỏa	brand	fire
hỏng	gebroken	corruption
hố	pit	hole
hốc	niches	cavity
hồ	meer	ho
hồi	anijs	muslim
hồn	ziel	soul
hổ	tijger	tiger
hổi	huh	"(term should be ""nóng hổi"") steaming hot (adj.)"
hổng	gapend	hole
hỗ	ondersteuning	"(should be ""hỗ trợ"") to support or assist"
hỗn	gemengd	"(term should be ""hỗn tạp"") mish-mash (adj.)"
hội	festival	society
hộp	doos	box
hới	open	hoi
hớn	schreeuwden	"(term should be ""hớn hở"") radiant (adj.)"
hờn	nukkig	hatred
hở	open	reveal
hỡi	oi	dear
hợi	varken	pig (n.)
hợp	goed geschikt	appropriate
hợpquận	toestemming	general district
hụt	tekort	loss
hủi	melaatse	reject
hủy	annuleer	to erase or destroy
hứa	belofte	promise
hử	he	hu
hửu	he	"(term should be ""sở hửu"") to own (v.)"
hữu	eigendom	(proper noun) hữu, a vietnamese middle name; also means right, as in the direction
hựu	huu	again
hỷ	hy	hy
ian	ian	ian, as in australian swimmer ian thorpe
iau	iau	iau
iberia	iberia	iberia
ibm	ibm	(proper noun) ibm, the computer company
ibmpc	ibmpc	ibm-pc
ic	ic	ic
icc	icc	icc
iceland	ijsland	(proper noun) the country of iceland
ide	ide	ide
ieng	ieng	(proper noun) ieng
igor	igor	igor
iii	iii	third
ilene	ilene	ilence
illusion	illusie	illusion
ilyich	ilyich	ilyich
im	im	still
imam	imam	(proper noun) imam
imbrium	onbalans	imbriun
immanuel	immanuel	(proper noun) immanuel, as in immanuel kant
impact	gevolg	impact
incoterm	incoterm	incoterm
incoterms	incoterms	(proper noun) incoterms
indian	indisch	indian
indiana	indiana	indiana
indochina	indo-china	indochina
indonesia	indonesië	indonesia
indrapura	indrapura	(proper noun) indrapura
info	info	info
innsbruck	innsbruck	innsbruck
insulin	insuline	insulin
int	int	int
intel	intel	(proper noun) intel, as in the name of the company
interpol	interpol	interpol
inu	inu	(proper noun) inu
inuyasha	inuyasha	inuyasha
inư	inu	(proper noun) inư
io	io	io
ioc	ioc	ioc
ion	ion	ion
iosif	iosif	(proper noun) iosif, as in iosif vissarionovich stalin
iran	iran	the nation of iran
iraq	irak	iraq
ireland	ierland	ireland
irgun	irgun	irgun
irony	ironie	irony
irving	irving	(proper noun) irving
isaac	isaac	isaac
isla	isla	isla
islam	islam	islam
islamabad	islamabad	(proper noun) islamabad
israeli	israëlisch	israeli
istanbul	istanbul	istabbul
italia	italia	italy
italiano	italiano	(proper noun) italiano
itanium	itanium	itanium, as in windows xp itanium
ito	ito	ito
itsukushima	itsukushima	itsukushima
itu	itu	itu
itzá	itzá	(proper noun) itzá
iv	iv	4 ( greek number)
iwami	iwami	iwami
j	j	j
jack	jack	jack
jackie	jackie	(proper noun) jackie chan
jackson	jackson	(proper noun) jackson, as in michael jackson
jacob	jakob	jacob
jae	jae	jae
jakarta	jakarta	(proper noun) jakarta
jan	jan	(proper noun) jan
janeiro	janeiro	janeiro
janet	janet	janet
japan	japan	japan
jared	jared	jared
jarvis	jarvis	(proper noun) jarvis, as in jarvis cocker
jasper	jasper	(proper noun) jasper
jean	jean	jean
jeane	jeane	jeane
jeanjacques	jeanjacques	jean-jacques
jeanpaul	jean paul	jeanpaul
jeans	jeans	jeans
jeet	jeet	(proper noun) jeet, as in jeet kune do
jeff	jeff	jeff, as in jeff drake
jefferson	jefferson	jefferson
jeffrey	jeffrey	jeffrey
jeju	jeju	jeju
jenda	jenda	jenda
jenny	jenny	jenny
jericho	jericho	jericho, as in wrestler chris jericho
jerome	jerome	jerome, as in fred jerome
jerry	jerry	(proper noun) jerry
jersey	jersey	jersey
jerusalem	jeruzalem	jerusalem
jesse	jesse	a name
jesus	jezus	chua jesus
jetstar	jetstar	jetstar
jewish	joods	jewish
jiao	jiao	jiao
jimmy	jimmy	jimmy
jin	jin	jin
jing	jing	jing
jiraiya	jiraiya	(proper noun) jiraiya
joachim	joachim	joachin
joan	joan	a name
joe	joe	(proper noun) joe
johan	johan	johan
johann	johann	johann
johannes	johannes	johannes
johannesburg	johannesburg	(proper noun) johannesburg, south africa
johnny	johnny	johnny
johns	onderbroek	johns
johnston	johnston	johnston, as in harry johnston
johor	johor	johor
joint	gewricht	joint
jonathan	jonathan	(proper noun) jonathan
jones	jones	jones
jose	jose	(proper noun) jose, a spanish first name
joseon	joseon	(proper noun) joseon
joseph	joseph	joseph
jscript	jscript	(proper noun) jscript
juche	juche	(proper noun) juche
judith	judith	judith
judo	judo	judo, the martial art
julesverne	jules verne	jules verne
julliard	julliard	(proper noun) julliard
jump	springen	jump
june	juni	june, as in the month
jung	jung	jung
junsu	junsu	junsu
jupiter	jupiter	(proper noun) jupiter, as in the planet
jura	jura	(proper noun) jura
juventus	juventus	juventus
k	k	k
kaede	kaede	a japanese name
kaffee	kaffee	(proper noun) kaffee, as in kaffee hag
kagome	kagome	kagome, as in higurashi kagome
kahn	kahn	kahn
kai	kai	kai
kakashi	kakashi	kakashi
kaká	kaká	(proper noun) kaka, a brazilian soccer player
kalashnikov	kalashnikov	(proper noun) kalashnikov
kali	kalium	potassium
kama	kama	(proper noun) kama, as in the kama sutra
kamakura	kamakura	kamakura
kamov	kamov	kamov
kampf	kampf	kampf
kampong	kampong	kampong
kampuchea	kampuchea	cambodian
kana	kana	kana, the japanese phonetic alphabet
kangin	kangin	(proper noun) kangin
kanji	kanji	kanji
kant	kant	a name
kar	kar	(proper noun) kar
kara	kara	kara
karaoke	karaoke	karaoke
karate	karate	karate
karatedo	karate doen	karatedo
karen	karen	(proper noun) karen
karim	karim	(proper noun) karim
kashmir	kasjmir	kashmir
kaspersky	kaspersky	(proper noun) kaspersky, as in kaspersky anti-virus software
katakana	katakana	katakana, a type of japanese script
kate	kate	(proper noun) kate, as in actress kate winslet
katherine	katherine	katherine
kathmandu	kathmandu	kathmandu
katrina	katrina	(proper noun) katrina, as in hurricane katrina
katz	katz	katz
kauthara	kauthara	kauthara, a part of the ancient kingdom of champa
kavkaz	kaukasus	kavkaz
kawasaki	kawasaki	(proper noun) kawasaki
kay	kay	kay
kazan	kazan	kazan, the name of a city
kcn	kcn	industrial zone
ke	ke	"(term should be ""boong ke"") a bunker (n.)"
kelly	kelly	kelly
kelsi	kelsi	kelsi
kelvin	kelvin	kelvin
kem	room	ice cream (n.)
ken	ken	ken
kennedy	kennedy	(proper noun) kennedy, as in john f. kennedy
kenneth	kenneth	(proper noun) kenneth, a name
kenny	kenny	kenny, an english first name
kentucky	kentucky	(proper noun) kentucky
kepler	kepler	kepler
kerala	kerala	(proper noun) kerala
kevin	kevin	kenvin
keynes	keynes	keynes, as in economist john maynard keynes
kg	kg	kilogram
kha	kha	(proper noun) a vietnamese first name
khai	verklaring	announce
khali	khali	(proper noun) khali
khalip	khalip	(proper noun) khalip
kham	kham	endure
khan	watervrij	rare
khang	khang	khang
khanh	khanh	khanh
khao	verlangen	desire
khay	dienblad	tray
khe	sleuf	chink
khem	khem	abstinence
khen	lof	praise
kheo	op stelten	kheo
khi	wanneer de	when
khieu	begrijp het niet	(proper noun) khieu, as in khieu samphan
khiêm	bescheiden	khiem
khiên	schild	a shield
khiêu	erotisch	"('khiêu dâm"") pornographic"
khiếm	verminderd	lack
khiến	oorzaak	control
khiếp	doodsbang	horrible
khiếu	lodge	talent (n.)
khiển	controle	control
khleang	khleang	kh'leang
kho	magazijn	warehouse
khoa	faculteit	"(term should be ""y khoa"") the study of medicine (n.)"
khoan	boren	drill
khoang	holte	brag
khoanh	rinkelen	a slice (n.)
khoe	pronken	to boast
khoá	slot	lock
khoác	overjas	coat
khoán	voorraad	stock
khoáng	mineraal	mineral
khoát	definitief	decisive
khoét	besnoeiing	carve
khoăn	tobben	disturbed
khoả	naakt	naked
khoản	item	an item (n.)
khoảng	ca.	about
khoảnh	momenten	moment
khoẻ	prima	health
khrushchev	chroesjtsjov	khrushchev
khrushchyov	chroesjtsjov	khrushchyov
khu	kwartalen	section
khung	kaders	frame
khural	khural	khural
khuynh	links	trend
khuyên	advies	advise
khuyết	defecte	lack
khuyển	hond	khuyen
khuất	verborgen	hidden
khuấy	geroerd	stir
khuẩn	bacteriën	bacteria
khuếch	versterken	amplification
khuỷu	elleboog	elbow
khá	liever	quite
khác	andere	different
khách	gast	customer
khái	conceptueel	concept
khám	examen	discover
khán	het publiek	audience
kháng	weerstand	appeal
khánh	onafhankelijkheid	a type of chime made of stone (n.)
khát	dorstig	to be thirsty for (adj.)
khâm	khâm	admire
khèn	helaas	a pan-pipe (n.)
khéo	ingenieus	cleverly or skillfully (adv.)
khép	dichtbij	close
khía	inkeping	"(term should be ""khía cạnh"") angle (n.)"
khích	aanmoedigen	encourage
khít	dichtbij	close
khó	moeilijk	difficulty
khóa	opsluiten	a session
khóc	huilen	cry
khói	rook	smoke
khóm	ananas	a cluster
khô	droog	dry
khôn	wijs	clever, intelligent
không	is niet	not
khúc	segment	song
khăm	slecht ruikend	nasty (adj.)
khăn	handdoek	difficult
khơi	offshore	sea
khư	khư	grip
khưu	khưu	khuu
khước	ontkennen	waive
khả	mogelijkheid	"(term should be ""khả năng"") ability (n.)"
khải	openbaring	triumph
khảm	mozaïek-	to encrust
khảo	examen	"(term should be ""tham khảo"") to consult (v.)"
khấm	doorboord	endure
khấn	bidden	pray
khấu	korting	"(term should be ""sân khấu"") a stage (n.)"
khẩn	dringend	"(term should be ""khẩn cấp"") urgent (adj.)"
khắc	inkeping	moment
khắp	voorbij	all over
khẳng	bevestigend	"(term should be ""khẳng định"") to assert (v.)"
khế	stervrucht	bond
khỉ	aap	monkey or ape (n.)
khỏa	naakt	nude
khỏe	sterk	health
khỏi	uit	leave
khố	lendendoek	loincloths
khốc	verschrikkelijk	devastating
khối	niveau	a block or mass of (n.)
khốn	bastaard-	miserable
khống	khong	control
khổ	lijden	miserable (adj.)
khổng	reusachtig	huge
khởi	initieert	start
khủng	vreselijk	"(term should be ""khủng bố"") terrorist (n.)"
khủyu	bastaard-	elbow
khứu	pastel	olfactory
khử	elimineren	reduction
ki	ki	"entire phrase is ""ki lo""; means ""kilometer"""
kia	dat	other
kid	kind	kid
kiel	kiel	(proper noun) kiel
kierkegaard	kierkegaard	kierkegaard, as in soren kierkegaard
kiernan	kiernan	kiernan
kii	kii	kii
kikyo	kikyo	kikyo
kilômét	kilometers	kilometer
kim	kim	kim
kingdom	koninkrijk	kingdom
kinsey	kinsey	kisney
kiribati	kiribati	kiribati
kishimoto	kishimoto	(proper noun) kishimoto
kiss	kus	kiss
kissinger	kissinger	kissinger
kitts	kitts	kitts
kitô	christian	christian
kiêm	cum	cum
kiên	geduldig	consistent
kiêng	zich onthouden	abstinence, as in abstaining from eating
kiêu	arrogant	showy
kiếp	levenslang	a lifetime (n.)
kiết	kiết	cheap (adj.)
kiềm	alkalisch	"(term should be ""kiềm chế"") to restrain (v.)"
kiểm	controleren	control
kiểu	type	type
kiệm	zuinig	save
kiện	aanklagen	event (su kien)
kiệt	meesterwerk	exhausted (adv.)
kiệu	draagstoel	scallion
klaus	klaus	klaus
klein	klein	klein
km	kilometer	kilometer
knesset	gebreid	knesset
knuth	knuth	knuth, as in donald knuth
koch	koch	koch
kodansha	kodansha	kodansha
kofun	kofun	kofun, as in the kofun period of japanese history
kogoro	kogoro	kogoro
komodo	komodo	komodo
kon	kon	"(term should be ""kon tum"") a province in the highlands of vietnam"
kong	kong	(proper noun) kong, as in hong kong
konstantin	konstantin	(proper noun) konstantin
konversationslexikon	konversationslexikon	konversation-lexikon
kop	kop	kop
koran	koran	koran
kornai	kornai	(proper noun) kornai, as in janos kornai
koruna	koruna	koruna
kosovo	kosovo	(proper noun) kosovo
kremli	kremli	kremil
kremlin	kremlin	kremlin
kristen	kristen	kristen
krông	krong	krong
ku	ku	is a name
kuala	kuala	(proper noun) kuala, as in kuala lumpur
kubrick	kubrick	kubrick
kuen	kuen	kuen
kuiper	kuiper	(proper noun) kuiper, as in the kuiper belt
kulak	koelak	kulak
kune	kune	(proper noun) kune, as in the martial art jeet kune do
kung	kung	danh vo
kungfu	kungfu	kung fu
kunst	kunst	kunst, as in richard kunst
kurd	koerd	kurd
kurt	kurt	(proper noun) kurt
kuwait	koeweit	kuwait, the country (n.)
kwan	kwan	kwan
kwen	kwen	kwen
kwon	kwon	kwon, as in tae kwon do; proper noun
kyrgyzstan	kyrinkistan	(proper noun) the country of kyrgyzstan
kyushu	kyushu	kyushu
kyūshū	kyushu	kyushu, a japanese island
kèm	ingesloten	included
kèn	trompet	horn
kém	minst	less
kén	cocon	selective
kéo	slepen	scissors
kép	dubbel	dual
két	kluizen	"(term should be ""rốc két"") rocket (n.)"
kê	gierst	statistics
kênh	kanalen	channel
kêu	klinkend	appeal
kìa	zie	that
kìm	tang	bar
kình	bril	rivalry
kí	teken	sign
kích	klik	excite
kíchbom	klikknop	bombers
kín	privaat	secretive or closed tight (adj.)
kính	bril	respect
kíp	bemanning	esoterica
kít	krijste	wheelbarrow
ký	teken	"(""nhật ký"") a diary"
kĩ	voorzichtig	technique
kơnia	kàia	a tree found in southeast asia; sometimes called wild mango
kạn	kan	kan
kẹo	snoep	candy
kẹp	klem	to clamp down (v.)
kẹt	zit vast	jam
kẻ	jongens	guy
kẻo	niet	lest
kẽ	interstitial	crevice
kẽm	zink	zinc
kế	de volgende	a scheme (n.)
kết	einde	combine
kề	aangrenzend	adjacent
kềnh	omvangrijk	bulky
kệ	planken	ignore
kỉ	eeuw	"(term should be ""kỉ niệm"") souvenir (n.)"
kị	cavalerie	ki
kịp	houden	kip
kỵ	cavalerie	taboo
kỷ	eeuw	"(term should be ""thế kỷ"") century (n.)"
l	l	l.
label	label	label
laboulaye	laboulaye	a name
ladakh	ladakh	(proper noun) ladakh
lai	hybride	"(term should be ""tương lai"") the future (n.)"
lam	lam	lam
lama	lama	a name
lan	lan	a name
land	land-	land
landon	land op	a name
lang	lang	lang
langdon	langdon	langdon
lange	lange	lange, as in oscar lange
langue	langue	langue
lanh	linnen	ringing
lanka	lanka	(proper noun) lanka, as in the island of sri lanka
lao	tb	labor
laos	laos	(proper noun) laos
lap	ronde	greek
larry	larry	larry
lars	lars	lars
las	las	(proper noun) las, as in las vegas
laser	laser	laser
lateran	lateraan	lateran
latinh	latijns	latin
latvia	letland	(proper noun) latvia
lau	veeg	lau
laura	laura	(proper noun) laura, as in laura bush
laurence	laurence	(proper noun) laurence
lawrence	lawrence	(proper noun) lawrence
lay	leggen	lay
lazarus	lazarus	(proper noun) lazarus
leach	uitlogen	(proper noun) leach
leaf	blad	leaf
leave	vertrekken	leave
lebanon	libanon	(proper noun) lebanon
lee	lee	lee
legacy	erfenis	legacy
leiden	leiden	leiden
lem	lem	cinderella
lenin	lenin	lenin
lenins	lenins	lenin's
leo	beklimmen	climb
leon	leon	leon
leonard	leonard	leonard
leonardo	leonardo	(proper noun) leonardo, as in leonardo da vinci
leonid	leonid	leonid
les	les	les
leslie	leslie	a name
lesotho	lesotho	lesotho
lg	lg	lg
lhp	lhp	film festival
lhq	lhq	un
libby	libby	(proper noun) libby
libero	libero	libero
libya	libië	libya
lido	lido	lido
liechtenstein	liechtenstein	liechtenstein
liga	liga	a name
lightning	bliksem	lightning
lilly	lilly	(proper noun) lilly
linga	linga	linga
linh	linh	efficacious (adj.)
links	koppelingen	links
linux	linux	linux server
lionel	lionel	lionel
lisboa	lisboa	lisboa
lisbon	lissabon	a name
litva	litouwen	(proper noun) lithuania
liu	liu	liu
liêm	integriteit	good example
liên	onderneming	relate
liêng	heilig	sacred
liêu	bureaucratie	bureaucracy
liềm	sikkel	sickle
liều	dosis	daring
liễu	wilg	a willow tree (n.)
liệng	werpen	"(term should be ""cánh liệng"") the aileron of a plane (n.)"
liệt	verlamming	impotent
liệu	of	document
lleyton	lleyton	lleyton
lo	zich zorgen maken	to worry (v.)
loa	spreken	"(term should be ""cổ loa"") an ancient vietnamese city (proper noun)"
loaita	loaita	loaita
loang	glad	patchy
loch	loch	loch
locke	locke	(proper noun) locke, as in philosopher john locke
lockheed	lockheed	(proper noun) lockheed, as in lockheed martin
log	logboek	log
logan	logan	a name
lon	kan	lon
london	londen	london
long	lang	dragon
lorenzo	lorenzo	lorenzo
los	los	los, as in los angeles
louis	louis	louis
louisiana	louisiana	(proper noun) the state of louisiana
louvre	rooster	(proper noun) louvre
love	liefde	yeu
loài	soorten	species
loát	opzichtig	overturn
loãng	wasachtig	wishy-washy
loét	zweer	gaping, as in a wound
loại	soorten	type
loạianh	type	not a word
loạianime	type anime	type anime
loạibệnh	type ziekte	disease
loạichiến	type	loaichien
loạicác	type	item
loạicâu	type	type: club
loạicông	type	type: industry
loạicựu	type	kind former
loạigia	type	loaigia
loạihuân	kindhuan	not a word
loạiluật	soort wet	type: law
loạimáy	type machine	kind plane
loạimôn	type	type
loạingày	typ dit	loaingay
loạiphim	filmtype	type movie
loạiphong	type	kind of movement
loạiscandal	type	scandal type
loạithuật	soort wet	type: lexicon
loạithành	type	kinds of payment
loạithần	type	kind myth
loạitrường	soort school	type of school
loạitín	soort	type: belief
loạitổ	type	kind organization
loạivõ	type type	type: martial art
loạixã	type	kind of society
loạn	wanorde	disorderly
loạt	serie	series
lp	lp	lp
lu	lu	dim
luang	luang	a name
lucas	lucas	(proper noun) lucas
lucia	lucia	lucia, as in the island of saint lucia
luciano	luciano	luciano
ludendorff	ludendorff	luđenorff
ludovico	ludovico	ludovico
ludwig	ludwig	ludwig
lui	terug	withdrawal
luis	luis	(proper noun) luis, a first name
luiz	luiz	luiz
lula	lula	lula
lung	long	shake
lustig	lustig	lusig
luther	luther	luther
luxembourg	luxemburg	a name
luy	luy	luy
luyến	hechting	love
luyện	opleiding	training
luận	commentaar	"(term should be ""xã luận"") an editorial"
luật	de wet	law
luồn	schroefdraad	wriggle
luồng	stroom	lane
luộc	gekookt	boiled
luỹ	cumulatief	rampart (n.)
ly	glas	divorce
lydia	lydia	lydia
lympho	lymfoom	lymphocyte
lyndon	lyndon	lyndon
lyon	lyon	lyon
là	was	the verb to be
làm	doen	make
làn	rijbaan	wave
làng	dorp	village
lành	genezen	protestant
lào	laos	laos
lá	bladeren	"(term should be ""lá thư"") a letter (n.)"
lác	scheel	brag
lách	milt	to swerve (v.)
lái	rijden	to drive (v.)
lán	keet	shack
láng	glanzend	neighbours
lâm	lam	lâm, a common vietnamese first name
lân	eenhoorn	nearby
lâu	lang	long time
lây	besmettelijk	to infect
lãi	interesseren	a profit
lãm	shows	exhibition
lãnh	ontvangen	to receive
lão	oud	old
lèo	lèo	"(term should be ""nước lèo"") broth (n.)"
lén	uitglijden	sneak
lê	peer	le
lêmạc	licht	"(term should be ""lê-mạc"") a war between two ruling families in ancient vietnamese history"
lên	omhoog	on
lênh	opdracht	"(should be ""lênh đênh"") adrift"
lênin	lenin	lenin
lìa	vertrekken	to leave (v.)
lình	plotseling	suddenly
lí	opslag	reason
lính	soldaat	soldier
lít	liter	litre
líu	coo	"(term should be ""dính líu"") to have a connection with"
lò	oven	release
lòng	verpletteren	heart
lóc	snakehead	cry
lóe	flitste	flash
lóng	jargon	"entire term should be ""tieng long""; means ""slang"""
lót	voering	undies
lô	veel	batch
lôi	fout	encourage
lôn	lol	"(term should be ""côn lôn"") a village in vietnam"
lông	haar-	hair
lõi	kern	core
lõm	concaaf	concave
lùi	achteruit	back
lùn	kort	dwarf
lùng	jacht	hunt
lúa	rijstveld	rice
lúc	bij	at the moment
lún	verzakking	subside
lúng	gloed	confused
lúp	vergroten	uneven
lút	stiekem	surreptitiously
lăm	vijf	tens
lăn	rollen	attack
lăng	mausoleum	tomb
lĩnh	domeinen	"(term should be ""thủ lĩnh"") the leader (n.)"
lũ	overstroming	a band or gang (n.)
lũng	vallei	valley
lũy	cumulatief	rampart
lơ	verwaarlozing	to ignore
lơi	maak los	"(term should be ""lả lơi"") to act in a familiar or flirting manner (adv.)"
lư	wierookvat	an urn
lưng	terug	back
lươn	paling	eel
lương	salaris	conscience
lưới	raster	a net (n.)
lướt	surfen	ski
lười	lui	lazy
lưỡi	tong	tongue
lưỡng	biseksueel	"(term should be ""lưỡng tính"") bisexual"
lược	kam	invasion
lượm	verzamelen	pick up
lượn	glijden	to glide over (v.)
lǐ	ik	(proper noun) li, as in jet li
lạ	vreemd	strange or unusual (adj.)
lạc	verloren	camel
lạch	kreek	"(term should be ""luồng lạch"") a narrow water passageway"
lại	opnieuw	reversed
lạn	verrot	bright
lạng	lang	lang
lạp	worst	"(term should be ""hy lạp"") greek"
lạtma	lamma	lama
lạy	knielen	kowtow
lấn	aantasting	to encroach on (v.)
lấp	vullen	sparkle
lấy	kiezen	taken
lầm	mis	wrong
lần	keer	time
lầu	verdieping	a story or level of a building (n.)
lầy	moerassig	swamp
lẩu	hot pot	hotpot
lẩy	springen	get
lẫn	verward	each other
lẫy	snuifje	illustrious
lận	bedriegen	fraudulent
lật	omdraaien	turn
lậy	o ja	"(term should be ""cai lậy"") the name of a rural district"
lắc	schudden	to shake (v.)
lắm	heel	do
lắng	af te wikkelen	"(should be ""lo lắ́́ng"") to worry"
lắp	passend	lap
lặng	rustig	quiet
lặp	herhaling	repeat
lặt	diversen	means miscellaneous, part of the word lat vat
lẹ	snel	quickly (adv.)
lẻ	vreemd	"(the term should be ""bán lẻ"") retail"
lẻn	sluipen	sneak
lẻo	laks	climb
lề	marge	alignment
lều	tent	tent
lễ	ceremonie	ceremony
lệ	tarief	"(term should be ""tỷ lệ"") probability (n.)"
lệch	scheef	difference
lệnh	comeinand	command
lị	dysenterie	"(term should be ""tỉnh lị"") a township (n.)"
lịch	kalender	history
lọc	filter	tricked
lọi	scheel	brilliant
lọng	parasol	rope
lọt	vallen	enter
lỏi	pluisjes	to enter
lỏng	los	loose
lố	over-	ridiculous
lốc	wervelwind	tornado
lối	ingang	way or path
lốp	band	tyre
lốt	gedaante	lolot
lồ	reusachtig	giant
lồi	convex	convex
lồng	kooi	cage
lỗ	gat	hole
lộc	fortuin	loc
lội	zwemmen	wade
lộn	omgedraaid	wrong/mistake
lộng	prachtig	"(term should be ""cổ lộng"") the name of a vietnamese city"
lột	strippen	exploit
lớn	groot	large
lớp	klasse	grade (n.)
lờ	negeren	turbid
lời	woord	advice
lở	mevrouw	to crack
lỡ	mevrouw	miss
lợi	winst	benefit
lợn	varken	pig
lợp	dakbedekking	roof
lụa	zijde	silk
lục	groen	record
lụi	platgebrand	ruin
lụt	overweldigen	flood
lụy	implicaties	consequence
lứa	afval	peer
lừa	truc	mislead
lừng	illuster	well-known
lửng	das	lơ lửng= not clear/ something in between
lự	aarzelend	reluctant
lựa	geselecteerd	chosen
lựu	granaatappel	grenade
ma	geest	ma sat (friction), ma thuat (magic), thay ma (zombie)
maastricht	maastricht	maastricht
macarthur	macarthur	macarthur
macclesfield	macklesfield	macclesfield
macedonia	macedonië	(proper noun) macedonia
mach	mach	mach
machiavelli	machiavelli	machiavelli, as in philosopher niccolo machiavelli
machu	machu	machu
macintosh	macintosh	macintosh
macma	magma	magma
macromedia	macromedia	macromedia
madeira	madeira	madeira
madhouse	gekkenhuis	madhouse
madison	madison	madison
madonna	madonna	(proper noun) madonna
madrid	madrid	madrid, as in the capital of spain
mafia	maffia	mafia
magiê	magnesium	magnesium
mahal	mahal	(proper noun) mahal, as in the taj mahal
mai	dak	"(term should be ""giang mai"") the disease syphilis (n.)"
mainframe	mainframe	mainframe
major	majoor	major
makemake	maken	makemake
malacca	malakka	malacca
malay	maleis	malaysia
malaysia	maleisië	(proper noun) the country of malaysia
malcolm	malcolm	malcolm
maldini	maldini	maldini
mali	mali	mai
malta	malta	malta
maluku	maluku	maluku
manche	manche	manche
manchester	manchester	manchester
mandela	mandela	mandela, as in nelson mandela
mandy	mandy	mandy
mang	carry	to bring (v.)
manga	manga	manga
mangnall	mangnall	(proper noun) mangnall, as in ernest mangnall
manh	manh	fragile
manila	manilla	manila, the capital of the philippines
mankiw	mankiw	mankiw, as in gregory mankiw
manti	manti	mantle
manuel	manuel	manuel
mao	mao	capillary
maps	kaarten	maps
maradona	maradona	(proper noun) maradona, as in soccer player diego maradona of argentina
marat	marat	(proper noun) marat, as in marat safin, a tennis player
marc	marc	marc, as in marc chagall
marcel	marcel	(proper noun) marcel, a french name
marcos	marcos	(proper noun) marcos, as in ferdinand marcos
marcus	marcus	marcus, as in marcus aurelius (n.)
margaret	margaret	(proper noun) margaret
maria	maria	(proper noun) maria
marianne	marianne	(proper noun) marianne
marie	marie	marie
marina	jachthaven	marina
marino	marino	marino
marić	marić	maric
marmara	marmara	(proper noun) marmara, as in the sea of marmara
marne	marne	marne, as in the marne river (n.)
mars	mars	mars
marseille	marseille	marseille
marshall	maarschalk	marshall
marsu	marsu	(proper noun) marsu
marta	marta	(proper noun) marta, as in the female brazilian soccer player
martin	martin	martin
marx	marx	this is a name
mary	maria	(proper noun) mary
maryland	maryland	a name
maría	maría	maria
mas	mas	mas
massachusetts	massachusetts	massachusetts
mat	mat	mat
mathematica	mathica	(proper noun) mathematica, as in isaac newton's work, principia mathematica
mats	matten	mats, as in mats sundin
matthias	matthias	matthias, as in matthias erzberger
mau	snel	fast
maurice	maurice	(proper noun) maurice
mausolus	mausolus	mausolus
maxim	maxim	a name
may	naaien	lucky
maya	maya	(proper noun) maya
mcafee	mcafee	(proper noun) mcafee
mccain	mccain	mccain
mccartney	mccartney	a name
mccullough	mccullough	mccullough
mcdonald	mcdonald	(proper noun) mcdonald
mchc	mchc	mchc
mclaren	mclaren	mclaren
mcmahon	mcmahon	(proper noun) mcmahon
mcnamara	mcnamara	(proper noun) mcnamara, as in robert mcnamara
mcv	mcv	mean corpuscular volume
media	media	media
medici	medici	(proper noun) medici, as in the medici family of italy
medina	medina	(proper noun) medina, as in ernest medina
medvedev	medvedev	medvedev
mekong	mekong	mekong
melbourne	melbourne	melbourne
mendeleev	mendelejev	mendeleev
menes	menes	(proper noun) menes
mercedes	mercedes	a name
messenger	boodschapper	messanger
messerschmitt	messerschmitt	messerschmitt, as in the messerschmitt me-109, a german plane
messi	messi	(proper noun) messi, as in argentinian soccer player lionel messi
messiah	messias	messiah
meteora	meteora	meteora
mext	mext	mext
meyer	meyer	(proper noun) meyer, as in stephenie meyer, author of the twilight series
meyers	meyers	meyers
miami	miami	a name
michael	michael	michael
michaels	michaels	michaels
michelangelo	michelangelo	michelangelo
michigan	michigan	a name
micro	micro	micro
microbiology	microbiologie	microbiology
microeconomics	micro-economie	microeconomics
micronesia	micronesië	micronesia
microsoft	microsoft	(proper noun) the microsoft company
miguel	miguel	miguel
mike	mike	mike
mikoyan	mikoyan	mikoyan
mikoyangurevich	mikoyangurevich	(proper noun) mikoyangurevich
milan	milaan	milan
milano	milano	milano
miley	miley	miley
mill	molen	mill
miller	molenaar	miller
milton	milton	milton
min	min	min
minas	minas	minas
mindanao	mindanao	(proper noun) mindanao
ming	ming	ming
minnesota	minnesota	minnesota
minoa	minoa	minoa; the minoan civilization
miraflores	miraflores	miraflores
mirage	luchtspiegeling	mirage
miroku	miroku	(proper noun) miroku, a japanese name
misfits	buitenbeentjes	misfits
mississippi	mississippi	mississippi
missouri	missouri	(proper noun) the state of missouri
mitchel	mitchel	mitchel
mitsubishi	mitsubishi	mitsubishi
miên	hypnose	mien
miêu	kat	"(term should be ""miêu tả"") to describe (v.)"
miến	rijstnoedel	burma
miếng	stukken	a piece (n.)
miếu	tempel	temple
miền	domein	area
miễn	vrijgesteld	to exempt (v.)
miện	kroon	crown
miệng	mond	mouth
mm	mm	millimeter
mobile	mobiel	mobile
mode	modus	mode
modul	module	module
modula	modula	(proper noun) modula, as in modula-2
mohammad	mohammad	mohammad
mohammed	mohammed	mohammed
moi	nieuw	winkle
molecular	moleculair	molecular
molotov	molotov	molotov
molypden	molybdeen	the element molybdenum (n.)
mongolia	mongolië	mongolia
monique	monique	(proper name) monique, a french first name
mono	mono	mono
monroe	monroe	monroe
mont	mont	(proper noun) mont
montaigne	montaigne	montaigne, as in michel de montaigne
montana	montana	(proper noun) montana, as in the state
montenegro	montenegro	montenegro
montmartre	montmartre	(proper noun) montmartre
montparnasse	montparnasse	montparnasse
montreal	montreal	(proper noun) montreal, quebec
moo	loeien	(proper noun) moo, as in cha moo won
moong	moong	moong
mora	mora	mora
moravia	moravië	moravia
morgan	morgan	(proper noun) morgan
mori	mori	(proper noun) mori
moriarty	moriarty	(proper noun) moriarty, as in james moriarty from sherlock holmes
morley	morley	morley
morocco	marokko	morocco
morris	morris	morris
morrison	morrison	(proper noun) morrison
morse	morse	(proper noun) morse, as in morse code
moscow	moskou	moscow
mosin	mosin	mosin
moskva	moskva	moscow
motown	motown	motown
mourinho	mourinho	mourinho
movie	film	movie
mozambique	mozambique	(proper noun) mozambique
mozart	mozart	(proper noun) mozart, as in the composer
mp	mp	mp
ms	mevrouw	metre per second
msdos	msdos	ms-dos
mtv	mtv	mtv
mu	mu	pubis
mua	kopen	buy
much	veel	much
muhammad	mohammed	(proper noun) muhammad, as in muhammad ali
mumbai	mumbai	mumbai
mun	ebbehout	a vietnamese name
munich	münchen	(proper noun) munich
murdoch	murdoch	murdoch
muromachi	muromachi	(proper noun) muromachi
murphy	murphy	murphy
murray	murray	(proper noun) murray, as in dr. conrad murray
mustang	mustang	mustang, as in the f-51 mustang
muta	muta	a name
muôn	willen	a large number; thousands (adj.)
muối	zout	salt
muốn	willen	want
muống	lepel	"(term should be ""rau muống"") water spinach (n.)"
muồi	laat	ripe
muỗi	mug	mosquito
muỗng	lepel	spoon
muội	zus	confusion
muộn	laat	late (adv.)
myanma	myanmar	the country of myanmar
myanmar	myanmar	(proper noun) myanmar
myspace	mijn ruimte	(proper noun) myspace
mà	maar	also
mài	slijpen	tomorrow
màn	scherm	curtain (n.)
mành	jaloezieën	a bamboo screen (n.)
mào	kam	a comb or crest, as in the body part of a bird
màu	kleur	color
mày	u	sew
má	moeder	cheek
mác	label	a name (marx)
mách	tips	tell
máclênin	marxel	marxist-leninist
mái	dak	"entire term should be ""thoai mai""; means ""comfortable"""
mát	koel	cool
máu	bloed	blood
máy	machine	a machine (n.)
mâm	dienblad	tray
mân	rozenkrans	"entire term should be ""man viet""; a country of ancient asia that now corresponds to a province in southern china"
mâu	tegenstrijdig	contradiction
mây	wolk	cloud
mã	code	"(term should be ""la mã"") roman (adj.)"
mãi	voor altijd	forever (adv.)
mãimại	code	commerce
mãn	zelfgenoegzaam	satisfy
mãnh	sterk	intense
mão	kronen	cat
mè	sesam	sesame
mèo	kat	cat (n.)
mé	me	a border
méo	vervormd	alter
mép	rand	edge
mét	meter	meter
mênh	onthutsend	vast
mêtan	methaan	methane
mì	noedels	wheat
mình	jezelf	me
mía	riet	sugar cane (n.)
mò	onhandig	to grope (v.)
mòn	parcours	trail
móc	haak	"(term should be ""máy móc"") machinery (n.)"
món	eten	dish
mô	zakdoek	mo
môi	elk	lip
môn	onderwerpen	anus
mông	billen	mongolia
mônôxít	monoxide	monoxide
môt	een	"(term should be ""một"") one (n.)"
môtô	motorfiets	motorcycle
mù	blind	mu
mùa	seizoen	season
mùi	geur	smell
múa	dans	dance
mút	zuigen	to suck (v.)
münchen	münchen	(proper noun) munchen
măng	bamboe schiet	bamboo shoot (n.)
mĩ	amerika	america
mũ	hoed	cap
mũi	neus-	nose
mơ	droom	vague
mơn	poten	caress
mưa	regen	rain
mưu	sluw	"(should be ""tham mưu"") advisors"
mươi	vijftig	tens
mương	afvoer	ditch
mướn	huur	hire
mướt	zijdezacht	smooth (adj.)
mường	muong	(proper noun) mường, a minority people in vietnam (n.)
mượn	lenen	borrow
mượt	glad	glossy (adj.)
mạc	woestijn	"(should be ""mộc mạc"") simple or natural"
mạch	stroomkring	vessel
mại	handel	commerce
mạn	kant	romantic
mạnh	sterk	strong
mạo	artikel	"(should be ""mạo hiểm"") to brave danger"
mạt	mijten	"(term should be ""lê mạt"") the ending or decline of something (adj.)"
mả	graven	tomb or grave (n.)
mải	druk	absorbedly
mảng	matrix	genre
mảnh	stuk	piece
mất	verloren	lose
mấu	tabblad	key
mấy	weinig	any
mầm	kiem	kindergarten
mầu	kleur	color
mẩu	stukken	piece
mận	pruim	plum
mập	vet	fat
mật	lieve schat	intimate
mậu	handel	mau
mắc	duur	get
mắm	vissaus	"(term should be ""nước mắm"") fish sauce (n.)"
mắn	lucky	"(term should be ""may mắn"") fortunate (adj.)"
mắng	schelden	scold
mắt	oog	eye
mặc	slijtage	wear
mặn	zout	salt
mặt	gezicht	face
mẹ	mam	mother (n.)
mẹo	tips	trick
mẻ	partij	cool
mẽ	sterk	strong
mến	geachte	to adore or like greatly (v.)
mề	spiermaag	locket
mềm	zacht	soft
mệnh	lot	revolution
mệt	moe	tired
mỉ	nauwkeurig	meticulous
mỉa	sarcasme	ironic
mỉm	glimlach	smile
mịch	shit	"(term should be ""tịch mịch"") quiet (adj.)"
mịn	glad	smooth
mịt	snuiven	dim
mọc	groeit	to grow (v.)
mọi	elk	every
mọn	bekrompen	lowly
mỏ	mijnen	mine
mỏi	moe	tired (adj.)
mỏng	dun	thin
mốc	muf	border
mối	termiet	relationship
mốt	mode	fashion or style (n.)
mồ	graf	"(term should be ""mồ hôi"") sweat (n.)"
mồi	aas	bait (n.)
mổ	chirurgie	to dissect or perform surgery (v.)
mỗi	elk	every
mộ	graf	admire
mộc	timmerwerk	simple
mộng	droom	dream
một	een	one
mới	nieuw	new (adj.)
mờ	wazig	dim
mời	nodig uit	invite
mở	open	open
mỡ	vet	fat or grease (n.)
mục	het voorwerp	purpose
mụn	acne	pimple
mức	niveau	level
mứt	jam	preserve
mừng	blij	to be happy
mửa	braken	to vomit (v.)
mực	inkt	"(term should be ""chuẩn mực"") standard (n.)"
mỳ	noedel	noodles (n.)
mỹ	amerika	america
mỹcông	amerika	my private
na	na	"(term should be ""na uy"") the country of norway"
naadam	naadam	naadam
nacional	nacional	nacional
nagant	nagant	nagant
nagar	nagar	nagar, as in champa po nagar
nagasaki	nagasaki	(proper noun) the city of nagasaki, japan
nagoya	nagoya	a name
nagumo	nagumo	nagumo
nai	herten	a deer
nairobi	nairobi	nairobi, a city in kenya (n.)
nakajima	nakajima	a japanese name
nalbandian	nalbandian	a name
nam	mannetje	male
nambắc	noorden	nambac
namibia	namibië	namibia
namnam	nam nam	male-male
namno	namno	nammo
nancy	nancy	nancy, as in nancy pelosi
nang	follikel	"(term should be ""cẩm nang"") a handbook (n.)"
nanh	hoektanden	fang
nano	nano	nano
naomi	naomi	naomi, as in model naomi campbell
napoleon	napoleon	(proper noun) napoleon
napoli	napoli	(proper noun) napoli
napoléon	napoleon	napoleon
nara	nara	nara
nasa	nasa	(proper noun) nasa
nat	nat	nat
nathan	nathan	nathan
natri	natrium	sodium
nauru	nauru	a name
nava	nava	nava
navarre	navarra	navarre
nay	nu op	this (adj.)
needham	needham	needham
nelson	nelson	(proper noun) nelson, as in nelson mandela
neo	anker	"(term should be ""mỏ neo"") an anchor (n.)"
neon	neon	neon
nepal	nepal	nepal
nepomuk	nepomuk	a name
nessie	nessie	(noun) nessie, the nickname of the loch ness monster
net	netto	net
netbook	netbook	netbook
netscape	netscape	netscape
networks	netwerken	networks
neumann	neumann	(proper noun) neumann
neutrino	neutrino	neutrino
nevada	nevada	nevada
neverland	nooitgedachtland	neverland
newcastle	newcastle	newcastle
newspaper	krant-	newspaper
newton	newton	newton
newtons	newton	(proper noun) newton's
next	de volgende	next
nga	rusland	russia
ngai	de troon	crown
ngang	horizontaal	horizontal
ngao	clam	clam (n.)
ngay	rechtsaf	even
nghe	luister	hear
nghinh	nghinh	welcome
nghiêm	ernstig	serious
nghiêng	geneigd zijn	inclined
nghiêu	nghieu	nghiêu, a vietnamese name
nghiền	squish	crush
nghiễm	jammer	serious
nghiệm	ervaring	experiment
nghiện	verslaafd	addiction
nghiệp	karma	karma/ sự nghiệp=career
nghiệt	grimmig	adverse
nghành	industrie	faculty
nghèo	arm	poor
nghé	nghe	to glance out of the corner of one's eye (v.)
nghê	nghe	nghe khuong
nghênh	welkom	support
nghìn	duizend	thousand
nghĩ	denken	think
nghĩa	middelen	meaning
nghẽn	congestie	jam
nghếch	luid	stupid
nghề	beroep	career
nghệquận	kunst	art district
nghỉ	vakantie	relaxation
nghị	aanbevelingen	think
ngo	sierlijk	ngo
ngoan	goede jongen	good
ngoc	ngoc	"(term should be ""ngọc"") gem (n.)"
ngon	smakelijk	delicious
ngoài	uit	outside of
ngoại	buitenlands	external
ngoạn	adembenemend	spectacular
ngoặc	haakjes	bracket
ngoặt	beurt	landmark
ngu	slaap	stupid
ngung	ngung	(proper noun) a vietnamese first name
nguyen	nguyen	nguyen
nguyên	origineel	reason
nguyền	vloek	curse
nguyện	gelofte	"(term should be ""mãn nguyện"") to be satisfied (adj.)"
nguyệt	maan	moon
nguôi	rustgevend	fade away
nguồn	bron	source
nguời	mensen	people
nguỵ	dwazen	camouflage
ngà	ivoor	russian
ngàn	duizend	thousand
ngàng	ngàng	"(term should be ""ngỡ ngàng"") to be at fault (adj.)"
ngành	afdeling	sector
ngào	zoet	sweet
ngày	dag	day
ngách	niche	"entire term should be ""ngoc ngach""; means ""a small, out-of-the-way road"""
ngái	dom	chinese ethnic group living in the vietnamese highlands near the china border
ngán	verveeld	to be tired of
ngáng	ngáng	stop
ngát	flauwvallen	"(term should be ""ngát hương"") fragrant (adj.)"
ngân	bank	money
ngây	blank	"(term should be ""ngây ngất"") to be in ecstasy"
ngãi	ngai	ngai
ngò	koriander	coriander
ngó	kijken	to look (v.)
ngói	tegel	tile or shingle
ngón	vinger	a finger (n.)
ngót	krimp	"(term should be ""rau ngót"") also called sweet leaf, a type of leafy vegetable used to make soup (n.)"
ngôn	taal	manifesto
ngông	gans	eccentric
ngõ	rijbaan	lane
ngùi	geur	sad
ngút	ngut	"entire term is ""ngut troi""; means ""sky-high"""
ngăn	gedeelte	prevent
ngũ	slaap	rank
ngơ	buiten beschouwing gelaten	ignored (adj.)
ngơi	rust uit	"(term should be ""nghỉ ngơi"") to rest (v.)"
ngư	visser	fishermen
ngưng	hou op	stop
ngưu	os	buffalo
ngươi	u	an ancient form of address equivalent to thou or thee (n.)
người	mensen	people
ngưỡng	drempel	religious
ngược	omgekeerde	opposite
ngạc	verrast	surprise
ngạch	rang	"(term should be ""kim ngạch"") turn-over (n.)"
ngạn	bank	bank
ngạnh	weerhaken	self-willed
ngạo	verwaand	"(term should be ""ngạo ngược"") insolent (adj.)"
ngạt	verstikking	stuffy
ngấm	doordrenkt	draw
ngất	flauw	unconscious
ngầm	impliciet	underground
ngần	aarzelen	hesitate
ngẩn	met stomheid geslagen	froze
ngẫm	nadenken	think
ngẫu	willekeurig	ngẫu nhiên= random
ngậm	zuigtabletten	keep
ngập	overstroomd	flood
ngắm	overwegen	to contemplate or look admiringly at something (v.)
ngắn	kort	short
ngặt	strak	strict
ngọ	middag	horse
ngọc	edelsteen	pearl
ngọn	top	top
ngọt	zoet	sweet (adj.)
ngồi	zitten	sit
ngộ	verlichting	ngo
ngột	abrupt	sudden
ngớ	dwaas	silly
ngời	mensen	bright
ngỡ	gedachte	surprised
ngợi	lof	praise
ngợm	ondeugend	naughty
ngục	gevangenis	dungeon
ngụm	slokje	sip
ngụy	wei	puppet
ngủ	slapen	sleep
ngủi	kort	"(should be ""ngắn ngủi"") short-lived"
ngứa	jeuk	itchy
ngừ	tonijn	tuna
ngừa	voorkomen	prevent
ngừng	ophouden	to cease (v.)
ngửa	gezicht omhoog	supine
ngửi	geur	to smell
ngữ	toespraak	term
ngự	wonen	defend
ngựa	paard	horse
ngực	borst	chest
nha	tandarts	dental
nhakẻ	kind	nha-ke
nham	lava	"(actual term is ""dung nham"") lava"
nhan	nhan	"(term should be ""dung nhan"") countenance or facial appearance (n.)"
nhang	wierook	incense
nhanh	snel	fast
nhat	nhat	nhat
nhen	nieuw leven ingeblazen	rekindle
nhi	kinderen	junior
nhiên	cursus	tuy nhiên= however
nhiêu	veel	how many
nhiều	veel	numerous
nhiễm	besmet	infect
nhiễu	lawaai	noise
nhiệm	plicht	task
nhiệt	warmte	heat
nhk	nhk	nhk
nhs	nhs	nhs
nhu	leuk vinden	demand
nhuận	winst	leap year
nhuệ	nhue	elite
nhuộm	kleurstof	dye
nhàn	inactief	leisure
nhàng	voorzichtig	"(term should be ""nhẹ nhàng"") gentle (adj.)"
nhào	kneden	to fall headlong
nhác	speling	coward
nhái	klonen	illegal copy
nhánh	afdeling	branch
nháp	droogte	draft
nháy	knippert	to flash or blink (v.)
nhâm	dompelen	leap
nhã	smaakvol	"(term should be ""thanh nhã"") elegant"
nhãn	label	"(term should be ""gán nhãn"") to affix a label"
nhét	zetten	put
nhì	tweede	second (adj.)
nhìn	kijken	to look (v.)
nhí	babbelen	children
nhím	egel	porcupine
nhòm	kijken	to peep (v.)
nhóc	kind	brat
nhóm	groep	group (n.)
nhô	uitstekend	emerge
nhôm	aluminium	aluminum (n.)
nhúng	dip	embed
nhút	verlegen	shy
nhăn	gerimpeld	wrinkle
nhĩ	atriaal	turkey
nhũ	emulsie	"(term should be ""thạch nhũ"") stalactite (n.)"
nhũng	corruptie	bribery
nhơn	vermenigvuldigen	nhon
như	net zo	like
nhưng	maar	but
nhương	speeksel	(proper noun) vietnamese first name
nhường	gaf weg	yield
nhưỡng	vettig	soil
nhược	zwakheid	weak
nhượng	concessies	concession
nhạ	nhạ	nha
nhạc	muziek-	music
nhạn	slikken	bird
nhạo	spotten	ridicule
nhạt	bleek	light
nhạy	gevoelig	sensitive
nhảy	dans	jump
nhấc	optillen	lift
nhấm	nippen	rodent
nhấn	drukken	to press (v.)
nhất	het beste	most
nhầm	mis	misunderstand
nhầy	slijmerig	glutinous
nhẫn	ringen	patient
nhậm	gestempeld	inaugurate
nhập	importeren	penetrate
nhậu	drinken	drink
nhậy	gevoelig	sensitive
nhắc	prompt	to remind (v.)
nhắm	doel	aim
nhắn	de boodschap	message
nhằm	richten	for the purpose of (adv.)
nhẵn	glad	smooth
nhặt	kiezen	pickup
nhẹ	licht	light
nhẹn	behendig	nhanh nhẹn= fast/nimble
nhị	meeldraad	sensitive
nhịn	zich onthouden	fasting
nhọ	pech	smear
nhọn	scherp	sharp (adj.)
nhỏ	klein	small
nhỏ|cây	kleine | boom	small|tree
nhỏ|một	klein | een	small | one
nhỏ|phải|	klein | rechts |	small|right
nhỏ|phải|px|	klein | rechts | px |	small | have | px |
nhỏ|phải|px|bức	klein | rechts | px | foto&#39;s	grape / fade / px / buc
nhỏ|phải|px|cây	klein | rechts | px | boom	px spicy grape fade
nhỏ|phải|px|khu	kleine | rechter | px | zone	small|right|px|area
nhỏ|phải|px|michael	klein | rechts | px | michael	small|right|px|michael
nhỏ|phải|px|máy	kleine | juiste | px | machine	small | right|px|machine
nhỏ|phải|px|một	klein | rechts | px | één	small|right|px|one
nhỏ|phải|px|quân	small | right | px | force	small|right|px|army
nhỏ|px|	klein | px |	small
nhỏ|px|các	klein | px | de	small
nhỏ|px|phải|kiến	klein | px | rechts | mier	small | px | right | patience
nhỏ|quân	klein | kracht	small|army
nhỏ|trái|px|máy	kleine | linker | px | machine	small|left|px|plane
nhỏ|tượng	kleine beelden	small|statue
nhốt	opgesloten	confine
nhồi	gevuld	cram
nhổ	plukken	uproot
nhộn	hilarisch	busy
nhớ	geest	remember
nhớt	stroperig	viscid
nhờ	bedankt	by
nhờn	vettig	multiplication
nhở	herinneren	remind
nhụ	snuifje	nhu
nhục	vernederd	shame
nhủ	herinneringen	needs
nhức	pijn	pain
nhứt	eerste	first (n.)
nhừ	papperig	tender
những	deze	the
nhựa	plastic	plastic
nhựt	nhut	"like the word ""nhật""; meaning ""sun"" (n.)"
ni	ni	nun
nia	nia	a flat basket (n.)
nicaea	nicaea	nicaea
nicaragua	nicaragua	(proper noun) nicaragua
niccolò	niccolò	(proper noun) niccolo, as in writer niccolo machiavelli
nicolas	nicolas	(proper noun) nicolas, as in nicolas sarkozy
niels	niels	(proper noun) niels
nigeria	nigeria	nigeria
nikel	nikel	nickel
niken	nikkel	nickel
nikita	nikita	(proper noun) nikita, a first name
nikko	nikko	(proper noun) nikko
nikolai	nikolai	nikolai
nikolayevich	nikolayevich	nikolayevich
nil	nihil	nile
nile	nijl	(proper noun) the river nile
nimitz	nimitz	(proper noun) nimitz, as in the ship uss nimitz
nin	nin	nin
ninh	veiligheid	ninh, as in bắc ninh
nintendo	nintendo	(proper noun) nintendo, the game company
nippon	nippon	nippon
nitơ	stikstof	nitrogen (n.)
nixon	nixon	(proper noun) nixon, as in former president richard nixon
niên	jaar	youth
niết	niet	nirvana
niềm	genoegen	trust
niệm	mindfulness	concept
niệu	diurese	urinary
nj	nj	nj
nlf	nlf	nlf
nm	nm	nano-meters
noah	noach	(proper noun) noah
nobel	nobel	nobel
nobita	nobita	nobita
noel	noel	(proper noun) noel
noi	zeggen	imitate
nokia	nokia	(proper noun) nokia, as in the nokia corporation
nol	nol	nol
nom	nom	look after
non	jong	mountain
nonpenetrative	niet penetrerend	nonpenetrative
norfolk	norfolk	norfolk
norge	norge	norge
norma	norma	(proper noun) norma, a female first name
norman	norman	norman
normandie	normandie	normandile
northrop	northrop	northrop, as in the northrop f-5 freedom fighter
norton	norton	norton
norway	noorwegen	norway
nou	nou	nou
novak	novak	novak
now	nu	now
nowc	nowc	nowc
noãn	zaadknop	ovule
nsnd	nsnd	people's artist
nst	nst	chromosome
nubia	nubia	nubia
number	aantal	number
nupedia	nupedia	a name
nusa	nusa	nusa
nuôi	eten geven	feed
nuối	slikken	"(term should be ""tiếc nuối"") to regret (v.)"
nuốt	slikken	to swallow (v.)
nuớc	water	water
nxb	nxb	publisher
nynorsk	nynorsk	nynorsk
nà	nà	na
nài	aandringen	pleading
nàn	geklaagd	poor
nành	soja	soy
nào	kom op	would
này	dit	this
ná	ná	a crossbow (n.)
nách	oksel	underarm (n.)
náo	rumoerig	riot
nát	verpletterd	ruin
náu	zich verstoppen	hide
nâng	verheffen	raise
nâu	bruin	brown
nã	nã	to track down (v.)
não	hersenen	brain
né	ontwijken	dodge
ném	werpen	to throw (v.)
nén	gecomprimeerd	compress
nét	beroertes	feature
nê	ne	ne
nên	kandelaar	should or ought to
nêu	vertellen	mention
nòi	ras	race
nòng	loop	barrel
nói	spreken	to say or speak (v.)
nón	hoed	cone
nóng	heet	hot
nô	slaaf	slave
nôbita	tobita	nobita
nôi	wieg	cradle
nôm	nôm	ancient vietnamese script that borrowed heavily from han chinese characters
nôn	braken	vomit
nông	oppervlakkig	farmer
nõn	pellen	peeled
nùng	nung	nung
núm	knop	nipple
núp	zich verstoppen	hide
nút	knoop	button
năm	jaar	year
năn	berouwvol	"(term should be ""ăn năn"") remorse (n.)"
năng	macht	"(term should be ""khả năng"") ability (n.)"
nơi	plaats	a place
nơtrino	neutino	neutrino
nước	land	country
nước 	land	water
nướng	gegrild	grill
nǎm	nǎm	year
nạ	masker	mask
nạc	slank	lean (adj.)
nại	klagen	complain
nạn	nood	a disaster (n.)
nạo	curettage	to scrape (v.)
nạp	geladen	tribute
nản	ontmoedigd	depressed
nảy	stuiteren	"(term should be ""nảy sinh"") to give rise to (v.)"
nấc	hik	a hiccup (n.)
nấp	zich verstoppen	hide
nấu	koken	cook
nấy	dit	this
nần	duwtje	debt
nầy	dit	this
nẩy	stuiteren	"(term should be ""nảy nở"") to sprout or start growing (v.)"
nẫu	n zon	"(""giọng nẫu"") a vietnamese accent commonly found in cities such as phú yên"
nậm	nam	"(term should be ""nậm rốm"") the name of a river in vietnam (proper noun)"
nập	heet	busy
nắm	houden	to grasp or hold (v.)
nắng	zonnig	sunlight
nắp	deksel	a lid or cover (n.)
nằm	liggen	to lie (v.)
nẵng	nang	"(term should be ""Đà nẵng"") a city in central vietnam"
nặc	anoniem	heavy
nặn	knijpen	mould
nặng	zwaar	heavy
nẻo	een ander	turn
nếm	smaak	taste
nến	kaars	candle
nếp	kleverig	sticky rice (n.)
nếu	als	if (adv.)
nề	metselwerk	severe
nể	respect	respect
nện	beukende	ram
nỉ	voelde	beg
nịnh	vleien	flatter
nọ	de andere	the other
nọc	venijn	tadpole
nỏ	kruisboog	a crossbow (n.)
nối	verbonden	connection
nốt	notitie	to finish off (v.)
nồi	pot	pot
nồm	nek	humid (adj.)
nồng	heet	heavy
nổ	explosief	explode
nổi	drijvend	nổi tiếng= famous
nỗ	poging	affort
nỗi	dat	state
nộ	toorn	anger
nội	intern	on the paternal side (adj.)
nộn	vulling	non
nộp	gearchiveerd	submit
nới	maak los	ease
nở	bloeiend	bloom
nỡ	hartelijk	do you have a heart to
nợ	in de schulden	debt
nụy	stamper	"(term should be ""nụy nhân"") the vietnamesized han term depicting the japanese"
nứa	kurk	a kind of bamboo (n.)
nứt	gebarsten	to crack
nửa	voor de helft	haft
nữa	opnieuw	moreover
oahu	oahu	(proper noun) oahu
oai	vrees	heroic
oakland	oakland	oakland
oan	onrecht	injustice
oanh	oanh	(with word liet) glorious
obama	obama	obama
oblast	oblast	(proper noun) oblast, as in tomsk oblast
oc	oc	oc
october	oktober	(proper noun) october
oda	o da	oda
oder	oder	oder
odyssey	odyssee	odyssey, as in the odyssey, homer's epic
oecd	oecd	oecd
officer	officier	officer
officers	officieren	officers
ohkawa	ohkawa	ohkawa
okhotsk	okhotsk	okhotsk
oliver	oliver	oliver
olivier	olivier	olivier
olympus	olympus	olympus
om	gestoofd	to simmer
omar	omar	a name
ong	bij	bee
ontario	ontario	ontario
oort	oort	oort
oprah	oprah	(proper noun) oprah, as in oprah winfrey
organ	orgaan	organ
oricon	oricon	oricon
origin	oorsprong	origin
orion	orion	(proper noun) orion, the hunter
orleans	orleans	(proper noun) orleans, as in new orleans
orochimaru	orochimaru	orochimaru
orton	orton	orton
os	os	os
osaka	osaka	(proper noun) osaka, a city in japan
osama	osama	(proper noun) osama, as in osama bin laden
osamu	osamu	(proper noun) osamu, a japanese first name
oscar	oscar	oscar
osiris	osiris	(proper noun) osiris, as in the egyptian god
oskar	oskar	a name
oslo	oslo	oslo
osment	osment	osment
ospf	ospf	ospf
ossetia	ossetia	(proper noun) ossetia
oswald	oswald	oswald
other	andere	other
otto	otto	(proper noun) otto, as in otto von bismarck
ottoman	poef	(proper noun) ottoman, as in the ottoman empire
outstanding	uitstekend	xuat sac
owen	owen	(proper noun) owen, as in michael owen
oxford	oxford	oxford
oxy	zuurstof	oxygen
ozawa	ozawa	(proper noun) ozawa, as in maria ozawa
oán	wrok	"(term should be ""oán than"") to complain or whine"
oát	watt	a watt (n.)
oản	oàn	"(term should be ""ăn oản"") gratitude and resentment (n.)"
paget	paget	(proper noun) paget
pailin	pailin	pailin
pakistan	pakistan	(proper noun) the country of pakistan
palais	palais	palais, as in grand palais
palawan	palawan	palawan
palenque	palenque	(proper noun) palenque
palestine	palestina	a name
palgrave	palgrave	palgrave
pali	pali	a name
pamir	pamir	pamir
pan	pan	pan, as in peter pan
panama	panama	panama
panamax	panamax	(proper noun) panamax
panduranga	panduranga	(proper noun) panduranga
panthera	panthera	(proper noun) panthera, a genus of felines
panthéon	pantheon	a name
paolo	paolo	paolo
paperback	paperback	paperback
papua	papoea	papua
paraguay	paraguay	(proper noun) paraguay
pari	pari	pari
park	park	park
parton	parton	parton
patel	patel	(proper noun) patel
patrick	patrick	patrick
patriot	patriot	patriot
paul	paul	paul
paula	paula	paula
paulo	paulo	(proper noun) paulo
pavia	pavia	pavia
pbs	pbs	pbs
pda	pda	pda
pdf	pdf	pdf
pedro	pedro	pedro
peers	leeftijdsgenoten	peers
pele	pele	(proper noun) pele, as in the soccer player
penang	penang	penang
penh	penh	(proper noun) penh, as in phnom penh
pennsylvania	pennsylvania	pennsylvania
penny	cent	(proper noun) penny, an english first name
pereira	pereira	pereira
perl	perl	(proper noun) perl
pero	pero	pero
perry	perry	(proper noun) perry, as in elizabeth perry
persephone	persephone	presephone
pershing	pershing	pershing
persian	perzisch	persian
peru	peru	peru, as in the south american country
peters	peters	peter's, possessive of peter
petersburg	petersburg	(proper noun) petersburg, as in saint petersburg
pfm	pfm	a name
pgs	pag	associate professor
pgđ	pgđ	associate professor
pha	gemengd	to mix
phaethon	phaethon	phaethon
pham	pham	pham
phanh	rem	expose
phao	vlotter	float
phaolô	paul	st. paul, the apostle
pharaoh	farao	pharaoh
pharaon	faraon	pharaoh
phay	frezen	mill
phe	factie	faction
phen	fen	time
phil	phil	(proper noun) phil, a first name
philip	philip	philip
philippe	philippe	philippe
philippines	filippijnen	(proper noun) philippines
phillip	phillip	(proper noun) phillip
phillips	phillips	philips
philosophiae	philosophiae	(proper noun) philosophiae, as in the work philosophiae naturalis principia mathematica
phim	film	phim
phin	filter	coffee filter
phineas	phineas	(proper noun) phineas
phiên	sessie	trial
phiêu	avontuur	adventurous
phiếm	roddel	gossip
phiến	blad	"(should be ""nha phiến"") opium"
phiện	opium	opium
phiệt	phiet	militarism
phnom	phnom	phnom
phnôm	phomom	phnôm pênh= phnom penh(cambodia's capital)
pho	pho	part of a person's name, rat-pho, or ratford
phoenix	feniks	(proper noun) phoenix
phong	kamer	movement
php	php	php
phrygian	frygisch	phrygian
phu	phu	"(term should be ""phu nhân"") wife (n.)"
phui	onbedekt	expose
phun	spuiten	to spray or spit (v.)
phà	veerboot	ferry
phàm	sterfelijk	superhuman
phàn	klagen	complain
phá	breken	destroy
phác	schetsen	"(term should be ""phác thảo"") outline or sketch (n.)"
phách	ritme	manner (n.)
phái	sekte	a party
phán	rechter	judge
pháo	kanon	artillery
pháp	frankrijk	method
phát	uitzending	develop
phèn	aluin	alum
phèo	phèo	organs
phép	toegestaan	permit
phê	high worden	"(term should be ""phê bình"") to criticize (v.)"
phêrô	peter	peter
phì	vergroot	non-
phình	uitstulping	bulge
phí	in rekening brengen	non-
phía	kant	side
phích	thermosfles	a flask (n.)
phím	sleutel	key
phò	phò	"(term should be ""phò mã"") a prince consort"
phòng	kamer	office
phó	plaatsvervanger	second
phóng	lancering	to launch (v.)
phô	stad	display
phôi	embryo	embryo
phông	lettertype	font
phùng	bladerdeeg	phung
phúc	gezegend	good fortune (n.)
phúclộc	zegen	phuc-loc
phún	kont	"(term should be ""lún phún"") sparse (adj.)"
phúng	jammer	satire
phút	minuut	a minute (n.)
phăn	tobben	phan
phăng	phang	knock
phương	phuong	direction
phước	zegen	luck
phường	afdeling	ward
phượng	feniks	phoenix
phạn	sanskriet	sanskrit
phạt	straffen	punish
phả	stamboom	pedigree
phải	rechtsaf	must
phải 	rechtsaf	right
phản	teller	reaction
phảng	vlak	subtle
phần	een deel	part
phẩm	producten	food
phẩy	komma	a comma
phẫn	verontwaardigd	wrathful
phẫu	chirurgie	surgery
phận	lot	part
phật	boeddha	buddhist
phẳng	vliegtuig	flat (adj.)
phế	schroot	dismiss
phết	verspreiding	to spread or smear (v.)
phỉ	hazelaar	defame
phỏng	brandwond	interview
phố	stad	city
phối	coördineren	coordinate
phốt	fosfaat	"(term should be ""phốt-phát"") phosphate (n.)"
phồng	opgeblazen	to swell (v.)
phổ	spectrum	popular
phổi	long	lung
phộng	pinda&#39;s	peanut
phới	vlotter	"(term should be ""phơi phới"") mildly exciting (adj.)"
phở	noedelsoep	pho
phục	kleding	convincing
phụng	dienen	worship
phụt	bladerdeeg	minute
phủ	gedekt	government
phức	complex	complex
picchu	picchu	a name
piccolo	piccolo	piccolo
pierre	pierre	pierre
pierrot	pierrot	pierrot
pietro	pietro	pietro
pike	snoek	pike
pin	de batterij	battery
pinlus	pinlus	pinlus
pioneer	pionier	pioneer
pipes	pijpen	pipes
pisa	pisa	a name
piston	zuiger	piston
pitch	toonhoogte	pitch
pius	pius	pius
plaaf	plaaf	plaaf
plan	plan	plan
plasma	plasma	plasma
plate	bord	plate
plato	plato	plato
platon	platon	platon
player	speler	player
pleiku	pleiku	(proper noun) pleiku
pleistocen	pleistocen	pleistocen
plus	plus	plus
pluto	pluto	pluto
pm	p.m	pm
pmu	pmu	pmu
po	po	po
pokémon	pokemon	pokemon
pol	pol	pol
poland	polen	poland
pollack	pollak	a name
pollux	pollux	a name
polo	polo	(proper noun) polo, as in marco polo
polynésie	polynésie	polynesian
pont	pont	(proper noun) pont, as in pont de normandie
pop	knal	pop
portland	portland	portland
porto	porto	porto
pot	pot	pot
potsdam	potsdam	(proper noun) potsdam
potter	pottenbakker	(proper noun) potter, as in harry potter
pour	giet	not vietnamese
powell	powell	(proper noun) powell, as in general colin powell
pradesh	pradesh	pradesh
praha	praha	praha
pratzen	pratzen	pratzen
preah	preah	(proper noun) preah
premier	premier	premier
preminger	preminger	(proper noun) preminger
preston	preston	(proper noun) preston, as in john preston
prince	prins	prince
princeton	princeton	princeton
printemps	printemps	printemps
printf	printf	printf
prinz	prinz	(proper noun) prinz, as in birgit prinz, the female german soccer player
prix	prijs	(proper noun) prix, as in the grand prix
procellarum	procellarum	procellarum, as in oceanus procellarum, the name of a mare on the moon
projekt	projekt	projekt
prometheus	prometheus	(proper noun) prometheus
protein	het eiwit	protein
prôtêin	eiwit	protein (n.)
ps	ps	ps
psv	psv	psv
ptolemy	ptolemaeus	ptolemy
ptq	ptq	ptq
puerto	puerto	puerto
pulau	pulau	(proper noun) pulau, as in pulau tekong, an island
pulitzer	pulitzer	(proper noun) pulitzer, as in the pulitzer prize
pulp	pulp	pulp
punjab	punjab	punjab
pusan	pusan	(proper noun) pusan
putin	putin	putin
pyrenees	pyreneeën	pyrenees
pytago	pytago	(proper noun) pytago
pzl	pzl	pzl
péc	péc	"(term should be ""vịnh péc xích"") the persian gulf"
pérez	pérez	(proper noun) perez, as in javier perez de cuellar
păng	steek	fansipan
pơ	pơ	"(term should be ""pơ kô"") a river in vietnam (n.)"
q	q	q ( a letter)
qatar	qatar	qatar
qd	qd	quantum dots
qing	qing	qing, as in the qing dynasty of  china
qlvnch	qlvnch	army of the republic of vietnam
qua	door	transmit
quad	quad	quad
quan	quan	"(term should be ""quan hệ"") relationship (n.)"
quang	optisch	bladder
quanh	in de omgeving van	around
quay	draaide zich om	turn
que	staven	stick
queen	koningin	queen
queens	koninginnen	(proper noun) queens, as in the new york borough
queensland	queensland	queensland
quen	bekend	accustomed to
qui	qui	formal
quincy	quincy	(proper noun) quincy, as in quincy jones
quran	koran	quran
quy	reglement	"(term should be ""quy ước"") agreement"
quyên	grondbeginselen	"(term should be ""quyên góp"") to donate (v.)"
quyến	charme	"(term should be ""gia quyến"") family"
quyền	toestemming	right
quyện	mengen	mix
quyệt	verraderlijk	"(should be ""xảo quyệt"") devious"
quá	te	over
quái	heck	strange or odd
quán	bar	hometown
quáng	blind	blind
quát	schreeuwden	generalize
quân	quan	army (n.)
quãng	ca.	optical
quét	scannen	to sweep (v.)
quê	dorp	countryside
quên	vergeten	forget
quý	kostbaar	love
quýt	mandarijn	tangerine
quăng	toss	to throw (v.)
quĩ	fonds	orbit
quạ	kraaien	crow (con qua)
quạt	ventilator	fan
quản	regerend	"(entire term is ""cai quản"") to manage"
quảng	promo	guangzhou
quấn	inpakken	wrap around
quất	kumquat	whip
quấy	roeren	harass
quần	broek	pants (n.)
quầng	halo	halo
quầy	de teller	stall
quẩy	schommelen	quay
quẫn	ellendig	necessitous
quận	wijk	county (n.)
quật	uitgraving	excavation
quẳng	toss	throw
quặc	raar	strange (adj.)
quặng	erts	an ore (n.)
quẻ	hexagram	hexagram
quế	kaneel	cinnamon (n.)
quết	uitschot	knead
quệ	arm	exhausted
quỉ	de duivel	demon
quỳ	knielen	demon (n.)
quỳnh	quỳnh	quynh
quỵ	beroerte	stroke
quỷ	de duivel	provided
quỹ	fonds	fund
qúy	kwartaal	quy
r	r	r
rabindranath	rabindranath	rabindranath
race	ras	race
rafael	rafael	rafael
rafale	rafale	(proper noun) rafale, as in dassault rafale
rai	rai	slowly intake
raleigh	raleigh	raleigh
ralph	ralph	(proper noun) ralph, as in ralph waldo emerson
ram	ram	a name
rama	rama	rama, first name of several rulers of thailand (n.)
ramadan	ramadan	(proper noun) the fasting month of ramadan
ramayana	ramayana	ramayana
rambus	rambus	rambus
ran	liep	ran
ranch	boerderij	ranch
randy	geil	randy
rang	belde	roast
rangers	rangers	rangers
ranh	grens	border (ranh gioi)
rao	advertentie	to announce
rap	tik	rap
raptor	roofvogel	raptor
rate	tarief	rate
rau	groente	vegetable
ray	straal	rail (n.)
raya	raya	raya
raymond	raymond	raymond
rađa	radar	radar
reagan	reagan	reagan
real	echt	real
reanimation	reanimatie	reanimation
reap	oogsten	reap
reef	rif	reef
regia	regia	regia
reichelt	reichelt	reichelt
ren	kant	lace (n.)
renaissance	renaissance	renaissance
renault	renault	renault
rené	rené	rene
reo	ring	yell
reserve	reserveren	reserve
resort	toevlucht	resort
reverse	omgekeerde	reverse
revolution	revolutie	revolution
rey	rey	rey, as in copa del rey
rfid	rfid	rfid
rhodes	rhodos	rhodes
rica	rica	rica
ricardo	ricardo	ricardo
ricci	ricci	ricci
richard	richard	richard
richardson	richardson	(proper noun) richardson, as in james o. richardson
richie	richie	(proper noun) richie, as in singer lionel richie
rico	rico	rico, as in puerto rico
riemann	riemann	riemann, as in bernhard riemann, a german mathematician
rimjob	rimjob	rimjob
rin	rin	rin
rising	stijgende lijn	rising
risk	risico	risk
ritchie	ritchie	a name
rivaldo	rivaal	rivaldo
rivière	rivière	a name
rizal	rizal	rizal
riêng	privaat	own
riêu	riêu	crab
riết	riet	urgently
riềng	laos	arrowroot
ro	ro	"entire term is ""rui ro""; means ""risk"""
robert	robert	(proper noun) robert
roberto	roberto	(proper noun) roberto
roberts	roberts	roberts
robespierre	robespierre	robespierre
robin	robin	a name
robinson	robinson	robinson, as in michelle robinson
rockefeller	rockefeller	rockefeller, as in john d. rockefeller
roddick	roddick	(proper noun) roddick
rodríguez	rodríguez	rodriguez (n.)
roi	hengel	a stick or switch used for punishment (n.)
roland	roland	roland
romania	roemenië	romania
rome	rome	rome, as in rome, italy
romeo	romeo	(proper noun) romeo, as in romeo and juliet
rommel	rommel	rommel
ron	ron	ron
ronald	ronald	ronald, an english first name
ronaldinho	ronaldinho	ronaldinho
rong	algen	seaweed (n.)
rosen	rosen	rosen, as in nathan rosen
roth	roth	roth
rotterdam	rotterdam	(proper noun) rotterdam
rousseau	rousseau	rousseau
router	router	cong noi
rovers	rovers	rovers
rowling	roeien	rowling
roy	roy	(proper noun) roy, a name
rpd	rpd	rpd
rtp	rtp	rpt
rudolph	rudolph	rudolph
rue	rue	rue, as in rue des vases, a street name
rulin	liniaal	(proper noun) rulin
rumani	roemeense	romanian
rumiko	rumiko	rumiko, a japanese first name
rummel	rummel	rummel
run	rennen	tremble
rung	trillen	to shake or vibrate (v.)
russian	russisch	(proper adjective) russian
russkaya	russkaya	(proper noun) russkaya avionika
ruth	ruth	(proper noun) ruth
rutherford	rutherford	rutherford
rutte	rutte	rutte
ruud	onbeleefd	ruud
ruốc	garnalen	pemmican
ruồi	vliegt	fly
ruổi	ruoi	rong ruổi=wandering
ruộng	rijstveld	"(term should be ""ruộng đất"") farmland (n.)"
ruột	darm	internals
rzeczpospolita	rzeczpospolita	rzeczpospolia
rà	uitchecken	finding
ràng	doorzichtig	clear
rành	vloeiend	exhaustive
rào	hek	barrier
rác	vuilnis	gabbage-trash
rách	gescheurd	tear
rái	otter	colander
rán	bak	fried (adj.)
ráp	bijeenkomst	to assemble (v.)
râm	schaduwrijk	shade
râu	baard	beard or mustache (n.)
rã	verval	out
rãi	kasseien	"(term should be ""rộng rãi"") generous"
rãnh	loopgraaf	groove
räikkönen	räikkönen	raikkonen
rèm	gordijn	curtain
rèn	smeden	train
ré	piepen	re
république	république	republique
rét	verkoudheid	cold
rê	slepen	"(term should be ""rê bóng"") to dribble the ball in soccer (v.)"
rên	janken	moan
rêu	mos	moss
rì	fluisteren	lush (adj.)
rìa	rand	edge
rình	spion	to watch for
rìu	bijl	ax
rít	fluiten	to wail (v.)
rò	lekkage	leak
ròng	netto	net
rót	gieten	to pour (v.)
rô	geruit	diamond
rôbôt	robot	robot
rôma	rome	roman
rông	hol	rising (adj.)
rõ	doorzichtig	clear
rùa	schildpad	turtle
rùng	griezelig	horror
rút	zich terugtrekken	withdraw
răn	gebod	commandment
răng	tand	roasted
rōmaji	rōmaji	romaji
rũ	verleidelijk	charm
rơ	auto	"(term should be ""rơ măm"") a minority people living in vietnam"
rơi	vallen	fall
rơm	rietje	straw
rươi	u	sand-worm
rước	processie	welcome
rưới	bestrooi	to sprinkle (v.)
rưỡi	voor de helft	half
rượt	jacht	pursue
rượu	alcohol	wine
rạ	riet	straw
rạc	discreet	discrete
rạch	kanaal	canal
rạng	dageraad	break
rạp	theaters	theater
rải	verspreide	spread
rảnh	vrij	to be free (adj.)
rất	heel	very
rầm	stijl	aggressive
rầu	verdrietig	sorrow
rẫy	teelt	full
rậm	bossig	jungle
rập	arab	"(term should be ""Ả rập"") arab"
rắc	bestrooi	trouble
rắn	slang	snake
rằm	volle maan	a full moon (n.)
rằng	dat	roasted
rặng	de steen	a row
rẻ	goedkoop	cheap
rẽ	beurt	"(term should be ""chia rẽ"") to separate or divide (v.)"
rền	kreunen	pealed
rể	schoonzoon	in-law
rễ	wortels	root (n.)
rệp	bug	bug
rệt	uitgesproken	clearly
rệu	aye	decay
rỉ	roest	leak
rịavũng	rìvà	ria - bay
rỏ	doorzichtig	clearly
rối	verstrikt	disorder
rốm	bewolkt	rom
rồ	gek	"(term should be ""điên rồ"") foolish (adj.)"
rồi	nu al	and
rồng	draak	dragon
rổ	mand	basket
rỗi	vrij	savation
rỗng	hol	hollow
rộ	drukte	profuse (adj.)
rộn	druk	busy
rộng	breed	wide
rớt	vallen	drop
rời	links	leave
rỡ	briljant	brilliant
rợ	barbaren	a savage (n.)
rợn	griezelig	scary
rụng	schuur	to drop
rủ	nodig uit	ask
rủi	ongeluk	unlucky or unfortunate (n.)
rứa	rứa	rua
rừng	woud	forest
rửa	wassen	to wash (v.)
rữa	wassen	to decompose or rot (v.)
sa	za	to fall or drop (v.)
sabah	sabah	sabah
sachsen	sachsen	sachsen
saddam	saddam	(proper noun) saddam, as in saddam hussein
safari	safari	safari
safin	safin	safin
sahara	sahara	sahara
sai	mis	wrong
saigon	saigon	saigon
saintdenis	saintdenis	saint-denis
sakura	sakura	sakura
salem	salem	(proper noun) salem, as in the city
salvador	salvador	salvador
salzburg	salzburg	salzburg
samhain	samhain	samhain
samo	samo	samo, the name of the first slavic ruler
samoa	samoa	(proper noun) samoa
samphan	samphan	samphan
samsung	samsung	samsung
samuel	samuel	samuel
samuelson	samuelson	(proper noun) samuelson
samurai	samurai	samurai
samut	samut	(proper noun) samut, as in samut prakan in thailand
san	san	level
sanchez	sanchez	sanchez
sang	naar	to
sango	sango	sango, a language spoken in africa
sangraal	sangraal	sangraal
sanh	geboorte	bear
sanktpeterburg	sint petersburg	sankt-peterburg
santos	santos	santos, as in footballer cristiano ronaldo dos santos aveiro of portugal
sao	ster	how
sap	sap	sap
sapa	sapa	sapa
sapiens	sapiens	sapiens
sar	sar	sar
sarah	sarah	sarah, as in sarah pierce
sarawak	sarawak	(proper noun) sarawak, a malaysian state on the island of borneo
sarcoma	sarcoom	sarcoma
sardinia	sardinië	sardinia
sary	sary	(proper noun) sary, as in ieng sary
saturanga	saturanga	saturanga
saturday	zaterdag	saturday
sau	na	after (adv.)
saudi	saudi	(proper noun) saudi, as in saudi arabia
saunière	saunière	saunière
scandinavia	scandinavië	scandinavia
schafer	schafer	schafer, as in john c. schafer
schengen	schengen	schengen
schiller	schiller	schiller
schlesinger	schlesinger	schlesinger
schneider	schneider	schneider, a last name
schumacher	schumacher	schumacher, as in michael schumacher
schuschnigg	schuschnigg	(proper noun) schuschnigg, as in kurt schuschnigg of austria
schuster	schuster	schuster
schwarzschild	schwarzschild	schwarzschild
scotland	schotland	scotland
scots	schotten	(proper noun) scots
scott	scott	scott
scream	schreeuw	scream
scud	scud	scud
scuderia	scuderia	scuderia
sdram	sdram	sdram
search	zoeken	search
seattle	seattle	(proper noun) seattle, washington
secret	geheim	bi mat
sedna	sedna	(proper noun) sedna
see	zien	see
sejm	sejm	(proper noun) sejm
selena	selena	selena
semit	semit	(proper noun) semit
sen	lotus	lotus
sense	zin	sense
september	september	(proper noun) the month of september
serbia	servië	serbia
sergeyevich	sergeyevich	(proper noun) sergeyevich
seri	serie	series
service	onderhoud	service
sesshomaru	sesshomaru	a name
seth	seth	seth
seto	seto	seto
sextus	sextus	sextus
sexy	sexy	sexy
seymour	seymour	seymour
seyssinquart	seyssinquart	(proper noun) seyss-inquart
shah	sjah	shah
shaman	sjamaan	the shaman religion
shan	shan	shan
shane	shane	(proper noun) shane, an english first name
shankly	schacht	(proper noun) shankly, as in bill shankly
shaolin	shaolin	shaolin, as in the shaolin temples
sharpay	sharpay	sharpay, as in sharpay evans
shawn	shawn	shawn
sherlock	sherlock	a name
shi	shi	shi
shia	shia	shia
shiite	sjiiet	shiite
shikoku	shikoku	shikoku, a japanese island (n.)
shinichi	shinichi	shinichi
shinoda	shinoda	shinoda, as in mike shinoda
shirakami	shirakami	(proper noun) shirakami
shirakawago	shirakawago	(proper noun) shirakawa-go
shiva	shiva	shiva
shoal	ondiepte	(proper noun) shoal
shonen	shonen	shonen
shop	winkel	shop
short	kort	short
showcase	vitrine	a name
shōnen	shōnen	shonen
siberi	siberi	siberi
sicilia	sicilia	sicilia
sicily	sicilië	sicily, a city in italy
sidney	sidney	(proper noun) sidney, as in sidney nolan
siem	siem	siem
siemens	siemens	siemens
sierra	sierra	(proper noun) sierra
sikh	sikh	sikh
sikorsky	sikorsky	a name
silas	sila&#39;s	silas
silesia	silezië	silesia
silic	silicium	silicon
silicat	silicaat	silicate
silva	silva	(proper noun) silva, as in carlos silva
silvestris	silvestris	silvestris
simone	simone	simone
sinai	sinai	sinai, as in mount sinai
sinensis	sinensis	sinensis
sing	zingen	sing
sinh	geboren	genital
sip	slokje	sip
sirô	siroop	name of a member
sistema	sistema	(proper noun) sistema
siu	siu	siu
siêu	super	super
siết	vastdraaien	to cut off (v.)
sky	lucht	sky
skype	skype	skype
skyteam	luchtteam	skyteam
sl	sl	sl
slav	slaaf	(proper noun) slav
slavơ	slaaf	slavic
slytherin	zwadderich	(proper noun) slytherin, as in salazar slytherin of the harry potter series
sm	sm	sm
smg	smg	smg
smith	smid	smith
smithsonian	smithsonian	smithsonian
so	zo	compare
société	société	societe
socrates	socrates	socrates
sohee	sohee	a korean name
soho	soho	soho
soi	dus ik	look/stare soi sáng=enlight
solaris	solaris	(proper noun) solaris
som	som	(proper noun) som, as in kampong som
somme	somme	somme
sonata	sonate	sonata
song	lied	however (adv.)
sony	sony	sony
soo	zo	soon
sophie	sophie	(proper noun) sophie, a first name
sopwith	sopwith	a name
sorbonne	sorbonne	sorbonne, the university in paris (n.)
sos	sos	sos
soul	ziel	soul
soát	controle	control
soạn	componist	compose
spears	speren	spears
spellman	spellman	spellman
spence	spence	(proper noun) spence
spencer	spencer	(proper noun) spencer
spielberg	spielberg	(proper noun) spielberg, as in steven spielberg
sports	sport-	sports
sri	sri	(proper noun) sri, as in sri lanka
ss	ss	ss
st	st	st.
stalingrad	stalingrad	stalingrad
stamford	stamford	this is a name
stand	stand	stand
stanford	stanford	stanford, as in stanford university
stanley	stanley	stanley
starr	starr	a name
startin	start in	bat dau
status	toestand	status
stdc	stdc	stdc
stefan	stefan	stefan
steiermark	steiermark	steiermark
steiner	steiner	steiner
stelzer	stelzer	stelzer
stennis	stennis	stennis
stephen	stephen	stephen
stephenie	stephenie	"stephenie, as in stephenie meyer, author of ""twilight"""
sterling	sterling	a name
steve	steve	steve
stevens	stevens	(proper noun) stevens, as in amanda stevens
stevenson	stevenson	stevenson
stevie	stevie	stevie
stewarthannah	stewarthannah	stewart/hannah
stf	stf	stf
stimson	stimson	stimson, as in henry lewis stimson, former secretary of war
stockholm	stockholm	a name
stones	stenen	stones
storting	storten	storting
strasberg	strasberg	strasberg
strauss	strauss	strauss
street	straat	street
struct	struct	struct
stt	stt	order number
stuart	stuart	stuart
stuttgart	stuttgart	(proper noun) stuttgart, a city in germany
styx	styx	(proper noun) styx, as in the river styx
stéfano	stéfano	stefano
su	zo	condom
subakhi	subakhi	subakhi
suez	suez	(proper noun) suez
suharto	suharto	suharto
sukarno	sukarno	(proper noun) sukarno,  president of indonesia
sulfua	sulfide	sulfide
sulu	sulu	sulu
sum	som	reunite
sumatera	sumatera	sumatera
sumatra	sumatra	(proper noun) the island of sumatra
sumitomo	sumitomo	sumitomo
summer	zomer	summer
summerslam	summerslam	(proper noun) summerslam
sun	zon	sun
sunday	zondag	(proper noun) sunday
sung	vijgen	supplement
sunni	soennitische	sunni
sunsilk	sunsilk	sunsilk, a hair products company
super	super	super
suriname	suriname	suriname
susan	susan	(proper noun) susan
susilo	susilo	(proper noun) susilo
sutra	sutra	sutra
suub	suub	a name
suvp	suvp	suv-p
suy	mislukking	decrease
suê	zo	lush
suôn	soepel	smooth
suất	productiviteit	number
suối	verwarming	stream
suốt	gedurende	through/all over
suồng	glad	overfamiliar
svd	svd	svd
swan	zwaan	swan
swaziland	swaziland	swaziland
sweet	zoet	sweet
sy	sy	sy
sydney	sydney	(proper noun) sydney, a city in australia
symantec	symantec	symantec
sync	synchroniseren	sync
syria	syrië	syria
sài	sai	"(term should be ""sơ sài"") something done without care (adv.)"
sàn	verdieping	san
sàng	zeef	ready
sành	terracotta	"(term should be ""sành sứ"") pottery"
sào	pool	"(term should be ""sào huyệt"") den or hideout (n.)"
sá	sipunculus	road
sách	boek	list
sái	mis	sai
sám	berouwvol	penitent
sáng	glanzend	light
sánh	comparatieve	compare
sáo	fluit	flute
sáp	was-	merger
sát	dichtbij	"(term should be ""quan sát"") to watch or observe (v.)"
sáu	zes	six
sâm	ginseng	sam
sân	werf	"(should be ""sân khấu"") a stage"
sâu	diep	deep
sã	sã	flippant
sãi	mis	pagoda warden
são	são	sao, as in sao paolo, brazil
sét	verlichting	clay
sê	se	sepon
sêri	serie	series
sêu	mos	seu tet
sính	leerling	betrothal gifts
síp	cyprus	cyprus
sít	strak	close
sò	clam	oyster
sòng	casino	casino
sóc	eekhoorn	"(should be ""sóc trăng"") a vietnamese town"
sói	de wolf	wolf
sóng	golf	wave
sót	weglating	to miss (v.)
sô	aantal	than
sôi	koken	vibrant
sông	rivier-	river
sùng	toewijding	cult
sú	zwarte tijger	a type of mangrove (n.)
súc	vee	animal
sún	wastafel	sun
súng	geweren	gun
súp	soep	source
sút	schot	reduce
săn	jacht	to hunt
sơn	verf	a mountain
sư	professor	lion
sưa	melk	filled with
sưng	zwelling	swell
sưu	collectibles	collection
sương	dauw	dew (n.)
sướng	gelukkig	high
sườn	kant	slope
sưởi	verwarming	heat
sạch	schoon	clean
sạn	hotel	hotel
sảm	helder	sam
sản	productie	reproductive
sảng	vers	sonorous
sảnh	hal	a hall, as in the rock and roll hall of fame
sấm	donder	ginseng
sấu	krokodil	crocodile
sấy	drogen	dry
sầm	slaat	crowded
sầu	melancholie	sad
sẩn	papels	coarseness
sẫm	donker	dark
sập	ineenstorting	destroy
sắm	boodschappen doen	shopping
sắn	cassave	cassava (n.)
sắp	bijna	soon
sắt	ijzer	"(term should be ""sắt son"") constant (adj.)"
sẵn	beschikbaar	available
sẹo	litteken	scar
sẻ	zal	share
sẽ	zullen	will
sọ	schedel	brain
sọc	strepen	stripe
sỏ	brutaal	oligarchy
sỏi	grind	gravel
số	aantal	"(term should be ""số lượng"") quantity (n.)"
sốc	geschokt	shock
sống	levend	live
sốt	koorts	fever
sồi	eik	oak
sổ	boek	window
sớ	zullen	document
sớm	spoedig	som
sờ	aanraken	touch
sỡ	gemist	colorful
sợ	bang	afraid
sợi	garens	fibers
sục	jacuzzi	"(term should be ""sôi sục"") to boil"
sụn	kraakbeen	cartilage
sụp	ineenstorting	collapse
sụt	malaise	drop
sủa	schors	bright
sủi	bruisend	sparkling
sủng	charismatisch	favored
sứ	keramiek	embassy
sứa	kwallen	jellyfish (n.)
sức	kracht	strength
sứt	afgebroken	cleft
sừng	toeter	sừng sững= huge
sử	geschiedenis	"(term should be ""sử dụng"") to use (v.)"
sửa	reparatie	repair
sửng	geschokt	startling
sửu	os	cow
sữa	melk	milk
sự	de	situation
ta	ta	us or our
tae	tae	(proper noun) tae
tag	label	tag
tai	oor	ear
taiji	taiji	(proper noun) taiji
taipei	taipei	taipei
taiwan	taiwan	taiwan
taj	taj	taj, as in taj mahal
tajikistan	tadzjikistan	tajikistan
tajima	tajima	tajima
tajiri	tajiri	tajiri
takahashi	takahashi	(proper noun) takahashi
taklamakan	taklamakan	taklamakan
tali	tali	thallium
taliban	taliban	taliban
talmud	talmoed	talmud
tam	tam	three (n.)
tamoxifen	tamoxifen	tamoxifen
tanaka	tanaka	tanaka
tang	rouw	funeral
tanh	raar	deserted
tankōbon	tankōbon	tankobon, as in a type of japanese literature
tanzania	tanzania	tanzania
tao	ik	(proper noun) tao, a chinese name
tarim	tarim	tarim
task	taak	task
tasman	tasman	tasman, as in abel tasman
tasmania	tasmanië	tasmania, a place
tau	tau	tau
taxi	taxi	taxi
tay	hand-	hand
taylor	taylor	taylor
tbt	tbt	tbt
tchad	tsjaad	tchad
tcm	tcm	tcm
tcp	tcp	tcp
technical	technisch	technical
ted	ted	(proper noun) ted
teddy	teddy	teddy, as in teddy lupin, a character in the harry potter series
telecom	telecom	telecom
telekom	telekom	telekom
telex	telex	telex
telnet	telnet	telnet
tem	postzegel	stamp
temple	tempel	temple
temujin	temujin	temujin
temur	temur	(proper noun) temur, as in temur oljeitu
tenxơ	kartel	tensor
teo	atrofisch	atrophy
terengganu	terengganu	(proper noun) terengganu
territories	gebieden	territories
terry	badstof	terry
terumbu	terumbu	(proper noun) terumbu
tet	tet	tet
texas	texas	(proper noun) the state of texas
tgv	tgv	tgv
tha	excuus	to forgive (v.)
thai	zwanger	pregnant
thailand	thailand	thailand
tham	hebzucht	involved
thames	theems	thames
than	houtskool	coal
thang	ladder	ladder
thanh	bar	youth
thani	dan ik	thani
thao	sport-	sport
thau	messing	a basin (n.)
thay	in plaats daarvan	change
thcn	thcn	vocational school
thcs	thcs	secondary
thdq	thdq	thdq
thebes	thebe	thebes
their	hun	their
them	hen	plus
then	vervolgens	key
theo	volgens de	according to
theory	theorie	thẻoy
theravada	theravada	theravada
theres	er is	there
theseus	theseus	theseus, the greek hero
thi	examen	competition (n.)
thich	leuk vinden	explanation
thien	thien	sky
third	derde	thỉd
thiu	muf	buồn thiu= sad/boring
thiêm	thiêm	thiem
thiêng	heilig	"(term should be ""thiêng liêng"") sacred or holy"
thiếc	blik	tin
thiến	onzijdig	castrate
thiếp	kaart	concubine
thiết	ingesteld	"(term should be ""cần thiết"") necessary (adj.)"
thiếu	kort	lack
thiềm	sikkel	crescent
thiền	meditatie	buddhist (adj.)
thiển	laten zien	superficial
thiểu	klein	minimum
thiện	goed	good
thiệp	kaart	intervene
thiệt	werkelijk	damage
thiệu	invoering	"(term should be ""giới thiệu"") to introduce (v.)"
tho	tho	tho
thoa	schar	combination
thoai	thoai	gentle
thomas	thomas	thomas
thompson	thompson	thompson
thong	string	(proper noun) thong, as in ang thong
those	die	those
thoái	regressief	deterioration
thoán	raad eens	usurpation
thoáng	luchtig	"(term should be ""thoáng qua"") to pass quickly"
thoát	uitgang	drainage
thoại	telefoon	telephone
thoạt	op het eerste gezicht	just (adv.)
thoả	deal	compromise
thoải	comfortabel	"(term should be ""thoải mái"") comfortable or relaxing (adj.)"
thoảng	af en toe	"(term should be ""thỉnh thoảng"") occasionally (adv.)"
thoắt	prompt	suddenly
thpt	thpt	high school
thriller	thriller	thriller
thskts	thskts	phd- architect
thua	verliezen	defeat
thumb|các	thumb | de	thumb|many
thunderbolt	blikseminslag	thunderbolt
thung	vallei	valley
thuyên	verplaatsing	a name
thuyết	theorie	theory
thuyền	boot	boat
thuê	huren	employ
thuần	zuiver	"(term should be ""đơn thuần"") pure (adj.)"
thuẫn	conflict	support
thuận	voors	favourable
thuật	kunst	term
thuế	belasting	tax
thuốc	geneesmiddel	medicine (n.)
thuộc	behoren	belong
thuớc	water	"(term should be ""kích thước"") dimensions of an object"
thuờng	meestal	usually
thuở	jeugd	period
thuỵ	thuy	"(term should be ""thụy Điển"") the nation of sweden (proper noun)"
thuỷ	thuy	water
thvn	thvn	vietnam television
thy	uw	thy
thà	zou liever	honest
thành	fort	"(term should be ""hình thành"") to take shape"
thày	leraar	teacher
thác	cascade	harvest
thách	uitdaging	challenge
thái	thais	attitude
thám	detective	to spy (v.)
tháng	maand	month (n.)
thánh	st	a holy person; a saint (n.)
tháo	verwijderen	"(term should be ""tháo chạy"") to run with abandon"
tháp	toren	tower
thâm	diep	penetrate
thâu	geplakt	to collect (v.)
thây	zien	body
thãi	shit	superabundant
thèm	snakken	desire
thép	staal	steel
thét	schreeuwde	shout
thê	de	category
thêm	meer	more
thêu	huur	to embroider (v.)
thìa	lepel	spoon
thìn	vervolgens	(proper noun) thìn, the year of the dragon
thình	plotseling	"(term should be ""thình lình"") suddenly"
thí	experimenten	(with word du) for example
thít	thit	(proper noun) mân thít, a district in vietnam
thò	prikte	tho
thòi	nadeel	"(term should be ""thiệt thòi"") to cost (adv.)"
thóc	rijstveld	grain (n.)
thói	gewoonte	a habit (n.)
thô	ruw	rough, old-fashioned
thôi	kom op	only
thông	op de hoogte	"(term should be ""thông thường"") usual (adj.)"
thù	vete	"entire term should be ""ke thu""; means ""enemy"""
thùng	prullenbak	barrel
thùy	kwab	thuy
thú	interessant	"(should be ""thích thú"") pleasurable"
thúc	einde	push
thúy	thuy	thuy
thăm	bezoek	visit
thăng	gepromoot	helicopter
thơm	geurig	aromatic
thư	brieven	"(term should be ""ung thư"") cancer (n.)"
thưa	geachte	sparse
thương	liefde	love
thước	heerser	ruler
thường	vaak	usually (adv.)
thưởng	beloning	to reward (v.)
thược	plof	(proper noun) thược
thượng	bovenste	upper
thạc	meesters	master
thạch	gelei	rock or stone (n.)
thạnh	thanh	thanh
thạo	deskundige	fluent
thả	laten vallen	"(term should be ""thả lỏng"") to let loose (v.)"
thải	verspilling	waste
thảm	tapijt	carpet or rug (n.)
thản	sereen	calmly
thảo	mooi	"(term should be ""hội thảo"") a workshop (n.)"
thấp	kort	low (adj.)
thấu	penetrant	penetrate
thầm	zwijgend	"(term should be ""thì thầm"") to whisper (v.)"
thần	god	"entire term should be ""tinh than""; means ""of the mind"""
thầy	leraar	teacher (n.)
thẩm	juryleden	osmotic/leak
thẫm	donker	dark
thận	nier	careful
thập	kruis	tens
thật	echt	true (adj.)
thắm	bloemblad	tham
thắn	eerlijk gezegd	frank
thắng	won	win
thắngthua	winnen	win-lose
thắp	licht	light
thắt	vastknopen	tense
thằn	hagedis	"entire term should be ""than lan""; means ""lizard"""
thằng	kerel	a derogatory term for a man (n.)
thẳm	diep	"(term should be ""thăm thẳm"") extremely deep (adj.)"
thẳng	rechtdoor	horizontal
thặng	overschot	surplus
thẹn	beschaamd	shameful
thẻ	kaart	card
thế	zo	"with word ""tu,"" means ""posture"" or ""a position"""
thếp	staal	steel
thề	zweer	swear
thềm	plank	shelf
thể	worden	maybe
thỉnh	nodig uit	"(term should be ""thỉnh thoảng"") occasionally"
thịnh	mode	prosperous
thịt	vlees	meat (n.)
thọ	levensduur	phu tho
thọc	prik	jab
thỏ	konijn	rabbit
thỏa	overeenkomst	"(term should be ""thoả thuận"") to come to an agreement (v.)"
thỏi	baar	a bar (n.)
thối	verrot	smelly
thốt	geuit	scream
thồ	verpakking	to transport via horse (v.)
thổ	aarde	"(term should be ""lãnh thổ"") territory (n.)"
thổi	blazen	blow
thớt	snijplank	sparse
thời	tijd	period
thở	adem	breathe
thợ	werknemer	craftman
thụ	receptor	"(term should be ""thụ thai"") to become pregnant"
thục	shu	(proper noun) a vietnamese first name
thụt	ingesprongen	clyster
thủ	prime	masturbate
thủa	thua	during childhood
thủng	perforatie	having holes
thứ	dingen	no.
thức	wakker	way
thừa	overtollig	redundant
thừng	touw	"(term should be ""thẳng thừng"") mercilessly"
thử	passen	try
thửa	pakket	square
thự	villa	mansion
thực	echt	perform
ti	ti	titov
tia	straal	ray
tiananmen	tiananmen	tiananmen
tiara	tiara	tiara
tibet	tibet	(proper noun) tibet
tigris	tigris	tigris
tiliaceus	tiliaceus	hoa dam but
tim	hart	heart
timor	timor	timor
timothy	timothy	timothy
tin	geloven	believe
tinbắc	bericht	file bac
tincầu	tinnen brug	file bridge
tinh	planeet	"(term should be ""tinh dịch"") sperm (n.)"
tinnhà	blikken huis	folder: house
tinsông	nieuws	file river
tinthị	tinthị	file: town
tirol	tirol	tirol
tisdale	tisdale	tisdale
tish	tish	(proper noun) tish
tissa	tissa	(proper noun) tissa, as in moggaliputta tissa
tivi	televisie	television
tizard	tizard	(proper noun) tizard
tiên	eerste	first
tiêu	peper	"entire term should be ""tieu chuan""; means ""a requirement"""
tiếc	spijt	"(term should be ""tiếc thương"") to pity (v.)"
tiếm	goofy	seize
tiến	omhoog	operate
tiếng	taal	language
tiết	afscheiding	abstinence/intensity
tiếu	gek	"(should be ""đàm tiếu"") to sneer"
tiềm	potentieel	potential
tiền	geld	money (n.)
tiều	shit	(proper noun) the name of a poet
tiểu	plas	tiểu sử= biography
tiễu	mr. liu	patrol
tiệc	feest	party
tiệm	winkel	shop
tiện	handig	mean
tiệp	tsjechisch	gustav franck
tiệt	neuken	sterilize
tncs	tncs	communist youth union
tngt	tngt	traffic accidents
tnhh	beperkt	limited
toang	toang	fast
tobago	tobago	tobago
toei	toei	toei
tokugawa	tokugawa	tokugawa
tokyo	tokyo	tokyo, the capital of japan
tokyopop	tokyopop	tokyopop
tomas	tomas	(proper noun) tomas
tommy	tommy	tommy
tomoyo	tomoyo	tomoyo
tony	tony	tony
toonami	toonami	(proper noun) toonami
top	top	top
torino	torino	torino, as in the italian city
toriyama	toriyama	(proper noun) toriyama
tottenham	t tottenham	tottenham
tourism	toerisme	tourism
tourist	toerist	tourist
toyama	toyama	toyama
toyota	toyota	(proper noun) toyota
toà	rechtbank	office
toàn	veilig	entire or whole (adj.)
toán	wiskunde	team
toát	goed	to exude or emit, as in sweat (v.)
toạ	coördinaten	locate
toại	bij	satisfaction
toả	straalt uit	spread
tp	tp	city
tphcm	tphcm	ho chi minh city
tphồ	stad	city ho
tpvĩnh	stad	vinh city
tqlc	tqlc	marine
trafalgar	trafalgar	(proper noun) trafalgar
trafford	trafford	trafford in greater manchester
trai	mosselen	boy
trang	bladzijde	a page (n.)
tranh	afbeeldingen	to compete (v.)
trao	uitgedeeld	reward
trau	trau	polish
tre	bamboe	bamboo (n.)
treo	hangen	hang
tri	tri	tri
tribune	tribune	a name
trinh	maagd	"(should be ""trinh bạch"") virtuous"
trinidad	trinidad	trinidad
trinity	drie-eenheid	trinity
tristan	tristan	tristan
triết	filosofie	philosophy
triền	trien	"(should be ""triền miên"") endless"
triều	tij	court
triện	zegel	stamp
triệt	grondig	completely
triệu	miljoen	a million
tro	as	ashes
troia	troia	troy
trondheim	trondheim	trondheim
trong	in	inside (adv.)
true	waar	true
truman	truman	(proper noun) truman
trung	midden-	"(term should be ""trung gian"") agent (n.)"
trungnhật	eerlijkheid	china-japan
truong	truong	truong
truyên	truyen	story
truyện	verhaal	story
truân	truân	arduous
truất	tegenstanders	cancel
truởng	chef	leader (n.)
truỵ	liggen	depraved
trà	thee	tea (n.)
tràm	cajuput	melaleuca
tràng	dikke darm	"entire term should be ""truc trang""; means ""rectum"""
trào	uitbarsting	movement
trác	trac	trac
trách	de schuld geven	blame
trái	links	against
trán	voorhoofd	forehead
tráng	gecoat	to coat (v.)
tránh	vermijden	to avoid (v.)
tráo	frauduleus	tráo trở= liar/betrayal/treacherous
tráp	doos	casket
trát	bevel	pile
trâm	broche	a type of elegant hairpin (n.)
trân	met vriendelijke groet	respect
trâu	buffel	a last name
trãi	verspreide	trai
trèo	beklimmen	climb
trên	aan	above
trình	indienen	process
trí	geest	intellectual
trích	uittreksel	to extract (v.)
trò	truc	role
tròn	ronde	rounding
trói	vastgebonden	tie
trôi	afdrijven	afloat
trông	uiterlijk	look
trùm	baas	cover
trùng	samenvallen	"(should be ""tinh trùng"") sperm"
trùy	echt	something to with monk
trú	instappen	residence
trúc	bamboe	structure
trăm	honderd	hundred
trăn	python	"(term should be ""trăn trở"") to ponder (v.)"
trăng	maan	moon
trĩ	aambeien	hemorrhoids
trũng	gezonken	medium
trơ	inert	bare
trơn	glad	slippery (adj.)
trư	tru	a pig (n.)
trưa	middag	noon (n.)
trưng	vorderen	symbolic
trưngcông	tentoongesteld	truongcong
trương	truong	policy
trước	voordat	front
trước 	voordat	front
trướng	uitbreiding	expand
trườn	kruipen	crawl
trường	school-	case
trượng	caduceus	a unit of length used in vietnam equal to 4 meters (n.)
trượt	glijden	slide
trạch	trach	ze
trại	kamp	camp
trạm	station	station
trạng	staat	situation
trạo	tao	trao
trả	betalen	to return
trải	hoes	spread
trảm	kisten	beheaded
trảo	kapmessen	trao
trấn	stad-	town
trấu	rijstschil	rice skin
trầm	diep	depression
trần	kaal	tran
trầu	betel	trầu
trầy	bekrast	scratch
trẩy	stuiteren	pilgrimage
trẫm	ik ben	i
trận	de wedstrijd	battle
trật	uit de kom	order
trắc	biometrie	"(term should be ""trắc ẩn"") to have pity (adj.)"
trắng	wit	white
trặc	hik	"entire phrase is ""truc trac""; means ""problem"""
trẻ	jong	youth
trễ	laat	late
trệ	stagneert	bamboo
trị	behandeling	cure
trịnh	zigzag	trịnh, a vietnamese last name
trọ	cafe	motel
trọn	vol	whole
trọng	belangrijk	serious
trỏ	aanwijzers	index
trối	laatste	last words
trốn	zich verstoppen	to hide
trống	leeg	in
trồi	opkomend	to emerge (v.)
trồng	toenemen	plant
trổ	laten zien	to burst open or display
trỗi	verschijning	rise
trội	dominant	better
trộm	dieven	theft
trớn	strelen	"(term should be ""mơn trớn"") to fondle or caress (v.)"
trời	god	sun
trợ	ondersteuning	support
trụ	kantoor	universe
trục	as	"(term should be ""khu trục"") fighter, in reference to planes (adj.)"
trụi	naakt	"(term should be ""trơ trụi"") bare (adj.)"
trứ	tru	famous
trứng	ei	egg
trừ	minus	except
trừng	schittering	punish
trừu	schapen	abstract
trữ	opslag	reserve
trực	in functie	direct
ts	ts	phd
tt	tt	news
tua	tentakel	fringe
tucker	tucker	tucker, an english last name
tudor	tudor	(proper noun) tudor, as in the tudor family
tukhachevsky	tukhachevsky	(proper noun) tukhachevsky
tulip	tulp	tulip
tum	tum	tum
tung	toss	release
tupolev	tupolev	tupolev, as in alexei tupolev
tuscan	toscaans	(proper noun) tuscan
tutsi	tutsi	(proper noun) tutsi
tuvalu	tuvalu	(proper noun) tuvalu, a polynesian island nation
tuy	echter	however
tuyên	verklaren	"(should be ""tuyên ngôn"") a declaration"
tuyết	sneeuw	snow (n.)
tuyền	tuyen	tuyen
tuyển	werving	recruit
tuyệt	super goed	excellent (adj.)
tuân	gehoorzamen	comply
tuông	blozen	jealous
tuý	tuyý	drug
tuần	week	week
tuế	minnows	years
tuệ	wijsheid	intelligence
tuốc	plukken	turbine
tuổi	jaar oud	age
tuộc	octopus	octopus
tuột	afglijden	slip
tuỳ	optioneel	depend
tv	televisie	tv
tvb	tvb	tvb
twin	tweeling	twin
twitter	tjilpen	twitter
ty	ty	company
type	type	type
typhon	typhon	typhon
tà	onheil	we
tài	fortuin	talent (n.)
tàn	as	dying
tàng	museum	"(should be ""bảo tàng"") a museum"
tành	tanh	shatter
tàu	schip	ship
tá	dozijn	"(term should be ""thiếu tá"") major (n.)"
tách	kop	to separate
tái	opnieuw	return
tám	acht	eight
tán	luifel	support
tánh	tanh	life
táp	kraan	to lap at (v.)
táu	schuldig	ashton
tâm	centrum	tâm
tâu	mijn heer	peach
tây	west	western
tâynam	westnam	"(should be ""tây-nam"") southwest"
tã	luiers	diaper
tét	krijsen	tet
tê	verdoven	numb
tên	naam	name (n.)
tì	milt	to lean on (v.)
tìm	vind	find
tìmdiệt	zoeken	find-kill
tình	liefde	sex
tía	purper	dad
tích	product	"(term should be ""tích cực"") to be zealous (adv.)"
tím	paars	purple
tín	credits	"(entire term should be ""tín dụng"") credit"
tít	kop	"(term should be ""tít mù"") very far away (adv.)"
tò	nieuwsgierigheid	curious
tòa	rechtbank	a court
tòi	spullen	"(term should be ""tìm tòi"") to search doggedly for something (v.)"
tòng	tong	tòng, a last name
tóm	compendium	summary
tô	kom	car
tôi	ik	i
tôm	garnalen	shrimp
tôn	gegolfd	venerate
tông	karton	tông, as in lê thánh tông; first name of an ancient vietnamese emperor
tù	gevangenis	prison
tùng	reserve	tung
tùy	optioneel	depend on
túc	voldoende	"(term should be ""bổ túc"") to give a refresher course (v.)"
túi	handtas	pocket
túm	grijp	catch
túng	onhandig	confuse
túp	hut	hut
túy	drug	"(term should be ""thuần túy"") pure (adj.)"
tý	rat	mouse, as in year of the mouse
tăm	tandenstoker	"(term should be ""tiếng tăm"") reputation"
tăng	toename	increase
tĩnh	statisch	calm
tơi	ik	ragged
tư	van	posture
tưng	wankel	"(term should be ""tưng bừng"") joyously (adv.)"
tươi	vers	fresh
tương	vergelijkbaar	"(term should be ""tương tự"") to be similar to"
tước	strippen	title (n.)
tưới	water geven	irrigation
tướng	algemeen	prime minister (thu tuong)
tường	muur	"a common vietnamese first name; means ""wall"""
tạ	barbell	weight
tạc	beeldhouwen	"(term should be ""oanh tạc"") to bomb from the air (v.)"
tại	in	survival
tạm	voorlopige	temporary
tạo	creëren	create
tạp	tijdschrift	"(should be ""hỗn tạp"") a jumble or mish-mash"
tả	omschrijving	describe
tản	dissipatie	disperse
tảng	platform	platform
tấc	inch	inch
tấm	borden	mirror
tấn	ton	tan
tấp	getrokken	crowded
tất	sokken	all
tấu	instrumentaal	tau
tầm	spellen	range or extent (n.)
tần	frequentie	"(term should be ""tần số"") frequency (n.)"
tầng	verdieping	layer
tầu	trein	ship
tẩm	geïmpregneerd	soak
tẩy	gom	to bleach
tận	einde	dedicated
tật	onbekwaamheid	disease
tắc	schakelaars	priciple
tắm	douche	bathing
tắt	uitschakelen	initial
tặc	hackers	"(term should be ""hải tặc"") a pirate (n.)"
tặng	doneren	donate
tẻ	saai	lẻ tẻ= scattered
tết	tet	(proper noun) the vietnamese new year
tếxã	economisch	economy - society
tề	qi	tidy
tể	meneer	lord
tệ	slecht	bad
tệp	het dossier	file
tỉa	trimmen	"(term should be ""bắn tỉa"") to snipe"
tỉnh	de provinciaal	province
tị	afgunst	refugee
tịch	president	"(""chủ tịch"") president or chairman"
tọa	coördinaten	"(term should be ""chủ toạ"") chairman (n.)"
tỏ	uitgedrukt	to
tỏa	straalt uit	radiate
tỏi	knoflook	garlic
tốc	snelheid	speed
tốn	kosten	to cost (v.)
tống	escort	dispose
tốp	groep	top
tốt	goed	good
tồi	slecht	bad
tồn	bestaan	exist
tổn	pijn doen	damage
tổng	totaal	president
tộc	clan	"(term should be ""dân tộc"") a race or people"
tội	zonde	crime
tột	extreem	extreme
tớ	me	servant
tới	de volgende	to the point
tờ	vel	paper/document
tởm	walgelijk	disgusting
tục	ontheiligen	"(term should be ""tập tục"") customs or practices"
tụy	alvleesklier	"(term should be ""tận tụy"") devoted (adj.)"
tủ	kasten	shelf
tủi	slecht	humiliated
tủy	merg	spine
tức	instant	i.e.
từ	van	from
từng	ooit	each
tử	dood	lion (su tu)
tửu	alcoholtolerantie	wine
tự	zelf	"(term should be ""tương tự"") like or similar to (adv.)"
tựa	titel	lean
tựu	prestaties	achievement
tỵ	slang	the han name for the year of the snake, according to the chinese zodiac
tỷ	miljard	billion
u	u	tumor
ua	ua	ua
uae	vae	uae
ubuntu	ubuntu	ubuntu
uc	uc	uc
uchiha	uchiha	uchiha
uefa	uefa	uefa
uh	uh	uh
uk	uk	uk
ukiyoe	ukiyoe	ukiyoe
ukraina	ukraina	ukraine
ulsan	ulsan	ulsan
umm	umm	umm
un	un	(proper noun) un, as in chung un chan of korea
und	und	und
under	onder	under
unesco	unesco	unesco
ung	verrot	cancer
unicorn	eenhoorn	unicorn
unit	eenheid	unit
unix	unix	unix
up	ups	up
ural	ural	ural, as in the ural mountains
urani	uranium	uranium
uri	uri	uri, a former political party in south korea
uruguay	uruguay	uruguay
usagi	usagi	usagi
usb	usb	usb
uss	uss	uss
utah	utah	utah
utrecht	utrecht	(proper noun) utrecht
uy	uy	"(term should be ""uy lực"") power (n.)"
uyghur	uyghur	(proper noun) uyghur
uygur	uygur	uygur
uyên	uyen	scholarly
uyển	eufemisme	"(term should be ""uyển chuyển"") flexible (adj.)"
uzbekistan	oezbekistan	uzbekistan
uông	uong	uong
uất	nee	busy
uốn	curling	to curl (v.)
uống	drinken	to drink
uổng	verspillen	vain
v	v	v
va	va	collide
vaccine	vaccin	vaccine
vai	schouder	shoulder
valencia	valencia	valencia
valentine	valentijn	valentine
valley	vallei	valley
van	klep	"(term should be ""van xin"") to beg (v.)"
vanessa	vanessa	vanessa
vargas	vargas	(proper noun) vargas
vasari	vasari	vasari
vay	lenen	borrow
vectơ	vector	vector
ven	langs	"(term should be ""ven biển"") coastal (adj.)"
vendôme	vendôme	vendome
venezia	venezia	venice
venus	venus	venus
verdun	verdun	verdun
vermont	vermont	vermont
verona	verona	(proper noun) the city of verona
versailles	versailles	(proper noun) versailles
vhs	vhs	vhs
vi	omdat	behavior
viagra	viagra	viagra
victor	victor	(proper noun) victor
victoria	victoria	victoria, a province of australia
vienna	wenen	(proper noun) vienna, austria
viet	viet	vietnamese
vietnam	vietnam	vietnam
viettel	viettel	viettel
viii	viii	eighth
vijaya	vijaya	(proper noun) vijaya
viking	viking	viking
villa	villa	villa
villeneuve	villeneuve	(proper noun) villeneuve, a french last name
vinagame	vinagame	vinagame
vinashin	vinashin	vinashin
vince	vince	(proper noun) vince, as in vince mcmahon
vincennes	vincennes	vincennes
vincent	vincent	vincent
vinpearl	vinpearl	vinepeal
viqr	viqr	viqr
virginia	virginia	(proper noun) virginia, as in the state
virus	virus	virus
virút	virus	virus
vissarionovich	vissarionovich	vissarionovich
vista	uitzicht	vista, as in windows vista
vitamin	vitamine	vitamin
vitruvius	vitruvius	vitruvius
viz	namelijk	(proper noun) viz
viêm	ontsteking	inflammation
viên	tabletten	member
viêng	viang	vientiane
viêt	schrijven	vietnam
viếng	bezoek	visit
viết	schrijven	write
việc	baan	thing
viện	instituut	institute
việt	vietnam	viet
việtmường	vietnamese muong	muong
việtnga	vietnga	vietnam-russia
việttrung	viettrung	vietnam-china
vn	vn	vietnam
vnexpress	vnexpress	(proper noun) vnexpress
vni	vni	vni
vo	vo	"(term should be ""tròn vo"") perfectly round (adj.)"
voi	olifanten	elephant
voip	voip	voip
voldemort	voldemort	(proper noun) voldemort, the villain from the harry potter series
von	von	compare
vonfram	wolfraam	wolfram
vong	slachtoffers	injured
voyager	voyager	voyager
voọc	langurs	a langur (n.)
vtc	vtc	vtc
vu	vu	"entire phrase is ""vu cao""; means ""to accuse wrongly"""
vua	koning	king
vui	pret	happy
vulcan	vulcaan	vulcan
vuông	vierkant	square
vuốt	klauw	stroke
vv	enzovoort.	etc.
vy	vy	vy
vyacheslav	vyacheslav	vyacheslav
và	en	and
vài	weinig	several
vàm	vm	the mouth of a rivulet (n.)
vàng	geel	gold
vành	rand	coronary
vào	in de	into
vá	patch	patchy
vác	dragen	to shoulder (v.)
vách	muur	wall
vái	ja	some
ván	plank	game
váng	uitschot	film
váy	jurk	skirt
vân	spoedig	"(term should be ""vân vân"") et cetera"
vây	vin	encircle
vã	gehaast	rush
vãi	shit	to release
vãn	van	save
vè	plas	to glance slyly (v.)
vé	ticket	ticket
vét	baggeren	plunder
vê	over	tremolo
vì	omdat	because
ví	portemonnee	example
vía	portemonnee	soul
vít	schroef	screw
vò	verfrommeld	jar
vòi	slang	tap
vòm	dak	upper jaw
vòng	ring	around
vó	hoooo	hooves
vóc	grootte	"(should be ""vóc sương"") dew-like or delicate"
vô	nee	"(term should be ""vô số"") countless (adj.)"
vôi	limoen	limestone
võ	krijgs	martial arts (n.)
võng	hangmat	hammock
vùi	begraven	"(term should be ""chôn vùi"") to bury or keep secret (v.)"
vùng	regio	region
vú	borst	breast (n.)
vút	stijgend	"entire term should be ""cong vut""; extreme curling"
văn	literatuur	culture
văng	plons	a name
vĩ	super goed	"(term should be ""vĩ đại"") great (adj.)"
vĩnh	permanent	ving
vũ	vu	armed
vũng	plas	vung
vơ	hulpeloos	lost
vơi	met	ullage
vưu	vưu	"actual term is ""xi vưu""; proper noun; name of a leader of a people in chinese legend"
vươn	bereiken	reach
vương	koning	kingdom
vướng	verstrikt	"(term should be ""vướng víu"") to become involved in (v.)"
vườn	tuin	garden
vượn	apen	gibbon
vượt	slagen voor	to overcome
vạ	zo	unfortunate problem
vạc	ketel	cauldron
vạch	bar	bar
vại	pot	jar
vạn	tien duizend	thousand
vạng	schemering	twilight
vả	fig	hard
vải	kleding stof	fabric
vảy	weegschaal	scale
vấn	advies	vấn đề= problem
vấp	struikelde over	stumble
vất	weggooien	hard
vần	rijm	spell
vầng	halo	moon (vang trang)
vẩn	nog steeds	wander
vẩy	vlokken	scale
vẫn	nog steeds	still
vẫy	zwaaien	wave
vận	fortuin	active
vắc	vaccin	vaccine
vắcxin	vaccin	vaccine
vắn	kort	short
vắng	afwezig	absent
vặn	schroef	to twist (v.)
vặt	advertenties	odd
vẹn	integriteit	complete
vẹt	papegaaien	parrots
vẽ	schilderen	draw
vết	patch	wound
vểnh	baars	warping
vệ	verdediging	"(term should be ""bảo vệ"") to defend (v.)"
vệt	strepen	streak
vỉa	naden	"(term should be ""vỉa hè"") sidewalk"
vịnh	baai	bay
vịt	eend	duck
vọng	hoop	"(term should be ""hy vọng"") hope (n.)"
vọt	omhoogschieten	to spurt out (v.)
vỏ	schors	shell
vồ	maul	"(term should be ""gạch vồ"") a type of brick"
vỗ	pat	to clap
vội	haast je	hurriedly (adv.)
vớ	sokken	"(term should be ""vớ vẩn"") silly (adj.)"
với	met	to
vớt	vis	salvage
vờ	doen alsof	"(term should be ""giả vờ"") to pretend (v.)"
vời	super goed	wonderful
vở	notebook	"(term should be ""vở kịch"") a play"
vỡ	gebroken	break
vợ	vrouw	wife
vụn	chips	debris
vụng	onhandig	covert
vứt	weggooien	throw away
vừa	passen	just (adv.)
vừng	sesam	sesame (n.)
vững	firma	firm (adj.)
vực	veld-	place
vựng	woordenschat	"(term should be ""từ vựng"") regional vocabulary (n.)"
vỹ	zo	majestic
w	w	w
wa	wa	wa
walt	walt	(proper noun) walt, as in walt disney
walter	walter	walter
walther	walther	walther
wan	wan	wan
wang	wang	wang
wankel	wankel	(proper noun) wankel
wanna	wil	wanna
warren	doolhof	a name
warsaw	warschau	warsaw
warszawa	warszawa	(proper noun) warsaw
washington	washington	(proper noun) washington
wat	wat	(proper noun) wat, as in angkor wat, the temple in cambodia
watergate	watergate	watergate
waterloo	waterloo	(proper noun) waterloo
waters	wateren	waters
wayne	wayne	wayne
wcdma	wcdma	w-cdma
weasley	wemel	weasley, as in ron weasley in the harry potter series
weblog	weblog	weblog
webmail	webmail	ưebmail
weimar	weimar	(proper noun) weimar
wellington	wellington	wellington
wells	putten	wells, as in author orson wells
welsh	welsh	(proper noun) welsh, as in the welsh language
wembley	wembley	wembley, as in wembley stadium
werner	werner	werner
westermarck	westermarck	westermarck
western	westers	western
westlife	westlife	westlife
westview	westview	westview, as in westview press
wheeler	speculant	a name
widener	verbreding	widener
wien	wien	wien
wiener	worstje	wiener
wifi	wifi	wi-fi, a technology term
wiki	wiki	wiki
wikia	wikia	a name
wikibooks	wikibooks	(proper noun) wikibooks
wikimapia	wikimapia	wikimapia
wikimedia	wikimedia	wikimedia
wikitravel	wikitravel	a name
wild	wild	wild
wilder	wilder	(proper noun) wilder, as in billy wilder
wiley	wiley	wiley
willard	willard	willard
wimbledon	wimbledon	wimbledon
windows	ramen	windows
winer	wijnmaker	winer
wisconsin	wisconsin	(proper noun) wisconsin
within	binnen	within
without	zonder	without
wolfgang	wolfgang	wolfgang
won	won	won
wong	wong	wong
woodrow	woodrow	woodrow
woods	bossen	(proper noun) woods, as in tiger woods
would	zou	would
wrestling	worstelen	wrestling
wright	goed	a name
wu	wu	wu
wushu	wushu	wushu, a type of martial art
wwf	wwf	wwf
xa	ver	ancient
xang	xang	"(term should be ""lan xang"") name of an ancient country in southeast asia"
xanh	blauw	green
xao	slap	xôn xao = chatting
xay	malen	grind
xe	auto	a car (n.)
xem	zien	watch
xen	xen	to insert (v.)
xhcn	xhcn	social republic
xi	xi	xi
xiii	xiii	eighth
xin	alstublieft	please
xinh	mooi	beautiful
xiv	xiv	fourteenth
xiêm	siamees	(proper noun) xiêm, or siam
xiên	schuin	oblique
xiêu	ciao	soften
xiếc	circus	circus
xiết	vastdraaien	to twist tightly (v.)
xiềng	ketenen	chain
xo	xo	spring
xoa	wrijven	massage
xoay	beurt	turn
xong	bereikt	completed
xoàng	middelmatig	mediocre
xoá	verwijderen	delete
xoáy	eddy	vortex
xoắn	verdraaid	coiled
xu	munt	trend
xua	verdrijven	dispel
xuan	xuan	"(term should be ""xuân"") a common vietnamese middle or first name; means ""the season of spring"""
xui	pech	incite
xuka	xuka	xuka
xum	weelderig	a name
xuyên	doordringend	frequently
xuyến	armbanden	manage
xuân	voorjaar	spring
xuâncông	voorjaar	xuan public
xuôi	geveegd	down
xuất	exporteren	ejaculate
xuấtnhập	export-import	import/export
xuống	beneden	down
xuồng	kano	boat
xv	xv	fifteenth
xvi	xvi	xvi
xvii	xvii	xvii
xx	xx	xx
xy	xy	cylinder
xài	besteden	use
xào	bak	stir fry
xách	handtas	to carry by the handle (v.)
xám	grijs	ustox
xán	gebakken	"(term should be ""xán lạn"") bright (adj.)"
xáo	verstoring	chaos
xát	wrijven	touch
xâm	getatoeëerd	invasion
xâu	draad	string
xây	bouwen	build
xã	gemeente	society
xãy	wispelturig	occur
xèo	xèo	xeo
xé	scheur	tear
xén	bijsnijden	"(term should be ""biếu xén"") to gift (v.)"
xéo	zijdelings	diagonally (adv.)
xét	overwegen	examine
xê	actie	"(term should be ""bánh xu xê"") a type of vietnamese cake"
xêkô	suneo	xeko
xì	scheet	scandal
xìu	scheet	to become flaccid (v.)
xí	fabriek	factory (xi nghiep)
xít	fascinerend	nazi
xíu	klein	small
xòe	verspreiden	spread
xóa	wissen	clear
xói	erosie	erode
xóm	buren	village
xót	genade	mercy
xô	duw	soviet
xôi	kleverige rijst	pierce
xôn	roeren	tumultuous
xông	gehaast	rush
xôphần	emmer sectie	soviet-poland
xôviết	sovjet unie	soviet
xù	verstoord	gigantic
xú	onbeleefd	xu
xúc	contact	touch
xúi	induceren	induce
xăm	tatoeëren	"(term should be ""xa xăm"") far away (adj.)"
xăng	benzine	gasoline
xơ	vezel	xo
xưa	oud	old
xưng	bekennen	"(should be ""tự xưng"") self-proclaimed"
xương	bot	bone (n.)
xước	bekrast	scratch
xướng	refrein	provoke
xưởng	werkplaats	workshop
xạ	straling	"(term should be ""phản xạ"") to reflect"
xả	kwijting	release
xảo	sluw	detailed
xảy	optreden	happen
xấp	ca.	approximate
xấu	slecht	bad
xẩm	ruig	a type of traditional vietnamese singing
xẩy	optreden	occur
xắt	dobbelsteen	cut
xẻo	pech	cut off
xếp	gevouwen	rank
xỉ	slakken	approximately
xỉa	floss	to pick (v.)
xỉu	flauw	to faint
xốc	schok	to lift up (v.)
xốp	piepschuim	porous
xổ	verloten	rush into
xộn	rommelig	messy
xứ	land-	native
xứng	waardig	appropriate
xử	traktatie	judge
y	y	medical
y=fracsin	y = fracsin	a function
ya	ja	(proper noun) ya, as in ya trang
yakovlev	yakovlev	yakovlev
yakushima	yakushima	yakushima
yalta	yalta	(proper noun) yalta
yankee	yankee	(proper noun) yankee
yard	werf	yard
yasha	yasha	a name
yeeun	yeeun	(proper noun) yeeun
yeltsin	yeltsin	yeltsin, as in boris yeltsin
yemen	jemen	yemen
yersin	yersin	(proper noun) yersin, asin alexandre yersin
yi	yi	(proper noun) yi
ying	ying	(proper noun) ying, as in ying yang
ymca	ymca	ymca
yo	yo	yo
yomiuri	yomiuri	yomiuri
yoochun	yoochun	yoochun
york	york	york
yorker	yorker	yorker
yorkshire	yorkshire	yorkshire
youtube	youtube	youtube
ypres	ieper	ypres
ytv	ytv	ytv
yu	yu	yu
yuan	yuan	(proper noun) yuan, as in yuan mu
yucatán	yucatán	yucatan, as in the yucatan peninsula
yudhoyono	yudhoyono	(proper noun) yudhoyono, as in indonesian president susilo bambang yudhoyono
yugi	yugi	yugi
yukito	yukito	yukito
yume	yume	(proper noun) yume
yunho	yunho	yunho
yuri	yuri	yuri, as in soviet pilot and cosmonaut yuri alekseyevich gagarin
yurt	yurt	yurt
yên	yen	peace or stillness (n.)
yêu	houden van	love
yếm	overall	tender
yến	vogelnest	a type of swallow (n.)
yết	lijst	yet
yếu	zwak	mainly
yểm	hoes	support
yển	yen	"is a name meaning, ""bird"""
yểu	lief	"(term should be ""yểu điệu"") graceful (adj.)"
z	z	z
zac	zac	zac
zambia	zambia	(proper noun) zambia, as in the nation
zealand	zeeland	(proper noun) zealand, as in new zealand
zedong	zedong	mao zedong
zero	nul	zero
zeus	zeus	zeus
zheng	zheng	zheng
zhukmse	zhukmse	zhuk-mse
zimbabwe	zimbabwe	zimbabwe
zinedine	zinedine	(proper noun) zinedine
zing	zing	zing, as in the website
zoe	zoe	zoe
zurich	zürich	(proper noun) zurich
zürich	zürich	(proper noun) zurich, as in zurich, switzerland
|nguyễn	| nguyen	a common vietnamese last name
|nổi	| drijft	"(term should be ""nổi"") to float (v.)"
|petya	| petya	(proper noun) petya
|tên	| naam	"(should be ""tên"") name (n.)"
|việt	| vietnamees	vietnam
 kg	kg	kg
 triệu	miljoen	million
 °c	° c	degrees celsius
°đến	° tot	up to
°độ	° graden	degree
×	×	x
ào	wauw	rush
á	aziatisch	asia
ác	onheil	evil
ách	juk	yoke (n.)
ái	verlangen	ai
ám	wordt weergegeven	(with the word chi) to hint at
ánh	glans	light
áo	overhemd	clothe
áohung	aohung	"(term should be ""Áo-hung"") austria-hungary"
áp	druk	"(term should be ""huyết áp"") blood pressure (n.)"
áâu	aoi	eurasian
â	een	a vietnamese vowel sound
âm	minus	vagina
ân	gunst	deed
én	zwaluwen	swallow
ép	knijpen	press
êgê	ego	aegean
êm	glad	smooth
ích	nuttig	benefit
ílam	ílam	tamil language name for the island of sri lanka
ít	weinig	less
île	ile	Île, as in Île de la cité, france
îledefrance	îledefrance	ile-de-france
ðiều	artikel	article
ðài	ðài	taiwan
ðường	suiker	a road
ðảng	partij	party
ðức	duitsland	"Đức, a common vietnamese first name; means ""virtue"""
ó	o	(with the word la) to boo down
óc	hersenen	brain
óng	iriserend	"(term should be ""óng ả"") flexible"
ôi	oh	"vietnamese version of the exclamation ""oh"""
ôm	knuffel	hug
ôn	met mate	peaceful (on hoa)
ông	hij	a man (n.)
ôtô	auto	car
ôxi	zuurstof	oxygen
ôxy	zuurstof	the element oxygen (n.)
ôxít	oxyde	oxide
ôzôn	ozon	ozone
ùn	jam	congest
úng	doordrenkt	flood
úp	naar beneden	upside
úy	luitenant	"(term should be ""thiếu úy"") second lieutenant (n.)"
ý	italië	italian
ăn	eten	eat
ăng	mier	antenna
ăngten	antenne	antenna
đa	multi	majority
đai	band	"(term should be ""Đai khố"") name of a village"
đak	dak	(proper noun) Đak
đan	brei	scandal
đau	pijn	painful
đay	jute-	jute, a type of vegetation the vietnamese use to make soup (n.)
đb	db	dien ban
đcstq	dcstq	communist party of china
đcsvn	dcsvn	vietnam communist party
đe	aambeeld	threaten
đem	brengen	to bring (v.)
đen	zwart	black
đentrắng	zwart en wit	"(term should be ""đen-trắng"") black-and-white (adj.)"
đeo	slijtage	wear
đh	đh	university
đhcn	đcn	university of industry
đhtm	dhtm	university of economics
đhông	oosten	dhong
đi	gaan	go
điên	gek	crazy
điêu	ding	sculpture
điôxít	dioxide	dioxide
điạ	dạ	dia
điếc	doof	heron
điếu	sigaret	funeral oration
điềm	teken	omen
điền	vullen	estate
điều	ding	control
điểm	punt	bearing point
điển	woordenboek	"(term should be ""từ điển"") a dictionary"
điểu	neuken	thing
điệp	de boodschap	spy
điệu	toon	memorial
đo	meten	measure
đoa	doa	doa
đoan	groep	extreme
đom	vuurvliegjes	firefly
đoài	mango	the west
đoàn	groep	an organization or group (n.)
đoái	uitwisseling	"(term should be ""hối đoái"") to exchange or trade (v.)"
đoạn	paragraaf	a stage or phase (n.)
đt	tel	training
đtđ	mobiele telefoon	diabetes
đua	ras	emulate
đui	blind	blind
đun	warmte	cook
đuôi	staart	tail
đuốc	fakkel	a torch
đuối	verdrinking	drowning
đuống	stam	(proper noun) Đuống, the name of a river
đuổi	jacht	pursue
đài	radio	statue
đàm	praat	negotiation
đàn	kudde	musical instrument
đàng	ja	side
đào	graven	train
đày	verbanning	exile
đá	rots	to kick
đái	plas	pee
đám	groep	dam
đán	dan	"(term should be ""tết nguyên Đán"") vietnamese new year's day"
đáng	waard	deserve
đáo	uniek	unique
đáp	antwoord	response
đát	land-	"(term should be ""bi đát"") lamentable (adj.)"
đâm	steken	pierce
đâu	waar	anywhere
đây	hier	below
đã	is al	already
đãi	traktatie	"(should be ""bạc đãi"") to ill-treat"
đãng	wellustig	dissolute
đè	overschrijven	to press on
đèn	lamp	light
đèo	slagen voor	a mountain pass (n.)
đê	dijk	a dike (n.)
đêm	nacht	night
đênh	buck	lênh đênh= float to unknown
đích	bestemming	goal
đính	gehecht	attached (adj.)
đò	veerboot	a ferry (n.)
đòi	beweren	require
đòn	blazen	welcome
đó	daar	that or there (adv.)
đóa	nee	"(term should be ""đoá hoa"") a flower bloom"
đói	hongerig	hungry
đón	oppakken	welcome
đôi	dubbele	sometimes
đôla	dollars	dollar
đôn	voetstuk	london
đông	bronzen	eastern
đôngbắc	noordoosten	north-east
đôngnam	zuid oost	south-east
đôngtây	oost west	"(term should be ""đông-tây"") east-west (adj.)"
đôrêmi	doraemon	(proper noun) Đôrêmi
đôrêmon	doraemon	doreamon
đùa	grap	joke
đùi	dijbeen	thigh
đúc	gieten	"(term should be ""đúc kết"") to sum up (v.)"
đúng	het is correct	right
đúp	dubbele	double
đút	zetten	"(term should be ""đút lót"") to bribe"
đăk	dak	dak
đĩ	slet	whore/bitch
đĩa	bord	disk
đơ	pauze	stiff or rigid (adj.)
đưa	slagen voor	girl
đường	straat	pathway
được	ok	is not
đạ	da	da
đại	super goed	eagle
đạm	eiwit	plain
đạn	kogel	bullet
đạo	religie	vagina
đạp	fiets	to step on
đạt	bereiken	reach
đả	gevechten	to hit
đảm	gegarandeerd	"(term should be ""đảm nhiệm"") to undertake (v.)"
đản	verjaardag	a group or flock (n.)
đảng	partij	party
đảo	eiland	an island (n.)
đấm	slaan	punch
đấng	god	the
đất	land-	country
đấtmặt	grond	datmat
đấy	daar	ignore
đầm	jurk	swamp
đần	stom	"(term should be ""đần độn"") stupid or ignorant (adj.)"
đầu	hoofd	start
đầy	vol	"(term should be ""đầy đủ"") adequate or enough"
đẩu	hoofd	"(entire term is ""khoa đẩu"") ancient phonetic script used in vietnam"
đẩy	duwen	to push
đẫm	doorweekt	wet
đậm	donker	dense
đậu	boon	to park (v.)
đậy	hoes	cover
đắc	krijgen	effectively
đắm	vergaan	sink
đắn	fatsoen	proper (dung dan)
đắng	bitter	bitter
đắp	omhoog	"(term should be ""bù đắp"") to compensate (v.)"
đắt	duur	expensive
đằng	over-	back
đẳng	klasse	equality
đặc	bijzonder	"(term should be ""đặc biệt"") special (adj.)"
đặn	regelmatig	regularly
đẹp	mooi	beautiful
đẽ	prima	beauty
đế	zolen	empire
đếm	tellen	to count (v.)
đến	komen	come
đề	draden	promote
đền	tempel	"(term should be ""đền thờ"") a religious shrine"
đều	zijn	all
để	naar	for
đệm	kussen	middle name
đỉnh	top	the summit or peak
địch	de vijand	enemy
định	gespecificeerd	appointed
đọ	ontpit	compete
đọan	paragraaf	period
đọc	lezen	read
đọng	stagneert	deposit
đỏ	rood	red (adj.)
đốc	gouverneur	admiral
đối	voor	face
đốm	plek	spot
đốn	omhakken	"(term should be ""suy đốn:) to be worse off"
đống	stapel	line
đốt	brandend	burn
đồ	ding	thing
đồi	heuvel	hill
đồn	gerucht	rumour
đồng	koper	agreeable
đổ	gieten	dump
đổi	verandering	to change (v.)
đổng	dong	"(term should be ""đồng bằng"") a delta"
đỗ	geparkeerd	pass
độ	mate	"term should actually be ""độ cao""; means ""height"""
độc	vergiftigen	alone
độn	opgevuld	chaos
động	dynamisch	action
đột	plotseling	"(term should be ""xung đột"") conflict (n.)"
đới	zen	tropical
đời	levenslang	generation
đỡ	ondersteuning	help
đợi	wacht	thigh
đợt	partij	fit
đục	ondoorzichtig	turbid
đụn	duinen	dune
đụng	aanraken	encounter
đủ	genoeg	enough
đứa	kinderen	child
đức	deugd	virtue (n.)
đứng	stand	to stand (v.)
đứt	gebroken	cut off
đừng	niet doen	not
đực	mannetje	male
đựng	bevatten	suffer
đựoc	oke	be
ĩ	oh	"(term should be ""ầm ĩ"") noisy"
ơ	oh	"(term should be ""thờ ơ"") to be indifferent (adj.)"
ơi	hallo	"vietnamese equivalent of english ""oh"""
ơn	bedankt	thank
ư	u	vowel sound found in the vietnamese alphabet (n.)
ưa	voorkeur	to like (v.)
ưng	oh ja	to accept (v.)
ưu	voors	"(term should be ""ưu việt"") preeminent (adj.)"
ươi	orang	orangutan
ươm	kinderkamer	nursery
ương	centraal	central
ướp	gemarineerd	mummy
ướt	nat	wet
ạ	meneer	a word added to the end of a response to show respect to someone in a position of authority, as in a child to a parent
ạt	stormloop	(with word o) to crowd
ải	ải	pass
ảnh	beeld	picture
ấm	warm	warm
ấn	druk op	press
ấnâu	afdrukken	"(term should be ""Ấn Âu"") a grouping of languages including european and indian languages that are thought to have originated from a single earlier language (adj.)"
ấp	gehucht	district
ấu	jong	childhood
ấy	dat	that
ẩm	warm	humidity
ẩn	zich verstoppen	hidden
ập	knal	rush
ắt	zeker	sure
ếch	een kikker	frog
ỏi	munt	little
ố	ooh	"(term should be ""hoen ố"") stained and smeared (adj.)"
ốc	slakken	building
ốm	ziek	sick
ống	buis	tube
ốp	raaklijn	omelette
ồn	lawaai	noisy (adj.)
ổ	rijden	hard drive
ổi	guava	guava (n.)
ổn	is goed	peace
ớn	groot	posts
ớt	chili	chili
ở	in	at
ủ	incubatie	"(term should be ""ủ dột"") gloomy (adj.)"
ủi	ijzer	"(term should be ""an ủi"") to comfort (v.)"
ủng	laarzen	boot
ủy	commissaris	commission
ứ	ja	to pool together (v.)
ức	borst	memories
ứng	toepassing	corresponding
−−	−−	__
≠	≠	different
