$ tỉ	miljardu dolāru	$ billion
abc	abc	abc
abdul	abduls	abdul
abkhazia	abhāzija	a name
about	par	about
abraham	abraham	abraham
abrams	abrams	abrams
abscbn	abscbn	abscbn
account	konts	account
aceh	aceh	(proper noun) aceh
achilles	ahilleja	achilles
acia	acija	acia
acid	skābe	acid
ada	ada	ada
adams	adams	(proper noun) adams
addisonwesley	addisonwesley	(proper noun) addison-wesley
adn	adn	adn
adobe	adobe	adobe
adrian	adrians	(proper noun) adrian
adsl	adsl	adsl
advanced	uzlabotas	advanced
aedes	aedes	aedes
aegypti	aegypti	aegypti
aero	aero	(proper noun) aero, as in the aero l-39 albatros jet
afc	afc	afc
aff	afēra	aff
afghanistan	afganistāna	afghanistan
africa	āfrika	(proper noun) africa
african	afrikāņu	african
ag	ag	ag
agasa	agasa	(proper noun) agasa, as in hiroshi agasa
agassi	agassi	agassi
ai	pvo	who
ailen	īru	ailen
aim	mērķis	aim
air	gaiss	air
airbus	airbus	airbus
aisne	aisne	aisne
ajax	ajax	ajax
ak	ak	ak
akatsuki	akatsuki	akastuki
akms	akms	akms
akô	sveiki	ako
al	al	al
alabama	alabama	alabama
alaska	alaska	alaska
albania	albānija	albania
albatros	albatros	(proper noun) albatros, as in the aero l-39 albatros
albert	alberts	(proper noun) albert
alberto	alberto	(proper noun) alberto
albion	albions	albion, an ancient name for great britain
albuquerque	albukerke	albuquerque
albus	albuss	albus
alexa	aleksa	alexa
alexandra	aleksandra	alexandra
alexandria	aleksandrija	alexandria
alexandros	aleksandros	alexandros
alexey	aleksijs	alexey
alfred	alfrēds	(proper noun) alfred, as in alfred kinsey
algérie	algérie	algerie
ali	ali	ali
alice	alise	this is a name
allan	alans	(proper noun) allan, as in edgar allan poe
allen	allen	(proper noun) allen
allmusic	allmusic	allmusíc
alois	alois	alois
alonso	alonso	alonso
alpher	alfa	(proper noun) alpher
alps	alpi	alps
altai	altaja	altai
always	vienmēr	luon luon
amaravati	amaravati	amaravati
amazon	amazon	amazon
amdo	amdo	(proper noun) amdo
ame	ame	ame
ami	amī	ami
amiens	amiens	amiens
amin	amīns	(proper noun) amin, as in nagib amin
amm	amm	amm
amoniac	amonjaks	ammonium (n.)
amphitrite	amfitrīts	(proper noun) amphitrite, a greek sea goddess
an	an	"(should be ""an toàn"") safe"
anand	anand	anand
anata	anata	anata
anatolia	anatolija	anatolia
andalusia	andalūzija	andalusia
andaman	andamans	andaman
anderson	andersons	anderson
andes	andes	andes
andorra	andora	andorra
andrew	iemeta	andrew
andré	andrē	andre, as in andre morval
andy	andy	(proper noun) andy, as in andy warhol
anfield	anfield	anfield
ang	ang	ang
angkor	angkor	(proper noun) angkor, as in angkor wat, the temple in cambodia
anglosaxon	anglosaxon	anglo-saxon
anh	brālis	english
anhmỹ	britu	"(term should be ""anh mỹ"") english or american"
anhpháp	angļu franču valoda	england-france
ankara	ankara	ankara
ankyl	ankil	ankly
anna	anna	anna
annam	nam	a name the way french called middle vietnam as a colony
annan	annans	annan
anne	anne	anne, a name
anorthosit	anorthosit	anorthosit, a type of igneous rock (n.)
anthony	antonijs	anthony
antigua	antigva	(proper noun) antigua
anton	antons	anton
antonov	antonovs	antonov
any	jebkura	any
anđêhít	aldehīds	aldehydes
ao	dīķis	pond
aotearoa	aotearoa	aotearoa
apollo	apollo	apollo
apple	ābolu	apple
aquinas	akvīnas	a name
arab	arābu	(proper noun) arab
archetypal	arhetipisks	archetypal
archive	arhīvs	archive
arctan	arktāns	a function
ares	āri	ares
argentina	argentīna	(proper noun) the south american nation of argentina
argo	argo	argo
arias	ārijas	arias
aringarosa	aringarosa	aringarosa, as in manuel aringarosa
aristotle	aristotelis	aristotle
arizona	arizona	arizona, as in the state
ark	šķirsts	ark
arkansas	arkansas	arkansas
arlington	ārlingtons	(proper noun) arlington
armenia	armēņu	(proper noun) armenia
armstrong	ieročos	(proper noun) armstrong, as in jazz artist louis armstrong
arnold	arnolds	arnold
arsenal	arsenāls	arsenal
artemis	artemija	(proper noun) artemis, the greek goddess of the hunt
aruba	aruba	aruba
arunachal	arunachal	"(term should be ""arunachal pradesh"") a state in india (proper noun)"
asc	asc	asc
ash	pelni	a name
ashikaga	ašikaga	ashikaga
ashley	ešlija	(proper noun) ashley
asia	āzija	asia
asm	asm	asm
asoka	asoka	asoka
association	asociācija	association
assyria	asīrija	assyria
aston	izbrīns	(proper noun) aston, as in aston villa
atkinson	atkinsons	atkinson
atlanta	atlanta	atlanta
atlantic	atlanti	atlantic
aua	aua	aua
aubrac	aubrac	aubrac
audition	klausīšanās	audition
auflage	auflage	auflage
auguste	auguste	auguste
australia	austrālija	(proper noun) australia
austria	austrijā	(proper noun) the country of austria
austrian	austrietis	austrian
avar	avar	a name
aviation	aviācija	aviation
awad	awad	awad
award	balvu	award
axit	skābe	acid
ayeyarwady	ayeyarwady	ayeyarwady
ayumi	ajumi	(proper noun) ayumi
ayutthaya	ajutihaja	(proper noun) ayutthaya
azerbaijan	azerbaidžāna	(proper noun) azerbaijan
aztec	acteki	aztec, as in the aztec people (adj.)
ba	tēvs	three
babylon	babilons	babylon
bacon	speķis	bacon
baden	bādene	baden
baghdad	bagdāde	(proper noun) baghdad
bago	bago	bago
bahamas	bahamu salas	bahamas
bahrain	bahreina	bahrain
baháí	baháí	bahai
balearic	baleāru	balearic
bali	bali	bali
balkan	balkāns	(proper adjective) balkan
balkans	balkāni	balkans
ballard	ballard	ballard
bamar	bamārs	bamar
ban	aizliegums	the
bang	sprādziens	state
banh	bumba	ball
banner	reklāmkarogs	banner
bantam	bantam	bantam
bantu	tu aizliedz	bantu
bao	maiss	bao giờ= ever
barack	baraks	barack
barak	baraks	barak
barbados	barbadosa	(proper noun) barbados
barbara	barbara	barbara
barbary	barbary	barbary
barca	barca	barca
barnes	barnes	barnes
barone	barone	barone
baroque	baroka	baroque
barquin	bariņš	barquin, as in ramon barquin, the cuban military colonel
barrichello	barichello	barrichello
bartholdi	bartholdi	bartholdi
baryon	barons	baryon
barça	barca	(proper noun) barca
base	bāze	base
basel	bāzele	basel, a city in switzerland
basil	baziliks	basil
baskervilles	baskervilles	baskervilles
bass	bass	bass
bator	batoru	bator
battambang	battambangs	battambang
bauer	bauers	bauer
bay	lidot	"(should be ""tuyến bay"") an airline"
bayern	bayern	bayern
bazan	bazalts	basalt (n.)
bazơ	pamata	base
bb	bb	bb
bbc	bbc	bbc
bc	bc	bc
bchtư	bchtư	central executive
beat	pārspēt	beat
beatles	sitieni	the beatles
beauty	skaistums	beauty
beckenbauer	bekenbauers	beckenbauer, as in franz beckenbauer
becker	bekeris	(proper noun) becker
beckham	bekhems	beckam
bedloe	gultasveļa	bedloe
beethoven	bēthovens	beethoven
beethovens	bietes	beethoven's
beginbmatrix	iesākuma matrica	this is a code
behind	aizmugurē	behind
beijing	pekina	beijing
bel	bel	bel
bell	zvans	bell
bella	bella	bella
bellatrix	bellatrix	bellatrix
benedict	benedikt	benedict
benetton	benettons	benetton
benfica	benfica	benfica
benito	benito	benito
benjamin	benjamin	(proper noun) benjamin
bennington	benningtona	bennigton
berber	berberu	berber
bergen	bergen	(proper noun) bergen
berger	bergers	berger
bering	bering	(proper noun) bering, as in the bering strait
berkeley	berkeley	(proper noun) the city of berkeley, california
berman	bermanis	a name
bermuda	bermuda	(proper noun) bermuda
bernard	bernards	bernard
bertrand	bertrand	bertrand
better	labāk	better
betty	betty	betty
bhutan	butāna	bhutan
bia	alus	beer (n.)
biang	bianga	biang
bic	bic	bic
bikini	bikini	bikini
bill	rēķins	(proper noun) bill, as in former president bill clinton
billy	billy	billy
bismarck	bismarks	bismarck, as in otto von bismarck
bitmap	bitkarte	bitmap
biên	ieraksts	bien
biếc	zīle	a bluish-green color (adj.)
biếm	neuzmanīgs	"(term should be ""biếm họa"") cartoon (n.)"
biến	ārā	other
biếng	slinks	lose interest in
biếu	izrādīt cieņu	present
biều	bieu	bieu
biển	jūra	ocean
biểuthứcđiềukiện	jāzina apstākļi	conditional expression
biện	atvainojos	"(term should be ""biện pháp"") a method (n.)"
biệt	atšķirīgs	"(term should be ""khác biệt"") different or distinct"
bkavpro	bkavpro	bkavpro
blackwell	melnplauka	this is a name
blair	blair	blair
blaise	vainot	blaise
blanc	blanc	blanc
blues	blūza	blues
bo	bo	a curl, as in a biceps curl exercise
bob	boba	bob
bobby	bobijs	bobby, as in bobby day
boeing	boeing	boeing
bohemia	bohēmija	bohemia
bolivia	bolīvija	(proper noun) bolivia
boltzmann	boltzmann	boltzmann
bom	bumba	bomb
bonaparte	bonaparte	bonaparte
bong	bongs	"(term should be ""bong bóng"") a balloon (n.)"
bonnal	kaulains	bonnal
bonobo	bonobo	bonono
bool	bols	bool
boolean	būla	(proper adjective) boolean, as in boolean algebra
boom	uzplaukums	boom
boong	klāja	a deck (n.)
boongke	bunkuri	bunker
bop	bop	bop
boris	boriss	boris
borland	borland	(proper noun) borland
borussia	borussia	borussia
bose	bose	bose, as in subhas chandra bose
boseeinstein	boseinšteins	bose einstein
bosna	bosna	(proper noun) bosnia
bosnia	bosnija	(proper noun) bosnia
botswana	botsvāna	botswana
bottom	apakšā	bottom
boulder	laukakmens	boulder
bourbon	burbonu	bourbon
boxing	bokss	boxing
brain	smadzenes	brain
brandenburg	brandenburga	(proper noun) brandenburg
brandt	brendijs	brandt
braun	braun	braun
brazil	brazīlija	brazil
bremen	bremeni	bremen, as in the bremen bank
brestlitovsk	brestlitovsk	brest-litovsk
breton	bretoņa	(proper noun) breton
bretton	brettons	hoi nghi
brezhnev	brežņevs	brezhnev
brian	braiens	a name
bridge	tilts	bridge
britannic	britannic	(proper noun) britannic
britney	britnija	britney
brooklyn	bruklina	brooklyn
brot	buljons	this is german not vietnamese
brown	brūns	brown
browne	brūns	browne
browning	brūnēšana	(proper noun) browning
bruce	bruce	bruce
brunei	bruneja	brunei
bruno	bruno	bruno, as in the city of san bruno
brusilov	brusilovs	brusilov
brussels	brisele	brussels, the capital of belgium
btr	btr	btr
bubalis	bubalis	bubalis
budapest	budapesta	budapest, the capital of hungary
bulgaria	bulgārija	bulgaria
bulletin	biļetens	thong bao
bungary	bungari	bungary
bungo	bungo	bungo
buonaparte	buonaparte	(proper noun) buonaparte, as in casa buonaparte
burke	burke	(proper noun) burke, as in edmund burke
burkina	burkina	burkina
burma	birma	burma
burundi	burundi	burundi
busan	busans	a korean city
busby	busby	busby
bush	krūms	bush
bushy	kupls	bushy
buôn	vairumtirdzniecība	commerce
buông	atlaisties	to release, to let loose
buýt	autobuss	bus
buốt	labprāt	sharp
buồm	bura	sail
buồn	skumji	sad
buồng	istaba	chamber
buổi	sesija	session
byzantine	bizantīns	byzantine
bà	vecmāmiņa	woman or lady (n.)
bài	ziņas	articles
bàn	tabula	table
bàng	ērglis	eagle
bành	peng	armchair
bào	ēvelēšana	compatriot
bàu	bau	bau
bày	prezentācija	"(term should be ""trưng bày"") to display (v.)"
bác	tēvocis	doctor
bách	ciprese	"(term should be ""bách khoa"") polytechnic (adj.)"
bái	kults	to bow (v.)
bám	pieķerties	cling
bán	pārdot	sell
báng	sprādziens	"(term should be ""phỉ báng"") to defame or slander"
báo	avīze	newspaper (n.)
bát	bļoda	eight (n.)
báu	dārgums	valuable
bây	tagad	now
bã	atlikums	"(term should be ""buồn bã"") sad (adj.)"
bãi	pagalmi	beach
bão	vētra	storm
bèn	tad	then
bé	maz	baby
bén	asu	sharp (adj.)
béo	tauki	fat
bên	pusē	side
bênh	slims	advocate
bì	iepakojums	foreskin (n.)
bìa	piesegt	cover
bìu	sēkliniekos	sac (n.)
bí	skvošs	secret
bính	binh	"(term should be ""bính âm"") romanized chinese words (n.)"
bíró	ķirbis	biro
bò	govs	beef
bó	ķekars	bound (adj.)
bói	zīlēšana	to foretell (v.)
bón	mēslot	"entire term should be ""phan bon""; means ""fertilizer"""
bóng	bumba	sphere or ball
bóp	saspiest	squeeze
bô	tēvs	"(term should be ""bôxit"") the mineral bauxite"
bôi	iesmērēts	to apply (as in oil)
bông	kokvilna	flower
bù	meikaps	compensate
bùa	amulets	talisman
bùn	dubļi	mud
bùng	uzliesmot	"(term should be ""bùng nổ"") to break out (v.)"
bú	zīst	to suck
búa	āmurs	a hammer
búi	kušķi	tuft
bún	rīsu nūdeles	noodle
búng	ņurdēja	snap
bút	pildspalva	pseudonym
băm	hashed	hash
băn	satracināt	concerned
băng	ledus	"(term should be ""băng giá"") freezing (adj.)"
bơ	sviests	"(term should be ""bơ vơ"") desolate (adj.)"
bơi	peldēt	swim
bơm	sūknis	pump
bưu	pasta izdevumi	post office
bước	solis	a step (n.)
bướm	tauriņš	butterfly
bạ	kontakti	directory
bạc	sudrabs	meager
bạch	balts	"(should be ""bạch tuộc"") an octopus"
bại	zaudēt	defeated
bảng	dēlis	chart
bảo	bao	protect
bảy	septiņi	seventh
bấm	nospiediet	press
bất	reāli	"(term should be ""bất cứ"") any (adj.)"
bấy	tas	contemporary
bần	nabadzīgs	poor
bầu	balso	vote
bầy	ganāmpulks	servant
bẩm	iedzimts	congenital
bẩn	netīrs	the
bẩy	slazds	"(term should be ""lẩy bẩy"") unsteadily (adv.)"
bẫy	slazds	a trap (n.)
bậc	grāds	level or class (n.)
bận	aizņemts	busy
bật	ieslēgts	outstanding
bắc	uz ziemeļiem	beijing
bắcnam	ziemeļi dienvidi	"(term should be ""bắc-nam"") north-south (adj.)"
bắn	šaut	shoot
bắp	kukurūza	venter
bắt	noķert	cross
bằng	vienāds	by
bẹp	sasmalcināt	crush
bẻ	pārtraukums	break
bẽ	pazemojums	humiliate
bến	piestātne	wharf
bếp	virtuve	kitchen
bề	virsma	"(should be ""bề mặt"") a surface"
bền	izturīgs	enduring (v.)
bể	plēšas	tank
bệ	pjedestāla	base
bện	pīts	braided (adj.)
bệnh	slims	benh
bỉ	beļģija	disgust
bỉnh	nerātns	binh
bịch	mest	ridiculous
bịt	pārklāts	cover
bọ	bļāviens	insect
bọc	ietīt	to cover or enclose (v.)
bọn	viņiem	a group (n.)
bọng	pietūkums	bladder
bọt	putas	foam
bỏ	atsaukt	to leave (v.)
bỏng	sadedzināt	hot
bố	tēvs	"(term should be ""tuyên bố"") to declare"
bốc	iekraušana	bốc lửa= on fire
bối	apjucis	messy
bốn	četri	four
bồi	kompensācija	"(term should be ""cao bồi"") cowboy (n.)"
bổn	nodoklis	duty
bổng	stipendija	"with word luong, means ""salary"" or ""wages"""
bỗng	pēkšņi	suddently
bộ	komplekts	part
bộc	boc	"(term should be ""bộc lộ"") to reveal (v.)"
bội	vairākas	betray
bột	milti	powder or flour (n.)
bớ	noapaļot uz augšu	arrest
bớt	mazāk	less
bờ	mala	coast
bời	bum	profuse
bở	autors	profitable
bởi	autors	because
bục	pjedestāla	platform
bụng	kuņģī	abdomen
bứt	neapzināti	"(term should be ""bứt phá"") power (n.)"
bừa	aizskarošs	messy, careless, or topsy-turvy (adj.)
bữa	maltīte	meal (n.)
bực	neapmierināti	bother
ca	maiņu	praise
ca-lo	ca-lo	a unit of measurement
cabo	kabo	cabo
cacbon	oglekļa	carbon
cacbonat	karbonāts	carbonate
cacbua	karbīds	carbides, carbon ions
caesar	ķeizars	caesar
caffein	kofeīns	caffeine
café	kafija	coffee
cai	kai	govern
cairo	kaira	cairo, the capital of egypt
cal	kal	cal, a first name
calculus	aprēķins	calculus
calvin	kalvins	calvin
cam	apelsīni	commit
cambodia	kambodža	(proper noun) the country of cambodia
cambridge	kembridža	cambridge
cameo	kameja	cameo part
cameron	kamerons	cameron
cameroon	kamerūna	cameroon
camille	camille	camille
campbell	nometne	campbell
campuchia	kambodža	campuchia
canada	kanāda	canada
canadian	kanādietis	canadian
canal	kanāls	canal
canary	kanārijputniņš	canary
cancer	vēzis	cancer
canterbury	kenterberija	canterbury
canxi	kalcijs	calcium
capello	kapelo	capello
capra	kapra	capra
carat	karāts	carat
carbine	karabīna	carbine
cardcaptor	kartogrāfs	cardcaptor
cardcaptors	kardināli	(proper noun) cardcaptors
carey	rūpīgs	(proper noun) carey, as in singer mariah carey
caribe	karibe	caribbean
caribê	karību jūras reģions	caribbean
carl	kārlis	carl
carlos	carlos	carlos
carnaval	karnavali	carnaval
carol	carol	carol
caroline	karolīna	(proper noun) caroline
carpathia	carpātija	carpathia
carter	karteris	carter
carxtơ	karāts	karst topography, a geological term (n.)
casa	ca sa	casa
casablanca	casablanca	casablanca
caspia	kaspija	caspia
cassini	kasini	cassini
cast	cast	cast
castries	kārbiņas	castries
castro	kastro	castro, as in fidel castro
cathay	katajs	cathay
catherine	katrīna	catherine
cau	cau	cau
cbc	cbc	cbc
cbgd	cbgd	educational  officer
cbs	cbs	cbs
ccc	ccc	ccc
ccn	ccn	industrial cluster
cctv	cctv	cctv
cd	kompaktdisks	cd
cdot	cdot	cdot
cdrom	cd rom	cd-rom
cell	šūna	cell
celtic	ķeltu	centic
cena	cena	(proper noun) cena, as in john cena, the wrestler
centauri	kentauru	centauri
ceres	ceres	ceres
cha	tētis	father
chai	pudele	bottle
chaillot	chaillot	a name
chamberlain	kamerlains	chamberlain
champa	šampa	champa
champion	čempions	champion
chamẹ	vecākiem	parents
chanel	kanāls	chanel
chanh	citronu	lemon or lime (n.)
chao	sveiki	(proper noun) chao, a name
charles	charles	charles
charlotte	šarlote	charlotte
charlton	charlton	charlton
charon	hronons	(proper noun) charon
chase	tramdīt	chase
chay	veģetārietis	fasting
chdcnd	chdcnd	democratic republic
che	piesegt	cover
chechnya	čečenija	chechnya
chen	čen	chen
cheo	cheo	"(term should be ""cheo reo"") name of a town"
chi	chi	"(term should be ""chi tiết"") details (n.)"
chia	dalīties	"(term should be ""chia sẻ"") to share"
chiang	chiang	chiang
chicago	čikago	chicago, as in chicago, illinois
chile	čīle	(proper noun) the country of chile
chim	putns	bird
china	ķīna	china
ching	čings	ching
chirac	čiraks	chirac, as in former french president jacques chirac
chiêm	zodiaka	"(term should be ""chiêm thành"") the ancient kingdom of champa in vietnam"
chiên	cepts	fry
chiêng	gongu	gong
chiếc	gab	the
chiếm	grāmatvedība	appropriate
chiến	cīņa	war, fight
chiết	ekstrakts	literal
chiếu	paklājs	show
chiền	ķekars	temple
chiều	plkst	length
chlamydia	hlamīdijas	chlamydia
chloride	hlorīds	chloroauric acid
chnd	chnd	chnd
choi	spēlēt	choi
chomsky	chomsky	chomsky
chong	chong	chong
chopin	šopēns	chopin
chosŏn	chosŏn	(proper noun) choson
choàng	apmetnis	coat
choáng	apstulbis	dizzy
chris	kriss	chris, as in chris hughes
christ	kristus	christ
christian	kristietis	christian
christopher	kristofers	christopher
chrome	hroms	chrome, as in google chrome
chrysler	chrysler	(proper noun) chrysler, the car company
chu	ču	cycle
chua	skābs	tomato
chuck	čaukst	(proper noun) chuck, as in chuck norris
chui	noslaucīt	underground
chum	čoms	pot
chun	čun	chun
chung	vispārējs	general
churchill	bazilika	churchill
chuyên	specializēta	professional
chuyến	ceļojums	trip
chuyền	caurlaide	volleyball
chuyển	pārcēlās tālāk	to move
chuyện	stāsts	nói chuyện= talk
chuôi	žņaugt	handle
chuông	zvans	a bell
chuẩn	standarta	standard
chuốc	kule	incur
chuối	banāns	banana
chuốt	atklāšana	refine
chuồng	būris	cage
chuỗi	ķēde	series
chuộc	izpirkt	redeem
chuộng	labvēlīgi	favorite
chuột	pele	a mouse (n.)
chà	berzēt	rub
chài	makšķerēšana	fish
chàm	indigo	indigo
chàng	puisis	"(term should be ""chàng trai"") a young man (n.)"
chào	sveiki	welcome
chày	beisbols	a pestle (n.)
chánh	priekšnieks	"(term should be ""chánh án"") the head of a tribunal (n.)"
cháo	putra	porridge
cháu	mazbērni	a term one uses denoting oneself when addressing an aunt or uncle (n.)
cháy	uguns	fire
châm	iedurt	motto
chân	pēdu	a leg
châu	eiropa	continental
chè	tēja	tea
chèn	ievietot	insert
chém	griezt	to chop
chén	kauss	bowl
chéo	krustu	cross
chép	kopēt	written
chê	sasodīts	decry
chênh	atšķirība	difference
chì	svinu	graphite
chìa	atslēga	"(term should be ""chìa khoá"") a key (n.)"
chìm	nogrima	to become submerged or sink (v.)
chình	zutis	eel
chí	utis	especially
chích	dzelonis	shoot
chín	deviņi	ripe
chính	galvenais	main
chít	čit	dense
chò	aizrīties	a type of plant, typically of the parashorea genus (n.)
chòi	kajīte	hut
chòm	zvaigznājs	constellation
chó	suns	dog
chóc	haha	killing (giet choc)
chói	atspīdums	bright
chóng	ātri	"entire term should be ""chong mat""; means ""dizzy"""
chóp	tops	the top (n.)
chôm	rambutāns	rambutan
chôn	aprakt	bury
chông	vīrs	thorn
chùa	templis	pagoda
chùy	mace	mace
chú	tēvocis	uncle (n.)
chúa	dievs	god
chúc	vēlēties	will
chúi	tuu	drop
chúng	viņiem	they
chút	mazliet	little
chăm	grūti	champa
chămpa	šampa	champa
chăng	pieejamu	would it
chĩa	dakšiņas	point
chơi	spēlēt	play
chơn	pēdas	"a more obscure form of the word ""chân""; means ""genuine"" or ""true"""
chư	ču	lower authorities
chưa	vēl nē	not yet
chưng	dist	steamed
chương	nodaļa	medal
chướng	šķēršļu josla	grating
chạ	daudzsološs	father
chạm	pieskarties	touch
chạng	krēsla	twilight
chạp	drebošs	slow
chạy	skriet	to run (v.)
chả	ruļļos	no
chảo	panna	pan
chảy	skriet	bleeding
chấm	punkts	end
chấp	izaicinājums	"(term should be ""chấp nhận"") to accept (v.)"
chất	matērija	quality
chấu	šķipsnu	"(term should be ""châu chấu"") a grasshopper (n.)"
chần	blanšēšana	slice
chẩn	diagnosticēt	"(term should be ""chẩn đoán"") to diagnose (v.)"
chậm	lēns	slow
chận	bloķēt	block
chật	saspringts	overcrowded
chậu	pods	pelvic
chắc	protams	certainly
chằng	pieri	ligament
chẵn	pat	even
chặn	bloķēt	prevent
chặng	kāju	journey
chặt	karbonāde	close
chẻ	sadalīt	strick
chẽ	saspringts	"(term should be ""chặt chẽ"") tightly or closely (adv.)"
chế	preparāti	produce
chếch	ļengans	oblique
chết	nomira	to die (v.)
chệch	nepareizi	deviant
chỉ	vienkārši	just (adv.)
chỉnh	korekcija	adjust
chịt	viltība	chằn chịt= complex/tangle
chịu	lācis	tolerate
chọc	iebakstīt	to poke
chọi	cīņas	oppose
chọn	izvēlēties	to choose
chỏ	elkonis	"(term should be ""cùi chỏ"") elbow (n.)"
chốc	brīdis	single
chối	noliegt	refuse
chốn	vieta	place
chống	anti	anti-
chốt	aizbīdnis	important
chồi	atvases	"(term should be ""đâm chồi"") budding"
chồn	lapsa	anxious
chồng	vīrs	husband
chỗ	vieta	where
chội	sūdi	cramped
chớ	ne	not
chớp	zibens	flashing (adj.)
chờ	pagaidiet	to wait
chở	nēsāšana	for
chợ	tirgus	market
chợt	pēkšņi	suddenly
chục	duci	dozen
chụp	nofotografēt	capture
chủ	meistars	"(term should be ""chủ yếu"") main or essential (adj.)"
chủng	celmi	strain
chứ	drīzāk	just or only (adv.)
chứa	saturēt	contain
chức	funkcija	function
chừ	vēstule	hesitate
chừa	aiziešana	leave
chừng	daži	about or roughly (adv.)
chử	vārdu	"(term should be ""chử bích"") the vietnamese name for a chinese island"
chửa	grūtniece	pregnant
chửi	lāsts	curse
chữ	vārdu	a letter of the alphabet (n.)
chữa	izārstēt	to cure or treat (v.)
chững	izlīdzināšana	to totter (v.)
cia	cia	cia
cincinnati	sinsinati	cincinnati
cinderella	pelnrušķīte	cinderrella
cip	cip	cip
circus	cirks	circus
cities	pilsētas	cities
clara	klara	clara
clark	clark	clark
claude	klibs	(proper noun) claude
claudius	klaudijs	(proper noun) claudius
clinton	klintons	clinton, as in former president bill clinton
clip	klips	clip
clips	klipus	clips
clo	hlors	chlorine
clow	klauns	clow
clyde	klaids	(proper noun) clyde, as in bonnie and clyde
cmc	cmc	cmc
cmt	cmt	cmt
cn	cn	christian era
cnet	cnet	cnet
cntb	cntb	capitalism
cntt	cntt	it
cnxh	cnxh	social republic
co	co	spasm
coburn	coburn	coburn
cocoa	kakao	cocoa
coen	coen	coen
coffea	kafija	coffee
cohen	koens	cohen
coi	skatīties	to regard
coleen	coleen	coleen
coleman	coleman	coleman
coli	koli	coli
colin	kolins	(proper noun) colin, as in colin powell
colleen	koleen	colleen
college	koledža	college
collins	collins	(proper noun) collins
collège	koledža	college (n.)
colombia	kolumbija	colombia
colombo	kolombo	(proper noun) colombo
colorado	kolorado	(proper noun) colorado, as in the state
columbus	kolumbs	columbus
comic	komiksu	comic
common	izplatīts	common
concacaf	konkūfs	concacaf
concerto	koncerts	concerto
concorde	saskaņot	concorde
condom	prezervatīvs	condom
cong	izliekts	curved or bent
congo	kongo	congo
congress	kongress	congress, as in library of congress
connecticut	savienojumu	connecticut
conrad	conrad	corrad
conservation	saglabāšana	conservation
constantine	konstantīns	constantine
contemporary	mūsdienu	contemporary
cooper	cooper	(proper noun) cooper
copenhagen	kopenhāgena	copenhagen
copernic	kopernika	corpernic
copperfield	vara lauks	(proper noun) copperfield, as in magician david copperfield
coppola	koppola	coppola
copy	kopija	copy
cordyceps	kordiceps	cordyceps
core	kodols	core
cornell	kornela	cornell
cosin	kosins	cosine
costa	kosta	costa
cotang	cotang	cotangent
cpt	cpt	cpt
craig	krabis	(proper noun) craig
crazy	traks	crazy
crespo	krespo	(proper noun) crespo
crest	cekuls	crest
crew	apkalpe	crew
crimson	sārtināt	crimson
crisis	krīze	crisis
cristiano	cristiano	cristiano, as in portuguese soccer player cristiano ronaldo
croatia	horvātija	croatia
cross	krustu	cross
crs	crs	crs
cruz	cruz	cruz
cruzeiro	kruzeiro	cruzeiro
crystal	kristāls	crystal
ctc	ctc	ctc
cua	krabis	crab (n.)
cullen	cullen	a name
cung	priekšgala	circle
cunningham	viltīgais	cunningham; proper name
cup	kauss	cup
cuả	no	of, from, belonging to
cuốc	kapļi	hoe
cuối	pēdējais	last or final (adj.)
cuốn	spole	book
cuống	kātiņš	throat
cuồng	traks	crazy (adj.)
cuộc		the
cyanide	cianīds	cyanide
cyber	kibernoziegums	cyber
cyril	kirils	(proper noun) cyril
cyrus	cyrus	cyrus
cyworld	cyworld	cyword
cà	kafija	ca
cài	uzstādīt	install
càn	vajag	raid
càng	vairāk	cang
cành	filiāle	branch
cào	saskrāpēt	scratch
cày	aršana	plow
các		all (adv.)
cách	veids	the
cái		"(term should be ""con cái"") children (n.)"
cán	velmēts	"(should be ""cán bộ"") an officer, especially in a communist regime"
cánh	spārns	wing
cáo	lapsa	report
cáopx|bình	cáopx | vidējais	not a word
cáp	kabelis	cable (n.)
cáy	vijole	fiddler
câm	mēms	mute (adj.)
cân	svari	weight
câu	teikums	saying
cãi	strīdēties	argue
cò	sprūda	stork
còn	joprojām	to have left (v.)
có	ir	have
cói	grīšļi	machine
cót	bērnu gultiņa	cot
cô	garām	girl
côi	bāreņi	orphaned
côn	konusveida	a stick (n.)
công	darbs	worker
côngtenơ	konteiners	container
cõi	valstības	entire area
cõng	piggyback	piggyback
cù	kutināt	cu
cùi	spitālīgie	leprosy
cùng	un	together
cú	pūce	old
cúi	priekšgala	to bow (v.)
cúm	gripa	cum
cúng	mājīgs	worship
cúp	kauss	cup (n.)
cút	pazūdi	to kick someone out (v.)
căm	iesprausts	detest (cam thu)
căn	radikāls	"(term should be ""căn bệnh"") cause of a disease (n.)"
căng	stiept	tense
cũ	vecs	old
cũi	gultiņa	kennel
cũng	arī	also
cơm	rīsi	rice
cư	apdzīvot	resident
cưa	ieraudzīja	saw
cưng	mana mazulīte	also
cước	kravas	megaman
cưới	precējies	marry
cướp	aplaupīt	to rob (v.)
cười	smieties	smile
cường	stipra	strengthen
cưỡi	jāšana	ride
cưỡng	piespiedu kārtā	force some body to do some thing. cưỡng dâm=rape
cạc	karti	card (n.)
cạn	sekla	shallow
cạnh	mala	"(term should be ""khía cạnh"") an angle"
cạo	noskūties	shave
cạp	skorpions	scorpion
cả	gan	both
cải	sinepes	reform
cảm	auksts	pleasure
cản	nomocīts	prevent
cảng	osta	port
cảnh	skatuves	situation
cảo	velk	posthumous
cấm	aizliegt	ban
cấn	vajag	dramatic
cấp	dotācija	level or rank (n.)
cất	destilēts	"(term should be ""cất giữ"") to keep safe or store"
cầm	turēt	to hold (v.)
cần	vajag	need
cầu	tilts	request
cầy	civets	farmed
cẩn	esi uzmanīgs	carefully
cẩu	celtnis	"(term should be ""hải cẩu"") a seal (n.)"
cận	pieeja	close
cập	skaitītājs	mention
cậu	puika	a young man (n.)
cậy	atkarīgs	reliable
cắm	iespraust	to plant (v.)
cắn	iekost	to bite
cắp	zagt	steal
cắt	griezt	cut
cằm	zods	chin
cằn	kašķīgs	exhausted (adj.)
cặp	soma	couple
cọ	berzēt	rub
cọc	kaudzes	pile
cọp	tīģeris	tiger
cỏ	zāle	plant
cố	mēģiniet	"(term should be ""cố gắng"") to try one's best (v.)"
cốc	krūze	cereal
cối	java	mortar
cốm	tīrradņi	grilled rice
cống	notekas	dedicate
cồn	alkohols	i
cồng	gongu	gong
cổng	vārti	gate
cỗ	klāja	engine
cỗi	spītīgs	barren
cộ	transporta līdzeklis	"(term should be ""xe cộ"") cars or vehicles (n.)"
cội	vecs	origin
cộng	plus	to add (v.)
cột	kolonna	pole
cớ	attaisnojums	excuse
cờ	karogs	flag
cỡ	izmērs	size
cợt	jokojot	"(term should be ""đùa cợt"") to trifle (v.)"
cục	nodaļa	department
cụm	klasteris	cluster
cụp	amputēts	down
cụt	amputēts	"(should be ""xương cụt"") the tailbone or coccyx"
củ	bumbuļi	a bulb, a botanical term
của	no	of
củi	malka	firewood
củng	arī	reinforce
cứ	ieslēgts	any
cức	dūdot	"(term should be ""cức Đê"") a character in chinese history"
cứng	grūti	hard
cứngi	hardi	cungi
cừ	stabi	nacre
cừu	jērs	sheep
cửa	durvis	door
cửu	reizināt	nine
cữ	cu	abstinence
cữu	zārks	nine
cự	attālums	against
cựa	spurs	retreat
cực	pole	extreme
cựu	bijušais	former
d	d	d.
da	āda	skin
daegu	daegu	daegu
dahl	dālijs	(proper noun) dahl, as in author roald dahl
dai	grūts	persistent
daily	katru dienu	daily
dakota	dakota	dakota, as in the state of south dakota
dalat	da lat	da lat
dampier	mitrāks	(proper noun) dampier, a last name
dan	dan	dan
dancing	dejošana	dancing
danger	briesmas	danger
danh	vārds	list
daniel	daniel	daniel
dante	dante	dante
dao	nazis	poniard
darwin	darvins	darwin
das	das	das
dassault	dasault	(proper noun) dassault
date	datums	date
dau	eļļa	dau
dave	dave	(proper noun) dave, as in dave sexton
david	deivids	david, as in david thomas
davies	davies	davies
davis	davis	davis
dbsk	dbsk	dbsk
dc	līdzstrāvas	d.c.
ddr	ddr	ddr
dean	prāvests	a name
degree	grāds	degree
delhi	delhi	delhi
delphi	delphi	(proper noun) delphi, as in the oracle
demeter	demeters	(proper noun) demeter, the greek goddess of the harvest
den	den	den
dennis	deniss	dennis
department	nodaļa	departmen
derek	derek	derek
des	des	des
descartes	descartes	descartes
design	thiết kế	thiet ke
deuterium	deitērijs	deuterium
deutschland	deutschland	deutschland
dewan	dewan	dewan, as in dewan rakyat
dewitt	dewitt	(proper noun) dewitt, as in rose dewitt bukater
di	di	move
diana	diāna	(proper noun) diana, as in diana ross
die	nomirt	german
diego	diego	diego
dien	traks	"(term should be ""Điện biên phủ"") a city in northwestern vietnam where a famous battle took place during the vietnam war"
dimaggio	dimaggio	gimaggio
dinh	pils	official residence or palace
dionysus	dionīzs	dionysus, as in the greek god
discovery	atklājums	discovery
discussion	diskusija	discussion
disneyland	disnejlenda	disneyland
division	dalīšana	division
divoire	divoire	d'lvoire
diêm	sērkociņi	diem vuong
diên	traks	"(term should be ""kinh diên"") canon (n.)"
diềm	valances	matches
diều	pūķis	kite
diểu	farss	(proper noun) diểu
diễm	diem	beauty; a common vietnamese first name for women
diễu	gājiens	parade
diệc	gārnis	a heron (n.)
diệm	diem	(proper noun) diệm, as in ngô Đình diệm, former president of south vietnam
diện	seja	face to face
diệt	nogalināt	to kill or destroy (v.)
diệu	maģija	effective (adj.)
djibouti	džibuti	djibouti, a country in africa
djokovic	džokovičs	(proper noun) djokovic, as in novak djokovic
dm	dm	dm
dmitri	dmitri	dmitri
dna	dna	dna
do	autors	because of
doanh	locītavu	"(term should be ""kinh doanh"") business (n.)"
doc	dok	doc
docherty	docherty	docherty
dolly	lelle	(proper noun) dolly, as in singer dolly parton
dome	kupols	nha
dominican	dominikāņu	(proper noun) dominican, as in the dominican republic
don	don	(proper noun) don
donau	donau	donau
dortmund	dortmunde	(proper noun) dortmund
dougherty	dougherty	dougherty
douglas	douglas	douglas
dover	doveris	(proper noun) dover, as in the capital of delaware
doyle	doyle	doyle
doãn	doans	doan
doạ	draudošs	threat
dp	dp	dp
dracula	drakula	dracula
draft	melnraksts	draft
drake	drake	(proper noun) drake
driver	šoferis	a name
ds	ds	ds
dtd	dtd	dtd
dth	d	dth
du	du	travel
dubai	dubai	dubai
duiker	divnieks	duiker
duk	duk	duk
dumas	dumas	dumas
dumbledore	dumbledore	dumbledore
dung	mēsli	portrait
durham	durham	durham
dursley	durslijs	dursley
duy	tikai	only
duyên	iepriekš noteikts	coastal
duyện	tiecoties	fellatio
duyệt	pārlūks	browser
duơng	duongs	ocean
duẩn	duana	duan
duật	duat	duat
duệ	pēcnācēji	descendants (n.)
duỗi	iztaisnot	stretch
dwight	dwight	dwight
dà	dah	gradually
dài	ilgi	to lengthen, as in time
dàn	inscenējums	to arrange
dàng	viegli	dang
dành	pavadīts	for
dào	bagātīgs	"complement to word ""doi""; entire phrase ""doi dao"" means ""plentiful"""
dày	bieza	thick
dái	mīzt	"penis (n.), although some may use the term to mean ""testicles"""
dám	uzdrīkstēties	dare
dán	ielīmēt	stick
dáng	forma	appearance
dát	inkrustēts	inlay
dâm	netikls	lustful (adj.)
dân	cilvēki	people
dâng	piedāvājums	dedicate
dây	aukla	nerve
dã	savvaļas	chronicle
dãi	visatļautība	band
dãn	paplašināta	extend
dãy	diapazons	a row (n.)
dè	esi uzmanīgs	tight
défense	defense	defense
dép	sandales	slipper
dê	kaza	goat
dì	tante	aunt
dìu	dìu	to lead by the hand (v.)
dính	lipīga	stick
dò	meklēt	(with word tham) to survey
dòm	skaties	snoop
dòng	pašreizējais	"(term should be ""dòng họ"") family (n.)"
dó	ka	a type of plant used to make paper in vietnam (n.)
dông	pērkona negaiss	a storm (n.)
dõi	trase	monitor
dù	tomēr	though
dùi	perforatoru	awl
dùng	izmantot	use
dăm	skaidas	"(term should be ""đá dăm"") pebbles (n.)"
dĩ	protams	why
dĩa	šķīvis	dish
dũng	varens	courage
dơ	netīrs	dirty
dơi	sikspārņi	bat
dư	atlikušais	remnant
dưa	melones	melons
dưng	apstāties	suddently
dương	pozitīvs	penis
dường	šķiet	seem
dưỡng	kopšana	feed
dược	aptieka	having to do with medicine (adj.)
dượng	tēvocis	uncle
dạ	jā	night
dại	dumjš	stupid or idiotic (adj.)
dạn	bezbailīgs	"(term should be ""dày dạn"") to be accustomed to, especially some sort of difficult situation (adj.)"
dạng	formāts	tyoe
dạo	pastaigāties	vending
dạt	nomazgāts	to drift
dạy	mācīt	teach
dải	sloksne	range
dấm	etiķis	vinegar
dấp	klupšana	shape
dấu	parakstīt	signal
dấy	uzmundrinošs	to raise (v.)
dần	pamazām	people
dầu	eļļa	oil
dẫm	sastingt	step on
dẫn	vadīt	to lead
dẫu	tomēr	though
dận	krustmāte	to step on
dậu	gailis	rooster
dậy	piecelties	"(term should be ""dậy thì"") pubescent (adj.)"
dắt	svinu	lead
dằn	balasts	"(term should be ""dằn lòng"") to hold yourself in (v.)"
dằng	noturīgs	dằng dai= long/endless
dẳng	noturīgs	persist
dặm	jūdze	mile
dặn	pasūtīts	to advise (v.)
dặt	pasūtīt	conservative
dẹp	dzīvoklis ārā	pacify
dẹt	plakans	flat
dẻ	kastaņi	chestnut
dẻo	plastiskums	flexible
dế	kriketi	cricket
dền	amarants	beetroot
dể	viegli	easy
dễ	viegli	easy
dệt	aušana	textile
dị	singularitāte	simple
dịch	tulko	semen
dịp	gadījumā	occasion
dịu	maiga	ease
dọa	draudošs	to threaten or scare (v.)
dọc	vertikāli	along
dỏm	asprātīgs	witty
dốc	slīpums	slope
dối	melot	lie
dốt	nezinošs	stupid or ignorant (adj.)
dồi	bagātīgs	"(term should be ""trau dồi"") improve (v.)"
dồn	stūrēts	accrue
dỗ	pierunāt	dirty
dời	kustēties	leave
dở	slikti	incomplete
dỡ	izkraušana	remove
dụ	piemēram	example
dục	dzimums	sexuality
dụng	izmantot	use
dứa	ananāsi	pineapple
dứt	apstāties	to cease
dừa	kokosriekstu	coconut (n.)
dừng	apstāties	to cease
dữ	dati	"(term should be ""giận dữ"") anger (n.)"
dự	prognozēts	attend
dựa	balstīta	base on
dực	vīrietis	dực, as in lê tương dực
dỹ	dỹ	dy
e	e	e.
ea	ea	(proper noun) ea, as in ea kao
earles	ausis	earles
eaton	ēst	eaton
ebro	ebro	a name
ecmascript	ecmascript	ecmascript
ecw	ecw	ecw
edda	edda	(proper noun) edda
edgar	edgars	edgar, as in author edgar allan poe (n.)
edge	mala	edge
edinburgh	edinburga	(proper noun) edinburgh, as in edinburgh, scotland
edison	edison	edison
editor	redaktors	editor
edmond	edmond	edmond
edo	edo	edo
edward	edvards	edward
edwin	edvīns	edwin
eea	eea	eea
efron	efrons	efron, as in zac efron
egypt	ēģipte	egypt
eid	eid	(proper noun) eid
eiffel	eifels	eiffel
einstein	einšteins	einstein
eisenhower	eizenhauers	eisenhower, as in former president dwight d. eisenhower
ekaterina	ekaterina	this is a name
elbe	elbe	(proper noun) the elbe river
electronic	elektroniska	electronic
eliane	eliāns	(proper noun) eliane
elip	elipse	ellipse
elizabeth	elizabete	elizabeth
ellen	ellen	ellen
ellis	eliss	a name
elton	elton	(proper noun) elton, as in elton john
elvis	elvis	elvis
elíp	elipse	ellipse
em	tu	younger sibling
email	e-pasts	email
emily	emīlija	(proper noun) emily, as in emily dickinson
emir	emir	emir
emmy	emmija	emmy
en	lv	erica reef
energy	enerģija	energy
engels	enģeļi	engels
england	anglija	(proper noun) england, as in new england
eniac	eniac	eniac
entente	entente	entente
entropy	entropija	entropy
enzym	ferments	enzymes
eo	viduklis	eo, as in the film captain eo
ep	ep	a name
erich	erich	erich
erik	eriks	erik, as in erik moller
eris	eris	eris
eritrea	eritrea	eritrea
ernest	ernests	(proper noun) ernest
eros	eross	eros, greek god of love
erwin	ervins	(proper noun) erwin, as in erwin rommel
españa	españa	espana
essential	būtiska	essential
ethernet	ethernet	ethernet
ethiopia	etiopija	(proper noun) ethiopia
euclid	eiklida	euclid
eugene	eugene	eugene
eugène	eugène	(proper noun) eugène
euler	euler	euler
euro	eiro	euro, as in the european currency
eurofighter	eurofighter	eurofighter
europe	eiropā	europe
european	eiropas	(proper adjective) european
eva	eva	eva
everton	evertons	everton
every	katrs	every
exgay	exgay	exgay
explorer	pētnieks	explorer
extensive	plaša	extensive
fabio	fabio	(proper noun) fabio
facebook	facebook	(proper noun) facebook
fact	fakts	fact
facto	faktiski	this is french not vietnamese
faifo	faifo	(proper noun) faifo
fao	fao	fao
farrell	farrell	farrell
faso	faso	faso
fbi	fbi	fbi
fca	fca	fca
fdi	āti	fdi
features	iespējas	features
federer	federācija	federer
feet	pēdas	feet
felipe	felipe	felipe
felis	felis	(proper noun) felis
felix	felix	(proper noun) felix, as in felix klein
ferb	ferba	ferb
ferdinand	ferdinands	ferdinand
ferguson	fergusons	ferguson
fernando	fernando	fernando
ferrari	ferrari	ferrari
fiat	fiat	fiat
fidel	fidels	fidel
field	lauka	field
fifa	fifa	fifa
fifpro	fifpro	fifpro
figo	figo	figo
fiji	fidži	fiji
finish	pabeigt	finish
firefox	firefox	(proper noun) mozilla firefox
fischer	zvejnieks	fischer, as in louis fischer
fish	zivis	fish
fishbed	zivju gulta	fishbed
fitzgerald	fitzgerald	(proper noun) fitzgerald
flanker	flankeris	flanker
fleming	flemings	fleming
flight	lidojums	flight
foch	fočs	(proper noun) foch
focus	fokuss	focus
foden	fodens	(proper noun) foden, as in tom foden
fokker	fokker	fokker
food	ēdiens	food
football	futbols	bong da
forbes	forbes	(proper noun) forbes, as in the magazine
ford	ford	(proper noun) ford
fordham	fordham	(proper noun) fordham
forks	dakšiņas	forks
foundation	pamats	foundation
fox	lapsa	fox
fpt	fpt	a company name in vietnam
fracsin	fracsin	a function
franc	franks	franc
france	francija	france
frances	frances	frances
francis	franks	francis, as in francis xavier
francisco	francisco	francisco
franco	franko	franco
frank	atklāti	frank
frankfurt	frankfurtē	(proper noun) frankfurt
franklin	franklins	franklin
franz	franzs	(proper noun) franz, as in franz ritter
freud	freids	(proper noun) freud, as in sigmund freud
friedman	cepējs	friedman
fu	fu	fu
fujiko	fujiko	fujiko, as in japanese writer fujiko fujio
fujimoto	fujimoto	fujimoto
fukuoka	fukuoka	fukuoka
funimation	funimācija	(proper noun) funimation
funk	funk	funk
futsal	futsal	futsal
fx	fx	fx
ga	ga	station
gabon	gabon	gabon
gabriel	gabriel	gabriel
gabriella	gabriella	gabriella
gagarin	gagarins	gagarin
gaia	gaia	gaia
gaillard	gaillard	gaillard
galilei	galilei	galilei
galileo	galileo	galileo, the astronomer
gam	grami	gam
gambia	gambija	gambia
gamow	gamow	a name
gan	aknas	liver
gandhi	gandhi	gandhi, as in mahatma gandhi
gang	banda	cast iron
ganh	greizsirdīgs	to be jealous
gao	rīsi	strictly
gareth	gareth	a name
garrett	garrett	garrett
gary	gari	gary
gascon	gāzkons	(proper noun) gascon, a dialect of france
gatt	gatt	gatt
gaule	gaule	gaul, a region in ancient western europe
gaulois	gaulois	gaulois
gay	gejs	tense
gaza	gaza	gaza
gdańsk	gdaņska	(proper noun) gdansk, poland
gdp	gdp	gdp
geisha	geiša	geisha
gen	gēni	gene
gene	gēns	(proper noun) gene, an english first name
genesis	ģenēze	(proper noun) genesis
georg	georg	(proper noun) georg
george	george	george
georges	george	(proper noun) georges, a french name
gepard	gepards	gepard
ger	ger	ger
gerais	gerais	(proper noun) gerais
gerhard	gerhards	gerhard
german	vācietis	german
germany	vācijā	germany
gerrard	gerrard	gerrard, a last name
ghana	gana	(proper noun) the african country of ghana
ghe	laiva	canoe
ghen	greizsirdīgs	to be jealous (v.)
ghi	uzrakstiet	write
ghim	pin	pin
ghé	apstāties	visit
ghép	potēt	fit
ghê	šausmas	disgust
ghì	ghì	tighten
ghẻ	kašķis	scabies (n.)
ghế	krēsls	chair
ghề	krāces	scabby
ghềnh	krāces	waterfall (n.)
gia	gia	date
giai	skatuve	period
giam	cietums	imprison
gian	telpa	"(term should be ""thời gian"") time (n.)"
giang	giang	syphilis
gibraltar	gibraltārs	(proper noun) gibraltar
gichin	gichin	gichin
gieo	sēt	sow
gifu	gifu	gifu, a district in northern japan
ginzan	ginzan	ginzan
gio	gio	wind
gioi	džoi	world
giuliani	giuliani	giuliani
giun	tārpi	worm
giuse	dusmu	giuse
giuộc	giuoc	"entire term should be ""can giuoc""; name of a vietnamese town"
giza	giza	giza
già	vecs	old (adj.)
giàn	kopnes	"(term should be ""giàn hoa"") a trellis girder"
giành	dedzīgi	secure
giàu	bagāts	rich or wealthy (adj.)
giày	kurpes	a shoe
giá	cena	estimate
giám	režisors	"(term should be ""giám sát"") to supervise (v.)"
gián	prusaku	"(term should be ""gián tiếp"") indirectly"
giây	sekundes	seconds
giã	ņurdēšana	"(term should be ""từ giã"") to say farewell to (v.)"
giãn	stiept	stretch
gièm	atdalītāji	"(should be ""gièm pha"") to backstab"
giêhôva	giva	jehovah
giêng	giong	january
giêsu	jēzus	jesus
giêxu	saikne	jesus
giò	tīteņi	leg
giòi	tārpi	maggot (n.)
giòn	kraukšķīgs	crunchy or crispy (adj.)
gió	vējš	wind
gióng	piemēram	align
giúp	palīdzēt	help
giũa	failu	sharpen
giơ	iesprūst	raise
giương	uzliesmo	posture
giường	gulta	bed
giả	viltus	fake (adj.)
giải	risinājums	solution
giảm	samazināšana	decrease
giản	vienkāršots	"(term should be ""giản dị"") simple (adj.)"
giấc	gulēt	giấc ngủ= the sleep
giấm	etiķis	drabble
giấu	paslēpties	hide
giấy	papīrs	paper
giầu	bagāts	rich
giận	dusmīgs	angry
giằng	spirdzinošs	pull
giặc	ienaidnieks	enemy
giặt	mazgāt	to wash (n.)
giếng	labi	well
giết	nogalināt	kill
giềng	kaimiņš	"(term should be ""láng giềng"") neighboring"
giễu	izsmiekls	ridicule
giọng	tonis	tone
giọt	nomest	drop
giỏ	grozs	basket
giỏi	lieliski	good
giồng	giong	mound
giỗ	nāves gadadiena	anniversaries of deaths
giới	dzimums	gender
giờ	stundas	bao giờ=ever
giở	zibspuldze	to open or unfold (v.)
giỡn	jokojot	joke
giục	mudināja	urge
giữ	turiet	hold
giữa	starp	between
gladys	priecājos	gladys
glazer	glazūra	glazer
glonass	glonass	glonass
gloria	glorija	gloria
gloster	glosteris	(proper noun) gloster, as in gloster meteor
glucose	glikoze	glucose
gmail	gmail	gmail
gnp	gnp	gnp
go	iet	"(term should be ""gay go"") tense"
goes	iet	goes
goku	goku	goku
golden	zeltaini	golden
gom	savākt	to gather (v.)
google	google	google
gorbachev	gorbačovs	gorbachev
gorbachyov	gorbachjovs	gorbachev, as in former soviet president mikhail gorbachev
gordon	gordons	gordon, as in gordon brown
gore	gore	gore
gorky	gorky	gorky, as in gorky park
gothic	gotu	gothic
gottfried	gotfrīds	gottfried
grabeel	grabeel	grabeel, a last name
graham	grehems	graham
granada	granada	granada
granit	granīts	granite
greek	grieķu	(proper noun) greek
greenland	grenlande	greenland
greenson	greenson	(proper noun) greenson
greenwich	griniča	(proper noun) greenwich
greg	gregs	greg
grenada	granāta	grenada
grenadines	grenadīni	grenadines
gross	bruto	gross
grumman	grummans	(proper noun) grumman
gruzia	gruzijā	gruzia
gryffindor	gryffindor	gryffindor
gs	gs	prof.
gsts	gsts	professor- phd
gu	stils	gu
guam	guams	guam
guard	sargs	guard
guatemala	gvatemala	guatemala
gui	gui	gui
guinea	gvineja	guinea
guinness	ginests	(proper noun) guinness
guitar	ģitāra	guitar
gujarat	gujārats	gujarat
gulag	gulags	gulag
gulf	līcis	gulf
gullit	gullit	(proper noun) gullit
gundam	gundam	(proper noun) gundam
gunung	gunung	(proper noun) gunung
gustave	gausties	gustave
gutenberg	gūtenberga	gutenberg
guyana	gujāna	guyana; proper noun
gà	cālis	chicken
gài	iešūt	to fasten (v.)
gào	kliedza	"(term should be ""thét gào"") to cry out (v.)"
gác	sargs	guard
gái	meitene	girl
gán	piešķirt	"entire phrase should be ""gan nhan""; means ""to label"""
gánh	nēsāt	hold
gáy	pakauša	crow
gân	tuvu	tendon
gây	cēlonis	make
gãy	salauzts	break
gì	kas	what
gìn	saglabāt	preserve
gò	kalns	"(term should be ""gò má"") cheekbone (n.)"
gòn	nav	gon
góa	atraitne	widowed
góc	stūra	angle
gói	iepakojums	goi
góp	iemaksa	to contribute
gót	papēdis	heels
gõ	tips	type
göbbels	göbbels	gobbels, as in joseph gobbels
găm	uzkrāt	poniard
găng	cimdi	gloves
gũi	tuvu	close
gươm	zobens	sword
gương	spogulis	mirror
gạc	marle	johnson south reef
gạo	rīsi	rice
gạt	apkrāpts	to cheat or trick (v.)
gả	laulība	marry
gảy	pārtraukums	"(term should be ""âm gảy"") a type of phonetic sound found in the japanese language (n.)"
gấc	gačs	gac
gấm	brokāts	brocade
gấp	pasteidzies	times, as in many times
gấu	lācis	a bear (n.)
gần	tuvu	near
gầy	plāns	thin
gẫy	salauzts	break
gập	salocīt	"(term should be ""gập ghềnh"") bumpy (adj.)"
gậy	nūju	stick
gắm	fart	send
gắn	uzmontēts	mount
gắng	mēģiniet	try
gắt	skarbi	intense
gặm	ņurdēt	rodent
gặp	satikties	meet
gặt	novākt ražu	harvest
gỉ	sarūsējis	rust
gọi	zvana	call
gọn	glīts	neat (adj.)
gọng	rimmed	gong
gọt	mizu	cut
gỏi	salāti	a vietnamese salad
gốc	izcelsme	origin (n.)
gối	spilvens	"(should be ""qùy gối"") to kneel"
gốm	keramikas	pottery
gồm	ieskaitot	include
gồng	gongu	carry
gỗ	koksne	wood
gội	šampūns	shampoo
gộp	sapludināt	aggregate
gớm	drausmīgs	tremendous
gờ	dzega	edge
gởi	sūtīt	send
gỡ	izkraut	meet
gợi	ierosinošs	to evoke (v.)
gục	uz leju	"(term should be ""đánh gục"") crush, as in battle"
gừng	ingvers	ginger
gửi	sūtīt	send
ha	ha	hectare
habana	habana	(proper noun) habana
habsburg	habsburga	(proper noun) habsburg
haeberle	haeberle	haeberle
hahn	hahn	hahn
hai	divi	two (adj.)
hal	hal	hal
halle	halle	(proper noun) halle
halogen	halogēna atoms	halogen (n.)
ham	šķiņķis	desire
hamilton	hamiltons	(proper noun) hamilton
han	han	han
hang	ala	cave
hangul	hangul	hangul
hanh	hanh	hanh
hanja	hanja	(proper noun) hanja, a type of chinese script
hansen	hansen	hasnen
hao	hao	"(term should be ""hao hụt"") to incur some loss (v.)"
harald	haralds	harald
hardy	izturīgs	hardy
harlem	harlema	harlem
harlow	harlow	harlow
harold	harolds	(proper noun) harold
harper	harper	harper
harpercollins	harpercollins	hapercollins
harrier	harrier	harrier, as in harrier jump jet
harris	hariss	harris
harry	harijs	harry
harvard	hārvarda	(proper noun) harvard, the name of a college
harvey	harvey	harvey
havana	havana	(proper noun) havana, cuba
havilland	havilland	havilland
hawker	vanags	hawker
hawking	vanags	(proper noun) hawking, as in physicist stephen hawking
hay	labi	or
hb	hb	hb
hbv	hbv	hbv
hcl	hcl	hcl
hd	hd	activity
he	viņš	he, a korean name
health	veselība	health
heath	virsotne	heath
hee	hee	hee
hegel	hegel	(proper noun) hegel, as in georg wilhelm friedrich hegel
heian	heian	heian
heinrich	heinrihs	heinrich
helen	helēna	helen
helena	helēna	helena
heli	hēlijs	helium
hematocrit	hematokrīts	hematocrit
hemoglobin	hemoglobīns	hemoglobin
hen	vista	asthma
henry	henrijs	(proper noun) henry, as in henry kissinger
heo	sastāvējies	dolphin
her	viņu	her
herbert	herberts	herbert, as in herbert schandler
hercegovina	hercegovina	hercegovina
hercules	hercules	hercules
hermann	hermans	hermann
hermes	hermes	hermes
hersh	skarbi	hersh, as in seymour hersh
hesiod	hesiods	hesiod
hestia	hestia	hestia
hi	sveiki	"(term should be ""hi vọng"") alternative spelling for ""hy vọng""; meaning ""hope"" (n.)"
hickam	hickam	(proper noun) hickam
hicks	hicks	hicks
hideto	hideto	(proper noun) hideto
hideyoshi	hidjoši	(proper noun) hideyoshi
hidro	ūdeņradis	hydrogen
hillsborough	hillsborough	hillsborough
hilton	hiltons	hilton
himalaya	himalaja	(proper noun) himalaya
hinata	hinata	hinata
hindenburg	hindenburga	(proper noun) hindenburg
hindi	hindi	hindi
hindu	hindu	hindu, as in the hindu religion
hinh	hinh	(proper noun) a vietnamese first name
hinhtron	hinhtrons	circle
hiragana	hiragana	hiragana
hiroshi	hiroshi	hiroshi
hiroshima	hirosima	(proper noun) hiroshima, the japanese city
hitchcock	aizķeršanās	hitchcock
hitler	hitlers	hitler
hitter	hitter	hitter
hitters	hitters	hitters
hiên	lievenis	(proper noun) hiên, a vietnamese first name
hiđrô	ūdeņradis	hydrogen
hiếm	reti	rare
hiến	dot	devote
hiếp	izvarošana	rape
hiếu	filiāla dievbijība	pious
hiềm	slims	grudge
hiền	salvija	sage
hiểm	bīstams	dangerous
hiểu	saprast	learn
hiện	parādīties	"(term should be ""thực hiện"") to accomplish"
hiệp	puse	united
hiệu	efekts	effective
hlv	treneris	trainer
hms	hms	hms
hmông	hmongi	hmong
hn	hn	hn
hoa	zieds	flower
hoan	festivāls	welcome
hogwarts	latvānis	(proper noun) hogwarts, sorcery school from the harry potter series
hoi	hoi	rare
hokage	hokage	hokage
hokusai	hokusai	hokusai
holmes	holmss	a name
holocaust	holokausts	holocause
holocen	holocēns	holocen
holt	holts	holt, an english last name
hom	spraudeņi	a cutting
homer	homer	(proper noun) homer, the authorof the iliad and the odyssey
hon	hon	"(term should be ""hòn"") rock (n.)"
honduras	honduras	honduras
hong	honga	hong
honolulu	honolulu	honolulu
honshū	honshū	honshu
hopkins	hopkins	(proper noun) hopkins
hornet	hornet	hornet
hotspur	hotspur	(proper noun) hotspur, as in tottenham hotspur
houston	hjūstona	(proper noun) houston, as in whitney houston
howard	howard	(proper noun) howard
however	tomēr	however
hoà	kakla saite	peace
hoài	nostaļģisks	always (adv.)
hoàn	pabeigts	"(term should be ""hoàn toàn"") completely"
hoàng	karalis	royal (adj.)
hoành	diafragma	rife
hoá	ķīmija	"(term should be ""văn hoá"") culture (n.)"
hoán	ilgviļņi	refined (adj.)
hoãn	viņi ēd	delay
hoạ	krāsot	disaster (tham hoa)
hoại	gangrēna	"(term should be ""phá hoại"") to sabotage (v.)"
hoạt	hentai	work
hoả	uguns	of
hoảng	panika	panic-stricken (adj.)
hoặc	vai	or
hp	zs	hp
hq	hq	hq
hudgens	hudgens	(proper noun) hudgens
hudson	hudsons	hudson
huey	hjū	huey
hughes	hughes	hughes
hugo	hugo	(proper noun) hugo
hume	hume	hume, as in david hume
hun	hun	(proper noun) hun
hungary	ungārija	hungary
hunt	medības	hunt
hurley	hērlijs	(proper noun) hurley, as in chad hurley
hussein	huseins	hussein
husserl	husserls	huserl
huston	hjūstona	huston
hutech	hutech	hutech
huy	huy	a common vietnamese first name
huynh	brālis	older brother
huyền	mistisks	huyền thoại= legend
huyễn	iluzors	huyen
huyện	apgabals	district
huyệt	akupunktūras punkti	lair
huân	huana	"(term should be ""huân chương"") medal (n.)"
huê	nokrāsa	"a less common vietnamese word for ""flower"""
huấn	apmācība	"(term should be ""huận luyện"") to train (v.)"
huế	nokrāsa	hue
huệ	nokrāsa	favour
huống	lietu	situation
huỳnh	sērs	sulfur
huỷ	atcelt	destroy
hydra	hidra	hydra, a monster in greek mythology
hydro	ūdeņradis	hydrogen
hyperion	hiperionu	hyperion
hà	ha	"(term should be ""hà nội"") the capital of vietnam"
hài	komēdija	corpse
hàm	žoklis	"(term should be ""bao hàm"") to imply (v.)"
hàng	rinda	row
hào	grāvējs	depreciation
hách	valdonīgs	glorious
hái	izvēlēties	picking
hán	sausums	china
háo	dedzīgi	eager
hát	dziedāt	song
hâm	traks	"(term should be ""hâm mộ"") to admire (v.)"
hân	han	le ngoc han
hãi	nobijies	to be scared (v.)
hãn	kāns	to sweat (v.)
hãng	firma	a company (n.)
hãnh	lepns	proud
hè	vasara	summer
hé	saplaisājis	reveal
héo	nokalst	dried-out
hét	kliegt	shout
hên	paveicies	luck
hí	ne	game
hít	elpot	act of kissing (hon hit)
hò	iepazīšanās	date
hòa	kakla saite	republic
hòe	sūdi	hoe
hòm	šķirsts	box
hòn	sala	island
hòng	labi	in order to
hóc	hóc	a corner (n.)
hót	dziedāt	to chirp or sing (v.)
hô	ho	respiration
hôi	nediena	stink
hôm	dienā	day (n.)
hôn	skūpsts	propose
hông	gurns	hip
hù	nobiedēt	threaten
hùng	varoņi	hero
húc	gore	huc
húng	iedvesma	"(should be ""húng láng"") water mint"
hút	smēķēšana	to suck (v.)
hăng	asa	enthusiasm
hđbt	hđbt	hdbt
hđh	hđh	system software
hũ	burkas	jar
hơi	nedaudz	slightly
hơn	nekā	more or less
hư	slikti	fictional
hưu	atvaļināts	huu
hương	vīraks	smell
hước	smieklīgs	humor
hướng	virziens	trend
hường	huong	huong
hưởng	izbaudi	influence
hạ	vasara	lower
hạc	flamingo	crane
hạch	ganglijs	ganglion
hại	kaitēt	harm
hạng	klase	rank
hạnh	hanh	happy
hạo	hao	hao
hạp	hap	hap
hạt	sēkla	seed
hải	muita	two
hảo	ideāls	perfect
hấn	hấn	aggressive gesture
hất	bēgt	toss
hấu	arbūzs	"(term should be ""dưa hấu"") watermelon"
hầm	tunelis	ham
hầu	gandrīz	most
hận	naids	hatred
hậu	karaliene	anus
hắc	melns	black
hắn	viņu	he (n.)
hắt	šķaudīt	reject
hằng	nemainīgs	every
hặc	hcc	to criticize (v.)
hẹ	šalotes	chinese chives
hẹp	šaurs	narrow
hẻm	aleja	alley (n.)
hẻo	nošķirts	outback
hến	gliemenes	mussel
hết	pāri	most
hề	klauns	"(term should be ""không hề"") never"
hễ	eh	whenever
hệ	sistēma	relation
hệt	identiski	exactly
hỉ	sitiens	happy
hịch	thud	a proclamation
họ	uzvārds	they (n.)
họa	māksla	picture
họach	plāns	"(term should be ""quy hoạch"") a project (n.)"
học	mācīties	study (v.)
họng	rīkle	throat
họp	sapulce	meet
hỏa	uguns	fire
hỏng	salauzts	corruption
hố	bedre	hole
hốc	nišas	cavity
hồ	ezers	ho
hồi	anīss	muslim
hồn	dvēsele	soul
hổ	tīģeris	tiger
hổi	huh	"(term should be ""nóng hổi"") steaming hot (adj.)"
hổng	gaping	hole
hỗ	atbalstu	"(should be ""hỗ trợ"") to support or assist"
hỗn	sajaukts	"(term should be ""hỗn tạp"") mish-mash (adj.)"
hội	festivāls	society
hộp	kaste	box
hới	atvērts	hoi
hớn	kliedza	"(term should be ""hớn hở"") radiant (adj.)"
hờn	drūms	hatred
hở	atvērts	reveal
hỡi	oi	dear
hợi	cūka	pig (n.)
hợp	labi piemērota	appropriate
hợpquận	piekrišana	general district
hụt	deficīts	loss
hủi	spitālīgais	reject
hủy	atcelt	to erase or destroy
hứa	solīt	promise
hử	ne?	hu
hửu	ne?	"(term should be ""sở hửu"") to own (v.)"
hữu	īpašums	(proper noun) hữu, a vietnamese middle name; also means right, as in the direction
hựu	huu	again
hỷ	hy	hy
ian	ian	ian, as in australian swimmer ian thorpe
iau	iau	iau
iberia	ibērija	iberia
ibm	ibm	(proper noun) ibm, the computer company
ibmpc	ibmpc	ibm-pc
ic	ic	ic
icc	icc	icc
iceland	islande	(proper noun) the country of iceland
ide	ide	ide
ieng	ieng	(proper noun) ieng
igor	igor	igor
iii	iii	third
ilene	ilēns	ilence
illusion	ilūzija	illusion
ilyich	ilyich	ilyich
im	es esmu	still
imam	imams	(proper noun) imam
imbrium	imbrijs	imbriun
immanuel	immanuel	(proper noun) immanuel, as in immanuel kant
impact	trieciens	impact
incoterm	incoterm	incoterm
incoterms	incoterms	(proper noun) incoterms
indian	indiānis	indian
indiana	indiāns	indiana
indochina	indoķīna	indochina
indonesia	indonēzija	indonesia
indrapura	indrapura	(proper noun) indrapura
info	info	info
innsbruck	insbruka	innsbruck
insulin	insulīns	insulin
int	int	int
intel	intel	(proper noun) intel, as in the name of the company
interpol	interpols	interpol
inu	inu	(proper noun) inu
inuyasha	inuyasha	inuyasha
inư	inu	(proper noun) inư
io	es	io
ioc	joc	ioc
ion	jonu	ion
iosif	iosif	(proper noun) iosif, as in iosif vissarionovich stalin
iran	irāns	the nation of iran
iraq	irāka	iraq
ireland	īrija	ireland
irgun	irguns	irgun
irony	ironija	irony
irving	irving	(proper noun) irving
isaac	isaac	isaac
isla	isla	isla
islam	islāms	islam
islamabad	islamabada	(proper noun) islamabad
israeli	izraēlas	israeli
istanbul	istanbul	istabbul
italia	itālijā	italy
italiano	italiano	(proper noun) italiano
itanium	itāns	itanium, as in windows xp itanium
ito	ito	ito
itsukushima	itsukushima	itsukushima
itu	itu	itu
itzá	itzá	(proper noun) itzá
iv	iv	4 ( greek number)
iwami	iwami	iwami
j	j	j
jack	domkrats	jack
jackie	džeks	(proper noun) jackie chan
jackson	džeksons	(proper noun) jackson, as in michael jackson
jacob	jakobs	jacob
jae	džejs	jae
jakarta	džakarta	(proper noun) jakarta
jan	jan	(proper noun) jan
janeiro	janeiro	janeiro
janet	janet	janet
japan	japāna	japan
jared	jared	jared
jarvis	jarvis	(proper noun) jarvis, as in jarvis cocker
jasper	jašma	(proper noun) jasper
jean	jean	jean
jeane	džins	jeane
jeanjacques	jeanjacques	jean-jacques
jeanpaul	jeanpaul	jeanpaul
jeans	džinsi	jeans
jeet	lidmašīna	(proper noun) jeet, as in jeet kune do
jeff	džefs	jeff, as in jeff drake
jefferson	džefersons	jefferson
jeffrey	džefrijs	jeffrey
jeju	jeju	jeju
jenda	jenda	jenda
jenny	dženija	jenny
jericho	jericho	jericho, as in wrestler chris jericho
jerome	jerome	jerome, as in fred jerome
jerry	jerijs	(proper noun) jerry
jersey	krekls	jersey
jerusalem	jerusalem	jerusalem
jesse	jesse	a name
jesus	jēzus	chua jesus
jetstar	jetstar	jetstar
jewish	ebreju	jewish
jiao	jiao	jiao
jimmy	džimijs	jimmy
jin	džins	jin
jing	jing	jing
jiraiya	džiraiya	(proper noun) jiraiya
joachim	joachim	joachin
joan	joan	a name
joe	džo	(proper noun) joe
johan	johan	johan
johann	johann	johann
johannes	johannes	johannes
johannesburg	johannesburg	(proper noun) johannesburg, south africa
johnny	džonijs	johnny
johns	johns	johns
johnston	johnston	johnston, as in harry johnston
johor	johor	johor
joint	locītavu	joint
jonathan	jonathan	(proper noun) jonathan
jones	jones	jones
jose	žoze	(proper noun) jose, a spanish first name
joseon	hosē	(proper noun) joseon
joseph	josefs	joseph
jscript	jscript	(proper noun) jscript
juche	juche	(proper noun) juche
judith	dūdita	judith
judo	džudo	judo, the martial art
julesverne	julesverne	jules verne
julliard	julliard	(proper noun) julliard
jump	lēkt	jump
june	jūnijs	june, as in the month
jung	džungļos	jung
junsu	junsu	junsu
jupiter	jupiters	(proper noun) jupiter, as in the planet
jura	jura	(proper noun) jura
juventus	juventus	juventus
k	k	k
kaede	kaede	a japanese name
kaffee	kafija	(proper noun) kaffee, as in kaffee hag
kagome	kagome	kagome, as in higurashi kagome
kahn	kahn	kahn
kai	kai	kai
kakashi	kakashi	kakashi
kaká	kaká	(proper noun) kaka, a brazilian soccer player
kalashnikov	kalašņikovs	(proper noun) kalashnikov
kali	kālijs	potassium
kama	kama	(proper noun) kama, as in the kama sutra
kamakura	kamakura	kamakura
kamov	kamovs	kamov
kampf	kampf	kampf
kampong	kampong	kampong
kampuchea	kampuchea	cambodian
kana	kana	kana, the japanese phonetic alphabet
kangin	kangin	(proper noun) kangin
kanji	kanji	kanji
kant	kant	a name
kar	kar	(proper noun) kar
kara	kara	kara
karaoke	karaoke	karaoke
karate	karatē	karate
karatedo	karatēo	karatedo
karen	karen	(proper noun) karen
karim	karim	(proper noun) karim
kashmir	kašmira	kashmir
kaspersky	kaspersky	(proper noun) kaspersky, as in kaspersky anti-virus software
katakana	katakana	katakana, a type of japanese script
kate	kate	(proper noun) kate, as in actress kate winslet
katherine	katerīns	katherine
kathmandu	kathmandu	kathmandu
katrina	katrīna	(proper noun) katrina, as in hurricane katrina
katz	katz	katz
kauthara	kauthara	kauthara, a part of the ancient kingdom of champa
kavkaz	kaukāzs	kavkaz
kawasaki	kawasaki	(proper noun) kawasaki
kay	kajs	kay
kazan	kazan	kazan, the name of a city
kcn	kcn	industrial zone
ke	ke	"(term should be ""boong ke"") a bunker (n.)"
kelly	kelly	kelly
kelsi	kelsi	kelsi
kelvin	kelvins	kelvin
kem	krēms	ice cream (n.)
ken	ken	ken
kennedy	kenedijs	(proper noun) kennedy, as in john f. kennedy
kenneth	kenneth	(proper noun) kenneth, a name
kenny	kenny	kenny, an english first name
kentucky	kentuki	(proper noun) kentucky
kepler	keplers	kepler
kerala	kerala	(proper noun) kerala
kevin	kevins	kenvin
keynes	keins	keynes, as in economist john maynard keynes
kg	kilograms	kilogram
kha	kha	(proper noun) a vietnamese first name
khai	deklarācija	announce
khali	khali	(proper noun) khali
khalip	khalip	(proper noun) khalip
kham	kham	endure
khan	bezūdens	rare
khang	khang	khang
khanh	khanh	khanh
khao	ilgas	desire
khay	paplāte	tray
khe	slots	chink
khem	khem	abstinence
khen	uzslavas	praise
kheo	uz statņiem	kheo
khi	kad	when
khieu	nesaprotu	(proper noun) khieu, as in khieu samphan
khiêm	pieticīgs	khiem
khiên	vairogs	a shield
khiêu	erotiska	"('khiêu dâm"") pornographic"
khiếm	traucēta	lack
khiến	cēlonis	control
khiếp	pārbijusies	horrible
khiếu	iesniegt	talent (n.)
khiển	kontrole	control
khleang	khleang	kh'leang
kho	noliktava	warehouse
khoa	fakultāte	"(term should be ""y khoa"") the study of medicine (n.)"
khoan	urbt	drill
khoang	dobums	brag
khoanh	zvana	a slice (n.)
khoe	izrādīties	to boast
khoá	atslēga	lock
khoác	mētelis	coat
khoán	krājums	stock
khoáng	minerāls	mineral
khoát	galīgs	decisive
khoét	griezt	carve
khoăn	satracināt	disturbed
khoả	kails	naked
khoản	lieta	an item (n.)
khoảng	apm	about
khoảnh	mirkļi	moment
khoẻ	labi	health
khrushchev	hruščovs	khrushchev
khrushchyov	hruščovs	khrushchyov
khu	ceturtdaļas	section
khung	rāmji	frame
khural	khural	khural
khuynh	pa kreisi	trend
khuyên	padoms	advise
khuyết	bojāts	lack
khuyển	suns	khuyen
khuất	slēpts	hidden
khuấy	maisa	stir
khuẩn	baktērijas	bacteria
khuếch	paplašināt	amplification
khuỷu	elkonis	elbow
khá	drīzāk	quite
khác	citi	different
khách	viesi	customer
khái	konceptuāls	concept
khám	pārbaude	discover
khán	auditorija	audience
kháng	pretestība	appeal
khánh	neatkarība	a type of chime made of stone (n.)
khát	izslāpis	to be thirsty for (adj.)
khâm	khâm	admire
khèn	diemžēl	a pan-pipe (n.)
khéo	ģeniāls	cleverly or skillfully (adv.)
khép	tuvu	close
khía	iecirtums	"(term should be ""khía cạnh"") angle (n.)"
khích	iedrošināt	encourage
khít	tuvu	close
khó	grūti	difficulty
khóa	aizslēgties	a session
khóc	raudāt	cry
khói	smēķēt	smoke
khóm	ananāsi	a cluster
khô	žāvēts	dry
khôn	gudrs	clever, intelligent
không	nav	not
khúc	segmentā	song
khăm	slikti smakojošs	nasty (adj.)
khăn	dvielis	difficult
khơi	ārzonas	sea
khư	khư	grip
khưu	khưu	khuu
khước	noliegt	waive
khả	iespēja	"(term should be ""khả năng"") ability (n.)"
khải	atklāsme	triumph
khảm	mozaīka	to encrust
khảo	pārbaude	"(term should be ""tham khảo"") to consult (v.)"
khấm	sadursta	endure
khấn	lūgties	pray
khấu	atlaide	"(term should be ""sân khấu"") a stage (n.)"
khẩn	steidzams	"(term should be ""khẩn cấp"") urgent (adj.)"
khắc	iecirtums	moment
khắp	visā	all over
khẳng	apstiprinošs	"(term should be ""khẳng định"") to assert (v.)"
khế	zvaigznes auglis	bond
khỉ	pērtiķis	monkey or ape (n.)
khỏa	pliks	nude
khỏe	stipra	health
khỏi	beidzās	leave
khố	loincloth	loincloths
khốc	dire	devastating
khối	pakāpe	a block or mass of (n.)
khốn	bastards	miserable
khống	khong	control
khổ	ciešanas	miserable (adj.)
khổng	milzis	huge
khởi	iniciē	start
khủng	briesmīgi	"(term should be ""khủng bố"") terrorist (n.)"
khủyu	bastards	elbow
khứu	pastelis	olfactory
khử	likvidēt	reduction
ki	ki	"entire phrase is ""ki lo""; means ""kilometer"""
kia	ka	other
kid	bērns	kid
kiel	kiel	(proper noun) kiel
kierkegaard	kierkegaard	kierkegaard, as in soren kierkegaard
kiernan	kiernan	kiernan
kii	kii	kii
kikyo	kikyo	kikyo
kilômét	kilometri	kilometer
kim	kims	kim
kingdom	karaļvalsts	kingdom
kinsey	kinsey	kisney
kiribati	kiribati	kiribati
kishimoto	kishimoto	(proper noun) kishimoto
kiss	skūpsts	kiss
kissinger	kissinger	kissinger
kitts	kaķēni	kitts
kitô	kristietis	christian
kiêm	cum	cum
kiên	pacients	consistent
kiêng	atturēties	abstinence, as in abstaining from eating
kiêu	augstprātīgs	showy
kiếp	mūžs	a lifetime (n.)
kiết	kiết	cheap (adj.)
kiềm	sārmains	"(term should be ""kiềm chế"") to restrain (v.)"
kiểm	pārbaudīt	control
kiểu	tips	type
kiệm	ekonomisks	save
kiện	iesūdzēt tiesā	event (su kien)
kiệt	meistardarbs	exhausted (adv.)
kiệu	palanquin	scallion
klaus	klaus	klaus
klein	kleins	klein
km	kilometru	kilometer
knesset	knesset	knesset
knuth	knuth	knuth, as in donald knuth
koch	koch	koch
kodansha	kodansha	kodansha
kofun	kofun	kofun, as in the kofun period of japanese history
kogoro	kogoro	kogoro
komodo	komodo	komodo
kon	kon	"(term should be ""kon tum"") a province in the highlands of vietnam"
kong	kong	(proper noun) kong, as in hong kong
konstantin	konstantīns	(proper noun) konstantin
konversationslexikon	konversationslexikon	konversation-lexikon
kop	kop	kop
koran	korāns	koran
kornai	kornai	(proper noun) kornai, as in janos kornai
koruna	krona	koruna
kosovo	kosova	(proper noun) kosovo
kremli	kremli	kremil
kremlin	kremlis	kremlin
kristen	kristen	kristen
krông	krona	krong
ku	ku	is a name
kuala	kuala	(proper noun) kuala, as in kuala lumpur
kubrick	kubrick	kubrick
kuen	kuen	kuen
kuiper	kuiper	(proper noun) kuiper, as in the kuiper belt
kulak	kulak	kulak
kune	kune	(proper noun) kune, as in the martial art jeet kune do
kung	kung	danh vo
kungfu	kungfu	kung fu
kunst	kunst	kunst, as in richard kunst
kurd	kurds	kurd
kurt	kurts	(proper noun) kurt
kuwait	kuveita	kuwait, the country (n.)
kwan	kwan	kwan
kwen	kwen	kwen
kwon	kwon	kwon, as in tae kwon do; proper noun
kyrgyzstan	kyriami	(proper noun) the country of kyrgyzstan
kyushu	kyushu	kyushu
kyūshū	kyūshū	kyushu, a japanese island
kèm	slēgts	included
kèn	trompete	horn
kém	vismazāk	less
kén	kokons	selective
kéo	velciet	scissors
kép	duāls	dual
két	seifi	"(term should be ""rốc két"") rocket (n.)"
kê	prosa	statistics
kênh	kanāli	channel
kêu	skan	appeal
kìa	lūk	that
kìm	knaibles	bar
kình	brilles	rivalry
kí	parakstīt	sign
kích	klikšķis	excite
kíchbom	noklikšķiniet uz pogas	bombers
kín	privāts	secretive or closed tight (adj.)
kính	brilles	respect
kíp	apkalpe	esoterica
kít	iesaucās	wheelbarrow
ký	parakstīt	"(""nhật ký"") a diary"
kĩ	uzmanīgi	technique
kơnia	kaija	a tree found in southeast asia; sometimes called wild mango
kạn	kan	kan
kẹo	konfektes	candy
kẹp	klips	to clamp down (v.)
kẹt	iestrēdzis	jam
kẻ	puiši	guy
kẻo	vismaz	lest
kẽ	iespiesta	crevice
kẽm	cinks	zinc
kế	nākamais	a scheme (n.)
kết	beigas	combine
kề	blakus	adjacent
kềnh	lielgabarīta	bulky
kệ	plaukti	ignore
kỉ	gadsimtā	"(term should be ""kỉ niệm"") souvenir (n.)"
kị	kavalērija	ki
kịp	saglabāt	kip
kỵ	kavalērija	taboo
kỷ	gadsimtā	"(term should be ""thế kỷ"") century (n.)"
l	l	l.
label	etiķete	label
laboulaye	darbs	a name
ladakh	ladakh	(proper noun) ladakh
lai	hibrīds	"(term should be ""tương lai"") the future (n.)"
lam	lam	lam
lama	lamu	a name
lan	lan	a name
land	zeme	land
landon	landons	a name
lang	lang	lang
langdon	langdon	langdon
lange	lange	lange, as in oscar lange
langue	langue	langue
lanh	veļa	ringing
lanka	lanka	(proper noun) lanka, as in the island of sri lanka
lao	tb	labor
laos	laosa	(proper noun) laos
lap	klēpī	greek
larry	lerija	larry
lars	lars	lars
las	las	(proper noun) las, as in las vegas
laser	lāzers	laser
lateran	lateran	lateran
latinh	latīņu valoda	latin
latvia	latvija	(proper noun) latvia
lau	noslaucīt	lau
laura	laura	(proper noun) laura, as in laura bush
laurence	laurence	(proper noun) laurence
lawrence	likumsakarības	(proper noun) lawrence
lay	gulēja	lay
lazarus	lācars	(proper noun) lazarus
leach	izskalošanās	(proper noun) leach
leaf	lapu	leaf
leave	aizbraukt	leave
lebanon	libāna	(proper noun) lebanon
lee	lī	lee
legacy	mantojums	legacy
leiden	leiden	leiden
lem	lem	cinderella
lenin	ļeņins	lenin
lenins	lenins	lenin's
leo	kāpt	climb
leon	leons	leon
leonard	leonards	leonard
leonardo	leonardo	(proper noun) leonardo, as in leonardo da vinci
leonid	leonīds	leonid
les	les	les
leslie	leslija	a name
lesotho	lesoto	lesotho
lg	lg	lg
lhp	lhp	film festival
lhq	lhq	un
libby	libby	(proper noun) libby
libero	libero	libero
libya	libija	libya
lido	lido	lido
liechtenstein	lihtenšteina	liechtenstein
liga	liga	a name
lightning	zibens	lightning
lilly	lilija	(proper noun) lilly
linga	linga	linga
linh	linh	efficacious (adj.)
links	saites	links
linux	linux	linux server
lionel	lauva	lionel
lisboa	lisboa	lisboa
lisbon	lisbon	a name
litva	lietuva	(proper noun) lithuania
liu	liu	liu
liêm	integritāte	good example
liên	riska	relate
liêng	svēts	sacred
liêu	birokrātija	bureaucracy
liềm	sirpis	sickle
liều	deva	daring
liễu	vītolu	a willow tree (n.)
liệng	mest	"(term should be ""cánh liệng"") the aileron of a plane (n.)"
liệt	paralīze	impotent
liệu	vai	document
lleyton	lleyton	lleyton
lo	uztraukties	to worry (v.)
loa	runā	"(term should be ""cổ loa"") an ancient vietnamese city (proper noun)"
loaita	loaita	loaita
loang	slidens	patchy
loch	loch	loch
locke	locke	(proper noun) locke, as in philosopher john locke
lockheed	lockheed	(proper noun) lockheed, as in lockheed martin
log	žurnāls	log
logan	logans	a name
lon	var	lon
london	londona	london
long	ilgi	dragon
lorenzo	lorenzo	lorenzo
los	los	los, as in los angeles
louis	luiss	louis
louisiana	luiziāna	(proper noun) the state of louisiana
louvre	skaļruņi	(proper noun) louvre
love	mīlestība	yeu
loài	sugas	species
loát	bezgaumīgs	overturn
loãng	mazgājies	wishy-washy
loét	čūla	gaping, as in a wound
loại	sugas	type
loạianh	tips	not a word
loạianime	ierakstiet anime	type anime
loạibệnh	slimības veids	disease
loạichiến	tips	loaichien
loạicác	tips	item
loạicâu	tips	type: club
loạicông	tips	type: industry
loạicựu	tips	kind former
loạigia	tips	loaigia
loạihuân	kindhuan	not a word
loạiluật	likuma tips	type: law
loạimáy	mašīnas tips	kind plane
loạimôn	tips	type
loạingày	ierakstiet šo	loaingay
loạiphim	filmas tips	type movie
loạiphong	tips	kind of movement
loạiscandal	tips	scandal type
loạithuật	likuma tips	type: lexicon
loạithành	tips	kinds of payment
loạithần	tips	kind myth
loạitrường	skolas tips	type of school
loạitín	laipns	type: belief
loạitổ	tips	kind organization
loạivõ	tipa tips	type: martial art
loạixã	tips	kind of society
loạn	traucējumi	disorderly
loạt	sērijas	series
lp	lp	lp
lu	lu	dim
luang	luanga	a name
lucas	lucas	(proper noun) lucas
lucia	lucija	lucia, as in the island of saint lucia
luciano	luciano	luciano
ludendorff	ludendorff	luđenorff
ludovico	ludovico	ludovico
ludwig	ludviga	ludwig
lui	atpakaļ	withdrawal
luis	luis	(proper noun) luis, a first name
luiz	luiz	luiz
lula	lula	lula
lung	plaušu	shake
lustig	lustig	lusig
luther	lutere	luther
luxembourg	luksemburga	a name
luy	luijs	luy
luyến	pieķeršanās	love
luyện	apmācība	training
luận	komentārs	"(term should be ""xã luận"") an editorial"
luật	likums	law
luồn	vītņots	wriggle
luồng	straume	lane
luộc	vārīts	boiled
luỹ	kumulatīvs	rampart (n.)
ly	stikls	divorce
lydia	lydia	lydia
lympho	limfoma	lymphocyte
lyndon	lyndon	lyndon
lyon	lyon	lyon
là	bija	the verb to be
làm	darīt	make
làn	josla	wave
làng	ciems	village
lành	dziedināja	protestant
lào	laosa	laos
lá	lapas	"(term should be ""lá thư"") a letter (n.)"
lác	šķielēt	brag
lách	liesa	to swerve (v.)
lái	brauc	to drive (v.)
lán	būda	shack
láng	glancēts	neighbours
lâm	lam	lâm, a common vietnamese first name
lân	vienradzis	nearby
lâu	ilgi	long time
lây	infekciozs	to infect
lãi	interese	a profit
lãm	šovi	exhibition
lãnh	saņemts	to receive
lão	vecs	old
lèo	lèo	"(term should be ""nước lèo"") broth (n.)"
lén	paslīdēt	sneak
lê	bumbieris	le
lêmạc	viegls	"(term should be ""lê-mạc"") a war between two ruling families in ancient vietnamese history"
lên	augšā	on
lênh	komanda	"(should be ""lênh đênh"") adrift"
lênin	ļeņins	lenin
lìa	aizbraukt	to leave (v.)
lình	pēkšņi	suddenly
lí	uzglabāšana	reason
lính	kareivis	soldier
lít	litru	litre
líu	dūdot	"(term should be ""dính líu"") to have a connection with"
lò	krāsns	release
lòng	sasmalcināt	heart
lóc	čūskas galva	cry
lóe	uzplaiksnīja	flash
lóng	slengs	"entire term should be ""tieng long""; means ""slang"""
lót	odere	undies
lô	daudz	batch
lôi	kļūda	encourage
lôn	lol	"(term should be ""côn lôn"") a village in vietnam"
lông	mati	hair
lõi	kodols	core
lõm	ieliekts	concave
lùi	atpakaļ	back
lùn	īss	dwarf
lùng	medības	hunt
lúa	nelobīts	rice
lúc	plkst	at the moment
lún	pazemināšanās	subside
lúng	uzliesmot	confused
lúp	palielinošs	uneven
lút	nekrietns	surreptitiously
lăm	pieci	tens
lăn	ripo	attack
lăng	mauzolejs	tomb
lĩnh	domēni	"(term should be ""thủ lĩnh"") the leader (n.)"
lũ	plūdi	a band or gang (n.)
lũng	ieleja	valley
lũy	kumulatīvs	rampart
lơ	nolaidība	to ignore
lơi	atraisīt	"(term should be ""lả lơi"") to act in a familiar or flirting manner (adv.)"
lư	cenzeris	an urn
lưng	atpakaļ	back
lươn	zutis	eel
lương	alga	conscience
lưới	režģis	a net (n.)
lướt	sērfošana	ski
lười	slinks	lazy
lưỡi	mēle	tongue
lưỡng	biseksuāls	"(term should be ""lưỡng tính"") bisexual"
lược	ķemme	invasion
lượm	pulcēties	pick up
lượn	slīdēt	to glide over (v.)
lǐ	lǐ	(proper noun) li, as in jet li
lạ	dīvaini	strange or unusual (adj.)
lạc	pazaudēts	camel
lạch	grīva	"(term should be ""luồng lạch"") a narrow water passageway"
lại	atkal	reversed
lạn	sapuvis	bright
lạng	langa	lang
lạp	desa	"(term should be ""hy lạp"") greek"
lạtma	lamma	lama
lạy	nobriest	kowtow
lấn	iejaukšanās	to encroach on (v.)
lấp	aizpildīt	sparkle
lấy	izvēlēties	taken
lầm	nepareizi	wrong
lần	reizes	time
lầu	grīda	a story or level of a building (n.)
lầy	purvains	swamp
lẩu	karsts katls	hotpot
lẩy	lēkt	get
lẫn	apjucis	each other
lẫy	šķipsnu	illustrious
lận	krāpt	fraudulent
lật	flip	turn
lậy	ak jā	"(term should be ""cai lậy"") the name of a rural district"
lắc	krata	to shake (v.)
lắm	ļoti	do
lắng	nokārtot	"(should be ""lo lắ́́ng"") to worry"
lắp	pieguļošs	lap
lặng	kluss	quiet
lặp	atkārtot	repeat
lặt	dažādi	means miscellaneous, part of the word lat vat
lẹ	ātri	quickly (adv.)
lẻ	nepāra	"(the term should be ""bán lẻ"") retail"
lẻn	līst	sneak
lẻo	cauri	climb
lề	rezerve	alignment
lều	telts	tent
lễ	ceremonija	ceremony
lệ	likme	"(term should be ""tỷ lệ"") probability (n.)"
lệch	šķībs	difference
lệnh	comeinand	command
lị	dizentērija	"(term should be ""tỉnh lị"") a township (n.)"
lịch	kalendārs	history
lọc	filtrs	tricked
lọi	šķielēt	brilliant
lọng	saulessargs	rope
lọt	kritums	enter
lỏi	savārstījums	to enter
lỏng	vaļīgs	loose
lố	pāri	ridiculous
lốc	viesulis	tornado
lối	ieeja	way or path
lốp	riepa	tyre
lốt	aizsegs	lolot
lồ	milzis	giant
lồi	izliekts	convex
lồng	būris	cage
lỗ	caurums	hole
lộc	laime	loc
lội	peldēt	wade
lộn	pārslīdēja	wrong/mistake
lộng	krāšņs	"(term should be ""cổ lộng"") the name of a vietnamese city"
lột	noģērbt	exploit
lớn	liels	large
lớp	klase	grade (n.)
lờ	ignorēt	turbid
lời	vārdu	advice
lở	garām	to crack
lỡ	garām	miss
lợi	peļņa	benefit
lợn	cūka	pig
lợp	jumta segums	roof
lụa	zīds	silk
lục	zaļš	record
lụi	nodedzis	ruin
lụt	apbērt	flood
lụy	sekas	consequence
lứa	metiens	peer
lừa	triks	mislead
lừng	izcila	well-known
lửng	āpsis	lơ lửng= not clear/ something in between
lự	vilcinās	reluctant
lựa	atlasīts	chosen
lựu	granātābols	grenade
ma	spoks	ma sat (friction), ma thuat (magic), thay ma (zombie)
maastricht	māstrihtas	maastricht
macarthur	macharthur	macarthur
macclesfield	macclesfield	macclesfield
macedonia	macedonija	(proper noun) macedonia
mach	mačs	mach
machiavelli	machiavelli	machiavelli, as in philosopher niccolo machiavelli
machu	machu	machu
macintosh	macintosh	macintosh
macma	magma	magma
macromedia	makromedia	macromedia
madeira	madeira	madeira
madhouse	traka māja	madhouse
madison	madison	madison
madonna	madonna	(proper noun) madonna
madrid	madride	madrid, as in the capital of spain
mafia	mafija	mafia
magiê	magnijs	magnesium
mahal	mahal	(proper noun) mahal, as in the taj mahal
mai	jumts	"(term should be ""giang mai"") the disease syphilis (n.)"
mainframe	lieldators	mainframe
major	vairākums	major
makemake	padarīt	makemake
malacca	malaka	malacca
malay	malajietis	malaysia
malaysia	malaizija	(proper noun) the country of malaysia
malcolm	malkolms	malcolm
maldini	maldini	maldini
mali	mali	mai
malta	malta	malta
maluku	maluku	maluku
manche	manche	manche
manchester	mančestra	manchester
mandela	mandela	mandela, as in nelson mandela
mandy	mandijs	mandy
mang	nes	to bring (v.)
manga	manga	manga
mangnall	mangnall	(proper noun) mangnall, as in ernest mangnall
manh	manh	fragile
manila	manila	manila, the capital of the philippines
mankiw	mankiw	mankiw, as in gregory mankiw
manti	manti	mantle
manuel	manuele	manuel
mao	mao	capillary
maps	kartes	maps
maradona	maradona	(proper noun) maradona, as in soccer player diego maradona of argentina
marat	marat	(proper noun) marat, as in marat safin, a tennis player
marc	čagas	marc, as in marc chagall
marcel	marcel	(proper noun) marcel, a french name
marcos	marcos	(proper noun) marcos, as in ferdinand marcos
marcus	markuss	marcus, as in marcus aurelius (n.)
margaret	margareta	(proper noun) margaret
maria	marija	(proper noun) maria
marianne	marianne	(proper noun) marianne
marie	marie	marie
marina	jahtu osta	marina
marino	marino	marino
marić	marić	maric
marmara	marmara	(proper noun) marmara, as in the sea of marmara
marne	marne	marne, as in the marne river (n.)
mars	marss	mars
marseille	marseļa	marseille
marshall	maršala	marshall
marsu	marsu	(proper noun) marsu
marta	marta	(proper noun) marta, as in the female brazilian soccer player
martin	martins	martin
marx	marx	this is a name
mary	marija	(proper noun) mary
maryland	maryland	a name
maría	marija	maria
mas	mas	mas
massachusetts	masačūsetsas	massachusetts
mat	paklājs	mat
mathematica	matemātika	(proper noun) mathematica, as in isaac newton's work, principia mathematica
mats	paklāji	mats, as in mats sundin
matthias	matiass	matthias, as in matthias erzberger
mau	ātri	fast
maurice	maurice	(proper noun) maurice
mausolus	mausolus	mausolus
maxim	maksimums	a name
may	šūt	lucky
maya	maija	(proper noun) maya
mcafee	mcafee	(proper noun) mcafee
mccain	mccain	mccain
mccartney	mccartney	a name
mccullough	mccullough	mccullough
mcdonald	mcdonald	(proper noun) mcdonald
mchc	mchc	mchc
mclaren	mclaren	mclaren
mcmahon	mcmahon	(proper noun) mcmahon
mcnamara	mcnamara	(proper noun) mcnamara, as in robert mcnamara
mcv	mcv	mean corpuscular volume
media	mediji	media
medici	medici	(proper noun) medici, as in the medici family of italy
medina	medina	(proper noun) medina, as in ernest medina
medvedev	medvedevs	medvedev
mekong	mekonga	mekong
melbourne	melburna	melbourne
mendeleev	mendelejevs	mendeleev
menes	menes	(proper noun) menes
mercedes	mercedes	a name
messenger	messenger	messanger
messerschmitt	messerschmitt	messerschmitt, as in the messerschmitt me-109, a german plane
messi	messi	(proper noun) messi, as in argentinian soccer player lionel messi
messiah	mesija	messiah
meteora	meteora	meteora
mext	mext	mext
meyer	meyer	(proper noun) meyer, as in stephenie meyer, author of the twilight series
meyers	mejeri	meyers
miami	maiami	a name
michael	mihaels	michael
michaels	michaels	michaels
michelangelo	mikelandželo	michelangelo
michigan	mičiganā	a name
micro	mikro	micro
microbiology	mikrobioloģija	microbiology
microeconomics	mikroekonomika	microeconomics
micronesia	mikronēzija	micronesia
microsoft	microsoft	(proper noun) the microsoft company
miguel	migels	miguel
mike	maiks	mike
mikoyan	mikoyan	mikoyan
mikoyangurevich	mikoyangurevich	(proper noun) mikoyangurevich
milan	milāna	milan
milano	milano	milano
miley	mailija	miley
mill	dzirnavas	mill
miller	dzirnavnieks	miller
milton	milton	milton
min	min	min
minas	minas	minas
mindanao	mindanao	(proper noun) mindanao
ming	kaut kā	ming
minnesota	minesota	minnesota
minoa	minoa	minoa; the minoan civilization
miraflores	miraflores	miraflores
mirage	mirāža	mirage
miroku	miroku	(proper noun) miroku, a japanese name
misfits	nepareizi	misfits
mississippi	misisipi	mississippi
missouri	misūri štatā	(proper noun) the state of missouri
mitchel	mežģīnes	mitchel
mitsubishi	mitsubishi	mitsubishi
miên	hipnoze	mien
miêu	kaķis	"(term should be ""miêu tả"") to describe (v.)"
miến	rīsu nūdeles	burma
miếng	gabali	a piece (n.)
miếu	templis	temple
miền	domēns	area
miễn	atbrīvots	to exempt (v.)
miện	kronis	crown
miệng	mute	mouth
mm	mm	millimeter
mobile	mobilais	mobile
mode	režīms	mode
modul	modulis	module
modula	modula	(proper noun) modula, as in modula-2
mohammad	mohammad	mohammad
mohammed	mohameds	mohammed
moi	jauns	winkle
molecular	molekulārā	molecular
molotov	molotovs	molotov
molypden	molibdēns	the element molybdenum (n.)
mongolia	mongolija	mongolia
monique	monē	(proper name) monique, a french first name
mono	mono	mono
monroe	monro	monroe
mont	monts	(proper noun) mont
montaigne	montaigne	montaigne, as in michel de montaigne
montana	montāna	(proper noun) montana, as in the state
montenegro	montenegro	montenegro
montmartre	montmartre	(proper noun) montmartre
montparnasse	montparnasse	montparnasse
montreal	monretāls	(proper noun) montreal, quebec
moo	moo	(proper noun) moo, as in cha moo won
moong	moongs	moong
mora	morā	mora
moravia	morāvija	moravia
morgan	morgāns	(proper noun) morgan
mori	mori	(proper noun) mori
moriarty	moriartība	(proper noun) moriarty, as in james moriarty from sherlock holmes
morley	morijs	morley
morocco	maroka	morocco
morris	morris	morris
morrison	morrison	(proper noun) morrison
morse	morze	(proper noun) morse, as in morse code
moscow	maskava	moscow
mosin	mosins	mosin
moskva	moskva	moscow
motown	motown	motown
mourinho	mourinho	mourinho
movie	filma	movie
mozambique	mozambika	(proper noun) mozambique
mozart	mocarts	(proper noun) mozart, as in the composer
mp	sp	mp
ms	jaunkundze	metre per second
msdos	msdos	ms-dos
mtv	mtv	mtv
mu	mu	pubis
mua	pirkt	buy
much	daudz	much
muhammad	muhameds	(proper noun) muhammad, as in muhammad ali
mumbai	mumbaja	mumbai
mun	melnkoks	a vietnamese name
munich	munich	(proper noun) munich
murdoch	murdoch	murdoch
muromachi	muromači	(proper noun) muromachi
murphy	murfijs	murphy
murray	murray	(proper noun) murray, as in dr. conrad murray
mustang	mustangs	mustang, as in the f-51 mustang
muta	muta	a name
muôn	gribu	a large number; thousands (adj.)
muối	sāls	salt
muốn	gribu	want
muống	karote	"(term should be ""rau muống"") water spinach (n.)"
muồi	vēlu	ripe
muỗi	odu	mosquito
muỗng	karote	spoon
muội	māsa	confusion
muộn	vēlu	late (adv.)
myanma	mjanma	the country of myanmar
myanmar	mjanma	(proper noun) myanmar
myspace	mana vieta	(proper noun) myspace
mà	bet	also
mài	slīpēšana	tomorrow
màn	ekrāns	curtain (n.)
mành	žalūzijas	a bamboo screen (n.)
mào	cekuls	a comb or crest, as in the body part of a bird
màu	krāsa	color
mày	tu	sew
má	māte	cheek
mác	etiķete	a name (marx)
mách	padomi	tell
máclênin	markselenīns	marxist-leninist
mái	jumts	"entire term should be ""thoai mai""; means ""comfortable"""
mát	forši	cool
máu	asinis	blood
máy	mašīna	a machine (n.)
mâm	paplāte	tray
mân	rožukronis	"entire term should be ""man viet""; a country of ancient asia that now corresponds to a province in southern china"
mâu	pretrunīgi	contradiction
mây	mākonis	cloud
mã	kods	"(term should be ""la mã"") roman (adj.)"
mãi	mūžīgi	forever (adv.)
mãimại	kods	commerce
mãn	pašapmierināšanās	satisfy
mãnh	stipra	intense
mão	vainagi	cat
mè	sezama	sesame
mèo	kaķis	cat (n.)
mé	mé	a border
méo	izkropļots	alter
mép	mala	edge
mét	metrs	meter
mênh	satriecoši	vast
mêtan	metāns	methane
mì	nūdeles	wheat
mình	sevi	me
mía	cukurniedres	sugar cane (n.)
mò	satracināts	to grope (v.)
mòn	taka	trail
móc	āķis	"(term should be ""máy móc"") machinery (n.)"
món	ēdiens	dish
mô	audi	mo
môi	katrs	lip
môn	priekšmeti	anus
mông	sēžamvieta	mongolia
mônôxít	monoksīds	monoxide
môt	viens	"(term should be ""một"") one (n.)"
môtô	motocikls	motorcycle
mù	akls	mu
mùa	gada sezonu	season
mùi	smaka	smell
múa	dejot	dance
mút	nepieredzējis	to suck (v.)
münchen	minhenē	(proper noun) munchen
măng	bambusa dzinumi	bamboo shoot (n.)
mĩ	amerika	america
mũ	cepure	cap
mũi	deguns	nose
mơ	sapnis	vague
mơn	ķepas	caress
mưa	lietus	rain
mưu	viltīgs	"(should be ""tham mưu"") advisors"
mươi	piecdesmit	tens
mương	notekas	ditch
mướn	īre	hire
mướt	zīdaini	smooth (adj.)
mường	muongs	(proper noun) mường, a minority people in vietnam (n.)
mượn	aizņemties	borrow
mượt	gluda	glossy (adj.)
mạc	tuksnesis	"(should be ""mộc mạc"") simple or natural"
mạch	ķēde	vessel
mại	tirdzniecība	commerce
mạn	pusē	romantic
mạnh	stipra	strong
mạo	raksts	"(should be ""mạo hiểm"") to brave danger"
mạt	ērces	"(term should be ""lê mạt"") the ending or decline of something (adj.)"
mả	kapiem	tomb or grave (n.)
mải	aizņemts	absorbedly
mảng	masīvs	genre
mảnh	gabals	piece
mất	pazaudēts	lose
mấu	cilne	key
mấy	maz	any
mầm	dīglis	kindergarten
mầu	krāsa	color
mẩu	gabali	piece
mận	plūme	plum
mập	tauki	fat
mật	medus	intimate
mậu	tirdzniecība	mau
mắc	dārgi	get
mắm	zivju mērce	"(term should be ""nước mắm"") fish sauce (n.)"
mắn	paveicies	"(term should be ""may mắn"") fortunate (adj.)"
mắng	bļaut	scold
mắt	acs	eye
mặc	valkāt	wear
mặn	sāļš	salt
mặt	seja	face
mẹ	mamma	mother (n.)
mẹo	padomi	trick
mẻ	partija	cool
mẽ	stipra	strong
mến	dārgs	to adore or like greatly (v.)
mề	žņaugs	locket
mềm	mīksts	soft
mệnh	liktenis	revolution
mệt	noguris	tired
mỉ	sīkumains	meticulous
mỉa	sarkasms	ironic
mỉm	smaidi	smile
mịch	sūdi	"(term should be ""tịch mịch"") quiet (adj.)"
mịn	gluda	smooth
mịt	šņaukāties	dim
mọc	aug	to grow (v.)
mọi	katrs	every
mọn	sīks	lowly
mỏ	mīnas	mine
mỏi	noguris	tired (adj.)
mỏng	plāns	thin
mốc	melns	border
mối	termīts	relationship
mốt	mode	fashion or style (n.)
mồ	kapu	"(term should be ""mồ hôi"") sweat (n.)"
mồi	ēsma	bait (n.)
mổ	operācija	to dissect or perform surgery (v.)
mỗi	katrs	every
mộ	kapenes	admire
mộc	galdniecība	simple
mộng	sapnis	dream
một	viens	one
mới	jauns	new (adj.)
mờ	izplūdis	dim
mời	uzaicināt	invite
mở	atvērts	open
mỡ	tauki	fat or grease (n.)
mục	prece	purpose
mụn	pūtītes	pimple
mức	līmenis	level
mứt	ievārījums	preserve
mừng	prieks	to be happy
mửa	vemšana	to vomit (v.)
mực	tinte	"(term should be ""chuẩn mực"") standard (n.)"
mỳ	nūdeles	noodles (n.)
mỹ	amerika	america
mỹcông	amerika	my private
na	na	"(term should be ""na uy"") the country of norway"
naadam	naadam	naadam
nacional	nacional	nacional
nagant	nagants	nagant
nagar	nagar	nagar, as in champa po nagar
nagasaki	nagasaki	(proper noun) the city of nagasaki, japan
nagoya	nagoja	a name
nagumo	nagumo	nagumo
nai	briedis	a deer
nairobi	nairobi	nairobi, a city in kenya (n.)
nakajima	nakajima	a japanese name
nalbandian	nalbandiāns	a name
nam	vīrietis	male
nambắc	uz ziemeļiem	nambac
namibia	namībija	namibia
namnam	nam nam	male-male
namno	namno	nammo
nancy	nancy	nancy, as in nancy pelosi
nang	folikulu	"(term should be ""cẩm nang"") a handbook (n.)"
nanh	fani	fang
nano	nano	nano
naomi	naomi	naomi, as in model naomi campbell
napoleon	napoleons	(proper noun) napoleon
napoli	napoli	(proper noun) napoli
napoléon	napoléon	napoleon
nara	nara	nara
nasa	nasa	(proper noun) nasa
nat	nat	nat
nathan	natāns	nathan
natri	nātrijs	sodium
nauru	nauru	a name
nava	nava	nava
navarre	navarra	navarre
nay	tagad	this (adj.)
needham	needham	needham
nelson	neilons	(proper noun) nelson, as in nelson mandela
neo	enkurs	"(term should be ""mỏ neo"") an anchor (n.)"
neon	neona	neon
nepal	nepāla	nepal
nepomuk	nepomuks	a name
nessie	nessie	(noun) nessie, the nickname of the loch ness monster
net	tīkls	net
netbook	netbook	netbook
netscape	netscape	netscape
networks	tīkli	networks
neumann	neumann	(proper noun) neumann
neutrino	neitrīno	neutrino
nevada	nevada	nevada
neverland	neverland	neverland
newcastle	ņūkāsla	newcastle
newspaper	avīze	newspaper
newton	ņūtons	newton
newtons	ņūtoni	(proper noun) newton's
next	nākamais	next
nga	krievija	russia
ngai	tronis	crown
ngang	horizontāli	horizontal
ngao	gliemene	clam (n.)
ngay	taisnība	even
nghe	klausies	hear
nghinh	nghinh	welcome
nghiêm	smagi	serious
nghiêng	slīpi	inclined
nghiêu	nghieu	nghiêu, a vietnamese name
nghiền	spļaut	crush
nghiễm	žēl	serious
nghiệm	pieredze	experiment
nghiện	atkarīgs	addiction
nghiệp	karma	karma/ sự nghiệp=career
nghiệt	drūms	adverse
nghành	nozare	faculty
nghèo	nabadzīgs	poor
nghé	nghe	to glance out of the corner of one's eye (v.)
nghê	nghe	nghe khuong
nghênh	laipni gaidīti	support
nghìn	tūkstoši	thousand
nghĩ	domā	think
nghĩa	nozīmē	meaning
nghẽn	sastrēgumi	jam
nghếch	skaļš	stupid
nghề	profesija	career
nghệquận	māksla	art district
nghỉ	brīvdienas	relaxation
nghị	ieteikumi	think
ngo	gards	ngo
ngoan	labs puika	good
ngoc	ngoc	"(term should be ""ngọc"") gem (n.)"
ngon	garšīgs	delicious
ngoài	ārā	outside of
ngoại	ārzemju	external
ngoạn	elpu aizraujošs	spectacular
ngoặc	iekavas	bracket
ngoặt	pagrieziens	landmark
ngu	gulēt	stupid
ngung	ngung	(proper noun) a vietnamese first name
nguyen	nguyen	nguyen
nguyên	oriģināls	reason
nguyền	lāsts	curse
nguyện	zvērests	"(term should be ""mãn nguyện"") to be satisfied (adj.)"
nguyệt	mēness	moon
nguôi	nomierinoša	fade away
nguồn	avots	source
nguời	cilvēki	people
nguỵ	muļķi	camouflage
ngà	ziloņkaula	russian
ngàn	tūkstoši	thousand
ngàng	ngàng	"(term should be ""ngỡ ngàng"") to be at fault (adj.)"
ngành	filiāle	sector
ngào	salds	sweet
ngày	dienā	day
ngách	niša	"entire term should be ""ngoc ngach""; means ""a small, out-of-the-way road"""
ngái	stulbi	chinese ethnic group living in the vietnamese highlands near the china border
ngán	garlaicīgi	to be tired of
ngáng	ngáng	stop
ngát	ģībonis	"(term should be ""ngát hương"") fragrant (adj.)"
ngân	banka	money
ngây	tukšs	"(term should be ""ngây ngất"") to be in ecstasy"
ngãi	ngai	ngai
ngò	cilantro	coriander
ngó	skaties	to look (v.)
ngói	flīze	tile or shingle
ngón	pirksts	a finger (n.)
ngót	saraušanās	"(term should be ""rau ngót"") also called sweet leaf, a type of leafy vegetable used to make soup (n.)"
ngôn	valoda	manifesto
ngông	zoss	eccentric
ngõ	josla	lane
ngùi	smaka	sad
ngút	nguta	"entire term is ""ngut troi""; means ""sky-high"""
ngăn	nodalījums	prevent
ngũ	gulēt	rank
ngơ	ignorēts	ignored (adj.)
ngơi	atpūsties	"(term should be ""nghỉ ngơi"") to rest (v.)"
ngư	zvejnieks	fishermen
ngưng	apstāties	stop
ngưu	vērsis	buffalo
ngươi	tu	an ancient form of address equivalent to thou or thee (n.)
người	cilvēki	people
ngưỡng	slieksnis	religious
ngược	atpakaļgaitā	opposite
ngạc	pārsteigts	surprise
ngạch	rangs	"(term should be ""kim ngạch"") turn-over (n.)"
ngạn	banka	bank
ngạnh	barbs	self-willed
ngạo	uzpūtīgs	"(term should be ""ngạo ngược"") insolent (adj.)"
ngạt	nosmakšana	stuffy
ngấm	uzpūta	draw
ngất	ģībonis	unconscious
ngầm	netieši	underground
ngần	vilcināties	hesitate
ngẩn	apmulsis	froze
ngẫm	apdomā	think
ngẫu	izlases veidā	ngẫu nhiên= random
ngậm	pastilās	keep
ngập	applūst	flood
ngắm	pārdomāt	to contemplate or look admiringly at something (v.)
ngắn	īss	short
ngặt	saspringts	strict
ngọ	pusdienlaiks	horse
ngọc	dārgakmens	pearl
ngọn	tops	top
ngọt	salds	sweet (adj.)
ngồi	sēdēt	sit
ngộ	apgaismība	ngo
ngột	pēkšņi	sudden
ngớ	dumjš	silly
ngời	cilvēki	bright
ngỡ	domāja	surprised
ngợi	uzslavas	praise
ngợm	nerātns	naughty
ngục	cietums	dungeon
ngụm	malks	sip
ngụy	vei	puppet
ngủ	gulēt	sleep
ngủi	īss	"(should be ""ngắn ngủi"") short-lived"
ngứa	nieze	itchy
ngừ	tuncis	tuna
ngừa	novērst	prevent
ngừng	pārtraukt	to cease (v.)
ngửa	seju uz augšu	supine
ngửi	smaka	to smell
ngữ	runa	term
ngự	pakavēties	defend
ngựa	zirgs	horse
ngực	krūtīs	chest
nha	zobārsts	dental
nhakẻ	bērns	nha-ke
nham	lava	"(actual term is ""dung nham"") lava"
nhan	nhan	"(term should be ""dung nhan"") countenance or facial appearance (n.)"
nhang	vīraks	incense
nhanh	ātri	fast
nhat	nhat	nhat
nhen	atgaiņājās	rekindle
nhi	bērni	junior
nhiên	protams	tuy nhiên= however
nhiêu	daudz	how many
nhiều	daudz	numerous
nhiễm	inficēts	infect
nhiễu	troksnis	noise
nhiệm	nodoklis	task
nhiệt	karstums	heat
nhk	nhk	nhk
nhs	nhs	nhs
nhu	piemēram	demand
nhuận	peļņa	leap year
nhuệ	njū	elite
nhuộm	krāsot	dye
nhàn	dīkstāvē	leisure
nhàng	maigi	"(term should be ""nhẹ nhàng"") gentle (adj.)"
nhào	mīcīt	to fall headlong
nhác	ļengans	coward
nhái	kloniem	illegal copy
nhánh	filiāle	branch
nháp	melnraksts	draft
nháy	mirgo	to flash or blink (v.)
nhâm	iegremdējot	leap
nhã	gaumīgs	"(term should be ""thanh nhã"") elegant"
nhãn	etiķete	"(term should be ""gán nhãn"") to affix a label"
nhét	likt	put
nhì	otrais	second (adj.)
nhìn	skaties	to look (v.)
nhí	pļāpāšana	children
nhím	ezis	porcupine
nhòm	skaties	to peep (v.)
nhóc	bērns	brat
nhóm	grupa	group (n.)
nhô	izvirzīts	emerge
nhôm	alumīnijs	aluminum (n.)
nhúng	iemērkt	embed
nhút	kautrīgs	shy
nhăn	saburzīts	wrinkle
nhĩ	priekškambaru	turkey
nhũ	emulsija	"(term should be ""thạch nhũ"") stalactite (n.)"
nhũng	korupcija	bribery
nhơn	reizināt	nhon
như	kā	like
nhưng	bet	but
nhương	siekalas	(proper noun) vietnamese first name
nhường	padevās	yield
nhưỡng	taukains	soil
nhược	vājums	weak
nhượng	koncesijas	concession
nhạ	nhạ	nha
nhạc	mūzika	music
nhạn	norīt	bird
nhạo	ņirgājas	ridicule
nhạt	bāla	light
nhạy	jūtīgs	sensitive
nhảy	dejot	jump
nhấc	pacelt	lift
nhấm	malkojot	rodent
nhấn	spiešana	to press (v.)
nhất	labākais	most
nhầm	nepareizi	misunderstand
nhầy	gļotains	glutinous
nhẫn	gredzeni	patient
nhậm	apzīmogots	inaugurate
nhập	importēt	penetrate
nhậu	dzeršana	drink
nhậy	jūtīgs	sensitive
nhắc	pamudināt	to remind (v.)
nhắm	mērķis	aim
nhắn	ziņa	message
nhằm	mērķis	for the purpose of (adv.)
nhẵn	gluda	smooth
nhặt	izvēlēties	pickup
nhẹ	viegls	light
nhẹn	veikls	nhanh nhẹn= fast/nimble
nhị	putekšņlapas	sensitive
nhịn	atturēties	fasting
nhọ	nelaimīgs	smear
nhọn	asu	sharp (adj.)
nhỏ	mazs	small
nhỏ|cây	mazs | koks	small|tree
nhỏ|một	mazs | viens	small | one
nhỏ|phải|	mazs | pareizi |	small|right
nhỏ|phải|px|	mazs | pa labi | px |	small | have | px |
nhỏ|phải|px|bức	mazs | pa labi | px | attēli	grape / fade / px / buc
nhỏ|phải|px|cây	mazs | pa labi | px | koks	px spicy grape fade
nhỏ|phải|px|khu	mazs | pa labi | px | zona	small|right|px|area
nhỏ|phải|px|michael	mazs | pa labi | px | michael	small|right|px|michael
nhỏ|phải|px|máy	mazs | pa labi | px | mašīna	small | right|px|machine
nhỏ|phải|px|một	mazs | pa labi | px | viens	small|right|px|one
nhỏ|phải|px|quân	mazs | pa labi | px | spēks	small|right|px|army
nhỏ|px|	mazs | px |	small
nhỏ|px|các	mazs | px | the	small
nhỏ|px|phải|kiến	mazs | px | pa labi | skudra	small | px | right | patience
nhỏ|quân	mazs | spēks	small|army
nhỏ|trái|px|máy	mazs | pa kreisi | px | mašīna	small|left|px|plane
nhỏ|tượng	mazas statujas	small|statue
nhốt	ieslēgts	confine
nhồi	pildīti	cram
nhổ	noplūkt	uproot
nhộn	jautrs	busy
nhớ	prāts	remember
nhớt	viskozs	viscid
nhờ	paldies	by
nhờn	taukains	multiplication
nhở	atgādināt	remind
nhụ	šķipsnu	nhu
nhục	pazemots	shame
nhủ	atgādinājumi	needs
nhức	sāpes	pain
nhứt	vispirms	first (n.)
nhừ	mīļais	tender
những	šie	the
nhựa	plastmasas	plastic
nhựt	nhut	"like the word ""nhật""; meaning ""sun"" (n.)"
ni	ni	nun
nia	nia	a flat basket (n.)
nicaea	nicaea	nicaea
nicaragua	nikaragva	(proper noun) nicaragua
niccolò	niccolò	(proper noun) niccolo, as in writer niccolo machiavelli
nicolas	nikolas	(proper noun) nicolas, as in nicolas sarkozy
niels	niels	(proper noun) niels
nigeria	nigērija	nigeria
nikel	nikel	nickel
niken	niķelis	nickel
nikita	nikita	(proper noun) nikita, a first name
nikko	nikko	(proper noun) nikko
nikolai	nikolai	nikolai
nikolayevich	nikolajevičs	nikolayevich
nil	nulle	nile
nile	nīls	(proper noun) the river nile
nimitz	nimitz	(proper noun) nimitz, as in the ship uss nimitz
nin	nin	nin
ninh	drošība	ninh, as in bắc ninh
nintendo	nintendo	(proper noun) nintendo, the game company
nippon	nippon	nippon
nitơ	slāpeklis	nitrogen (n.)
nixon	nixon	(proper noun) nixon, as in former president richard nixon
niên	gadā	youth
niết	niet	nirvana
niềm	prieks	trust
niệm	uzmanība	concept
niệu	diurēze	urinary
nj	nj	nj
nlf	nlf	nlf
nm	nm	nano-meters
noah	njā	(proper noun) noah
nobel	nobela	nobel
nobita	nobita	nobita
noel	noel	(proper noun) noel
noi	sakiet	imitate
nokia	nokia	(proper noun) nokia, as in the nokia corporation
nol	nol	nol
nom	nom	look after
non	jauns	mountain
nonpenetrative	necaurlaidīgs	nonpenetrative
norfolk	norfolk	norfolk
norge	norge	norge
norma	norma	(proper noun) norma, a female first name
norman	normans	norman
normandie	normandie	normandile
northrop	ziemeļu puse	northrop, as in the northrop f-5 freedom fighter
norton	nortons	norton
norway	norvēģijā	norway
nou	nou	nou
novak	novaks	novak
now	tagad	now
nowc	nowc	nowc
noãn	ovule	ovule
nsnd	nsnd	people's artist
nst	nst	chromosome
nubia	nubija	nubia
number	numuru	number
nupedia	nupedia	a name
nusa	nusa	nusa
nuôi	barot	feed
nuối	norīt	"(term should be ""tiếc nuối"") to regret (v.)"
nuốt	norīt	to swallow (v.)
nuớc	ūdens	water
nxb	nxb	publisher
nynorsk	ņūnorska	nynorsk
nà	nà	na
nài	uzstāt	pleading
nàn	sūdzējās	poor
nành	sojas	soy
nào	aiziet	would
này	šo	this
ná	ná	a crossbow (n.)
nách	paduses	underarm (n.)
náo	drausmīgs	riot
nát	sasmalcināts	ruin
náu	paslēpties	hide
nâng	paaugstināt	raise
nâu	brūns	brown
nã	nã	to track down (v.)
não	smadzenes	brain
né	izvairīties	dodge
ném	mest	to throw (v.)
nén	saspiests	compress
nét	sitieni	feature
nê	ne	ne
nên	svečturis	should or ought to
nêu	pastāsti	mention
nòi	sacensības	race
nòng	muca	barrel
nói	runāt	to say or speak (v.)
nón	cepure	cone
nóng	karsts	hot
nô	vergs	slave
nôbita	tobita	nobita
nôi	gultiņa	cradle
nôm	nôm	ancient vietnamese script that borrowed heavily from han chinese characters
nôn	vemt	vomit
nông	sekla	farmer
nõn	pīlings	peeled
nùng	nung	nung
núm	kloķis	nipple
núp	paslēpties	hide
nút	mezgls	button
năm	gadā	year
năn	nožēlojams	"(term should be ""ăn năn"") remorse (n.)"
năng	spēks	"(term should be ""khả năng"") ability (n.)"
nơi	vieta	a place
nơtrino	neitino	neutrino
nước	valsts	country
nước 	valsts	water
nướng	grilēts	grill
nǎm	nǎm	year
nạ	maska	mask
nạc	liekties	lean (adj.)
nại	sūdzēties	complain
nạn	ciešanas	a disaster (n.)
nạo	kuretāža	to scrape (v.)
nạp	piekrauts	tribute
nản	atrunāts	depressed
nảy	piepeši	"(term should be ""nảy sinh"") to give rise to (v.)"
nấc	žaga	a hiccup (n.)
nấp	paslēpties	hide
nấu	pavārs	cook
nấy	šo	this
nần	iedunkāt	debt
nầy	šo	this
nẩy	piepeši	"(term should be ""nảy nở"") to sprout or start growing (v.)"
nẫu	n saule	"(""giọng nẫu"") a vietnamese accent commonly found in cities such as phú yên"
nậm	nam	"(term should be ""nậm rốm"") the name of a river in vietnam (proper noun)"
nập	karsts	busy
nắm	turēt	to grasp or hold (v.)
nắng	saulains	sunlight
nắp	vāks	a lid or cover (n.)
nằm	melot	to lie (v.)
nẵng	nang	"(term should be ""Đà nẵng"") a city in central vietnam"
nặc	anonīmi	heavy
nặn	saspiest	mould
nặng	smags	heavy
nẻo	cits	turn
nếm	garša	taste
nến	svece	candle
nếp	lipīga	sticky rice (n.)
nếu	ja	if (adv.)
nề	mūra	severe
nể	cieņu	respect
nện	ņurdēšana	ram
nỉ	juta	beg
nịnh	glaimot	flatter
nọ	otrs	the other
nọc	inde	tadpole
nỏ	arbalets	a crossbow (n.)
nối	savienots	connection
nốt	piezīme	to finish off (v.)
nồi	pods	pot
nồm	pakauša	humid (adj.)
nồng	karsts	heavy
nổ	sprādzienbīstams	explode
nổi	peldošs	nổi tiếng= famous
nỗ	mēģinājums	affort
nỗi	ka	state
nộ	dusmas	anger
nội	iekšējais	on the paternal side (adj.)
nộn	pildīšana	non
nộp	iesniegts	submit
nới	atraisīt	ease
nở	ziedošs	bloom
nỡ	sirsnīgs	do you have a heart to
nợ	parādos	debt
nụy	pistil	"(term should be ""nụy nhân"") the vietnamesized han term depicting the japanese"
nứa	korķis	a kind of bamboo (n.)
nứt	ieplaisājis	to crack
nửa	puse	haft
nữa	atkal	moreover
oahu	oahu	(proper noun) oahu
oai	bīstas	heroic
oakland	oakland	oakland
oan	netaisnība	injustice
oanh	oāns	(with word liet) glorious
obama	obama	obama
oblast	apgabals	(proper noun) oblast, as in tomsk oblast
oc	oc	oc
october	oktobris	(proper noun) october
oda	o da	oda
oder	oder	oder
odyssey	odiseja	odyssey, as in the odyssey, homer's epic
oecd	oecd	oecd
officer	virsnieks	officer
officers	virsnieki	officers
ohkawa	ohkawa	ohkawa
okhotsk	okhotska	okhotsk
oliver	olivers	oliver
olivier	olivier	olivier
olympus	olimps	olympus
om	sautēts	to simmer
omar	omārs	a name
ong	bite	bee
ontario	ontario	ontario
oort	oort	oort
oprah	oprah	(proper noun) oprah, as in oprah winfrey
organ	ērģeles	organ
oricon	orikons	oricon
origin	izcelsme	origin
orion	oriona	(proper noun) orion, the hunter
orleans	orleans	(proper noun) orleans, as in new orleans
orochimaru	orochimaru	orochimaru
orton	ortons	orton
os	os	os
osaka	osaka	(proper noun) osaka, a city in japan
osama	osama	(proper noun) osama, as in osama bin laden
osamu	osamu	(proper noun) osamu, a japanese first name
oscar	oscars	oscar
osiris	osiris	(proper noun) osiris, as in the egyptian god
oskar	oskar	a name
oslo	oslo	oslo
osment	osment	osment
ospf	ospf	ospf
ossetia	ossetia	(proper noun) ossetia
oswald	osvalds	oswald
other	citi	other
otto	otto	(proper noun) otto, as in otto von bismarck
ottoman	osmaņu	(proper noun) ottoman, as in the ottoman empire
outstanding	izcils	xuat sac
owen	pūce	(proper noun) owen, as in michael owen
oxford	oksfords	oxford
oxy	skābeklis	oxygen
ozawa	ozawa	(proper noun) ozawa, as in maria ozawa
oán	aizvainojums	"(term should be ""oán than"") to complain or whine"
oát	vati	a watt (n.)
oản	oāns	"(term should be ""ăn oản"") gratitude and resentment (n.)"
paget	lappuse	(proper noun) paget
pailin	pailin	pailin
pakistan	pakistāna	(proper noun) the country of pakistan
palais	palais	palais, as in grand palais
palawan	palavana	palawan
palenque	palenque	(proper noun) palenque
palestine	palestīna	a name
palgrave	palgrave	palgrave
pali	pali	a name
pamir	pamir	pamir
pan	panna	pan, as in peter pan
panama	panama	panama
panamax	panamax	(proper noun) panamax
panduranga	panduranga	(proper noun) panduranga
panthera	pantera	(proper noun) panthera, a genus of felines
panthéon	panteons	a name
paolo	paolo	paolo
paperback	paperback	paperback
papua	papuas	papua
paraguay	paragvaja	(proper noun) paraguay
pari	pari	pari
park	parks	park
parton	parton	parton
patel	patels	(proper noun) patel
patrick	patriks	patrick
patriot	patriots	patriot
paul	pauls	paul
paula	paula	paula
paulo	paulo	(proper noun) paulo
pavia	pavia	pavia
pbs	lpp	pbs
pda	pda	pda
pdf	pdf	pdf
pedro	pedro	pedro
peers	vienaudžiem	peers
pele	pele	(proper noun) pele, as in the soccer player
penang	penangs	penang
penh	penss	(proper noun) penh, as in phnom penh
pennsylvania	pensilvānija	pennsylvania
penny	santīms	(proper noun) penny, an english first name
pereira	pereira	pereira
perl	perls	(proper noun) perl
pero	pero	pero
perry	bumbieru	(proper noun) perry, as in elizabeth perry
persephone	persephone	presephone
pershing	pershing	pershing
persian	persiešu	persian
peru	peru	peru, as in the south american country
peters	peters	peter's, possessive of peter
petersburg	pēterburga	(proper noun) petersburg, as in saint petersburg
pfm	pfm	a name
pgs	lpp	associate professor
pgđ	pgđ	associate professor
pha	sajaukts	to mix
phaethon	faetons	phaethon
pham	pham	pham
phanh	bremzēt	expose
phao	peldēt	float
phaolô	pols	st. paul, the apostle
pharaoh	faraons	pharaoh
pharaon	faraons	pharaoh
phay	frēzēšana	mill
phe	frakcija	faction
phen	fen	time
phil	phil	(proper noun) phil, a first name
philip	philip	philip
philippe	philippe	philippe
philippines	filipīnas	(proper noun) philippines
phillip	phillip	(proper noun) phillip
phillips	phillips	philips
philosophiae	filozofijas	(proper noun) philosophiae, as in the work philosophiae naturalis principia mathematica
phim	filma	phim
phin	filtrs	coffee filter
phineas	phineas	(proper noun) phineas
phiên	sesija	trial
phiêu	piedzīvojums	adventurous
phiếm	tenkas	gossip
phiến	asmens	"(should be ""nha phiến"") opium"
phiện	opijs	opium
phiệt	phiet	militarism
phnom	phnom	phnom
phnôm	phomom	phnôm pênh= phnom penh(cambodia's capital)
pho	pho	part of a person's name, rat-pho, or ratford
phoenix	fēnikss	(proper noun) phoenix
phong	istaba	movement
php	php	php
phrygian	frygian	phrygian
phu	phu	"(term should be ""phu nhân"") wife (n.)"
phui	bez pārklājuma	expose
phun	izsmidzināt	to spray or spit (v.)
phà	prāmis	ferry
phàm	mirstīgais	superhuman
phàn	sūdzēties	complain
phá	laušana	destroy
phác	skice	"(term should be ""phác thảo"") outline or sketch (n.)"
phách	pārspēt	manner (n.)
phái	sekta	a party
phán	tiesnesis	judge
pháo	lielgabalu	artillery
pháp	francija	method
phát	pārraide	develop
phèn	alum	alum
phèo	fèo	organs
phép	atļauts	permit
phê	pacelties augstu	"(term should be ""phê bình"") to criticize (v.)"
phêrô	pēteris	peter
phì	palielināts	non-
phình	izspiesties	bulge
phí	uzlādēt	non-
phía	pusē	side
phích	termoss	a flask (n.)
phím	atslēga	key
phò	phò	"(term should be ""phò mã"") a prince consort"
phòng	istaba	office
phó	vietnieks	second
phóng	palaišana	to launch (v.)
phô	pilsēta	display
phôi	embrijs	embryo
phông	fonts	font
phùng	dvesma	phung
phúc	svētīts	good fortune (n.)
phúclộc	svētība	phuc-loc
phún	bum	"(term should be ""lún phún"") sparse (adj.)"
phúng	žēl	satire
phút	minūte	a minute (n.)
phăn	satracināt	phan
phăng	phang	knock
phương	phuong	direction
phước	svētība	luck
phường	palātā	ward
phượng	fēnikss	phoenix
phạn	sanskrits	sanskrit
phạt	sodīt	punish
phả	ciltsraksti	pedigree
phải	taisnība	must
phải 	taisnība	right
phản	skaitītājs	reaction
phảng	plakans	subtle
phần	daļa	part
phẩm	izstrādājumi	food
phẩy	komats	a comma
phẫn	sašutis	wrathful
phẫu	operācija	surgery
phận	liktenis	part
phật	buda	buddhist
phẳng	lidmašīna	flat (adj.)
phế	lūžņi	dismiss
phết	izplatība	to spread or smear (v.)
phỉ	lazda	defame
phỏng	sadedzināt	interview
phố	pilsēta	city
phối	koordinēt	coordinate
phốt	fosfāts	"(term should be ""phốt-phát"") phosphate (n.)"
phồng	piepūsts	to swell (v.)
phổ	spektrs	popular
phổi	plaušu	lung
phộng	zemesrieksti	peanut
phới	peldēt	"(term should be ""phơi phới"") mildly exciting (adj.)"
phở	nūdeļu zupa	pho
phục	apģērbs	convincing
phụng	pasniegt	worship
phụt	dvesma	minute
phủ	pārklāts	government
phức	sarežģīts	complex
picchu	pikči	a name
piccolo	pikolo	piccolo
pierre	pierre	pierre
pierrot	pierrot	pierrot
pietro	pietro	pietro
pike	līdaka	pike
pin	akumulators	battery
pinlus	pinlus	pinlus
pioneer	pionieris	pioneer
pipes	caurules	pipes
pisa	piza	a name
piston	virzulis	piston
pitch	piķis	pitch
pius	pijs	pius
plaaf	klaips	plaaf
plan	plāns	plan
plasma	plazma	plasma
plate	šķīvis	plate
plato	plato	plato
platon	platon	platon
player	spēlētājs	player
pleiku	pleiku	(proper noun) pleiku
pleistocen	pleistocēns	pleistocen
plus	plus	plus
pluto	plutons	pluto
pm	plkst	pm
pmu	pmu	pmu
po	po	po
pokémon	pokemon	pokemon
pol	pol	pol
poland	polija	poland
pollack	pollaks	a name
pollux	pollux	a name
polo	polo	(proper noun) polo, as in marco polo
polynésie	polinēze	polynesian
pont	pont	(proper noun) pont, as in pont de normandie
pop	pop	pop
portland	portland	portland
porto	porto	porto
pot	pods	pot
potsdam	potsdam	(proper noun) potsdam
potter	podnieks	(proper noun) potter, as in harry potter
pour	ielej	not vietnamese
powell	powell	(proper noun) powell, as in general colin powell
pradesh	pradeša	pradesh
praha	praha	praha
pratzen	pratzen	pratzen
preah	sludināt	(proper noun) preah
premier	premjers	premier
preminger	preminger	(proper noun) preminger
preston	preston	(proper noun) preston, as in john preston
prince	princis	prince
princeton	princetonu	princeton
printemps	printemps	printemps
printf	printf	printf
prinz	prinz	(proper noun) prinz, as in birgit prinz, the female german soccer player
prix	prix	(proper noun) prix, as in the grand prix
procellarum	procellarum	procellarum, as in oceanus procellarum, the name of a mare on the moon
projekt	projekts	projekt
prometheus	prometejs	(proper noun) prometheus
protein	olbaltumvielu	protein
prôtêin	olbaltumvielas	protein (n.)
ps	ps	ps
psv	psv	psv
ptolemy	ptolemaja	ptolemy
ptq	ptq	ptq
puerto	puerto	puerto
pulau	pulau	(proper noun) pulau, as in pulau tekong, an island
pulitzer	pulicers	(proper noun) pulitzer, as in the pulitzer prize
pulp	mīkstums	pulp
punjab	pendžabs	punjab
pusan	pusan	(proper noun) pusan
putin	putins	putin
pyrenees	pireneji	pyrenees
pytago	pytago	(proper noun) pytago
pzl	pzl	pzl
péc	péc	"(term should be ""vịnh péc xích"") the persian gulf"
pérez	pérez	(proper noun) perez, as in javier perez de cuellar
păng	pang	fansipan
pơ	pơ	"(term should be ""pơ kô"") a river in vietnam (n.)"
q	q	q ( a letter)
qatar	katara	qatar
qd	qd	quantum dots
qing	qing	qing, as in the qing dynasty of  china
qlvnch	qlvnch	army of the republic of vietnam
qua	autors	transmit
quad	četrinieks	quad
quan	quan	"(term should be ""quan hệ"") relationship (n.)"
quang	optiskā	bladder
quanh	apkārt	around
quay	pagriezās	turn
que	stieņi	stick
queen	karaliene	queen
queens	karalienes	(proper noun) queens, as in the new york borough
queensland	queensland	queensland
quen	pazīstams	accustomed to
qui	qui	formal
quincy	cidonija	(proper noun) quincy, as in quincy jones
quran	korāns	quran
quy	noteikumiem	"(term should be ""quy ước"") agreement"
quyên	pamati	"(term should be ""quyên góp"") to donate (v.)"
quyến	šarmu	"(term should be ""gia quyến"") family"
quyền	atļauju	right
quyện	sajaukt	mix
quyệt	mānīgs	"(should be ""xảo quyệt"") devious"
quá	arī	over
quái	heck	strange or odd
quán	bārs	hometown
quáng	akls	blind
quát	kliedza	generalize
quân	quan	army (n.)
quãng	apm	optical
quét	skenēt	to sweep (v.)
quê	ciems	countryside
quên	aizmirst	forget
quý	dārgakmeņi	love
quýt	mandarīns	tangerine
quăng	mētāties	to throw (v.)
quĩ	fonds	orbit
quạ	vārnas	crow (con qua)
quạt	ventilatoru	fan
quản	valdošie	"(entire term is ""cai quản"") to manage"
quảng	promo	guangzhou
quấn	ietīt	wrap around
quất	kumkvāts	whip
quấy	maisa	harass
quần	bikses	pants (n.)
quầng	halo	halo
quầy	skaitītājs	stall
quẩy	šūpošana	quay
quẫn	nožēlojami	necessitous
quận	apgabals	county (n.)
quật	rakšana	excavation
quẳng	mētāties	throw
quặc	dīvaini	strange (adj.)
quặng	rūdas	an ore (n.)
quẻ	heksagramma	hexagram
quế	kanēlis	cinnamon (n.)
quết	putas	knead
quệ	nabadzīgs	exhausted
quỉ	velns	demon
quỳ	ceļos	demon (n.)
quỳnh	qunnh	quynh
quỵ	insults	stroke
quỷ	velns	provided
quỹ	fonds	fund
qúy	ceturksnis	quy
r	r	r
rabindranath	rabindranath	rabindranath
race	sacensības	race
rafael	rafaels	rafael
rafale	rafale	(proper noun) rafale, as in dassault rafale
rai	rai	slowly intake
raleigh	raleigh	raleigh
ralph	ralfs	(proper noun) ralph, as in ralph waldo emerson
ram	auns	a name
rama	rama	rama, first name of several rulers of thailand (n.)
ramadan	ramadāns	(proper noun) the fasting month of ramadan
ramayana	ramajana	ramayana
rambus	rambuss	rambus
ran	skrēja	ran
ranch	rančo	ranch
randy	randijs	randy
rang	zvanīja	roast
rangers	rangers	rangers
ranh	robeža	border (ranh gioi)
rao	sludinājums	to announce
rap	reps	rap
raptor	raptors	raptor
rate	likme	rate
rau	dārzeņu	vegetable
ray	staru	rail (n.)
raya	rajas	raya
raymond	raymond	raymond
rađa	radars	radar
reagan	reagan	reagan
real	īsts	real
reanimation	reanimācija	reanimation
reap	pļaut	reap
reef	rifs	reef
regia	regija	regia
reichelt	reichelt	reichelt
ren	mežģīnes	lace (n.)
renaissance	renesanse	renaissance
renault	renault	renault
rené	renē	rene
reo	gredzens	yell
reserve	rezervēt	reserve
resort	kūrorts	resort
reverse	atpakaļgaitā	reverse
revolution	revolūcija	revolution
rey	rej	rey, as in copa del rey
rfid	rfid	rfid
rhodes	rodas	rhodes
rica	rica	rica
ricardo	rikardo	ricardo
ricci	ricci	ricci
richard	richards	richard
richardson	ričardsons	(proper noun) richardson, as in james o. richardson
richie	bagātnieks	(proper noun) richie, as in singer lionel richie
rico	riko	rico, as in puerto rico
riemann	riemann	riemann, as in bernhard riemann, a german mathematician
rimjob	rimjob	rimjob
rin	rin	rin
rising	celšanās	rising
risk	risks	risk
ritchie	rituāls	a name
rivaldo	rivaldo	rivaldo
rivière	rivière	a name
rizal	rizal	rizal
riêng	privāts	own
riêu	riêu	crab
riết	riet	urgently
riềng	galangal	arrowroot
ro	ro	"entire term is ""rui ro""; means ""risk"""
robert	roberts	(proper noun) robert
roberto	roberto	(proper noun) roberto
roberts	roberts	roberts
robespierre	robespierre	robespierre
robin	robins	a name
robinson	robinsons	robinson, as in michelle robinson
rockefeller	rokefellers	rockefeller, as in john d. rockefeller
roddick	roddiks	(proper noun) roddick
rodríguez	rodríguez	rodriguez (n.)
roi	stienis	a stick or switch used for punishment (n.)
roland	rolands	roland
romania	rumānija	romania
rome	romu	rome, as in rome, italy
romeo	romeo	(proper noun) romeo, as in romeo and juliet
rommel	rommel	rommel
ron	ron	ron
ronald	ronalds	ronald, an english first name
ronaldinho	ronaldinho	ronaldinho
rong	aļģes	seaweed (n.)
rosen	rosen	rosen, as in nathan rosen
roth	roth	roth
rotterdam	roterdama	(proper noun) rotterdam
rousseau	ruso	rousseau
router	maršrutētājs	cong noi
rovers	rovers	rovers
rowling	airēšana	rowling
roy	rojs	(proper noun) roy, a name
rpd	rpd	rpd
rtp	rtp	rpt
rudolph	rudolfs	rudolph
rue	rue	rue, as in rue des vases, a street name
rulin	valdi	(proper noun) rulin
rumani	rumāņu	romanian
rumiko	rumiko	rumiko, a japanese first name
rummel	rummel	rummel
run	skriet	tremble
rung	vibrēt	to shake or vibrate (v.)
russian	krievu	(proper adjective) russian
russkaya	ruskaja	(proper noun) russkaya avionika
ruth	rūta	(proper noun) ruth
rutherford	rutherford	rutherford
rutte	rutte	rutte
ruud	rupjība	ruud
ruốc	garneles	pemmican
ruồi	mušas	fly
ruổi	ruoi	rong ruổi=wandering
ruộng	rīsu lauks	"(term should be ""ruộng đất"") farmland (n.)"
ruột	zarnas	internals
rzeczpospolita	rzeczpospolita	rzeczpospolia
rà	izbraukšana	finding
ràng	skaidrs	clear
rành	tekoši	exhaustive
rào	žogs	barrier
rác	atkritumu	gabbage-trash
rách	saplēsts	tear
rái	ūdrs	colander
rán	apcep	fried (adj.)
ráp	montāža	to assemble (v.)
râm	ēnains	shade
râu	bārda	beard or mustache (n.)
rã	pagrimums	out
rãi	bruģis	"(term should be ""rộng rãi"") generous"
rãnh	tranšeja	groove
räikkönen	räikkönen	raikkonen
rèm	aizkars	curtain
rèn	kalšana	train
ré	čīkstēt	re
république	république	republique
rét	auksts	cold
rê	velciet	"(term should be ""rê bóng"") to dribble the ball in soccer (v.)"
rên	čukstēt	moan
rêu	sūnas	moss
rì	čukst	lush (adj.)
rìa	mala	edge
rình	spiegs	to watch for
rìu	cirvis	ax
rít	šņākt	to wail (v.)
rò	noplūde	leak
ròng	tīkls	net
rót	ielejot	to pour (v.)
rô	rūtaini	diamond
rôbôt	robots	robot
rôma	romu	roman
rông	dobi	rising (adj.)
rõ	skaidrs	clear
rùa	bruņurupucis	turtle
rùng	rāpojošs	horror
rút	atsaukt	withdraw
răn	bauslis	commandment
răng	zobu	roasted
rōmaji	rōmaji	romaji
rũ	vilinošs	charm
rơ	auto	"(term should be ""rơ măm"") a minority people living in vietnam"
rơi	kritums	fall
rơm	salmi	straw
rươi	tevi	sand-worm
rước	gājiens	welcome
rưới	apkaisa	to sprinkle (v.)
rưỡi	puse	half
rượt	tramdīt	pursue
rượu	alkohols	wine
rạ	salmu	straw
rạc	diskrēts	discrete
rạch	kanāls	canal
rạng	rītausma	break
rạp	teātri	theater
rải	izkaisīti	spread
rảnh	bez maksas	to be free (adj.)
rất	ļoti	very
rầm	aploks	aggressive
rầu	skumji	sorrow
rẫy	audzēšana	full
rậm	kupls	jungle
rập	arābu	"(term should be ""Ả rập"") arab"
rắc	apkaisa	trouble
rắn	čūska	snake
rằm	pilnmēness	a full moon (n.)
rằng	ka	roasted
rặng	akmens	a row
rẻ	lēts	cheap
rẽ	pagrieziens	"(term should be ""chia rẽ"") to separate or divide (v.)"
rền	vaidēt	pealed
rể	znots	in-law
rễ	saknes	root (n.)
rệp	bļāviens	bug
rệt	izrunāts	clearly
rệu	jā	decay
rỉ	rūsa	leak
rịavũng	rìvà	ria - bay
rỏ	skaidrs	clearly
rối	samudžināts	disorder
rốm	mākoņains	rom
rồ	traks	"(term should be ""điên rồ"") foolish (adj.)"
rồi	jau	and
rồng	pūķis	dragon
rổ	grozs	basket
rỗi	bez maksas	savation
rỗng	dobi	hollow
rộ	burzma	profuse (adj.)
rộn	aizņemts	busy
rộng	plašs	wide
rớt	kritums	drop
rời	pa kreisi	leave
rỡ	izcili	brilliant
rợ	barbari	a savage (n.)
rợn	rāpojošs	scary
rụng	šķūnis	to drop
rủ	uzaicināt	ask
rủi	nelaime	unlucky or unfortunate (n.)
rứa	rứa	rua
rừng	mežs	forest
rửa	mazgāt	to wash (v.)
rữa	mazgāt	to decompose or rot (v.)
sa	sa	to fall or drop (v.)
sabah	sabah	sabah
sachsen	sachsen	sachsen
saddam	saddams	(proper noun) saddam, as in saddam hussein
safari	safari	safari
safin	safīns	safin
sahara	sahara	sahara
sai	nepareizi	wrong
saigon	saigons	saigon
saintdenis	saintdenis	saint-denis
sakura	sakura	sakura
salem	salems	(proper noun) salem, as in the city
salvador	salvadors	salvador
salzburg	zalcburga	salzburg
samhain	samhain	samhain
samo	samo	samo, the name of the first slavic ruler
samoa	samoa	(proper noun) samoa
samphan	sampans	samphan
samsung	samsung	samsung
samuel	samuels	samuel
samuelson	samuelsons	(proper noun) samuelson
samurai	samuraju	samurai
samut	samuts	(proper noun) samut, as in samut prakan in thailand
san	san	level
sanchez	sanchez	sanchez
sang	uz	to
sango	sango	sango, a language spoken in africa
sangraal	sangraal	sangraal
sanh	dzimšanas	bear
sanktpeterburg	sanktpeterburg	sankt-peterburg
santos	santos	santos, as in footballer cristiano ronaldo dos santos aveiro of portugal
sao	zvaigzne	how
sap	sulas	sap
sapa	sapa	sapa
sapiens	sapiens	sapiens
sar	sar	sar
sarah	sāra	sarah, as in sarah pierce
sarawak	sarawak	(proper noun) sarawak, a malaysian state on the island of borneo
sarcoma	sarkoma	sarcoma
sardinia	sardīnija	sardinia
sary	sary	(proper noun) sary, as in ieng sary
saturanga	saturanga	saturanga
saturday	sestdiena	saturday
sau	pēc	after (adv.)
saudi	saūda	(proper noun) saudi, as in saudi arabia
saunière	saunière	saunière
scandinavia	skandināvija	scandinavia
schafer	schafer	schafer, as in john c. schafer
schengen	schengen	schengen
schiller	šillers	schiller
schlesinger	schlesinger	schlesinger
schneider	schneider	schneider, a last name
schumacher	šūmahers	schumacher, as in michael schumacher
schuschnigg	schuschnigg	(proper noun) schuschnigg, as in kurt schuschnigg of austria
schuster	blēdis	schuster
schwarzschild	schwarzschild	schwarzschild
scotland	skotija	scotland
scots	skoti	(proper noun) scots
scott	skots	scott
scream	kliedz	scream
scud	skaustīt	scud
scuderia	scuderia	scuderia
sdram	sdram	sdram
search	meklēt	search
seattle	sietla	(proper noun) seattle, washington
secret	slepeni	bi mat
sedna	sedna	(proper noun) sedna
see	redzēt	see
sejm	sejm	(proper noun) sejm
selena	selēna	selena
semit	semit	(proper noun) semit
sen	lotoss	lotus
sense	jēga	sense
september	septembris	(proper noun) the month of september
serbia	serbija	serbia
sergeyevich	sergejevičs	(proper noun) sergeyevich
seri	sērijas	series
service	apkalpošana	service
sesshomaru	seshomaru	a name
seth	septītā	seth
seto	seto	seto
sextus	sextus	sextus
sexy	seksīgs	sexy
seymour	seymour	seymour
seyssinquart	seyssinquart	(proper noun) seyss-inquart
shah	šahs	shah
shaman	šamanis	the shaman religion
shan	šans	shan
shane	shane	(proper noun) shane, an english first name
shankly	šausmīgi	(proper noun) shankly, as in bill shankly
shaolin	šaolīns	shaolin, as in the shaolin temples
sharpay	sharpay	sharpay, as in sharpay evans
shawn	shawn	shawn
sherlock	šerloks	a name
shi	shi	shi
shia	šiija	shia
shiite	shiite	shiite
shikoku	šikoku	shikoku, a japanese island (n.)
shinichi	shinichi	shinichi
shinoda	šinoda	shinoda, as in mike shinoda
shirakami	shirakami	(proper noun) shirakami
shirakawago	širakawago	(proper noun) shirakawa-go
shiva	šiva	shiva
shoal	seklums	(proper noun) shoal
shonen	shonen	shonen
shop	veikals	shop
short	īss	short
showcase	vitrīna	a name
shōnen	shōnen	shonen
siberi	siberi	siberi
sicilia	sicīlija	sicilia
sicily	sicīlija	sicily, a city in italy
sidney	sidney	(proper noun) sidney, as in sidney nolan
siem	siem	siem
siemens	siemens	siemens
sierra	sierra	(proper noun) sierra
sikh	sikh	sikh
sikorsky	sikorsky	a name
silas	silas	silas
silesia	silēzija	silesia
silic	silīcijs	silicon
silicat	silikāts	silicate
silva	silva	(proper noun) silva, as in carlos silva
silvestris	silvestris	silvestris
simone	simone	simone
sinai	sinai	sinai, as in mount sinai
sinensis	sinensis	sinensis
sing	dziedāt	sing
sinh	dzimis	genital
sip	malks	sip
sirô	sīrups	name of a member
sistema	sistema	(proper noun) sistema
siu	siu	siu
siêu	super	super
siết	pievelciet	to cut off (v.)
sky	debesis	sky
skype	skype	skype
skyteam	skyteam	skyteam
sl	sl	sl
slav	slāvi	(proper noun) slav
slavơ	slāvi	slavic
slytherin	slīterīns	(proper noun) slytherin, as in salazar slytherin of the harry potter series
sm	sm	sm
smg	smg	smg
smith	kalējs	smith
smithsonian	smithsonian	smithsonian
so	tātad	compare
société	société	societe
socrates	sokrāts	socrates
sohee	sohee	a korean name
soho	soho	soho
soi	tāpēc es	look/stare soi sáng=enlight
solaris	solaris	(proper noun) solaris
som	som	(proper noun) som, as in kampong som
somme	somme	somme
sonata	sonāte	sonata
song	dziesma	however (adv.)
sony	sony	sony
soo	tā	soon
sophie	sophie	(proper noun) sophie, a first name
sopwith	sopwith	a name
sorbonne	sorbons	sorbonne, the university in paris (n.)
sos	sos	sos
soul	dvēsele	soul
soát	kontrole	control
soạn	komponists	compose
spears	šķēpi	spears
spellman	pareizrakstnieks	spellman
spence	spence	(proper noun) spence
spencer	spencer	(proper noun) spencer
spielberg	spīlberga	(proper noun) spielberg, as in steven spielberg
sports	sports	sports
sri	sīrija	(proper noun) sri, as in sri lanka
ss	ss	ss
st	st	st.
stalingrad	staļingrada	stalingrad
stamford	stamford	this is a name
stand	stāvēt	stand
stanford	stanfords	stanford, as in stanford university
stanley	stallis	stanley
starr	zvaigznīte	a name
startin	startin	bat dau
status	statusu	status
stdc	stdc	stdc
stefan	stefans	stefan
steiermark	steiermark	steiermark
steiner	steiner	steiner
stelzer	stelzer	stelzer
stennis	stennis	stennis
stephen	stefans	stephen
stephenie	stephenie	"stephenie, as in stephenie meyer, author of ""twilight"""
sterling	sterliņu	a name
steve	stīvs	steve
stevens	stīvensa	(proper noun) stevens, as in amanda stevens
stevenson	stīvensons	stevenson
stevie	stevijs	stevie
stewarthannah	stewarthannah	stewart/hannah
stf	stf	stf
stimson	šķībs	stimson, as in henry lewis stimson, former secretary of war
stockholm	stockholm	a name
stones	akmeņi	stones
storting	storting	storting
strasberg	strasberga	strasberg
strauss	strauss	strauss
street	iela	street
struct	būvēt	struct
stt	stt	order number
stuart	stuart	stuart
stuttgart	štutgarte	(proper noun) stuttgart, a city in germany
styx	styx	(proper noun) styx, as in the river styx
stéfano	stéfano	stefano
su	su	condom
subakhi	subakhi	subakhi
suez	suez	(proper noun) suez
suharto	suharto	suharto
sukarno	sukarno	(proper noun) sukarno,  president of indonesia
sulfua	sulfīds	sulfide
sulu	sulu	sulu
sum	summa	reunite
sumatera	sumatera	sumatera
sumatra	sumatra	(proper noun) the island of sumatra
sumitomo	sumitomo	sumitomo
summer	vasara	summer
summerslam	summerslam	(proper noun) summerslam
sun	saule	sun
sunday	svētdiena	(proper noun) sunday
sung	vīģes	supplement
sunni	sunnīti	sunni
sunsilk	sauļošanās	sunsilk, a hair products company
super	super	super
suriname	surinama	suriname
susan	sūzana	(proper noun) susan
susilo	susilo	(proper noun) susilo
sutra	sutra	sutra
suub	suub	a name
suvp	suvp	suv-p
suy	neveiksme	decrease
suê	tātad	lush
suôn	gludi	smooth
suất	produktivitāte	number
suối	sildīšana	stream
suốt	visā	through/all over
suồng	gluda	overfamiliar
svd	svd	svd
swan	gulbis	swan
swaziland	svazilenda	swaziland
sweet	salds	sweet
sy	sy	sy
sydney	sidneja	(proper noun) sydney, a city in australia
symantec	symantec	symantec
sync	sinhronizēt	sync
syria	sīrija	syria
sài	sai	"(term should be ""sơ sài"") something done without care (adv.)"
sàn	grīda	san
sàng	siets	ready
sành	terakota	"(term should be ""sành sứ"") pottery"
sào	pole	"(term should be ""sào huyệt"") den or hideout (n.)"
sá	sipunculus	road
sách	grāmata	list
sái	nepareizi	sai
sám	nožēlojams	penitent
sáng	spīdēšana	light
sánh	salīdzinošais	compare
sáo	flauta	flute
sáp	vasks	merger
sát	tuvu	"(term should be ""quan sát"") to watch or observe (v.)"
sáu	seši	six
sâm	žeņšeņs	sam
sân	pagalms	"(should be ""sân khấu"") a stage"
sâu	dziļi	deep
sã	sã	flippant
sãi	nepareizi	pagoda warden
são	são	sao, as in sao paolo, brazil
sét	apgaismojums	clay
sê	se	sepon
sêri	sērijas	series
sêu	sūnas	seu tet
sính	students	betrothal gifts
síp	kipra	cyprus
sít	saspringts	close
sò	gliemene	oyster
sòng	kazino	casino
sóc	vāvere	"(should be ""sóc trăng"") a vietnamese town"
sói	vilks	wolf
sóng	vilnis	wave
sót	izlaidība	to miss (v.)
sô	numuru	than
sôi	vārot	vibrant
sông	upe	river
sùng	ziedošanās	cult
sú	melnais tīģeris	a type of mangrove (n.)
súc	liellopi	animal
sún	izlietne	sun
súng	pistoles	gun
súp	zupa	source
sút	nošauts	reduce
săn	medības	to hunt
sơn	krāsot	a mountain
sư	profesors	lion
sưa	piens	filled with
sưng	pietūkums	swell
sưu	kolekcijas	collection
sương	rasa	dew (n.)
sướng	laimīgs	high
sườn	pusē	slope
sưởi	sildīšana	heat
sạch	tīrs	clean
sạn	viesnīca	hotel
sảm	spilgti	sam
sản	produkcija	reproductive
sảng	svaigi	sonorous
sảnh	zāle	a hall, as in the rock and roll hall of fame
sấm	pērkons	ginseng
sấu	krokodils	crocodile
sấy	žāvēšana	dry
sầm	slams	crowded
sầu	melanholija	sad
sẩn	papulas	coarseness
sẫm	tumšs	dark
sập	sabrukt	destroy
sắm	iepirkšanās	shopping
sắn	manioka	cassava (n.)
sắp	gandrīz	soon
sắt	dzelzs	"(term should be ""sắt son"") constant (adj.)"
sẵn	pieejams	available
sẹo	rēta	scar
sẻ	būs	share
sẽ	būs	will
sọ	galvaskauss	brain
sọc	svītras	stripe
sỏ	pļāpīgs	oligarchy
sỏi	grants	gravel
số	numuru	"(term should be ""số lượng"") quantity (n.)"
sốc	šokēts	shock
sống	dzīvo	live
sốt	drudzis	fever
sồi	ozols	oak
sổ	grāmata	window
sớ	būs	document
sớm	drīz	som
sờ	pieskarties	touch
sỡ	palaida garām	colorful
sợ	nobijies	afraid
sợi	dzijas	fibers
sục	džakuzi	"(term should be ""sôi sục"") to boil"
sụn	skrimslis	cartilage
sụp	sabrukt	collapse
sụt	kritums	drop
sủa	miza	bright
sủi	putojošs	sparkling
sủng	harizmātisks	favored
sứ	keramikas	embassy
sứa	medūzas	jellyfish (n.)
sức	spēks	strength
sứt	sasmalcināts	cleft
sừng	rags	sừng sững= huge
sử	vēsture	"(term should be ""sử dụng"") to use (v.)"
sửa	remonts	repair
sửng	šokēts	startling
sửu	vērsis	cow
sữa	piens	milk
sự		situation
ta	ta	us or our
tae	tae	(proper noun) tae
tag	birka	tag
tai	auss	ear
taiji	taiji	(proper noun) taiji
taipei	taipeja	taipei
taiwan	taivāna	taiwan
taj	taj	taj, as in taj mahal
tajikistan	tadžikistāna	tajikistan
tajima	tajima	tajima
tajiri	tajiri	tajiri
takahashi	takahashi	(proper noun) takahashi
taklamakan	taklamakan	taklamakan
tali	tali	thallium
taliban	talibu	taliban
talmud	talmuds	talmud
tam	tam	three (n.)
tamoxifen	tamoksifēns	tamoxifen
tanaka	tanaka	tanaka
tang	sērojot	funeral
tanh	netīrs	deserted
tankōbon	tankōbon	tankobon, as in a type of japanese literature
tanzania	tanzānija	tanzania
tao	es	(proper noun) tao, a chinese name
tarim	tarim	tarim
task	uzdevums	task
tasman	tasmans	tasman, as in abel tasman
tasmania	tasmānija	tasmania, a place
tau	tau	tau
taxi	taksometrs	taxi
tay	roka	hand
taylor	teilors	taylor
tbt	tbt	tbt
tchad	tchad	tchad
tcm	tcm	tcm
tcp	tcp	tcp
technical	tehnisks	technical
ted	ted	(proper noun) ted
teddy	rotaļu	teddy, as in teddy lupin, a character in the harry potter series
telecom	telekomunikāciju	telecom
telekom	telekom	telekom
telex	telekss	telex
telnet	telnet	telnet
tem	zīmogs	stamp
temple	templis	temple
temujin	temujin	temujin
temur	temur	(proper noun) temur, as in temur oljeitu
tenxơ	kartelis	tensor
teo	atrofiska	atrophy
terengganu	terengganu	(proper noun) terengganu
territories	teritorijas	territories
terry	frotē	terry
terumbu	terumbu	(proper noun) terumbu
tet	tet	tet
texas	texas	(proper noun) the state of texas
tgv	tgv	tgv
tha	attaisnojums	to forgive (v.)
thai	grūtniece	pregnant
thailand	taizeme	thailand
tham	alkatība	involved
thames	thames	thames
than	kokogles	coal
thang	kāpnes	ladder
thanh	bārs	youth
thani	nekā	thani
thao	sports	sport
thau	misiņš	a basin (n.)
thay	tā vietā	change
thcn	tūkst	vocational school
thcs	thcs	secondary
thdq	tūkst	thdq
thebes	thebes	thebes
their	viņu	their
them	viņiem	plus
then	tad	key
theo	saskaņā ar	according to
theory	teorija	thẻoy
theravada	theravada	theravada
theres	theres	there
theseus	šie	theseus, the greek hero
thi	eksāmens	competition (n.)
thich	piemēram	explanation
thien	thien	sky
third	trešais	thỉd
thiu	sastāvējies	buồn thiu= sad/boring
thiêm	thiêm	thiem
thiêng	svēts	"(term should be ""thiêng liêng"") sacred or holy"
thiếc	alva	tin
thiến	neitrāls	castrate
thiếp	karti	concubine
thiết	komplekts	"(term should be ""cần thiết"") necessary (adj.)"
thiếu	īss	lack
thiềm	sirpis	crescent
thiền	meditācija	buddhist (adj.)
thiển	šovs	superficial
thiểu	nepilngadīgs	minimum
thiện	labi	good
thiệp	karti	intervene
thiệt	tiešām	damage
thiệu	ievads	"(term should be ""giới thiệu"") to introduce (v.)"
tho	tu	tho
thoa	dab	combination
thoai	tei	gentle
thomas	thomas	thomas
thompson	tompsons	thompson
thong	siksna	(proper noun) thong, as in ang thong
those	tiem	those
thoái	regresīvs	deterioration
thoán	uzminēt	usurpation
thoáng	gaisīgs	"(term should be ""thoáng qua"") to pass quickly"
thoát	izeja	drainage
thoại	tālrunis	telephone
thoạt	pēc pirmā acu uzmetiena	just (adv.)
thoả	galā	compromise
thoải	ērti	"(term should be ""thoải mái"") comfortable or relaxing (adj.)"
thoảng	ik pa laikam	"(term should be ""thỉnh thoảng"") occasionally (adv.)"
thoắt	pamudināt	suddenly
thpt	thpt	high school
thriller	trilleris	thriller
thskts	tūkst	phd- architect
thua	zaudēt	defeat
thumb|các	īkšķis |	thumb|many
thunderbolt	pērkons	thunderbolt
thung	ieleja	valley
thuyên	pārvietojums	a name
thuyết	teorija	theory
thuyền	laiva	boat
thuê	īrēt	employ
thuần	tīrs	"(term should be ""đơn thuần"") pure (adj.)"
thuẫn	konflikts	support
thuận	plusi	favourable
thuật	art	term
thuế	nodoklis	tax
thuốc	medicīna	medicine (n.)
thuộc	piederēt	belong
thuớc	ūdens	"(term should be ""kích thước"") dimensions of an object"
thuờng	parasti	usually
thuở	bērnība	period
thuỵ	thuy	"(term should be ""thụy Điển"") the nation of sweden (proper noun)"
thuỷ	thuy	water
thvn	tūkst	vietnam television
thy	tavs	thy
thà	drīzāk	honest
thành	forts	"(term should be ""hình thành"") to take shape"
thày	skolotājs	teacher
thác	kaskāde	harvest
thách	izaicinājums	challenge
thái	taizemietis	attitude
thám	detektīvs	to spy (v.)
tháng	mēnesī	month (n.)
thánh	sv	a holy person; a saint (n.)
tháo	noņemt	"(term should be ""tháo chạy"") to run with abandon"
tháp	tornis	tower
thâm	dziļi	penetrate
thâu	lenti	to collect (v.)
thây	redzēt	body
thãi	sūdi	superabundant
thèm	alkst	desire
thép	tērauda	steel
thét	kliedza	shout
thê		category
thêm	vairāk	more
thêu	īre	to embroider (v.)
thìa	karote	spoon
thìn	tad	(proper noun) thìn, the year of the dragon
thình	pēkšņi	"(term should be ""thình lình"") suddenly"
thí	eksperimenti	(with word du) for example
thít	thit	(proper noun) mân thít, a district in vietnam
thò	iebāza	tho
thòi	trūkums	"(term should be ""thiệt thòi"") to cost (adv.)"
thóc	nelobīts	grain (n.)
thói	ieradums	a habit (n.)
thô	raupja	rough, old-fashioned
thôi	aiziet	only
thông	informēts	"(term should be ""thông thường"") usual (adj.)"
thù	naids	"entire term should be ""ke thu""; means ""enemy"""
thùng	atkritumu tvertne	barrel
thùy	daiva	thuy
thú	interesanti	"(should be ""thích thú"") pleasurable"
thúc	beigas	push
thúy	thuy	thuy
thăm	apmeklējums	visit
thăng	reklamēts	helicopter
thơm	smaržīgs	aromatic
thư	vēstules	"(term should be ""ung thư"") cancer (n.)"
thưa	dārgs	sparse
thương	mīlestība	love
thước	valdnieks	ruler
thường	bieži	usually (adv.)
thưởng	atlīdzība	to reward (v.)
thược	thud	(proper noun) thược
thượng	augšējā	upper
thạc	meistari	master
thạch	želeja	rock or stone (n.)
thạnh	nekā	thanh
thạo	eksperts	fluent
thả	nomest	"(term should be ""thả lỏng"") to let loose (v.)"
thải	atkritumi	waste
thảm	paklājs	carpet or rug (n.)
thản	rāms	calmly
thảo	skaists	"(term should be ""hội thảo"") a workshop (n.)"
thấp	īss	low (adj.)
thấu	caurspīdīgs	penetrate
thầm	klusi	"(term should be ""thì thầm"") to whisper (v.)"
thần	dievs	"entire term should be ""tinh than""; means ""of the mind"""
thầy	skolotājs	teacher (n.)
thẩm	zvērinātie	osmotic/leak
thẫm	tumšs	dark
thận	nieres	careful
thập	krustu	tens
thật	īsts	true (adj.)
thắm	ziedlapa	tham
thắn	atklāti sakot	frank
thắng	uzvarēja	win
thắngthua	uzvarot	win-lose
thắp	viegls	light
thắt	sasiet	tense
thằn	ķirzaka	"entire term should be ""than lan""; means ""lizard"""
thằng	puisis	a derogatory term for a man (n.)
thẳm	dziļi	"(term should be ""thăm thẳm"") extremely deep (adj.)"
thẳng	taisni	horizontal
thặng	pārpalikums	surplus
thẹn	kauns	shameful
thẻ	karti	card
thế	tātad	"with word ""tu,"" means ""posture"" or ""a position"""
thếp	tērauda	steel
thề	zvēru	swear
thềm	plaukts	shelf
thể	būt	maybe
thỉnh	uzaicināt	"(term should be ""thỉnh thoảng"") occasionally"
thịnh	modē	prosperous
thịt	gaļa	meat (n.)
thọ	ilgmūžība	phu tho
thọc	žoklis	jab
thỏ	trusis	rabbit
thỏa	vienošanās	"(term should be ""thoả thuận"") to come to an agreement (v.)"
thỏi	lietnis	a bar (n.)
thối	sapuvis	smelly
thốt	izteicās	scream
thồ	komplekts	to transport via horse (v.)
thổ	zeme	"(term should be ""lãnh thổ"") territory (n.)"
thổi	sitiens	blow
thớt	kapu dēlis	sparse
thời	laiks	period
thở	elpa	breathe
thợ	strādnieks	craftman
thụ	receptoru	"(term should be ""thụ thai"") to become pregnant"
thục	šu	(proper noun) a vietnamese first name
thụt	ievilkts	clyster
thủ	galvenais	masturbate
thủa	thua	during childhood
thủng	perforācija	having holes
thứ	lietas	no.
thức	nomodā	way
thừa	lieks	redundant
thừng	virve	"(term should be ""thẳng thừng"") mercilessly"
thử	uzmērīt	try
thửa	pakomāts	square
thự	villa	mansion
thực	reāli	perform
ti	ti	titov
tia	staru	ray
tiananmen	tiananmen	tiananmen
tiara	tiāra	tiara
tibet	tibeta	(proper noun) tibet
tigris	tigris	tigris
tiliaceus	tiliaceus	hoa dam but
tim	sirds	heart
timor	taimeris	timor
timothy	timotejs	timothy
tin	ticēt	believe
tinbắc	ziņa	file bac
tincầu	alvas tilts	file bridge
tinh	planēta	"(term should be ""tinh dịch"") sperm (n.)"
tinnhà	tinhome	folder: house
tinsông	ziņas	file river
tinthị	desmitais	file: town
tirol	tirols	tirol
tisdale	tisdale	tisdale
tish	tish	(proper noun) tish
tissa	tissa	(proper noun) tissa, as in moggaliputta tissa
tivi	televīzija	television
tizard	ķivere	(proper noun) tizard
tiên	vispirms	first
tiêu	pipari	"entire term should be ""tieu chuan""; means ""a requirement"""
tiếc	nožēlo	"(term should be ""tiếc thương"") to pity (v.)"
tiếm	dumjš	seize
tiến	augšā	operate
tiếng	valoda	language
tiết	sekrēcija	abstinence/intensity
tiếu	dumjš	"(should be ""đàm tiếu"") to sneer"
tiềm	potenciāls	potential
tiền	nauda	money (n.)
tiều	sūdi	(proper noun) the name of a poet
tiểu	urinēt	tiểu sử= biography
tiễu	liu kungs	patrol
tiệc	svētki	party
tiệm	veikals	shop
tiện	ērti	mean
tiệp	čehu	gustav franck
tiệt	jāšanās	sterilize
tncs	tncs	communist youth union
tngt	tngt	traffic accidents
tnhh	ierobežots	limited
toang	toang	fast
tobago	tobago	tobago
toei	toei	toei
tokugawa	tokugawa	tokugawa
tokyo	tokyo	tokyo, the capital of japan
tokyopop	tokopops	tokyopop
tomas	tomas	(proper noun) tomas
tommy	tomijs	tommy
tomoyo	tomoyo	tomoyo
tony	tonijs	tony
toonami	toonami	(proper noun) toonami
top	tops	top
torino	torino	torino, as in the italian city
toriyama	torijama	(proper noun) toriyama
tottenham	t tottenham	tottenham
tourism	tūrisms	tourism
tourist	tūrists	tourist
toyama	tojama	toyama
toyota	rotaļlieta	(proper noun) toyota
toà	tiesa	office
toàn	droši	entire or whole (adj.)
toán	matemātika	team
toát	labi	to exude or emit, as in sweat (v.)
toạ	koordinātas	locate
toại	plkst	satisfaction
toả	izstarot	spread
tp	tp	city
tphcm	tphcm	ho chi minh city
tphồ	pilsēta	city ho
tpvĩnh	pilsēta	vinh city
tqlc	tqlc	marine
trafalgar	trafalgārs	(proper noun) trafalgar
trafford	traffords	trafford in greater manchester
trai	gliemenes	boy
trang	lappuse	a page (n.)
tranh	bildes	to compete (v.)
trao	izdalīja	reward
trau	trau	polish
tre	bambusa	bamboo (n.)
treo	pakārt	hang
tri	tri	tri
tribune	tribune	a name
trinh	jaunava	"(should be ""trinh bạch"") virtuous"
trinidad	trinidad	trinidad
trinity	trīsvienība	trinity
tristan	tristans	tristan
triết	filozofija	philosophy
triền	trīne	"(should be ""triền miên"") endless"
triều	plūdmaiņas	court
triện	ronis	stamp
triệt	pamatīgi	completely
triệu	miljons	a million
tro	pelni	ashes
troia	troja	troy
trondheim	trondheim	trondheim
trong	iekšā	inside (adv.)
true	taisnība	true
truman	truman	(proper noun) truman
trung	vidus	"(term should be ""trung gian"") agent (n.)"
trungnhật	godīgums	china-japan
truong	truong	truong
truyên	trujens	story
truyện	stāsts	story
truân	truāns	arduous
truất	atdalītāji	cancel
truởng	priekšnieks	leader (n.)
truỵ	melot	depraved
trà	tēja	tea (n.)
tràm	cajuput	melaleuca
tràng	kols	"entire term should be ""truc trang""; means ""rectum"""
trào	izvirdums	movement
trác	trac	trac
trách	vainīgi	blame
trái	pa kreisi	against
trán	piere	forehead
tráng	pārklāts	to coat (v.)
tránh	izvairīties	to avoid (v.)
tráo	krāpnieciski	tráo trở= liar/betrayal/treacherous
tráp	kaste	casket
trát	orderi	pile
trâm	piespraude	a type of elegant hairpin (n.)
trân	ar laba vēlējumiem	respect
trâu	bifeļu	a last name
trãi	izkaisīti	trai
trèo	kāpt	climb
trên	ieslēgts	above
trình	iesniegt	process
trí	prāts	intellectual
trích	izraksts	to extract (v.)
trò	triks	role
tròn	raunds	rounding
trói	sasiets	tie
trôi	dreifējošs	afloat
trông	izskatās	look
trùm	priekšnieks	cover
trùng	sakrīt	"(should be ""tinh trùng"") sperm"
trùy	trujs	something to with monk
trú	iekāpšana	residence
trúc	bambusa	structure
trăm	simts	hundred
trăn	pitons	"(term should be ""trăn trở"") to ponder (v.)"
trăng	mēness	moon
trĩ	hemoroīdi	hemorrhoids
trũng	nogrimis	medium
trơ	inerts	bare
trơn	slidens	slippery (adj.)
trư	trū	a pig (n.)
trưa	pusdienlaiks	noon (n.)
trưng	rekvizācija	symbolic
trưngcông	izstādīts	truongcong
trương	truong	policy
trước	pirms tam	front
trước 	pirms tam	front
trướng	paplašināšana	expand
trườn	pārmeklēt	crawl
trường	skola	case
trượng	kaducejs	a unit of length used in vietnam equal to 4 meters (n.)
trượt	slīdēt	slide
trạch	trach	ze
trại	nometne	camp
trạm	stacija	station
trạng	stāvoklis	situation
trạo	tao	trao
trả	maksāt	to return
trải	piesegt	spread
trảm	cajuput	beheaded
trảo	mačetēm	trao
trấn	pilsēta	town
trấu	rīsu miziņa	rice skin
trầm	dziļi	depression
trần	pliks	tran
trầu	beteles	trầu
trầy	saskrāpēts	scratch
trẩy	lielība	pilgrimage
trẫm	es esmu	i
trận	spēle	battle
trật	izmežģīju	order
trắc	biometrija	"(term should be ""trắc ẩn"") to have pity (adj.)"
trắng	balts	white
trặc	žaga	"entire phrase is ""truc trac""; means ""problem"""
trẻ	jauns	youth
trễ	vēlu	late
trệ	sastingusi	bamboo
trị	ārstēšana	cure
trịnh	līkločs	trịnh, a vietnamese last name
trọ	krogs	motel
trọn	pilns	whole
trọng	svarīgs	serious
trỏ	norādes	index
trối	fināls	last words
trốn	paslēpties	to hide
trống	tukšs	in
trồi	parādās	to emerge (v.)
trồng	augt	plant
trổ	šovs	to burst open or display
trỗi	rašanās	rise
trội	dominējošais	better
trộm	zagļi	theft
trớn	glāstīt	"(term should be ""mơn trớn"") to fondle or caress (v.)"
trời	dievs	sun
trợ	atbalstu	support
trụ	birojs	universe
trục	ass	"(term should be ""khu trục"") fighter, in reference to planes (adj.)"
trụi	kails	"(term should be ""trơ trụi"") bare (adj.)"
trứ	trū	famous
trứng	olu	egg
trừ	mīnus	except
trừng	atspīdums	punish
trừu	aitas	abstract
trữ	glabāšana	reserve
trực	darbā	direct
ts	ts	phd
tt	tt	news
tua	tausteklis	fringe
tucker	draņķis	tucker, an english last name
tudor	tudors	(proper noun) tudor, as in the tudor family
tukhachevsky	tukhachevsky	(proper noun) tukhachevsky
tulip	tulpe	tulip
tum	tum	tum
tung	mētāties	release
tupolev	tupolevs	tupolev, as in alexei tupolev
tuscan	toskāna	(proper noun) tuscan
tutsi	tutsi	(proper noun) tutsi
tuvalu	tuvalu	(proper noun) tuvalu, a polynesian island nation
tuy	tomēr	however
tuyên	paziņo	"(should be ""tuyên ngôn"") a declaration"
tuyết	sniegs	snow (n.)
tuyền	tuyen	tuyen
tuyển	pieņemšana darbā	recruit
tuyệt	lieliski	excellent (adj.)
tuân	pakļauties	comply
tuông	flush	jealous
tuý	tuyý	drug
tuần	nedēļā	week
tuế	minnows	years
tuệ	gudrība	intelligence
tuốc	noplūkšana	turbine
tuổi	gadus vecs	age
tuộc	astoņkāji	octopus
tuột	nošļukt	slip
tuỳ	neobligāti	depend
tv	televīzija	tv
tvb	tvb	tvb
twin	dvīnīte	twin
twitter	twitter	twitter
ty	ty	company
type	tips	type
typhon	taifons	typhon
tà	ļaunums	we
tài	laime	talent (n.)
tàn	pelni	dying
tàng	muzejs	"(should be ""bảo tàng"") a museum"
tành	tanh	shatter
tàu	kuģis	ship
tá	duci	"(term should be ""thiếu tá"") major (n.)"
tách	kauss	to separate
tái	re	return
tám	astoņi	eight
tán	nojume	support
tánh	tanh	life
táp	krāns	to lap at (v.)
táu	vainīgs	ashton
tâm	centrā	tâm
tâu	mans kungs	peach
tây	uz rietumiem	western
tâynam	westnam	"(should be ""tây-nam"") southwest"
tã	autiņi	diaper
tét	skandāls	tet
tê	sastindzis	numb
tên	vārds	name (n.)
tì	liesa	to lean on (v.)
tìm	atrodi	find
tìmdiệt	meklēt	find-kill
tình	mīlestība	sex
tía	violets	dad
tích	produkts	"(term should be ""tích cực"") to be zealous (adv.)"
tím	violets	purple
tín	kredītus	"(entire term should be ""tín dụng"") credit"
tít	virsraksts	"(term should be ""tít mù"") very far away (adv.)"
tò	zinātkāre	curious
tòa	tiesa	a court
tòi	sīkumi	"(term should be ""tìm tòi"") to search doggedly for something (v.)"
tòng	tongs	tòng, a last name
tóm	apkopojums	summary
tô	bļoda	car
tôi	es	i
tôm	garneles	shrimp
tôn	gofrēts	venerate
tông	kartons	tông, as in lê thánh tông; first name of an ancient vietnamese emperor
tù	cietums	prison
tùng	rezerves	tung
tùy	neobligāti	depend on
túc	pietiekamība	"(term should be ""bổ túc"") to give a refresher course (v.)"
túi	rokassomu	pocket
túm	greifers	catch
túng	neveikli	confuse
túp	būda	hut
túy	narkotiku	"(term should be ""thuần túy"") pure (adj.)"
tý	žurka	mouse, as in year of the mouse
tăm	zobu bakstāmais	"(term should be ""tiếng tăm"") reputation"
tăng	palielināt	increase
tĩnh	statisks	calm
tơi	es	ragged
tư	no plkst	posture
tưng	drebošs	"(term should be ""tưng bừng"") joyously (adv.)"
tươi	svaigi	fresh
tương	līdzīgi	"(term should be ""tương tự"") to be similar to"
tước	noņemšana	title (n.)
tưới	laistīšana	irrigation
tướng	vispārējs	prime minister (thu tuong)
tường	sienas	"a common vietnamese first name; means ""wall"""
tạ	stienis	weight
tạc	skulptūra	"(term should be ""oanh tạc"") to bomb from the air (v.)"
tại	iekšā	survival
tạm	pagaidu	temporary
tạo	izveidot	create
tạp	žurnāls	"(should be ""hỗn tạp"") a jumble or mish-mash"
tả	apraksts	describe
tản	izkliedēšana	disperse
tảng	platforma	platform
tấc	collas	inch
tấm	šķīvji	mirror
tấn	tonnu	tan
tấp	velk	crowded
tất	zeķes	all
tấu	instrumentāls	tau
tầm	spēles	range or extent (n.)
tần	biežums	"(term should be ""tần số"") frequency (n.)"
tầng	grīda	layer
tầu	vilciens	ship
tẩm	piesūcināts	soak
tẩy	dzēšgumija	to bleach
tận	beigas	dedicated
tật	invaliditāte	disease
tắc	slēdži	priciple
tắm	duša	bathing
tắt	izslēgt	initial
tặc	hakeri	"(term should be ""hải tặc"") a pirate (n.)"
tặng	ziedot	donate
tẻ	drab	lẻ tẻ= scattered
tết	tet	(proper noun) the vietnamese new year
tếxã	ekonomiski	economy - society
tề	qi	tidy
tể	mister	lord
tệ	slikti	bad
tệp	failu	file
tỉa	sagrieziet	"(term should be ""bắn tỉa"") to snipe"
tỉnh	provinces	province
tị	skaudība	refugee
tịch	priekšsēdētājs	"(""chủ tịch"") president or chairman"
tọa	koordinātas	"(term should be ""chủ toạ"") chairman (n.)"
tỏ	izteikts	to
tỏa	izstarot	radiate
tỏi	ķiploki	garlic
tốc	ātrums	speed
tốn	izmaksas	to cost (v.)
tống	eskorts	dispose
tốp	grupa	top
tốt	labi	good
tồi	slikti	bad
tồn	pastāvēt	exist
tổn	ievainot	damage
tổng	kopā	president
tộc	klans	"(term should be ""dân tộc"") a race or people"
tội	grēks	crime
tột	ekstrēms	extreme
tớ	es	servant
tới	nākamais	to the point
tờ	lapa	paper/document
tởm	pretīgi	disgusting
tục	nelietīgs	"(term should be ""tập tục"") customs or practices"
tụy	aizkuņģa dziedzeris	"(term should be ""tận tụy"") devoted (adj.)"
tủ	skapji	shelf
tủi	slikti	humiliated
tủy	smadzenes	spine
tức	tūlītēju	i.e.
từ	no plkst	from
từng	kādreiz	each
tử	nāve	lion (su tu)
tửu	alkohola tolerance	wine
tự	sevi	"(term should be ""tương tự"") like or similar to (adv.)"
tựa	nosaukums	lean
tựu	sasniegumi	achievement
tỵ	čūska	the han name for the year of the snake, according to the chinese zodiac
tỷ	miljardus	billion
u	u	tumor
ua	ua	ua
uae	uae	uae
ubuntu	ubuntu	ubuntu
uc	uc	uc
uchiha	uchiha	uchiha
uefa	uefa	uefa
uh	nu	uh
uk	uk	uk
ukiyoe	ukiyoe	ukiyoe
ukraina	ukraina	ukraine
ulsan	ulsan	ulsan
umm	umm	umm
un	un	(proper noun) un, as in chung un chan of korea
und	und	und
under	zem	under
unesco	unesco	unesco
ung	sapuvis	cancer
unicorn	vienradzis	unicorn
unit	vienība	unit
unix	unix	unix
up	ups	up
ural	urāls	ural, as in the ural mountains
urani	urāns	uranium
uri	uri	uri, a former political party in south korea
uruguay	urugvaja	uruguay
usagi	usagi	usagi
usb	usb	usb
uss	uss	uss
utah	utah	utah
utrecht	utrecht	(proper noun) utrecht
uy	labi	"(term should be ""uy lực"") power (n.)"
uyghur	uiguru	(proper noun) uyghur
uygur	uigurs	uygur
uyên	uyen	scholarly
uyển	eifēmisms	"(term should be ""uyển chuyển"") flexible (adj.)"
uzbekistan	uzbekistāna	uzbekistan
uông	uonga	uong
uất	uất	busy
uốn	kērlings	to curl (v.)
uống	dzert	to drink
uổng	izšķērdēt	vain
v	v	v
va	va	collide
vaccine	vakcīna	vaccine
vai	plecu	shoulder
valencia	valencia	valencia
valentine	izredzētais	valentine
valley	ieleja	valley
van	vārsts	"(term should be ""van xin"") to beg (v.)"
vanessa	vanesa	vanessa
vargas	vargas	(proper noun) vargas
vasari	vasari	vasari
vay	aizņemties	borrow
vectơ	vektors	vector
ven	gar	"(term should be ""ven biển"") coastal (adj.)"
vendôme	vendôme	vendome
venezia	venezia	venice
venus	venera	venus
verdun	verdun	verdun
vermont	vermonts	vermont
verona	verona	(proper noun) the city of verona
versailles	versailles	(proper noun) versailles
vhs	vhs	vhs
vi	jo	behavior
viagra	viagra	viagra
victor	uzvarētājs	(proper noun) victor
victoria	viktorija	victoria, a province of australia
vienna	vienna	(proper noun) vienna, austria
viet	viet	vietnamese
vietnam	vjetnama	vietnam
viettel	viettelis	viettel
viii	viii	eighth
vijaya	vijaya	(proper noun) vijaya
viking	vikings	viking
villa	villa	villa
villeneuve	villeneuve	(proper noun) villeneuve, a french last name
vinagame	vinagame	vinagame
vinashin	vinashin	vinashin
vince	vince	(proper noun) vince, as in vince mcmahon
vincennes	vincennes	vincennes
vincent	vincents	vincent
vinpearl	vinpearl	vinepeal
viqr	viqr	viqr
virginia	virginia	(proper noun) virginia, as in the state
virus	vīruss	virus
virút	vīruss	virus
vissarionovich	vissarionovičs	vissarionovich
vista	vista	vista, as in windows vista
vitamin	vitamīns	vitamin
vitruvius	vitruvius	vitruvius
viz	viz	(proper noun) viz
viêm	iekaisums	inflammation
viên	tabletes	member
viêng	viangs	vientiane
viêt	rakstīšana	vietnam
viếng	apmeklējums	visit
viết	rakstīt	write
việc	darbs	thing
viện	institūts	institute
việt	vjetnama	viet
việtmường	vjetnamas muongs	muong
việtnga	vietnga	vietnam-russia
việttrung	viettrung	vietnam-china
vn	vn	vietnam
vnexpress	vnexpress	(proper noun) vnexpress
vni	vni	vni
vo	vo	"(term should be ""tròn vo"") perfectly round (adj.)"
voi	ziloņi	elephant
voip	voip	voip
voldemort	voldemorts	(proper noun) voldemort, the villain from the harry potter series
von	fon	compare
vonfram	volframa	wolfram
vong	zaudējumi	injured
voyager	voyager	voyager
voọc	zūd	a langur (n.)
vtc	vtc	vtc
vu	vu	"entire phrase is ""vu cao""; means ""to accuse wrongly"""
vua	karalis	king
vui	jautri	happy
vulcan	vulkāns	vulcan
vuông	kvadrāts	square
vuốt	nags	stroke
vv	utt.	etc.
vy	vy	vy
vyacheslav	vjačeslavs	vyacheslav
và	un	and
vài	maz	several
vàm	vm	the mouth of a rivulet (n.)
vàng	dzeltenā krāsā	gold
vành	loka	coronary
vào	iekšā	into
vá	plāksteris	patchy
vác	nēsāšana	to shoulder (v.)
vách	sienas	wall
vái	jā	some
ván	dēlis	game
váng	putas	film
váy	kleita	skirt
vân	utt	"(term should be ""vân vân"") et cetera"
vây	fin	encircle
vã	steidzās	rush
vãi	sūdi	to release
vãn	van	save
vè	urinēt	to glance slyly (v.)
vé	biļete	ticket
vét	draga	plunder
vê	par	tremolo
vì	jo	because
ví	maku	example
vía	maku	soul
vít	skrūve	screw
vò	saburzīts	jar
vòi	šļūtene	tap
vòm	jumts	upper jaw
vòng	gredzens	around
vó	hoooo	hooves
vóc	izmērs	"(should be ""vóc sương"") dew-like or delicate"
vô	nē	"(term should be ""vô số"") countless (adj.)"
vôi	laims	limestone
võ	cīņas	martial arts (n.)
võng	šūpuļtīkls	hammock
vùi	apbedīts	"(term should be ""chôn vùi"") to bury or keep secret (v.)"
vùng	novads	region
vú	krūts	breast (n.)
vút	planējošs	"entire term should be ""cong vut""; extreme curling"
văn	literatūra	culture
văng	šļakatas	a name
vĩ	lieliski	"(term should be ""vĩ đại"") great (adj.)"
vĩnh	mūžīgs	ving
vũ	vu	armed
vũng	peļķe	vung
vơ	bezpalīdzīgs	lost
vơi	ar	ullage
vưu	vưu	"actual term is ""xi vưu""; proper noun; name of a leader of a people in chinese legend"
vươn	sasniegt	reach
vương	karalis	kingdom
vướng	sapinušies	"(term should be ""vướng víu"") to become involved in (v.)"
vườn	dārzs	garden
vượn	pērtiķi	gibbon
vượt	caurlaide	to overcome
vạ	tātad	unfortunate problem
vạc	katls	cauldron
vạch	bārs	bar
vại	burka	jar
vạn	desmit tūkstoši	thousand
vạng	krēsla	twilight
vả	att	hard
vải	audums	fabric
vảy	svari	scale
vấn	padoms	vấn đề= problem
vấp	paklupis	stumble
vất	izmest	hard
vần	atskaņa	spell
vầng	halo	moon (vang trang)
vẩn	joprojām	wander
vẩy	pārslas	scale
vẫn	joprojām	still
vẫy	vicinot	wave
vận	laime	active
vắc	vakcīna	vaccine
vắcxin	vakcīna	vaccine
vắn	īss	short
vắng	prombūtnē	absent
vặn	skrūve	to twist (v.)
vặt	sludinājumi	odd
vẹn	integritāte	complete
vẹt	papagaiļi	parrots
vẽ	glezna	draw
vết	plāksteris	wound
vểnh	asari	warping
vệ	aizstāvība	"(term should be ""bảo vệ"") to defend (v.)"
vệt	svītras	streak
vỉa	šuves	"(term should be ""vỉa hè"") sidewalk"
vịnh	līcis	bay
vịt	pīle	duck
vọng	ceru	"(term should be ""hy vọng"") hope (n.)"
vọt	raķete	to spurt out (v.)
vỏ	miza	shell
vồ	maul	"(term should be ""gạch vồ"") a type of brick"
vỗ	pat	to clap
vội	pasteidzies	hurriedly (adv.)
vớ	zeķes	"(term should be ""vớ vẩn"") silly (adj.)"
với	ar	to
vớt	zivis	salvage
vờ	izlikties	"(term should be ""giả vờ"") to pretend (v.)"
vời	lieliski	wonderful
vở	piezīmju grāmatiņa	"(term should be ""vở kịch"") a play"
vỡ	salauzts	break
vợ	sieva	wife
vụn	čipsi	debris
vụng	neveikls	covert
vứt	izmest	throw away
vừa	der	just (adv.)
vừng	sezama	sesame (n.)
vững	stingrs	firm (adj.)
vực	lauka	place
vựng	vārdu krājums	"(term should be ""từ vựng"") regional vocabulary (n.)"
vỹ	tātad	majestic
w	w	w
wa	wa	wa
walt	valsis	(proper noun) walt, as in walt disney
walter	valters	walter
walther	valters	walther
wan	bļaut	wan
wang	wang	wang
wankel	wankel	(proper noun) wankel
wanna	gribi	wanna
warren	warren	a name
warsaw	varšava	warsaw
warszawa	varšava	(proper noun) warsaw
washington	mazgāšanās	(proper noun) washington
wat	vat	(proper noun) wat, as in angkor wat, the temple in cambodia
watergate	ūdens vārti	watergate
waterloo	ūdenskritums	(proper noun) waterloo
waters	ūdeņi	waters
wayne	wayne	wayne
wcdma	wcdma	w-cdma
weasley	weasley	weasley, as in ron weasley in the harry potter series
weblog	tīmekļa žurnāls	weblog
webmail	tīmekļa pasts	ưebmail
weimar	veimārā	(proper noun) weimar
wellington	velingtona	wellington
wells	akas	wells, as in author orson wells
welsh	velsietis	(proper noun) welsh, as in the welsh language
wembley	wembley	wembley, as in wembley stadium
werner	verners	werner
westermarck	rietummarka	westermarck
western	rietumu	western
westlife	westlife	westlife
westview	westview	westview, as in westview press
wheeler	riteņbraucējs	a name
widener	paplašinātājs	widener
wien	wien	wien
wiener	wiener	wiener
wifi	bezvadu internets	wi-fi, a technology term
wiki	wiki	wiki
wikia	wikia	a name
wikibooks	wikibooks	(proper noun) wikibooks
wikimapia	wikimapia	wikimapia
wikimedia	wikimedia	wikimedia
wikitravel	wikitravel	a name
wild	savvaļas	wild
wilder	mežonīgāks	(proper noun) wilder, as in billy wilder
wiley	viltīgs	wiley
willard	willard	willard
wimbledon	vimbldona	wimbledon
windows	logi	windows
winer	uzvarētājs	winer
wisconsin	wisconsin	(proper noun) wisconsin
within	ietvaros	within
without	bez	without
wolfgang	vilkāns	wolfgang
won	uzvarēja	won
wong	wong	wong
woodrow	kokgriezums	woodrow
woods	meži	(proper noun) woods, as in tiger woods
would	gribētu	would
wrestling	cīkstēšanās	wrestling
wright	brigāde	a name
wu	wu	wu
wushu	wushu	wushu, a type of martial art
wwf	wwf	wwf
xa	tālu	ancient
xang	xang	"(term should be ""lan xang"") name of an ancient country in southeast asia"
xanh	zils	green
xao	ļengans	xôn xao = chatting
xay	sasmalcina	grind
xe	auto	a car (n.)
xem	redzēt	watch
xen	ksens	to insert (v.)
xhcn	xhcn	social republic
xi	xi	xi
xiii	xiii	eighth
xin	lūdzu	please
xinh	skaists	beautiful
xiv	xiv	fourteenth
xiêm	siāmas	(proper noun) xiêm, or siam
xiên	slīpi	oblique
xiêu	xiao	soften
xiếc	cirks	circus
xiết	pievelciet	to twist tightly (v.)
xiềng	važas	chain
xo	xo	spring
xoa	berzēt	massage
xoay	pagrieziens	turn
xong	paveikts	completed
xoàng	viduvējs	mediocre
xoá	dzēst	delete
xoáy	virpuļi	vortex
xoắn	savīti	coiled
xu	monēta	trend
xua	kliedēt	dispel
xuan	xuan	"(term should be ""xuân"") a common vietnamese middle or first name; means ""the season of spring"""
xui	nelaimīgs	incite
xuka	xuka	xuka
xum	grezns	a name
xuyên	pīrsings	frequently
xuyến	aproces	manage
xuân	pavasaris	spring
xuâncông	pavasaris	xuan public
xuôi	slaucīja	down
xuất	eksportēt	ejaculate
xuấtnhập	eksports-imports	import/export
xuống	uz leju	down
xuồng	kanoe	boat
xv	xv	fifteenth
xvi	xvi	xvi
xvii	xvii	xvii
xx	xx	xx
xy	xy	cylinder
xài	tērēt	use
xào	apcep	stir fry
xách	rokassomu	to carry by the handle (v.)
xám	pelēks	ustox
xán	cepts	"(term should be ""xán lạn"") bright (adj.)"
xáo	traucējumi	chaos
xát	berzes	touch
xâm	tetovēts	invasion
xâu	virkne	string
xây	būvēt	build
xã	komūna	society
xãy	dūriens	occur
xèo	xèo	xeo
xé	asaru	tear
xén	apgriešana	"(term should be ""biếu xén"") to gift (v.)"
xéo	sāniski	diagonally (adv.)
xét	apsveriet	examine
xê	kustēties	"(term should be ""bánh xu xê"") a type of vietnamese cake"
xêkô	suneo	xeko
xì	fart	scandal
xìu	fart	to become flaccid (v.)
xí	rūpnīca	factory (xi nghiep)
xít	aizraujoši	nazi
xíu	sīks	small
xòe	izplatās	spread
xóa	izdzēst	clear
xói	erozija	erode
xóm	kaimiņi	village
xót	žēlsirdība	mercy
xô	bāzt	soviet
xôi	lipīgi rīsi	pierce
xôn	maisa	tumultuous
xông	steidzās	rush
xôphần	kausa sekcija	soviet-poland
xôviết	padomju savienība	soviet
xù	sačukstējās	gigantic
xú	rupjš	xu
xúc	kontakts	touch
xúi	pamudināt	induce
xăm	tetovējums	"(term should be ""xa xăm"") far away (adj.)"
xăng	benzīns	gasoline
xơ	šķiedra	xo
xưa	vecs	old
xưng	atzīstas	"(should be ""tự xưng"") self-proclaimed"
xương	kauls	bone (n.)
xước	saskrāpēts	scratch
xướng	koris	provoke
xưởng	darbnīca	workshop
xạ	starojums	"(term should be ""phản xạ"") to reflect"
xả	izlāde	release
xảo	veikls	detailed
xảy	rodas	happen
xấp	apm	approximate
xấu	slikti	bad
xẩm	pinkains	a type of traditional vietnamese singing
xẩy	rodas	occur
xắt	kauliņš	cut
xẻo	nelaimīgs	cut off
xếp	salocīts	rank
xỉ	izdedži	approximately
xỉa	diegs	to pick (v.)
xỉu	ģībonis	to faint
xốc	šoks	to lift up (v.)
xốp	putuplasta	porous
xổ	izloze	rush into
xộn	netīrs	messy
xứ	zeme	native
xứng	cienīgs	appropriate
xử	ārstēt	judge
y	y	medical
y=fracsin	y = fracsin	a function
ya	jā	(proper noun) ya, as in ya trang
yakovlev	jakovļevs	yakovlev
yakushima	jakušima	yakushima
yalta	jaltā	(proper noun) yalta
yankee	jankieši	(proper noun) yankee
yard	pagalms	yard
yasha	jaša	a name
yeeun	yeeun	(proper noun) yeeun
yeltsin	jeļcins	yeltsin, as in boris yeltsin
yemen	jemeni	yemen
yersin	jersins	(proper noun) yersin, asin alexandre yersin
yi	yi	(proper noun) yi
ying	ying	(proper noun) ying, as in ying yang
ymca	ymca	ymca
yo	yo	yo
yomiuri	jomiuri	yomiuri
yoochun	yoochun	yoochun
york	york	york
yorker	jorks	yorker
yorkshire	jorkšīra	yorkshire
youtube	youtube	youtube
ypres	ypres	ypres
ytv	ytv	ytv
yu	ju	yu
yuan	juaņa	(proper noun) yuan, as in yuan mu
yucatán	jukatana	yucatan, as in the yucatan peninsula
yudhoyono	yudhoyono	(proper noun) yudhoyono, as in indonesian president susilo bambang yudhoyono
yugi	yugi	yugi
yukito	jukito	yukito
yume	yume	(proper noun) yume
yunho	yunho	yunho
yuri	jurijs	yuri, as in soviet pilot and cosmonaut yuri alekseyevich gagarin
yurt	jurta	yurt
yên	jena	peace or stillness (n.)
yêu	mīlēt	love
yếm	virsvalki	tender
yến	putna ligzda	a type of swallow (n.)
yết	iekļaušana sarakstā	yet
yếu	vājš	mainly
yểm	piesegt	support
yển	jena	"is a name meaning, ""bird"""
yểu	jauki	"(term should be ""yểu điệu"") graceful (adj.)"
z	z	z
zac	zac	zac
zambia	zambija	(proper noun) zambia, as in the nation
zealand	zēlande	(proper noun) zealand, as in new zealand
zedong	dzedongs	mao zedong
zero	nulle	zero
zeus	zevs	zeus
zheng	zheng	zheng
zhukmse	zhukmse	zhuk-mse
zimbabwe	zimbabve	zimbabwe
zinedine	zinedīns	(proper noun) zinedine
zing	zing	zing, as in the website
zoe	zoe	zoe
zurich	cīrihe	(proper noun) zurich
zürich	cīrihe	(proper noun) zurich, as in zurich, switzerland
|nguyễn	| nguyen	a common vietnamese last name
|nổi	| pludiņi	"(term should be ""nổi"") to float (v.)"
|petya	| petja	(proper noun) petya
|tên	| vārds	"(should be ""tên"") name (n.)"
|việt	| vjetnamiešu	vietnam
 kg	kilograms	kg
 triệu	miljons	million
 °c	° c	degrees celsius
°đến	° līdz	up to
°độ	° grādi	degree
×	×	x
ào	wow	rush
á	āzijas	asia
ác	ļaunums	evil
ách	jūgs	yoke (n.)
ái	alkas	ai
ám	padara	(with the word chi) to hint at
ánh	spīdums	light
áo	krekls	clothe
áohung	aohung	"(term should be ""Áo-hung"") austria-hungary"
áp	spiediens	"(term should be ""huyết áp"") blood pressure (n.)"
áâu	aoi	eurasian
â	â	a vietnamese vowel sound
âm	mīnus	vagina
ân	labvēlība	deed
én	bezdelīgas	swallow
ép	saspiest	press
êgê	ego	aegean
êm	gluda	smooth
ích	noderīga	benefit
ílam	ílam	tamil language name for the island of sri lanka
ít	maz	less
île	île	Île, as in Île de la cité, france
îledefrance	îledefrance	ile-de-france
ðiều	raksts	article
ðài	ðài	taiwan
ðường	cukurs	a road
ðảng	ballīte	party
ðức	vācija	"Đức, a common vietnamese first name; means ""virtue"""
ó	ó	(with the word la) to boo down
óc	smadzenes	brain
óng	zaigojošs	"(term should be ""óng ả"") flexible"
ôi	ak	"vietnamese version of the exclamation ""oh"""
ôm	apskaut	hug
ôn	mērenība	peaceful (on hoa)
ông	viņš	a man (n.)
ôtô	auto	car
ôxi	skābeklis	oxygen
ôxy	skābeklis	the element oxygen (n.)
ôxít	oksīds	oxide
ôzôn	ozons	ozone
ùn	ievārījumi	congest
úng	aizsērējis	flood
úp	seju uz leju	upside
úy	leitnants	"(term should be ""thiếu úy"") second lieutenant (n.)"
ý	itālijā	italian
ăn	ēst	eat
ăng	skudra	antenna
ăngten	antena	antenna
đa	multi	majority
đai	josla	"(term should be ""Đai khố"") name of a village"
đak	dak	(proper noun) Đak
đan	adīt	scandal
đau	sāpes	painful
đay	džutas	jute, a type of vegetation the vietnamese use to make soup (n.)
đb	db	dien ban
đcstq	dcstq	communist party of china
đcsvn	dcsvn	vietnam communist party
đe	lakta	threaten
đem	atnest	to bring (v.)
đen	melns	black
đentrắng	melns un balts	"(term should be ""đen-trắng"") black-and-white (adj.)"
đeo	valkāt	wear
đh	đh	university
đhcn	đcn	university of industry
đhtm	dhtm	university of economics
đhông	austrumos	dhong
đi	iet	go
điên	traks	crazy
điêu	lieta	sculpture
điôxít	dioksīds	dioxide
điạ	dạ	dia
điếc	kurls	heron
điếu	cigarete	funeral oration
điềm	parakstīt	omen
điền	aizpildīt	estate
điều	lieta	control
điểm	punkts	bearing point
điển	vārdnīca	"(term should be ""từ điển"") a dictionary"
điểu	izdrāzt	thing
điệp	ziņa	spy
điệu	tonis	memorial
đo	mērs	measure
đoa	doa	doa
đoan	grupa	extreme
đom	ugunspuķes	firefly
đoài	mango	the west
đoàn	grupa	an organization or group (n.)
đoái	apmaiņa	"(term should be ""hối đoái"") to exchange or trade (v.)"
đoạn	paragrāfs	a stage or phase (n.)
đt	tālr	training
đtđ	mobilais telefons	diabetes
đua	sacensības	emulate
đui	akls	blind
đun	karstums	cook
đuôi	aste	tail
đuốc	lāpa	a torch
đuối	noslīkst	drowning
đuống	kāts	(proper noun) Đuống, the name of a river
đuổi	tramdīt	pursue
đài	radio	statue
đàm	sarunas	negotiation
đàn	ganāmpulks	musical instrument
đàng	jā	side
đào	rakt	train
đày	trimdā	exile
đá	akmens	to kick
đái	urinēt	pee
đám	grupa	dam
đán	dan	"(term should be ""tết nguyên Đán"") vietnamese new year's day"
đáng	vērts	deserve
đáo	unikāls	unique
đáp	atbildi	response
đát	zeme	"(term should be ""bi đát"") lamentable (adj.)"
đâm	stab	pierce
đâu	kur	anywhere
đây	šeit	below
đã	jau ir	already
đãi	ārstēt	"(should be ""bạc đãi"") to ill-treat"
đãng	lecherous	dissolute
đè	ignorēt	to press on
đèn	lampu	light
đèo	caurlaide	a mountain pass (n.)
đê	dambis	a dike (n.)
đêm	nakts	night
đênh	buks	lênh đênh= float to unknown
đích	galapunkts	goal
đính	pievienots	attached (adj.)
đò	prāmis	a ferry (n.)
đòi	prasība	require
đòn	sitiens	welcome
đó	tur	that or there (adv.)
đóa	nē	"(term should be ""đoá hoa"") a flower bloom"
đói	izsalcis	hungry
đón	pacelt	welcome
đôi	dubultā	sometimes
đôla	dolāru	dollar
đôn	pjedestāla	london
đông	bronzas	eastern
đôngbắc	ziemeļaustrumiem	north-east
đôngnam	dienvidaustrumi	south-east
đôngtây	austrumi rietumi	"(term should be ""đông-tây"") east-west (adj.)"
đôrêmi	doraemon	(proper noun) Đôrêmi
đôrêmon	doraemons	doreamon
đùa	joks	joke
đùi	augšstilba kauls	thigh
đúc	liešana	"(term should be ""đúc kết"") to sum up (v.)"
đúng	tas ir pareizi	right
đúp	dubultā	double
đút	likt	"(term should be ""đút lót"") to bribe"
đăk	dak	dak
đĩ	slampa	whore/bitch
đĩa	šķīvis	disk
đơ	pauze	stiff or rigid (adj.)
đưa	caurlaide	girl
đường	iela	pathway
được	labi	is not
đạ	da	da
đại	lieliski	eagle
đạm	olbaltumvielas	plain
đạn	lode	bullet
đạo	reliģija	vagina
đạp	velosipēds	to step on
đạt	sasniegt	reach
đả	cīnās	to hit
đảm	garantēta	"(term should be ""đảm nhiệm"") to undertake (v.)"
đản	dzimšanas diena	a group or flock (n.)
đảng	ballīte	party
đảo	sala	an island (n.)
đấm	iesist	punch
đấng	dievs	the
đất	zeme	country
đấtmặt	zemes	datmat
đấy	tur	ignore
đầm	kleita	swamp
đần	mēms	"(term should be ""đần độn"") stupid or ignorant (adj.)"
đầu	galva	start
đầy	pilns	"(term should be ""đầy đủ"") adequate or enough"
đẩu	galva	"(entire term is ""khoa đẩu"") ancient phonetic script used in vietnam"
đẩy	virzīt	to push
đẫm	iemērcis	wet
đậm	tumšs	dense
đậu	pupa	to park (v.)
đậy	piesegt	cover
đắc	iegūt	effectively
đắm	sagrauts	sink
đắn	pieklājība	proper (dung dan)
đắng	rūgta	bitter
đắp	augšā	"(term should be ""bù đắp"") to compensate (v.)"
đắt	dārgi	expensive
đằng	pāri	back
đẳng	klase	equality
đặc	īpašs	"(term should be ""đặc biệt"") special (adj.)"
đặn	regulāri	regularly
đẹp	glīti	beautiful
đẽ	labi	beauty
đế	zoles	empire
đếm	skaita	to count (v.)
đến	nāc	come
đề	pavedieni	promote
đền	templis	"(term should be ""đền thờ"") a religious shrine"
đều	ir	all
để	uz	for
đệm	spilvens	middle name
đỉnh	tops	the summit or peak
địch	ienaidnieks	enemy
định	precizēts	appointed
đọ	bez kauliņiem	compete
đọan	paragrāfs	period
đọc	lasīt	read
đọng	sastingusi	deposit
đỏ	sarkans	red (adj.)
đốc	gubernators	admiral
đối	priekš	face
đốm	vietas	spot
đốn	nocirst	"(term should be ""suy đốn:) to be worse off"
đống	kaudzes	line
đốt	dedzināšana	burn
đồ	lieta	thing
đồi	kalns	hill
đồn	baumas	rumour
đồng	vara	agreeable
đổ	ieliet	dump
đổi	mainīt	to change (v.)
đổng	donga	"(term should be ""đồng bằng"") a delta"
đỗ	noparkots	pass
độ	grāds	"term should actually be ""độ cao""; means ""height"""
độc	inde	alone
độn	polsterēts	chaos
động	dinamisks	action
đột	pēkšņi	"(term should be ""xung đột"") conflict (n.)"
đới	zen	tropical
đời	mūžs	generation
đỡ	atbalstu	help
đợi	pagaidiet	thigh
đợt	partija	fit
đục	necaurspīdīgs	turbid
đụn	kāpas	dune
đụng	pieskarties	encounter
đủ	pietiekami	enough
đứa	bērni	child
đức	tikums	virtue (n.)
đứng	stāvēt	to stand (v.)
đứt	salauzts	cut off
đừng	nevajag	not
đực	vīrietis	male
đựng	saturēt	suffer
đựoc	labi	be
ĩ	ak	"(term should be ""ầm ĩ"") noisy"
ơ	ak,	"(term should be ""thờ ơ"") to be indifferent (adj.)"
ơi	hei	"vietnamese equivalent of english ""oh"""
ơn	paldies	thank
ư	u	vowel sound found in the vietnamese alphabet (n.)
ưa	dod priekšroku	to like (v.)
ưng	o jā	to accept (v.)
ưu	plusi	"(term should be ""ưu việt"") preeminent (adj.)"
ươi	orang	orangutan
ươm	bērnistaba	nursery
ương	centrālā	central
ướp	marinēts	mummy
ướt	slapjš	wet
ạ	kungs	a word added to the end of a response to show respect to someone in a position of authority, as in a child to a parent
ạt	steigties	(with word o) to crowd
ải	ải	pass
ảnh	attēls	picture
ấm	silts	warm
ấn	nospiediet	press
ấnâu	drukāt	"(term should be ""Ấn Âu"") a grouping of languages including european and indian languages that are thought to have originated from a single earlier language (adj.)"
ấp	hamlets	district
ấu	jauns	childhood
ấy	ka	that
ẩm	silts	humidity
ẩn	paslēpties	hidden
ập	sprādziens	rush
ắt	protams	sure
ếch	varde	frog
ỏi	piparmētra	little
ố	oi	"(term should be ""hoen ố"") stained and smeared (adj.)"
ốc	gliemeži	building
ốm	slims	sick
ống	caurule	tube
ốp	pieskare	omelette
ồn	troksnis	noisy (adj.)
ổ	brauc	hard drive
ổi	gvajave	guava (n.)
ổn	ir labi	peace
ớn	liels	posts
ớt	čili	chili
ở	iekšā	at
ủ	inkubācija	"(term should be ""ủ dột"") gloomy (adj.)"
ủi	dzelzs	"(term should be ""an ủi"") to comfort (v.)"
ủng	zābaki	boot
ủy	komisārs	commission
ứ	jā	to pool together (v.)
ức	krūts	memories
ứng	pieteikums	corresponding
−−	−−	__
≠	≠	different
