aajo	হাস্যকর	hospitality
aala	সীমান্ত	border
aanu	সমবেদনা	compassion
aapon	আপন	bachelor or spinster (bachelorette)
aare	aare	president
aawe	পক্ষাঘাত	fasting
abala	অংশ	division
abeikojopo	উত্তরাধিকারী	subset
abeorile	স্বদেশ প্রত্যাবর্তন	nation
abesahara	ছিটিয়ে দেয়া	under the sahara
abidi	বর্ণমালা	abidi
abidjan	চিরকাল	abidjan
abo	নারী সংক্রান্ত	security
aburunmu	আমাদের ঘৃণা	reduced in value, diminished
abálájo	অভিজ্ঞ	that is why
abé	সুই	under
abínibí	জাতীয়তা	inborn
abúléko	গ্রাম	village
accra	আক্রা	accra
adaba	সুবিধাজনক	factor
adabaye	ঠিক আছে	previously-existing
adarihunrun	পরিষ্কারক	human
addis	আদ্দিস	addis
adeda	প্রকৃতি	creator
adiokan	নির্জন	stubbornness
adágbà	অগ্রজ	adagba
adúgbò kútò	রাস্তায় প্রতিবেশীরা	kuto area
adúgbò mókóla	মিউকোলা মিউকোসা	mokola area
adúgbò quarry	কোয়ার প্রতিবেশীরা	neighborhood
adúgbò ìdí	পাড়ার কারণ	area
afida	পরিবার	element
afomo	উদাহরণ স্বরূপ	cleansing
afoyemo	সংক্ষিপ্তসার	abstract
africa	আফ্রিকা	africa
african	আফ্রিকান	ara afrika
africans	আফ্রিকার	africans
aféfé	বাতচক্র	air
agba	রং	principal
agbado	ভুট্টা	maize
agbara	ক্ষমতা	power
agbaye	বিশ্ব	world
agbeinadie	কৃষিজমি	semi-conductor
agbà	একজন প্রাপ্তবয়স্ক	adult
agbàbò	অভিভাবক	adopted child
agbára	ক্ষমতা	power
agbéiná	অগ্নিনির্বাপক	conductor
agio	কান্না	agio
aintimulo	aintimulo	un-exploited
aisi	অভাব	lack
ajagun	একটি কুকুর	ajagun
aje	অর্থনীতি	trade
ajemoroyin	জিজ্ঞাসাবাদ	reporting
ajibola	আলোচ্যসূচি	ajibola
ajo	ভ্রমণ	firms
ajoro	ভ্রমণ	discussion
ajọra	অবিকল প্রতিরুপ	resemblance
akiidah	coridah	(non-standard yoruba, this maybe from benin)
akinpelu	আর্টিলারি	akinpelu
akokolo	কাল	period
akole	আমরা পারি না	title
akoni	আমাদের নেই	teacher
akopa	প্রথমে এবং সর্বাগ্রে	participant
akopo	সংকলন	assembly
akátá	শৃগাল	african american
akíkanjú	বীর	courageous
akíngbógun	ব্যাটেলিয়ন	akingbogun
akẹ́kọ̀ọ́	ছাত্র	students
ala	নিচে	limit
alaabo	অক্ষম	protection
alaadanida	অনাবশ্যক	individual
alaafia	শান্তি	peace
alaafin	অবৈধ	alaafin
aladaani	ব্যক্তিগত	privately-owned
aladani	ব্যক্তিগত	self-owned
aladanida	ইচ্ছামত	private
alaidogba	ভারসাম্যহীন	unequal
alaigbara	অনিবার্য	neutron
alaini	অতি দরিদ্র	the poor
alakitiyan	কর্মী	activist
alakobere	ব্রতী	primary
alalaye	পার্থিব	explanatory
alawose	ভবিষ্যৎ কথন	mentor
albany	albany	albany
albert	আলবার্ট	albert
alexandra	আলেকজান্দ্রা	alexandra
alicia	অ্যালিসিয়া	alicia
allāh	আল্লাহ	allah
alominira	স্বাধীনতা	independent
alpha	আরম্ভ	alpha
alubàbá	পিতা	drummer
alukuraani	কোরান	quran
alumoni	আরোগ্যক্ষম	minerals
alumíníọ̀mù	অ্যালুমিনিয়াম	aluminium
alákọ̀bẹ̀rẹ̀	দীক্ষক	primary education
alápapò	প্রতিস্থাপন	general
alátise	শিল্পী	alatise
aláyèwò	পরিদর্শক	expert
aláísàn	অসুস্থ	the sick
alúwo	গম্ভীর গর্জন	traditional cults
alọ́po	মানিব্যাগ	tied
amazonas	amazonas	amazonas
americas	আমেরিকাস	americas
amerika	আমেরিকা	america
amojeoyipada	পরিবর্তনযোগ্য	reform
amosi	মসজিদ	amos
améríkà	মার্কিন	america
améríkà	মার্কিন	america
an	একটি	him
anabi	নবী	prophet
anc	এএনসি	anc
andaman	andman	andaman
angkor	আংকর	angkor
anita	অনিতা	anita
anschluss	anschluss	anschluss
apagusu	দক্ষিণ	southern
apaguusuilaorun	নৈর্ঋত	south-western
apaguusuiwoorun	নৈর্ঋত	part of the south
apailaorun	সূর্যোদয়	east side
apaiwoorun	পশ্চিম	eastern side
aparapo	সমাহার	confederation
apeja	জেলে	fisherman
apeere	উদাহরণ স্বরূপ	example
apis	api গুলি	apis
apòmù	পরিচ্চদ-রক্ষক বহিরাবরণ	apomu
apẹ̀rè	পরিচ্চদ-রক্ষক বহিরাবরণ	example
arabu	আরব	arab
aralíle	গ্রীষ্মপ্রধান	healthy body
arinkankan	এইটা	nationalist
ariso	এআরআইএস	oral tradition
ariwaarin	মধ্যপ্রাচ্য	mid-north
ariwaguusu	দক্ষিণ-পশ্চিম	north-south
arkansas	আরকানসাস	arkansas
aroko	গাছপালা	composition
aruleyin	হ্যালো	carried on the back
arun	রোগ	disease
aryan	আরিয়ান	aryan
aráa	ভাই	people from
arábíà	বর্ণানুক্রমিক	arabia
aráròmí	হ্যালো	araromi
arópò	উত্কোচ গ্রহণ	substitute
arúgbó	বার্ধক্য	elderly
arọ	পঙ্গু	cripple
asagun	বিজয়	intial, first (referring to the 13 colonies)
ascii	খুঁজে বের কর	ascii
aseeto	বন্দোবস্ত	unfair
aseyori	সাফল্য	success
asipa	চ্যুতি	first to kill
assessment	মূল্যায়ন	ayewo
asìko	আজেবাজে কথা	time; ni asiko=when
asèdá	প্রাকৃতিক	origination
atangbona	পরমাণু	emission
atanna	পরমাণু	emitter
atigba	গ্রাহ্য	from time
atimo	পরিকল্পনা	inland
atinrin	হাস্যময়	thin
atun	আবার গুটিয়ে নেওয়া	also
atunse	সংশোধন	revision
australia	অস্ট্রেলিয়া	australia
austriahumgary	austriahumgary	austria-hungary
austronesian	অস্ট্রোনেশীয়	austronesian
austríà	অস্ট্রেলিয়া	austria
avar	avar	avar
awari	আবিষ্কার	discovery
awo	প্লেট	of
awonara	আবেগ	people of
awoòn	টেমপ্লেট	people
awon	তাহাদিগকে	they
awuruju	ঐন্দ্রজালিক	shady
awùjo	শ্লীলতা	society
awújẹ	কলঙ্ক	root
aya	শ্লোক	chest
ayeye	অনন্তকাল	celebration
ayàfi	এটা উত্তম	only if
ayò	চিরদিনের জন্য	game
azikiwe	সাধারণ বোধ	azikwe
aṣòkan	স্বতন্ত্র	united
baa	হয়	be with
babaláwo	ডিভাইনার	herbalist
bahrain	বাহরাইন	bahrain
balẹ̀	তাকে তার মত থাকতে দিন	settled
bang	ঠুং	bang
banle	banle	banle
bara	গত বছর	themselves
bauxitealumina	bauxitealumina	bauxite/aluminum
bayelsa	bayelsa	beyelsa
bayi	এখন	like this
bayìí	এখন	this
bce	দূরে	bce
beauharnais	beauharnais	beauharnais
beijing	বেইজিং	beijing
belarus	বেলারুশ	belarus
belgium	বেলজিয়াম	belgium
bengal	বঙ্গ	bengal
bengali	বাংলা	bengal
benin	এজলাস	benin
berber	বর্বরজাতিসংক্রান্ত	berber
berlin	বার্লিন	berlin
bernstein	বার্নস্টেন	bernstein
bharat	ভারত	bharat
bharata	ফিরে এসো	bharata
bibeli	বাইবেল	bible
biribiri	চূর্ণ করা হয়েছিল	intense
black	কালো	dudu
bodies	লাশ	ara
bojú	দেখা যাক	take care
bole	গাছের গুঁড়ি	ground
bolt	বল্টু	bolt
bolívar	বলিভারের	bolivar
brasil	ব্রাজিল	brazil
brazzaville	ব্রাজাভিল	brazzaville
bridgeport	bridgeport	bridgeport
britain	ব্রিটেন	britain
brítánì	ব্রিটিশ	britain
bu	এটাই	give
buenaventura	buenaventura	buenaventura
bujumbura	সম্প্রসারিত	bujumbura
burúkú	মন্দ	bad
by	দ্বারা	does not translate directly, does not exist
bàbá	বাবা	father
bákannáà	যেমন	likewise
bálè	বেলুন	lying on the ground
bárakú	অনুরতি	habitual
báyìí	এখন	this
bèrẹ̀	দিয়ে শুরু করতে	started
béè	এটার মতই	than
bòtswánà	বাস	botswana
búburú	খারাপ	bad
búrú	সাহসী হও	wicked
bẹ̀rẹ̀	শুরু করতে	started
bẹ́	ভেঙে	also
bẹ́ljíọ̀m	পান্না	belgium
bẹ́ẹ̀ni	হ্যাঁ	yes
bẹ́ẹ̀sìni	হ্যাঁ	that is it
cairo	ক্রোধ	cairo
calabar	চুইংগাম	calabar
canaria	canaria	canaria
cape	অন্তরীপ	cape
casablanca	কাসাব্লাংকা	casablanca
caslon	নাচঘর	caslon
cathedral	ক্যাথেড্রাল	cathedral (katidral)
catherine	ক্যাথরিন	catherine
cauchy	কোশি	cauchy
cbc	সিবিসি	cbc
chamorro	চামেরো	chamorro
charles	চার্লস	charles
chaskalson	chaskalson	chaskalson
chebbi	মনে	chebbi
cherished	লালিত	mu lokunkundun
china	চীন	china
cipollone	cipollone	cipollone
clear	স্পষ্ট	danmanran
code	কোড	code
coetsee	coetsee	coetese
coloured	রঙ্গিন	alawo dudu
coming	আসছে	yo jade
compared	তুলনা	does not directly translate
computers	কম্পিউটার	komputa, ero ayarabiasa
csto	csto	csto
ct	ct	ct
cunha	গলা	cunha
da	এবং	back; but in this form it is unnecessary
dagbasoke	বড় হওয়া	developing
dandan	বাধ্যতামূলক	a must
dani	অধিষ্ঠিত	hand-held
darapo	যোগদানের	joinedd
daru	ধ্বংস	scattered
dates	তারিখ	pada si
delhi	করো না	delhi
denver	denver	denver
des	দেস	des
describes	বর্ণনা	se apejuwe (apejuwe=description; se prefix makes it a verb)
desmond	ডেসমন্ড	desmond
development	উন্নয়ন	idagbasoke
didagba	সমতা	growing
didasile	সংস্থা	established
different	বিভিন্ন	iyato
din	ভাজা	reduced
dinwoju	খুঁজে দেখো	suitable
divoire	divoire	d'ivoire
doju	মুখোমুখি	face
dojú	মুখোমুখি	turn face (full phrase is doju ko, to face)
dominic	ডমিনিক	dominic
doni	doni	this day
dote	ভালাবাসায় অন্ধ হত্তয়া	rebel
doublehelix	ডাবল হেলিস্ক	hiliksi abara meji
doublestrand	doublestrand	double-strand
dover	ডোভের	dova
du	ডু	hustle
due	কারণে	nitori
dun	সুস্বাদু	sound
dàbíi	এটার মত	like
dàpò	তাদের পাল্টে দাও	mix
dá	নির্মিত	intervene
dágbó	বার্ধক্য	forest
dájó	ঠিক আছে	pass judgement
dálóríi	ধন্যবাদ	about
dáradára	আমরা হব	well
dásà	একটি কাসা	peculiar way of saying
dáwó	দান করা	undertake
dé	আগত	reach
délànà	নীতিগতভাবে	delana
dépò	কিছুদূর	to a position
dì	চাদর	be
dìde	উঠা	stand
dìró	ডানদিকে	hang on
dìtẹ̀	চক্রান্ত	rebel
díè	ক্রিয়ার কাল	few
dóko	ভাল	upstanding
dólà	আমরা হব	dollar
dún	শব্দ	sound
dúró	দাঁড়ানো	stand (been in existence)
dọ́gba	সমান	equal
ea	হ্যাঁ	ea
eba	eba	shore
ebi	পরিবার	family
ecomog	ecomog	ecomog
ede	ভাষা	language
efrem	effem	efrem
egba	একেবারে	cane
egbe	বন্দুক	group
egberundun	হাজার বছর	a thousand year
egbo	একটি ক্ষত	brother
egbé	দুর্ভাগ্য	party
egbò	একটি ক্ষত	chemicals
egbògi	চিকিৎসা	don't know this
eighteen	আঠার	ejidinlogun
eka	জটিল	branch, department, part
ekeji	অন্যটি	second
eko	শিক্ষা	lagos
elede	শূকর	speaker
eleyi	এই	this
eleyii	এটার মত	this
elláda	সৃষ্টি	ellada
eléde	বিমূর্ত	pig
eléré	ক্রীড়াবিদ	performer
elòmírà	সামুদ্রিক	freedom
elòmíràn	অন্য	another person
emerging	উদীয়মান	ibere-pese
emmanuel	এমানুয়েল	emmanuel
enikéni	সবাই	whoever
enter	প্রবেশ করান	wole
enì	হাতি	person
eníbá	জ্বর	such person
epa	চিনাবাদাম	groundnut
ernst	আর্নেস্ট	ernst
erofo	পলল	swamp
erékùsù	দ্বীপ	island
eréonítàn	অন্য শব্দের আদ্যক্ষর দ্বারা গঠিত শব্দ	written play
eseese	নকশা	step by step
esia	আসছে	asia
esteri	esteri	ester
etisalat	etisalat	etisalat
etymologiae	etymologiae	etymologiae
etíòkun	উপকূলটি	beach
euro	ইউরো	euro
euroasia	euroasia	uro-esia
ewe	গাছের পাতা	ewe
ewé	গাছের পাতা	leaf
ewì	কবিতা	traditional poem
example	উদাহরণ	apere
eya	বিভাগ	tribe
eyin	ডিম	previous
eyonomba	eyonomba	digit
eléja	মাছ ধরা	fisherman
elòmíràn	অন্য কেউ	another person
eka	প্রভাব	branches
eléyàmèyà	জাতিভুক্ত	tribalism
enu	মুখ	mouth
esin	ধর্ম	horse
esè	আয়	leg
ewà	আচরণের	beauty
fagile	বাতিল করা হয়েছে	cancel
fail	fail	padanu
fan	পাখা	spread
faramó	মেনে চলা	accept
faranse	ফরাসি	french
farsi	arti	farsi
felifeli	মখমল	fuming
ferde	ferde	verde
fesèmúlè	অস্থায়ী উত্স	established
fe	চেয়েছিলেন	want
fi	সংরক্ষণ	by
fifihan	দেখাচ্ছে	revealed
fihan	জ্ঞাপিত	shows, to show
fimú	রুঢ়ভাবে সংজ্ঞায়িত	captivate with
finiki	পদার্থবিদ্যা	finiki
finlandi	ফিনল্যাণ্ড	finland
fitino	পরীক্ষা	judgement
five	পাঁচ	marun
fodio	fodio	fodio
fofinde	নিষিদ্ধ	prohibited
fohùn	চিত্কার	consent
foniimu	চলচ্চিত্র	phoneme
force	বল	agbara
foriko	উদাহরণ স্বরূপ	agreed
fourbase	fourbase	onidi-merin
fowobowe	সংরক্ষণ	signed
fowó	টাকার জন্য	sign
fracmv	fracmv	does not translate
francis	ফ্রান্সিস	francis
fransi	ফরাসি	france
freetown	ফ্রিটাউন	freetown
fuji	অপসারণ	fuji
fulani	অবীর	fulani
fulbe	পরিমাণ	fulbe
fun	জন্য	for
funra	নিজেই	suspect
further	অধিকতর	si
fé	fé	like
fé	fé	want
fégbé	ভুলে যান	for peers
fífò	উড়ন্ত	jumping
fífún	দান	giving
fòye	বোঝা	rationalise
fẹ́rẹ̀ẹ́	প্রায়	nearly
galatia	এইবার	galatia
gba	একমত	accept
gbajúgbujà	খুব জনপ্রিয়	popular
gbale	জনপ্রিয়তা	flourished
gbaná	গুলি করা	engulf in flame/rage
gbe	বহন	set up
gbera	চলো এগোই	move
gberasoke	গতি বাড়ান	rising
gbese	ঋণ	debt
gbigbamulo	শোষণ	adopted
gbigbewo	অর্থায়ন	examined
gbilè	ভাঙ্গা	gaining ground
gbin	নিখাত	farm
gbogbogbo	সাধারণ	general
gbongbo	মূল	root
gbàgbọ́	বিশ্বাস করা	believe
gbàgùrà	shook	gbagura
gbá	সম্পূর্ণ ধ্বংস	received
gbáradì	উঠে পড়	prepare
gbé	লাইভ দেখান	convey
gbédìí	স্থাপন করা	respect
gbékalè	কাঠমিস্ত্রি	establish
gbéni	লাইভ দেখান	lift
gbéyèwò	পুনঃমূল্যায়ন	examine
gbésè	প্রদান	die
gbìnyànjú	চেষ্টা	endeavour
gbìyànju	আরো কঠোরভাবে চেষ্টা করো	try
gbódò	অবশ্যই	must
gbónmisi	আইন	strife
gbúnùn	এটা শুঁক	hostile
gbọ́dọ̀	অবশ্যই	must
geesi	ইংরেজি	english
geneva	জেনেভা	geneva
genevieve	genevieve	genevieve
georgia	জর্জিয়া	georgia
german	জার্মান	german
gfaj	gfaj	gfaj
ghana	ঘানা	ghana
gidigidi	খুব	significantly
gidí	গৃহ	real
goemai	goemai	goemai
gomina	রাজ্যপাল	governor
gorgina	.গল	gorgina
gquadruplex	gquadruplex	g-gigalonomerin
grammy	গ্র্যামি	grammy
griiki	গ্রিক	greek
groove	খাঁজ	iho
guanínì	guanni	guanine
guinea	গিনি	guinea
guineabissau	guineabissau	guinea bissau
guinébissau	guinébissau	guinea bissau
gun	দীর্ঘ	stretch
gunle	বন্দুক	arrive
guusu	দক্ষিণ	south
gv	গ্লোবাল ভয়েসেস	gv
gèésì	আঠা	english
gèésì	মণি	english
gégé	সত্যিই	like
gírámà	gramps	grammar
gòkè	আরোহণ করা	climb
gún	অনুপ্রবিষ্ট	properly
gúúsù	দক্ষিণ	south
gẹ̀ẹ́sì	ইংরেজি	english
habsburg	habsburg	habsburg
haggai	নির্দেশিকা	haggai
haiti	হাইতি	haiti
halomonadaceae	halomonadaceae	halomonadaceae
hard	কঠিন	lile
haughton	haughton	haughton
hausafulani	hausafulani	hausa fulani
hawaii	হাওয়াই	hawaii
heinrich	হাইনরিখ	heinrich
hendu	মিছরি	hendu
henny	henny	henny
heraklion	heraklion	heraklion
hesse	একমত	hesse
him	তাকে	un, this term is sexless
hindu	hindu	hindu
histoni	histoni	histones
hominidae	hominidae	hominidae
hosea	হোসেয়া	hosea
hp	এইচপি	hp
hugh	হিউ	hugh
hun	হুন	knit
hungari	অনাহার	hungary
hv	hv	hv
ibalo	ব্যাপার	relationship
ibarepo	সংঘ	friendship
ibeji	যুগল	twins
ibewo	এসেছে	visit
ibiamusin	আশ্রয়স্থল	colony
ibile	ঐতিহ্যগত	municipality
ibimo	জন্ম	birth
ibise	workout আপনি	official
ibiti	জায়গা	where
ibn	ইবনে	ibn
ibojì	সমাধি	burial ground
ibori	ঘোমটা	conquest
ibujoko	এজলাস	place of abode
ibuseripadabosi	পরিশোধ	eternity
ibuso	লড়াই করা	bus stop
ibùdó	শিবির	settlement, seat of, area,
ibùjókòó	আসনবিন্যাস	settlement
iceland	আইস্ল্যাণ্ড	iceland
idagbasoke	উন্নয়ন	development
idagbe	অবহেলা	isolation
idaji	অর্ধেক	half
idajo	বিচার	judgement
idamita	আঁকা	sector
idari	নিয়ন্ত্রণগুলি	control
ideraa	লিখতে	comfort
idimule	গ্রেফতার	establishment
idoma	অঙ্কন	idoma
idupe	ধন্যবাদ	thanksgiving
idánwò	পরীক্ষা	examination
ifija	মাছ ধরা	weapon
ifilole	শুরু করা	resolution
ifitonileti	তথ্য	reporting
ifobaje	দুর্নীতি	coronating
ifofinde	কংগ্রেস	prohibition
ifriqiya	উত্তেজন	ifriqiya
igbeduro	প্রস্তুতি	institute
igbegun	বিজয়	declaration of war
igberiko	শহরতলিসুলভ	region
igbesoke	আপগ্রেড	upliftment
igbeyawo	বিবাহ	marriage
igbowolori	ব্যয়বহুল	inflation
igbá	মুরগির মাংস	shell
igbáẹ̀yìn	শেষটা	shell
igitòròmogbè	ব্রডব্যান্ড	willow tree
ihan	প্রদর্শিত	ray
ihinrere	গসপেল	gospel
ijagun	যুদ্ধ	war
ijakadi	সংগ্রাম	wrestling
ijaya	আতঙ্ক	fear
ije	আন্দোলন	eating
ijinnasi	পদার্থবিদ্যা	the wind open
ijosin	পূজা	worship
ijó	নাট্য	dance
ikan	এক	one of
ikandinlogun	আঠার	nineteen
ikaowo	সম্মান	finger
ikejidinlogun	আঠার	eighteen
ikeko	সংকলন	education
ikerin	চতুর্থ	fourth
iketa	উত্তরাধিকারী	third
ikoenu	বাঁচাতে	union
ikojopo	আহরণ	collection
ikoreokere	ফসল ফলানোর	migration
iku	মরণ	death
ikúgbaèyí	এখন	death-has-this
ikún	ভর্তি	squirrel or wild rodent
ilagbolojo	প্রচার	latitude
ilana	কার্যপ্রণালী	procedure
ilanaoye	কৌশল	knowledge procedure
ilaodo	রক্ষা করা	cana
ilaorun	সূর্যোদয়	west
ileasofin	বিধানিক	house of law,
ilegiga	বাড়ি	higher ground or higher plain
ileife	অবহেলা	ile-ife
ileigbimo	সম্মতি	house of assembly/congress
ileobaluaye	বিশ্ব	high chief
ileru	অগ্নিকুণ্ড	volcanic
ilopo	ডবল	times
iluoba	নাগরিক অধিকার	king's town
iluorilejoba	বিশ্বায়নের	capital city
ilé	বাড়ি	house
iléayé	বাড়ি	earth
iléisé	বাড়ি	workplace
ilélódò	ঘর	ile-lodo
iléàtèéré	বাড়ি	ile-ateere
iléńlá	চত্বর	ile-nla (area)
ilẹ	স্থল	land
ilẹ̀ayé	পৃথিবী	the world
iminle	গ্রেফতার করতে	earthquake
imoero	লঘুকরণ	engineering
imojuto	যত্ন	protection
imusin	আঁকা	colony
imú	নাক	nose
imúnisìn	স্বাস্থ্যবিধি	slavery
inagberingberi	বাদামের মাখন	electromagnetic force
indeed	প্রকৃতপক্ষে	paapa julo
indus	সিন্ধু	indus
inkosi	ন্যায্যতা	inkosi
integration	মিশ্রণ	ifowosowopo
inágbéringbérin	সতের	electromagnet
iní	উত্তরাধিকার	possession
inúnibíni	নিপীড়ন	hatred
ioja	মাছ	fight
ioniani	অতি দরিদ্র	ionian
iowa	পৃথিবীতে	iowa
ipare	বিলীন করা	abolition
ipawo	ব্যবহারসমূহ	income
ipele	উচ্চতা	stage
ipin	অধ্যায়	share
ipinpa	অংশগ্রহণ	arm of, branch of
ipinu	রায়	determination
ipo	অবস্থান	position
ipá	বল	effort
iraja	জঘন্য	bargaining
iranlose	সহায়তা	mission
ire	বিক্রয়	you
irele	নম্রতা	irele
iringa	শেষ করি	iringa
irisi	চেহারা	appearance
irorun	খুব সহজ	convenient
irò	গুজব	iro
irúnmọlẹ̀	বজ্র	apparition
isa	যথেষ্ট	jesus, isa or yisa is hausa language
isare	ত্বরণ	track race
isedaniloro	স্ব-সন্দেহ	terrorism
iseero	ঘড়ি	engineering
isejoba	শাসন	governance
iseoba	পনের	civil service
iseoroayeijoun	পুরাতত্ত্ব	archaeology
iseowo	ব্যবসায়	business
isepinpin	বিতরণ	division
iso	আসা	unit
isoponomba	isoponomba	addition of numbers
isun	প্রবাহ	spring
isesi	আত্মসমর্পণ	conduct
isè	সেবা	occupation
itali	ইতালীয়	italy
itanakole	গল্প	ancient
itelentele	স্পষ্টভাবে	coming after
itiraka	সংগ্রাম	effort
itobi	বড়াই করা	size
itokowo	ব্যবসায়	economy
itorawo	উদার	astrology
itu	নিক্ষেপ করা	solution
itumo	অর্থ	meaning
iwadi	গবেষণা	research
iwasi	ইমপ্রেস	behaviour
iwifun	তথ্য	report
iwoile	বাড়ি	entering
iwosan	আরোগ্য	healing
iwulo	দরকারী	use
iwuwa	অনুশীলন করা	behaviour
iyan	দুর্ভিক্ষ	argument
iyato	পার্থক্য	difference
iyawo	নববধূ	wife
iyen	এটাই	that
iyán	ঝিলিমিলি	pounded yam
iḷẹ̀	কাজ	land
iṣẹ́ìwádìí	গবেষণা	research
jabo	প্রতিবেদন	give account
jackson	জ্যাকসন	jackson
jadide	অপেক্ষা কর	emerge
jagbe	হারিয়ে যেতে	shout
jalè	চুরি	steal
jamaica	ইউটিউব	jamaica
jamo	চলে যাও	link
jawaharlal	সোমালিয়ার দিকে নিচ্ছে	jawaharial
jeffrey	জেফ্রি	jeffrey
jeometri	জ্যামিতি	geometry
jesu	যীশু	jesus
jfk	jfk	jfk
jije	হচ্ছে	existing as
jijinna	এ পর্যন্ত	distance
jiròrò	কুয়াশাচ্ছন্ন	dialogue
jo	ফুটো	days
jogun	উত্তরাধিকারসূত্রে	inherit
johann	জাহান্নাম	johann
johanu	দুঃখিত	john
jojo	কর্কশ	great extent
jopò	যোগ দিতে	gathered
jo	জন	resemble
juneau	জূনো	juneau
jàgídíjàgan	হিংসাত্মক	violent
jáde	বাহিরে আস	out
jé	আসা	is
jéésù	যীশু	jesus
jìnnàa	এ পর্যন্ত	further
jíje	হচ্ছে	eating
jíjuwó	টাকা কামানো	waving hands
jíjéomoléyìnkírísítì	একজন পরোপকারী হিসাবে	followers of christ
jùlo	অধিক	most
jùlo	বিশেষত	most
jùló	বেশিরভাগ	most
jẹ́mánì	জার্মান	germany
jọ́	অনুগ্রহ	together
kadara	সম্পদ	destiny
kagera	দাম্ভিক	kagera
kakiri	চিহ্ন	all over
kalinga	cinga	kalinga
kalẹ	আলাদা করা	established
kampala	আলিঙ্গন	kampala
kan	একটি	one
kankan	না	any
kanlè	kanal	established
karbonumarun	thecentricane	5 carbon
karl	কার্ল	karl
karun	পঞ্চম	fifth
karùún	পঞ্চম	fifth
kebbi	নিয়মিত	kebbi
kekere	ছোট	lower
keko	সাক্ষর	learn
kept	রাখা	fi pamo
khoisan	নিকৃষ্ট	khoisan
ki	তাই	not
kiakiajulo	দ্রুততর	rapidly
kiko	আনয়ন	gathering
kikojo	সংকলন	gathering
kikopomo	উত্তাপ	mixed
kikoso	দ্রুত	colonised
kiko	শিক্ষা	making
kikuninu	কল্পনা করা	size
kilhar	বগল	kilhar
kinkinni	ছোট জিনিস	small quantity
ko	অথবা	don't
kodò	নিচে	bow
koidu	koidu	koidu
kojá	ক্রস	pass
kolo	kolo	going
komputa	কম্পিউটার	computer
kong	কং	kong
kongo	কনডম	congo
kookan	এই	one
koto	টোপ	pit
koko	শিক্ষা	make heap
ko	ko	learn
kori	আর না	not found
krio	krio	krio
ku	আপনি	remain
kwara	উদ্দেশ্য	kwara
kàríbẹ́ánì	এ অঞ্চলের	carribean
kàyéfì	আশ্চর্যের কিছু নেই	amazement
ká	এর	we
kánfinkése	অকপটতা	prolonged
kánádà	অবশ্যই	canada
káyé	বিশ্ব	world
kéesì	হাস্যকর	keesi
kékéèké	ছোট	small
kétu	প্রস্তুত হও	ketu
kémíkà	বিপরীত	chemical
kéyìn	পরে	come after,
kìnní	প্রথম	first
kí	অভিবাদন	not
kíko	অধ্যয়নরত	written
kíkọ́	শিখতে	learning
kínu	সস্নেহ	greet
kírísìtì	বড়দিনের পর্ব	christ
kòjòkú	বৃষ্টি	kojoku
kòkó	ইঁদুরটি	cocoa
kòmpútà	কম্পিউটার	computer
kòtò	একটি গর্ত	pit
kòòsí	এইটা না	coaching
kòòkan	প্রত্যেকটি	each
kógo	গরিমা	glorious
kóra	সংগ্রহ করা	participate
kùkú	সর্বোপরি	eventually
kùrání	কোরান	quran
kúkú	সর্বোপরি	now
kúkúrú	সংক্ষেপে	short
kúrò	দূরে	away
kútò	সব	kuto (place)
kúùkù	বিপরীতে	punches; expression meaning 'by force' (ti pa ti kuuku)
kẹrin	চতুর্থ	4
kẹsàán	এখনই	ninth
kẹta	তৃতীয়	third
kẹ́nyà	বিচ্ছেদ	kenya
kọjá	পাস	pass through
kọ̀mpútà	কম্পিউটার	computer
kọ́kọ́	প্রথম	first
kọ́lọ́mú	কলাম	breast owner
kọ́ni	অভাব	teach
laa	চলে যাও	will
laada	পদাঘাত	good fortune
laaka	বিপরীত	important
laarin	মধ্যে	between
labalaba	প্রজাপতি	butterfly
labee	নিম্নদেশে	under
lade	পোরা	crowned
laid	পাড়া	tele
laifi	দোষ	without
languages	ভাষায়	ede
lanka	শ্রীলঙ্কা	lanka
lasile	মুক্তি	laid out
latibe	সেখান থেকে	from there
latigbana	তখন থেকে	from then on
latini	ল্যাটিন	latin
latvia	ল্যাট্ভিআ	latvia
lay	লে	da
le	করতে পারা	can
leboa	লেবো	leboa
lekun	তীব্র	open door
leo	সিংহরাশি	leo
lese	পোস্ট	firmly
less	কম	okeresi
lewaju	অগ্রগামী	front
lewon	কারাবাস	imprisonment
leyi	এটা এখানে	mispelled...should be 'leyin', after
leè	may	can
lilelile	হার্ডকোর	tightly
lilemo	ভাং	sticky
lilongwe	lilongwe	lilongwe
lindi	একরকমের ক্ষারজাতীয় বস্তু	lindi
linear	রৈখিক	dogba
links	লিংক	eka; this is a new word and does not really exist in yoruba
lodo	সংঘটিত	from
lojowaju	ভবিষ্যতে	the future
lojukokoro	লোভী	covetousness
lojúgun	সে ধ্বংস হয়ে গেছে	knee
lokunkun	অনলস	in the dark
loloselu	রাজনৈতিকভাবে	in politics
lopolopo	অনেক	so many
loruko	নাম	name
louvre	louvre	louvre
lovers	প্রেমীদের	awon olufe
low	কম	diye
lo	যাও	than
luanda	লুয়ান্ডা	luanda
luther	লুথার	luther
lynton	lynton	lynton
làgba	সমান	more important
lààmi	চিহ্ন	sign
lààmì	লক্ষণ	significant
lábé	ওজন	under
láfún	প্রদত্ত	cassava food
láimo	ছাড়া	unknown
láké	অট্ট	in ake
lámọ́di	ভাগ্য	lamodi
lápá	অংশ	from
lára	আহত	part of
lárúbáwá	প্রাকৃতিক	arabic
láì	ছাড়া	without
láíláí	না	old
lèe	করতে পারা	can
lèyìn	পরে	after
lédè	ভাষায়	language
léebá	প্রসঙ্গক্রমে	catch up with it
lérìnín	তুষার	erin=laughter; the prefix 'l' is possesive
lérò	কারণ	thought
léyin	পরে	after
léyìn	পরে	after
lérú	দাসত্ব	enslave
lílo	শোষণ	using
lísa	ত্বরণ	a chieftaincy title
lítésò	যন্ত্রণাদায়ক	literature
lóde	বাহিরে	modern
lópez	nipez	lopez
lópó	বিধবা	widow
lórì	আশ্রয়	on the head
lóríba	উপর	subdue
lóti	অনেক	have
lóòótò	হ্যাঁ	truly
lóòótọ́	প্রকৃতপক্ষে	truly
ló	ló	to
lónà	পথে	in a way
lórò	আগামীকাল	become wealthy
lọndọnu	লণ্ডন	london
lọ́dọọdún	সালিয়ানা	yearly
lọ́jà	বাজারে	in the market
maapu	মানচিত্র	map
madeira	beira	madeira
mahatma	মহাত্মা	mahatma
makedonia	ম্যাসাডোনিয়া	macedonia
malabo	মধু	malabo
malay	অধিকৃত	malay
malayopolynesian	malayopolynesian	malayo-polynesian
malaysia	মাল্যাশিয়া	malaysia
mali	দিন	mali
mango	আম	mango
manˈdeːla	mandelala	mandela
marcellus	মার্সেলাস	marcellus
march	মার্চ	march
marku	এইবার	mark
mars	মঙ্গল	mars
maryland	মেরিল্যান্ড	maryland
maseru	সন্দেহ	don't be slave
matheu	matheu	matthew
mathiew	mathiew	mathiew
mathimatiki	গাণিতিক	mathematics
max	সর্বোচ্চ	max
maya	না	maya
mbabane	নেতিবাচক	mbabane
means	মানে	ona (way)
mediteraneani	ভূমধ্য	mediterranean
mefeefa	&#39;পৃষ্ঠা পরিবর্তনের	all six
mejidinlogbon	আটাশ	twenty eight
mejila	বার	twelve
meksiko	মক্সিকো	mexico
melo	কতগুলো	some
member	সদস্য	ara
mercosur	mercosur	mercosur
merin	চার	four
methodologies	পদ্ধতি	anaoniruuru
metropoli	metropoli	metropolis
meucci	মিউচি	meucci
mewar	mewar	mewar
mexico	মেক্সিকো	mexico
michelle	মিশেল	michelle
micronesia	মাইক্রোনেশিয়া	micronesia
miiràn	উপশম করা	another
mimoy	mimoy	mimoy
mimuwa	আঁটসাঁট	import
minnesota	মিনেসোটা	minnesota
minority	নাবালকত্ব	awon ara kekere
mohandas	মোহনদাস	mohandas
mokaleladota	নিবিড়	51, (mokanleladota)
mokanlelogbon	বত্রিশ	thirty-one
mombasa	mombasa	mombasa
monrovia	মনরোভিয়া	monrovia
morgan	morgan	morgan
morogoro	মোটরগাড়ি	morogoro
mozambique	মোজাম্বিক	mozambique
mozilla	মোজিলা	mozilla
mtn	mtn	mtn
mtwara	আবার চয়ন করুন	mtwara
mughal	আয়তন	mughal
mulẹ̀	স্থাপন করা	establish
munispal	munispal	municipal
muungano	muungano	muungano
májèmú	কিছু মনে করবেন না	testament
mère	অঙ্কন	significant
méjèèjì	উভয়	the two
mérindíláàdóta	পঞ্চান্ন	forty-six
méte	পাঁচ	lip
mérìndínlógún	ষোল	sixteen
mérìnlélógójì	চুয়াল্লিশ	44
méta	তিন	three
métèètà	কাঠমিস্ত্রি	the three
méwàá	দশ	ten
ménu	তুমি কি মনে কর	verbally contribute; complete phrase= me nu ba
mímọ́	পবিত্র	holy
míràn	অন্য	other
míìrán	অন্য	other
mííràn	অন্য	other
mò	জ্ঞান	know
mókólà	আঠা	mokola
móra	আরোগ্য	with themselves
mó	m	with
múlẹ̀	ধরে রাখো	select land (farmland)
mẹ́fà	ছয়	6
mẹ́rkúríù	ইঁদুরটি	mercury
mẹ́ta	তিন	3
mẹ́talọ́kan	ত্রিত্ব	trinity
namibia	আসা	namibia
nathaniel	নাথানিয়েল	nathaniel
nato	ন্যাটো	nato
nawojulo	বিরক্তিকর	highest-spending
nawó	আপনার টাকা পেতে	point finger
ncnc	ncnc	ncnc
nebraska	নেব্রাস্কা	nebraska
nefimu	nephim	nefimu
neptune	নেপচুনের	neptune
nevis	নেভিস	nevis
ngbero	পরিকল্পিত	planning
ngubengcuka	ngubengcuka	ngubengcuka
nibe	সেখানে	there
nibere	গোড়ার দিকে	earlier
nigbakan	কখনও কখনও	at one time
nigbà	তারপর	when
nijẹr	নাইকি	niger
nilè	এখানে	remaining
nisinyi	এখন	at present
nitoriidieyi	এর জন্য	because of this
nitoripe	কারণ	because
nitosi	নিকটবর্তী	nearby
niwaju	এগিয়ে	in front of
niyato	প্রভেদ করা	unlike
niye	যথেষ্ট	in number
niyi	এটা এখানে	these
nkan	জিনিস	things
nkàn	ক্যান্সার	something
nnaji	চাচা	nnaji
nobel	নোবেল	nobel
nombamewa	গুণকারক	decimal
nombáméjì	প্রথম দুইটা	two-number
novo	নভো	novo
nri	খাদ্য	nri
nse	নকশা	acting
nso	কাছাকাছি	saying
nsolaboraro	নিরাপত্তা	nso laboraro
nsowikipedia	obowikipedia	saying
ntoka	বিন্দু	indicates
nu	পরিষ্কার	in
nukleotidi	নিউক্লিওটাইড	nucleotides
nukleotidipupo	নিউক্লিওটাইড	cell
numeri	অসাড় অবস্থা	numbers
nwa	বাচ্চা	drill
nàìjíríà	নাইজেরিয়ায়	nigeria
náwo	ব্যয়	spend money
náà	অত্যধিক	that
nì	পর্বত	is
nìnú	দুঃখিত	in
nìyí	এই হল	this is
ní	আছে	on
níbè	সেখানে	there
níbè	সেখানে	there
nífẹ̀ẹ́	ভালবাসতে	love
nígbàtí	কখন	when
nílè	নিচে	on the ground
nílùú	শহরে	in the town
nílẹ̀	মাটিতে	in the land
nínlá	মহান	large
nínu	সুযোগ	in
níní	আছে	having
nípà	অন্তত	by
nítorípé	কারণ	because
nítumò	অর্থ	meaningful
nítòsí	নিকটবর্তী	nearby
nítòótó	ঠিক	truly
nítòótọ́	প্রকৃতপক্ষে	in truth, truthfully
níwájú	এগিয়ে	in front
níyanjú	সুনিশ্চিত	solved
nǹkan	জিনিস	things
nso	শীঘ্রই আসছে	say
oba	ওবামা	king
obairanderan	চাচাত ভাই	hereditary
obere	ছোট	started
obínibí	শ্লীলতা	inborn
ododo	ন্যায়পরায়ণতা	righteousness
ofin	আইন	law
ogbè	অঞ্চল	a divinity
ogun	যুদ্ধ	war
ogunlogo	ভিড়	hundreds
ojo	মত চেহারা	day
ojojumo	দৈনন্দিন	daily
ojoru	উত্তাপ	wednesday
ojukokoro	লালসা	covetousness
ojuoorun	সূর্যাস্ত	atmosphere
ojuse	দায়িত্ব	responsibility
ojùkòsì	বৃষ্টিপাতের পরিমাণ	ojukosi
ojùkòtúu	বৃষ্টিপাতের পরিমাণ	ojukotuu
ojúlùmọ̀	পরিচিতদের	acquaintance
ojútáyé	সান্দ্রতা	public
ojúìwé	পৃষ্ঠা	page
okeere	বিদেশী	distant
okhotsk	okhotsk	okhotsk
oko	ক্ষেত্র	farm
okunkun	অন্ধকার	darkness
okunrin	মানুষটি	male person
olodiajodojuko	একে অপরকে	facing wall
olohun	মালিকদের	god
olojukanna	অবিলম্বে	same surface
olokunkun	হেডফোন	popular
ololugbe	অভাগা	occupants
olopon	উদ্ধত	a local game
olora	চর্বি	fertile
oloselukan	হ্যালো	one political
oloye	প্রতিভা	chief
oluda	স্রষ্টা	creator
oludase	উত্পাদক	separatist
olukoitan	উপাধ্যায়	the writer
olukowe	লেখক	writer
olumojuto	লোভী	overseer
oluparapo	সমাহার	joint
olusoju	পাহারা	ambassador
oluwakiri	অন্বেষণ	explorer
olympus	স্বর্গ	olympus
olódùmarè	সর্বশক্তিমান	almighty god
olóyè	শাসক	chief
olóṣèlú	রাজনীতিজ্ঞ	politics
olùbátan	এই যোগাযোগ	relative
olùdarí	নেতা	director
olùkópa	অংশদাতা	participant
olùkó	উপাধ্যায়	teacher
olùkọ́	শিক্ষক	teacher
omi	পানি	water
omiadalu	বন্যা	mixture
onialjebra	onialjebra	of algebra
onibugbe	প্রজা	population
onigbeja	গঠনমূলক	allied
onigbowo	একটি স্পনসর	sponsor
onigunfenfe	নিষ্ক্রিয়	large angle
onilanaibagbepo	কনডম	constitutional
onilile	বাসগৃহমালিকদের	solid
oninawo	অধমর্ণ	financial
onipin	যুক্তিসঙ্গত	even
onisayensi	যন্ত্রবিৎ	scientific
onisowo	ব্যবসায়ী	trader
oniyewumeji	বাইনারি	two-chamber
oniyijulo	অসাধারণ	highest honour
onje	খাদ্য	food
onka	গণক	counter
onígbàgbó	বৃদ্ধ লোক	believer
oníkólóbó	অবমাননাকর	onikolobo (place)
onílẹ̀	নিচে	land owners; citizens (omo onile)
oníná	আগুন	electronic
onítumò	অনুবাদক	meaning
onítèbọmi	বাপ্তিস্ম গ্রহণ	baptist
onítòhùn	হিসাবরক্ষক	that person
oníwòsàn	প্রতিষেধক	doctor
oníyanjù	অ্যানিমেটেড	persevere
ooni	কুম্ভীর	ooni (king)
ootọ́	সত্য	truth
opec	ওপেক	opec
opposite	বিপরীত	odi
ori	মাথা	top
oriire	অভিনন্দন	success
oriki	পূর্বদেশীয়	name of endearment
orileede	জাতি	country
orileedeajoba	সাম্রাজ্যবাদ	monarchic country
orilejoba	সরকার	seat of government, kingdom
orileominira	উত্তাপ	republic
orinìyìn	একটি গান	songs of praise
orisirisi	বৈচিত্র্য	various
orisun	উৎস	source
orisa	উৎপত্তি	god
oritameta	মাঝখানে	crossway
orudnun	বার্ষিক	mispelled...should orundun, century
oruko	বিশেষ্য	name
oríilè	জাতীয়	land
oríilẹ̀	প্রবন্ধ	land
oríkì	কবিতা	family name
orílèèdè	জাতি	country
orílẹ̀	জাতি	continent
orílẹ́	সন্ধ্যা	nation
orísiirísi	বিভিন্ন	various
orísìí	বৈচিত্র্য	type
orísìírísi	বিভিন্ন ধরনের	various
orúko	ক্ষেত্র	name
oscar	অস্কার	oscar
oseluarailu	অসামরিক	political unit
otherwise	অন্যভাবে	ibaje
otutu	অনেক	coldness
oun	তিনি	it
owojagidijagan	সন্ত্রাসীদের	upheaval
oúnjẹ	খাদ্য	food
odún	বছর	year
ojó	ইটা	day
okùnrín	হাসি	man
olórun	সৃষ্টিকর্তা	god
olósìn	ধার্মিক	rearing
odun	বাত্সরিক	year
olorun	সৃষ্টিকর্তা	god
omonìyàn	মানুষ	human beings
opolo	অনেক	brain
ose	ose	week
oyé	বিশ্ব	harmattan
ofò	সুপ্রভাত	nothingness
opolo	অনেক	brain
paa	বন্ধ কর	back
paapaa	বিশেষত	especially
padá	শুঁটি	go back
palauan	পালায়ুয়ান	palauan
panaˈma	পানামা	panama
panyanan	the_space	spanish
papa	বাবা	specifically
parapọ̀	মিশ্রণ	join
paripari	শেষ	finally
pele	কমনীয়	hello
penh	পেন	penh
penisula	penisula	peninsula
periferi	periferi	periphery
petu	petu	resolve
pelu	মুক্তা	with
phillipines	phillipines	phillipines
pinsi	পড়ন্ত	divided
pinsoto	pinoto	separated
pinu	নির্ধারিত	decide
pipo	অনেক	plenty
pipolongo	বিজ্ঞাপন	publicise
piposi	অনেক	multiplication
platos	platos	plato's
plánẹ́tì	নদীর গভীরতানির্ণয়	planet
po	po	share
pojulo	সর্বোচ্চ	larger
polandi	পালিশ	poland
polaroid	পোলারয়েড	polaroid
population	জনসংখ্যা	ero
portonovo	portonovo	porto novo
portuguese	পর্তুগীজ	portuguese
press	প্রেস	press
produced	উত্পাদিত	yo
protokolu	protocolu	protocol
proton	প্রোটন	kemika alaropo
providence	দূরদর্শিতা	providence
príncipe	প্রিন্সিপি	principe
pupa	লাল	red
px|kùránì	px |	koran or quran; the px  does not belong
pàmò	বিশেষভাবে	pamo (town)
pàràkòyí	অবিলম্বে	parakoyi
pààlà	একটি সীমানা	signalised
pàápàá	বিশেষত	especially
pásíà	ভিত্তিটি	persia
pátáporongodo	একেবারে	entire
pè	নামক	that
pèhìndà	বীর্য	turned back
pèlu	সাথে	with
pèlúpèlú	যেমন	in addition
pèsè	প্রদত্ত	provide
pé	যে	that
péré	কেবল	only
péé	যে	that
pípa	বধ	order
pípèsè	বিধান	providing
pípẹ́	দীর্ঘ	long
pòwe	নীতিবাক্যমূলক গ্রন্থবিশেষ	to say a proverb or wise saying
pò	ভাঁজ	join
púpo	অনেক বেশি	much
púpò	বরং	a lot
quran	কুরআন	quran
ra	কেনা	self
race	জাতি	ere
rajya	আশা	rajya
ramadan	রমজান	ramadan
rank	মর্যাদাক্রম	ipo
reggae	রেগা	reggae
repeats	পুনরাবৃত্তি	tunso
repetejulo	সবচেয়ে সংবেদনশীল	most of all
rere	ভাল	success
research	গবেষণা	agbeyewo
richard	রিচার্ড	richard
right|thumb|px|aworan	ডান | থাম্ব | পিক্স | চিত্র	picture
rinle	সদ্য	emphasise
riresile	রেকর্ডার	humbled, lowered
riro	কল্পনা	thought as
rn	rn	rn
rna	rna	rna
rnarna	rnarna	rna-rna
rnas	rnas	rnas
ro	মনে	thought
robinson	রবিনসন	robinson
roboto	পৃষ্ঠতলের	round
rogbodiyan	দাঙ্গা	riot
rokirika	ব্রাউজিং	publicise
roko	ভিড়	farm work
roma	রোমা	roma
rome	ক্রৌমিয়াম	rome
ronald	রোনাল্ড	ronald
rorùn	সহজ	easy
rossii	rossii	rossii
rural	গ্রামীণ	igberiko
ryan	রায়ান	ryan
ráhàn	হাজির	complain
ránmú	চিন্তা করবেন না	grumble
république	république	republic
ré	গ	his/her
rìn	হাঁটা	should be orin, song or music
ròyìn	রিপোর্ট	give account
rẹ	তার	it
saarc	অপসারণ	saarc
saaree	উচ্চতর	after death
saarland	তলায়	saarland
safari	আফ্রিকায় শিকার অভিযান	safari
saffana	নীলকান্তমণি	savannah
safiwe	তুলনা	describe
safta	সারিবদ্ধ	safta
saheli	সুবিধা	sahel
sakyamuni	পরবর্তী	sakyamuni
sakyas	sakyas	sakyas
salem	সালেম	salem
salàyé	জীবন	explained
sambia	যৌবন	zambia
samioro	সহজলভ্য	signal
santa	সান্তা	santa
say	বলে	so
sb	sb	sb
schwarz	schwarz	schwarz
sea	সমুদ্র	odo
seat	আসন	itedo
segbese	সম্ভবত	take steps
seidamo	স্পষ্ট	identify
semolara	এজমা	accustom
semudaju	অবশ্যই	assure
senegal	সেনেগাল	senegal
sense	ইন্দ্রিয়	sensi
seville	seville	seville
sewadi	অনুসন্ধান	investigate
sharon	শ্যারন	sharon
sibesibe	এখনো	further more
sihamoni	গঠন	sihamoni
sile	পিছনে	previously
silè	ড্রপ	on the ground
sinai	পাপ	sinai
sinsin	ধর্ম	unshakably
sioux	sioux	sioux
sise	রান্না করা	works
sisodagba	ক্রমবর্ধমান	came of age
sisopo	লিঙ্ক	joined
sisupapoerekusu	নিষ্ঠীবন-নিক্ষেপ	neighbouring islands
sisupo	সংখ্যাবৃদ্ধি	concentrated
slovo	slovo	slovo
so	ভালবাসা	turned
sohun	হ্যাঁ	something
solomon	সলোমন	solomon
soon	শীঘ্রই	lai'pe
sopin	শেষ	ended
so	সুতরাং	tells
spectacular	দর্শনীয়	damanran
stella	স্টেলা	stella
structures	কাঠামো	igbekale
suez	সুয়েজ	suez
sugbo	কিন্তু না	but
sugbọ́n	যুক্তিসঙ্গত	but, however
sun	সূর্য	sleep
suny	suny	suny
swahili	সোয়াহিলি	swahili
symmetry	প্রতিসাম্য	ogbooga
sàbúrí	সর্বোপরি	saburi
sàmì	একটি চিহ্ন	signalize
sàn	আরও ভাল	flow
sàngó	দল	sango (god of thunder)
sàì	আমরা হব	un
sápadè	আজ	run to
sáàpàdé	জামিনদার	saapade
sáààrin	মাঝে	between
são	নতুন একটি	sao
sèle	চুরি	down
ségun	কাদতে	conquered
sénégal	বীর্য	senegal
séyìn	পেছনে	back
séyìn	পেছনে	at the back of
sìbẹ̀	এখনো	there
sìni	চিংড়ি	likewise
síbèsíbè	তবু	further more
síbú	মাটিতে	ocean
sílẹ̀	হতাশ করা	drop
síse	কাজ	doing
síso	এখনো	spoken
síso	এখনো	saying
síta	বাহিরে	outing
síwon	তাহাদিগকে	to them
síwájú	অগ্রগামী	comes before
síí	এখানে	on it
sòrò	মগজ-ধোলাই	talk
sójà	সৈনিক	soldier
sóko	উদ্ভিদ	to the farm
sùgbón	বিপরীতে	but
sọ	বলে	lose
si	অবশ্যই	to
síse	গঠন	performing
sùgbón	বিপরীতে	but
se	তারা করে	do
sepò	পরিশেষে	cooperation
sisé	কাজ করা	work
sááju	এক মিনিট সময় নিন	before
sísa	s .ía	to be
sísè	অনুবাদ	step
tabi	অথবা	or
tabili	টেবিল	table
tabora	পরিহার	tabora
taino	dino	taino
tainos	taínos	tainos
takuntakun	সীমাবদ্ধতার	valiant
talaka	দরিদ্র	poor
talika	দারিদ্র্য	the poor
tara	নয়	wholly
tata	ছাঁকনি	wildly
taínos	taínos	tainos
technology	প্রযুক্তি	tekinoloji
tedo	ডেটিং	stay
teksas	টেক্সাস	texas
tele	অনুসরণ	before
temptation	চাইছেন	idanwo
terutomo	terutomo	everybody
tfrac	tfrac	tfrac
the	দ্য	does no directly translate
they	তারা	won
those	সেগুলো	awon
thumb|left|upright|nelson	থাম্ব | বাম | খাড়া | নেলসন	apa osi naro
tira	ক্রিয়ার কাল	quranic verse
tirana	তিরানা	tirana
tirè	তার	own
titu	অঙ্কুর	cold (if it's a person's name, it is tutu)
tiwọn	তাহাদেরই	theirs
to	প্রতি	it
toje	বিরল	that is
tokasi	চিহ্নিত করা	pointing to
tokyo	টোকিও	tokyo
tolerejulo	সহ্য	most profitable
tolórítelémù	ব্যাপক হত্যাকাণ্ড	all manners of people
tomé	টমেটো	tome
tooto	সত্যিই	true
tori	টোরি	because
torun	শ্যামাঙ্গিনী	heavenly
toseluaralu	রাজনৈতিক	political
tounsejanu	মৃতু্যঘটিত	control
traduite	traduite	traduite
translated	অনূদিত	tunmo
tumosi	মানে	means
tuntun	নতুন	new
tàsí	ছাড়া	or
tàwon	তাহাদিগকে	theirs
táawà	মাথা নত করতে	we
tèlé	অনুসরণ	before
tètè	দ্রুত	quickly
tèlé	অবিলম্বে	follow
tèsíwájú	উন্নতির জন্য	progress
té	টি	follow
télè	দ্বারা	before
té	t	shamed
títi	বদ্ধ	till
títèlé	অনুসরণ করা	following
títío	পর্যন্ত	until
tíátà	টিকেট	theater
tíórì	টায়ার	that is seen
tò	সেট	enough
tóbi	বড়	big
tódárajùlọ	সেরা	most beautiful
tókù	বিশ্রাম	others
tówùú	যে কোন পরিমান	whatever
tó	tó	taught
tóka	উদাহৃত	pointed
tú	ঢেলে	untie
túmò	বরই	means
túnse	পুনরায় সাজান	restructured
tẹ̀ǹbẹ̀	তারপর	rivalry
tẹ̀ǹbẹ̀lẹ̀kun	চক্রান্ত	bitterness
ucb	ইউসিবি	ucb
umueri	শিশু	umueri
unifasiti	বিশ্ববিদ্যালয়	university
unla	হ্যাঁ	great
urasílì	uracil	uracil
uribe	আভা	uribe
usps	usps	usps
utah	উটাহ	utah
utc	ইউটিসি	utc
uzbek	রাস্তা	uzbek
venezuela	ভেনেজুয়েলা	venezuela
vermont	ভারমন্ট	vermont
victor	বিজেতা	victor
videos	ভিডিও	fidio
vihara	বিহার	vihara
villa	উদ্যানবাটি	villa
viruses	ভাইরাস	awon eran
visit	দর্শন	ibewo
vz	vz	vz
waa	এইটা	ours
waju	মুখ	future
wari	গন্ধ	once existing
westminster	ওয়েস্টমিনস্টার	westminster
wisconsin	উইসকনসিন	wisconsin
witkin	witkin	witkin
wiwari	আবিষ্কার	discovered
województwo	cheworddztwo	wojewodztwo
wole	সাইন ইন করুন	into
woo	পাণিপ্রার্থনা করা	look
wo	এখানে	enter
wo	এখানে	look
won	তাহাদিগকে	they
wura	স্বর্ণ	gold
wyoming	ইয়মিং	wyoming
wàásù	গাহা	preach
wì	ধুয়ে ফেলুন	that
wípè	নির্মলতা	that
wòfún	এক পলক দেখা	convenient
wònyí	এইগুলো	these
wón	তাহাদিগকে	they
wúnrèn	কাজ করা	small amount
wọn	তাহাদিগকে	they
wọ̀nyí	এইগুলো	these
xd	xd	xd
xiv	চতুর্দশ	xiv
yafran	বর্ণমালা	yafran
yakubu	ইয়াকুব	yakubu
yan	নির্বাচন করা	choose
yanjú	সমাধান	solve
yanturu	প্রচুর	abundant
yaoundé	এওনডে	yaounde
yewo	উন্নতি	examine
ye	হাঁ	suitable
ye	হাঁ	should
yindinyindin	কখনো থেমো না	brightly
yio	হইবে	will
yiowu	এটা হবে	any
yipada	ঘুরিয়ে	change
yiyafunnilo	ক্ষয়	borrow
yoo	ইচ্ছাশক্তি	will
yori	এলইডি	result
york	ইয়র্ক	york
yorúbà	দই	yoruba
yo	yo	remove
yànan	আশ্চর্য	scattered
yàtò	সেট আপ	other than
yára	তারাতারি কর	quickly
yèwò	বর্ণন	examine
yée	তাদেরকে করতে দাও	eplained to
yì	যাওয়া	this
yìí	এই	this
yí	ঘুরিয়ে	this
yíyípadà	পরিবর্তন	changed
yíì	তুমি করবে	this
yíò	এটা হবে	it will
yẹ̀ẹ́	কেমন লাগলো	check
yọ	অপসারণ	bring out
zanzibar centralsouth	জানজিবার সেন্ট্রালসাউথ	zanzibar centralsouth
zdna	zdna	z-dna
zou	মালভূমি	zou
zscores	zscores	z-scores
zy	zy	zy
 bce	দূরে	bce
àbe	বানরজাতীয় প্রাণিবিশেষ	under
àbámẹ́ta	বৃহস্পতিবার	saturday
àbáyo	পরামর্শ	breakthrough
àbìkú	অমরত্ব	'born to die' child
àbọ̀	অর্ধেক	result
àdámò	গোপনীয়তা	earmark
àdátá	বিপরীত	adata
àdáátán	একচেটিয়া	adaatan
àdóolóró	তেল	bomb
àgbàjọ	বৃদ্ধ লোকটি	assembly
àgbàrá	বন্যা	power
àgbáríjọ	সংগঠন	combination
àgbékà	বিমূর্ত	suitable
àgbéyèwò	পুনঃমূল্যায়ন	examination
àgbìgbò	আশপাশ	a type of bird
àgbùdo	গজ	corn
àgọ́	তাঁবু	ago
àifète	উদ্দেশ্য	unable to keep quiet
àjo	ভ্রমণ	board
àjákọ	পৃথক্	ajako
àjọṣepọ̀	সামাজিক	union
àkosílè	বিমূর্তন	written
àkosílè	গবেষণামূলক প্রবন্ধ	written account
àkàrà	কেক	bean pudding
àká	তাক	store
àkójopò	গ্রুপ	collection
àkókó	সময়	previous
àlàkalè	গোল	breakdown, explanation of actions
àlàyé	তথ্য	explanation
àlàáfíà	শান্তি	peace
àlááfià	উপমা	wellbeing
àlè	জারজ	mistress, concubine, (side booty)
àlèpò	উপরে	joined together
àlébù	কলঙ্ক	ills
àmérìkà	অতিপ্রাকৃত	america
àmì	চিহ্ন	sign
àmúlò	ব্যবহারিক	synonyms
àmúsorò	মনোবিজ্ঞান	resources
ànfàní	সুযোগ	opportunity
àpapọ̀	সার্বিকভাবে	federal
àpeere	উদাহরণ	example
àrígbámú	ধকল	assistant
àrùn	রোগ	disease
àrẹ	সভাপতি	president
àse	পরব	authority
àsàjemátèe	ভোর	cunning
àsèyìn	ভবিষ্যৎ ফল	at the end
àsìkò	সময়	time
àsótélè	প্রসার	prophecy
àsọdọ̀kan	ঐক্য	unitary
àsekúdórógbó	বাকল	do or die
àsà	প্রথা	habit, culture, norm
àtijo	অপ্রচলিত	olden days
àtìpó	ভিনগ্রহবাসী	sojourn
àtòrìnká	প্রায় কাছাকাছি	urinating while walking
àtúnse	সম্পাদন করা	modification
àtúnse	সম্পাদন করা	renovate, fix
àtẹnudẹ́nu	মৌখিক	oral
àwon	তত্ত্ব	they
àwón	টাকা	the
àwón	টাকা	the
àwùjo	সমাজ	community
ààtò	অনুষ্ঠান	suitability
ààyè	জীবিত	space
àárín	মাঝখানে	middle
àáyá	বীর্য	seconds
àìkó	স্বল্পতা	unlearned
àìní	প্রয়োজন	lack
àìròtélè	অপ্রত্যাশিত	unthought of
àìsí	অনুপস্থিতি	lack
án	টি	it
áwon	ব্যভিচার	those
èbà	মশা	cassava flour food
èbúté	বন্দর	shore
èdá	সৃষ্টি	creature
èdè	ভাষা	language
èdè	ভাষা	language
èfòn	ক্রিয়ার কাল	efon
èhìn	পরবর্তী	outskirt
èka	শাখা	branch
èkejì	অন্যটি	second
èlò	পাত্রে	tool
ènìkan	কিছু	someone
èràn	রোগ	virus
èrò	চিন্তা	thoughts
èsó	মসজিদ	modesty
èsúrú	বীজে পিঁপড়ে না ধরতে	yam (indigenous to west africa)
ète	উদ্দেশ্য	plan
èyì	সম্মান	this
èka	প্রভাব	branch
èro	চিন্তা	machine
èrí	প্রমান	witness
èsìn	ধর্ম	religion
èwù	শার্ট	clothe
èpón	অনেক	modifier
ìbarà	জ্বর	ibara (town)
ìbánisòrò	সংযোগ	dialogue
ìbáraeni	বহন	to themselves
ìbílè	জন্মাধিকার	local
ìbílè	জন্মাধিকার	local
ìdàgbà	সাবালকত্ব	grow
ìdàpapọ̀	একত্রীকরণের	union
ìdàrúdàpò	বিশৃঙ্খলা	misunderstanding
ìdá	ছলনা	division
ìdìmú	ঝামেলা	branch, part
ìdíisin	কারণ	idi-isin
ìdíwòn	আপনার কারণ	criteria
ìdó	দংশন	ido (a person's name)
ìfara	যন্ত্রণা	self
ìfojúìtànìgbesiayé	জীবনী	biography
ìfáàrà	একটি পুরোহিত	introduction
ìgbonnìbí jé	এটা একটা দূর্যোগ	igbonnibi
ìgbà	সময়	when
ìgbàgbé	ভুলো	forgetfulness
ìgbá	ডানা	time
ìgbáraga	শক্তি	pride
ìgbéraga	গর্ব	pride
ìgbésí	জীবন	life
ìgbò	র্যাম	igbo people
ìhun	লোহা	things
ìjo	নাচতে	church
ìjo	গির্জা	church
ìjoba	সরকার	government
ìjora	ঘৃণা	resemblance
ìjìnlè	রহস্য	comprehensive
ìjìnlè	রহস্য	mysterious
ìjò	নেতা	consent
ìjọba	সরকার	government
ìkejì	অন্যটি	second
ìkànna	একই	ikanna (town)
ìkèrèkú	পূর্ণতা	ikereku
ìkéde	ঘোষণা	advert
ìkìjà	একটি চ্যালেঞ্জ	ikija
ìkìlò	অপব্যবহার	warning
ìkínin	ষষ্ঠ	greetings
ìkẹrin	চতুর্থ	fourth
ìkọpa	অংশগ্রহণ	ikopa
ìlera	স্বাস্থ্য	health
ìlo	কল	use
ìlà	রূপরেখা	border
ìlànàn	বিভ্রম	procedure
ìlàorùn	চূর্ণ	east
ìlàìnàró	নিপীড়ন	vertical
ìlè	উত্কোচ গ্রহণ	land
ìlé	বাড়ি	land
ìmò	সাপ	knowledge
ìmò	বজ্র	knowledge
ìmóbìdo	জন্মগত অধিকার	imobido
ìmú	নাক	knowledge
ìmúnilérú	নির্যাতনের	slavery
ìmúsára	আরও শক্তিশালী করতে	contagious
ìnagije	বিজয়	alias
ìnáwó	ব্যয়	expenditure
ìpolongo	বিজ্ঞাপন	advertisement
ìpìlẹ̀núkléù	জোড়া লাগানো	base
ìpìnlè	শুরুতে	foundation
ìpínrò	অনুচ্ছেদ	economize
ìrànlọ́wọ́	সাহায্যের	help
ìrànàna	সাহায্যের	path-clearing
ìràwọ̀	তারাগুলো	s
ìrí	অভিজ্ঞতা	sight
ìròkò	চিন্তার	iroko
ìròyìn	খবর	news
ìròyìnwiki	খবর	wikinews
ìròrùn	বিভ্রম	peaceful
ìró	শব্দ	sound
ìrúbo	পতন	sacrifice
ìsawo	ভবিষ্যৎ কথন	divinity-practice
ìse	কর্ম	behaviour
ìsinsìnyí	এখন	modern
ìsirò	হিসাব	adding
ìsomó	যোগদান করতে	attachment
ìsàlè	সূর্যাস্ত	down town
ìsèlè	উৎপাদন	happening
ìsìn	ধর্ম	worship
ìsòrò	ধ্যান	speech
ìsòrí	মহকুমা	chapter
ìsú	বেধ	lump
ìsọ	দোকান	stall
ìse	কর্ম	work
ìsègbèfábo	অধ্যবসায়	female support
ìsèdá	সৃষ্টি	creation
ìsèjoba	সরকার	government
ìsílé	বাড়ি	house opening
ìsòro	অসুবিধা	problem
ìse	কর্ম	action
ìta	বাহিরে	outside
ìtaeko	কারখানা	outskirts of eko
ìtan	ইতিহাস	story
ìtokò	পাত্র	story
ìtàn	ইতিহাস	history
ìtànkálé	বন্যা	spread
ìtèsíwájú	উন্নতি	progress
ìtójú	যত্ন	treatment
ìtóju	বিশৃঙ্খলা	treatment
ìtójú	মুখের অভিব্যক্তি	treatment
ìtóka	মারধর করা	dictionary
ìtúmò	অনুবাদ	meaning
ìtúpalè	অনুবাদ	exposition
ìwe	তুলনা	book
ìwo	শিং	horn
ìwàásù	প্রচার	sermon
ìwéré	পুস্তিকা	iwere (town)
ìwò	সামগ্রিক	set
ìwòran	দৃষ্টি	viewing
ìwúlò	দরকারী	usefulness
ìya	দুর্ভোগ	mother
ìyapa	বিচ্ছেদ	divorce
ìyàwó	কনে	wife
ìyípadà	রূপান্তর	transformation
ìṣèlú	রাজনীতি	politics
ìṣẹ́kù	বাকি	broken
ìṣọ̣̀tẹ̣̀	নিউমোনিয়া	rebellion
òde	বাহিরে	society
òdeojú	পরিচয়হীন	surface
òdo	যৌবন	zero
òdìkejì	অন্যটি	opposite
òféàrán	একটি চিত্র	a town name
ògbójú	উপযুক্ত	brave
ògiri	প্রাচীর	wall
ògo	গরিমা	glory
ògun	ওষুধ	medicine
ògúndìpẹ̀	চূর্ণিত	ogundipe
òjo	মত চেহারা	ojo
òjísé	ডাক্তার	servant
òkèògbún	এক হাজার	oke-ogbun
òkòòkan	একটার পর একটা	each
òkú	ওই মৃতদেহগুলিকে	corpse
òkúta	দস	stone
òle	গৃহিনী	lazy
òmiràn	যাদুকর	other
òmùàrán	একটি চিত্র	omu-aran (town)
òní	আজ	today
òotó	সত্য	true
òpópóònà	রাস্তা	highway
òranyàn	বাধ্যতামূলক	a must
òrìsà	মূর্তি	god
òrí	অধ্যায়	top
òrò	মস্তিষ্ক	word
òsán	দুপুর	afternoon
òsèlú	রাজনীতিজ্ঞ	politics
òsèré	ক্রীড়াবিদ	player
òwù	কাপড়	owu
òṣèlú	রাজনীতি	politician
òjògbón	বৃষ্টির আবহাওয়া	learned person
òkan	এক	heart
òkòòkan	একটার পর একটা	each
òpòlopò	অনেক	many
òré	খেলা	friend
òfò	পরবর্তী	sorrowful
òpòlopo	অনেক	lot of
òré	খেলা	friend
òrò	চিন্তা	word
òsà	গোল্ডফিশ	lagoon
òwó	টাকা	hand
òrò	চিন্তা	word
òròàjòmó	সকাল	part of speech
ó	এটা	that
óníse	তিনি একজন ডিজাইনার	stricken
ósírísì	মুখের লালা	diverse
ósékú	তিনি মৃত	die suddenly
ó	হ্যাঁ	word
ôdún	বছর	year
únṣẹlẹ̀	ভূমিকম্প	formed
şe	করা	do
ʔaːnaːtɕɑ̀k	অনুসন্ধান করুন	not yoruba
ˈøːstəˌʁaɪç	øːstəˌʁaɪç	austria
ˌkælɪˈfɔrnjə	ɪkælɪfɔrnjə	not yoruba
ˌæləˈbæmə	অসুস্থতা	not yoruba
κάππα	.α	does not translate
σ	σ	does not translate
ṣiṣé	উদ্বোধন	work
ṣàkóbá	ক্ষতিকর	incriminate
ẹdo	রসিকতা	edo
ẹlẹ́bùn	একটি উপহার	award winner
ẹlẹ́sìn	ধার্মিক	religionist
ẹnìkan	এক ব্যক্তি	someone
ẹsẹ	পা দুটো	verse
ẹtì	যকৃৎ	friday
ẹ̀kaawon	জমা	branch of
ẹ̀kabrítánì	চাচা	part of britain
ẹ̀kajuly	মে	chapter july
ẹ̀kaoṣù	কণ্টকাকীর্ণ	month
ẹ̀kasístẹ̀mù	বিষয়ী	sistemu=system
ẹ̀kẹ́ta	তৃতীয়	third, the third
ẹ̀kọ́	শিক্ষা	teachings
ẹ̀ni	who	person
ẹ̀rọ	যন্ত্রপাতি	machine
ẹ̀wẹ̀	অন্য দিকে	leaf
ọbàkàn	সৎ ভাই	step-sister
ọdún	বছর	year
ọlọ́mọ	শিশু	members
ọlọ́run	একজন বিধাতা	god
ọmú	আপনি স্তন্যপান	breast
ọmọ	শিশু	c
ọn	এটা	him
ọpọ́lọpọ́	ডুমুর	many
ọ̀dọ́	যৌবন	youth
ọ̀gbìn	উদ্ভিদ	seedlings
ọ̀nà	পথ	ways
ọ̀pòlòpò	কর্ম	various
ọ̀rọ̀	আলাপ	word
ọ̀sẹ	সপ্তাহ	week
