aajo	nevetséges	hospitality
aala	határ	border
aanu	együttérzés	compassion
aapon	aapon	bachelor or spinster (bachelorette)
aare	aare	president
aawe	bénulás	fasting
abala	a rész	division
abeikojopo	örökösnő	subset
abeorile	hazatérés	nation
abesahara	szór	under the sahara
abidi	ábécé	abidi
abidjan	valaha	abidjan
abo	nőies	security
aburunmu	utálatunk	reduced in value, diminished
abálájo	tapasztalt	that is why
abé	tű	under
abínibí	állampolgárság	inborn
abúléko	falu	village
accra	accra	accra
adaba	kényelmes	factor
adabaye	rendben	previously-existing
adarihunrun	tisztító	human
addis	addisz	addis
adeda	természet	creator
adiokan	magányos	stubbornness
adágbà	idősebb	adagba
adúgbò kútò	szomszédok az utcán	kuto area
adúgbò mókóla	mucocula	mokola area
adúgbò quarry	kőbánya szomszédok	neighborhood
adúgbò ìdí	szomszédsági okokból	area
afida	a család	element
afomo	például	cleansing
afoyemo	szinopszis	abstract
africa	afrika	africa
african	afrikai	ara afrika
africans	africans	africans
aféfé	szélmalom	air
agba	festék	principal
agbado	kukorica	maize
agbara	erő	power
agbaye	a világ	world
agbeinadie	termőföld	semi-conductor
agbà	egy felnőtt	adult
agbàbò	védő	adopted child
agbára	erő	power
agbéiná	tűzoltó	conductor
agio	kiáltás	agio
aintimulo	aintimulo	un-exploited
aisi	hiány	lack
ajagun	egy kutya	ajagun
aje	gazdaság	trade
ajemoroyin	kihallgatás	reporting
ajibola	napirend	ajibola
ajo	utazás	firms
ajoro	utazás	discussion
ajọra	másolat	resemblance
akiidah	coridah	(non-standard yoruba, this maybe from benin)
akinpelu	tüzérségi	akinpelu
akokolo	időszak	period
akole	nem tudjuk	title
akoni	nekünk nincs	teacher
akopa	legelőször is	participant
akopo	összeállítás	assembly
akátá	sakál	african american
akíkanjú	bátor	courageous
akíngbógun	csaták	akingbogun
akẹ́kọ̀ọ́	diák	students
ala	le-	limit
alaabo	tiltva	protection
alaadanida	felesleges	individual
alaafia	béke	peace
alaafin	törvénytelen	alaafin
aladaani	magán	privately-owned
aladani	magán	self-owned
aladanida	tetszőleges	private
alaidogba	kiegyensúlyozatlan	unequal
alaigbara	ellenállhatatlan	neutron
alaini	szűkölködő	the poor
alakitiyan	aktivista	activist
alakobere	novícius	primary
alalaye	földes	explanatory
alawose	jövőbelátás	mentor
albany	albany	albany
albert	albert	albert
alexandra	alexandra	alexandra
alicia	alicia	alicia
allāh	allah	allah
alominira	függetlenség	independent
alpha	alfa	alpha
alubàbá	apa	drummer
alukuraani	korán	quran
alumoni	gyógyhatású	minerals
alumíníọ̀mù	alumínium	aluminium
alákọ̀bẹ̀rẹ̀	kezdeményező	primary education
alápapò	csere	general
alátise	művész	alatise
aláyèwò	ellenőr	expert
aláísàn	beteg	the sick
alúwo	bumm	traditional cults
alọ́po	pénztárca	tied
amazonas	amazonas	amazonas
americas	americas	americas
amerika	amerika	america
amojeoyipada	átváltható	reform
amosi	mecset	amos
améríkà	amerikai	america
améríkà	amerikai	america
an	egy	him
anabi	a próféta	prophet
anc	anc	anc
andaman	andman	andaman
angkor	angkor	angkor
anita	anita	anita
anschluss	anschluss	anschluss
apagusu	a dél	southern
apaguusuilaorun	délnyugati	south-western
apaguusuiwoorun	délnyugati	part of the south
apailaorun	napkelte	east side
apaiwoorun	nyugati	eastern side
aparapo	kombináció	confederation
apeja	halász	fisherman
apeere	például	example
apis	apis	apis
apòmù	kötény	apomu
apẹ̀rè	kötény	example
arabu	arab	arab
aralíle	tropikus	healthy body
arinkankan	ezt	nationalist
ariso	aris	oral tradition
ariwaarin	közel-kelet	mid-north
ariwaguusu	délnyugati	north-south
arkansas	arkansas	arkansas
aroko	növényzet	composition
aruleyin	szia	carried on the back
arun	betegség	disease
aryan	az aryan	aryan
aráa	fiú testvér	people from
arábíà	betűrendes	arabia
aráròmí	szia	araromi
arópò	megvesztegetés	substitute
arúgbó	öreg kor	elderly
arọ	béna	cripple
asagun	győzelem	intial, first (referring to the 13 colonies)
ascii	kitalál	ascii
aseeto	település	unfair
aseyori	siker	success
asipa	eltérés	first to kill
assessment	értékelés	ayewo
asìko	ostobaság	time; ni asiko=when
asèdá	a természetes	origination
atangbona	atom	emission
atanna	atom	emitter
atigba	elfogadható	from time
atimo	terv	inland
atinrin	nevetés	thin
atun	visszatekerés	also
atunse	javítás	revision
australia	ausztrália	australia
austriahumgary	austriahumgary	austria-hungary
austronesian	ausztronéz	austronesian
austríà	ausztrália	austria
avar	avar	avar
awari	felfedezés	discovery
awo	lemez	of
awonara	érzelem	people of
awoòn	sablon	people
awon	őket	they
awuruju	mágikus	shady
awùjo	udvariasság	society
awújẹ	botrány	root
aya	vers	chest
ayeye	örökkévalóság	celebration
ayàfi	ez rendben van	only if
ayò	igen	game
azikiwe	józan ész	azikwe
aṣòkan	egyedi	united
baa	jelentése	be with
babaláwo	az elválasztó	herbalist
bahrain	bahrain	bahrain
balẹ̀	hadd legyen	settled
bang	bumm	bang
banle	banle	banle
bara	tavaly	themselves
bauxitealumina	bauxitealumina	bauxite/aluminum
bayelsa	bayelsa	beyelsa
bayi	most	like this
bayìí	most	this
bce	el	bce
beauharnais	beauharnais	beauharnais
beijing	peking	beijing
belarus	belarus	belarus
belgium	belgium	belgium
bengal	bengália	bengal
bengali	bengáli	bengal
benin	pad	benin
berber	berber	berber
berlin	berlin	berlin
bernstein	bernstein	bernstein
bharat	bharat	bharat
bharata	gyere vissza	bharata
bibeli	biblia	bible
biribiri	összetörték	intense
black	fekete	dudu
bodies	testületek	ara
bojú	nézd meg	take care
bole	fatörzs	ground
bolt	csavar	bolt
bolívar	bolívar	bolivar
brasil	brasil	brazil
brazzaville	brazzaville	brazzaville
bridgeport	bridgeport	bridgeport
britain	britannia	britain
brítánì	angol	britain
bu	azaz	give
buenaventura	buenaventura	buenaventura
bujumbura	kiterjesztett	bujumbura
burúkú	gonosz	bad
by	által	does not translate directly, does not exist
bàbá	az apa	father
bákannáà	is	likewise
bálè	ballon	lying on the ground
bárakú	függőség	habitual
báyìí	most	this
bèrẹ̀	mindenekelőtt	started
béè	pontosan úgy	than
bòtswánà	a busz	botswana
búburú	rossz	bad
búrú	bátornak lenni	wicked
bẹ̀rẹ̀	az induláshoz	started
bẹ́	törött	also
bẹ́ljíọ̀m	berill	belgium
bẹ́ẹ̀ni	igen	yes
bẹ́ẹ̀sìni	igen	that is it
cairo	düh	cairo
calabar	rágógumi	calabar
canaria	canaria	canaria
cape	köpeny	cape
casablanca	casablanca	casablanca
caslon	kaszinó	caslon
cathedral	székesegyház	cathedral (katidral)
catherine	catherine	catherine
cauchy	cauchy	cauchy
cbc	cbc	cbc
chamorro	chamorro	chamorro
charles	károly	charles
chaskalson	chaskalson	chaskalson
chebbi	gondol	chebbi
cherished	dédelgetett	mu lokunkundun
china	kína	china
cipollone	cipollone	cipollone
clear	egyértelmű	danmanran
code	kód	code
coetsee	coetsee	coetese
coloured	színezett	alawo dudu
coming	eljövetel	yo jade
compared	képest	does not directly translate
computers	számítógépek	komputa, ero ayarabiasa
csto	csto	csto
ct	ct	ct
cunha	torok	cunha
da	és	back; but in this form it is unnecessary
dagbasoke	felnő	developing
dandan	kötelező	a must
dani	holding	hand-held
darapo	csatlakozik	joinedd
daru	elpusztítani	scattered
dates	időpontját,	pada si
delhi	nem	delhi
denver	denver	denver
des	des	des
describes	körülír	se apejuwe (apejuwe=description; se prefix makes it a verb)
desmond	desmond	desmond
development	fejlődés	idagbasoke
didagba	egyenlőség	growing
didasile	intézmény	established
different	különböző	iyato
din	süt	reduced
dinwoju	nézz fel	suitable
divoire	divoire	d'ivoire
doju	szemtől szemben	face
dojú	szemtől szemben	turn face (full phrase is doju ko, to face)
dominic	dominic	dominic
doni	doni	this day
dote	fecseg	rebel
doublehelix	doublehelix	hiliksi abara meji
doublestrand	kettösszái	double-strand
dover	dover	dova
du	du	hustle
due	következtében	nitori
dun	ízletes	sound
dàbíi	mint ez	like
dàpò	cserélje ki őket	mix
dá	készítette	intervene
dágbó	öreg kor	forest
dájó	rendben	pass judgement
dálóríi	köszönöm	about
dáradára	jól	well
dásà	egy casa	peculiar way of saying
dáwó	adományoz	undertake
dé	megérkezett	reach
délànà	elvben	delana
dépò	amennyiben	to a position
dì	lap	be
dìde	merülnek fel	stand
dìró	jobbra	hang on
dìtẹ̀	összeesküszik	rebel
díè	feszült	few
dóko	jó	upstanding
dólà	jól	dollar
dún	hang	sound
dúró	állni	stand (been in existence)
dọ́gba	egyenlő	equal
ea	igen	ea
eba	eba	shore
ebi	család	family
ecomog	ecomog	ecomog
ede	nyelv	language
efrem	effem	efrem
egba	teljesen	cane
egbe	pisztoly	group
egberundun	ezer év	a thousand year
egbo	egy seb	brother
egbé	szomorúság	party
egbò	egy seb	chemicals
egbògi	orvosi	don't know this
eighteen	tizennyolc	ejidinlogun
eka	összetett	branch, department, part
ekeji	a másik	second
eko	oktatás	lagos
elede	sertések	speaker
eleyi	ez	this
eleyii	mint ez	this
elláda	teremtés	ellada
eléde	absztrakt	pig
eléré	sportoló	performer
elòmírà	a alga	freedom
elòmíràn	egy másik	another person
emerging	feltörekvő	ibere-pese
emmanuel	emmanuel	emmanuel
enikéni	mindenki	whoever
enter	belép	wole
enì	elefánt	person
eníbá	láz	such person
epa	földimogyoró	groundnut
ernst	ernst	ernst
erofo	üledék	swamp
erékùsù	sziget	island
eréonítàn	betűszó	written play
eseese	diagram	step by step
esia	jön	asia
esteri	esteri	ester
etisalat	etisalat	etisalat
etymologiae	etymologiae	etymologiae
etíòkun	a tengerpart	beach
euro	euro	euro
euroasia	euroasia	uro-esia
ewe	levél növényen	ewe
ewé	levél növényen	leaf
ewì	költészet	traditional poem
example	példa	apere
eya	kategória	tribe
eyin	tojás	previous
eyonomba	eyonomba	digit
eléja	halászat	fisherman
elòmíràn	valaki más	another person
eka	hatás	branches
eléyàmèyà	etnikai	tribalism
enu	száj	mouth
esin	vallás	horse
esè	bevétel	leg
ewà	magatartás	beauty
fagile	törölve	cancel
fail	fail	padanu
fan	ventilátor	spread
faramó	tartsák be	accept
faranse	francia	french
farsi	arti	farsi
felifeli	bársony	fuming
ferde	ferde	verde
fesèmúlè	ideiglenes forrás	established
fe	kívánatos	want
fi	mentés	by
fifihan	bemutató	revealed
fihan	jelzett	shows, to show
fimú	élesen meghatározott	captivate with
finiki	fizika	finiki
finlandi	finnország	finland
fitino	próba	judgement
five	öt	marun
fodio	fodio	fodio
fofinde	betiltása	prohibited
fohùn	kiáltás	consent
foniimu	film	phoneme
force	kényszerítés	agbara
foriko	például	agreed
fourbase	fourbase	onidi-merin
fowobowe	foglalás	signed
fowó	pénzért	sign
fracmv	fracmv	does not translate
francis	francis	francis
fransi	francia	france
freetown	freetown	freetown
fuji	eltávolítás	fuji
fulani	gyáván	fulani
fulbe	ful	fulbe
fun	mert	for
funra	maga	suspect
further	további	si
fé	fé	like
fé	fé	want
fégbé	felejtsd el	for peers
fífò	repülő	jumping
fífún	így	giving
fòye	megért	rationalise
fẹ́rẹ̀ẹ́	majdnem	nearly
galatia	ezúttal	galatia
gba	egyetért	accept
gbajúgbujà	nagyon népszerű	popular
gbale	népszerűség	flourished
gbaná	lő ki	engulf in flame/rage
gbe	visz	set up
gbera	lépj tovább	move
gberasoke	felgyorsul	rising
gbese	adósság	debt
gbigbamulo	kizsákmányolás	adopted
gbigbewo	finanszírozás	examined
gbilè	kitörni	gaining ground
gbin	beültetett	farm
gbogbogbo	tábornok	general
gbongbo	gyökér	root
gbàgbọ́	hinni	believe
gbàgùrà	rázta	gbagura
gbá	összetör	received
gbáradì	felkelni	prepare
gbé	élő	convey
gbédìí	létrehozni	respect
gbékalè	ács	establish
gbéni	élő	lift
gbéyèwò	felülvizsgálat	examine
gbésè	ajánlat	die
gbìnyànjú	próbáld ki	endeavour
gbìyànju	próbáld erősebben	try
gbódò	kell	must
gbónmisi	törvény	strife
gbúnùn	szagold meg	hostile
gbọ́dọ̀	kell	must
geesi	angol	english
geneva	genf	geneva
genevieve	genevieve	genevieve
georgia	grúzia	georgia
german	német	german
gfaj	gfaj	gfaj
ghana	ghána	ghana
gidigidi	nagyon	significantly
gidí	ház	real
goemai	goemai	goemai
gomina	kormányzó	governor
gorgina	a sas	gorgina
gquadruplex	gquadruplex	g-gigalonomerin
grammy	grammy	grammy
griiki	görög	greek
groove	horony	iho
guanínì	guanni	guanine
guinea	guinea	guinea
guineabissau	bissau-guinea	guinea bissau
guinébissau	guinébissau	guinea bissau
gun	hosszú	stretch
gunle	pisztoly	arrive
guusu	déli	south
gv	gv	gv
gèésì	ragasztó	english
gèésì	drágakő	english
gégé	igazán	like
gírámà	gramps	grammar
gòkè	felmegy	climb
gún	áttört	properly
gúúsù	déli	south
gẹ̀ẹ́sì	angol	english
habsburg	habsburg	habsburg
haggai	útmutató	haggai
haiti	haiti	haiti
halomonadaceae	halomonadaceae	halomonadaceae
hard	kemény	lile
haughton	haughton	haughton
hausafulani	hausafulani	hausa fulani
hawaii	hawaii	hawaii
heinrich	heinrich	heinrich
hendu	cukorka	hendu
henny	henny	henny
heraklion	heraklion	heraklion
hesse	egyetért	hesse
him	neki	un, this term is sexless
hindu	hindu	hindu
histoni	histoni	histones
hominidae	hominidae	hominidae
hosea	hóseás	hosea
hp	le	hp
hugh	hugh	hugh
hun	hun	knit
hungari	éhezés	hungary
hv	hv	hv
ibalo	ügy	relationship
ibarepo	egyesület	friendship
ibeji	ikrek	twins
ibewo	jött	visit
ibiamusin	szentély	colony
ibile	hagyományos	municipality
ibimo	születés	birth
ibise	edzés	official
ibiti	helyek	where
ibn	ibn	ibn
ibojì	síremlék	burial ground
ibori	fátyol	conquest
ibujoko	pad	place of abode
ibuseripadabosi	visszafizetés	eternity
ibuso	harcolni	bus stop
ibùdó	tábor	settlement, seat of, area,
ibùjókòó	ülés	settlement
iceland	izland	iceland
idagbasoke	fejlődés	development
idagbe	elhanyagolás	isolation
idaji	fél	half
idajo	igazságszolgáltatás	judgement
idamita	húz	sector
idari	ellenőrzések	control
ideraa	írni	comfort
idimule	letartóztatás	establishment
idoma	rajz	idoma
idupe	köszönöm	thanksgiving
idánwò	próba	examination
ifija	halászat	weapon
ifilole	dob	resolution
ifitonileti	információ	reporting
ifobaje	vesztegetés	coronating
ifofinde	kongresszus	prohibition
ifriqiya	stimuláció	ifriqiya
igbeduro	készítmény	institute
igbegun	győzelem	declaration of war
igberiko	külvárosi	region
igbesoke	frissíteni	upliftment
igbeyawo	esküvő	marriage
igbowolori	drága	inflation
igbá	csirke	shell
igbáẹ̀yìn	az utolsó	shell
igitòròmogbè	szélessávú	willow tree
ihan	megjelenni	ray
ihinrere	evangélium	gospel
ijagun	harc	war
ijakadi	küzdelem	wrestling
ijaya	pánik	fear
ije	mozgalom	eating
ijinnasi	fizika	the wind open
ijosin	imádat	worship
ijó	tánc	dance
ikan	egy	one of
ikandinlogun	tizennyolc	nineteen
ikaowo	tisztelet	finger
ikejidinlogun	tizennyolc	eighteen
ikeko	összeállítás	education
ikerin	a negyedik	fourth
iketa	örökölni	third
ikoenu	menteni	union
ikojopo	felhalmozódás	collection
ikoreokere	aratás	migration
iku	halál	death
ikúgbaèyí	most	death-has-this
ikún	töltő	squirrel or wild rodent
ilagbolojo	nyilvánosság	latitude
ilana	eljárás	procedure
ilanaoye	stratégiák	knowledge procedure
ilaodo	véd	cana
ilaorun	napkelte	west
ileasofin	törvényhozó	house of law,
ilegiga	itthon	higher ground or higher plain
ileife	elhanyagolás	ile-ife
ileigbimo	beleegyezés	house of assembly/congress
ileobaluaye	a világ	high chief
ileru	kemence	volcanic
ilopo	kettős	times
iluoba	polgárság	king's town
iluorilejoba	globalizáció	capital city
ilé	itthon	house
iléayé	itthon	earth
iléisé	itthon	workplace
ilélódò	a ház	ile-lodo
iléàtèéré	itthon	ile-ateere
iléńlá	udvar	ile-nla (area)
ilẹ	talaj	land
ilẹ̀ayé	a föld	the world
iminle	letartóztatni	earthquake
imoero	könnyítés	engineering
imojuto	gondoskodás	protection
imusin	húz	colony
imú	orr	nose
imúnisìn	higiénia	slavery
inagberingberi	mogyoróvaj	electromagnetic force
indeed	valóban	paapa julo
indus	indus	indus
inkosi	igazolni	inkosi
integration	integráció	ifowosowopo
inágbéringbérin	tizenhét	electromagnet
iní	öröklés	possession
inúnibíni	üldözés	hatred
ioja	hal	fight
ioniani	szűkölködő	ionian
iowa	a földön	iowa
ipare	áttűnés	abolition
ipawo	felhasználások	income
ipele	szint	stage
ipin	fejezet	share
ipinpa	részvétel	arm of, branch of
ipinu	döntés	determination
ipo	elhelyezkedés	position
ipá	kényszerítés	effort
iraja	megdöbbentő	bargaining
iranlose	támogatás	mission
ire	eladás	you
irele	alázatosság	irele
iringa	tedd össze	iringa
irisi	megjelenés	appearance
irorun	nagyon egyszerű	convenient
irò	szóbeszéd	iro
irúnmọlẹ̀	villám	apparition
isa	elég	jesus, isa or yisa is hausa language
isare	gyorsulás	track race
isedaniloro	önbizalomhiány	terrorism
iseero	néz	engineering
isejoba	kormányzás	governance
iseoba	tizenöt	civil service
iseoroayeijoun	régészet	archaeology
iseowo	üzleti	business
isepinpin	terjesztés	division
iso	jönni	unit
isoponomba	isoponomba	addition of numbers
isun	folyam	spring
isesi	megadás	conduct
isè	szolgáltatás	occupation
itali	olasz	italy
itanakole	sztori	ancient
itelentele	világosan	coming after
itiraka	küzdelem	effort
itobi	dicsekedni	size
itokowo	üzleti	economy
itorawo	liberális	astrology
itu	dobni	solution
itumo	jelentését	meaning
iwadi	kutatás	research
iwasi	lenyűgözni	behaviour
iwifun	információ	report
iwoile	itthon	entering
iwosan	gyógyulás	healing
iwulo	hasznos	use
iwuwa	gyakorlat	behaviour
iyan	éhínség	argument
iyato	a különbség	difference
iyawo	menyasszony	wife
iyen	azaz	that
iyán	szikrázó	pounded yam
iḷẹ̀	munka	land
iṣẹ́ìwádìí	kutatás	research
jabo	jelentés	give account
jackson	jackson	jackson
jadide	kitartás	emerge
jagbe	menj a francba	shout
jalè	lopás	steal
jamaica	youtube	jamaica
jamo	menj innen	link
jawaharlal	hinták	jawaharial
jeffrey	jeffrey	jeffrey
jeometri	geometria	geometry
jesu	jézus	jesus
jfk	jfk	jfk
jije	lény	existing as
jijinna	messze	distance
jiròrò	ködös	dialogue
jo	szivárog	days
jogun	örökölt	inherit
johann	pokol	johann
johanu	sajnálom	john
jojo	repedt	great extent
jopò	csatlakozz be	gathered
jo	jános	resemble
juneau	juneau	juneau
jàgídíjàgan	erőszakos	violent
jáde	kijön	out
jé	jön	is
jéésù	jézus	jesus
jìnnàa	messze	further
jíje	lény	eating
jíjuwó	pénzt keresni	waving hands
jíjéomoléyìnkírísítì	mint jótékonysági szakember	followers of christ
jùlo	több mint	most
jùlo	különösen	most
jùló	a legtöbb	most
jẹ́mánì	német	germany
jọ́	kérem	together
kadara	vagyontárgy	destiny
kagera	nagyképű	kagera
kakiri	nyom	all over
kalinga	cinga	kalinga
kalẹ	félretesz, mellőz	established
kampala	kapocs	kampala
kan	egy	one
kankan	egyik sem	any
kanlè	kanal	established
karbonumarun	thecentricane	5 carbon
karl	karl	karl
karun	ötödik	fifth
karùún	az ötödik	fifth
kebbi	állítható	kebbi
kekere	kicsi	lower
keko	írástudó	learn
kept	tartotta	fi pamo
khoisan	alárendelt	khoisan
ki	így van	not
kiakiajulo	a leggyorsabb	rapidly
kiko	fűződő	gathering
kikojo	összeállítás	gathering
kikopomo	melegség	mixed
kikoso	gyors	colonised
kiko	tanulás	making
kikuninu	képzeld el	size
kilhar	hónalj	kilhar
kinkinni	a kis dolog	small quantity
ko	vagy	don't
kodò	lent	bow
koidu	koidu	koidu
kojá	kereszt	pass
kolo	kolo	going
komputa	számítógép	computer
kong	kong	kong
kongo	óvszer	congo
kookan	ez	one
koto	csali	pit
koko	tanulás	make heap
ko	ko	learn
kori	nem több	not found
krio	krio	krio
ku	ön	remain
kwara	címzett	kwara
kàríbẹ́ánì	a régióban	carribean
kàyéfì	csoda	amazement
ká	nak,-nek	we
kánfinkése	találékonyság	prolonged
kánádà	természetesen	canada
káyé	világ	world
kéesì	nevetséges	keesi
kékéèké	kicsi	small
kétu	felkészültnek lenni	ketu
kémíkà	ellenkezőleg	chemical
kéyìn	később	come after,
kìnní	első	first
kí	üdvözöl	not
kíko	tanul	written
kíkọ́	tanulni	learning
kínu	csókolózás	greet
kírísìtì	karácsony	christ
kòjòkú	eső	kojoku
kòkó	az egér	cocoa
kòmpútà	számítógép	computer
kòtò	egy gödör	pit
kòòsí	ez nem	coaching
kòòkan	mindegyik	each
kógo	dicsőség	glorious
kóra	gyűjt	participate
kùkú	végül	eventually
kùrání	a korán	quran
kúkú	végül	now
kúkúrú	dióhéjban	short
kúrò	el	away
kútò	minden	kuto (place)
kúùkù	ellenkezőleg	punches; expression meaning 'by force' (ti pa ti kuuku)
kẹrin	a negyedik	4
kẹsàán	azonnal	ninth
kẹta	harmadik	third
kẹ́nyà	elválasztás	kenya
kọjá	elhalad	pass through
kọ̀mpútà	számítógép	computer
kọ́kọ́	első	first
kọ́lọ́mú	oszlopok	breast owner
kọ́ni	valaminek a hiánya	teach
laa	menj innen	will
laada	rúgás	good fortune
laaka	fordított	important
laarin	belül	between
labalaba	pillangó	butterfly
labee	alul	under
lade	megterhel	crowned
laid	terített	tele
laifi	hiba	without
languages	nyelvek	ede
lanka	lanka	lanka
lasile	kiadás	laid out
latibe	onnan	from there
latigbana	azóta	from then on
latini	latin	latin
latvia	lettország	latvia
lay	világi	da
le	tud	can
leboa	lebo	leboa
lekun	fokozott	open door
leo	oroszlán	leo
lese	posta	firmly
less	kevésbé	okeresi
lewaju	tovább	front
lewon	bebörtönzés	imprisonment
leyi	itt van	mispelled...should be 'leyin', after
leè	lehet	can
lilelile	kemény	tightly
lilemo	kender	sticky
lilongwe	lilongwe	lilongwe
lindi	lúg	lindi
linear	lineáris	dogba
links	linkek	eka; this is a new word and does not really exist in yoruba
lodo	megtörténik	from
lojowaju	a jövőben	the future
lojukokoro	kapzsi	covetousness
lojúgun	feldúlt	knee
lokunkun	energikus	in the dark
loloselu	politikailag	in politics
lopolopo	nagyon	so many
loruko	név	name
louvre	világítónyílás autóhűtőn	louvre
lovers	szerelmeseinek	awon olufe
low	alacsony	diye
lo	tovább	than
luanda	luanda	luanda
luther	luther	luther
lynton	lynton	lynton
làgba	egyenlő	more important
lààmi	jel	sign
lààmì	jelek	significant
lábé	súly	under
láfún	adott	cassava food
láimo	nélkül	unknown
láké	hangos	in ake
lámọ́di	szerencse	lamodi
lápá	rész	from
lára	sért	part of
lárúbáwá	a természetes	arabic
láì	nélkül	without
láíláí	soha	old
lèe	tud	can
lèyìn	később	after
lédè	nyelven	language
léebá	mellékesen	catch up with it
lérìnín	a hó	erin=laughter; the prefix 'l' is possesive
lérò	ok	thought
léyin	később	after
léyìn	később	after
lérú	rabszolgaság	enslave
lílo	kizsákmányolás	using
lísa	gyorsulás	a chieftaincy title
lítésò	szúrós	literature
lóde	kívül	modern
lópez	nipez	lopez
lópó	özvegy	widow
lórì	kikötő	on the head
lóríba	felett	subdue
lóti	sok	have
lóòótò	igen	truly
lóòótọ́	valóban	truly
ló	ló	to
lónà	úton	in a way
lórò	holnap	become wealthy
lọndọnu	london	london
lọ́dọọdún	évente	yearly
lọ́jà	a piacon	in the market
maapu	térkép	map
madeira	beira	madeira
mahatma	a mahatma	mahatma
makedonia	macedónia	macedonia
malabo	édesem	malabo
malay	feltételezte	malay
malayopolynesian	malayopolynesian	malayo-polynesian
malaysia	malaysia	malaysia
mali	nap	mali
mango	mangó	mango
manˈdeːla	mandelala	mandela
marcellus	marcellus	marcellus
march	március	march
marku	ezúttal	mark
mars	mars	mars
maryland	maryland	maryland
maseru	féltékenység	don't be slave
matheu	matheu	matthew
mathiew	mathiew	mathiew
mathimatiki	matematikai	mathematics
max	max	max
maya	nem	maya
mbabane	negatív	mbabane
means	eszközök	ona (way)
mediteraneani	földközi-tenger	mediterranean
mefeefa	nagyjavítás	all six
mejidinlogbon	huszonnyolc	twenty eight
mejila	tizenkét	twelve
meksiko	mexikó	mexico
melo	mennyi	some
member	tag	ara
mercosur	mercosur	mercosur
merin	négy	four
methodologies	módszerek	anaoniruuru
metropoli	metropoli	metropolis
meucci	meucci	meucci
mewar	mewar	mewar
mexico	mexikó	mexico
michelle	michelle	michelle
micronesia	mikronézia	micronesia
miiràn	enyhítésére	another
mimoy	mimoy	mimoy
mimuwa	ragaszkodás	import
minnesota	minnesota	minnesota
minority	kisebbség	awon ara kekere
mohandas	mohandász	mohandas
mokaleladota	kompakt	51, (mokanleladota)
mokanlelogbon	harminckettő	thirty-one
mombasa	mombasa	mombasa
monrovia	monrovia	monrovia
morgan	morgan	morgan
morogoro	gépkocsizás	morogoro
mozambique	mozambik	mozambique
mozilla	mozilla	mozilla
mtn	mtn	mtn
mtwara	válassza újra	mtwara
mughal	hangerő	mughal
mulẹ̀	létrehozni	establish
munispal	munispal	municipal
muungano	muungano	muungano
májèmú	ne bánj	testament
mère	rajz	significant
méjèèjì	mindkét	the two
mérindíláàdóta	ötvenöt	forty-six
méte	öt	lip
mérìndínlógún	tizenhat	sixteen
mérìnlélógójì	negyvennégy	44
méta	három	three
métèètà	ács	the three
méwàá	tíz	ten
ménu	gondolod	verbally contribute; complete phrase= me nu ba
mímọ́	szent	holy
míràn	egy másik	other
míìrán	egy másik	other
mííràn	egy másik	other
mò	tudás	know
mókólà	ragasztó	mokola
móra	gyógymód	with themselves
mó	m	with
múlẹ̀	tartsd gyorsan	select land (farmland)
mẹ́fà	hat	6
mẹ́rkúríù	az egér	mercury
mẹ́ta	három	3
mẹ́talọ́kan	szentháromság	trinity
namibia	jönni	namibia
nathaniel	nathaniel	nathaniel
nato	nato	nato
nawojulo	rejtélyes	highest-spending
nawó	szerezz pénzt	point finger
ncnc	ncnc	ncnc
nebraska	nebraska	nebraska
nefimu	nephim	nefimu
neptune	neptun	neptune
nevis	nevis	nevis
ngbero	tervezett	planning
ngubengcuka	ngubengcuka	ngubengcuka
nibe	ott	there
nibere	korai	earlier
nigbakan	néha	at one time
nigbà	azután	when
nijẹr	nike	niger
nilè	itt	remaining
nisinyi	most	at present
nitoriidieyi	emiatt	because of this
nitoripe	mivel	because
nitosi	közeli	nearby
niwaju	előre	in front of
niyato	különbséget tesz	unlike
niye	elég	in number
niyi	itt van	these
nkan	dolog	things
nkàn	rák	something
nnaji	nagybácsi	nnaji
nobel	nobel	nobel
nombamewa	szaporodását	decimal
nombáméjì	az első kettő	two-number
novo	novo	novo
nri	étel	nri
nse	tervezés	acting
nso	közel	saying
nsolaboraro	biztonság	nso laboraro
nsowikipedia	obowikipedia	saying
ntoka	pont	indicates
nu	tiszta	in
nukleotidi	nukleotid	nucleotides
nukleotidipupo	nukleotid	cell
numeri	zsibbadtság	numbers
nwa	baba	drill
nàìjíríà	nigériában	nigeria
náwo	költség	spend money
náà	is	that
nì	hegy	is
nìnú	sajnálom	in
nìyí	ez az	this is
ní	van	on
níbè	ott	there
níbè	ott	there
nífẹ̀ẹ́	szeretni	love
nígbàtí	amikor	when
nílè	lent	on the ground
nílùú	a városban	in the town
nílẹ̀	földön	in the land
nínlá	nagy	large
nínu	véletlen	in
níní	birtokolni	having
nípà	legalább	by
nítorípé	mivel	because
nítumò	jelentését	meaningful
nítòsí	közeli	nearby
nítòótó	pontosan	truly
nítòótọ́	valóban	in truth, truthfully
níwájú	előre	in front
níyanjú	pozitívan	solved
nǹkan	dolog	things
nso	hamarosan	say
oba	obama	king
obairanderan	unokatestvér	hereditary
obere	kicsi	started
obínibí	udvariasság	inborn
ododo	igazsága	righteousness
ofin	törvény	law
ogbè	vidék	a divinity
ogun	háború	war
ogunlogo	tömeg	hundreds
ojo	hasonló	day
ojojumo	napi	daily
ojoru	melegség	wednesday
ojukokoro	fösvénység	covetousness
ojuoorun	napnyugta	atmosphere
ojuse	felelősség	responsibility
ojùkòsì	csapadék	ojukosi
ojùkòtúu	csapadék	ojukotuu
ojúlùmọ̀	ismerősök	acquaintance
ojútáyé	viszkozitás	public
ojúìwé	oldal	page
okeere	tengerentúli	distant
okhotsk	okhotsk	okhotsk
oko	terület	farm
okunkun	sötétség	darkness
okunrin	a férfi	male person
olodiajodojuko	egymás	facing wall
olohun	tulajdonosok	god
olojukanna	azonnal	same surface
olokunkun	fejhallgató	popular
ololugbe	vesztes	occupants
olopon	gőgös	a local game
olora	zsír	fertile
oloselukan	szia	one political
oloye	zseni	chief
oluda	teremtő	creator
oludase	termelő	separatist
olukoitan	oktató	the writer
olukowe	szerző	writer
olumojuto	kapzsi	overseer
oluparapo	kombináció	joint
olusoju	őr	ambassador
oluwakiri	felfedezés	explorer
olympus	olympus	olympus
olódùmarè	mindenható	almighty god
olóyè	vonalzó	chief
olóṣèlú	politikus	politics
olùbátan	ez a kapcsolat	relative
olùdarí	egy vezető	director
olùkópa	hozzájáruló	participant
olùkó	oktató	teacher
olùkọ́	tanár	teacher
omi	víz	water
omiadalu	árvíz	mixture
onialjebra	onialjebra	of algebra
onibugbe	bérlő	population
onigbeja	konstruktív	allied
onigbowo	egy szponzor	sponsor
onigunfenfe	passzív	large angle
onilanaibagbepo	óvszer	constitutional
onilile	lakástulajdonosok	solid
oninawo	kölcsönvevő	financial
onipin	racionális	even
onisayensi	technikus	scientific
onisowo	kereskedő	trader
oniyewumeji	kétkomponensű	two-chamber
oniyijulo	fantasztikus	highest honour
onje	diéta	food
onka	számológép	counter
onígbàgbó	idős ember	believer
oníkólóbó	gyalázkodó	onikolobo (place)
onílẹ̀	le-	land owners; citizens (omo onile)
oníná	tűz	electronic
onítumò	fordító	meaning
onítèbọmi	megkeresztelkedtek	baptist
onítòhùn	könyvelő	that person
oníwòsàn	a gyógyító	doctor
oníyanjù	élénk	persevere
ooni	krokodil	ooni (king)
ootọ́	igaz	truth
opec	opec	opec
opposite	szemben	odi
ori	fej	top
oriire	gratulálunk	success
oriki	keleti	name of endearment
orileede	a nemzet	country
orileedeajoba	imperializmus	monarchic country
orilejoba	kormány	seat of government, kingdom
orileominira	melegség	republic
orinìyìn	egy dal	songs of praise
orisirisi	fajta	various
orisun	forrás	source
orisa	eredet	god
oritameta	középen	crossway
orudnun	évi	mispelled...should orundun, century
oruko	főnév	name
oríilè	nemzeti	land
oríilẹ̀	cikk	land
oríkì	költészet	family name
orílèèdè	nemzet	country
orílẹ̀	nemzet	continent
orílẹ́	este	nation
orísiirísi	különféle	various
orísìí	fajta	type
orísìírísi	különböző típusok	various
orúko	területén	name
oscar	oscar	oscar
oseluarailu	polgári	political unit
otherwise	másképp	ibaje
otutu	sok	coldness
oun	ő	it
owojagidijagan	terroristák	upheaval
oúnjẹ	étel	food
odún	az év	year
ojó	esős	day
okùnrín	nevetés	man
olórun	isten	god
olósìn	vallási	rearing
odun	évi	year
olorun	isten	god
omonìyàn	emberi lények	human beings
opolo	sok	brain
ose	ose	week
oyé	a világ	harmattan
ofò	jó reggelt kívánok	nothingness
opolo	sok	brain
paa	kikapcsolni	back
paapaa	különösen	especially
padá	hüvely	go back
palauan	palauan	palauan
panaˈma	panama	panama
panyanan	az űr	spanish
papa	papa	specifically
parapọ̀	keverék	join
paripari	vége	finally
pele	bájos	hello
penh	penh	penh
penisula	félsziget	peninsula
periferi	periferi	periphery
petu	petu	resolve
pelu	gyöngyszem	with
phillipines	phillipines	phillipines
pinsi	hanyatló	divided
pinsoto	pinoto	separated
pinu	eltökélt	decide
pipo	sokkal	plenty
pipolongo	hirdetés	publicise
piposi	nagyon	multiplication
platos	platos	plato's
plánẹ́tì	csőhálózat	planet
po	po	share
pojulo	a legmagasabb	larger
polandi	fényesít	poland
polaroid	polaroid	polaroid
population	népesség	ero
portonovo	portonovo	porto novo
portuguese	portugál	portuguese
press	nyomja meg	press
produced	előállított	yo
protokolu	protocolu	protocol
proton	proton	kemika alaropo
providence	gondviselés	providence
príncipe	príncipe	principe
pupa	piros	red
px|kùránì	px | kernel	koran or quran; the px  does not belong
pàmò	kimondottan	pamo (town)
pàràkòyí	azonnal	parakoyi
pààlà	egy határ	signalised
pàápàá	különösen	especially
pásíà	az alagsor	persia
pátáporongodo	teljesen	entire
pè	hívott	that
pèhìndà	sperma	turned back
pèlu	együtt	with
pèlúpèlú	is	in addition
pèsè	biztosítani	provide
pé	hogy	that
péré	csak	only
péé	hogy	that
pípa	levágás	order
pípèsè	ellátás	providing
pípẹ́	hosszú	long
pòwe	közmondások	to say a proverb or wise saying
pò	szeres	join
púpo	túl sok	much
púpò	inkább	a lot
quran	korán	quran
ra	megvesz	self
race	verseny	ere
rajya	remény	rajya
ramadan	ramadan	ramadan
rank	rang	ipo
reggae	reggae	reggae
repeats	ismétlődés	tunso
repetejulo	a legérzékenyebb	most of all
rere	jó	success
research	kutatás	agbeyewo
richard	richard	richard
right|thumb|px|aworan	jobb | hüvelykujj | px | kép	picture
rinle	újonnan	emphasise
riresile	jegyző	humbled, lowered
riro	képzelet	thought as
rn	rn	rn
rna	rna	rna
rnarna	rnarna	rna-rna
rnas	rns	rnas
ro	gondol	thought
robinson	robinson	robinson
roboto	felületek	round
rogbodiyan	lázadás	riot
rokirika	böngészés	publicise
roko	csőcselék	farm work
roma	roma	roma
rome	króm	rome
ronald	ronald	ronald
rorùn	könnyen	easy
rossii	rossii	rossii
rural	vidéki	igberiko
ryan	ryan	ryan
ráhàn	megjelent	complain
ránmú	aggodalom	grumble
république	république	republic
ré	c	his/her
rìn	járni	should be orin, song or music
ròyìn	jelentett	give account
rẹ	neki	it
saarc	eltávolítás	saarc
saaree	kiváló	after death
saarland	a padlón	saarland
safari	szafari	safari
saffana	zafír	savannah
safiwe	összehasonlítás	describe
safta	felsorakozni	safta
saheli	kényelem	sahel
sakyamuni	a következő	sakyamuni
sakyas	sakyas	sakyas
salem	salem	salem
salàyé	élet	explained
sambia	ifjúság	zambia
samioro	elérhető	signal
santa	télapó	santa
say	mond	so
sb	sb	sb
schwarz	schwarz	schwarz
sea	tenger	odo
seat	ülés	itedo
segbese	esetleg	take steps
seidamo	egyértelmű	identify
semolara	asztma	accustom
semudaju	természetesen	assure
senegal	szenegál	senegal
sense	érzék	sensi
seville	sevilla	seville
sewadi	keresés	investigate
sharon	sharon	sharon
sibesibe	még	further more
sihamoni	szerkezet	sihamoni
sile	mögött	previously
silè	cseppek	on the ground
sinai	bűn	sinai
sinsin	vallás	unshakably
sioux	sioux	sioux
sise	főzés	works
sisodagba	felnőni	came of age
sisopo	összekapcsolása	joined
sisupapoerekusu	köpködés	neighbouring islands
sisupo	szorzás	concentrated
slovo	slovo	slovo
so	szeretet	turned
sohun	igen	something
solomon	salamon	solomon
soon	hamar	lai'pe
sopin	vég	ended
so	így	tells
spectacular	látványos	damanran
stella	stella	stella
structures	szerkezetek	igbekale
suez	suez	suez
sugbo	de nem	but
sugbọ́n	racionális	but, however
sun	nap	sleep
suny	suny	suny
swahili	szuahéli	swahili
symmetry	szimmetria	ogbooga
sàbúrí	mindenek felett	saburi
sàmì	jel	signalize
sàn	a jobb	flow
sàngó	banda	sango (god of thunder)
sàì	jól	un
sápadè	ezen a napon	run to
sáàpàdé	szponzorálás	saapade
sáààrin	közte	between
são	az új	sao
sèle	lopás	down
ségun	sírni	conquered
sénégal	sperma	senegal
séyìn	vissza	back
séyìn	vissza	at the back of
sìbẹ̀	még	there
sìni	garnélarák	likewise
síbèsíbè	mindazonáltal	further more
síbú	a földre	ocean
sílẹ̀	cserbenhagy	drop
síse	munka	doing
síso	még mindig	spoken
síso	még mindig	saying
síta	kívül	outing
síwon	őket	to them
síwájú	tovább	comes before
síí	itt	on it
sòrò	agymosás	talk
sójà	katona	soldier
sóko	növény	to the farm
sùgbón	ellenkezőleg	but
sọ	mond	lose
si	biztosan	to
síse	szerkezet	performing
sùgbón	ellenkezőleg	but
se	csinálják	do
sepò	végül	cooperation
sisé	dolgozzanak ki	work
sááju	szánj egy percet	before
sísa	s .ía	to be
sísè	fordítás	step
tabi	vagy	or
tabili	asztal	table
tabora	elkerülés	tabora
taino	dino	taino
tainos	tainos	tainos
takuntakun	korlátok	valiant
talaka	szegény	poor
talika	szegénység	the poor
tara	kilenc	wholly
tata	szűrő	wildly
taínos	tainos	tainos
technology	technológia	tekinoloji
tedo	társkereső	stay
teksas	texas	texas
tele	nyomon követni	before
temptation	keres	idanwo
terutomo	terutomo	everybody
tfrac	tfrac	tfrac
the	a	does no directly translate
they	ők	won
those	azok	awon
thumb|left|upright|nelson	hüvelykujj | bal | egyenes | nelson	apa osi naro
tira	feszült	quranic verse
tirana	tirana	tirana
tirè	övé	own
titu	lő	cold (if it's a person's name, it is tutu)
tiwọn	övék	theirs
to	nak nek	it
toje	ritka	that is
tokasi	rámutatott	pointing to
tokyo	tokyo	tokyo
tolerejulo	tolerálható	most profitable
tolórítelémù	holocaust	all manners of people
tomé	paradicsom	tome
tooto	igazán	true
tori	tori	because
torun	barna	heavenly
toseluaralu	politikai	political
tounsejanu	tragikus	control
traduite	traduite	traduite
translated	lefordított	tunmo
tumosi	eszközök	means
tuntun	új	new
tàsí	nélkül	or
tàwon	őket	theirs
táawà	meghajolni	we
tèlé	nyomon követni	before
tètè	gyorsan	quickly
tèlé	azonnal	follow
tèsíwájú	hogy haladást érjünk el	progress
té	t	follow
télè	által	before
té	t	shamed
títi	zárva	till
títèlé	követni	following
títío	amíg	until
tíátà	jegyek	theater
tíórì	gumiabroncsok	that is seen
tò	készlet	enough
tóbi	nagy	big
tódárajùlọ	a legjobb	most beautiful
tókù	pihenés	others
tówùú	bármennyi	whatever
tó	tó	taught
tóka	idézett	pointed
tú	kitölteni	untie
túmò	szilva	means
túnse	átrendezése	restructured
tẹ̀ǹbẹ̀	azután	rivalry
tẹ̀ǹbẹ̀lẹ̀kun	összeesküszik	bitterness
ucb	ucb	ucb
umueri	gyermekek	umueri
unifasiti	egyetemi	university
unla	igen	great
urasílì	uracil	uracil
uribe	az aura	uribe
usps	usps	usps
utah	utah	utah
utc	utc	utc
uzbek	az út	uzbek
venezuela	venezuela	venezuela
vermont	vermont	vermont
victor	győztes	victor
videos	videók	fidio
vihara	vihara	vihara
villa	villa	villa
viruses	vírusok	awon eran
visit	látogatás	ibewo
vz	vz	vz
waa	ez	ours
waju	arc	future
wari	szag	once existing
westminster	westminster	westminster
wisconsin	wisconsin	wisconsin
witkin	witkin	witkin
wiwari	felfedezés	discovered
województwo	cheworddztwo	wojewodztwo
wole	bejelentkezés	into
woo	udvarol	look
wo	itt	enter
wo	itt	look
won	őket	they
wura	arany	gold
wyoming	wyoming	wyoming
wàásù	prédikál	preach
wì	elmos	that
wípè	világosság	that
wòfún	pillantás	convenient
wònyí	ezek	these
wón	őket	they
wúnrèn	edzés	small amount
wọn	őket	they
wọ̀nyí	ezek	these
xd	xd	xd
xiv	xiv	xiv
yafran	ábécé	yafran
yakubu	yakub	yakubu
yan	választ	choose
yanjú	elhatározás	solve
yanturu	bőven	abundant
yaoundé	yaoundé	yaounde
yewo	javulás	examine
ye	igen	suitable
ye	igen	should
yindinyindin	soha ne állj meg	brightly
yio	köteles	will
yiowu	fog	any
yipada	fordulj meg	change
yiyafunnilo	erózió	borrow
yoo	akarat	will
yori	vezette	result
york	york	york
yorúbà	joghurt	yoruba
yo	yo	remove
yànan	csodálkozás	scattered
yàtò	beállít	other than
yára	siess	quickly
yèwò	néz	examine
yée	hagyd őket	eplained to
yì	megy	this
yìí	ez	this
yí	fordulj meg	this
yíyípadà	változás	changed
yíì	fogsz	this
yíò	fog	it will
yẹ̀ẹ́	tudod	check
yọ	eltávolítás	bring out
zanzibar centralsouth	zanzibár központjában	zanzibar centralsouth
zdna	zdna	z-dna
zou	zou	zou
zscores	zscores	z-scores
zy	zi	zy
 bce	el	bce
àbe	pávián	under
àbámẹ́ta	csütörtök	saturday
àbáyo	javaslat	breakthrough
àbìkú	halhatatlanság	'born to die' child
àbọ̀	fél	result
àdámò	magánélet	earmark
àdátá	az ellenkező	adata
àdáátán	kizárólagos	adaatan
àdóolóró	olaj	bomb
àgbàjọ	az öreg ember	assembly
àgbàrá	árvíz	power
àgbáríjọ	szervezet	combination
àgbékà	absztrakt	suitable
àgbéyèwò	felülvizsgálat	examination
àgbìgbò	szomszédság	a type of bird
àgbùdo	udvar	corn
àgọ́	sátor	ago
àifète	célja	unable to keep quiet
àjo	utazás	board
àjákọ	egymástól	ajako
àjọṣepọ̀	szociális	union
àkosílè	absztrakció	written
àkosílè	tézis	written account
àkàrà	sütemények	bean pudding
àká	polcok	store
àkójopò	csoport	collection
àkókó	az idő	previous
àlàkalè	célok	breakdown, explanation of actions
àlàyé	információ	explanation
àlàáfíà	béke	peace
àlááfià	analógia	wellbeing
àlè	fattyú	mistress, concubine, (side booty)
àlèpò	felett	joined together
àlébù	hiba	ills
àmérìkà	természetfölötti	america
àmì	jel	sign
àmúlò	gyakorlati	synonyms
àmúsorò	pszichológia	resources
ànfàní	lehetőség	opportunity
àpapọ̀	mint egész	federal
àpeere	példa	example
àrígbámú	zavaró	assistant
àrùn	betegség	disease
àrẹ	elnök	president
àse	ünnep	authority
àsàjemátèe	hajnal	cunning
àsèyìn	utóhatás	at the end
àsìkò	idő	time
àsótélè	kiterjesztés	prophecy
àsọdọ̀kan	egység	unitary
àsekúdórógbó	ugat	do or die
àsà	egyedi	habit, culture, norm
àtijo	elavult	olden days
àtìpó	az idegen	sojourn
àtòrìnká	körül	urinating while walking
àtúnse	szerkesztés	modification
àtúnse	szerkesztés	renovate, fix
àtẹnudẹ́nu	orális	oral
àwon	elméletek	they
àwón	a pénz	the
àwón	pénz	the
àwùjo	társadalom	community
ààtò	szertartás	suitability
ààyè	élő	space
àárín	középen	middle
àáyá	sperma	seconds
àìkó	hiány	unlearned
àìní	akar	lack
àìròtélè	váratlan	unthought of
àìsí	hiány	lack
án	t	it
áwon	paráználkodás	those
èbà	szúnyogok	cassava flour food
èbúté	kikötő	shore
èdá	teremtés	creature
èdè	nyelv	language
èdè	nyelv	language
èfòn	feszült	efon
èhìn	a következő	outskirt
èka	ág	branch
èkejì	a másik	second
èlò	felszerelés	tool
ènìkan	valami	someone
èràn	betegség	virus
èrò	gondolatok	thoughts
èsó	mecset	modesty
èsúrú	hangyák	yam (indigenous to west africa)
ète	célja	plan
èyì	méltóság	this
èka	hatás	branch
èro	gondolatok	machine
èrí	bizonyíték	witness
èsìn	vallás	religion
èwù	ing	clothe
èpón	nagyon	modifier
ìbarà	láz	ibara (town)
ìbánisòrò	a kapcsolat	dialogue
ìbáraeni	szállítás	to themselves
ìbílè	elsőszülöttségi	local
ìbílè	elsőszülöttségi	local
ìdàgbà	felnőttkor	grow
ìdàpapọ̀	konszolidáció	union
ìdàrúdàpò	káosz	misunderstanding
ìdá	dezertálás	division
ìdìmú	zavarás	branch, part
ìdíisin	ok	idi-isin
ìdíwòn	az okod	criteria
ìdó	fullánk	ido (a person's name)
ìfara	kínvallatás	self
ìfojúìtànìgbesiayé	élettörténet	biography
ìfáàrà	pap	introduction
ìgbonnìbí jé	ez egy katasztrófa	igbonnibi
ìgbà	idő	when
ìgbàgbé	feledékeny	forgetfulness
ìgbá	szárnyak	time
ìgbáraga	erő	pride
ìgbéraga	büszkeség	pride
ìgbésí	élet	life
ìgbò	kos	igbo people
ìhun	vas	things
ìjo	tánc	church
ìjo	a templom	church
ìjoba	kormány	government
ìjora	gyűlöl	resemblance
ìjìnlè	rejtély	comprehensive
ìjìnlè	rejtély	mysterious
ìjò	vezető	consent
ìjọba	kormány	government
ìkejì	a másik	second
ìkànna	ugyanaz	ikanna (town)
ìkèrèkú	torlódás	ikereku
ìkéde	nyilatkozat	advert
ìkìjà	kihívás	ikija
ìkìlò	visszaélés	warning
ìkínin	a hatodik	greetings
ìkẹrin	a negyedik	fourth
ìkọpa	részvétel	ikopa
ìlera	egészség	health
ìlo	hívás	use
ìlà	vázlat	border
ìlànàn	illúzió	procedure
ìlàorùn	zúzódások	east
ìlàìnàró	elnyomás	vertical
ìlè	megvesztegetés	land
ìlé	itthon	land
ìmò	kígyó	knowledge
ìmò	villám	knowledge
ìmóbìdo	az előjog	imobido
ìmú	orr	knowledge
ìmúnilérú	visszaélések	slavery
ìmúsára	erősíteni	contagious
ìnagije	győzelem	alias
ìnáwó	kiadás	expenditure
ìpolongo	hirdető	advertisement
ìpìlẹ̀núkléù	titkosítás	base
ìpìnlè	a kezdet	foundation
ìpínrò	bekezdések	economize
ìrànlọ́wọ́	segítség	help
ìrànàna	segítség	path-clearing
ìràwọ̀	a csillagok	s
ìrí	tapasztalat	sight
ìròkò	gondolat	iroko
ìròyìn	hírek	news
ìròyìnwiki	hírek	wikinews
ìròrùn	illúzió	peaceful
ìró	hang	sound
ìrúbo	összeomlás	sacrifice
ìsawo	jövőbelátás	divinity-practice
ìse	akció	behaviour
ìsinsìnyí	most	modern
ìsirò	számítás	adding
ìsomó	csatlakozni	attachment
ìsàlè	napnyugta	down town
ìsèlè	termelés	happening
ìsìn	vallás	worship
ìsòrò	elmélkedés	speech
ìsòrí	felosztás	chapter
ìsú	vastagság	lump
ìsọ	üzletek	stall
ìse	akció	work
ìsègbèfábo	szorgalom	female support
ìsèdá	teremtés	creation
ìsèjoba	kormány	government
ìsílé	itthon	house opening
ìsòro	nehézség	problem
ìse	akció	action
ìta	kívül	outside
ìtaeko	műhely	outskirts of eko
ìtan	történelem	story
ìtokò	a bankot	story
ìtàn	történelem	history
ìtànkálé	árvizek	spread
ìtèsíwájú	előrehalad	progress
ìtójú	gondoskodás	treatment
ìtóju	zavar	treatment
ìtójú	arckifejezések	treatment
ìtóka	megverték	dictionary
ìtúmò	fordítás	meaning
ìtúpalè	fordítás	exposition
ìwe	összehasonlítás	book
ìwo	szarvak	horn
ìwàásù	prédikáció	sermon
ìwéré	kis könyv	iwere (town)
ìwò	átfogó	set
ìwòran	látomás	viewing
ìwúlò	hasznos	usefulness
ìya	szenvedő	mother
ìyapa	elválasztás	divorce
ìyàwó	a menyasszony	wife
ìyípadà	átalakítás	transformation
ìṣèlú	politika	politics
ìṣẹ́kù	a maradék	broken
ìṣọ̣̀tẹ̣̀	tüdőgyulladás	rebellion
òde	kívül	society
òdeojú	arctalan	surface
òdo	ifjúság	zero
òdìkejì	a másik	opposite
òféàrán	egy kép	a town name
ògbójú	illetékes	brave
ògiri	fal	wall
ògo	dicsőség	glory
ògun	gyógyszer	medicine
ògúndìpẹ̀	porszerű	ogundipe
òjo	hasonló	ojo
òjísé	az orvos	servant
òkèògbún	ezer	oke-ogbun
òkòòkan	egyenként	each
òkú	elhalt	corpse
òkúta	egy kő	stone
òle	háziasszony	lazy
òmiràn	a varázsló	other
òmùàrán	egy kép	omu-aran (town)
òní	ma	today
òotó	igazság	true
òpópóònà	út	highway
òranyàn	kötelező	a must
òrìsà	bálványok	god
òrí	fejezet	top
òrò	agy	word
òsán	dél	afternoon
òsèlú	politikus	politics
òsèré	sportoló	player
òwù	szövet	owu
òṣèlú	politika	politician
òjògbón	esős időjárás	learned person
òkan	egy	heart
òkòòkan	egyenként	each
òpòlopò	sok	many
òré	játszma, meccs	friend
òfò	a következő	sorrowful
òpòlopo	sok	lot of
òré	játszma, meccs	friend
òrò	gondolatok	word
òsà	aranyhal	lagoon
òwó	pénz	hand
òrò	gondolatok	word
òròàjòmó	reggeltől	part of speech
ó	azt	that
óníse	ő egy tervező	stricken
ósírísì	nyál	diverse
ósékú	ő halott	die suddenly
ó	igen	word
ôdún	év	year
únṣẹlẹ̀	földrengés	formed
şe	csinál	do
ʔaːnaːtɕɑ̀k	.aːnaːtɕɑɕɑk	not yoruba
ˈøːstəˌʁaɪç	øːstəˌʁaɪç	austria
ˌkælɪˈfɔrnjə	ɪkælɪfɔrnjə	not yoruba
ˌæləˈbæmə	betegség	not yoruba
κάππα	.α	does not translate
σ	σ	does not translate
ṣiṣé	nyítás	work
ṣàkóbá	káros	incriminate
ẹdo	tréfa	edo
ẹlẹ́bùn	ajándék	award winner
ẹlẹ́sìn	vallási	religionist
ẹnìkan	egy ember	someone
ẹsẹ	láb	verse
ẹtì	máj	friday
ẹ̀kaawon	beadványok	branch of
ẹ̀kabrítánì	nagybácsi	part of britain
ẹ̀kajuly	lehet	chapter july
ẹ̀kaoṣù	tüskés	month
ẹ̀kasístẹ̀mù	szubjektív	sistemu=system
ẹ̀kẹ́ta	a harmadik	third, the third
ẹ̀kọ́	oktatás	teachings
ẹ̀ni	who	person
ẹ̀rọ	gépezet	machine
ẹ̀wẹ̀	másrészről	leaf
ọbàkàn	féltestvér	step-sister
ọdún	év	year
ọlọ́mọ	gyermekek	members
ọlọ́run	egy isten	god
ọmú	szopsz	breast
ọmọ	gyermek	c
ọn	azt	him
ọpọ́lọpọ́	füge	many
ọ̀dọ́	ifjúság	youth
ọ̀gbìn	növény	seedlings
ọ̀nà	út	ways
ọ̀pòlòpò	akció	various
ọ̀rọ̀	beszélgetés	word
ọ̀sẹ	hét	week
