aajo	హాస్యాస్పదంగా	hospitality
aala	సరిహద్దు	border
aanu	కరుణ	compassion
aapon	aapon	bachelor or spinster (bachelorette)
aare	ఆరే	president
aawe	పక్షవాతం	fasting
abala	భాగం	division
abeikojopo	వారసురాలైన	subset
abeorile	హోమ్కమింగ్	nation
abesahara	చల్లుకోవటానికి	under the sahara
abidi	అక్షరం	abidi
abidjan	ఎప్పుడైనా	abidjan
abo	స్త్రీ	security
aburunmu	మా అసహ్యం	reduced in value, diminished
abálájo	అనుభవం	that is why
abé	సూది	under
abínibí	జాతీయత	inborn
abúléko	గ్రామం	village
accra	అక్ర	accra
adaba	సౌకర్యవంతంగా	factor
adabaye	అయితే సరే	previously-existing
adarihunrun	క్లీనర్	human
addis	ఆడిస్	addis
adeda	ప్రకృతి	creator
adiokan	ఒంటరి	stubbornness
adágbà	పెద్ద	adagba
adúgbò kútò	వీధిలో పొరుగువారు	kuto area
adúgbò mókóla	mucocula	mokola area
adúgbò quarry	క్వారీ పొరుగువారు	neighborhood
adúgbò ìdí	పొరుగు కారణాలు	area
afida	కుటుంబం	element
afomo	ఉదాహరణకి	cleansing
afoyemo	సంక్షిప్తముగా	abstract
africa	ఆఫ్రికా	africa
african	ఆఫ్రికన్	ara afrika
africans	ఆఫ్రికన్లు	africans
aféfé	విండ్మిల్	air
agba	పెయింట్	principal
agbado	మొక్కజొన్న	maize
agbara	శక్తి	power
agbaye	ప్రపంచం	world
agbeinadie	భూములను	semi-conductor
agbà	ఒక వయోజనుడు	adult
agbàbò	రక్షక	adopted child
agbára	శక్తి	power
agbéiná	ఆర్చేవాడు	conductor
agio	క్రై	agio
aintimulo	aintimulo	un-exploited
aisi	లేకపోవడం	lack
ajagun	ఒక కుక్క	ajagun
aje	ఆర్థిక	trade
ajemoroyin	ప్రశ్నించే	reporting
ajibola	ఎజెండా	ajibola
ajo	ప్రయాణ	firms
ajoro	ప్రయాణ	discussion
ajọra	ప్రతిరూప	resemblance
akiidah	coridah	(non-standard yoruba, this maybe from benin)
akinpelu	ఫిరంగి	akinpelu
akokolo	కాలం	period
akole	మా వల్ల కాదు	title
akoni	మా దగ్గర లేదు	teacher
akopa	ప్రప్రదమముగా	participant
akopo	సంగ్రహం	assembly
akátá	నక్క	african american
akíkanjú	వాలియంట్	courageous
akíngbógun	బెటాలియన్	akingbogun
akẹ́kọ̀ọ́	విద్యార్ధి	students
ala	డౌన్	limit
alaabo	వికలాంగ	protection
alaadanida	అవాంఛిత	individual
alaafia	శాంతి	peace
alaafin	అక్రమ	alaafin
aladaani	ప్రైవేట్	privately-owned
aladani	ప్రైవేట్	self-owned
aladanida	ఏకపక్ష	private
alaidogba	అసమతుల్య	unequal
alaigbara	ఎదురులేని	neutron
alaini	ఆదుకోవాల్సిన	the poor
alakitiyan	కార్యకర్త	activist
alakobere	అనుభవం లేని	primary
alalaye	భూసంబంధమైన	explanatory
alawose	భవిష్యవాణి	mentor
albany	అల్బానీ	albany
albert	ఆల్బర్ట్	albert
alexandra	alexandra	alexandra
alicia	అలిసియా	alicia
allāh	అల్లాహ్	allah
alominira	స్వాతంత్య్రం	independent
alpha	ఆల్ఫా	alpha
alubàbá	తండ్రి	drummer
alukuraani	ఖురాన్	quran
alumoni	నివారణ	minerals
alumíníọ̀mù	అల్యూమినియం	aluminium
alákọ̀bẹ̀rẹ̀	ప్రారంబిక	primary education
alápapò	భర్తీ	general
alátise	కళాకారుడు	alatise
aláyèwò	ఇన్స్పెక్టర్	expert
aláísàn	అనారోగ్యం	the sick
alúwo	బూమ్	traditional cults
alọ́po	జేబు	tied
amazonas	అమెజోనాస్	amazonas
americas	అమెరికాలు	americas
amerika	అమెరికా	america
amojeoyipada	కన్వర్టిబుల్	reform
amosi	మసీదు	amos
améríkà	అమెరికన్	america
améríkà	అమెరికన్	america
an	ఒక	him
anabi	ప్రవక్తయైన	prophet
anc	anc	anc
andaman	andman	andaman
angkor	ఆంగ్కోర్	angkor
anita	అనితా	anita
anschluss	అన్స్చ్లుస్స్	anschluss
apagusu	దక్షిణం	southern
apaguusuilaorun	నైరుతీ	south-western
apaguusuiwoorun	నైరుతీ	part of the south
apailaorun	సూర్యోదయం	east side
apaiwoorun	పశ్చిమ	eastern side
aparapo	కలయిక	confederation
apeja	మత్స్యకారులు	fisherman
apeere	ఉదాహరణకి	example
apis	నంది	apis
apòmù	ఆప్రాన్	apomu
apẹ̀rè	ఆప్రాన్	example
arabu	అరబ్	arab
aralíle	ఉష్ణమండల	healthy body
arinkankan	ఇది	nationalist
ariso	ఏరిస్	oral tradition
ariwaarin	మధ్య ప్రాచ్యం	mid-north
ariwaguusu	నైరుతి	north-south
arkansas	arkansas	arkansas
aroko	వృక్ష సంపద	composition
aruleyin	హలో	carried on the back
arun	వ్యాధి	disease
aryan	ఆర్యన్	aryan
aráa	సోదరుడు	people from
arábíà	అక్షర	arabia
aráròmí	హలో	araromi
arópò	లంచం	substitute
arúgbó	పెద్ద వయస్సు	elderly
arọ	మందకొడిగా	cripple
asagun	విజయం	intial, first (referring to the 13 colonies)
ascii	కనిపెట్టండి	ascii
aseeto	పరిష్కారం	unfair
aseyori	విజయం	success
asipa	విచలనం	first to kill
assessment	అంచనా	ayewo
asìko	అర్ధంలేని	time; ni asiko=when
asèdá	సహజమైనది	origination
atangbona	అణువు	emission
atanna	అణువు	emitter
atigba	అనుమతించదగిన	from time
atimo	ప్రణాళిక	inland
atinrin	నవ్వుతూ	thin
atun	రివైండ్	also
atunse	దిద్దుబాటు	revision
australia	ఆస్ట్రేలియా	australia
austriahumgary	austriahumgary	austria-hungary
austronesian	ఆస్ట్రోనేషియన్	austronesian
austríà	ఆస్ట్రేలియా	austria
avar	అవార్	avar
awari	ఆవిష్కరణ	discovery
awo	ప్లేట్	of
awonara	భావోద్వేగం	people of
awoòn	టెంప్లేట్	people
awon	వాటిని	they
awuruju	మాయా	shady
awùjo	మర్యాద	society
awújẹ	కుంభకోణం	root
aya	పద్యం	chest
ayeye	శాశ్వతత్వం	celebration
ayàfi	అది బాగుంది	only if
ayò	ay	game
azikiwe	ఇంగిత జ్ఞనం	azikwe
aṣòkan	వ్యక్తిగత	united
baa	ఉంది	be with
babaláwo	దైవిక	herbalist
bahrain	బహ్రెయిన్	bahrain
balẹ̀	అతడు ఉండనివ్వండి	settled
bang	బ్యాంగ్	bang
banle	banle	banle
bara	గత సంవత్సరం	themselves
bauxitealumina	bauxitealumina	bauxite/aluminum
bayelsa	bayelsa	beyelsa
bayi	ఇప్పుడు	like this
bayìí	ఇప్పుడు	this
bce	దూరంగా	bce
beauharnais	బెయుహర్నైస్	beauharnais
beijing	బీజింగ్	beijing
belarus	బెలారస్	belarus
belgium	బెల్జియం	belgium
bengal	బెంగాల్	bengal
bengali	బెంగాలీ	bengal
benin	బెంచ్	benin
berber	బెర్బెర్	berber
berlin	బెర్లిన్	berlin
bernstein	బెర్న్స్టెయిన్	bernstein
bharat	భారత్	bharat
bharata	తిరిగి రా	bharata
bibeli	బైబిల్	bible
biribiri	చూర్ణం చేయబడింది	intense
black	బ్లాక్	dudu
bodies	శరీరాలు	ara
bojú	ఒకసారి చూడు	take care
bole	బోలే	ground
bolt	బోల్ట్	bolt
bolívar	బొలీవర్	bolivar
brasil	brasil	brazil
brazzaville	బ్రాజవిల్	brazzaville
bridgeport	bridgeport	bridgeport
britain	బ్రిటన్	britain
brítánì	బ్రిటిష్	britain
bu	అంటే	give
buenaventura	బుఎనవెంటుర	buenaventura
bujumbura	విస్తరించింది	bujumbura
burúkú	చెడు	bad
by	ద్వారా	does not translate directly, does not exist
bàbá	తండ్రి	father
bákannáà	అలాగే	likewise
bálè	బెలూన్	lying on the ground
bárakú	వ్యసనం	habitual
báyìí	ఇప్పుడు	this
bèrẹ̀	ప్రారంభించడానికి	started
béè	ఊరికే	than
bòtswánà	బస్సు	botswana
búburú	చెడు	bad
búrú	ధైర్యంగా ఉండు	wicked
bẹ̀rẹ̀	ప్రారంభించడానికి	started
bẹ́	విరిగింది	also
bẹ́ljíọ̀m	గరుడపచ్చ	belgium
bẹ́ẹ̀ni	అవును	yes
bẹ́ẹ̀sìni	అవును	that is it
cairo	rage	cairo
calabar	నమిలే జిగురు	calabar
canaria	కానరియా	canaria
cape	కేప్	cape
casablanca	కాసాబ్లాంకా	casablanca
caslon	కాసినో	caslon
cathedral	కేథడ్రల్	cathedral (katidral)
catherine	కాథరిన్	catherine
cauchy	cauchy	cauchy
cbc	cbc	cbc
chamorro	చమర్రో	chamorro
charles	చార్లెస్	charles
chaskalson	chaskalson	chaskalson
chebbi	అనుకుంటున్నాను	chebbi
cherished	ప్రతిష్టాత్మకమైన	mu lokunkundun
china	చైనా	china
cipollone	cipollone	cipollone
clear	స్పష్టమైన	danmanran
code	కోడ్	code
coetsee	coetsee	coetese
coloured	రంగు	alawo dudu
coming	వచ్చే	yo jade
compared	పోలిస్తే	does not directly translate
computers	కంప్యూటర్లు	komputa, ero ayarabiasa
csto	csto	csto
ct	ct	ct
cunha	గొంతు	cunha
da	మరియు	back; but in this form it is unnecessary
dagbasoke	ఎదుగు	developing
dandan	తప్పనిసరి	a must
dani	పట్టుకొని	hand-held
darapo	చేరడానికి	joinedd
daru	నాశనం	scattered
dates	తేదీలు	pada si
delhi	వద్దు	delhi
denver	డెన్వర్	denver
des	డెస్	des
describes	వివరిస్తుంది	se apejuwe (apejuwe=description; se prefix makes it a verb)
desmond	డెస్మండ్	desmond
development	అభివృద్ధి	idagbasoke
didagba	సమానత్వం	growing
didasile	స్థాపన	established
different	వివిధ	iyato
din	వేసి	reduced
dinwoju	పైకి చూడు	suitable
divoire	divoire	d'ivoire
doju	ముఖా ముఖి	face
dojú	ముఖా ముఖి	turn face (full phrase is doju ko, to face)
dominic	డొమినిక్	dominic
doni	దోని	this day
dote	అతిగారాబం కనబరచు	rebel
doublehelix	doublehelix	hiliksi abara meji
doublestrand	doublestrand	double-strand
dover	డోవర్	dova
du	డు	hustle
due	వలన	nitori
dun	రుచికరమైన	sound
dàbíi	ఇలా	like
dàpò	వాటిని భర్తీ చేయండి	mix
dá	రూపొందించినవారు	intervene
dágbó	పెద్ద వయస్సు	forest
dájó	ఆల్రైట్	pass judgement
dálóríi	ధన్యవాదాలు	about
dáradára	బాగా	well
dásà	ఒక కాసా	peculiar way of saying
dáwó	దానం	undertake
dé	వచ్చారు	reach
délànà	సూత్రం లో	delana
dépò	ఆ మేర వరకు	to a position
dì	షీట్	be
dìde	ఉత్పన్నమయ్యే	stand
dìró	కుడి వైపు	hang on
dìtẹ̀	కుట్ర	rebel
díè	కాలం	few
dóko	మంచిది	upstanding
dólà	బాగా	dollar
dún	ధ్వని	sound
dúró	నిలబడటానికి	stand (been in existence)
dọ́gba	సమాన	equal
ea	అవును	ea
eba	eba	shore
ebi	కుటుంబం	family
ecomog	ecomog	ecomog
ede	భాష	language
efrem	effem	efrem
egba	ఖచ్చితంగా	cane
egbe	తుపాకీ	group
egberundun	వెయ్యి సంవత్సరాలు	a thousand year
egbo	ఒక గాయం	brother
egbé	దుఃఖకరమైన	party
egbò	ఒక గాయం	chemicals
egbògi	వైద్య	don't know this
eighteen	పద్దెనిమిది	ejidinlogun
eka	క్లిష్టమైన	branch, department, part
ekeji	ఇతర	second
eko	చదువు	lagos
elede	పందులు	speaker
eleyi	ఈ	this
eleyii	ఇలా	this
elláda	సృష్టి	ellada
eléde	నైరూప్య	pig
eléré	అథ్లెట్	performer
elòmírà	సముద్రపు పాచి	freedom
elòmíràn	మరో	another person
emerging	ఉద్భవిస్తున్న	ibere-pese
emmanuel	ఇమ్మాన్యూల్	emmanuel
enikéni	ప్రతి ఒక్కరూ	whoever
enter	నమోదు	wole
enì	ఏనుగు	person
eníbá	జ్వరం	such person
epa	వేరుశెనగ	groundnut
ernst	ఎర్నస్ట్	ernst
erofo	అవక్షేప	swamp
erékùsù	ద్వీపం	island
eréonítàn	ఎక్రోనిం	written play
eseese	రేఖాచిత్రం	step by step
esia	వస్తున్నారు	asia
esteri	esteri	ester
etisalat	ఎటిసలాట్	etisalat
etymologiae	etymologiae	etymologiae
etíòkun	తీరం	beach
euro	యూరో	euro
euroasia	euroasia	uro-esia
ewe	ఆకు	ewe
ewé	ఆకు	leaf
ewì	కవిత్వం	traditional poem
example	ఉదాహరణ	apere
eya	వర్గం	tribe
eyin	గుడ్లు	previous
eyonomba	eyonomba	digit
eléja	ఫిషింగ్	fisherman
elòmíràn	ఇంకెవరో	another person
eka	ప్రభావం	branches
eléyàmèyà	జాతి	tribalism
enu	నోటి	mouth
esin	మతం	horse
esè	ఆదాయం	leg
ewà	ప్రవర్తన	beauty
fagile	రద్దు	cancel
fail	fail	padanu
fan	అభిమాని	spread
faramó	కట్టుబడి	accept
faranse	ఫ్రెంచ్	french
farsi	ఆర్టి	farsi
felifeli	వెల్వెట్	fuming
ferde	ferde	verde
fesèmúlè	తాత్కాలిక మూలం	established
fe	కావలెను	want
fi	సేవ్	by
fifihan	చూపుతుంది	revealed
fihan	సూచించబడిన	shows, to show
fimú	తీవ్రంగా నిర్వచించబడింది	captivate with
finiki	భౌతిక	finiki
finlandi	ఫిన్లాండ్	finland
fitino	విచారణ	judgement
five	ఐదు	marun
fodio	fodio	fodio
fofinde	నిషేధిస్తూ	prohibited
fohùn	అరవడం	consent
foniimu	సినిమా	phoneme
force	ఫోర్స్	agbara
foriko	ఉదాహరణకి	agreed
fourbase	fourbase	onidi-merin
fowobowe	బుకింగ్	signed
fowó	డబ్బు కోసం	sign
fracmv	fracmv	does not translate
francis	ఫ్రాన్సిస్	francis
fransi	ఫ్రెంచ్	france
freetown	freetown	freetown
fuji	తొలగిస్తాయి	fuji
fulani	పిరికి	fulani
fulbe	ful	fulbe
fun	కోసం	for
funra	కూడా	suspect
further	మరింత	si
fé	ఫే	like
fé	fé	want
fégbé	మర్చిపో	for peers
fífò	ఎగురుతున్న	jumping
fífún	ఇవ్వడం	giving
fòye	అర్థం	rationalise
fẹ́rẹ̀ẹ́	దాదాపు	nearly
galatia	ఈసారి	galatia
gba	అంగీకరిస్తున్నారు	accept
gbajúgbujà	చాలా ప్రాచుర్యం పొందింది	popular
gbale	ప్రజాదరణ	flourished
gbaná	షూట్ అవుట్	engulf in flame/rage
gbe	క్యారీ	set up
gbera	కొనసాగండి	move
gberasoke	వేగవంతం	rising
gbese	రుణ	debt
gbigbamulo	దోపిడీ	adopted
gbigbewo	ఫైనాన్సింగ్	examined
gbilè	విరిగిపొవటం	gaining ground
gbin	నాటిన	farm
gbogbogbo	సాధారణ	general
gbongbo	రూట్	root
gbàgbọ́	నమ్మకం	believe
gbàgùrà	shook	gbagura
gbá	స్మాష్	received
gbáradì	లే	prepare
gbé	ప్రత్యక్ష	convey
gbédìí	ఏర్పాటు	respect
gbékalè	కార్పెంటర్	establish
gbéni	ప్రత్యక్ష	lift
gbéyèwò	సమీక్ష	examine
gbésè	ఆఫర్	die
gbìnyànjú	ప్రయత్నించండి	endeavour
gbìyànju	గట్టిగా ప్రయత్నించు	try
gbódò	తప్పక	must
gbónmisi	చట్టం	strife
gbúnùn	వాసన	hostile
gbọ́dọ̀	తప్పక	must
geesi	ఆంగ్ల	english
geneva	శృతికి	geneva
genevieve	genevieve	genevieve
georgia	జార్జియా	georgia
german	జర్మన్	german
gfaj	gfaj	gfaj
ghana	ఘనా	ghana
gidigidi	చాలా	significantly
gidí	హౌస్	real
goemai	goemai	goemai
gomina	గవర్నర్	governor
gorgina	డేగ	gorgina
gquadruplex	gquadruplex	g-gigalonomerin
grammy	గ్రామీ	grammy
griiki	గ్రీకు	greek
groove	గాడి	iho
guanínì	guanni	guanine
guinea	గినియా	guinea
guineabissau	guineabissau	guinea bissau
guinébissau	guinébissau	guinea bissau
gun	దీర్ఘ	stretch
gunle	తుపాకీ	arrive
guusu	దక్షిణ	south
gv	జివి	gv
gèésì	గ్లూ	english
gèésì	రత్నం	english
gégé	నిజంగా	like
gírámà	gramps	grammar
gòkè	పైకి వెళ్ళు	climb
gún	కుట్టిన	properly
gúúsù	దక్షిణ	south
gẹ̀ẹ́sì	ఆంగ్ల	english
habsburg	హబ్స్బర్గ్	habsburg
haggai	గైడ్	haggai
haiti	హైతీ	haiti
halomonadaceae	halomonadaceae	halomonadaceae
hard	హార్డ్	lile
haughton	haughton	haughton
hausafulani	hausafulani	hausa fulani
hawaii	హవాయి	hawaii
heinrich	హెన్రిచ్	heinrich
hendu	మిఠాయి	hendu
henny	henny	henny
heraklion	heraklion	heraklion
hesse	అంగీకరించింది	hesse
him	అతనికి	un, this term is sexless
hindu	hindu	hindu
histoni	histoni	histones
hominidae	హోమినిడే	hominidae
hosea	హోషేయా	hosea
hp	hp	hp
hugh	హ్యూ	hugh
hun	హన్	knit
hungari	ఆకలి	hungary
hv	hv	hv
ibalo	వ్యవహారంలో	relationship
ibarepo	అసోసియేషన్	friendship
ibeji	కవలలు	twins
ibewo	వచ్చింది	visit
ibiamusin	అభయారణ్యం	colony
ibile	సంప్రదాయకమైన	municipality
ibimo	పుట్టిన	birth
ibise	వ్యాయామం	official
ibiti	స్థలాలు	where
ibn	ఇబ్నె	ibn
ibojì	సమాధి	burial ground
ibori	వీల్	conquest
ibujoko	బెంచ్	place of abode
ibuseripadabosi	రీఎంబెర్స్మెంట్ను	eternity
ibuso	పోరాడటానికి	bus stop
ibùdó	శిబిరంలో	settlement, seat of, area,
ibùjókòó	సీటింగ్	settlement
iceland	ఐస్లాండ్	iceland
idagbasoke	అభివృద్ధి	development
idagbe	నిర్లక్ష్యం	isolation
idaji	సగం	half
idajo	న్యాయం	judgement
idamita	డ్రా	sector
idari	నియంత్రణలు	control
ideraa	వ్రాయటానికి	comfort
idimule	అరెస్టు	establishment
idoma	డ్రాయింగ్	idoma
idupe	ధన్యవాదాలు	thanksgiving
idánwò	విచారణ	examination
ifija	ఫిషింగ్	weapon
ifilole	ప్రయోగ	resolution
ifitonileti	సమాచారం	reporting
ifobaje	అవినీతి	coronating
ifofinde	సమావేశం	prohibition
ifriqiya	ప్రేరణ	ifriqiya
igbeduro	తయారీ	institute
igbegun	విజయం	declaration of war
igberiko	సబర్బన్	region
igbesoke	అప్గ్రేడ్	upliftment
igbeyawo	పెండ్లి	marriage
igbowolori	ఖరీదైన	inflation
igbá	చికెన్	shell
igbáẹ̀yìn	చివరిది	shell
igitòròmogbè	బ్రాడ్బ్యాండ్	willow tree
ihan	కనపడడం కోసం	ray
ihinrere	సువార్త	gospel
ijagun	పోరాటం	war
ijakadi	పోరాటం	wrestling
ijaya	భయాందోళనలు	fear
ije	ఉద్యమం	eating
ijinnasi	భౌతిక	the wind open
ijosin	ఆరాధన	worship
ijó	డ్యాన్స్	dance
ikan	ఒకటి	one of
ikandinlogun	పద్దెనిమిది	nineteen
ikaowo	గౌరవం	finger
ikejidinlogun	పద్దెనిమిది	eighteen
ikeko	సంగ్రహం	education
ikerin	నాల్గవ	fourth
iketa	వారసత్వంగా	third
ikoenu	కాపాడడానికి	union
ikojopo	చేరడం	collection
ikoreokere	సాగు	migration
iku	మరణం	death
ikúgbaèyí	ఇప్పుడు	death-has-this
ikún	పూరకం	squirrel or wild rodent
ilagbolojo	ప్రచారం	latitude
ilana	విధానం	procedure
ilanaoye	వ్యూహాలు	knowledge procedure
ilaodo	రక్షించడానికి	cana
ilaorun	సూర్యోదయం	west
ileasofin	శాసన	house of law,
ilegiga	హోమ్	higher ground or higher plain
ileife	నిర్లక్ష్యం	ile-ife
ileigbimo	సమ్మతి	house of assembly/congress
ileobaluaye	ప్రపంచం	high chief
ileru	ఫర్నేస్	volcanic
ilopo	డబుల్	times
iluoba	పౌరసత్వం	king's town
iluorilejoba	ప్రపంచీకరణ	capital city
ilé	హోమ్	house
iléayé	హోమ్	earth
iléisé	హోమ్	workplace
ilélódò	ఇల్లు	ile-lodo
iléàtèéré	హోమ్	ile-ateere
iléńlá	ప్రాంగణంలో	ile-nla (area)
ilẹ	గ్రౌండ్	land
ilẹ̀ayé	భూమి	the world
iminle	అరెస్టు చేయడానికి	earthquake
imoero	సౌందర్య	engineering
imojuto	సంరక్షణ	protection
imusin	డ్రా	colony
imú	ముక్కు	nose
imúnisìn	పరిశుభ్రత	slavery
inagberingberi	వేరుశెనగ వెన్న	electromagnetic force
indeed	నిజానికి	paapa julo
indus	ఇండస్	indus
inkosi	సమర్థించేందుకు	inkosi
integration	అనుసంధానం	ifowosowopo
inágbéringbérin	పదిహేడు	electromagnet
iní	వారసత్వ	possession
inúnibíni	హింసను	hatred
ioja	చేప	fight
ioniani	ఆదుకోవాల్సిన	ionian
iowa	భూమిపై	iowa
ipare	వాడిపోవు	abolition
ipawo	ఉపయోగాలు	income
ipele	స్థాయి	stage
ipin	అధ్యాయము	share
ipinpa	పాల్గొనడం	arm of, branch of
ipinu	నిర్ణయం	determination
ipo	స్థానం	position
ipá	ఫోర్స్	effort
iraja	దిగ్భ్రాంతిని	bargaining
iranlose	సాయం	mission
ire	అమ్మకానికి	you
irele	వినయం	irele
iringa	మూటగట్టు	iringa
irisi	ప్రదర్శన	appearance
irorun	చాలా సులభం	convenient
irò	పుకారు	iro
irúnmọlẹ̀	మెరుపు	apparition
isa	చాలు	jesus, isa or yisa is hausa language
isare	త్వరణం	track race
isedaniloro	స్వీయ సందేహం	terrorism
iseero	వాచ్	engineering
isejoba	పాలన	governance
iseoba	పదిహేను	civil service
iseoroayeijoun	పురావస్తు	archaeology
iseowo	వ్యాపార	business
isepinpin	పంపిణీ	division
iso	వచ్చిన	unit
isoponomba	isoponomba	addition of numbers
isun	ప్రవాహం	spring
isesi	లొంగిపోయేందుకు	conduct
isè	సేవ	occupation
itali	ఇటాలియన్	italy
itanakole	కథ	ancient
itelentele	రోబోట్లు స్పష్టంగా	coming after
itiraka	పోరాటం	effort
itobi	గొప్పగా చెప్పుకోవటానికి	size
itokowo	వ్యాపార	economy
itorawo	ఉదారవాద	astrology
itu	విసిరేందుకు	solution
itumo	అర్థం	meaning
iwadi	పరిశోధన	research
iwasi	ఇంప్రెస్	behaviour
iwifun	సమాచారం	report
iwoile	హోమ్	entering
iwosan	వైద్యం	healing
iwulo	ఉపయోగకరమైన	use
iwuwa	ఆచరణలో	behaviour
iyan	కరువు	argument
iyato	తేడా	difference
iyawo	వధువు	wife
iyen	అంటే	that
iyán	మద్యం	pounded yam
iḷẹ̀	పని	land
iṣẹ́ìwádìí	పరిశోధన	research
jabo	నివేదిక	give account
jackson	jackson	jackson
jadide	పట్టుకోండి	emerge
jagbe	పోగొట్టుకోండి	shout
jalè	దొంగతనం	steal
jamaica	youtube	jamaica
jamo	వెళ్ళిపో	link
jawaharlal	కల్లోలం	jawaharial
jeffrey	జెఫ్రీ	jeffrey
jeometri	జ్యామితి	geometry
jesu	jesus	jesus
jfk	jfk	jfk
jije	జీవి	existing as
jijinna	దురముగా	distance
jiròrò	పొగమంచు	dialogue
jo	లీక్	days
jogun	వారసత్వంగా	inherit
johann	నరకం	johann
johanu	క్షమించండి	john
jojo	పగుళ్లు	great extent
jopò	చేరండి	gathered
jo	john	resemble
juneau	జునేయు	juneau
jàgídíjàgan	హింసాత్మక	violent
jáde	బయటికి రా	out
jé	రండి	is
jéésù	యేసు	jesus
jìnnàa	దురముగా	further
jíje	జీవి	eating
jíjuwó	డబ్బు సంపాదించడం	waving hands
jíjéomoléyìnkírísítì	పరోపకారిగా	followers of christ
jùlo	మించి	most
jùlo	ముఖ్యంగా	most
jùló	అత్యంత	most
jẹ́mánì	జర్మన్	germany
jọ́	దయచేసి	together
kadara	ఆస్తి	destiny
kagera	గొప్పగా చెప్పుకోవడం	kagera
kakiri	జాడ కనుగొను	all over
kalinga	cinga	kalinga
kalẹ	పక్కన పెట్టండి	established
kampala	కలుపుట	kampala
kan	ఒక	one
kankan	ఎవరూ	any
kanlè	kanal	established
karbonumarun	thecentricane	5 carbon
karl	కార్ల్	karl
karun	ఐదవ	fifth
karùún	ఐదవది	fifth
kebbi	సర్దుబాటు	kebbi
kekere	చిన్న	lower
keko	అక్షరాస్యులు	learn
kept	ఉంచింది	fi pamo
khoisan	నాసిరకం	khoisan
ki	కాబట్టి చేయండి	not
kiakiajulo	వేగవంతమైన	rapidly
kiko	తీసుకురావడంలో	gathering
kikojo	సంగ్రహం	gathering
kikopomo	వెచ్చదనం	mixed
kikoso	ఫాస్ట్	colonised
kiko	లెర్నింగ్	making
kikuninu	ఊహించే	size
kilhar	బాహుమూలములో	kilhar
kinkinni	చిన్న విషయం	small quantity
ko	లేదా	don't
kodò	క్రింద	bow
koidu	koidu	koidu
kojá	క్రాస్	pass
kolo	kolo	going
komputa	కంప్యూటర్	computer
kong	కాంగ్	kong
kongo	కండోమ్	congo
kookan	ఈ	one
koto	ఎరగా	pit
koko	లెర్నింగ్	make heap
ko	ko	learn
kori	ఇక లేదు	not found
krio	krio	krio
ku	మీరు	remain
kwara	ప్రసంగించారు	kwara
kàríbẹ́ánì	ప్రాంతంలో	carribean
kàyéfì	వండర్	amazement
ká	ఆఫ్	we
kánfinkése	చాతుర్యం	prolonged
kánádà	కోర్సు యొక్క	canada
káyé	ప్రపంచ	world
kéesì	హాస్యాస్పదంగా	keesi
kékéèké	చిన్న	small
kétu	సిద్దంగా ఉండు	ketu
kémíkà	దీనికి విరుద్ధంగా	chemical
kéyìn	తరువాత	come after,
kìnní	ప్రధమ	first
kí	అభినందించడానికి	not
kíko	అభ్యసించడం	written
kíkọ́	నేర్చుకోవడం	learning
kínu	ముద్దు	greet
kírísìtì	క్రిస్మస్	christ
kòjòkú	వర్షం	kojoku
kòkó	ఎలుక	cocoa
kòmpútà	కంప్యూటర్	computer
kòtò	ఒక గొయ్యి	pit
kòòsí	అది కాదు	coaching
kòòkan	ప్రతి ఒక్కరు	each
kógo	గ్లోరీ	glorious
kóra	సేకరించడానికి	participate
kùkú	అన్ని తరువాత	eventually
kùrání	ఖురాన్	quran
kúkú	అన్ని తరువాత	now
kúkúrú	క్లుప్తంగా	short
kúrò	దూరంగా	away
kútò	ప్రతిదీ	kuto (place)
kúùkù	దీనికి విరుద్ధంగా	punches; expression meaning 'by force' (ti pa ti kuuku)
kẹrin	నాల్గవ	4
kẹsàán	వెంటనే	ninth
kẹta	మూడో	third
kẹ́nyà	వేరు	kenya
kọjá	పాస్	pass through
kọ̀mpútà	కంప్యూటర్	computer
kọ́kọ́	ప్రధమ	first
kọ́lọ́mú	నిలువు	breast owner
kọ́ni	లేకపోవడం	teach
laa	వెళ్ళిపో	will
laada	కిక్	good fortune
laaka	రివర్స్	important
laarin	లోపల	between
labalaba	సీతాకోకచిలుక	butterfly
labee	కింద	under
lade	లేడ్	crowned
laid	వేశాడు	tele
laifi	తప్పు	without
languages	భాషలు	ede
lanka	లంక	lanka
lasile	విడుదల	laid out
latibe	అక్కడి నుంచి	from there
latigbana	అప్పటి నుండి	from then on
latini	లాటిన్	latin
latvia	లాట్వియా	latvia
lay	లే	da
le	చెయ్యవచ్చు	can
leboa	lebo	leboa
lekun	తీవ్రమైంది	open door
leo	leo	leo
lese	పోస్ట్	firmly
less	తక్కువ	okeresi
lewaju	ముందుకు	front
lewon	ఖైదు	imprisonment
leyi	ఇదిగో	mispelled...should be 'leyin', after
leè	మే	can
lilelile	హార్డ్కోర్	tightly
lilemo	గంజాయి	sticky
lilongwe	లైల్గ్	lilongwe
lindi	లై	lindi
linear	సరళ	dogba
links	లింకులు	eka; this is a new word and does not really exist in yoruba
lodo	జరిగేటట్లు	from
lojowaju	భవిష్యత్తులో	the future
lojukokoro	అత్యాశకరమైన	covetousness
lojúgun	అతను ధ్వంసం చేశాడు	knee
lokunkun	శక్తివంతమైన	in the dark
loloselu	రాజకీయంగా	in politics
lopolopo	చాలా	so many
loruko	పేరు	name
louvre	లౌవ్రే	louvre
lovers	ప్రేమికులకు	awon olufe
low	తక్కువ	diye
lo	కొనసాగించు	than
luanda	లువాండా	luanda
luther	లూథర్	luther
lynton	లింటన్	lynton
làgba	సమాన	more important
lààmi	సైన్	sign
lààmì	చిహ్నాలు	significant
lábé	బరువు	under
láfún	ఇచ్చిన	cassava food
láimo	లేకుండా	unknown
láké	బిగ్గరగా	in ake
lámọ́di	అదృష్టం	lamodi
lápá	భాగం	from
lára	హర్ట్	part of
lárúbáwá	సహజమైనది	arabic
láì	లేకుండా	without
láíláí	ఎప్పుడూ	old
lèe	చెయ్యవచ్చు	can
lèyìn	తరువాత	after
lédè	భాషలో	language
léebá	యాదృచ్ఛికంగా	catch up with it
lérìnín	మంచు	erin=laughter; the prefix 'l' is possesive
lérò	కారణం	thought
léyin	తరువాత	after
léyìn	తరువాత	after
lérú	బానిసత్వం	enslave
lílo	దోపిడీ	using
lísa	త్వరణం	a chieftaincy title
lítésò	పరుష	literature
lóde	బయట	modern
lópez	nipez	lopez
lópó	వితంతువు	widow
lórì	నౌకాశ్రయం	on the head
lóríba	పైగా	subdue
lóti	చాలా	have
lóòótò	అవును	truly
lóòótọ́	నిజానికి	truly
ló	ló	to
lónà	మార్గంలో	in a way
lórò	రేపు	become wealthy
lọndọnu	లండన్	london
lọ́dọọdún	ఏటా	yearly
lọ́jà	మార్కెట్లో	in the market
maapu	మ్యాప్	map
madeira	beira	madeira
mahatma	మహాత్ముడు	mahatma
makedonia	మేసిడోనియా	macedonia
malabo	తేనె	malabo
malay	భావించలేము	malay
malayopolynesian	malayopolynesian	malayo-polynesian
malaysia	మలేషియాలో	malaysia
mali	రోజు	mali
mango	మామిడి	mango
manˈdeːla	mandelala	mandela
marcellus	మర్సుల్లుస్	marcellus
march	మార్చి	march
marku	ఈసారి	mark
mars	అంగారక	mars
maryland	మేరీల్యాండ్	maryland
maseru	అసూయ	don't be slave
matheu	matheu	matthew
mathiew	mathiew	mathiew
mathimatiki	గణిత	mathematics
max	గరిష్టంగా	max
maya	ఏ	maya
mbabane	ప్రతికూల	mbabane
means	అంటే	ona (way)
mediteraneani	మధ్యధరా	mediterranean
mefeefa	సమగ్ర	all six
mejidinlogbon	ఇరువై ఎనిమిది	twenty eight
mejila	పన్నెండు	twelve
meksiko	మెక్సికో	mexico
melo	ఎన్ని	some
member	సభ్యుడు	ara
mercosur	మెర్కోసర్	mercosur
merin	నాలుగు	four
methodologies	పద్ధతులు	anaoniruuru
metropoli	metropoli	metropolis
meucci	మెస్సీ	meucci
mewar	మేవార్	mewar
mexico	మెక్సికో	mexico
michelle	మిచెల్	michelle
micronesia	మైక్రోనేషియా	micronesia
miiràn	ఉపశమనానికి	another
mimoy	mimoy	mimoy
mimuwa	తగులుకున్న	import
minnesota	minnesota	minnesota
minority	మైనారిటీ	awon ara kekere
mohandas	మోహన్దాస్	mohandas
mokaleladota	కాంపాక్ట్	51, (mokanleladota)
mokanlelogbon	ముప్పై రెండు	thirty-one
mombasa	మొంబాసా	mombasa
monrovia	monrovia	monrovia
morgan	మోర్గాన్	morgan
morogoro	వాహన	morogoro
mozambique	మొజాంబిక్	mozambique
mozilla	మొజిల్లా	mozilla
mtn	mtn	mtn
mtwara	మళ్ళీ ఎంచుకోండి	mtwara
mughal	వాల్యూమ్	mughal
mulẹ̀	ఏర్పాటు	establish
munispal	munispal	municipal
muungano	muungano	muungano
májèmú	పర్వాలేదు	testament
mère	డ్రాయింగ్	significant
méjèèjì	రెండు	the two
mérindíláàdóta	యాభై ఐదు	forty-six
méte	ఐదు	lip
mérìndínlógún	పదహారు	sixteen
mérìnlélógójì	నలభై నాలుగు	44
méta	మూడు	three
métèètà	కార్పెంటర్	the three
méwàá	పది	ten
ménu	మీరు అనుకుంటున్నారా	verbally contribute; complete phrase= me nu ba
mímọ́	పవిత్ర	holy
míràn	మరో	other
míìrán	మరో	other
mííràn	మరో	other
mò	జ్ఞానం	know
mókólà	గ్లూ	mokola
móra	నివారణ	with themselves
mó	m	with
múlẹ̀	పట్టుకో త్వరగా	select land (farmland)
mẹ́fà	ఆరు	6
mẹ́rkúríù	ఎలుక	mercury
mẹ́ta	మూడు	3
mẹ́talọ́kan	త్రిమూర్తులు	trinity
namibia	వచ్చిన	namibia
nathaniel	నాథనీల్	nathaniel
nato	nato	nato
nawojulo	అయోమయంగా	highest-spending
nawó	మీ డబ్బు పొందండి	point finger
ncnc	ncnc	ncnc
nebraska	నెబ్రాస్కా	nebraska
nefimu	nephim	nefimu
neptune	నెప్ట్యూన్	neptune
nevis	నెవిస్	nevis
ngbero	అనుకున్న	planning
ngubengcuka	ngubengcuka	ngubengcuka
nibe	అక్కడ	there
nibere	ప్రారంభ	earlier
nigbakan	కొన్నిసార్లు	at one time
nigbà	అప్పుడు	when
nijẹr	నైక్	niger
nilè	ఇక్కడ	remaining
nisinyi	ఇప్పుడు	at present
nitoriidieyi	దీనివల్ల	because of this
nitoripe	ఎందుకంటే	because
nitosi	సమీపంలోని	nearby
niwaju	ముందుకు	in front of
niyato	వేరు	unlike
niye	చాలు	in number
niyi	ఇదిగో	these
nkan	విషయం	things
nkàn	కాన్సర్	something
nnaji	మామయ్య	nnaji
nobel	నోబెల్	nobel
nombamewa	గుణించడం	decimal
nombáméjì	మొదటి రెండు	two-number
novo	నోవో	novo
nri	ఆహార	nri
nse	రూపకల్పన	acting
nso	సమీపంలో	saying
nsolaboraro	భద్రతా	nso laboraro
nsowikipedia	obowikipedia	saying
ntoka	పాయింట్	indicates
nu	శుభ్రంగా	in
nukleotidi	న్యూక్లియోటైడ్	nucleotides
nukleotidipupo	న్యూక్లియోటైడ్	cell
numeri	తిమ్మిరి	numbers
nwa	బేబీ	drill
nàìjíríà	నైజీరియాలో	nigeria
náwo	వ్యయం	spend money
náà	చాలా	that
nì	మౌంటైన్	is
nìnú	క్షమించండి	in
nìyí	ఇంక ఇదే	this is
ní	కలిగి	on
níbè	అక్కడ	there
níbè	అక్కడ	there
nífẹ̀ẹ́	ప్రెమించదానికి	love
nígbàtí	ఎప్పుడు	when
nílè	క్రింద	on the ground
nílùú	నగరంలో	in the town
nílẹ̀	నేల మీద	in the land
nínlá	గొప్ప	large
nínu	క్రీడల్లో అవకాశాలు	in
níní	కలిగి	having
nípà	కనీసం	by
nítorípé	ఎందుకంటే	because
nítumò	అర్థం	meaningful
nítòsí	సమీపంలోని	nearby
nítòótó	ఖచ్చితంగా	truly
nítòótọ́	నిజానికి	in truth, truthfully
níwájú	ముందుకు	in front
níyanjú	సానుకూలంగా	solved
nǹkan	విషయం	things
nso	త్వరలో	say
oba	ఒబామా	king
obairanderan	బంధువు	hereditary
obere	చిన్న	started
obínibí	మర్యాద	inborn
ododo	ధర్మానికి	righteousness
ofin	చట్టం	law
ogbè	ప్రాంతం	a divinity
ogun	యుద్ధం	war
ogunlogo	ప్రేక్షకులు	hundreds
ojo	లాగా ఉంటుంది	day
ojojumo	రోజువారీ	daily
ojoru	వెచ్చదనం	wednesday
ojukokoro	దురాశ	covetousness
ojuoorun	సూర్యాస్తమయం	atmosphere
ojuse	బాధ్యత	responsibility
ojùkòsì	వర్షపాతం	ojukosi
ojùkòtúu	వర్షపాతం	ojukotuu
ojúlùmọ̀	పరిచయాలు	acquaintance
ojútáyé	స్నిగ్ధత	public
ojúìwé	పేజీ	page
okeere	విదేశీ	distant
okhotsk	ఓఖోట్క్	okhotsk
oko	ఫీల్డ్	farm
okunkun	చీకటి	darkness
okunrin	మనిషి	male person
olodiajodojuko	ఒకరికొకరు	facing wall
olohun	యజమానులు	god
olojukanna	తక్షణమే	same surface
olokunkun	హెడ్ఫోన్స్	popular
ololugbe	ఓటమి	occupants
olopon	గర్వముగల	a local game
olora	కొవ్వు	fertile
oloselukan	హలో	one political
oloye	మేధావి	chief
oluda	సృష్టికర్త	creator
oludase	నిర్మాత	separatist
olukoitan	బోధకుడు	the writer
olukowe	రచయిత	writer
olumojuto	అత్యాశకరమైన	overseer
oluparapo	కలయిక	joint
olusoju	గార్డు	ambassador
oluwakiri	అన్వేషణ	explorer
olympus	ఒలింపస్	olympus
olódùmarè	దేవుడు	almighty god
olóyè	పాలకుడు	chief
olóṣèlú	రాజకీయ	politics
olùbátan	ఈ పరిచయం	relative
olùdarí	ఒక నాయకుడు	director
olùkópa	కంట్రిబ్యూటర్	participant
olùkó	బోధకుడు	teacher
olùkọ́	గురువు	teacher
omi	నీటి	water
omiadalu	వరద	mixture
onialjebra	onialjebra	of algebra
onibugbe	కౌలుదారు	population
onigbeja	నిర్మాణాత్మక	allied
onigbowo	స్పాన్సర్	sponsor
onigunfenfe	నిష్క్రియాత్మ	large angle
onilanaibagbepo	కండోమ్	constitutional
onilile	గృహ యజమానులు	solid
oninawo	రుణగ్రహీత	financial
onipin	హేతుబద్ధమైన	even
onisayensi	టెక్నీషియన్	scientific
onisowo	వ్యాపారి	trader
oniyewumeji	బైనరీ	two-chamber
oniyijulo	అద్భుతంగా	highest honour
onje	ఆహారం	food
onka	కాలిక్యులేటర్	counter
onígbàgbó	ముసలివాడు	believer
oníkólóbó	అసంబద్ధం	onikolobo (place)
onílẹ̀	డౌన్	land owners; citizens (omo onile)
oníná	ఫైర్	electronic
onítumò	అనువాదకుడు	meaning
onítèbọmi	బాప్తిస్మం తీసుకున్నారు	baptist
onítòhùn	అకౌంటెంట్	that person
oníwòsàn	వైద్యుడు	doctor
oníyanjù	యానిమేటెడ్	persevere
ooni	మొసలి	ooni (king)
ootọ́	నిజమైన	truth
opec	opec	opec
opposite	వ్యతిరేక	odi
ori	తల	top
oriire	అభినందనలు	success
oriki	ఓరియంటల్	name of endearment
orileede	ఒక దేశం	country
orileedeajoba	సామ్రాజ్యవాద	monarchic country
orilejoba	ప్రభుత్వం	seat of government, kingdom
orileominira	వెచ్చదనం	republic
orinìyìn	ఒక పాట	songs of praise
orisirisi	వివిధ	various
orisun	మూలం	source
orisa	మూలాలు	god
oritameta	మధ్యలో	crossway
orudnun	వార్షిక	mispelled...should orundun, century
oruko	నామవాచకం	name
oríilè	జాతీయ	land
oríilẹ̀	వ్యాసం	land
oríkì	కవిత్వం	family name
orílèèdè	దేశం	country
orílẹ̀	దేశం	continent
orílẹ́	సాయంత్రం	nation
orísiirísi	వివిధ	various
orísìí	వివిధ	type
orísìírísi	వివిధ రకములు	various
orúko	స్థలము	name
oscar	ఆస్కార్	oscar
oseluarailu	పౌర	political unit
otherwise	లేకపోతే	ibaje
otutu	అనేక	coldness
oun	అతను	it
owojagidijagan	తీవ్రవాదుల	upheaval
oúnjẹ	ఆహార	food
odún	సంవత్సరం	year
ojó	వర్షం పడుతుంది	day
okùnrín	నవ్వు	man
olórun	దేవుడు	god
olósìn	మత	rearing
odun	వార్షిక	year
olorun	దేవుడు	god
omonìyàn	మనుషులు	human beings
opolo	అనేక	brain
ose	ose	week
oyé	ప్రపంచం	harmattan
ofò	శుభోదయం	nothingness
opolo	అనేక	brain
paa	ఆపివేయండి	back
paapaa	ముఖ్యంగా	especially
padá	పాడ్	go back
palauan	పాలుఆన్	palauan
panaˈma	పనామా	panama
panyanan	స్పేస్	spanish
papa	పాపా	specifically
parapọ̀	మిశ్రమం	join
paripari	ముగింపు	finally
pele	అందమైన	hello
penh	పెన్	penh
penisula	పెనిసులా	peninsula
periferi	periferi	periphery
petu	petu	resolve
pelu	పెర్ల్	with
phillipines	phillipines	phillipines
pinsi	క్షీణిస్తున్న	divided
pinsoto	pinoto	separated
pinu	నిర్ణయిస్తారు	decide
pipo	చాలా	plenty
pipolongo	ప్రకటన	publicise
piposi	చాలా	multiplication
platos	ప్లేటో	plato's
plánẹ́tì	ప్లంబింగ్	planet
po	పో	share
pojulo	ఎత్తైన	larger
polandi	పోలిష్	poland
polaroid	పోలరాయిడ్	polaroid
population	జనాభా	ero
portonovo	portonovo	porto novo
portuguese	portuguese	portuguese
press	పత్రికా	press
produced	ఉత్పత్తి	yo
protokolu	protocolu	protocol
proton	ప్రోటాన్	kemika alaropo
providence	భగవత్	providence
príncipe	ప్రిన్సిపి	principe
pupa	ఎరుపు	red
px|kùránì	px | కెర్నల్	koran or quran; the px  does not belong
pàmò	ప్రత్యేకంగా	pamo (town)
pàràkòyí	తక్షణమే	parakoyi
pààlà	ఒక సరిహద్దు	signalised
pàápàá	ముఖ్యంగా	especially
pásíà	నేలమాళిగ	persia
pátáporongodo	ఖచ్చితంగా	entire
pè	అని	that
pèhìndà	వీర్యం	turned back
pèlu	పాటు	with
pèlúpèlú	అలాగే	in addition
pèsè	అందించిన	provide
pé	ఆ	that
péré	మాత్రమే	only
péé	ఆ	that
pípa	స్లాటర్	order
pípèsè	నియమం	providing
pípẹ́	దీర్ఘ	long
pòwe	సామెతలు	to say a proverb or wise saying
pò	రెట్లు	join
púpo	చాలా ఎక్కువ	much
púpò	కాకుండా	a lot
quran	quran	quran
ra	కొనుగోలు	self
race	రేసు	ere
rajya	ఆశిస్తున్నాము	rajya
ramadan	రంజాన్	ramadan
rank	ర్యాంక్	ipo
reggae	రెగె	reggae
repeats	రిపీట్స్	tunso
repetejulo	అత్యంత సున్నితమైనది	most of all
rere	మంచిది	success
research	పరిశోధన	agbeyewo
richard	రిచర్డ్	richard
right|thumb|px|aworan	కుడి | బొటనవేలు | px | చిత్రం	picture
rinle	కొత్తగా	emphasise
riresile	రికార్డర్	humbled, lowered
riro	ఊహ	thought as
rn	rn	rn
rna	rna	rna
rnarna	rnarna	rna-rna
rnas	rnas	rnas
ro	అనుకుంటున్నాను	thought
robinson	రాబిన్సన్	robinson
roboto	ఉపరితలాలు	round
rogbodiyan	అల్లర్లు	riot
rokirika	బ్రౌజింగ్	publicise
roko	మాబ్	farm work
roma	రోమా	roma
rome	క్రోమ్	rome
ronald	రోనాల్డ్	ronald
rorùn	సులభంగా	easy
rossii	rossii	rossii
rural	గ్రామీణ	igberiko
ryan	ryan	ryan
ráhàn	కనిపించింది	complain
ránmú	ఆందోళన	grumble
république	république	republic
ré	సి	his/her
rìn	నడవడానికి	should be orin, song or music
ròyìn	నివేదించారు	give account
rẹ	ఆమె	it
saarc	తొలగిస్తాయి	saarc
saaree	ఉన్నతమైన	after death
saarland	నేలపై	saarland
safari	సఫారీ	safari
saffana	నీలం	savannah
safiwe	పోలిక	describe
safta	వరుసలో	safta
saheli	సౌలభ్యం	sahel
sakyamuni	తదుపరి	sakyamuni
sakyas	sakyas	sakyas
salem	సేలం	salem
salàyé	జీవితం	explained
sambia	యువత	zambia
samioro	అందుబాటులో	signal
santa	శాంటా	santa
say	సే	so
sb	sb	sb
schwarz	ష్వార్జ్	schwarz
sea	సముద్ర	odo
seat	సీటు	itedo
segbese	బహుశా	take steps
seidamo	స్పష్టమైన	identify
semolara	ఆస్తమా	accustom
semudaju	కోర్సు యొక్క	assure
senegal	సెనెగల్	senegal
sense	భావం	sensi
seville	సెవిల్లె	seville
sewadi	వెతకండి	investigate
sharon	sharon	sharon
sibesibe	ఇంకా	further more
sihamoni	నిర్మాణం	sihamoni
sile	వెనుక	previously
silè	చుక్కల	on the ground
sinai	పాపం	sinai
sinsin	మతం	unshakably
sioux	sioux	sioux
sise	వంట	works
sisodagba	పెరుగుతోంది	came of age
sisopo	లింకింగ్	joined
sisupapoerekusu	ఉమ్మివేయటం	neighbouring islands
sisupo	గుణకారం	concentrated
slovo	slovo	slovo
so	ప్రేమ	turned
sohun	అవును	something
solomon	సోలమన్	solomon
soon	త్వరలో	lai'pe
sopin	ముగింపు	ended
so	కాబట్టి	tells
spectacular	అద్భుతమైన	damanran
stella	స్టెల్లా	stella
structures	నిర్మాణాలు	igbekale
suez	సూయజ్	suez
sugbo	కాని కాదు	but
sugbọ́n	హేతుబద్ధమైన	but, however
sun	సూర్యుడు	sleep
suny	suny	suny
swahili	swahili	swahili
symmetry	సమరూపత	ogbooga
sàbúrí	పైవన్నీ	saburi
sàmì	ఒక గుర్తు	signalize
sàn	మంచి	flow
sàngó	ముఠా	sango (god of thunder)
sàì	బాగా	un
sápadè	ఈ రోజు	run to
sáàpàdé	స్పాన్సర్షిప్	saapade
sáààrin	నడి మధ్యలో	between
são	క్రొత్తది	sao
sèle	దొంగిలించడం	down
ségun	ఏడుపు	conquered
sénégal	వీర్యం	senegal
séyìn	తిరిగి	back
séyìn	తిరిగి	at the back of
sìbẹ̀	ఇంకా	there
sìni	రొయ్యలు	likewise
síbèsíbè	అయితే	further more
síbú	నేలకి	ocean
sílẹ̀	అణగదొక్కండి	drop
síse	పని	doing
síso	ఇప్పటికీ	spoken
síso	ఇప్పటికీ	saying
síta	బయట	outing
síwon	వాటిని	to them
síwájú	ముందుకు	comes before
síí	ఇక్కడ	on it
sòrò	జ్ఞాన వత్తిడి	talk
sójà	సైనికుడు	soldier
sóko	మొక్క	to the farm
sùgbón	దీనికి విరుద్ధంగా	but
sọ	సే	lose
si	ఖచ్చితంగా	to
síse	నిర్మాణం	performing
sùgbón	దీనికి విరుద్ధంగా	but
se	వారు చేస్తారు	do
sepò	చివరకు	cooperation
sisé	పని చేయండి	work
sááju	ఒక నిమిషం పడుతుంది	before
sísa	s .ía	to be
sísè	అనువాదం	step
tabi	లేదా	or
tabili	పట్టిక	table
tabora	ఎగవేత	tabora
taino	రక్తవర్ణం	taino
tainos	టైనోస్	tainos
takuntakun	అవరోధాల	valiant
talaka	పేద	poor
talika	పేదరికం	the poor
tara	తొమ్మిది	wholly
tata	వడపోత	wildly
taínos	టైనోలు	tainos
technology	సాంకేతికం	tekinoloji
tedo	డేటింగ్	stay
teksas	టెక్సాస్	texas
tele	అనుసరించండి	before
temptation	కోరుతూ	idanwo
terutomo	terutomo	everybody
tfrac	tfrac	tfrac
the	ది	does no directly translate
they	వాళ్ళు	won
those	ఆ	awon
thumb|left|upright|nelson	బొటనవేలు | ఎడమ | నిటారుగా | నెల్సన్	apa osi naro
tira	కాలం	quranic verse
tirana	టిరాన	tirana
tirè	తన	own
titu	షూట్	cold (if it's a person's name, it is tutu)
tiwọn	వారిది	theirs
to	కు	it
toje	అరుదైన	that is
tokasi	ఎత్తి చూపారు	pointing to
tokyo	టోక్యో	tokyo
tolerejulo	ఉపేక్షించేవారు	most profitable
tolórítelémù	హోలోకాస్ట్	all manners of people
tomé	టమోటా	tome
tooto	నిజంగా	true
tori	టోరి	because
torun	నల్లటి జుట్టు గల స్త్రీని	heavenly
toseluaralu	రాజకీయ	political
tounsejanu	విషాద	control
traduite	traduite	traduite
translated	అనువాదం	tunmo
tumosi	అంటే	means
tuntun	కొత్త	new
tàsí	లేకుండా	or
tàwon	వాటిని	theirs
táawà	నమస్కరించడానికి	we
tèlé	అనుసరించండి	before
tètè	త్వరగా	quickly
tèlé	తక్షణమే	follow
tèsíwájú	పురోగతి సాధించడానికి	progress
té	t	follow
télè	ద్వారా	before
té	t	shamed
títi	క్లోజ్డ్	till
títèlé	అనుసరించుట	following
títío	వరకు	until
tíátà	టిక్కెట్లు	theater
tíórì	టైర్లు	that is seen
tò	సెట్	enough
tóbi	పెద్ద	big
tódárajùlọ	అత్యుత్తమమైన	most beautiful
tókù	విశ్రాంతి	others
tówùú	ఏదైనా మొత్తం	whatever
tó	tó	taught
tóka	సైటెడ్	pointed
tú	బయట పోయు	untie
túmò	ప్లం	means
túnse	మళ్లీ అమర్చండి	restructured
tẹ̀ǹbẹ̀	అప్పుడు	rivalry
tẹ̀ǹbẹ̀lẹ̀kun	కుట్ర	bitterness
ucb	ucb	ucb
umueri	పిల్లలు	umueri
unifasiti	విశ్వవిద్యాలయ	university
unla	అవును	great
urasílì	uracil	uracil
uribe	ప్రకాశం	uribe
usps	usps	usps
utah	utah	utah
utc	utc	utc
uzbek	మార్గం	uzbek
venezuela	వెనిజులా	venezuela
vermont	వెర్మోంట్	vermont
victor	విక్టర్	victor
videos	వీడియోలను	fidio
vihara	విహార	vihara
villa	విల్లా	villa
viruses	వైరస్లు	awon eran
visit	పర్యటన	ibewo
vz	వజ్	vz
waa	అది	ours
waju	ముఖం	future
wari	వాసన	once existing
westminster	వెస్ట్మిన్స్టర్	westminster
wisconsin	విస్కాన్సిన్	wisconsin
witkin	విత్కిన్	witkin
wiwari	ఆవిష్కరణ	discovered
województwo	cheworddztwo	wojewodztwo
wole	సైన్ ఇన్ చేయండి	into
woo	వూ	look
wo	ఇక్కడ	enter
wo	ఇక్కడ	look
won	వాటిని	they
wura	బంగారం	gold
wyoming	wyoming	wyoming
wàásù	బోధించాలని	preach
wì	కడిగివేయు	that
wípè	స్పష్టత	that
wòfún	చూపులో	convenient
wònyí	ఇవి	these
wón	వాటిని	they
wúnrèn	వర్కవుట్	small amount
wọn	వాటిని	they
wọ̀nyí	ఈ	these
xd	xd	xd
xiv	xiv	xiv
yafran	ఇది బాగుంది	yafran
yakubu	yakub	yakubu
yan	ఎంచుకోండి	choose
yanjú	సంకల్పము	solve
yanturu	పుష్కలంగా	abundant
yaoundé	యౌండే	yaounde
yewo	మెరుగుదల	examine
ye	అవును	suitable
ye	అవును	should
yindinyindin	ఎన్నటికి ఆపకు	brightly
yio	వలెను	will
yiowu	అది ఖచ్చితంగా	any
yipada	చుట్టూ తిరగండి	change
yiyafunnilo	కోతను	borrow
yoo	రెడీ	will
yori	దారితీసింది	result
york	యార్క్	york
yorúbà	పెరుగు	yoruba
yo	yo	remove
yànan	ఆశర్యం	scattered
yàtò	ఏర్పాటు	other than
yára	త్వరగా	quickly
yèwò	లుక్	examine
yée	వాళ్ళని చేయనివ్వు	eplained to
yì	వెళ్ళండి	this
yìí	ఈ	this
yí	చుట్టూ తిరగండి	this
yíyípadà	మార్పు	changed
yíì	మీరు రెడీ	this
yíò	అది ఖచ్చితంగా	it will
yẹ̀ẹ́	కుశలమా	check
yọ	తొలగిస్తాయి	bring out
zanzibar centralsouth	జాంజిబార్ సెంట్రల్‌సౌత్	zanzibar centralsouth
zdna	zdna	z-dna
zou	zou	zou
zscores	zscores	z-scores
zy	zy	zy
 bce	దూరంగా	bce
àbe	బబూన్	under
àbámẹ́ta	గురువారం	saturday
àbáyo	సలహా	breakthrough
àbìkú	అమరత్వం	'born to die' child
àbọ̀	సగం	result
àdámò	గోప్యతా	earmark
àdátá	వ్యతిరేకం	adata
àdáátán	ప్రత్యేక	adaatan
àdóolóró	ఆయిల్	bomb
àgbàjọ	ముదుసలి వాడు	assembly
àgbàrá	వరద	power
àgbáríjọ	సంస్థ	combination
àgbékà	నైరూప్య	suitable
àgbéyèwò	సమీక్ష	examination
àgbìgbò	పొరుగు	a type of bird
àgbùdo	యార్డ్	corn
àgọ́	డేరా	ago
àifète	ప్రయోజనం	unable to keep quiet
àjo	ప్రయాణ	board
àjákọ	కాకుండా	ajako
àjọṣepọ̀	సామాజిక	union
àkosílè	సంగ్రహణం	written
àkosílè	థీసిస్	written account
àkàrà	కేకులు	bean pudding
àká	అల్మారాలు	store
àkójopò	సమూహం	collection
àkókó	సమయం	previous
àlàkalè	గోల్స్	breakdown, explanation of actions
àlàyé	సమాచారం	explanation
àlàáfíà	శాంతి	peace
àlááfià	సారూప్యత	wellbeing
àlè	బాస్టర్డ్	mistress, concubine, (side booty)
àlèpò	పైన	joined together
àlébù	నిర్దోషమైన	ills
àmérìkà	అతీంద్రియ	america
àmì	సైన్	sign
àmúlò	ఆచరణాత్మక	synonyms
àmúsorò	మనస్తత్వశాస్త్రం	resources
ànfàní	అవకాశం	opportunity
àpapọ̀	మొత్తంగా	federal
àpeere	ఉదాహరణ	example
àrígbámú	కలవరం	assistant
àrùn	వ్యాధి	disease
àrẹ	అధ్యక్షుడు	president
àse	విందు	authority
àsàjemátèe	డాన్	cunning
àsèyìn	పరిణామాల	at the end
àsìkò	సమయం	time
àsótélè	పొడిగింపు	prophecy
àsọdọ̀kan	ఐక్యత	unitary
àsekúdórógbó	బెరడు	do or die
àsà	కస్టమ్	habit, culture, norm
àtijo	వాడుకలో	olden days
àtìpó	గ్రహాంతర	sojourn
àtòrìnká	చుట్టూ	urinating while walking
àtúnse	మార్చు	modification
àtúnse	మార్చు	renovate, fix
àtẹnudẹ́nu	మౌఖిక	oral
àwon	సిద్ధాంతాలు	they
àwón	డబ్బు	the
àwón	డబ్బు	the
àwùjo	సమాజం	community
ààtò	కర్మ	suitability
ààyè	సజీవంగా	space
àárín	మధ్యలో	middle
àáyá	వీర్యం	seconds
àìkó	లోపం	unlearned
àìní	కావలసిన	lack
àìròtélè	ఊహించని	unthought of
àìsí	లేకపోవడం	lack
án	t	it
áwon	వివాహేతర సంబంధం	those
èbà	దోమలు	cassava flour food
èbúté	పోర్ట్	shore
èdá	సృష్టి	creature
èdè	భాష	language
èdè	భాష	language
èfòn	కాలం	efon
èhìn	తదుపరి	outskirt
èka	శాఖ	branch
èkejì	ఇతర	second
èlò	పాత్రలకు	tool
ènìkan	ఏదో	someone
èràn	వ్యాధి	virus
èrò	ఆలోచనలు	thoughts
èsó	మసీదు	modesty
èsúrú	చీమలు	yam (indigenous to west africa)
ète	ప్రయోజనం	plan
èyì	గౌరవం	this
èka	ప్రభావం	branch
èro	ఆలోచనలు	machine
èrí	సాక్ష్యం	witness
èsìn	మతం	religion
èwù	చొక్కా	clothe
èpón	చాలా	modifier
ìbarà	జ్వరం	ibara (town)
ìbánisòrò	కనెక్షన్	dialogue
ìbáraeni	క్యారేజ్	to themselves
ìbílè	జన్మహక్కు	local
ìbílè	జన్మహక్కు	local
ìdàgbà	యుక్తవయస్సు	grow
ìdàpapọ̀	ఏకీకరణ	union
ìdàrúdàpò	ఖోస్	misunderstanding
ìdá	పారిపోవటం	division
ìdìmú	భంగం	branch, part
ìdíisin	కారణం	idi-isin
ìdíwòn	మీ కారణం	criteria
ìdó	స్టింగ్	ido (a person's name)
ìfara	హింస	self
ìfojúìtànìgbesiayé	జీవిత చరిత్ర	biography
ìfáàrà	ఒక పూజారి	introduction
ìgbonnìbí jé	ఇది విపత్తు	igbonnibi
ìgbà	సమయం	when
ìgbàgbé	మతిమరుపు	forgetfulness
ìgbá	రెక్కలు	time
ìgbáraga	బలం	pride
ìgbéraga	అహంకారం	pride
ìgbésí	జీవితం	life
ìgbò	రామ్	igbo people
ìhun	ఇనుము	things
ìjo	నృత్యం	church
ìjo	చర్చి	church
ìjoba	ప్రభుత్వం	government
ìjora	ద్వేషం	resemblance
ìjìnlè	మిస్టరీ	comprehensive
ìjìnlè	మిస్టరీ	mysterious
ìjò	నాయకుడు	consent
ìjọba	ప్రభుత్వం	government
ìkejì	ఇతర	second
ìkànna	అదే	ikanna (town)
ìkèrèkú	రద్దీ	ikereku
ìkéde	డిక్లరేషన్	advert
ìkìjà	ఒక సవాలు	ikija
ìkìlò	తిట్టు	warning
ìkínin	ఆరవది	greetings
ìkẹrin	నాల్గవ	fourth
ìkọpa	పాల్గొనడం	ikopa
ìlera	ఆరోగ్య	health
ìlo	కాల్	use
ìlà	చుట్టుగీత	border
ìlànàn	భ్రాంతిని	procedure
ìlàorùn	గాయాల	east
ìlàìnàró	అణచివేతకు	vertical
ìlè	లంచం	land
ìlé	హోమ్	land
ìmò	పాము	knowledge
ìmò	మెరుపు	knowledge
ìmóbìdo	జన్మహక్కు	imobido
ìmú	ముక్కు	knowledge
ìmúnilérú	వేధింపులను	slavery
ìmúsára	బలోపేతం చేయడానికి	contagious
ìnagije	విజయం	alias
ìnáwó	వ్యయం	expenditure
ìpolongo	ప్రకటనలు	advertisement
ìpìlẹ̀núkléù	ఎన్క్రిప్షన్	base
ìpìnlè	ప్రారంభం	foundation
ìpínrò	పేరాలు	economize
ìrànlọ́wọ́	సహాయం	help
ìrànàna	సహాయం	path-clearing
ìràwọ̀	నక్షత్రాలు	s
ìrí	అనుభవం	sight
ìròkò	ఆలోచన	iroko
ìròyìn	వార్తలు	news
ìròyìnwiki	వార్తలు	wikinews
ìròrùn	భ్రాంతిని	peaceful
ìró	ధ్వని	sound
ìrúbo	పతనం	sacrifice
ìsawo	భవిష్యవాణి	divinity-practice
ìse	చర్య	behaviour
ìsinsìnyí	ఇప్పుడు	modern
ìsirò	లెక్కింపు	adding
ìsomó	చేరడానికి	attachment
ìsàlè	సూర్యాస్తమయం	down town
ìsèlè	ఉత్పత్తి	happening
ìsìn	మతం	worship
ìsòrò	ధ్యానం	speech
ìsòrí	ఉపశీర్షిక	chapter
ìsú	మందం	lump
ìsọ	దుకాణాలు	stall
ìse	చర్య	work
ìsègbèfábo	శ్రద్ధ	female support
ìsèdá	సృష్టి	creation
ìsèjoba	ప్రభుత్వం	government
ìsílé	హోమ్	house opening
ìsòro	కష్టం	problem
ìse	చర్య	action
ìta	బయట	outside
ìtaeko	వర్క్	outskirts of eko
ìtan	చరిత్ర	story
ìtokò	కుండ	story
ìtàn	చరిత్ర	history
ìtànkálé	వరదలు	spread
ìtèsíwájú	పురోగతి	progress
ìtójú	సంరక్షణ	treatment
ìtóju	గందరగోళం	treatment
ìtójú	ముఖ కవళికలు	treatment
ìtóka	కొట్టబడాలి	dictionary
ìtúmò	అనువాదం	meaning
ìtúpalè	అనువాదం	exposition
ìwe	పోలిక	book
ìwo	కొమ్ములు	horn
ìwàásù	బోధన	sermon
ìwéré	బుక్లెట్	iwere (town)
ìwò	మొత్తం	set
ìwòran	దృష్టి	viewing
ìwúlò	ఉపయోగకరమైన	usefulness
ìya	బాధ	mother
ìyapa	వేరు	divorce
ìyàwó	వధువు	wife
ìyípadà	మార్పిడి	transformation
ìṣèlú	రాజకీయాలు	politics
ìṣẹ́kù	మిగిలినవి	broken
ìṣọ̣̀tẹ̣̀	న్యుమోనియా	rebellion
òde	బయట	society
òdeojú	అనామకుడిగానే	surface
òdo	యువత	zero
òdìkejì	ఇతర	opposite
òféàrán	ఒక చిత్రం	a town name
ògbójú	సమర్థ	brave
ògiri	గోడ	wall
ògo	గ్లోరీ	glory
ògun	మందు	medicine
ògúndìpẹ̀	బూజు	ogundipe
òjo	లాగా ఉంటుంది	ojo
òjísé	వైద్యుడు	servant
òkèògbún	వెయ్యి	oke-ogbun
òkòòkan	ఒక్కొక్కటిగా	each
òkú	శవాలు	corpse
òkúta	ఒక రాయి	stone
òle	గృహిణి	lazy
òmiràn	మాంత్రికుడు	other
òmùàrán	ఒక చిత్రం	omu-aran (town)
òní	నేడు	today
òotó	నిజం	true
òpópóònà	త్రోవ	highway
òranyàn	తప్పనిసరిగా	a must
òrìsà	విగ్రహాలను	god
òrí	అధ్యాయము	top
òrò	మె ద డు	word
òsán	మధ్యాహ్నం	afternoon
òsèlú	రాజకీయ	politics
òsèré	అథ్లెట్	player
òwù	గుడ్డ	owu
òṣèlú	రాజకీయాలు	politician
òjògbón	వర్ష వాతావరణము	learned person
òkan	ఒకటి	heart
òkòòkan	ఒక్కొక్కటిగా	each
òpòlopò	అనేక	many
òré	గేమ్	friend
òfò	తదుపరి	sorrowful
òpòlopo	అనేక	lot of
òré	గేమ్	friend
òrò	ఆలోచనలు	word
òsà	గోల్డ్ ఫిష్	lagoon
òwó	డబ్బు	hand
òrò	ఆలోచనలు	word
òròàjòmó	ఉదయం	part of speech
ó	ఇది	that
óníse	అతను డిజైనర్	stricken
ósírísì	లాలాజలం	diverse
ósékú	అతను చనిపోయాడు	die suddenly
ó	అవును	word
ôdún	ఇయర్	year
únṣẹlẹ̀	భూకంపం	formed
şe	అలా	do
ʔaːnaːtɕɑ̀k	.aːnaːtɕɑɕɑk	not yoruba
ˈøːstəˌʁaɪç	øːstəˌʁaɪç	austria
ˌkælɪˈfɔrnjə	ɪkælɪfɔrnjə	not yoruba
ˌæləˈbæmə	రోగము	not yoruba
κάππα	.α	does not translate
σ	σ	does not translate
ṣiṣé	ప్రారంభ	work
ṣàkóbá	హానికర	incriminate
ẹdo	జోక్	edo
ẹlẹ́bùn	ఒక బహుమతి	award winner
ẹlẹ́sìn	మత	religionist
ẹnìkan	ఒక వ్యక్తి	someone
ẹsẹ	అడుగుల	verse
ẹtì	కాలేయం	friday
ẹ̀kaawon	సమర్పణలు	branch of
ẹ̀kabrítánì	మామయ్య	part of britain
ẹ̀kajuly	మే	chapter july
ẹ̀kaoṣù	విసుగు పుట్టించెడు	month
ẹ̀kasístẹ̀mù	ఆత్మాశ్రయ	sistemu=system
ẹ̀kẹ́ta	మూడవది	third, the third
ẹ̀kọ́	చదువు	teachings
ẹ̀ni	who	person
ẹ̀rọ	యంత్రాలు	machine
ẹ̀wẹ̀	మరోవైపు	leaf
ọbàkàn	సగం సోదరుడు	step-sister
ọdún	సంవత్సరం	year
ọlọ́mọ	పిల్లలు	members
ọlọ́run	ఒక దేవుడు	god
ọmú	మీరు పీలుస్తారు	breast
ọmọ	పిల్లల	c
ọn	ఇది	him
ọpọ́lọpọ́	అత్తి పండ్లను	many
ọ̀dọ́	యువత	youth
ọ̀gbìn	మొక్క	seedlings
ọ̀nà	మార్గం	ways
ọ̀pòlòpò	చర్య	various
ọ̀rọ̀	చర్చ	word
ọ̀sẹ	వారం	week
