aajo	bema&#39;ni	hospitality
aala	chegara	border
aanu	rahm-shafqat	compassion
aapon	aapon	bachelor or spinster (bachelorette)
aare	aare	president
aawe	falaj	fasting
abala	qismi	division
abeikojopo	merosxo&#39;r	subset
abeorile	uyga qaytish	nation
abesahara	sepmoq	under the sahara
abidi	alifbo	abidi
abidjan	har doim	abidjan
abo	nazokatli	security
aburunmu	bizning jirkanchligimiz	reduced in value, diminished
abálájo	tajribali	that is why
abé	igna	under
abínibí	millati	inborn
abúléko	qishloq	village
accra	accra	accra
adaba	qulay	factor
adabaye	hammasi joyida	previously-existing
adarihunrun	tozalovchi	human
addis	qo&#39;shadi	addis
adeda	tabiat	creator
adiokan	yakka	stubbornness
adágbà	oqsoqol	adagba
adúgbò kútò	ko&#39;chada qo&#39;shnilar	kuto area
adúgbò mókóla	mukola shilliq qavati	mokola area
adúgbò quarry	karerning qo&#39;shnilari	neighborhood
adúgbò ìdí	mahalla sabablari	area
afida	oila	element
afomo	misol uchun	cleansing
afoyemo	tezis	abstract
africa	afrika	africa
african	afrika	ara afrika
africans	afrikaliklar	africans
aféfé	shamol tegirmoni	air
agba	bo&#39;yamoq	principal
agbado	makkajo&#39;xori	maize
agbara	quvvat	power
agbaye	dunyo	world
agbeinadie	qishloq xo&#39;jaligi erlari	semi-conductor
agbà	kattalar	adult
agbàbò	himoyachi	adopted child
agbára	quvvat	power
agbéiná	o&#39;t o&#39;chiruvchi	conductor
agio	yig‘lamoq	agio
aintimulo	aintimulo	un-exploited
aisi	etishmasligi	lack
ajagun	it	ajagun
aje	iqtisodiyot	trade
ajemoroyin	so&#39;roq qilish	reporting
ajibola	kun tartibi	ajibola
ajo	sayohat	firms
ajoro	sayohat	discussion
ajọra	nusxa	resemblance
akiidah	korida	(non-standard yoruba, this maybe from benin)
akinpelu	artilleriya	akinpelu
akokolo	davri	period
akole	biz qila olmaymiz	title
akoni	bizda yo&#39;q	teacher
akopa	birinchi navbatda	participant
akopo	jamlama	assembly
akátá	chakalak	african american
akíkanjú	jasur	courageous
akíngbógun	batalyon	akingbogun
akẹ́kọ̀ọ́	talaba	students
ala	pastga	limit
alaabo	nogiron	protection
alaadanida	nomaqbul	individual
alaafia	tinchlik	peace
alaafin	noqonuniy	alaafin
aladaani	xususiy	privately-owned
aladani	xususiy	self-owned
aladanida	o&#39;zboshimchalik bilan	private
alaidogba	muvozanatsiz	unequal
alaigbara	qaytarib bo&#39;lmaydigan	neutron
alaini	muhtoj	the poor
alakitiyan	faol	activist
alakobere	ajam	primary
alalaye	tuproqli	explanatory
alawose	folbinlik	mentor
albany	albany	albany
albert	albert	albert
alexandra	aleksandra	alexandra
alicia	alisiya	alicia
allāh	allohim	allah
alominira	mustaqillik	independent
alpha	alfa	alpha
alubàbá	otasi	drummer
alukuraani	qur’on	quran
alumoni	shifobaxsh	minerals
alumíníọ̀mù	alyuminiy	aluminium
alákọ̀bẹ̀rẹ̀	tashabbuskori	primary education
alápapò	almashtirish	general
alátise	rassom	alatise
aláyèwò	tekshiruvchi	expert
aláísàn	kasal	the sick
alúwo	portlash	traditional cults
alọ́po	hamyon	tied
amazonas	amazonka	amazonas
americas	amerikaliklar	americas
amerika	amerika	america
amojeoyipada	ayirboshlanadigan	reform
amosi	masjid	amos
améríkà	amerikalik	america
améríkà	amerikalik	america
an	an	him
anabi	payg&#39;ambar	prophet
anc	eski	anc
andaman	andman	andaman
angkor	angkor	angkor
anita	anita	anita
anschluss	anschluss	anschluss
apagusu	janubi	southern
apaguusuilaorun	janubi-g&#39;arbiy	south-western
apaguusuiwoorun	janubi-g&#39;arbiy	part of the south
apailaorun	quyosh chiqishi	east side
apaiwoorun	g&#39;arbiy	eastern side
aparapo	birikmasi	confederation
apeja	baliqchi	fisherman
apeere	misol uchun	example
apis	apis	apis
apòmù	apron	apomu
apẹ̀rè	apron	example
arabu	arab	arab
aralíle	tropik	healthy body
arinkankan	bunisi	nationalist
ariso	aris	oral tradition
ariwaarin	o&#39;rta sharq	mid-north
ariwaguusu	janubi-g&#39;arbiy	north-south
arkansas	arkanzas	arkansas
aroko	o&#39;simlik	composition
aruleyin	salom	carried on the back
arun	kasallik	disease
aryan	aryan	aryan
aráa	aka	people from
arábíà	alifbo tartibida	arabia
aráròmí	salom	araromi
arópò	poraxo&#39;rlik	substitute
arúgbó	qarilik	elderly
arọ	cho&#39;loq	cripple
asagun	g&#39;alaba	intial, first (referring to the 13 colonies)
ascii	top	ascii
aseeto	turar-joy	unfair
aseyori	muvaffaqiyat	success
asipa	og&#39;ish	first to kill
assessment	baholash	ayewo
asìko	bema&#39;nilik	time; ni asiko=when
asèdá	tabiiy	origination
atangbona	atom	emission
atanna	atom	emitter
atigba	maqbul	from time
atimo	rejasi	inland
atinrin	kulib	thin
atun	orqaga	also
atunse	tuzatish	revision
australia	avstraliya	australia
austriahumgary	avstriyaumgari	austria-hungary
austronesian	avstraliyalik	austronesian
austríà	avstraliya	austria
avar	avar	avar
awari	kashfiyot	discovery
awo	plitasi	of
awonara	hissiyot	people of
awoòn	shablon	people
awon	ularni	they
awuruju	sehrli	shady
awùjo	xushmuomalalik	society
awújẹ	janjal	root
aya	oyat	chest
ayeye	abadiylik	celebration
ayàfi	bu yaxshi	only if
ayò	ay	game
azikiwe	umumiy ma&#39;noda	azikwe
aṣòkan	individual	united
baa	hisoblanadi	be with
babaláwo	folbin	herbalist
bahrain	bahrayn	bahrain
balẹ̀	u bo&#39;lsin	settled
bang	portlash	bang
banle	banle	banle
bara	o&#39;tgan yili	themselves
bauxitealumina	boksitalumina	bauxite/aluminum
bayelsa	bayelsa	beyelsa
bayi	hozir	like this
bayìí	hozir	this
bce	uzoqda	bce
beauharnais	chiroyli	beauharnais
beijing	beijing	beijing
belarus	belarus	belarus
belgium	belgi	belgium
bengal	bengal	bengal
bengali	bengali	bengal
benin	dastgoh	benin
berber	berber	berber
berlin	berlin	berlin
bernstein	bernshteyn	bernstein
bharat	bharat	bharat
bharata	qaytib kelmoq	bharata
bibeli	bibliya	bible
biribiri	ezildi	intense
black	qora	dudu
bodies	tanalar	ara
bojú	qarab qo&#39;ymoq	take care
bole	bole	ground
bolt	murvat	bolt
bolívar	bolivar	bolivar
brasil	brazil	brazil
brazzaville	brazzavil	brazzaville
bridgeport	bridgeport	bridgeport
britain	britaniya	britain
brítánì	britaniya	britain
bu	anavi	give
buenaventura	buenaventura	buenaventura
bujumbura	kengaytirildi	bujumbura
burúkú	yovuzlik	bad
by	tomonidan	does not translate directly, does not exist
bàbá	ota	father
bákannáà	shuningdek	likewise
bálè	balon	lying on the ground
bárakú	giyohvandlik	habitual
báyìí	hozir	this
bèrẹ̀	bilan boshlamoq	started
béè	xuddi shunday	than
bòtswánà	avtobus	botswana
búburú	yomon	bad
búrú	jasur bo&#39;l	wicked
bẹ̀rẹ̀	boshlash uchun	started
bẹ́	sindirdi	also
bẹ́ljíọ̀m	berill	belgium
bẹ́ẹ̀ni	ha	yes
bẹ́ẹ̀sìni	ha	that is it
cairo	g&#39;azab	cairo
calabar	saqich	calabar
canaria	kanariya	canaria
cape	kaput	cape
casablanca	kasablanka	casablanca
caslon	kazino	caslon
cathedral	ibodathona	cathedral (katidral)
catherine	ketrin	catherine
cauchy	choyshab	cauchy
cbc	cbc	cbc
chamorro	romashka	chamorro
charles	charlz	charles
chaskalson	chaskalson	chaskalson
chebbi	o&#39;ylab ko&#39;ring	chebbi
cherished	qadrlaydi	mu lokunkundun
china	chinni	china
cipollone	sipollon	cipollone
clear	ravshan	danmanran
code	kodi	code
coetsee	pirog	coetese
coloured	rangli	alawo dudu
coming	kelayotgan	yo jade
compared	taqqoslandi	does not directly translate
computers	kompyuterlar	komputa, ero ayarabiasa
csto	csto	csto
ct	ct	ct
cunha	tomoq	cunha
da	va	back; but in this form it is unnecessary
dagbasoke	o&#39;s	developing
dandan	majburiy	a must
dani	ushlab turish	hand-held
darapo	qo&#39;shiling	joinedd
daru	yo&#39;q qil	scattered
dates	xurmo	pada si
delhi	qilma	delhi
denver	denver	denver
des	des	des
describes	tasvirlaydi	se apejuwe (apejuwe=description; se prefix makes it a verb)
desmond	tushkunlik	desmond
development	rivojlanish	idagbasoke
didagba	tenglik	growing
didasile	tashkil etish	established
different	boshqacha	iyato
din	qovurmoq	reduced
dinwoju	qidirmoq	suitable
divoire	divoire	d'ivoire
doju	yuzma-yuz	face
dojú	yuzma-yuz	turn face (full phrase is doju ko, to face)
dominic	dominik	dominic
doni	doni	this day
dote	nuqta	rebel
doublehelix	ikki karra	hiliksi abara meji
doublestrand	ikki karra	double-strand
dover	kaptar	dova
du	du	hustle
due	sababli	nitori
dun	mazali	sound
dàbíi	shunga o&#39;xshash	like
dàpò	ularni almashtiring	mix
dá	yaratilgan	intervene
dágbó	qarilik	forest
dájó	yaxshi	pass judgement
dálóríi	rahmat	about
dáradára	yaxshi	well
dásà	bir kasa	peculiar way of saying
dáwó	ehson qilmoq	undertake
dé	keldi	reach
délànà	amalda	delana
dépò	darajada	to a position
dì	varaq	be
dìde	paydo	stand
dìró	o&#39;ngda	hang on
dìtẹ̀	fitna	rebel
díè	tarang	few
dóko	yaxshi	upstanding
dólà	yaxshi	dollar
dún	ovoz	sound
dúró	turmoq	stand (been in existence)
dọ́gba	teng	equal
ea	ha	ea
eba	eba	shore
ebi	oila	family
ecomog	ekomog	ecomog
ede	tili	language
efrem	effem	efrem
egba	mutlaqo	cane
egbe	qurol	group
egberundun	ming yil	a thousand year
egbo	yara	brother
egbé	voy	party
egbò	yara	chemicals
egbògi	tibbiy	don't know this
eighteen	o&#39;n sakkizda	ejidinlogun
eka	murakkab	branch, department, part
ekeji	boshqa	second
eko	ta&#39;lim	lagos
elede	cho&#39;chqalar	speaker
eleyi	bu	this
eleyii	shunga o&#39;xshash	this
elláda	yaratish	ellada
eléde	mavhum	pig
eléré	sportchi	performer
elòmírà	dengiz shoxlari	freedom
elòmíràn	boshqa	another person
emerging	paydo bo&#39;lgan	ibere-pese
emmanuel	emmanuel	emmanuel
enikéni	hamma	whoever
enter	kiriting	wole
enì	fil	person
eníbá	isitma	such person
epa	yeryong&#39;oq	groundnut
ernst	ernst	ernst
erofo	cho&#39;kindi	swamp
erékùsù	orol	island
eréonítàn	qisqartma	written play
eseese	diagrammasi	step by step
esia	kelmoqda	asia
esteri	esteri	ester
etisalat	etisalat	etisalat
etymologiae	etimologiya	etymologiae
etíòkun	sohil	beach
euro	evroga tushdi	euro
euroasia	evroaziya	uro-esia
ewe	barg	ewe
ewé	barg	leaf
ewì	she&#39;riyat	traditional poem
example	misol	apere
eya	kategoriya	tribe
eyin	tuxum	previous
eyonomba	eyonomba	digit
eléja	baliq ovlash	fisherman
elòmíràn	yana kimdir	another person
eka	ta&#39;siri	branches
eléyàmèyà	millati	tribalism
enu	darvoza	mouth
esin	din	horse
esè	tushadi	leg
ewà	xulq-atvori	beauty
fagile	bekor qilindi	cancel
fail	muvaffaqiyatsiz	padanu
fan	fanat	spread
faramó	rioya qilmoq	accept
faranse	fransuzcha	french
farsi	arti	farsi
felifeli	baxmal	fuming
ferde	ferde	verde
fesèmúlè	vaqtinchalik manba	established
fe	qidirildi	want
fi	tejash	by
fifihan	ko&#39;rsatmoqda	revealed
fihan	ko&#39;rsatilgan	shows, to show
fimú	keskin aniqlangan	captivate with
finiki	fizika	finiki
finlandi	finlandiya	finland
fitino	sinov	judgement
five	beshta	marun
fodio	fodio	fodio
fofinde	taqiqlash	prohibited
fohùn	- deb baqiradi	consent
foniimu	film	phoneme
force	kuch	agbara
foriko	misol uchun	agreed
fourbase	to&#39;rt asos	onidi-merin
fowobowe	bron qilish	signed
fowó	pul uchun	sign
fracmv	fracmv	does not translate
francis	frank	francis
fransi	fransuzcha	france
freetown	freetown	freetown
fuji	olib tashlang	fuji
fulani	qo&#39;rqoqlik bilan	fulani
fulbe	to&#39;liq	fulbe
fun	uchun	for
funra	o&#39;zi	suspect
further	keyingi	si
fé	fé	like
fé	fé	want
fégbé	buni unuting	for peers
fífò	uchish	jumping
fífún	berib	giving
fòye	tushunmoq	rationalise
fẹ́rẹ̀ẹ́	deyarli	nearly
galatia	bu gal	galatia
gba	rozi	accept
gbajúgbujà	juda mashhur	popular
gbale	mashhurlik	flourished
gbaná	otib tashlang	engulf in flame/rage
gbe	olib yurmoq	set up
gbera	davom etish	move
gberasoke	tezlikni oshirmoq	rising
gbese	qarz	debt
gbigbamulo	ekspluatatsiya	adopted
gbigbewo	moliyalashtirish	examined
gbilè	qutilib chiqishga urinmoq; tarqamoq	gaining ground
gbin	ekilgan	farm
gbogbogbo	umumiy	general
gbongbo	ildiz	root
gbàgbọ́	ishonish	believe
gbàgùrà	larzaga keldi	gbagura
gbá	buzmoq	received
gbáradì	turmoq	prepare
gbé	jonli	convey
gbédìí	o&#39;rnatmoq	respect
gbékalè	duradgor	establish
gbéni	jonli	lift
gbéyèwò	sharh	examine
gbésè	taklif	die
gbìnyànjú	harakat qilib ko&#39;ring	endeavour
gbìyànju	qattiq harakat qil	try
gbódò	kerak	must
gbónmisi	qonun	strife
gbúnùn	uni hidlang	hostile
gbọ́dọ̀	kerak	must
geesi	inglizcha	english
geneva	jeneva	geneva
genevieve	qilmoq	genevieve
georgia	georgiya	georgia
german	nemis	german
gfaj	gfaj	gfaj
ghana	gana	ghana
gidigidi	juda	significantly
gidí	uy	real
goemai	goemay	goemai
gomina	hokim	governor
gorgina	burgut	gorgina
gquadruplex	gquadruplex	g-gigalonomerin
grammy	grammiya	grammy
griiki	yunon	greek
groove	truba	iho
guanínì	guanni	guanine
guinea	gvineya	guinea
guineabissau	gineabissau	guinea bissau
guinébissau	guinébissau	guinea bissau
gun	uzoq	stretch
gunle	qurol	arrive
guusu	janubda	south
gv	gv	gv
gèésì	elim	english
gèésì	marvarid	english
gégé	haqiqatan ham	like
gírámà	panjurlar	grammar
gòkè	ko&#39;tarilish	climb
gún	teshilgan	properly
gúúsù	janubda	south
gẹ̀ẹ́sì	inglizcha	english
habsburg	habsburg	habsburg
haggai	qo&#39;llanma	haggai
haiti	haiti	haiti
halomonadaceae	halomonadaceae	halomonadaceae
hard	qattiq	lile
haughton	gugton	haughton
hausafulani	hausafulani	hausa fulani
hawaii	xovayi	hawaii
heinrich	geynrix	heinrich
hendu	shirinlik	hendu
henny	jiyan	henny
heraklion	iraklion	heraklion
hesse	kelishilgan	hesse
him	uni	un, this term is sexless
hindu	hindu	hindu
histoni	histoni	histones
hominidae	hominidae	hominidae
hosea	shlang	hosea
hp	ot kuchi	hp
hugh	hug	hugh
hun	ov	knit
hungari	ochlik	hungary
hv	hv	hv
ibalo	ish	relationship
ibarepo	uyushma	friendship
ibeji	egizaklar	twins
ibewo	keldi	visit
ibiamusin	ziyoratgoh	colony
ibile	an&#39;anaviy	municipality
ibimo	tug&#39;ilish	birth
ibise	tayyorlamoq	official
ibiti	joylar	where
ibn	ibn	ibn
ibojì	qabr	burial ground
ibori	parda	conquest
ibujoko	dastgoh	place of abode
ibuseripadabosi	ko&#39;chirish	eternity
ibuso	jang qilmoq	bus stop
ibùdó	lager	settlement, seat of, area,
ibùjókòó	o&#39;tirish	settlement
iceland	muzlik	iceland
idagbasoke	rivojlanish	development
idagbe	beparvolik	isolation
idaji	yarmi	half
idajo	adolat	judgement
idamita	chizish	sector
idari	boshqaruvlari	control
ideraa	yozmoq	comfort
idimule	hibsga olish	establishment
idoma	chizish	idoma
idupe	rahmat	thanksgiving
idánwò	sinov	examination
ifija	baliq ovlash	weapon
ifilole	ishga tushirish	resolution
ifitonileti	ma `lumot	reporting
ifobaje	buzilish	coronating
ifofinde	kongress	prohibition
ifriqiya	rag&#39;batlantirish	ifriqiya
igbeduro	tayyorlash	institute
igbegun	g&#39;alaba	declaration of war
igberiko	shahar atrofi	region
igbesoke	oshirish	upliftment
igbeyawo	to&#39;y	marriage
igbowolori	qimmat	inflation
igbá	tovuq	shell
igbáẹ̀yìn	oxirgisi	shell
igitòròmogbè	keng polosali	willow tree
ihan	paydo bo&#39;lmoq	ray
ihinrere	xushxabar	gospel
ijagun	jang	war
ijakadi	kurash	wrestling
ijaya	vahima	fear
ije	harakat	eating
ijinnasi	fizika	the wind open
ijosin	sig&#39;inish	worship
ijó	raqsga tushish	dance
ikan	bitta	one of
ikandinlogun	o&#39;n sakkizda	nineteen
ikaowo	hurmat	finger
ikejidinlogun	o&#39;n sakkizda	eighteen
ikeko	jamlama	education
ikerin	to&#39;rtinchisi	fourth
iketa	meros olmoq	third
ikoenu	saqlamoq	union
ikojopo	to&#39;planish	collection
ikoreokere	bo&#39;ri	migration
iku	o&#39;lim	death
ikúgbaèyí	hozir	death-has-this
ikún	to&#39;ldirish	squirrel or wild rodent
ilagbolojo	oshkoralik	latitude
ilana	tartibi	procedure
ilanaoye	strategiyalar	knowledge procedure
ilaodo	himoya qilish	cana
ilaorun	quyosh chiqishi	west
ileasofin	qonun chiqaruvchi	house of law,
ilegiga	uy	higher ground or higher plain
ileife	beparvolik	ile-ife
ileigbimo	rozilik	house of assembly/congress
ileobaluaye	dunyo	high chief
ileru	o&#39;choq	volcanic
ilopo	ikki baravar	times
iluoba	fuqarolik	king's town
iluorilejoba	globallashuv	capital city
ilé	uy	house
iléayé	uy	earth
iléisé	uy	workplace
ilélódò	uy	ile-lodo
iléàtèéré	uy	ile-ateere
iléńlá	hovli	ile-nla (area)
ilẹ	zamin	land
ilẹ̀ayé	er	the world
iminle	qamoqqa olmoq	earthquake
imoero	yoritish	engineering
imojuto	parvarish qilish	protection
imusin	chizish	colony
imú	burun	nose
imúnisìn	gigiena	slavery
inagberingberi	yong&#39;oq moyi	electromagnetic force
indeed	haqiqatdan ham	paapa julo
indus	indus	indus
inkosi	oqlamoq	inkosi
integration	integratsiya	ifowosowopo
inágbéringbérin	o&#39;n yetti	electromagnet
iní	meros olish	possession
inúnibíni	quvg&#39;in	hatred
ioja	baliq	fight
ioniani	muhtoj	ionian
iowa	er yuzida	iowa
ipare	so&#39;nmoq	abolition
ipawo	foydalanadi	income
ipele	daraja	stage
ipin	bob	share
ipinpa	ishtirok etish	arm of, branch of
ipinu	qaror	determination
ipo	manzil	position
ipá	kuch	effort
iraja	dahshatli	bargaining
iranlose	yordam	mission
ire	sotish	you
irele	kamtarlik	irele
iringa	aylantirmoq	iringa
irisi	tashqi ko&#39;rinishi	appearance
irorun	juda sodda	convenient
irò	mish-mish	iro
irúnmọlẹ̀	chaqmoq	apparition
isa	yetarli	jesus, isa or yisa is hausa language
isare	tezlashtirish	track race
isedaniloro	o&#39;z-o&#39;zidan shubha	terrorism
iseero	tomosha	engineering
isejoba	boshqaruv	governance
iseoba	o&#39;n besh	civil service
iseoroayeijoun	arxeologiya	archaeology
iseowo	biznes	business
isepinpin	tarqatish	division
iso	kelmoq	unit
isoponomba	izoponomba	addition of numbers
isun	oqimi	spring
isesi	taslim bo&#39;lish	conduct
isè	xizmat	occupation
itali	italyancha	italy
itanakole	hikoya	ancient
itelentele	aniq	coming after
itiraka	kurash	effort
itobi	maqtanish	size
itokowo	biznes	economy
itorawo	liberal	astrology
itu	otmoq	solution
itumo	ma&#39;nosi	meaning
iwadi	tadqiqot	research
iwasi	taassurot qoldirmoq	behaviour
iwifun	ma `lumot	report
iwoile	uy	entering
iwosan	davolaydi	healing
iwulo	foydali	use
iwuwa	amaliyot	behaviour
iyan	ochlik	argument
iyato	farqi	difference
iyawo	kelin	wife
iyen	anavi	that
iyán	uchqunli	pounded yam
iḷẹ̀	ishlash	land
iṣẹ́ìwádìí	tadqiqot	research
jabo	hisobot	give account
jackson	jekson	jackson
jadide	to&#39;hta	emerge
jagbe	yo&#39;qol	shout
jalè	o&#39;g&#39;irlik	steal
jamaica	youtube	jamaica
jamo	yo&#39;qol	link
jawaharlal	siljishlar	jawaharial
jeffrey	jeffri	jeffrey
jeometri	geometriya	geometry
jesu	iso	jesus
jfk	jfk	jfk
jije	bo&#39;lish	existing as
jijinna	uzoq	distance
jiròrò	tumanli	dialogue
jo	oqish	days
jogun	meros qilib olingan	inherit
johann	jahannam	johann
johanu	uzr	john
jojo	darz ketgan	great extent
jopò	qo&#39;shilish	gathered
jo	john	resemble
juneau	iyunda	juneau
jàgídíjàgan	zo&#39;ravon	violent
jáde	tashqariga chiq	out
jé	keling	is
jéésù	iso	jesus
jìnnàa	uzoq	further
jíje	bo&#39;lish	eating
jíjuwó	pul topish	waving hands
jíjéomoléyìnkírísítì	filantrop sifatida	followers of christ
jùlo	bundan ko&#39;proq	most
jùlo	ayniqsa	most
jùló	eng	most
jẹ́mánì	nemis	germany
jọ́	iltimos	together
kadara	aktiv	destiny
kagera	maqtanchoq	kagera
kakiri	iz	all over
kalinga	kinga	kalinga
kalẹ	chetga surib qo&#39;ying	established
kampala	ushlash	kampala
kan	a	one
kankan	hech biri	any
kanlè	kanal	established
karbonumarun	tsentrikan	5 carbon
karl	karl	karl
karun	beshinchi	fifth
karùún	beshinchisi	fifth
kebbi	sozlanishi	kebbi
kekere	kichik	lower
keko	savodli	learn
kept	saqlandi	fi pamo
khoisan	past	khoisan
ki	shunday qiling	not
kiakiajulo	eng tezkor	rapidly
kiko	olib keladi	gathering
kikojo	jamlama	gathering
kikopomo	iliqlik	mixed
kikoso	tez	colonised
kiko	o&#39;rganish	making
kikuninu	tasavvur qiling	size
kilhar	qo&#39;ltiq	kilhar
kinkinni	kichik narsa	small quantity
ko	yoki	don't
kodò	quyida	bow
koidu	koidu	koidu
kojá	kesib o&#39;tish	pass
kolo	kolo	going
komputa	kompyuter	computer
kong	kong	kong
kongo	prezervativ	congo
kookan	bu	one
koto	o&#39;lja	pit
koko	o&#39;rganish	make heap
ko	ko	learn
kori	boshqa emas; boshqa ... bo&#39;lmaydi; endi yo&#39;q	not found
krio	krio	krio
ku	siz	remain
kwara	murojaat qildi	kwara
kàríbẹ́ánì	mintaqada	carribean
kàyéfì	hayron	amazement
ká	ning	we
kánfinkése	sekin	prolonged
kánádà	albatta	canada
káyé	dunyo	world
kéesì	bema&#39;ni	keesi
kékéèké	kichik	small
kétu	tayyor bo&#39;ling	ketu
kémíkà	aksincha	chemical
kéyìn	keyinroq	come after,
kìnní	birinchi	first
kí	salomlashing	not
kíko	o&#39;qish	written
kíkọ́	o&#39;rganish	learning
kínu	o&#39;pish	greet
kírísìtì	rojdestvo	christ
kòjòkú	yomg&#39;ir	kojoku
kòkó	sichqonchani	cocoa
kòmpútà	kompyuter	computer
kòtò	chuqur	pit
kòòsí	emas	coaching
kòòkan	har biri	each
kógo	shon-sharaf	glorious
kóra	yig‘moq	participate
kùkú	oxirida	eventually
kùrání	qur’on	quran
kúkú	oxirida	now
kúkúrú	qisqasini etkanda	short
kúrò	uzoqda	away
kútò	hamma narsa	kuto (place)
kúùkù	aksincha	punches; expression meaning 'by force' (ti pa ti kuuku)
kẹrin	to&#39;rtinchisi	4
kẹsàán	darhol	ninth
kẹta	uchinchi	third
kẹ́nyà	ajratish	kenya
kọjá	o&#39;tish	pass through
kọ̀mpútà	kompyuter	computer
kọ́kọ́	birinchi	first
kọ́lọ́mú	ustunlar	breast owner
kọ́ni	kamomad	teach
laa	yo&#39;qol	will
laada	tepish	good fortune
laaka	teskari	important
laarin	ichida	between
labalaba	kapalak	butterfly
labee	ostida	under
lade	qilmoq	crowned
laid	yotqizilgan	tele
laifi	xato	without
languages	tillari	ede
lanka	lanka	lanka
lasile	ozod qilish	laid out
latibe	u erdan	from there
latigbana	o&#39;shandan beri	from then on
latini	lotin	latin
latvia	latviya	latvia
lay	yotmoq	da
le	mumkin	can
leboa	lebo	leboa
lekun	kuchaygan	open door
leo	leo	leo
lese	post	firmly
less	kamroq	okeresi
lewaju	oldinga	front
lewon	qamoq	imprisonment
leyi	mana	mispelled...should be 'leyin', after
leè	mumkin	can
lilelile	hardkor	tightly
lilemo	nasha	sticky
lilongwe	lilongwe	lilongwe
lindi	lye	lindi
linear	chiziqli	dogba
links	havolalar	eka; this is a new word and does not really exist in yoruba
lodo	sodir bo&#39;lmoq	from
lojowaju	kelajakda	the future
lojukokoro	ochko&#39;z	covetousness
lojúgun	buzilgan	knee
lokunkun	baquvvat	in the dark
loloselu	siyosiy jihatdan	in politics
lopolopo	ko&#39;p	so many
loruko	nomi	name
louvre	louvre	louvre
lovers	sevishganlar	awon olufe
low	past	diye
lo	davom et	than
luanda	luanda	luanda
luther	yuk mashinasi	luther
lynton	linton	lynton
làgba	teng	more important
lààmi	belgisi	sign
lààmì	belgilari	significant
lábé	vazn	under
láfún	berilgan	cassava food
láimo	holda	unknown
láké	baland ovozda	in ake
lámọ́di	omad	lamodi
lápá	qismi	from
lára	jarohat	part of
lárúbáwá	tabiiy	arabic
láì	holda	without
láíláí	hech qachon	old
lèe	mumkin	can
lèyìn	keyin	after
lédè	tilida	language
léebá	tasodifan	catch up with it
lérìnín	qor	erin=laughter; the prefix 'l' is possesive
lérò	sabab	thought
léyin	keyin	after
léyìn	keyinroq	after
lérú	qullik	enslave
lílo	ekspluatatsiya	using
lísa	tezlashtirish	a chieftaincy title
lítésò	qoqish	literature
lóde	tashqarida	modern
lópez	nipez	lopez
lópó	beva	widow
lórì	port	on the head
lóríba	ustida	subdue
lóti	lot	have
lóòótò	ha	truly
lóòótọ́	haqiqatdan ham	truly
ló	ló	to
lónà	yulda	in a way
lórò	ertaga	become wealthy
lọndọnu	london	london
lọ́dọọdún	har yili	yearly
lọ́jà	bozorda	in the market
maapu	xaritasi	map
madeira	beira	madeira
mahatma	mahatma	mahatma
makedonia	makedoniya	macedonia
malabo	asal	malabo
malay	taxmin	malay
malayopolynesian	malayopolineziya	malayo-polynesian
malaysia	malayziya	malaysia
mali	kun	mali
mango	mango	mango
manˈdeːla	manˈdelala	mandela
marcellus	marselus	marcellus
march	marsh	march
marku	bu gal	mark
mars	marslar	mars
maryland	merilend	maryland
maseru	rashk	don't be slave
matheu	mateyu	matthew
mathiew	matematik ko&#39;rinish	mathiew
mathimatiki	matematik	mathematics
max	maksimal	max
maya	yo&#39;q	maya
mbabane	manfiy	mbabane
means	degan ma&#39;noni anglatadi	ona (way)
mediteraneani	o&#39;rta er dengizi	mediterranean
mefeefa	mukammal ta&#39;mirlash	all six
mejidinlogbon	yigirma sakkiz	twenty eight
mejila	o&#39;n ikki	twelve
meksiko	meksika	mexico
melo	nechta	some
member	a&#39;zosi	ara
mercosur	merkosur	mercosur
merin	to&#39;rtta	four
methodologies	metodologiyalar	anaoniruuru
metropoli	metropoli	metropolis
meucci	meucci	meucci
mewar	mewar	mewar
mexico	meksika	mexico
michelle	mikron	michelle
micronesia	mikronesiya	micronesia
miiràn	yengillashtirmoq	another
mimoy	mimoy	mimoy
mimuwa	yopishib olish	import
minnesota	minnesota shtatida	minnesota
minority	ozchilik	awon ara kekere
mohandas	mohandalar	mohandas
mokaleladota	ixcham	51, (mokanleladota)
mokanlelogbon	o&#39;ttiz ikki	thirty-one
mombasa	mombasa	mombasa
monrovia	monroviya	monrovia
morgan	morgan	morgan
morogoro	motorli	morogoro
mozambique	mozambik	mozambique
mozilla	mozilla	mozilla
mtn	mtn	mtn
mtwara	yana tanlang	mtwara
mughal	hajmi	mughal
mulẹ̀	o&#39;rnatmoq	establish
munispal	munispal	municipal
muungano	mugangano	muungano
májèmú	qarshi emas	testament
mère	chizish	significant
méjèèjì	ikkalasi ham	the two
mérindíláàdóta	ellik besh	forty-six
méte	beshta	lip
mérìndínlógún	o&#39;n olti	sixteen
mérìnlélógójì	qirq to&#39;rt	44
méta	uch	three
métèètà	duradgor	the three
méwàá	o‘n	ten
ménu	nima deb o&#39;ylaysiz	verbally contribute; complete phrase= me nu ba
mímọ́	muqaddas	holy
míràn	boshqa	other
míìrán	boshqa	other
mííràn	boshqa	other
mò	bilim	know
mókólà	elim	mokola
móra	davolash	with themselves
mó	m	with
múlẹ̀	ushlanib turish; to&#39;xtamoq	select land (farmland)
mẹ́fà	olti	6
mẹ́rkúríù	sichqonchani	mercury
mẹ́ta	uch	3
mẹ́talọ́kan	uchlik	trinity
namibia	kelmoq	namibia
nathaniel	nataniel	nathaniel
nato	nato	nato
nawojulo	jumboqli	highest-spending
nawó	pulingni ol	point finger
ncnc	ncnc	ncnc
nebraska	nebraska	nebraska
nefimu	nefim	nefimu
neptune	neptun	neptune
nevis	nevis	nevis
ngbero	rejalashtirilgan	planning
ngubengcuka	ngubengcuka	ngubengcuka
nibe	mana	there
nibere	erta	earlier
nigbakan	ba&#39;zan	at one time
nigbà	keyin	when
nijẹr	nike	niger
nilè	bu yerda	remaining
nisinyi	hozir	at present
nitoriidieyi	shuni dastidan; shu sababdan	because of this
nitoripe	chunki	because
nitosi	yaqinida	nearby
niwaju	oldinda	in front of
niyato	ajratib turmoq	unlike
niye	yetarli	in number
niyi	mana	these
nkan	narsa	things
nkàn	saraton	something
nnaji	tog&#39;a	nnaji
nobel	nobel	nobel
nombamewa	ko&#39;paymoqda	decimal
nombáméjì	birinchi ikkita	two-number
novo	novo	novo
nri	ovqat	nri
nse	dizayn	acting
nso	yaqin	saying
nsolaboraro	xavfsizlik	nso laboraro
nsowikipedia	obowikipedia	saying
ntoka	nuqta	indicates
nu	toza	in
nukleotidi	nukleotiddan iborat	nucleotides
nukleotidipupo	nukleotiddan iborat	cell
numeri	xiralik	numbers
nwa	chaqaloq	drill
nàìjíríà	nigeriyada	nigeria
náwo	xarajatlar	spend money
náà	ham	that
nì	tog	is
nìnú	uzr	in
nìyí	mana shu	this is
ní	bor	on
níbè	mana	there
níbè	mana	there
nífẹ̀ẹ́	sevmoq	love
nígbàtí	qachon	when
nílè	quyida	on the ground
nílùú	shaharda	in the town
nílẹ̀	yerda	in the land
nínlá	ajoyib	large
nínu	imkoniyat	in
níní	bor	having
nípà	kamida	by
nítorípé	chunki	because
nítumò	ma&#39;nosi	meaningful
nítòsí	yaqinida	nearby
nítòótó	aniq	truly
nítòótọ́	haqiqatdan ham	in truth, truthfully
níwájú	oldinda	in front
níyanjú	ijobiy	solved
nǹkan	narsa	things
nso	tez kunda	say
oba	obama	king
obairanderan	amakivachcha	hereditary
obere	kichik	started
obínibí	xushmuomalalik	inborn
ododo	solihlik	righteousness
ofin	qonun	law
ogbè	viloyati	a divinity
ogun	urush	war
ogunlogo	olomon	hundreds
ojo	o&#39;xshamoq	day
ojojumo	kunlik	daily
ojoru	iliqlik	wednesday
ojukokoro	ochko&#39;zlik	covetousness
ojuoorun	quyosh botishi	atmosphere
ojuse	javobgarlik	responsibility
ojùkòsì	yog&#39;ingarchilik	ojukosi
ojùkòtúu	yog&#39;ingarchilik	ojukotuu
ojúlùmọ̀	tanishlar	acquaintance
ojútáyé	yopishqoqligi	public
ojúìwé	sahifa	page
okeere	chet elda	distant
okhotsk	okhotsk	okhotsk
oko	maydon	farm
okunkun	zulmat	darkness
okunrin	erkak	male person
olodiajodojuko	bir-biri	facing wall
olohun	egalari	god
olojukanna	darhol	same surface
olokunkun	naushniklar	popular
ololugbe	omadsiz	occupants
olopon	mag&#39;rur	a local game
olora	yog &#39;	fertile
oloselukan	salom	one political
oloye	daho	chief
oluda	yaratuvchisi	creator
oludase	ishlab chiqaruvchi	separatist
olukoitan	o&#39;qituvchi	the writer
olukowe	muallif	writer
olumojuto	ochko&#39;z	overseer
oluparapo	birikmasi	joint
olusoju	qorovul	ambassador
oluwakiri	razvedka	explorer
olympus	olimpiya	olympus
olódùmarè	qudratli	almighty god
olóyè	hukmdori	chief
olóṣèlú	siyosatchi	politics
olùbátan	bu aloqa	relative
olùdarí	rahbar	director
olùkópa	yordamchi	participant
olùkó	o&#39;qituvchi	teacher
olùkọ́	o&#39;qituvchi	teacher
omi	suv	water
omiadalu	toshqin	mixture
onialjebra	onialjebra	of algebra
onibugbe	ijarachi	population
onigbeja	konstruktiv	allied
onigbowo	homiy	sponsor
onigunfenfe	passiv	large angle
onilanaibagbepo	prezervativ	constitutional
onilile	uy egalari	solid
oninawo	qarz oluvchi	financial
onipin	oqilona	even
onisayensi	texnik mutaxassis	scientific
onisowo	savdogar	trader
oniyewumeji	ikkilik	two-chamber
oniyijulo	ajoyib	highest honour
onje	parhez	food
onka	kalkulyator	counter
onígbàgbó	qariya	believer
oníkólóbó	haqoratli	onikolobo (place)
onílẹ̀	pastga	land owners; citizens (omo onile)
oníná	olov	electronic
onítumò	tarjimon	meaning
onítèbọmi	suvga cho&#39;mganlar	baptist
onítòhùn	hisobchi	that person
oníwòsàn	tabib	doctor
oníyanjù	jonlantirilgan	persevere
ooni	timsoh	ooni (king)
ootọ́	rost	truth
opec	opec	opec
opposite	qarama-qarshi	odi
ori	bosh	top
oriire	tabriklayman	success
oriki	sharqona	name of endearment
orileede	millat	country
orileedeajoba	imperializm	monarchic country
orilejoba	hukumat	seat of government, kingdom
orileominira	iliqlik	republic
orinìyìn	qo&#39;shiq	songs of praise
orisirisi	xilma-xillik	various
orisun	manba	source
orisa	kelib chiqishi	god
oritameta	o&#39;rtasida	crossway
orudnun	yillik	mispelled...should orundun, century
oruko	ot	name
oríilè	milliy	land
oríilẹ̀	maqola	land
oríkì	she&#39;riyat	family name
orílèèdè	millat	country
orílẹ̀	millat	continent
orílẹ́	oqshom	nation
orísiirísi	turli xil	various
orísìí	xilma-xillik	type
orísìírísi	har xil turlari	various
orúko	maydon	name
oscar	oskar	oscar
oseluarailu	fuqarolik	political unit
otherwise	aks holda	ibaje
otutu	juda ko&#39;p	coldness
oun	u	it
owojagidijagan	terrorchilar	upheaval
oúnjẹ	ovqat	food
odún	yil	year
ojó	yomg&#39;ir yog&#39;adi	day
okùnrín	kulgu	man
olórun	xudo	god
olósìn	diniy	rearing
odun	har yili	year
olorun	xudo	god
omonìyàn	odamzod	human beings
opolo	juda ko&#39;p	brain
ose	ose	week
oyé	dunyo	harmattan
ofò	xayrli tong	nothingness
opolo	juda ko&#39;p	brain
paa	o&#39;chirmoq	back
paapaa	ayniqsa	especially
padá	pod	go back
palauan	palov	palauan
panaˈma	panaˈma	panama
panyanan	tegi	spanish
papa	papa	specifically
parapọ̀	aralashtirish	join
paripari	tamom	finally
pele	jozibali	hello
penh	penya	penh
penisula	penisula	peninsula
periferi	periferi	periphery
petu	petu	resolve
pelu	dur	with
phillipines	filipinlar	phillipines
pinsi	pasayish	divided
pinsoto	pinoto	separated
pinu	aniqlangan	decide
pipo	ko&#39;p	plenty
pipolongo	reklama	publicise
piposi	ko&#39;p	multiplication
platos	platolar	plato's
plánẹ́tì	sanitariya-tesisat	planet
po	po	share
pojulo	eng baland	larger
polandi	jilo	poland
polaroid	polaroid	polaroid
population	aholisi	ero
portonovo	portonovo	porto novo
portuguese	portugal tilida	portuguese
press	bosing	press
produced	ishlab chiqarilgan	yo
protokolu	protokoli	protocol
proton	proton	kemika alaropo
providence	ta&#39;minlash	providence
príncipe	príncipe	principe
pupa	qizil	red
px|kùránì	px | yadro	koran or quran; the px  does not belong
pàmò	xususan	pamo (town)
pàràkòyí	darhol	parakoyi
pààlà	chegara	signalised
pàápàá	ayniqsa	especially
pásíà	podval	persia
pátáporongodo	mutlaqo	entire
pè	chaqirdi	that
pèhìndà	sperma	turned back
pèlu	bilan birga	with
pèlúpèlú	shuningdek	in addition
pèsè	taqdim etilgan	provide
pé	bu	that
péré	faqat	only
péé	bu	that
pípa	so&#39;yish	order
pípèsè	ta&#39;minlash	providing
pípẹ́	uzoq	long
pòwe	maqollar	to say a proverb or wise saying
pò	katlamoq	join
púpo	juda ko&#39;p	much
púpò	o&#39;rniga	a lot
quran	quron	quran
ra	sotib olmoq	self
race	irqi	ere
rajya	umid	rajya
ramadan	ramazon	ramadan
rank	daraja	ipo
reggae	reggi	reggae
repeats	takrorlaydi	tunso
repetejulo	eng sezgir	most of all
rere	yaxshi	success
research	tadqiqot	agbeyewo
richard	richard	richard
right|thumb|px|aworan	o&#39;ng | bosh barmog&#39;i | px | rasm	picture
rinle	yangi	emphasise
riresile	magnitafon	humbled, lowered
riro	xayol	thought as
rn	rn	rn
rna	rna	rna
rnarna	rnarna	rna-rna
rnas	rnas	rnas
ro	o&#39;ylab ko&#39;ring	thought
robinson	robinson	robinson
roboto	yuzalar	round
rogbodiyan	g&#39;alayon	riot
rokirika	ko&#39;rib chiqish	publicise
roko	to&#39;da	farm work
roma	rim	roma
rome	xrom	rome
ronald	ronald	ronald
rorùn	oson	easy
rossii	rossii	rossii
rural	qishloq	igberiko
ryan	ryan	ryan
ráhàn	paydo bo&#39;ldi	complain
ránmú	xavotir	grumble
république	république	republic
ré	v	his/her
rìn	yurmoq	should be orin, song or music
ròyìn	xabar qildi	give account
rẹ	uni	it
saarc	olib tashlang	saarc
saaree	ustun	after death
saarland	polning ustida	saarland
safari	safari	safari
saffana	safir	savannah
safiwe	taqqoslash	describe
safta	qatorga turish	safta
saheli	qulaylik	sahel
sakyamuni	keyingi	sakyamuni
sakyas	sakyalar	sakyas
salem	salom	salem
salàyé	hayot	explained
sambia	yoshlar	zambia
samioro	mavjud	signal
santa	santa	santa
say	demoq	so
sb	sb	sb
schwarz	shvars	schwarz
sea	dengiz	odo
seat	o&#39;rindiq	itedo
segbese	ehtimol	take steps
seidamo	ravshan	identify
semolara	astma	accustom
semudaju	albatta	assure
senegal	senegal	senegal
sense	ma&#39;nosi	sensi
seville	sevil	seville
sewadi	qidirmoq	investigate
sharon	sharon	sharon
sibesibe	hali	further more
sihamoni	tuzilishi	sihamoni
sile	orqasida	previously
silè	tomchilar	on the ground
sinai	gunoh	sinai
sinsin	din	unshakably
sioux	suz	sioux
sise	pishirish	works
sisodagba	o&#39;smoq	came of age
sisopo	bog&#39;laydi	joined
sisupapoerekusu	tupurish	neighbouring islands
sisupo	ko&#39;paytiring	concentrated
slovo	slovo	slovo
so	sevgi	turned
sohun	ha	something
solomon	solomon	solomon
soon	yaqinda	lai'pe
sopin	oxiri	ended
so	shunday qilib	tells
spectacular	ajoyib	damanran
stella	stella	stella
structures	tuzilmalar	igbekale
suez	suez	suez
sugbo	lekin yo&#39;q	but
sugbọ́n	oqilona	but, however
sun	quyosh	sleep
suny	quyoshli	suny
swahili	suaxili	swahili
symmetry	simmetriya	ogbooga
sàbúrí	eng avvalo	saburi
sàmì	belgi	signalize
sàn	yaxshiroq	flow
sàngó	to&#39;da	sango (god of thunder)
sàì	yaxshi	un
sápadè	bu kun	run to
sáàpàdé	homiylik	saapade
sáààrin	orasida	between
são	yangisi	sao
sèle	o&#39;g&#39;irlash	down
ségun	yig&#39;lamoq	conquered
sénégal	sperma	senegal
séyìn	orqaga	back
séyìn	orqaga	at the back of
sìbẹ̀	hali	there
sìni	mayda qisqichbaqa	likewise
síbèsíbè	baribir	further more
síbú	erga	ocean
sílẹ̀	pand bermoq	drop
síse	ishlash	doing
síso	hanuzgacha	spoken
síso	hanuzgacha	saying
síta	tashqarida	outing
síwon	ularni	to them
síwájú	oldinga	comes before
síí	bu yerda	on it
sòrò	miya yuvish	talk
sójà	askar	soldier
sóko	o&#39;simlik	to the farm
sùgbón	aksincha	but
sọ	demoq	lose
si	albatta	to
síse	tuzilishi	performing
sùgbón	aksincha	but
se	ular qiladi	do
sepò	nihoyat	cooperation
sisé	tayyorlamoq	work
sááju	bir daqiqa vaqt oling	before
sísa	s .ía	to be
sísè	tarjima	step
tabi	yoki	or
tabili	jadval	table
tabora	oldini olish	tabora
taino	dino	taino
tainos	tainos	tainos
takuntakun	cheklovlar	valiant
talaka	bechora	poor
talika	qashshoqlik	the poor
tara	to&#39;qqiz	wholly
tata	filtri	wildly
taínos	tainos	tainos
technology	texnologiya	tekinoloji
tedo	tanishuv	stay
teksas	texas	texas
tele	kuzatish	before
temptation	qidirmoqda	idanwo
terutomo	terutomo	everybody
tfrac	tfrac	tfrac
the	the	does no directly translate
they	ular	won
those	o&#39;sha	awon
thumb|left|upright|nelson	bosh barmog&#39;i | chap | tik | nelson	apa osi naro
tira	tarang	quranic verse
tirana	tirana	tirana
tirè	uning	own
titu	otmoq	cold (if it's a person's name, it is tutu)
tiwọn	ularning	theirs
to	ga	it
toje	kamdan-kam uchraydigan	that is
tokasi	ishora	pointing to
tokyo	tokyo	tokyo
tolerejulo	toqatli	most profitable
tolórítelémù	holokost	all manners of people
tomé	pomidor	tome
tooto	haqiqatan ham	true
tori	tori	because
torun	qoramag&#39;iz	heavenly
toseluaralu	siyosiy	political
tounsejanu	fojiali	control
traduite	traduite	traduite
translated	tarjima qilingan	tunmo
tumosi	degan ma&#39;noni anglatadi	means
tuntun	yangi	new
tàsí	holda	or
tàwon	ularni	theirs
táawà	ta&#39;zim qilish	we
tèlé	kuzatish	before
tètè	tezda	quickly
tèlé	darhol	follow
tèsíwájú	taraqqiyotga erishish	progress
té	t	follow
télè	tomonidan	before
té	t	shamed
títi	yopiq	till
títèlé	ergashmoq	following
títío	gacha	until
tíátà	chiptalar	theater
tíórì	shinalar	that is seen
tò	o&#39;rnatildi	enough
tóbi	katta	big
tódárajùlọ	eng yahshi	most beautiful
tókù	dam oling	others
tówùú	har qanday miqdor	whatever
tó	tó	taught
tóka	iqtibos keltirdi	pointed
tú	to&#39;kib tashlang	untie
túmò	olxo&#39;ri	means
túnse	qayta tartibga solish	restructured
tẹ̀ǹbẹ̀	keyin	rivalry
tẹ̀ǹbẹ̀lẹ̀kun	fitna	bitterness
ucb	ucb	ucb
umueri	bolalar	umueri
unifasiti	universitet	university
unla	ha	great
urasílì	urasil	uracil
uribe	aura	uribe
usps	usps	usps
utah	utah	utah
utc	utc	utc
uzbek	yo&#39;l	uzbek
venezuela	venesuela	venezuela
vermont	vermont	vermont
victor	g&#39;olib	victor
videos	videolar	fidio
vihara	vihara	vihara
villa	villa	villa
viruses	viruslar	awon eran
visit	tashrif	ibewo
vz	vz	vz
waa	bu	ours
waju	yuzi	future
wari	hidi	once existing
westminster	westminster	westminster
wisconsin	kentukki	wisconsin
witkin	jodu	witkin
wiwari	kashfiyot	discovered
województwo	jinnilik	wojewodztwo
wole	tizimga kirish	into
woo	wu	look
wo	bu yerda	enter
wo	bu yerda	look
won	ularni	they
wura	oltin	gold
wyoming	wyoming	wyoming
wàásù	va&#39;z qilmoq	preach
wì	yuving	that
wípè	ravshanlik	that
wòfún	qarash	convenient
wònyí	bular	these
wón	ularni	they
wúnrèn	tayyorlamoq	small amount
wọn	ularni	they
wọ̀nyí	bular	these
xd	xd	xd
xiv	xiv	xiv
yafran	bu yaxshi	yafran
yakubu	yakub	yakubu
yan	tanlang	choose
yanjú	hal qiling	solve
yanturu	mo&#39;llik	abundant
yaoundé	yaunde	yaounde
yewo	takomillashtirish	examine
ye	ha	suitable
ye	ha	should
yindinyindin	hech qachon to&#39;xtamang	brightly
yio	qiladi	will
yiowu	bo&#39;ladi	any
yipada	ortga burilmoq	change
yiyafunnilo	eroziya	borrow
yoo	irodasi	will
yori	led	result
york	york	york
yorúbà	qatiq	yoruba
yo	yo	remove
yànan	hayrat	scattered
yàtò	sozlash	other than
yára	shoshilmoq	quickly
yèwò	qarang	examine
yée	qo&#39;yib bering	eplained to
yì	boring	this
yìí	bu	this
yí	ortga burilmoq	this
yíyípadà	o&#39;zgartirish	changed
yíì	siz qilasiz	this
yíò	bo&#39;ladi	it will
yẹ̀ẹ́	y’in	check
yọ	olib tashlang	bring out
zanzibar centralsouth	zanzibar markaziy markaz	zanzibar centralsouth
zdna	zdna	z-dna
zou	zou	zou
zscores	zscores	z-scores
zy	zy	zy
 bce	uzoqda	bce
àbe	baboon	under
àbámẹ́ta	payshanba	saturday
àbáyo	taklif	breakthrough
àbìkú	boqiylik	'born to die' child
àbọ̀	yarmi	result
àdámò	maxfiylik	earmark
àdátá	qarama-qarshi	adata
àdáátán	eksklyuziv	adaatan
àdóolóró	yog &#39;	bomb
àgbàjọ	qariya	assembly
àgbàrá	toshqin	power
àgbáríjọ	tashkiloti	combination
àgbékà	mavhum	suitable
àgbéyèwò	sharh	examination
àgbìgbò	turar joy dahasi	a type of bird
àgbùdo	hovli	corn
àgọ́	chodir	ago
àifète	maqsadi	unable to keep quiet
àjo	sayohat	board
àjákọ	alohida	ajako
àjọṣepọ̀	ijtimoiy	union
àkosílè	mavhumlik	written
àkosílè	tezis	written account
àkàrà	keklar	bean pudding
àká	javonlar	store
àkójopò	guruh	collection
àkókó	vaqt	previous
àlàkalè	maqsadlar	breakdown, explanation of actions
àlàyé	ma `lumot	explanation
àlàáfíà	tinchlik	peace
àlááfià	qiyoslash	wellbeing
àlè	ablah	mistress, concubine, (side booty)
àlèpò	yuqorida	joined together
àlébù	dog &#39;	ills
àmérìkà	g&#39;ayritabiiy	america
àmì	imzo	sign
àmúlò	amaliy	synonyms
àmúsorò	psixologiya	resources
ànfàní	imkoniyat	opportunity
àpapọ̀	bir butun sifatida	federal
àpeere	misol	example
àrígbámú	bezovta qiluvchi	assistant
àrùn	kasallik	disease
àrẹ	prezident	president
àse	ziyofat	authority
àsàjemátèe	tong	cunning
àsèyìn	oqibati	at the end
àsìkò	vaqt	time
àsótélè	kengaytma	prophecy
àsọdọ̀kan	birlik	unitary
àsekúdórógbó	po&#39;stloq	do or die
àsà	odat	habit, culture, norm
àtijo	eskirgan	olden days
àtìpó	musofir	sojourn
àtòrìnká	atrofida	urinating while walking
àtúnse	tahrirla	modification
àtúnse	tahrirla	renovate, fix
àtẹnudẹ́nu	og&#39;zaki	oral
àwon	nazariyalar	they
àwón	pul	the
àwón	pul	the
àwùjo	jamiyat	community
ààtò	marosim	suitability
ààyè	tirik	space
àárín	o&#39;rtasida	middle
àáyá	sperma	seconds
àìkó	etishmovchilik	unlearned
àìní	xohlamoq	lack
àìròtélè	kutilmagan	unthought of
àìsí	yo&#39;qligi	lack
án	t	it
áwon	zino	those
èbà	pashsha	cassava flour food
èbúté	port	shore
èdá	yaratish	creature
èdè	tili	language
èdè	tili	language
èfòn	tarang	efon
èhìn	keyingi	outskirt
èka	filiali	branch
èkejì	boshqa	second
èlò	idishlar	tool
ènìkan	nimadur	someone
èràn	kasallik	virus
èrò	fikrlar	thoughts
èsó	masjid	modesty
èsúrú	chumolilar	yam (indigenous to west africa)
ète	maqsadi	plan
èyì	qadr-qimmati	this
èka	ta&#39;siri	branch
èro	fikrlar	machine
èrí	dalil	witness
èsìn	din	religion
èwù	ko&#39;ylak	clothe
èpón	ko&#39;p	modifier
ìbarà	isitma	ibara (town)
ìbánisòrò	ulanish	dialogue
ìbáraeni	avtoulov	to themselves
ìbílè	tug&#39;ilish huquqi	local
ìbílè	tug&#39;ilish huquqi	local
ìdàgbà	balog&#39;at	grow
ìdàpapọ̀	mustahkamlash	union
ìdàrúdàpò	betartiblik	misunderstanding
ìdá	qochish	division
ìdìmú	bezovtalik	branch, part
ìdíisin	sabab	idi-isin
ìdíwòn	sizning sababingiz	criteria
ìdó	qoqish	ido (a person's name)
ìfara	qiynoq	self
ìfojúìtànìgbesiayé	hayot tarixi	biography
ìfáàrà	ruhoniy	introduction
ìgbonnìbí jé	bu falokat	igbonnibi
ìgbà	vaqt	when
ìgbàgbé	unutuvchan	forgetfulness
ìgbá	qanotlar	time
ìgbáraga	kuch	pride
ìgbéraga	mag&#39;rurlik	pride
ìgbésí	hayot	life
ìgbò	ram	igbo people
ìhun	temir	things
ìjo	raqsga tushish	church
ìjo	cherkov	church
ìjoba	hukumat	government
ìjora	nafrat	resemblance
ìjìnlè	sir	comprehensive
ìjìnlè	sir	mysterious
ìjò	rahbar	consent
ìjọba	hukumat	government
ìkejì	boshqa	second
ìkànna	xuddi shu	ikanna (town)
ìkèrèkú	tiqilib qolish	ikereku
ìkéde	deklaratsiya	advert
ìkìjà	qiyinchilik	ikija
ìkìlò	suiiste&#39;mol qilish	warning
ìkínin	oltinchi	greetings
ìkẹrin	to&#39;rtinchisi	fourth
ìkọpa	ishtirok etish	ikopa
ìlera	sog&#39;liq	health
ìlo	qo&#39;ng&#39;iroq	use
ìlà	rejasi	border
ìlànàn	xayol	procedure
ìlàorùn	ko&#39;karish	east
ìlàìnàró	zulm	vertical
ìlè	poraxo&#39;rlik	land
ìlé	uy	land
ìmò	ilon	knowledge
ìmò	chaqmoq	knowledge
ìmóbìdo	tug&#39;ilish huquqi	imobido
ìmú	burun	knowledge
ìmúnilérú	suiiste&#39;molliklar	slavery
ìmúsára	mustahkamlash	contagious
ìnagije	g&#39;alaba	alias
ìnáwó	xarajatlar	expenditure
ìpolongo	reklama	advertisement
ìpìlẹ̀núkléù	shifrlash	base
ìpìnlè	boshlanishi	foundation
ìpínrò	paragraflar	economize
ìrànlọ́wọ́	yordam	help
ìrànàna	yordam	path-clearing
ìràwọ̀	yulduzlar	s
ìrí	tajriba	sight
ìròkò	o&#39;yladi	iroko
ìròyìn	yangiliklar	news
ìròyìnwiki	yangiliklar	wikinews
ìròrùn	xayol	peaceful
ìró	ovoz	sound
ìrúbo	qulashi	sacrifice
ìsawo	folbinlik	divinity-practice
ìse	harakat	behaviour
ìsinsìnyí	hozir	modern
ìsirò	hisoblash	adding
ìsomó	qo&#39;shilmoq	attachment
ìsàlè	quyosh botishi	down town
ìsèlè	ishlab chiqarish	happening
ìsìn	din	worship
ìsòrò	meditatsiya	speech
ìsòrí	bo&#39;linma	chapter
ìsú	qalinligi	lump
ìsọ	do&#39;konlar	stall
ìse	harakat	work
ìsègbèfábo	mehnatsevarlik	female support
ìsèdá	yaratish	creation
ìsèjoba	hukumat	government
ìsílé	uy	house opening
ìsòro	qiyinchilik	problem
ìse	harakat	action
ìta	tashqarida	outside
ìtaeko	ustaxona	outskirts of eko
ìtan	tarixi	story
ìtokò	qozon	story
ìtàn	tarixi	history
ìtànkálé	toshqinlar	spread
ìtèsíwájú	taraqqiyot	progress
ìtójú	parvarish	treatment
ìtóju	tartibsizlik	treatment
ìtójú	yuz ifodalari	treatment
ìtóka	urish	dictionary
ìtúmò	tarjima	meaning
ìtúpalè	tarjima	exposition
ìwe	taqqoslash	book
ìwo	shoxlari	horn
ìwàásù	va&#39;z qilish	sermon
ìwéré	risola	iwere (town)
ìwò	umuman	set
ìwòran	ko&#39;rish	viewing
ìwúlò	foydali	usefulness
ìya	azob	mother
ìyapa	ajratish	divorce
ìyàwó	kelin	wife
ìyípadà	aylantirish	transformation
ìṣèlú	siyosat	politics
ìṣẹ́kù	qolgan qismi	broken
ìṣọ̣̀tẹ̣̀	zotiljam	rebellion
òde	tashqarida	society
òdeojú	yuzsiz	surface
òdo	yoshlar	zero
òdìkejì	boshqa	opposite
òféàrán	rasm	a town name
ògbójú	vakolatli	brave
ògiri	devor	wall
ògo	shon-sharaf	glory
ògun	dori	medicine
ògúndìpẹ̀	chang	ogundipe
òjo	o&#39;xshamoq	ojo
òjísé	shifokor	servant
òkèògbún	ming	oke-ogbun
òkòòkan	birma-bir	each
òkú	murdalar	corpse
òkúta	tosh	stone
òle	uy bekasi	lazy
òmiràn	sehrgar	other
òmùàrán	rasm	omu-aran (town)
òní	bugun	today
òotó	haqiqat	true
òpópóònà	yo&#39;l	highway
òranyàn	majburiy	a must
òrìsà	butlar	god
òrí	bob	top
òrò	miya	word
òsán	peshin	afternoon
òsèlú	siyosatchi	politics
òsèré	sportchi	player
òwù	mato	owu
òṣèlú	siyosat	politician
òjògbón	yomg&#39;irli ob-havo	learned person
òkan	bitta	heart
òkòòkan	birma-bir	each
òpòlopò	juda ko&#39;p	many
òré	o&#39;yin	friend
òfò	keyingi	sorrowful
òpòlopo	juda ko&#39;p	lot of
òré	o&#39;yin	friend
òrò	fikrlar	word
òsà	oltin baliq	lagoon
òwó	pul	hand
òrò	fikrlar	word
òròàjòmó	gripp	part of speech
ó	u	that
óníse	u dizayner	stricken
ósírísì	tupurik	diverse
ósékú	u o&#39;lgan	die suddenly
ó	ha	word
ôdún	yil	year
únṣẹlẹ̀	zilzila	formed
şe	qilmoq	do
ʔaːnaːtɕɑ̀k	.aːnaːtɕɑɕɑk	not yoruba
ˈøːstəˌʁaɪç	ˌʁstˌʁaɪç	austria
ˌkælɪˈfɔrnjə	ɪˈkælɪˈfɔrnjə	not yoruba
ˌæləˈbæmə	kasallik	not yoruba
κάππα	.aa	does not translate
σ	σ	does not translate
ṣiṣé	ochilishi	work
ṣàkóbá	zararli	incriminate
ẹdo	hazil	edo
ẹlẹ́bùn	sovg&#39;a	award winner
ẹlẹ́sìn	diniy	religionist
ẹnìkan	bitta odam	someone
ẹsẹ	oyoqlari	verse
ẹtì	jigar	friday
ẹ̀kaawon	taqdim	branch of
ẹ̀kabrítánì	tog&#39;a	part of britain
ẹ̀kajuly	may	chapter july
ẹ̀kaoṣù	tikanli	month
ẹ̀kasístẹ̀mù	subyektiv	sistemu=system
ẹ̀kẹ́ta	uchinchisi	third, the third
ẹ̀kọ́	ta&#39;lim	teachings
ẹ̀ni	jssv	person
ẹ̀rọ	mashinalar	machine
ẹ̀wẹ̀	boshqa tarafdan	leaf
ọbàkàn	yarim aka	step-sister
ọdún	yil	year
ọlọ́mọ	bolalar	members
ọlọ́run	xudo	god
ọmú	siz rasvosiz	breast
ọmọ	bola	c
ọn	u	him
ọpọ́lọpọ́	anjir	many
ọ̀dọ́	yoshlar	youth
ọ̀gbìn	o&#39;simlik	seedlings
ọ̀nà	yo&#39;l	ways
ọ̀pòlòpò	harakat	various
ọ̀rọ̀	gapirish	word
ọ̀sẹ	hafta	week
