aajo	ไร้สาระ	hospitality
aala	ชายแดน	border
aanu	ความเห็นอกเห็นใจ	compassion
aapon	aapon	bachelor or spinster (bachelorette)
aare	aare	president
aawe	อัมพาต	fasting
abala	ส่วนหนึ่ง	division
abeikojopo	ผู้รับพินัยกรรม	subset
abeorile	การกลับบ้าน	nation
abesahara	โรย	under the sahara
abidi	ตัวอักษร	abidi
abidjan	เคย	abidjan
abo	ของผู้หญิง	security
aburunmu	ความรู้สึกของเรา	reduced in value, diminished
abálájo	ที่มีประสบการณ์	that is why
abé	เข็ม	under
abínibí	สัญชาติ	inborn
abúléko	หมู่บ้าน	village
accra	อักกรา	accra
adaba	สะดวกสบาย	factor
adabaye	เอาล่ะ	previously-existing
adarihunrun	ทำความสะอาด	human
addis	addis	addis
adeda	ธรรมชาติ	creator
adiokan	โดดเดี่ยว	stubbornness
adágbà	ผู้สูงอายุ	adagba
adúgbò kútò	เพื่อนบ้านในถนน	kuto area
adúgbò mókóla	mucocula	mokola area
adúgbò quarry	เพื่อนบ้านเหมืองหิน	neighborhood
adúgbò ìdí	เหตุผลที่ใกล้เคียง	area
afida	ครอบครัว	element
afomo	ตัวอย่างเช่น	cleansing
afoyemo	สรุป	abstract
africa	แอฟริกา	africa
african	แอฟริกัน	ara afrika
africans	แอฟริกัน	africans
aféfé	สีลม	air
agba	สี	principal
agbado	ข้าวโพด	maize
agbara	อำนาจ	power
agbaye	โลก	world
agbeinadie	เกษตร	semi-conductor
agbà	ผู้ใหญ่	adult
agbàbò	ผู้คุ้มครอง	adopted child
agbára	อำนาจ	power
agbéiná	เจ้าหน้าที่ดับเพลิง	conductor
agio	ร้องไห้	agio
aintimulo	aintimulo	un-exploited
aisi	ไม่มี	lack
ajagun	สุนัข	ajagun
aje	เศรษฐกิจ	trade
ajemoroyin	คำถาม	reporting
ajibola	ระเบียบวาระการประชุม	ajibola
ajo	การท่องเที่ยว	firms
ajoro	การท่องเที่ยว	discussion
ajọra	แบบจำลอง	resemblance
akiidah	coridah	(non-standard yoruba, this maybe from benin)
akinpelu	ปืนใหญ่	akinpelu
akokolo	ระยะเวลา	period
akole	เราไม่สามารถ	title
akoni	เราไม่มี	teacher
akopa	ก่อนอื่น	participant
akopo	การรวบรวม	assembly
akátá	ลิ่วล้อ	african american
akíkanjú	กล้าหาญ	courageous
akíngbógun	กองพัน	akingbogun
akẹ́kọ̀ọ́	นักเรียน	students
ala	ลง	limit
alaabo	พิการ	protection
alaadanida	ที่ไม่พึงประสงค์	individual
alaafia	ความสงบ	peace
alaafin	นอกกฎหมาย	alaafin
aladaani	เอกชน	privately-owned
aladani	เอกชน	self-owned
aladanida	โดยพลการ	private
alaidogba	ไม่สมดุลย์	unequal
alaigbara	ต่อต้านไม่ได้	neutron
alaini	ยากจน	the poor
alakitiyan	กิจกรรม	activist
alakobere	สามเณร	primary
alalaye	เหมือนดิน	explanatory
alawose	ดวงชะตา	mentor
albany	อัลบานี	albany
albert	อัลเบิร์	albert
alexandra	อเล็กซาน	alexandra
alicia	อลิเซีย	alicia
allāh	อัล	allah
alominira	ความเป็นอิสระ	independent
alpha	แอลฟา	alpha
alubàbá	พ่อ	drummer
alukuraani	คัมภีร์โกหร่าน	quran
alumoni	แก้	minerals
alumíníọ̀mù	อลูมิเนียม	aluminium
alákọ̀bẹ̀rẹ̀	เจ้าตำรับ	primary education
alápapò	การแทนที่	general
alátise	ศิลปิน	alatise
aláyèwò	ผู้ตรวจการ	expert
aláísàn	ป่วย	the sick
alúwo	ความเจริญ	traditional cults
alọ́po	กระเป๋าสตางค์	tied
amazonas	amazonas	amazonas
americas	อเมริกา	americas
amerika	สหรัฐอเมริกา	america
amojeoyipada	แปลงสภาพ	reform
amosi	มัสยิด	amos
améríkà	อเมริกัน	america
améríkà	อเมริกัน	america
an		him
anabi	ผู้เผยพระวจนะ	prophet
anc	anc	anc
andaman	andman	andaman
angkor	อังกอร์	angkor
anita	แอนนิต้า	anita
anschluss	เวียนนา	anschluss
apagusu	ใต้	southern
apaguusuilaorun	ทิศตะวันตกเฉียงใต้	south-western
apaguusuiwoorun	ทิศตะวันตกเฉียงใต้	part of the south
apailaorun	พระอาทิตย์ขึ้น	east side
apaiwoorun	ตะวันตก	eastern side
aparapo	การรวมกัน	confederation
apeja	ชาวประมง	fisherman
apeere	ตัวอย่างเช่น	example
apis	apis	apis
apòmù	ผ้ากันเปื้อน	apomu
apẹ̀rè	ผ้ากันเปื้อน	example
arabu	อาหรับ	arab
aralíle	เขตร้อน	healthy body
arinkankan	อันนี้	nationalist
ariso	aris	oral tradition
ariwaarin	ตะวันออกกลาง	mid-north
ariwaguusu	ทางตะวันตกเฉียงใต้	north-south
arkansas	อาร์คันซอ	arkansas
aroko	พืชพันธุ์	composition
aruleyin	สวัสดี	carried on the back
arun	โรค	disease
aryan	อารยัน	aryan
aráa	พี่ชาย	people from
arábíà	เรียงตามตัวอักษร	arabia
aráròmí	สวัสดี	araromi
arópò	การกินสินบน	substitute
arúgbó	อายุเยอะ	elderly
arọ	กะพร่องกะแพร่ง	cripple
asagun	ชัยชนะ	intial, first (referring to the 13 colonies)
ascii	หา	ascii
aseeto	การตั้งถิ่นฐาน	unfair
aseyori	ความสำเร็จ	success
asipa	การเบี่ยงเบน	first to kill
assessment	การประเมินผล	ayewo
asìko	เรื่องไร้สาระ	time; ni asiko=when
asèdá	ธรรมชาติ	origination
atangbona	อะตอม	emission
atanna	อะตอม	emitter
atigba	อนุญาตได้	from time
atimo	วางแผน	inland
atinrin	ที่หัวเราะ	thin
atun	ม้วนกลับ	also
atunse	การแก้ไข	revision
australia	ออสเตรเลีย	australia
austriahumgary	austriahumgary	austria-hungary
austronesian	austronesian	austronesian
austríà	ออสเตรเลีย	austria
avar	วาร์	avar
awari	การค้นพบ	discovery
awo	จาน	of
awonara	อารมณ์	people of
awoòn	แบบ	people
awon	พวกเขา	they
awuruju	ขลัง	shady
awùjo	มารยาท	society
awújẹ	เรื่องอื้อฉาว	root
aya	กลอน	chest
ayeye	กัลป์	celebration
ayàfi	มันเป็นเรื่องปกติ	only if
ayò	ay	game
azikiwe	กึ๋น	azikwe
aṣòkan	รายบุคคล	united
baa	คือ	be with
babaláwo	diviner	herbalist
bahrain	บาห์เรน	bahrain
balẹ̀	ปล่อยให้เขาเป็น	settled
bang	ปัง	bang
banle	banle	banle
bara	ปีที่แล้ว	themselves
bauxitealumina	bauxitealumina	bauxite/aluminum
bayelsa	bayelsa	beyelsa
bayi	ตอนนี้	like this
bayìí	ตอนนี้	this
bce	ไป	bce
beauharnais	beauharnais	beauharnais
beijing	ปักกิ่ง	beijing
belarus	เบลารุส	belarus
belgium	เบลเยียม	belgium
bengal	เบงกอล	bengal
bengali	ประเทศบังคลาเทศ	bengal
benin	ม้านั่ง	benin
berber	เบอร์เบอร์	berber
berlin	กรุงเบอร์ลิน	berlin
bernstein	bernstein	bernstein
bharat	สาธารณรัฐอินเดีย	bharat
bharata	กลับมา	bharata
bibeli	คัมภีร์ไบเบิล	bible
biribiri	ถูกบด	intense
black	สีดำ	dudu
bodies	ร่างกาย	ara
bojú	ลองดูสิ	take care
bole	ลำต้น	ground
bolt	สายฟ้า	bolt
bolívar	bolívar	bolivar
brasil	brasil	brazil
brazzaville	บราซซาวิ	brazzaville
bridgeport	บริดจ์	bridgeport
britain	สหราชอาณาจักร	britain
brítánì	อังกฤษ	britain
bu	นั่นคือ	give
buenaventura	buenaventura	buenaventura
bujumbura	ขยาย	bujumbura
burúkú	ชั่วร้าย	bad
by	โดย	does not translate directly, does not exist
bàbá	พ่อ	father
bákannáà	เช่นกัน	likewise
bálè	บอลลูน	lying on the ground
bárakú	ติดยาเสพติด	habitual
báyìí	ตอนนี้	this
bèrẹ̀	เริ่มต้นกับ	started
béè	เป็นแบบนั้น	than
bòtswánà	รถบัส	botswana
búburú	ไม่ดี	bad
búrú	กล้าเข้าไว้	wicked
bẹ̀rẹ̀	ที่จะเริ่มต้น	started
bẹ́	ยากจน	also
bẹ́ljíọ̀m	แร่จำพวกหนึ่ง	belgium
bẹ́ẹ̀ni	ใช่	yes
bẹ́ẹ̀sìni	ใช่	that is it
cairo	ความโกรธ	cairo
calabar	เคี้ยวหมากฝรั่ง	calabar
canaria	คานาเรีย	canaria
cape	แหลม	cape
casablanca	คาซาบลังกา	casablanca
caslon	บ่อนคาสิโน	caslon
cathedral	โบสถ์ใหญ่	cathedral (katidral)
catherine	แคทเธอรี	catherine
cauchy	cauchy	cauchy
cbc	cbc	cbc
chamorro	chamorro	chamorro
charles	ชาร์ลส์	charles
chaskalson	chaskalson	chaskalson
chebbi	คิด	chebbi
cherished	หัวแก้วหัวแหวน	mu lokunkundun
china	ประเทศจีน	china
cipollone	cipollone	cipollone
clear	ชัดเจน	danmanran
code	รหัส	code
coetsee	coetsee	coetese
coloured	มีสี	alawo dudu
coming	มา	yo jade
compared	เมื่อเทียบกับ	does not directly translate
computers	คอมพิวเตอร์	komputa, ero ayarabiasa
csto	csto	csto
ct	กะรัต	ct
cunha	ลำคอ	cunha
da	และ	back; but in this form it is unnecessary
dagbasoke	โตขึ้น	developing
dandan	จำเป็น	a must
dani	โฮลดิ้ง	hand-held
darapo	ร่วม	joinedd
daru	ทำลาย	scattered
dates	วันที่	pada si
delhi	อย่า	delhi
denver	เดนเวอร์	denver
des	des	des
describes	อธิบาย	se apejuwe (apejuwe=description; se prefix makes it a verb)
desmond	เดสมอนด์	desmond
development	พัฒนาการ	idagbasoke
didagba	ความเท่าเทียมกัน	growing
didasile	สถานประกอบการ	established
different	ต่าง	iyato
din	ทอด	reduced
dinwoju	เงยหน้าขึ้นมอง	suitable
divoire	divoire	d'ivoire
doju	ประจันหน้า	face
dojú	ประจันหน้า	turn face (full phrase is doju ko, to face)
dominic	โดมินิก	dominic
doni	doni	this day
dote	หลงใหล	rebel
doublehelix	เกลียวคู่	hiliksi abara meji
doublestrand	doublestrand	double-strand
dover	โดเวอร์	dova
du	ดู่	hustle
due	เนื่องจาก	nitori
dun	รสอร่อย	sound
dàbíi	แบบนี้	like
dàpò	แทนที่พวกเขา	mix
dá	สร้าง	intervene
dágbó	อายุเยอะ	forest
dájó	ไม่เป็นไร	pass judgement
dálóríi	ขอบคุณ	about
dáradára	ดี	well
dásà	คาซ่า	peculiar way of saying
dáwó	บริจาค	undertake
dé	มาถึง	reach
délànà	ในหลักการ	delana
dépò	ในขอบเขต	to a position
dì	แผ่น	be
dìde	เกิดขึ้น	stand
dìró	ทางขวา	hang on
dìtẹ̀	วางแผน	rebel
díè	เครียด	few
dóko	ดี	upstanding
dólà	ดี	dollar
dún	เสียง	sound
dúró	ยืน	stand (been in existence)
dọ́gba	เท่ากัน	equal
ea	ใช่	ea
eba	eba	shore
ebi	ครอบครัว	family
ecomog	ecomog	ecomog
ede	ภาษา	language
efrem	effem	efrem
egba	อย่างแน่นอน	cane
egbe	ปืน	group
egberundun	หนึ่งพันปี	a thousand year
egbo	แผล	brother
egbé	ความฉิบหาย	party
egbò	แผล	chemicals
egbògi	ทางการแพทย์	don't know this
eighteen	สิบแปด	ejidinlogun
eka	ซับซ้อน	branch, department, part
ekeji	อื่น ๆ	second
eko	การศึกษา	lagos
elede	สุกร	speaker
eleyi	นี้	this
eleyii	แบบนี้	this
elláda	การสร้าง	ellada
eléde	บทคัดย่อ	pig
eléré	นักกีฬา	performer
elòmírà	สาหร่ายทะเล	freedom
elòmíràn	อื่น	another person
emerging	ฉุกเฉิน	ibere-pese
emmanuel	มานูเอล	emmanuel
enikéni	ทุกคน	whoever
enter	เข้าสู่	wole
enì	ช้าง	person
eníbá	ไข้	such person
epa	ถั่วลิสง	groundnut
ernst	เอิร์นส์	ernst
erofo	ตะกอน	swamp
erékùsù	เกาะ	island
eréonítàn	อักษรย่อ	written play
eseese	แผนภาพ	step by step
esia	กำลังมา	asia
esteri	esteri	ester
etisalat	etisalat	etisalat
etymologiae	etymologiae	etymologiae
etíòkun	ชายฝั่ง	beach
euro	ยูโร	euro
euroasia	euroasia	uro-esia
ewe	ใบไม้	ewe
ewé	ใบไม้	leaf
ewì	บทกวี	traditional poem
example	ตัวอย่าง	apere
eya	ประเภท	tribe
eyin	ไข่	previous
eyonomba	eyonomba	digit
eléja	ประมง	fisherman
elòmíràn	คนอื่น	another person
eka	ผล	branches
eléyàmèyà	เชื้อชาติ	tribalism
enu	ปาก	mouth
esin	ศาสนา	horse
esè	เงินที่ได้	leg
ewà	ของความประพฤติ	beauty
fagile	ยกเลิก	cancel
fail	ล้มเหลว	padanu
fan	แฟน	spread
faramó	เป็นไปตาม	accept
faranse	ฝรั่งเศส	french
farsi	arti	farsi
felifeli	กำมะหยี่	fuming
ferde	ferde	verde
fesèmúlè	แหล่งชั่วคราว	established
fe	ต้องการ	want
fi	บันทึก	by
fifihan	แสดง	revealed
fihan	ที่ระบุ	shows, to show
fimú	กำหนดไว้อย่างรวดเร็ว	captivate with
finiki	ฟิสิกส์	finiki
finlandi	ฟินแลนด์	finland
fitino	การทดลอง	judgement
five	ห้า	marun
fodio	fodio	fodio
fofinde	การห้าม	prohibited
fohùn	เสียงร้อง	consent
foniimu	ฟิล์ม	phoneme
force	บังคับ	agbara
foriko	ตัวอย่างเช่น	agreed
fourbase	fourbase	onidi-merin
fowobowe	การจอง	signed
fowó	เพื่อเงิน	sign
fracmv	fracmv	does not translate
francis	ฟรานซิส	francis
fransi	ฝรั่งเศส	france
freetown	ฟรีทาวน์	freetown
fuji	ลบ	fuji
fulani	ขี้ขลาด	fulani
fulbe	ful	fulbe
fun	สำหรับ	for
funra	ตัวเอง	suspect
further	ต่อไป	si
fé	ซานตาเฟ	like
fé	fé	want
fégbé	ลืมมันซะ	for peers
fífò	การบิน	jumping
fífún	ให้	giving
fòye	เข้าใจ	rationalise
fẹ́rẹ̀ẹ́	เกือบจะ	nearly
galatia	เวลานี้	galatia
gba	ตกลง	accept
gbajúgbujà	เป็นที่นิยมมาก	popular
gbale	ความนิยม	flourished
gbaná	ยิงออก	engulf in flame/rage
gbe	การพกพา	set up
gbera	ก้าวต่อไป	move
gberasoke	เร่งความเร็ว	rising
gbese	หนี้สิน	debt
gbigbamulo	การแสวงหาผลประโยชน์	adopted
gbigbewo	การจัดหาเงินทุน	examined
gbilè	แตกออก	gaining ground
gbin	ปลูก	farm
gbogbogbo	ทั่วไป	general
gbongbo	ราก	root
gbàgbọ́	เชื่อ	believe
gbàgùrà	ส่าย	gbagura
gbá	ชน	received
gbáradì	ตื่น	prepare
gbé	มีชีวิต	convey
gbédìí	สร้าง	respect
gbékalè	ช่างไม้	establish
gbéni	มีชีวิต	lift
gbéyèwò	ทบทวน	examine
gbésè	เสนอ	die
gbìnyànjú	ลอง	endeavour
gbìyànju	พยายามอย่างหนัก	try
gbódò	ต้อง	must
gbónmisi	กฎหมาย	strife
gbúnùn	ดมมัน	hostile
gbọ́dọ̀	ต้อง	must
geesi	อังกฤษ	english
geneva	เหล้ายิน	geneva
genevieve	เจเนเวีย	genevieve
georgia	จอร์เจีย	georgia
german	เยอรมัน	german
gfaj	gfaj	gfaj
ghana	กานา	ghana
gidigidi	มาก	significantly
gidí	บ้าน	real
goemai	goemai	goemai
gomina	ผู้ว่าราชการจังหวัด	governor
gorgina	นกอินทรี	gorgina
gquadruplex	gquadruplex	g-gigalonomerin
grammy	แกรมมี่	grammy
griiki	กรีก	greek
groove	ร่อง	iho
guanínì	guanni	guanine
guinea	ประเทศกินี	guinea
guineabissau	guineabissau	guinea bissau
guinébissau	guinébissau	guinea bissau
gun	ยาว	stretch
gunle	ปืน	arrive
guusu	ทางทิศใต้	south
gv	gv	gv
gèésì	กาว	english
gèésì	อัญมณี	english
gégé	จริงๆ	like
gírámà	gramps	grammar
gòkè	ขึ้น	climb
gún	เจาะ	properly
gúúsù	ทางทิศใต้	south
gẹ̀ẹ́sì	อังกฤษ	english
habsburg	เบิร์กส์	habsburg
haggai	คู่มือ	haggai
haiti	ไฮติ	haiti
halomonadaceae	halomonadaceae	halomonadaceae
hard	ยาก	lile
haughton	haughton	haughton
hausafulani	hausafulani	hausa fulani
hawaii	ฮาวาย	hawaii
heinrich	เฮ็น	heinrich
hendu	ลูกอม	hendu
henny	เฮนนี	henny
heraklion	heraklion	heraklion
hesse	ตกลง	hesse
him	เขา	un, this term is sexless
hindu	hindu	hindu
histoni	histoni	histones
hominidae	hominidae	hominidae
hosea	โฮเชยา	hosea
hp	แรงม้า	hp
hugh	ฮิวจ์	hugh
hun	ฮั่น	knit
hungari	ความอดอยาก	hungary
hv	hv	hv
ibalo	เรื่อง	relationship
ibarepo	สมาคม	friendship
ibeji	ฝาแฝด	twins
ibewo	ได้มา	visit
ibiamusin	สถานที่ศักดิ์สิทธิ์	colony
ibile	แบบดั้งเดิม	municipality
ibimo	กำเนิด	birth
ibise	ออกกำลังกาย	official
ibiti	สถานที่	where
ibn	อิบัน	ibn
ibojì	หลุมฝังศพ	burial ground
ibori	ผ้าคลุมหน้า	conquest
ibujoko	ม้านั่ง	place of abode
ibuseripadabosi	การชำระเงินคืน	eternity
ibuso	สู้	bus stop
ibùdó	ค่าย	settlement, seat of, area,
ibùjókòó	ที่นั่ง	settlement
iceland	ประเทศไอซ์แลนด์	iceland
idagbasoke	พัฒนาการ	development
idagbe	ละเลย	isolation
idaji	ครึ่ง	half
idajo	ความยุติธรรม	judgement
idamita	วาด	sector
idari	การควบคุม	control
ideraa	เขียน	comfort
idimule	จับกุม	establishment
idoma	การวาดภาพ	idoma
idupe	ขอบคุณ	thanksgiving
idánwò	การทดลอง	examination
ifija	ประมง	weapon
ifilole	เปิด	resolution
ifitonileti	ข้อมูล	reporting
ifobaje	คอรัปชั่น	coronating
ifofinde	รัฐสภา	prohibition
ifriqiya	การกระตุ้น	ifriqiya
igbeduro	การจัดเตรียม	institute
igbegun	ชัยชนะ	declaration of war
igberiko	ชานเมือง	region
igbesoke	อัพเกรด	upliftment
igbeyawo	งานแต่งงาน	marriage
igbowolori	เเพง	inflation
igbá	ไก่	shell
igbáẹ̀yìn	สุดท้าย	shell
igitòròmogbè	บรอดแบนด์	willow tree
ihan	ที่จะปรากฏ	ray
ihinrere	พระกิตติคุณ	gospel
ijagun	สู้	war
ijakadi	การต่อสู้	wrestling
ijaya	ตื่นตกใจ	fear
ije	การเคลื่อนไหว	eating
ijinnasi	ฟิสิกส์	the wind open
ijosin	นมัสการ	worship
ijó	การเต้นรำ	dance
ikan	หนึ่ง	one of
ikandinlogun	สิบแปด	nineteen
ikaowo	เคารพ	finger
ikejidinlogun	สิบแปด	eighteen
ikeko	การรวบรวม	education
ikerin	ที่สี่	fourth
iketa	เพื่อสืบทอด	third
ikoenu	เพื่อบันทึก	union
ikojopo	ขุม	collection
ikoreokere	การเก็บเกี่ยว	migration
iku	ความตาย	death
ikúgbaèyí	ตอนนี้	death-has-this
ikún	การกรอก	squirrel or wild rodent
ilagbolojo	การเผยแพร่	latitude
ilana	ขั้นตอน	procedure
ilanaoye	กลยุทธ์	knowledge procedure
ilaodo	ป้องกัน	cana
ilaorun	พระอาทิตย์ขึ้น	west
ileasofin	ฝ่ายนิติบัญญัติ	house of law,
ilegiga	บ้าน	higher ground or higher plain
ileife	ละเลย	ile-ife
ileigbimo	ความยินยอม	house of assembly/congress
ileobaluaye	โลก	high chief
ileru	เตาหลอมโลหะ	volcanic
ilopo	สอง	times
iluoba	พลเมือง	king's town
iluorilejoba	โลกาภิวัตน์	capital city
ilé	บ้าน	house
iléayé	บ้าน	earth
iléisé	บ้าน	workplace
ilélódò	บ้าน	ile-lodo
iléàtèéré	บ้าน	ile-ateere
iléńlá	ลาน	ile-nla (area)
ilẹ	พื้น	land
ilẹ̀ayé	โลก	the world
iminle	จับกุม	earthquake
imoero	การลดน้ำหนัก	engineering
imojuto	การดูแล	protection
imusin	วาด	colony
imú	จมูก	nose
imúnisìn	สุขภาพ	slavery
inagberingberi	เนยถั่ว	electromagnetic force
indeed	จริง	paapa julo
indus	สินธุ	indus
inkosi	เพื่อปรับ	inkosi
integration	บูรณาการ	ifowosowopo
inágbéringbérin	สิบเจ็ด	electromagnet
iní	มรดก	possession
inúnibíni	การประหัตประหาร	hatred
ioja	ปลา	fight
ioniani	ยากจน	ionian
iowa	บนโลก	iowa
ipare	เลือนหายไป	abolition
ipawo	การใช้งาน	income
ipele	ชั้น	stage
ipin	บท	share
ipinpa	การมีส่วนร่วม	arm of, branch of
ipinu	การตัดสิน	determination
ipo	ที่ตั้ง	position
ipá	บังคับ	effort
iraja	ที่ตกตะลึง	bargaining
iranlose	ความช่วยเหลือ	mission
ire	การขาย	you
irele	ความนอบน้อม	irele
iringa	สรุป	iringa
irisi	การปรากฏ	appearance
irorun	ง่ายมาก	convenient
irò	เล่าลือ	iro
irúnmọlẹ̀	ฟ้าแลบ	apparition
isa	พอ	jesus, isa or yisa is hausa language
isare	การเร่งความเร็ว	track race
isedaniloro	ตนเองสงสัย	terrorism
iseero	ดู	engineering
isejoba	การกำกับดูแล	governance
iseoba	สิบห้า	civil service
iseoroayeijoun	โบราณคดี	archaeology
iseowo	ธุรกิจ	business
isepinpin	การกระจาย	division
iso	ที่จะมา	unit
isoponomba	isoponomba	addition of numbers
isun	ไหล	spring
isesi	ยอมจำนน	conduct
isè	บริการ	occupation
itali	อิตาลี	italy
itanakole	เรื่องราว	ancient
itelentele	ชัดถ้อยชัดคำ	coming after
itiraka	การต่อสู้	effort
itobi	เพื่อคุยโว	size
itokowo	ธุรกิจ	economy
itorawo	ใจกว้าง	astrology
itu	ที่จะโยน	solution
itumo	ความหมาย	meaning
iwadi	วิจัย	research
iwasi	ประทับใจ	behaviour
iwifun	ข้อมูล	report
iwoile	บ้าน	entering
iwosan	การรักษา	healing
iwulo	มีประโยชน์	use
iwuwa	การปฏิบัติ	behaviour
iyan	ความอดอยาก	argument
iyato	ความแตกต่าง	difference
iyawo	เจ้าสาว	wife
iyen	นั่นคือ	that
iyán	ที่เป็นประกาย	pounded yam
iḷẹ̀	งาน	land
iṣẹ́ìwádìí	วิจัย	research
jabo	รายงาน	give account
jackson	แจ็คสัน	jackson
jadide	ยึดมั่นใน	emerge
jagbe	หลงทาง	shout
jalè	โจรกรรม	steal
jamaica	youtube	jamaica
jamo	ไปให้พ้น	link
jawaharlal	ชิงช้า	jawaharial
jeffrey	เจฟฟรีย์	jeffrey
jeometri	เรขาคณิต	geometry
jesu	พระเยซู	jesus
jfk	เจเอฟเค	jfk
jije	ความเป็นอยู่	existing as
jijinna	ห่างไกล	distance
jiròrò	เต็มไปด้วยหมอก	dialogue
jo	รั่ว	days
jogun	ได้รับการถ่ายทอด	inherit
johann	นรก	johann
johanu	ขอโทษ	john
jojo	cracked	great extent
jopò	เข้าร่วม	gathered
jo	จอห์น	resemble
juneau	จูโน	juneau
jàgídíjàgan	รุนแรง	violent
jáde	ออกมา	out
jé	มา	is
jéésù	พระเยซู	jesus
jìnnàa	ห่างไกล	further
jíje	ความเป็นอยู่	eating
jíjuwó	หาเงิน	waving hands
jíjéomoléyìnkírísítì	เป็นคนใจบุญสุนทาน	followers of christ
jùlo	มากกว่า	most
jùlo	โดยเฉพาะอย่างยิ่ง	most
jùló	ที่สุด	most
jẹ́mánì	เยอรมัน	germany
jọ́	กรุณา	together
kadara	สินทรัพย์	destiny
kagera	ชอบโอ้อวด	kagera
kakiri	ติดตาม	all over
kalinga	cinga	kalinga
kalẹ	พักไว้	established
kampala	เข็มกลัด	kampala
kan		one
kankan	ไม่มี	any
kanlè	kanal	established
karbonumarun	thecentricane	5 carbon
karl	คาร์ล	karl
karun	ที่ห้า	fifth
karùún	ที่ห้า	fifth
kebbi	ปรับ	kebbi
kekere	เล็ก	lower
keko	มีความรู้	learn
kept	เก็บไว้	fi pamo
khoisan	ด้อยกว่า	khoisan
ki	ทำเช่นนั้น	not
kiakiajulo	ที่เร็วที่สุด	rapidly
kiko	การนำ	gathering
kikojo	การรวบรวม	gathering
kikopomo	ความอบอุ่น	mixed
kikoso	รวดเร็ว	colonised
kiko	การเรียนรู้	making
kikuninu	จินตนาการ	size
kilhar	รักแร้	kilhar
kinkinni	สิ่งเล็กน้อย	small quantity
ko	หรือ	don't
kodò	ด้านล่าง	bow
koidu	koidu	koidu
kojá	ข้าม	pass
kolo	kolo	going
komputa	คอมพิวเตอร์	computer
kong	kong	kong
kongo	ถุงยาง	congo
kookan	นี้	one
koto	เหยื่อ	pit
koko	การเรียนรู้	make heap
ko	ko	learn
kori	ไม่อีกแล้ว	not found
krio	krio	krio
ku	คุณ	remain
kwara	จ่าหน้า	kwara
kàríbẹ́ánì	ในภูมิภาค	carribean
kàyéfì	น่าแปลกใจ	amazement
ká	ของ	we
kánfinkése	ความฉลาด	prolonged
kánádà	แน่นอน	canada
káyé	โลก	world
kéesì	ไร้สาระ	keesi
kékéèké	เล็ก	small
kétu	เตรียมตัว	ketu
kémíkà	ในทางตรงกันข้าม	chemical
kéyìn	ต่อมา	come after,
kìnní	เป็นครั้งแรก	first
kí	ทักทาย	not
kíko	การศึกษา	written
kíkọ́	เพื่อเรียนรู้	learning
kínu	จูบ	greet
kírísìtì	คริสต์มาส	christ
kòjòkú	ฝน	kojoku
kòkó	หนู	cocoa
kòmpútà	คอมพิวเตอร์	computer
kòtò	หลุม	pit
kòòsí	มันไม่ใช่	coaching
kòòkan	แต่ละอัน, แต่ละคน	each
kógo	ความรุ่งโรจน์	glorious
kóra	รวบรวม	participate
kùkú	หลังจากนั้น	eventually
kùrání	อัลกุรอาน	quran
kúkú	หลังจากนั้น	now
kúkúrú	โดยสังเขป	short
kúrò	ไป	away
kútò	ทุกอย่าง	kuto (place)
kúùkù	ในทางตรงกันข้าม	punches; expression meaning 'by force' (ti pa ti kuuku)
kẹrin	ที่สี่	4
kẹsàán	ทันที	ninth
kẹta	ที่สาม	third
kẹ́nyà	การแยก	kenya
kọjá	ผ่านไป	pass through
kọ̀mpútà	คอมพิวเตอร์	computer
kọ́kọ́	เป็นครั้งแรก	first
kọ́lọ́mú	คอลัมน์	breast owner
kọ́ni	ขาด	teach
laa	ไปให้พ้น	will
laada	เตะ	good fortune
laaka	ถอยหลัง	important
laarin	ภายใน	between
labalaba	ผีเสื้อ	butterfly
labee	ภายใต้	under
lade	รับภาระ	crowned
laid	วาง	tele
laifi	ความผิด	without
languages	ภาษา	ede
lanka	ลังกา	lanka
lasile	ปล่อย	laid out
latibe	จากที่นั่น	from there
latigbana	ตั้งแต่นั้นมา	from then on
latini	ละติน	latin
latvia	ลัตเวีย	latvia
lay	วาง	da
le	สามารถ	can
leboa	lebo	leboa
lekun	ทวีความรุนแรงมาก	open door
leo	สิงห์	leo
lese	เสา	firmly
less	น้อยกว่า	okeresi
lewaju	ต่อไปข้างหน้า	front
lewon	การจำคุก	imprisonment
leyi	นี่มันคือ	mispelled...should be 'leyin', after
leè	อาจ	can
lilelile	ไม่ยอมใครง่ายๆ	tightly
lilemo	กัญชา	sticky
lilongwe	ลิลองเว	lilongwe
lindi	น้ำด่าง	lindi
linear	เชิงเส้น	dogba
links	การเชื่อมโยง	eka; this is a new word and does not really exist in yoruba
lodo	แทนที่	from
lojowaju	ในอนาคต	the future
lojukokoro	โลภ	covetousness
lojúgun	เขาทำลาย	knee
lokunkun	กระปรี้กระเปร่า	in the dark
loloselu	ในทางการเมือง	in politics
lopolopo	มาก	so many
loruko	ชื่อ	name
louvre	บานเกล็ด่	louvre
lovers	คนรัก	awon olufe
low	ต่ำ	diye
lo	ต่อไป	than
luanda	ลูอันดา	luanda
luther	ลูเทอร์	luther
lynton	lynton	lynton
làgba	เท่ากัน	more important
lààmi	สัญญาณ	sign
lààmì	สัญญาณ	significant
lábé	น้ำหนัก	under
láfún	รับ	cassava food
láimo	ไม่มี	unknown
láké	ดัง	in ake
lámọ́di	โชคลาภ	lamodi
lápá	ส่วนหนึ่ง	from
lára	เจ็บ	part of
lárúbáwá	ธรรมชาติ	arabic
láì	ไม่มี	without
láíláí	ไม่เคย	old
lèe	สามารถ	can
lèyìn	ภายหลัง	after
lédè	ในภาษา	language
léebá	โดยบังเอิญ	catch up with it
lérìnín	หิมะ	erin=laughter; the prefix 'l' is possesive
lérò	เหตุผล	thought
léyin	ภายหลัง	after
léyìn	ต่อมา	after
lérú	ความเป็นทาส	enslave
lílo	การแสวงหาผลประโยชน์	using
lísa	การเร่งความเร็ว	a chieftaincy title
lítésò	ที่กัด	literature
lóde	ด้านนอก	modern
lópez	nipez	lopez
lópó	แม่หม้าย	widow
lórì	ท่าเรือ	on the head
lóríba	เกิน	subdue
lóti	จำนวนมาก	have
lóòótò	ใช่	truly
lóòótọ́	จริง	truly
ló	ló	to
lónà	ระหว่างทาง	in a way
lórò	วันพรุ่งนี้	become wealthy
lọndọnu	กรุงลอนดอน	london
lọ́dọọdún	เป็นประจำทุกปี	yearly
lọ́jà	ที่ตลาด	in the market
maapu	แผนที่	map
madeira	beira	madeira
mahatma	มหาตมะ	mahatma
makedonia	มาซิโดเนีย	macedonia
malabo	น้ำผึ้ง	malabo
malay	สันนิษฐาน	malay
malayopolynesian	malayopolynesian	malayo-polynesian
malaysia	ประเทศมาเลเซีย	malaysia
mali	วัน	mali
mango	มะม่วง	mango
manˈdeːla	mandelala	mandela
marcellus	มาร์เซลลั	marcellus
march	มีนาคม	march
marku	เวลานี้	mark
mars	ดาวอังคาร	mars
maryland	รัฐแมรี่แลนด์	maryland
maseru	ความหึงหวง	don't be slave
matheu	matheu	matthew
mathiew	mathiew	mathiew
mathimatiki	คณิตศาสตร์	mathematics
max	สูงสุด	max
maya	ไม่	maya
mbabane	เชิงลบ	mbabane
means	วิธี	ona (way)
mediteraneani	ทะเลเมดิเตอร์เรเนียน	mediterranean
mefeefa	ยกเครื่อง	all six
mejidinlogbon	ยี่สิบแปด	twenty eight
mejila	สิบสอง	twelve
meksiko	เม็กซิโก	mexico
melo	เท่าไหร่	some
member	สมาชิก	ara
mercosur	mercosur	mercosur
merin	สี่	four
methodologies	วิธีการ	anaoniruuru
metropoli	metropoli	metropolis
meucci	meucci	meucci
mewar	mewar	mewar
mexico	เม็กซิโก	mexico
michelle	michelle	michelle
micronesia	ไมโครนีเซีย	micronesia
miiràn	บรรเทา	another
mimoy	mimoy	mimoy
mimuwa	ยึดมั่น	import
minnesota	มินนิโซตา	minnesota
minority	ชนกลุ่มน้อย	awon ara kekere
mohandas	มหาตมะ	mohandas
mokaleladota	กะทัดรัด	51, (mokanleladota)
mokanlelogbon	สามสิบสอง	thirty-one
mombasa	มอมบาซา	mombasa
monrovia	มอนโรเวีย	monrovia
morgan	มอร์แกน	morgan
morogoro	ซึ่งใช้เครื่องยนต์	morogoro
mozambique	ประเทศโมซัมบิก	mozambique
mozilla	mozilla	mozilla
mtn	mtn	mtn
mtwara	เลือกอีกครั้ง	mtwara
mughal	ปริมาณ	mughal
mulẹ̀	สร้าง	establish
munispal	munispal	municipal
muungano	muungano	muungano
májèmú	ไม่เป็นไร	testament
mère	การวาดภาพ	significant
méjèèjì	ทั้งสอง	the two
mérindíláàdóta	ห้าสิบห้า	forty-six
méte	ห้า	lip
mérìndínlógún	สิบหก	sixteen
mérìnlélógójì	สี่สิบสี่	44
méta	สาม	three
métèètà	ช่างไม้	the three
méwàá	สิบ	ten
ménu	คุณคิดว่า	verbally contribute; complete phrase= me nu ba
mímọ́	ศักดิ์สิทธิ์	holy
míràn	อื่น	other
míìrán	อื่น	other
mííràn	อื่น	other
mò	ความรู้	know
mókólà	กาว	mokola
móra	รักษา	with themselves
mó	m	with
múlẹ̀	ยึดไว้อย่างรวดเร็ว	select land (farmland)
mẹ́fà	หก	6
mẹ́rkúríù	หนู	mercury
mẹ́ta	สาม	3
mẹ́talọ́kan	กลุ่มที่มี 3 คน	trinity
namibia	ที่จะมา	namibia
nathaniel	นาธาเนียล	nathaniel
nato	นาโต	nato
nawojulo	ทำให้งง	highest-spending
nawó	รับเงินของคุณ	point finger
ncnc	ncnc	ncnc
nebraska	เนบราสก้า	nebraska
nefimu	nephim	nefimu
neptune	เกตุ	neptune
nevis	เนวิส	nevis
ngbero	ที่วางแผนไว้	planning
ngubengcuka	นกูเบงคูกา	ngubengcuka
nibe	ที่นั่น	there
nibere	ตอนต้น	earlier
nigbakan	บางครั้ง	at one time
nigbà	แล้วก็	when
nijẹr	nike	niger
nilè	ที่นี่	remaining
nisinyi	ตอนนี้	at present
nitoriidieyi	ด้วยเหตุนี้	because of this
nitoripe	เพราะ	because
nitosi	ใกล้เคียง	nearby
niwaju	ล่วงหน้า	in front of
niyato	เห็นความแตกต่าง	unlike
niye	พอ	in number
niyi	นี่มันคือ	these
nkan	สิ่ง	things
nkàn	โรคมะเร็ง	something
nnaji	ลุง	nnaji
nobel	โนเบล	nobel
nombamewa	คูณ	decimal
nombáméjì	สองคนแรก	two-number
novo	โนโว	novo
nri	อาหาร	nri
nse	ออกแบบ	acting
nso	ใกล้	saying
nsolaboraro	ความปลอดภัย	nso laboraro
nsowikipedia	obowikipedia	saying
ntoka	จุด	indicates
nu	สะอาด	in
nukleotidi	เบื่อหน่าย	nucleotides
nukleotidipupo	เบื่อหน่าย	cell
numeri	ชา	numbers
nwa	ทารก	drill
nàìjíríà	ในไนจีเรีย	nigeria
náwo	ค่าใช้จ่าย	spend money
náà	เกินไป	that
nì	ภูเขา	is
nìnú	ขอโทษ	in
nìyí	นี่ไง	this is
ní	มี	on
níbè	ที่นั่น	there
níbè	ที่นั่น	there
nífẹ̀ẹ́	ที่จะรัก	love
nígbàtí	เมื่อไหร่	when
nílè	ด้านล่าง	on the ground
nílùú	ในเมือง	in the town
nílẹ̀	บนพื้น	in the land
nínlá	ยิ่งใหญ่	large
nínu	โอกาส	in
níní	เพื่อที่จะมี	having
nípà	อย่างน้อย	by
nítorípé	เพราะ	because
nítumò	ความหมาย	meaningful
nítòsí	ใกล้เคียง	nearby
nítòótó	อย่างแน่นอน	truly
nítòótọ́	จริง	in truth, truthfully
níwájú	ล่วงหน้า	in front
níyanjú	ในทางบวก	solved
nǹkan	สิ่ง	things
nso	เร็ว ๆ นี้	say
oba	โอบามา	king
obairanderan	ลูกพี่ลูกน้อง	hereditary
obere	เล็ก	started
obínibí	มารยาท	inborn
ododo	ความชอบธรรม	righteousness
ofin	กฏหมาย	law
ogbè	ภูมิภาค	a divinity
ogun	สงคราม	war
ogunlogo	ฝูงชน	hundreds
ojo	ดูเหมือน	day
ojojumo	ประจำวัน	daily
ojoru	ความอบอุ่น	wednesday
ojukokoro	ความโลภ	covetousness
ojuoorun	พระอาทิตย์ตกดิน	atmosphere
ojuse	ความรับผิดชอบ	responsibility
ojùkòsì	การเร่งรัด	ojukosi
ojùkòtúu	การเร่งรัด	ojukotuu
ojúlùmọ̀	คนรู้จัก	acquaintance
ojútáyé	ความเหนียว	public
ojúìwé	หน้า	page
okeere	ต่างประเทศ	distant
okhotsk	okhotsk	okhotsk
oko	สนาม	farm
okunkun	ความมืด	darkness
okunrin	ผู้ชาย	male person
olodiajodojuko	ซึ่งกันและกัน	facing wall
olohun	เจ้าของ	god
olojukanna	ทันที	same surface
olokunkun	หูฟัง	popular
ololugbe	คนขี้แพ้	occupants
olopon	หยิ่งผยอง	a local game
olora	อ้วน	fertile
oloselukan	สวัสดี	one political
oloye	อัจฉริยภาพ	chief
oluda	ผู้สร้าง	creator
oludase	ผู้ผลิต	separatist
olukoitan	อาจารย์ผู้สอน	the writer
olukowe	ผู้เขียน	writer
olumojuto	โลภ	overseer
oluparapo	การรวมกัน	joint
olusoju	ยาม	ambassador
oluwakiri	การสำรวจ	explorer
olympus	olympus	olympus
olódùmarè	ยิ่งใหญ่	almighty god
olóyè	ไม้บรรทัด	chief
olóṣèlú	นักการเมือง	politics
olùbátan	ผู้ติดต่อนี้	relative
olùdarí	ผู้นำ	director
olùkópa	ผู้สนับสนุน	participant
olùkó	อาจารย์ผู้สอน	teacher
olùkọ́	ครู	teacher
omi	น้ำ	water
omiadalu	น้ำท่วม	mixture
onialjebra	onialjebra	of algebra
onibugbe	ผู้เช่า	population
onigbeja	สร้างสรรค์	allied
onigbowo	สปอนเซอร์	sponsor
onigunfenfe	อยู่เฉยๆ	large angle
onilanaibagbepo	ถุงยาง	constitutional
onilile	เจ้าของบ้าน	solid
oninawo	ผู้ยืม	financial
onipin	มีเหตุผล	even
onisayensi	ช่าง	scientific
onisowo	ผู้ประกอบการค้า	trader
oniyewumeji	ไบนารี่	two-chamber
oniyijulo	น่ากลัว	highest honour
onje	อาหาร	food
onka	เครื่องคิดเลข	counter
onígbàgbó	ชายชรา	believer
oníkólóbó	ปากหมา	onikolobo (place)
onílẹ̀	ลง	land owners; citizens (omo onile)
oníná	ไฟ	electronic
onítumò	นักแปล	meaning
onítèbọmi	บัพติศมา	baptist
onítòhùn	นักบัญชี	that person
oníwòsàn	หมอ	doctor
oníyanjù	ภาพเคลื่อนไหว	persevere
ooni	จระเข้	ooni (king)
ootọ́	จริง	truth
opec	โอเปก	opec
opposite	ตรงข้าม	odi
ori	ศีรษะ	top
oriire	ขอแสดงความยินดี	success
oriki	ชาวตะวันออก	name of endearment
orileede	ประเทศชาติ	country
orileedeajoba	จักรวรรดินิยม	monarchic country
orilejoba	รัฐบาล	seat of government, kingdom
orileominira	ความอบอุ่น	republic
orinìyìn	เพลง	songs of praise
orisirisi	ความหลากหลาย	various
orisun	แหล่ง	source
orisa	ต้นกำเนิด	god
oritameta	ระหว่างกลาง	crossway
orudnun	ประจำปี	mispelled...should orundun, century
oruko	คำนาม	name
oríilè	แห่งชาติ	land
oríilẹ̀	บทความ	land
oríkì	บทกวี	family name
orílèèdè	ประเทศชาติ	country
orílẹ̀	ประเทศชาติ	continent
orílẹ́	ตอนเย็น	nation
orísiirísi	ต่างๆ	various
orísìí	ความหลากหลาย	type
orísìírísi	ประเภทที่แตกต่างกัน	various
orúko	สนาม	name
oscar	ออสการ์	oscar
oseluarailu	พลเรือน	political unit
otherwise	มิฉะนั้น	ibaje
otutu	จำนวนมาก	coldness
oun	เขา	it
owojagidijagan	ผู้ก่อการร้าย	upheaval
oúnjẹ	อาหาร	food
odún	ปี	year
ojó	ฝนตก	day
okùnrín	เสียงหัวเราะ	man
olórun	พระเจ้า	god
olósìn	เคร่งศาสนา	rearing
odun	รายปี	year
olorun	พระเจ้า	god
omonìyàn	มนุษย์	human beings
opolo	จำนวนมาก	brain
ose	ose	week
oyé	โลก	harmattan
ofò	สวัสดีตอนเช้าค่ะ	nothingness
opolo	จำนวนมาก	brain
paa	ปิด	back
paapaa	โดยเฉพาะอย่างยิ่ง	especially
padá	รุน	go back
palauan	palauan	palauan
panaˈma	ปานามา	panama
panyanan	พื้นที่	spanish
papa	พ่อ	specifically
parapọ̀	การผสมผสาน	join
paripari	ตอนจบ	finally
pele	สวยงาม	hello
penh	พนมเปญ	penh
penisula	penisula	peninsula
periferi	periferi	periphery
petu	petu	resolve
pelu	ไข่มุก	with
phillipines	ฟิลิปปินส์	phillipines
pinsi	การลดลงของ	divided
pinsoto	pinoto	separated
pinu	มุ่งมั่น	decide
pipo	มาก	plenty
pipolongo	การโฆษณา	publicise
piposi	มาก	multiplication
platos	platos	plato's
plánẹ́tì	ประปา	planet
po	po	share
pojulo	สูงที่สุด	larger
polandi	ขัด	poland
polaroid	กล้องถ่ายรูปยี่ห้อโพเลอะรอยด	polaroid
population	ประชากร	ero
portonovo	portonovo	porto novo
portuguese	โปรตุเกส	portuguese
press	กด	press
produced	ผลิต	yo
protokolu	protocolu	protocol
proton	โปรตอน	kemika alaropo
providence	ความรอบคอบ	providence
príncipe	ปรินซิปี	principe
pupa	สีแดง	red
px|kùránì	px | เคอร์เนล	koran or quran; the px  does not belong
pàmò	เฉพาะ	pamo (town)
pàràkòyí	ทันที	parakoyi
pààlà	ขอบเขต	signalised
pàápàá	โดยเฉพาะอย่างยิ่ง	especially
pásíà	ชั้นใต้ดิน	persia
pátáporongodo	อย่างแน่นอน	entire
pè	เรียกว่า	that
pèhìndà	น้ำอสุจิ	turned back
pèlu	พร้อมด้วย	with
pèlúpèlú	เช่นกัน	in addition
pèsè	ให้	provide
pé	ที่	that
péré	เท่านั้น	only
péé	ที่	that
pípa	ฆ่า	order
pípèsè	บทบัญญัติ	providing
pípẹ́	ยาว	long
pòwe	สุภาษิต	to say a proverb or wise saying
pò	พับ	join
púpo	มากเกินไป	much
púpò	ค่อนข้าง	a lot
quran	คัมภีร์กุรอาน	quran
ra	ซื้อ	self
race	แข่ง	ere
rajya	ความหวัง	rajya
ramadan	เดือนรอมฎอน	ramadan
rank	ยศ	ipo
reggae	เร้กเก้	reggae
repeats	ซ้ำ	tunso
repetejulo	ที่สำคัญที่สุด	most of all
rere	ดี	success
research	วิจัย	agbeyewo
richard	ริชาร์ด	richard
right|thumb|px|aworan	ขวา | thumb | px | รูปภาพ	picture
rinle	ใหม่	emphasise
riresile	เครื่องบันทึก	humbled, lowered
riro	จินตนาการ	thought as
rn	rn	rn
rna	อาร์เอ็นเอ	rna
rnarna	rnarna	rna-rna
rnas	rnas	rnas
ro	คิด	thought
robinson	โรบินสัน	robinson
roboto	พื้นผิว	round
rogbodiyan	จลาจล	riot
rokirika	เรียกดู	publicise
roko	ฝูงชน	farm work
roma	โรม่า	roma
rome	โครเมียม	rome
ronald	โรนัลด์	ronald
rorùn	ง่าย	easy
rossii	rossii	rossii
rural	ชนบท	igberiko
ryan	ryan	ryan
ráhàn	ปรากฏ	complain
ránmú	กังวล	grumble
république	république	republic
ré	ค	his/her
rìn	ที่จะเดิน	should be orin, song or music
ròyìn	รายงาน	give account
rẹ	เธอ	it
saarc	ลบ	saarc
saaree	เหนือกว่า	after death
saarland	บนพื้น	saarland
safari	การแข่งรถวิบาก	safari
saffana	ไพลิน	savannah
safiwe	การเปรียบเทียบ	describe
safta	เข้าแถว	safta
saheli	ความสะดวกสบาย	sahel
sakyamuni	ต่อไป	sakyamuni
sakyas	sakyas	sakyas
salem	ซาเลม	salem
salàyé	ชีวิต	explained
sambia	หนุ่ม	zambia
samioro	ใช้ได้	signal
santa	ซานตา	santa
say	พูด	so
sb	sb	sb
schwarz	schwarz	schwarz
sea	ทะเล	odo
seat	ที่นั่ง	itedo
segbese	อาจ	take steps
seidamo	ชัดเจน	identify
semolara	โรคหอบหืด	accustom
semudaju	แน่นอน	assure
senegal	ประเทศเซเนกัล	senegal
sense	ความรู้สึก	sensi
seville	เซวิลล์	seville
sewadi	ค้นหา	investigate
sharon	ชารอน	sharon
sibesibe	ยัง	further more
sihamoni	โครงสร้าง	sihamoni
sile	หลัง	previously
silè	ยาหยอด	on the ground
sinai	บาป	sinai
sinsin	ศาสนา	unshakably
sioux	ซู	sioux
sise	การปรุงอาหาร	works
sisodagba	โตขึ้น	came of age
sisopo	การเชื่อมโยง	joined
sisupapoerekusu	การคาย	neighbouring islands
sisupo	คูณ	concentrated
slovo	slovo	slovo
so	รัก	turned
sohun	ใช่	something
solomon	ซาโลมอน	solomon
soon	ในไม่ช้า	lai'pe
sopin	ปลาย	ended
so	ดังนั้น	tells
spectacular	น่าตื่นเต้น	damanran
stella	สเตลล่า	stella
structures	โครงสร้าง	igbekale
suez	คลองสุเอซ	suez
sugbo	แต่ไม่	but
sugbọ́n	มีเหตุผล	but, however
sun	ดวงอาทิตย์	sleep
suny	suny	suny
swahili	ภาษาสวาฮิลี	swahili
symmetry	สมมาตร	ogbooga
sàbúrí	เหนือสิ่งอื่นใด	saburi
sàmì	สัญญาณ	signalize
sàn	ดีกว่า	flow
sàngó	แก๊ง	sango (god of thunder)
sàì	ดี	un
sápadè	วันนี้	run to
sáàpàdé	การประกัน	saapade
sáààrin	ในระหว่าง	between
são	อันใหม่	sao
sèle	การขโมย	down
ségun	ร้องไห้	conquered
sénégal	น้ำอสุจิ	senegal
séyìn	กลับ	back
séyìn	กลับ	at the back of
sìbẹ̀	ยัง	there
sìni	กุ้ง	likewise
síbèsíbè	แต่ถึงอย่างไร	further more
síbú	กับพื้นดิน	ocean
sílẹ̀	ปล่อยให้ลง	drop
síse	งาน	doing
síso	ยังคง	spoken
síso	ยังคง	saying
síta	ด้านนอก	outing
síwon	พวกเขา	to them
síwájú	ต่อไปข้างหน้า	comes before
síí	ที่นี่	on it
sòrò	ล้างสมอง	talk
sójà	ทหาร	soldier
sóko	ปลูก	to the farm
sùgbón	ในทางตรงกันข้าม	but
sọ	พูด	lose
si	อย่างแน่นอน	to
síse	โครงสร้าง	performing
sùgbón	ในทางตรงกันข้าม	but
se	พวกเขาทำ	do
sepò	ในที่สุด	cooperation
sisé	ออกกำลังกาย	work
sááju	ใช้เวลาสักครู่	before
sísa	s. 	to be
sísè	การแปล	step
tabi	หรือ	or
tabili	ตาราง	table
tabora	การหลีกเลี่ยง	tabora
taino	dino	taino
tainos	tainos	tainos
takuntakun	ข้อ จำกัด	valiant
talaka	น่าสงสาร	poor
talika	ความยากจน	the poor
tara	เก้า	wholly
tata	กรอง	wildly
taínos	tainos	tainos
technology	เทคโนโลยี	tekinoloji
tedo	การนัดหมาย	stay
teksas	เท็กซัส	texas
tele	ติดตาม	before
temptation	แสวงหา	idanwo
terutomo	terutomo	everybody
tfrac	tfrac	tfrac
the		does no directly translate
they	พวกเขา	won
those	เหล่านั้น	awon
thumb|left|upright|nelson	นิ้วหัวแม่มือ | ซ้าย | ตั้งตรง | เนลสัน	apa osi naro
tira	เครียด	quranic verse
tirana	ติรานา	tirana
tirè	ของเขา	own
titu	ยิง	cold (if it's a person's name, it is tutu)
tiwọn	ของพวกเขา	theirs
to	ถึง	it
toje	หายาก	that is
tokasi	ชี้ให้เห็น	pointing to
tokyo	โตเกียว	tokyo
tolerejulo	ทน	most profitable
tolórítelémù	ความหายนะ	all manners of people
tomé	มะเขือเทศ	tome
tooto	จริงๆ	true
tori	tori	because
torun	สีน้ำตาล	heavenly
toseluaralu	ในทางการเมือง	political
tounsejanu	อนาถ	control
traduite	traduite	traduite
translated	แปล	tunmo
tumosi	วิธี	means
tuntun	ใหม่	new
tàsí	ไม่มี	or
tàwon	พวกเขา	theirs
táawà	ก้มตัวลง	we
tèlé	ติดตาม	before
tètè	อย่างรวดเร็ว	quickly
tèlé	ทันที	follow
tèsíwájú	เพื่อความก้าวหน้า	progress
té	เสื้อ	follow
télè	โดย	before
té	t	shamed
títi	ปิด	till
títèlé	ติดตาม	following
títío	จนกระทั่ง	until
tíátà	ตั๋ว	theater
tíórì	ยาง	that is seen
tò	ชุด	enough
tóbi	ใหญ่	big
tódárajùlọ	ที่สุด	most beautiful
tókù	ส่วนที่เหลือ	others
tówùú	จำนวนเท่าใดก็ได้	whatever
tó	tó	taught
tóka	อ้างถึง	pointed
tú	หลั่งออกมา	untie
túmò	พลัม	means
túnse	จัดเรียง	restructured
tẹ̀ǹbẹ̀	แล้วก็	rivalry
tẹ̀ǹbẹ̀lẹ̀kun	วางแผน	bitterness
ucb	เลือดจากสายสะดือ	ucb
umueri	เด็ก ๆ	umueri
unifasiti	มหาวิทยาลัย	university
unla	ใช่	great
urasílì	uracil	uracil
uribe	ออร่า	uribe
usps	usps	usps
utah	รัฐยุทา	utah
utc	utc	utc
uzbek	ทาง	uzbek
venezuela	เวเนซุเอลา	venezuela
vermont	เวอร์มอนต์	vermont
victor	ผู้มีชัย	victor
videos	วิดีโอ	fidio
vihara	วิหาร	vihara
villa	วิลล่า	villa
viruses	ไวรัส	awon eran
visit	เยือน	ibewo
vz	vz	vz
waa	มันคือ	ours
waju	ใบหน้า	future
wari	กลิ่น	once existing
westminster	westminster	westminster
wisconsin	วิสคอนซิน	wisconsin
witkin	witkin	witkin
wiwari	การค้นพบ	discovered
województwo	ความบ้า	wojewodztwo
wole	เข้าสู่ระบบ	into
woo	แอ่ว	look
wo	ที่นี่	enter
wo	ที่นี่	look
won	พวกเขา	they
wura	ทอง	gold
wyoming	ไวโอมิง	wyoming
wàásù	สั่งสอน	preach
wì	ล้างออก	that
wípè	ความชัดเจน	that
wòfún	ชำเลือง	convenient
wònyí	เหล่านี้คือ	these
wón	พวกเขา	they
wúnrèn	ออกกำลังกาย	small amount
wọn	พวกเขา	they
wọ̀nyí	เหล่านี้	these
xd	xd	xd
xiv	xiv	xiv
yafran	ตัวอักษร	yafran
yakubu	yakub	yakubu
yan	เลือก	choose
yanjú	แก้ไข	solve
yanturu	ความอุดมสมบูรณ์	abundant
yaoundé	ยาอุนเด	yaounde
yewo	การปรับปรุง	examine
ye	ใช่	suitable
ye	ใช่	should
yindinyindin	ไม่เคยหยุด	brightly
yio	จะต้อง	will
yiowu	มันจะ	any
yipada	หันหลังกลับ	change
yiyafunnilo	การกัดกร่อน	borrow
yoo	จะ	will
yori	นำ	result
york	york	york
yorúbà	โยเกิร์ต	yoruba
yo	yo	remove
yànan	ความประหลาดใจ	scattered
yàtò	ติดตั้ง	other than
yára	เร็วเข้า	quickly
yèwò	ดู	examine
yée	ปล่อยให้พวกเขา	eplained to
yì	ไป	this
yìí	นี้	this
yí	หันหลังกลับ	this
yíyípadà	เปลี่ยนแปลง	changed
yíì	คุณจะ	this
yíò	มันจะ	it will
yẹ̀ẹ́	นะ	check
yọ	ลบ	bring out
zanzibar centralsouth	zanzibar centralsouth	zanzibar centralsouth
zdna	zdna	z-dna
zou	zou	zou
zscores	zscores	z-scores
zy	zy	zy
 bce	ไป	bce
àbe	ลิงทโมน	under
àbámẹ́ta	วันพฤหัสบดี	saturday
àbáyo	ข้อเสนอแนะ	breakthrough
àbìkú	ความอมตะ	'born to die' child
àbọ̀	ครึ่ง	result
àdámò	ความเป็นส่วนตัว	earmark
àdátá	ตรงข้าม	adata
àdáátán	พิเศษ	adaatan
àdóolóró	น้ำมัน	bomb
àgbàjọ	ชายชรา	assembly
àgbàrá	น้ำท่วม	power
àgbáríjọ	องค์กร	combination
àgbékà	บทคัดย่อ	suitable
àgbéyèwò	ทบทวน	examination
àgbìgbò	ย่าน	a type of bird
àgbùdo	ลาน	corn
àgọ́	เต็นท์	ago
àifète	วัตถุประสงค์	unable to keep quiet
àjo	การท่องเที่ยว	board
àjákọ	ต่างหาก	ajako
àjọṣepọ̀	สังคม	union
àkosílè	สิ่งที่เป็นนามธรรม	written
àkosílè	วิทยานิพนธ์	written account
àkàrà	เค้ก	bean pudding
àká	ชั้นวาง	store
àkójopò	กลุ่ม	collection
àkókó	เวลา	previous
àlàkalè	เป้าหมาย	breakdown, explanation of actions
àlàyé	ข้อมูล	explanation
àlàáfíà	ความสงบ	peace
àlááfià	การเปรียบเทียบ	wellbeing
àlè	ลูกครึ่ง	mistress, concubine, (side booty)
àlèpò	ข้างบน	joined together
àlébù	ด่างพร้อย	ills
àmérìkà	เหนือธรรมชาติ	america
àmì	สัญญาณ	sign
àmúlò	ประยุกต์	synonyms
àmúsorò	จิตวิทยา	resources
ànfàní	โอกาส	opportunity
àpapọ̀	โดยรวม	federal
àpeere	ตัวอย่าง	example
àrígbámú	รบกวน	assistant
àrùn	โรค	disease
àrẹ	ประธาน	president
àse	งานฉลอง	authority
àsàjemátèe	รุ่งอรุณ	cunning
àsèyìn	ควันหลง	at the end
àsìkò	เวลา	time
àsótélè	ส่วนขยาย	prophecy
àsọdọ̀kan	เอกภาพ	unitary
àsekúdórógbó	เห่า	do or die
àsà	กำหนดเอง	habit, culture, norm
àtijo	ล้าสมัย	olden days
àtìpó	เอเลี่ยน	sojourn
àtòrìnká	รอบเกี่ยวกับ	urinating while walking
àtúnse	แก้ไข	modification
àtúnse	แก้ไข	renovate, fix
àtẹnudẹ́nu	ทางปาก	oral
àwon	ทฤษฎี	they
àwón	เงิน	the
àwón	เงิน	the
àwùjo	สังคม	community
ààtò	พิธีทางศาสนา	suitability
ààyè	มีชีวิตอยู่	space
àárín	ระหว่างกลาง	middle
àáyá	น้ำอสุจิ	seconds
àìkó	ข้อบกพร่อง	unlearned
àìní	ต้องการ	lack
àìròtélè	ไม่คาดฝัน	unthought of
àìsí	ขาด	lack
án	เสื้อ	it
áwon	การผิดประเวณี	those
èbà	ยุง	cassava flour food
èbúté	ท่าเรือ	shore
èdá	การสร้าง	creature
èdè	ภาษา	language
èdè	ภาษา	language
èfòn	เครียด	efon
èhìn	ต่อไป	outskirt
èka	สาขา	branch
èkejì	อื่น ๆ	second
èlò	เครื่องใช้ในครัว	tool
ènìkan	บางสิ่งบางอย่าง	someone
èràn	โรค	virus
èrò	ความคิด	thoughts
èsó	มัสยิด	modesty
èsúrú	มด	yam (indigenous to west africa)
ète	วัตถุประสงค์	plan
èyì	เกียรติ	this
èka	ผล	branch
èro	ความคิด	machine
èrí	หลักฐาน	witness
èsìn	ศาสนา	religion
èwù	เสื้อเชิ้ต	clothe
èpón	มาก	modifier
ìbarà	ไข้	ibara (town)
ìbánisòrò	การเชื่อมต่อ	dialogue
ìbáraeni	การขนส่ง	to themselves
ìbílè	สิทธิซึ่งทุกคนต้องมี	local
ìbílè	สิทธิซึ่งทุกคนต้องมี	local
ìdàgbà	วุฒิ	grow
ìdàpapọ̀	การรวบรวม	union
ìdàrúdàpò	ความสับสนวุ่นวาย	misunderstanding
ìdá	การละทิ้ง	division
ìdìmú	การรบกวน	branch, part
ìdíisin	สาเหตุ	idi-isin
ìdíwòn	เหตุผลของคุณ	criteria
ìdó	ต่อย	ido (a person's name)
ìfara	การทรมาน	self
ìfojúìtànìgbesiayé	ประวัติชีวิต	biography
ìfáàrà	นักบวช	introduction
ìgbonnìbí jé	มันเป็นหายนะ	igbonnibi
ìgbà	เวลา	when
ìgbàgbé	ขี้ลืม	forgetfulness
ìgbá	ปีก	time
ìgbáraga	ความแข็งแรง	pride
ìgbéraga	ความภาคภูมิใจ	pride
ìgbésí	ชีวิต	life
ìgbò	แกะ	igbo people
ìhun	เหล็ก	things
ìjo	เต้นรำ	church
ìjo	คริสตจักร	church
ìjoba	รัฐบาล	government
ìjora	เกลียด	resemblance
ìjìnlè	ความลึกลับ	comprehensive
ìjìnlè	ความลึกลับ	mysterious
ìjò	หัวหน้า	consent
ìjọba	รัฐบาล	government
ìkejì	อื่น ๆ	second
ìkànna	เหมือน	ikanna (town)
ìkèrèkú	ความแออัด	ikereku
ìkéde	การประกาศ	advert
ìkìjà	ความท้าทาย	ikija
ìkìlò	การละเมิด	warning
ìkínin	ที่หก	greetings
ìkẹrin	ที่สี่	fourth
ìkọpa	การมีส่วนร่วม	ikopa
ìlera	สุขภาพ	health
ìlo	โทร	use
ìlà	เค้าโครง	border
ìlànàn	ภาพมายา	procedure
ìlàorùn	ช้ำ	east
ìlàìnàró	การกดขี่	vertical
ìlè	การกินสินบน	land
ìlé	บ้าน	land
ìmò	งู	knowledge
ìmò	ฟ้าแลบ	knowledge
ìmóbìdo	สิทธิบุตรหัวปี	imobido
ìmú	จมูก	knowledge
ìmúnilérú	ละเมิดสิทธิมนุษยชน	slavery
ìmúsára	เพื่อเสริมสร้าง	contagious
ìnagije	ชัยชนะ	alias
ìnáwó	รายจ่าย	expenditure
ìpolongo	การโฆษณา	advertisement
ìpìlẹ̀núkléù	การเข้ารหัส	base
ìpìnlè	การเริ่มต้น	foundation
ìpínrò	ย่อหน้า	economize
ìrànlọ́wọ́	ช่วยด้วย	help
ìrànàna	ช่วยด้วย	path-clearing
ìràwọ̀	ดาว	s
ìrí	ประสบการณ์	sight
ìròkò	ความคิด	iroko
ìròyìn	ข่าว	news
ìròyìnwiki	ข่าว	wikinews
ìròrùn	ภาพมายา	peaceful
ìró	เสียง	sound
ìrúbo	ล่มสลาย	sacrifice
ìsawo	ดวงชะตา	divinity-practice
ìse	หนังบู๊	behaviour
ìsinsìnyí	ตอนนี้	modern
ìsirò	การคำนวณ	adding
ìsomó	ที่จะเข้าร่วม	attachment
ìsàlè	พระอาทิตย์ตกดิน	down town
ìsèlè	การผลิต	happening
ìsìn	ศาสนา	worship
ìsòrò	การทำสมาธิ	speech
ìsòrí	แผนก	chapter
ìsú	ความหนา	lump
ìsọ	ร้านค้า	stall
ìse	หนังบู๊	work
ìsègbèfábo	ความขยัน	female support
ìsèdá	การสร้าง	creation
ìsèjoba	รัฐบาล	government
ìsílé	บ้าน	house opening
ìsòro	ความยาก	problem
ìse	หนังบู๊	action
ìta	ด้านนอก	outside
ìtaeko	โรงงาน	outskirts of eko
ìtan	ประวัติศาสตร์	story
ìtokò	หม้อ	story
ìtàn	ประวัติศาสตร์	history
ìtànkálé	น้ำท่วม	spread
ìtèsíwájú	ความคืบหน้า	progress
ìtójú	การดูแล	treatment
ìtóju	ความสับสน	treatment
ìtójú	การแสดงออกทางสีหน้า	treatment
ìtóka	ที่จะถูกตี	dictionary
ìtúmò	การแปล	meaning
ìtúpalè	การแปล	exposition
ìwe	การเปรียบเทียบ	book
ìwo	แตร	horn
ìwàásù	พระธรรมเทศนา	sermon
ìwéré	หนังสือเล่มเล็ก ๆ	iwere (town)
ìwò	ทั้งหมด	set
ìwòran	วิสัยทัศน์	viewing
ìwúlò	มีประโยชน์	usefulness
ìya	ความทุกข์ทรมาน	mother
ìyapa	การแยก	divorce
ìyàwó	เจ้าสาว	wife
ìyípadà	การแปลง	transformation
ìṣèlú	การเมือง	politics
ìṣẹ́kù	ส่วนที่เหลือ	broken
ìṣọ̣̀tẹ̣̀	โรคปอดอักเสบ	rebellion
òde	ด้านนอก	society
òdeojú	faceless	surface
òdo	หนุ่ม	zero
òdìkejì	อื่น ๆ	opposite
òféàrán	รูปภาพ	a town name
ògbójú	สามารถ	brave
ògiri	ผนัง	wall
ògo	ความรุ่งโรจน์	glory
ògun	ยา	medicine
ògúndìpẹ̀	เป็นผง	ogundipe
òjo	ดูเหมือน	ojo
òjísé	แพทย์	servant
òkèògbún	พัน	oke-ogbun
òkòòkan	ทีละคน	each
òkú	ศพ	corpse
òkúta	หิน	stone
òle	แม่บ้าน	lazy
òmiràn	หมอผี	other
òmùàrán	รูปภาพ	omu-aran (town)
òní	ในวันนี้	today
òotó	ความจริง	true
òpópóònà	ถนน	highway
òranyàn	ภาคบังคับ	a must
òrìsà	ไอดอล	god
òrí	บท	top
òrò	สมอง	word
òsán	เที่ยง	afternoon
òsèlú	นักการเมือง	politics
òsèré	นักกีฬา	player
òwù	ผ้า	owu
òṣèlú	การเมือง	politician
òjògbón	สภาพอากาศที่ฝนตก	learned person
òkan	หนึ่ง	heart
òkòòkan	ทีละคน	each
òpòlopò	จำนวนมาก	many
òré	เกม	friend
òfò	ต่อไป	sorrowful
òpòlopo	จำนวนมาก	lot of
òré	เกม	friend
òrò	ความคิด	word
òsà	ปลาทอง	lagoon
òwó	เงิน	hand
òrò	ความคิด	word
òròàjòmó	ตอนเช้า	part of speech
ó	มัน	that
óníse	เขาเป็นนักออกแบบ	stricken
ósírísì	น้ำลาย	diverse
ósékú	เขาตายไปแล้ว	die suddenly
ó	ใช่	word
ôdún	ปี	year
únṣẹlẹ̀	แผ่นดินไหว	formed
şe	ทำ	do
ʔaːnaːtɕɑ̀k	ค้นหา	not yoruba
ˈøːstəˌʁaɪç	øːstəˌʁaɪç	austria
ˌkælɪˈfɔrnjə	ɪkælɪfɔrnjə	not yoruba
ˌæləˈbæmə	การเจ็บป่วย	not yoruba
κάππα	.α	does not translate
σ	σ	does not translate
ṣiṣé	การเปิด	work
ṣàkóbá	เป็นอันตราย	incriminate
ẹdo	เรื่องตลก	edo
ẹlẹ́bùn	ของที่ระลึก	award winner
ẹlẹ́sìn	เคร่งศาสนา	religionist
ẹnìkan	คนคนหนึ่ง	someone
ẹsẹ	ฟุต	verse
ẹtì	ตับ	friday
ẹ̀kaawon	ส่ง	branch of
ẹ̀kabrítánì	ลุง	part of britain
ẹ̀kajuly	อาจ	chapter july
ẹ̀kaoṣù	มีหนาม	month
ẹ̀kasístẹ̀mù	อัตนัย	sistemu=system
ẹ̀kẹ́ta	ที่สาม	third, the third
ẹ̀kọ́	การศึกษา	teachings
ẹ̀ni	who	person
ẹ̀rọ	เครื่องจักรกล	machine
ẹ̀wẹ̀	ในทางกลับกัน	leaf
ọbàkàn	พี่ชายครึ่งหนึ่ง	step-sister
ọdún	ปี	year
ọlọ́mọ	เด็ก ๆ	members
ọlọ́run	พระเจ้า	god
ọmú	คุณดูด	breast
ọmọ	เด็ก	c
ọn	มัน	him
ọpọ́lọpọ́	มะเดื่อ	many
ọ̀dọ́	หนุ่ม	youth
ọ̀gbìn	ปลูก	seedlings
ọ̀nà	ทาง	ways
ọ̀pòlòpò	หนังบู๊	various
ọ̀rọ̀	การพูดคุย	word
ọ̀sẹ	สัปดาห์	week
