aajo	ridicolo	hospitality
aala	confine	border
aanu	compassione	compassion
aapon	aapon	bachelor or spinster (bachelorette)
aare	aare	president
aawe	paralisi	fasting
abala	la parte	division
abeikojopo	ecosistema	subset
abeorile	ritorno a casa	nation
abesahara	spruzzatina	under the sahara
abidi	alfabeto	abidi
abidjan	mai	abidjan
abo	femminile	security
aburunmu	il nostro abominio	reduced in value, diminished
abálájo	esperto	that is why
abé	ago	under
abínibí	nazionalità	inborn
abúléko	villaggio	village
accra	accra	accra
adaba	conveniente	factor
adabaye	tutto ok	previously-existing
adarihunrun	addetto alle pulizie	human
addis	addis	addis
adeda	natura	creator
adiokan	solitario	stubbornness
adágbà	sambuco	adagba
adúgbò kútò	vicini di casa	kuto area
adúgbò mókóla	mucocula	mokola area
adúgbò quarry	vicini di cava	neighborhood
adúgbò ìdí	ragioni di vicinato	area
afida	la famiglia	element
afomo	per esempio	cleansing
afoyemo	sinossi	abstract
africa	africa	africa
african	africano	ara afrika
africans	africani	africans
aféfé	mulino a vento	air
agba	dipingere	principal
agbado	mais	maize
agbara	energia	power
agbaye	il mondo	world
agbeinadie	terreni agricoli	semi-conductor
agbà	un adulto	adult
agbàbò	protettore	adopted child
agbára	energia	power
agbéiná	vigile del fuoco	conductor
agio	piangere	agio
aintimulo	aintimulo	un-exploited
aisi	mancanza	lack
ajagun	un cane	ajagun
aje	economia	trade
ajemoroyin	interrogatorio	reporting
ajibola	ordine del giorno	ajibola
ajo	viaggio	firms
ajoro	viaggio	discussion
ajọra	replica	resemblance
akiidah	coridah	(non-standard yoruba, this maybe from benin)
akinpelu	artiglieria	akinpelu
akokolo	periodo	period
akole	non possiamo	title
akoni	non abbiamo	teacher
akopa	innanzitutto	participant
akopo	compilazione	assembly
akátá	sciacallo	african american
akíkanjú	valoroso	courageous
akíngbógun	battaglione	akingbogun
akẹ́kọ̀ọ́	alunno	students
ala	giù	limit
alaabo	disabilitato	protection
alaadanida	non desiderato	individual
alaafia	pace	peace
alaafin	illegittimo	alaafin
aladaani	privato	privately-owned
aladani	privato	self-owned
aladanida	arbitrario	private
alaidogba	squilibrato	unequal
alaigbara	irresistibile	neutron
alaini	bisognoso	the poor
alakitiyan	attivista	activist
alakobere	novizio	primary
alalaye	terroso	explanatory
alawose	divinazione	mentor
albany	albany	albany
albert	albert	albert
alexandra	alexandra	alexandra
alicia	alicia	alicia
allāh	allah	allah
alominira	indipendenza	independent
alpha	alfa	alpha
alubàbá	padre	drummer
alukuraani	corano	quran
alumoni	curativo	minerals
alumíníọ̀mù	alluminio	aluminium
alákọ̀bẹ̀rẹ̀	iniziatore	primary education
alápapò	sostituzione	general
alátise	artista	alatise
aláyèwò	ispettore	expert
aláísàn	malato	the sick
alúwo	boom	traditional cults
alọ́po	portafoglio	tied
amazonas	amazonas	amazonas
americas	americhe	americas
amerika	america	america
amojeoyipada	convertibile	reform
amosi	moschea	amos
améríkà	americano	america
améríkà	americano	america
an	un	him
anabi	il profeta	prophet
anc	anc	anc
andaman	andman	andaman
angkor	angkor	angkor
anita	anita	anita
anschluss	anschluss	anschluss
apagusu	il sud	southern
apaguusuilaorun	sud-ovest	south-western
apaguusuiwoorun	sud-ovest	part of the south
apailaorun	alba	east side
apaiwoorun	occidentale	eastern side
aparapo	combinazione	confederation
apeja	pescatore	fisherman
apeere	per esempio	example
apis	apis	apis
apòmù	grembiule	apomu
apẹ̀rè	grembiule	example
arabu	arabo	arab
aralíle	tropicale	healthy body
arinkankan	questo	nationalist
ariso	aris	oral tradition
ariwaarin	medio oriente	mid-north
ariwaguusu	sud-occidentale	north-south
arkansas	arkansas	arkansas
aroko	vegetazione	composition
aruleyin	ciao	carried on the back
arun	patologia	disease
aryan	l&#39;ariano	aryan
aráa	fratello	people from
arábíà	alfabetico	arabia
aráròmí	ciao	araromi
arópò	corruzione	substitute
arúgbó	vecchiaia	elderly
arọ	noioso	cripple
asagun	vittoria	intial, first (referring to the 13 colonies)
ascii	scoprire	ascii
aseeto	insediamento	unfair
aseyori	successo	success
asipa	deviazione	first to kill
assessment	valutazione	ayewo
asìko	senza senso	time; ni asiko=when
asèdá	il naturale	origination
atangbona	atomo	emission
atanna	atomo	emitter
atigba	ammissibile	from time
atimo	piano	inland
atinrin	ridendo	thin
atun	riavvolgere	also
atunse	correzione	revision
australia	australia	australia
austriahumgary	austriahumgary	austria-hungary
austronesian	austronesiana	austronesian
austríà	australia	austria
avar	avar	avar
awari	scoperta	discovery
awo	piatto	of
awonara	emozione	people of
awoòn	modello	people
awon	loro	they
awuruju	magico	shady
awùjo	cortesia	society
awújẹ	scandalo	root
aya	versetto	chest
ayeye	eternità	celebration
ayàfi	va bene	only if
ayò	ay	game
azikiwe	buon senso	azikwe
aṣòkan	individuale	united
baa	è	be with
babaláwo	il divinatore	herbalist
bahrain	bahrain	bahrain
balẹ̀	lascialo essere	settled
bang	scoppio	bang
banle	banle	banle
bara	l&#39;anno scorso	themselves
bauxitealumina	bauxitealumina	bauxite/aluminum
bayelsa	bayelsa	beyelsa
bayi	adesso	like this
bayìí	adesso	this
bce	lontano	bce
beauharnais	beauharnais	beauharnais
beijing	pechino	beijing
belarus	bielorussia	belarus
belgium	belgio	belgium
bengal	bengala	bengal
bengali	bengalese	bengal
benin	panchina	benin
berber	berbero	berber
berlin	berlino	berlin
bernstein	bernstein	bernstein
bharat	bharat	bharat
bharata	ritorno	bharata
bibeli	bibbia	bible
biribiri	è stato schiacciato	intense
black	nero	dudu
bodies	corpi	ara
bojú	guarda	take care
bole	tronco	ground
bolt	bullone	bolt
bolívar	bolívar	bolivar
brasil	brasil	brazil
brazzaville	brazzaville	brazzaville
bridgeport	bridgeport	bridgeport
britain	gran bretagna	britain
brítánì	britannico	britain
bu	questo è	give
buenaventura	buenaventura	buenaventura
bujumbura	allargato	bujumbura
burúkú	il male	bad
by	di	does not translate directly, does not exist
bàbá	il padre	father
bákannáà	anche	likewise
bálè	palloncino	lying on the ground
bárakú	dipendenza	habitual
báyìí	adesso	this
bèrẹ̀	iniziare con	started
béè	proprio così	than
bòtswánà	il bus	botswana
búburú	male	bad
búrú	sii coraggioso	wicked
bẹ̀rẹ̀	per iniziare	started
bẹ́	rotto	also
bẹ́ljíọ̀m	berillo	belgium
bẹ́ẹ̀ni	sì	yes
bẹ́ẹ̀sìni	sì	that is it
cairo	rabbia	cairo
calabar	gomma da masticare	calabar
canaria	canaria	canaria
cape	mantellina	cape
casablanca	casablanca	casablanca
caslon	casinò	caslon
cathedral	cattedrale	cathedral (katidral)
catherine	catherine	catherine
cauchy	cauchy	cauchy
cbc	cbc	cbc
chamorro	chamorro	chamorro
charles	charles	charles
chaskalson	chaskalson	chaskalson
chebbi	pensare	chebbi
cherished	caro	mu lokunkundun
china	cina	china
cipollone	cipollone	cipollone
clear	chiaro	danmanran
code	codice	code
coetsee	coetsee	coetese
coloured	colorato	alawo dudu
coming	in arrivo	yo jade
compared	rispetto	does not directly translate
computers	computer	komputa, ero ayarabiasa
csto	csto	csto
ct	ct	ct
cunha	gola	cunha
da	e	back; but in this form it is unnecessary
dagbasoke	cresci	developing
dandan	obbligatorio	a must
dani	tenere	hand-held
darapo	aderire	joinedd
daru	distruggere	scattered
dates	date	pada si
delhi	non	delhi
denver	denver	denver
des	des	des
describes	descrive	se apejuwe (apejuwe=description; se prefix makes it a verb)
desmond	desmond	desmond
development	sviluppo	idagbasoke
didagba	uguaglianza	growing
didasile	istituzione	established
different	diverso	iyato
din	friggere	reduced
dinwoju	consultare	suitable
divoire	divoire	d'ivoire
doju	faccia a faccia	face
dojú	faccia a faccia	turn face (full phrase is doju ko, to face)
dominic	dominic	dominic
doni	doni	this day
dote	essere rimbambito	rebel
doublehelix	doppia elica	hiliksi abara meji
doublestrand	doublestrand	double-strand
dover	dover	dova
du	du	hustle
due	a causa di	nitori
dun	gustoso	sound
dàbíi	come questo	like
dàpò	sostituirli	mix
dá	creato	intervene
dágbó	vecchiaia	forest
dájó	tutto a posto	pass judgement
dálóríi	grazie	about
dáradára	bene	well
dásà	a casa	peculiar way of saying
dáwó	donare	undertake
dé	arrivato	reach
délànà	in linea di principio	delana
dépò	nella misura	to a position
dì	foglio	be
dìde	sorgere	stand
dìró	sulla destra	hang on
dìtẹ̀	cospirare	rebel
díè	teso	few
dóko	bene	upstanding
dólà	bene	dollar
dún	suono	sound
dúró	stare in piedi	stand (been in existence)
dọ́gba	pari	equal
ea	sì	ea
eba	eba	shore
ebi	famiglia	family
ecomog	ecomog	ecomog
ede	linguaggio	language
efrem	effem	efrem
egba	assolutamente	cane
egbe	pistola	group
egberundun	millennio	a thousand year
egbo	una ferita	brother
egbé	dolore	party
egbò	una ferita	chemicals
egbògi	medico	don't know this
eighteen	diciotto	ejidinlogun
eka	complesso	branch, department, part
ekeji	l&#39;altro	second
eko	formazione scolastica	lagos
elede	maiali	speaker
eleyi	questo	this
eleyii	come questo	this
elláda	creazione	ellada
eléde	astratto	pig
eléré	atleta	performer
elòmírà	l&#39;alga	freedom
elòmíràn	un altro	another person
emerging	emergente	ibere-pese
emmanuel	emmanuel	emmanuel
enikéni	tutti	whoever
enter	accedere	wole
enì	elefante	person
eníbá	febbre	such person
epa	arachide	groundnut
ernst	ernst	ernst
erofo	sedimento	swamp
erékùsù	isola	island
eréonítàn	acronimo	written play
eseese	diagramma	step by step
esia	sta arrivando	asia
esteri	esteri	ester
etisalat	etisalat	etisalat
etymologiae	etymologiae	etymologiae
etíòkun	la costa	beach
euro	euro	euro
euroasia	euroasia	uro-esia
ewe	foglia	ewe
ewé	foglia	leaf
ewì	poesia	traditional poem
example	esempio	apere
eya	categoria	tribe
eyin	uova	previous
eyonomba	eyonomba	digit
eléja	pesca	fisherman
elòmíràn	qualcun altro	another person
eka	effetto	branches
eléyàmèyà	etnia	tribalism
enu	bocca	mouth
esin	religione	horse
esè	ricavo	leg
ewà	di condotta	beauty
fagile	annullato	cancel
fail	fallire	padanu
fan	fan	spread
faramó	aderire a	accept
faranse	francese	french
farsi	arti	farsi
felifeli	velluto	fuming
ferde	ferde	verde
fesèmúlè	fonte provvisoria	established
fe	ricercato	want
fi	salva	by
fifihan	mostrando	revealed
fihan	indicato	shows, to show
fimú	nettamente definito	captivate with
finiki	fisica	finiki
finlandi	finlandia	finland
fitino	prova	judgement
five	cinque	marun
fodio	fodio	fodio
fofinde	divieto	prohibited
fohùn	grido	consent
foniimu	film	phoneme
force	vigore	agbara
foriko	per esempio	agreed
fourbase	fourbase	onidi-merin
fowobowe	prenotazione	signed
fowó	per soldi	sign
fracmv	fracmv	does not translate
francis	francesco	francis
fransi	francese	france
freetown	freetown	freetown
fuji	rimuovere	fuji
fulani	vigliaccamente	fulani
fulbe	ful	fulbe
fun	per	for
funra	si	suspect
further	ulteriore	si
fé	fé	like
fé	fé	want
fégbé	dimenticalo	for peers
fífò	volante	jumping
fífún	dando	giving
fòye	capire	rationalise
fẹ́rẹ̀ẹ́	quasi	nearly
galatia	questa volta	galatia
gba	essere d&#39;accordo	accept
gbajúgbujà	è molto popolare	popular
gbale	popolarità	flourished
gbaná	sparare	engulf in flame/rage
gbe	trasportare	set up
gbera	vai avanti	move
gberasoke	accelerare	rising
gbese	debito	debt
gbigbamulo	sfruttamento	adopted
gbigbewo	finanziamento	examined
gbilè	scoppiare	gaining ground
gbin	piantato	farm
gbogbogbo	generale	general
gbongbo	radice	root
gbàgbọ́	credere	believe
gbàgùrà	scuotere	gbagura
gbá	distruggere	received
gbáradì	alzarsi	prepare
gbé	vivere	convey
gbédìí	stabilire	respect
gbékalè	falegname	establish
gbéni	vivere	lift
gbéyèwò	revisione	examine
gbésè	offrire	die
gbìnyànjú	provare	endeavour
gbìyànju	sforzati	try
gbódò	dovere	must
gbónmisi	legge	strife
gbúnùn	annusalo	hostile
gbọ́dọ̀	dovere	must
geesi	inglese	english
geneva	ginevra	geneva
genevieve	genevieve	genevieve
georgia	georgia	georgia
german	tedesco	german
gfaj	gfaj	gfaj
ghana	ghana	ghana
gidigidi	molto	significantly
gidí	casa	real
goemai	goemai	goemai
gomina	governatore	governor
gorgina	l&#39;aquila	gorgina
gquadruplex	g-quadruplex	g-gigalonomerin
grammy	grammy	grammy
griiki	greco	greek
groove	scanalatura	iho
guanínì	guanni	guanine
guinea	guinea	guinea
guineabissau	guinea-bissau	guinea bissau
guinébissau	guinébissau	guinea bissau
gun	lungo	stretch
gunle	pistola	arrive
guusu	sud	south
gv	gv	gv
gèésì	colla	english
gèésì	gemma	english
gégé	veramente	like
gírámà	gramps	grammar
gòkè	vai su	climb
gún	forato	properly
gúúsù	sud	south
gẹ̀ẹ́sì	inglese	english
habsburg	habsburg	habsburg
haggai	guida	haggai
haiti	haiti	haiti
halomonadaceae	halomonadaceae	halomonadaceae
hard	difficile	lile
haughton	haughton	haughton
hausafulani	hausafulani	hausa fulani
hawaii	hawaii	hawaii
heinrich	heinrich	heinrich
hendu	caramella	hendu
henny	henny	henny
heraklion	heraklion	heraklion
hesse	concordato	hesse
him	lui	un, this term is sexless
hindu	hindu	hindu
histoni	histoni	histones
hominidae	hominidae	hominidae
hosea	osea	hosea
hp	cv	hp
hugh	hugh	hugh
hun	unno	knit
hungari	fame	hungary
hv	hv	hv
ibalo	affare	relationship
ibarepo	associazione	friendship
ibeji	gemelli	twins
ibewo	è arrivato	visit
ibiamusin	santuario	colony
ibile	tradizionale	municipality
ibimo	nascita	birth
ibise	allenarsi	official
ibiti	posti	where
ibn	ibn	ibn
ibojì	tomba	burial ground
ibori	velo	conquest
ibujoko	panchina	place of abode
ibuseripadabosi	delocalizzazione	eternity
ibuso	combattere	bus stop
ibùdó	campo	settlement, seat of, area,
ibùjókòó	posti a sedere	settlement
iceland	islanda	iceland
idagbasoke	sviluppo	development
idagbe	trascurare	isolation
idaji	metà	half
idajo	giustizia	judgement
idamita	disegnare	sector
idari	controlli	control
ideraa	scrivere	comfort
idimule	arresto	establishment
idoma	disegno	idoma
idupe	grazie	thanksgiving
idánwò	prova	examination
ifija	pesca	weapon
ifilole	lanciare	resolution
ifitonileti	informazione	reporting
ifobaje	corruzione	coronating
ifofinde	congresso	prohibition
ifriqiya	stimolazione	ifriqiya
igbeduro	preparazione	institute
igbegun	vittoria	declaration of war
igberiko	suburbano	region
igbesoke	aggiornare	upliftment
igbeyawo	nozze	marriage
igbowolori	costoso	inflation
igbá	pollo	shell
igbáẹ̀yìn	l&#39;ultimo	shell
igitòròmogbè	banda larga	willow tree
ihan	apparire	ray
ihinrere	vangelo	gospel
ijagun	combattimento	war
ijakadi	lotta	wrestling
ijaya	panico	fear
ije	movimento	eating
ijinnasi	fisica	the wind open
ijosin	culto	worship
ijó	danza	dance
ikan	uno	one of
ikandinlogun	diciotto	nineteen
ikaowo	rispetto	finger
ikejidinlogun	diciotto	eighteen
ikeko	compilazione	education
ikerin	la quarta	fourth
iketa	ereditare	third
ikoenu	salvare	union
ikojopo	accumulazione	collection
ikoreokere	raccolta	migration
iku	morte	death
ikúgbaèyí	adesso	death-has-this
ikún	riempimento	squirrel or wild rodent
ilagbolojo	pubblicità	latitude
ilana	procedura	procedure
ilanaoye	strategie	knowledge procedure
ilaodo	proteggere	cana
ilaorun	alba	west
ileasofin	legislativo	house of law,
ilegiga	casa	higher ground or higher plain
ileife	trascurare	ile-ife
ileigbimo	consenso	house of assembly/congress
ileobaluaye	il mondo	high chief
ileru	forno	volcanic
ilopo	doppio	times
iluoba	cittadinanza	king's town
iluorilejoba	globalizzazione	capital city
ilé	casa	house
iléayé	casa	earth
iléisé	casa	workplace
ilélódò	la casa	ile-lodo
iléàtèéré	casa	ile-ateere
iléńlá	cortile	ile-nla (area)
ilẹ	terra	land
ilẹ̀ayé	la terra	the world
iminle	arrestare	earthquake
imoero	alleggerimento	engineering
imojuto	cura	protection
imusin	disegnare	colony
imú	naso	nose
imúnisìn	igiene	slavery
inagberingberi	burro di arachidi	electromagnetic force
indeed	infatti	paapa julo
indus	indus	indus
inkosi	giustificare	inkosi
integration	integrazione	ifowosowopo
inágbéringbérin	diciassette	electromagnet
iní	eredità	possession
inúnibíni	persecuzione	hatred
ioja	pesce	fight
ioniani	bisognoso	ionian
iowa	sulla terra	iowa
ipare	dissolvenza	abolition
ipawo	usi	income
ipele	livello	stage
ipin	capitolo	share
ipinpa	partecipazione	arm of, branch of
ipinu	decisione	determination
ipo	posizione	position
ipá	vigore	effort
iraja	scioccante	bargaining
iranlose	assistenza	mission
ire	vendita	you
irele	umiltà	irele
iringa	incartare	iringa
irisi	aspetto	appearance
irorun	molto semplice	convenient
irò	pettegolezzo	iro
irúnmọlẹ̀	fulmine	apparition
isa	abbastanza	jesus, isa or yisa is hausa language
isare	accelerazione	track race
isedaniloro	insicurezza	terrorism
iseero	orologio	engineering
isejoba	governo	governance
iseoba	quindici	civil service
iseoroayeijoun	archeologia	archaeology
iseowo	attività commerciale	business
isepinpin	distribuzione	division
iso	venire	unit
isoponomba	isoponomba	addition of numbers
isun	flusso	spring
isesi	resa	conduct
isè	servizio	occupation
itali	italiano	italy
itanakole	storia	ancient
itelentele	chiaramente	coming after
itiraka	lotta	effort
itobi	vantarsi	size
itokowo	attività commerciale	economy
itorawo	liberale	astrology
itu	gettare	solution
itumo	senso	meaning
iwadi	ricerca	research
iwasi	impressionare	behaviour
iwifun	informazione	report
iwoile	casa	entering
iwosan	guarigione	healing
iwulo	utile	use
iwuwa	pratica	behaviour
iyan	carestia	argument
iyato	la differenza	difference
iyawo	sposa	wife
iyen	questo è	that
iyán	scintillante	pounded yam
iḷẹ̀	lavoro	land
iṣẹ́ìwádìí	ricerca	research
jabo	rapporto	give account
jackson	jackson	jackson
jadide	resisti	emerge
jagbe	va al diavolo	shout
jalè	furto	steal
jamaica	youtube	jamaica
jamo	va via	link
jawaharlal	altalene	jawaharial
jeffrey	jeffrey	jeffrey
jeometri	geometria	geometry
jesu	gesù	jesus
jfk	jfk	jfk
jije	essere	existing as
jijinna	lontano	distance
jiròrò	nebbioso	dialogue
jo	perdita	days
jogun	ereditato	inherit
johann	inferno	johann
johanu	spiacente	john
jojo	cracked	great extent
jopò	unisciti	gathered
jo	john	resemble
juneau	juneau	juneau
jàgídíjàgan	violento	violent
jáde	vieni fuori	out
jé	venire	is
jéésù	gesù	jesus
jìnnàa	lontano	further
jíje	essere	eating
jíjuwó	fare soldi	waving hands
jíjéomoléyìnkírísítì	come filantropo	followers of christ
jùlo	più di	most
jùlo	particolarmente	most
jùló	più	most
jẹ́mánì	tedesco	germany
jọ́	per favore	together
kadara	risorsa	destiny
kagera	vanagloriosi	kagera
kakiri	traccia	all over
kalinga	cinga	kalinga
kalẹ	accantonare	established
kampala	fermaglio	kampala
kan	un&#39;	one
kankan	nessuna	any
kanlè	kanal	established
karbonumarun	thecentricane	5 carbon
karl	karl	karl
karun	quinto	fifth
karùún	il quinto	fifth
kebbi	regolabile	kebbi
kekere	piccolo	lower
keko	colto	learn
kept	tenuto	fi pamo
khoisan	inferiore	khoisan
ki	così	not
kiakiajulo	il più veloce	rapidly
kiko	portando	gathering
kikojo	compilazione	gathering
kikopomo	calore	mixed
kikoso	veloce	colonised
kiko	apprendimento	making
kikuninu	immaginare	size
kilhar	ascella	kilhar
kinkinni	la piccola cosa	small quantity
ko	o	don't
kodò	sotto	bow
koidu	koidu	koidu
kojá	attraversare	pass
kolo	kolo	going
komputa	computer	computer
kong	kong	kong
kongo	preservativo	congo
kookan	questo	one
koto	esca	pit
koko	apprendimento	make heap
ko	ko	learn
kori	non piu	not found
krio	krio	krio
ku	tu	remain
kwara	indirizzata	kwara
kàríbẹ́ánì	nella regione	carribean
kàyéfì	meraviglia	amazement
ká	di	we
kánfinkése	ingegnosità	prolonged
kánádà	ovviamente	canada
káyé	mondo	world
kéesì	ridicolo	keesi
kékéèké	piccolo	small
kétu	essere preparato	ketu
kémíkà	al contrario	chemical
kéyìn	dopo	come after,
kìnní	primo	first
kí	salutare	not
kíko	studiando	written
kíkọ́	per imparare	learning
kínu	baci	greet
kírísìtì	natale	christ
kòjòkú	pioggia	kojoku
kòkó	il topo	cocoa
kòmpútà	computer	computer
kòtò	un pozzo	pit
kòòsí	non è	coaching
kòòkan	ognuno	each
kógo	gloria	glorious
kóra	raccogliere	participate
kùkú	dopotutto	eventually
kùrání	il corano	quran
kúkú	dopotutto	now
kúkúrú	in poche parole	short
kúrò	lontano	away
kútò	qualunque cosa	kuto (place)
kúùkù	anzi	punches; expression meaning 'by force' (ti pa ti kuuku)
kẹrin	la quarta	4
kẹsàán	al momento	ninth
kẹta	terzo	third
kẹ́nyà	separazione	kenya
kọjá	passaggio	pass through
kọ̀mpútà	computer	computer
kọ́kọ́	primo	first
kọ́lọ́mú	colonne	breast owner
kọ́ni	mancanza di	teach
laa	va via	will
laada	calcio	good fortune
laaka	inversione	important
laarin	entro	between
labalaba	la farfalla	butterfly
labee	sotto	under
lade	imbarcare	crowned
laid	di cui	tele
laifi	colpa	without
languages	le lingue	ede
lanka	lanka	lanka
lasile	pubblicazione	laid out
latibe	da li	from there
latigbana	da allora	from then on
latini	latino	latin
latvia	lettonia	latvia
lay	posare	da
le	può	can
leboa	lebo	leboa
lekun	intensificata	open door
leo	leo	leo
lese	inviare	firmly
less	di meno	okeresi
lewaju	in avanti	front
lewon	reclusione	imprisonment
leyi	ecco qui	mispelled...should be 'leyin', after
leè	maggio	can
lilelile	hardcore	tightly
lilemo	canapa	sticky
lilongwe	lilongwe	lilongwe
lindi	liscivia	lindi
linear	lineare	dogba
links	link	eka; this is a new word and does not really exist in yoruba
lodo	avere luogo	from
lojowaju	nel futuro	the future
lojukokoro	avido	covetousness
lojúgun	ha devastato	knee
lokunkun	energico	in the dark
loloselu	politicamente	in politics
lopolopo	un sacco	so many
loruko	nome	name
louvre	persiana di ventilazione	louvre
lovers	gli amanti	awon olufe
low	basso	diye
lo	vai avanti	than
luanda	luanda	luanda
luther	luther	luther
lynton	lynton	lynton
làgba	pari	more important
lààmi	cartello	sign
lààmì	segni	significant
lábé	peso	under
láfún	dato	cassava food
láimo	senza	unknown
láké	forte	in ake
lámọ́di	fortuna	lamodi
lápá	parte	from
lára	male	part of
lárúbáwá	il naturale	arabic
láì	senza	without
láíláí	mai	old
lèe	può	can
lèyìn	in seguito	after
lédè	nella lingua	language
léebá	incidentalmente	catch up with it
lérìnín	la neve	erin=laughter; the prefix 'l' is possesive
lérò	motivo	thought
léyin	in seguito	after
léyìn	dopo	after
lérú	schiavitù	enslave
lílo	sfruttamento	using
lísa	accelerazione	a chieftaincy title
lítésò	pungente	literature
lóde	al di fuori	modern
lópez	nipez	lopez
lópó	vedova	widow
lórì	porto	on the head
lóríba	al di sopra di	subdue
lóti	lotto	have
lóòótò	sì	truly
lóòótọ́	infatti	truly
ló	ló	to
lónà	sulla strada	in a way
lórò	domani	become wealthy
lọndọnu	londra	london
lọ́dọọdún	annualmente	yearly
lọ́jà	sul mercato	in the market
maapu	carta geografica	map
madeira	beira	madeira
mahatma	il mahatma	mahatma
makedonia	macedonia	macedonia
malabo	miele	malabo
malay	presunto	malay
malayopolynesian	malayopolynesian	malayo-polynesian
malaysia	malaysia	malaysia
mali	giorno	mali
mango	mango	mango
manˈdeːla	mandelala	mandela
marcellus	marcello	marcellus
march	marzo	march
marku	questa volta	mark
mars	marte	mars
maryland	maryland	maryland
maseru	gelosia	don't be slave
matheu	matheu	matthew
mathiew	mathiew	mathiew
mathimatiki	matematico	mathematics
max	max	max
maya	no	maya
mbabane	negativo	mbabane
means	si intende	ona (way)
mediteraneani	il mediterraneo	mediterranean
mefeefa	revisione	all six
mejidinlogbon	ventotto	twenty eight
mejila	dodici	twelve
meksiko	messico	mexico
melo	quanti	some
member	membro	ara
mercosur	mercosur	mercosur
merin	quattro	four
methodologies	metodologie	anaoniruuru
metropoli	metropoli	metropolis
meucci	meucci	meucci
mewar	mewar	mewar
mexico	messico	mexico
michelle	michelle	michelle
micronesia	micronesia	micronesia
miiràn	alleviare	another
mimoy	mimoy	mimoy
mimuwa	attaccamento	import
minnesota	minnesota	minnesota
minority	minoranza	awon ara kekere
mohandas	mohandas	mohandas
mokaleladota	compatto	51, (mokanleladota)
mokanlelogbon	trentadue	thirty-one
mombasa	mombasa	mombasa
monrovia	monrovia	monrovia
morgan	morgan	morgan
morogoro	automobilismo	morogoro
mozambique	mozambico	mozambique
mozilla	mozilla	mozilla
mtn	mtn	mtn
mtwara	scegli ancora	mtwara
mughal	volume	mughal
mulẹ̀	stabilire	establish
munispal	munispal	municipal
muungano	muungano	muungano
májèmú	non importa	testament
mère	disegno	significant
méjèèjì	tutti e due	the two
mérindíláàdóta	cinquantacinque	forty-six
méte	cinque	lip
mérìndínlógún	sedici	sixteen
mérìnlélógójì	quarantaquattro	44
méta	tre	three
métèètà	falegname	the three
méwàá	dieci	ten
ménu	pensi	verbally contribute; complete phrase= me nu ba
mímọ́	santo	holy
míràn	un altro	other
míìrán	un altro	other
mííràn	un altro	other
mò	conoscenza	know
mókólà	colla	mokola
móra	cura	with themselves
mó	m	with
múlẹ̀	tenetevi forte	select land (farmland)
mẹ́fà	sei	6
mẹ́rkúríù	il topo	mercury
mẹ́ta	tre	3
mẹ́talọ́kan	trinità	trinity
namibia	venire	namibia
nathaniel	nathaniel	nathaniel
nato	nato	nato
nawojulo	sconcertante	highest-spending
nawó	prendi i tuoi soldi	point finger
ncnc	ncnc	ncnc
nebraska	nebraska	nebraska
nefimu	nephim	nefimu
neptune	nettuno	neptune
nevis	nevis	nevis
ngbero	pianificato	planning
ngubengcuka	ngubengcuka	ngubengcuka
nibe	là	there
nibere	presto	earlier
nigbakan	qualche volta	at one time
nigbà	poi	when
nijẹr	nike	niger
nilè	qui	remaining
nisinyi	adesso	at present
nitoriidieyi	a causa di ciò	because of this
nitoripe	perché	because
nitosi	nelle vicinanze	nearby
niwaju	avanti	in front of
niyato	distinguere	unlike
niye	abbastanza	in number
niyi	ecco qui	these
nkan	cosa	things
nkàn	cancro	something
nnaji	zio	nnaji
nobel	nobel	nobel
nombamewa	moltiplicando	decimal
nombáméjì	i primi due	two-number
novo	novo	novo
nri	cibo	nri
nse	design	acting
nso	vicino	saying
nsolaboraro	sicurezza	nso laboraro
nsowikipedia	obowikipedia	saying
ntoka	punto	indicates
nu	pulito	in
nukleotidi	nucleotide	nucleotides
nukleotidipupo	nucleotide	cell
numeri	intorpidimento	numbers
nwa	bambino	drill
nàìjíríà	in nigeria	nigeria
náwo	spese	spend money
náà	pure	that
nì	montagna	is
nìnú	spiacente	in
nìyí	questo è	this is
ní	avere	on
níbè	là	there
níbè	là	there
nífẹ̀ẹ́	amare	love
nígbàtí	quando	when
nílè	sotto	on the ground
nílùú	nella città	in the town
nílẹ̀	per terra	in the land
nínlá	grande	large
nínu	opportunità	in
níní	avere	having
nípà	almeno	by
nítorípé	perché	because
nítumò	senso	meaningful
nítòsí	nelle vicinanze	nearby
nítòótó	esattamente	truly
nítòótọ́	infatti	in truth, truthfully
níwájú	avanti	in front
níyanjú	positivamente	solved
nǹkan	cosa	things
nso	prossimamente	say
oba	obama	king
obairanderan	cugino	hereditary
obere	piccolo	started
obínibí	cortesia	inborn
ododo	giustizia	righteousness
ofin	la legge	law
ogbè	regione	a divinity
ogun	guerra	war
ogunlogo	folla	hundreds
ojo	assomiglia a	day
ojojumo	quotidiano	daily
ojoru	calore	wednesday
ojukokoro	cupidigia	covetousness
ojuoorun	tramonto	atmosphere
ojuse	responsabilità	responsibility
ojùkòsì	precipitazione	ojukosi
ojùkòtúu	precipitazione	ojukotuu
ojúlùmọ̀	conoscenti	acquaintance
ojútáyé	viscosità	public
ojúìwé	pagina	page
okeere	all&#39;estero	distant
okhotsk	okhotsk	okhotsk
oko	campo	farm
okunkun	buio	darkness
okunrin	l&#39;uomo	male person
olodiajodojuko	l&#39;un l&#39;altro	facing wall
olohun	proprietari	god
olojukanna	subito	same surface
olokunkun	cuffie	popular
ololugbe	perdente	occupants
olopon	altezzoso	a local game
olora	grasso	fertile
oloselukan	ciao	one political
oloye	genio	chief
oluda	creatore	creator
oludase	produttore	separatist
olukoitan	istruttore	the writer
olukowe	autore	writer
olumojuto	avido	overseer
oluparapo	combinazione	joint
olusoju	guardia	ambassador
oluwakiri	esplorazione	explorer
olympus	olimpo	olympus
olódùmarè	onnipotente	almighty god
olóyè	righello	chief
olóṣèlú	politico	politics
olùbátan	questo contatto	relative
olùdarí	un capo	director
olùkópa	collaboratore	participant
olùkó	istruttore	teacher
olùkọ́	insegnante	teacher
omi	acqua	water
omiadalu	alluvione	mixture
onialjebra	onialjebra	of algebra
onibugbe	inquilino	population
onigbeja	costruttivo	allied
onigbowo	uno sponsor	sponsor
onigunfenfe	passivo	large angle
onilanaibagbepo	preservativo	constitutional
onilile	i proprietari di abitazione	solid
oninawo	mutuatario	financial
onipin	razionale	even
onisayensi	tecnico	scientific
onisowo	commerciante	trader
oniyewumeji	binario	two-chamber
oniyijulo	eccezionale	highest honour
onje	dieta	food
onka	calcolatrice	counter
onígbàgbó	vecchio uomo	believer
oníkólóbó	abusivo	onikolobo (place)
onílẹ̀	giù	land owners; citizens (omo onile)
oníná	fuoco	electronic
onítumò	traduttore	meaning
onítèbọmi	il battezzato	baptist
onítòhùn	contabile	that person
oníwòsàn	il guaritore	doctor
oníyanjù	animato	persevere
ooni	coccodrillo	ooni (king)
ootọ́	vero	truth
opec	opec	opec
opposite	di fronte	odi
ori	testa	top
oriire	congratulazioni	success
oriki	orientale	name of endearment
orileede	la nazione	country
orileedeajoba	imperialismo	monarchic country
orilejoba	governo	seat of government, kingdom
orileominira	calore	republic
orinìyìn	una canzone	songs of praise
orisirisi	varietà	various
orisun	fonte	source
orisa	origini	god
oritameta	nel mezzo	crossway
orudnun	annuale	mispelled...should orundun, century
oruko	sostantivo	name
oríilè	nazionale	land
oríilẹ̀	articolo	land
oríkì	poesia	family name
orílèèdè	nazione	country
orílẹ̀	nazione	continent
orílẹ́	sera	nation
orísiirísi	vario	various
orísìí	varietà	type
orísìírísi	tipi diversi	various
orúko	il campo	name
oscar	oscar	oscar
oseluarailu	civile	political unit
otherwise	altrimenti	ibaje
otutu	molti	coldness
oun	lui	it
owojagidijagan	terroristi	upheaval
oúnjẹ	cibo	food
odún	l&#39;anno	year
ojó	è piovoso	day
okùnrín	risata	man
olórun	dio	god
olósìn	religioso	rearing
odun	annuale	year
olorun	dio	god
omonìyàn	esseri umani	human beings
opolo	molti	brain
ose	ose	week
oyé	il mondo	harmattan
ofò	buongiorno	nothingness
opolo	molti	brain
paa	spegni	back
paapaa	particolarmente	especially
padá	baccello	go back
palauan	palauan	palauan
panaˈma	panama	panama
panyanan	lo spazio	spanish
papa	papà	specifically
parapọ̀	miscela	join
paripari	la fine	finally
pele	affascinante	hello
penh	penh	penh
penisula	penisola	peninsula
periferi	periferi	periphery
petu	petu	resolve
pelu	perla	with
phillipines	filippine	phillipines
pinsi	in calo	divided
pinsoto	pinoto	separated
pinu	determinato	decide
pipo	tanto	plenty
pipolongo	annuncio pubblicitario	publicise
piposi	un sacco	multiplication
platos	platos	plato's
plánẹ́tì	piombatura	planet
po	po	share
pojulo	il più alto	larger
polandi	polacco	poland
polaroid	polaroid	polaroid
population	popolazione	ero
portonovo	portonovo	porto novo
portuguese	portoghese	portuguese
press	stampa	press
produced	prodotta	yo
protokolu	protocolu	protocol
proton	protone	kemika alaropo
providence	provvidenza	providence
príncipe	príncipe	principe
pupa	rosso	red
px|kùránì	px | kernel	koran or quran; the px  does not belong
pàmò	in particolare	pamo (town)
pàràkòyí	subito	parakoyi
pààlà	un confine	signalised
pàápàá	particolarmente	especially
pásíà	la cantina	persia
pátáporongodo	assolutamente	entire
pè	chiamato	that
pèhìndà	sperma	turned back
pèlu	insieme a	with
pèlúpèlú	anche	in addition
pèsè	fornito	provide
pé	quello	that
péré	solo	only
péé	quello	that
pípa	macello	order
pípèsè	fornitura	providing
pípẹ́	lungo	long
pòwe	proverbi	to say a proverb or wise saying
pò	piegare	join
púpo	troppo	much
púpò	piuttosto	a lot
quran	corano	quran
ra	acquistare	self
race	gara	ere
rajya	speranza	rajya
ramadan	ramadan	ramadan
rank	rango	ipo
reggae	reggae	reggae
repeats	ripete	tunso
repetejulo	il più sensibile	most of all
rere	bene	success
research	ricerca	agbeyewo
richard	richard	richard
right|thumb|px|aworan	destra | pollice | px | immagine	picture
rinle	recentemente	emphasise
riresile	registratore	humbled, lowered
riro	immaginazione	thought as
rn	rn	rn
rna	rna	rna
rnarna	rnarna	rna-rna
rnas	rna	rnas
ro	pensare	thought
robinson	robinson	robinson
roboto	superfici	round
rogbodiyan	rivolta	riot
rokirika	navigazione	publicise
roko	mob	farm work
roma	roma	roma
rome	cromo	rome
ronald	ronald	ronald
rorùn	facile	easy
rossii	rossii	rossii
rural	rurale	igberiko
ryan	ryan	ryan
ráhàn	apparso	complain
ránmú	preoccupazione	grumble
république	république	republic
ré	c	his/her
rìn	camminare	should be orin, song or music
ròyìn	segnalati	give account
rẹ	sua	it
saarc	rimuovere	saarc
saaree	superiore	after death
saarland	sul pavimento	saarland
safari	safari	safari
saffana	zaffiro	savannah
safiwe	confronto	describe
safta	allineare	safta
saheli	convenienza	sahel
sakyamuni	il prossimo	sakyamuni
sakyas	sakya	sakyas
salem	salem	salem
salàyé	vita	explained
sambia	gioventù	zambia
samioro	a disposizione	signal
santa	santa	santa
say	dire	so
sb	sb	sb
schwarz	schwarz	schwarz
sea	mare	odo
seat	posto a sedere	itedo
segbese	possibilmente	take steps
seidamo	chiaro	identify
semolara	asma	accustom
semudaju	ovviamente	assure
senegal	senegal	senegal
sense	senso	sensi
seville	siviglia	seville
sewadi	ricerca	investigate
sharon	sharon	sharon
sibesibe	ancora	further more
sihamoni	struttura	sihamoni
sile	dietro a	previously
silè	gocce	on the ground
sinai	peccato	sinai
sinsin	religione	unshakably
sioux	sioux	sioux
sise	cucinando	works
sisodagba	crescendo	came of age
sisopo	linking	joined
sisupapoerekusu	sputare	neighbouring islands
sisupo	moltiplicare	concentrated
slovo	slovo	slovo
so	amore	turned
sohun	sì	something
solomon	salomone	solomon
soon	presto	lai'pe
sopin	fine	ended
so	così	tells
spectacular	spettacolare	damanran
stella	stella	stella
structures	strutture	igbekale
suez	suez	suez
sugbo	ma no	but
sugbọ́n	razionale	but, however
sun	sole	sleep
suny	suny	suny
swahili	swahili	swahili
symmetry	simmetria	ogbooga
sàbúrí	soprattutto	saburi
sàmì	un segno	signalize
sàn	meglio è	flow
sàngó	banda	sango (god of thunder)
sàì	bene	un
sápadè	questo giorno	run to
sáàpàdé	sponsorizzazione	saapade
sáààrin	nel mezzo	between
são	quello nuovo	sao
sèle	furto	down
ségun	piangere	conquered
sénégal	sperma	senegal
séyìn	indietro	back
séyìn	indietro	at the back of
sìbẹ̀	ancora	there
sìni	gamberetto	likewise
síbèsíbè	tuttavia	further more
síbú	a terra	ocean
sílẹ̀	deludere	drop
síse	lavoro	doing
síso	ancora	spoken
síso	ancora	saying
síta	al di fuori	outing
síwon	loro	to them
síwájú	in avanti	comes before
síí	qui	on it
sòrò	lavaggio del cervello	talk
sójà	soldato	soldier
sóko	pianta	to the farm
sùgbón	anzi	but
sọ	dire	lose
si	certamente	to
síse	struttura	performing
sùgbón	anzi	but
se	loro fanno	do
sepò	finalmente	cooperation
sisé	allenarsi	work
sááju	prenditi un minuto	before
sísa	s	to be
sísè	traduzione	step
tabi	o	or
tabili	tavolo	table
tabora	evitare	tabora
taino	dino	taino
tainos	tainos	tainos
takuntakun	vincoli	valiant
talaka	povero	poor
talika	povertà	the poor
tara	nove	wholly
tata	filtro	wildly
taínos	taínos	tainos
technology	tecnologia	tekinoloji
tedo	incontri	stay
teksas	texas	texas
tele	azione supplementare	before
temptation	in cerca di	idanwo
terutomo	terutomo	everybody
tfrac	tfrac	tfrac
the	il	does no directly translate
they	essi	won
those	quelli	awon
thumb|left|upright|nelson	pollice | sinistra | verticale | nelson	apa osi naro
tira	teso	quranic verse
tirana	tirana	tirana
tirè	il suo	own
titu	sparare	cold (if it's a person's name, it is tutu)
tiwọn	il loro	theirs
to	per	it
toje	raro	that is
tokasi	sottolineato	pointing to
tokyo	tokyo	tokyo
tolerejulo	tollerato	most profitable
tolórítelémù	olocausto	all manners of people
tomé	pomodoro	tome
tooto	veramente	true
tori	tori	because
torun	brunetta	heavenly
toseluaralu	politico	political
tounsejanu	tragico	control
traduite	traduite	traduite
translated	tradotto	tunmo
tumosi	si intende	means
tuntun	nuovo	new
tàsí	senza	or
tàwon	loro	theirs
táawà	inchinarsi	we
tèlé	azione supplementare	before
tètè	velocemente	quickly
tèlé	subito	follow
tèsíwájú	fare progressi	progress
té	t	follow
télè	di	before
té	t	shamed
títi	chiuso	till
títèlé	da seguire	following
títío	fino a	until
tíátà	biglietti	theater
tíórì	pneumatici	that is seen
tò	impostato	enough
tóbi	grande	big
tódárajùlọ	il migliore	most beautiful
tókù	riposo	others
tówùú	qualsiasi importo	whatever
tó	tó	taught
tóka	citato	pointed
tú	versare	untie
túmò	prugna	means
túnse	rearrange	restructured
tẹ̀ǹbẹ̀	poi	rivalry
tẹ̀ǹbẹ̀lẹ̀kun	cospirare	bitterness
ucb	ucb	ucb
umueri	bambini	umueri
unifasiti	università	university
unla	sì	great
urasílì	uracile	uracil
uribe	l&#39;aura	uribe
usps	usps	usps
utah	utah	utah
utc	utc	utc
uzbek	la via	uzbek
venezuela	venezuela	venezuela
vermont	vermont	vermont
victor	vincitore	victor
videos	video	fidio
vihara	vihara	vihara
villa	villa	villa
viruses	virus	awon eran
visit	visitare	ibewo
vz	vz	vz
waa	è	ours
waju	viso	future
wari	odore	once existing
westminster	westminster	westminster
wisconsin	wisconsin	wisconsin
witkin	witkin	witkin
wiwari	scoperta	discovered
województwo	cheworddztwo	wojewodztwo
wole	registrati	into
woo	corteggiare	look
wo	qui	enter
wo	qui	look
won	loro	they
wura	oro	gold
wyoming	wyoming	wyoming
wàásù	predicare	preach
wì	lavare via	that
wípè	chiarezza	that
wòfún	grida	convenient
wònyí	questi sono	these
wón	loro	they
wúnrèn	allenarsi	small amount
wọn	loro	they
wọ̀nyí	questi	these
xd	xd	xd
xiv	xiv	xiv
yafran	alfabeto	yafran
yakubu	yakub	yakubu
yan	selezionare	choose
yanjú	risolvere	solve
yanturu	abbondanza	abundant
yaoundé	yaoundé	yaounde
yewo	miglioramento	examine
ye	si	suitable
ye	si	should
yindinyindin	mai smettere	brightly
yio	deve	will
yiowu	lo farà	any
yipada	girarsi	change
yiyafunnilo	erosione	borrow
yoo	volere	will
yori	guidato	result
york	york	york
yorúbà	yogurt	yoruba
yo	yo	remove
yànan	stupore	scattered
yàtò	impostare	other than
yára	sbrigati	quickly
yèwò	guarda	examine
yée	lasciarli	eplained to
yì	partire	this
yìí	questo	this
yí	girarsi	this
yíyípadà	modificare	changed
yíì	desideri	this
yíò	lo farà	it will
yẹ̀ẹ́	sai	check
yọ	rimuovere	bring out
zanzibar centralsouth	zanzibar centralsouth	zanzibar centralsouth
zdna	zdna	z-dna
zou	zou	zou
zscores	zscores	z-scores
zy	zy	zy
 bce	lontano	bce
àbe	babbuino	under
àbámẹ́ta	giovedi	saturday
àbáyo	suggerimento	breakthrough
àbìkú	immortalità	'born to die' child
àbọ̀	metà	result
àdámò	vita privata	earmark
àdátá	l&#39;opposto	adata
àdáátán	esclusivo	adaatan
àdóolóró	olio	bomb
àgbàjọ	il vecchio	assembly
àgbàrá	alluvione	power
àgbáríjọ	organizzazione	combination
àgbékà	astratto	suitable
àgbéyèwò	revisione	examination
àgbìgbò	quartiere	a type of bird
àgbùdo	cortile	corn
àgọ́	tenda	ago
àifète	scopo	unable to keep quiet
àjo	viaggio	board
àjákọ	a parte	ajako
àjọṣepọ̀	sociale	union
àkosílè	astrazione	written
àkosílè	tesi	written account
àkàrà	torte	bean pudding
àká	scaffali	store
àkójopò	gruppo	collection
àkókó	il tempo	previous
àlàkalè	obiettivi	breakdown, explanation of actions
àlàyé	informazione	explanation
àlàáfíà	pace	peace
àlááfià	analogia	wellbeing
àlè	bastardo	mistress, concubine, (side booty)
àlèpò	sopra	joined together
àlébù	macchia	ills
àmérìkà	soprannaturale	america
àmì	cartello	sign
àmúlò	pratico	synonyms
àmúsorò	psicologia	resources
ànfàní	opportunità	opportunity
àpapọ̀	nel complesso	federal
àpeere	esempio	example
àrígbámú	inquietante	assistant
àrùn	patologia	disease
àrẹ	presidente	president
àse	festa	authority
àsàjemátèe	alba	cunning
àsèyìn	conseguenze	at the end
àsìkò	tempo	time
àsótélè	estensione	prophecy
àsọdọ̀kan	unità	unitary
àsekúdórógbó	abbaiare	do or die
àsà	costume	habit, culture, norm
àtijo	obsoleto	olden days
àtìpó	l&#39;alieno	sojourn
àtòrìnká	rotatoria	urinating while walking
àtúnse	modificare	modification
àtúnse	modificare	renovate, fix
àtẹnudẹ́nu	orale	oral
àwon	teorie	they
àwón	i soldi	the
àwón	i soldi	the
àwùjo	società	community
ààtò	rituale	suitability
ààyè	vivo	space
àárín	nel mezzo	middle
àáyá	sperma	seconds
àìkó	carenza	unlearned
àìní	volere	lack
àìròtélè	inaspettato	unthought of
àìsí	assenza	lack
án	t	it
áwon	fornicazione	those
èbà	zanzare	cassava flour food
èbúté	porta	shore
èdá	creazione	creature
èdè	linguaggio	language
èdè	linguaggio	language
èfòn	teso	efon
èhìn	il prossimo	outskirt
èka	ramo	branch
èkejì	l&#39;altro	second
èlò	utensili	tool
ènìkan	qualcosa	someone
èràn	patologia	virus
èrò	pensieri	thoughts
èsó	moschea	modesty
èsúrú	formiche	yam (indigenous to west africa)
ète	scopo	plan
èyì	dignità	this
èka	effetto	branch
èro	pensieri	machine
èrí	prova	witness
èsìn	religione	religion
èwù	camicia	clothe
èpón	monete	modifier
ìbarà	febbre	ibara (town)
ìbánisòrò	la connessione	dialogue
ìbáraeni	carrozza	to themselves
ìbílè	primogenitura	local
ìbílè	primogenitura	local
ìdàgbà	età adulta	grow
ìdàpapọ̀	consolidamento	union
ìdàrúdàpò	caos	misunderstanding
ìdá	cazzotto	division
ìdìmú	disturbo	branch, part
ìdíisin	causa	idi-isin
ìdíwòn	la tua ragione	criteria
ìdó	puntura	ido (a person's name)
ìfara	tortura	self
ìfojúìtànìgbesiayé	storia di vita	biography
ìfáàrà	un prete	introduction
ìgbonnìbí jé	è un disastro	igbonnibi
ìgbà	tempo	when
ìgbàgbé	dimentico	forgetfulness
ìgbá	ali	time
ìgbáraga	forza	pride
ìgbéraga	orgoglio	pride
ìgbésí	vita	life
ìgbò	montone	igbo people
ìhun	ferro	things
ìjo	danza	church
ìjo	la chiesa	church
ìjoba	governo	government
ìjora	odiare	resemblance
ìjìnlè	mistero	comprehensive
ìjìnlè	mistero	mysterious
ìjò	capo	consent
ìjọba	governo	government
ìkejì	l&#39;altro	second
ìkànna	lo stesso	ikanna (town)
ìkèrèkú	congestione	ikereku
ìkéde	dichiarazione	advert
ìkìjà	una sfida	ikija
ìkìlò	abuso	warning
ìkínin	il sesto	greetings
ìkẹrin	la quarta	fourth
ìkọpa	partecipazione	ikopa
ìlera	salute	health
ìlo	chiamata	use
ìlà	contorno	border
ìlànàn	illusione	procedure
ìlàorùn	ecchimosi	east
ìlàìnàró	oppressione	vertical
ìlè	corruzione	land
ìlé	casa	land
ìmò	serpente	knowledge
ìmò	fulmine	knowledge
ìmóbìdo	il diritto di nascita	imobido
ìmú	gengive	knowledge
ìmúnilérú	abusi	slavery
ìmúsára	rafforzare	contagious
ìnagije	vittoria	alias
ìnáwó	spesa	expenditure
ìpolongo	pubblicità	advertisement
ìpìlẹ̀núkléù	crittografia	base
ìpìnlè	l&#39;inizio	foundation
ìpínrò	paragrafi	economize
ìrànlọ́wọ́	aiuto	help
ìrànàna	aiuto	path-clearing
ìràwọ̀	le stelle	s
ìrí	esperienza	sight
ìròkò	pensiero	iroko
ìròyìn	notizia	news
ìròyìnwiki	notizia	wikinews
ìròrùn	illusioni	peaceful
ìró	suono	sound
ìrúbo	crollo	sacrifice
ìsawo	divinazione	divinity-practice
ìse	azione	behaviour
ìsinsìnyí	adesso	modern
ìsirò	calcolo	adding
ìsomó	unirsi	attachment
ìsàlè	tramonto	down town
ìsèlè	produzione	happening
ìsìn	religione	worship
ìsòrò	meditazione	speech
ìsòrí	suddivisione	chapter
ìsú	spessore	lump
ìsọ	negozi	stall
ìse	azione	work
ìsègbèfábo	diligenza	female support
ìsèdá	creazione	creation
ìsèjoba	governo	government
ìsílé	casa	house opening
ìsòro	difficoltà	problem
ìse	azione	action
ìta	al di fuori	outside
ìtaeko	laboratorio	outskirts of eko
ìtan	storia	story
ìtokò	la pentola	story
ìtàn	storia	history
ìtànkálé	inondazioni	spread
ìtèsíwájú	progresso	progress
ìtójú	cura	treatment
ìtóju	confusione	treatment
ìtójú	espressioni facciali	treatment
ìtóka	essere battuto	dictionary
ìtúmò	traduzione	meaning
ìtúpalè	traduzione	exposition
ìwe	confronto	book
ìwo	corna	horn
ìwàásù	predicazione	sermon
ìwéré	opuscolo	iwere (town)
ìwò	complessivamente	set
ìwòran	visione	viewing
ìwúlò	utile	usefulness
ìya	sofferenza	mother
ìyapa	separazione	divorce
ìyàwó	la sposa	wife
ìyípadà	conversione	transformation
ìṣèlú	politica	politics
ìṣẹ́kù	il promemoria	broken
ìṣọ̣̀tẹ̣̀	polmonite	rebellion
òde	al di fuori	society
òdeojú	senza volto	surface
òdo	gioventù	zero
òdìkejì	l&#39;altro	opposite
òféàrán	un&#39;immagine	a town name
ògbójú	competente	brave
ògiri	parete	wall
ògo	gloria	glory
ògun	medicinale	medicine
ògúndìpẹ̀	compatto	ogundipe
òjo	assomiglia a	ojo
òjísé	il dottore	servant
òkèògbún	un migliaio	oke-ogbun
òkòòkan	uno per uno	each
òkú	cadaveri	corpse
òkúta	una pietra	stone
òle	casalinga	lazy
òmiràn	lo stregone	other
òmùàrán	un&#39;immagine	omu-aran (town)
òní	oggi	today
òotó	verità	true
òpópóònà	strada	highway
òranyàn	obbligatorio	a must
òrìsà	idoli	god
òrí	capitolo	top
òrò	cervello	word
òsán	mezzogiorno	afternoon
òsèlú	politico	politics
òsèré	atleta	player
òwù	stoffa	owu
òṣèlú	politica	politician
òjògbón	tempo piovoso	learned person
òkan	uno	heart
òkòòkan	uno per uno	each
òpòlopò	molti	many
òré	gioco	friend
òfò	il prossimo	sorrowful
òpòlopo	molti	lot of
òré	gioco	friend
òrò	pensieri	word
òsà	pesce rosso	lagoon
òwó	i soldi	hand
òrò	pensieri	word
òròàjòmó	influenza	part of speech
ó	esso	that
óníse	lui è un designer	stricken
ósírísì	saliva	diverse
ósékú	lui è morto	die suddenly
ó	sì	word
ôdún	anno	year
únṣẹlẹ̀	terremoto	formed
şe	fare	do
ʔaːnaːtɕɑ̀k	.aːnaːtɕɑɕɑk	not yoruba
ˈøːstəˌʁaɪç	øːstəˌʁaɪç	austria
ˌkælɪˈfɔrnjə	ɪkælɪfɔrnjə	not yoruba
ˌæləˈbæmə	malattia	not yoruba
κάππα	.α	does not translate
σ	σ	does not translate
ṣiṣé	apertura	work
ṣàkóbá	dannoso	incriminate
ẹdo	scherzare	edo
ẹlẹ́bùn	un regalo	award winner
ẹlẹ́sìn	religioso	religionist
ẹnìkan	una persona	someone
ẹsẹ	piedi	verse
ẹtì	fegato	friday
ẹ̀kaawon	osservazioni	branch of
ẹ̀kabrítánì	zio	part of britain
ẹ̀kajuly	maggio	chapter july
ẹ̀kaoṣù	spine	month
ẹ̀kasístẹ̀mù	soggettivo	sistemu=system
ẹ̀kẹ́ta	il terzo	third, the third
ẹ̀kọ́	formazione scolastica	teachings
ẹ̀ni	oms	person
ẹ̀rọ	macchinari	machine
ẹ̀wẹ̀	d&#39;altro canto	leaf
ọbàkàn	fratellastro	step-sister
ọdún	anno	year
ọlọ́mọ	bambini	members
ọlọ́run	un dio	god
ọmú	fai schifo	breast
ọmọ	bambino	c
ọn	esso	him
ọpọ́lọpọ́	fichi	many
ọ̀dọ́	gioventù	youth
ọ̀gbìn	pianta	seedlings
ọ̀nà	modo	ways
ọ̀pòlòpò	azione	various
ọ̀rọ̀	parlare	word
ọ̀sẹ	settimana	week
