aajo	löjlig	hospitality
aala	gräns	border
aanu	medkänsla	compassion
aapon	aapon	bachelor or spinster (bachelorette)
aare	aare	president
aawe	förlamning	fasting
abala	delen	division
abeikojopo	arvtagerska	subset
abeorile	hemkomst	nation
abesahara	stänk	under the sahara
abidi	alfabet	abidi
abidjan	någonsin	abidjan
abo	feminin	security
aburunmu	vår styggedom	reduced in value, diminished
abálájo	erfaren	that is why
abé	nål	under
abínibí	nationalitet	inborn
abúléko	by	village
accra	accra	accra
adaba	bekväm	factor
adabaye	okej	previously-existing
adarihunrun	rengöringsmedel	human
addis	addis	addis
adeda	natur	creator
adiokan	enslig	stubbornness
adágbà	äldre	adagba
adúgbò kútò	grannar på gatan	kuto area
adúgbò mókóla	mukolaslimhinna	mokola area
adúgbò quarry	stenbrott grannar	neighborhood
adúgbò ìdí	grannskapsskäl	area
afida	familjen	element
afomo	till exempel	cleansing
afoyemo	synopsis	abstract
africa	afrika	africa
african	afrikansk	ara afrika
africans	afrikaner	africans
aféfé	väderkvarn	air
agba	måla	principal
agbado	majs	maize
agbara	kraft	power
agbaye	världen	world
agbeinadie	jordbruksmark	semi-conductor
agbà	en vuxen	adult
agbàbò	beskyddare	adopted child
agbára	kraft	power
agbéiná	brandman	conductor
agio	gråta	agio
aintimulo	aintimulo	un-exploited
aisi	brist	lack
ajagun	en hund	ajagun
aje	ekonomi	trade
ajemoroyin	förhör	reporting
ajibola	dagordning	ajibola
ajo	resa	firms
ajoro	resa	discussion
ajọra	kopia	resemblance
akiidah	coridah	(non-standard yoruba, this maybe from benin)
akinpelu	artilleri	akinpelu
akokolo	period	period
akole	vi kan inte	title
akoni	vi har inte	teacher
akopa	först och främst	participant
akopo	kompilering	assembly
akátá	schakal	african american
akíkanjú	tapper	courageous
akíngbógun	bataljon	akingbogun
akẹ́kọ̀ọ́	studerande	students
ala	ner	limit
alaabo	inaktiverad	protection
alaadanida	oönskade	individual
alaafia	fred	peace
alaafin	olaglig	alaafin
aladaani	privat	privately-owned
aladani	privat	self-owned
aladanida	slumpmässig	private
alaidogba	obalanserad	unequal
alaigbara	oemotståndligt	neutron
alaini	behövande	the poor
alakitiyan	aktivist	activist
alakobere	nybörjare	primary
alalaye	jordnära	explanatory
alawose	spådom	mentor
albany	albany	albany
albert	albert	albert
alexandra	alexandra	alexandra
alicia	alicia	alicia
allāh	allah	allah
alominira	oberoende	independent
alpha	alfa	alpha
alubàbá	far	drummer
alukuraani	koranen	quran
alumoni	botande	minerals
alumíníọ̀mù	aluminium	aluminium
alákọ̀bẹ̀rẹ̀	initiator	primary education
alápapò	ersättning	general
alátise	konstnär	alatise
aláyèwò	inspektör	expert
aláísàn	sjuk	the sick
alúwo	bom	traditional cults
alọ́po	plånbok	tied
amazonas	amazonas	amazonas
americas	americas	americas
amerika	amerika	america
amojeoyipada	konvertibel	reform
amosi	moské	amos
améríkà	american	america
améríkà	american	america
an	en	him
anabi	profeten	prophet
anc	anc	anc
andaman	andman	andaman
angkor	angkor	angkor
anita	anita	anita
anschluss	anschluss	anschluss
apagusu	södern	southern
apaguusuilaorun	sydväst	south-western
apaguusuiwoorun	sydväst	part of the south
apailaorun	soluppgång	east side
apaiwoorun	västra	eastern side
aparapo	kombination	confederation
apeja	fiskare	fisherman
apeere	till exempel	example
apis	apis	apis
apòmù	förkläde	apomu
apẹ̀rè	förkläde	example
arabu	arab	arab
aralíle	tropisk	healthy body
arinkankan	den här	nationalist
ariso	aris	oral tradition
ariwaarin	mellanöstern	mid-north
ariwaguusu	sydvästlig	north-south
arkansas	arkansas	arkansas
aroko	vegetation	composition
aruleyin	hallå	carried on the back
arun	sjukdom	disease
aryan	den ariska	aryan
aráa	bror	people from
arábíà	alfabetisk	arabia
aráròmí	hallå	araromi
arópò	bestickning	substitute
arúgbó	gammal ålder	elderly
arọ	lam	cripple
asagun	seger	intial, first (referring to the 13 colonies)
ascii	ta reda på	ascii
aseeto	lösning	unfair
aseyori	framgång	success
asipa	avvikelse	first to kill
assessment	bedömning	ayewo
asìko	dumheter	time; ni asiko=when
asèdá	den naturliga	origination
atangbona	atom	emission
atanna	atom	emitter
atigba	tillåtlig	from time
atimo	planen	inland
atinrin	skrattande	thin
atun	spola tillbaka	also
atunse	korrektion	revision
australia	australien	australia
austriahumgary	austriahumgary	austria-hungary
austronesian	austronesian	austronesian
austríà	australien	austria
avar	avar	avar
awari	upptäckt	discovery
awo	tallrik	of
awonara	känsla	people of
awoòn	mall	people
awon	dem	they
awuruju	magisk	shady
awùjo	artighet	society
awújẹ	skandal	root
aya	vers	chest
ayeye	evighet	celebration
ayàfi	det är okej	only if
ayò	ay	game
azikiwe	sunt förnuft	azikwe
aṣòkan	enskild	united
baa	är	be with
babaláwo	säljaren	herbalist
bahrain	bahrain	bahrain
balẹ̀	låt honom vara	settled
bang	smäll	bang
banle	banle	banle
bara	förra året	themselves
bauxitealumina	bauxitealumina	bauxite/aluminum
bayelsa	bayelsa	beyelsa
bayi	nu	like this
bayìí	nu	this
bce	bort	bce
beauharnais	beauharnais	beauharnais
beijing	beijing	beijing
belarus	vitryssland	belarus
belgium	belgien	belgium
bengal	bengal	bengal
bengali	bengali	bengal
benin	bänk	benin
berber	berber	berber
berlin	berlin	berlin
bernstein	bernstein	bernstein
bharat	bharat	bharat
bharata	kom tillbaka	bharata
bibeli	bibel	bible
biribiri	krossades	intense
black	svart	dudu
bodies	kroppar	ara
bojú	ta en titt	take care
bole	bole	ground
bolt	bult	bolt
bolívar	bolívar	bolivar
brasil	brasil	brazil
brazzaville	brazzaville	brazzaville
bridgeport	bridge	bridgeport
britain	storbritannien	britain
brítánì	british	britain
bu	det är	give
buenaventura	buenaventura	buenaventura
bujumbura	expanderat	bujumbura
burúkú	ondska	bad
by	förbi	does not translate directly, does not exist
bàbá	fadern	father
bákannáà	också	likewise
bálè	ballong	lying on the ground
bárakú	missbruk	habitual
báyìí	nu	this
bèrẹ̀	till att börja med	started
béè	precis så	than
bòtswánà	bussen	botswana
búburú	dålig	bad
búrú	var modig	wicked
bẹ̀rẹ̀	för att starta	started
bẹ́	pank	also
bẹ́ljíọ̀m	beryll	belgium
bẹ́ẹ̀ni	ja	yes
bẹ́ẹ̀sìni	ja	that is it
cairo	rasa	cairo
calabar	tuggummi	calabar
canaria	canaria	canaria
cape	cape	cape
casablanca	casablanca	casablanca
caslon	kasino	caslon
cathedral	katedral	cathedral (katidral)
catherine	catherine	catherine
cauchy	cauchy	cauchy
cbc	cbc	cbc
chamorro	chamorro	chamorro
charles	charles	charles
chaskalson	chaskalson	chaskalson
chebbi	tror	chebbi
cherished	omhuldade	mu lokunkundun
china	kina	china
cipollone	cipollone	cipollone
clear	klar	danmanran
code	koda	code
coetsee	coetsee	coetese
coloured	färgad	alawo dudu
coming	kommande	yo jade
compared	jämfört	does not directly translate
computers	datorer	komputa, ero ayarabiasa
csto	csto	csto
ct	ct	ct
cunha	hals	cunha
da	och	back; but in this form it is unnecessary
dagbasoke	väx upp	developing
dandan	obligatorisk	a must
dani	innehav	hand-held
darapo	ansluta sig	joinedd
daru	förstöra	scattered
dates	datum	pada si
delhi	låt bli	delhi
denver	denver	denver
des	des	des
describes	beskriver	se apejuwe (apejuwe=description; se prefix makes it a verb)
desmond	desmond	desmond
development	utveckling	idagbasoke
didagba	jämlikhet	growing
didasile	etablering	established
different	annorlunda	iyato
din	fritera	reduced
dinwoju	slå upp	suitable
divoire	divoire	d'ivoire
doju	ansikte mot ansikte	face
dojú	ansikte mot ansikte	turn face (full phrase is doju ko, to face)
dominic	dominic	dominic
doni	doni	this day
dote	dote	rebel
doublehelix	dubbel helix	hiliksi abara meji
doublestrand	doublestrand	double-strand
dover	dover	dova
du	du	hustle
due	på grund av	nitori
dun	gott	sound
dàbíi	så här	like
dàpò	byt ut dem	mix
dá	skapad	intervene
dágbó	gammal ålder	forest
dájó	ok	pass judgement
dálóríi	tack	about
dáradára	väl	well
dásà	en casa	peculiar way of saying
dáwó	donera	undertake
dé	anlänt	reach
délànà	i princip	delana
dépò	till omfattningen	to a position
dì	ark	be
dìde	stiga upp	stand
dìró	till höger	hang on
dìtẹ̀	konspirera	rebel
díè	spänd	few
dóko	bra	upstanding
dólà	väl	dollar
dún	ljud	sound
dúró	att stå	stand (been in existence)
dọ́gba	likvärdig	equal
ea	ja	ea
eba	eba	shore
ebi	familj	family
ecomog	ecomog	ecomog
ede	språk	language
efrem	effem	efrem
egba	absolut	cane
egbe	pistol	group
egberundun	tusen år	a thousand year
egbo	ett sår	brother
egbé	ve	party
egbò	ett sår	chemicals
egbògi	medicinsk	don't know this
eighteen	arton	ejidinlogun
eka	komplex	branch, department, part
ekeji	den andra	second
eko	utbildning	lagos
elede	grisar	speaker
eleyi	detta	this
eleyii	så här	this
elláda	skapande	ellada
eléde	abstrakt	pig
eléré	idrottare	performer
elòmírà	tång	freedom
elòmíràn	annan	another person
emerging	framväxande	ibere-pese
emmanuel	emmanuel	emmanuel
enikéni	alla	whoever
enter	stiga på	wole
enì	elefant	person
eníbá	feber	such person
epa	jordnöt	groundnut
ernst	ernst	ernst
erofo	sediment	swamp
erékùsù	ö	island
eréonítàn	akronym	written play
eseese	diagram	step by step
esia	kommer	asia
esteri	esteri	ester
etisalat	etisalat	etisalat
etymologiae	etymologiae	etymologiae
etíòkun	kusten	beach
euro	euro	euro
euroasia	euroasia	uro-esia
ewe	blad	ewe
ewé	blad	leaf
ewì	poesi	traditional poem
example	exempel	apere
eya	kategori	tribe
eyin	ägg	previous
eyonomba	eyonomba	digit
eléja	fiske	fisherman
elòmíràn	någon annan	another person
eka	effekt	branches
eléyàmèyà	etnicitet	tribalism
enu	port	mouth
esin	religion	horse
esè	vinning	leg
ewà	av uppförande	beauty
fagile	inställt	cancel
fail	misslyckas	padanu
fan	fläkt	spread
faramó	hålla fast vid	accept
faranse	franska	french
farsi	arti	farsi
felifeli	sammet	fuming
ferde	ferde	verde
fesèmúlè	provisorisk källa	established
fe	efterlyst	want
fi	spara	by
fifihan	som visar	revealed
fihan	indikerade	shows, to show
fimú	tydligt definierat	captivate with
finiki	fysik	finiki
finlandi	finland	finland
fitino	rättegång	judgement
five	fem	marun
fodio	fodio	fodio
fofinde	förbjuda	prohibited
fohùn	skrika	consent
foniimu	filma	phoneme
force	tvinga	agbara
foriko	till exempel	agreed
fourbase	fourbase	onidi-merin
fowobowe	bokning	signed
fowó	för pengar	sign
fracmv	fracmv	does not translate
francis	francis	francis
fransi	franska	france
freetown	freetown	freetown
fuji	avlägsna	fuji
fulani	feg	fulani
fulbe	ful	fulbe
fun	för	for
funra	sig	suspect
further	ytterligare	si
fé	fé	like
fé	fé	want
fégbé	glöm det	for peers
fífò	flygande	jumping
fífún	ger	giving
fòye	förstå	rationalise
fẹ́rẹ̀ẹ́	nästan	nearly
galatia	den här gången	galatia
gba	hålla med	accept
gbajúgbujà	är mycket populär	popular
gbale	popularitet	flourished
gbaná	skjut ut	engulf in flame/rage
gbe	bära	set up
gbera	gå vidare	move
gberasoke	öka farten	rising
gbese	skuld	debt
gbigbamulo	utnyttjande	adopted
gbigbewo	finansiering	examined
gbilè	bryta ut	gaining ground
gbin	planterade	farm
gbogbogbo	allmän	general
gbongbo	rot	root
gbàgbọ́	tro	believe
gbàgùrà	skakade	gbagura
gbá	smash	received
gbáradì	gå upp	prepare
gbé	leva	convey
gbédìí	slå fast	respect
gbékalè	snickare	establish
gbéni	leva	lift
gbéyèwò	recension	examine
gbésè	erbjudande	die
gbìnyànjú	prova	endeavour
gbìyànju	försök hårt	try
gbódò	måste	must
gbónmisi	lag	strife
gbúnùn	lukta på det	hostile
gbọ́dọ̀	måste	must
geesi	engelsk	english
geneva	geneva	geneva
genevieve	genevieve	genevieve
georgia	georgien	georgia
german	tysk	german
gfaj	gfaj	gfaj
ghana	ghana	ghana
gidigidi	mycket	significantly
gidí	hus	real
goemai	goemai	goemai
gomina	guvernör	governor
gorgina	örnen	gorgina
gquadruplex	gquadruplex	g-gigalonomerin
grammy	grammy	grammy
griiki	grekisk	greek
groove	räffla	iho
guanínì	guanni	guanine
guinea	guinea	guinea
guineabissau	guinea-bissau	guinea bissau
guinébissau	guinébissau	guinea bissau
gun	lång	stretch
gunle	pistol	arrive
guusu	söder	south
gv	gv	gv
gèésì	lim	english
gèésì	pärla	english
gégé	verkligen	like
gírámà	gramps	grammar
gòkè	gå upp	climb
gún	pierced	properly
gúúsù	söder	south
gẹ̀ẹ́sì	engelsk	english
habsburg	habsburg	habsburg
haggai	guide	haggai
haiti	haiti	haiti
halomonadaceae	halomonadaceae	halomonadaceae
hard	hård	lile
haughton	haughton	haughton
hausafulani	hausafulani	hausa fulani
hawaii	hawaii	hawaii
heinrich	heinrich	heinrich
hendu	godis	hendu
henny	henny	henny
heraklion	heraklion	heraklion
hesse	höll med	hesse
him	honom	un, this term is sexless
hindu	hindu	hindu
histoni	histoni	histones
hominidae	hominidae	hominidae
hosea	hosea	hosea
hp	hk	hp
hugh	hugh	hugh
hun	hun	knit
hungari	svält	hungary
hv	hv	hv
ibalo	affär	relationship
ibarepo	förening	friendship
ibeji	tvillingar	twins
ibewo	har kommit	visit
ibiamusin	fristad	colony
ibile	traditionell	municipality
ibimo	födelse	birth
ibise	träna	official
ibiti	platser	where
ibn	ibn	ibn
ibojì	grav	burial ground
ibori	slöja	conquest
ibujoko	bänk	place of abode
ibuseripadabosi	ersättning	eternity
ibuso	att slåss	bus stop
ibùdó	läger	settlement, seat of, area,
ibùjókòó	sittplatser	settlement
iceland	island	iceland
idagbasoke	utveckling	development
idagbe	försummelse	isolation
idaji	halv	half
idajo	rättvisa	judgement
idamita	dra	sector
idari	kontroller	control
ideraa	att skriva	comfort
idimule	gripa	establishment
idoma	teckning	idoma
idupe	tack	thanksgiving
idánwò	rättegång	examination
ifija	fiske	weapon
ifilole	lansera	resolution
ifitonileti	information	reporting
ifobaje	korruption	coronating
ifofinde	kongress	prohibition
ifriqiya	stimulering	ifriqiya
igbeduro	förberedelse	institute
igbegun	seger	declaration of war
igberiko	förorts	region
igbesoke	uppgradera	upliftment
igbeyawo	bröllop	marriage
igbowolori	dyr	inflation
igbá	kyckling	shell
igbáẹ̀yìn	den sista	shell
igitòròmogbè	bredband	willow tree
ihan	dyka upp	ray
ihinrere	evangeliet	gospel
ijagun	bekämpa	war
ijakadi	kamp	wrestling
ijaya	panik	fear
ije	rörelse	eating
ijinnasi	fysik	the wind open
ijosin	dyrkan	worship
ijó	dans	dance
ikan	ett	one of
ikandinlogun	arton	nineteen
ikaowo	respekt	finger
ikejidinlogun	arton	eighteen
ikeko	kompilering	education
ikerin	den fjärde	fourth
iketa	att ärva	third
ikoenu	att spara	union
ikojopo	ackumulation	collection
ikoreokere	skörd	migration
iku	död	death
ikúgbaèyí	nu	death-has-this
ikún	fyllning	squirrel or wild rodent
ilagbolojo	publicitet	latitude
ilana	procedur	procedure
ilanaoye	strategier	knowledge procedure
ilaodo	skydda	cana
ilaorun	soluppgång	west
ileasofin	lagstiftande	house of law,
ilegiga	hem	higher ground or higher plain
ileife	försummelse	ile-ife
ileigbimo	samtycke	house of assembly/congress
ileobaluaye	världen	high chief
ileru	ugn	volcanic
ilopo	dubbel-	times
iluoba	medborgarskap	king's town
iluorilejoba	globaliseringen	capital city
ilé	hem	house
iléayé	hem	earth
iléisé	hem	workplace
ilélódò	huset	ile-lodo
iléàtèéré	hem	ile-ateere
iléńlá	gård	ile-nla (area)
ilẹ	jord	land
ilẹ̀ayé	jorden	the world
iminle	att arrestera	earthquake
imoero	lighte	engineering
imojuto	vård	protection
imusin	dra	colony
imú	näsa	nose
imúnisìn	hygien	slavery
inagberingberi	jordnötssmör	electromagnetic force
indeed	verkligen	paapa julo
indus	indus	indus
inkosi	att motivera	inkosi
integration	integration	ifowosowopo
inágbéringbérin	sjutton	electromagnet
iní	arv	possession
inúnibíni	förföljelse	hatred
ioja	fisk	fight
ioniani	behövande	ionian
iowa	på jorden	iowa
ipare	blekna	abolition
ipawo	användningar	income
ipele	nivå	stage
ipin	kapitel	share
ipinpa	deltagande	arm of, branch of
ipinu	beslut	determination
ipo	plats	position
ipá	tvinga	effort
iraja	upprörande	bargaining
iranlose	bistånd	mission
ire	försäljning	you
irele	ödmjukhet	irele
iringa	sammanfatta	iringa
irisi	utseende	appearance
irorun	väldigt enkelt	convenient
irò	rykte	iro
irúnmọlẹ̀	blixt-	apparition
isa	tillräckligt	jesus, isa or yisa is hausa language
isare	acceleration	track race
isedaniloro	självtvivel	terrorism
iseero	kolla på	engineering
isejoba	styrning	governance
iseoba	femton	civil service
iseoroayeijoun	arkeologi	archaeology
iseowo	företag	business
isepinpin	distribution	division
iso	att komma	unit
isoponomba	isoponomba	addition of numbers
isun	flöde	spring
isesi	överlämna	conduct
isè	service	occupation
itali	italiensk	italy
itanakole	berättelse	ancient
itelentele	tydligt	coming after
itiraka	kamp	effort
itobi	att skryta	size
itokowo	företag	economy
itorawo	liberal	astrology
itu	att kasta	solution
itumo	menande	meaning
iwadi	forskning	research
iwasi	imponera på	behaviour
iwifun	information	report
iwoile	hem	entering
iwosan	läkning	healing
iwulo	användbar	use
iwuwa	öva	behaviour
iyan	svält	argument
iyato	skillnaden	difference
iyawo	brud	wife
iyen	det är	that
iyán	gnistrande	pounded yam
iḷẹ̀	arbete	land
iṣẹ́ìwádìí	forskning	research
jabo	rapportera	give account
jackson	jackson	jackson
jadide	vänta	emerge
jagbe	försvinn	shout
jalè	stöld	steal
jamaica	youtube	jamaica
jamo	gå bort	link
jawaharlal	gungor	jawaharial
jeffrey	jeffrey	jeffrey
jeometri	geometri	geometry
jesu	ta hand om jesus	jesus
jfk	jfk	jfk
jije	varelse	existing as
jijinna	långt	distance
jiròrò	dimmig	dialogue
jo	läcka	days
jogun	ärvt	inherit
johann	helvete	johann
johanu	förlåt	john
jojo	knäckt	great extent
jopò	var med	gathered
jo	john	resemble
juneau	juneau	juneau
jàgídíjàgan	våldsam	violent
jáde	komma ut	out
jé	komma	is
jéésù	jesus	jesus
jìnnàa	långt	further
jíje	varelse	eating
jíjuwó	tjäna pengar	waving hands
jíjéomoléyìnkírísítì	som filantrop	followers of christ
jùlo	mer än	most
jùlo	framförallt	most
jùló	mest	most
jẹ́mánì	tysk	germany
jọ́	snälla du	together
kadara	tillgång	destiny
kagera	skrytsam	kagera
kakiri	spår	all over
kalinga	cinga	kalinga
kalẹ	avsätta	established
kampala	lås	kampala
kan	en	one
kankan	ingen	any
kanlè	kanal	established
karbonumarun	thecentricane	5 carbon
karl	karl	karl
karun	femte	fifth
karùún	den femte	fifth
kebbi	justerbar	kebbi
kekere	små	lower
keko	rate	learn
kept	hålls	fi pamo
khoisan	sämre	khoisan
ki	så gör	not
kiakiajulo	den snabbaste	rapidly
kiko	föra	gathering
kikojo	kompilering	gathering
kikopomo	värme	mixed
kikoso	snabb	colonised
kiko	inlärning	making
kikuninu	tänka	size
kilhar	armhåla	kilhar
kinkinni	den lilla saken	small quantity
ko	eller	don't
kodò	nedan	bow
koidu	koidu	koidu
kojá	korsa	pass
kolo	kolo	going
komputa	dator	computer
kong	kong	kong
kongo	kondom	congo
kookan	detta	one
koto	bete	pit
koko	inlärning	make heap
ko	ko	learn
kori	inte mer	not found
krio	krio	krio
ku	du	remain
kwara	adresserad	kwara
kàríbẹ́ánì	i regionen	carribean
kàyéfì	undra	amazement
ká	av	we
kánfinkése	påhittighet	prolonged
kánádà	självklart	canada
káyé	värld	world
kéesì	löjlig	keesi
kékéèké	små	small
kétu	var redo	ketu
kémíkà	tvärtom	chemical
kéyìn	senare	come after,
kìnní	först	first
kí	hälsa	not
kíko	studerar	written
kíkọ́	att lära	learning
kínu	kissing	greet
kírísìtì	jul	christ
kòjòkú	regn	kojoku
kòkó	musen	cocoa
kòmpútà	dator	computer
kòtò	en grop	pit
kòòsí	det är det inte	coaching
kòòkan	varenda en	each
kógo	ära	glorious
kóra	samla	participate
kùkú	trots allt	eventually
kùrání	koranen	quran
kúkú	trots allt	now
kúkúrú	i ett nötskal	short
kúrò	bort	away
kútò	allt	kuto (place)
kúùkù	tvärtom	punches; expression meaning 'by force' (ti pa ti kuuku)
kẹrin	den fjärde	4
kẹsàán	direkt	ninth
kẹta	tredje	third
kẹ́nyà	separation	kenya
kọjá	passera	pass through
kọ̀mpútà	dator	computer
kọ́kọ́	först	first
kọ́lọ́mú	kolonner	breast owner
kọ́ni	brist på	teach
laa	gå bort	will
laada	sparka	good fortune
laaka	omvänd	important
laarin	inom	between
labalaba	fjäril	butterfly
labee	under	under
lade	lade	crowned
laid	lagd	tele
laifi	fel	without
languages	språk	ede
lanka	lanka	lanka
lasile	släpp	laid out
latibe	därifrån	from there
latigbana	sedan dess	from then on
latini	latin	latin
latvia	lettland	latvia
lay	lägga	da
le	burk	can
leboa	lebo	leboa
lekun	intensifierat	open door
leo	leo	leo
lese	posta	firmly
less	mindre	okeresi
lewaju	framåt	front
lewon	fängelse	imprisonment
leyi	här är det	mispelled...should be 'leyin', after
leè	maj	can
lilelile	hardcore	tightly
lilemo	cannabis	sticky
lilongwe	lilongwe	lilongwe
lindi	lut	lindi
linear	linjär	dogba
links	länkar	eka; this is a new word and does not really exist in yoruba
lodo	äga rum	from
lojowaju	i framtiden	the future
lojukokoro	girig	covetousness
lojúgun	härjade	knee
lokunkun	energisk	in the dark
loloselu	politiskt	in politics
lopolopo	mycket	so many
loruko	namn	name
louvre	louvre	louvre
lovers	älskande	awon olufe
low	låg	diye
lo	fortsätt	than
luanda	luanda	luanda
luther	luther	luther
lynton	lynton	lynton
làgba	likvärdig	more important
lààmi	tecken	sign
lààmì	tecken	significant
lábé	vikt	under
láfún	given	cassava food
láimo	utan	unknown
láké	högt	in ake
lámọ́di	förmögenhet	lamodi
lápá	del	from
lára	ont	part of
lárúbáwá	den naturliga	arabic
láì	utan	without
láíláí	aldrig	old
lèe	burk	can
lèyìn	efteråt	after
lédè	på språk	language
léebá	tillfälligtvis	catch up with it
lérìnín	snön	erin=laughter; the prefix 'l' is possesive
lérò	anledning	thought
léyin	efteråt	after
léyìn	senare	after
lérú	slaveri	enslave
lílo	utnyttjande	using
lísa	acceleration	a chieftaincy title
lítésò	sveda	literature
lóde	utanför	modern
lópez	nipez	lopez
lópó	änka	widow
lórì	hamn	on the head
lóríba	över	subdue
lóti	massa	have
lóòótò	ja	truly
lóòótọ́	verkligen	truly
ló	ló	to
lónà	på väg	in a way
lórò	i morgon	become wealthy
lọndọnu	london	london
lọ́dọọdún	årligen	yearly
lọ́jà	på marknaden	in the market
maapu	karta	map
madeira	beira	madeira
mahatma	mahatma	mahatma
makedonia	makedonien	macedonia
malabo	honung	malabo
malay	antas	malay
malayopolynesian	malayopolynesian	malayo-polynesian
malaysia	malaysia	malaysia
mali	dag	mali
mango	mango	mango
manˈdeːla	mandelala	mandela
marcellus	marcellus	marcellus
march	mars	march
marku	den här gången	mark
mars	fördärvar	mars
maryland	maryland	maryland
maseru	svartsjuka	don't be slave
matheu	matheu	matthew
mathiew	mathiew	mathiew
mathimatiki	matematisk	mathematics
max	max	max
maya	nej	maya
mbabane	negativ	mbabane
means	betyder att	ona (way)
mediteraneani	medelhavs	mediterranean
mefeefa	översyn	all six
mejidinlogbon	tjugoåtta	twenty eight
mejila	tolv	twelve
meksiko	mexico	mexico
melo	hur många	some
member	medlem	ara
mercosur	mercosur	mercosur
merin	fyra	four
methodologies	metoder	anaoniruuru
metropoli	metropoli	metropolis
meucci	meucci	meucci
mewar	mewar	mewar
mexico	mexico	mexico
michelle	michelle	michelle
micronesia	micronesia	micronesia
miiràn	lindra	another
mimoy	mimoy	mimoy
mimuwa	klängande	import
minnesota	minnesota	minnesota
minority	minoritet	awon ara kekere
mohandas	mohandas	mohandas
mokaleladota	kompakt	51, (mokanleladota)
mokanlelogbon	trettiotvå	thirty-one
mombasa	mombasa	mombasa
monrovia	monrovia	monrovia
morgan	morgan	morgan
morogoro	bilkörning	morogoro
mozambique	moçambique	mozambique
mozilla	mozilla	mozilla
mtn	mtn	mtn
mtwara	välj igen	mtwara
mughal	volym	mughal
mulẹ̀	slå fast	establish
munispal	munispal	municipal
muungano	muungano	muungano
májèmú	har inget emot	testament
mère	teckning	significant
méjèèjì	både	the two
mérindíláàdóta	femtiofem	forty-six
méte	fem	lip
mérìndínlógún	sexton	sixteen
mérìnlélógójì	fyrtiofyra	44
méta	tre	three
métèètà	snickare	the three
méwàá	tio	ten
ménu	tror du	verbally contribute; complete phrase= me nu ba
mímọ́	helig	holy
míràn	annan	other
míìrán	annan	other
mííràn	annan	other
mò	kunskap	know
mókólà	lim	mokola
móra	bota	with themselves
mó	m	with
múlẹ̀	håll fast	select land (farmland)
mẹ́fà	sex	6
mẹ́rkúríù	musen	mercury
mẹ́ta	tre	3
mẹ́talọ́kan	trinity	trinity
namibia	att komma	namibia
nathaniel	nathaniel	nathaniel
nato	nato	nato
nawojulo	förbryllande	highest-spending
nawó	få dina pengar	point finger
ncnc	ncnc	ncnc
nebraska	nebraska	nebraska
nefimu	nephim	nefimu
neptune	neptune	neptune
nevis	nevis	nevis
ngbero	planerad	planning
ngubengcuka	ngubengcuka	ngubengcuka
nibe	där	there
nibere	tidigt	earlier
nigbakan	ibland	at one time
nigbà	sedan	when
nijẹr	nike	niger
nilè	här	remaining
nisinyi	nu	at present
nitoriidieyi	på grund av detta	because of this
nitoripe	därför att	because
nitosi	närliggande	nearby
niwaju	ett huvud	in front of
niyato	skilja på	unlike
niye	tillräckligt	in number
niyi	här är det	these
nkan	sak	things
nkàn	cancer	something
nnaji	farbror	nnaji
nobel	nobel	nobel
nombamewa	multiplicerande	decimal
nombáméjì	de första två	two-number
novo	novo	novo
nri	mat	nri
nse	design	acting
nso	nära	saying
nsolaboraro	säkerhet	nso laboraro
nsowikipedia	obowikipedia	saying
ntoka	punkt	indicates
nu	rena	in
nukleotidi	nukleotid	nucleotides
nukleotidipupo	nukleotid	cell
numeri	domningar	numbers
nwa	bebis	drill
nàìjíríà	i nigeria	nigeria
náwo	bekostnad	spend money
náà	för	that
nì	fjäll	is
nìnú	förlåt	in
nìyí	detta är det	this is
ní	ha	on
níbè	där	there
níbè	där	there
nífẹ̀ẹ́	att älska	love
nígbàtí	när	when
nílè	nedan	on the ground
nílùú	i staden	in the town
nílẹ̀	på marken	in the land
nínlá	bra	large
nínu	chans	in
níní	att ha	having
nípà	minst	by
nítorípé	därför att	because
nítumò	menande	meaningful
nítòsí	närliggande	nearby
nítòótó	exakt	truly
nítòótọ́	verkligen	in truth, truthfully
níwájú	ett huvud	in front
níyanjú	positivt	solved
nǹkan	sak	things
nso	kommer snart	say
oba	obama	king
obairanderan	kusin	hereditary
obere	små	started
obínibí	artighet	inborn
ododo	rättfärdighet	righteousness
ofin	lagen	law
ogbè	område	a divinity
ogun	krig	war
ogunlogo	folkmassan	hundreds
ojo	ser ut som	day
ojojumo	dagligen	daily
ojoru	värme	wednesday
ojukokoro	covetousness	covetousness
ojuoorun	solnedgång	atmosphere
ojuse	ansvar	responsibility
ojùkòsì	nederbörd	ojukosi
ojùkòtúu	nederbörd	ojukotuu
ojúlùmọ̀	bekanta	acquaintance
ojútáyé	viskositet	public
ojúìwé	sida	page
okeere	utomlands	distant
okhotsk	okhotsk	okhotsk
oko	fält	farm
okunkun	mörker	darkness
okunrin	mannen	male person
olodiajodojuko	varandra	facing wall
olohun	ägare	god
olojukanna	omedelbart	same surface
olokunkun	hörlurar	popular
ololugbe	förlorare	occupants
olopon	högdragen	a local game
olora	fett	fertile
oloselukan	hallå	one political
oloye	geni	chief
oluda	skapare	creator
oludase	producent	separatist
olukoitan	instruktör	the writer
olukowe	författare	writer
olumojuto	girig	overseer
oluparapo	kombination	joint
olusoju	vakt	ambassador
oluwakiri	utforskning	explorer
olympus	olympus	olympus
olódùmarè	allsmäktig	almighty god
olóyè	linjal	chief
olóṣèlú	politiker	politics
olùbátan	denna kontakt	relative
olùdarí	en ledare	director
olùkópa	bidragsgivare	participant
olùkó	instruktör	teacher
olùkọ́	lärare	teacher
omi	vatten	water
omiadalu	översvämning	mixture
onialjebra	onialjebra	of algebra
onibugbe	hyresgäst	population
onigbeja	konstruktiv	allied
onigbowo	en sponsor	sponsor
onigunfenfe	passiv	large angle
onilanaibagbepo	kondom	constitutional
onilile	husägare	solid
oninawo	låntagare	financial
onipin	rationell	even
onisayensi	tekniker	scientific
onisowo	näringsidkare	trader
oniyewumeji	binär	two-chamber
oniyijulo	grymt bra	highest honour
onje	diet	food
onka	kalkylator	counter
onígbàgbó	gammal man	believer
oníkólóbó	oegentlig	onikolobo (place)
onílẹ̀	ner	land owners; citizens (omo onile)
oníná	brand	electronic
onítumò	översättare	meaning
onítèbọmi	de dopade	baptist
onítòhùn	revisor	that person
oníwòsàn	helaren	doctor
oníyanjù	animerad	persevere
ooni	krokodil	ooni (king)
ootọ́	sann	truth
opec	opec	opec
opposite	motsatt	odi
ori	huvud	top
oriire	grattis	success
oriki	orientalisk	name of endearment
orileede	nationen	country
orileedeajoba	imperialism	monarchic country
orilejoba	regering	seat of government, kingdom
orileominira	värme	republic
orinìyìn	en sång	songs of praise
orisirisi	mängd	various
orisun	källa	source
orisa	ursprung	god
oritameta	i mitten	crossway
orudnun	årlig	mispelled...should orundun, century
oruko	substantiv	name
oríilè	nationell	land
oríilẹ̀	artikel	land
oríkì	poesi	family name
orílèèdè	nation	country
orílẹ̀	nation	continent
orílẹ́	kväll	nation
orísiirísi	olika	various
orísìí	mängd	type
orísìírísi	olika typer	various
orúko	fältet	name
oscar	oscar	oscar
oseluarailu	civil	political unit
otherwise	annat	ibaje
otutu	många	coldness
oun	han	it
owojagidijagan	terrorister	upheaval
oúnjẹ	mat	food
odún	året	year
ojó	det är regnigt	day
okùnrín	skratt	man
olórun	gud	god
olósìn	religiös	rearing
odun	årlig	year
olorun	gud	god
omonìyàn	människor	human beings
opolo	många	brain
ose	ose	week
oyé	världen	harmattan
ofò	god morgon	nothingness
opolo	många	brain
paa	stäng av	back
paapaa	framförallt	especially
padá	pod	go back
palauan	palauan	palauan
panaˈma	panama	panama
panyanan	utrymmet	spanish
papa	pappa	specifically
parapọ̀	blandning	join
paripari	slutet	finally
pele	charmig	hello
penh	penh	penh
penisula	penisula	peninsula
periferi	periferi	periphery
petu	petu	resolve
pelu	pärla	with
phillipines	phillipines	phillipines
pinsi	minskande	divided
pinsoto	pinoto	separated
pinu	fast besluten	decide
pipo	mycket	plenty
pipolongo	annons	publicise
piposi	mycket	multiplication
platos	platos	plato's
plánẹ́tì	vvs	planet
po	po	share
pojulo	det högsta	larger
polandi	putsa	poland
polaroid	polaroid	polaroid
population	befolkning	ero
portonovo	novo	porto novo
portuguese	portugisiska	portuguese
press	tryck	press
produced	produceras	yo
protokolu	protocolu	protocol
proton	proton	kemika alaropo
providence	försyn	providence
príncipe	príncipe	principe
pupa	röd	red
px|kùránì	px | kärna	koran or quran; the px  does not belong
pàmò	specifikt	pamo (town)
pàràkòyí	omedelbart	parakoyi
pààlà	en gräns	signalised
pàápàá	framförallt	especially
pásíà	källaren	persia
pátáporongodo	absolut	entire
pè	kallad	that
pèhìndà	sädesvätska	turned back
pèlu	tillsammans med	with
pèlúpèlú	också	in addition
pèsè	försedd	provide
pé	det där	that
péré	endast	only
péé	det där	that
pípa	slakt	order
pípèsè	tillhandahållande	providing
pípẹ́	lång	long
pòwe	proverbs	to say a proverb or wise saying
pò	vika ihop	join
púpo	för mycket	much
púpò	snarare	a lot
quran	quran	quran
ra	köpa	self
race	lopp	ere
rajya	hoppas	rajya
ramadan	ramadan	ramadan
rank	rang	ipo
reggae	reggae	reggae
repeats	upprepningar	tunso
repetejulo	den mest känsliga	most of all
rere	bra	success
research	forskning	agbeyewo
richard	richard	richard
right|thumb|px|aworan	höger | tum | px | bild	picture
rinle	nytt	emphasise
riresile	inspelare	humbled, lowered
riro	fantasi	thought as
rn	rn	rn
rna	rna	rna
rnarna	rnarna	rna-rna
rnas	rna	rnas
ro	tror	thought
robinson	robinson	robinson
roboto	ytor	round
rogbodiyan	upplopp	riot
rokirika	bläddring	publicise
roko	folkhop	farm work
roma	roma	roma
rome	krom	rome
ronald	ronald	ronald
rorùn	lätt	easy
rossii	rossii	rossii
rural	lantlig	igberiko
ryan	ryan	ryan
ráhàn	dök upp	complain
ránmú	oroa	grumble
république	république	republic
ré	c	his/her
rìn	att gå	should be orin, song or music
ròyìn	rapporterad	give account
rẹ	henne	it
saarc	avlägsna	saarc
saaree	överlägsen	after death
saarland	på golvet	saarland
safari	safari	safari
saffana	safir	savannah
safiwe	jämförelse	describe
safta	rada upp	safta
saheli	bekvämlighet	sahel
sakyamuni	nästa	sakyamuni
sakyas	sakyas	sakyas
salem	salem	salem
salàyé	liv	explained
sambia	ungdom	zambia
samioro	tillgängliga	signal
santa	santa	santa
say	säga	so
sb	sb	sb
schwarz	schwarz	schwarz
sea	hav	odo
seat	plats	itedo
segbese	eventuellt	take steps
seidamo	klar	identify
semolara	astma	accustom
semudaju	självklart	assure
senegal	senegal	senegal
sense	känsla	sensi
seville	sevilla	seville
sewadi	sök	investigate
sharon	sharon	sharon
sibesibe	än	further more
sihamoni	strukturera	sihamoni
sile	bakom	previously
silè	droppar	on the ground
sinai	synd	sinai
sinsin	religion	unshakably
sioux	sioux	sioux
sise	matlagning	works
sisodagba	växa upp	came of age
sisopo	länkning	joined
sisupapoerekusu	spotta	neighbouring islands
sisupo	multiplicera	concentrated
slovo	slovo	slovo
so	kärlek	turned
sohun	ja	something
solomon	solomon	solomon
soon	snart	lai'pe
sopin	slutet	ended
so	så	tells
spectacular	spektakulär	damanran
stella	stella	stella
structures	strukturer	igbekale
suez	suez	suez
sugbo	men inte	but
sugbọ́n	rationell	but, however
sun	sol	sleep
suny	suny	suny
swahili	swahili	swahili
symmetry	symmetri	ogbooga
sàbúrí	framför allt	saburi
sàmì	en skylt	signalize
sàn	desto bättre	flow
sàngó	gäng	sango (god of thunder)
sàì	väl	un
sápadè	denna dag	run to
sáàpàdé	sponsorskap	saapade
sáààrin	mellan	between
são	den nya	sao
sèle	stjäla	down
ségun	att gråta	conquered
sénégal	sädesvätska	senegal
séyìn	tillbaka	back
séyìn	tillbaka	at the back of
sìbẹ̀	än	there
sìni	räka	likewise
síbèsíbè	ändå	further more
síbú	till marken	ocean
sílẹ̀	svika	drop
síse	arbete	doing
síso	fortfarande	spoken
síso	fortfarande	saying
síta	utanför	outing
síwon	dem	to them
síwájú	framåt	comes before
síí	här	on it
sòrò	brainwash	talk
sójà	soldat	soldier
sóko	växt	to the farm
sùgbón	tvärtom	but
sọ	säga	lose
si	säkert	to
síse	strukturera	performing
sùgbón	tvärtom	but
se	dom gör	do
sepò	till sist	cooperation
sisé	träna	work
sááju	ta en minut	before
sísa	s .ía	to be
sísè	översättning	step
tabi	eller	or
tabili	tabell	table
tabora	undvikande	tabora
taino	dino	taino
tainos	tainos	tainos
takuntakun	begränsningar	valiant
talaka	fattig	poor
talika	fattigdom	the poor
tara	nio	wholly
tata	filtrera	wildly
taínos	taínos	tainos
technology	teknologi	tekinoloji
tedo	dejting	stay
teksas	texas	texas
tele	uppföljning	before
temptation	sökande	idanwo
terutomo	terutomo	everybody
tfrac	tfrac	tfrac
the	de	does no directly translate
they	de	won
those	de där	awon
thumb|left|upright|nelson	tummen | vänster | upprätt | nelson	apa osi naro
tira	spänd	quranic verse
tirana	tirana	tirana
tirè	hans	own
titu	skjuta	cold (if it's a person's name, it is tutu)
tiwọn	deras	theirs
to	till	it
toje	sällsynt	that is
tokasi	pekat ut	pointing to
tokyo	tokyo	tokyo
tolerejulo	tolereras	most profitable
tolórítelémù	förintelse	all manners of people
tomé	tomat	tome
tooto	verkligen	true
tori	tori	because
torun	brunett	heavenly
toseluaralu	politisk	political
tounsejanu	tragisk	control
traduite	traduite	traduite
translated	översatt	tunmo
tumosi	betyder att	means
tuntun	ny	new
tàsí	utan	or
tàwon	dem	theirs
táawà	att böja sig	we
tèlé	uppföljning	before
tètè	snabbt	quickly
tèlé	omedelbart	follow
tèsíwájú	att göra framsteg	progress
té	t	follow
télè	förbi	before
té	t	shamed
títi	stängd	till
títèlé	att följa	following
títío	fram tills	until
tíátà	biljetter	theater
tíórì	däck	that is seen
tò	uppsättning	enough
tóbi	stor	big
tódárajùlọ	det bästa	most beautiful
tókù	resten	others
tówùú	vilken summa som helst	whatever
tó	tó	taught
tóka	citerad	pointed
tú	hälla ut	untie
túmò	plommon	means
túnse	ordna om	restructured
tẹ̀ǹbẹ̀	sedan	rivalry
tẹ̀ǹbẹ̀lẹ̀kun	konspirera	bitterness
ucb	ucb	ucb
umueri	barn	umueri
unifasiti	universitet	university
unla	ja	great
urasílì	uracil	uracil
uribe	aura	uribe
usps	usps	usps
utah	utah	utah
utc	utc	utc
uzbek	vägen	uzbek
venezuela	venezuela	venezuela
vermont	vermont	vermont
victor	segrare	victor
videos	videoklipp	fidio
vihara	vihara	vihara
villa	villa	villa
viruses	virus	awon eran
visit	besök	ibewo
vz	vz	vz
waa	det är	ours
waju	ansikte	future
wari	lukt	once existing
westminster	westminster	westminster
wisconsin	wisconsin	wisconsin
witkin	witkin	witkin
wiwari	upptäckt	discovered
województwo	vansinne	wojewodztwo
wole	logga in	into
woo	uppvakta	look
wo	här	enter
wo	här	look
won	dem	they
wura	guld	gold
wyoming	wyoming	wyoming
wàásù	predika	preach
wì	tvätta bort	that
wípè	klarhet	that
wòfún	blick	convenient
wònyí	dessa är	these
wón	dem	they
wúnrèn	träna	small amount
wọn	dem	they
wọ̀nyí	dessa	these
xd	xd	xd
xiv	xiv	xiv
yafran	alfabet	yafran
yakubu	yakub	yakubu
yan	välj	choose
yanjú	lösa	solve
yanturu	massor	abundant
yaoundé	yaoundé	yaounde
yewo	förbättring	examine
ye	ja	suitable
ye	ja	should
yindinyindin	sluta aldrig	brightly
yio	skall	will
yiowu	det kommer	any
yipada	vänd dig om	change
yiyafunnilo	erosion	borrow
yoo	kommer	will
yori	led	result
york	york	york
yorúbà	yoghurt	yoruba
yo	yo	remove
yànan	förvåning	scattered
yàtò	uppstart	other than
yára	skynda dig	quickly
yèwò	se	examine
yée	låt dem	eplained to
yì	gå	this
yìí	detta	this
yí	vänd dig om	this
yíyípadà	förändra	changed
yíì	du kommer	this
yíò	det kommer	it will
yẹ̀ẹ́	y&#39;know	check
yọ	avlägsna	bring out
zanzibar centralsouth	zanzibar centralsouth	zanzibar centralsouth
zdna	zdna	z-dna
zou	zou	zou
zscores	zscores	z-scores
zy	zy	zy
 bce	bort	bce
àbe	babian	under
àbámẹ́ta	torsdag	saturday
àbáyo	förslag	breakthrough
àbìkú	odödlighet	'born to die' child
àbọ̀	halv	result
àdámò	integritet	earmark
àdátá	motsatsen	adata
àdáátán	exklusiv	adaatan
àdóolóró	olja	bomb
àgbàjọ	den gamla mannen	assembly
àgbàrá	översvämning	power
àgbáríjọ	organisation	combination
àgbékà	abstrakt	suitable
àgbéyèwò	recension	examination
àgbìgbò	grannskap	a type of bird
àgbùdo	gård	corn
àgọ́	tält	ago
àifète	syfte	unable to keep quiet
àjo	resa	board
àjákọ	isär	ajako
àjọṣepọ̀	social	union
àkosílè	abstraktion	written
àkosílè	avhandling	written account
àkàrà	kakor	bean pudding
àká	hyllor	store
àkójopò	grupp	collection
àkókó	tiden	previous
àlàkalè	mål	breakdown, explanation of actions
àlàyé	information	explanation
àlàáfíà	fred	peace
àlááfià	analogi	wellbeing
àlè	bastard	mistress, concubine, (side booty)
àlèpò	ovan	joined together
àlébù	fläck	ills
àmérìkà	övernaturlig	america
àmì	tecken	sign
àmúlò	praktisk	synonyms
àmúsorò	psykologi	resources
ànfàní	möjlighet	opportunity
àpapọ̀	som helhet	federal
àpeere	exempel	example
àrígbámú	störande	assistant
àrùn	sjukdom	disease
àrẹ	president	president
àse	fest	authority
àsàjemátèe	gryning	cunning
àsèyìn	verkningarna	at the end
àsìkò	tid	time
àsótélè	förlängning	prophecy
àsọdọ̀kan	enhet	unitary
àsekúdórógbó	bark	do or die
àsà	beställnings-	habit, culture, norm
àtijo	föråldrad	olden days
àtìpó	utlänningen	sojourn
àtòrìnká	runt omkring	urinating while walking
àtúnse	redigera	modification
àtúnse	redigera	renovate, fix
àtẹnudẹ́nu	oral	oral
àwon	teorier	they
àwón	pengarna	the
àwón	pengar	the
àwùjo	samhälle	community
ààtò	ritual	suitability
ààyè	levande	space
àárín	i mitten	middle
àáyá	sädesvätska	seconds
àìkó	brist	unlearned
àìní	vilja	lack
àìròtélè	oväntat	unthought of
àìsí	frånvaro	lack
án	t	it
áwon	otukt	those
èbà	mygg	cassava flour food
èbúté	hamn	shore
èdá	skapande	creature
èdè	språk	language
èdè	språk	language
èfòn	spänd	efon
èhìn	nästa	outskirt
èka	gren	branch
èkejì	den andra	second
èlò	redskap	tool
ènìkan	något	someone
èràn	sjukdom	virus
èrò	tankar	thoughts
èsó	moské	modesty
èsúrú	myror	yam (indigenous to west africa)
ète	syfte	plan
èyì	värdighet	this
èka	effekt	branch
èro	tankar	machine
èrí	bevis	witness
èsìn	religion	religion
èwù	skjorta	clothe
èpón	mycket	modifier
ìbarà	feber	ibara (town)
ìbánisòrò	anslutningen	dialogue
ìbáraeni	transport	to themselves
ìbílè	födslorätt	local
ìbílè	födslorätt	local
ìdàgbà	vuxen ålder	grow
ìdàpapọ̀	konsolidering	union
ìdàrúdàpò	kaos	misunderstanding
ìdá	övergivenhet	division
ìdìmú	störning	branch, part
ìdíisin	orsak	idi-isin
ìdíwòn	din anledning	criteria
ìdó	sting	ido (a person's name)
ìfara	tortyr	self
ìfojúìtànìgbesiayé	livshistoria	biography
ìfáàrà	en präst	introduction
ìgbonnìbí jé	det är en katastrof	igbonnibi
ìgbà	tid	when
ìgbàgbé	glömsk	forgetfulness
ìgbá	vingar	time
ìgbáraga	styrka	pride
ìgbéraga	stolthet	pride
ìgbésí	liv	life
ìgbò	bagge	igbo people
ìhun	järn	things
ìjo	dansa	church
ìjo	kyrkan	church
ìjoba	regering	government
ìjora	hata	resemblance
ìjìnlè	mysterium	comprehensive
ìjìnlè	mysterium	mysterious
ìjò	ledare	consent
ìjọba	regering	government
ìkejì	den andra	second
ìkànna	det samma	ikanna (town)
ìkèrèkú	trängsel	ikereku
ìkéde	deklaration	advert
ìkìjà	en utmaning	ikija
ìkìlò	missbruk	warning
ìkínin	den sjätte	greetings
ìkẹrin	den fjärde	fourth
ìkọpa	deltagande	ikopa
ìlera	hälsa	health
ìlo	ringa upp	use
ìlà	skissera	border
ìlànàn	illusion	procedure
ìlàorùn	blåmärken	east
ìlàìnàró	förtryck	vertical
ìlè	bestickning	land
ìlé	hem	land
ìmò	orm	knowledge
ìmò	blixt-	knowledge
ìmóbìdo	förstfödelsen	imobido
ìmú	näsa	knowledge
ìmúnilérú	missbruk	slavery
ìmúsára	för att stärka	contagious
ìnagije	seger	alias
ìnáwó	utgifter	expenditure
ìpolongo	reklam	advertisement
ìpìlẹ̀núkléù	kryptering	base
ìpìnlè	början	foundation
ìpínrò	punkterna	economize
ìrànlọ́wọ́	hjälp	help
ìrànàna	hjälp	path-clearing
ìràwọ̀	stjärnorna	s
ìrí	erfarenhet	sight
ìròkò	trodde	iroko
ìròyìn	nyheter	news
ìròyìnwiki	nyheter	wikinews
ìròrùn	illusion	peaceful
ìró	ljud	sound
ìrúbo	kollaps	sacrifice
ìsawo	spådom	divinity-practice
ìse	handling	behaviour
ìsinsìnyí	nu	modern
ìsirò	beräkning	adding
ìsomó	ansluta sig	attachment
ìsàlè	solnedgång	down town
ìsèlè	produktion	happening
ìsìn	religion	worship
ìsòrò	meditation	speech
ìsòrí	delfältet	chapter
ìsú	tjocklek	lump
ìsọ	butiker	stall
ìse	handling	work
ìsègbèfábo	flit	female support
ìsèdá	skapande	creation
ìsèjoba	regering	government
ìsílé	hem	house opening
ìsòro	svårighet	problem
ìse	handling	action
ìta	utanför	outside
ìtaeko	verkstad	outskirts of eko
ìtan	historia	story
ìtokò	grytan	story
ìtàn	historia	history
ìtànkálé	översvämningar	spread
ìtèsíwájú	framsteg	progress
ìtójú	vård	treatment
ìtóju	förvirring	treatment
ìtójú	ansiktsuttryck	treatment
ìtóka	att bli slagen	dictionary
ìtúmò	översättning	meaning
ìtúpalè	översättning	exposition
ìwe	jämförelse	book
ìwo	horn	horn
ìwàásù	förkunnelse	sermon
ìwéré	häfte	iwere (town)
ìwò	övergripande	set
ìwòran	syn	viewing
ìwúlò	användbar	usefulness
ìya	lidande	mother
ìyapa	separation	divorce
ìyàwó	bruden	wife
ìyípadà	omvandling	transformation
ìṣèlú	politik	politics
ìṣẹ́kù	påminnelsen	broken
ìṣọ̣̀tẹ̣̀	lunginflammation	rebellion
òde	utanför	society
òdeojú	ansiktslös	surface
òdo	ungdom	zero
òdìkejì	den andra	opposite
òféàrán	en bild	a town name
ògbójú	behörig	brave
ògiri	vägg	wall
ògo	ära	glory
ògun	medicin	medicine
ògúndìpẹ̀	pulver-	ogundipe
òjo	ser ut som	ojo
òjísé	doktorn	servant
òkèògbún	tusen	oke-ogbun
òkòòkan	en och en	each
òkú	lik	corpse
òkúta	en sten	stone
òle	hemmafru	lazy
òmiràn	trollkarlen	other
òmùàrán	en bild	omu-aran (town)
òní	i dag	today
òotó	sanning	true
òpópóònà	väg	highway
òranyàn	obligatorisk	a must
òrìsà	idoler	god
òrí	kapitel	top
òrò	hjärna	word
òsán	middag	afternoon
òsèlú	politiker	politics
òsèré	idrottare	player
òwù	trasa	owu
òṣèlú	politik	politician
òjògbón	regnigt väder	learned person
òkan	ett	heart
òkòòkan	en och en	each
òpòlopò	många	many
òré	spel	friend
òfò	nästa	sorrowful
òpòlopo	många	lot of
òré	spel	friend
òrò	tankar	word
òsà	guldfisk	lagoon
òwó	pengar	hand
òrò	tankar	word
òròàjòmó	morgonen	part of speech
ó	den	that
óníse	han är en designer	stricken
ósírísì	saliv	diverse
ósékú	han är död	die suddenly
ó	ja	word
ôdún	år	year
únṣẹlẹ̀	jordbävning	formed
şe	do	do
ʔaːnaːtɕɑ̀k	.aːnaːtɕɑɕɑk	not yoruba
ˈøːstəˌʁaɪç	øːstəˌʁaɪç	austria
ˌkælɪˈfɔrnjə	ɪˌæɪɪɔɔəə	not yoruba
ˌæləˈbæmə	sjukdom	not yoruba
κάππα	.α	does not translate
σ	σ	does not translate
ṣiṣé	öppning	work
ṣàkóbá	skadlig	incriminate
ẹdo	skämt	edo
ẹlẹ́bùn	en gåva	award winner
ẹlẹ́sìn	religiös	religionist
ẹnìkan	en person	someone
ẹsẹ	fötter	verse
ẹtì	lever	friday
ẹ̀kaawon	inlagor	branch of
ẹ̀kabrítánì	farbror	part of britain
ẹ̀kajuly	maj	chapter july
ẹ̀kaoṣù	taggig	month
ẹ̀kasístẹ̀mù	subjektiv	sistemu=system
ẹ̀kẹ́ta	den tredje	third, the third
ẹ̀kọ́	utbildning	teachings
ẹ̀ni	who	person
ẹ̀rọ	maskineri	machine
ẹ̀wẹ̀	å andra sidan	leaf
ọbàkàn	halvbror	step-sister
ọdún	år	year
ọlọ́mọ	barn	members
ọlọ́run	en gud	god
ọmú	du suger	breast
ọmọ	barn	c
ọn	den	him
ọpọ́lọpọ́	fikon	many
ọ̀dọ́	ungdom	youth
ọ̀gbìn	växt	seedlings
ọ̀nà	sätt	ways
ọ̀pòlòpò	handling	various
ọ̀rọ̀	prata	word
ọ̀sẹ	vecka	week
