aajo	смешно	hospitality
aala	граница	border
aanu	саосећање	compassion
aapon	оружје	bachelor or spinster (bachelorette)
aare	ааре	president
aawe	парализа	fasting
abala	део	division
abeikojopo	насљедница	subset
abeorile	повратак кући	nation
abesahara	посипати	under the sahara
abidi	абецеда	abidi
abidjan	икад	abidjan
abo	женствено	security
aburunmu	наша чула	reduced in value, diminished
abálájo	искусан	that is why
abé	игла	under
abínibí	националност	inborn
abúléko	село	village
accra	ацра	accra
adaba	повољно	factor
adabaye	у реду	previously-existing
adarihunrun	чистач	human
addis	аддис	addis
adeda	природа	creator
adiokan	усамљен	stubbornness
adágbà	старији	adagba
adúgbò kútò	комшије на улици	kuto area
adúgbò mókóla	мукокула	mokola area
adúgbò quarry	каменоломе комшије	neighborhood
adúgbò ìdí	суседски разлози	area
afida	породица	element
afomo	на пример	cleansing
afoyemo	синопсис	abstract
africa	африка	africa
african	афрички	ara afrika
africans	африканци	africans
aféfé	ветрењача	air
agba	фарбати	principal
agbado	кукуруз	maize
agbara	снага	power
agbaye	свет	world
agbeinadie	пољопривредне површине	semi-conductor
agbà	одрасла особа	adult
agbàbò	заштитник	adopted child
agbára	снага	power
agbéiná	ватрогасац	conductor
agio	плакати	agio
aintimulo	аинтимуло	un-exploited
aisi	недостатак	lack
ajagun	пас	ajagun
aje	економија	trade
ajemoroyin	испитивање	reporting
ajibola	дневни ред	ajibola
ajo	путовати	firms
ajoro	путовати	discussion
ajọra	реплика	resemblance
akiidah	цоридах	(non-standard yoruba, this maybe from benin)
akinpelu	артиљерија	akinpelu
akokolo	раздобље	period
akole	не можемо	title
akoni	немамо	teacher
akopa	прво и основно	participant
akopo	компилација	assembly
akátá	шакал	african american
akíkanjú	с периком	courageous
akíngbógun	батаљона	akingbogun
akẹ́kọ̀ọ́	ученик	students
ala	доле	limit
alaabo	онеспособљено	protection
alaadanida	нежељено	individual
alaafia	мир	peace
alaafin	нелегитиман	alaafin
aladaani	приватно	privately-owned
aladani	приватно	self-owned
aladanida	произвољан	private
alaidogba	неуравнотежен	unequal
alaigbara	неодољиво	neutron
alaini	потребан	the poor
alakitiyan	активиста	activist
alakobere	новак	primary
alalaye	земљани	explanatory
alawose	гатање	mentor
albany	албани	albany
albert	алберт	albert
alexandra	александра	alexandra
alicia	алициа	alicia
allāh	аллах	allah
alominira	независност	independent
alpha	алфа	alpha
alubàbá	отац	drummer
alukuraani	коран	quran
alumoni	лековито	minerals
alumíníọ̀mù	алуминијум	aluminium
alákọ̀bẹ̀rẹ̀	иницијатор	primary education
alápapò	замена	general
alátise	уметник	alatise
aláyèwò	инспекторе	expert
aláísàn	болестан	the sick
alúwo	бум	traditional cults
alọ́po	новчаник	tied
amazonas	амазонас	amazonas
americas	америцас	americas
amerika	америка	america
amojeoyipada	кабриолет	reform
amosi	џамија	amos
améríkà	американац	america
améríkà	американац	america
an	ан	him
anabi	пророк	prophet
anc	анц	anc
andaman	андман	andaman
angkor	ангкор	angkor
anita	анита	anita
anschluss	ансцхлусс	anschluss
apagusu	југ	southern
apaguusuilaorun	југозапад	south-western
apaguusuiwoorun	југозапад	part of the south
apailaorun	излазак сунца	east side
apaiwoorun	западни	eastern side
aparapo	комбинација	confederation
apeja	рибар	fisherman
apeere	на пример	example
apis	апис	apis
apòmù	прегача	apomu
apẹ̀rè	прегача	example
arabu	арапски	arab
aralíle	тропски	healthy body
arinkankan	овај	nationalist
ariso	настао	oral tradition
ariwaarin	блиски исток	mid-north
ariwaguusu	југозападни	north-south
arkansas	арканзас	arkansas
aroko	вегетација	composition
aruleyin	здраво	carried on the back
arun	болест	disease
aryan	аријан	aryan
aráa	брате	people from
arábíà	абецедно	arabia
aráròmí	здраво	araromi
arópò	подмићивање	substitute
arúgbó	старост	elderly
arọ	хром	cripple
asagun	победа	intial, first (referring to the 13 colonies)
ascii	сазнати	ascii
aseeto	поравнање	unfair
aseyori	успех	success
asipa	одступање	first to kill
assessment	процена	ayewo
asìko	глупости	time; ni asiko=when
asèdá	природно	origination
atangbona	атом	emission
atanna	атом	emitter
atigba	прихватљиво	from time
atimo	план	inland
atinrin	смејати се	thin
atun	премотавање	also
atunse	исправка	revision
australia	аустралиа	australia
austriahumgary	аустриахумгари	austria-hungary
austronesian	аустронесиан	austronesian
austríà	аустралиа	austria
avar	авар	avar
awari	откриће	discovery
awo	тањир	of
awonara	емоција	people of
awoòn	образац	people
awon	њих	they
awuruju	магичан	shady
awùjo	учтивост	society
awújẹ	скандал	root
aya	стих	chest
ayeye	вечност	celebration
ayàfi	то је у реду	only if
ayò	аи	game
azikiwe	здрав разум	azikwe
aṣòkan	појединац	united
baa	је	be with
babaláwo	врачар	herbalist
bahrain	бахреин	bahrain
balẹ̀	нека буде	settled
bang	прасак	bang
banle	банле	banle
bara	прошле године	themselves
bauxitealumina	бокситеалумина	bauxite/aluminum
bayelsa	баиелса	beyelsa
bayi	сада	like this
bayìí	сада	this
bce	далеко	bce
beauharnais	беаухарнаис	beauharnais
beijing	пекинг	beijing
belarus	белорусија	belarus
belgium	белгија	belgium
bengal	бенгал	bengal
bengali	бенгали	bengal
benin	клупа	benin
berber	бербер	berber
berlin	берлин	berlin
bernstein	бернстеин	bernstein
bharat	бхарат	bharat
bharata	врати се	bharata
bibeli	библија	bible
biribiri	био је сломљен	intense
black	црн	dudu
bodies	тела	ara
bojú	погледај	take care
bole	боле	ground
bolt	завртањ	bolt
bolívar	боливар	bolivar
brasil	брасил	brazil
brazzaville	браззавилле	brazzaville
bridgeport	мост	bridgeport
britain	британија	britain
brítánì	британци	britain
bu	то је	give
buenaventura	буенавентура	buenaventura
bujumbura	проширен	bujumbura
burúkú	зло	bad
by	од стране	does not translate directly, does not exist
bàbá	отац	father
bákannáà	такође	likewise
bálè	балон	lying on the ground
bárakú	зависност	habitual
báyìí	сада	this
bèrẹ̀	почети са	started
béè	управо тако	than
bòtswánà	аутобус	botswana
búburú	лоше	bad
búrú	буди храбар	wicked
bẹ̀rẹ̀	започети	started
bẹ́	сломио	also
bẹ́ljíọ̀m	берил	belgium
bẹ́ẹ̀ni	да	yes
bẹ́ẹ̀sìni	да	that is it
cairo	бес	cairo
calabar	жвакаћа гума	calabar
canaria	канарија	canaria
cape	рт	cape
casablanca	цасабланца	casablanca
caslon	цасино	caslon
cathedral	катедрала	cathedral (katidral)
catherine	катарина	catherine
cauchy	кашасти	cauchy
cbc	цбц	cbc
chamorro	цхаморро	chamorro
charles	цхарлес	charles
chaskalson	цхаскалсон	chaskalson
chebbi	мисли	chebbi
cherished	његован	mu lokunkundun
china	кина	china
cipollone	циполлоне	cipollone
clear	јасно	danmanran
code	код	code
coetsee	цоетсее	coetese
coloured	обојено	alawo dudu
coming	долази	yo jade
compared	у поређењу	does not directly translate
computers	рачунари	komputa, ero ayarabiasa
csto	цсто	csto
ct	цт	ct
cunha	грло	cunha
da	и	back; but in this form it is unnecessary
dagbasoke	одрастати	developing
dandan	обавезно	a must
dani	држање	hand-held
darapo	придружити	joinedd
daru	уништити	scattered
dates	датуми	pada si
delhi	немој	delhi
denver	денвер	denver
des	дес	des
describes	описује	se apejuwe (apejuwe=description; se prefix makes it a verb)
desmond	десмонд	desmond
development	развој	idagbasoke
didagba	једнакост	growing
didasile	оснивање	established
different	различит	iyato
din	пржити	reduced
dinwoju	потражити	suitable
divoire	дивоире	d'ivoire
doju	лице у лице	face
dojú	лице у лице	turn face (full phrase is doju ko, to face)
dominic	доминик	dominic
doni	дони	this day
dote	доте	rebel
doublehelix	доублехелик	hiliksi abara meji
doublestrand	доублестранд	double-strand
dover	довер	dova
du	ду	hustle
due	услед	nitori
dun	укусно	sound
dàbíi	овако	like
dàpò	замените их	mix
dá	креирано	intervene
dágbó	старост	forest
dájó	у реду	pass judgement
dálóríi	хвала вам	about
dáradára	добро	well
dásà	а цаса	peculiar way of saying
dáwó	донирати	undertake
dé	стигао	reach
délànà	у принципу	delana
dépò	у мери	to a position
dì	лист	be
dìde	настају	stand
dìró	на десној	hang on
dìtẹ̀	удруживати	rebel
díè	напет	few
dóko	добро	upstanding
dólà	добро	dollar
dún	звук	sound
dúró	стајати	stand (been in existence)
dọ́gba	једнак	equal
ea	да	ea
eba	еба	shore
ebi	породица	family
ecomog	ецомог	ecomog
ede	језик	language
efrem	еффем	efrem
egba	апсолутно	cane
egbe	пиштољ	group
egberundun	хиљаду година	a thousand year
egbo	рана	brother
egbé	јао	party
egbò	рана	chemicals
egbògi	медицински	don't know this
eighteen	осамнаест	ejidinlogun
eka	комплекс	branch, department, part
ekeji	други	second
eko	образовање	lagos
elede	свиње	speaker
eleyi	ово	this
eleyii	овако	this
elláda	стварање	ellada
eléde	апстрактан	pig
eléré	атлета	performer
elòmírà	морске алге	freedom
elòmíràn	други	another person
emerging	у настајању	ibere-pese
emmanuel	еммануел	emmanuel
enikéni	сви	whoever
enter	уђи	wole
enì	слон	person
eníbá	грозница	such person
epa	кикирики	groundnut
ernst	ернст	ernst
erofo	седимент	swamp
erékùsù	острво	island
eréonítàn	акроним	written play
eseese	дијаграм	step by step
esia	долази	asia
esteri	естери	ester
etisalat	етисалат	etisalat
etymologiae	етимологије	etymologiae
etíòkun	обала	beach
euro	евро	euro
euroasia	еуроасиа	uro-esia
ewe	лист	ewe
ewé	лист	leaf
ewì	поезија	traditional poem
example	пример	apere
eya	категорија	tribe
eyin	јаја	previous
eyonomba	еиономба	digit
eléja	риболов	fisherman
elòmíràn	неко други	another person
eka	ефекат	branches
eléyàmèyà	националност	tribalism
enu	уста	mouth
esin	религија	horse
esè	приходи	leg
ewà	понашања	beauty
fagile	отказано	cancel
fail	неуспех	padanu
fan	лепеза	spread
faramó	придржавају	accept
faranse	француски	french
farsi	арти	farsi
felifeli	баршун	fuming
ferde	ферде	verde
fesèmúlè	привремени извор	established
fe	желео	want
fi	сачувати	by
fifihan	показивање	revealed
fihan	назначено	shows, to show
fimú	оштро дефинисано	captivate with
finiki	стање	finiki
finlandi	финска	finland
fitino	суђење	judgement
five	пет	marun
fodio	фодио	fodio
fofinde	забрана	prohibited
fohùn	узвик	consent
foniimu	филм	phoneme
force	сила	agbara
foriko	на пример	agreed
fourbase	фоурбасе	onidi-merin
fowobowe	боокинг	signed
fowó	за новац	sign
fracmv	фрацмв	does not translate
francis	францис	francis
fransi	француски	france
freetown	фреетовн	freetown
fuji	уклони	fuji
fulani	кукавички	fulani
fulbe	фул	fulbe
fun	за	for
funra	себе	suspect
further	даље	si
fé	фе	like
fé	фе	want
fégbé	заборави	for peers
fífò	лети	jumping
fífún	давање	giving
fòye	разумети	rationalise
fẹ́rẹ̀ẹ́	скоро	nearly
galatia	овај пут	galatia
gba	договорити се	accept
gbajúgbujà	је веома популаран	popular
gbale	популарност	flourished
gbaná	пуцати	engulf in flame/rage
gbe	носити	set up
gbera	ићи даље	move
gberasoke	убрзај	rising
gbese	дуг	debt
gbigbamulo	експлоатација	adopted
gbigbewo	финансирање	examined
gbilè	избити	gaining ground
gbin	посађено	farm
gbogbogbo	генерал	general
gbongbo	корен	root
gbàgbọ́	верујем	believe
gbàgùrà	уздрмао	gbagura
gbá	разбити	received
gbáradì	устани	prepare
gbé	уживо	convey
gbédìí	успоставити	respect
gbékalè	столар	establish
gbéni	уживо	lift
gbéyèwò	преглед	examine
gbésè	понуда	die
gbìnyànjú	покушати	endeavour
gbìyànju	потруди се више	try
gbódò	мора	must
gbónmisi	закон	strife
gbúnùn	помириши	hostile
gbọ́dọ̀	мора	must
geesi	енглески језик	english
geneva	генева	geneva
genevieve	геневиеве	genevieve
georgia	георгиа	georgia
german	немачки	german
gfaj	гфај	gfaj
ghana	гана	ghana
gidigidi	врло	significantly
gidí	куца	real
goemai	гоемаи	goemai
gomina	гувернере	governor
gorgina	орао	gorgina
gquadruplex	гкуадруплек	g-gigalonomerin
grammy	грамми	grammy
griiki	грчки	greek
groove	утор	iho
guanínì	гуанни	guanine
guinea	гвинеја	guinea
guineabissau	гуинеабиссау	guinea bissau
guinébissau	гуинебиссау	guinea bissau
gun	дуго	stretch
gunle	пиштољ	arrive
guusu	југ	south
gv	гв	gv
gèésì	лепак	english
gèésì	драгуљ	english
gégé	стварно	like
gírámà	грампс	grammar
gòkè	иди горе	climb
gún	пробијен	properly
gúúsù	југ	south
gẹ̀ẹ́sì	енглески језик	english
habsburg	хабсбург	habsburg
haggai	водич	haggai
haiti	хаити	haiti
halomonadaceae	халомонадацеае	halomonadaceae
hard	тешко	lile
haughton	хаугхтон	haughton
hausafulani	хаусафулани	hausa fulani
hawaii	хаваји	hawaii
heinrich	хеинрицх	heinrich
hendu	бомбона	hendu
henny	хенни	henny
heraklion	хераклион	heraklion
hesse	договорили	hesse
him	њега	un, this term is sexless
hindu	хинду	hindu
histoni	хистони	histones
hominidae	хоминидае	hominidae
hosea	хосеа	hosea
hp	хп	hp
hugh	хугх	hugh
hun	хун	knit
hungari	гладовање	hungary
hv	хв	hv
ibalo	афера	relationship
ibarepo	удруживање	friendship
ibeji	близанци	twins
ibewo	дошло	visit
ibiamusin	уточиште	colony
ibile	традиционални	municipality
ibimo	рођење	birth
ibise	разрадити	official
ibiti	места	where
ibn	ибн	ibn
ibojì	гроб	burial ground
ibori	вео	conquest
ibujoko	клупа	place of abode
ibuseripadabosi	надокнаду	eternity
ibuso	свађати се	bus stop
ibùdó	камп	settlement, seat of, area,
ibùjókòó	седење	settlement
iceland	исланд	iceland
idagbasoke	развој	development
idagbe	занемаривање	isolation
idaji	половина	half
idajo	правда	judgement
idamita	извући	sector
idari	контрола	control
ideraa	писати	comfort
idimule	хапшење	establishment
idoma	цртање	idoma
idupe	хвала вам	thanksgiving
idánwò	суђење	examination
ifija	риболов	weapon
ifilole	лансирање	resolution
ifitonileti	информације	reporting
ifobaje	корупција	coronating
ifofinde	конгрес	prohibition
ifriqiya	стимулација	ifriqiya
igbeduro	припрема	institute
igbegun	победа	declaration of war
igberiko	приградски	region
igbesoke	надоградњу	upliftment
igbeyawo	венчање	marriage
igbowolori	скупо	inflation
igbá	пилетина	shell
igbáẹ̀yìn	последњи	shell
igitòròmogbè	широкопојасни	willow tree
ihan	да се појави	ray
ihinrere	госпел	gospel
ijagun	борити се	war
ijakadi	борба	wrestling
ijaya	паника	fear
ije	кретање	eating
ijinnasi	стање	the wind open
ijosin	обожавање	worship
ijó	плеше	dance
ikan	једно	one of
ikandinlogun	осамнаест	nineteen
ikaowo	поштовање	finger
ikejidinlogun	осамнаест	eighteen
ikeko	компилација	education
ikerin	четврти	fourth
iketa	да наследи	third
ikoenu	да сачувате	union
ikojopo	акумулација	collection
ikoreokere	жетва	migration
iku	смрт	death
ikúgbaèyí	сада	death-has-this
ikún	пуњење	squirrel or wild rodent
ilagbolojo	публицитет	latitude
ilana	процедура	procedure
ilanaoye	стратегије	knowledge procedure
ilaodo	заштитити	cana
ilaorun	излазак сунца	west
ileasofin	законодавни	house of law,
ilegiga	кућа	higher ground or higher plain
ileife	занемаривање	ile-ife
ileigbimo	сагласност	house of assembly/congress
ileobaluaye	свет	high chief
ileru	пећ	volcanic
ilopo	дупло	times
iluoba	држављанство	king's town
iluorilejoba	глобализација	capital city
ilé	кућа	house
iléayé	кућа	earth
iléisé	кућа	workplace
ilélódò	кућа	ile-lodo
iléàtèéré	кућа	ile-ateere
iléńlá	двориште	ile-nla (area)
ilẹ	земља	land
ilẹ̀ayé	земља	the world
iminle	ухапсити	earthquake
imoero	осветљавање	engineering
imojuto	нега	protection
imusin	извући	colony
imú	нос	nose
imúnisìn	хигијена	slavery
inagberingberi	путер од кикирикија	electromagnetic force
indeed	заиста	paapa julo
indus	индус	indus
inkosi	оправдати	inkosi
integration	интеграција	ifowosowopo
inágbéringbérin	седамнаест	electromagnet
iní	наслеђивање	possession
inúnibíni	прогон	hatred
ioja	риба	fight
ioniani	потребан	ionian
iowa	на земљи	iowa
ipare	изблиједити	abolition
ipawo	користи	income
ipele	ниво	stage
ipin	поглавље	share
ipinpa	учешће	arm of, branch of
ipinu	одлука	determination
ipo	локацију	position
ipá	сила	effort
iraja	шокантан	bargaining
iranlose	помоћ	mission
ire	продаја	you
irele	понизност, одмереност	irele
iringa	упаковати	iringa
irisi	изглед	appearance
irorun	врло једноставна	convenient
irò	гласине	iro
irúnmọlẹ̀	муња	apparition
isa	довољно	jesus, isa or yisa is hausa language
isare	убрзање	track race
isedaniloro	сумња у себе	terrorism
iseero	гледати	engineering
isejoba	управљање	governance
iseoba	петнаест	civil service
iseoroayeijoun	археологија	archaeology
iseowo	посао	business
isepinpin	дистрибуција	division
iso	доћи	unit
isoponomba	исопономба	addition of numbers
isun	проток	spring
isesi	предаја	conduct
isè	услуга	occupation
itali	италијан	italy
itanakole	прича	ancient
itelentele	јасно	coming after
itiraka	борба	effort
itobi	да се хвалим	size
itokowo	посао	economy
itorawo	либерал	astrology
itu	бацити	solution
itumo	значење	meaning
iwadi	истраживање	research
iwasi	импресионирати	behaviour
iwifun	информације	report
iwoile	кућа	entering
iwosan	исцељивање	healing
iwulo	корисно	use
iwuwa	вежба	behaviour
iyan	глад	argument
iyato	разлика	difference
iyawo	невеста	wife
iyen	то је	that
iyán	блистав	pounded yam
iḷẹ̀	посао	land
iṣẹ́ìwádìí	истраживање	research
jabo	извештај	give account
jackson	јацксон	jackson
jadide	држи се	emerge
jagbe	залутати	shout
jalè	крађа	steal
jamaica	јутјуб	jamaica
jamo	одлази	link
jawaharlal	љуљачке	jawaharial
jeffrey	јеффреи	jeffrey
jeometri	геометрија	geometry
jesu	јесус	jesus
jfk	јфк	jfk
jije	биће	existing as
jijinna	далеко	distance
jiròrò	магловито	dialogue
jo	цурење	days
jogun	наслеђено	inherit
johann	додјавола	johann
johanu	извињавам се	john
jojo	сломљен	great extent
jopò	придружи се	gathered
jo	јохн	resemble
juneau	јунеау	juneau
jàgídíjàgan	насилни	violent
jáde	изаћи	out
jé	доћи	is
jéésù	исусе	jesus
jìnnàa	далеко	further
jíje	биће	eating
jíjuwó	зарађивати новац	waving hands
jíjéomoléyìnkírísítì	као филантроп	followers of christ
jùlo	више од	most
jùlo	посебно	most
jùló	највише	most
jẹ́mánì	немачки	germany
jọ́	молимо вас	together
kadara	имовина	destiny
kagera	хвалисав	kagera
kakiri	траг	all over
kalinga	цинга	kalinga
kalẹ	издвојити	established
kampala	копча	kampala
kan	а	one
kankan	ниједан	any
kanlè	канал	established
karbonumarun	тецентрица	5 carbon
karl	карл	karl
karun	пето	fifth
karùún	пети	fifth
kebbi	подесиви	kebbi
kekere	мала	lower
keko	писмен	learn
kept	задржан	fi pamo
khoisan	инфериорни	khoisan
ki	учини	not
kiakiajulo	најбржи	rapidly
kiko	доношење	gathering
kikojo	компилација	gathering
kikopomo	топлина	mixed
kikoso	брзо	colonised
kiko	учење	making
kikuninu	замислити	size
kilhar	пазух	kilhar
kinkinni	та ситница	small quantity
ko	или	don't
kodò	испод	bow
koidu	коиду	koidu
kojá	крст	pass
kolo	коло	going
komputa	рачунар	computer
kong	конг	kong
kongo	кондом	congo
kookan	ово	one
koto	мамац	pit
koko	учење	make heap
ko	ко	learn
kori	не више	not found
krio	крио	krio
ku	ти	remain
kwara	адресирано	kwara
kàríbẹ́ánì	у региону	carribean
kàyéfì	чудо	amazement
ká	од	we
kánfinkése	домишљатост	prolonged
kánádà	наравно	canada
káyé	свет	world
kéesì	смешно	keesi
kékéèké	мала	small
kétu	буди спреман	ketu
kémíkà	напротив	chemical
kéyìn	касније	come after,
kìnní	први	first
kí	поздравити	not
kíko	студирање	written
kíkọ́	научити	learning
kínu	љубакање	greet
kírísìtì	божић	christ
kòjòkú	киша	kojoku
kòkó	миш	cocoa
kòmpútà	рачунар	computer
kòtò	јама	pit
kòòsí	није	coaching
kòòkan	сваки	each
kógo	слава	glorious
kóra	скупити	participate
kùkú	после свега	eventually
kùrání	коран	quran
kúkú	после свега	now
kúkúrú	укратко	short
kúrò	далеко	away
kútò	све	kuto (place)
kúùkù	напротив	punches; expression meaning 'by force' (ti pa ti kuuku)
kẹrin	четврти	4
kẹsàán	одмах	ninth
kẹta	треће	third
kẹ́nyà	раздвајање	kenya
kọjá	пролаз	pass through
kọ̀mpútà	рачунар	computer
kọ́kọ́	први	first
kọ́lọ́mú	колона	breast owner
kọ́ni	недостатак	teach
laa	одлази	will
laada	ударац	good fortune
laaka	преокренути	important
laarin	у склопу	between
labalaba	лептир	butterfly
labee	испод	under
lade	ладе	crowned
laid	положено	tele
laifi	грешка	without
languages	језицима	ede
lanka	ланка	lanka
lasile	издање	laid out
latibe	одатле	from there
latigbana	од тада	from then on
latini	латински	latin
latvia	латвиа	latvia
lay	лежати	da
le	моћи	can
leboa	лебо	leboa
lekun	појачано	open door
leo	лео	leo
lese	пошта	firmly
less	мање	okeresi
lewaju	па надаље	front
lewon	затвор	imprisonment
leyi	ево га	mispelled...should be 'leyin', after
leè	може	can
lilelile	хардцоре	tightly
lilemo	конопља	sticky
lilongwe	лилонгве	lilongwe
lindi	луг	lindi
linear	линеарни	dogba
links	линкови	eka; this is a new word and does not really exist in yoruba
lodo	узети место	from
lojowaju	убудуће	the future
lojukokoro	похлепни	covetousness
lojúgun	опустошио је	knee
lokunkun	енергичан	in the dark
loloselu	политички	in politics
lopolopo	много	so many
loruko	име	name
louvre	лоувре	louvre
lovers	љубавници	awon olufe
low	ниска	diye
lo	настави	than
luanda	луанда	luanda
luther	лутхер	luther
lynton	линтон	lynton
làgba	једнак	more important
lààmi	знак	sign
lààmì	знакови	significant
lábé	тежина	under
láfún	дато	cassava food
láimo	без	unknown
láké	гласно	in ake
lámọ́di	богатство	lamodi
lápá	део	from
lára	повриједити	part of
lárúbáwá	природно	arabic
láì	без	without
láíláí	никад	old
lèe	моћи	can
lèyìn	после	after
lédè	на језику	language
léebá	случајно	catch up with it
lérìnín	снег	erin=laughter; the prefix 'l' is possesive
lérò	разлог	thought
léyin	после	after
léyìn	касније	after
lérú	ропство	enslave
lílo	експлоатација	using
lísa	убрзање	a chieftaincy title
lítésò	убод	literature
lóde	напољу	modern
lópez	нипез	lopez
lópó	удовица	widow
lórì	лука	on the head
lóríba	преко	subdue
lóti	лот	have
lóòótò	да	truly
lóòótọ́	заиста	truly
ló	ло	to
lónà	на путу	in a way
lórò	сутра	become wealthy
lọndọnu	лондон	london
lọ́dọọdún	сваке године	yearly
lọ́jà	на пијаци	in the market
maapu	мапа	map
madeira	беира	madeira
mahatma	махатма	mahatma
makedonia	македонија	macedonia
malabo	мед	malabo
malay	претпостављено	malay
malayopolynesian	малаиополинесиан	malayo-polynesian
malaysia	малезија	malaysia
mali	дан	mali
mango	манго	mango
manˈdeːla	манˈделала	mandela
marcellus	марцеллус	marcellus
march	марш	march
marku	овај пут	mark
mars	марс	mars
maryland	мариланд	maryland
maseru	љубомора	don't be slave
matheu	матхеу	matthew
mathiew	матхиев	mathiew
mathimatiki	математички	mathematics
max	мак	max
maya	не	maya
mbabane	негативан	mbabane
means	значи	ona (way)
mediteraneani	медитеранска	mediterranean
mefeefa	ремонт	all six
mejidinlogbon	двадесет осам	twenty eight
mejila	дванаест	twelve
meksiko	мексико	mexico
melo	колико	some
member	члан	ara
mercosur	мерцосур	mercosur
merin	четири	four
methodologies	методологије	anaoniruuru
metropoli	метрополи	metropolis
meucci	меуцци	meucci
mewar	мевар	mewar
mexico	мексико	mexico
michelle	мицхелле	michelle
micronesia	микронезија	micronesia
miiràn	олакшати	another
mimoy	мимои	mimoy
mimuwa	прилијепити	import
minnesota	минесота	minnesota
minority	мањина	awon ara kekere
mohandas	мохандас	mohandas
mokaleladota	компактан	51, (mokanleladota)
mokanlelogbon	тридесет два	thirty-one
mombasa	момбаса	mombasa
monrovia	монровиа	monrovia
morgan	морган	morgan
morogoro	моторинг	morogoro
mozambique	мозамбикуе	mozambique
mozilla	мозилла	mozilla
mtn	мтн	mtn
mtwara	изаберите поново	mtwara
mughal	запремина	mughal
mulẹ̀	успоставити	establish
munispal	муниспал	municipal
muungano	муунгано	muungano
májèmú	не смета	testament
mère	цртање	significant
méjèèjì	обоје	the two
mérindíláàdóta	педесет пет	forty-six
méte	пет	lip
mérìndínlógún	шеснаест	sixteen
mérìnlélógójì	четрдесет четири	44
méta	три	three
métèètà	столар	the three
méwàá	десет	ten
ménu	да ли мислиш	verbally contribute; complete phrase= me nu ba
mímọ́	свети	holy
míràn	други	other
míìrán	други	other
mííràn	други	other
mò	знање	know
mókólà	лепак	mokola
móra	лек	with themselves
mó	м	with
múlẹ̀	држи чврсто	select land (farmland)
mẹ́fà	шест	6
mẹ́rkúríù	миш	mercury
mẹ́ta	три	3
mẹ́talọ́kan	тројство	trinity
namibia	доћи	namibia
nathaniel	натханиел	nathaniel
nato	нато	nato
nawojulo	загонетан	highest-spending
nawó	узми свој новац	point finger
ncnc	нцнц	ncnc
nebraska	небраска	nebraska
nefimu	непхим	nefimu
neptune	нептун	neptune
nevis	невис	nevis
ngbero	планирано	planning
ngubengcuka	нгубенгцука	ngubengcuka
nibe	тамо	there
nibere	рано	earlier
nigbakan	понекад	at one time
nigbà	онда	when
nijẹr	нике	niger
nilè	овде	remaining
nisinyi	сада	at present
nitoriidieyi	због овога	because of this
nitoripe	јер	because
nitosi	у близини	nearby
niwaju	напред	in front of
niyato	разликовати	unlike
niye	довољно	in number
niyi	ево га	these
nkan	ствар	things
nkàn	рак	something
nnaji	стриц	nnaji
nobel	нобел	nobel
nombamewa	множење	decimal
nombáméjì	прва два	two-number
novo	ново	novo
nri	храна	nri
nse	дизајн	acting
nso	близу	saying
nsolaboraro	сигурност	nso laboraro
nsowikipedia	обовикипедиа	saying
ntoka	тачка	indicates
nu	чист	in
nukleotidi	нуклеотид	nucleotides
nukleotidipupo	нуклеотид	cell
numeri	укоченост	numbers
nwa	беба	drill
nàìjíríà	у нигерији	nigeria
náwo	трошак	spend money
náà	такође	that
nì	планина	is
nìnú	извињавам се	in
nìyí	то је то	this is
ní	имати	on
níbè	тамо	there
níbè	тамо	there
nífẹ̀ẹ́	волети	love
nígbàtí	када	when
nílè	испод	on the ground
nílùú	у граду	in the town
nílẹ̀	на терену	in the land
nínlá	сјајно	large
nínu	шанса	in
níní	имати	having
nípà	барем	by
nítorípé	јер	because
nítumò	значење	meaningful
nítòsí	у близини	nearby
nítòótó	баш тако	truly
nítòótọ́	заиста	in truth, truthfully
níwájú	напред	in front
níyanjú	позитивно	solved
nǹkan	ствар	things
nso	долази ускоро	say
oba	обама	king
obairanderan	рођак	hereditary
obere	мала	started
obínibí	учтивост	inborn
ododo	праведност	righteousness
ofin	закон	law
ogbè	регион	a divinity
ogun	рата	war
ogunlogo	гомила	hundreds
ojo	изгледати	day
ojojumo	дневно	daily
ojoru	топлина	wednesday
ojukokoro	похлепа	covetousness
ojuoorun	залазак сунца	atmosphere
ojuse	одговорност	responsibility
ojùkòsì	падавине	ojukosi
ojùkòtúu	падавине	ojukotuu
ojúlùmọ̀	познанства	acquaintance
ojútáyé	вискозитет	public
ojúìwé	страна	page
okeere	у иностранству	distant
okhotsk	окхотск	okhotsk
oko	поље	farm
okunkun	тама	darkness
okunrin	човек	male person
olodiajodojuko	један другог	facing wall
olohun	власници	god
olojukanna	одмах	same surface
olokunkun	слушалице	popular
ololugbe	губитник	occupants
olopon	узвишен	a local game
olora	дебео	fertile
oloselukan	здраво	one political
oloye	генијално	chief
oluda	творац	creator
oludase	произвођач	separatist
olukoitan	инструктор	the writer
olukowe	аутор	writer
olumojuto	похлепни	overseer
oluparapo	комбинација	joint
olusoju	чувар	ambassador
oluwakiri	истраживање	explorer
olympus	олимпус	olympus
olódùmarè	свемоћни	almighty god
olóyè	лењир	chief
olóṣèlú	политичар	politics
olùbátan	овај контакт	relative
olùdarí	вођа	director
olùkópa	сарадник	participant
olùkó	инструктор	teacher
olùkọ́	учитељ	teacher
omi	вода	water
omiadalu	поплава	mixture
onialjebra	ониаљебра	of algebra
onibugbe	станар	population
onigbeja	конструктивно	allied
onigbowo	спонзор	sponsor
onigunfenfe	пасиван	large angle
onilanaibagbepo	кондом	constitutional
onilile	власници домова	solid
oninawo	дужник	financial
onipin	рационално	even
onisayensi	техничар	scientific
onisowo	трговац	trader
oniyewumeji	бинарни	two-chamber
oniyijulo	феноменално	highest honour
onje	дијета	food
onka	калкулатор	counter
onígbàgbó	старац	believer
oníkólóbó	увредљив	onikolobo (place)
onílẹ̀	доле	land owners; citizens (omo onile)
oníná	ватра	electronic
onítumò	преводилац	meaning
onítèbọmi	крштени	baptist
onítòhùn	рачуновођа	that person
oníwòsàn	исцелитељ	doctor
oníyanjù	анимирани	persevere
ooni	крокодила	ooni (king)
ootọ́	истинито	truth
opec	опец	opec
opposite	супротно	odi
ori	глава	top
oriire	честитам	success
oriki	оријентални	name of endearment
orileede	нација	country
orileedeajoba	империјализам	monarchic country
orilejoba	влада	seat of government, kingdom
orileominira	топлина	republic
orinìyìn	песма	songs of praise
orisirisi	разноликост	various
orisun	извор	source
orisa	порекло	god
oritameta	у средини	crossway
orudnun	годишње	mispelled...should orundun, century
oruko	именица	name
oríilè	национална	land
oríilẹ̀	чланак	land
oríkì	поезија	family name
orílèèdè	нација	country
orílẹ̀	нација	continent
orílẹ́	вече	nation
orísiirísi	разне	various
orísìí	разноликост	type
orísìírísi	различити типови	various
orúko	поље	name
oscar	осцар	oscar
oseluarailu	цивил	political unit
otherwise	иначе	ibaje
otutu	многи	coldness
oun	он	it
owojagidijagan	терористи	upheaval
oúnjẹ	храна	food
odún	година	year
ojó	је кишовито	day
okùnrín	смех	man
olórun	бог	god
olósìn	религиозни	rearing
odun	годишње	year
olorun	бог	god
omonìyàn	људска бића	human beings
opolo	многи	brain
ose	осе	week
oyé	свет	harmattan
ofò	добро јутро	nothingness
opolo	многи	brain
paa	искључи	back
paapaa	посебно	especially
padá	под	go back
palauan	палауан	palauan
panaˈma	панаˈма	panama
panyanan	простор	spanish
papa	тата	specifically
parapọ̀	мешавина	join
paripari	крај	finally
pele	шармантан	hello
penh	пенх	penh
penisula	пенисула	peninsula
periferi	перифери	periphery
petu	пету	resolve
pelu	бисер	with
phillipines	филипини	phillipines
pinsi	опада	divided
pinsoto	пиното	separated
pinu	одлучно	decide
pipo	много	plenty
pipolongo	реклама	publicise
piposi	много	multiplication
platos	платос	plato's
plánẹ́tì	водовод	planet
po	по	share
pojulo	највише	larger
polandi	пољски	poland
polaroid	полароид	polaroid
population	популација	ero
portonovo	портоново	porto novo
portuguese	португалски	portuguese
press	притисните	press
produced	произведено	yo
protokolu	протоцолу	protocol
proton	протон	kemika alaropo
providence	провиђење	providence
príncipe	принципе	principe
pupa	црвено	red
px|kùránì	пк | кернел	koran or quran; the px  does not belong
pàmò	тачније	pamo (town)
pàràkòyí	одмах	parakoyi
pààlà	граница	signalised
pàápàá	посебно	especially
pásíà	подрум	persia
pátáporongodo	апсолутно	entire
pè	звани	that
pèhìndà	сперма	turned back
pèlu	упоредо са	with
pèlúpèlú	такође	in addition
pèsè	под условом	provide
pé	то	that
péré	само	only
péé	то	that
pípa	клања	order
pípèsè	обезбеђивање	providing
pípẹ́	дуго	long
pòwe	пословице	to say a proverb or wise saying
pò	пресавити	join
púpo	превише	much
púpò	радије	a lot
quran	кур&#39;ан	quran
ra	купити	self
race	трка	ere
rajya	надати се	rajya
ramadan	рамадан	ramadan
rank	чин	ipo
reggae	реггае	reggae
repeats	понавља	tunso
repetejulo	најосетљивија	most of all
rere	добро	success
research	истраживање	agbeyewo
richard	рицхард	richard
right|thumb|px|aworan	десно | палац | пк | слика	picture
rinle	ново	emphasise
riresile	диктафон	humbled, lowered
riro	машта	thought as
rn	рн	rn
rna	рна	rna
rnarna	рнарна	rna-rna
rnas	рнас	rnas
ro	мисли	thought
robinson	робинсон	robinson
roboto	површине	round
rogbodiyan	неред	riot
rokirika	прегледавање	publicise
roko	банда	farm work
roma	роми	roma
rome	хром	rome
ronald	роналд	ronald
rorùn	лако	easy
rossii	россии	rossii
rural	сеоски	igberiko
ryan	рајан	ryan
ráhàn	појавио	complain
ránmú	забринути	grumble
république	републикуе	republic
ré	ц	his/her
rìn	шетати	should be orin, song or music
ròyìn	известио	give account
rẹ	њеној	it
saarc	уклони	saarc
saaree	супериорни	after death
saarland	на поду	saarland
safari	сафари	safari
saffana	сафир	savannah
safiwe	поређење	describe
safta	ређати	safta
saheli	погодност	sahel
sakyamuni	следећа	sakyamuni
sakyas	сакиас	sakyas
salem	салем	salem
salàyé	живот	explained
sambia	младост	zambia
samioro	на располагању	signal
santa	санта	santa
say	реците	so
sb	сб	sb
schwarz	сцхварз	schwarz
sea	море	odo
seat	седиште	itedo
segbese	вероватно	take steps
seidamo	јасно	identify
semolara	астма	accustom
semudaju	наравно	assure
senegal	сенегал	senegal
sense	смисла	sensi
seville	севилле	seville
sewadi	претрага	investigate
sharon	схарон	sharon
sibesibe	још	further more
sihamoni	структура	sihamoni
sile	иза	previously
silè	капи	on the ground
sinai	грех	sinai
sinsin	религија	unshakably
sioux	сиоук	sioux
sise	кување	works
sisodagba	одрастање	came of age
sisopo	повезивање	joined
sisupapoerekusu	пљување	neighbouring islands
sisupo	множе се	concentrated
slovo	слово	slovo
so	љубав	turned
sohun	да	something
solomon	саломон	solomon
soon	ускоро	lai'pe
sopin	крај	ended
so	тако	tells
spectacular	спектакуларно	damanran
stella	стелла	stella
structures	структуре	igbekale
suez	суез	suez
sugbo	али не	but
sugbọ́n	рационално	but, however
sun	сунце	sleep
suny	суни	suny
swahili	свахили	swahili
symmetry	симетрија	ogbooga
sàbúrí	изнад свега	saburi
sàmì	знак	signalize
sàn	боље	flow
sàngó	банда	sango (god of thunder)
sàì	добро	un
sápadè	овај дан	run to
sáàpàdé	спонзорство	saapade
sáààrin	између	between
são	нова	sao
sèle	крађа	down
ségun	плакати	conquered
sénégal	сперма	senegal
séyìn	назад	back
séyìn	назад	at the back of
sìbẹ̀	још	there
sìni	козице	likewise
síbèsíbè	ипак	further more
síbú	на земљу	ocean
sílẹ̀	изневерити	drop
síse	посао	doing
síso	још увек	spoken
síso	још увек	saying
síta	напољу	outing
síwon	њих	to them
síwájú	па надаље	comes before
síí	овде	on it
sòrò	испирање мозга	talk
sójà	војник	soldier
sóko	биљка	to the farm
sùgbón	напротив	but
sọ	реците	lose
si	сигурно	to
síse	структура	performing
sùgbón	напротив	but
se	раде	do
sepò	напокон	cooperation
sisé	разрадити	work
sááju	узми минут	before
sísa	с .иа	to be
sísè	превод	step
tabi	или	or
tabili	сто	table
tabora	избегавање	tabora
taino	дино	taino
tainos	таинос	tainos
takuntakun	ограничења	valiant
talaka	сиромашан	poor
talika	сиромаштво	the poor
tara	девет	wholly
tata	филтер	wildly
taínos	таинос	tainos
technology	технологија	tekinoloji
tedo	упознавање	stay
teksas	текас	texas
tele	пратити	before
temptation	тражећи	idanwo
terutomo	терутомо	everybody
tfrac	тфрац	tfrac
the	тхе тхе	does no directly translate
they	они	won
those	оне	awon
thumb|left|upright|nelson	палац | лево | усправно | нелсон	apa osi naro
tira	напет	quranic verse
tirana	тирана	tirana
tirè	његов	own
titu	пуцај	cold (if it's a person's name, it is tutu)
tiwọn	њихов	theirs
to	до	it
toje	ретко	that is
tokasi	истакао	pointing to
tokyo	токио	tokyo
tolerejulo	толерисано	most profitable
tolórítelémù	холокауст	all manners of people
tomé	парадајз	tome
tooto	стварно	true
tori	тори	because
torun	бринета	heavenly
toseluaralu	политичка	political
tounsejanu	трагичан	control
traduite	традуит	traduite
translated	преведено	tunmo
tumosi	значи	means
tuntun	нова	new
tàsí	без	or
tàwon	њих	theirs
táawà	клањати се	we
tèlé	пратити	before
tètè	брзо	quickly
tèlé	одмах	follow
tèsíwájú	напредовати	progress
té	т	follow
télè	од стране	before
té	т	shamed
títi	затворено	till
títèlé	пратити	following
títío	све док	until
tíátà	карте	theater
tíórì	гуме	that is seen
tò	комплет	enough
tóbi	велика	big
tódárajùlọ	најбоље	most beautiful
tókù	почивај	others
tówùú	било који износ	whatever
tó	то	taught
tóka	навео	pointed
tú	излити	untie
túmò	шљива	means
túnse	преуредити	restructured
tẹ̀ǹbẹ̀	онда	rivalry
tẹ̀ǹbẹ̀lẹ̀kun	удруживати	bitterness
ucb	уцб	ucb
umueri	деца	umueri
unifasiti	универзитет	university
unla	да	great
urasílì	урацил	uracil
uribe	аура	uribe
usps	успс	usps
utah	утах	utah
utc	утц	utc
uzbek	начин	uzbek
venezuela	венезуела	venezuela
vermont	вермонт	vermont
victor	вицтор	victor
videos	видео	fidio
vihara	вихара	vihara
villa	вила	villa
viruses	вируса	awon eran
visit	посета	ibewo
vz	вз	vz
waa	то је	ours
waju	лице	future
wari	мирис	once existing
westminster	вестминстер	westminster
wisconsin	висцонсин	wisconsin
witkin	духовитост	witkin
wiwari	откриће	discovered
województwo	цхеворддзтво	wojewodztwo
wole	пријавите се	into
woo	воо	look
wo	овде	enter
wo	овде	look
won	њих	they
wura	злато	gold
wyoming	виоминг	wyoming
wàásù	проповиједати	preach
wì	спрати	that
wípè	јасноћа	that
wòfún	поглед	convenient
wònyí	су	these
wón	њих	they
wúnrèn	разрадити	small amount
wọn	њих	they
wọ̀nyí	ове	these
xd	кд	xd
xiv	кив	xiv
yafran	абецеда	yafran
yakubu	иакуб	yakubu
yan	одаберите	choose
yanjú	ријешити	solve
yanturu	доста	abundant
yaoundé	иаоунде	yaounde
yewo	побољшање	examine
ye	да	suitable
ye	да	should
yindinyindin	никад не одустајте	brightly
yio	ће	will
yiowu	хоће	any
yipada	окрени се	change
yiyafunnilo	ерозија	borrow
yoo	воља	will
yori	лед	result
york	иорк	york
yorúbà	јогурт	yoruba
yo	ио	remove
yànan	запрепашћење	scattered
yàtò	поставити	other than
yára	пожури	quickly
yèwò	погледај	examine
yée	пусти их	eplained to
yì	иди	this
yìí	ово	this
yí	окрени се	this
yíyípadà	промена	changed
yíì	хоћеш	this
yíò	хоће	it will
yẹ̀ẹ́	знате	check
yọ	уклони	bring out
zanzibar centralsouth	занзибар централсоутх	zanzibar centralsouth
zdna	здна	z-dna
zou	зоу	zou
zscores	зсцорес	z-scores
zy	зи	zy
 bce	далеко	bce
àbe	бабуна	under
àbámẹ́ta	четвртак	saturday
àbáyo	предлог	breakthrough
àbìkú	бесмртност	'born to die' child
àbọ̀	половина	result
àdámò	приватност	earmark
àdátá	супротно	adata
àdáátán	ексклузивно	adaatan
àdóolóró	уље	bomb
àgbàjọ	старац	assembly
àgbàrá	поплава	power
àgbáríjọ	организација	combination
àgbékà	апстрактан	suitable
àgbéyèwò	преглед	examination
àgbìgbò	комшилук	a type of bird
àgbùdo	двориште	corn
àgọ́	шатор	ago
àifète	сврха	unable to keep quiet
àjo	путовати	board
àjákọ	одвојено	ajako
àjọṣepọ̀	социјални	union
àkosílè	одвајање	written
àkosílè	теза	written account
àkàrà	колачи	bean pudding
àká	полице	store
àkójopò	група	collection
àkókó	време	previous
àlàkalè	циљеве	breakdown, explanation of actions
àlàyé	информације	explanation
àlàáfíà	мир	peace
àlááfià	аналогија	wellbeing
àlè	копиле	mistress, concubine, (side booty)
àlèpò	горе	joined together
àlébù	мана	ills
àmérìkà	натприродно	america
àmì	потпиши	sign
àmúlò	практичан	synonyms
àmúsorò	психологија	resources
ànfàní	прилика	opportunity
àpapọ̀	у целини	federal
àpeere	пример	example
àrígbámú	узнемирујуће	assistant
àrùn	болест	disease
àrẹ	председник	president
àse	гозба	authority
àsàjemátèe	зора	cunning
àsèyìn	послије	at the end
àsìkò	време	time
àsótélè	продужетак	prophecy
àsọdọ̀kan	јединство	unitary
àsekúdórógbó	лавеж	do or die
àsà	обичај	habit, culture, norm
àtijo	застарио	olden days
àtìpó	ванземаљац	sojourn
àtòrìnká	кружни ток	urinating while walking
àtúnse	уредити	modification
àtúnse	уредити	renovate, fix
àtẹnudẹ́nu	орално	oral
àwon	теорије	they
àwón	новац	the
àwón	новац	the
àwùjo	друштво	community
ààtò	ритуал	suitability
ààyè	жив	space
àárín	у средини	middle
àáyá	сперма	seconds
àìkó	недостатак	unlearned
àìní	желим	lack
àìròtélè	неочекивано	unthought of
àìsí	одсуство	lack
án	т	it
áwon	блуд	those
èbà	комарци	cassava flour food
èbúté	лука	shore
èdá	стварање	creature
èdè	језик	language
èdè	језик	language
èfòn	напет	efon
èhìn	следећа	outskirt
èka	огранак	branch
èkejì	други	second
èlò	посуђе	tool
ènìkan	нешто	someone
èràn	болест	virus
èrò	мисли	thoughts
èsó	џамија	modesty
èsúrú	мрави	yam (indigenous to west africa)
ète	сврха	plan
èyì	достојанство	this
èka	ефекат	branch
èro	мисли	machine
èrí	доказ	witness
èsìn	религија	religion
èwù	кошуља	clothe
èpón	много	modifier
ìbarà	грозница	ibara (town)
ìbánisòrò	конекција	dialogue
ìbáraeni	кочија	to themselves
ìbílè	право рођења	local
ìbílè	право рођења	local
ìdàgbà	зрелост	grow
ìdàpapọ̀	консолидација	union
ìdàrúdàpò	хаос	misunderstanding
ìdá	десертион	division
ìdìmú	узнемиреност	branch, part
ìdíisin	узрок	idi-isin
ìdíwòn	твој разлог	criteria
ìdó	убод	ido (a person's name)
ìfara	мучење	self
ìfojúìtànìgbesiayé	животна историја	biography
ìfáàrà	свештеник	introduction
ìgbonnìbí jé	то је катастрофа	igbonnibi
ìgbà	време	when
ìgbàgbé	заборавни	forgetfulness
ìgbá	крила	time
ìgbáraga	снага	pride
ìgbéraga	понос	pride
ìgbésí	живот	life
ìgbò	рам	igbo people
ìhun	гвожђе	things
ìjo	плес	church
ìjo	црква	church
ìjoba	влада	government
ìjora	мрзе	resemblance
ìjìnlè	мистерија	comprehensive
ìjìnlè	мистерија	mysterious
ìjò	вођа	consent
ìjọba	влада	government
ìkejì	други	second
ìkànna	исти	ikanna (town)
ìkèrèkú	загушења	ikereku
ìkéde	декларација	advert
ìkìjà	изазов	ikija
ìkìlò	злоупотреба	warning
ìkínin	шести	greetings
ìkẹrin	четврти	fourth
ìkọpa	учешће	ikopa
ìlera	здравље	health
ìlo	позив	use
ìlà	контура	border
ìlànàn	илузија	procedure
ìlàorùn	модрице	east
ìlàìnàró	угњетавања	vertical
ìlè	подмићивање	land
ìlé	кућа	land
ìmò	змија	knowledge
ìmò	муња	knowledge
ìmóbìdo	право рођења	imobido
ìmú	нос	knowledge
ìmúnilérú	злоупотребе	slavery
ìmúsára	да ојача	contagious
ìnagije	победа	alias
ìnáwó	издаци	expenditure
ìpolongo	оглашавање	advertisement
ìpìlẹ̀núkléù	шифровање	base
ìpìnlè	почетак	foundation
ìpínrò	параграфе	economize
ìrànlọ́wọ́	помоћ	help
ìrànàna	помоћ	path-clearing
ìràwọ̀	звезде	s
ìrí	искуство	sight
ìròkò	мисао	iroko
ìròyìn	вести	news
ìròyìnwiki	вести	wikinews
ìròrùn	илузија	peaceful
ìró	звук	sound
ìrúbo	колапс	sacrifice
ìsawo	гатање	divinity-practice
ìse	поступак	behaviour
ìsinsìnyí	сада	modern
ìsirò	прорачун	adding
ìsomó	придружити се	attachment
ìsàlè	залазак сунца	down town
ìsèlè	производња	happening
ìsìn	религија	worship
ìsòrò	медитација	speech
ìsòrí	подброј	chapter
ìsú	дебљина	lump
ìsọ	продавнице	stall
ìse	поступак	work
ìsègbèfábo	марљивост	female support
ìsèdá	стварање	creation
ìsèjoba	влада	government
ìsílé	кућа	house opening
ìsòro	потешкоће	problem
ìse	поступак	action
ìta	напољу	outside
ìtaeko	радионица	outskirts of eko
ìtan	историја	story
ìtokò	лонац	story
ìtàn	историја	history
ìtànkálé	поплаве	spread
ìtèsíwájú	напредак	progress
ìtójú	нега	treatment
ìtóju	конфузија	treatment
ìtójú	изрази лица	treatment
ìtóka	да се туку	dictionary
ìtúmò	превод	meaning
ìtúpalè	превод	exposition
ìwe	поређење	book
ìwo	рогови	horn
ìwàásù	проповедање	sermon
ìwéré	брошура	iwere (town)
ìwò	уопште	set
ìwòran	визија	viewing
ìwúlò	корисно	usefulness
ìya	патња	mother
ìyapa	раздвајање	divorce
ìyàwó	млада	wife
ìyípadà	конверзија	transformation
ìṣèlú	политика	politics
ìṣẹ́kù	остатак	broken
ìṣọ̣̀tẹ̣̀	упала плућа	rebellion
òde	напољу	society
òdeojú	без лица	surface
òdo	младост	zero
òdìkejì	други	opposite
òféàrán	слика	a town name
ògbójú	надлежни	brave
ògiri	зид	wall
ògo	слава	glory
ògun	лек	medicine
ògúndìpẹ̀	прашкаст	ogundipe
òjo	изгледати	ojo
òjísé	доктор	servant
òkèògbún	хиљаду	oke-ogbun
òkòòkan	један по један	each
òkú	лешеви	corpse
òkúta	камен	stone
òle	домаћице	lazy
òmiràn	чаробница	other
òmùàrán	слика	omu-aran (town)
òní	данас	today
òotó	истина	true
òpópóònà	пут	highway
òranyàn	обавезно	a must
òrìsà	идоли	god
òrí	поглавље	top
òrò	мозак	word
òsán	подне	afternoon
òsèlú	политичар	politics
òsèré	атлета	player
òwù	платно	owu
òṣèlú	политика	politician
òjògbón	кишовито време	learned person
òkan	једно	heart
òkòòkan	један по један	each
òpòlopò	многи	many
òré	игра	friend
òfò	следећа	sorrowful
òpòlopo	многи	lot of
òré	игра	friend
òrò	мисли	word
òsà	златна рибица	lagoon
òwó	новац	hand
òrò	мисли	word
òròàjòmó	ујутро	part of speech
ó	то	that
óníse	он је дизајнер	stricken
ósírísì	пљувачка	diverse
ósékú	он је мртав	die suddenly
ó	да	word
ôdún	година	year
únṣẹlẹ̀	земљотрес	formed
şe	урадити	do
ʔaːnaːtɕɑ̀k	.аːнаːтɕɑɕɑк	not yoruba
ˈøːstəˌʁaɪç	ˈøːстәˌʁаɪц	austria
ˌkælɪˈfɔrnjə	ɪˈкӕлɪˈфɔрњә	not yoruba
ˌæləˈbæmə	болест	not yoruba
κάππα	.α	does not translate
σ	σ	does not translate
ṣiṣé	отварање	work
ṣàkóbá	штетно	incriminate
ẹdo	шала	edo
ẹlẹ́bùn	поклон	award winner
ẹlẹ́sìn	религиозни	religionist
ẹnìkan	једна особа	someone
ẹsẹ	стопала	verse
ẹtì	јетра	friday
ẹ̀kaawon	поднесци	branch of
ẹ̀kabrítánì	стриц	part of britain
ẹ̀kajuly	може	chapter july
ẹ̀kaoṣù	трновит	month
ẹ̀kasístẹ̀mù	субјективни	sistemu=system
ẹ̀kẹ́ta	трећи	third, the third
ẹ̀kọ́	образовање	teachings
ẹ̀ni	ко	person
ẹ̀rọ	машина	machine
ẹ̀wẹ̀	с друге стране	leaf
ọbàkàn	полубрат	step-sister
ọdún	године	year
ọlọ́mọ	деца	members
ọlọ́run	бог	god
ọmú	лош си	breast
ọmọ	дете	c
ọn	то	him
ọpọ́lọpọ́	смокве	many
ọ̀dọ́	младост	youth
ọ̀gbìn	биљка	seedlings
ọ̀nà	начин	ways
ọ̀pòlòpò	поступак	various
ọ̀rọ̀	причај	word
ọ̀sẹ	недеља	week
