$	$	Nan
عانى	jiya	Nan
عبادة	jọsin	Nan
عبارة	gbolohun ọrọ	Nan
عباس	abbas	Nan
عبد	ẹrú	Nan
عبده	ẹrú	Nan
عبر	nipasẹ	Nan
عبرانيون	heberu	Nan
عبور	líla	Nan
عبيد	ẹrú	Nan
عبيدة	obaida	Nan
عتبة	àbáwọlé	Nan
عثر	ti ri	Nan
عثمان	othman	Nan
عثمانية	ilu ottoman	Nan
عانت	o jiya	Nan
عجائب	awọn iyanu	Nan
عامًا	ọdun	Nan
عامي	iṣọkan	Nan
عاصمتها	olu ilu rẹ	Nan
عالم	onimọn-jinlẹ	Nan
عالمي	ayé mi	Nan
عالميا	ni kariaye	Nan
عالمياً	ni kariaye	Nan
عالمية	international	Nan
عالي	ga	Nan
عالية	giga	Nan
عام	odun	Nan
عاما	awọn ọdun atijọ	Nan
عاماً	odun	Nan
عامة	gbogbogbo	None
عامر	amer	Nan
عامل	o daju	Nan
عاملاً	a ifosiwewe	Nan
عاميّ	slang	Nan
عاصمته	olu rẹ	Nan
عدا	ayafi	Nan
عدد	nọmba	Nan
عرضت	ti a nṣe	Nan
عرضه	ifaragba	Nan
عرضها	fihan	None
عرف	o mọ	Nan
عرفات	arafat	Nan
عرفة	arafa	Nan
عرفت	mo ti mọ	Nan
عرفوا	wọn mọ	Nan
عروة	taabu	Nan
عز	olodumare	Nan
عزل	ìyàraẹniṣọtọ	Nan
عزم	ipinnu	Nan
عزيز	olufẹ	Nan
عسكري	ọmọ ogun	Nan
عسكرية	ologun	Nan
عرضة	ifaragba	Nan
عدة	lọpọlọpọ	Nan
عرض	fihan	None
عربية	dè lárúbáwá	Nan
عددا	nọmba kan	Nan
عدداً	nọmba kan	Nan
عددها	nọmba wọn	Nan
عددهم	nọmba wọn	Nan
عددًا	nọmba kan	Nan
عدل	ododo	None
عدم	rara	Nan
عدن	àgbà	Nan
عدنان	adani	Nan
عدوى	akoran	Nan
عدي	oday	Nan
عديدة	lọpọlọpọ	Nan
عدّة	lọpọlọpọ	Nan
عرب	awọn ara larubawa	Nan
عربي	dè lárúbáwá	Nan
عرش	itẹ	Nan
عاصمة	olu	Nan
عاصم	ṣe apejọ	Nan
عاصفة	ìjì	Nan
طلاب	awọn ọmọ ile-iwe	Nan
طلال	talal	Nan
طلب	beere	Nan
طلبة	awọn ọmọ ile-iwe	Nan
طلبت	beere	Nan
طلبه	ibeere rẹ	Nan
طلحة	talha	Nan
طن	awọn agogo	Nan
طنجة	tangier	Nan
طه	taha	Nan
طهران	tehran	Nan
طوائف	awọn ẹgbẹ	Nan
طوال	jakejado	Nan
طور	dagbasoke	None
طورت	ni idagbasoke	Nan
طلائعيات	aṣáájú ọ̀nà	Nan
طول	gigun	Nan
طقوس	irubo	Nan
طفل	ọmọ	None
طبيعية	adawa	Nan
طرابلس	tripoli	Nan
طراز	ara	Nan
طرازات	ki asopọ	Nan
طرح	yọkuro	Nan
طرد	gba	None
طرف	ẹgbẹ	Nan
طرفاوية	ebute	Nan
طرق	awọn ọna	Nan
طرول	awọn iṣọn	Nan
طريق	ọna	Nan
طريقة	ọna	Nan
طريقه	ọna	Nan
طريقها	ọna rẹ	Nan
طعام	oúnjẹ	None
طفولته	ti ewe rẹ	Nan
طولها	gigun rẹ	Nan
طويل	gun	None
طويلا	gun	None
عابرة	gbigbe	Nan
عاد	ti pada	Nan
عادات	awọn iṣe	Nan
عادة	ewu	Nan
عادةً	ewu	Nan
عادت	o pada	Nan
عادل	o kan	Nan
عادوا	wọn pada wa	Nan
عادي	deede	Nan
عادية	deede	Nan
عارض	oluwo	Nan
عارف	mọ	Nan
عاش	gbe	None
عاشت	o ngbe	Nan
عاشوراء	ashura	Nan
عائلته	ebi re	Nan
عائلة	ẹbi	Nan
عائلات	idile	Nan
عائشة	aisha	Nan
طويلاً	gun	None
طويلة	gun	None
طيبة	irú	Nan
طيران	ofurufu	Nan
طيلة	jakejado	Nan
طيور	awọn ẹyẹ	Nan
ظاهر	gbangba	Nan
عسل	oyin	Nan
ظاهرة	lasan	Nan
ظل	iboji	Nan
ظلت	ti wa	Nan
ظهر	pada	Nan
ظهرت	han	Nan
ظهره	ẹhin rẹ	Nan
ظهور	irisi ti	Nan
ظواهر	phenomena	Nan
ظروف	awọn aye	Nan
طبيعي	àbínibí	Nan
عسير	nira	Nan
عشر	mẹwa	Nan
عندما	nigbawo	Nan
عنده	ni	Nan
عندها	lẹhinna	Nan
عندهم	wọn ni	Nan
عنصر	ohun kan	Nan
عنق	ọrùn	Nan
عنه	nipa rẹ	Nan
عنها	nipa rẹ	Nan
عنهم	nipa wọn	Nan
عنهما	nipa wọn	Nan
عنوان	akọle	Nan
عني	nipa mi	Nan
عنيفة	iwa-ipa	Nan
عهد	majẹmu	Nan
عهده	ihamọ	Nan
عندئذ	lẹhinna	Nan
عهود	awọn majẹmu	Nan
عند	ni	Nan
عنترة	antara	Nan
عمليات	awọn iṣiṣẹ	Nan
عملية	ilana	None
عمه	arabinrin	Nan
عمود	òpó	Nan
عموم	pan	Nan
عموما	ni gbogbogbo	Nan
عموماً	ni gbogbogbo	Nan
عمومًا	ni gbogbogbo	Nan
عمير	amir	Nan
عميق	jinjin	Nan
عميقة	jin	Nan
عمّان	oman	Nan
عن	nipa	Nan
عناصر	awọn ohun	Nan
عناية	ifarabalẹ	Nan
عنخ	ankh	Nan
عملها	iṣẹ rẹ	Nan
عواصم	awọn akọle	Nan
عوامل	okunfa	Nan
غازات	awọn ọya	Nan
غازي	gase	Nan
غالب	ghalib	Nan
غالبا	nigbagbogbo	Nan
غالباً	nigbagbogbo	Nan
غالبية	ni opolopo ti	Nan
غالبًا	nigbagbogbo	Nan
غاما	gamma	Nan
غاميلان	gamilan	Nan
غاندي	gandhi	Nan
غانم	ghanem	Nan
غاية	opin irin ajo	Nan
غباء	omugo	Nan
غذاء	oúnjẹ	None
غرار	fẹran	Nan
غاز	gaasi	Nan
عواقب	awọn abajade	Nan
غار	laurel	Nan
غابات	igbo	Nan
عودة	sẹhin	Nan
عودته	ipadabọ rẹ	Nan
عوف	aouf	Nan
عيد	ajọ	Nan
عيسى	essa	Nan
عين	oju	Nan
عينات	awọn ayẹwo	Nan
عينيه	oju rẹ	Nan
عيون	oju	Nan
عَلَى	ali	Nan
عَلَيْهِ	lori rẹ	Nan
عُثر	ti ri	Nan
عُرف	o mọ	Nan
عُرفت	o mọ	Nan
عُمان	oman	Nan
غادر	osi	Nan
عمله	owo	Nan
عملت	mo ti ṣiṣẹ	Nan
عملة	owo	Nan
عظيم	nla	Nan
عظيمة	nla	Nan
عفان	affan	Nan
عفص	tannery	Nan
عقارب	ọwọ	Nan
عقب	lẹhin	Nan
عقبة	idiwọ	Nan
عقد	ẹgba kan	Nan
عقدت	gbọdọ	Nan
عقل	lokan	Nan
عقوبة	ijiya	Nan
عقود	ọsẹ	Nan
عقيدة	ẹkọ	Nan
عكا	acre	Nan
عكس	yiyipada	Nan
عظمى	egungun	Nan
علاء	alaa	Nan
عظمة	titobi	Nan
عظام	egungun	Nan
عشرات	mewa	Nan
عشرة	mẹwa	Nan
عشرية	apẹrẹ	Nan
عشرين	meji	Nan
عصام	agbasọ	Nan
عصبة	ajumọṣe	Nan
عصر	fun jade	Nan
عصره	igba rẹ	Nan
عصور	eras	Nan
عصير	oje	Nan
عضوا	ọmọ ẹgbẹ	Nan
عضواً	ọmọ ẹgbẹ	Nan
عضوية	ẹgbẹ	Nan
عطارد	makiuri	Nan
عطلة	isinmi	Nan
عظم	eegun	Nan
علاج	itọju ailera	Nan
علاقات	ẹbí	Nan
علاقاتها	awọn ibatan rẹ	Nan
عليهم	lori wọn	Nan
عليهما	lori wọn	Nan
عليّ	ali	Nan
عم	aburo	Nan
عما	nipa	Nan
عماد	emad	Nan
عمال	awọn oṣiṣẹ	Nan
عمان	oman	Nan
عمد	ṣe ìrìbọmi	Nan
عمر	omar	Nan
عمره	ti ọjọ ori rẹ	Nan
عمرو	amr	Nan
عمق	ijinle	Nan
عمل	iṣe	Nan
عملاق	omiran	Nan
عليها	lori rẹ	Nan
عليه	lori rẹ	Nan
علينا	àwa	Nan
عليكم	lórí ẹ	Nan
علاقة	ibasepo	Nan
علامات	awọn ami	Nan
علامة	ami	Nan
علاوة	ajonirun	Nan
علاوةً	pẹlupẹlu	Nan
علم	imọ	Nan
علما	akiyesi	Nan
عش	gbe	None
علماء	awọn ọjọgbọn	Nan
علماً	akiyesi	Nan
علمه	imo re	Nan
علمية	ijinle sayensi	Nan
علوم	awọn sáyẹnsì	Nan
على	tan	Nan
علي	ali	Nan
عليك	lórí ẹ	Nan
علمانية	ipanilaya	Nan
طبيعة	iseda	Nan
طبية	egbogi	Nan
طبيب	dọkita kan	Nan
شخصيته	ihuwasi rẹ	Nan
شداد	tightening	Nan
شديد	intense	Nan
شديداً	gan gan	Nan
شديدًا	gan lile	Nan
شراء	ra	None
شراكة	ajọṣepọ	Nan
شرب	mu	Nan
شرج	anus	Nan
شرح	se alaye	Nan
شرط	majemu	Nan
شرع	tẹsiwaju	Nan
شرعية	t’olofin	Nan
شرف	kj iyi	Nan
شرق	ila-oorun	Nan
شخصية	ohun kikọ	Nan
شرقا	ila-oorun	Nan
شخصيات	awọn aṣapẹẹrẹ	Nan
شحنة	gbigbe	Nan
شامل	okeerẹ	Nan
شاملة	pẹlu	Nan
شاه	shah	Nan
شاهد	wo	Nan
شاهين	shaheen	Nan
شباب	odo	Nan
شبابه	ti ọdọ rẹ	Nan
شبكات	awọn nẹtiwọki	Nan
شبكة	nẹtiwọọki	Nan
شبه	kanna	Nan
شبيه	fẹran	Nan
شبيهة	iru si	Nan
شتى	oniruru	Nan
شجرة	igi	Nan
شجع	iwuri	Nan
شخص	eniyan	Nan
شامة	moolu	Nan
شرقاً	ila-oorun	Nan
شركات	awọn ile-iṣẹ	Nan
شعوب	eniyan	Nan
شغل	kun	Nan
شق	lila	Nan
شقيقه	arabinrin	Nan
شك	iyemeji	Nan
شكل	fọọmu	Nan
شكلت	ti gbekale	Nan
شكله	apẹrẹ rẹ	Nan
شكلها	apẹrẹ rẹ	Nan
شمال	ariwa	Nan
شمالا	ariwa	Nan
شمالاً	ariwa	Nan
شمالي	ariwa	Nan
شمس	oorun	Nan
شمسية	oṣiṣẹ	Nan
شعره	irun	Nan
شرقي	ila-oorun	Nan
شعراء	awọn ewi	Nan
شعبية	gbaye-gbale	Nan
شركة	ile-iṣẹ kan	Nan
شروط	awọn ofin	Nan
شريط	tẹẹrẹ	Nan
شريعة	ofin	None
شريف	sherif	Nan
شريك	alabaṣepọ	Nan
شطرنج	chess	Nan
شعائر	rituals	Nan
شعار	logo	Nan
شعاع	ilẹ	None
شعب	eniyan	Nan
شعبان	shaaban	Nan
شعبة	abala	None
شعبه	abala	None
شعبي	gbajumọ	Nan
شعر	akewi	Nan
شاكلة	fẹran	Nan
شاكر	shaker	Nan
شاطئ	eti okun	Nan
سوري	ará síríà	Nan
سوريا	síríà	Nan
سورية	ará síríà	Nan
سوف	yoo	None
سوق	ọja	Nan
سومطرة	sumatra	Nan
سوى	ṣugbọn	Nan
سويسرا	switzerland	Nan
سي	k.	Nan
سيئة	buburu	Nan
سياحة	irin-ajo	Nan
سياحية	irin-ajo	Nan
سيادة	ọba aláṣẹ	Nan
سيارات	awọn ọkọ ayọkẹlẹ	Nan
سيارة	ọkọ	Nan
سورة	suratu	Nan
سياسات	awọn ilana imulo	Nan
سور	odi	Nan
سواحل	awọn agbegbe	Nan
سنغافورة	orílẹ̀ èdè singapore	Nan
سنن	sunan	Nan
سنه	odun	Nan
سنوات	ọdun	Nan
سنويا	ododun	Nan
سنوياً	ododun	Nan
سنوية	lododun	Nan
سنويًا	ododun	Nan
سنين	ọdun	Nan
سهل	rọrun	Nan
سهول	awọn pẹtẹlẹ	Nan
سهولة	irọrun	Nan
سهيل	suhail	Nan
سوء	aisan	Nan
سواء	boya	Nan
سوداء	dudu	Nan
سياسة	eto imulo	Nan
سياسي	oselu	Nan
سياسيا	oselu	Nan
سيناء	sinai	None
شأن	nkan	None
شأنه	yoo	None
شأنها	fẹran	Nan
شؤون	oro	Nan
شئون	oro	Nan
شاء	o fẹ	Nan
شائع	wọpọ	Nan
شائعة	agbasọ	Nan
شارع	st	Nan
شارك	pin	Nan
شاركت	mo kopa	Nan
شارل	charles	None
شاسعة	onjẹ	Nan
شاش	gauze	Nan
سيما	paapa	Nan
سيلينيوم	seleni	Nan
سيكون	yio je	Nan
سيكلامين	cyclamen	Nan
سياسية	oselu	Nan
سياق	ọrọ-ọrọ	Nan
سيتم	yio je	Nan
سيتي	ilu	Nan
سيد	ọgbẹni	Nan
سيدة	arabinrin	Nan
سيدي	sir	Nan
شمل	ni	Nan
سير	rìn	None
سيرته	itan igbesiaye re	Nan
سيطر	mu iṣakoso	Nan
سيطرة	iṣakoso	Nan
سيطرت	mu iṣakoso	Nan
سيطرتها	iṣakoso rẹ	Nan
سيف	idà	Nan
سيفه	idà rẹ	Nan
سيرة	itan igbesiaye	Nan
شملت	to wa	Nan
شن	ṣe	Nan
شهاب	irawo ti n ta	Nan
صوتية	ohùn	Nan
صور	aworan	Nan
صورة	aworan	Nan
صوفيا	sofia	Nan
صياغة	ṣiṣatunkọ	Nan
صيد	sode	Nan
صيغة	fọọmu	Nan
صيف	igba ooru	Nan
صَلَّى	gbadura	Nan
ضئيلة	tẹẹrẹ	Nan
ضابط	oṣiṣẹ	Nan
ضباط	awọn oṣiṣẹ	Nan
ضبط	eto	Nan
ضحايا	olufaragba	Nan
ضخم	tobi pupo	Nan
صوت	ohùn	Nan
ضخمة	o tobi	Nan
صوب	ifọkanbalẹ	Nan
صنف	kilasi	Nan
صلاة	adura	Nan
صلاح	salah	Nan
صلاحيات	awọn ofin ti itọkasi	Nan
صلادة	líle	Nan
صلب	ri to	Nan
صلبة	ri to	Nan
صلة	ọna asopọ	Nan
صلح	ilaja	Nan
صلى	gbadura	Nan
صناعات	awọn ile-iṣẹ	Nan
صناعة	sise	None
صناعي	ise	Nan
صناعية	ise	Nan
صندوق	àpótí	Nan
صنع	sise	None
صواريخ	awọn irin-iṣẹ	Nan
ضد	lodi si	Nan
ضده	lodi si i	Nan
ضربة	kan to buruju	Nan
طائرة	rọgbọkú	Nan
طائفة	apakan	Nan
طابع	ontẹ kan	Nan
طارق	tariq	Nan
طاعة	ṣègbọràn	Nan
طاقة	agbara	None
طالب	ọmọ ile-iwe	Nan
طالبت	o beere	Nan
طالع	wo	Nan
طالما	bi gun	Nan
طاهر	ajẹsara	Nan
طب	òògùn	Nan
طبقا	gẹgẹbi	Nan
طبقاً	gẹgẹbi	Nan
طبقة	ipele	None
طائرات	awọn ọkọ ofurufu	Nan
ضيقة	o le	Nan
ضيق	fẹẹrẹ	Nan
ضواحي	ìgberiko	Nan
ضرورة	iwulo	None
ضرورية	pataki	Nan
ضريبة	owo-ori	Nan
ضريح	oriṣa	Nan
ضعف	ailera	Nan
ضعيف	ailagbara	Nan
ضعيفة	ailagbara	Nan
صقلية	aṣa	Nan
ضغط	titẹ	Nan
ضم	darapọ	Nan
ضمان	idaniloju	Nan
ضمت	to wa	Nan
ضمن	laarin	None
ضمنها	laarin rẹ	Nan
ضوء	imọlẹ	Nan
ضوئية	imọlẹ	Nan
ضفاف	awọn ile-ifowopamọ	Nan
غرب	oorun	Nan
صقر	falcon	Nan
صفوف	awọn ori ila	Nan
شيوخ	awọn àgba	Nan
شيوعا	wọpọ	Nan
شيوعاً	wọpọ	Nan
شيوعية	ibarapọpọ	Nan
شيوعًا	wọpọ	Nan
ص	s	Nan
صاحب	oniwun	Nan
صاحبه	eni to ni	Nan
صادرات	okeere	None
صادق	ooto	Nan
صار	o ṣẹlẹ	Nan
صارت	o di	Nan
صارمة	ti o muna	Nan
صالح	wulo	Nan
صالحة	wulo	Nan
شيد	ti won ko	Nan
صباح	owurọ	Nan
شيخ	sheikh	Nan
شيئاً	nkankan	Nan
شهادة	ìyí	Nan
شهد	ẹlẹri	Nan
شهدت	ti ri	Nan
شهدوا	wọn ti ri	Nan
شهر	osu	Nan
شهرة	olokiki	Nan
شهور	awọn oṣu	Nan
شوارع	awọn ọna	Nan
شواطئ	awọn eti okun	Nan
شوال	shawwal	Nan
شوقي	ṣọọṣi	Nan
شي	shi	Nan
شيء	ohun	Nan
شيءًا	nkankan	Nan
شيئا	nkankan	Nan
شيث	séré	Nan
صبحي	sobhi	Nan
صبري	sùúrù mi	Nan
صحة	ilera	Nan
صرح	o ṣalaye	Nan
صريح	fojuhan	Nan
صعب	lile	Nan
صعبة	nira	Nan
صعوبة	iṣoro	Nan
صعيد	ipele	None
صغار	junior	Nan
صغير	kekere	None
صغيرة	kekere	None
صف	row	Nan
صفات	awọn agbara	Nan
صفة	ijuwe	Nan
صفحات	awọn oju-iwe	Nan
صفحة	oju iwe	Nan
صفر	odo	Nan
صربيا	serbia	Nan
صراع	rogbodiyan	None
صديقه	arabinrin	Nan
صديق	ore	Nan
صحراء	aginju	Nan
صحف	iwe iroyin	Nan
صحية	ni ilera	Nan
صحيح	otitọ	Nan
صحيحة	tọ	Nan
صحيحه	tọ	Nan
صحيفة	iwe iroyin	Nan
صفين	awọn ori ila meji	Nan
صخرية	rocky	Nan
صد	ara	Nan
صداقة	ore	Nan
صدام	saddamu	Nan
صدر	tu silẹ	Nan
صدرت	ti oniṣowo	Nan
صدق	otitọ	Nan
صدور	àyà	Nan
صخور	awọn apata	Nan
سنتين	odun meji	Nan
غربا	iwọ oorun	Nan
غربي	iwọ oorun	Nan
كأس	ife	Nan
كأنه	bii pe	Nan
كائن	ohun kan	Nan
كائنات	awọn ohun	Nan
كاتب	akọwe	Nan
كاتدرائية	katidira	Nan
كاترين	katrin	Nan
كاجو	cashew	Nan
كاد	fẹẹrẹ	Nan
كادميوم	cadmium	Nan
كارل	carl	Nan
كارلوس	carlos	Nan
كاروانسرا	karwansra	Nan
كارولين	caroline	Nan
كاسترو	castro	Nan
قُتل	pipa	Nan
كاظم	kazem	Nan
قَالَ	o si wi	Nan
قيمة	awọn idiyele	Nan
قومية	t’orilẹ-ede	Nan
قوى	lagbara	Nan
قوي	lagbara	Nan
قوياً	lagbara	Nan
قوية	lagbara	Nan
قويسة	sage	Nan
قي	oṣuwọn	Nan
قيادة	aṣáájú	Nan
قياس	wiwọn	Nan
قيام	ṣe	Nan
قيد	ni ihamọ	Nan
قيس	qais	Nan
قيصر	késárì	Nan
قيل	o ti sọ	Nan
قيم	awọn idiyele	Nan
قيود	awọn ihamọ	Nan
قومي	orilẹ-ede	Nan
كافة	gbogbo	Nan
كافية	to	None
كبيراً	nla	Nan
كبيرة	nla	Nan
كبيرًا	nla	Nan
كتائب	awọn ọmọ ogun	Nan
كتاب	iwe	Nan
كتابات	awọn kikọ	Nan
كتابة	kikọ	Nan
كتابه	kikọ	Nan
كتب	kọ	Nan
كتبت	mo ko	Nan
كتبغا	kọ	Nan
كتبه	kọ nipa	Nan
كتبها	kọ nipasẹ	Nan
كتل	awọn ohun amorindun	Nan
كتلة	ibi	Nan
كبيرا	nla	Nan
كافور	ipago	Nan
كبير	nla	Nan
كبر	da gba soke	Nan
كالتالي	ni atẹle	Nan
كاليفورنيا	california	Nan
كامب	àgọ́	None
كامل	gbogbo	Nan
كاملاً	ni kikun	Nan
كاملة	pipe	Nan
كان	oun ni	Nan
كانا	wọn wa	Nan
كاناميسين	kanamycin	Nan
كانت	on ni	Nan
كانتا	wọn wa	Nan
كانوا	wọn wa	Nan
كانون	canon	Nan
كايبر	kipper	Nan
كبار	oloye	None
كبرى	nla	Nan
قومه	awọn eniyan rẹ	Nan
قوم	eniyan	Nan
قوله	wipe o	Nan
قصائده	awọn ewi rẹ	Nan
قصة	itan kan	Nan
قصد	mo mọ	Nan
قصر	ààfin	Nan
قصص	awọn itan	Nan
قصف	ikarahun	Nan
قصور	ikuna	Nan
قصيدة	ewi	Nan
قصير	kukuru	Nan
قصيرة	kukuru	Nan
قضاء	na	Nan
قضايا	awọn ọran	Nan
قضى	lowo	Nan
قضيبه	agbọn rẹ	Nan
قضية	oro	Nan
قصائد	awọn ewi	Nan
قط	rara	Nan
قسمين	abala meji	Nan
قسم	eka	None
قرر	o pinnu	Nan
قرص	tabulẹti	Nan
قرطاج	carthage	Nan
قرطاجنة	cartagena	Nan
قرطبة	cordoba	Nan
قرن	orundun kan	Nan
قرون	sehin	Nan
قرى	abule	Nan
قريب	pade	Nan
قريبة	pade	Nan
قرية	abule	Nan
قريش	quraysh	Nan
قريظة	qurayza	Nan
قزوين	ara ilu caspini	Nan
قسطنطين	constantine	Nan
قسمت	pin	Nan
قطار	ikẹkọ	Nan
قطاع	apakan	Nan
قطاعات	awọn apakan	Nan
قمر	oṣupa	Nan
قمع	tẹmọlẹ	Nan
قناة	ikanni	Nan
قنوات	awọn ikanni	Nan
قوائم	awọn akojọ	Nan
قوات	awọn ologun	Nan
قواته	awọn ipa rẹ	Nan
قواتها	awọn ipa rẹ	Nan
قواعد	awọn ofin	Nan
قوانين	awọn ofin	Nan
قوبلاي	kublai	Nan
قوة	agbara	None
قوتها	agbara rẹ	Nan
قوس	arki	Nan
قول	sọ	None
قمة	akopọ	Nan
قم	forukọsilẹ	Nan
قليلة	kan diẹ	Nan
قليلاً	kekere	None
قطب	òpó	Nan
قطر	iwọn opin	Nan
قطرها	iwọn opin	Nan
قطز	qutuz	Nan
قطع	ge	Nan
قطعة	nkan	None
قلاوون	qalawun	Nan
كتيبة	ọmọ ogun	Nan
قلب	obi	Nan
قلبي	ọkan mi	Nan
قلة	aini	Nan
قلت	mo ti sọ	Nan
قلعة	ile kasulu	Nan
قلوب	okan	Nan
قليل	diẹ	Nan
قليلا	kekere	None
قلبه	okan re	Nan
قرب	nitosi	None
كثافة	iwuwo	Nan
كثرة	lọpọlọpọ	Nan
لألمانيا	fun jẹmánì	Nan
لأن	nitori	Nan
لأنه	nitori oun	Nan
لأنها	nitori o	Nan
لأهل	si awọn eniyan	Nan
لأوروبا	fun yuroopu	Nan
لأول	fun igba akọkọ	Nan
لأي	fun eyikeyi	Nan
لإثبات	lati fi mule	Nan
لإجراء	lati dari	Nan
لإدارة	lati ṣakoso	Nan
لإسرائيل	si israeli	Nan
لإعادة	lati tunto	Nan
لإقامة	lati fi idi mulẹ	Nan
لإنتاج	lati gbejade	Nan
لأكثر	fun diẹ sii	Nan
لإنشاء	lati ṣẹda	Nan
لأفضل	fun dara julọ	Nan
لأسباب	fun awọn idi	Nan
كيشيون	igba	Nan
كيف	bawo ni	Nan
كيفية	bi o si	Nan
كيلومتر	kilomita	Nan
كيمياء	kemistri	Nan
كيميائي	kẹmika	Nan
كيميائية	kẹmika	Nan
كييف	kiev	Nan
ل	sí	Nan
لآخر	fun omiiran	Nan
لأبي	fun baba mi	Nan
لأجل	fun nitori	Nan
لأحد	fun ẹnikẹni	Nan
لأداء	lati ṣe	Nan
لأرسطو	si aristotle	Nan
لأغراض	fun awọn idi	Nan
كيشوا	quechua	Nan
لإيجاد	lati wa	Nan
لابد	gbọdọ	Nan
لاَ	rara	Nan
لبث	fi funni	Nan
لبعض	fun diẹ ninu	Nan
لبلاد	fun orilẹ-ede kan	Nan
لبناء	lati òrùka	Nan
لبنانية	lẹ́bánì	Nan
لتجنب	lati yago fun	Nan
لتحديد	lati pinnu	Nan
لتحرير	lati satunkọ	Nan
لتحسين	lati ni ilọsiwaju	Nan
لتحقيق	lati ṣe aṣeyọri	Nan
لتشكل	lati duro	Nan
لتشكيل	lati apẹrẹ	Nan
لتشمل	lati pẹlu	Nan
لتصبح	lati di	Nan
لاين	laini	Nan
لا	rara	Nan
لايف	gbe	None
لاند	ilẹ	None
لابن	si ọmọ kan	Nan
لاتخ	maṣe da a lẹbi	Nan
لاحظ	akiyesi	Nan
لاحق	nigbamii	Nan
لاحقا	nigbamii	Nan
لاحقاً	nigbamii	Nan
لاحقة	suffix	Nan
لادن	laden	Nan
لاسم	fun orukọ kan	Nan
لاسيما	paapa	Nan
لاعب	player	Nan
لاعبي	awọn oṣere mi	Nan
لاقت	irin	Nan
لامدا	lambda	Nan
لان	nitori	Nan
لانه	nitori oun	Nan
كيان	nkankan	Nan
كي	ki	None
كونها	jije	None
كسر	wó lulẹ	Nan
كشف	fi han	Nan
كشفت	fihàn	Nan
كعب	igigirisẹ	Nan
كفر	aigbagbọ	Nan
كقوة	bi ipa	Nan
ككل	lakopo	Nan
كل	ọkọọkan	Nan
كلا	mejeeji	Nan
كلام	sọrọ	Nan
كلثوم	kulthum	Nan
كلغة	bi ede kan	Nan
كلما	nigbakugba	Nan
كلمات	lyrics	Nan
كلمة	ọrọ kan	Nan
كسب	jo&#39;gun	Nan
كله	gbogbo	Nan
كريت	kíréte	Nan
كركيات	awọn kiki	Nan
كثير	pupo	Nan
كثيرا	pọ	Nan
كثيراً	pọ	Nan
كثيرة	pupo	Nan
كثيرون	ọpọlọpọ	Nan
كثيف	iku	None
كثيفة	wuwo	Nan
كجزء	gẹgẹ bi apakan	Nan
كدولة	bi orilẹ-ede	Nan
كذا	iru	Nan
كذلك	pelu	Nan
كرات	bọọlu	Nan
كربلاء	karbala	Nan
كرة	bọọlu kan	Nan
كرسي	ijoko kan	Nan
كريات	pellets	Nan
كلها	gbogbo eyiti	Nan
كلهم	gbogbo won	Nan
كليات	awọn ẹkọ	Nan
كهربائي	onina	Nan
كهربائية	ina	Nan
كواكب	aye	Nan
كوايك	quik	Nan
كوبا	kuba	Nan
كوريا	korea	Nan
كوريوم	curium	Nan
كوزميد	cozumid	Nan
كوسيلة	bi ọna kan	Nan
كوكب	ile aye	Nan
كولوم	coulomb	Nan
كولومبيا	ilu columbia	Nan
كون	aye	Nan
كونان	konini	Nan
كونه	jije	None
كهرباء	ina	Nan
كنيسة	ijo kan	Nan
كنعان	kenaani	Nan
كندا	kánádà	None
كليب	agekuru	Nan
كلية	kọlẹji	Nan
كلينتون	clinton	Nan
كليوباترا	cleopatra	Nan
كلّ	ọkọọkan	Nan
كم	melo ni	Nan
كما	bi eleyi	Nan
كثر	ọpọlọpọ	Nan
كمال	pipe	Nan
كميات	titobi	Nan
كمية	opoiye	Nan
كنا	a wà	Nan
كنائس	awọn ile-ijọsin	Nan
كنانة	kinaana	Nan
كنت	mo ti wà	Nan
كنتيجة	nitorina na	Nan
كمصدر	gẹgẹbi orisun	Nan
قرارات	awọn ipinnu	Nan
قرار	ipinnu	Nan
قرابة	nipa	Nan
فرسان	awọn ẹwa knights	Nan
فرساي	awọn idarọ	Nan
فرص	awọn aye	Nan
فرصة	anfani	Nan
فرض	faṣẹ	Nan
فرضت	ti dimu	Nan
فرضية	idawọle	Nan
فرع	ẹka kan	Nan
فرعون	fáráò	Nan
فرعية	atẹle	Nan
فرق	iyato	None
فرقة	elegede	Nan
فرنسا	faranse	None
فرنسي	faranse	None
فرنسية	faranse	None
فردية	olukọọkan	Nan
فروع	awọn ẹka	Nan
فرد	olukọọkan	Nan
فرانك	frank	Nan
فترة	aarin	Nan
فتكون	iwọ yoo jẹ	Nan
فتم	fm	Nan
فتنة	idanwo	Nan
فجاء	nitorinaa o wa	Nan
فجر	owurọ	Nan
فجعل	o ṣe	Nan
فحسب	nikan	Nan
فحص	se iwadi	Nan
فخرج	bẹ̃li o jade	Nan
فخلال	lakoko	Nan
فدخل	o si wọle	Nan
فذهب	bẹ̃li o lọ	Nan
فراس	awọn firas	Nan
فرانسيسكو	francisco	Nan
فرانكو	franko	Nan
فترات	awọn akoko	Nan
فرويد	freud	Nan
فريدة	farida	Nan
فعلاً	lootọ	Nan
فعله	ti ṣee	Nan
فعلى	gangan	Nan
فعندما	nigbawo	Nan
ففي	ninu	Nan
فقال	o si wi	Nan
فقالت	on si wipe	Nan
فقالوا	nwọn si wipe	Nan
فقام	o si dide	Nan
فقامت	nitorinaa o dide	Nan
فقبل	ṣaaju	Nan
فقد	ti sọnu	Nan
فقدان	isonu	Nan
فقدت	ti sọnu	Nan
فقر	osi	Nan
فعلا	lootọ	Nan
فريد	alailẹgbẹ	Nan
فعل	ìṣe	Nan
فعالة	munadoko	Nan
فريدريك	fredoni	Nan
فريق	ẹgbẹ	Nan
فشل	ikuna	Nan
فشلت	kuna	Nan
فصائل	awọn eya	Nan
فصل	akoko	Nan
فصول	awọn ori	Nan
فضاء	aaye	Nan
فضائية	aaye	Nan
فضل	o ṣeun	Nan
فضلا	si be e si	Nan
فضلاً	si be e si	Nan
فطلب	o beere	Nan
فطيرة	paii	Nan
فعال	munadoko	Nan
فعالية	ndin	Nan
فتحي	fathi	Nan
فتحها	ṣi i	Nan
فتحت	ṣii silẹ	Nan
غلطة	aṣiṣe	Nan
غلوكوز	glukosi	Nan
غلوون	onu	Nan
غناء	orin	Nan
غناها	rẹ ọrọ	Nan
غني	ọlọrọ	Nan
غنية	ọlọrọ	Nan
غوستاف	gustav	Nan
غياب	aisi	None
غير	rara	Nan
غيره	owú	Nan
غيرها	omiiran	Nan
غيرهم	awọn ẹlomiran	Nan
غيفارا	guevara	Nan
غينيا	guinea	None
غلاف	casing	Nan
فأخذ	nitorinaa o mu	Nan
غطاء	ideri	Nan
غضب	ibinu	Nan
غربية	oorun	Nan
غربًا	iwọ oorun	Nan
غرفة	yara	Nan
غرناطة	granada	Nan
غريب	àlejò	Nan
غريبة	ajeji	Nan
غرين	greene	Nan
غزا	ṣẹgun	Nan
غزة	gasa	Nan
غزو	pipe	Nan
غزوات	awọn ariyanjiyan	Nan
غزوة	foray	Nan
غسق	alẹ́	Nan
غسل	wẹ	Nan
غشاء	awo ilu	Nan
غضون	laarin	None
فأرسل	o ranṣẹ	Nan
فأصبح	o di	Nan
فأصبحت	mo di	Nan
فاطمة	fatima	Nan
فاعلية	ndin	Nan
فالج	hemiplegia	Nan
فالكيري	valkyrie	Nan
فالنتين	valentin	Nan
فان	fani	Nan
فاندانغو	fandango	Nan
فايمار	weimar	Nan
فبدأ	nitorinaa o bẹrẹ	Nan
فبراير	oṣu kínní	Nan
فبعد	lẹhin	Nan
فبعض	diẹ ninu	Nan
فتاة	ọmọbinrin	Nan
فتح	ṣii	Nan
فتحة	iho	Nan
فاس	ax	Nan
فازت	o bori	Nan
فاز	bori	Nan
فاروق	farooq	Nan
فأمر	nitorinaa o paṣẹ	Nan
فأن	lẹhinna	Nan
فؤاد	fouad	Nan
فإذا	nitorinaa	Nan
فإن	awọn	Nan
فإننا	a yoo	Nan
فإنه	o ṣe	Nan
فقرر	nitorinaa o pinnu	Nan
فإنها	wọn yoo	Nan
فئات	awọn ẹka	Nan
فئة	ẹka	Nan
فائدة	anfani	Nan
فائقة	olodumare	Nan
فاراداي	faraday	Nan
فارس	oru	Nan
فارسي	páṣíà	Nan
فإنهم	wọn jẹ	Nan
فقط	o kan	Nan
فقلت	nitorinaa mo sọ	Nan
فقه	ẹjọ	Nan
قارات	awọn orilẹ-ede	Nan
قارة	kọntinia	Nan
قاسم	onidajọ	Nan
قاسية	onjẹ	Nan
قاعة	gbangan	Nan
قاعدة	base	Nan
قال	o si wi	Nan
قالت	o sọ	Nan
قاله	o sọ bẹ	Nan
قالوا	wọn sọ	Nan
قام	dide	Nan
قامت	o ṣe	Nan
قاموا	wọn dide	Nan
قاموس	itumọ	Nan
قانون	ofin	None
قادرين	agbara	None
قانوني	t’olofin	Nan
قادرة	anfani	Nan
قادت	o dari	Nan
فيهما	ninu wọn	Nan
فيينا	vienna	Nan
فِي	ni a	Nan
ق	s	Nan
قائد	aṣáájú	Nan
قائلا	sisọ	Nan
قائلاً	sisọ	Nan
قائم	wa	Nan
قائمة	atokọ	Nan
قابل	irin	Nan
قابلة	pàdé e	Nan
قابوس	qaboos	Nan
قاتل	apaniyan	Nan
قاد	mu silẹ	Nan
قادة	awọn oludari	Nan
قادر	anfani	Nan
قانونية	ofin	None
قايتباي	qaitbay	Nan
قباء	quba	Nan
قدرته	agbara rẹ	Nan
قدرتها	agbara rẹ	Nan
قدرها	kadara rẹ	Nan
قدم	ẹsẹ	None
قدماء	awọn igba atijọ	Nan
قدمت	silẹ	Nan
قدمه	sin o	Nan
قدمها	sin o	Nan
قدوم	n bọ	Nan
قديم	atijọ	Nan
قديما	ni akoko ti o kọja	Nan
قديمًا	igba atijọ	Nan
قذف	iyaworan	Nan
قرأ	ka	Nan
قراءة	kika	Nan
قدرت	mo ṣe iṣiro	Nan
قدرة	agbara	None
قدر	saucepan	Nan
قد	boya	Nan
قبائل	ẹya	Nan
قباني	kan mi	Nan
قبة	éù	Nan
قبر	alẹmọ	Nan
قبرص	kírúsì	Nan
قبره	lark	Nan
قبض	yẹ	Nan
فيهم	pẹlu	Nan
قبل	ṣaaju	Nan
قبول	gba	None
قبيلة	ẹyà	Nan
قتال	ija	Nan
قتل	pipa	Nan
قتلة	apaniyan	Nan
قتله	apaniyan	Nan
قتلوا	ni won pa	Nan
قبله	ẹnu	Nan
غرباً	iwọ oorun	Nan
فيها	ninu eyiti	Nan
فينول	phenol	Nan
فلك	aworawo	Nan
فلم	fiimu kan	Nan
فلما	kilode	Nan
فلمّا	kilode	Nan
فلن	iwọ kii yoo ṣe	Nan
فلو	òò	Nan
فلورنسا	florence	Nan
فليس	ko ṣe bẹ	Nan
فما	ngba yen nko	Nan
فمثلا	fun apere	Nan
فمثلاً	fun apere	Nan
فمن	oun ni	Nan
فمنذ	niwon	Nan
فمنهم	o ti wa ni lati wọn	Nan
فن	aworan	Nan
فلقد	o ni	Nan
فنان	olorin	Nan
فلسفة	imoye	Nan
فلسطيني	palestini	Nan
فقهاء	jurists	Nan
فقيل	o ti sọ	Nan
فك	olumulo	Nan
فكان	oun ni	Nan
فكانت	oun ni	Nan
فكانوا	wọn wa	Nan
فكر	ronu	Nan
فكرة	imọran	Nan
فكل	nitorinaa gbogbo	Nan
فلا	ko ṣe bẹ	Nan
فلاح	àgbẹ̀	Nan
فلاديمير	irina	Nan
فلاسفة	onimoye	Nan
فلدسبار	feldspar	Nan
فلسطين	palestine	Nan
فلسطينية	palestini	Nan
فندق	hotẹẹli	Nan
فنزويلا	venezuela	None
فنلندا	finland	Nan
فيديو	fidio	Nan
فيرفكس	firefox	Nan
فيروس	kòkòrò àrùn fáírọọsì	Nan
فيروسات	awọn ọlọjẹ	Nan
فيرونا	verona	Nan
فيزيائية	ti ara	Nan
فيس	facebook	Nan
فيصل	faisal	Nan
فيقول	o sọpe	Nan
فيكون	nitorina o jẹ	Nan
فيلم	fiimu	Nan
فيليب	fílípì	Nan
فيما	nipa	Nan
فيمكن	o le	Nan
فينشي	vinci	Nan
فيجب	o ye	Nan
فيتنام	vietnam	Nan
في	ni a	Nan
فوهة	aranu	Nan
فنون	iṣẹ ọnà	Nan
فني	imọ-ẹrọ	Nan
فنية	iṣẹ ọna	Nan
فهد	amotekun	Nan
فهذا	eyi ni	Nan
فهذه	nitorina eyi	Nan
فهم	oye	Nan
فيه	ninu e	Nan
فهمي	oye mi	Nan
فهو	oun ni	Nan
فهي	o n ni	Nan
فوائد	awọn anfani	Nan
فور	lesekese	Nan
فوضى	meji	Nan
فوق	loke	Nan
فون	iphone	Nan
فهناك	nibẹ ti o jẹ	Nan
سنة	odun	Nan
سنان	eyin	None
سن	ọjọ ori	Nan
جديدة	tuntun	None
جديدًا	tuntun	None
جدير	yẹ fun	Nan
جدًا	pupọ	Nan
جذب	ifamọra	Nan
جذور	awọn gbongbo	Nan
جراء	puppet	Nan
جرائم	odaran	Nan
جرانيت	granite	Nan
جرت	gba aye	Nan
جرى	o sare	Nan
جريدة	iwe iroyin	Nan
جزء	apakan	Nan
جزءا	apakan	Nan
جزءاً	apakan	Nan
جديداً	tuntun	None
جزءًا	apakan	Nan
جديدا	tuntun	None
جدوى	anfani	Nan
جبران	jubran	Nan
جبريل	gébúrẹ́lì	Nan
جبلية	oke	Nan
جبهة	iwaju	Nan
جد	baba agba	Nan
جدا	pupọ	Nan
جدار	odi	Nan
جدال	ariyanjiyan	Nan
جداً	pupọ	Nan
جدة	iya agba	Nan
جدد	tuntun	None
جدران	odi	Nan
جدل	ariyanjiyan	Nan
جده	iya agba	Nan
جدول	tabili	None
جديد	tuntun	None
جبال	awọn oke-nla	Nan
جزئيا	ni apakan	Nan
جزيئات	awọn molecules	Nan
جلب	ti mu wa	Nan
جلد	awọ	Nan
جلسة	igba	Nan
جماع	ajọṣepọ	Nan
جماعات	awọn ẹgbẹ	Nan
جماعية	gbigba	Nan
جمال	ẹwa	Nan
جمع	ọpọ	Nan
جمعة	ọjọru	Nan
جمعت	gbà	Nan
جمعه	ọjọru	Nan
جمعها	gbà	Nan
جمعية	ẹgbẹ	Nan
جملة	idajọ	Nan
جمهور	gbangba	Nan
جلال	celal	Nan
جزر	awọn karooti	Nan
جل	gel	Nan
جغرافية	ẹkọ nipa ilẹ	Nan
جزيرة	erekusu	Nan
جساس	ami	Nan
جسد	ara	Nan
جسده	ara rẹ	Nan
جسدها	ara rẹ	Nan
جسر	afara	Nan
جسم	ara	Nan
جسمه	ara rẹ	Nan
جسيمات	awọn patikulu	Nan
جعفر	jafar	Nan
جعل	ṣe	Nan
جعلت	ṣe	Nan
جعله	ṣe o	Nan
جعلها	ṣe o	Nan
جغرافيا	ẹkọ nipa ilẹ	Nan
جفاف	ogbele	Nan
جانبي	ẹgbẹ	Nan
جانبه	ẹgbẹ rẹ	Nan
جانب	ẹgbẹ	Nan
تيمية	taymiyya	Nan
تُشكل	fọọmu	Nan
تُظهر	han	Nan
تُعتبر	kà bi	Nan
تُعد	mura	Nan
تُعرف	mo	Nan
ثابتة	ti o wa titi	Nan
ثار	ẹsan	Nan
ثالث	kẹta	None
ثاليوم	thallium	Nan
ثانوية	ile-iwe giga	Nan
ثاني	ikeji	Nan
ثانيا	keji	Nan
ثانية	a keji	Nan
ثبت	ti fihan	Nan
تيمور	aago	Nan
ثروة	oro	Nan
تيفوس	typhus	Nan
تيار	san	Nan
توقع	ireti	Nan
توقف	duro	Nan
توقيع	ibuwọlu	Nan
توكيس	tokis	Nan
تولد	fifun ni ibimọ	Nan
تولى	gba gbogbo e	Nan
توليد	iran	Nan
توليه	ifilọlẹ	Nan
تولّى	gba gbogbo e	Nan
توما	toma	Nan
توماس	thomas	Nan
تونس	tunisia	Nan
تويوتا	toyota	Nan
تويودا	toyoda	Nan
تي	t	Nan
تيارات	awọn ṣiṣan	Nan
ثقافات	awọn aṣa	Nan
ثقافة	aṣa	Nan
ثقافي	aṣa	Nan
جاء	wa	Nan
جاءت	o wa	Nan
جائزة	ohun eye	Nan
جابر	jaber	Nan
جاذبية	walẹ	Nan
جاسم	jaasi	Nan
جاك	jack	Nan
جاكسون	onilu	Nan
جالوت	gòláyátì	Nan
جاليليو	galileo	Nan
جالينوس	galen	Nan
جامع	mosalasi	Nan
جامعات	awọn ile-iwe giga	Nan
جامعة	yunifasiti	Nan
جان	jan	Nan
ج	c	Nan
ثيوديسيا	theodisia	Nan
ثورة	iyika	Nan
ثورات	iyika	Nan
ثقافية	asa	Nan
ثقب	iho	Nan
ثقة	igboya	Nan
ثلاث	mẹta	Nan
ثلاثة	mẹta	Nan
ثلاثية	iṣẹ ibatan mẹta	Nan
ثلاثين	ọgbọn	Nan
جمهوري	olominira	Nan
ثلث	ọkan kẹta	Nan
ثمان	mẹjọ	Nan
ثماني	mẹjọ	Nan
ثمانية	mẹjọ	Nan
ثمة	o wa	Nan
ثمّ	lẹhinna	Nan
ثنائية	meji	Nan
ثور	akọmalu	Nan
ثم	lẹhinna	Nan
توفيق	laja	Nan
جمهورية	olominira	Nan
جميعا	gbogbo won	Nan
حدائق	awọn ọgba	Nan
حدة	sharpness	Nan
حدث	iṣẹlẹ	Nan
حدثت	imudojuiwọn	Nan
حدثنا	sọ fun wa	Nan
حدد	wa	Nan
حدودها	awọn ifilelẹ rẹ	Nan
حديث	igba ode	Nan
حديثا	tuntun	None
حديثة	igba ode	Nan
حديثًا	tuntun	None
حديد	irin	Nan
حديدية	ferrous	Nan
حديقة	ọgba	Nan
حراء	hira	Nan
حد	idiwọn	Nan
حرارة	igbona	Nan
حجوالة	gbigbe	Nan
حجما	ni iwọn	Nan
حاليا	lọwọlọwọ	Nan
حالياً	lọwọlọwọ	Nan
حاليًا	lọwọlọwọ	Nan
حامد	arakunrin	Nan
حامل	loyun	Nan
حاول	gbiyanju lati	Nan
حاولت	mo gbiyanju	Nan
حب	ni ife	Nan
حبيب	ololufe	Nan
حبيبي	ọmọ	None
حتى	titi	Nan
حتي	titi	Nan
حجة	ariyanjiyan	Nan
حجر	okuta	Nan
حجم	iwọn	Nan
حجمها	iwọn rẹ	Nan
حالته	ipo rẹ	Nan
حرارته	igbona re	Nan
حرام	dena	Nan
حساسة	ọpọlọ	Nan
حسان	hassan	Nan
حسب	gẹgẹ bi	Nan
حسن	hassan	Nan
حسنة	iwa rere	Nan
حسني	hosni	Nan
حسين	hussain	Nan
حشد	ogunlọgọ	Nan
حشرات	awọn kokoro	Nan
حشيشة	haṣishaki	Nan
حصار	dotì	Nan
حصة	akoko	Nan
حصدت	ikore	Nan
حصل	ṣẹlẹ	Nan
حصلت	mo gba	Nan
حسابات	awọn iroyin	Nan
حرارتها	igbona rẹ	Nan
حساب	akọọlẹ	Nan
حزن	awọn ibanujẹ	Nan
حرب	ogun	None
حربية	ijakadi	None
حرة	ọfẹ	Nan
حرس	ṣọ	Nan
حرف	lẹta	Nan
حرق	jona	Nan
حركات	awọn gbigbe	Nan
حركة	ronu	Nan
حرم	dena	Nan
حروب	ogun	None
حروف	awọn lẹta	Nan
حرية	ominira	Nan
حزام	beliti	Nan
حزب	ẹgbẹ	Nan
حزم	okùn	Nan
حزيران	oṣu karun	Nan
حالة	ipo	None
حالب	ureter	Nan
حالات	awọn ọran	Nan
جهات	awọn ibi	Nan
جهاد	jihad	Nan
جهاز	ẹrọ	Nan
جهة	apa	Nan
جهد	akitiyan	Nan
جهود	akitiyan	Nan
جو	aye	Nan
جوائز	ẹbun	Nan
جواز	iwe irinna	Nan
جوانب	awọn ẹya	Nan
جواهر	awọn iyebiye	Nan
جوجل	google	Nan
جودة	didara	Nan
جورج	george	Nan
جورجيا	georgia	None
جنوده	awọn ọmọ ogun rẹ	Nan
جورجيون	georgians	Nan
جنود	awọn ọmọ-ogun	Nan
جنوبي	guusu	None
جميعاً	gbogbo won	Nan
جميعًا	gbogbo won	Nan
جميل	iferanju	Nan
جميلة	lẹwa	Nan
جناح	suite	Nan
جنب	apa	Nan
جندي	jagunjagun	Nan
جنس	ibalopọ	Nan
جنسي	ibalopo	Nan
جنسية	abínibí-èdè	Nan
جنطيانية	kèfèrí sí	Nan
جنكيز	genghisi	Nan
جنو	gnu	Nan
جنوب	guusu	None
جنوبا	guusu	None
جنوبًا	guusu	None
جوزيف	jósẹ́fù	Nan
جولة	irin-ajo	Nan
جون	jòhánù	Nan
حائل	yinyin	Nan
حاتم	hatem	Nan
حاجة	nilo	Nan
حادة	didasilẹ	Nan
حادث	ijamba	Nan
حادثة	iṣẹlẹ	Nan
حار	gbona	Nan
حارب	ja	Nan
حارة	lane	Nan
حاز	ni	Nan
حاسوب	kọmputa kan	Nan
حافة	eti	Nan
حافظ	hafiz	Nan
حافظت	ṣetọju	Nan
حال	ipo	None
حائط	odi	Nan
جيوش	awọn ọmọ ogun	Nan
جينات	awọn jiini	Nan
جين	gene	Nan
جوهر	lodi	Nan
جوي	eriali	Nan
جوية	afẹfẹ	Nan
جي	ing	Nan
جيبوتي	ilu djibouti	Nan
جيجابت	gigabit	Nan
جيد	o dara	Nan
جميع	gbogbo	Nan
جيدا	daradara	Nan
جيدة	ikan todara	Nan
جيش	ọmọ ogun	Nan
جيشه	ẹgbẹ ọmọ ogun rẹ	Nan
جيشًا	ẹgbẹ ọmọ ogun kan	Nan
جيفارا	guevara	Nan
جيل	iran	Nan
جيمس	jákọ́bù	Nan
جيداً	daradara	Nan
توفير	pese	Nan
توفيت	o ku	Nan
توفي	ti ku	Nan
تضع	fi	None
تضم	pẹlu	Nan
تطبق	waye	Nan
تطبيق	imuse	Nan
تطبيقات	awọn ohun elo	Nan
تطل	wó isale	Nan
تطلب	beere	Nan
تطلق	ti firanṣẹ	Nan
تطهير	irinse	Nan
تطور	ti wa	Nan
تطورا	oniruuru	Nan
تطورت	ti yipada	Nan
تطوير	idagbasoke	None
تطوّر	ti wa	Nan
تظل	duro	Nan
تضخم	dide	Nan
تظهر	han	Nan
تضاعف	isodipupo	Nan
تصوير	ya fọto	Nan
تصنيفعلم	tia ipin	Nan
تصنيفعلماء	pinpin awọn onimọ-jinlẹ	Nan
تصنيفعواصم	ayebaye ti awọn kapusulu	Nan
تصنيففلاسفة	ipilẹ awọn onimoye	Nan
تصنيفقادة	awọn oludari rating	Nan
تصنيفكتاب	iwe ipin	Nan
تصنيفلاعبو	ipilẹ awọn ẹrọ orin	Nan
تصنيفمدن	ipilẹ awọn ilu	Nan
تصنيفمصريون	awọn ara egipti rating	Nan
تصنيفممثلات	ayebaye ti awọn oṣere	Nan
تصنيفممثلون	awọn oṣere rating	Nan
تصنيفمواليد	ipele ti ọmọ tuntun	Nan
تصنيفوزراء	ayebaye ti awọn minisita	Nan
تصنيفوفيات	awọn ẹka	Nan
تصور	fojuinu	Nan
تصيب	arun	None
تصنيفصحابة	alabaṣepọ kilasi	Nan
تعارض	àríyànjiyàn	Nan
تعالى	wá	Nan
تعطى	ti a fun	Nan
تعطي	fifun	Nan
تعكس	ṣe afihan	Nan
تعلم	kọ ẹkọ	Nan
تعليم	eko	None
تعليمه	kọ ẹkọ	Nan
تعليمية	ẹ̀kọ́	None
تعمل	ṣiṣẹ	Nan
تعني	tumọ si	Nan
تعود	pada	Nan
تعيش	gbe	None
تغطي	ibora	Nan
تغطية	agbegbe	Nan
تغلب	gbagbe	Nan
تغير	yipada	None
تعزيز	ṣe okun	Nan
تعاطي	ilokulo	Nan
تعرّض	ìsírasílẹ	Nan
تعرف	mọ	Nan
تعاليم	awọn ẹkọ	Nan
تعامل	ṣe adehun	Nan
تعاني	jiya	Nan
تعاون	ifowosowopo	Nan
تعبر	agbelebu	Nan
تعتبر	kà bi	Nan
تعترف	mọ	Nan
تعتمد	gbarale	Nan
تعد	mura	Nan
تعداد	akowe	Nan
تعددت	mo ti isodipupo	Nan
تعديل	iyipada	Nan
تعرض	ìsírasílẹ	Nan
تعرضت	ti han	Nan
تعرضوا	wọn fara han	Nan
تعريف	definition ti	Nan
تصنيفشعراء	ipilẹ awọn ewi	Nan
تصنيفرؤساء	ipilẹ awọn olori	Nan
تصنيفديمقراطيات	ijoba tiwantiwa	Nan
تسمية	lorukọ	Nan
تسونامي	tsunami	Nan
تسوية	ipinlese	Nan
تسير	lọ	Nan
تسيطر	awọn isakoso	Nan
تشاد	chad	Nan
تشارك	lilọwọsi	Nan
تشارلز	charles	None
تشبه	fẹran	Nan
تشترك	pin	Nan
تشتمل	ni	Nan
تشتهر	jẹ olokiki fun	Nan
تشجيع	iwuri	Nan
تشخيص	ṣe ayẹwo	Nan
تشرف	lola	Nan
تسمى	o ti n pe	Nan
تشريع	ofin	None
تسمح	gba laaye	Nan
تسلم	gba	None
تستخدم	ti lo	Nan
تستطع	o le	Nan
تستطيع	se o le	Nan
تستعمل	ti lo	Nan
تستغرق	mu	Nan
تستمر	o tẹsiwaju	Nan
تستهلك	agbara	None
تسجيل	forukọsilẹ	Nan
تسخين	alapapo	Nan
تسرب	leak	Nan
تسع	mẹsan	Nan
تسعة	mẹsan	Nan
تسعى	wiwa	Nan
تسقط	ja bo sile	Nan
تسلسل	ọkọọkan	Nan
تسليم	ifijiṣẹ	Nan
تشرين	tishreen	Nan
تشغل	ṣiṣẹ	Nan
تشغيل	nṣiṣẹ	Nan
تصغير|مسجد	dinku | mosalasi	Nan
تصف	ṣe apejuwe	Nan
تصل	de ọdọ	Nan
تصميم	oniru	Nan
تصنع	ṣelọpọ	Nan
تصنف	ti wa ni classified	Nan
تصنيع	iṣelọpọ	Nan
تصنيف	rating	Nan
تصنيفآل	ipele	None
تصنيفأشخاص	ipilẹ awọn eniyan	Nan
تصنيفأعلام	awọn asia kilasika	Nan
تصنيفبلدان	kilasika orilẹ-ede	Nan
تصنيفتاريخ	ọjọ	Nan
تصنيفخريجو	ipele ti awọn graduates	Nan
تصنيفدول	awọn orilẹ-ede ti ipin	Nan
تصغير|صورة	dinku | aworan	Nan
تصغير|رسم	gbe si | fa	Nan
تصغير|بك|رسم	gbe | rẹ | fa	Nan
تصغير|	gbe kere |	Nan
تشكل	fọọmu	Nan
تشكلت	ti gbekale	Nan
تشكيل	ibiyi	Nan
تشمل	ni	Nan
تشهد	jẹri	Nan
تشي	ṣẹ	Nan
تشير	fihan	None
تغيرات	awọn ayipada	Nan
تشيكوسلوفاكيا	czechoslovakia	Nan
تشييد	ikole	Nan
تشييط	ṣayẹwo	Nan
تصاعد	gbeke	Nan
تصب	tú	None
تصبح	di	Nan
تصدر	ti oniṣowo	Nan
تصدير	si okeere	Nan
تشين	chen	Nan
تغيرت	yi pada	Nan
تغيير	iyipada kan	Nan
تفاصيل	awọn alaye	Nan
تمنع	dena	Nan
تمويل	isuna	Nan
تميز	yatọ si	Nan
تميزت	ti samisi	Nan
تميل	duro	Nan
تميم	tamimu	Nan
تمييز	iyasoto	Nan
تمّ	ti ṣee	Nan
تنازل	amojukuro	Nan
تناول	njẹ	Nan
تناولت	jẹun	Nan
تنبأ	asọtẹlẹ	Nan
تنتج	awọn iṣelọpọ	Nan
تنتشر	tan kaakiri	Nan
تنتقل	gbe	None
تمنح	funni	Nan
تنتمي	pẹlú	Nan
تملك	awọn oniwun	Nan
تمرد	insurgency	Nan
تم	ti ṣee	Nan
تمارس	ni adaṣe	Nan
تمام	o dara	Nan
تماما	patapata	Nan
تماماً	patapata	Nan
تمامًا	patapata	Nan
تمت	ti ṣee	Nan
تمتاز	tayo	Nan
تمتد	nkanna	Nan
تمتعت	mo gbadun	Nan
تمتلك	awọn ohun ini	Nan
تمثال	ere	Nan
تمثلت	ti ya aworan	Nan
تمثيل	oniduro	Nan
تمر	ṣe kọja	Nan
تمكن	ṣiṣakoso	Nan
تنتهي	dopin	Nan
تنخفض	lọ si isalẹ	Nan
تنسيق	alakoso	Nan
توتونيون	teutonic	Nan
توجد	o wa	Nan
توجه	iṣalaye	Nan
توجيه	itọsọna	Nan
توحيد	ipele	None
توزيع	pinpin	Nan
توسع	imugboroosi	Nan
توسعت	faagun	Nan
توسيع	imugboroosi	Nan
توصل	dide	Nan
توصيل	sisopọ	Nan
توضح	ṣe alaye	Nan
توضع	wa ni gbe	Nan
توفر	wiwa	Nan
توفى	ti ku	Nan
توت	blueberry	Nan
توافق	gba	None
توازن	iwontunws.funfun	Nan
تواجه	oju	Nan
تنشأ	dide	Nan
تنص	awọn ipinlẹ	Nan
تنظم	ṣeto	Nan
تنظيم	ẹgbẹ	Nan
تنفيذ	imuse ti	Nan
تنقسم	pin	Nan
تنقل	gbe	None
تليها	tele mi	Nan
تنمو	dagba	Nan
تنوع	oniruuru	Nan
تهتم	itọju	Nan
تهدد	irokeke	Nan
تهدف	awọn ero	Nan
تهيمن	jọba	Nan
توابل	turari	Nan
تواجد	iwalaaye	Nan
تنمية	idagbasoke	None
حصن	fort	Nan
تلوث	idoti	Nan
تلك	iyẹn	Nan
تقدمه	pese o	Nan
تقدمها	pese	Nan
تقدير	ìmọrírì	Nan
تقديرات	awọn iṣiro	Nan
تقديم	gbigbe	Nan
تقرر	pinnu	Nan
تقريبا	o fẹrẹ to	Nan
تقريباً	o fẹrẹ to	Nan
تقريبًا	o fẹrẹ to	Nan
تقرير	ijabọ	Nan
تقسم	pipin	Nan
تقسيم	pipin	Nan
تقضي	na	Nan
تقع	be	Nan
تقف	dide	Nan
تقدمت	onitẹsiwaju	Nan
تقل	ti o kere	Nan
تقدم	ilọsiwaju	Nan
تقتصر	ti ni ifipamo	Nan
تفاعل	ibaraenisepo	Nan
تفاعلات	awọn ibaraenisepo	Nan
تفرض	fa	Nan
تفسير	alaye	Nan
تفصل	lọtọ	Nan
تفعل	ti wa ni nse	Nan
تفقد	padanu	Nan
تفكك	subu	Nan
تفوق	o tayọ	Nan
تفيد	anfani	Nan
تقارب	aigbagbọ	Nan
تقارير	awọn ijabọ	Nan
تقاليد	aṣa	Nan
تقام	ti wa ni waye	Nan
تقبل	gba	None
تقدر	ẹ mọrírì	Nan
تقلل	dinku	Nan
تقليد	atọwọdọwọ	Nan
تقليدية	ibile	None
تكنولوجيا	imọ-ẹrọ	Nan
تكون	jẹ	Nan
تكونت	ti gbekale	Nan
تكوين	ibiyi	Nan
تكيف	aṣamubadọgba	Nan
تل	.kè	Nan
تلال	hills	Nan
تلاميذه	awọn ọmọ-ẹhin rẹ	Nan
تلبية	pade	Nan
تلت	tẹle	Nan
تلعب	mu ṣiṣẹ	Nan
تلف	bibajẹ	Nan
تلفزيون	tv	Nan
تلفزيونية	tẹlifisiọnu	Nan
تلقى	gba	None
تكن	jẹ	Nan
تكمن	jẹ	Nan
تكليس	kalikoni	Nan
تكلفة	iye owo	Nan
تقليل	dinku	Nan
تقنيات	imọ-ẹrọ	Nan
تقنية	ilana	None
تقود	asiwaju	Nan
تقول	sọ	None
تقوم	dide	Nan
تقوية	agbara	None
تلو	lẹhin	Nan
تقويم	iyẹwo	Nan
تقييم	iyẹwo	Nan
تكاد	elegbe	Nan
تكاليف	awọn idiyele	Nan
تكتب	o kọwe	Nan
تكثر	pọpọ̀	Nan
تكرار	atunwi	Nan
تكساس	texas	Nan
تقي	olooto	Nan
حصول	gba	None
حضارات	ilu	Nan
حضارة	ọlaju	Nan
ركن	igun	Nan
رمزا	ami kan	Nan
رمزية	ami	Nan
رمسيس	awọn eegun	Nan
رمضان	ramadan	None
رموز	awọn aami	Nan
رمي	jabọ	Nan
روابط	awọn ọna asopọ	Nan
رواد	awọn aṣáájú-ọnà	Nan
رواه	sọ nipa	Nan
روايات	awọn aramada	Nan
رواية	aramada	Nan
روبرت	robert	Nan
روثينيوم	ruthenium	Nan
روح	ẹ̀mí	Nan
ركام	biba	Nan
روس	rosa	Nan
رقيقة	tinrin	Nan
رقعة	ẹtọ	Nan
رصد	bojuto	Nan
رضا	ooto	Nan
رضي	itelorun	Nan
رعاف	eefun	Nan
رعاية	abojuto	Nan
رعد	ààrá	Nan
رغبة	ifẹ	Nan
رغم	pelu	Nan
رفض	kọ	Nan
رفضت	o kọ	Nan
رفضه	kọ ọ	Nan
رفع	po si	Nan
رفعت	gbígbé	Nan
رفيعة	sọnda	Nan
رفيق	ẹlẹgbẹ	Nan
رقم	nọmba	Nan
رشيد	rashid	Nan
روستوك	rostock	Nan
روسيا	rọ́ṣíà	Nan
زالت	ṣi	Nan
زاوية	igun	Nan
زايد	zayed	Nan
زحف	jijoko	Nan
زحل	saturn	Nan
زراعة	ogbin	Nan
زراعية	ogbin	Nan
زرع	gbingbin	Nan
زرنيخيد	arsenide	Nan
زعامة	oludari	Nan
زعماء	awọn oludari	Nan
زعيم	aṣáájú	Nan
زغلول	zaghloul	Nan
زكريا	sakaria	Nan
زكي	zaki	Nan
زال	ṣi	Nan
روسو	russo	Nan
زار	ṣabẹwo	Nan
زاد	pọsi	Nan
روما	lomu	Nan
رومانيا	romania	Nan
رومانية	romania	Nan
رونالدو	ronaldo	Nan
روى	sọ	None
روي	roy	Nan
رياح	afẹfẹ	Nan
رياض	riad	Nan
رياضة	idaraya	Nan
رياضية	ere idaraya	Nan
ريال	rial	Nan
ريتشارد	richard	None
ريشة	quill	Nan
ريكشا	riksha	Nan
ريولوجيا	rheology	Nan
زادت	pọsi	Nan
رشد	agbalagba	Nan
رسوم	owo	Nan
رسول	ojiṣẹ	Nan
رئاسة	ààrẹ	Nan
رئيس	alakoso	Nan
رئيسا	gẹgẹbi adari	Nan
رئيساً	gẹgẹbi adari	Nan
رئيسة	alaga	Nan
رئيسيا	olórí	Nan
رئيسياً	olórí	Nan
رئيسية	olórí	Nan
رئيسيين	olórí	Nan
رئيسًا	alakoso	Nan
رائحة	orun	Nan
رائد	aṣáájú ọ̀nà	Nan
رائدة	aṣáájú	Nan
رائعة	iyanu kan	Nan
رابط	ọna asopọ	Nan
رؤيتها	wo o	Nan
رابطة	ẹgbẹ	Nan
رؤية	iran	Nan
رؤوس	olori	Nan
ذوات	awọn obirin	Nan
ذوي	pẹlu	Nan
ذي	dhi	Nan
ذُكر	ọkunrin	Nan
رآه	sa ri	Nan
رأت	o rii	Nan
رأس	ori	None
رأسه	ori rẹ	Nan
رأسها	ori rẹ	Nan
رأسهم	ori wọn	Nan
رأى	ero	Nan
رأي	ero	Nan
رأيت	mo ti ri	Nan
رأيه	asia	Nan
رؤساء	olori	Nan
رؤيا	ìran	Nan
رابع	kẹrin	None
راجع	wo	Nan
راشد	rashid	Nan
رحل	lọ	Nan
رحلات	awọn oko oju omi	Nan
رحلة	irin ajo	Nan
رحلته	ọkọ ofurufu rẹ	Nan
ردود	awọn idahun	Nan
رسائل	awọn ifiranṣẹ	Nan
رسالة	ifiranṣẹ	Nan
رسالته	ifiranṣẹ rẹ	Nan
رستم	rustem	Nan
رسم	fa	Nan
رسمها	yiya	Nan
رسمي	osise	Nan
رسميا	ifowosi	Nan
رسمياً	ifowosi	Nan
رسميًا	ifowosi	Nan
رجم	okuta	Nan
رجليها	ẹsẹ rẹ	Nan
رجلاً	okunrin	None
رجلا	okunrin	None
رام	tafafa	Nan
راية	asia	Nan
رب	allah	Nan
ربط	ọna asopọ	Nan
ربع	mẹẹdogun	Nan
ربما	jasi	Nan
ربه	oluwa	Nan
زلزال	iwariri-ilẹ	Nan
ربيع	orisun omi	Nan
رتب	too	Nan
رتبة	ipele	None
رجال	awọn ọkunrin	Nan
رجاله	awọn ọkunrin rẹ	Nan
رجب	regep	Nan
رجع	pada	Nan
رجل	ẹsẹ kan	Nan
ربيعة	rabia	Nan
زمان	aago	Nan
زمانه	akoko re	Nan
زمن	aago	Nan
سعودية	orilẹ-ede saudi	Nan
سعوديون	saudis	Nan
سعى	beere	Nan
سعيد	dun	None
سفر	irin-ajo	Nan
سفن	awọn ọkọ oju omi	Nan
سفيان	soufyan	Nan
سفينة	ọkọ oju-omi	Nan
سقراط	socrates	Nan
سقط	ja bo	Nan
سقطت	fell	Nan
سقوط	dropp pa	Nan
سكان	olugbe	Nan
سكانديوم	scandium	Nan
سكانها	olugbe rẹ	Nan
سعودي	orilẹ-ede saudi	Nan
سكانية	olugbe	Nan
سعود	saud	Nan
سعت	mo wa	Nan
سراح	tu silẹ	Nan
سرطان	alakan	Nan
سرعان	laipẹ	Nan
سرعة	iyara	Nan
سرقة	olè	Nan
سرو	kirusi	Nan
سري	aṣiri	Nan
سرية	asiri	Nan
سريع	sare	Nan
سريعة	yiyara	Nan
سريعًا	laipẹ	Nan
سطح	dada	Nan
سطحه	oju-ilẹ rẹ	Nan
سطحها	oju-ilẹ rẹ	Nan
سعاد	suad	Nan
سعر	owo	Nan
سكة	rail	Nan
سكر	ṣuga	Nan
سكك	awọn afowodimu	Nan
سلوك	ihuwasi	Nan
سليم	salim	Nan
سليمان	sulaiman	Nan
سم	cm	Nan
سمات	awọn ẹya	Nan
سماه	o pe e	Nan
سمة	trait	Nan
سمح	gba laaye	Nan
سمحت	ti gba laaye	Nan
سمع	o gbo	Nan
سمعت	mo ti gbọ	Nan
سمك	ẹja	Nan
سمي	ti o lorukọ	Nan
سميت	o ti a daruko	Nan
سمير	sameer	Nan
سلمية	alaafia	None
سلمة	salama	Nan
سلمان	sáráì	Nan
سلم	akọbu	Nan
سكن	ibugbe	Nan
سلاح	ohun ija kan	Nan
سلاسل	awọn ẹwọn	Nan
سلاطين	sultans	Nan
سلالات	awọn ọna	Nan
سلالة	igara	Nan
سلام	pẹlẹ o	Nan
سر	asiri	Nan
سلامة	aabo	Nan
سلسلة	jara	Nan
سلطات	awọn alaṣẹ	Nan
سلطان	sultan	Nan
سلطة	saladi	Nan
سلطنة	sultanate	Nan
سلف	awọn awin	Nan
سلفوناميد	sulfonamide	Nan
سلبية	ilodi	Nan
ذو	ti ṣee	Nan
سدة	pulọọgi	Nan
سحب	ilọkuro	Nan
زيدان	zidane	Nan
زين	zain	Nan
زينب	saynab	Nan
س	s	Nan
سأل	beere	Nan
سؤال	ibeere kan	Nan
سائر	omiiran	Nan
سائل	omi oloomi	Nan
سابق	tele	None
سابقا	tẹlẹ	Nan
سابقاً	tẹlẹ	Nan
سابقة	ipilẹṣẹ	Nan
سابقًا	tẹlẹ	Nan
ساحة	àgbàlá	Nan
ساحل	etikun	Nan
زيد	zaid	Nan
ساحلية	etikun	Nan
زيت	epo	Nan
زيادة	a plus	Nan
زمني	akoko mi	Nan
زمنية	aago	Nan
زنكي	sinkii	Nan
زهرة	ododo	None
زواج	igbeyawo	None
زواجه	igbeyawo re	Nan
زوال	ìparun	Nan
زوج	ọkọ	Nan
زوجات	awọn iyawo	Nan
زوجاته	awọn iyawo rẹ	Nan
زوجة	iyawo	None
زوجته	iyawo e	Nan
زوجها	ọkọ rẹ	Nan
زوكربيرج	zuckerberg	Nan
زياد	ziyad	Nan
زيارة	ṣabẹwo	Nan
سار	o rin	Nan
ساراكينوس	saracenus	Nan
سارة	sara	Nan
سبعة	meje	Nan
سبعين	aadọrin	Nan
سبق	tẹlẹ	Nan
سبقت	sáré	Nan
سبيس	myspace	Nan
سبيل	ona	Nan
ست	mefa	Nan
ستالين	stalin	Nan
ستة	mefa	Nan
ستكون	yoo jẹ bẹ	Nan
ستيرول	ise elegbogi	Nan
ستين	ogota	Nan
سجل	igbasilẹ	Nan
سجن	ẹwọn	Nan
سحابة	awọsanma	Nan
سبع	meje	Nan
سبحانه	ogo ni fun un	Nan
سبتمبر	oṣu kẹsan	Nan
سببا	idi kan	Nan
ساعات	awọn wakati	Nan
ساعة	wakati	Nan
ساعد	iranlọwọ	Nan
ساعدت	iranlọwọ	Nan
سافر	irin-ajo	Nan
سالم	salem	None
سامي	sami	Nan
سد	pulọọgi	Nan
سامية	arosọ	Nan
سانت	st.	Nan
ساهم	pinpin	Nan
ساهمت	pinpin	Nan
سبأ	sheeba	Nan
سباق	ije kan	Nan
سباقات	awọn ẹka	Nan
سبب	idi	Nan
سان	san	Nan
لتصل	lati de odo	Nan
ذهبية	wẹwẹ	Nan
ذلك	iyẹn	Nan
خاصا	ni pataki	Nan
خاصة	paapa	Nan
خاصةً	paapa	Nan
خاصية	ohun-ini	Nan
خاض	ni ireti	Nan
خاضعة	koko-ọrọ	Nan
خالد	aiku	Nan
خالص	mimọ	Nan
خالية	ṣofo	Nan
خام	aise	Nan
خان	khan	Nan
ختان	kọlà	Nan
خدمات	awọn iṣẹ	Nan
خدمة	iṣẹ	Nan
خديجة	ikorira	Nan
خاص	pataki	Nan
خرائط	awọn maapu	Nan
خارجية	ita	Nan
خادم	iranṣẹ	Nan
حياتها	rẹ aye	Nan
حياتهم	aye won	Nan
حياتي	igbesi aye mi	Nan
حيان	hayyan	Nan
حية	laaye	Nan
حيث	nibo	Nan
حيفا	haifa	Nan
حين	nigbawo	Nan
حينما	nigbakugba	Nan
حينها	ni igba yen	Nan
حيوان	eran	Nan
حيوانات	ẹranko	Nan
حيوانية	eran	Nan
حيوية	pataki	Nan
خابية	kaṣe	Nan
خارجي	ita	Nan
حياته	igbesi aye	Nan
خراسان	khorasan	Nan
خرجت	jade wá	Nan
خطبة	ọrọ	Nan
خطة	gbero	Nan
خطر	ewu	Nan
خطط	awọn ero	Nan
خطف	jijipa	Nan
خطوة	igbesẹ kan	Nan
خطورة	ijamba	Nan
خطوط	awọn ọna ila	Nan
خطيرة	isẹ	Nan
خفض	asekale si isalẹ	Nan
خفيف	ina	Nan
خفيفة	imọlẹ	Nan
خلاف	àríyànjiyàn	Nan
خلافته	aṣeyọri rẹ	Nan
خلال	nipasẹ	Nan
خطاب	ọrọ	Nan
خرج	jade	Nan
خطأ	aṣiṣe	Nan
خضعت	ti lọ	Nan
خرجوا	wọn jade	Nan
خروج	jade	Nan
خريطة	maapu kan	Nan
خزيمة	ṣẹgun	Nan
خسائر	adanu	Nan
خسارة	isonu	Nan
خسر	ti sọnu	Nan
خصائص	awọn ohun-ini	Nan
خصبة	irọyin	Nan
خصوصا	paapa	Nan
خصوصاً	paapa	Nan
خصوصًا	paapa	Nan
خصومه	àríyànjiyàn	Nan
خضراء	alawọ ewe	Nan
خضع	koko	Nan
خط	laini	Nan
حياة	igbesi aye	Nan
حي	aladugbo	Nan
حولها	ni ayika	Nan
حكام	awọn oludari	Nan
حكايات	awọn ta	Nan
حكاية	itan	Nan
حكم	ofin	None
حكمة	ọgbọn	Nan
حكمت	o jọba	Nan
حكمه	ọgbọn	Nan
حكمها	ofin rẹ	Nan
حكمهم	ofin wọn	Nan
حكومات	awọn ijọba	Nan
حكومة	ijọba	Nan
حكومي	ti ijọba	Nan
حكومية	ijoba	Nan
حكيم	seji	Nan
حلال	hala	Nan
حقيقية	gidi	Nan
حلب	aleppo	Nan
حقيقي	gidi	Nan
حقول	awọn aaye	Nan
حضر	wa	Nan
حضور	iwaju	Nan
حطين	hatitin	Nan
حظر	idiwọ kan	Nan
حفر	liluho	Nan
حفظ	fipamọ	Nan
حفل	ẹgbẹ	Nan
حق	ni ọtun	Nan
حقائق	awọn ododo	Nan
حقبة	igbala	Nan
حقق	ṣe aṣeyọri	Nan
حققت	ṣe aṣeyọri	Nan
حقل	pápá	Nan
حقه	ọtun	Nan
حقوق	awọn ẹtọ	Nan
حقيقة	.ótọ́	Nan
حلت	ti tuka	Nan
حلف	aṣọ	Nan
حلقات	awọn ere	Nan
حمير	kẹtẹkẹtẹ	Nan
حنا	hanna	Nan
حنبعل	hannibal	Nan
حنبل	hanbal	Nan
حنك	aafin	Nan
حنيفة	hanifa	Nan
حنين	nostalgia	Nan
حواء	efa	Nan
حوادث	awọn ijamba	Nan
حوار	ijiroro	Nan
حوالي	yika	Nan
حوذانية	labalaba	None
حوض	agbọn	Nan
حول	nipa	Nan
حوله	ni ayika rẹ	Nan
حملته	ipolongo rẹ	Nan
حملت	ti kojọpọ	Nan
حملة	ipolongo	Nan
حملات	awọn ipolowo	Nan
حلقة	òrùka	Nan
حلمي	àlá mi	Nan
حلول	awọn solusan	Nan
حلويات	suwiti	Nan
حماة	awọn alaabo	Nan
حماد	hammad	Nan
حماس	ifarabalẹ	Nan
خلاله	lakoko rẹ	Nan
حماية	aabo	Nan
حمدان	hamdan	Nan
حمدي	hamdi	Nan
حمراء	pupa	None
حمزة	hamza	Nan
حمص	adiye	Nan
حمض	acid	Nan
حمل	oyun	Nan
حمد	o yìn	Nan
خلالها	lakoko rẹ	Nan
خلايا	awọn sẹẹli	Nan
خلدون	khaldoun	Nan
دورات	awọn ẹkọ	Nan
دوران	iyipo	Nan
دوراً	ipa kan	Nan
دورة	ẹkọ	Nan
دوره	ẹkọ	Nan
دورها	rẹ ipa	Nan
دوري	kẹta	None
دورية	oluṣọ	Nan
دورًا	ipa kan	Nan
دول	awọn orilẹ-ede	Nan
دولار	awọn dọla	Nan
دولة	orilẹ-ede	Nan
دولته	orilẹ-ede rẹ	Nan
دولتهم	ipinle wọn	Nan
دولتين	awọn ipinlẹ meji	Nan
دورا	ipa kan	Nan
دولي	kariaye	Nan
دور	ipa	Nan
دو	du	None
دفن	isinku	Nan
دقائق	iṣẹju	Nan
دقة	yiye	Nan
دقيق	iyẹfun	Nan
دقيقة	pipe	Nan
دلائل	eri	Nan
دلالة	itọkasi	Nan
دلتا	delta	Nan
دليل	itọsọna	Nan
دم	ẹ̀jẹ̀	Nan
دمج	dapọ	Nan
دمرت	parun	Nan
دمشق	damasku	Nan
دمياط	damietta	Nan
دنيا	donia	Nan
دوائر	awọn iyika	Nan
دولياً	ni kariaye	Nan
دولية	international	Nan
دون	laisi	Nan
ذاته	kanna	Nan
ذاتها	ararẹ	Nan
ذاتي	koko-ọrọ	Nan
ذاتية	pada	Nan
ذاك	iyẹn	Nan
ذاكرة	iranti	Nan
ذرات	atomu	Nan
ذروة	gongo	Nan
ذروتها	giga	Nan
ذرية	ọmọ	None
ذكر	ọkunrin	Nan
ذكره	darukọ o	Nan
ذكرها	darukọ o	Nan
ذكرى	iranti	Nan
ذكور	ọkunrin	Nan
ذات	jẹmọ	Nan
ذا	awọn	Nan
ديوان	diwan	Nan
دينًا	esin	Nan
دياب	diab	Nan
ديانة	ẹsin	Nan
دير	monastery	Nan
ديزني	disney	Nan
ديسمبر	oṣu kejila	Nan
ديفنباخيا	devenpachia	Nan
ديفيد	dáfídì	Nan
دفعت	sanwo	Nan
ديل	dell	Nan
دين	gbese	None
دينار	dinari	Nan
ديناصور	dinosaur	Nan
دينه	ẹsin rẹ	Nan
دينهم	esin won	Nan
ديني	ẹlẹsin	Nan
دينية	esin	Nan
ديمقراطية	tiwantiwa	Nan
ذهب	lọ	Nan
دفعة	sanwo	Nan
دعى	o pe	Nan
خوف	bẹru	Nan
خوفو	khufu	Nan
خياطة	ranko	Nan
خيبر	khaibar	Nan
خير	o dara	Nan
د	dokita	Nan
دا	s	Nan
داء	aisan	Nan
دائرة	circle	Nan
دائرية	ayika	Nan
دائم	titilai	Nan
دائما	nigbagbogbo	Nan
دائماً	nigbagbogbo	Nan
دائمة	nigbagbogbo	Nan
دائمًا	nigbagbogbo	Nan
خوسيه	jose	Nan
داخل	inu	Nan
خوان	juan	Nan
خمسة	marun	Nan
خلع	bọ kuro	Nan
خلف	sile	None
خلفاء	aṣeyọri	Nan
خلفه	sile e	Nan
خلفها	osi loke	Nan
خلفية	lẹhin	Nan
خلقه	ẹda rẹ	Nan
خلل	abawọn	Nan
خلنجية	heather	Nan
خلية	sẹẹli	Nan
خليج	bay	Nan
خليط	adalu	Nan
خليفة	agbapo	Nan
خليل	khalil	Nan
خمس	marun	Nan
خمسين	aadọta	Nan
داخلي	ti abẹnu	Nan
داخلية	ti inu	Nan
دار	dar: ile	Nan
درس	ẹkọ	Nan
درع	asà	Nan
درهم	aed	Nan
دروس	awọn tutorial	Nan
درويش	darwish	Nan
دريد	duraid	Nan
دستور	t’olofin	Nan
دستوري	t’olofin	Nan
دستورية	t&#39;olofin	Nan
دعا	pe	Nan
دعاء	adura	Nan
دعت	o pe	Nan
دعم	atilẹyin	Nan
دعوة	pe	Nan
دعوته	ipe rẹ	Nan
درجة	ìyí	Nan
درجات	awọn iwọn	Nan
درب	ọnà	Nan
دراما	eré	Nan
دارت	ẹsẹ	None
داروين	darwin	Nan
دام	ti firanṣẹ	Nan
دامت	bi gun to	Nan
داود	dáfídì	Nan
داوود	dáfídì	Nan
دبلوماسية	diplomacy	Nan
دفع	sanwo	Nan
دبي	ilu dubai	Nan
دخل	owo oya	Nan
دخلت	mo wọ inu	Nan
دخول	wo ile	Nan
دخوله	titẹ sii	Nan
دراسات	awọn ijinlẹ	Nan
دراسته	ṣe iwadi rẹ	Nan
دراسية	ikẹkọ	Nan
دجلة	tigris	Nan
لتطور	lati dagbasoke	Nan
لتطوير	lati dagbasoke	Nan
لتعداد	lati akojopo	Nan
وتكون	ki o si jẹ	Nan
وتكوين	ati atunto	Nan
وتلك	ati awọn wọnyẹn	Nan
وتم	ati awọn ti o ti ṣe	Nan
وتمت	ati awọn ti o ti ṣe	Nan
وتمتد	nkanna	Nan
وتمتلك	ati awọn ti o ni	Nan
وتمثل	ki o si soju	Nan
وتمكن	o ṣakoso	Nan
وتنتج	o mu wa	Nan
وتنتشر	ati ki o tan	Nan
وتنظيم	ati ilana	Nan
وتنقسم	pin	Nan
وتهدف	ifọkanbalẹ	Nan
وتوجد	o wa	Nan
وتقوم	ati orisun	Nan
وتوزيع	ati pinpin	Nan
وتقول	ati pe o sọ	Nan
وتقدم	ti pese	Nan
وتطور	o dagbasoke	Nan
وتطورت	ati awọn ti o wa lati	Nan
وتطوير	ati idagbasoke	Nan
وتظهر	ki o si fihan	Nan
وتعالى	olodumare	Nan
وتعتبر	ti wa ni gbero	Nan
وتعتمد	o gbarale	Nan
وتعد	ati mura	Nan
وتعرف	ati pe o mọ	Nan
وتعزيز	ati igbega	Nan
وتعمل	o ṣiṣẹ	Nan
وتعني	o tumọ si	Nan
وتعود	ati pada	Nan
وتعيين	ati ṣeto	Nan
وتغطي	ati ibora	Nan
وتقع	ṣubu	Nan
وتطبيق	ati ohun elo	Nan
وتوفي	okurin naa ku	Nan
وتونس	ati tunisia	Nan
وجعلها	ati ki o ṣe	Nan
وجل	gbigbegaga	Nan
وجمع	ki o si gba	Nan
وجمهورية	ati ijọba olominira kan	Nan
وجميع	ati gbogbo	Nan
وجنوب	ati gusu	Nan
وجه	oju	Nan
وجهات	awọn ibi	Nan
وجهة	ibi	Nan
وجهه	oju rẹ	Nan
وجهها	oju rẹ	Nan
وجوب	ni dandan	Nan
وجود	iwaju	Nan
وجوده	wíwàníhìn-ín rẹ	Nan
وجودها	iwaju rẹ	Nan
وجعل	ki o si ṣe	Nan
وتولى	o mu	Nan
وجزيرة	ati erekusu kan	Nan
وجدير	o tọ	Nan
وتيرة	pace	Nan
وثائق	awọn iwe aṣẹ	Nan
وثائقي	itan	Nan
وثاني	ati ekeji	Nan
وثلاثة	ati mẹta	Nan
وثلاثون	ọgbọn	Nan
وثلاثين	ọgbọn	Nan
وثيقة	iwe	Nan
وجاء	o wa	Nan
وجاءت	o wa	Nan
وجامعة	ati ile-iwe giga	Nan
وجبال	ati awọn oke-nla	Nan
وجبل	ati oke	Nan
وجد	ni a rii	Nan
وجدت	wa	Nan
وجزر	ati awọn erekusu	Nan
وتضم	awọn idije	Nan
وتصل	ati oke	Nan
وتصبح	ati ki o di	Nan
وبريطانيا	ati gẹẹsi	Nan
وبسبب	ati pe nitori	Nan
وبشكل	ati ni ọna kan	Nan
وبصفة	ati ni ọna kan	Nan
وبعد	ati sibẹsibẹ	Nan
وبعدها	ati igba yen	Nan
وبعض	ati diẹ ninu	Nan
وبعضها	diẹ ninu awọn ni	Nan
وبعضهم	ati diẹ ninu wọn	Nan
وبقي	o duro	Nan
وبقية	ati awọn iyokù	Nan
وبقيت	mo sanko lo	Nan
وبلاد	ati orilẹ-ede	Nan
وبلغ	ati ki o lu	Nan
وبلغاريا	ati bulgaria	Nan
وبذلك	nipa ti	Nan
وبلغت	gba	None
وبدأت	o bere	Nan
وبخاصة	paapa	Nan
وبأن	ati pe	Nan
وباء	àjàkálẹ àrùn	Nan
وباقي	ati awọn iyokù	Nan
وباكستان	ati pakistan	Nan
وبالأخص	gegebi bi	Nan
وبالإضافة	ni afikun	Nan
وبالتالي	ati nitorina	Nan
وبالتحديد	ati ni pataki	Nan
وبالرغم	biotilejepe	Nan
وبالفعل	ati ni otitọ	Nan
وبالمثل	bakanna	Nan
وبالنسبة	ati fun	Nan
وبحر	ati nipasẹ okun	Nan
وبحسب	gẹgẹ bi	Nan
وبحلول	nipasẹ	Nan
وبدأ	o bẹrẹ	Nan
وبما	pẹlu	Nan
وبناء	ki o si kọ	Nan
وبناءً	ati ki o constructively	Nan
وتحسين	ati ilọsiwaju	Nan
وتحقيق	ki o si ṣe aṣeyọri	Nan
وتحليل	ati onínọmbà	Nan
وتحمل	ati gbe	Nan
وتختلف	ati yato	Nan
وتربية	ati ibisi	Nan
وترجمت	ati túmọ	Nan
وترك	ki o si lọ	Nan
وتركيا	ati tọki	Nan
وتستخدم	ti lo	Nan
وتسعين	ọgọrun	Nan
وتسمى	ti a pe	Nan
وتشكل	ifipaju	Nan
وتشمل	ni	Nan
وتشير	ati tọka	Nan
وتحديد	ati atunse	Nan
وتحدث	o sọ	Nan
وتحتوي	ati ni	Nan
وتحتل	ati awọn ti tẹdo	Nan
وبنى	o kọ	Nan
وبه	ati pẹlu rẹ	Nan
وبها	ati pẹlu rẹ	Nan
وبهذا	pẹlu eyi	Nan
وبين	ati laarin	Nan
وبينما	ati nigba ti	Nan
وتأتي	ki o si wa	Nan
وجوه	nkan	None
وتأسيس	ki o si fi idi mulẹ	Nan
وتبادل	ati paṣipaarọ	Nan
وتبلغ	o de	Nan
وتتضمن	o ni	Nan
وتتكون	o ni	Nan
وتتم	ati pe o ti ṣe	Nan
وتتميز	o ti ṣe iyatọ	Nan
وتحت	ati labẹ	Nan
وتاريخ	ati ọjọ	Nan
واهتم	ati ṣe abojuto	Nan
وجيزة	finifini	Nan
وحتى	ati paapaa	Nan
وصل	dide	Nan
وصلات	awọn ọna asopọ	Nan
وصلت	ransẹ	Nan
وصلوا	dide	Nan
وصناعة	ati ile-iṣẹ	Nan
وصنع	ati ṣiṣe	Nan
وصول	wiwọle	Nan
وصوله	dide	Nan
وصية	yoo	None
وضرب	ati ki o lu	Nan
وضع	fi	None
وضعت	ni idagbasoke	Nan
وضعف	ailagbara	Nan
وضعها	fi si isalẹ	Nan
وطرق	ati awọn ọna	Nan
وصفه	ohunelo	Nan
وطريق	ati opopona kan	Nan
وصفاته	awọn eroja rẹ	Nan
وصدر	ati idasilẹ	Nan
وسرعان	ati bẹbẹ lọ	Nan
وسط	aarin	Nan
وسقوط	ki o si ṣubu	Nan
وسلم	oun	None
وسميت	o ti a npe ni	Nan
وسوريا	ati siria	Nan
وسوق	ati ọjà	Nan
وشبه	ati irisi	Nan
وشرح	ki o si se alaye	Nan
وشرق	ati ila-oorun	Nan
وشركة	ati ile-iṣẹ kan	Nan
وشمال	ariwa	Nan
وشهد	ati ri	Nan
وشهدت	ati ri	Nan
وصار	o si di	Nan
وصف	ṣe apejuwe	Nan
وسبب	ati idi kan	Nan
وطريقة	ati ọna	Nan
وطن	ile-ile	Nan
وعرض	o ṣafihan	Nan
وعرف	o mọ	Nan
وعرفت	mo mọ	Nan
وعشرون	meji	Nan
وعشرين	ati ogun	Nan
وعضو	ati ọmọ ẹgbẹ	Nan
وعقد	ki o si mu	Nan
وعلاوة	pẹlupẹlu	Nan
وعلم	ati mimọ	Nan
وعلماء	ati awọn ọjọgbọn	Nan
وعلوم	ati awọn sáyẹnsì	Nan
وعلى	ati lori	Nan
وعلي	ati lori	Nan
وعليه	ati lori rẹ	Nan
وعمر	ati omar	Nan
وعدم	ati ki o ko ni ogbon	Nan
وطلب	o beere	Nan
وعددها	ati nọmba rẹ	Nan
وعد	ṣèlérí	Nan
وطني	orilẹ-ede	Nan
وطنية	omo ilu	Nan
وظائف	awọn iṣẹ	Nan
وظل	ati ki o tọju	Nan
وظلت	o wa nibe	Nan
وظهر	o si farahan	Nan
وظهرت	o han	Nan
وظهور	ati irisi	Nan
وظيفة	jóòbù	Nan
وعاد	o pada	Nan
وعادة	ati igbagbogbo	Nan
وعاش	o wa laaye	Nan
وعاصمتها	ati olu-ilu rẹ	Nan
وعبد	ati ẹrú	Nan
وعبر	ati kọja	Nan
وعدد	ati nọmba kan	Nan
وسام	wissam	Nan
وساعد	o ṣe iranlọwọ	Nan
وسائل	ọna	Nan
وحيدة	ẹyọ kan	Nan
وحين	ati nigbati	Nan
وخاصة	paapa	Nan
وخاصةً	paapa	Nan
وخرج	o wa jade	Nan
وخصوصا	paapa	Nan
وخصوصاً	paapa	Nan
وخصوصًا	paapa	Nan
وخلال	ati nipasẹ	Nan
وخلفه	ati lẹhin rẹ	Nan
وخلق	ki o si ṣẹda	Nan
وخمسين	ati aadọta	Nan
ودار	ati ile	Nan
ودخل	ati ki o wọ	Nan
ودراسة	ati iwadi	Nan
وحيد	nikan	Nan
ودرجة	ati alefa	Nan
وحيث	ati nibo	Nan
وحول	ati nipa	Nan
وحدات	awọn ipin	Nan
وحدة	ẹyọ kan	Nan
وحده	ẹyọ kan	Nan
وحدها	ẹyọ kan	Nan
وحركة	ati gbigbe	Nan
وحرية	ati ominira	Nan
وحسب	ati pe o kan	Nan
وحسن	ati pe o dara	Nan
وحصل	o si ni	Nan
وحضر	ati ki o wa	Nan
وحفظ	ki o si fipamọ	Nan
وحقوق	ati awọn ẹtọ	Nan
وحكم	ati idajọ	Nan
وحماية	ati aabo	Nan
وحمل	ati igbasilẹ	Nan
وحي	awokose	Nan
ودرس	o kẹkọ	Nan
ودعا	ti a pe	Nan
ودعت	o pe	Nan
ورغم	biotilejepe	Nan
ورفض	o kọ	Nan
ورفع	ati gbega	Nan
ورق	iwe	Nan
ورقة	dì	None
وروسيا	ati russia	Nan
وزاد	ati pọsi	Nan
وزارة	ifiranṣẹ	Nan
وزراء	awọn minisita	Nan
وزن	iwuwo	Nan
وزوجته	ati iyawo rẹ	Nan
وزيادة	ati siwaju sii	Nan
وزيت	ati ororo	Nan
وزير	òjíṣẹ́	Nan
وسائر	ati gbogbo awọn miiran	Nan
وردت	gba	None
وردة	a dide	Nan
ورد	òdòdó	Nan
ورجال	ati awọn ọkunrin	Nan
ودعم	ati atilẹyin	Nan
ودفن	ati ki o sin	Nan
ودمشق	ati damasku	Nan
ودور	ati ipa	Nan
ودول	ati awọn orilẹ-ede	Nan
ودولة	ati orilẹ-ede	Nan
ودون	ati laisi	Nan
وحاول	ati ki o gbiyanju	Nan
وذكر	o mẹnuba	Nan
وذهب	o si lọ	Nan
ورأى	ati ri	Nan
ورئيس	ati ori	Nan
وراء	sile	None
وراثيا	atilẹba ohun gbogbo	Nan
وراح	o si lọ	Nan
وربما	ati boya	Nan
وذلك	ati pe	Nan
وانخفاض	ati kekere	Nan
وانتهى	o ti pari	Nan
وانتهت	o si pari	Nan
والبعض	ati diẹ ninu	Nan
والبنية	ati be	Nan
والبيئة	ati ayika	Nan
والتاريخ	ati itan	Nan
والتجارة	ati isowo	Nan
والتحليل	ati onínọmbà	Nan
والتخلص	ati ki o xo	Nan
والتدريب	ati ikẹkọ	Nan
والتطور	ati itankalẹ	Nan
والتطوير	ati idagbasoke	Nan
والتعاون	ati ifowosowopo	Nan
والتعليم	ati eto-ẹkọ	Nan
والتقاليد	ati awọn aṣa	Nan
والتكنولوجيا	ati imọ-ẹrọ	Nan
والتلفزيون	ati tv	Nan
والبحرين	ati bahrain	Nan
والتنمية	ati idagbasoke	Nan
والبحرية	okun-nla	Nan
والباحثين	ati awọn oniwadi	Nan
والإسلام	ati islam	Nan
والإسلامية	ati islam	Nan
والإعلام	ati awọn media	Nan
والإمارات	ati emi naa	Nan
والإمام	ati imam	Nan
والإمبراطورية	ati ijọba	Nan
والإنسان	ati eniyan	Nan
والإيمان	ati igbagbọ	Nan
والاتحاد	ati awọn euroopu	Nan
والاتصالات	ati ibaraẹnisọrọ	Nan
والاجتماعي	ati ti awujo	Nan
والاجتماعية	ati ti awujo	Nan
والاقتصاد	ati aje	Nan
والاقتصادي	ati pe ọrọ-aje	Nan
والاقتصادية	ati aje	Nan
والبحر	ati okun	Nan
والإدارة	ati iṣakoso	Nan
والتوزيع	ati pinpin	Nan
والثالث	ati ẹkẹta	Nan
والحرية	ati ominira	Nan
والحزب	ati keta	Nan
والحسن	ati pe o dara	Nan
والحسين	ati hussein	Nan
والحضارة	ati ọlaju	Nan
والحفاظ	ki o si tọju	Nan
والحكم	ati idajọ	Nan
والحكومات	ati awọn ijọba	Nan
والحكومة	ati ijọba	Nan
والحياة	ati igbe aye	Nan
والحيوانات	ati awon eranko	Nan
والخارجية	ati ni ita	Nan
والخاصة	ati pataki	Nan
والخدمات	ati awọn iṣẹ	Nan
والد	baba	Nan
والحروب	ati awọn ogun	Nan
والتي	ati pe	Nan
والحركة	ati gbigbe	Nan
والحديد	ati irin	Nan
والثاني	ati ekeji	Nan
والثانية	ati ekeji	Nan
والثقافة	ati asa	Nan
والجامعات	ati awọn ile-iwe giga	Nan
والجدير	ati tọ	Nan
والجزء	ati apakan	Nan
والجزائر	ati algeria	Nan
والجزر	ati awọn erekusu	Nan
والجماعة	ati ẹgbẹ naa	Nan
والجمال	ati ẹwa	Nan
والجنوب	ati guusu	Nan
والجنوبية	ati gusu	Nan
والجيش	ati awọn ọmọ ogun	Nan
والحجاز	ati hijaz	Nan
والحديث	ati ki o sọrọ	Nan
والحرب	ati ogun	Nan
والأنهار	ati odo	Nan
والأنصار	ati awọn alatilẹyin	Nan
والأميرة	ati ayaba	Nan
وإنشاء	ki o si ṣẹda	Nan
وإنما	ṣugbọn dipo	Nan
وإيران	ati iran	Nan
وإيطاليا	ati italia	Nan
وائل	wael	Nan
وابن	ati ọmọ	Nan
وابنه	ati ọmọ rẹ	Nan
واجب	iṣẹ	Nan
واجه	oju	Nan
واجهة	ọlọpọọmídíà	Nan
واجهت	dojuko	Nan
واحد	ọkan	Nan
واحدا	ọkan	Nan
واحداً	ọkan	Nan
واحدة	ọkan	Nan
وإنتاج	ati iṣelọpọ	Nan
واحدًا	ọkan	Nan
وإن	ati daju	Nan
وإلا	bibẹẹkọ	Nan
وأهمها	pataki julo	Nan
وأوائل	ati ni kutukutu	Nan
وأوروبا	ati yuroopu	Nan
وأول	ati ni akọkọ	Nan
وأي	ati eyikeyi	Nan
وأيضا	ati pe pẹlu	Nan
وأيضاً	ati pe pẹlu	Nan
وأيضًا	ati pe pẹlu	Nan
وإدارة	ati iṣakoso	Nan
وإذا	ti o ba ti	Nan
وإسبانيا	ati spain	Nan
وإسرائيل	ati israeli	Nan
وإعادة	ati ki o tun	Nan
وإعلان	ati ikede kan	Nan
وإقامة	ki o si fi idi mulẹ	Nan
وإلى	ati si	Nan
وادي	àfonífojì	Nan
وارتفاع	ati pe giga	Nan
واستخدام	ati lilo	Nan
والآلات	ati awọn ero	Nan
والأحزاب	ati awọn ẹgbẹ	Nan
والأخرى	ati ekeji	Nan
والأخلاق	ati iwa	Nan
والأدب	ati litireso	Nan
والأراضي	ati awọn ilẹ	Nan
والأردن	ati jordani	Nan
والأرض	ati earth	Nan
والأطفال	ati awọn ọmọde	Nan
والأعمال	ati iṣowo	Nan
والأفكار	ati awọn imọran	Nan
والأكثر	ati diẹ sii	Nan
والأمراء	ati awọn ijoye	Nan
والأمن	ati aabo	Nan
والأمير	ati olori	Nan
والآداب	ati awọn ihuwasi	Nan
والآخر	ati ekeji	Nan
والآثار	ati awọn ipa	Nan
واقعة	iṣẹlẹ	Nan
واستخدم	ati lilo	Nan
واستطاعت	ati pe o ṣakoso	Nan
واستمر	ati ki o tẹsiwaju	Nan
واستمرت	ati ki o tẹsiwaju	Nan
واسع	jooro	Nan
واسعة	jooro	Nan
واسم	ati orukọ	Nan
والدة	iya	Nan
واسمه	ati orukọ rẹ	Nan
واصل	mura si	Nan
واضح	ko o	Nan
واضحة	ko o	Nan
واعتبر	ti kà	Nan
وافق	o gba	Nan
وافقت	ti a fọwọsi	Nan
واقع	otito	Nan
واشنطن	washington	Nan
والدته	iya rẹ	Nan
والدراسات	ati awọn ijinlẹ	Nan
والدفاع	ati aabo	Nan
والماء	ati omi	Nan
والمحيط	ati okun	Nan
والمدارس	ati awọn ile-iwe	Nan
والمدن	ati awọn ilu	Nan
والمدينة	ati ilu naa	Nan
والمرأة	ati obinrin na	Nan
والمسجد	ati mossalassi naa	Nan
والمسيحية	ati kristiẹniti	Nan
والمسيحيين	ati awọn kristiani	Nan
والمعادن	ati ohun alumọni	Nan
والمعاهد	ati awọn ilana	Nan
والمعدات	ati ẹrọ	Nan
والمعراج	ati mirage	Nan
والمعرفة	ati imo	Nan
والمعروف	mo	Nan
والمؤسسات	ati awọn ile-iṣẹ	Nan
والمعروفة	mo	Nan
والله	mo bura	Nan
واللغات	ati awọn ede	Nan
والفيزياء	ati fisiksi	Nan
والقانون	ati ofin	Nan
والقدرة	ati agbara	Nan
والقرآن	ati al-qur’an	Nan
والقضاء	ati imukuro	Nan
والقمر	ati oṣupa	Nan
والقوات	ati awọn ipa	Nan
والقوانين	ati awọn ofin	Nan
والقوة	ati okun	Nan
والكتاب	ati iwe	Nan
والكتابة	ki o si kọ	Nan
والكثير	ati pupọ diẹ sii	Nan
والكنيسة	ati ijo	Nan
والكواكب	ati awon aye orun	Nan
والكيمياء	ati kemistri	Nan
واللغة	ati ede	Nan
والمغرب	ati ilu morocco	Nan
والمكسيك	ati meksiko	Nan
والملك	ati ọba	Nan
والهند	india	Nan
والهندسة	ati ina-	Nan
والواقع	lootọ	Nan
والولايات	ati awọn ipinle	Nan
والي	wali	Nan
واليابان	ati japan	Nan
واليمن	ati yemen	Nan
واليهود	ati awọn ju	Nan
واليهودية	ati ẹsin juu	Nan
واليوم	ati loni	Nan
واليونان	griki	Nan
وان	ati daju	Nan
وانتشار	ati ki o tan	Nan
وانتشر	o tan ka	Nan
وانتشرت	ati ki o tan jade	Nan
والهرسك	ati herzegovina	Nan
والنهاية	ati nikẹhin	Nan
والنمسا	ati austria	Nan
والنقل	ati gbigbe	Nan
والمملكة	ati ijọba naa	Nan
والمناخ	ati afefe	Nan
والمناطق	ati awọn ẹkun ni	Nan
والمنتجات	ati awọn ọja	Nan
والمنطق	ati ọgbọn kan	Nan
والمنطقة	ati ekun	Nan
والمواد	ati awọn ohun elo	Nan
والفنون	ati awọn ona	Nan
والمواصلات	gbigbe	Nan
والمياه	ati omi	Nan
والنباتات	ati awon eweko	Nan
والنجوم	ati awọn irawọ	Nan
والنرويج	norway	Nan
والنساء	ati awọn obinrin	Nan
والنسيج	ati aṣọ naa	Nan
والنقد	ati ibawi	Nan
والموسيقى	ati orin	Nan
وعن	ati nipa	Nan
والفن	ati aworan	Nan
والفلسفة	ati imoye	Nan
والسبب	ati pe idi	Nan
والسعودية	ati saudi arabia	Nan
والسلام	ati alafia	Nan
والسنة	ati ọdun	Nan
والسودان	ati sudan	Nan
والسويد	sweden	Nan
والسياسة	ati iselu	Nan
والسياسي	ati oloselu naa	Nan
والسياسية	ati iselu	Nan
والسيطرة	ati iṣakoso	Nan
والشام	ati ọmọ lefi	Nan
والشرق	ati ila-oorun	Nan
والشركات	ati awọn ile-iṣẹ	Nan
والشعر	ati irun	Nan
والشمال	ati ariwa	Nan
والسادس	ati ẹkẹfa	Nan
والشيخ	ati sheikh	Nan
والزهرة	ati ododo	Nan
والزبير	ati zubair	Nan
والدليل	ẹri naa	Nan
والده	iya	Nan
والدها	baba rẹ	Nan
والدول	ati awọn ipinle	Nan
والدولة	ati ipinle	Nan
والدين	awọn obi	Nan
والدينية	esin	Nan
والذي	ati tani	Nan
والذين	ati tani	Nan
والرئيس	ati alakoso	Nan
والرابع	ati ẹkẹrin	Nan
والرومان	ati awọn romu	Nan
والرومانية	ati romania	Nan
والرياح	ati afẹfẹ	Nan
والرياضيات	ati mathimatiki	Nan
والزراعة	ati ogbin	Nan
والشيعة	shiites	Nan
والصفات	ati awọn eroja	Nan
والصلاة	ati adura	Nan
والعلوم	ati imọ	Nan
والعمارة	ati faaji	Nan
والعمل	ati ṣiṣẹ	Nan
والعمليات	ati awọn iṣẹ	Nan
والعناية	ati ki o ya itoju	Nan
والغابات	ati awon igbo	Nan
والغاز	ati gaasi	Nan
والغرب	ati oorun	Nan
والغربية	oorun	Nan
والغناء	ati orin	Nan
والفارسية	ati persian	Nan
والفرات	odò	Nan
والفرنسية	ati faranse	Nan
والفضة	ati fadaka	Nan
والفقه	agbara	None
والعلمية	ati sayensi	Nan
والعلماء	ati awọn ọjọgbọn	Nan
والعلم	ati imọ	Nan
والعلاقات	ati awọn ibatan	Nan
والصناعات	ati awọn ile-iṣẹ	Nan
والصناعة	ati ile-iṣẹ	Nan
والصين	ati ṣaini	Nan
والطاقة	ati agbara	Nan
والطب	ati oogun	Nan
والطيور	ati awon eye	Nan
والعالم	ati ni agbaye	Nan
والفلك	ati aworawo	Nan
والعديد	ati ọpọlọpọ diẹ sii	Nan
والعرب	ati awọn larubawa	Nan
والعربية	ati arabic	Nan
والعسكرية	ati ologun	Nan
والعشرون	meji	Nan
والعشرين	meji	Nan
والعطلات	ati awọn isinmi	Nan
والعلاج	ati itoju	Nan
والعراق	ati iraaki	Nan
وعند	ati ni	Nan
وعندها	ati igba yen	Nan
وعين	o yan	Nan
يستخدمون	wọn lo	Nan
يستطع	le	None
يستطيع	le	None
يستعمل	ti lo	Nan
يستقبل	gba	None
يستمر	tẹsiwaju	Nan
يسجل	forukọsilẹ	Nan
يسعى	wá	Nan
يسكن	gbe	None
يسمح	gba laaye	Nan
يسمى	ni a npe ni	Nan
يسميه	o pe	Nan
يسهل	awọn irọrun	Nan
يسود	ṣe a gaju	Nan
يسوع	jesu	None
يستخدمها	lilo rẹ	Nan
يسيطر	awọn isakoso	Nan
يستخدم	lilo	Nan
يسبب	o fa	Nan
يركز	koju	Nan
يرمز	awọn aami	Nan
يرون	wọn rii	Nan
يروى	sọ	None
يروي	sọ	None
يرى	ni ri	Nan
يريد	fẹ	Nan
يريفان	jerevan	Nan
يزال	ṣi	Nan
يزداد	ti n pọ si	Nan
يزيد	awọn afikun	Nan
يسار	osi	Nan
يساعد	egba mi o	Nan
يساهم	constribte	Nan
يساوي	dọgbadọgba	Nan
يسبق	awọn iṣaaju	Nan
يرفع	awọn ẹbun	Nan
يشار	tọka si	Nan
يشبه	o dabi	Nan
يصيب	o ni ipa lori	Nan
يضاف	fikun	Nan
يضع	yoo	None
يضم	ile	Nan
يضمن	idaniloju	Nan
يطلب	awọn ibeere	Nan
يطلق	ifilole	None
يظل	o ku	Nan
يظهر	o han	Nan
يعادل	ibaramu	Nan
يعانون	jiya	Nan
يعاني	ijiya	Nan
يعبر	rekoja	Nan
يعتبر	ṣakiyesi	Nan
يعتبره	ka o	Nan
يصنع	ṣe	Nan
يشارك	lilọwọsi	Nan
يصلي	o gbadura	Nan
يصف	ṣe apejuwe	Nan
يشتمل	pẹlu	Nan
يشتهر	jẹ olokiki fun	Nan
يشرب	o mu	Nan
يشرف	lola	Nan
يشعر	lero	Nan
يشغل	ṣiṣẹ	Nan
يشكل	awọn ipo	Nan
يشكلون	ifipaju	Nan
يشمل	pẹlu	Nan
يشهد	ẹlẹri	Nan
يشير	ṣe afihan	Nan
يصبح	di	Nan
يصح	atunse	None
يصدر	ti oniṣowo	Nan
يصعب	nira	Nan
يصل	de ọdọ	Nan
يرفض	o kọ	Nan
يرغب	fẹ	Nan
يرسل	ti firanṣẹ	Nan
يحتاج	nilo	Nan
يحتفظ	n tọju	Nan
يحتفل	ayeye	Nan
يحتل	awọn iṣẹ iṣe	Nan
يحتمل	o ṣeeṣe	Nan
يحتوي	gba	None
يحد	ifilelẹ	Nan
يحدث	ṣe o tabi ṣẹlẹ	Nan
يحدد	awọn ipinnu	Nan
يحدها	ti yika	Nan
يحصل	n ni	Nan
يحضر	mu	Nan
يحق	ni ẹtọ	Nan
يحقق	ṣe aṣeyọri	Nan
يحكم	idajọ	Nan
يحب	fẹran	Nan
يحل	yanju	Nan
يحاول	gbiyanju	Nan
يجمع	gbigba	Nan
يتواجد	o wa	Nan
يتوقع	reti	Nan
يتوقف	o ma duro	Nan
يتولى	gba lori	Nan
يتيح	jẹ ki	Nan
يثبت	vewe	Nan
يثرب	yathrib	Nan
يجب	gbọdọ	Nan
يجتمع	pade	Nan
يجد	wa	Nan
يجري	jije	None
يجعل	ki asopọ	Nan
يجعله	ki asopọ o	Nan
يجعلها	ki asopọ o	Nan
يجلس	joko	Nan
يجوز	gbanilaaye	Nan
يحمل	gbe	None
يحملون	wọn gbe	Nan
يحمي	dabobo	Nan
يده	ọwọ rẹ	Nan
يدور	spins	Nan
يدي	ọwọ mi	Nan
يدير	ṣiṣakoso	Nan
يديه	awọn ọwọ rẹ	Nan
يذكر	iṣaroye	Nan
يذهب	o lọ	Nan
يرابيع	sin	Nan
يراه	o rii	Nan
يراها	o rii	Nan
يربط	somọ	Nan
يرتبط	elegbe	Nan
يرتفع	dide	Nan
يرجع	nitori	Nan
يرد	fesi	Nan
يدل	ifiweranṣẹ	Nan
يدفع	sanwo	Nan
يدعي	o beere	Nan
يدعى	o beere	Nan
يحوي	ni awọn	Nan
يحيط	awọn agbegbe	Nan
يحيى	yahia	Nan
يختار	yan	None
يختلف	awọn iyatọ	Nan
يخدم	sin	Nan
يخرج	jade	Nan
يعتبرون	wọn gbero	Nan
يخص	n ṣakiyesi	Nan
يد	ọwọ	Nan
يدخل	ti nwọ	Nan
يدرس	nkọ́ni	Nan
يدرك	mọ	Nan
يدعم	atilẹyin	Nan
يدعو	pípè	Nan
يدعون	wọn beere	Nan
يخضع	koko-ọrọ	Nan
يعترف	gbigbawọle	Nan
يعتقد	awọn onigbagbọ	Nan
يعتقدون	wọn ronu	Nan
ينتمون	pẹlú	Nan
ينتمي	yoo si	Nan
ينتهي	pari	Nan
ينجب	fi fun ibi	Nan
ينجح	ṣe aṣeyọri	Nan
ينزل	lọ silẹ	Nan
ينسب	ni ifarahan	Nan
ينشأ	awọn idaamu	Nan
ينص	awọn ipinlẹ	Nan
ينطبق	nbere	Nan
ينظر	wo	Nan
ينظم	ṣeto	Nan
ينقسم	pin	Nan
ينقل	gbigbe	Nan
ينكر	kọ	Nan
ينتقل	gbe	None
يهتم	n ṣakiyesi nipa	Nan
ينتشر	tan kaakiri	Nan
ينتج	mu jade	Nan
يمثل	aṣoju	Nan
يمثلون	wọn ṣe	Nan
يمكن	le	None
يمكننا	a le	Nan
يمكنه	o le	Nan
يمكنها	o le	Nan
يملك	awọn oniwun	Nan
يمنع	awọn idena	Nan
يموت	ku	None
يميز	awọn iyatọ	Nan
يميل	duro	Nan
يمين	ni ọtun	Nan
ينادي	pípè	Nan
ينبع	stems	Nan
ينبغي	yẹ	Nan
ينتخب	dibo	Nan
يهدف	ifọkansi si	Nan
يهود	juu	Nan
يهودي	juu	Nan
يومًا	awọn ọjọ	Nan
يونانية	griki	Nan
يونايتد	orilẹ amẹrika	Nan
يونيو	oṣu karun	Nan
يوهان	johannu	Nan
يَملك	awọn oniwun	Nan
يُحتمل	o ṣeeṣe	Nan
يُسمى	ni a npe ni	Nan
يُشكل	ti wa ni akoso	Nan
يُطلق	ifilole	None
يُظهر	o han	Nan
يُعتقد	awọn onigbagbọ	Nan
يُعد	mura	Nan
يُعرف	mo	Nan
يُقال	o sọ	Nan
يوميا	ojoojumọ	Nan
يومنا	ọjọ wa	Nan
يوماً	lọjọ kan	Nan
يوما	awọn ọjọ	Nan
يهودية	juu	Nan
يهوذا	júdà	Nan
يو	yo	Nan
يواجه	awọn oju	Nan
يوان	iwin	Nan
يوتيوب	the youtube	Nan
يوجد	wa	Nan
يمتلك	awọn ohun ini	Nan
يوحنا	jòhánù	Nan
يوسف	yousuf	Nan
يوضح	awọn ifihan	Nan
يوفر	pese	Nan
يولد	ti bi	Nan
يوليو	oṣu keje	Nan
يوم	ọjọ	Nan
يومئذ	ọjọ yẹn	Nan
يوروبيوم	ara ilu yuroopu	Nan
يتناول	awọn adehun pẹlu	Nan
يمتد	awọn awin	Nan
يمارس	iwa	Nan
يغطي	awọn ideri	Nan
يغلب	lu	Nan
يغير	yipada	None
يفتح	ṣi	Nan
يفترض	gbiyanju	Nan
يفرض	nlo	Nan
يفسر	ṣe alaye	Nan
يفصل	awọn ipinya	Nan
يفضل	ti fẹran	Nan
يفعل	ṣe	Nan
يفقد	padanu	Nan
يفكر	ronu	Nan
يفهم	oye	Nan
يفوز	aamieye	Nan
يفوق	o koja	Nan
يعين	awọn apẹẹrẹ	Nan
يفيد	anfani	Nan
يعيشون	wọn n gbe	Nan
يعيد	tun	Nan
يعتمد	gbarale	Nan
يعد	mura	Nan
يعرض	han	Nan
يعرف	mo	Nan
يعرفه	mọ ọ	Nan
يعرفون	wọn mọ	Nan
يعطي	fifun	Nan
يعقوب	yacoub	Nan
يعكس	awọn afihan	Nan
يعلم	mọ	Nan
يعلن	kede	Nan
يعمل	awọn iṣẹ	Nan
يعملون	ṣiṣẹ	Nan
يعني	tumọ si	Nan
يعود	awọn ipadabọ	Nan
يعيش	gbe	None
يقارب	isunmọ	Nan
يقال	o sọ	Nan
يقام	wáyé	Nan
يقيم	aye	Nan
يكاد	fẹrẹ	Nan
يكتب	awọn kikọ	Nan
يكثر	pọpọ̀	Nan
يكفي	to	None
يكن	kii ṣe	Nan
يكون	ti wa ni	Nan
يكونوا	wọn jẹ	Nan
يكونون	wọn jẹ	Nan
يلاحظ	akiyesi	Nan
يلتقي	pade	Nan
يلزم	nilo	Nan
يلعب	mu ṣiṣẹ	Nan
يلقى	gbà	Nan
يلي	tẹle	Nan
يقومون	wọn ṣe	Nan
يقوم	dide	Nan
يقولون	wọn sọ	Nan
يقول	sọ	None
يقبل	gba	None
يقتصر	ni opin	Nan
يقتل	pa	Nan
يقدر	mọrírì	Nan
يقدم	pese	Nan
يقرأ	ti wa ni kika	Nan
يقرب	isunmọ	Nan
يمارسون	wọn ṣe adaṣe	Nan
يقسم	awọn ẹṣẹ	Nan
يقضي	nlo	Nan
يقع	be	Nan
يقف	dide	Nan
يقل	awọn idinku	Nan
يقلل	dinku	Nan
يقم	osi	Nan
يقود	wiwakọ	Nan
يقصد	tumọ si	Nan
وأهم	ati pataki julọ	Nan
يتميز	ifihan	Nan
يتمتعون	gbadun	Nan
ولعلّ	boya	Nan
ولغة	ati ede	Nan
ولقب	ati akọle	Nan
ولقد	ati pe mo ni	Nan
ولكل	ati fun ọkọọkan	Nan
ولكنه	ṣugbọn o jẹ	Nan
ولكنها	ṣugbọn o jẹ	Nan
ولكنهم	ṣugbọn wọn jẹ	Nan
ولكي	ati fun	Nan
ولم	ati pe ko ṣe	Nan
ولما	ati pe kilode	Nan
ولمّا	kilode	Nan
وله	ati fun u	Nan
ولها	ati arabinrin rẹ	Nan
ولهذا	fun eyi	Nan
ولعل	boya	Nan
ولو	paapaa	None
ولذلك	nitorinaa	Nan
ولديه	ati ni	Nan
وكيف	ati bawo	Nan
ولأن	ati pe nitori	Nan
ولا	tabi	None
ولاة	awọn gomina	Nan
ولادة	ibi	Nan
ولادته	rẹ ibi	Nan
ولاسيما	paapa	Nan
ولايات	awọn ipinlẹ	Nan
ولاية	ipinle	Nan
ولايته	ase re	Nan
ولبنان	ati lẹbanoni	Nan
ولد	ọmọkunrin	Nan
ولدت	mo bi	Nan
ولده	ọmọ rẹ	Nan
ولدى	ati pe mo ni	Nan
ولذا	nitorinaa	Nan
وكوريا	ati korea	Nan
ولي	olutọju	Nan
وليبيا	ati libiya	Nan
ومسلم	ati musulumi	Nan
ومصر	ati egipti	Nan
ومع	ati pẹlu	Nan
ومعرفة	ki o si wa jade	Nan
ومعظم	ati pupọ julọ	Nan
ومعناها	ati itumọ rẹ	Nan
ومعه	ati pẹlu rẹ	Nan
ومكان	ibikan	Nan
ومما	ati lati kini	Nan
ومملكة	ati ijọba kan	Nan
ومن	ati lati	Nan
ومناطق	ati awọn ẹkun ni	Nan
ومنذ	ati ki o niwon	Nan
ومنطقة	ati agbegbe	Nan
ومنظمة	ati agbari	Nan
ومسجد	ati mossalassi kan	Nan
وليام	william	Nan
ومركز	ati aarin	Nan
ومراجع	ati awọn itọkasi	Nan
وليد	waleed	Nan
وليس	ko ṣe bẹ	Nan
وليست	kii ṣe	Nan
وليلة	ati ọkan alẹ	Nan
وليم	william	Nan
وما	ẹla	Nan
وماض	ti o ti kọja	Nan
ومثل	ati bi	Nan
ومجلس	ati igbimọ	Nan
ومجموعة	ati ẹgbẹ kan	Nan
ومحاولة	ati ki o gbiyanju	Nan
ومحمد	ati muhammad	Nan
ومدرسة	ati ile-iwe kan	Nan
ومدى	ati bi o jina	Nan
ومدينة	ati ilu	Nan
ومراكز	ati awọn ile-iṣẹ	Nan
وكنيسة	ati ijo kan	Nan
وكندا	ati ilu kanada	Nan
وكما	ati bi	Nan
وفقًا	gẹgẹbi	Nan
وفلسطين	ati palestine	Nan
وفنلندا	finland	Nan
وفى	o ti ṣẹ	Nan
وفي	ati ninu	Nan
وفيما	pẹlu	Nan
وفيه	ati ninu rẹ	Nan
وفيها	ati ninu rẹ	Nan
وقائع	otito	Nan
وقاد	ati dari	Nan
وقال	on si wipe	Nan
وقالت	on si wipe	Nan
وقالوا	nwọn si wipe	Nan
وقام	o si dide	Nan
وقامت	o ṣe	Nan
وفقاً	gẹgẹbi	Nan
وقاموا	nwọn si dide	Nan
وفقا	gẹgẹbi	Nan
وفرنسا	ati faranse	Nan
وغالبا	ati nigbagbogbo	Nan
وغالباً	ati nigbagbogbo	Nan
وغالبًا	ati nigbagbogbo	Nan
وغرب	ati iwọ-oorun	Nan
وغير	ati diẹ sii	Nan
وغيره	ati diẹ sii	Nan
وغيرها	ati awọn miiran	Nan
وغيرهم	ati awọn miiran	Nan
وفاة	iku	None
وفاته	okurin naa ku	Nan
وفاتها	o ku	Nan
وفتح	ati ṣii	Nan
وفد	aṣoju	Nan
وفر	fipamọ	Nan
وفرة	opolopo	Nan
وفق	gẹgẹ bi	Nan
وقبل	ati ṣaaju	Nan
وقت	aago	Nan
وقتل	ti pa	Nan
وكان	ati awọn ti o wà	Nan
وكانت	ati pe o wa	Nan
وكانوا	ati pe wọn jẹ	Nan
وكتاب	ati iwe kan	Nan
وكتب	o kọ	Nan
وكثير	ati ọpọlọpọ	Nan
وكثيرا	ati pupọ	Nan
وكذا	ati iru bẹ	Nan
وكذلك	ati pe pẹlu	Nan
وكرة	bọọlu kan	Nan
وكل	ati gbogbo	Nan
وكلاهما	mejeeji ni	Nan
وكلما	ati nigbakugba	Nan
وكلمة	ati ọrọ kan	Nan
وكلها	ati gbogbo wọn	Nan
وكالة	ile ibẹwẹ	Nan
وكالات	awọn ile ibẹwẹ	Nan
وكأنه	fẹran	Nan
وقيل	o ti sọ	Nan
وقته	akoko re	Nan
وقتها	asiko to	Nan
وقد	ti wa	Nan
وقدم	o fun	Nan
وقرر	ati ki o pinnu	Nan
وقصر	aafin	Nan
وقطاع	ati rinhoho	Nan
ومنع	ati idiwọ	Nan
وقطر	ati qatar	Nan
وقع	fowo si	Nan
وقعت	silẹ	Nan
وقف	dide duro	Nan
وقلة	ati diẹ	Nan
وقوة	ati okun	Nan
وقود	epo	Nan
وقوع	iṣẹlẹ	Nan
وقطع	ati ki o ge	Nan
ومنه	ati lati rẹ	Nan
ومنها	bi eleyi	Nan
ومنهم	ati ti wọn	Nan
ويوجد	ati pe o wa	Nan
ويوسف	ati josefu	Nan
وَلاَ	tabi	None
وُلد	ọmọkunrin	Nan
يأتي	wá	Nan
يأخذ	gba	None
يأكل	jẹun	Nan
يأمر	bere fun	Nan
يؤثر	ikolu	Nan
يؤخذ	wa ni mu	Nan
يؤدى	asiwaju	Nan
يؤدي	asiwaju	Nan
يؤكد	awọn iṣeduro	Nan
يؤمن	gbagbọ	Nan
يؤمنون	gbagbọ ninu	Nan
وينقسم	o ti pin	Nan
يا	ah	Nan
ويندوز	windows	Nan
ويمكن	ati pe o le	Nan
ويعني	o tumọ si	Nan
ويعود	ati pada	Nan
ويعيش	ati laaye	Nan
ويقال	o ti sọ	Nan
ويقدر	o ti wa ni ifoju	Nan
ويقدم	o pese	Nan
ويقع	ati ki o ṣubu	Nan
ويقول	ati sọ	Nan
ويقوم	o ti wa ni ipilẹ	Nan
ويكون	ki o si jẹ	Nan
ويكي	wiki	Nan
ويكيبيديا	wikipedia	Nan
ويلز	awọn kanga	Nan
ويليام	william	Nan
ويمثل	o duro fun	Nan
وينتج	o mu wa	Nan
ياسر	yasser	Nan
ياسين	yassen	Nan
يبحث	wá	Nan
يترك	lọ	Nan
يتسبب	fa	Nan
يتصل	ibasọrọ	Nan
يتضح	apejuwe	Nan
يتضمن	o ni	Nan
يتطلب	nilo	Nan
يتعرض	sihan	Nan
يتعلق	pẹlu	Nan
يتغير	ti n yipada	Nan
يتفق	gba	None
يتكلم	sọrọ sókè	Nan
يتكون	oriširiši	Nan
يتلقى	gba	None
يتم	pari	Nan
يتمتع	gbadun	Nan
يترتب	o tẹle	Nan
يتراوح	awọn sakani	Nan
يتخذ	mu	Nan
يتحول	wa soke	Nan
يبدأ	bibẹrẹ	Nan
يبدو	ìró	None
يبعد	lọ	Nan
يبق	o ku	Nan
يبقى	o ku	Nan
يبلغ	ijabọ	Nan
يبين	fihan	None
ويعمل	ati pe o ṣiṣẹ	Nan
يتأثر	fowo	Nan
يتأهل	rọye	Nan
يتبع	tẹsiwaju	Nan
يتجاوز	kọja	Nan
يتجه	orí	Nan
يتحدث	o sọrọ	Nan
يتحدثون	wọn sọ	Nan
يتحرك	ti nlọ	Nan
يتألف	awọn onigbagbọ	Nan
يتمكن	ṣakoso	Nan
ويعرف	o mọ	Nan
ويعتمد	o gbarale	Nan
وهناك	ati nibẹ	Nan
وهو	ati on	Nan
وهولندا	awọn nẹdalandi naa	Nan
وهى	ewo ni	Nan
وهي	ewo ni	Nan
ووادي	ati afonifoji	Nan
ووجد	o wa	Nan
ووجدت	o si ri	Nan
ووجود	ati niwaju	Nan
ووسائل	tumọ si	Nan
ووسط	ati arin	Nan
ووصل	o de	Nan
ووصلت	mo si de	Nan
ووضع	ki o si fi	Nan
ووفقا	gẹgẹbi	Nan
وهنا	ati nibi	Nan
ووفقاً	gẹgẹbi	Nan
وهما	ati pe wọn jẹ meji	Nan
وهكذا	ati bẹbẹ lọ	Nan
ونادي	ati ọgọ	Nan
ونتيجة	nitorina na	Nan
ونشأته	ati igbega re	Nan
ونشر	ki o si jade	Nan
ونصف	ati idaji	Nan
ونظام	ati eto	Nan
ونظرا	ti a fun	Nan
ونظرًا	ati wo	Nan
ونظم	ati awọn ọna ṣiṣe	Nan
ونقل	ati gbe	Nan
ونهر	ati odo kan	Nan
وهؤلاء	ati awọn wọnyi	Nan
وهبي	wehbe	Nan
وهذا	ati pe eyi	Nan
وهذه	ati eyi	Nan
وهم	ati pe wọn jẹ	Nan
ووفقًا	gẹgẹbi	Nan
ويأتي	o wa	Nan
ويؤدي	ati awọn itọsọna	Nan
ويرى	o si ri	Nan
ويستخدم	o nlo	Nan
ويستطيع	o si le	Nan
ويسمى	o ti a npe ni	Nan
ويشمل	o ni	Nan
ويشير	awọn akọsilẹ	Nan
ويصبح	ati pe o di	Nan
ويصل	ati oke	Nan
ويضم	o ni	Nan
ويضيف	o ṣe afikun	Nan
ويطلق	o ti a npe ni	Nan
ويظهر	o han	Nan
ويعتبر	o ti gbero	Nan
ويعتقد	o si gbagbọ	Nan
ويعتقدون	ati pe wọn ronu	Nan
ويروي	o sọ	Nan
ويرجع	o pada	Nan
ويذكر	o mẹnuba	Nan
ويدخل	ati awọn ti nwọ	Nan
ويؤكد	o jẹrisi	Nan
ويؤمن	ati gbagbọ	Nan
ويب	oju opo wẹẹbu	Nan
ويبدو	o han	Nan
ويبقى	o wa	Nan
ويبلغ	o sọ fun	Nan
ويتحدث	o sọrọ	Nan
ويعد	ati awọn ileri	Nan
ويتراوح	o awọn sakani	Nan
ويتم	ati pe o ti ṣe	Nan
ويتميز	o ẹya	Nan
ويجب	a gbọdọ	Nan
ويجوز	o ti yọọda	Nan
ويحتوي	o ni	Nan
ويحدث	ati pe o ṣẹlẹ	Nan
ويختلف	o yatọ	Nan
ويتكون	o ni	Nan
تسببت	fa	Nan
وأهل	ati eniyan	Nan
وأنها	ati obirin	Nan
مبكرة	kutukutu	Nan
مبلغ	iye	Nan
مبنى	ile	Nan
مبني	ile	Nan
مبنية	itumọ ti	Nan
مبيعات	awọn tita	Nan
متابعة	tẹsiwaju	Nan
متاحة	wa	Nan
متتالية	itẹlera	Nan
متحركة	gbigbe	Nan
متحف	ile ọnọ	Nan
متحقق	ṣe aṣeyọri	Nan
متخصصة	pataki	Nan
متر	mita	Nan
مترو	ọkọ-irin alaja-ilẹ	Nan
مبكر	kutukutu	Nan
متزايد	ndagba	Nan
مبرهنة	theorem	Nan
مباشرة	taara	Nan
مالي	owo	Nan
مالية	isuna	Nan
ماليزيا	malaysia	None
مان	ọkunrin	Nan
مانشستر	ilu manchester	Nan
مايكروسوفت	microsoft	Nan
مايكل	mikaeli	Nan
مايو	oṣu karun	Nan
مبابان	mbabane	None
مبادئ	awọn ipilẹṣẹ	Nan
مبادرة	ipilẹṣẹ	Nan
مباراة	baramu	Nan
مبارك	ibukun	Nan
مباريات	awọn ibaamu	Nan
مباشر	taara	Nan
مبدأ	opo	Nan
مالك	eni	Nan
متزايدة	dagba	Nan
متساوية	dọgbadọgba	Nan
مثلث	onigun mẹta	Nan
مثلما	bi	Nan
مثله	fẹran rẹ	Nan
مثلها	bi ara rẹ	Nan
مثيرة	moriwu	Nan
مثيل	apẹẹrẹ	Nan
مجاعة	ìyàn	Nan
مجال	pápá	Nan
مجالات	awọn aaye	Nan
مجالس	awọn ile-iṣẹ	Nan
مجتمع	agbegbe	Nan
مجتمعات	awọn agbegbe	Nan
مجددًا	lẹẹkansi	Nan
مجرة	galaxy	Nan
مجرد	o kan	Nan
مثلاً	fun apere	Nan
متزوج	ti ṣe ìgbéyàwó	Nan
مثلا	fun apere	Nan
مثال	apẹẹrẹ	Nan
متصلة	ti sopọ	Nan
متطلبات	awọn ibeere	Nan
متطورة	oniruuru	Nan
متعدد	pupọ	Nan
متعددة	pupọ	Nan
متفاوتة	yiyatọ	Nan
متفرقة	ti tu sita	Nan
متقدمة	ti ni ilọsiwaju	Nan
متكررة	loorekoore	Nan
متميزة	yàtọ	Nan
متنوعة	oriṣiriṣi	Nan
متوسط	apapọ	Nan
متوسطة	alabọde	Nan
متوفرة	wa	Nan
متى	nigbawo	Nan
مثل	bi eleyi	Nan
مال	olu	Nan
ماكسويل	maxwell	Nan
مافيا	nsomi	Nan
ليبرالية	ominira	Nan
ليبيا	libya	Nan
ليتم	lati ṣe	Nan
ليتو	jẹ ki	Nan
ليزر	laser	Nan
ليس	kii ṣe	Nan
ليست	ko ṣe bẹ	Nan
ليسوا	awón kó	Nan
ليصبح	lati di	Nan
ليصل	lati de	Nan
ليكون	lati wa ni	Nan
ليلاً	alẹ	Nan
ليلة	a night	Nan
ليلى	layla	Nan
لينكون	lincoln	Nan
ليالي	oru	Nan
لينين	lenin	Nan
لي	mi	Nan
لونه	awọ rẹ	Nan
لواء	pataki gbogbogbo	Nan
لوثر	luther	None
لوجود	lati wa	Nan
لوح	plank	Nan
لوحات	awọn aba	Nan
لوحة	kikun	Nan
لوزارة	si ile-iṣẹ naa	Nan
لوس	ọdun	Nan
لوصف	lati ṣapejuwe	Nan
لوضع	lati fi	Nan
لوقا	lúùkù	Nan
لوقف	lati da	Nan
لولا	léla	Nan
لولاية	fun ipinle kan	Nan
لون	awọ	Nan
لويس	lewis	Nan
ليون	lyon	Nan
ليوناردو	leonardo	Nan
مأهولة	gbígbé	Nan
ماتت	o ku	Nan
ماجد	majid	Nan
مادة	nkan	None
مادية	ohun elo	Nan
ماذا	kini	Nan
مارتن	martin	Nan
مارس	oṣu kẹta	Nan
مارك	samisi	Nan
ماركس	maaki	Nan
ماركوس	makosi	Nan
ماري	marie	Nan
ماريا	maria	Nan
مارينر	onilu	Nan
ماسنجر	ojiṣẹ	Nan
ماعدا	ayafi	Nan
مات	ti ku	Nan
مائية	akua	Nan
مائة	ọgọrun	Nan
ما	kini	Nan
مؤتمر	apejọ	Nan
مؤخرا	laipẹ	Nan
مؤخراً	laipẹ	Nan
مؤخرًا	laipẹ	Nan
مؤسس	oludasile	Nan
مؤسسات	awọn ile-iṣẹ	Nan
مؤسسة	ile-iṣẹ	Nan
مجرى	san	Nan
مؤشر	atọka	Nan
مؤكدة	jẹrisi	Nan
مؤلف	onkọwe	Nan
مؤلفات	awọn onkọwe	Nan
مؤلفاته	awọn iwe rẹ	Nan
مئات	ọjo	Nan
مئة	ọgọrun	Nan
مئوية	ogorun	Nan
مؤقتة	fun igba diẹ	Nan
لو	ti o ba ti	Nan
مجلة	iwe irohin	Nan
مجمع	eka	None
مركبات	awọn ọkọ	Nan
مركبة	ọkọ	Nan
مركز	aarin	Nan
مركزا	aarin	Nan
مركزاً	aarin	Nan
مركزية	ibi-ajọṣepọ	Nan
مركزًا	ni aarin	Nan
مرمرة	marmara	Nan
مروان	marwan	Nan
مرور	fi aye	Nan
مريم	mariam	Nan
مزارع	agbẹ	Nan
مزايا	awọn anfani	Nan
مزيج	illa	Nan
مزيد	diẹ sii	Nan
مركب	eroja	Nan
مسألة	oro	Nan
مرقس	samisi	Nan
مرض	àìsàn	Nan
مراقبة	iṣakoso	Nan
مراكز	awọn ile-iṣẹ	Nan
مراكش	marrakesh	Nan
مربع	ààrin	Nan
مرة	ni ẹẹkan	Nan
مرت	ti kọja	Nan
مرتبة	ipele	None
مرتبطة	ti so pọ	Nan
مرتفع	giga	Nan
مرتفعات	giga	Nan
مرتفعة	giga	Nan
مرتين	lemeji	Nan
مرحلة	ipele	None
مرسوم	aṣẹ	Nan
مرصد	akiyesi	Nan
مرضى	alaisan	Nan
مراقب	foreman	Nan
مسؤول	lodidi	Nan
مسؤولية	layabiliti	Nan
مستقرة	idurosinsin	Nan
مستقل	olominira	Nan
مستقلة	ominira	Nan
مستمر	tẹsiwaju	Nan
مستمرة	ti nlọ lọwọ	Nan
مستوطنة	pinpin okun	Nan
مستوى	ipele	None
مستويات	awọn ipele	Nan
مسجد	mosalasi	Nan
مسح	iwadi	None
مسرح	ipele	None
مسرحية	ere kan	Nan
مسعود	masoud	Nan
مسقط	muscat	Nan
مسلسل	onka	None
مستقبل	ojo iwaju	Nan
مسؤولة	lodidi	Nan
مستعمرة	ileto	Nan
مستشفى	ile-iwosan	Nan
مساء	irọlẹ	Nan
مسائل	awọn ọran	Nan
مسابقات	awọn idije	Nan
مسابقة	idije	Nan
مساجد	awọn mọṣalaṣi	Nan
مساحة	aaye	Nan
مساحتها	agbegbe rẹ	Nan
مسار	ọnà kan	Nan
مساعد	olùrànlówó	Nan
مساعدة	egba mi o	Nan
مسافة	jinna	Nan
مساندة	atilẹyin	Nan
مساهمة	input	Nan
مستخدم	olumulo	Nan
مستخدمي	awọn olumulo	Nan
مستعمرات	awọn ileto	Nan
مراعاة	ronu	Nan
مراد	pinnu	Nan
مراحل	alakoso	Nan
محدود	ni opin	Nan
محدودة	ni opin	Nan
محركات	awọn iṣanmọ	Nan
محرم	muharram	Nan
محط	ibusọ	Nan
محطات	awọn ile	Nan
محطة	ibusọ	Nan
محفز	ayase	Nan
محفوظ	ti o fipamọ	Nan
محل	ile itaja	Nan
محلول	ojutu	Nan
محلي	dun	None
محلية	agbegbe	Nan
محمد	mohammed	Nan
محمدًا	mohamed a	Nan
محددة	pato	Nan
محمود	mahmud	Nan
محدد	pàtó	Nan
محاولة	gbiyanju	Nan
مجمل	ìwò	None
مجموع	aropọ	Nan
مجموعات	awọn ẹgbẹ	Nan
مجموعتين	awọn ẹgbẹ meji	Nan
مجهول	aimọ	Nan
مجهولة	aimọ	Nan
مجيء	n bọ	Nan
محاسبة	ṣiṣe iṣiro	Nan
محاطة	ti yika	Nan
محافظات	awọn agbegbe	Nan
محافظة	isakoso	Nan
محاكاة	kikopa	Nan
محاكم	awọn kootu	Nan
محاكمة	iwadii	Nan
محاولات	akitiyan	Nan
محايدة	aarin	Nan
محمودية	mahmoudia	Nan
محمية	ni aabo	Nan
محو	paarẹ	Nan
مدنها	awọn ilu rẹ	Nan
مدني	ara ilu	Nan
مدنية	ara ilu	Nan
مدونة	buloogi	Nan
مدى	beeli	Nan
مدير	oludari	Nan
مدينة	ilu	Nan
مدينتي	ilu mi	Nan
مذاهب	awọn ẹkọ	Nan
مذكرات	iwe ijumọsọrọ	Nan
مذكراته	awọn akọsilẹ rẹ	Nan
مر	ju	Nan
مرات	igba	Nan
مراجع	awọn itọkasi	Nan
مراجعة	atunwo	Nan
مدن	awọn ilu	Nan
مدعوم	atilẹyin	Nan
مدريد	ilu madrid	Nan
مدرسة	ile-iwe	Nan
محور	àú	Nan
محيط	okun	Nan
مخاطر	ewu	Nan
مخالفة	ifaarun	Nan
مخاوف	ibẹru	Nan
مختلف	yatọ	Nan
مختلفة	yatọ	Nan
مجلس	ọkọ	Nan
مختلفين	meji ti o yatọ	Nan
مخطط	ti gbero	Nan
مخطوطة	iwe afọwọkọ	Nan
مخيم	àgọ́	None
مدارات	orbits	Nan
مدارس	awọn ile-iwe	Nan
مدة	iye akoko	Nan
مدخل	ẹnu ọna	Nan
مخصصة	iyasọtọ	Nan
لهما	fun wọn	Nan
لهم	fun wpn	Nan
لهذه	fun eyi	Nan
لقاح	ajesara	Nan
لقب	akọle	Nan
لقبه	oruko apeso rẹ	Nan
لقتال	lati ja	Nan
لقد	panṣaga	Nan
لقوات	si ipa	Nan
لقوانين	awọn ofin	Nan
لقول	lati sọ	Nan
لقي	wa	Nan
لقياس	lati wiwọn	Nan
لك	tirẹ ni	Nan
لكتاب	fun iwe kan	Nan
لكثرة	pupọ ju	Nan
لكثير	fun ọpọlọpọ	Nan
لكرة	fun bọọlu kan	Nan
لقاء	ipade	Nan
لكل	fun gbogbo	Nan
لفهم	lati ni oye	Nan
لفكرة	fun imọran	Nan
لعمل	lati ṣiṣẹ	Nan
لعملية	lati ilana	Nan
لغات	awọn ede	Nan
لغة	ede	None
لغتهم	ede wọn	Nan
لغرض	fun idi kan	Nan
لغزو	lati gbogun ja	Nan
لغوية	ede	None
لغير	fun miiran	Nan
لـ	fun	None
لفتح	lati ṣii	Nan
لفترات	fun awọn akoko	Nan
لفترة	fun igba diẹ	Nan
لفرنسا	fun faranse	Nan
لفظة	ọrọ	Nan
لفلسطين	fun palestine	Nan
لعلي	boya	Nan
لكلمة	fun ọrọ kan	Nan
لكن	ṣugbọn	Nan
للاتحاد	fun euroopu	Nan
للاتصالات	telecom	Nan
للاقتصاد	fun aje	Nan
للبحث	ṣewadii	Nan
للبحر	si okun	Nan
للبشر	fun eniyan	Nan
للبلاد	fun orilẹ-ede naa	Nan
للتاريخ	fun itan	Nan
للتجارة	iṣowo	Nan
للتخلص	lati xo	Nan
للتدخين	fun mimu siga	Nan
للتدريب	fun ikẹkọ	Nan
للتربة	fun ile	Nan
للتعبير	lati ṣafihan	Nan
للتعليم	fun eto-ẹkọ	Nan
للإنسان	fun eniyan	Nan
لكم	si ọ	Nan
للإمبراطورية	fun ijọba naa	Nan
للإصابة	fun ipalara	Nan
لكنه	ṣugbọn on	Nan
لكنها	ṣugbọn on	Nan
لكنهم	ṣugbọn wọn jẹ	Nan
لكوكب	fun aye kan	Nan
لكون	fun agbaye kan	Nan
لكونه	fun kikopa	Nan
لكي	lati le	Nan
للأراضي	fun awọn ilẹ	Nan
للأرض	fun ilẹ na	Nan
للأطفال	fun awọn ọmọde	Nan
للأمم	ti awọn orilẹ-ede	Nan
للأندية	fun awọn ẹgbẹ	Nan
للإتحاد	fun euroopu	Nan
للإسلام	si islam	Nan
للإشارة	lati ifihan agbara	Nan
للإمام	si imam naa	Nan
لعلماء	fun awọn ọjọgbọn	Nan
لعلم	fun alaye	Nan
لعلاج	lati toju	Nan
لحد	dinku	Nan
لحركة	fun ronu	Nan
لحزب	fun ayẹyẹ kan	Nan
لحساب	lati ṣe iṣiro	Nan
لحظة	akoko	Nan
لحفظ	lati fipamọ	Nan
لحقوق	fun awọn ẹtọ	Nan
لحكم	lati ṣàkóso	Nan
لحل	lati yanju	Nan
لحم	eran	Nan
لحماية	lati daabo bo	Nan
لحن	tune	Nan
لحوالي	fun nipa	Nan
لخدمة	lati sin	Nan
لدراسة	lati kawe	Nan
لحام	alurinmorin	Nan
لدرجة	si alefa kan	Nan
لجيش	fun ọmọ ogun	Nan
لجميع	fun gbogbo	Nan
لتعزيز	lati se igbelaruge	Nan
لتفسير	fun alaye	Nan
لتقديم	lati pese	Nan
لتكون	lati wa ni	Nan
لتكوين	lati tunto	Nan
لتلك	fun awon na	Nan
لتنظيم	lati ṣeto	Nan
لتنفيذ	lati ṣe	Nan
لتوفير	lati pese	Nan
لتوليد	lati se ina	Nan
لجأ	asasala	Nan
لجامعة	yunifasiti	Nan
لجعل	lati ṣe	Nan
لجمع	lati gba	Nan
لجمهورية	si orileede	Nan
لجنة	igbimọ kan	Nan
لدعم	lati ṣe atilẹyin	Nan
لدول	si awọn orilẹ-ede	Nan
لدولة	si orilẹ-ede kan	Nan
لصناعة	lati ṣe	Nan
لضمان	lati ẹri	Nan
لطفي	lotfi	Nan
لطيفة	latifa	Nan
لظهور	lati han	Nan
لعام	fun ọdun	Nan
لعب	mu ṣiṣẹ	Nan
لعبة	ohun isere	Nan
لعبت	mo ti ṣere	Nan
لعبد	si iranṣẹ kan	Nan
لعدة	fun pupọ	Nan
لعدد	fun nọmba kan	Nan
لعدم	fun ko	Nan
لعطارد	si mercury	Nan
لعل	le	None
لصالح	ni ojurere	Nan
لشركة	fun ile-iṣẹ kan	Nan
لشبونة	lisbon	Nan
لشبه	fun irisi	Nan
لدى	mo ni	Nan
لدي	mo ni	Nan
لدينا	a ti sọ ni	Nan
لديه	o ni	Nan
لديها	o ni	Nan
لديهم	wọn ni	Nan
لذا	nitorinaa	Nan
للتنمية	fun idagbasoke	Nan
لذلك	nitorinaa	Nan
لرعاية	lati ṣe abojuto	Nan
لزيادة	lati mu pọ	Nan
لسان	ahọn	Nan
لسكان	fun olugbe	Nan
لسنة	fun ọdun kan	Nan
لسنوات	fun ọdun	Nan
لسياسة	fun iṣelu	Nan
لرئيس	fun ori	Nan
للثقافة	fun asa	Nan
للثورة	ti iyika	Nan
للجدل	ariyanjiyan	Nan
للموسيقى	si orin	Nan
للمياه	fun omi	Nan
للميلاد	fun ojo ibi	Nan
للنادي	fun ologba	Nan
للناس	fun eniyan	Nan
للنبي	si anabi	Nan
للنساء	fun awqn obinrin	Nan
للنظام	fun eto	Nan
للنفط	fun epo	Nan
للنقل	fun gbigbe	Nan
لله	allah	Nan
للهجوم	lati kọlu	Nan
للوزراء	si awọn minisita	Nan
للوصول	lati de odo	Nan
للولايات	si awọn ilu	Nan
للمواد	fun awọn ohun elo	Nan
لليهود	si awọn ju	Nan
للمنطقة	fun ekun	Nan
للملك	si ọba	Nan
للكواكب	fun awọn aye aye	Nan
للكوكب	fun ile aye	Nan
للكويت	fun kuwaiti	Nan
للماء	mabomire	Nan
للمجتمع	si agbegbe	Nan
للمجلس	si igbimọ naa	Nan
للمجموعة	fun ẹgbẹ naa	Nan
للمدينة	fun ilu	Nan
للمرة	fun akoko naa	Nan
للمساعدة	fun iranlọwọ	Nan
للمستخدمين	fun awọn olumulo	Nan
للمسجد	fun mossalassi	Nan
للمسلمين	fun awọn musulumi	Nan
للمسيحية	fun kristiẹniti	Nan
للمغرب	fun ilu morocco	Nan
للمملكة	fun ijọba naa	Nan
لم	ṣe ko	Nan
لما	nigbawo	Nan
لماذا	kilode	Nan
لن	yoo ko	Nan
لنا	wa	Nan
لندن	lọndọnu	None
لنظام	si eto naa	Nan
لنظرية	fun yii	Nan
لنفسه	fun ararẹ	Nan
لنقل	jẹ ká sọ	Nan
لنكدوك-روسيون	languedoc-roussillon	Nan
لنهر	fun odo kan	Nan
له	fun okunrin na	Nan
لها	fún un	Nan
لهتلر	fun hitila	Nan
لهجات	awọn asẹ	Nan
لهجة	tẹ	Nan
لهذا	fun eyi	Nan
لمواجهة	lati dojuko	Nan
لمنع	lati yago fun	Nan
لمنظمة	fun agbari kan	Nan
لمنطقة	fun agbegbe kan	Nan
لمجلس	fun igbimọ kan	Nan
لمجموعة	fun ẹgbẹ kan	Nan
لمحاربة	lati ja	Nan
لمحاولة	lati gbiyanju	Nan
لمحمد	si muhammad	Nan
لمختلف	fun oriṣiriṣi	Nan
لمدة	fun igba diẹ	Nan
للكنيسة	fun ile ijọsin	Nan
لمدينة	fun ilu kan	Nan
لمساعدة	lati ṣe iranlọwọ	Nan
لمصر	fun egipti	Nan
لمعالجة	lati koju	Nan
لمعرفة	iwari	Nan
لمعظم	fun pupọ julọ	Nan
لمكافحة	lati ja	Nan
لمن	tani	Nan
لمرض	fun arun	Nan
مسلسلات	jara	Nan
للكثير	fun ọpọlọpọ	Nan
للقيام	lati ṣe	Nan
للخليفة	si kalifa	Nan
للدراسات	fun awọn ijinlẹ	Nan
للدراسة	lati kawe	Nan
للدفاع	lati dabobo	Nan
للدلالة	lati ṣe afihan	Nan
للدول	si awọn ilu	Nan
للدولة	si ipinle	Nan
للدين	fun esin	Nan
للرئيس	si alakoso	Nan
للرجال	fun okunrin	Nan
للرجل	fun eniyan naa	Nan
للزراعة	fun ogbin	Nan
للزهرة	fun ododo	Nan
للسكان	fun olugbe	Nan
للسلام	alaafia	None
للخلافة	fun aṣeyọri	Nan
للسلطان	si sultan	Nan
للحيوانات	fun awon eranko	Nan
للحكومة	si ijọba	Nan
للجزائر	fun algeria	Nan
للجسم	fun ara	Nan
للجمعية	si ẹgbẹ	Nan
للجمهورية	ti orileede	Nan
للجميع	fun gbogbo eniyan	Nan
للجنة	si igbimọ naa	Nan
للجيش	fun ọmọ ogun	Nan
للحد	lati se idinwo	Nan
للحرارة	lati ooru	Nan
للحرب	fun ogun	Nan
للحركة	fun ronu	Nan
للحزب	fun ẹgbẹ naa	Nan
للحصول	lati mu	Nan
للحفاظ	lati toju	Nan
للحكم	lati ṣe idajọ	Nan
للحياة	titi ayeraye	Nan
للسلطة	fun agbara	Nan
للسيارات	fun awọn ọkọ ayọkẹlẹ	Nan
للسيطرة	lati ṣakoso	Nan
للعناصر	fun awọn ohun naa	Nan
للعهد	fun majẹmu	Nan
للعولمة	fun agbaye	Nan
للغاية	lalailopinpin	Nan
للغة	fun ede	Nan
للفرد	fun ẹni kọọkan	Nan
للفنون	fun ona ona	Nan
للفيروسات	fun awọn ọlọjẹ	Nan
للقارات	intercontinental	Nan
للقتال	lati ja	Nan
للقدس	fun jerusalemu	Nan
للقرآن	fun al-kuran	Nan
للقرن	fun orundun	Nan
للقضاء	lati imukuro	Nan
للقوات	fun awọn ọmọ ogun	Nan
للعمل	fun iṣẹ	Nan
للعلوم	ti imọ	Nan
للعلماء	fun awọn ọjọgbọn	Nan
للعلم	fun alaye	Nan
للشباب	fun awọn ọdọ	Nan
للشعب	si awọn eniyan	Nan
للشمس	fun oorun	Nan
للشيخ	sheikh	Nan
للصلاة	lati gbadura	Nan
للضوء	si imọlẹ	Nan
للطاقة	fun okun	Nan
للكتاب	fun iwe naa	Nan
للطبيعة	ti iseda	Nan
للطيران	lati fo	Nan
للعالم	fun agbaye	Nan
للعام	fun ọdun	Nan
للعديد	fun ọpọlọpọ	Nan
للعراق	fun iraaki	Nan
للعرب	si awọn larubawa	Nan
للعلاج	fun itọju	Nan
للطلاب	fun awọn ọmọ ile-iwe	Nan
مسلم	musulumi	Nan
مسلمة	musulumi	Nan
مسلمون	musulumi	Nan
نصف	idaji	None
نصوص	awọn ọrọ	Nan
نصيب	pin	Nan
نصير	olufowosi	Nan
نطاق	ase	Nan
نظام	eto	Nan
نظر	ero	Nan
نظرا	nitori	Nan
نظراً	nitori	Nan
نظرة	iwo kan	Nan
نظريات	awọn imọ-jinlẹ	Nan
نظرية	yii	Nan
نظريته	ẹkọ rẹ	Nan
نظرًا	nitori	Nan
نظم	ṣeto	Nan
نصر	iṣẹgun	Nan
نظير	baramu	Nan
نصب	ṣeto	Nan
نشوب	ìbújáde	Nan
نسمة	afẹfẹ	Nan
نشأ	sitashi	Nan
نشأة	jẹnẹsisi	Nan
نشأت	ti ipilẹṣẹ	Nan
نشأته	mo dagba	Nan
نشأتها	o ti ipilẹṣẹ	Nan
نشاط	iṣẹ ṣiṣe	Nan
نشاطات	awọn iṣẹ ṣiṣe	Nan
نشبت	bu jade	Nan
نشر	tànkálẹ	Nan
نشرت	atejade	Nan
نشرها	ti firanṣẹ	Nan
نشط	lọwọ	Nan
نشطة	ṣiṣẹ	Nan
نشوء	farahan	Nan
نص	ọrọ	Nan
نسل	irugbin	Nan
نعرف	a mọ	Nan
نفر	paa	None
نمر	tiger	Nan
نمط	ara	Nan
نمو	idagba	Nan
نموذج	fọọmu	Nan
نهائي	ik	Nan
نهائيات	ipari	Nan
نهاية	ipari	Nan
نهج	sunmọ	Nan
نهر	odò	Nan
نهضة	atunṣe	Nan
نهيان	nahyan	Nan
نواب	awọn aṣoju	Nan
نواة	ẹyọ	Nan
نواس	pendulum	Nan
نوبل	noble	Nan
نمت	ti dagba	Nan
نعيم	naeem	Nan
نماذج	awọn fọọmu	Nan
نقله	gbe e	Nan
نفس	ikan na	Nan
نفسه	funrararẹ	Nan
نفسها	iho	Nan
نفسي	arami	Nan
نفسية	oroinuokan	Nan
نفط	epo	Nan
نفوذه	ipa rẹ	Nan
نفوذها	awọn ipa rẹ	Nan
نفوس	emi	Nan
نفي	kọ	Nan
نقاط	awọn aaye	Nan
نقد	owo	Nan
نقص	aito	Nan
نقطة	ojuami	Nan
نقل	gbe	None
نقول	a sọ	Nan
نسخة	daakọ	Nan
نسخ	awọn ẹda	Nan
نستطيع	a le	Nan
نابلس	nablus	Nan
نابليون	napoleon	Nan
ناتج	abajade	Nan
ناجحة	aseyori	None
ناحية	ọwọ	Nan
نادرة	toje	None
نادى	ọgọ	Nan
نادي	ọgọ	Nan
نار	iná	Nan
ناسا	nasa	Nan
ناصر	ọmọde	Nan
ناطقة	nsoro	Nan
نال	o gba	Nan
نالت	o ni	Nan
نانسي	nancy	Nan
ناب	tusk	Nan
نايف	nayef	Nan
نائب	igbakeji	Nan
مِنْ	lati	Nan
ميدان	ààrin	Nan
ميزانية	isuna	Nan
ميزة	ẹya	Nan
ميسي	messi	Nan
ميكانيكا	awọn ọna ẹrọ	Nan
ميل	titọju	Nan
ميلاد	ibi	Nan
ميلان	milan	Nan
ميلانو	milan	Nan
ميلودراما	melodrama	Nan
ميناء	oko oju omi	Nan
ميونيخ	munich	Nan
مَا	kini	Nan
مَنْ	lati	Nan
مِن	lati	Nan
ن	n	Nan
نبات	ohun ọgbin	Nan
نباتات	eweko	Nan
نبتون	neptune	None
نحو	si ọna	Nan
نذكر	a mẹnuba	Nan
نرى	a rii	Nan
نزار	nazar	Nan
نزل	ṣe igbasilẹ	Nan
نزلت	mo ti lọ	Nan
نزول	n bọ	Nan
نساء	obinrin	Nan
نسب	ìlà	None
نسبة	oṣuwọn	Nan
نسبته	re ipin	Nan
نسبه	ogorun	Nan
نسبيا	jo	None
نسبياً	jo	None
نسبيًا	jo	None
نحن	àwa	Nan
نجيب	najib	Nan
نجوم	awọn irawọ	Nan
نجمة	irawo	Nan
نبذة	finifini	Nan
نبي	woli	Nan
نبيل	nabil	Nan
نت	apapọ	Nan
نتائج	awọn abajade	Nan
نتاج	ọja	Nan
نتج	ti yanju	Nan
نوح	nóà	Nan
نتيجة	kalẹnda	Nan
نجاحاً	aṣeyọri kan	Nan
نجاد	najad	Nan
نجح	o ṣaṣeyọri	Nan
نجحت	mo kọja	Nan
نجد	a wa	Nan
نجران	najran	Nan
نجم	irawo kan	Nan
نجاح	aṣeyọri	Nan
نور	imọlẹ	Nan
نورة	noura	Nan
نوستراداموس	nostradamus	Nan
وأبي	ati baba mi	Nan
وأتباعه	ati awọn ọmọlẹyìn rẹ	Nan
وأثناء	ati nigba	Nan
وأجزاء	ati awọn ẹya	Nan
وأجهزة	ati servo	Nan
وأحد	ọkan	Nan
وأحمد	ati ahmed	Nan
وأحيانا	ati nigbami	Nan
وأخذ	ati mu	Nan
وأخذت	ati ki o mu	Nan
وأخرى	ati pe miiran	Nan
وأخيرا	ati nikẹhin	Nan
وأخيراً	lakotan	Nan
وأخيرًا	ati nikẹhin	Nan
وأدت	ati dari	Nan
وأبو	ati abu	Nan
وأدى	àfonífojì	Nan
وأبرزها	ohun akiyesi julọ	Nan
وآله	ati awọn idile rẹ	Nan
هي	obinrin na	Nan
هيئة	ara	Nan
هيا	kọja siwaju	Nan
هياكل	awọn ọna	Nan
هيدروجين	hydrogen	Nan
هيفاء	haifa	Nan
هيكل	be	Nan
هيلين	helen	Nan
هيم	hem	Nan
هينايانا	hinayana	Nan
هُوَ	o jẹ	Nan
و	ati	Nan
وآخر	ati pe miiran	Nan
وآخرون	ati awọn miiran	Nan
وآسيا	ati esia	Nan
وأبرز	pupọ ti o tẹnumọ	Nan
وأذربيجان	ati azerbaijan	Nan
وأربعين	ati ogoji	Nan
وأرسل	o ranṣẹ	Nan
وأقدم	ati agbalagba	Nan
وأقل	ati dinku	Nan
وأكبر	ati tobi	Nan
وأكثر	ati diẹ sii	Nan
وأكثرها	ati pupọ julọ wọn	Nan
وأكد	jẹrisi	Nan
وألمانيا	ati jẹmánì	Nan
وأما	tabi	None
وأمر	o paṣẹ	Nan
وأمريكا	ati america	Nan
وأمه	ati iya rẹ	Nan
وأن	ati daju	Nan
وأنا	ati emi	Nan
وأنشأ	ti iṣeto	Nan
وأنه	ati pe o jẹ	Nan
وأقام	o duro	Nan
وأقاليم	ati awọn agbegbe	Nan
وأفغانستان	ati afiganisitani	Nan
وأفريقيا	ati afirika	Nan
وأساليب	ati awọn ọna	Nan
وأسباب	ati awọn idi	Nan
وأستراليا	ati australia	Nan
وأسس	ati awọn ipilẹ	Nan
وأشار	se afihan	Nan
وأشهر	olokiki julọ	Nan
وأصبح	o si di	Nan
هوية	idanimọ	Nan
وأصبحت	ati pe mo di	Nan
وأصحابه	ati awọn ẹlẹgbẹ rẹ	Nan
وأضاف	o fi kun	Nan
وأطلق	ti firanṣẹ	Nan
وأعضاء	ati awọn ọmọ ẹgbẹ	Nan
وأعلن	o kede	Nan
وأعلنت	ti kede	Nan
وأغلب	ati pupọ julọ	Nan
وأصحاب	ati awọn oniwun	Nan
ميخائيل	mikaeli	Nan
هولندا	gẹẹsi	Nan
هوراس	horace	Nan
هاجر	iṣilọ	Nan
هاجروا	wọn kó lọ	Nan
هاجم	ti kolu	Nan
هاجمت	ti kolu	Nan
هارفارد	harvard	Nan
هارون	aaroni	Nan
هاري	harry	Nan
هاشم	oluwa	Nan
هام	pataki	Nan
هاما	pataki	Nan
هاماً	pataki	Nan
هامة	pataki	Nan
هاواي	hawaii	None
هايدا	haida	Nan
هتلر	hitila	Nan
هاتين	awọn meji wọnyi	Nan
هجرة	ijira	Nan
هائلة	o tobi	Nan
هؤلاء	iwọnyi	Nan
نوع	iru	Nan
نوعا	nkankan bi	Nan
نوعان	awọn oriṣi meji	Nan
نوعه	awọn oniwe-iru	Nan
نوعها	awọn oniwe-iru	Nan
نوعية	didara	Nan
نوعين	awọn oriṣi meji	Nan
نوفمبر	oṣu kọkanla	Nan
نووي	iparun	Nan
نووية	iparun	Nan
نيتشه	nietzsche	Nan
نيجيريا	nàìjíríà	None
نيوتن	newton	Nan
نيوزيلندا	ilu niu silandii	Nan
نيويورك	niu yoki	Nan
هائل	tobi pupo	Nan
هجمات	awọn ikọlu	Nan
هجوم	kọlu	Nan
هدف	ibi-afẹde	Nan
هـم	hm	Nan
هكتور	hector	Nan
هكذا	nitorinaa	Nan
هل	ṣe o	Nan
هلال	oṣu kẹta	Nan
هم	wọn	None
هما	wọn	None
هنا	nibi	Nan
هناك	nibe yen	Nan
هنالك	ní bẹ	Nan
هند	hind	Nan
هندسة	ẹnjinia	Nan
هنري	henry	Nan
هو	o jẹ	Nan
هواء	ategun	Nan
هـ	é	Nan
هطول	ojoriro	Nan
هضبة	pẹtẹlẹ	Nan
هشام	hésham	Nan
هدفه	ilepa re	Nan
هدم	parun	Nan
هدنة	alaafia	None
هدى	itọsọna	Nan
هذا	eyi	Nan
هذان	awọn meji wọnyi	Nan
هذة	eyi ni	Nan
هولاكو	hulagu	Nan
هذه	eyi ni	Nan
هرب	o si sa asala	Nan
هرقل	hercules	Nan
هرقليطس	heraclitus	Nan
هرم	jibiti	Nan
هريرة	ọmọ ologbo	Nan
هزم	ti ṣẹgun	Nan
هزيمة	ṣẹgun	Nan
هذين	awọn meji wọnyi	Nan
وأنواع	ati awọn oriṣi	Nan
ميثيونين	methionine	Nan
ميت	kú	Nan
معقد	apapọ	Nan
معقدة	idiju	Nan
معلومات	awọn alaye	Nan
معمر	oloye	None
معناه	itumọ rẹ	Nan
معناها	itumọ rẹ	Nan
معنى	itumo ti	Nan
معه	pẹlu rẹ	Nan
معهد	ilé-ìwé	Nan
معهم	pẹlu wọn	Nan
معينة	daju	Nan
معًا	papọ	Nan
مغادرة	nlọ	Nan
مغامرات	irinajo seresere	Nan
مغربي	ilu moroccan	Nan
معظمهم	pupọ ninu wọn	Nan
مغناطيسي	o se	Nan
معظمها	julọ ti o	Nan
معسكرات	awọn ago bata	Nan
معتدل	dede	Nan
معتدلة	dede	Nan
معترف	gbaṣẹ	Nan
معجزة	iseyanu	Nan
معد	ti a pinnu	Nan
معدات	ohun èlò	Nan
معدة	ikun	Nan
معدل	oṣuwọn	Nan
معدلات	awọn oṣuwọn	Nan
معدنية	irin	Nan
معرفة	imo	Nan
معركة	ogun	None
معروف	ojurere	Nan
معروفة	mọ	Nan
معسكر	àgọ́	None
معظم	pupọ	Nan
معبد	tẹmpili	Nan
مغناطيسية	o se	Nan
مفاهيم	awọn ilana	Nan
مقاومة	atako	Nan
مقبرة	itẹ oku	Nan
مقبولة	itewogba	Nan
مقتل	pa	Nan
مقتله	pa a	Nan
مقدار	iye	Nan
مقدسة	mimọ	Nan
مقدم	olufunni	Nan
مقدمة	ifihan	Nan
مقدونيا	makedonia	None
مقديشيو	mogadishu	Nan
مقر	orí orí	Nan
مقرا	iduro	Nan
مقرها	da	None
مقسمة	pin	Nan
مقام	onidajọ	Nan
مفاعل	riakito	Nan
مقالة	nkan	None
مقال	nkan	None
مفاوضات	awọn ijiroro	Nan
مفتاح	bọtini kan	Nan
مفتوحة	ṣi	Nan
مفتي	mufti	Nan
مفصلة	hiriji	Nan
مفهوم	erongba	Nan
مفيدة	iranlọwọ	Nan
مقابر	awọn oku	Nan
مقابل	idakeji	Nan
مقابلة	ifọrọwanilẹnuwo	Nan
مقاتل	onija	Nan
مقارنة	ifiwera	Nan
مقاطعات	awọn agbegbe	Nan
مقاطعة	ikokunrin	Nan
مقاعد	ibijoko	Nan
مقالات	nkan	None
معاً	papọ	Nan
معايير	awọn ipilẹ	Nan
معاوية	sid	Nan
مشتقة	ohun itọsẹ	Nan
مشروع	ise agbese	Nan
مشعل	torgùṣọ	Nan
مشكلة	iṣoro	Nan
مشهد	ifaworanhan	Nan
مشهور	olokiki	Nan
مشهورة	olokiki	Nan
مشيخة	arabinrin naa ti darugbo	Nan
مصادر	awọn orisun	Nan
مصانع	awọn ile-iṣẹ	Nan
مصحف	mus&#39;haf	Nan
مصدر	orisun	None
مصر	íjíbítì	Nan
مصرف	banki	Nan
مصري	ara egipti	Nan
مشتركة	pipin	Nan
مصريات	awọn ara egipti	Nan
مشترك	pelu	Nan
مشاهدة	ṣọ	Nan
مسلمين	musulumi	Nan
مسمى	ti o lorukọ	Nan
مسند	ẹsẹsẹ	Nan
مسيحية	kristiẹni	Nan
مسيرة	irin-ajo	Nan
مسيرته	iṣẹ-ṣiṣe rẹ	Nan
مشابه	jọra	Nan
مشابهة	kanna	Nan
مشاة	alarinkiri	Nan
مشاركة	pinpin	Nan
مشاريع	awọn iṣẹ akanṣe	Nan
مشاعر	rilara	Nan
مشاعل	awọn igbunaya	Nan
مشاكل	awọn iṣoro	Nan
مشاهد	iwo	Nan
مشاهير	olokiki	Nan
مصرية	ara egipti	Nan
مصريون	awọn ara egipti	Nan
مصطفى	mustafa	Nan
مظاهر	awọn ifarahan	Nan
مظاهرات	awọn ikede	Nan
مظهر	hihan	Nan
مع	pẹlu	Nan
معا	papọ	Nan
معاداة	ija	Nan
معارض	tako	Nan
معارضة	àtakò	Nan
معارك	awọn ija	Nan
معالجة	ṣiṣẹ	Nan
معالم	awọn maili	Nan
معامل	o daju	Nan
معاملة	itọju	Nan
معاني	itumọ	Nan
معاهدة	adehun	Nan
مطلقة	kọrasilẹ	Nan
مطلع	bẹrẹ	Nan
مطلة	pẹlu iwo	Nan
مطرب	akorin	Nan
مصطلح	igba	Nan
مصطلحات	awọn ofin	Nan
مصلحة	anfani	Nan
مصنع	ile-iṣẹ	Nan
مصنوع	ṣe	Nan
مصنوعة	ṣe	Nan
مصير	ayanmọ	Nan
مقياس	asekale	Nan
مضادة	ohunka	Nan
مضى	ti lọ	Nan
مضيق	rọ	Nan
مطابقة	baramu	Nan
مطار	papa ọkọ ofurufu	Nan
مطارات	papa ọkọ ofurufu	Nan
مطالب	awọn ibeere	Nan
مطر	ojo	None
مضخم	ampilifaya	Nan
مكاتب	awọn ọfiisi	Nan
مكافحة	ija	Nan
مكان	ibi	Nan
مهد	jojolo	Nan
مهدي	mahdi	Nan
مهرجان	ajọdun	Nan
مهم	pataki	Nan
مهما	ohunkohun ti	Nan
مهمة	ise	Nan
مهمًا	ohunkohun ti	Nan
مهنة	iṣẹ-oojọ	Nan
مهندس	onina	Nan
مواجهة	ija	Nan
مواد	ohun elo	Nan
موارد	awọn orisun	Nan
مواضيع	awọn akọle	Nan
مواطن	ara ilu	Nan
مواطني	arakunrin mi	Nan
مهام	awọn iṣẹ-ṣiṣe	Nan
موافقة	ifijiṣẹ	Nan
مهارات	ogbon	Nan
منيرة	munira	Nan
منصب	ipo	None
منصبه	ọffisi	Nan
منصور	mansoor	Nan
منطقة	agbegbe	Nan
منظمات	awọn ajọ	Nan
منظور	irisi	None
منع	dina	Nan
منعت	idena	Nan
منغوليا	mongolia	Nan
منها	ti eyiti	Nan
منهج	ọna	Nan
منهم	tani won	Nan
منهما	tani won	Nan
منى	mona	Nan
مني	mona	Nan
مهاجمة	kọlu	Nan
مواقع	awọn aaye	Nan
مواقف	awọn ipo	Nan
مواليد	awọn ọmọluwabi ọmọde	Nan
موطن	ile	Nan
موعد	ipinnu lati pade	Nan
موقع	ipo	None
موقعة	wole	None
موقعه	wole	None
موقعها	ipo rẹ	Nan
موقف	ihuwasi	Nan
موقفه	ipo rẹ	Nan
مول	ile itaja	Nan
مولاي	moulay	Nan
مولده	rẹ ibi	Nan
موليبدنوم	molybdenum	Nan
مونتانا	montana	Nan
مونكو	monco	Nan
مياه	omi	None
موضي	moudy	Nan
موضوع	akori	Nan
موضع	ipo	None
موسيقية	musical	Nan
موانئ	awọn ọkọ oju omi	Nan
موت	iku	None
موته	iku re	Nan
موجات	awọn igbi	Nan
موجة	gbeke	Nan
موجودة	wa	Nan
موحد	ti iṣọkan	Nan
منزله	ile rẹ	Nan
موحدة	ẹṣọ	Nan
موريتانيا	orilẹ-ede mauritania	Nan
موسكو	ilu moscow	Nan
موسم	akoko	Nan
موسوعة	ìmọ ọfẹ	Nan
موسوليني	mussolini	Nan
موسى	mousa	Nan
موسيقى	orin	Nan
مورد	olupese	Nan
ميثاق	charter	Nan
منزلة	ile rẹ	Nan
منذ	ago	Nan
ملجأ	asasala	Nan
ملحوظ	samisi	Nan
ملحوظة	nb	Nan
ملعب	àgbàlá	Nan
ملعقة	sibi	Nan
ملف	faili kan	Nan
ملفات	awọn faili	Nan
ملك	ọba	Nan
ملكة	ayaba	Nan
ملكي	ọmọ ọba	Nan
ملكية	ohun-ini	Nan
ملكًا	ọba	Nan
ملوك	awọn ọba	Nan
مليار	bilili	Nan
مليون	milionu	Nan
ملايين	milionu	Nan
مما	ju	Nan
ملامح	awọn ẹya	Nan
ملاحظة	akiyesi	Nan
مكانة	ipo	None
مكانته	aye re	Nan
مكانه	ipo	None
مكانها	ipo rẹ	Nan
مكة	makka	Nan
مكتب	ọffisi	Nan
مكتبة	ile-ikawe	Nan
مكتوب	kọ	Nan
مكتوبة	kọ	Nan
مكتوم	muffled	Nan
مكنسة	igbomikana	Nan
مكون	eroja	Nan
مكونات	awọn eroja	Nan
مكونة	ti a ṣe	Nan
ملاحظات	awọn akọsilẹ	Nan
ملاك	angẹli	Nan
مماثل	jọra	Nan
مماثلة	kanna	Nan
ممارسة	iwa	Nan
مناف	munaf	Nan
منافسة	idije	Nan
مناقشة	ifọrọwanilẹnuwo	Nan
مناهج	ẹtan	Nan
منتج	olupilẹṣẹ	Nan
منتجات	awọn ọja	Nan
منتخب	ti yan	Nan
منتشرة	ni ibigbogbo	Nan
منتصف	agbede	Nan
منتظم	deede	Nan
منتظمة	deede	Nan
منح	fifun	Nan
منحت	funni	Nan
منخفض	kekere	None
منخفضة	kekere	None
مناطق	awọn ẹkun-ilu	Nan
مناصب	awọn ipo	Nan
مناسبة	ayeye	Nan
مناسب	o yẹ	Nan
ممالك	awọn ijọba	Nan
مماليك	mamluks	Nan
ممثل	oṣere	Nan
ممثلة	oṣere	Nan
ممرض	nọọsi	Nan
ممكن	boya	Nan
ممكنة	owun to le	Nan
منزل	ilé kan	Nan
مملكة	ijọba	Nan
مميزات	awọn ẹya	Nan
مميزة	iyatọ	Nan
من	lati	Nan
منا	lati u.s	Nan
مناخ	afefe	Nan
منارة	ile ina	Nan
منازل	awọn ile	Nan
ممن	ti tani	Nan
يُلاحظ	akiyesi	Nan
تسبب	o fa	Nan
تساهم	ṣe alabapin	Nan
التلفاز	tẹlifisiọnu	Nan
التلفزيون	tẹlifisiọnu	Nan
التلفزيونية	tẹlifisiọnu	Nan
التلوث	ẹlẹgbin	Nan
التمثيل	awọn anesitetiki	Nan
التمرد	awọn iṣọtẹ	Nan
التمويل	igbeowo	Nan
التميمي	al-tamimi	Nan
التمييز	ifi-iyasọtọ	Nan
التنازل	waiver	Nan
التناسلي	jiini	Nan
التناسلية	jiini	Nan
التنافس	idije	Nan
التنبؤ	asọtẹlẹ	Nan
التنسيق	iṣeto	Nan
التلاميذ	awọn ọmọ ile-iwe	Nan
التنظيم	agbari	Nan
التكيف	adaṣe	Nan
التكنولوجية	imọ-ẹrọ	Nan
التقسيم	ipin	None
التقسيمات	awọn ipin	Nan
التقليد	atọwọdọwọ	Nan
التقليدي	ibile	None
التقليدية	ibile	None
التقنيات	imọ-ẹrọ	Nan
التقنية	imọ-ẹrọ	Nan
التقويم	kalẹnda	Nan
التقى	ó pàdé	Nan
التقييم	iyẹwo	Nan
التكاثر	atunse	None
التكافؤ	iwa-ipa	Nan
التكتونية	tectonic	Nan
التكلفة	idiyele	Nan
التكنولوجيا	imọ-ẹrọ	Nan
التكوين	iṣeto ni	Nan
التقرير	ijabọ naa	Nan
التنفس	mimi	Nan
التنفيذي	alase	Nan
التونسية	ara ilu tunisia	Nan
التي	ewo ni	Nan
التيار	ẹlẹtiriki naa	Nan
التيارات	awọn ipo lọwọlọwọ	Nan
الثابت	ibakan	Nan
الثابتة	ti o wa titi	Nan
الثالث	kẹta	None
الثالثة	kẹta	None
الثالوث	metalokan	Nan
الثامن	viii	Nan
الثامنة	kẹjọ	Nan
الثانوي	atẹle	Nan
الثانوية	ile-iwe giga	Nan
الثاني	keji	Nan
الثانية	ikeji	Nan
التونسي	ara ilu tunisia	Nan
التنفيذ	imuse	Nan
التوقيع	ibuwọlu	Nan
التوسع	imugboroosi	Nan
التنفيذية	alase	Nan
التنقل	iyika	Nan
التنقيب	prospecting	Nan
التنمية	idagbasoke	None
التنوع	oniruuru	Nan
التنوير	imọye	Nan
التهاب	igbona	Nan
التوازن	iwontunws.funfun	Nan
التواصل	ibaraẹnisọrọ	Nan
التوالي	taara	Nan
التوبة	ronupiwada	Nan
التوتر	wahala	Nan
التوجه	iṣalaye	Nan
التوحيد	monotheism	Nan
التوراة	torah	Nan
التوصل	de ọdọ	Nan
التقديرات	awọn iṣiro	Nan
التقدم	ilọsiwaju	Nan
التقاليد	awọn aṣa	Nan
التشريح	anatomi	Nan
التشريع	ofin	None
التشريعات	ofin	None
التشريعي	isofin	Nan
التشريعية	isofin	Nan
التشكيل	ibiyi	Nan
التصحر	aabo-irekọja	Nan
التصدي	rogbodiyan	None
التصديق	iwe-ẹri	Nan
التصرف	ìṣe	Nan
التصفيات	awọn ipẹṣẹ	Nan
التصميم	awọn apẹrẹ	Nan
التصنيع	iṣelọpọ	Nan
التصنيف	ẹka	Nan
التصنيفات	awọn ipin kilasi	Nan
التشخيص	okunfa	Nan
التصوف	sufism	Nan
التشابه	awọn ibajọra	Nan
التسونامي	tsunami	Nan
الترجمة	itumọ	Nan
الترفيهية	fàájì	Nan
الترك	awọn turk	Nan
التركي	tooki	Nan
التركيب	tiwqn	Nan
التركية	tooki	Nan
التركيز	fojusi	Nan
الترمذي	tirmidhi	Nan
التزاوج	ibarasun	Nan
التزلج	fifọ	Nan
التسامح	ifarada	Nan
التسجيل	forukọsilẹ	Nan
التسعينيات	awọn nineties	Nan
التسلسل	ọkọọkan	Nan
التسمية	aami naa	Nan
التسويق	titaja	Nan
التصويت	dibo	Nan
التصوير	fọtoyiya	Nan
التضاريس	landforms	Nan
التعليم	eko	None
التعليمي	ẹ̀kọ́	None
التعليمية	ẹ̀kọ́	None
التغذية	ounjẹ	Nan
التغير	ayipada	Nan
التغيرات	awọn ayipada	Nan
التغيير	yipada	None
التغييرات	awọn ayipada	Nan
التفاصيل	awọn alaye	Nan
التفاعل	ibaraṣepọ	Nan
التفسير	alaye	Nan
التفسيرات	awọn alaye	Nan
التفكير	lerongba	Nan
التفوق	titobi	Nan
التقارير	awọn ijabọ	Nan
التعلم	eko	None
التعريفات	awọn asọye	Nan
التعريف	itumọ naa	Nan
التعرية	kọlu	Nan
التضخم	afikun	Nan
التطبيق	ohun elo	Nan
التطبيقات	awọn ohun elo	Nan
التطبيقية	loo	Nan
التطور	idagbasoke	None
التطورات	awọn idagbasoke	Nan
التطوير	idagbasoke	None
الثبات	itẹramọṣẹ	Nan
التعاليم	awọn ẹkọ	Nan
التعاون	cooperat	Nan
التعبير	ifihan	Nan
التعداد	ensustò-ìkànìyàn	Nan
التعديل	atunṣe	Nan
التعديلات	awọn atunṣe	Nan
التعرض	ìsírasílẹ	Nan
التعرف	ṣe idanimọ	Nan
التعامل	ṣe adehun	Nan
الترجمات	awọn itumọ	Nan
الثدي	oyan	Nan
الثروات	awọn ọrọ	Nan
الجمع	ọpọ	Nan
الجمعة	ọjọru	Nan
الجمعيات	awọn ẹgbẹ	Nan
الجمعية	ẹgbẹ	Nan
الجمل	kamẹli	Nan
الجملة	idajọ	Nan
الجمهور	awọn olukopa	Nan
الجمهوري	oloṣelu ijọba olominira	Nan
الجمهورية	orileede olominira	Nan
الجميع	gbogbo eyan	Nan
الجن	jinn	Nan
الجنائية	odaran	Nan
الجناح	ẹṣọ	Nan
الجنة	ni párádísè	Nan
الجند	awọn ọmọ-ogun	Nan
الجمباز	idaraya	Nan
الجندي	ọmọ ogun naa	Nan
الجماهير	ọpọ eniyan	Nan
الجماعية	gbigba	Nan
الجسر	afara	Nan
الجسم	ara	Nan
الجسور	awọn ọmọge	Nan
الجسيمات	awọn patikulu	Nan
الجغرافي	geographical	Nan
الجغرافيا	ẹkọ nipa ilẹ	Nan
الجغرافية	àgbègbè	Nan
الجفاف	ogbele	Nan
الجلد	awọ ara	Nan
الجليد	yinyin	Nan
الجليدية	icy	Nan
الجليل	galili	Nan
الجماع	ibaṣepọ	Nan
الجماعة	agbegbe	Nan
الجماعي	gbigba	Nan
الجمال	ẹwa	Nan
الجسد	ara	Nan
الجنرال	gbogboogbo	Nan
الجنسي	ibalopo	Nan
الجولان	awọn golan	Nan
الجوهرة	ohun iyebiye	Nan
الجوي	afẹfẹ	Nan
الجوية	afẹfẹ	Nan
الجيد	awọn ti o dara	Nan
الجيدة	o rẹwa	Nan
الجيزة	géza	Nan
الجيش	ogun	None
الجيل	iran	Nan
الجينات	awọn jiini	Nan
الجينوم	oniye	Nan
الجيني	jiini	Nan
الجينية	jiini	Nan
الجيوش	awọn ọmọ ogun	Nan
الجيولوجية	geology	Nan
الجوفية	ilẹ-ilẹ	Nan
الجنس	ibalopo	Nan
الجودة	awọn didara	Nan
الجوار	aladugbo	Nan
الجنسيات	awọn orilẹ-ede	Nan
الجنسية	orilẹ-ede	Nan
الجنسين	awọn oluda	Nan
الجنوب	gúúsù	None
الجنوبي	gúúsù	None
الجنود	awọn ọmọ-ogun	Nan
الجنين	ọmọ inu oyun	Nan
الجهات	awọn oṣere	Nan
الجهاز	ẹrọ	Nan
الجهة	ipinle naa	Nan
الجهد	akitiyan	Nan
الجهل	aimokan	Nan
الجهود	akitiyan	Nan
الجو	oju ojo	Nan
الجوائز	awọn ẹbun	Nan
الجوانب	awọn ọna	Nan
الجزيرة	al jazeera	Nan
الجزية	ẹya	Nan
الجزيئي	oniyi	Nan
الثمانية	awọn mẹjọ	Nan
الثمانينات	awọn eighties	Nan
الثمانينيات	awọn eighties	Nan
الثنائي	tọkọtaya naa	Nan
الثنائية	ijoko meji	Nan
الثوار	awọn ọlọtẹ	Nan
الثورات	iyika	Nan
الثورة	iyika	Nan
الثوري	iyika	Nan
الثورية	iyika	Nan
الجائزة	joju	Nan
الجابر	al-jaber	Nan
الجاحظ	bigeye	Nan
الجاذبية	walẹ	Nan
الجاز	jazz	Nan
الثلوج	yinyin	Nan
الجاف	gbẹ	Nan
الثلج	yinyin	Nan
الثلاثينات	ekeji	None
الثروة	oro	Nan
الثقافات	awọn aṣa	Nan
الثقافة	aṣa naa	Nan
الثقافي	asa	Nan
الثقب	iho naa	Nan
الثقة	igbekele	Nan
الثقفي	asa	Nan
الثقوب	awọn iho	Nan
الثقيل	oloro	Nan
الثقيلة	oloro	Nan
الثلاث	awọn mẹta	Nan
الثلاثاء	ọjọru	Nan
الثلاثة	awọn mẹta	Nan
الثلاثي	trio	Nan
الثلاثين	ọgbọn	Nan
الثلاثينيات	awọn ọgbọn	Nan
الجافة	gbẹ	Nan
الجاليات	awọn agbegbe	Nan
الجالية	agbegbe	Nan
الجديدة	tuntun	None
الجدير	jẹ tọ	Nan
الجذور	wá	Nan
الجرائم	awọn ọdaràn	Nan
الجراثيم	awọn ara germs	Nan
الجراح	oniṣẹ-abẹ	Nan
الجرمانية	jẹmánì	Nan
الجريدة	iwe iroyin	Nan
الجريمة	ilufin	Nan
الجزء	abala	None
الجزائر	algeria	Nan
الجزائري	awọn algeria	Nan
الجزائريين	awọn ara ilu algeria naa	Nan
الجزر	awọn karooti	Nan
الجزيئات	awọn molecules	Nan
الجديد	tuntun	None
الجدول	iṣeto	Nan
الجدل	ariyanjiyan	Nan
الجدد	neo	Nan
الجامع	gbogbo e	Nan
الجامعات	awọn ile-iwe giga	Nan
الجامعة	yunifasiti	Nan
الجامعي	yunifasiti	Nan
الجامعية	aṣiwe-jinlẹ	Nan
الجانب	ẹgbẹ	Nan
الجانبية	lateral	Nan
الثدييات	awọn osin	Nan
الجانبين	awọn idide	Nan
الجاهلية	aimokan	Nan
الجبال	awọn oke-nla	Nan
الجبر	aljebra	Nan
الجبل	òkè náà	Nan
الجبلية	oke	Nan
الجبهة	ni iwaju	Nan
الجدار	ogiri naa	Nan
الجاهلي	ami-islam	Nan
الترتيب	rangetò	Nan
التربية	eko	None
التربة	ile	Nan
البابوية	papacy	Nan
البابية	ẹjọ	Nan
الباحث	oniwadi	Nan
الباحثون	awọn oniwadi	Nan
الباحثين	awọn oniwadi	Nan
البارد	tutu	Nan
الباردة	tutu	Nan
البارزة	ohun akiyesi	Nan
البارزين	oniye	Nan
الباطنية	esoteric	Nan
الباقي	isimi na	Nan
الباقية	isimi na	Nan
البالغ	agbalagba	Nan
البالغة	agbalagba	Nan
البالغين	agbalagba	Nan
البابلية	bábílónì	Nan
البتراء	petra	Nan
البابلي	bábílónì	Nan
الباب	ilekun	Nan
الانتقال	gbigbe ni	Nan
الانتقالية	alagbede	Nan
الانتقام	gbọsan	Nan
الانتهاء	pari	Nan
الاندلس	andalus	Nan
الاندماج	apapọ	Nan
الانسحاب	nfa jade	Nan
الانضمام	darapọ	Nan
الانطروبولوجيا	apanirun	Nan
الانفجار	bugbamu naa	Nan
الانفصال	iyapa	Nan
الانقسام	pipin	Nan
الانقلاب	awọn coup	Nan
الاهتمام	iwulo	None
الايكولوجية	ilolupo	Nan
البابا	pope	Nan
الانتقادات	ibawi	Nan
البترول	epo	Nan
البحار	okun	Nan
البراكين	onina	Nan
البرامج	awọn eto	Nan
البربر	berberi	Nan
البربرية	okunkun	None
البرتغال	ilu pọtugali	Nan
البرتغالي	ilu pọtugali	Nan
البرتغالية	ilu pọtugali	Nan
البرتغاليين	ilu pọtugali naa	Nan
البرج	ile-iṣọ	Nan
البركان	oke onina aru eefin	Nan
البركاني	onina aruwo	Nan
البركانية	onina aruwo	Nan
البرلمان	ile igbimọ aṣofin	Nan
البرلمانية	ile igbimọ aṣofin	Nan
البرمجيات	sọfitiwia	Nan
البرازيلي	ara ilu brazil	Nan
البث	itankale	Nan
البرازيل	ilu brazil	Nan
البذور	awọn irugbin	Nan
البحر	okun	Nan
البحري	okun-nla	Nan
البحرية	ọgagun	Nan
البحرين	sekun meji	Nan
البحوث	iwadi	None
البحيرات	adagun	Nan
البحيرة	adagun	Nan
البخار	nya si	Nan
البخاري	bukhari	Nan
البدء	bẹrẹ	Nan
البدائي	ni akọkọ	Nan
البدائية	lakoko	Nan
البداية	ibere	Nan
البدنية	ti ara	Nan
البدو	bedouins	Nan
البر	ododo	None
الانتفاضة	rogbodiyan	None
الانتصارات	awọn iṣẹgun	Nan
الانتصار	iṣẹgun	Nan
الاستثمار	idoko-owo	Nan
الاستثمارات	awọn idoko-owo	Nan
الاستخبارات	oloye	None
الاستخدام	lilo	Nan
الاستخدامات	lilo	Nan
الاستراتيجي	ọgbọn	Nan
الاستراتيجية	yi nwon.mirza	Nan
الاستسلام	lati fun ni	Nan
الاستعمار	ilodi	Nan
الاستعماري	ilu amunisin	Nan
الاستعمارية	ilu amunisin	Nan
الاستعمال	lo	Nan
الاستفتاء	awọn referendum	Nan
الاستقرار	iduroṣinṣin	Nan
الاستقلال	ominira	Nan
الازدهار	aisiki	Nan
الاستنساخ	atunse	None
الارتفاع	iga	Nan
الاختيار	awọn wun	Nan
الاجتماع	ipade naa	Nan
الاجتماعات	awọn ipade	Nan
الاجتماعي	awujọ	Nan
الاجتماعية	awujọ	Nan
الاجتهاد	ifarada	Nan
الاحتباس	idaduro	Nan
الاحتفاظ	tọju	Nan
الاحتفال	ayeye	Nan
الاحتفالات	awọn ayẹyẹ	Nan
الاحتكاك	ikọja	Nan
الاحتلال	iṣẹ oojọ	Nan
الاحتياجات	nilo	Nan
الاختبار	idanwo naa	Nan
الاختلاف	iyatọ naa	Nan
الاختلافات	awọn iyatọ	Nan
الارتباط	ọna asopọ	Nan
الاستهلاك	agbara	None
الاستواء	ipele	None
الاستوائية	tropical	Nan
الاعمال	iṣowo	Nan
الاغنية	orin naa	Nan
الاقتصاد	eto-aje	Nan
الاقتصادي	oro-aje	Nan
الاقتصادية	oro-aje	Nan
الاكتشاف	awari	None
الاكتشافات	awari	None
الالتزام	ifaramo	Nan
الامام	imam	Nan
الامبراطورية	ahọluigba lọ	Nan
الامير	ọmọ alade	Nan
الانتخابات	idibo	Nan
الانتخابية	idibo	Nan
الانتداب	ni ase	Nan
الانتشار	itankale	Nan
الاعلام	media	Nan
الاعتماد	ifọwọsi	Nan
الاعتقاد	igbagbọ	Nan
الاعتراف	ti idanimọ	Nan
الاستيلاء	ijagba	Nan
الاسكندنافية	scandinavian	Nan
الاسم	orukọ naa	Nan
الاسود	dudu	Nan
الاشتراك	ṣiṣe alabapin	Nan
الاشتراكي	alaifeiruedaomoenikeji	Nan
الاشتراكية	awujọ	Nan
البرنامج	eto naa	Nan
الاشتراكيون	awọn alagbaṣepọ	Nan
الاصطناعي	orík.	Nan
الاضطراب	rudurudu	Nan
الاضطرابات	rogbodiyan	None
الاضطهاد	inunibini	Nan
الاضطهادات	awọn inunibini	Nan
الاعتبار	ironu	Nan
الاعتداء	sele	Nan
الاصطناعى	sintetiki	Nan
البروتستانت	alatẹnumọ	Nan
البروتستانتية	onitẹnumọ	Nan
البروتوكولات	awọn ilana	Nan
التأكيد	ìmúdájú	Nan
التأليف	onkọwe	Nan
التأمين	iṣeduro	Nan
التائية	t	Nan
التابع	ọmọ-ẹhin naa	Nan
التابعة	alafaramo	Nan
التابعين	awọn ọmọ-ẹhin	Nan
التاج	ade	Nan
التاريخ	itan-akọọlẹ	Nan
التاريخي	itan-akọọlẹ	Nan
التاريخية	itan-akọọlẹ	Nan
التاسع	ẹkẹsan	Nan
التاسعة	ẹkẹsan	Nan
التالي	t’okan t’okan	Nan
التالية	itele	Nan
التأكد	ṣiṣe awọn daju	Nan
التبادل	paṣipaarọ	Nan
التأثيرات	awọn ipa	Nan
البيولوجية	ti ibi	Nan
البيئات	awọn agbegbe	Nan
البيئة	ayika	Nan
البيئي	ayika	Nan
البيان	gbólóhùn	Nan
البيانات	data	Nan
البيت	ile	Nan
البيروني	al-biruni	Nan
البيزنطي	byzantine	Nan
البيزنطية	byzantine	Nan
البيزنطيين	byzantines	Nan
البيض	ẹyin	Nan
البيضاء	funfun	Nan
البيعة	igbagbe ijẹri	Nan
البيوت	awọn ile	Nan
البيولوجي	ti ibi	Nan
التأثير	awọn ipa	Nan
التبانة	ọna miliki	Nan
التبرعات	awọn ẹbun	Nan
التبغ	taba	Nan
التحليلية	itupalẹ	Nan
التحول	awọn naficula	Nan
التحويلية	iyipada	Nan
التخصص	imọ-jinlẹ	Nan
التخصصات	awọn ogbontarigi	Nan
التخطيط	gbimọ	Nan
التخلص	kuro	Nan
التخلي	jowo re sile	Nan
التدخل	ifiisiṣẹ	Nan
التدخين	siga mimu	Nan
التدريب	idanileko	Nan
التدريس	kíkọ́	None
التراب	rtri	Nan
التراث	ajogunba	Nan
التراجع	fifẹyin kalẹ	Nan
التحليل	onínọmbà	Nan
التحكيم	idajọ	Nan
التحكم	iṣakoso	Nan
التحقيق	iwadii	Nan
التتار	jábánì	Nan
التجار	awọn ọjà	Nan
التجارب	awọn iriri	Nan
التجارة	titaja	Nan
التجاري	iṣowo	Nan
التجارية	iṣowo	Nan
التجديد	isọdọtun	Nan
البويضة	awọn ẹyin	Nan
التجربة	iriri	Nan
التجريبية	esiperimenta	Nan
التجنيد	iforukọsilẹ	Nan
التحتية	amayederun	Nan
التحدث	sọ	None
التحرك	gbe	None
التحرير	ṣiṣatunṣe	Nan
التحق	iforukọsilẹ	Nan
التجريبي	ririnkiri	Nan
الحائط	ogiri naa	Nan
البونيقية	ṣẹgun	Nan
البولندية	pólándì	Nan
البضائع	awọn ẹru	Nan
البطالة	alainiṣẹ	Nan
البطل	akọni	Nan
البطن	ikun	Nan
البطولات	awọn ere-idije	Nan
البطولة	idije	Nan
البظر	olaju	Nan
البعث	ajinde	Nan
البعثات	awọn iṣẹ apinfunni	Nan
البعثة	ise	Nan
البعد	iwọn naa	Nan
البعض	diẹ ninu	Nan
البعيدة	jina	Nan
البغدادي	al-baghdadi	Nan
البق	awọn idun	Nan
البصرية	wiwo	Nan
البقاء	duro	Nan
البصريات	optics	Nan
البصرة	basra	Nan
البروتونات	protons	Nan
البروتين	amuaradagba	Nan
البروتينات	awọn ọlọjẹ	Nan
البري	egan	Nan
البرية	egan	Nan
البريد	meeli	Nan
البريطاني	ara ilu gẹẹsi	Nan
البريطانية	ara ilu gẹẹsi	Nan
البريطانيون	ara ilu gẹẹsi	Nan
البريطانيين	ara ilu gẹẹsi	Nan
البسيط	rọrun	Nan
البسيطة	rọrun	Nan
البشر	eniyan	Nan
البشري	eda eniyan	Nan
البشرية	eda eniyan	Nan
البصري	opin	Nan
البقر	maalu	Nan
البقرة	maalu	Nan
البقعة	gbe	None
البنك	banki	Nan
البنوك	awọn ile-ifowopamọ	Nan
البنى	brown	Nan
البنية	awọn be	Nan
البهاء	plego	Nan
البهائي	baháíí	Nan
البهائية	bahá&#39;ís	Nan
البهائيون	bahá&#39;ís	Nan
البهائيين	bahá&#39;ís	Nan
البوابة	ẹnu-ọna	Nan
البوب	agbejade	Nan
البوذية	buddhism	Nan
البوسفور	bosphorus	Nan
البوسنة	bosnia	Nan
البول	imi iṣan	Nan
البنفسجية	àwọ̀	Nan
البنات	awọn ọmọbinrin	Nan
البنائية	ijakadi	None
البناء	ile	Nan
البكارة	wundia	Nan
البكتيريا	alamọ	Nan
البكر	pristine	Nan
البلاد	orílẹ èdè	Nan
البلاغة	rhetoric	Nan
البلد	orilẹ-ede	Nan
البلدان	awọn orilẹ-ede	Nan
البوم	awọn owiwi	Nan
البلدة	ilu	Nan
البلدية	agbegbe	Nan
البلدين	awọn orilẹ-ede meji	Nan
البلطيق	baliki	Nan
البلغارية	ede bulgaria	Nan
البلقان	baluku	Nan
البلوغ	obododo	Nan
البنا	banna	Nan
البلديات	awọn agbegbe	Nan
الاثنين	ọjọ mọndee	Nan
الحاجة	iwulo	None
الحادث	isẹlẹ naa	Nan
الروسي	ara ilu rọsia	Nan
الروسية	ara ilu rọsia	Nan
الروضة	ile-ẹkọ ọmọ-ọwọ	Nan
الروم	oti romu	Nan
الرومان	lomunu lẹ	Nan
الرومانسية	idawọle	Nan
الروماني	roman	Nan
الرومانية	ara ilu romania	Nan
الرومي	rumi	Nan
الري	omi-omi	Nan
الرياح	afẹfẹ	Nan
الرياض	riyad	Nan
الرياضات	idaraya	Nan
الرياضة	idaraya	Nan
الرياضي	elere idaraya	Nan
الروس	awọn ara russia	Nan
الرياضيات	awọn oye	Nan
الروحية	emi	Nan
الروح	ẹ̀mí	Nan
الركن	igun	Nan
الركود	sisanra	Nan
الرمال	iyanrin	Nan
الرمز	koodu	Nan
الرمزي	ami	Nan
الرمزية	ami	Nan
الرمل	iyanrin	Nan
الرملية	iyanrin	Nan
الرموز	awọn aami	Nan
الرنا	rana	Nan
الرها	edessa	Nan
الرهبان	awọn arabara	Nan
الروابط	awọn ọna asopọ	Nan
الروايات	awọn aramada	Nan
الرواية	aramada	Nan
الروحي	emi	Nan
الركاب	awọn ero	Nan
الرياضية	idaraya	Nan
الريف	igberiko	None
الزهراء	zahra	Nan
الزهرة	ododo	None
الزهري	syphilis	Nan
الزهور	awọn ododo	Nan
الزواج	igbeyawo	None
الزواحف	awọn abuku	Nan
الزوار	alejo	Nan
الزوايا	awọn igunpa	Nan
الزوج	ọkọ	Nan
الزوجة	iyawo	None
الزي	aṣọ ile	Nan
الزيادة	awọn ilosoke	Nan
الزيت	òróró	Nan
الزيتون	ólífì	Nan
الزيدية	zaidi	Nan
الزمنية	ago	Nan
الريح	afẹfẹ	Nan
الزمني	ago	Nan
الزمرة	oniye	Nan
الريفية	agbegbe	Nan
الزاوية	igun naa	Nan
الزبير	zubair	Nan
الزجاج	gilasi	Nan
الزراعة	ogbin	Nan
الزراعي	ogbin	Nan
الزراعية	ogbin	Nan
الزرقاء	bulu	Nan
الزعتر	thyme	Nan
الزعماء	awọn adari	Nan
الزعيم	olori	Nan
الزكاة	saki	Nan
الزلازل	awọn iwariri-ilẹ	Nan
الزلزال	ìṣẹlẹ	Nan
الزمان	aago	Nan
الزمن	aago	Nan
الرقيق	awọn irú	Nan
الرقم	nọnba	Nan
الرقص	ijó	Nan
الرئيسية	akọkọ	Nan
الرائدة	olori	Nan
الرابطة	awọn nesusi	Nan
الرابع	kẹrin	None
الرابعة	ẹkẹrin	Nan
الراحة	itunu	Nan
الراحل	ti pẹ	Nan
الراديو	redio	Nan
الرازي	al-razi	Nan
الراشدين	agbalagba	Nan
الرافدين	mesopotamia	Nan
الراقية	giga-opin	Nan
الراهن	ni lọwọlọwọ	Nan
الرايخ	awọn reich	Nan
الرب	ọlọrun	Nan
الرئيسي	akọkọ	Nan
الرباط	rábótì	Nan
الرئيسة	olori	Nan
الرئة	ẹdọ	Nan
الذكري	ọkunrin	Nan
الذكور	ọkunrin	Nan
الذهاب	lọ	Nan
الذهب	wúrà	Nan
الذهبي	wẹwẹ	Nan
الذهبية	wẹwẹ	Nan
الذي	ewo ni	Nan
الذين	tani	Nan
الرأس	orí	Nan
الرأسمالي	kapitalisimu	Nan
الرأسمالية	kapitalisimu	Nan
الرأي	awọn ero	Nan
الرؤية	iran	Nan
الرئاسة	alakoso	Nan
الرئاسية	alakoso	Nan
الرئيس	alakoso	Nan
الربح	itrè	Nan
الربط	asopọmọra	Nan
الربع	kẹkẹ ẹlẹsẹ mẹrin	Nan
الرسول	woli	Nan
الرسولي	apostolic	Nan
الرسوم	awọn owo	Nan
الرشيد	awọn onipin	Nan
الرصاص	asiwaju	Nan
الرصافي	al rusafi	Nan
الرصد	abojuto	Nan
الرضا	itelorun	Nan
الرطوبة	ọriniinitutu	Nan
الرعاية	itọju	Nan
الرغبة	ni ifẹ	Nan
الرغم	tilẹ	Nan
الرفاعي	al-rifai	Nan
الرفض	ijusile	Nan
الرقابة	iṣakoso	Nan
الرسمية	osise	Nan
الرسمي	osise	Nan
الرسم	fa	Nan
الرسل	awọn onṣẹ	Nan
الربيع	orisun omi	Nan
الرتب	awọn ipo	Nan
الرجال	awọn ọkunrin	Nan
الرجل	ọkunrin na	Nan
الرجوع	pada	Nan
الرحالة	apoeyin	Nan
الرحلات	awọn irin ajo	Nan
السؤال	ibeere naa	Nan
الرحلة	irin-ajo	Nan
الرحمة	aanu	None
الرحمن	alaanu	Nan
الرحيم	aanu	None
الرد	idahun si	Nan
الردة	apanirun	Nan
الرسائل	awọn ifiranṣẹ	Nan
الرسالة	ifiranṣẹ	Nan
الرحم	ile-ọmọ	Nan
الذكر	iranti	Nan
السائد	awọn ti nmulẹ	Nan
السائل	omi naa	Nan
السنوات	awọn ọdun	Nan
السنوريات	felidae	Nan
السنوي	lododun	Nan
السنوية	lododun	Nan
السني	sunni	Nan
السنية	sunni	Nan
السنين	awọn ọdun naa	Nan
السنّة	ọdun	Nan
السهل	rọrun	Nan
السهول	awọn pẹtẹlẹ	Nan
السوائل	awọn olomi	Nan
السواحل	awọn agbegbe	Nan
السوبر	olodumare	Nan
السوداء	dudu	Nan
السودان	sudan	Nan
السند	awọn mnu	Nan
السوداني	ara ilu sudan	Nan
السنة	ọdun	Nan
السمك	eja	Nan
السلطة	aṣẹ	Nan
السلطنة	sultanate	Nan
السلع	awọn de	Nan
السلف	royi	Nan
السلفية	salafism	Nan
السلم	akaba	Nan
السلمية	alaafia	None
السلوك	ihuwasi	Nan
السلوكية	ihuwasi	Nan
السليم	dara	Nan
السليمة	ohùn	Nan
السم	oje	Nan
السماء	ọrun	Nan
السمات	awọn ẹya	Nan
السماح	gba laaye	Nan
السن	ọjọ ori	Nan
السلطانية	t’ọla	Nan
السودانية	ara ilu sudan	Nan
السورة	suratu	Nan
السيادة	ologo	Nan
السيارات	awọn ọkọ ayọkẹlẹ	Nan
السيارة	ọkọ	Nan
السياسات	awọn ilana imulo	Nan
السياسة	oselu	Nan
السياسي	oselu	Nan
السياسية	oselu	Nan
السياسيين	awọn oloselu	Nan
السياق	ọrọ-ọrọ	Nan
السيد	ọga	Nan
السيدة	fúnmi	Nan
السير	rìn	None
السيرة	iwe eko	Nan
السيطرة	iṣakoso	Nan
السيف	idà	Nan
السياحية	oniriajo	Nan
السور	odi	Nan
السياحي	oniriajo	Nan
السياح	irin-ajo	Nan
السوري	ará síríà	Nan
السورية	ará síríà	Nan
السوفياتي	ara ilu soviet	Nan
السوفياتية	rosia	Nan
السوفيتي	ara ilu soviet	Nan
السوفيتية	rosia	Nan
السوفييت	awọn soviets	Nan
السوفييتي	ara ilu soviet	Nan
السوق	ọjà	Nan
السويد	sweden	Nan
السويدي	ara ilu sweden	Nan
السويدية	ara ilu sweden	Nan
السويس	suez	None
السويسري	switzerland	Nan
السيئة	awọn ẹni buburu naa	Nan
السياحة	irin-ajo	Nan
السلطان	sultan naa	Nan
السلطات	awọn alase	Nan
السلسلة	jara	Nan
السبت	satide	Nan
السبع	awọn meje	Nan
السبعة	awọn meje	Nan
السبعينات	awọn agogo	Nan
السبعينيات	awọn agogo	Nan
السبيل	ọna naa	Nan
الست	awọn mẹfa	Nan
الستة	awọn mẹfa	Nan
الستينات	awọn mefa	Nan
الستينيات	awọn mefa	Nan
السجن	ẹwọn	Nan
السجون	awọn ẹlẹwọn	Nan
السحابة	awọsanma	Nan
السحب	awọn awọsanma	Nan
السد	idido	Nan
السبب	idi	Nan
السديري	al-sudairy	Nan
السباحة	odo	Nan
السامة	majele	Nan
السائلة	omi naa	Nan
السابع	keje	Nan
السابعة	keje	Nan
السابق	ti tẹlẹ	Nan
السابقة	tẹlẹ	Nan
السابقين	eks	Nan
الساحة	arena	Nan
الساحل	etikun	Nan
الساحلي	etikun	Nan
الساحلية	etikun	Nan
الساخنة	gbona	Nan
السادات	ibanujẹ	Nan
السادس	vi	Nan
الساعة	aago	Nan
الساكنة	aimi	Nan
السامية	giga	Nan
السر	aṣiri naa	Nan
السرطان	alakan	Nan
السرطانات	awọn aarun	Nan
السكر	suga	Nan
السكري	àtọgbẹ	Nan
السكك	rail	Nan
السكن	gbígbé	Nan
السكنية	olugbe	Nan
السلاجقة	seljuks	Nan
السلاح	ohun ija	Nan
السلاسل	ẹwọn	Nan
السلاطين	sultans	Nan
السلالات	awọn ọna	Nan
السلالة	iwọn naa	Nan
السلام	alaafia	None
السلبي	palolo	Nan
السلبية	itara	Nan
السلة	apeere	Nan
السكانية	olugbe	Nan
السكاني	olugbe	Nan
السكان	olugbe	Nan
السفينة	ọkọ oju omi	Nan
السرطانية	gbaju	Nan
السريانية	syriac	Nan
السرية	idaniloju	Nan
السريع	dekun	Nan
السريعة	dekun	Nan
السطح	orule	Nan
السطحية	dada	Nan
السائدة	ṣẹgun	Nan
السعادة	arosọ	Nan
السعودية	orilẹ-ede saudi	Nan
السعي	lepa	Nan
السفر	irin-ajo	Nan
السفلى	isalẹ	Nan
السفلي	isalẹ	Nan
السفن	awọn ọkọ oju omi	Nan
السفير	aṣoju	Nan
السعودي	ara ilu saudi arabia	Nan
الذكاء	oloye	None
الذرية	ebi	None
الذري	atomu	Nan
الحكم	idajọ	Nan
الحكمة	ọgbọn	Nan
الحكومات	awọn ijọba	Nan
الحكومة	ijọba	Nan
الحكومي	ijọba	Nan
الحكومية	ijọba	Nan
الحكيم	ologbon	Nan
الحل	ojutu	Nan
الحلفاء	awọn allies	Nan
الحلقات	awọn ere	Nan
الحلقة	ti iwọn	Nan
الحلم	àlá náà	Nan
الحلول	awọn solusan	Nan
الحلي	awọn ohun ọṣọ	Nan
الحليب	awọn wara	Nan
الحكام	awọn oludari	Nan
الحليم	idahun	Nan
الحقيقية	eni gidi	Nan
الحقيقة	otitọ	Nan
الحصول	gba	None
الحضارات	ilu	Nan
الحضارة	ọlaju	Nan
الحضاري	ọlaju	Nan
الحضرية	agbegbe ilu	Nan
الحظ	orire	Nan
الحظر	wiwọle naa	Nan
الحفاظ	tọju	Nan
الحفلات	awọn ẹgbẹ naa	Nan
الحق	ọtun	Nan
الحقائق	awọn mon	Nan
الحقبة	mú un	Nan
الحقل	aaye	Nan
الحقوق	awọn ẹtọ	Nan
الحقول	awọn aaye	Nan
الحقيقي	gidi	Nan
الحصان	ẹṣin	Nan
الحمام	igbonse	Nan
الحماية	idaabobo	Nan
الحين	ni bayi	Nan
الحيوان	eran	Nan
الحيوانات	awon eranko	Nan
الحيوانية	eran	Nan
الحيوي	biye	Nan
الحيوية	pataki	Nan
الخ	ati be be lo	Nan
الخارج	ita	Nan
الخارجي	odi	Nan
الخارجية	ita	Nan
الخاص	awọn ikọkọ	Nan
الخاصة	ni	Nan
الخاصية	ohun-ini naa	Nan
الخاضعة	koko-ọrọ	Nan
الخالق	eleda	Nan
الحية	gbe	None
الحمامات	awọn balùwẹ	Nan
الحياد	aibikita	Nan
الحي	agbegbe	Nan
الحمد	iyin	Nan
الحمر	py	Nan
الحمراء	pupa	None
الحمض	acid	Nan
الحمل	oyun	Nan
الحملات	awọn ipolowo	Nan
الحملة	ipolongo	Nan
الحميد	hameed	Nan
الحنبلي	hambali	Nan
الحنفي	hanafi	Nan
الحوادث	awọn ijamba	Nan
الحوار	ifọrọwanilẹnuwo	Nan
الحواس	awọn ẹṣẹ	Nan
الحواسيب	awọn kọmputa	Nan
الحوض	agbada	Nan
الحياة	igbesi aye	Nan
الحصار	dóti	Nan
الحشيش	papa odan	Nan
الحشرية	kokoro	Nan
الحبيب	olufẹ	Nan
الحج	irin ajo mimọ	Nan
الحجاب	ibori	None
الحجاج	awọn ajo mimọ	Nan
الحجارة	awọn okuta	Nan
الحجاز	hijaz	Nan
الحجة	ariyanjiyan naa	Nan
الحجر	okuta	Nan
الحجرية	okuta	Nan
الحجم	iwọn	Nan
الحد	idiwọn	Nan
الحدائق	awọn ọgba	Nan
الحداثة	ti igbalode	Nan
الحدث	ìṣẹlẹ	Nan
الحدود	ààlà	Nan
الحبوب	ọkà	Nan
الحدودية	borderlands	Nan
الحبل	cord	Nan
الحب	ife	Nan
الحادثة	ijamba naa	Nan
الحار	loworo	Nan
الحارة	loworo	Nan
الحارث	tiller	Nan
الحاسوب	kọmputa naa	Nan
الحاصل	awọn ipin	Nan
الحاضر	lọwọlọwọ	Nan
الحافظ	olutọju	Nan
الحافلات	awọn ọkọ akero	Nan
الحاكم	adarí	Nan
الحاكمة	idajọ	Nan
الحال	adverb	Nan
الحالات	awọn ọran	Nan
الحالي	ni lọwọlọwọ	Nan
الحالية	lọwọlọwọ	Nan
الحبشة	etiopia	Nan
الحديبية	tubercle	Nan
الحديث	ọrọ naa	Nan
الحديثة	igba ode	Nan
الحروب	ogun	None
الحروف	awọn lẹta	Nan
الحريات	awọn ominira	Nan
الحرية	ominira	Nan
الحرير	ṣoki	Nan
الحريري	al-hariri	Nan
الحزام	beliti	Nan
الحزب	egbe naa	Nan
الحساب	akọọlẹ naa	Nan
الحسن	hassan	Nan
الحسنة	awọn ti o dara	Nan
الحسين	elhussein	Nan
الحسيني	al-hussaini	Nan
الحشرات	awọn kokoro	Nan
الحشرة	kokoro	Nan
الحرمين	awọn ibi mimọ meji	Nan
الحرم	ibi-mimọ naa	Nan
الحركة	egbe	None
الحركات	awọn gbigbe	Nan
الحديد	iron	Nan
الحديدي	okunrin irin	Nan
الحديدية	iron	Nan
الحديقة	ogba	Nan
الحذر	pele	None
الحر	ọfẹ	Nan
الحرائق	ina	Nan
الخام	aise	Nan
الحرارة	ooru	Nan
الحرارية	igbona	Nan
الحرب	ogun	None
الحربي	al-harbi	Nan
الحربية	ijakadi	None
الحرة	ọfẹ	Nan
الحرس	ẹṣọ́	Nan
الحرف	ti ohun kikọ silẹ	Nan
الحراري	igbona	Nan
الخامس	karun	None
الخامسة	karun	None
الخان	awọn khan	Nan
الدفاع	aabo	Nan
الدفاعية	olugbeja	Nan
الدقة	konge	Nan
الدقيق	iyẹfun	Nan
الدقيقة	iṣẹju	Nan
الدكتوراه	ojú	Nan
الدلائل	awọn itọsọna	Nan
الدلالة	itọkasi	Nan
الدليل	itọsọna	Nan
الدم	ẹ̀jẹ̀	Nan
الدماء	ẹjẹ	Nan
الدمار	iparun	Nan
الدماغ	ọpọlọ	Nan
الدمشقي	damascene	Nan
الدموية	ẹjẹ	Nan
الدعوة	ifiwepe	Nan
الدنا	dna	Nan
الدعم	atilẹyin	Nan
الدعارة	panṣaga	Nan
الدجال	quack	Nan
الدخان	ẹfin	Nan
الدخل	owo oya	Nan
الدخول	wiwọle	Nan
الدراسات	awọn ijinlẹ	Nan
الدراسة	keko	None
الدراسية	ileewe	Nan
الدراما	eré náà	Nan
الدرجات	awọn iwọn	Nan
الدرجة	kilasi	Nan
الدروز	rọ	Nan
الدستور	orileede	None
الدستوري	t’olofin	Nan
الدستورية	t’olofin	Nan
الدعاء	gbadura fun	Nan
الدعاية	hype	Nan
الدنمارك	egeskov	Nan
الدنيا	ileaye	Nan
الدهون	awọn ọra	Nan
الدين	esin	Nan
الدينار	dinari	Nan
الديناصور	dinosaur naa	Nan
الديناصورات	dinosaurs	Nan
الدينية	esin	Nan
الديوان	diwan	Nan
الديون	awọn gbese	Nan
الذئب	ìkookò	Nan
الذات	ara-ẹni	Nan
الذاتي	ara-ẹni	Nan
الذاتية	koko-ọrọ	Nan
الذاكرة	iranti	Nan
الذرات	atomu	Nan
الذراع	awọn apa	Nan
الذرة	agbado	None
الديموقراطية	ijoba tiwantiwa	Nan
الديموغرافيا	demography	Nan
الديمقراطية	ijoba tiwantiwa	Nan
الديمقراطيات	ijoba tiwantiwa	Nan
الدوائر	awọn iyika	Nan
الدوافع	iwuri	Nan
الدوحة	doha	Nan
الدور	ipa naa	Nan
الدوران	yiyi	Nan
الدورة	ni papa	Nan
الدوري	ajumọṣe	Nan
الدجاج	adiẹ	Nan
الدورية	akoko igbakọọkan	Nan
الدولة	orilẹ-ede	Nan
الدولتين	awọn ipinlẹ meji	Nan
الدولية	international	Nan
الديار	ile	Nan
الديانات	awọn ẹsin	Nan
الديانة	esin	Nan
الديمقراطي	democrat	Nan
الدول	awọn orilẹ-ede	Nan
الحادة	irorẹ	Nan
الدبلوماسية	ijọṣepọ	Nan
الدار	ile naa	Nan
الخط	laini	Nan
الخطأ	aṣiṣe naa	Nan
الخطة	ero naa	Nan
الخطر	ewu naa	Nan
الخطط	awọn ero	Nan
الخطوات	awọn igbesẹ	Nan
الخطوة	igbesẹ naa	Nan
الخطوط	awọn ila	Nan
الخطيب	khatib	Nan
الخطيرة	isẹ	Nan
الخفيفة	imọlẹ	Nan
الخلاص	igbala	Nan
الخلافات	awọn iyatọ	Nan
الخلافة	aṣeyọri	Nan
الخلايا	awọn sẹẹli	Nan
الخضراء	alawọ ewe	Nan
الخلف	pada	Nan
الخصيب	irọyin	Nan
الخصوبة	irọyin	Nan
الخانات	awọn nọmba	Nan
الخبر	iroyin	Nan
الخبراء	awọn amoye	Nan
الخدمات	awọn iṣẹ	Nan
الخدمة	iṣẹ naa	Nan
الخديوي	awọn khedive	Nan
الخرائط	awọn maapu	Nan
الخروج	jade	Nan
الخريطة	maapu	None
الخسائر	awọn adanu	Nan
الخشب	igi	Nan
الخشبية	iku	None
الخصائص	awọn ohun-ini	Nan
الخصبة	lush	Nan
الخصم	ẹdinwo	Nan
الخصوص	paapa	Nan
الخلفاء	awọn caliphs	Nan
الخلفية	lẹhin	Nan
الخلق	ẹda	Nan
الخوف	ẹru	Nan
الخيال	oju inu	Nan
الخيالة	gbeke	Nan
الخيام	awọn agọ	Nan
الخير	awọn ti o dara	Nan
الخيرية	oore	Nan
الخيل	ẹṣin	Nan
الخيول	awọn ẹṣin	Nan
الدائرة	circle	Nan
الدائري	oruka	Nan
الدائم	awọn yẹ	Nan
الدائمة	duro	Nan
الداخل	ninu	Nan
الداخلي	ilana	None
الداخلية	inu ilohunsoke	Nan
الخواص	awọn ohun-ini	Nan
الخوارزمي	alkhawarizmi	Nan
الخوارج	kharijites	Nan
الخندق	ogbe naa	Nan
الخلوي	alagbeka	Nan
الخلوية	alagbeka	Nan
الخلية	sẹẹli	Nan
الخليج	gulfkun	Nan
الخليجي	al khaliji	Nan
الخليجية	gulfkun	Nan
الخليفة	caliph	Nan
الدانوب	danube	Nan
الخليل	hebroni	Nan
الخمس	awọn marun	Nan
الخمسة	awọn marun	Nan
الخمسينات	awọn aadọta naa	Nan
الخمسينيات	awọn aadọta naa	Nan
الخميس	ọjọbọ	Nan
الخنازير	awọn ẹlẹdẹ	Nan
الخنافس	awọn beetles	Nan
الخمر	waini	Nan
الاثني	eya eleyameya	Nan
الاتهام	ẹsun naa	Nan
الاتفاقية	adehun	Nan
أنهما	wọn jẹ	Nan
أنهى	pari	Nan
أنواع	awọn eya	Nan
أنواعها	awọn oriṣi rẹ	Nan
أنوبيس	anubis	Nan
أنور	anwar	Nan
أني	iyẹn ni	Nan
أنّ	iyẹn	Nan
أنّه	o jẹ a	Nan
أهالي	eniyan	Nan
أهداف	àfojúsùn	Nan
أهدافها	awọn ibi-afẹde rẹ	Nan
أهل	eniyan	Nan
أهله	ebi re	Nan
أهلها	ebi re	Nan
أنهم	pe wọn	Nan
أهلية	yiyẹ ni yiyan	Nan
أنهار	o wó lulẹ	Nan
أنه	o jẹ a	Nan
أنس	anas	Nan
أنسجة	tissue	Nan
أنشأت	ti iṣeto	Nan
أنشئ	ṣẹda	Nan
أنشئت	ti iṣeto	Nan
أنشطة	awọn iṣẹ ṣiṣe	Nan
أنصار	olufowosi	Nan
أنطاكية	chńtíókù	Nan
أنظر	wo	Nan
أنظمة	awọn ọna ṣiṣe	Nan
أنفسهم	awọn funrararẹ	Nan
أنقرة	ankara	Nan
أنك	iyẹn jẹ	Nan
أنماط	awọn ilana	Nan
أننا	wipe a wa	Nan
أنها	o	Nan
أندية	awọn ẹgbẹ	Nan
أهم	pataki julo	Nan
أهمية	pataki	Nan
أوسع	jiduku	Nan
أوسلو	oslo	Nan
أوصى	mo ṣeduro	Nan
أوضاع	awọn ipo	Nan
أوضح	se alaye	Nan
أوضحت	o salaye	Nan
أوقات	igba	Nan
أوقطاي	akoko mi	Nan
أوكرانيا	yukirenia	Nan
أول	akoko	Nan
أولئك	awọn wọnyẹn	Nan
أولا	akoko	Nan
أولاد	awọn ọmọde	Nan
أولاده	awọn ọmọ rẹ	Nan
أولاً	akoko	Nan
أوساط	media	Nan
أهمها	pataki julo	Nan
أوروبية	oyinbo	Nan
أوروبا	yuroopu	Nan
أهميتها	pataki rẹ	Nan
أو	tabi	None
أوائل	tete	Nan
أواخر	pẹ	Nan
أواسط	àárín	None
أوامر	bibere	Nan
أوامره	awọn aṣẹ rẹ	Nan
أوباما	oba	None
أوبرا	oprah	Nan
أوج	apogee	Nan
أوجه	ation	Nan
أوراق	elọ	Nan
أورانوس	uranu	Nan
أورخان	orhan	Nan
أورشليم	jerusalẹmu	Nan
أوروبي	oyinbo	Nan
أنحاء	ju	Nan
أنجلوسكسونيون	angelesxionion	Nan
أنجبت	fun ibi si	Nan
ألعاب	awọn nkan isere	Nan
ألف	ẹgbẹrun	Nan
ألفا	alfa	Nan
ألفًا	alfa	Nan
ألقاب	oruko apeso	Nan
ألقى	wó lulẹ	Nan
ألكسندر	alexander	Nan
ألكيل	alkyl	Nan
ألمانيا	jẹmánì	Nan
ألمانية	jẹmánì	Nan
ألوان	awọn awọ	Nan
أم	iya	Nan
أما	bi fun	Nan
أماكن	awọn aaye	Nan
أمام	ṣaaju	Nan
ألدهيد	aldehyde	Nan
أمامه	ni iwaju rẹ	Nan
ألبوم	awo-orin	Nan
ألبانيا	albania	Nan
أقوى	diẹ alagbara	Nan
أقيم	mo duro	Nan
أقيمت	ni atunse	Nan
أكاديمية	ile-iwe giga	Nan
أكان	akan	Nan
أكتوبر	oṣu kẹwa	Nan
أكثر	diẹ sii	Nan
أكثرها	pupọ ti o	Nan
أكد	jẹrisi	Nan
أكدت	jẹrisi	Nan
أكسيد	ohun elo afẹfẹ	Nan
أكل	jẹun	Nan
أكمل	pari	Nan
ألا	ayafi	Nan
ألاسكا	alaska	Nan
ألبرت	albert	None
أمانة	iyi	Nan
أمة	ìyá r.	Nan
أمثال	fẹran	Nan
أمور	ohun	Nan
أمية	aimọwe	Nan
أمير	olori	Nan
أمين	ni igbẹkẹle	Nan
أمّا	bi fun	Nan
أن	iyẹn	Nan
أنا	emi ni	Nan
أنابيب	awọn iwẹ	Nan
أناكوندا	anaconda	Nan
أنباء	awọn iroyin	Nan
أنبياء	awọn anabi	Nan
أنت	o ti wa	Nan
أنتج	ti iṣelọpọ	Nan
أنتجت	ti iṣelọpọ	Nan
أنثى	obinrin	Nan
أموال	owo	Nan
أمه	ìyá r.	Nan
أمن	aabo	Nan
أمم	awọn orilẹ-ede	Nan
أمثلة	awọn apẹẹrẹ	Nan
أمر	àṣẹ	Nan
أمرا	ohun aṣẹ	Nan
أمراء	awọn akọle	Nan
أمراض	arun	None
أمره	àṣẹ rẹ	Nan
أمرهم	o paṣẹ fun wọn	Nan
أولها	akọkọ ninu wọn	Nan
أمريكا	amẹrika	Nan
أمريكية	ara ilu amẹrika	Nan
أمريكيون	ara amẹrika	Nan
أمرًا	ohun aṣẹ	Nan
أمطار	.jò	Nan
أمفورة	amọmọ	Nan
أمكن	owun to le	Nan
أمل	nireti	Nan
أمريكي	ara ilu amẹrika	Nan
أقواله	awọn ọrọ rẹ	Nan
أولى	akoko	Nan
أوّل	akoko	Nan
إلهام	pataki	Nan
إلى	si mi	Nan
إلي	si mi	Nan
إليك	si ọ	Nan
إلينا	si wa	Nan
إليه	siseto	Nan
إليها	fún un	Nan
إليهم	si wọn	Nan
إم	iya	Nan
إما	bi fun	Nan
إمارة	emirate	Nan
إمام	ṣaaju	Nan
إمبراطور	olú ọba	Nan
إمبراطورية	ọba	Nan
إمكانية	seese	Nan
إله	ẹrọ	Nan
إنا	emi ni	Nan
إلقاء	jabọ	Nan
إلاّ	ayafi	Nan
إطلاق	itusilẹ	Nan
إعادة	pada	Nan
إعداد	igbaradi	Nan
إعطاء	fifun	Nan
إعلامية	oniṣiro	Nan
إعلان	ipolowo	Nan
إف	f	Nan
إفراز	yomijade	Nan
إفريقيا	afirika	Nan
إفريقية	ara ilu afirika	Nan
إقامة	ibugbe	Nan
إقليم	igberiko	None
إقليمية	agbegbe	Nan
إل	awọn	Nan
إلا	ayafi	Nan
إلغاء	ifagile	Nan
إطار	ilana	None
إنتاج	mu jade	Nan
إنتاجها	ikojade wọn	Nan
إياها	o	Nan
إيجاد	wiwa	Nan
إيران	iran	Nan
إيرث	ile aye	Nan
إيطاليا	italia	Nan
إيفان	aifanu	Nan
إيفل	eiffel	Nan
إيقاف	pipa	Nan
إيه	ẹsẹ	None
إِلا	ayafi	Nan
إِلَى	si mi	Nan
ا	a	Nan
ابتداء	bẹrẹ	Nan
ابتناء	anabolism	Nan
ابن	ọmọ	None
إياه	oun	None
إنتاجه	gbe jade	Nan
إنّ	iyẹn	Nan
إنهم	pe wọn	Nan
إنترنت	intanẹẹti	Nan
إنجازات	aṣeyọri	Nan
إنجلترا	england	Nan
إنجليزية	gẹẹsi	Nan
إنجيل	ihinrere	None
إندونيسيا	indonesia	Nan
إنسان	ọkunrin	Nan
إنسانية	onígboyà	Nan
إنشاء	kọ ni ṣisẹ n tẹle	Nan
إنشائها	ṣẹda wọn	Nan
إنفلونزا	aisan	Nan
إنكار	kiko	None
إنما	dipo	Nan
إنها	o	Nan
إنهاء	ipari	Nan
إني	emi ni	Nan
إضافية	afikun	Nan
إضافةً	afikun	Nan
إضافة	afikun	Nan
أَنْ	iyẹn	Nan
إبادة	iparun	Nan
إبان	nigba	Nan
إبراهيم	ibrahim	Nan
إثارة	ayo	Nan
إثبات	imudaniloju	Nan
إثر	ipa	Nan
إثيوبيا	etiopia	Nan
إجراء	ilana	None
إجراءات	awọn ilana	Nan
إجماع	isokan	Nan
إجمالي	lapapọ	Nan
إحباط	ibanujẹ	Nan
إحداث	iṣẹlẹ	Nan
إحدى	ọkan	Nan
أَنَّ	iyẹn	Nan
إحصاء	kika	Nan
أيوب	ayoub	Nan
أينشتاين	einstein	Nan
أى	ewo ni	Nan
أي	ewo ni	Nan
أيام	àwọn ọjọ́	Nan
أيامه	awọn ọjọ rẹ	Nan
أيبك	aybak	Nan
أية	ẹsẹ	None
أيدي	ọwọ	Nan
أيديهم	ọwọ wọn	Nan
أيرلندا	orile-ede ireland	Nan
أيضا	tun	Nan
أيضاً	tun	Nan
أيضًا	tun	Nan
أيلول	oṣu kẹsan	Nan
أيمن	aimen	Nan
أين	nibo	Nan
أيها	hey	Nan
إحصاءات	awọn iṣiro	Nan
إحصائيات	eeka	Nan
إحياء	isedale	Nan
إسرائيل	israeli	Nan
إسطنبول	ilu istanbul	Nan
إسقاط	ilana	None
إسلام	islam	Nan
إسلامه	islam rẹ	Nan
إسلامي	islami	Nan
إسلامية	islamu	Nan
إسماعيل	iṣimaeli	Nan
إشارات	awọn ifihan agbara	Nan
إشارة	ibuwọlu	Nan
إشعاع	itu	None
إصابة	akoran	Nan
إصدار	ipinfunni	Nan
إصلاح	tunṣe	Nan
إصلاحات	tunṣe	Nan
إسحاق	ísákì	Nan
إستراتيجية	nwon.mirza	Nan
إسبانيا	ilu sibeeni	Nan
إس	s.	Nan
إخراج	oludari ni	Nan
إخوته	awọn arakunrin rẹ	Nan
إدارة	isakoso	Nan
إداري	isakoso	Nan
إدارية	isakoso	Nan
إدخال	tẹ	Nan
إدراك	gbigbawọle	Nan
أولية	alakoko	Nan
إذ	nitorinaa	Nan
إذاعة	itankale	Nan
إذن	eti	Nan
إرادة	yoo	None
إرتريا	eretria	Nan
إرسال	firanṣẹ	Nan
إرهابية	apanilaya	Nan
إزالة	yiyọ	Nan
إذا	ti o ba ti	Nan
أقوال	awọn ọrọ	Nan
أقمار	osu	Nan
أقلية	ẹlẹgbẹ	Nan
أحسن	dara julọ	Nan
أحكام	awọn ipese	Nan
أحلام	awọn àlá	Nan
أحمد	ahmad	Nan
أحمدي	ahmadi	Nan
أحمر	pupa	None
أحوال	awọn ipo	Nan
أحياء	isedale	Nan
أحيان	nigba miiran	Nan
أحيانا	nigba miiran	Nan
أحياناً	nigba miiran	Nan
أحيانًا	nigba miiran	Nan
أخاه	arakunrin rẹ	Nan
أخبار	awọn iroyin	Nan
أخت	arabinrin	Nan
أحزاب	awọn ẹgbẹ	Nan
أخته	arabinrin rẹ	Nan
أحدهما	ọkan ninu wọn	Nan
أحدث	titun	Nan
أجريت	ti oludari	Nan
أجزاء	awọn ẹya	Nan
أجسام	ara	Nan
أجل	bẹẹni	Nan
أجمع	mo gba	Nan
أجمل	ẹwà julọ	Nan
أجنبية	ajeji	Nan
أجنحة	iyẹ	Nan
أجهزة	awọn ẹrọ	Nan
أحادي	ẹyọkan	Nan
أحاديث	awọn aditi	Nan
أحب	mo nifẹ	Nan
أحجية	ere idaraya	Nan
أحد	ọkan	Nan
أحداث	iṣẹlẹ	Nan
أحدهم	ẹnikan	Nan
أجرى	lọ sáré	Nan
أخذ	yiya	Nan
أخر	omiiran	Nan
أدوار	ogbeni	Nan
أدولف	adágún	Nan
أدوية	àwọn òògùn	Nan
أدى	gba	None
أدّت	gba	None
أدّى	ṣe	Nan
أذربيجان	azerbaijan	Nan
أراد	fẹ	Nan
أرادت	o fe	Nan
أراض	awọn ilẹ	Nan
أراضي	awọn ilẹ	Nan
أراضيها	ilẹ agbegbe rẹ	Nan
أرباع	awọn mẹẹdogun	Nan
أربع	mẹrin	Nan
أربعة	mẹrin	Nan
أدنى	o kere ju	Nan
أخذت	mo mu	Nan
أدناه	ni isalẹ	Nan
أدرك	ṣẹ	Nan
أخرج	jade	Nan
أخرى	omiiran	Nan
أخطاء	awọn aṣiṣe	Nan
أخطر	lewu julo	Nan
أخلاقية	eya	None
أخوه	arakunrin	Nan
أخيرا	lakotan	Nan
أخيه	arakunrin rẹ	Nan
أخيون	arakunrin	Nan
أداء	imuṣere	Nan
أداة	ohun elo kan	Nan
أدب	litireso	Nan
أدبية	ikawe	Nan
أدت	gba	None
أدخل	tẹ	Nan
أدلة	awọn amọran	Nan
أجراها	ṣe nipasẹ	Nan
أجرام	ilufin	Nan
أجبر	fi ipa mu	Nan
آلات	awọn ẹrọ	Nan
آلاف	ẹgbẹẹgbẹrun	Nan
آلام	iya naa	Nan
آلة	ẹrọ	Nan
آلهة	awọn ọlọrun	Nan
آلية	siseto	Nan
آمن	aabo	Nan
آمنة	ailewu	Nan
آمون	amoni	Nan
آن	iyẹn	Nan
آنذاك	ni igba na	Nan
آي	ewo ni	Nan
آيات	awọn ẹsẹ	Nan
آية	ẹsẹ	None
أ	a	Nan
آل	awọn	Nan
أئمة	awọn imam	Nan
آشوربانيبال	ashurbanipal	Nan
آسكي	ascii	None
+	+	Nan
=	=	Nan
==	==	Nan
|	|	Nan
°	° °	Nan
°م	° c	Nan
آثار	ipa	Nan
آثارها	awọn ipa rẹ	Nan
آخر	omiiran	Nan
آخرها	awọn julọ to ṣẹṣẹ	Nan
آخرون	awọn miiran	Nan
آخرين	awọn ẹlomiran	Nan
آخيل	achilles	Nan
آدم	adam	Nan
آراء	awọn imọran	Nan
آسيا	esia	None
أب	bàbá	None
أبا	oppa	Nan
أباتيت	apatite	Nan
أتاتورك	ataturk	Nan
أتباع	atẹle	Nan
أتباعه	awọn ọmọlẹhin rẹ	Nan
أتت	o wa	Nan
أتى	wa	Nan
أثار	ipa	Nan
أثارت	aro	Nan
أثبت	safihan	Nan
أثبتت	ṣe afihan	Nan
أثر	ipa	Nan
أثرت	fowo	Nan
أثره	ipa rẹ	Nan
أثرية	atijọ	Nan
أثناء	lakoko	Nan
أثينا	athena	Nan
أبيه	baba re	Nan
أبيب	tẹli	Nan
أبي	baba mi	Nan
أبى	baba mi	Nan
أباه	baba re	Nan
أبحاث	iwadi	None
أبدا	bẹrẹ	Nan
أبداً	bẹrẹ	Nan
أبدًا	bẹrẹ	Nan
أبرز	ohun akiyesi julọ	Nan
أبرزها	ohun akiyesi julọ	Nan
أربعين	mẹrin	Nan
أبريل	oṣu kẹrin	Nan
أبعد	jinna	Nan
أبناء	ọmọ	None
أبنائه	awọn ọmọ rẹ	Nan
أبو	abu	Nan
أبواب	ilekun	Nan
أبوظبي	abu dhabi	Nan
أبوه	bàbá r.	Nan
أبطال	awọn aṣaju-ija	Nan
أرجاء	deferent	Nan
أرخبيل	archipelago	Nan
أرخميدس	archimedes	Nan
أعداء	awọn ọtá	Nan
أعدائه	awon ota re	Nan
أعداد	igbaradi	Nan
أعراض	aisan	Nan
أعضاء	awọn ọmọ ẹgbẹ	Nan
أعطى	fún	Nan
أعظم	tobi julo	Nan
أعقاب	lẹhin	Nan
أعلام	awọn asia	Nan
أعلاه	loke	Nan
أعلم	mo mo	Nan
أعلن	polowo	Nan
أعلنت	o kede	Nan
أعلى	oke	Nan
أعمال	iṣowo	Nan
أعاد	tun	Nan
أعماله	awọn iṣẹ rẹ	Nan
أظهرت	mo fihan	Nan
أطول	awọn gunjulo	Nan
أصله	orisun rẹ	Nan
أصلها	orisun rẹ	Nan
أصوات	awọn ohun	Nan
أصول	awọn ipilẹṣẹ	Nan
أصيب	ti farapa	Nan
أضاف	o fi kun	Nan
أضخم	ti o tobi julọ	Nan
أضرار	awọn ibajẹ	Nan
أضعاف	ilọpo meji	Nan
أضلاع	awọn egungun	Nan
أطراف	awọn ẹgbẹ	Nan
أطفال	awọn ọmọde	Nan
أطلق	tu silẹ	Nan
أطلقت	ti ṣe ifilọlẹ	Nan
أطوال	awọn ipari	Nan
أظهر	ṣafihan	Nan
أعمالها	iṣowo rẹ	Nan
أعمدة	awọn ọwọn	Nan
أعوام	ọdun	Nan
أفلام	awọn fiimu	Nan
أفلامه	awọn fiimu rẹ	Nan
أفندي	effendi	Nan
أقاليم	awọn agbegbe	Nan
أقام	duro	Nan
أقبل	gba	None
أقدم	atijọ	Nan
أقر	ti kọja	Nan
أقرب	sunmọ	Nan
أقسام	awọn apakan	Nan
أقصر	kukuru	Nan
أقصى	o pọju	Nan
أقطار	awọn iwọn ila opin	Nan
أقل	ti o kere	Nan
أقليات	awọn kekere	Nan
أفلاطون	plato	Nan
أفكاره	awọn ero rẹ	Nan
أفكار	awọn ero	Nan
أفغانستان	afiganisitani	Nan
أعيد	ti pada	Nan
أغاني	awọn orin	Nan
أغراض	awọn idi	Nan
أغسطس	oṣu kẹjọ	Nan
أغلب	julọ	Nan
أغلبها	julọ ti o	Nan
أغلبية	poju	Nan
أصلاً	ni akọkọ	Nan
أغنى	olowo ni	Nan
أفراد	olukuluku	Nan
أفرادها	awọn ọmọ ẹgbẹ rẹ	Nan
أفرودة	afroda	Nan
أفريقيا	afirika	Nan
أفريقية	ara ilu afirika	Nan
أفضل	dara julọ	Nan
أفعال	verbs	Nan
أغنية	orin	Nan
ابنة	ọmọbinrin	Nan
أصلا	ni akọkọ	Nan
أصفر	odo	Nan
أساسًا	ni ipilẹ	Nan
أساليب	awọn imuposi	Nan
أسامة	ossama	Nan
أسباب	awọn idi	Nan
أسبانيا	ilu sibeeni	Nan
أسبوع	ọsẹ kan	Nan
أستاذ	alamọdaju	Nan
أستراليا	australia	None
أسد	kiniun	Nan
أسر	yiya	Nan
أسرار	asiri	Nan
أسرة	idile	Nan
أسرته	ebi re	Nan
أسرع	yara ju	Nan
أسس	fi idi mulẹ	Nan
أساسية	ipilẹ	Nan
أسست	ni ipilẹṣẹ	Nan
أساسيا	pataki	Nan
أساساً	ni ipilẹ	Nan
أرسطو	aristotle	Nan
أرسل	firanṣẹ	Nan
أرسلان	arslan	Nan
أرسلت	mo si rán	Nan
أرسله	firanṣẹ	Nan
أرض	ilẹ	None
أرضية	ilẹ	None
أرقام	awọn nọmba	Nan
أركان	awọn ọta	Nan
أرمينيا	armenia	Nan
أزمة	rogbodiyan	None
أس	oga patapata	Nan
أسابيع	ọsẹ	Nan
أساس	ipilẹ	Nan
أساسا	ni ipilẹ	Nan
أساسي	ipilẹ	Nan
أسسها	ni ipilẹṣẹ	Nan
أسطورة	àlàyé	None
أسطول	ọkọ oju-omi kekere	Nan
أشد	tougher	Nan
أشرف	ashraf	Nan
أشعة	awọn egungun	Nan
أشكال	awọn apẹrẹ	Nan
أشهر	awọn oṣu	Nan
أشهرها	olokiki julọ	Nan
أشياء	ohun	Nan
أصابع	awọn ika ọwọ	Nan
أصبح	ti di	Nan
أصبحوا	wọn di	Nan
أصحاب	ọrẹ	Nan
أصحابه	awọn ẹlẹgbẹ	Nan
أصدر	ti oniṣowo	Nan
أصدرت	ti oniṣowo	Nan
أصغر	kere	Nan
أشخاص	eniyan	Nan
أشجار	igi	Nan
أشبه	diẹ fẹran	Nan
أشارت	o fihan	Nan
أسعار	awọn idiyele	Nan
أسعد	ti o dun julo	Nan
أسفر	so eso	Nan
أسفرت	ni irugbin	Nan
أسفل	si isalẹ	Nan
أسلحة	awọn ọwọ	Nan
أسلم	aabo	Nan
أصل	oti	Nan
أسلوب	ara	Nan
أسمهان	asmahan	Nan
أسهم	ọjà	Nan
أسوأ	buru	Nan
أسوار	awọn fences	Nan
أسواق	awọn ọja	Nan
أسود	dudu	Nan
أشار	se afihan	Nan
أسماء	awọn orukọ	Nan
ابنته	ọmọbinrin rẹ	Nan
ابنه	ọmọbinrin	Nan
ابي	baba mi	Nan
الأمد	iye akoko	Nan
الأمر	ọrọ naa	Nan
الأمراء	awọn ọmọ-alade	Nan
الأمراض	arun	None
الأمريكتين	amẹrika	Nan
الأمريكي	ara ilu amẹrika	Nan
الأمريكية	ara ilu amẹrika	Nan
الأمريكيون	awọn ara ilu amẹrika	Nan
الأمريكيين	awọn ara ilu amẹrika	Nan
الأمصار	awọn awọn kẹkẹ	Nan
الأمطار	.jò	Nan
الأمعاء	intestine	Nan
الأمل	ireti	Nan
الأملاح	iyọ	Nan
الأمم	awọn orilẹ-ede	Nan
الأمثلة	awọn apẹẹrẹ	Nan
الأمن	aabo	Nan
الأمثال	proverbswe	Nan
الأمانة	iyi	Nan
الألبانية	albania	Nan
الألف	alif	Nan
الألفية	ọdun ẹgbẹrun	Nan
الألم	irora naa	Nan
الألمان	awọn ara jamani	Nan
الألماني	jẹmánì	Nan
الألمانية	jẹmánì	Nan
الألواح	awọn aba	Nan
الألوان	awọn awọ	Nan
الأم	iya naa	Nan
الأمازيغ	awọn berbers	Nan
الأمازيغية	tamazight	Nan
الأماكن	awọn aye	Nan
الأمام	siwaju	Nan
الأمان	aabo	Nan
الأمة	orilẹ-ede	Nan
الألبان	omi-wara	Nan
الأمنية	awọn fẹ	Nan
الأموال	owo	Nan
الأندية	awọn ẹgbẹ	Nan
الأنسجة	tissue	Nan
الأنسولين	hisulini	Nan
الأنشطة	awọn iṣẹ ṣiṣe	Nan
الأنصار	ansar	Nan
الأنصاري	al ansari	Nan
الأنطروبولوجيا	apanirun	Nan
الأنظمة	awọn ọna ṣiṣe	Nan
الأنف	imu	Nan
الأنفاق	awọn ikanni	Nan
الأنماط	awọn ara	Nan
الأنهار	odò	Nan
الأنواع	awọn eya	Nan
الأهالي	awọn obi	Nan
الأهداف	awọn .te	Nan
الأندلس	andalus	Nan
الأمواج	awọn igbi	Nan
الأنثى	obirin	Nan
الأنبياء	awọn woli	Nan
الأمور	ohun ṣẹlẹ	Nan
الأموي	umayyad	Nan
الأموية	umayyad	Nan
الأمويون	awọn umayyads	Nan
الأمويين	awọn umayyads	Nan
الأمية	aimọwe	Nan
الأمير	ọmọ alade	Nan
الأميرة	ọmọ-alade	Nan
الأميركي	ara ilu amẹrika	Nan
الأميركية	ara ilu amẹrika	Nan
الأمين	akọwe	Nan
الأنا	ego	Nan
الأناجيل	awọn bibeli	Nan
الأناضول	anatolia	Nan
الأنباء	awọn iroyin	Nan
الأنثروبولوجيا	alamọdaju	Nan
الألب	alẹ	Nan
الأكسجين	atẹgun	Nan
الأكراد	awọn kurdi	Nan
الأصول	awọn ipilẹṣẹ	Nan
الأضحى	al-adha	Nan
الأضرار	awọn ibajẹ	Nan
الأضلاع	awọn egungun	Nan
الأطباء	awọn dokita	Nan
الأطباق	awọn awopọ	Nan
الأطراف	awọn ẹgbẹ	Nan
الأطرش	atrash	Nan
الأطعمة	onjẹ	Nan
الأطفال	ọmọ	None
الأطلس	atlas	Nan
الأطلسي	ede atlantic	Nan
الأعداء	awọn ọtá	Nan
الأعداد	igbaradi	Nan
الأعراض	awọn aami aisan	Nan
الأصوات	awọn ohun	Nan
الأعراق	awọn ẹya ara ilu	Nan
الأصناف	awọn oriṣiriṣi	Nan
الأصليون	ilu abinibi	Nan
الأشجار	awọn igi	Nan
الأشخاص	eniyan	Nan
الأشراف	abojuto	Nan
الأشرف	ashraf	Nan
الأشعة	awọn ọna	Nan
الأشعري	al-ash&#39;ari	Nan
الأشكال	awọn apẹrẹ	Nan
الأشهر	awọn oṣu	Nan
الأشياء	awọn ohun naa	Nan
الأصدقاء	ọrẹ	Nan
الأصغر	ti o kere ju	Nan
الأصفر	yellow	Nan
الأصل	ipilẹṣẹ	Nan
الأصلي	atilẹba	Nan
الأصلية	atilẹba	Nan
الأصليين	ilu abinibi	Nan
الأعشاب	eweko	Nan
الأعصاب	ara	Nan
الأعضاء	awọn ọmọ ẹgbẹ	Nan
الأفلام	awọn fiimu	Nan
الأفيون	opi	Nan
الأقاليم	awọn agbegbe	Nan
الأقدس	olutọju julọ	Nan
الأقدم	akọbi	Nan
الأقرب	awọn sunmọ	Nan
الأقسام	awọn apakan	Nan
الأقصى	jina	Nan
الأقطار	diagonals	Nan
الأقل	èyí tí ó kéré jù lọ	Nan
الأقليات	awọn kekere	Nan
الأقمار	osu	Nan
الأقوال	awọn ọrọ	Nan
الأكاديمية	omowe	Nan
الأكبر	tobi julo	Nan
الأفكار	awọn imọran	Nan
الأفغاني	ara ilu afiganisitani	Nan
الأفعال	awọn iṣe	Nan
الأفضل	dara julọ	Nan
الأعظم	ti o tobi julọ	Nan
الأعلام	media	Nan
الأعلى	awọn loke	Nan
الأعمال	iṣowo	Nan
الأعمدة	awọn ọwọn	Nan
الأعوام	ọdun	Nan
الأغالبة	aghlabids	Nan
الأهرام	awọn pyramids	Nan
الأغاني	awọn orin	Nan
الأغراض	nkan na	Nan
الأغلب	okeene	Nan
الأغلبية	awọn poju	Nan
الأغنية	orin naa	Nan
الأفراد	olukuluku	Nan
الأفريقي	ara ilu afirika	Nan
الأفريقية	ara ilu afirika	Nan
الأغذية	ounje	Nan
الأهرامات	awọn pyramids	Nan
الأهلي	al-ahly	Nan
الأهلية	yiyẹ ni yiyan	Nan
الإقليمي	agbegbe	Nan
الإقليمية	agbegbe	Nan
الإلحاد	aigbagbọ	Nan
الإلكترون	itanna	Nan
الإلكترونات	itanna	Nan
الإلكترونية	é	Nan
الإله	ọlọrun	Nan
الإلهي	ibawi	Nan
الإلهية	ibawi	Nan
الإمارات	uae	Nan
الإمارة	emirate	Nan
الإمامة	onimeji	Nan
الإمامية	imami	Nan
الإمبراطور	olú ọba	Nan
الإمبراطورية	ahọluigba lọ	Nan
الإقليم	agbegbe	Nan
الإمدادات	awọn ipese	Nan
الإقامة	ibugbe	Nan
الإفريقي	ara ilu afirika	Nan
الإصابة	ipalara	Nan
الإصدار	tu silẹ	Nan
الإصلاح	fix	Nan
الإصلاحات	awọn atunṣe	Nan
الإصلاحية	atunse	None
الإطار	fireemu naa	Nan
الإطلاق	ifilọlẹ	Nan
الإعدام	awọn ipaniyan	Nan
الإعلام	media	Nan
الإعلامي	oniṣiro	Nan
الإعلان	ipolowo	Nan
الإعلانات	awọn ipolowo	Nan
الإغريق	awọn hellene	Nan
الإغريقي	griki	Nan
الإغريقية	griki	Nan
الإفريقية	ara ilu afirika	Nan
الإناث	obirin	Nan
الإنتاج	isejade	Nan
الإنتاجية	ise sise	Nan
الإيطاليين	awọn ara italia	Nan
الإيمان	igbagbọ	Nan
الا	ayafi	Nan
الائتلاف	iṣọkan	Nan
الابتدائي	lakoko	Nan
الابتدائية	lakoko	Nan
الابن	ọmọ	None
الاتجاه	itọsọna	Nan
الاتجاهات	itọsọna	Nan
الاتحاد	euroopu	Nan
الاتحادية	federal	Nan
الاتصال	asopọ	Nan
الاتصالات	awọn ibaraẹnisọrọ	Nan
الاتفاق	adehun naa	Nan
الاتفاقيات	awọn adehun	Nan
الإيطالية	ilu italia	Nan
الإيطالي	ilu italia	Nan
الإيرانية	ara ilu iran	Nan
الإيراني	ara ilu iran	Nan
الإنترنت	intanẹẹti	Nan
الإنجليز	gẹẹsi naa	Nan
الإنجليزي	gẹẹsi	Nan
الإنجليزية	gẹẹsi	Nan
الإنجيل	ihinrere	None
الإنسان	eda eniyan	Nan
الإنساني	eniyan	Nan
الإشعاعي	idawọle	Nan
الإنسانية	eda eniyan	Nan
الإنفاق	lilo	Nan
الإنفلونزا	aisan	Nan
الإنكشارية	awọn onidanwo	Nan
الإنكليزي	gẹẹsi	Nan
الإنكليزية	gẹẹsi	Nan
الإيجابية	awọn rere	Nan
الإيدز	eedi	Nan
الإنشاء	ẹda	Nan
الأسود	dúdú	Nan
الإشعاع	radi	Nan
الإسماعيلية	iṣimaya	Nan
الأوقات	awọn akoko	Nan
الأوكراني	yukirenia	Nan
الأوكرانية	yukirenia	Nan
الأول	akọkọ	Nan
الأولمبية	olimpiiki	Nan
الأولى	ni igba akọkọ	Nan
الأولي	lakoko	Nan
الأولية	lakoko	Nan
الأيام	awọn ọjọ	Nan
الأيبيرية	ara ilu iberian	Nan
الأيسر	osi	Nan
الأيمن	ọtun	Nan
الأيوبي	al ayoubi	Nan
الأيوبية	ayyubid	Nan
الإباحية	aworan iwokuwo	Nan
الأوعية	awọn abọ	Nan
الإبادة	iparun	Nan
الأوضاع	awọn ipo	Nan
الأوسط	àárín	None
الأهم	diẹ pataki	Nan
الأهمية	pataki	Nan
الأوائل	oke	Nan
الأوامر	awọn pipaṣẹ	Nan
الأوبرا	opera	Nan
الأودية	awọn afonifoji	Nan
الأوراق	elọ	Nan
الأورام	awọn ara	Nan
الأوربية	oyinbo	Nan
الأوروبي	oyinbo	Nan
الأوروبية	oyinbo	Nan
الأوروبيون	ara ilu yuroopu	Nan
الأوروبيين	ara ilu yuroopu	Nan
الأوزون	ozone	Nan
الأوساط	awọn iyika	Nan
الأوسمة	awọn ọṣọ	Nan
الإباضية	ibadi	Nan
الإبداع	àtinúdá	Nan
الإبراهيمية	abrahamu	Nan
الإرادة	yoo	None
الإرشاد	igbaninimoran	Nan
الإرهاب	ipanilaya	Nan
الإسبان	awọn ara ilu sipeeni	Nan
الإسباني	awọn ara ilu sipeeni	Nan
الإسبانية	ede spanish	Nan
الإسراء	isra	Nan
الإسرائيلي	ọmọ israel	Nan
الإسرائيلية	ọmọ israel	Nan
الإسرائيليين	awọn ọmọ israel	Nan
الإسكندر	alexander	Nan
الإسكندرية	alexandria	Nan
الإسلام	islam	Nan
الإسلامي	islamu	Nan
الإسلامية	islamu	Nan
الإذاعة	redio	Nan
الإدعشري	el adhari	Nan
الإدارية	isakoso	Nan
الإداري	isakoso	Nan
الإبل	awọn ibakasiẹ	Nan
الإتحاد	euroopu	Nan
الإثارة	iyalẹnu	Nan
الإثنين	ọjọ mọndee	Nan
الإجابة	idahun	Nan
الإجراءات	igbese	Nan
الإجماع	isopọ	Nan
الإشارات	awọn ami naa	Nan
الإجمالي	lapapọ	Nan
الإحساس	ailokun	Nan
الإحصاء	awọn iṣiro	Nan
الإحصاءات	awọn iṣiro	Nan
الإحصائيات	eeka	Nan
الإحصائية	iṣiro	Nan
الإخوان	arakunrin	Nan
الإدارة	isakoso	Nan
الإجمالية	lapapọ	Nan
السينما	ere sinima	Nan
الأسواق	awọn ọja	Nan
الأسمدة	awọn ajile	Nan
استقرار	iduroṣinṣin	Nan
استقرت	ṣeto si isalẹ	Nan
استقلال	ominira	Nan
استقلالها	ominira re	Nan
استكشاف	iwakiri	Nan
استمر	tẹsiwaju	Nan
استمرار	itesiwaju	Nan
استمرت	tẹsiwaju	Nan
استنادا	da lori	Nan
استنادًا	da lori	Nan
استهلاك	lilo	Nan
استولى	gba a	Nan
استيراد	gbewọle	Nan
اسم	nọun	Nan
اسمه	orukọ rẹ	Nan
استقر	fokan bale	Nan
اسمها	oruko re	Nan
استقبال	gbigba	Nan
استفتاء	aṣoju	Nan
استخراج	fa jade	Nan
استراتيجية	nwon.mirza	Nan
استرجاع	gbigba	Nan
استسلام	tẹriba	Nan
استسلمت	mo juwọ	Nan
استضافة	alejo	Nan
استطاع	le	None
استطاعت	o ṣakoso	Nan
استطلاع	atunkọ	Nan
استعادة	imularada	Nan
استعداد	ṣetan	Nan
استعمال	lo	Nan
استعمالها	lo o	Nan
استعمل	lo	Nan
استغلال	lo nilokulo	Nan
استقالته	ifusilẹ rẹ	Nan
استخدمها	lo o	Nan
اشتد	intensify	Nan
اشتهر	ti o dara ju mọ	Nan
اعتمادا	o da lori	Nan
اعتمد	gbokan le	Nan
اعتمدت	ti gba	Nan
اعتناق	gba esin	Nan
اعتنق	gba esin	Nan
اغتيال	apaniyan	Nan
اغتياله	ipaniyan re	Nan
افتتاح	nsii	Nan
افتتح	ṣí	Nan
افتتحت	mo ṣii	Nan
اقتراب	isunmọ	Nan
اقتراح	aba	Nan
اقترح	daba	Nan
اقتصاد	oro aje	Nan
اقتصادها	eto-aje rẹ	Nan
اعتماد	ifọwọsi	Nan
اشتراكية	ọrọ ẹlẹyamẹya	Nan
اعتقد	ronu	Nan
اعتقاد	igbagbọ	Nan
اشتهرت	o di olokiki	Nan
اصدار	ipinfunni	Nan
اضطر	fi ipa mu	Nan
اضطراب	rudurudu	Nan
اضطرابات	awọn iyọnu	Nan
اضطهاد	inunibini	Nan
اعادة	pada	Nan
اعتبار	ero	Nan
اعتبارا	ipa	Nan
اعتباراً	ro	None
اعتبارها	okan	Nan
اعتبر	ṣakiyesi	Nan
اعتبرت	ṣakiyesi	Nan
اعتراف	idanimọ	Nan
اعترف	mo jẹwọ	Nan
اعتقال	dide	Nan
استخدمت	ti lo	Nan
استخدم	lo	Nan
استخدامها	lo o	Nan
اتهام	ẹsùn	Nan
اتهم	fẹsun kan	Nan
اثنان	meji	Nan
اثنتين	meji	Nan
اثنين	meji	Nan
اجتماع	ipade	Nan
اجتماعات	awọn ipade	Nan
اجتماعي	lawujọ	Nan
اجتماعية	awujọ	Nan
اجتمع	irin	Nan
اجتياح	ikogun	Nan
اجل	bẹẹni	Nan
احتراق	sisun	Nan
احترام	ọwọ	Nan
احتفظ	tọju	Nan
اتفق	ti gba	Nan
احتل	iṣẹ iṣe	Nan
اتفاقية	àdéhùn	Nan
اتفاق	àdéhùn	Nan
اتباع	atẹle	Nan
اتباعه	awọn ọmọlẹhin rẹ	Nan
اتبع	tẹ siwaju	Nan
اتجاه	itọsọna	Nan
اتجاهات	lominu	Nan
اتجه	yipada	None
اتحاد	apapọ	Nan
اتخاذ	mu	Nan
اتخذ	ti ya	Nan
اتخذت	mu	Nan
اتساع	ibú	Nan
اتسعت	ti fẹ	Nan
اتسمت	ti samisi	Nan
اتصال	kan si	Nan
اتصالات	telecom	Nan
اتفاقيات	awọn adehun	Nan
احتلال	iṣẹ	Nan
احتلت	ti n ṣiṣẹ	Nan
احتمال	aleebu	Nan
ارتفاعه	giga re	Nan
ارتفاعها	giga re	Nan
ارتفع	ti jinde	Nan
ارتفعت	dide	Nan
ازداد	ti pọ si	Nan
ازدادت	pọsi	Nan
ازدهار	fẹẹrẹ	Nan
ازدهر	rọ	Nan
ازدهرت	rọ	Nan
ازدياد	pọ si	Nan
اس	s.	Nan
استبدال	rọpo	Nan
استخدام	lilo	Nan
استخدامات	lilo	Nan
استخدامه	lo o	Nan
ارتفاع	iga	Nan
ارتبطت	foruka sowo	Nan
ارتبط	sopọ	Nan
ارتباط	ibaraṣepọ	Nan
احتياجات	nilo	Nan
احتياطي	sipaa	Nan
احمد	ahmed	Nan
اختار	yan	None
اختبار	idanwo	Nan
اختبارات	awọn idanwo	Nan
اختراع	kiikan	Nan
اقتصادي	aje	None
اختراق	itusilẹ	Nan
اختلاف	iyato	None
اختلافات	awọn iyatọ	Nan
اختلفت	yatọ	Nan
اختيار	aṣayan	Nan
اختياره	yiyan re	Nan
اخر	omiiran	Nan
اديسون	edison	Nan
اخترع	ti a se	Nan
اقتصاديا	ti ọrọ-aje	Nan
اقتصادية	oro-aje	Nan
اقرأ	ka	Nan
الأديان	awọn ẹsin	Nan
الأذربيجانية	azerbaijani	Nan
الأراضي	awọn ilẹ	Nan
الأرانب	ehoro	Nan
الأربع	mẹẹdogun si	Nan
الأربعة	awọn mẹrin	Nan
الأربعين	mẹrin	Nan
الأرثوذكس	àtijọ	Nan
الأرثوذكسية	àtijọ	Nan
الأرجح	boya	Nan
الأرجنتين	ilu amẹrika	Nan
الأردن	jọ́dánì	Nan
الأردني	jẹ́bánì	Nan
الأردنية	jẹ́bánì	Nan
الأرز	iresi	Nan
الأدوية	elegbogi	Nan
الأرضي	ilẹ	None
الأدوار	awọn ipa	Nan
الأدنى	ni asuwon ti	Nan
الأخر	ekeji	None
الأخرى	ekeji	None
الأخضر	awọn alawọ	Nan
الأخطاء	awọn aṣebi	Nan
الأخلاق	ihuwasi	Nan
الأخلاقية	ihuwasi	Nan
الأخوان	arakunrin	Nan
الأخير	eyi to gbeyin	Nan
الأخيرة	kẹhin	Nan
الأداء	awọn iṣẹ	Nan
الأدب	litireso	Nan
الأدباء	awọn onkọwe	Nan
الأدبي	ikawe	Nan
الأدبية	ikawe	Nan
الأدلة	ẹri naa	Nan
الأدوات	awọn irinṣẹ	Nan
الأرضية	ipakà	Nan
الأرقام	awọn nọmba	Nan
الأرمن	armenia	Nan
الأسبوع	ọsẹ	Nan
الأستاذ	ọjọgbọn naa	Nan
الأسترالية	ilu ọstrelia	Nan
الأسد	kiniun	Nan
الأسر	awọn idile	Nan
الأسرة	ebi	None
الأسرى	awọn ẹlẹwọn	Nan
الأسطورة	awọn arosọ	Nan
الأسطول	awọn ọkọ oju-omi kekere	Nan
الأسعار	awọn idiyele	Nan
الأسفل	kere	Nan
الأسلحة	ohun ija	Nan
الأسلوب	ọna	Nan
الأسماء	awọn orukọ	Nan
الأسماك	eja	Nan
الأسبق	awọn tele	Nan
الأسبرين	aspirin	Nan
الأسبانية	ede spanish	Nan
الأسباني	ede spanish	Nan
الأرمني	armenia	Nan
الأرمنية	armenia	Nan
الأرنب	ehoro	Nan
الأرواح	awọn ẹmi	Nan
الأزرق	bulu	Nan
الأزمات	rogbodiyan	None
الأزمة	aawọ naa	Nan
الأخذ	yiya	Nan
الأزهر	al-azhar	Nan
الأسئلة	awọn ibeere	Nan
الأساس	ipile	Nan
الأساسي	akọkọ	Nan
الأساسية	ipilẹ	Nan
الأساطير	awọn arosọ	Nan
الأساليب	awọn ọna	Nan
الأسباب	awọn idi	Nan
الأزياء	njagun	Nan
الأسنان	awọn eyin	Nan
الأخبار	awọn iroyin	Nan
الأحيان	nigba miiran	Nan
الآستانة	astana	Nan
الآسيوي	ara ilu esia	Nan
الآسيوية	ara ilu esia	Nan
الآشورية	ara assysíríà	Nan
الآفات	ajenirun	Nan
الآلات	awọn ẹrọ	Nan
الآلاف	ẹgbẹẹgbẹrun	Nan
الآلام	irora	Nan
الآلة	ọlọrun	Nan
الآلهة	awọn ọlọrun	Nan
الآلي	aládàáṣiṣẹ	Nan
الآلية	awọn ẹrọ	Nan
الآن	ni bayi	Nan
الآونة	laipẹ	Nan
الآيات	awọn ẹsẹ	Nan
الآرامية	aramaiki	Nan
الآية	ẹsẹ naa	Nan
الآر	the aar	Nan
الآخرين	awọn ẹlomiran	Nan
اكتساب	ohun-ini	Nan
اكتسبت	gba	None
اكتشاف	awari	None
اكتشافه	ṣawari rẹ	Nan
اكتشافها	ṣawari wọn	Nan
اكتشف	ṣawari	Nan
اكتشفت	mo ṣe awari	Nan
ال	awọn	Nan
الآب	baba	Nan
الآباء	awọn obi	Nan
الآبار	awọn kanga	Nan
الآتي	atẹle	Nan
الآثار	archaeology	Nan
الآخر	ekeji	None
الآخرة	ọla	Nan
الآداب	litireso	Nan
الأئمة	awọn imam	Nan
الأب	baba	Nan
الأباطرة	awọn ọba-nla	Nan
الأجنحة	awọn iyẹ	Nan
الأجهزة	awọn ẹrọ	Nan
الأجيال	awọn ipin	Nan
الأحاديث	awọn aditi	Nan
الأحد	ọjọ sundee	Nan
الأحداث	awọn iṣẹlẹ	Nan
الأحرار	eniyan ọfẹ	Nan
الأحرف	awọn ohun kikọ	Nan
الأحزاب	awọn ẹgbẹ naa	Nan
الأحكام	awọn ipese	Nan
الأحماض	awọn apọju	Nan
الأحمد	al-ahmad	Nan
الأحمر	pupa	None
الأحوال	awọn ipo	Nan
الأحياء	isedale	Nan
الأجنبية	ajeji	Nan
الأجنبي	àlejò	Nan
الأجناس	awọn ẹka	Nan
الأجسام	awọn ohun	Nan
الأبجدية	ahbidi	Nan
الأبحاث	iwadi	None
الأبطال	awọn akọni	Nan
الأبعاد	awọn iwọn	Nan
الأبناء	awọn ọmọde	Nan
الأبواب	awọn ilẹkun	Nan
الأبيض	funfun	Nan
الأخ	arakunrin naa	Nan
الأتراك	awọn ara ilu tooki	Nan
الأثر	ipa	Nan
الأثرية	archaeological	Nan
الأثناء	l&#39;akoko	Nan
الأثير	ether	Nan
الأجانب	awọn ajeji	Nan
الأجرام	ara	Nan
الأجزاء	awọn ẹya naa	Nan
الأثار	archaeology	Nan
السينمائي	fiimu	Nan
السينمائية	ere sinima	Nan
السينية	x	Nan
الوزن	iwuwo	Nan
الوزير	minisita naa	Nan
الوسائل	ọna	Nan
الوسط	àárín	None
الوسطى	aarin	Nan
الوسواس	akiyesi	Nan
الوسيط	olulaja	Nan
الوصف	ijuwe naa	Nan
الوصول	wiwọle	Nan
الوصيف	olusare	Nan
الوضع	ipo naa	Nan
الوطن	iya-ile	Nan
الوطني	ti orilẹ-ede	Nan
الوطنية	orilẹ-ede	Nan
الوظائف	awọn iṣẹ	Nan
الوزراء	awọn minisita	Nan
الوظيفة	iṣẹ oojọ	Nan
الوزارة	ijoba	Nan
الورق	iwe	Nan
الوثائق	awọn iwe aṣẹ	Nan
الوثنية	ibọriṣa	Nan
الوثيقة	iwe	Nan
الوجبات	awọn ounjẹ	Nan
الوجه	ojú	Nan
الوجود	iwalaaye	Nan
الوحدات	awọn ipin	Nan
الوحدة	ẹgbẹ	Nan
الوحي	ifihan	Nan
الوحيد	oun nikan	Nan
الوحيدة	nikan kan	Nan
الوديان	awọn afonifoji	Nan
الوراء	pada sẹhin	Nan
الوراثة	jiini	Nan
الوراثية	jiini	Nan
الورم	epo naa	Nan
الوالي	igbakeji	Nan
الوظيفي	ọmọ	None
الوفاة	iku	None
اليابانية	japanese	Nan
اليابسة	ilẹ	None
اليد	ọwọ	Nan
اليدوية	ọwọ	Nan
اليرموك	yarmouk	Nan
اليسار	òsì	Nan
اليسرى	osi	Nan
اليقين	idaniloju	Nan
اليمامة	al-yamamah	Nan
اليمن	si tani	Nan
اليمنى	ọtun	Nan
اليمنية	yemeni	Nan
اليمين	ni ọtun	Nan
اليه	siseto	Nan
اليهود	awọn ju	Nan
الياباني	japanese	Nan
الوعي	akiyesi	Nan
اليابان	japan	Nan
الوهابية	wahhabism	Nan
الوفد	aṣoju naa	Nan
الوفيات	awọn iku	Nan
الوقائع	awọn mon	Nan
الوقاية	aabo	Nan
الوقت	aago	Nan
الوقود	epo naa	Nan
الوقوف	dide	Nan
الوكالة	ibẹwẹ	Nan
الولاء	otitọ	Nan
الولاة	àṣẹ	Nan
الولادة	ibi	Nan
الولايات	awọn ipinle	Nan
الولاية	ipinle	Nan
الوليد	alwaleed	Nan
الوهاب	olufun gbogbo eniyan	Nan
الويب	wẹẹbu	Nan
الوالد	baba	Nan
الواقعية	otito	Nan
الواقعة	otitọ naa	Nan
النيتروجين	nitrogen	Nan
النيجر	niger	Nan
النيل	nile	Nan
الهائل	phenomenal	Nan
الهائلة	oniyi	Nan
الهاتف	foonu	Nan
الهادئ	idaamu	Nan
الهادي	oludari naa	Nan
الهاشمي	hashemi	Nan
الهاشمية	hashemite	Nan
الهامة	pataki	Nan
الهبوط	ibalẹ	Nan
الهجان	arabara	Nan
الهجرة	iṣilọ	Nan
الهجري	hijri	Nan
النيازك	meteorites	Nan
الهجمات	awọn ikọlu	Nan
النووية	iparun	Nan
النوم	orun	Nan
النهائي	ik	Nan
النهائية	ik	Nan
النهار	osan	Nan
النهاية	ipari	Nan
النهج	isunmọ	Nan
النهر	odo	Nan
النهرين	awọn odo meji	Nan
النهضة	renesansi	Nan
النواب	awọn aṣoju	Nan
النواحي	awọn ọna	Nan
النوادي	awọn ẹgbẹ	Nan
النواعير	awọn orisun omi	Nan
النور	ina	Nan
النوع	iru	Nan
النوعية	didara	Nan
النووي	iparun	Nan
الهجوم	kọlu	Nan
الهدنة	apagun	Nan
الهرم	jibiti	Nan
الهيئة	igbimọ	Nan
الهياكل	awọn ọna	Nan
الهيثم	al-haytham	Nan
الهيدروجين	hydrogen	Nan
الهيكل	awọn be	Nan
الواجب	iṣẹ amurele	Nan
الواجهة	ọlọpọọmídíà	Nan
الواحد	oun gangan	Nan
الوادي	afonifoji	Nan
الواردات	mu awọn okeere	Nan
الواردة	ti ni	Nan
الواسع	jooro	Nan
الواسعة	jooro	Nan
الواضح	o han ni	Nan
الواقع	otitọ	Nan
الهيئات	awọn ajọ	Nan
الهوية	idanimọ	Nan
الهولوكوست	bibajẹ	Nan
الهولندية	dutch	Nan
الهروب	sa fun	Nan
الهزيمة	ṣẹgun	Nan
الهضاب	awo pẹlẹbẹ naa	Nan
الهضبة	awo pẹtẹlẹ	Nan
الهلال	oṣupa kinni	Nan
الهند	india	Nan
الهندسة	imọ-ẹrọ	Nan
اليهودي	júù	Nan
الهندسية	imọ-ẹrọ	Nan
الهندوسية	hinduism	Nan
الهندي	ara ilu inde	Nan
الهندية	hindi	Nan
الهنود	ara ilu inde	Nan
الهواء	afẹfẹ	Nan
الهوائية	aerobic	Nan
الهولندي	dutch	Nan
الهندوس	arabinrin naa	Nan
النمور	awọn ara tigers	Nan
اليهودية	ẹsin juu	Nan
اليورو	euro	None
بإصدار	lati jade	Nan
بإضافة	nipa fifi	Nan
بإطلاق	egba pipe	Nan
بإعادة	tun	Nan
بإقامة	fi idi	Nan
بإنتاج	mu jade	Nan
بإنشاء	awọn ẹda	Nan
بئر	daradara	Nan
باب	ilẹkun	Nan
بابا	baba	Nan
بابل	bábílónì	Nan
بابن	ọmọkunrin kan	Nan
بات	ti di	Nan
باتجاه	si ọna	Nan
باحتلال	gbigbe	Nan
بإرسال	firanṣẹ	Nan
باختلاف	yatọ	Nan
بإجراء	lati ṣe	Nan
بأول	tẹsiwaju	Nan
بأحد	si ẹnikẹni	Nan
بأداء	lati ṣe	Nan
بأسلوب	ni ọna	Nan
بأسماء	pẹlu awọn orukọ	Nan
بأشكال	ni awọn fọọmu	Nan
بأعمال	awọn iṣẹ	Nan
بأكثر	diẹ sii	Nan
بأكمله	odindi	Nan
بألمانيا	jẹmánì	Nan
بأمر	nipa aṣẹ	Nan
بأن	iyẹn	Nan
بأنه	iyẹn ni	Nan
بأنها	o bi	Nan
بأنهم	pe wọn jẹ	Nan
بأوروبا	ni yuroopu	Nan
بأي	ni eyikeyi	Nan
بأبي	baba mi	Nan
بادئ	lakoko	Nan
باديس	badis	Nan
باكو	baku	Nan
بالأرض	flattened	Nan
بالأمر	nipa rẹ	Nan
بالإسكندرية	ni alexandria	Nan
بالإسلام	pẹlu islam	Nan
بالإضافة	ni afikun	Nan
بالإمكان	o ṣee ṣe	Nan
بالإنجليزية	ni ede gẹẹsi	Nan
بالاشتراك	apapọ	Nan
بالبلاد	ninu ilu	Nan
بالتالي	paradà	Nan
بالتجارة	iṣowo	Nan
بالتركية	ni tooki	Nan
بالتعاون	ni ifowosowopo	Nan
بالجامعة	ni yunifasiti	Nan
باكستان	pakistan	Nan
بادية	badia	Nan
باقي	oludari	Nan
باعتباره	bi awọn kan	Nan
بارتفاع	soke	Nan
بارد	tutu	Nan
بارز	oguna	Nan
بارزة	olokiki	Nan
باريس	paris	Nan
باستثناء	ayafi	Nan
باستخدام	lilo	Nan
باستعمال	lilo	Nan
باستقلال	ominira	Nan
باستمرار	loorekoore	Nan
باسم	basim	Nan
باسمه	ni orukọ rẹ	Nan
باشا	pasha	Nan
باطن	soles	Nan
باعتبار	considering	Nan
باعتبارها	bi awọn kan	Nan
ب	b	Nan
اي	ewo ni	Nan
اهل	eniyan	Nan
انبعاث	itusilẹ	Nan
انبعاثات	awọn itujade	Nan
انتخاب	idibo	Nan
انتخابات	awọn idibo	Nan
انتخابه	idibo rẹ	Nan
انتخب	ti dibo	Nan
انتزاز	ifipa	Nan
انتشار	tànkálẹ	Nan
انتشارا	ṣẹgun	Nan
انتشاراً	ṣẹgun	Nan
انتشارها	itankale rẹ	Nan
انتشارًا	ilọju	Nan
انتشر	osun	Nan
انتشرت	itankale	Nan
انتصار	isegun	Nan
ان	iyẹn	Nan
انتصارات	aamieye	Nan
امساخ	rtri	Nan
امتلكت	mo ni	Nan
اليوم	loni	Nan
اليومية	lojojumo	Nan
اليونان	griki	Nan
اليوناني	griki	Nan
اليونانية	griki	Nan
اليونانيون	awọn hellene	Nan
اليونانيين	awọn hellene	Nan
اليونسكو	unesco	Nan
ام	iya	Nan
اما	bi fun	Nan
امام	ṣaaju	Nan
امتد	tànkálẹ	Nan
امتداد	itẹsiwaju	Nan
امتدت	ti ita nà	Nan
امتصاص	akiyesi	Nan
امرأة	obinrin kan	Nan
انتصر	o bori	Nan
انتفاضة	igbagbe	Nan
انتقاد	ibaniwi	Nan
انظر	wo	Nan
انعقاد	ntojọ	Nan
انفجار	bugbamu	Nan
انفصال	iyapa	Nan
انقراض	iparun	Nan
انقسام	pin	Nan
انقطاع	idalọwọduro	Nan
انقلاب	iyipo	Nan
انه	o jẹ a	Nan
انها	o	Nan
انهم	pe wọn	Nan
انهيار	subu	Nan
اهتم	o dabọ	Nan
اهتمام	ifẹ si	Nan
اهتمامه	ifẹ si	Nan
انطلقت	ti ṣe ifilọlẹ	Nan
انطلق	tẹ siwaju	Nan
انضمت	o darapo	Nan
انضمام	apapọ	Nan
انتقادات	ibawi	Nan
انتقال	orilede	Nan
انتقالية	alagbede	Nan
انتقد	kọjọ	Nan
انتقل	o gbe	Nan
انتقلت	mo ti gbe	Nan
انتهاء	ipari	Nan
اليورانيوم	uranium	Nan
انتهت	ti pari	Nan
انخفاض	silẹ	Nan
انخفض	ti dinku	Nan
انخفضت	ti dinku	Nan
اندلعت	bu jade	Nan
اندونيسيا	indonesia	Nan
انسحاب	yiyọ kuro	Nan
انضم	darapo	None
انتهى	ti pari	Nan
النموذج	ayẹwo	Nan
النمل	awon kokoro	Nan
النمط	ilana	None
المناصب	awọn ipo	Nan
المناطق	awọn ẹkun-ilu	Nan
المناعة	ajesara	Nan
المناعي	immunofluorescence	Nan
المنافسة	idije naa	Nan
المناهج	ẹtan	Nan
المناهضة	alatako	Nan
المنتج	ọja	Nan
المنتجات	awọn ọja	Nan
المنتجة	ti iṣelọpọ	Nan
المنتخب	awọn ayanfẹ	Nan
المنتخبات	awọn ẹgbẹ	Nan
المنتدى	apejọ	Nan
المنتشرة	ti tu sita	Nan
المنتظر	nduro fun	Nan
المناسبة	ayeye	Nan
المنخفضة	kekere	None
المناسبات	awọn iṣẹlẹ	Nan
المنازل	awọn ile	Nan
الممالك	awọn ijọba	Nan
المماليك	mamluks	Nan
الممتاز	o tayọ	Nan
الممتدة	lilọ kiri	Nan
الممتلكات	awọn ohun-ini	Nan
الممثل	oṣere	Nan
الممثلة	oṣere	Nan
الممثلين	awọn oṣere	Nan
الممكن	owun to le	Nan
المملكة	ijọba	Nan
المملوكي	mamluk	Nan
المملوكية	mamluk	Nan
المميزة	iyatọ	Nan
المناخ	afefe	Nan
المناخية	irọrun	Nan
المناسب	yẹ	Nan
الممارسة	iwa	Nan
المندائية	dadè mánáánì	Nan
المنزلي	ile abinibi	Nan
المهرجانات	awọn ayẹyẹ	Nan
المهلهل	onititọ	Nan
المهم	awọn pataki	Nan
المهمة	ise apinfunni	Nan
المهنة	iṣẹ oojọ	Nan
المهندس	enjinia	Nan
المهندسين	enjinia	Nan
المهنية	ọjọgbọn	Nan
المواجهة	ifigagbaga	Nan
المواد	awọn ohun elo	Nan
الموارد	awọn orisun	Nan
المواصلات	gbigbe	Nan
المواضيع	awọn okun	Nan
المواطن	ara ilu	Nan
المواطنين	ara ilu	Nan
المهدي	mahadi	Nan
المنزل	ile	Nan
المهبل	obo	Nan
المهارات	ogbon	Nan
المنزلية	ilé	None
المنشآت	awọn ohun elo	Nan
المنصب	ipo naa	Nan
المنصور	al-mansour	Nan
المنصورة	mansoura	Nan
المنطق	apanirun	Nan
المنطقة	agbegbe	Nan
المنظمات	awọn ajọ	Nan
المنظمة	agbari	Nan
المنعم	munim	Nan
المنفى	yíyọ	Nan
المنهج	ọla-iṣẹ	Nan
المنورة	medina	Nan
المنوية	sugbọn	Nan
المهاجرين	awọn aṣikiri	Nan
المهام	ise	Nan
الملوك	awọn ọba	Nan
الملوثة	dipo	Nan
الملوثات	awọn idoti	Nan
المفسرين	awọn onitumọ naa	Nan
المفضلة	ayanfẹ	Nan
المفكرين	awọn arinlẹ	Nan
المفهوم	oye	Nan
المقابر	awọn oku	Nan
المقابل	pada naa	Nan
المقابلة	ifọrọwanilẹnuwo	Nan
المقارنة	ifiwera	Nan
المقاطعات	awọn ilu	Nan
المقاطعة	ọmọkunrin	Nan
المقاعد	awọn ijoko	Nan
المقال	nkan naa	Nan
المقالات	nkan	None
المقالة	nkan	None
المقام	awọn ariam	Nan
المفروضة	ti fi ofin si	Nan
المقاومة	resistance	Nan
المفردات	ikọwe	Nan
المفترض	sawon	Nan
المغاربة	ilu moroccan	Nan
المغرب	ilu morocco, iwọ-oorun, iwọoorun	Nan
المغربي	ilu moroccan	Nan
المغربية	ilu moroccan	Nan
المغلقة	ti paade	Nan
المغناطيس	oofa	Nan
المغناطيسي	o se	Nan
المغناطيسية	oofa	Nan
المغول	awọn mongoli naa	Nan
المغولي	mughal	None
المغولية	mongolian	Nan
المفاتيح	awọn bọtini	Nan
المفاعلات	awọn ololufẹ	Nan
المفاهيم	awọn ilana	Nan
المفاوضات	awọn ijiroro	Nan
المفتوحة	ṣi	Nan
المقاييس	awọn iwọn	Nan
المقدس	mimọ	Nan
المقدسة	mimọ	Nan
الملائكة	awọn angẹli	Nan
الملابس	awọn aṣọ	Nan
الملاحة	lilọ kiri	Nan
الملاحظات	awọn akọsilẹ	Nan
الملاحظة	akiyesi	Nan
الملايو	ede mala	Nan
الملايين	milionu	Nan
الملح	iyo	Nan
الملعب	ile-iṣere naa	Nan
الملفات	awọn faili	Nan
الملقب	inú	Nan
الملك	ọba	Nan
الملكة	ayaba	Nan
الملكي	ọba	Nan
الملكية	ohun-ini	Nan
المكي	meccan	Nan
المكونة	irinṣẹ	Nan
المكونات	awọn eroja	Nan
المكون	irinṣẹ	Nan
المقدسي	jerúsálẹ́mù	Nan
المقدمة	ifaara	Nan
المقدوني	makedonia	None
المقر	orí orí	Nan
المقربين	awọn ti o sunmọ	Nan
المقرر	ipinnu	Nan
المقصود	ti pinnu	Nan
الموافق	ibamu	Nan
المقيمين	olugbe	Nan
المكتب	iduro	Nan
المكتبات	awọn ile-ikawe	Nan
المكتبة	ile ikawe	Nan
المكتوبة	kọ	Nan
المكرمة	al mukarramah	Nan
المكسيك	meksiko	None
المكسيكية	meksiko	None
المكان	ibi	Nan
الموافقة	dara	Nan
المواقع	awọn ipo	Nan
المواقف	awọn ipo	Nan
النسبي	ebi	None
النسبية	isọdọtun	Nan
النسخ	atagba	Nan
النسخة	tu silẹ	Nan
النسق	ìfilélẹ	Nan
النسيج	awọn aṣọ	Nan
النشأة	foundation	Nan
النشاط	iṣẹ ṣiṣe	Nan
النشاطات	awọn akitiyan	Nan
النشر	atẹjade	Nan
النشطة	ṣiṣẹ	Nan
النشيد	orin-ọlọrun	Nan
النص	ọrọ	Nan
النصارى	awọn kristiani	Nan
النصر	iṣẹgun	Nan
النسبة	ipin naa	Nan
النصف	idaji	None
النسب	awọn ipin	Nan
النساء	awọn obirin	Nan
النجار	gbẹnagbẹna na	Nan
النجم	irawo	Nan
النجوم	irawọ	Nan
النحاس	ejò	Nan
النحت	sisọ ẹrọ	Nan
النحل	oyin	Nan
النحو	bi	Nan
النخبة	gbajumo	Nan
النخيل	ọpẹ	Nan
النرويج	norway	Nan
النرويجي	nowejiani	Nan
النرويجية	nowejiani	Nan
النزاع	rogbodiyan	None
النزاعات	rogbodiyan	None
النزعة	titọju	Nan
النسائية	arabinrin	Nan
النصوص	awọn ọrọ	Nan
النضر	aseyori	None
النطاق	sakani	Nan
النقاد	awọn alariwisi	Nan
النقاط	ojuami	Nan
النقد	ibaniwi	Nan
النقدي	owo	Nan
النقدية	owo	Nan
النقص	àìpé	Nan
النقطة	koko	Nan
النقل	ọkọ	Nan
النقود	owo naa	Nan
النقيض	ifiwera	Nan
النماذج	awọn awoṣe	Nan
النمر	tiger	Nan
النمسا	austria	Nan
النمساوي	ara ilu austrian	Nan
النمساوية	ara ilu austrian	Nan
النفوس	emi	Nan
النفوذ	ipa	Nan
النفقات	awọn inawo	Nan
النفطية	epo	Nan
النطق	ronwe	Nan
النظام	awọn eto	Nan
النظامي	awọn ilana	Nan
النظامية	ọna ẹrọ	Nan
النظر	wo	Nan
النظرة	oju naa	Nan
النظريات	awọn imọ-jinlẹ	Nan
النجاح	aṣeyọri	Nan
النظرية	yii	Nan
النعمان	lane	Nan
النفايات	egbin	Nan
النفس	iho	Nan
النفسي	oroinuokan	Nan
النفسية	ọpọlọ	Nan
النفط	epo naa	Nan
النفطي	epo naa	Nan
النظير	ojúgbà	Nan
بالجزائر	ni algeria	Nan
النثر	sewe	Nan
النتائج	awọn abajade	Nan
الموسيقار	olorin	Nan
الموسيقى	orin	Nan
الموسيقي	orin	Nan
الموسيقية	musical	Nan
الموضوع	koko-ọrọ	Nan
الموضوعات	awọn akọle	Nan
الموظفين	oṣiṣẹ	Nan
الموقع	aaye	Nan
الموقف	ipo	None
المولد	bibi	Nan
المولود	bibi	Nan
المولى	sire	Nan
المياه	omi	None
الميت	kú	Nan
الميثاق	oludari	Nan
الموسوعة	encyclopedia	Nan
الميثان	meta	Nan
الموسمية	ti igba	Nan
المورثة	ẹbun	Nan
الموالية	pro	Nan
المواليد	ọmọ tuntun	Nan
الموانئ	awọn ọkọ oju omi	Nan
الموت	iku	None
الموتى	awọn okú	Nan
الموجات	awọn igbi	Nan
الموجة	igbi naa	Nan
الموجهة	itọsọna	Nan
الموجود	wa	Nan
الموجودة	wa tẹlẹ	Nan
الموجي	waveform	Nan
الموجية	waveform	Nan
الموحد	iṣeduro	Nan
الموحدة	boṣewa	Nan
الموحدين	awọn alailẹgbẹ	Nan
الموسم	akoko	Nan
الميدالية	medal	Nan
الميدان	aaye	Nan
الميزانية	isuna	Nan
الناشئة	nyoju	Nan
الناصر	nasser	Nan
الناطقة	nsoro	Nan
الناطقين	awọn agbọrọsọ	Nan
النامية	dagbasoke	None
النبات	ohun ọgbin	Nan
النباتات	awọn ohun ọgbin	Nan
النباتي	ewebe	Nan
النباتية	ewebe	Nan
النبلاء	awọn ọlọla	Nan
النبوة	asọtẹlẹ	Nan
النبوي	woli naa	Nan
النبوية	woli naa	Nan
النبي	woli naa	Nan
النبيذ	waini	Nan
الناس	eniyan	Nan
النازية	nazism	Nan
النازي	ara nazi	Nan
النارية	alupupu	Nan
الميكانيكا	awọn ọna ẹrọ	Nan
الميكانيكية	meji	Nan
الميلاد	keresimesi	Nan
الميلادية	gregorian	Nan
الميلاديين	ad	Nan
الميناء	ọdụ ebute oko	Nan
الميول	awọn isunmọtosi	Nan
النتيجة	esi ni	Nan
الناتج	abajade	Nan
الناتو	nato	None
الناجحة	aseyori	None
الناجمة	fa	Nan
الناحية	ẹgbẹ	Nan
النادرة	toje	None
النادي	ologba	Nan
النار	ina	Nan
الناتجة	idi	Nan
بالجنة	ọrun	Nan
بالحرب	pẹlu ogun	Nan
بالحكم	nipa idajọ	Nan
بيوم	ojokan	Nan
بُني	tọọlẹ	Nan
ت	t	Nan
تأثر	fowo	Nan
تأثرت	iwunilori	Nan
تأثير	ipa	Nan
تأثيرا	ipa	Nan
تأثيرات	ipa	Nan
تأثيره	ipa rẹ	Nan
تأثيرها	ipa rẹ	Nan
تأخذ	mu	Nan
تأسس	ti iṣeto	Nan
تأسست	ti dasilẹ	Nan
تأسيس	ṣiṣeto	Nan
تأسيسها	ipile rẹ	Nan
بيوت	awọn ile	Nan
تأكيد	tcnu	Nan
بينهما	laarin wọn	Nan
بينها	laarin wọn	Nan
بيبرس	ata	Nan
بيت	ilé kan	Nan
بيته	ile rẹ	Nan
بيد	sibẹsibẹ	Nan
بيده	pẹlu ọwọ rẹ	Nan
بيروت	beirut	Nan
بيعة	tita	Nan
بيك	bek	Nan
بيكو	pico	Nan
بيكومتر	awọn pakoomu	Nan
بيل	owo-iwe	Nan
بيليوس	peleus	Nan
بين	laarin	None
بينما	lakoko ti	Nan
بينه	ẹri	Nan
بينهم	laarin won	Nan
بيانات	data	Nan
تأليف	kọ nipa	Nan
تأييد	atilẹyin	Nan
تبث	itankale	Nan
تبدأ	bẹrẹ	Nan
تبدو	wo	Nan
تبرز	ai-gba	Nan
تبع	tẹle	Nan
تبعا	fehin ti	Nan
تبعد	lọ	Nan
تبقى	duro	Nan
تبلغ	ijabọ	Nan
تبنت	ti gba	Nan
تبنى	isọdọmọ	Nan
تبني	isọdọmọ	Nan
تبوك	tabuk	Nan
تبين	wa ni	Nan
تتأثر	fowo	Nan
تبادل	paṣipaarọ	Nan
تأمين	aṣeduro	Nan
تايوان	taiwan	Nan
تامة	gangan	Nan
تؤثر	ipa	Nan
تؤدي	abajade	Nan
تؤكد	tẹnumọ	Nan
تؤمن	gbagbọ	Nan
تابع	tẹle	Nan
تابعة	alakoso	Nan
تاج	ade	Nan
تاريخ	itan-akọọlẹ	Nan
تاريخه	itan re	Nan
تاريخها	itan re	Nan
تاريخي	itan-akọọlẹ	Nan
تاريخيا	itan-akọọlẹ	Nan
تاريخياً	itan-akọọlẹ	Nan
تاريخية	itan-akọọlẹ	Nan
تاشفين	ṣe o ri	Nan
تايمز	igba	Nan
بيان	alaye	Nan
بيئة	ayika	Nan
بي	ninu mi	Nan
بنشر	lati jade	Nan
بنظام	eto	Nan
بنغازي	benghazi	Nan
بنفس	pẹlu kanna	Nan
بنفسه	nipa ararẹ	Nan
بنفسها	nipasẹ ararẹ	Nan
بنقل	gbigbe	Nan
بنك	bank	Nan
بنو	awọn ọmọde	Nan
بنوع	bi i	Nan
بنى	tọọlẹ	Nan
بني	tọọlẹ	Nan
بنية	be	Nan
بنيت	ti a še	Nan
به	pẹlu rẹ	Nan
بنسبة	ni oṣuwọn ti	Nan
بها	o jade	Nan
بنزوين	benzoin	Nan
بنحو	nipa	Nan
بممارسة	ere idaraya	Nan
بمناسبة	siṣamisi	Nan
بمنطقة	ni agbegbe kan	Nan
بموجب	labẹ	Nan
بن	ọmọ ti	Nan
بنا	awọn ewa kọfi	Nan
بناء	ile	Nan
بناءً	ile	Nan
بنائها	kọ o	Nan
بنات	awọn ọmọbinrin	Nan
بناه	awọn akọle	Nan
بناها	o kọ ọ	Nan
بنت	ọmọbinrin kan	Nan
بنتيجة	pẹlu abajade kan	Nan
بنجاح	ni aṣeyọri	Nan
بندر	bender	Nan
بهاء	baha	Nan
بهجوم	pẹlu ikọlu	Nan
بهدف	pẹlu a ìlépa	Nan
بوصفها	bi awọn kan	Nan
بوضع	lati fi	Nan
بوضوح	kedere	Nan
بوقت	pẹlu akoko	Nan
بوك	facebook	Nan
بول	pọ́ọ̀lù	Nan
بولاية	pẹlu ipinle kan	Nan
بولس	pọ́ọ̀lù	Nan
بولندا	polandii	Nan
بولينا	paulina	Nan
بومدين	boumediene	Nan
بونابرت	bonaparte	Nan
بونيقيون	ṣẹgun	Nan
بوهيميا	bohemia	Nan
بويع	tita!	Nan
بوصفه	bi	Nan
بوش	bush	Nan
بورصة	ọja	Nan
بورسعيد	port said	Nan
بهذا	nipasẹ eyi	Nan
بهذه	pẹlu eyi	Nan
بهلوي	pahlavi	Nan
بهم	wọn	None
بهما	pẹlu wọn	Nan
بو	bo	Nan
بوابات	awọn ẹbun	Nan
تتألف	kq	Nan
بوابة	ilekun nla	Nan
بواسطة	nipasẹ	Nan
بوجه	oju	Nan
بوجود	ní bẹ	Nan
بوحدة	ẹyọ kan	Nan
بوذا	buddha	Nan
بور	bohr	Nan
بورتو	porto	Nan
بواس	boas	Nan
تتبع	orin	Nan
تتجاوز	kọja	Nan
تتجمع	ẹjọ	Nan
تخفيض	ẹdinwo	Nan
تدار	ṣiṣakoso	Nan
تدخين	mimu siga	Nan
تدرس	duro	Nan
تدريب	idanileko	Nan
تدريجيا	di .di.	Nan
تدريجياً	di .di.	Nan
تدريجيًا	di .di.	Nan
تدعم	atilẹyin	Nan
تدعو	awọn ifiwepe	Nan
تدفع	o sanwo	Nan
تدفق	ṣiṣan	Nan
تدل	sọ	None
تدمير	iparun	Nan
تدهور	idapada	Nan
تخطيط	gbimọ	Nan
تدور	spin	Nan
تخضع	koko-ọrọ	Nan
تخصص	pataki	Nan
تحكم	iṣakoso	Nan
تحل	ti yanju	Nan
تحليل	itupalẹ	Nan
تحمل	ṣiṣe	Nan
تحميل	ṣe igbasilẹ	Nan
تحول	iyipada	Nan
تحولت	yipada	None
تحوي	ni	Nan
تحويل	iyipada	Nan
تحوّل	iyipada	Nan
تحيط	ti yika	Nan
تختلف	yatọ	Nan
تخدم	sin	Nan
تخرج	ayẹyẹ-ayẹyẹ	Nan
تخزين	ibi ipamọ	Nan
تخصيص	ṣe akanṣe	Nan
تدوين	igbasilẹ	Nan
تدير	o sare	Nan
تذكر	ranti	Nan
تركيا	tọki	Nan
تركيب	fifi sori ẹrọ	Nan
تركية	tooki	Nan
تركيز	idojukọ	Nan
ترى	wo	Nan
تريد	o fẹ	Nan
ترير	trier	Nan
تزال	ṣi	Nan
تزايد	pọ si	Nan
تزداد	ngba diẹ sii	Nan
تزوج	se igbeyawo	Nan
تزوجت	ṣe ìgbéyàwó	Nan
تزوجها	fẹ́ ẹ	Nan
تزيد	pọsi	Nan
تساعد	egba mi o	Nan
تركي	tọki	Nan
تركها	fisile	Nan
تركز	idojukọ	Nan
تركت	osi	Nan
تراث	ogún	Nan
تراجع	sẹhin	Nan
تراجعت	ti ya	Nan
تراقيا	itanran	Nan
ترانسفيراز	itankale	Nan
تربة	ile	Nan
تربط	sopọ	Nan
تحقيق	iwadii	Nan
تربية	eko	None
ترتفع	lọ soke	Nan
ترتيب	bere fun	Nan
ترجع	awọn ipadabọ	Nan
ترجم	itumọ	Nan
ترجمة	itumọ	Nan
تردد	igbagbogbo	Nan
ترك	lọ	Nan
ترتبط	ti so pọ	Nan
بمكة	ni mekka	Nan
تحقق	ṣayẹwo	Nan
تحصل	gba	None
تتعلق	jẹmọ	Nan
تتغذى	wọn ifunni	Nan
تتغير	yipada	None
تتكون	ti a ṣe	Nan
تتم	ti ṣee	Nan
تتمتع	gbadun	Nan
تتمثل	oun ni	Nan
تتمكن	o le	Nan
تتميز	ti wa ni characterized nipasẹ	Nan
تتناول	nini ounje	Nan
تتنوع	yatọ	Nan
تتواجد	wa tẹlẹ	Nan
تتوفر	wa	Nan
تتوقف	duro	Nan
تتيح	gba laaye	Nan
تتعرض	sihan	Nan
تثبت	vewe	Nan
تتعامل	ṣe iṣowo	Nan
تتطلب	beere	Nan
تتجه	orí	Nan
تتحدث	o sọrọ	Nan
تتحرك	gbigbe	Nan
تتحول	gbe jade	Nan
تتخذ	mu	Nan
تتدخل	idapọmọra	Nan
تتراوح	ibiti	None
تتركز	koju	Nan
تتسبب	fa	Nan
تتسع	le gba	Nan
تتسم	ti fiwe si	Nan
تتشابه	kanna	Nan
تتشكل	ti gbekale	Nan
تتصل	rekọ si	Nan
تتضمن	pẹlu	Nan
تتطور	da bi	Nan
تجار	awọn olutaja	Nan
تجارب	awọn iriri	Nan
تجارة	isowo	Nan
تحتفظ	awọn ifiṣura	Nan
تحتل	iṣẹ iṣe	Nan
تحتها	labẹ rẹ	Nan
تحتوى	ni awọn	Nan
تحتوي	ni awọn	Nan
تحد	ipenija	Nan
تحدث	sọrọ	Nan
تحدد	pinnu	Nan
تحديث	imudojuiwọn	Nan
تحديد	pinnu	Nan
تحرر	ominira	Nan
تحرك	gbe	None
تحرير	tu silẹ	Nan
تحسن	ilọsiwaju	Nan
تحسين	ilọsiwaju	Nan
تحتاج	nilo	Nan
تحت	labẹ	Nan
تحاول	o gbiyanju	Nan
تحاميل	awọn iṣeduro	Nan
تجاري	ti iṣowo	Nan
تجارية	iṣowo	Nan
تجاه	si ọna	Nan
تجاوز	amuye	Nan
تجد	o wa	Nan
تجديد	isọdọtun	Nan
تجربة	idanwo	Nan
تحظى	ni	Nan
تجري	mu aye	Nan
تجمع	apejo	Nan
تجمعات	apejo	Nan
تجميع	ajọpọ	Nan
تجنب	yago fun	Nan
تجهيز	igbaradi	Nan
تحافظ	tọju	Nan
تحالف	alliance	Nan
تجعل	ṣe	Nan
المعي	ikun	Nan
بمكان	ni aaye kan	Nan
بمعنى	itumo	None
بحيرة	adagun	Nan
بخار	nya si	Nan
بخصوص	ifiyesi	Nan
بخط	ninu iwe afọwọkọ	Nan
بخلاف	miiran ju	Nan
بد	gbọdọ	Nan
بدء	bẹrẹ	Nan
بدءا	bibẹrẹ	Nan
بدءاً	bibẹrẹ pẹlu	Nan
بدءًا	bibẹrẹ	Nan
بدأ	dabi	Nan
بدأت	o bere	Nan
بدا	dabi	Nan
بداخل	inu ti	Nan
بدايات	awọn bibẹrẹ	Nan
بحيرات	adagun	Nan
بداية	bẹrẹ	Nan
بحيث	ninu eyiti	Nan
بحوالي	nipa	Nan
بجوار	ti o tele	Nan
بجيش	pẹlu ọmọ ogun	Nan
بجيشه	pẹlu ọmọ ogun rẹ	Nan
بحاجة	nilo	Nan
بحال	lonakona	Nan
بحث	ṣewadii	Nan
بحجة	ijiyan	Nan
بحد	idiwọn	Nan
بحر	okun	Nan
بحري	ipilẹṣẹ	Nan
بحرية	ọfẹ	Nan
بحسب	gẹgẹ bi	Nan
بحق	ọtun	Nan
بحكم	nipa agbara ti	Nan
بحلول	nipasẹ	Nan
بحوث	iwadi	None
بجميع	ninu gbogbo ẹ	Nan
بدايتها	ibẹrẹ rẹ	Nan
بدر	badr	Nan
برج	ile-iṣọ	Nan
برز	ai-gba	Nan
برزت	pọ soke	Nan
برسم	fun owo kan	Nan
برشلونة	ilu barcelona	Nan
برعاية	ti gba itọju	Nan
برفع	lati gbe soke	Nan
برقة	rọra	Nan
بركان	onina	Nan
بركة	omi ikudu	Nan
برلمان	ile igbimọ aṣofin	Nan
برلمانية	ile igbimọ aṣofin	Nan
برلين	ilu berlin	Nan
برنامج	eto kan	Nan
بروبيلين	propylene	Nan
براون	brown	Nan
بدخول	tẹ	Nan
براكودة	barracuda	Nan
بذلك	pẹlu iyẹn	Nan
بدراسة	ikẹkọ	Nan
بدرجة	ìyí	Nan
بدعم	atilẹyin	Nan
بدفع	lati sanwo	Nan
بدقة	deede	Nan
بدلا	dipo	Nan
بدلاً	dipo	Nan
بدمشق	ni damasku	Nan
بدن	ara	Nan
بدور	ipa	Nan
بدوره	leteto	Nan
بدورها	leteto	Nan
بدولة	ni orilẹ-ede kan	Nan
بدون	laisi	Nan
بديلة	omiiran	Nan
برئاسة	orí	Nan
بجمع	gba	None
بجعة	siwani	Nan
بجانب	ti o tele	Nan
بالفرنسية	ni faranse	Nan
بالفشل	kuna	Nan
بالفعل	lootọ	Nan
بالقاهرة	ni cairo	Nan
بالقدس	ni jerusalẹmu	Nan
بالقرب	sunmọ	Nan
بالقوة	nipa agbara	Nan
بالكثير	pupo	Nan
باللاتينية	ni latin	Nan
باللغات	tun wa	Nan
باللغة	ni ede	Nan
بالله	ninu ọlọrun	Nan
باللون	ni awọ	Nan
بالماء	pelu omi	Nan
بالمدينة	nipa ilu	Nan
بالغة	agbalagba	Nan
بالمرض	gba aisan	Nan
بالغ	agbalagba	Nan
بالعمل	nibi ise	Nan
بالخط	laini kan	Nan
بالخلافة	aṣeyọri	Nan
بالدولة	ipinle	Nan
بالذات	pupọ	Nan
بالذكر	n mẹnuba	Nan
بالرغم	tilẹ	Nan
بالسكان	olugbe	Nan
بالسنة	odun	Nan
بالسيطرة	mu iṣakoso	Nan
بالشكل	ni apẹrẹ	Nan
بالطاقة	agbara	None
بالعالم	ni agbaye	Nan
بالعبرية	ni heberu	Nan
بالعديد	ọpọlọpọ	Nan
بالعربية	ni ede arabic	Nan
بالعين	nipa oju	Nan
بالمعنى	ni ori	Nan
بالمغرب	ni ilu morocco	Nan
بالمقابل	lọna miiran	Nan
بتطبيق	nipa lilo	Nan
بتعيين	ṣeto	Nan
بتغيير	yipada	None
بتقديم	gbigbe	Nan
بتلك	pẹlu iyẹn	Nan
بتنظيم	ṣeto	Nan
بتنفيذ	ṣe imuṣe	Nan
بتهمة	lori awọn idiyele	Nan
بتوجيه	labẹ itọsọna naa	Nan
بتونس	ni tunisia	Nan
بث	igbohunsafefe	Nan
بثلاث	mẹta	Nan
بثلاثة	nipa mẹta	Nan
بجائزة	onipokinni	Nan
بجامعة	yunifasiti	Nan
بتشكيل	ni agbekalẹ	Nan
بتحويل	yipada	None
بتاريخ	tan	Nan
بتأسيس	ni ipilẹṣẹ	Nan
بالمقارنة	ni ifiwera pẹlu	Nan
بالمملكة	ni ijọba	Nan
بالمنطقة	ni agbegbe	Nan
بالمياه	pelu omi	Nan
بالنسبة	nipa	Nan
باليونانية	ni greek	Nan
بان	wiwọle	Nan
بروتوكول	ilana	None
باوني	pawnee	Nan
بايزيد	bayezid	Nan
ببساطة	nìkan	Nan
ببطء	laiyara	Nan
ببطولة	arabara	Nan
ببعض	diẹ ninu	Nan
ببعضها	papọ	Nan
ببناء	akopọ	Nan
باي	oniye	Nan
بروتون	proton	None
بروز	igbasilẹ	Nan
بروسيا	prussia	Nan
بقتله	lati pa a	Nan
بقدر	bi elo	Nan
بقرار	pẹlu ipinnu kan	Nan
بقعة	iranran	Nan
بقلم	nipasẹ	Nan
بقليل	kekere die	Nan
بقوة	ni okun	Nan
بقوله	nipa sisọ	Nan
بقي	dúró	None
بقيادة	gba nipasẹ	Nan
بقية	iyoku	Nan
بقيت	o duro	Nan
بك|	rẹ |	Nan
بكتابة	ni kikọ	Nan
بكتيريا	awọn kokoro arun	Nan
بقتل	lati pa	Nan
بكثرة	lọpọlọpọ	Nan
بقايا	ku	None
بق	kokoro	Nan
بعيدا	lọ	Nan
بعيداً	lọ	Nan
بعيدة	jinna	Nan
بعين	pẹlu oju	Nan
بغداد	baghdad	Nan
بغزو	ti yabo	Nan
بغض	laibikita	Nan
بغير	ayafi ti	Nan
بـ	pẹlu	Nan
بفتح	ṣi	Nan
بفترة	igba die	Nan
بفضل	ọpẹ si	Nan
بفعل	nipa ṣiṣe	Nan
بفكرة	pẹlu imọran	Nan
بفيروس	pẹlu ọlọjẹ kan	Nan
بقاء	iwalaaye	Nan
بكثير	pọ	Nan
بكر	bakr	Nan
بكرة	rola	Nan
بلغت	gba	None
بلفور	balfour	Nan
بلقب	pẹlu akọle	Nan
بلقيس	belques	Nan
بليحائية	blahy	Nan
بما	pẹlu	Nan
بمثابة	bi	Nan
بمجرد	ni ẹẹkan	Nan
بمحمد	muhammad	Nan
بمختلف	yatọ	Nan
بمرض	gba aisan	Nan
بمرور	kọja nipasẹ	Nan
بمساعدة	pẹlu iranlọwọ ti	Nan
بمصر	ni egipti	Nan
بمعدل	ni oṣuwọn kan	Nan
بلغة	ni ede kan	Nan
بلغاريا	bulgaria	Nan
بلغ	de ọdọ	Nan
بلعمية	phagocytosis	Nan
بكل	ninu gbogbo ẹ	Nan
بكميات	ni titobi	Nan
بكونها	nipa kikopa	Nan
بكين	ilu beijing	Nan
بل	ṣugbọn	Nan
بلا	laisi	Nan
بلاد	awọn orilẹ-ede	Nan
بعيد	jinna	Nan
بلاده	ibinujẹ	Nan
بلاط	awọn alẹmọ	Nan
بلال	belal	Nan
بلجيكا	bẹljiọmu	Nan
بلد	orilẹ-ede	Nan
بلدان	awọn orilẹ-ede	Nan
بلدة	ilu	Nan
بلدية	agbegbe	Nan
بلادهم	orilẹ-ede wọn	Nan
بمقدار	nipasẹ	Nan
بعنوان	ifọwọsi	Nan
بعمليات	awọn iṣiṣẹ	Nan
بشأن	nipa	Nan
بشار	bashar	Nan
بشدة	darale	Nan
بشر	eda eniyan	Nan
بشراء	ra	None
بشرط	lori majemu	Nan
بشركة	pẹlu ile-iṣẹ kan	Nan
بشري	eda eniyan	Nan
بشرية	ọmọ eniyan	Nan
بشكل	ni ọna kan	Nan
بشيء	pẹlu ohunkan	Nan
بشير	bashir	Nan
بصفة	bi	Nan
بصفته	bi tirẹ	Nan
بصورة	aworan	Nan
بسيطة	rọrun	Nan
بضرورة	laanu	Nan
بسيط	o rọrun	Nan
بسم	ni orukọ	Nan
بروسيلا	brucella	Nan
بروناي	brunei	Nan
بري	egan	Nan
برية	aginjù	Nan
بريد	meeli	Nan
بريشة	ẹyẹ	Nan
بريطانيا	gẹẹsi	Nan
بريطانية	ara ilu gẹẹsi	Nan
بزعامة	gba nipasẹ	Nan
بزيادة	soke	Nan
بزيارة	ṣabẹwo	Nan
بسبب	nitori	Nan
بسرطان	akàn	Nan
بسرعة	ni kiakia	Nan
بسط	faagun	Nan
بسهولة	ni irọrun	Nan
بضع	kan diẹ	Nan
بضعة	kan diẹ	Nan
بضم	nipa apapọ	Nan
بعدم	ko si	Nan
بعدما	lẹhin	Nan
بعده	lẹhin rẹ	Nan
بعدها	lẹhinna	Nan
بعدهم	lẹhin wọn	Nan
بعرض	iwọn	Nan
بعض	diẹ ninu	Nan
بعضها	diẹ ninu wọn	Nan
بعضهم	diẹ ninu wọn	Nan
بعضهما	olukuluuku ara wa	Nan
بعقد	pẹlu adehun	Nan
بعل	hubby	Nan
بعلم	mimọ	Nan
بعمر	pẹlu igbesi aye kan	Nan
بعمل	n ṣe	Nan
بعدد	ni nọmba	Nan
بعدة	orisirisi	None
بعد	jinna	Nan
بعثة	irin ajo	Nan
بطاقات	awọn kaadi	Nan
بطاقة	kaadi	Nan
بطبيعة	dajudaju	Nan
بطرس	pétérù	Nan
بطرق	ni awọn ọna	Nan
بطريق	penguin	Nan
بطريقة	ni ọna kan	Nan
بعملية	isẹ	Nan
بطل	akọni kan	Nan
بطن	ikun	Nan
بطوطة	batuta	Nan
بطولات	awọn ere-idije	Nan
بطولة	aṣaju	Nan
بطيئة	lọra	Nan
بعام	ọdun kan	Nan
بعث	o ranṣẹ	Nan
بطليموس	ptolemy	Nan
تساوي	dọgbadọgba	Nan
المعهد	ile-iwe	Nan
المعنى	itumo	None
العوامل	okunfa	Nan
العود	lute	Nan
العودة	pada	Nan
العولمة	iṣowo agbaye	Nan
العيد	eid	Nan
العيش	gbe	None
العين	oju	Nan
العينين	oju	Nan
العيون	awọn oju	Nan
الغابات	igbo	Nan
الغابة	woods	Nan
الغاز	gaasi	Nan
الغازات	awọn ọya	Nan
الغازي	ajígun	Nan
الغالب	okeene	Nan
العوام	awọn ẹlẹwọn	Nan
الغالبية	pupọ	Nan
العواصف	ìjì	Nan
العنف	iwa-ipa	Nan
العملاق	omiran	Nan
العملاقة	awọn omiran	Nan
العملة	owo naa	Nan
العملي	wulo	Nan
العمليات	awọn ilana	Nan
العملية	ni isẹ	Nan
العمود	iwe	Nan
العموم	awọn wọpọ	Nan
العمومية	akopọ	Nan
العميق	jinjin	Nan
العميقة	jin	Nan
العناصر	awọn eroja	Nan
العناية	itọju	Nan
العنب	àjàrà	Nan
العنصر	idi	Nan
العهد	majẹmu	Nan
العمل	iṣẹ	Nan
الغبار	eruku	Nan
الغذاء	ounje	Nan
الغني	awọn ọlọrọ	Nan
الغنية	ọlọrọ	Nan
الغير	awọn ẹlomiran	Nan
الـ	awọn	Nan
الفئات	awọn ẹka	Nan
الفئة	ẹka	Nan
الفائدة	anfani	Nan
الفائز	olubori	Nan
الفاتح	al fateh	Nan
الفاتحة	al-fatiha	Nan
الفاتيكان	ilu vatican	Nan
الفارابي	al-farabi	Nan
الفارسي	páṣíà	Nan
الفارسية	páṣíà	Nan
الفاشية	fakisi	Nan
الغموض	ohun ijinlẹ	Nan
الغدد	awọn keeki	Nan
الغليون	pipe	Nan
الغلاف	bo	Nan
الغذائي	ounje	Nan
الغذائية	ounje	Nan
الغرب	oorun	Nan
الغربي	iwọ oorun	Nan
الغربية	oorun	Nan
الغربيين	awọn ara iwọ-oorun	Nan
الغرض	idi	Nan
الغرفة	yara naa	Nan
الغزاة	awọn akogun	Nan
الغزالي	al-ghazali	Nan
الغزل	alayipo	Nan
الغزو	awọn ayabogun	Nan
الغزوات	awọn abuku	Nan
الغشاء	awo ilu	Nan
الغطاء	ideri	Nan
الغلوكوز	glukosi	Nan
العمق	ijinle	Nan
العمري	al-omari	Nan
العمرة	umrah	Nan
العصبي	ara	Nan
العصبية	ara	Nan
العصر	ọjọ ori	Nan
العصور	awọn ọjọ-ori	Nan
العضلات	awọn iṣan	Nan
العضو	omo egbe	Nan
العضوية	ọmọ ẹgbẹ	Nan
العطل	awọn isinmi	Nan
العظام	egungun	Nan
العظم	egungun	Nan
العظمى	nla	Nan
العظمي	egungun	Nan
العظيم	nla	Nan
العظيمة	nla	Nan
العفو	awọn idariji	Nan
العصابات	awọn ẹgbẹ	Nan
العقائد	awọn ẹkọ	Nan
العشرينات	twenties	Nan
العشرة	awọn mẹwa	Nan
العرقي	eya	None
العرقية	eya	None
العروض	awọn ipese	Nan
العريضة	ẹbẹ	Nan
العريقة	atijọ	Nan
العزيز	ololufe	Nan
العسكر	ologun	Nan
العسكري	ologun	Nan
العسكرية	ologun	Nan
العسكريين	ologun	Nan
العسل	oyin	Nan
العش	itẹ-ẹiyẹ	Nan
العشاء	ale	Nan
العشائر	awọn idile	Nan
العشر	awọn mẹwa	Nan
العشرين	meji	Nan
العقائدية	dogmatic	Nan
العقاد	akkad	Nan
العقبة	ohun idiwọ	Nan
العلمي	ijinle sayensi	Nan
العلمية	ijinle sayensi	Nan
العلوم	awọn sáyẹnsì	Nan
العلوي	oke	Nan
العلوية	afori	Nan
العلويين	alawites	Nan
العلي	giga julọ	Nan
العمارة	faaji	Nan
العمال	awọn alagbaṣe	Nan
العمالة	oojọ	Nan
العمالية	laala	Nan
العمر	ọjọ ori	Nan
العمران	ilu ilu	Nan
العمراني	ilu	Nan
العمرانية	ilu ilu	Nan
العلمانية	secularism	Nan
العلماء	sayensi	Nan
العلم	imọ	Nan
العلل	awọn agekuru	Nan
العقد	àdéhùn	Nan
العقل	okan	Nan
العقلي	ọpọlọ	Nan
العقلية	ọpọlọ	Nan
العقوبات	awọn ifiyaje	Nan
العقود	awọn adehun	Nan
العقول	awọn ọpọlọ	Nan
الفاصل	onilapa	Nan
العقيد	kononeli	Nan
العكس	idakeji	Nan
العلاء	awọn giga	Nan
العلاج	itọju	Nan
العلاجية	iwosan	None
العلاقات	ẹbí	Nan
العلاقة	ibasepo	Nan
العلامة	iyasọtọ	Nan
العقيدة	igbagbo	Nan
العرق	lagun	Nan
الفاطمي	fatimid	Nan
الفاطميين	awọn fatimids	Nan
الفهم	oye	Nan
الفوائد	awọn anfani	Nan
الفور	aami naa	Nan
الفوز	win	Nan
الفوضى	idarudapọ	Nan
الفولاذ	irin	Nan
الفوهات	nozzles	Nan
الفيدرالي	federal	Nan
الفيدرالية	federalism	Nan
الفيديو	fidio	Nan
الفيروس	kokoro arun fairọọsi naa	Nan
الفيروسات	awọn ọlọjẹ	Nan
الفيروسي	gbogun	Nan
الفيروسية	gbogun	Nan
الفيزياء	fisiksi	Nan
الفهد	cheetah	Nan
الفيزيائية	ti ara	Nan
الفنية	iṣẹ ọna	Nan
الفنون	iṣẹ ọnà	Nan
الفلسفي	oloye	None
الفلسفية	oloye	None
الفلك	aworawo	Nan
الفلكي	aworawo	Nan
الفلكية	aworawo	Nan
الفلكيون	aworawo	Nan
الفلم	fiimu naa	Nan
الفم	ẹnu	Nan
الفن	awọn aworan	Nan
الفنادق	ile itura	Nan
الفنان	olorin	Nan
الفنانة	olorin	Nan
الفنانين	awọn oṣere	Nan
الفنلندي	finn	Nan
الفنلندية	ede finisi	Nan
الفني	iṣẹ ọnà	Nan
الفلسفة	imọye	Nan
الفيس	elvis	Nan
الفيضانات	agbara	None
القاعدة	al-qaeda	Nan
القانون	ofin	None
القانوني	ofin	None
القانونية	ofin	None
القبائل	ẹya	Nan
القبة	ogbo naa	Nan
القبر	ibojì	None
القبض	ti mu	Nan
القبطي	onigbagbọ	Nan
القبطية	onigbagbọ	Nan
القبلة	ifẹnukonu	Nan
القبلي	ẹya	Nan
القبول	awọn gbigba	Nan
القبيلة	ẹya	Nan
القتال	ija	Nan
القاضي	adajọ	Nan
الفيضان	ikun omi	Nan
القاسم	iyeida	Nan
القارة	afirika	Nan
الفيفا	fifa	Nan
الفيل	erin	Nan
الفيلة	awọn erin	Nan
الفيلسوف	onitumọ	Nan
الفيلم	fiimu naa	Nan
الفينيقية	onigbagbọ	Nan
القائد	aṣáájú	Nan
القائلة	wipe	Nan
القائم	da	None
القائمة	atokọ naa	Nan
القادم	itele	Nan
القادمة	wiwa	Nan
القادمين	wiwa	Nan
القارئ	oluka	Nan
القارات	awọn orilẹ-ede	Nan
القارية	apọju	Nan
الفلسطينيين	palestinians	Nan
الفلسطينيون	awọn palestinians	Nan
الفلسطينية	palestini	Nan
الفرد	olukọọkan	Nan
الفردي	awọn ẹyọkan	Nan
الفردية	olukọọkan	Nan
الفرس	àwọn ará páṣíà	Nan
الفرسان	awọn ẹwa	Nan
الفرصة	aye	Nan
الفرع	ẹka	Nan
الفرعونية	farao	Nan
الفرعية	iha	Nan
الفرق	iyatọ naa	Nan
الفرقة	ẹgbẹ	Nan
الفرن	adiro	Nan
الفرنجة	awọn ara ilu faranse	Nan
الفرنسي	ara faranse naa	Nan
الفرنسية	faranse	None
الفرج	vulva	Nan
الفرنسيون	ara faranse naa	Nan
الفراغ	ṣofo	Nan
الفراش	ohun elo ibusun	Nan
الفتاة	omobinrin	Nan
الفتح	iṣẹgun	Nan
الفترات	awọn akoko	Nan
الفترة	akoko	Nan
الفتنة	discord	Nan
الفتوح	al-futouh	Nan
الفتوحات	awọn idije	Nan
الفجر	ọsan	Nan
الفجوة	giga	Nan
الفحص	ayẹwo	Nan
الفحم	alóró	Nan
الفخار	ikoko	Nan
الفدرالي	federal	Nan
الفدرالية	federalism	Nan
الفرات	odò	Nan
الفراعنة	awọn farao	Nan
الفرنسيين	ara faranse naa	Nan
الفروع	awọn ẹka	Nan
الفريدة	alailẹgbẹ	Nan
الفقري	spine	Nan
الفقه	agbara	None
الفقهاء	jurists	Nan
الفقهية	agbara	None
الفقيرة	talaka	None
الفقيه	faqih	Nan
الفكر	ro	None
الفكرة	ero naa	Nan
الفكري	ologbon	Nan
الفكرية	ologbon	Nan
الفلاحين	ewa	Nan
الفلاسفة	awọn ọlọgbọn	Nan
الفلبين	philippines	Nan
الفلبينية	filipino	Nan
الفلسطيني	palestini	Nan
الفقراء	talaka	None
الفقر	osi	Nan
الفعلية	awọn lodo	Nan
الفعلي	gangan	Nan
الفريق	ẹgbẹ naa	Nan
الفريقان	awọn ẹgbẹ meji	Nan
الفريقين	awọn ẹgbẹ meji	Nan
الفساد	iwa ibajẹ	Nan
الفصائل	awọn ẹgbẹ naa	Nan
الفصح	ajinde	Nan
الفصحى	ayebaye	Nan
الفاطمية	fatimidism	Nan
الفصل	yara ikawe	Nan
الفضائي	ajeeji	Nan
الفضائية	satẹlaiti	Nan
الفضة	fadaka	Nan
الفضل	ni ojurere	Nan
الفطر	olu	Nan
الفعالة	munadoko	Nan
الفعل	ìse	Nan
الفضاء	awọn aye	Nan
العرض	ifihan	Nan
العرش	itẹ	Nan
العربية	dè lárúbáwá	Nan
الصحابة	awọn ẹlẹgbẹ	Nan
الصحابي	ẹlẹgbẹ	Nan
الصحاري	awọn aginjù	Nan
الصحافة	awọn tẹ	Nan
الصحة	ilera	Nan
الصحراء	aginjù	Nan
الصحراوي	aginju	Nan
الصحراوية	aginju	Nan
الصحف	iwe iroyin	Nan
الصحفي	akoroyin	Nan
الصحفيين	akoroyin	Nan
الصحية	ilera	Nan
الصحيح	ti o tọ	Nan
الصخرة	àpáta	Nan
الصخري	rocky	Nan
الصباح	owurọ	Nan
الصخرية	rocky	Nan
الصالحة	olododo	Nan
الصادق	ebi	None
الشيخة	sheikha	Nan
الشيطان	ibi	Nan
الشيعة	shia	Nan
الشيعي	shiite	Nan
الشيعية	shiite	Nan
الشيوخ	awọn àgba	Nan
الشيوعي	communist	Nan
الشيوعية	ibaraẹnisọrọ	Nan
الشيوعيين	komunisonu	Nan
الصابئة	sabéíà	Nan
الصابئي	sabean	Nan
الصابون	ọṣẹ	Nan
الصادر	ti ita	Nan
الصادرات	awọn okeere	Nan
الصادرة	ti oniṣowo	Nan
الصالح	awọn ti o dara	Nan
الشيخ	awọn sheikh	Nan
الصخور	awọn apata	Nan
الصدد	asopọ	Nan
الصفراء	yellow	Nan
الصفويين	awọn safavids	Nan
الصلاة	adura	Nan
الصلال	awọn hides	Nan
الصلب	irin	Nan
الصلبة	ri to	Nan
الصلة	ọna asopọ	Nan
الصلح	ilaja	Nan
الصلوات	awọn adura	Nan
الصليب	agbelebu	Nan
الصليبي	ológun	Nan
الصليبية	ológun	Nan
الصليبيون	awọn ologun	Nan
الصليبيين	awọn ọgagun	Nan
الصناعات	awọn ile-iṣẹ	Nan
الصفر	odo	Nan
الصداقة	ọrẹ	Nan
الصفحة	iwe	Nan
الصفا	al-safa	Nan
الصدر	àyà	Nan
الصدري	thoracic	Nan
الصديق	ọrẹ	Nan
الصراع	rogbodiyan	None
الصراعات	rogbodiyan	None
الصرب	awọn iṣẹ	Nan
الصرف	paṣipaarọ	Nan
الصعب	nira	Nan
الصعيد	oke egipiti	Nan
الصغار	awọn ọmọ kekere	Nan
الصغر	filigree	Nan
الصغرى	micro	Nan
الصغير	diẹ	Nan
الصغيرة	kekere	None
الصف	kilasi	Nan
الصفة	idawọle	Nan
الشيء	nkan naa	Nan
الشورى	shura	Nan
الشواطئ	awọn eti okun	Nan
الشبه	likeness	Nan
الشتاء	igba otutu	Nan
الشجاعة	ìgboyà	Nan
الشجرة	igi	Nan
الشحنات	awọn gbigbe	Nan
الشحنة	sowo	Nan
الشخص	eniyan naa	Nan
الشخصي	profaili	Nan
الشخصيات	awọn ohun kikọ	Nan
الشخصية	ti ara ẹni	Nan
الشديد	lewu	Nan
الشديدة	lewu	Nan
الشذوذ	anomalies	Nan
الشر	buburu	Nan
الشرائية	rira	Nan
الشبكة	nẹtiwọọki	Nan
الشرط	majemu	Nan
الشبكات	awọn nẹtiwọki	Nan
الشاي	tii	Nan
الشأن	ọrọ naa	Nan
الشؤون	oro	Nan
الشائع	wọpọ	Nan
الشائعة	wọpọ	Nan
الشابي	ọdọmọkunrin naa	Nan
الشارع	opopona	Nan
الشاشة	iboju	Nan
الشاطئ	eti okun	Nan
الشاعر	akewi	Nan
الشافعي	al-shafii	Nan
الشام	ṣámánì	Nan
الشامل	ibi	Nan
الشامي	ṣámánì	Nan
الشامية	levantinerúsóríà	Nan
الشاه	awọn shah	Nan
الشباب	omode	Nan
الشرطة	awon olopa	Nan
الشرعي	abẹnu	Nan
الشرعية	ofin	None
الشك	iyemeji	Nan
الشكل	irisi	None
الشكوك	awọn iyemeji	Nan
الشمال	ariwa	Nan
الشمالي	ariwa	Nan
الشمالية	ariwa	Nan
الشمس	oorun	Nan
الشمسية	oorun	Nan
الشهادة	ijẹrisi	Nan
الشهداء	awọn ajeriku	Nan
الشهر	osù	Nan
الشهيد	ajé	Nan
الشهير	olokiki	Nan
الشهيرة	olokiki	Nan
الشوارع	awọn ọna	Nan
الشفاء	iwosan	None
الشعور	rilara	Nan
الشعرية	noodles	Nan
الشعراوي	shaarawy	Nan
الشرف	kj iyi	Nan
الشرق	ila-oorun	Nan
الشرقي	ila-oorun	Nan
الشرقية	ila-oorun	Nan
الشرك	polytheism	Nan
الشركات	awọn ile-iṣẹ	Nan
الشركة	ile-iṣẹ naa	Nan
الصناعة	ile ise	Nan
الشروط	awọn ipo	Nan
الشطرنج	chess	Nan
الشعار	ami naa	Nan
الشعب	awon eniyan	Nan
الشعبي	awọn eniyan	Nan
الشعبية	gbajumo	Nan
الشعر	irun	Nan
الشعراء	awọn ewi	Nan
الشريعة	ofin islamu	Nan
الصناعي	ise	Nan
الصناعية	ise	Nan
الصنع	ṣe	Nan
العادل	ẹwà	Nan
العادي	arinrin	Nan
العادية	deede	Nan
العاشر	ẹkẹwa	Nan
العاشرة	kẹwa	Nan
العاص	awọn aas	Nan
العاصمة	olu	Nan
العالم	ileaye	Nan
العالمي	agbaye	None
العالمية	agbaye	None
العالمين	awọn agbaye	Nan
العالي	ga julọ	Nan
العالية	ga	Nan
العام	odun	Nan
العامة	ita	Nan
العادة	ewu	Nan
العامل	oṣiṣẹ naa	Nan
العادات	awọn iṣe	Nan
العائلة	ẹbi	Nan
الطيب	awọn ti o dara	Nan
الطيران	afẹfẹ	Nan
الطيف	oju iwoye	Nan
الطين	clay	Nan
الطيور	awọn ẹiyẹ	Nan
الظاهر	nkqwe	Nan
الظاهرة	phenomenon	Nan
الظاهري	foju	Nan
الظروف	awọn aye	Nan
الظلام	okunkun	None
الظلم	aisedede	Nan
الظهر	osan	Nan
الظهور	ifihan	Nan
الظواهر	phenomena	Nan
العائلات	awọn idile	Nan
العابدين	awọn oluriṣa	Nan
العاملة	ṣiṣẹ	Nan
العاملين	oṣiṣẹ	Nan
العامية	vernacular	Nan
العدالة	idajo	None
العدد	nọnba	Nan
العدل	idajo	None
العدو	ọtá	Nan
العدوان	asọgun	Nan
العدوى	ikolu	Nan
العديد	ọpọlọpọ	Nan
العديدة	pupọ	Nan
العذبة	alabapade	Nan
العذراء	wundia	Nan
العراق	iraaki	Nan
العراقية	ara ilu iraaki	Nan
العراقيين	iraaki	Nan
العرب	awọn larubawa	Nan
العربي	arabi	Nan
العجز	agbara	None
العثور	wa	Nan
العثمانيين	awọn ottomans	Nan
العثمانيون	awọn ottomans	Nan
العامّة	ita	Nan
العباد	awọn iranṣẹ	Nan
العبادات	ijosin	None
العبادة	ijosin	None
العبارة	sọrọ	Nan
العباس	abbas	Nan
العباسي	abbasid	Nan
الطويلة	gun	None
العباسية	abbasid	Nan
العباسيين	awọn abbasids	Nan
العبد	iranṣẹ na	Nan
العبرية	heberu	Nan
العبودية	oko eru	Nan
العبّاسية	abbassie	Nan
العثماني	ilu ottoman	Nan
العثمانية	ilu ottoman	Nan
العباسيون	awọn abbasids	Nan
القتالية	ija	Nan
الطويل	awọn gun	Nan
الطور	alakoso	Nan
الصينيين	awọn kannada	Nan
الضارة	ipalara	Nan
الضباط	awọn olori	Nan
الضحايا	awọn olufaragba	Nan
الضحية	olugbala	Nan
الضخم	awọn tobi	Nan
الضخمة	mega	Nan
الضرائب	awọn owo-ori	Nan
الضربة	awọn lu	Nan
الضروري	awọn pataki	Nan
الضعف	ailagbara	Nan
الضغط	titẹ	Nan
الضغوط	titẹ	Nan
الضفة	banki naa	Nan
الضوء	ina	Nan
الصينيون	ṣaina	Nan
الضوئي	photosynthesis	Nan
الصينية	ṣaina	Nan
الصين	ṣaina	Nan
الصهيوني	sioni	Nan
الصهيونية	sioni	Nan
الصواريخ	awọn irin-iṣẹ	Nan
الصوت	ìró	None
الصوتية	sonic	Nan
الصور	awọn aworan	Nan
الصورة	aworan	Nan
الصوفية	sufism	Nan
الصوم	ingwẹ	Nan
الصومال	somalia	Nan
الصومالي	arakunrin	Nan
الصومالية	arakunrin	Nan
الصيد	ọdẹ	Nan
الصيف	igba ooru	Nan
الصيفية	igba ooru	Nan
الصيني	ṣaina	Nan
الضوئية	ina opopona	Nan
الطائرات	awọn ọkọ ofurufu	Nan
الطائرة	ọrun	Nan
الطراز	ara	Nan
الطرف	ẹgbẹ	Nan
الطرفين	awọn ẹgbẹ meji	Nan
الطرق	awọn opopona	Nan
الطريق	opopona	Nan
الطريقة	ọna	Nan
الطعام	ounje	Nan
الطفل	ọmọ	None
الطفولة	ọmọ	None
الطقس	oju ojo	Nan
الطقوس	rituals	Nan
الطلاب	awọn ọmọ ile-iwe	Nan
الطلب	eletan	Nan
الطلبة	awọn ọmọ ile-iwe	Nan
الطوائف	awọn apakan	Nan
الطرائد	ere	Nan
الطبيعية	adawa	Nan
الطبيعي	adawa	Nan
الطبيعة	iseda	Nan
الطائف	taif	Nan
الطائفة	apakan	Nan
الطابع	ohun kikọ	Nan
الطابق	ipakà	Nan
الطاعون	ìyọnu	Nan
الطاقة	agbara	None
الطالب	onifẹ	Nan
الطول	gigun	Nan
الطب	òògùn	Nan
الطباعة	titẹ sita	Nan
الطبري	al-tabari	Nan
الطبعة	ẹda	Nan
الطبقة	kilasi	Nan
الطبي	oogun	Nan
الطبيب	dokita	Nan
الطبية	oogun	Nan
الطباشيري	cretaceous	Nan
القتل	pa	Nan
القتلى	awọn okú	Nan
القدامى	igba-agba	Nan
المدنيين	awọn ara ilu	Nan
المدونات	nbulọọgi	Nan
المدونة	buloogi	Nan
المدى	igba	Nan
المديح	iyin	Nan
المدير	oluṣakoso	Nan
المدينة	ilu	Nan
المذاهب	awọn ẹkọ	Nan
المذكور	darukọ	Nan
المذكورة	darukọ	Nan
المذنبات	awọn comets	Nan
المذهب	ipinya	Nan
المرء	ọkan ni tirẹ	Nan
المرأة	obinrin	Nan
المرئي	hihan	Nan
المدنية	ara ilu	Nan
المرابطين	awọn almoravids	Nan
المدني	ara ilu	Nan
المدفعية	ohun ija	Nan
المخصص	ti pin	Nan
المخصصة	sọtọ	Nan
المخطط	eto na	Nan
المخطوطات	awọn iwe afọwọkọ	Nan
المخلص	olugbala	Nan
المخلوقات	awọn ẹda	Nan
المد	ifaagun	Nan
المدارس	awọn ile-iwe	Nan
المداري	orbital	Nan
المدارية	tropical	Nan
المدافع	awọn cannons	Nan
المدة	iye akoko	Nan
المدرب	olukọ	Nan
المدرسة	ile-iwe naa	Nan
المدرعة	ọkọ ihamọra	Nan
المدن	awọn ilu	Nan
المخرج	oludari	Nan
المراجع	awọn itọkasi	Nan
المراد	lati wa ni	Nan
المركزي	aarin	Nan
المركزية	aarin	Nan
المرمى	ibi ti o nlo	Nan
المرور	ijabọ	Nan
المريخ	maasi	Nan
المريض	alaisan	Nan
المزارعون	awọn agbe	Nan
المزارعين	agbe	Nan
المزروعة	ngbin	Nan
المزيد	diẹ sii	Nan
المسألة	ọrọ naa	Nan
المسؤول	alabojuto	Nan
المسؤولة	lodidi	Nan
المسؤولية	ojuse	None
المسؤولين	lodidi	Nan
المركز	aarin	Nan
المراحل	awọn ipele	Nan
المركبة	ọkọ	Nan
المركب	ọkọ oju omi	Nan
المرافق	ajọ	Nan
المراقبة	ṣọ	Nan
المراكز	awọn ile-iṣẹ	Nan
المرة	aago	Nan
المرتبة	ipele	None
المرتبط	ti so pọ	Nan
المرتبطة	ni ibasepo pelu	Nan
المرتفع	awọn giga	Nan
المرتفعات	awọn ilu giga	Nan
المرتفعة	giga	Nan
المرجانية	ṣọpọ	Nan
المرحلة	ipele	None
المرشد	oludari	Nan
المرض	aarun	Nan
المرضى	awọn alaisan	Nan
المركبات	awọn ọkọ	Nan
المخدرات	oogun naa	Nan
المختلفة	yatọ	Nan
المختصة	idije	Nan
المثلثات	awọn onigun mẹta	Nan
المثلية	homeopathy	Nan
المثليين	onibaje	Nan
المجاعة	ebi	None
المجال	pápá	Nan
المجالات	awọn ibugbe	Nan
المجالس	awọn igbimọ	Nan
المجاهدين	mujahidi	Nan
المجاورة	aládùúgbò	Nan
المجتمع	awujọ naa	Nan
المجتمعات	awọn ẹgbẹ	Nan
المجر	họnari	Nan
المجرات	awọn akọọlẹ	Nan
المجرة	galaxy	Nan
المجردة	ihoho	Nan
المثلث	onigun mẹta	Nan
المجري	ara ilu hungary	Nan
المثل	verwe	Nan
المتوكل	al-mutawakkil	Nan
المتعددة	olona-pupọ	Nan
المتعلقة	jẹmọ	Nan
المتقدم	onitẹsiwaju	Nan
المتقدمة	onitẹsiwaju	Nan
المتكاملة	iṣọpọ	Nan
المتمثلة	o ni aṣoju	Nan
المتميزة	dayato	Nan
المتنبي	mutanabbi	Nan
المتنوعة	oriṣiriṣi	Nan
المتواجدة	wa	Nan
المتوسط	iwọn	Nan
المتوسطة	alabọde	Nan
المتوفرة	wa	Nan
المتوفى	kú	Nan
المتوقع	o ti ṣe yẹ	Nan
المثال	apẹẹrẹ	Nan
المجرية	ara ilu hungary	Nan
المجلات	awọn iwe irohin	Nan
المجلة	iwe irohin naa	Nan
المحطات	awọn ile	Nan
المحطة	ibudo naa	Nan
المحكمة	ẹjọ	Nan
المحلة	mahalla	Nan
المحلي	ti agbegbe	Nan
المحلية	agbegbe	Nan
المحليين	awọn agbegbe	Nan
المحور	ibudo	Nan
المحيط	okun	Nan
المحيطات	cekun	Nan
المحيطة	aye kaakiri	Nan
المخ	ọpọlọ	Nan
المخاطر	ewu	Nan
المخاوف	ibẹru	Nan
المختار	awọn ti a yàn	Nan
المحسن	ni ilọsiwaju	Nan
المحركات	moto	Nan
المحرك	ẹrọ	Nan
المحرقة	bibajẹ	Nan
المجلس	igbimọ naa	Nan
المجمع	eka naa	Nan
المجموع	lapapọ	Nan
المجموعات	awọn ẹgbẹ	Nan
المجموعة	ẹgbẹ naa	Nan
المجيد	ologo	Nan
المحاسبة	ṣiṣe iṣiro	Nan
المساء	irọlẹ	Nan
المحاصيل	awọn irugbin	Nan
المحافظة	isakoso	Nan
المحاولات	igbiyanju	Nan
المحاولة	lati gbiyanju	Nan
المحبة	ni ife	Nan
المحتلة	ti n ṣiṣẹ	Nan
المحتمل	boya	Nan
المحدودة	ltd.	Nan
المحافظات	awọn agbegbe	Nan
المسائل	awọn nkan	Nan
المسابقات	awọn idije	Nan
المسابقة	idije	Nan
المطلب	ibeere	Nan
المطلة	rim	Nan
المطلق	ifa	Nan
المطلقة	kọrasilẹ	Nan
المطلوب	beere	Nan
المطلوبة	beere	Nan
المطيرة	forejò ojo	Nan
المظاهرات	awọn ifihan	Nan
المظلمة	dudu	Nan
المعابد	awọn ile-isin oriṣa	Nan
المعادن	awọn ohun alumọni	Nan
المعادية	ogungun	Nan
المعارض	awọn ifihan	Nan
المعارضة	alatako naa	Nan
المعارضين	awọn alatako	Nan
المطر	òjò	Nan
المعارف	imọ	Nan
المطبخ	ibi idana	Nan
المطاعم	ile-ounjẹ	Nan
المصانع	awọn ile-iṣẹ	Nan
المصحف	awọn koran	Nan
المصدر	orisun	None
المصري	ara egipti naa	Nan
المصرية	ara egipti	Nan
المصريون	awọn ara egipti	Nan
المصريين	awọn ara egipti	Nan
المصطلح	igba	Nan
المصطلحات	ẹkọ ẹkọ	Nan
المضاد	counterattack	Nan
المضادة	awọn aroye	Nan
المضيف	agbanisodo	Nan
المضيفة	agbalejo	Nan
المطار	papa ọkọ ofurufu	Nan
المطارات	papa ọkọ ofurufu	Nan
المطاف	ipari	Nan
المعارك	awọn ija	Nan
المعاصر	contemporary	Nan
المعاصرة	contemporary	Nan
المعرفة	imọ	Nan
المعرفي	olóye	Nan
المعرفية	olóye	Nan
المعركة	ogun naa	Nan
المعروف	mo	Nan
المعروفة	mo	Nan
المعري	maari	Nan
المعز	awọn ewúrẹ	Nan
المعسكر	àgọ́	None
المعقدة	apapọ	Nan
المعلم	oluko	Nan
المعلمين	awọn olukọni	Nan
المعلومات	alaye naa	Nan
المعماري	ayaworan ile	Nan
المعمارية	ayaworan	Nan
المعرض	ifihan naa	Nan
المعدية	aarun	Nan
المعدنية	nkan ti alumọni	Nan
المعدلة	atunse	None
المعاصرين	awọn iwe aṣaju	Nan
المعالم	awọn maili	Nan
المعاني	itumọ	Nan
المعاهد	awọn ile-ẹkọ	Nan
المعاهدات	awọn adehun	Nan
المعاهدة	adehun	Nan
المعايير	awọn ipilẹ	Nan
المصالح	nifesi	Nan
المعبد	tẹmpili	Nan
المعتزلة	mu&#39;tazilah	Nan
المعتقدات	igbagbo	Nan
المعتمد	ti a fọwọsi	Nan
المعتمدة	ti a fọwọsi	Nan
المعدات	ohun elo	Nan
المعدة	ikun	Nan
المعدل	ni apapọ	Nan
المعتدل	dede	Nan
المتعة	ayo	Nan
المصارف	awọn ile-ifowopamọ	Nan
المصاحف	awọn koran	Nan
المستعمرة	ileto	Nan
المستعملة	ti lo	Nan
المستقبل	ojo iwaju	Nan
المستقبلية	ojo iwaju	Nan
المستقلة	ominira	Nan
المستمر	tẹsiwaju	Nan
المستمرة	adani	Nan
المستوطنات	awọn ibugbe	Nan
المستوى	ipele	None
المستويات	awọn ipele	Nan
المسجد	mosalasi naa	Nan
المسرح	ile itage naa	Nan
المسرحي	tiata	Nan
المسرحيات	mu awọn	Nan
المسرحية	awọn play	Nan
المستعمرات	awọn ileto	Nan
المسلح	ibon naa	Nan
المستشفيات	awọn ile iwosan	Nan
المستشار	onimọnran	Nan
المساجد	awọn mọṣalaṣi	Nan
المساحة	awọn aye	Nan
المساعدات	iranlọwọ	Nan
المساعدة	egba mi o	Nan
المسافات	awọn ọna pataki	Nan
المسافة	jinna	Nan
المساكن	ile	Nan
المساهمة	pinpin	Nan
المساواة	dọgbadọgba	Nan
المسبار	thewe	Nan
المسببة	nfa	Nan
المستخدم	olumulo	Nan
المستخدمة	ti lo	Nan
المستخدمين	awọn olumulo	Nan
المستدامة	alagbero	Nan
المستشفى	ile-iwosan	Nan
المسلحة	ologun	Nan
المسلسل	awọn jara	Nan
المسلسلات	jara	Nan
المشركين	awọn ọlọlọtọ	Nan
المشروبات	awọn ounjẹ	Nan
المشروع	ise agbese na	Nan
المشروعات	awọn iṣẹ akanṣe	Nan
المشعة	ohun ipanilara	Nan
المشكلات	awọn iṣoro naa	Nan
المشكلة	iṣoro naa	Nan
المشهد	ibi isere naa	Nan
المشهور	olokiki	Nan
المشهورة	olokiki	Nan
المشهورين	olokiki	Nan
المشير	field marshal	Nan
المصاب	awọn farapa	Nan
المصابة	ti kó àrùn	Nan
المصابين	ti farapa	Nan
المشرفة	alabojuto	Nan
المشتري	olura	Nan
المشترى	olura	Nan
المشتركة	pipin	Nan
المسلمة	fa jade	Nan
المسلمون	musulumi	Nan
المسلمين	musulumi	Nan
المسمى	ti o lorukọ	Nan
المسيحي	kristiẹni	Nan
المسيحية	kristiẹniti	Nan
المسيحيون	awọn kristiani	Nan
المصادر	awọn orisun	Nan
المسيحيين	awọn kristiani	Nan
المشاركة	kopa	Nan
المشاركين	olukopa	Nan
المشاريع	awọn iṣẹ akanṣe	Nan
المشاعر	awọn ikunsinu	Nan
المشاكل	awọn iṣoro	Nan
المشاهد	oluwo naa	Nan
المشترك	olumulo	Nan
المشاة	alarinkiri	Nan
المعنية	ti fiyesi	Nan
المتطورة	ige eti	Nan
المتزايد	dagba	Nan
القومية	t’orilẹ-ede	Nan
القوى	awọn agbara	Nan
القوي	awọn ti o lagbara	Nan
القوية	duro	Nan
القيادة	aṣáájú	Nan
القياس	onkowe	Nan
القياسي	boṣewa	Nan
القياسية	boṣewa	Nan
القيام	awọn iṣẹ	Nan
القيامة	ajinde	Nan
القيروان	kairouan	Nan
القيس	wiwọn	Nan
القيصر	the cesar	Nan
القيم	iye	Nan
القيمة	iye	Nan
القومي	orilẹ-ede	Nan
القيود	awọn ihamọ	Nan
القوم	awọn eniyan	Nan
القوقاز	caucasus	Nan
القمح	alikama	Nan
القمر	osupa	Nan
القمرية	lunar	Nan
القمني	apical	Nan
القنابل	awọn ado-iku naa	Nan
القناة	ikanni	Nan
القنوات	awọn ikanni	Nan
القهري	dandan	None
القوائم	awọn akojọ	Nan
القوات	awọn ologun	Nan
القواعد	awọn ofin	Nan
القوافل	awọn idagba	Nan
القوانين	awọn ofin	Nan
القوس	awọn ọrun	Nan
القوط	awọn goths	Nan
القول	lati sọ	Nan
القمة	oke	Nan
الكأس	ago	Nan
الكائنات	awọn ọti	Nan
الكثافة	iwuwo	Nan
الكثير	awọn ọpọlọpọ	Nan
الكثيرة	ọpọlọpọ	Nan
الكثيرون	ọpọlọpọ	Nan
الكثيرين	ọpọlọpọ	Nan
الكثيفة	iku	None
الكحول	ọtí	Nan
الكحولية	ọti-lile	Nan
الكذب	ete	Nan
الكرامة	iyì	Nan
الكربون	erogba	Nan
الكردية	kuridi	Nan
الكرسي	alaga	Nan
الكرك	karaki	Nan
الكريم	oninuwo	Nan
الكتلة	bọbu	Nan
الكائن	nkan naa	Nan
الكتل	awọn bulọọki	Nan
الكتابة	kikọ	Nan
الكاتب	onkọwe	Nan
الكاثوليكية	katoliki	Nan
الكاريبي	karibeanu	Nan
الكافي	pipe	Nan
الكافية	pipe	Nan
الكامل	kun	Nan
الكاملة	kun	Nan
الكبار	awon agbalagba	Nan
الكبد	ẹdọ	Nan
الكبرى	nla	Nan
الكبريت	efin	Nan
الكبير	nla	Nan
الكبيرة	eyan nla	Nan
الكتاب	iwe	Nan
الكتابات	awọn kikọ	Nan
الكتب	awọn iwe	Nan
القماش	ẹ̀wù	Nan
القليلة	awọn diẹ	Nan
القليل	diẹ	Nan
القران	al-kuran	Nan
القرشي	qurashi	Nan
القرص	disiki naa	Nan
القرضاوي	al-qaradawi	Nan
القرم	ilu crimea	Nan
القرن	orundun	Nan
القرنين	iwo meji	Nan
القرون	pods	Nan
القرويين	awọn ara abule naa	Nan
القرى	awọn abule	Nan
القريب	nitosi	None
القريبة	nitosi	None
القرية	abule	Nan
القزمة	arara	Nan
القسطنطينية	constantinople	Nan
القرارات	awọn ipinnu	Nan
القسم	abala	None
القرار	ipinnu	Nan
القراء	awọn olukawe	Nan
القدر	kadara	None
القدرات	agbara	None
القدرة	agbara	None
القدس	jerusalẹmu	Nan
القدسي	al-qudsi	Nan
القدم	ẹsẹ	None
القدماء	awọn atijọ	Nan
القديس	awọn saint	Nan
القديسين	awon eniyan mimo	Nan
القديم	atijọ	Nan
القذافي	gadi	Nan
القذف	gbigbe	Nan
القرآن	al-kuran	Nan
القرآني	al-qur&#39;an	Nan
القرآنية	al-qur&#39;an	Nan
القراءة	kika	Nan
القشرة	dandruff	Nan
القصبة	awọn kasbah	Nan
القصة	itan naa	Nan
القطبية	pola	Nan
القطبين	awọn ọpá	Nan
القطر	iwọn opin	Nan
القطرية	orilẹ-ede	Nan
القطط	awọn ologbo	Nan
القطع	ige	Nan
القطن	owu	Nan
القعدة	buru	Nan
القفز	fò	Nan
القلاع	awọn kasulu	Nan
القلب	okan	Nan
القلبية	tọkàntọkàn	Nan
القلعة	ile odi	Nan
القلق	ṣàníyàn	Nan
القلوب	awọn ọkàn	Nan
القطبي	pola	Nan
القطب	òpó	Nan
القطاعات	awọn apakan	Nan
القطاع	apa	Nan
القصر	ààfin	Nan
القصص	awọn itan	Nan
القصف	buburu	Nan
القصور	awọn aito	Nan
القصوى	awọn iwọn	Nan
القصيدة	ewi	Nan
القصيرة	kukuru	Nan
الكريمة	olore-ọfẹ	Nan
القضاء	imukuro	Nan
القضائية	idajọ	Nan
القضاة	awọn onidajọ	Nan
القضايا	awọn ọran	Nan
القضيب	kòfẹ	Nan
القضية	ọran	Nan
القطار	ọkọ oju-irin	Nan
القطارات	awọn ọkọ oju-irin	Nan
القضائي	idajọ	Nan
الكسوف	apapọ oorun ati oṣupa	Nan
الكعبة	kaaba	Nan
الكفاءة	agbara	None
المؤرخون	itan-akọọlẹ	Nan
المؤرخين	itan-akọọlẹ	Nan
المؤسس	oludasile	Nan
المؤسسات	awọn ile-iṣẹ	Nan
المؤسسة	idawọlẹ	Nan
المؤسسين	awọn oludasilẹ	Nan
المؤكد	daju	Nan
المؤلف	onkọwe	Nan
المؤلفات	awọn iwe	Nan
المؤمن	onigbagbọ	Nan
المؤمنين	oloto	Nan
المؤيدين	olufowosi	Nan
المئات	ọgọọgọrun	Nan
الماء	omi	None
المائة	ile-iṣẹ	Nan
المؤرخ	onitumọ	Nan
المائدة	tabili	None
المؤثرة	gbajugbaja	Nan
المؤتمر	apejọ	Nan
اللواء	oloye gbogbogbo	Nan
اللوحات	awọn kikun	Nan
اللوحة	igbimọ	Nan
اللون	awọ	Nan
الليبرالية	ominira	Nan
الليبي	ara líbíà	Nan
الليبية	ara líbíà	Nan
الليزر	laser	Nan
الليل	alẹ́	Nan
الليلة	lalẹ	Nan
الليمفاوية	lymph	Nan
اللَّهُ	allah	Nan
اللّه	allah	Nan
المأكولات	ounje	Nan
المأمون	ailewu	Nan
المؤتمرات	awọn apejọ	Nan
المائي	oko	None
المائية	omi-omi	Nan
المادة	koko-ọrọ	Nan
المبدأ	ilana	None
المبشرين	mẹdehlan lẹ	Nan
المبكر	tete	Nan
المبكرة	tete	Nan
المبنى	ile	Nan
المبيدات	awọn ipakokoropaeku	Nan
المتاحة	wa	Nan
المتاحف	awọn musiọmu	Nan
المتبقية	ti o ku	Nan
المتجددة	ti o ṣe sọdọtun	Nan
المتحدة	orilẹ amẹrika	Nan
المتحدثين	awọn agbọrọsọ	Nan
المتحركة	animation	Nan
المتحف	ile musiọmu	Nan
المتخصصة	onakan	Nan
المباني	awọn ile	Nan
المباشرة	taara	Nan
المباشر	taara	Nan
المباريات	awọn ibaamu	Nan
المادي	ti ara	Nan
المادية	ti ara	Nan
الماركسية	marxism	Nan
الماسونية	freemasonry	Nan
الماشية	maalu	Nan
الماضي	awọn ti o ti kọja	Nan
الماضية	ti o ti kọja	Nan
اللهِ	allah	Nan
المال	ni owo	Nan
المالكي	al-maliki	Nan
المالي	owo	Nan
المالية	isuna	Nan
الماليزية	ara ilu malaysia	Nan
المبادئ	awọn ipilẹṣẹ	Nan
المبادرة	ipilẹṣẹ	Nan
المباراة	baramu	Nan
المالكة	ọba	Nan
المتزايدة	dagba	Nan
اللهم	olohun	None
اللهجات	awọn fifọ	Nan
الكهربائية	itanna	Nan
الكهربية	electrophysiology	Nan
الكهرومغناطيسية	itanna	Nan
الكهنة	awọn alufa	Nan
الكهوف	awọn iho	Nan
الكوارث	awọn ajalu	Nan
الكواكب	aye	Nan
الكورية	ara ilu korea	Nan
الكوفة	kufa	Nan
الكوفي	kufi	Nan
الكوكب	aye	Nan
الكومنولث	ibaṣepọ	Nan
الكون	aye	Nan
الكونغرس	ile asofin ijoba	Nan
الكونغو	kongo	None
الكهربائي	itanna	Nan
الكوني	apanirun	Nan
الكهرباء	ina	Nan
الكندية	ara ilu kanada	Nan
الكلاب	awọn aja	Nan
الكلاسيكي	ayebaye	Nan
الكلاسيكية	ayebaye	Nan
الكلام	sọrọ	Nan
الكلمات	awọn ọrọ	Nan
الكلمة	ọrọ	Nan
الكلي	àrùn	None
الكليات	awọn ẹkọ	Nan
الكلية	kọlẹji naa	Nan
الكم	kuatomu	Nan
الكمال	pipe	Nan
الكمبيوتر	kọmputa	Nan
الكمية	opoiye	Nan
الكنائس	awọn ile-ijọsin	Nan
الكندي	ara ilu kanada	Nan
الكنيسة	ijo	Nan
الكونية	apanirun	Nan
الكويت	kuwait	Nan
الكويتي	kuwaiti	Nan
اللحظة	akoko	Nan
اللحم	eran	Nan
اللحوم	eran	Nan
اللذان	àjọ who	Nan
اللسان	ahọn	Nan
اللطيف	toosi	Nan
اللعب	mu ṣiṣẹ	Nan
اللعبة	eré náà	Nan
اللغات	awọn ede	Nan
اللغة	ede naa	Nan
اللغوية	ede	None
اللفظ	ronwe	Nan
اللقاء	ipade	Nan
اللقب	akọle	Nan
الله	allah	Nan
اللجوء	wá ibi aabo	Nan
اللجنة	igbimọ naa	Nan
اللبنانيين	awọn ara lebanoni	Nan
اللبنانية	lẹ́bánì	Nan
الكويتية	kuwaiti	Nan
الكويكبات	asteroids	Nan
الكيماوية	kẹmika	Nan
الكيمياء	kemistri	Nan
الكيميائي	onimọn-jinlẹ naa	Nan
الكيميائية	kẹmika	Nan
اللاتيني	ede latini	Nan
اللهجة	itẹnumọ	Nan
اللاتينية	ede latini	Nan
اللاحقة	suffix	Nan
اللاذقية	lattakia	Nan
اللازم	pataki	Nan
اللازمة	pataki	Nan
اللاعب	ẹrọ orin	Nan
اللاعبين	awọn oṣere	Nan
اللبناني	lẹ́bánì	Nan
اللاجئين	asasala	Nan
يُمكن	le	None
