$	$	None
عانى	silica	Nan
عبادة	cibaadada	None
عبارة	weedha	Nan
عباس	cabbaas	None
عبد	addoonsiga	Nan
عبده	addoonsiga	Nan
عبر	oo	None
عبرانيون	cibraaniyada	Nan
عبور	isgoysyada	Nan
عبيد	addoonsiga	Nan
عبيدة	obaida	Nan
عتبة	marinka	None
عثر	helay	None
عثمان	othman	Nan
عثمانية	ottoman	Nan
عانت	way	None
عجائب	yaab	None
عامًا	sanado	None
عامي	wadajir	None
عاصمتها	caasimadeeda	Nan
عالم	aqoonyahan	None
عالمي	adduunkayga	Nan
عالميا	adduunyada	None
عالمياً	adduunyada	None
عالمية	caalami	None
عالي	sare	None
عالية	sare	None
عام	sanad	None
عاما	jir	None
عاماً	sanad	None
عامة	guud	None
عامر	amer	Nan
عامل	xaqiiqda	None
عاملاً	arrin	None
عاميّ	slang	Nan
عاصمته	caasimadiisa	None
عدا	reebo	None
عدد	tirada	None
عرضت	lasiiyay	Nan
عرضه	u	None
عرضها	bandhigay	None
عرف	wuu	None
عرفات	carafaad	Nan
عرفة	arafa	Nan
عرفت	gartay	None
عرفوا	ogaadeen	None
عروة	tab	Nan
عز	badan	None
عزل	karantiil	Nan
عزم	qaadashada	None
عزيز	gacaliye	Nan
عسكري	askari	None
عسكرية	ciidan	None
عرضة	u	None
عدة	ah	None
عرض	muuji	Nan
عربية	carabi	None
عددا	tiro	None
عدداً	tiro	None
عددها	tiradooda	Nan
عددهم	tiradooda	Nan
عددًا	tiro	None
عدل	cadaalada	None
عدم	maya	Nan
عدن	aadan	None
عدنان	cadnaan	None
عدوى	caabuq	Nan
عدي	oday	None
عديدة	badan	None
عدّة	ah	None
عرب	carab	None
عربي	carabi	None
عرش	carshiga	Nan
عاصمة	caasimad	None
عاصم	assem	Nan
عاصفة	duufaano	Nan
طلاب	ardayda	None
طلال	talal	Nan
طلب	codsi	None
طلبة	ardayda	None
طلبت	codsaday	None
طلبه	codsigiisa	Nan
طلحة	talha	Nan
طن	taagag	Nan
طنجة	tangier	Nan
طه	taha	Nan
طهران	tehran	Nan
طوائف	wadaadyo	Nan
طوال	dhan	None
طور	horumar	None
طورت	horumariyay	Nan
طلائعيات	tababar	Nan
طول	dhererka	Nan
طقوس	dhaqan	None
طفل	ilmo	None
طبيعية	dabiici	None
طرابلس	tripoli	Nan
طراز	qaabka	None
طرازات	dhigaysa	None
طرح	kala	None
طرد	laad	Nan
طرف	xaflad	Nan
طرفاوية	terminal	Nan
طرق	dariiqooyinka	Nan
طرول	trowels	Nan
طريق	jid	None
طريقة	habka	None
طريقه	habka	None
طريقها	jidkeeda	Nan
طعام	cuntada	None
طفولته	caruurnimadiisii	Nan
طولها	dhererkeeda	Nan
طويل	dheer	None
طويلا	dheer	None
عابرة	gudbitaanka	Nan
عاد	noqday	None
عادات	caadooyin	Nan
عادة	caado	None
عادةً	caado	None
عادت	noqotay	None
عادل	just	Nan
عادوا	noqdeen	None
عادي	caadi	None
عادية	caadi	None
عارض	muuqaal	Nan
عارف	ogaanshaha	Nan
عاش	toos	None
عاشت	way	None
عاشوراء	caasho	Nan
عائلته	qoyskiisa	Nan
عائلة	qoys	None
عائلات	qoysas	Nan
عائشة	caasha	None
طويلاً	dheer	None
طويلة	dheer	None
طيبة	nooc	None
طيران	duulimaad	Nan
طيلة	dhan	None
طيور	shimbiraha	None
ظاهر	muuqata	None
عسل	malab	Nan
ظاهرة	ifafaale	Nan
ظل	xarka	Nan
ظلت	nagaaday	None
ظهر	noqo	None
ظهرت	muuqday	None
ظهره	dhabarkiisa	Nan
ظهور	muuqaalka	None
ظواهر	phenomena	Nan
ظروف	duruufaha	Nan
طبيعي	ah	None
عسير	adag	None
عشر	toban	None
عندما	goorma	Nan
عنده	leh	None
عندها	kadib	None
عندهم	leeyihiin	None
عنصر	shay	None
عنق	luqunta	Nan
عنه	isaga	None
عنها	iyada	None
عنهم	iyaga	None
عنهما	iyaga	None
عنوان	cinwaanka	None
عني	saabsan	None
عنيفة	rabshado	Nan
عهد	axdi	Nan
عهده	ilaalin	None
عندئذ	kadib	None
عهود	axdiyada	Nan
عند	ugu	None
عنترة	antara	Nan
عمليات	hawlgallada	Nan
عملية	hawsha	Nan
عمه	aabo	Nan
عمود	cirif	Nan
عموم	dusha	None
عموما	ahaan	None
عموماً	ahaan	None
عمومًا	ahaan	None
عمير	caamir	Nan
عميق	dheer	None
عميقة	dheer	None
عمّان	cumaan	None
عن	saabsan	None
عناصر	alaabada	Nan
عناية	feejignaan	Nan
عنخ	ankh	Nan
عملها	shaqadeeda	Nan
عواصم	caasimadaha	None
عوامل	sababaha	None
غازات	meelaha	None
غازي	gaseous	Nan
غالب	ghalib	Nan
غالبا	ah	None
غالباً	ah	None
غالبية	badan	None
غالبًا	ah	None
غاما	gamma	Nan
غاميلان	gamilan	Nan
غاندي	gaandi	None
غانم	ghanem	Nan
غاية	socdo	None
غباء	doqonnimo	Nan
غذاء	cuntada	None
غرار	jeceshahay	Nan
غاز	gaas	Nan
عواقب	cawaaqibta	Nan
غار	laurel	Nan
غابات	kaymaha	None
عودة	dib	None
عودته	soo	None
عوف	aouf	Nan
عيد	ciid	None
عيسى	essa	Nan
عين	isha	None
عينات	muunadaha	Nan
عينيه	indhihiisa	Nan
عيون	indhaha	None
عَلَى	cali	None
عَلَيْهِ	dushiisa	Nan
عُثر	helay	None
عُرف	wuu	None
عُرفت	way	None
عُمان	cumaan	None
غادر	bidix	None
عمله	lacag	None
عملت	shaqeeyay	None
عملة	lacag	None
عظيم	weyn	None
عظيمة	weyn	None
عفان	affan	Nan
عفص	tannery	Nan
عقارب	gacmaha	None
عقب	dib	None
عقبة	caqabad	Nan
عقد	silsilad	Nan
عقدت	xalay	Nan
عقل	maanka	None
عقوبة	ciqaab	None
عقود	sano	None
عقيدة	caqiido	Nan
عكا	acre	Nan
عكس	noqo	None
عظمى	jab	None
علاء	alaa	Nan
عظمة	weynaan	Nan
عظام	lafo	Nan
عشرات	tobanaan	Nan
عشرة	toban	None
عشرية	jajab tobanle	Nan
عشرين	labaatan	None
عصام	essam	Nan
عصبة	horyaal	None
عصر	tuuji	Nan
عصره	xilligiisii	Nan
عصور	eras	Nan
عصير	casiir	Nan
عضوا	xubin	None
عضواً	xubin	None
عضوية	xubinimada	Nan
عطارد	meerkuriga	Nan
عطلة	fasax	None
عظم	laf	None
علاج	daaweynta	Nan
علاقات	xiriirka	None
علاقاتها	xiriirkeeda	Nan
عليهم	dushooda	Nan
عليهما	iyaga	None
عليّ	cali	None
عم	adeer	None
عما	saabsan	None
عماد	emad	Nan
عمال	shaqaalaha	None
عمان	cumaan	None
عمد	baabtiis	Nan
عمر	cumar	None
عمره	da&#39;diisa	Nan
عمرو	amr	Nan
عمق	dheer	None
عمل	ficil	None
عملاق	giant	Nan
عليها	dusheeda	None
عليه	dushiisa	Nan
علينا	anaga	Nan
عليكم	saaran	None
علاقة	xiriirka	None
علامات	calaamadaha	Nan
علامة	saxeex	Nan
علاوة	gunno	Nan
علاوةً	dheer	None
علم	sayniska	None
علما	ogeysiis	Nan
عش	toos	None
علماء	culimada	None
علماً	ogeysiis	Nan
علمه	aqoontiisa	None
علمية	cilmiga	None
علوم	cilmiga	None
على	on	None
علي	cali	None
عليك	saaran	None
علمانية	xasilloonida	Nan
طبيعة	dabeecadda	Nan
طبية	caafimaad	None
طبيب	dhakhtar	Nan
شخصيته	dabeecaddiisa	None
شداد	adkeynta	None
شديد	xun	None
شديداً	adag	None
شديدًا	adag	None
شراء	iibsiga	Nan
شراكة	iskaashi	None
شرب	cab	Nan
شرج	futada	Nan
شرح	sharxay	Nan
شرط	xaalad	Nan
شرع	socda	None
شرعية	ahaanshaha	None
شرف	maamuus	Nan
شرق	bari	None
شخصية	astaamaha	None
شرقا	bari	None
شخصيات	mudanayaal	Nan
شحنة	shixnad	Nan
شامل	dhameystiran	Nan
شاملة	midnimo	None
شاه	shah	Nan
شاهد	eeg	None
شاهين	shaheen	Nan
شباب	dhallinyar	Nan
شبابه	dhallintiisii	Nan
شبكات	shabakado	Nan
شبكة	shabakad	None
شبه	ah	None
شبيه	jecel	None
شبيهة	ah	None
شتى	duwan	None
شجرة	geed	None
شجع	dhiirrigaliyay	Nan
شخص	qofka	None
شامة	bar	None
شرقاً	bari	None
شركات	shirkadaha	None
شعوب	dadka	None
شغل	buuxi	Nan
شق	jeexis	Nan
شقيقه	walaasha	Nan
شك	shaki	None
شكل	foom	Nan
شكلت	sameeyay	None
شكله	qaabkeeda	Nan
شكلها	qaabkeeda	Nan
شمال	waqooyiga	None
شمالا	woqooyi	None
شمالاً	woqooyi	None
شمالي	waqooyiga	None
شمس	qorrax	Nan
شمسية	dallad	Nan
شعره	timo	None
شرقي	bari	None
شعراء	gabayaaga	Nan
شعبية	caan	None
شركة	shirkad	None
شروط	shuruudaha	Nan
شريط	xargaha	Nan
شريعة	sharciga	None
شريف	sherif	Nan
شريك	lammaane	Nan
شطرنج	chess	Nan
شعائر	rituals	Nan
شعار	logo	Nan
شعاع	laydh	None
شعب	dadka	None
شعبان	shaaban	Nan
شعبة	qaybta	None
شعبه	qaybta	None
شعبي	ah	None
شعر	gabay	None
شاكلة	jeceshahay	Nan
شاكر	shaker	Nan
شاطئ	xeebta	None
سوري	suuriya	None
سوريا	siiriya	Nan
سورية	suuriya	None
سوف	doono	None
سوق	suuqa	None
سومطرة	sumatra	Nan
سوى	laakiin	None
سويسرا	switzerland	None
سي	c.	Nan
سيئة	xun	None
سياحة	dalxiiska	None
سياحية	dalxiiska	None
سيادة	gobanimada	Nan
سيارات	gawaarida	Nan
سيارة	gaari	None
سورة	surah	Nan
سياسات	siyaasadaha	Nan
سور	dayr	Nan
سواحل	xeebaha	None
سنغافورة	singapore	Nan
سنن	sunan	Nan
سنه	sanad	None
سنوات	sanado	None
سنويا	sanadkii	None
سنوياً	sanadkii	None
سنوية	sanadle	Nan
سنويًا	sanadkii	None
سنين	sanado	None
سهل	fudud	None
سهول	bannaanka	Nan
سهولة	fudayd	Nan
سهيل	suhail	Nan
سوء	xanuunsan	None
سواء	in	None
سوداء	madoow	Nan
سياسة	siyaasada	None
سياسي	siyaasi	None
سياسيا	siyaasiyan	Nan
سيناء	siinay	Nan
شأن	muhiim	None
شأنه	lahaa	None
شأنها	jeceshahay	Nan
شؤون	arimaha	None
شئون	arimaha	None
شاء	doonayaa	None
شائع	ah	None
شائعة	xanta	None
شارع	st	None
شارك	la	None
شاركت	ka	None
شارل	charles	None
شاسعة	vast	Nan
شاش	gauze	Nan
سيما	ahaan	None
سيلينيوم	selenium	Nan
سيكون	doontaa	None
سيكلامين	cyclamen	Nan
سياسية	siyaasadeed	None
سياق	dulucda	None
سيتم	doontaa	None
سيتي	magaalada	None
سيد	mudane	None
سيدة	marwo	None
سيدي	sayid	None
شمل	dar	None
سير	soco	None
سيرته	taariikhdiisa	Nan
سيطر	xakamee	Nan
سيطرة	xakamayn	Nan
سيطرت	xakamaynta	Nan
سيطرتها	xakamadeeda	Nan
سيف	seefta	Nan
سيفه	seeftiisii	Nan
سيرة	nololeed	None
شملت	kujira	Nan
شن	shen	Nan
شهاب	toogashada xiddig	Nan
صوتية	codka	None
صور	sawir	None
صورة	sawir	None
صوفيا	safiya	None
صياغة	tafatirka	Nan
صيد	ugaarsiga	Nan
صيغة	qaaciddada	Nan
صيف	xagaaga	Nan
صَلَّى	duceeya	Nan
ضئيلة	caato	None
ضابط	sarkaal	None
ضباط	saraakiisha	None
ضبط	dejinta	Nan
ضحايا	dhibanayaashu	Nan
ضخم	weyn	None
صوت	codka	None
ضخمة	badan	None
صوب	ujeedada	None
صنف	fasalka	Nan
صلاة	ducada	None
صلاح	saalax	None
صلاحيات	shuruudaha tixraaca	Nan
صلادة	adag	None
صلب	adag	None
صلبة	adag	None
صلة	iskuxirka	Nan
صلح	u	None
صلى	duceeya	Nan
صناعات	warshadaha	None
صناعة	samaynta	Nan
صناعي	warshadaha	None
صناعية	warshadaha	None
صندوق	sanduuq	Nan
صنع	samaynta	Nan
صواريخ	gantaallada	Nan
ضد	soo	None
ضده	isaga	None
ضربة	garaacid	Nan
طائرة	diyaarad	Nan
طائفة	qayb	None
طابع	shaabad	Nan
طارق	tariq	Nan
طاعة	addeecid	Nan
طاقة	tamar	None
طالب	arday	None
طالبت	way	None
طالع	eeg	None
طالما	inta	None
طاهر	nuugid	Nan
طب	daawo	None
طبقا	xigtay	None
طبقاً	xigtay	None
طبقة	lakab	Nan
طائرات	diyaaradaha	None
ضيقة	toos	None
ضيق	adkeyn	Nan
ضواحي	xaafadaha	None
ضرورة	daruuri	Nan
ضرورية	maarmaan	None
ضريبة	cashuurta	Nan
ضريح	masaajidka	None
ضعف	daciifnimo	Nan
ضعيف	tabar	Nan
ضعيفة	tabar	Nan
صقلية	xun	None
ضغط	cadaadis	None
ضم	dar	None
ضمان	qaad	None
ضمت	kujira	Nan
ضمن	gudahood	Nan
ضمنها	gudaheeda	None
ضوء	iftiimin	Nan
ضوئية	iftiimin	Nan
ضفاف	bangiyada	Nan
غرب	galbeedka	None
صقر	falcon	Nan
صفوف	safka	Nan
شيوخ	odayaasha	None
شيوعا	wadajir	None
شيوعاً	wadajir	None
شيوعية	wadaag	Nan
شيوعًا	wadajir	None
ص	s	None
صاحب	milkiilaha	None
صاحبه	milkiilkiisa	Nan
صادرات	dhoofinta	Nan
صادق	ah	None
صار	dhacday	None
صارت	noqotay	None
صارمة	adag	None
صالح	ah	None
صالحة	ah	None
شيد	dhismay	Nan
صباح	subax	None
شيخ	sheekh	None
شيئاً	wax	None
شهادة	degree	None
شهد	markhaati	Nan
شهدت	aragtay	None
شهدوا	arkeen	None
شهر	bisha	None
شهرة	maansada	None
شهور	bilooyin	Nan
شوارع	dariiqyada	Nan
شواطئ	xeebaha	None
شوال	shawwal	Nan
شوقي	shawky	Nan
شي	shi	Nan
شيء	shay	None
شيءًا	wax	None
شيئا	wax	None
شيث	seth	Nan
صبحي	sobhi	Nan
صبري	samirkayga	Nan
صحة	caafimaadka	None
صرح	yidhi	None
صريح	cadayn	Nan
صعب	adag	None
صعبة	dhibaato	None
صعوبة	dhib	None
صعيد	heer	None
صغار	junior	Nan
صغير	yar	None
صغيرة	yar	None
صف	row	Nan
صفات	astaamaha	None
صفة	sharraxaad	Nan
صفحات	bogagga	Nan
صفحة	bogga	None
صفر	eber	Nan
صربيا	serbia	None
صراع	dhac	None
صديقه	gabar	None
صديق	saaxiib	None
صحراء	cidlada	Nan
صحف	wargeysyada	Nan
صحية	qaba	None
صحيح	run	None
صحيحة	sax	None
صحيحه	sax	None
صحيفة	wargeys	Nan
صفين	laba	None
صخرية	dhagax	None
صد	boog	Nan
صداقة	saaxiibtinimo	None
صدام	saddam	Nan
صدر	daayay	None
صدرت	saaray	None
صدق	runta	None
صدور	laabta	Nan
صخور	dhagaxyada	Nan
سنتين	sano	None
غربا	galbeed	None
غربي	galbeed	None
كأس	koob	None
كأنه	sida	None
كائن	shay	None
كائنات	waxyaabaha	None
كاتب	karraaniga	Nan
كاتدرائية	cathedral	Nan
كاترين	katrin	Nan
كاجو	cashew	Nan
كاد	ku	None
كادميوم	cadmium	Nan
كارل	carl	Nan
كارلوس	carlos	Nan
كاروانسرا	karwansra	Nan
كارولين	caroline	Nan
كاسترو	castro	Nan
قُتل	dil	None
كاظم	kazem	Nan
قَالَ	yidhi	None
قيمة	qiimayaasha	Nan
قومية	qaranimo	Nan
قوى	leh	None
قوي	leh	None
قوياً	xoog	None
قوية	xoog	None
قويسة	sage	Nan
قي	qiimee	Nan
قيادة	hogaaminta	Nan
قياس	cabbiraad	Nan
قيام	samee	Nan
قيد	xaddid	Nan
قيس	qais	Nan
قيصر	kaysar	Nan
قيل	yiri	None
قيم	qiimayaasha	Nan
قيود	xaddidaadaha	Nan
قومي	qaranka	None
كافة	dhamaan	None
كافية	filan	None
كبيراً	weyn	None
كبيرة	weyn	None
كبيرًا	weyn	None
كتائب	dagaallada	None
كتاب	buug	None
كتابات	qoraallada	Nan
كتابة	qoraalka	None
كتابه	qoraalka	None
كتب	qoraal	None
كتبت	qoray	None
كتبغا	qoraa	None
كتبه	qoray	None
كتبها	qoray	None
كتل	biraha	Nan
كتلة	mass	Nan
كبيرا	weyn	None
كافور	cambaareyn	Nan
كبير	ballaaran	None
كبر	koray	None
كالتالي	socota	None
كاليفورنيا	kaliforniya	Nan
كامب	xero	None
كامل	dhamaan	None
كاملاً	buuxda	None
كاملة	ah	None
كان	ahayd	None
كانا	ahaayeen	None
كاناميسين	kanamycin	Nan
كانت	ahayd	None
كانتا	ahaayeen	None
كانوا	ahaayeen	None
كانون	canon	Nan
كايبر	kipper	Nan
كبار	sare	None
كبرى	weyn	None
قومه	dadkiisa	None
قوم	dadka	None
قوله	dheh	None
قصائده	gabayadiisa	None
قصة	sheeko	None
قصد	jeedaa	None
قصر	qasriga	Nan
قصص	sheekooyinka	None
قصف	duqeynta	Nan
قصور	fashil	Nan
قصيدة	gabay	None
قصير	gaaban	None
قصيرة	gaaban	None
قضاء	bixi	None
قضايا	arimaha	None
قضى	bixin	None
قضيبه	guska	Nan
قضية	arrin	None
قصائد	gabayo	None
قط	marna	None
قسمين	qaybood	None
قسم	qeybta	None
قرر	ayuu	None
قرص	kiniin	Nan
قرطاج	carthage	Nan
قرطاجنة	cartagena	Nan
قرطبة	cordoba	Nan
قرن	qarni	None
قرون	qarniyo	None
قرى	tuulooyinka	None
قريب	xidh	None
قريبة	xidh	None
قرية	tuulo	None
قريش	quraysh	None
قريظة	qurayza	Nan
قزوين	caspian	Nan
قسطنطين	constantin	Nan
قسمت	kala	None
قطار	tareen	None
قطاع	qaybta	None
قطاعات	waaxaha	Nan
قمر	dayaxa	None
قمع	xakamaynta	Nan
قناة	channel	None
قنوات	idaacadaha	None
قوائم	liisaska	Nan
قوات	ciidan	None
قواته	ciidankiisa	Nan
قواتها	awooddeeda	Nan
قواعد	xeerarka	None
قوانين	xeerarka	None
قوبلاي	kublai	Nan
قوة	tamarta	None
قوتها	awooddeeda	Nan
قوس	ark	Nan
قول	dheh	None
قمة	shir	None
قم	saxiix	Nan
قليلة	yaroo	None
قليلاً	xoogaa	None
قطب	cirif	Nan
قطر	dhexroor	Nan
قطرها	dhexroor	Nan
قطز	qutuz	Nan
قطع	gooyaa	Nan
قطعة	jiiska	Nan
قلاوون	qalawun	Nan
كتيبة	guuto	Nan
قلب	wadnaha	None
قلبي	qalbigeyga	Nan
قلة	la&#39;aanta	Nan
قلت	idhi	None
قلعة	qalcaddii	Nan
قلوب	quluubtooda	Nan
قليل	yar	None
قليلا	xoogaa	None
قلبه	qalbigiisa	None
قرب	dhow	None
كثافة	cufnaanta	Nan
كثرة	badan	None
لألمانيا	jarmalka	None
لأن	ah	None
لأنه	isagu	None
لأنها	iyada	None
لأهل	dadka	None
لأوروبا	yurubna	Nan
لأول	hore	None
لأي	kasta	None
لإثبات	loo	None
لإجراء	loo	None
لإدارة	loo	None
لإسرائيل	binu	None
لإعادة	loo	None
لإقامة	la	None
لإنتاج	saaro	None
لأكثر	badan	None
لإنشاء	abuuro	None
لأفضل	soo	None
لأسباب	sababo dartood	Nan
كيشيون	kicin	Nan
كيف	sidee	None
كيفية	loo	None
كيلومتر	kiiloomitir	Nan
كيمياء	kimistariga	Nan
كيميائي	kiimikada	Nan
كيميائية	kiimiko	Nan
كييف	kiev	Nan
ل	ku	None
لآخر	kale	None
لأبي	aabahay	Nan
لأجل	aawadood	Nan
لأحد	qofkasta	None
لأداء	qabto	None
لأرسطو	socota	None
لأغراض	ujeeddooyin	Nan
كيشوا	quechua	Nan
لإيجاد	helo	None
لابد	in	None
لاَ	maya	Nan
لبث	nooga	None
لبعض	qaarna	None
لبلاد	dal	None
لبناء	dhiso	None
لبنانية	lubnaan	None
لتجنب	fogaado	None
لتحديد	loo	None
لتحرير	loo	None
لتحسين	loo	None
لتحقيق	gaadho	None
لتشكل	garto	None
لتشكيل	loo	None
لتشمل	ku	None
لتصبح	inaad	None
لاين	khad	None
لا	maya	Nan
لايف	toos	None
لاند	dhul	None
لابن	wiil	None
لاتخ	ha	None
لاحظ	ogeysiis	Nan
لاحق	dambe	None
لاحقا	dambe	None
لاحقاً	dambe	None
لاحقة	suffix	Nan
لادن	liin	Nan
لاسم	magac	None
لاسيما	ahaan	None
لاعب	ciyaaryahan	Nan
لاعبي	ciyaartoyda	Nan
لاقت	kulmay	None
لامدا	lambda	Nan
لان	ah	None
لانه	isagu	None
كيان	hay&#39;ad	Nan
كي	ki	None
كونها	ahaan	None
كسر	burburay	None
كشف	muujinta	Nan
كشفت	muujiyey	None
كعب	ciribta	Nan
كفر	gaalnimo	Nan
كقوة	ahaan	None
ككل	ahaan	None
كل	kasta	None
كلا	labadaba	None
كلام	hadalka	None
كلثوم	kulthum	Nan
كلغة	ahaan	None
كلما	markasta	None
كلمات	heesta	None
كلمة	eray	None
كسب	kasban	Nan
كله	ahaanba	None
كريت	kireeti	Nan
كركيات	kariimka	None
كثير	badan	None
كثيرا	badan	None
كثيراً	badan	None
كثيرة	badan	None
كثيرون	inbadan	None
كثيف	cufan	Nan
كثيفة	culus	None
كجزء	ahaan	None
كدولة	ahaan	None
كذا	ah	None
كذلك	kale	None
كرات	kubadaha	Nan
كربلاء	karbala	Nan
كرة	kubad	Nan
كرسي	kursi	Nan
كريات	kiniiniyada	Nan
كلها	dhamaantood	None
كلهم	dhamaantood	None
كليات	xirfadaha	Nan
كهربائي	yaqaan	None
كهربائية	koronto	None
كواكب	meerayaasha	Nan
كوايك	quik	Nan
كوبا	cuba	Nan
كوريا	kuuriya	None
كوريوم	curium	Nan
كوزميد	cozumid	Nan
كوسيلة	yahay	None
كوكب	meeraha	Nan
كولوم	coulomb	Nan
كولومبيا	kolombiya	None
كون	caalamka	None
كونان	conan	Nan
كونه	ahaan	None
كهرباء	koronto	None
كنيسة	kaniisad	None
كنعان	kancaan	Nan
كندا	kanada	None
كليب	clip	Nan
كلية	kuleej	Nan
كلينتون	clinton	None
كليوباترا	cleopatra	Nan
كلّ	kasta	None
كم	immisa	Nan
كما	sida	None
كثر	inbadan	None
كمال	ah	None
كميات	tiro	None
كمية	tirada	None
كنا	ahayn	None
كنائس	kaniisadaha	Nan
كنانة	kinaanah	Nan
كنت	ahaa	None
كنتيجة	ahaan	None
كمصدر	ahaan	None
قرارات	go’aamada	Nan
قرار	qaraar	None
قرابة	saabsan	None
فرسان	laydhka	Nan
فرساي	aayado	Nan
فرص	fursado	Nan
فرصة	fursad	None
فرض	soo	None
فرضت	xirmay	Nan
فرضية	mala-awaal	Nan
فرع	laan	None
فرعون	fircoon	None
فرعية	secondary	None
فرق	kala	None
فرقة	kooxda	None
فرنسا	faransiiska	None
فرنسي	faransiiska	None
فرنسية	faransiiska	None
فردية	shaqsi	None
فروع	laamaha	Nan
فرد	shaqsi	None
فرانك	frank	Nan
فترة	bareeg	Nan
فتكون	doontaa	None
فتم	amaan	None
فتنة	imtixaan	Nan
فجاء	yimid	None
فجر	waaberiga	Nan
فجعل	sameeyay	None
فحسب	kaliya	None
فحص	kantarool	Nan
فخرج	baxay	None
فخلال	muddadii	None
فدخل	galay	None
فذهب	tegey	None
فراس	firas	Nan
فرانسيسكو	francisco	Nan
فرانكو	franco	Nan
فترات	wakhtiyada	Nan
فرويد	freud	Nan
فريدة	farida	Nan
فعلاً	runtii	None
فعله	dhameeyay	None
فعلى	ah	None
فعندما	goorma	Nan
ففي	gudaha	None
فقال	yidhi	None
فقالت	tidhi	None
فقالوا	waxay	None
فقام	kacay	None
فقامت	way	None
فقبل	kahor	None
فقد	lumiyay	Nan
فقدان	guuldarro	Nan
فقدت	lumiyay	Nan
فقر	saboolnimada	Nan
فعلا	runtii	None
فريد	caadi	None
فعل	fal	None
فعالة	ah	None
فريدريك	frederick	Nan
فريق	kooxda	None
فشل	fashil	Nan
فشلت	fashilmay	None
فصائل	noocyada	None
فصل	xilliga	Nan
فصول	cutubyada	Nan
فضاء	boos	Nan
فضائية	boos	Nan
فضل	mahadsanid	Nan
فضلا	kale	None
فضلاً	kale	None
فطلب	waydiiyay	None
فطيرة	jiid	Nan
فعال	ah	None
فعالية	waxtarka	Nan
فتحي	fathi	Nan
فتحها	fur	Nan
فتحت	furay	None
غلطة	qalad	None
غلوكوز	gulukoos	Nan
غلوون	gluon	Nan
غناء	heeso	None
غناها	maalkeeda	None
غني	ah	None
غنية	taajir	None
غوستاف	gustav	Nan
غياب	maqnaanshaha	Nan
غير	maya	Nan
غيره	masayr	Nan
غيرها	kale	None
غيرهم	kale	None
غيفارا	guevara	Nan
غينيا	guinea	None
غلاف	santuuqa	Nan
فأخذ	qaatay	None
غطاء	dabool	Nan
غضب	cadho	Nan
غربية	galbeedka	None
غربًا	galbeed	None
غرفة	qol	Nan
غرناطة	granada	Nan
غريب	shisheeye	None
غريبة	leh	None
غرين	greene	Nan
غزا	guul	None
غزة	qasa	Nan
غزو	martiqaad	None
غزوات	forays	Nan
غزوة	foray	Nan
غسق	fiidkii	Nan
غسل	dhaq	None
غشاء	xuubka	Nan
غضون	gudaha	None
فأرسل	diray	None
فأصبح	noqday	None
فأصبحت	noqday	None
فاطمة	faadumo	None
فاعلية	waxtarka	Nan
فالج	hemiplegia	Nan
فالكيري	valkyrie	Nan
فالنتين	valentin	Nan
فان	van	Nan
فاندانغو	fandango	Nan
فايمار	weimar	Nan
فبدأ	bilaabay	None
فبراير	febraayo	None
فبعد	kadib	None
فبعض	qaar	None
فتاة	gabadh	None
فتح	fur	Nan
فتحة	booska	Nan
فاس	ax	Nan
فازت	ku	None
فاز	guuleystay	None
فاروق	faaruuq	Nan
فأمر	amray	None
فأن	kadib	None
فؤاد	fouad	Nan
فإذا	marka	None
فإن	the	None
فإننا	yeeli	None
فإنه	dhacdaa	None
فقرر	ayuu	None
فإنها	leh	None
فئات	qeybaha	None
فئة	qayb	None
فائدة	faa iido	Nan
فائقة	super	None
فاراداي	faraday	Nan
فارس	habeen	None
فارسي	faaris	Nan
فإنهم	waa	None
فقط	just	Nan
فقلت	idhi	None
فقه	sharciyeynta	Nan
قارات	qaaradaha	None
قارة	qaaradda	None
قاسم	tilmaanta	Nan
قاسية	cadaadis	None
قاعة	hoolka	Nan
قاعدة	saldhig	None
قال	yidhi	None
قالت	tidhi	None
قاله	yidhi	None
قالوا	waxay	None
قام	kac	Nan
قامت	yeertay	None
قاموا	way	None
قاموس	qaamuus	None
قانون	sharciga	None
قادرين	awood	None
قانوني	ah	None
قادرة	leh	None
قادت	way	None
فيهما	iyaga	None
فيينا	vienna	Nan
فِي	a	None
ق	s	None
قائد	hogaamiye	None
قائلا	leh	None
قائلاً	leh	None
قائم	jira	None
قائمة	liiska	None
قابل	kulmay	None
قابلة	kulmay	None
قابوس	qaboos	Nan
قاتل	dilaaga	Nan
قاد	abaar	None
قادة	hogaamiyaasha	Nan
قادر	leh	None
قانونية	sharci	None
قايتباي	qaitbay	Nan
قباء	quba	Nan
قدرته	awoodiisa	Nan
قدرتها	awooddeeda	Nan
قدرها	yoolkeeda	Nan
قدم	cagta	None
قدماء	hore	None
قدمت	gudbiyey	Nan
قدمه	adeeg	None
قدمها	adeeg	None
قدوم	socda	None
قديم	waayeel	None
قديما	hore	None
قديمًا	hore	None
قذف	toogasho	None
قرأ	akhri	None
قراءة	akhrinta	None
قدرت	waan	None
قدرة	awood	None
قدر	maraq	Nan
قد	in	None
قبائل	qabiilooyinka	Nan
قباني	iguufo	Nan
قبة	xamar	None
قبر	bambo	Nan
قبرص	qubrus	None
قبره	caano	None
قبض	qabasho	Nan
فيهم	ku	None
قبل	kahor	None
قبول	aqbalaada	Nan
قبيلة	qabiil	None
قتال	dagaal	None
قتل	dilaya	Nan
قتلة	dilaaga	Nan
قتله	dilaaga	Nan
قتلوا	dilay	None
قبله	dhunko	Nan
غرباً	galbeed	None
فيها	oo	None
فينول	phenol	Nan
فلك	astronomy	Nan
فلم	filin	Nan
فلما	sababta	None
فلمّا	sababta	None
فلن	yeeli	None
فلو	dabaq	None
فلورنسا	florence	Nan
فليس	ahan	None
فما	maxaa	None
فمثلا	ahaan	None
فمثلاً	ahaan	None
فمن	waa	None
فمنذ	iyo	None
فمنهم	iyaga	None
فن	fanka	None
فلقد	waxeey	None
فنان	farshaxan	None
فلسفة	falsafada	Nan
فلسطيني	falastiin	None
فقهاء	garsoorayaasha	Nan
فقيل	yiri	None
فك	tilmaam	Nan
فكان	ahayd	None
فكانت	ahayd	None
فكانوا	ahaayeen	None
فكر	fikir	Nan
فكرة	fikrad	None
فكل	dhamaan	None
فلا	ahan	None
فلاح	ah	None
فلاديمير	vladimir	Nan
فلاسفة	falsafadayaasha	Nan
فلدسبار	feldspar	Nan
فلسطين	falastiin	None
فلسطينية	falastiin	None
فندق	hoteel	None
فنزويلا	venezuela	None
فنلندا	finland	None
فيديو	fiidiyow	Nan
فيرفكس	firefox	None
فيروس	fayruus	Nan
فيروسات	fayrasyada	Nan
فيرونا	verona	Nan
فيزيائية	ahaan	None
فيس	facebook	Nan
فيصل	faysal	Nan
فيقول	yidhi	None
فيكون	sidaas	None
فيلم	filim	Nan
فيليب	filibos	Nan
فيما	saabsan	None
فيمكن	waa	None
فينشي	vinci	Nan
فيجب	inay	None
فيتنام	fiyatnaam	Nan
في	a	None
فوهة	xujo	Nan
فنون	farshaxanka	None
فني	farsamo	None
فنية	farshaxannimo	Nan
فهد	leopard	Nan
فهذا	waa	None
فهذه	tan	None
فهم	fahamka	None
فيه	jira	None
فهمي	fahamkeyga	Nan
فهو	waa	None
فهي	waa	None
فوائد	faa&#39;iidooyinka	Nan
فور	markiiba	None
فوضى	qasan	Nan
فوق	xusan	None
فون	iphone	Nan
فهناك	jira	None
سنة	sanad	None
سنان	ilkaha	None
سن	da	None
جديدة	cusub	None
جديدًا	cusub	None
جدير	yahay	None
جدًا	aad	None
جذب	jiidasho	None
جذور	xididdada	Nan
جراء	riwaayad	Nan
جرائم	dambiyada	Nan
جرانيت	granite	Nan
جرت	meeshii	None
جرى	orday	None
جريدة	wargeys	Nan
جزء	qayb	None
جزءا	qayb	None
جزءاً	qayb	None
جديداً	cusub	None
جزءًا	qayb	None
جديدا	cusub	None
جدوى	suurtogal	Nan
جبران	jubran	Nan
جبريل	jibriil	None
جبلية	buurta	None
جبهة	horta	Nan
جد	awoowe	None
جدا	aad	None
جدار	darbiga	None
جدال	khilaaf	None
جداً	aad	None
جدة	ayeeyo	Nan
جدد	cusub	None
جدران	darbiyada	None
جدل	dood-wadaag	Nan
جده	ayeeyo	Nan
جدول	miis	Nan
جديد	cusub	None
جبال	buuraha	None
جزئيا	ahaan	None
جزيئات	molecules	Nan
جلب	keenay	None
جلد	maqaar	Nan
جلسة	kalfadhiga	Nan
جماع	galmada	Nan
جماعات	kooxo	None
جماعية	wadajir	None
جمال	qurux	None
جمع	jamac	None
جمعة	jimce	None
جمعت	aruuriyay	Nan
جمعه	jimce	None
جمعها	aruuriyay	Nan
جمعية	urur	None
جملة	xukunka	None
جمهور	dadweynaha	None
جلال	celal	Nan
جزر	karootada	Nan
جل	geel	None
جغرافية	juquraafiga	Nan
جزيرة	jasiirad	None
جساس	basaas	None
جسد	jirka	None
جسده	jidhkiisa	Nan
جسدها	jirkeeda	Nan
جسر	buundo	None
جسم	jirka	None
جسمه	jidhkiisa	Nan
جسيمات	waxyaabaha	None
جعفر	jaafar	Nan
جعل	samee	Nan
جعلت	sameeyay	None
جعله	samee	Nan
جعلها	samee	Nan
جغرافيا	juqraafi	None
جفاف	abaarta	None
جانبي	dhinac	None
جانبه	dhinaciisa	Nan
جانب	dhinac	None
تيمية	taymiyya	Nan
تُشكل	foom	Nan
تُظهر	soo	None
تُعتبر	sida	None
تُعد	diyaari	Nan
تُعرف	yaqaan	None
ثابتة	go&#39;an	Nan
ثار	aargudasho	Nan
ثالث	saddexaad	None
ثاليوم	thallium	Nan
ثانوية	sare	None
ثاني	labaad	None
ثانيا	labaad	None
ثانية	labaad	None
ثبت	caddeeyay	None
تيمور	waqtiga	None
ثروة	dhaqaale	None
تيفوس	tiibay	Nan
تيار	qulqulka	Nan
توقع	filasho	Nan
توقف	jooji	Nan
توقيع	saxeex	Nan
توكيس	tokis	Nan
تولد	dhalasho	None
تولى	wareegtay	None
توليد	jiil	Nan
توليه	furitaanka	Nan
تولّى	wareegtay	None
توما	toma	Nan
توماس	thomas	Nan
تونس	tuniisiya	Nan
تويوتا	toyota	Nan
تويودا	toyoda	Nan
تي	t	None
تيارات	qulqulka	Nan
ثقافات	dhaqamada	Nan
ثقافة	dhaqanka	None
ثقافي	dhaqan	None
جاء	yimid	None
جاءت	timid	None
جائزة	abaalmarin	Nan
جابر	jaber	Nan
جاذبية	cufnaanta	Nan
جاسم	jaasim	Nan
جاك	jack	Nan
جاكسون	jackson	Nan
جالوت	goliath	Nan
جاليليو	galileo	Nan
جالينوس	galen	Nan
جامع	masaajidka	None
جامعات	jaamacadaha	None
جامعة	jaamacadda	None
جان	jan	Nan
ج	c	None
ثيوديسيا	theodisia	Nan
ثورة	kacaan	None
ثورات	kacdoonada	Nan
ثقافية	dhaqan	None
ثقب	dalool	None
ثقة	kalsooni	None
ثلاث	saddex	None
ثلاثة	saddex	None
ثلاثية	trilogy	Nan
ثلاثين	soddon	None
جمهوري	jamhuuriyada	None
ثلث	meel	None
ثمان	sideed	None
ثماني	sideed	None
ثمانية	sideed	None
ثمة	jira	None
ثمّ	kadib	None
ثنائية	dualism	Nan
ثور	dibiga	Nan
ثم	kadib	None
توفيق	heshiisiin	Nan
جمهورية	jamhuuriyadda	None
جميعا	dhamaantood	None
حدائق	jardiinooyin	Nan
حدة	shark	Nan
حدث	dhacdo	None
حدثت	la	None
حدثنا	sheeg	None
حدد	yaal	None
حدودها	xuduudeeda	Nan
حديث	ah	None
حديثا	cusub	None
حديثة	ah	None
حديثًا	cusub	None
حديد	bir	None
حديدية	caro	Nan
حديقة	janno	None
حراء	hira	Nan
حد	xaddid	Nan
حرارة	kuleyl	Nan
حجوالة	wareejinta	Nan
حجما	ahaan	None
حاليا	hada	None
حالياً	hada	None
حاليًا	hada	None
حامد	hamed	Nan
حامل	leh	None
حاول	isku	None
حاولت	dayay	None
حب	jacayl	None
حبيب	lover	Nan
حبيبي	ilmaha	Nan
حتى	ilaa	None
حتي	ilaa	None
حجة	dood	None
حجر	dhagax	None
حجم	cabir	None
حجمها	cabirkeeda	Nan
حالته	xaaladiisa	Nan
حرارته	kuleylkiisa	Nan
حرام	waa	None
حساسة	ah	None
حسان	xasan	None
حسب	xigtay	None
حسن	xasan	None
حسنة	wanaagsan	None
حسني	hosni	Nan
حسين	xussein	Nan
حشد	badan	None
حشرات	cayayaanka	Nan
حشيشة	xashish	Nan
حصار	go&#39;doomin	Nan
حصة	muddada	Nan
حصدت	goostay	None
حصل	dhacay	None
حصلت	helay	None
حسابات	akoonada	Nan
حرارتها	kuleylkiisa	Nan
حساب	koonto	Nan
حزن	murugo	Nan
حرب	dagaal	None
حربية	dagaalka	None
حرة	bilaash	Nan
حرس	ilaali	None
حرف	warqad	None
حرق	gubasho	Nan
حركات	dhaqdhaqaaqyada	Nan
حركة	dhaqdhaqaaq	None
حرم	waa	None
حروب	dagaal	None
حروف	waraaqaha	Nan
حرية	xorriyadda	Nan
حزام	cajal	Nan
حزب	xaflad	Nan
حزم	xarig	Nan
حزيران	juun	None
حالة	xaalad	Nan
حالب	ureter	Nan
حالات	kiisaska	Nan
جهات	goobaha	None
جهاد	jihaad	None
جهاز	aaladda	Nan
جهة	dhinac	None
جهد	dadaal	None
جهود	dadaal	None
جو	jawi	None
جوائز	abaalmarino	Nan
جواز	baasaboor	Nan
جوانب	dhinacyada	None
جواهر	dahabka	None
جوجل	google	Nan
جودة	tayada	None
جورج	george	Nan
جورجيا	georgia	Nan
جنوده	askartiisii	Nan
جورجيون	georgiyiinta	Nan
جنود	askarta	None
جنوبي	koonfurta	None
جميعاً	dhamaantood	None
جميعًا	dhamaantood	None
جميل	jecel	None
جميلة	badan	None
جناح	suite	Nan
جنب	dhinac	None
جندي	askari	None
جنس	galmada	Nan
جنسي	galmo	Nan
جنسية	dhalasho	None
جنطيانية	cunsuriyada	Nan
جنكيز	genghis	Nan
جنو	gnu	Nan
جنوب	koonfur	None
جنوبا	koonfur	None
جنوبًا	koonfur	None
جوزيف	yuusuf	None
جولة	safar	None
جون	yooxanaa	Nan
حائل	hayaan	None
حاتم	nacayb	None
حاجة	baahi	None
حادة	sharp	Nan
حادث	shil	None
حادثة	dhacdo	None
حار	kulul	None
حارب	la	None
حارة	lane	Nan
حاز	leh	None
حاسوب	kombiyuutar	Nan
حافة	gees	None
حافظ	xaaf	Nan
حافظت	joogtay	None
حال	xaaladda	None
حائط	darbiga	None
جيوش	ciidamada	None
جينات	hidayaasha	Nan
جين	gene	Nan
جوهر	nuxurka	Nan
جوي	hawada	None
جوية	hawada	None
جي	ing	None
جيبوتي	jabuuti	None
جيجابت	gigabit	Nan
جيد	wanaagsan	None
جميع	dhamaan	None
جيدا	hagaag	Nan
جيدة	fiican	None
جيش	ciidan	None
جيشه	ciidankiisii	None
جيشًا	ciidan	None
جيفارا	guevara	Nan
جيل	jiil	Nan
جيمس	yacquub	None
جيداً	hagaag	Nan
توفير	bixi	None
توفيت	dhimatay	None
توفي	dhintay	None
تضع	dhig	Nan
تضم	jira	None
تطبق	dalbo	Nan
تطبيق	hirgelinta	Nan
تطبيقات	codsiyada	Nan
تطل	fiiri	None
تطلب	weydii	Nan
تطلق	firay	Nan
تطهير	jeermis dilid	Nan
تطور	ayaa	None
تطورا	ah	None
تطورت	bedelay	None
تطوير	horumarin	Nan
تطوّر	ayaa	None
تظل	joog	None
تضخم	barar	Nan
تظهر	soo	None
تضاعف	dhuftay	None
تصوير	qaad	None
تصنيفعلم	calanka	None
تصنيفعلماء	kala	None
تصنيفعواصم	caasimadaha	None
تصنيففلاسفة	kala	None
تصنيفقادة	hogaamiyaasha qiimeynta	Nan
تصنيفكتاب	buugga	None
تصنيفلاعبو	kala	None
تصنيفمدن	magaalooyinka	None
تصنيفمصريون	qiimeynta masaarida	Nan
تصنيفممثلات	kala	None
تصنيفممثلون	jilayaasha qiimeynta	Nan
تصنيفمواليد	cusub	None
تصنيفوزراء	kala-saaridda wasiirrada	Nan
تصنيفوفيات	kala-saarista	Nan
تصور	qiyaas	None
تصيب	cudur	None
تصنيفصحابة	saaxiibka	None
تعارض	khilaaf	None
تعالى	kaalay	Nan
تعطى	siiyay	None
تعطي	sii	None
تعكس	milicsi	Nan
تعلم	baro	None
تعليم	waxbarasho	None
تعليمه	bartay	None
تعليمية	waxbarashada	None
تعمل	shaqeynaya	None
تعني	micnaheeda	None
تعود	noqo	None
تعيش	toos	None
تغطي	daboolida	None
تغطية	caymiska	Nan
تغلب	soo	None
تغير	beddel	Nan
تعزيز	adkeyn	Nan
تعاطي	xadgudub	Nan
تعرّض	u	None
تعرف	ogow	Nan
تعاليم	waxbarista	Nan
تعامل	heshiis	None
تعاني	dhibane	Nan
تعاون	iskaashi	None
تعبر	isugeyn	Nan
تعتبر	sida	None
تعترف	aqoonsiga	Nan
تعتمد	waxay	None
تعد	diyaari	Nan
تعداد	xisaab	None
تعددت	waan	None
تعديل	ka	None
تعرض	u	None
تعرضت	la	None
تعرضوا	la	None
تعريف	qeexida	Nan
تصنيفشعراء	kala	None
تصنيفرؤساء	kala-saaridda madaxyada	Nan
تصنيفديمقراطيات	dimuqraadiyadda	None
تسمية	magacaabista	Nan
تسونامي	tsunami	Nan
تسوية	dejinta	Nan
تسير	socda	None
تسيطر	xakamaynta	Nan
تشاد	chad	Nan
تشارك	leh	None
تشارلز	charles	None
تشبه	jeceshahay	Nan
تشترك	la	None
تشتمل	dar	None
تشتهر	yahay	None
تشجيع	dhiirrigeli	Nan
تشخيص	ogaadey	None
تشرف	maamuus	Nan
تسمى	la	None
تشريع	sharci	None
تسمح	u	None
تسلم	helay	None
تستخدم	loo	None
تستطع	waad	None
تستطيع	ma	None
تستعمل	loo	None
تستغرق	qaado	None
تستمر	way	None
تستهلك	isticmaal	None
تسجيل	saxiix	Nan
تسخين	kululaynta	Nan
تسرب	liqid	Nan
تسع	sagaal	None
تسعة	sagaal	None
تسعى	raadinta	Nan
تسقط	dhicid	Nan
تسلسل	isku	None
تسليم	gaarsiinta	None
تشرين	tishreen	Nan
تشغل	socdaa	None
تشغيل	ordaya	Nan
تصغير|مسجد	masaajidka	None
تصف	sifee	Nan
تصل	gaaritaan	Nan
تصميم	naqshadeynta	Nan
تصنع	saarey	None
تصنف	saaraa	None
تصنيع	saar	None
تصنيف	qiimeynta	Nan
تصنيفآل	kala-saaritaan	Nan
تصنيفأشخاص	dadka	None
تصنيفأعلام	calaamadaha kala-saaridda	Nan
تصنيفبلدان	waddanka	None
تصنيفتاريخ	taariikhda	None
تصنيفخريجو	qalin	None
تصنيفدول	wadammada kala-saaridda	Nan
تصغير|صورة	sawirka	None
تصغير|رسم	sawir	None
تصغير|بك|رسم	|	None
تصغير|	|	None
تشكل	foom	Nan
تشكلت	sameeyay	None
تشكيل	sameynta	Nan
تشمل	dar	None
تشهد	markhaati	Nan
تشي	che	Nan
تشير	muuji	Nan
تغيرات	isbadalada	None
تشيكوسلوفاكيا	czechoslovakia	Nan
تشييد	dhismaha	None
تشييط	hubi	Nan
تصاعد	fuulay	None
تصب	ku	None
تصبح	noqo	None
تصدر	saaray	None
تصدير	dhoofinta	Nan
تشين	chen	Nan
تغيرت	bedelay	None
تغيير	isbeddel	Nan
تفاصيل	faahfaahinta	Nan
تمنع	ka	None
تمويل	dhaqaalaha	None
تميز	mudan	None
تميزت	calaamadeeyay	Nan
تميل	taag	Nan
تميم	tamim	Nan
تمييز	takoorid	Nan
تمّ	dhameeyay	None
تنازل	dhaafid	Nan
تناول	cunista	Nan
تناولت	cun	None
تنبأ	saadaalin	Nan
تنتج	soosaara	Nan
تنتشر	fidiyay	Nan
تنتقل	guur	None
تمنح	deeqay	Nan
تنتمي	soco	None
تملك	leh	None
تمرد	kacdoon	None
تم	dhameeyay	None
تمارس	dhaqma	None
تمام	waa	None
تماما	ahaanba	None
تماماً	ahaanba	None
تمامًا	ahaanba	None
تمت	dhameeyay	None
تمتاز	heersare	None
تمتد	kala-bixin	Nan
تمتعت	ku	None
تمتلك	haysashada	Nan
تمثال	taallada	Nan
تمثلت	sawir	None
تمثيل	metelaad	Nan
تمر	gudub	Nan
تمكن	maamulay	Nan
تنتهي	dhacayaa	Nan
تنخفض	u	None
تنسيق	isuduwe	Nan
توتونيون	teutonic	Nan
توجد	jira	None
توجه	jihaynta	Nan
توجيه	hanuun	None
توحيد	dejinta	Nan
توزيع	qaybinta	Nan
توسع	fidinta	None
توسعت	la	None
توسيع	fidinta	None
توصل	imaatin	Nan
توصيل	xidhka	None
توضح	caddee	Nan
توضع	lagu	None
توفر	jiritaanka	None
توفى	dhintay	None
توت	buluug	Nan
توافق	ogolaado	Nan
توازن	isku	None
تواجه	wejiga	None
تنشأ	kac	Nan
تنص	gobollada	None
تنظم	abaabul	None
تنظيم	koox	None
تنفيذ	hirgelinta	Nan
تنقسم	kala	None
تنقل	beddelka	Nan
تليها	xiga	None
تنمو	koraan	Nan
تنوع	kala	None
تهتم	daryeel	None
تهدد	hanjabaad	Nan
تهدف	ujeeddooyin	Nan
تهيمن	dulqaadid	Nan
توابل	udgoon	None
تواجد	jiritaanka	None
تنمية	horumarin	Nan
حصن	fort	Nan
تلوث	wasaqda	Nan
تلك	taasi	None
تقدمه	sii	None
تقدمها	bixiyay	None
تقدير	mahadnaq	None
تقديرات	qiyaasta	None
تقديم	gudbi	Nan
تقرر	go&#39;aan	Nan
تقريبا	qiyaastii	None
تقريباً	qiyaastii	None
تقريبًا	qiyaastii	None
تقرير	warbixin	None
تقسم	qaybin	None
تقسيم	qaybinta	Nan
تقضي	bixi	None
تقع	yaal	None
تقف	istaag	Nan
تقدمت	hormarsan	None
تقل	kayar	Nan
تقدم	horumar	None
تقتصر	xaddidan	Nan
تفاعل	is	None
تفاعلات	isdhaxgalka	Nan
تفرض	saar	None
تفسير	sharaxa	Nan
تفصل	saar	None
تفعل	qabanayaan	None
تفقد	laydh	None
تفكك	dhacay	None
تفوق	heersare	None
تفيد	faa&#39;iido	Nan
تقارب	ansaxinta	Nan
تقارير	warbixinno	Nan
تقاليد	caadooyinka	Nan
تقام	qabtay	None
تقبل	aqbal	Nan
تقدر	mahadsanid	Nan
تقلل	yaree	Nan
تقليد	dhaqan	None
تقليدية	ahaan	None
تكنولوجيا	tikniyoolajiyadda	Nan
تكون	noqo	None
تكونت	sameeyay	None
تكوين	sameynta	Nan
تكيف	qabsashada	None
تل	buuraha	None
تلال	koofiyadaha	Nan
تلاميذه	xertiisii	Nan
تلبية	kulan	None
تلت	soco	None
تلعب	ciyaar	None
تلف	dhaawac	None
تلفزيون	tv	None
تلفزيونية	telefishanka	Nan
تلقى	hesho	None
تكن	noqo	None
تكمن	beenso	Nan
تكليس	kilcin	Nan
تكلفة	qiimaha	None
تقليل	yaree	Nan
تقنيات	teknolojiyada	Nan
تقنية	farsamada	None
تقود	hogaanka	None
تقول	yidhi	None
تقوم	kac	Nan
تقوية	xoojinta	None
تلو	kadib	None
تقويم	qiimayn	None
تقييم	qiimayn	None
تكاد	ku	None
تكاليف	qiimaha	None
تكتب	waxay	None
تكثر	buux	Nan
تكرار	ku	None
تكساس	texas	Nan
تقي	leh	None
حصول	hel	Nan
حضارات	degmooyinka	None
حضارة	ilbaxnimo	Nan
ركن	geeska	None
رمزا	astaan	None
رمزية	calaamadaha	Nan
رمسيس	ramses	Nan
رمضان	ramadaan	None
رموز	calaamadaha	Nan
رمي	tuur	None
روابط	xiriirimaha	Nan
رواد	mudanayaal	Nan
رواه	koobaya	None
روايات	buugag	Nan
رواية	sheeko	None
روبرت	robert	Nan
روثينيوم	ruthenium	Nan
روح	ruuxa	Nan
ركام	dhagaxlay	Nan
روس	ross	Nan
رقيقة	caato	None
رقعة	gawaarida	Nan
رصد	kormeer	Nan
رضا	qancinta	Nan
رضي	ku	None
رعاف	epistaxis	Nan
رعاية	daryeel	None
رعد	onkod	Nan
رغبة	rabitaan	Nan
رغم	oo	None
رفض	diidmo	Nan
رفضت	diiday	None
رفضه	diiday	None
رفع	geliso	Nan
رفعت	lifiyay	Nan
رفيعة	jecel	None
رفيق	saaxiib	None
رقم	tirada	None
رشيد	rashiid	None
روستوك	xoolaha	None
روسيا	ruushka	None
زالت	weli	None
زاوية	xagal	Nan
زايد	zayed	Nan
زحف	gurguurasho	Nan
زحل	saturn	Nan
زراعة	beeraha	None
زراعية	beeraha	None
زرع	beero	None
زرنيخيد	arsenide	Nan
زعامة	hogaaminta	Nan
زعماء	hogaamiyaasha	Nan
زعيم	hogaamiye	None
زغلول	zaghloul	Nan
زكريا	sakariye	None
زكي	zaki	Nan
زال	weli	None
روسو	russo	Nan
زار	booqasho	Nan
زاد	kordhay	Nan
روما	rome	None
رومانيا	romania	None
رومانية	roomaania	Nan
رونالدو	ronaldo	Nan
روى	sheegay	None
روي	roy	Nan
رياح	dabayl	Nan
رياض	riad	Nan
رياضة	isboorti	None
رياضية	fudud	None
ريال	kiraan	Nan
ريتشارد	richard	None
ريشة	quill	Nan
ريكشا	riksha	Nan
ريولوجيا	cilmiga	None
زادت	kordhay	Nan
رشد	qaangaarka	Nan
رسوم	ajuurada	Nan
رسول	farriin	Nan
رئاسة	madaxtooyada	None
رئيس	madaxweynaha	None
رئيسا	ahaan	None
رئيساً	ahaan	None
رئيسة	gudoomiye	None
رئيسيا	weyn	None
رئيسياً	weyn	None
رئيسية	weyn	None
رئيسيين	weyn	None
رئيسًا	madaxweynaha	None
رائحة	urta	Nan
رائد	tababar	Nan
رائدة	hogaamiye	None
رائعة	ah	None
رابط	iskuxirka	Nan
رؤيتها	eeg	None
رابطة	ururka	None
رؤية	himilo	Nan
رؤوس	madax	None
ذوات	haweenka	None
ذوي	iyadoo	None
ذي	dhameeyay	None
ذُكر	lab	None
رآه	saw	Nan
رأت	aragtay	None
رأس	madaxa	None
رأسه	madaxiisa	Nan
رأسها	madaxa	None
رأسهم	madaxa	None
رأى	fikrad	None
رأي	fikrad	None
رأيت	arkay	None
رأيه	calan	None
رؤساء	madax	None
رؤيا	aragti	None
رابع	afraad	Nan
راجع	eeg	None
راشد	rashiid	None
رحل	waayey	None
رحلات	doomaha	Nan
رحلة	socdaalka	None
رحلته	duulimaadkiisa	Nan
ردود	jawaabaha	Nan
رسائل	farriimaha	Nan
رسالة	farriin	Nan
رسالته	fariintiisa	Nan
رستم	rustem	Nan
رسم	sawir	None
رسمها	jiiday	Nan
رسمي	ah	None
رسميا	ah	None
رسمياً	ah	None
رسميًا	ah	None
رجم	dhagxan	Nan
رجليها	lugaheeda	Nan
رجلاً	nin	None
رجلا	nin	None
رام	archer	Nan
راية	calan	None
رب	allah	None
ربط	iskuxirka	Nan
ربع	rubuc	Nan
ربما	malaha	None
ربه	sayidow	Nan
زلزال	dhul	None
ربيع	guga	None
رتب	saar	None
رتبة	darajo	None
رجال	ragga	None
رجاله	raggiisii	Nan
رجب	regep	Nan
رجع	noqday	None
رجل	lug	None
ربيعة	rabia	Nan
زمان	waqti	None
زمانه	waqtigiisii	Nan
زمن	waqti	None
سعودية	sacuudiga	None
سعوديون	sacuudi	None
سعى	la	None
سعيد	farxad	None
سفر	safarka	None
سفن	maraakiibta	None
سفيان	soufyan	Nan
سفينة	markab	None
سقراط	socrates	Nan
سقط	soboso	Nan
سقطت	fey	Nan
سقوط	qulqulaya	Nan
سكان	dadka	None
سكانديوم	scandium	Nan
سكانها	dadkeeda	None
سعودي	sacuudiga	None
سكانية	dadweynaha	None
سعود	sacuud	Nan
سعت	waan	None
سراح	daayay	None
سرطان	kansarka	Nan
سرعان	dhaw	None
سرعة	xawaare	Nan
سرقة	xatooyo	Nan
سرو	websaydh	Nan
سري	sirta	None
سرية	sirta	None
سريع	soomi	Nan
سريعة	ah	None
سريعًا	dhaw	None
سطح	sare	None
سطحه	kore	None
سطحها	kore	None
سعاد	sucaad	Nan
سعر	qiimo	None
سكة	tareenka	Nan
سكر	sonkorta	None
سكك	wadooyinka	None
سلوك	dhaqanka	None
سليم	salim	Nan
سليمان	sulaiman	Nan
سم	cm	Nan
سمات	astaamaha	None
سماه	yeedhay	None
سمة	dhaqan	None
سمح	yahay	None
سمحت	ogolyahay	None
سمع	maqlay	None
سمعت	maqlay	None
سمك	kalluun	None
سمي	magacaabay	None
سميت	magacaabay	None
سمير	sameer	Nan
سلمية	nabadoon	None
سلمة	salama	Nan
سلمان	salmaan	Nan
سلم	jaranjarada	Nan
سكن	degenaansho	None
سلاح	hub	None
سلاسل	silsiladaha	Nan
سلاطين	sultans	Nan
سلالات	harag	None
سلالة	cadaadis	None
سلام	salaan	None
سر	sirta	None
سلامة	amniga	None
سلسلة	taxanaha	Nan
سلطات	madaxda	None
سلطان	suldaan	None
سلطة	salaad	None
سلطنة	suldaan	None
سلف	amaaho	Nan
سلفوناميد	sulfonamide	Nan
سلبية	taban	Nan
ذو	dhameeyay	None
سدة	xadhig	None
سحب	ka	None
زيدان	zidane	Nan
زين	saynab	Nan
زينب	saynab	Nan
س	s	None
سأل	weydiiyay	Nan
سؤال	suaal	None
سائر	kale	None
سائل	dareere	Nan
سابق	hore	None
سابقا	hore	None
سابقاً	hore	None
سابقة	hor	None
سابقًا	hore	None
ساحة	dayrka	None
ساحل	xeebta	None
زيد	zaid	Nan
ساحلية	xeebta	None
زيت	saliid	None
زيادة	daro	None
زمني	waqtigeyga	Nan
زمنية	waqtiga	None
زنكي	zinc	Nan
زهرة	ubax	None
زواج	guur	None
زواجه	guurkiisa	Nan
زوال	dhicis	Nan
زوج	ninka	None
زوجات	haweenka	None
زوجاته	xaasaskiisa	Nan
زوجة	naag	None
زوجته	xaaskiisa	Nan
زوجها	ninkeeda	Nan
زوكربيرج	zuckerberg	Nan
زياد	ziyaad	Nan
زيارة	booqasho	Nan
سار	socday	None
ساراكينوس	saracenus	Nan
سارة	sara	Nan
سبعة	toddobo	None
سبعين	todobaatan	Nan
سبق	horeba	None
سبقت	orod	None
سبيس	myspace	Nan
سبيل	wadada	None
ست	lix	None
ستالين	stalin	Nan
ستة	lix	None
ستكون	doontaa	None
ستيرول	dhaqdhaqaaq	None
ستين	lixdan	Nan
سجل	geli	None
سجن	xabsi	None
سحابة	daruuro	None
سبع	toddobo	None
سبحانه	leh	None
سبتمبر	sebtember	Nan
سببا	sababta	None
ساعات	saacadaha	None
ساعة	saac	Nan
ساعد	caawi	Nan
ساعدت	caawiyay	Nan
سافر	safarka	None
سالم	salem	Nan
سامي	sami	Nan
سد	fur	Nan
سامية	subxaanyo	Nan
سانت	st.	Nan
ساهم	ku	None
ساهمت	ku	None
سبأ	sheeba	Nan
سباق	tartan	Nan
سباقات	jinsiyadaha	Nan
سبب	sabab	None
سان	san	None
لتصل	gaaro	None
ذهبية	dahab	None
ذلك	taasi	None
خاصا	ahaan	None
خاصة	ahaan	None
خاصةً	ahaan	None
خاصية	hanti	None
خاض	waaqay	Nan
خاضعة	mawduuc	Nan
خالد	karin	None
خالص	ah	None
خالية	faaruq	Nan
خام	cayriin	Nan
خان	khan	Nan
ختان	gudniinka	Nan
خدمات	adeegyada	None
خدمة	adeeg	None
خديجة	nacayb	None
خاص	ah	None
خرائط	khariidadaha	Nan
خارجية	dibadda	None
خادم	addoon	None
حياتها	nolosheeda	Nan
حياتهم	noloshooda	None
حياتي	noloshayda	Nan
حيان	hayyan	Nan
حية	nolosha	None
حيث	halkee	Nan
حيفا	haifa	Nan
حين	goorma	Nan
حينما	markasta	None
حينها	markaa	None
حيوان	xayawaanka	Nan
حيوانات	xayawaanka	Nan
حيوانية	xayawaanka	Nan
حيوية	dhalashada	None
خابية	kaar	None
خارجي	dibedda	None
حياته	noloshiisa	None
خراسان	khorasan	Nan
خرجت	baxay	None
خطبة	hadalka	None
خطة	qorshe	None
خطر	halista	Nan
خطط	qorshooyinka	Nan
خطف	afduub	Nan
خطوة	tallaabo	Nan
خطورة	khatar	None
خطوط	khadadka	Nan
خطيرة	ah	None
خفض	u	None
خفيف	iftiin	Nan
خفيفة	iftiimin	Nan
خلاف	muran	None
خلافته	guushiisii	Nan
خلال	oo	None
خطاب	hadalka	None
خرج	baxay	None
خطأ	cilad	Nan
خضعت	maray	None
خرجوا	baxeen	None
خروج	ka	None
خريطة	khariidad	Nan
خزيمة	guuldareystay	Nan
خسائر	khasaare	Nan
خسارة	guuldarro	Nan
خسر	lumiyay	Nan
خصائص	guryaha	None
خصبة	ciid	None
خصوصا	ahaan	None
خصوصاً	ahaan	None
خصوصًا	ahaan	None
خصومه	muran	None
خضراء	cagaar	Nan
خضع	mawduuc	Nan
خط	khad	None
حياة	nolosha	None
حي	deriska	None
حولها	wareegsan	None
حكام	taliyayaasha	Nan
حكايات	sheeko	None
حكاية	sheeko	None
حكم	xeerka	None
حكمة	xikmad	None
حكمت	waxay	None
حكمه	xikmad	None
حكمها	xeerkeeda	Nan
حكمهم	xeerkooda	Nan
حكومات	dowladaha	None
حكومة	dowlada	None
حكومي	dawladnimo	None
حكومية	dawladnimo	None
حكيم	sage	Nan
حلال	xalaal	Nan
حقيقية	xaqiiqada	None
حلب	aleppo	Nan
حقيقي	ah	None
حقول	beeraha	None
حضر	galay	None
حضور	joogitaanka	Nan
حطين	hittin	Nan
حظر	mamnuuc	Nan
حفر	qodista	Nan
حفظ	badbaadin	Nan
حفل	xisbi	None
حق	sax	None
حقائق	xaqiiqooyinka	Nan
حقبة	xil	None
حقق	guul	None
حققت	guul	None
حقل	duurka	None
حقه	xaqdiisa	Nan
حقوق	xuquuqda	None
حقيقة	xaqiiqda	None
حلت	diray	None
حلف	dharka	None
حلقات	dhacdooyinka	None
حمير	dameeraha	Nan
حنا	hanna	Nan
حنبعل	hannibal	Nan
حنبل	hanbal	Nan
حنك	carte	None
حنيفة	hanifa	Nan
حنين	nostalgia	Nan
حواء	xaawo	None
حوادث	shilalka	Nan
حوار	wadahadal	None
حوالي	hareeraha	None
حوذانية	butercup	Nan
حوض	berkadda	Nan
حول	saabsan	None
حوله	wareegsan	None
حملته	ololihiisa	Nan
حملت	xirmay	Nan
حملة	olole	None
حملات	ololeyaal	Nan
حلقة	garaac	Nan
حلمي	riyadayda	Nan
حلول	xalka	Nan
حلويات	nacnac	Nan
حماة	difaacayaasha	Nan
حماد	xammad	Nan
حماس	jab	None
خلاله	lagu	None
حماية	ilaalin	None
حمدان	hamdan	None
حمدي	xamdi	Nan
حمراء	casaan	Nan
حمزة	xamsa	None
حمص	digaagga	Nan
حمض	aashito	Nan
حمل	uurka	Nan
حمد	wuu	None
خلالها	lagu	None
خلايا	unugyada	None
خلدون	khaldoun	Nan
دورات	koorsooyinka	Nan
دوران	wareejin	None
دوراً	door	None
دورة	koorso	Nan
دوره	koorso	Nan
دورها	doorkeeda	Nan
دوري	baaskiil	Nan
دورية	roondo	Nan
دورًا	door	None
دول	wadamada	None
دولار	doolar	Nan
دولة	wadan	None
دولته	dalkiisa	None
دولتهم	gobolkooda	Nan
دولتين	gobol	None
دورا	door	None
دولي	ah	None
دور	doorka	None
دو	du	None
دفن	aaska	Nan
دقائق	daqiiqado	Nan
دقة	sax	None
دقيق	dhir	None
دقيقة	sax	None
دلائل	caddayn	None
دلالة	tilmaam	Nan
دلتا	delta	Nan
دليل	tilmaanta	Nan
دم	dhiig	None
دمج	dar	None
دمرت	baaba&#39;ay	Nan
دمشق	dimishiq	None
دمياط	damietta	Nan
دنيا	donia	Nan
دوائر	wareegyada	Nan
دولياً	ahaan	None
دولية	caalami	None
دون	la’aan	Nan
ذاته	ah	None
ذاتها	iskeed	Nan
ذاتي	mawduuc	Nan
ذاتية	u	None
ذاك	taasi	None
ذاكرة	xusuusta	Nan
ذرات	atom	None
ذروة	gabagabadii	Nan
ذروتها	dhammaystir	Nan
ذرية	farac	None
ذكر	lab	None
ذكره	xusan	None
ذكرها	sheeg	None
ذكرى	xusuusta	Nan
ذكور	lab	None
ذات	laxiriira	Nan
ذا	the	None
ديوان	diwan	Nan
دينًا	diinta	None
دياب	diab	Nan
ديانة	diinta	None
دير	keniisad	Nan
ديزني	disney	Nan
ديسمبر	dec	None
ديفنباخيا	devenpachia	Nan
ديفيد	daa’uud	Nan
دفعت	bixiyay	None
ديل	dell	Nan
دين	deyn	Nan
دينار	dinar	Nan
ديناصور	diinsoor	None
دينه	diintiisa	None
دينهم	diintooda	None
ديني	diinta	None
دينية	diin	None
ديمقراطية	dimuqraadiyadda	None
ذهب	tag	Nan
دفعة	bixiyay	None
دعى	wuu	None
خوف	cabsi	None
خوفو	khufu	Nan
خياطة	tolidda	Nan
خيبر	khaibar	Nan
خير	fiican	None
د	dr	None
دا	s	None
داء	cudur	None
دائرة	goobaabin	Nan
دائرية	wareeg	Nan
دائم	ah	None
دائما	jeer	None
دائماً	jeer	None
دائمة	jeer	None
دائمًا	jeer	None
خوسيه	jose	Nan
داخل	gudaha	None
خوان	juan	Nan
خمسة	shan	None
خلع	iska	None
خلف	gadaal	None
خلفاء	ku-xigeennada	Nan
خلفه	gadaal	None
خلفها	bidix	None
خلفية	asalka	None
خلقه	abuurkiisa	Nan
خلل	cillad	Nan
خلنجية	heather	Nan
خلية	qolka	Nan
خليج	bay	None
خليط	isku	None
خليفة	guuleystaha	Nan
خليل	khaliil	None
خمس	shan	None
خمسين	konton	Nan
داخلي	gudaha	None
داخلية	gudaha	None
دار	guri	None
درس	cashar	Nan
درع	gaashaan	None
درهم	aed	Nan
دروس	casharrada	Nan
درويش	darwiish	Nan
دريد	duraid	Nan
دستور	dastuurka	None
دستوري	dastuurka	None
دستورية	dastuurka	None
دعا	wac	Nan
دعاء	ducada	None
دعت	way	None
دعم	taageero	None
دعوة	wac	Nan
دعوته	wicitaankiisa	Nan
درجة	degree	None
درجات	shahaadooyinka	Nan
درب	dariiqa	Nan
دراما	riwaayadaha	Nan
دارت	dart	Nan
داروين	darwin	Nan
دام	dhimatay	None
دامت	inta	None
داود	daa’uud	Nan
داوود	daa’uud	Nan
دبلوماسية	diblomaasiyadda	Nan
دفع	bixi	None
دبي	dubai	None
دخل	dakhli	Nan
دخلت	galay	None
دخول	gal	None
دخوله	galitaanka	Nan
دراسات	waxbarasho	None
دراسته	baro	None
دراسية	daraasad	Nan
دجلة	tigris	Nan
لتطور	loo	None
لتطوير	loo	None
لتعداد	loo	None
وتكون	noqo	None
وتكوين	iyo	None
وتلك	kuwa	None
وتم	noqotay	None
وتمت	noqotay	None
وتمتد	kala-bixin	Nan
وتمتلك	leh	None
وتمثل	oo	None
وتمكن	wuu	None
وتنتج	saartaa	None
وتنتشر	oo	None
وتنظيم	iyo	None
وتنقسم	kala	None
وتهدف	ujeedada	None
وتوجد	jira	None
وتقوم	ku	None
وتوزيع	iyo	None
وتقول	tidhi	None
وتقدم	siiyay	None
وتطور	waxay	None
وتطورت	baxday	None
وتطوير	oo	None
وتظهر	oo	None
وتعالى	badan	None
وتعتبر	la	None
وتعتمد	waxay	None
وتعد	is	None
وتعرف	ogtahay	None
وتعزيز	iyo	None
وتعمل	way	None
وتعني	jeedaa	None
وتعود	noqo	None
وتعيين	dejiyey	None
وتغطي	daboolida	None
وتقع	dhicitaan	Nan
وتطبيق	codsi	None
وتوفي	dhintay	None
وتونس	tunisiya	None
وجعلها	oo	None
وجل	dhaafay	None
وجمع	oo	None
وجمهورية	jamhuuriyad	None
وجميع	dhamaan	None
وجنوب	koonfurta	None
وجه	wejiga	None
وجهات	goobaha	None
وجهة	gaaritaan	Nan
وجهه	wejigiisa	Nan
وجهها	wejigeeda	None
وجوب	waajib	None
وجود	joogitaanka	Nan
وجوده	joogitaankiisa	Nan
وجودها	jiritaankeeda	None
وجعل	oo	None
وتولى	qaatay	None
وجزيرة	jasiirad	None
وجدير	tahay	None
وتيرة	xawaare	Nan
وثائق	dukumiintiyada	Nan
وثائقي	dokumenti	Nan
وثاني	labaad	None
وثلاثة	saddex	None
وثلاثون	soddon	None
وثلاثين	soddon	None
وثيقة	dokumenti	Nan
وجاء	yimid	None
وجاءت	timid	None
وجامعة	jaamacad	None
وجبال	buuro	None
وجبل	buur	None
وجد	helay	None
وجدت	helay	None
وجزر	jasiirado	None
وتضم	wadarta	None
وتصل	ilaa	None
وتصبح	noqo	None
وبريطانيا	ingiriiska	None
وبسبب	ah	None
وبشكل	qaab	None
وبصفة	qaab	None
وبعد	weliba	None
وبعدها	dibna	None
وبعض	qaar	None
وبعضها	waa	None
وبعضهم	ah	None
وبقي	joogaa	None
وبقية	kalena	None
وبقيت	joogay	None
وبلاد	wadan	None
وبلغ	oo	None
وبلغاريا	bulgaria	None
وبذلك	intaa	None
وبلغت	ku	None
وبدأت	bilaabatay	None
وبخاصة	ahaan	None
وبأن	taas	None
وباء	ah	None
وباقي	kalena	None
وباكستان	iyo	None
وبالأخص	ahaan	None
وبالإضافة	dheer	None
وبالتالي	daraaddeed	None
وبالتحديد	ahaan	None
وبالرغم	oo	None
وبالفعل	runtii	None
وبالمثل	kale	None
وبالنسبة	iyo	None
وبحر	badda	None
وبحسب	xigtay	None
وبحلول	qoray	None
وبدأ	bilaabay	None
وبما	ku	None
وبناء	dhiso	None
وبناءً	ah	None
وتحسين	oo	None
وتحقيق	iyo	None
وتحليل	iyo	None
وتحمل	qaado	None
وتختلف	yihiin	None
وتربية	iyo	None
وترجمت	oo	None
وترك	ka	None
وتركيا	turkiga	None
وتستخدم	isticmaalaa	None
وتسعين	sagaashan	Nan
وتسمى	yeedhay	None
وتشكل	isqurxin	Nan
وتشمل	dar	None
وتشير	oo	None
وتحديد	iyo	None
وتحدث	hadlay	None
وتحتوي	hayaa	None
وتحتل	qabsadeen	None
وبنى	dhisay	None
وبه	leh	None
وبها	leh	None
وبهذا	tan	None
وبين	dhaxaysa	None
وبينما	intii	None
وتأتي	oo	None
وجوه	walax	Nan
وتأسيس	iyo	None
وتبادل	is	None
وتبلغ	gaadhay	None
وتتضمن	ah	None
وتتكون	tahay	None
وتتم	yeelay	None
وتتميز	saaray	None
وتحت	hooseeya	None
وتاريخ	taariikh	None
واهتم	is	None
وجيزة	koob	None
وحتى	xitaa	None
وصل	imaatin	Nan
وصلات	xiriirimaha	Nan
وصلت	gaarmay	Nan
وصلوا	gaaray	None
وصناعة	warshadaha	None
وصنع	sameeyay	None
وصول	gaaritaan	Nan
وصوله	imaanshaha	Nan
وصية	doono	None
وضرب	oo	None
وضع	gelin	None
وضعت	horumariyay	Nan
وضعف	tabardarro	Nan
وضعها	hoos	None
وطرق	iyo	None
وصفه	recipe	Nan
وطريق	waddo	None
وصفاته	astaamihiisii	Nan
وصدر	daayay	None
وسرعان	soon	None
وسط	xarunta	None
وسقوط	dhaca	None
وسلم	isaga	None
وسميت	yeedhay	None
وسوريا	suuriya	None
وسوق	suuq	None
وشبه	iyo	None
وشرح	oo	None
وشرق	bariga	None
وشركة	shirkad	None
وشمال	woqooyi	None
وشهد	arkay	None
وشهدت	arkay	None
وصار	noqotay	None
وصف	sifee	Nan
وسبب	sabab	None
وطريقة	habka	None
وطن	hooyo	None
وعرض	bandhigay	None
وعرف	wuu	None
وعرفت	gartay	None
وعشرون	labaatan	None
وعشرين	labaatan	None
وعضو	xubin	None
وعقد	xaji	None
وعلاوة	dheer	None
وعلم	iyo	None
وعلماء	iyo	None
وعلوم	cilmiga	None
وعلى	dusha	None
وعلي	dusha	None
وعليه	dusha	None
وعمر	cumar	None
وعدم	noqon	None
وطلب	waydiiyay	None
وعددها	iyo	None
وعد	qaad	None
وطني	qaranka	None
وطنية	waddaniyad	Nan
وظائف	xirfadaha	Nan
وظل	oo	None
وظلت	joogtay	None
وظهر	muuqday	None
وظهرت	muuqatay	None
وظهور	muuqaalka	None
وظيفة	shaqo	None
وعاد	noqday	None
وعادة	iyo	None
وعاش	noolaa	None
وعاصمتها	caasimadeeda	Nan
وعبد	addoomo	None
وعبر	ahaan	None
وعدد	tiro	None
وسام	wissam	Nan
وساعد	way	None
وسائل	macnaheedu	None
وحيدة	kali	None
وحين	iyo	None
وخاصة	ahaan	None
وخاصةً	ahaan	None
وخرج	baxay	None
وخصوصا	ahaan	None
وخصوصاً	ahaan	None
وخصوصًا	ahaan	None
وخلال	marayo	None
وخلفه	iyo	None
وخلق	iyo	None
وخمسين	iyo	None
ودار	guri	None
ودخل	gashay	None
ودراسة	waxbarasho	None
وحيد	hal	None
ودرجة	shahaado	None
وحيث	halka	None
وحول	saabsan	None
وحدات	cutubyo	Nan
وحدة	kali	None
وحده	kali	None
وحدها	kali	None
وحركة	dhaqdhaqaaq	None
وحرية	iyo	None
وحسب	kaliya	None
وحسن	wanaag	None
وحصل	helay	None
وحضر	soo	None
وحفظ	oo	None
وحقوق	xuquuqda	None
وحكم	xukun	None
وحماية	ilaali	None
وحمل	soo	None
وحي	dhiirigelin	None
ودرس	bartay	None
ودعا	yeedhay	None
ودعت	way	None
ورغم	oo	None
ورفض	diiday	None
ورفع	qaad	None
ورق	warqad	None
ورقة	xaashi	None
وروسيا	ruushka	None
وزاد	oo	None
وزارة	wasaaradda	None
وزراء	wasiiro	None
وزن	miisaan	None
وزوجته	iyo	None
وزيادة	inbadan	None
وزيت	saliid	None
وزير	wasiir	None
وسائر	dhan	None
وردت	helay	None
وردة	ubax	None
ورد	ubax	None
ورجال	ragga	None
ودعم	taageero	None
ودفن	aasay	None
ودمشق	dimishiq	None
ودور	door	None
ودول	dalal	None
ودولة	wadan	None
ودون	iyo	None
وحاول	isku	None
وذكر	yidhi	None
وذهب	tegey	None
ورأى	arkay	None
ورئيس	madaxa	None
وراء	gadaal	None
وراثيا	ahaan	None
وراح	tegey	None
وربما	laga	None
وذلك	taas	None
وانخفاض	hooseeya	None
وانتهى	way	None
وانتهت	waana	None
والبعض	qaar	None
والبنية	qaab	None
والبيئة	deegaanka	None
والتاريخ	taariikh	None
والتجارة	ganacsiga	None
والتحليل	iyo	None
والتخلص	ka	None
والتدريب	iyo	None
والتطور	horumar	None
والتطوير	horumarka	None
والتعاون	iskaashi	None
والتعليم	waxbarashada	None
والتقاليد	iyo	None
والتكنولوجيا	iyo	None
والتلفزيون	tv	None
والبحرين	baxrayn	None
والتنمية	horumarka	None
والبحرية	badda	None
والباحثين	iyo	None
والإسلام	islaamka	None
والإسلامية	islaamka	None
والإعلام	warbaahinta	None
والإمارات	iyo	None
والإمام	imaamka	None
والإمبراطورية	boqortooyada	None
والإنسان	aadanaha	None
والإيمان	iimaanka	None
والاتحاد	midowga	None
والاتصالات	isgaadhsiinta	None
والاجتماعي	bulshada	None
والاجتماعية	bulshada	None
والاقتصاد	dhaqaalaha	None
والاقتصادي	ahaan	None
والاقتصادية	dhaqaale	None
والبحر	badda	None
والإدارة	maaraynta	None
والتوزيع	iyo	None
والثالث	saddexaad	None
والحرية	iyo	None
والحزب	iyo	None
والحسن	wanaag	None
والحسين	iyo	None
والحضارة	iyo	None
والحفاظ	ilaali	None
والحكم	xukun	None
والحكومات	dowladaha	None
والحكومة	dowladda	None
والحياة	nolosha	None
والحيوانات	xoolaha	None
والخارجية	dibaddana	Nan
والخاصة	ah	None
والخدمات	adeegyo	None
والد	aabe	None
والحروب	dagaalo	None
والتي	taas	None
والحركة	dhaqdhaqaaq	None
والحديد	bir	None
والثاني	labaad	None
والثانية	labaad	None
والثقافة	dhaqanka	None
والجامعات	jaamacadaha	None
والجدير	mudan	None
والجزء	qaybta	None
والجزائر	aljeeriya	None
والجزر	jasiirado	None
والجماعة	kooxda	None
والجمال	qurux	None
والجنوب	koonfurta	None
والجنوبية	koonfurta	None
والجيش	ciidankii	None
والحجاز	iyo	None
والحديث	hadal	None
والحرب	dagaalkii	None
والأنهار	wabiyaal	None
والأنصار	taageerayaasha	None
والأميرة	boqoraddii	None
وإنشاء	iyo	None
وإنما	halkii	None
وإيران	iran	None
وإيطاليا	talyaaniga	None
وائل	wael	Nan
وابن	wiil	None
وابنه	wiilkiisa	None
واجب	waajib	None
واجه	wejiga	None
واجهة	dhex-dhexaadin	Nan
واجهت	wejigiisii	Nan
واحد	mid	None
واحدا	mid	None
واحداً	mid	None
واحدة	mid	None
وإنتاج	saar	None
واحدًا	mid	None
وإن	hubaal	None
وإلا	kale	None
وأهمها	muhiimsan	None
وأوائل	hore	None
وأوروبا	yurub	None
وأول	horreeyay	None
وأي	kasta	None
وأيضا	kale	None
وأيضاً	kale	None
وأيضًا	kale	None
وإدارة	maaraynta	None
وإذا	hadday	None
وإسبانيا	iyo	None
وإسرائيل	binu	None
وإعادة	iyo	None
وإعلان	iyo	None
وإقامة	iyo	None
وإلى	iyo	None
وادي	dooxada	None
وارتفاع	oo	None
واستخدام	isticmaal	None
والآلات	iyo	None
والأحزاب	iyo	None
والأخرى	kale	None
والأخلاق	akhlaaqda	None
والأدب	suugaanta	None
والأراضي	iyo	None
والأردن	iyo	None
والأرض	dhulkii	None
والأطفال	caruur	None
والأعمال	ganacsi	None
والأفكار	iyo	None
والأكثر	inbadan	None
والأمراء	iyo	None
والأمن	amniga	None
والأمير	amiirka	None
والآداب	dhaqan	None
والآخر	kalena	None
والآثار	saamaynta	None
واقعة	dhacdo	None
واستخدم	isticmaal	None
واستطاعت	guulaysatay	None
واستمر	waday	None
واستمرت	waday	None
واسع	balaadhan	None
واسعة	balaadhan	None
واسم	magac	None
والدة	hooyo	None
واسمه	magaciisa	None
واصل	sii	None
واضح	nadiifi	Nan
واضحة	nadiifi	Nan
واعتبر	loo	None
وافق	ogolaaday	None
وافقت	ogolaaday	None
واقع	xaqiiqada	None
واشنطن	washington	Nan
والدته	hooyadiis	None
والدراسات	iyo	None
والدفاع	difaaca	None
والماء	biyo	None
والمحيط	baddii	None
والمدارس	iskuulada	None
والمدن	magaalooyin	None
والمدينة	magaaladii	None
والمرأة	naagta	None
والمسجد	masaajidka	None
والمسيحية	iyo	None
والمسيحيين	iyo	None
والمعادن	iyo	None
والمعاهد	iyo	None
والمعدات	qalab	None
والمعراج	milatariga	None
والمعرفة	aqoon	None
والمعروف	yaqaan	None
والمؤسسات	iyo	None
والمعروفة	yaqaan	None
والله	ku	None
واللغات	afafka	None
والفيزياء	iyo	None
والقانون	sharciga	None
والقدرة	karti	None
والقرآن	iyo	None
والقضاء	iyo	None
والقمر	dayaxa	None
والقوات	xoogag	None
والقوانين	iyo	None
والقوة	xoog	None
والكتاب	buugga	None
والكتابة	oo	None
والكثير	ah	None
والكنيسة	kaniisadda	None
والكواكب	iyo	None
والكيمياء	iyo	None
واللغة	af	None
والمغرب	iyo	None
والمكسيك	iyo	None
والملك	boqorkii	None
والهند	hindiya	None
والهندسة	iyo	None
والواقع	ahaantii	None
والولايات	gobolada	None
والي	wali	None
واليابان	jabaan	None
واليمن	yemen	None
واليهود	iyo	None
واليهودية	yahuudda	None
واليوم	maantana	None
واليونان	giriigga	None
وان	hubaal	None
وانتشار	oo	None
وانتشر	wuu	None
وانتشرت	faafay	None
والهرسك	iyo	None
والنهاية	ugu	None
والنمسا	iyo	None
والنقل	gaadiid	None
والمملكة	boqortooyada	None
والمناخ	cimilada	None
والمناطق	gobolada	None
والمنتجات	iyo	None
والمنطق	gal	None
والمنطقة	gobolka	None
والمواد	iyo	None
والفنون	farshaxanka	None
والمواصلات	gaadiidka	None
والمياه	biyo	None
والنباتات	dhir	None
والنجوم	iyo	None
والنرويج	norwey	None
والنساء	dumarka	None
والنسيج	dharka	None
والنقد	dhaliil	None
والموسيقى	muusig	None
وعن	saabsan	None
والفن	iyo	None
والفلسفة	iyo	None
والسبب	sababta	None
والسعودية	sacuudiga	None
والسلام	nabad	None
والسنة	sanadka	None
والسودان	suudaan	None
والسويد	sweden	None
والسياسة	siyaasada	None
والسياسي	siyaasiga	None
والسياسية	siyaasad	None
والسيطرة	oo	None
والشام	reer	None
والشرق	bariga	None
والشركات	shirkadaha	None
والشعر	timo	None
والشمال	waqooyi	None
والسادس	lixaad	None
والشيخ	sheekh	None
والزهرة	iyo	None
والزبير	iyo	None
والدليل	cadaynta	Nan
والده	hooyo	None
والدها	aabaheed	Nan
والدول	dawladaha	None
والدولة	gobolka	None
والدين	waalidiinta	Nan
والدينية	diin	None
والذي	yaa	None
والذين	yaa	None
والرئيس	madaxweynaha	None
والرابع	kii	None
والرومان	roomaanka	None
والرومانية	roomaaniyiinta	None
والرياح	iyo	None
والرياضيات	xisaabta	None
والزراعة	beeraha	None
والشيعة	shiites	Nan
والصفات	astaamaha	None
والصلاة	salaadda	None
والعلوم	sayniska	None
والعمارة	qaab	None
والعمل	shaqeeyaan	None
والعمليات	iyo	None
والعناية	is	None
والغابات	kaymaha	None
والغاز	iyo	None
والغرب	galbeedka	None
والغربية	galbeedka	None
والغناء	heesta	None
والفارسية	reer	None
والفرات	webiga	None
والفرنسية	faransiis	None
والفضة	lacag	None
والفقه	xukunka	None
والعلمية	cilmi	None
والعلماء	iyo	None
والعلم	sayniska	None
والعلاقات	iyo	None
والصناعات	warshadaha	None
والصناعة	warshadaha	None
والصين	shiinaha	None
والطاقة	tamar	None
والطب	daawo	None
والطيور	shimbiraha	None
والعالم	iyo	None
والفلك	cilmiga	None
والعديد	badan	None
والعرب	carabtii	None
والعربية	carabi	None
والعسكرية	militariga	None
والعشرون	labaatan	None
والعشرين	labaatan	None
والعطلات	iyo	None
والعلاج	iyo	None
والعراق	ciraaq	None
وعند	iyo	None
وعندها	dibna	None
وعين	magacaabay	None
يستخدمون	adeegsadaan	None
يستطع	karaa	None
يستطيع	karaa	None
يستعمل	loo	None
يستقبل	hesho	None
يستمر	sii	None
يسجل	diiwaangelinta	Nan
يسعى	raadinta	Nan
يسكن	toos	None
يسمح	u	None
يسمى	yaqaan	None
يسميه	wuu	None
يسهل	fududeeya	Nan
يسود	sare	None
يسوع	ciise	None
يستخدمها	wuxuu	None
يسيطر	xakamaynta	Nan
يستخدم	adeegsada	Nan
يسبب	keena	None
يركز	saar	None
يرمز	astaamaha	None
يرون	arkaan	None
يروى	sheeg	None
يروي	sheeg	None
يرى	arko	None
يريد	rabaa	None
يريفان	yerevan	Nan
يزال	weli	None
يزداد	sii	None
يزيد	kordhinta	None
يسار	bidix	None
يساعد	i	None
يساهم	adkayn	Nan
يساوي	isleeg	None
يسبق	hordhac	None
يرفع	hadiyado	Nan
يشار	xigasho	Nan
يشبه	u	None
يصيب	dhacdaa	None
يضاف	daray	None
يضع	dheereeya	Nan
يضم	guri	None
يضمن	qaad	None
يطلب	codsiyada	Nan
يطلق	bilaabid	Nan
يظل	hadhaagii	Nan
يظهر	soo	None
يعادل	u	None
يعانون	dhibane	Nan
يعاني	dhibaatooyinka	None
يعبر	gudub	Nan
يعتبر	tixgelin	Nan
يعتبره	waxaa	None
يصنع	samee	Nan
يشارك	leh	None
يصلي	wuu	None
يصف	sifee	Nan
يشتمل	jira	None
يشتهر	yahay	None
يشرب	wuu	None
يشرف	maamuus	Nan
يشعر	dareen	None
يشغل	socdaa	None
يشكل	jidadka	Nan
يشكلون	isqurxin	Nan
يشمل	jira	None
يشهد	markhaati	Nan
يشير	muujisaa	Nan
يصبح	noqo	None
يصح	sax	None
يصدر	saaray	None
يصعب	dhibaato	None
يصل	gaaritaan	Nan
يرفض	diiday	None
يرغب	rabaa	None
يرسل	dirayaa	Nan
يحتاج	baahi	None
يحتفظ	hayaa	None
يحتفل	dabaaldeg	Nan
يحتل	dhacdooyin	None
يحتمل	suurtagal	Nan
يحتوي	hayso	None
يحد	xadka	None
يحدث	dhacdo	None
يحدد	go’aaminta	Nan
يحدها	xudduudda	Nan
يحصل	helitaanka	None
يحضر	keen	Nan
يحق	leeyahay	None
يحقق	guul	None
يحكم	xukuntay	Nan
يحب	jeceshahay	Nan
يحل	xal	None
يحاول	isku	None
يجمع	ururinaya	Nan
يتواجد	jira	None
يتوقع	filo	Nan
يتوقف	way	None
يتولى	la	None
يتيح	u	None
يثبت	caddayn	None
يثرب	yathrib	Nan
يجب	in	None
يجتمع	buuxiyo	Nan
يجد	soo	None
يجري	ahaan	None
يجعل	dhigaysa	None
يجعله	dhigaysa	None
يجعلها	dhigaysa	None
يجلس	fadhiya	None
يجوز	yahay	None
يحمل	qaado	None
يحملون	qaadaan	None
يحمي	ilaali	None
يده	gacantiisa	None
يدور	dhibco	Nan
يدي	gacantayda	Nan
يدير	maareyn	Nan
يديه	gacmihiisa	Nan
يذكر	fahmay	None
يذهب	tagaa	None
يرابيع	adeeg	None
يراه	arkaa	None
يراها	arkaa	None
يربط	lifaaq	Nan
يرتبط	xiriir	None
يرتفع	kac	Nan
يرجع	sababta	None
يرد	jawaab	Nan
يدل	diidmo	Nan
يدفع	bixi	None
يدعي	ku	None
يدعى	ku	None
يحوي	waxaa	None
يحيط	xeeran	None
يحيى	yahia	Nan
يختار	xullo	Nan
يختلف	kala	None
يخدم	adeeg	None
يخرج	dibedda	None
يعتبرون	way	None
يخص	salaan	None
يد	gacanta	None
يدخل	galaya	Nan
يدرس	waxbarista	Nan
يدرك	xaqiiji	Nan
يدعم	taageerooyinka	Nan
يدعو	wicitaan	Nan
يدعون	way	None
يخضع	mawduuc	Nan
يعترف	oggolaanaya	Nan
يعتقد	rumaysan	None
يعتقدون	waxay	None
ينتمون	soco	None
ينتمي	leh	None
ينتهي	dhammayn	Nan
ينجب	dhalasho	None
ينجح	guul	None
ينزل	dhaca	None
ينسب	bandhigay	None
ينشأ	qalalaase	None
ينص	gobollada	None
ينطبق	codsi	None
ينظر	eegid	Nan
ينظم	abaabul	None
ينقسم	kala	None
ينقل	gudbinta	Nan
ينكر	diidmo	Nan
ينتقل	guur	None
يهتم	daryeelo	Nan
ينتشر	faafin	Nan
ينتج	soosaarid	Nan
يمثل	wakiil	None
يمثلون	dhaqmaan	None
يمكن	karaa	None
يمكننا	waan	None
يمكنه	wuu	None
يمكنها	waa	None
يملك	leh	None
يمنع	ka	None
يموت	dhimasho	None
يميز	kala	None
يميل	go&#39;aan	Nan
يمين	sax	None
ينادي	wicitaan	Nan
ينبع	jirridaha	Nan
ينبغي	in	None
ينتخب	doorto	None
يهدف	ujeedada	None
يهود	ah	None
يهودي	ah	None
يومًا	maalmo	None
يونانية	giriig	None
يونايتد	united	None
يونيو	juun	None
يوهان	yooxanaa	Nan
يَملك	leh	None
يُحتمل	suurtagal	Nan
يُسمى	yaqaan	None
يُشكل	sameeyay	None
يُطلق	bilaabid	Nan
يُظهر	soo	None
يُعتقد	rumaysan	None
يُعد	diyaari	Nan
يُعرف	yaqaan	None
يُقال	tiri	None
يوميا	walba	None
يومنا	maalinteenna	Nan
يوماً	maalin	None
يوما	maalmo	None
يهودية	ah	None
يهوذا	reer	None
يو	yo	Nan
يواجه	wejiyada	Nan
يوان	yuan	Nan
يوتيوب	youtube-ka	Nan
يوجد	jiraan	None
يمتلك	haysashada	Nan
يوحنا	yooxanaa	Nan
يوسف	yousuf	Nan
يوضح	riwaayadaha	Nan
يوفر	bixisaa	None
يولد	dhashay	None
يوليو	luulyo	None
يوم	maalin	None
يومئذ	taas	None
يوروبيوم	yurubiyaan	Nan
يتناول	ka	None
يمتد	bixin	None
يمارس	ku	None
يغطي	daboolida	None
يغلب	beat	Nan
يغير	beddel	Nan
يفتح	furaa	Nan
يفترض	malaha	None
يفرض	buuxiya	Nan
يفسر	wuxuu	None
يفصل	saar	None
يفضل	la	None
يفعل	samee	Nan
يفقد	laydh	None
يفكر	ka	None
يفهم	fahmay	None
يفوز	guul	None
يفوق	dhaafay	None
يعين	naqshadeeyayaasha	Nan
يفيد	faa&#39;iido	Nan
يعيشون	noolyihiin	None
يعيد	celi	None
يعتمد	waxay	None
يعد	diyaari	Nan
يعرض	bandhigay	None
يعرف	yaqaan	None
يعرفه	yaqaan	None
يعرفون	way	None
يعطي	sii	None
يعقوب	yacoub	Nan
يعكس	muujinaya	None
يعلم	ogow	Nan
يعلن	ku	None
يعمل	shaqeynaya	None
يعملون	shaqeynaya	None
يعني	micnaheeda	None
يعود	soo	None
يعيش	toos	None
يقارب	qiyaas	None
يقال	tiri	None
يقام	meel	None
يقيم	nolosha	None
يكاد	ku	None
يكتب	qoraa	None
يكثر	buux	Nan
يكفي	filan	None
يكن	noqon	None
يكون	la	None
يكونوا	waa	None
يكونون	waa	None
يلاحظ	ogeysiis	Nan
يلتقي	kulan	None
يلزم	baahan	None
يلعب	ciyaar	None
يلقى	gaarsiin	Nan
يلي	soco	None
يقومون	sameeyaan	None
يقوم	kac	Nan
يقولون	dhaheen	None
يقول	yidhi	None
يقبل	waan	None
يقتصر	tahay	None
يقتل	dil	None
يقدر	qadarin	Nan
يقدم	bixisaa	None
يقرأ	waa	None
يقرب	qiyaas	None
يمارسون	dhaqmaan	None
يقسم	dhaarista	Nan
يقضي	bixiya	None
يقع	yaal	None
يقف	istaaga	Nan
يقل	hoos	None
يقلل	yareyn	Nan
يقم	bidix	None
يقود	wadista	Nan
يقصد	micnaheeda	None
وأهم	muhiimsan	None
يتميز	muujinta	Nan
يتمتعون	ku	None
ولعلّ	malaha	None
ولغة	af	None
ولقب	cinwaanka	None
ولقد	waan	None
ولكل	kasta	None
ولكنه	waa	None
ولكنها	waa	None
ولكنهم	waa	None
ولكي	iyo	None
ولم	uusan	None
ولما	sababta	None
ولمّا	sababta	None
وله	isaga	None
ولها	iyada	None
ولهذا	awgeed	None
ولعل	malaha	None
ولو	xitaa	None
ولذلك	darteed	None
ولديه	leeyahay	None
وكيف	sida	None
ولأن	yeelay	None
ولا	midkoodna	Nan
ولاة	maamulayaasha	Nan
ولادة	dhalasho	None
ولادته	dhalashadiisa	Nan
ولاسيما	ahaan	None
ولايات	gobollada	None
ولاية	gobolka	None
ولايته	amarkiisa	Nan
ولبنان	lubnaan	None
ولد	wiil	None
ولدت	dhashay	None
ولده	wiilkiisa	None
ولدى	waan	None
ولذا	darteed	None
وكوريا	kuuriya	None
ولي	ilaaliyaha	None
وليبيا	liibiya	None
ومسلم	muslim	None
ومصر	masar	None
ومع	leh	None
ومعرفة	oo	None
ومعظم	badan	None
ومعناها	micnaheeda	None
ومعه	isaga	None
ومكان	meel	None
ومما	waxa	None
ومملكة	boqortooyo	None
ومن	ka	None
ومناطق	gobolada	None
ومنذ	iyo	None
ومنطقة	iyo	None
ومنظمة	urur	None
ومسجد	masaajid	None
وليام	william	Nan
ومركز	xarunta	None
ومراجع	iyo	None
وليد	waleed	Nan
وليس	ahan	None
وليست	maya	Nan
وليلة	habeen	None
وليم	william	Nan
وما	dildilaaca	Nan
وماض	hore	None
ومثل	sida	None
ومجلس	oo	None
ومجموعة	koox	None
ومحاولة	isku	None
ومحمد	muxamed	None
ومدرسة	iyo	None
ومدى	ilaa	None
ومدينة	magaalada	None
ومراكز	xarumaha	None
وكنيسة	kaniisad	None
وكندا	kanada	None
وكما	sida	None
وفقًا	xigtay	None
وفلسطين	falastiin	None
وفنلندا	finland	None
وفى	dhameystiran	Nan
وفي	gudaha	None
وفيما	iyadoo	None
وفيه	jira	None
وفيها	jira	None
وقائع	xaqiiqda	None
وقاد	horseeday	None
وقال	yidhi	None
وقالت	tidhi	None
وقالوا	waxay	None
وقام	kacay	None
وقامت	way	None
وفقاً	xigtay	None
وقاموا	way	None
وفقا	xigtay	None
وفرنسا	faransiiska	None
وغالبا	iyo	None
وغالباً	iyo	None
وغالبًا	iyo	None
وغرب	galbeedka	None
وغير	inbadan	None
وغيره	inbadan	None
وغيرها	kale	None
وغيرهم	kale	None
وفاة	geeri	None
وفاته	dhintay	None
وفاتها	dhimatay	None
وفتح	oo	None
وفد	wafdi	None
وفر	badbaadin	Nan
وفرة	badan	None
وفق	xigtay	None
وقبل	kahor	None
وقت	waqti	None
وقتل	dilay	None
وكان	ahayd	None
وكانت	ahayd	None
وكانوا	ahaayeen	None
وكتاب	buug	None
وكتب	qoray	None
وكثير	badan	None
وكثيرا	iyo	None
وكذا	sida	None
وكذلك	kale	None
وكرة	kubad	Nan
وكل	dhamaan	None
وكلاهما	waa	None
وكلما	markasta	None
وكلمة	eray	None
وكلها	dhamaantood	None
وكالة	wakaaladda	Nan
وكالات	hay&#39;adaha	Nan
وكأنه	jeceshahay	Nan
وقيل	yiri	None
وقته	waqtigiisii	Nan
وقتها	waqtigiisii	Nan
وقد	ahayd	None
وقدم	siiyay	None
وقرر	waana	None
وقصر	qasabad	Nan
وقطاع	iyo	None
ومنع	oo	None
وقطر	qadar	None
وقع	saxeexay	Nan
وقعت	dhacday	None
وقف	istaagay	None
وقلة	yar	None
وقوة	xoog	None
وقود	shidaal	None
وقوع	dhacdooyin	None
وقطع	oo	None
ومنه	bilaabo	None
ومنها	sida	None
ومنهم	iyaga	None
ويوجد	jira	None
ويوسف	yuusuf	None
وَلاَ	midkoodna	Nan
وُلد	wiil	None
يأتي	kaalay	Nan
يأخذ	qaadanaya	None
يأكل	cun	None
يأمر	amarka	Nan
يؤثر	saamaynta	None
يؤخذ	qaado	None
يؤدى	hogaanka	None
يؤدي	hogaanka	None
يؤكد	xaqiijinaya	Nan
يؤمن	rumayso	None
يؤمنون	rumeeyso	Nan
وينقسم	loo	None
يا	oh	Nan
ويندوز	windows	None
ويمكن	way	None
ويعني	jeedaa	None
ويعود	noqo	None
ويعيش	ha	None
ويقال	yiri	None
ويقدر	lagu	None
ويقدم	bixisaa	None
ويقع	dhaca	None
ويقول	dheh	None
ويقوم	tahay	None
ويكون	noqo	None
ويكي	wiki	None
ويكيبيديا	wikipedia	None
ويلز	ceelal	None
ويليام	william	Nan
ويمثل	waxay	None
وينتج	saartaa	None
ياسر	yaasir	Nan
ياسين	yassen	Nan
يبحث	raadi	None
يترك	bax	Nan
يتسبب	sababta	None
يتصل	xiriir	None
يتضح	sawir	None
يتضمن	ah	None
يتطلب	baahi	None
يتعرض	faafin	Nan
يتعلق	xiriira	None
يتغير	is	None
يتفق	ogolow	Nan
يتكلم	hadal	None
يتكون	kooban	None
يتلقى	hel	Nan
يتم	dhameystiran	Nan
يتمتع	ku	None
يترتب	waxay	None
يتراوح	darajooyin	Nan
يتخذ	qaado	None
يتحول	baxa	None
يبدأ	bilaabmay	None
يبدو	cod	None
يبعد	baxsan	None
يبق	hadhaagii	Nan
يبقى	hadhaagii	Nan
يبلغ	warbixin	None
يبين	muuji	Nan
ويعمل	way	None
يتأثر	saameeyay	Nan
يتأهل	u-qalma	Nan
يتبع	waa	None
يتجاوز	dhaaf	None
يتجه	madaxa	None
يتحدث	wuu	None
يتحدثون	hadlaan	None
يتحرك	dhaqaaqay	None
يتألف	kujiraan	None
يتمكن	maaree	Nan
ويعرف	ogyahay	None
ويعتمد	waxay	None
وهناك	halkaas	None
وهو	isagu	None
وهولندا	nederland	None
وهى	kee	Nan
وهي	kee	Nan
ووادي	dooxada	None
ووجد	helay	None
ووجدت	helay	None
ووجود	iyo	None
ووسائل	micnaheeda	None
ووسط	dhexda	None
ووصل	yimid	None
ووصلت	imid	None
ووضع	oo	None
ووفقا	xigtay	None
وهنا	halkan	None
ووفقاً	xigtay	None
وهما	laba	None
وهكذا	ah	None
ونادي	naadi	Nan
ونتيجة	ahaan	None
ونشأته	iyo	None
ونشر	oo	None
ونصف	badh	None
ونظام	nidaam	None
ونظرا	siiyay	None
ونظرًا	fiiri	None
ونظم	iyo	None
ونقل	dhaqaaq	None
ونهر	wabi	None
وهؤلاء	kuwan	None
وهبي	wehbe	Nan
وهذا	tan	None
وهذه	kan	None
وهم	waa	None
ووفقًا	xigtay	None
ويأتي	timid	None
ويؤدي	oo	None
ويرى	arkaa	None
ويستخدم	way	None
ويستطيع	wuu	None
ويسمى	la	None
ويشمل	ah	None
ويشير	xusuusin	Nan
ويصبح	noqotaa	None
ويصل	ilaa	None
ويضم	ah	None
ويضيف	daray	None
ويطلق	la	None
ويظهر	u	None
ويعتبر	la	None
ويعتقد	wuuna	None
ويعتقدون	u	None
ويروي	sheegayaa	None
ويرجع	noqotaa	None
ويذكر	xusay	None
ويدخل	gala	None
ويؤكد	wuu	None
ويؤمن	oo	None
ويب	websaydh	Nan
ويبدو	u	None
ويبقى	jirtaa	None
ويبلغ	waxay	None
ويتحدث	wuu	None
ويعد	iyo	None
ويتراوح	u	None
ويتم	yeelay	None
ويتميز	waxay	None
ويجب	a	None
ويجوز	yahay	None
ويحتوي	tahay	None
ويحدث	dhacdaa	None
ويختلف	tahay	None
ويتكون	tahay	None
تسببت	sababay	None
وأهل	dadka	None
وأنها	iyadu	None
مبكرة	hore	None
مبلغ	qadarka	None
مبنى	dhismaha	None
مبني	dhismaha	None
مبنية	dhisan	None
مبيعات	iibka	Nan
متابعة	sii	None
متاحة	karo	None
متتالية	xiga	None
متحركة	guuraya	Nan
متحف	madxafka	Nan
متحقق	guul	None
متخصصة	ah	None
متر	mitir	Nan
مترو	hoostiisa	None
مبكر	hore	None
متزايد	koraya	Nan
مبرهنة	theorem	Nan
مباشرة	ah	None
مالي	dhaqaale	None
مالية	dhaqaalaha	None
ماليزيا	malaysiya	None
مان	nin	None
مانشستر	manchester	None
مايكروسوفت	microsoft	None
مايكل	michael	Nan
مايو	yaabaa	None
مبابان	mbabane	Nan
مبادئ	mabaadi&#39;da	Nan
مبادرة	dadaal	None
مباراة	ciyaar	None
مبارك	duco	None
مباريات	kulamada	Nan
مباشر	ah	None
مبدأ	mabda &#39;	Nan
مالك	milkiilaha	None
متزايدة	koraaya	Nan
متساوية	isleeg	None
مثلث	saddex	None
مثلما	sida	None
مثله	kale	None
مثلها	iyada	None
مثيرة	farxad	None
مثيل	tusaale	None
مجاعة	abaar	None
مجال	duurka	None
مجالات	beeraha	None
مجالس	guddiyada	Nan
مجتمع	bulsho	None
مجتمعات	bulshooyinka	Nan
مجددًا	labaad	None
مجرة	galaxy	Nan
مجرد	just	Nan
مثلاً	ahaan	None
متزوج	guursaday	None
مثلا	ahaan	None
مثال	tusaale	None
متصلة	ku	None
متطلبات	shuruudaha	Nan
متطورة	ah	None
متعدد	badan	None
متعددة	badan	None
متفاوتة	kala	None
متفرقة	kala	None
متقدمة	horumarsan	Nan
متكررة	noqnoqda	None
متميزة	fog	None
متنوعة	duwan	None
متوسط	celcelis	Nan
متوسطة	dhexaad	None
متوفرة	karo	None
متى	goorma	Nan
مثل	sida	None
مال	caasimad	None
ماكسويل	maxwell	Nan
مافيا	mafia	Nan
ليبرالية	libaax	None
ليبيا	liibiya	None
ليتم	sameeyo	None
ليتو	leto	Nan
ليزر	laser	Nan
ليس	maya	Nan
ليست	ahan	None
ليسوا	aha	None
ليصبح	inaad	None
ليصل	yimaado	None
ليكون	ahaado	None
ليلاً	habeen	None
ليلة	habeen	None
ليلى	layla	Nan
لينكون	lincoln	Nan
ليالي	habeenno	Nan
لينين	lenin	Nan
لي	leh	None
لونه	midabkeeda	Nan
لواء	generalka	None
لوثر	luther	Nan
لوجود	jiro	None
لوح	diyaaradda	Nan
لوحات	taargooyinka	Nan
لوحة	rinjiyeynta	Nan
لوزارة	wasaaradda	None
لوس	los	Nan
لوصف	loo	None
لوضع	dhigo	None
لوقا	luukos	Nan
لوقف	la	None
لولا	lula	Nan
لولاية	gobol	None
لون	midab	None
لويس	lewis	None
ليون	lyon	Nan
ليوناردو	leonardo	Nan
مأهولة	deganaan	Nan
ماتت	dhimatay	None
ماجد	majid	Nan
مادة	muhiim	None
مادية	waxyaabaha	None
ماذا	maxay	None
مارتن	martin	Nan
مارس	maarso	None
مارك	calaamadee	Nan
ماركس	marx	None
ماركوس	marcus	Nan
ماري	marie	Nan
ماريا	maryan	None
مارينر	mariner	Nan
ماسنجر	rasuul	None
ماعدا	reebo	None
مات	dhintay	None
مائية	aqua	Nan
مائة	boqol	None
ما	maxay	None
مؤتمر	shir	None
مؤخرا	dhawaan	None
مؤخراً	dhawaan	None
مؤخرًا	dhawaan	None
مؤسس	aasaasaha	None
مؤسسات	hay&#39;adaha	Nan
مؤسسة	shirkadda	None
مجرى	qulqulka	Nan
مؤشر	tilmaame	Nan
مؤكدة	xaqiijiyay	Nan
مؤلف	qoraa	None
مؤلفات	qorayaasha	Nan
مؤلفاته	qoraalladiisa	Nan
مئات	wanaagsan	None
مئة	boqol	None
مئوية	boqolkiiba	None
مؤقتة	ah	None
لو	hadday	None
مجلة	joornaal	Nan
مجمع	adag	None
مركبات	gawaarida	Nan
مركبة	gaari	None
مركز	xarunta	None
مركزا	xarunta	None
مركزاً	xarunta	None
مركزية	dhex	None
مركزًا	xarun	None
مرمرة	marmara	Nan
مروان	marwan	Nan
مرور	marin	None
مريم	maryan	None
مزارع	farmaajo	None
مزايا	faa&#39;iidooyinka	Nan
مزيج	isku	None
مزيد	inbadan	None
مركب	kooban	None
مسألة	arrin	None
مرقس	calaamadee	Nan
مرض	jiro	None
مراقبة	xakamayn	Nan
مراكز	xarumaha	None
مراكش	marrakesh	Nan
مربع	barxadda	Nan
مرة	mar	None
مرت	gudubtay	Nan
مرتبة	darajo	None
مرتبطة	iskuxiran	Nan
مرتفع	sare	None
مرتفعات	dhererka	Nan
مرتفعة	sare	None
مرتين	jeer	None
مرحلة	marxalad	None
مرسوم	wareegto	Nan
مرصد	kormeer	Nan
مرضى	bukaanka	Nan
مراقب	horman	Nan
مسؤول	masuul	None
مسؤولية	deyn	Nan
مستقرة	deggan	None
مستقل	banaan	None
مستقلة	madaxbannaan	None
مستمر	ah	None
مستمرة	socda	None
مستوطنة	dejinta	Nan
مستوى	heer	None
مستويات	heerarka	Nan
مسجد	masaajidka	None
مسح	sahamin	Nan
مسرح	marxalad	None
مسرحية	ciyaar	None
مسعود	masoud	Nan
مسقط	muscat	Nan
مسلسل	ah	None
مستقبل	mustaqbalka	None
مسؤولة	ah	None
مستعمرة	gumeysiga	None
مستشفى	isbitaal	None
مساء	fiidkii	Nan
مسائل	arimaha	None
مسابقات	tartamada	Nan
مسابقة	tartan	Nan
مساجد	masaajidda	Nan
مساحة	booska	Nan
مساحتها	aaggeeda	Nan
مسار	waddo	None
مساعد	caawiye	Nan
مساعدة	i	None
مسافة	masaafada	None
مساندة	taageero	None
مساهمة	gelinta	None
مستخدم	adeegsade	Nan
مستخدمي	isticmaalayaasha	None
مستعمرات	gawaarida	Nan
مراعاة	tixgelin	Nan
مراد	ujeedo	Nan
مراحل	wajiga	Nan
محدود	xaddidan	Nan
محدودة	xaddidan	Nan
محركات	mashiinnada	Nan
محرم	muharram	Nan
محط	saldhig	None
محطات	xarumaha	None
محطة	saldhig	None
محفز	dheecaan	None
محفوظ	kaydiyay	Nan
محل	dukaan	None
محلول	xalka	Nan
محلي	macaan	None
محلية	deegaanka	None
محمد	maxamed	None
محمدًا	a	None
محددة	ah	None
محمود	maxamud	None
محدد	ah	None
محاولة	isku	None
مجمل	ahaan	None
مجموع	isugeyn	Nan
مجموعات	kooxo	None
مجموعتين	koox	None
مجهول	yaqaan	None
مجهولة	yaqaan	None
مجيء	socda	None
محاسبة	xisaabaadka	None
محاطة	wareegsan	None
محافظات	degmooyinka	None
محافظة	maamulka	None
محاكاة	jilitaanka	Nan
محاكم	maxkamadaha	None
محاكمة	maxkamad	None
محاولات	dadaal	None
محايدة	dhexdhexaad	None
محمودية	maxamuudia	Nan
محمية	difaacay	None
محو	tirtir	Nan
مدنها	magaalooyinkeeda	Nan
مدني	ah	None
مدنية	ah	None
مدونة	blog	Nan
مدى	bezel	Nan
مدير	agaasime	None
مدينة	magaalada	None
مدينتي	magaaladayda	Nan
مذاهب	khudbadaha	Nan
مذكرات	xusuus-qor	Nan
مذكراته	qoraalladiisa	Nan
مر	weyn	None
مرات	waqtiyo	None
مراجع	tixraacyada	None
مراجعة	u	None
مدن	magaalooyinka	None
مدعوم	la	None
مدريد	madrid	Nan
مدرسة	dugsi	None
محور	axis	Nan
محيط	badweynta	None
مخاطر	khataraha	Nan
مخالفة	ka	None
مخاوف	cabsi	None
مختلف	duwan	None
مختلفة	duwan	None
مجلس	gole	Nan
مختلفين	duwan	None
مخطط	la	None
مخطوطة	xusuus-qor	Nan
مخيم	xero	None
مدارات	orbits	Nan
مدارس	iskuulada	None
مدة	muddada	Nan
مدخل	irridda	Nan
مخصصة	balanqaaday	None
لهما	iyaga	None
لهم	iyaga	None
لهذه	awgeed	None
لقاح	tallaal	Nan
لقب	cinwaanka	None
لقبه	naaneyskiisa	Nan
لقتال	ula	None
لقد	lur	Nan
لقوات	ku	None
لقوانين	sharciyada	None
لقول	dhaho	None
لقي	helay	None
لقياس	loo	None
لك	leh	None
لكتاب	buug	None
لكثرة	badan	None
لكثير	inbadan	None
لكرة	ahaan	None
لقاء	kulan	None
لكل	midkastoo	Nan
لفهم	fahmo	None
لفكرة	ahaan	None
لعمل	shaqeeyo	None
لعملية	loo	None
لغات	luuqadaha	None
لغة	af	None
لغتهم	afkooda	Nan
لغرض	ujeedo	Nan
لغزو	lagu	None
لغوية	luuqad	Nan
لغير	kale	None
لـ	waayo	None
لفتح	in	None
لفترات	muddo	None
لفترة	cabbaar	Nan
لفرنسا	faransiiska	None
لفظة	erey	None
لفلسطين	falastiin	None
لعلي	in	None
لكلمة	eray	None
لكن	laakiin	None
للاتحاد	shaqaalaha	None
للاتصالات	telecom	Nan
للاقتصاد	dhaqaalaha	None
للبحث	raadin	Nan
للبحر	badda	None
للبشر	dadka	None
للبلاد	dalka	None
للتاريخ	ahaan	None
للتجارة	ganacsiga	None
للتخلص	looga	None
للتدخين	sigaar cabista	Nan
للتدريب	tababar	Nan
للتربة	carrada	Nan
للتعبير	loo	None
للتعليم	waxbarashada	None
للإنسان	ahaan	None
لكم	adiga	None
للإمبراطورية	boqortooyadii	None
للإصابة	dhaawac	None
لكنه	isagu	None
لكنها	iyadu	None
لكنهم	waa	None
لكوكب	meerahan	Nan
لكون	caalamka	None
لكونه	ahaanshaha	None
لكي	u	None
للأراضي	ahaan	None
للأرض	dhulka	None
للأطفال	carruurta	None
للأمم	quruumaha	Nan
للأندية	naadiyada	Nan
للإتحاد	shaqaalaha	None
للإسلام	islaamka	None
للإشارة	u	None
للإمام	imaamka	None
لعلماء	aqoonyahannada	Nan
لعلم	ah	None
لعلاج	loo	None
لحد	yaree	Nan
لحركة	dhaqdhaqaaqa	None
لحزب	xisbi	None
لحساب	loo	None
لحظة	waqti	None
لحفظ	badbaadiyo	None
لحقوق	xuquuqda	None
لحكم	xukumo	None
لحل	loo	None
لحم	hilib	Nan
لحماية	ilaaliyo	None
لحن	tune	Nan
لحوالي	saabsan	None
لخدمة	loogu	None
لدراسة	barto	None
لحام	alxanka	Nan
لدرجة	heer	None
لجيش	ciidan	None
لجميع	dhamaantiin	Nan
لتعزيز	qaado	None
لتفسير	faahfaahin	Nan
لتقديم	loo	None
لتكون	ahaado	None
لتكوين	loo	None
لتلك	kuwaas	None
لتنظيم	loo	None
لتنفيذ	loo	None
لتوفير	loo	None
لتوليد	abuuro	None
لجأ	qaxooti	None
لجامعة	jaamacadda	None
لجعل	sameeyo	None
لجمع	loo	None
لجمهورية	jamhuuriyadda	None
لجنة	guddi	Nan
لدعم	taageero	None
لدول	wadamada	None
لدولة	dal	None
لصناعة	saar	None
لضمان	qaad	None
لطفي	lotfi	Nan
لطيفة	latifa	Nan
لظهور	muuqato	None
لعام	sanadka	None
لعب	ciyaar	None
لعبة	toy	Nan
لعبت	ciyaaray	None
لعبد	addoon	None
لعدة	dhowr	None
لعدد	ahaan	None
لعدم	aha	None
لعطارد	socota	None
لعل	wareeg	Nan
لصالح	xun	None
لشركة	shirkad	None
لشبونة	lisbon	Nan
لشبه	ahaan	None
لدى	hayaa	None
لدي	hayaa	None
لدينا	waan	None
لديه	leeyahay	None
لديها	wey	None
لديهم	leeyihiin	None
لذا	marka	None
للتنمية	horumar	None
لذلك	marka	None
لرعاية	loo	None
لزيادة	kordhiyo	None
لسان	luuqada	None
لسكان	deganeyaasha	Nan
لسنة	ah	None
لسنوات	sanado	None
لسياسة	siyaasada	None
لرئيس	madaxa	None
للثقافة	ahaan	None
للثورة	kacaanka	None
للجدل	khilaafaadka	Nan
للموسيقى	muusikada	Nan
للمياه	biyo	None
للميلاد	dhalasho	None
للنادي	naadiga	Nan
للناس	dadka	None
للنبي	nabiga	None
للنساء	haweenka	None
للنظام	nidaamka	None
للنفط	saliid	None
للنقل	wareejinta	Nan
لله	allah	None
للهجوم	weeraro	None
للوزراء	wasiirada	None
للوصول	gaaro	None
للولايات	gobolada	None
للمواد	qalabka	None
لليهود	socota	None
للمنطقة	gobolka	None
للملك	boqorka	None
للكواكب	meerayaasha	Nan
للكوكب	meeraha	Nan
للكويت	galay	None
للماء	galeen	None
للمجتمع	bulshada	None
للمجلس	golaha	None
للمجموعة	kooxda	None
للمدينة	magaalada	None
للمرة	waqtiga	None
للمساعدة	caawimaad	Nan
للمستخدمين	galay	None
للمسجد	masaajidka	None
للمسلمين	ah	None
للمسيحية	masiixiyiinta	Nan
للمغرب	dhanka	None
للمملكة	boqortooyada	None
لم	sameyn	None
لما	goorma	Nan
لماذا	sababta	None
لن	doono	None
لنا	naga	None
لندن	london	None
لنظام	nidaamka	None
لنظرية	ahaan	None
لنفسه	isaga	None
لنقل	aynu	None
لنكدوك-روسيون	languedoc-roussillon	Nan
لنهر	webi	None
له	isaga	None
لها	iyada	None
لهتلر	talagalay	None
لهجات	qorayaal	Nan
لهجة	soo	None
لهذا	awgeed	None
لمواجهة	wajiga	Nan
لمنع	hortago	None
لمنظمة	urur	None
لمنطقة	meel	None
لمجلس	guddi	Nan
لمجموعة	ahaan	None
لمحاربة	ula	None
لمحاولة	dayo	None
لمحمد	socota	None
لمختلف	duwan	None
لمدة	cabbaar	Nan
للكنيسة	kaniisadda	None
لمدينة	magaalo	None
لمساعدة	caawiyo	None
لمصر	masar	None
لمعالجة	qabto	None
لمعرفة	ogaado	None
لمعظم	badiyaa	None
لمكافحة	ula	None
لمن	kuwee	Nan
لمرض	cudur	None
مسلسلات	taxanaha	Nan
للكثير	inbadan	None
للقيام	sameeyo	None
للخليفة	soco	None
للدراسات	daraasadaha	Nan
للدراسة	barto	None
للدفاع	loo	None
للدلالة	loo	None
للدول	gobolada	None
للدولة	gobolka	None
للدين	diinta	None
للرئيس	madaxweynaha	None
للرجال	ragga	None
للرجل	ninka	None
للزراعة	beeraha	None
للزهرة	ubax	None
للسكان	dadka	None
للسلام	nabadda	None
للخلافة	isku	None
للسلطان	suldaanka	None
للحيوانات	xayawaanka	Nan
للحكومة	dowladda	None
للجزائر	aljeeriya	None
للجسم	jirka	None
للجمعية	ururka	None
للجمهورية	jamhuuriyadda	None
للجميع	qofkasta	None
للجنة	socota	None
للجيش	ciidanka	None
للحد	loo	None
للحرارة	kuleylka	Nan
للحرب	dagaal	None
للحركة	dhaqdhaqaaqa	None
للحزب	xisbiga	None
للحصول	hesho	None
للحفاظ	ilaaliyo	None
للحكم	xukumo	None
للحياة	nolosha	None
للسلطة	awoodda	None
للسيارات	gawaarida	Nan
للسيطرة	loo	None
للعناصر	alaabada	Nan
للعهد	ballanqaadka	Nan
للعولمة	caalamka	None
للغاية	xun	None
للغة	ahaan	None
للفرد	shakhsiga	Nan
للفنون	farshaxanka	None
للفيروسات	fayrasyada	Nan
للقارات	is-dhexgalka	Nan
للقتال	ula	None
للقدس	ee	None
للقرآن	qur&#39;aanka	Nan
للقرن	qarnigii	None
للقضاء	loo	None
للقوات	ciidamada	None
للعمل	shaqada	None
للعلوم	cilmiga	None
للعلماء	aqoonyahannada	Nan
للعلم	ah	None
للشباب	dhalinyarada	None
للشعب	dadka	None
للشمس	qorraxda	Nan
للشيخ	sheekh	None
للصلاة	tukado	None
للضوء	iftiimin	Nan
للطاقة	tamarta	None
للكتاب	buugga	None
للطبيعة	dabcan	Nan
للطيران	aad	None
للعالم	adduunka	None
للعام	sanadka	None
للعديد	ah	None
للعراق	ciraaq	None
للعرب	socota	None
للعلاج	daaweynta	Nan
للطلاب	ardayda	None
مسلم	muslim	None
مسلمة	muslim	None
مسلمون	muslimiinta	None
نصف	badh	None
نصوص	qoraallada	Nan
نصيب	wadaag	Nan
نصير	taageere	Nan
نطاق	xayndaab	Nan
نظام	nidaam	None
نظر	tixgelin	Nan
نظرا	sababta	None
نظراً	sababta	None
نظرة	muuqaal	Nan
نظريات	fikradaha	Nan
نظرية	aragti	None
نظريته	fikirkiisa	Nan
نظرًا	sababta	None
نظم	abaabulay	None
نصر	guul	None
نظير	ciyaar	None
نصب	samee	Nan
نشوب	xanuun	None
نسمة	dabayl	Nan
نشأ	istaarijka	Nan
نشأة	bilowgii	None
نشأت	ahaan	None
نشأته	koray	None
نشأتها	timid	None
نشاط	waxqabadka	Nan
نشاطات	hawlaha	None
نشبت	burbur	None
نشر	faafitaan	Nan
نشرت	la	None
نشرها	dhejiyay	Nan
نشط	firfircoon	None
نشطة	firfircoon	None
نشوء	soo	None
نص	qoraal	None
نسل	abuur	Nan
نعرف	ognahay	None
نفر	dami	Nan
نمر	tiger	Nan
نمط	qaabka	None
نمو	koritaanka	Nan
نموذج	foom	Nan
نهائي	dhamaadka	None
نهائيات	ah	None
نهاية	dhamaad	Nan
نهج	u	None
نهر	wabiga	None
نهضة	nooleynta	Nan
نهيان	naxdin	Nan
نواب	kuxigeenada	Nan
نواة	xudunta	Nan
نواس	pendulum	Nan
نوبل	noble	Nan
نمت	koray	None
نعيم	naeem	Nan
نماذج	foomamka	Nan
نقله	guur	None
نفس	mid	None
نفسه	naftiisa	None
نفسها	lafteeda	Nan
نفسي	aniga	None
نفسية	cilmi	None
نفط	saliid	None
نفوذه	saameyntiisa	Nan
نفوذها	saameynteeda	Nan
نفوس	nafta	None
نفي	diidmo	Nan
نقاط	dhibco	Nan
نقد	lacag	None
نقص	yaraanta	Nan
نقطة	barta	None
نقل	beddelka	Nan
نقول	waxaan	None
نسخة	nuqul	Nan
نسخ	koobiyada	Nan
نستطيع	waan	None
نابلس	nablus	Nan
نابليون	napoleon	Nan
ناتج	saar	None
ناجحة	guul	None
ناحية	gacanta	None
نادرة	dhif	Nan
نادى	naadi	Nan
نادي	naadi	Nan
نار	dabka	None
ناسا	nasa	Nan
ناصر	naser	Nan
ناطقة	hadalka	None
نال	helay	None
نالت	heshay	None
نانسي	nancy	None
ناب	ilkaha	None
نايف	nayef	Nan
نائب	ku-xigeen	Nan
مِنْ	bilaabo	None
ميدان	barxadda	Nan
ميزانية	miisaaniyad	Nan
ميزة	muuqaal	Nan
ميسي	messi	Nan
ميكانيكا	farsamada	None
ميل	feejignaan	Nan
ميلاد	dhalasho	None
ميلان	milan	Nan
ميلانو	milan	Nan
ميلودراما	melodrama	Nan
ميناء	xero	None
ميونيخ	munich	Nan
مَا	maxay	None
مَنْ	bilaabo	None
مِن	bilaabo	None
ن	n	Nan
نبات	dhirta	None
نباتات	dhirta	None
نبتون	neptune	Nan
نحو	xagga	None
نذكر	xusnay	None
نرى	waan	None
نزار	nazar	Nan
نزل	soo	None
نزلت	degay	None
نزول	soo	None
نساء	haweenka	None
نسب	safka	Nan
نسبة	qiimee	Nan
نسبته	isugeyntiisa	Nan
نسبه	boqolkiiba	None
نسبيا	ahaan	None
نسبياً	ahaan	None
نسبيًا	ahaan	None
نحن	anaga	Nan
نجيب	najib	Nan
نجوم	xiddigaha	Nan
نجمة	xiddig	Nan
نبذة	koob	None
نبي	nabiga	None
نبيل	nabil	Nan
نت	net	None
نتائج	cawaaqibta	Nan
نتاج	sheyga	Nan
نتج	la	None
نوح	nuux	None
نتيجة	kalandarka	None
نجاحاً	guul	None
نجاد	najad	Nan
نجح	guuleystay	None
نجحت	gudbay	None
نجد	waan	None
نجران	najran	Nan
نجم	xiddig	Nan
نجاح	guul	None
نور	iftiimin	Nan
نورة	nuura	Nan
نوستراداموس	nostradamus	Nan
وأبي	iyo	None
وأتباعه	asxaabtiisa	None
وأثناء	lagu	None
وأجزاء	qaybo	None
وأجهزة	iyo	None
وأحد	mid	None
وأحمد	axmed	None
وأحيانا	qaarkood	None
وأخذ	qaadashada	None
وأخذت	qaadday	None
وأخرى	kale	None
وأخيرا	ugu	None
وأخيراً	ugu	None
وأخيرًا	ugu	None
وأدت	horseeday	None
وأبو	abuu	None
وأدى	dooxada	None
وأبرزها	mudan	None
وآله	iyo	None
هي	iyada	None
هيئة	jirka	None
هيا	kaalay	Nan
هياكل	qaab	None
هيدروجين	hydrogen	Nan
هيفاء	haifa	Nan
هيكل	qaab	None
هيلين	helen	Nan
هيم	hem	Nan
هينايانا	hinayana	Nan
هُوَ	waa	None
و	iyo	None
وآخر	kale	None
وآخرون	kale	None
وآسيا	aasiya	None
وأبرز	badan	None
وأذربيجان	iyo	None
وأربعين	iyo	None
وأرسل	diray	None
وأقدم	weyn	None
وأقل	yar	None
وأكبر	weyn	None
وأكثر	inbadan	None
وأكثرها	badankood	None
وأكد	xaqiijiyay	Nan
وألمانيا	jarmalka	None
وأما	ama	None
وأمر	amray	None
وأمريكا	ameerika	None
وأمه	hooyadiis	None
وأن	hubaal	None
وأنا	aniga	None
وأنشأ	aasaasay	None
وأنه	waa	None
وأقام	joogaa	None
وأقاليم	iyo	None
وأفغانستان	iyo	None
وأفريقيا	afrika	None
وأساليب	qaababka	None
وأسباب	sababaha	None
وأستراليا	australia	None
وأسس	aasaaska	None
وأشار	sifeeyay	Nan
وأشهر	caansan	None
وأصبح	noqotay	None
هوية	aqoonsi	None
وأصبحت	noqday	None
وأصحابه	asxaabtiisa	None
وأضاف	daray	None
وأطلق	eryay	None
وأعضاء	iyo	None
وأعلن	dhawaaqay	None
وأعلنت	dhawaaqay	None
وأغلب	badan	None
وأصحاب	iyo	None
ميخائيل	michael	Nan
هولندا	holland	None
هوراس	horace	Nan
هاجر	haajiray	None
هاجروا	guureen	None
هاجم	weeraray	None
هاجمت	weeraray	None
هارفارد	harvard	Nan
هارون	haaruun	None
هاري	harry	Nan
هاشم	hashee	Nan
هام	muhiim	None
هاما	muhiim	None
هاماً	muhiim	None
هامة	muhiim	None
هاواي	hawaii	None
هايدا	haida	Nan
هتلر	hitler	Nan
هاتين	labadan	None
هجرة	haajirida	Nan
هائلة	badan	None
هؤلاء	kuwan	None
نوع	nooca	None
نوعا	sida	None
نوعان	nooc	None
نوعه	leeyahay	None
نوعها	leeyahay	None
نوعية	tayada	None
نوعين	nooc	None
نوفمبر	nof	Nan
نووي	nukliyeerka	Nan
نووية	nuclear	Nan
نيتشه	nietzsche	Nan
نيجيريا	nigeria	Nan
نيوتن	newton	Nan
نيوزيلندا	new	None
نيويورك	york	None
هائل	weyn	None
هجمات	weerarada	Nan
هجوم	weerar	None
هدف	hadaf	Nan
هـم	hm	Nan
هكتور	hector	Nan
هكذا	marka	None
هل	adiga	None
هلال	xariiqda	Nan
هم	iyaga	None
هما	iyaga	None
هنا	halkan	None
هناك	halkaas	None
هنالك	halkaas	None
هند	hind	Nan
هندسة	injineerinka	Nan
هنري	henry	Nan
هو	waa	None
هواء	hawo	None
هـ	e	None
هطول	roobab	None
هضبة	plateau	Nan
هشام	xesham	Nan
هدفه	hadafkiisa	Nan
هدم	burburin	Nan
هدنة	xabad	None
هدى	hanuun	None
هذا	tan	None
هذان	labadan	None
هذة	waa	None
هولاكو	hulagu	Nan
هذه	waa	None
هرب	baxsaday	None
هرقل	hercules	Nan
هرقليطس	xiiqda	Nan
هرم	ahraam	Nan
هريرة	caruusad	Nan
هزم	guuldareystay	Nan
هزيمة	guuldarro	Nan
هذين	labadan	None
وأنواع	noocyada	None
ميثيونين	methionine	Nan
ميت	dhintay	None
معقد	isku	None
معقدة	fudud	None
معلومات	bixin	None
معمر	sare	None
معناه	micnaheeda	None
معناها	micnaheeda	None
معنى	macnaha	None
معه	isaga	None
معهد	machadka	None
معهم	iyaga	None
معينة	hubaal	None
معًا	wada	None
مغادرة	ka	None
مغامرات	adventures	Nan
مغربي	moroccan	Nan
معظمهم	badan	None
مغناطيسي	magnetic	Nan
معظمها	badankood	None
معسكرات	lugta	None
معتدل	ah	None
معتدلة	ah	None
معترف	la	None
معجزة	mucjiso	None
معد	talagalay	None
معدات	qalab	None
معدة	caloosha	Nan
معدل	qiimee	Nan
معدلات	qiimaha	None
معدنية	birta	None
معرفة	aqoon	None
معركة	dagaal	None
معروف	nimco	Nan
معروفة	yaqaan	None
معسكر	xero	None
معظم	badan	None
معبد	macbudka	Nan
مغناطيسية	magnetic	Nan
مفاهيم	fikradaha	Nan
مقاومة	iska	None
مقبرة	qabuuro	Nan
مقبولة	karo	None
مقتل	dilay	None
مقتله	dilay	None
مقدار	qadarka	None
مقدسة	leh	None
مقدم	soo-bandhig	Nan
مقدمة	hordhac	None
مقدونيا	makedoniya	Nan
مقديشيو	muqdisho	None
مقر	dhexe	None
مقرا	miiska	None
مقرها	ku	None
مقسمة	kala	None
مقام	tilmaanta	Nan
مفاعل	firfircoonaan	Nan
مقالة	maqaal	Nan
مقال	maqaal	Nan
مفاوضات	wadahadal	None
مفتاح	fure	Nan
مفتوحة	furan	None
مفتي	mufti	None
مفصلة	hinge	Nan
مفهوم	fikradda	Nan
مفيدة	caawiya	Nan
مقابر	qabuuraha	Nan
مقابل	soo	None
مقابلة	wareysiga	Nan
مقاتل	dagaalyahan	Nan
مقارنة	isbarbar dhig	Nan
مقاطعات	degmooyinka	None
مقاطعة	qaadac	Nan
مقاعد	kursiga	None
مقالات	maqaallada	Nan
معاً	wada	None
معايير	heerarka	Nan
معاوية	sid	Nan
مشتقة	kala	None
مشروع	mashruuc	None
مشعل	toox	Nan
مشكلة	dhibaatada	None
مشهد	goobta	None
مشهور	caan	None
مشهورة	caan	None
مشيخة	tahay	None
مصادر	ilo	None
مصانع	warshadaha	None
مصحف	mushaafa	Nan
مصدر	xigasho	Nan
مصر	masar	None
مصرف	bangiga	None
مصري	masriyiintii	Nan
مشتركة	wadaag	Nan
مصريات	haweenka	None
مشترك	isweydaarsi	Nan
مشاهدة	soco	None
مسلمين	muslimiinta	None
مسمى	magacaabay	None
مسند	cagta	None
مسيحية	ah	None
مسيرة	socod	Nan
مسيرته	xirfadiisa	Nan
مشابه	ah	None
مشابهة	ah	None
مشاة	lugeeye	Nan
مشاركة	wadaag	Nan
مشاريع	mashaariicda	Nan
مشاعر	dareemid	Nan
مشاعل	holac	Nan
مشاكل	dhibaatooyinka	None
مشاهد	arag	None
مشاهير	caan	None
مصرية	masriyiintii	Nan
مصريون	masriyiintii	Nan
مصطفى	mustafa	None
مظاهر	muuqaalada	Nan
مظاهرات	mudaharaadyada	Nan
مظهر	muuqaal	Nan
مع	iyadoo	None
معا	wada	None
معاداة	cadaawad	Nan
معارض	soo	None
معارضة	mucaaradka	None
معارك	dagaal	None
معالجة	ka	None
معالم	nololeed	None
معامل	xaqiiqda	None
معاملة	daaweynta	Nan
معاني	macnayaasha	Nan
معاهدة	heshiis	None
مطلقة	furiin	Nan
مطلع	bilaabo	None
مطلة	eegayo	None
مطرب	fanaan	None
مصطلح	muddo	None
مصطلحات	shuruudaha	Nan
مصلحة	daneyn	Nan
مصنع	warshadda	None
مصنوع	sameeyey	None
مصنوعة	sameeyay	None
مصير	qaddar	Nan
مقياس	miisaan	None
مضادة	counter	Nan
مضى	udhacay	Nan
مضيق	xarig	Nan
مطابقة	isbarbar dhig	Nan
مطار	madaarka	None
مطارات	diyaaradaha	None
مطالب	baahida	None
مطر	roob	None
مضخم	cod-weyne	Nan
مكاتب	xafiisyada	None
مكافحة	dagaal	None
مكان	goobta	None
مهد	gogosha	Nan
مهدي	mahdi	None
مهرجان	dabaaldag	Nan
مهم	muhiim	None
مهما	wixii	None
مهمة	howlgalka	Nan
مهمًا	wixii	None
مهنة	xirfadda	Nan
مهندس	injineer	None
مواجهة	hor	None
مواد	waxyaabaha	None
موارد	kheyraadka	None
مواضيع	mawduucyada	Nan
مواطن	muwaadin	Nan
مواطني	dalka	None
مهام	hawlaha	None
موافقة	oggolaanshaha	Nan
مهارات	xirfado	Nan
منيرة	munira	Nan
منصب	booska	Nan
منصبه	xafiiska	None
منصور	mansuur	None
منطقة	aag	Nan
منظمات	ururada	None
منظور	ujeedo	Nan
منع	xannib	Nan
منعت	ka	None
منغوليا	mongolia	Nan
منها	oo	None
منهج	habka	None
منهم	waa	None
منهما	waa	None
منى	mona	Nan
مني	mona	Nan
مهاجمة	weerar	None
مواقع	goobaha	None
مواقف	xaaladaha	None
مواليد	ilmaha qaniinyadooda	Nan
موطن	hoyga	None
موعد	ballan	None
موقع	goobta	None
موقعة	saxiixay	Nan
موقعه	saxiixay	Nan
موقعها	goobteeda	Nan
موقف	muuqaal	Nan
موقفه	mowqifkiisa	Nan
مول	suuq	None
مولاي	moulay	Nan
مولده	dhalashadiisa	Nan
موليبدنوم	molybdenum	Nan
مونتانا	montana	Nan
مونكو	monco	Nan
مياه	biyo	None
موضي	moudy	Nan
موضوع	dulucda	None
موضع	booska	Nan
موسيقية	muusig	None
موانئ	dekadaha	Nan
موت	geeri	None
موته	dhimashadiisa	Nan
موجات	duufaanta	Nan
موجة	wareer	Nan
موجودة	helay	None
موحد	mideysan	None
منزله	gurigiisa	None
موحدة	lebis	Nan
موريتانيا	mauritania	None
موسكو	moscow	Nan
موسم	xilli	None
موسوعة	encyclopedia	Nan
موسوليني	mussolini	None
موسى	mousa	Nan
موسيقى	muusig	None
مورد	alaab-qeybiye	Nan
ميثاق	axdi-qarameedka	Nan
منزلة	gurigiisa	None
منذ	ago	Nan
ملجأ	qaxooti	None
ملحوظ	la	None
ملحوظة	nb	Nan
ملعب	garoomada	None
ملعقة	qaaddo	Nan
ملف	feyl	Nan
ملفات	faylasha	Nan
ملك	boqorka	None
ملكة	boqoradda	Nan
ملكي	boqortooyo	None
ملكية	hanti	None
ملكًا	boqorka	None
ملوك	boqorradii	Nan
مليار	bilyan	Nan
مليون	milyan	None
ملايين	malaayiin	Nan
مما	badan	None
ملامح	astaamaha	None
ملاحظة	ogeysiis	Nan
مكانة	xaalad	Nan
مكانته	cabbirkiisa	Nan
مكانه	xaalad	Nan
مكانها	meesha	None
مكة	makka	None
مكتب	xafiiska	None
مكتبة	maktabadda	Nan
مكتوب	qoran	None
مكتوبة	qoran	None
مكتوم	muffled	Nan
مكنسة	xaaqin	Nan
مكون	ah	None
مكونات	yihiin	None
مكونة	sameeyay	None
ملاحظات	xusuusin	Nan
ملاك	malag	Nan
مماثل	ah	None
مماثلة	ah	None
ممارسة	ku	None
مناف	munaf	Nan
منافسة	tartan	Nan
مناقشة	dood	None
مناهج	manhajka	None
منتج	soo-saare	Nan
منتجات	alaabada	Nan
منتخب	doortay	None
منتشرة	fidsan	None
منتصف	mid	None
منتظم	ah	None
منتظمة	ah	None
منح	deeqda	Nan
منحت	deeqay	Nan
منخفض	hoose	None
منخفضة	hoose	None
مناطق	gobollada	None
مناصب	meelaha	None
مناسبة	munaasabad	Nan
مناسب	habboon	None
ممالك	boqortooyooyinka	Nan
مماليك	mamluks	Nan
ممثل	jilaa	None
ممثلة	jilaa	None
ممرض	caafimaad	None
ممكن	in	None
ممكنة	suurtagal	Nan
منزل	guri	None
مملكة	boqortooyada	None
مميزات	astaamaha	None
مميزة	kala	None
من	bilaabo	None
منا	mareykanka	None
مناخ	cimilada	None
منارة	nalalka	Nan
منازل	guryaha	None
ممن	yaa	None
يُلاحظ	ogeysiis	Nan
تسبب	keena	None
تساهم	ku	None
التلفاز	telefishanka	Nan
التلفزيون	telefishanka	Nan
التلفزيونية	telefishanka	Nan
التلوث	wasakheynta	Nan
التمثيل	ku-simaha	Nan
التمرد	kacaankii	None
التمويل	maalgalinta	Nan
التميمي	al-tamimi	Nan
التمييز	takoorka	Nan
التنازل	dhaaf	None
التناسلي	gudniinka	Nan
التناسلية	gudniinka	Nan
التنافس	tartan	Nan
التنبؤ	saadaalin	Nan
التنسيق	isuduwid	Nan
التلاميذ	ardayda	None
التنظيم	ururka	None
التكيف	laqabsashada	Nan
التكنولوجية	farsamada	None
التقسيم	qeyb	None
التقسيمات	qeybaha	None
التقليد	dhaqan	None
التقليدي	ahaan	None
التقليدية	ahaan	None
التقنيات	teknolojiyada	Nan
التقنية	teknolojiyada	Nan
التقويم	kaalandarka	Nan
التقى	kulmay	None
التقييم	qiimayn	None
التكاثر	taranka	Nan
التكافؤ	cadaadis	None
التكتونية	tectonic	Nan
التكلفة	qiimaha	None
التكنولوجيا	teknolojiyada	Nan
التكوين	qaabeynta	Nan
التقرير	warbixinta	None
التنفس	neefsashada	Nan
التنفيذي	fulinta	Nan
التونسية	tuniisiya	Nan
التي	kee	Nan
التيار	hadda	None
التيارات	hada	None
الثابت	ah	None
الثابتة	go&#39;an	Nan
الثالث	saddexaad	None
الثالثة	saddexaad	None
الثالوث	trinity	Nan
الثامن	viii	Nan
الثامنة	sideedaad	None
الثانوي	secondary	None
الثانوية	sare	None
الثاني	labaad	None
الثانية	labaad	None
التونسي	tuniisiya	Nan
التنفيذ	hirgelinta	Nan
التوقيع	saxeex	Nan
التوسع	ballaarinta	Nan
التنفيذية	fulinta	Nan
التنقل	dhaqdhaqaaqa	None
التنقيب	saadaalin	Nan
التنمية	horumarin	Nan
التنوع	kala	None
التنوير	iftiimin	Nan
التهاب	caabuq	Nan
التوازن	isku	None
التواصل	isgaarsiinta	None
التوالي	toosan	None
التوبة	keena	None
التوتر	cadaadiska	Nan
التوجه	jihaynta	Nan
التوحيد	monotheism	Nan
التوراة	tawreed	Nan
التوصل	gaaritaan	Nan
التقديرات	qiyaasta	None
التقدم	horumar	None
التقاليد	caadooyin	Nan
التشريح	xanuun	None
التشريع	sharci	None
التشريعات	sharci	None
التشريعي	sharci-dejinta	Nan
التشريعية	sharci-dejinta	Nan
التشكيل	qaabeynta	Nan
التصحر	xaaluf	Nan
التصدي	muran	None
التصديق	shahaadada	None
التصرف	fal	None
التصفيات	ciyaaraha	None
التصميم	nashqadeynta	Nan
التصنيع	waxsoosaarka	None
التصنيف	nooca	None
التصنيفات	kala-saarista	Nan
التشخيص	cudurka	None
التصوف	suufi	None
التشابه	ah	None
التسونامي	tsunami	Nan
الترجمة	tarjumida	Nan
الترفيهية	madadaalo	Nan
الترك	turkigu	None
التركي	turkiga	None
التركيب	halabuurka	Nan
التركية	turkiga	None
التركيز	feejignaan	Nan
الترمذي	tirmidhi	Nan
التزاوج	qaan-goynta	Nan
التزلج	barafka	Nan
التسامح	dulqaad	None
التسجيل	diiwaangelinta	Nan
التسعينيات	sagaashankii	Nan
التسلسل	isku	None
التسمية	calaamadda	Nan
التسويق	suuqgeynta	Nan
التصويت	codbixinta	Nan
التصوير	qaade	None
التضاريس	dhulkoobka	Nan
التعليم	waxbarasho	None
التعليمي	waxbarashada	None
التعليمية	waxbarashada	None
التغذية	nafaqada	Nan
التغير	isbedelka	Nan
التغيرات	isbedelada	Nan
التغيير	beddel	Nan
التغييرات	isbedelada	Nan
التفاصيل	faahfaahinta	Nan
التفاعل	is	None
التفسير	sharaxa	Nan
التفسيرات	faahfaahinta	Nan
التفكير	fikir	Nan
التفوق	ka	None
التقارير	warbixinno	Nan
التعلم	barashada	None
التعريفات	qeexitaanno	Nan
التعريف	qeexida	Nan
التعرية	xarig	Nan
التضخم	sicirbararka	Nan
التطبيق	codsi	None
التطبيقات	codsiyada	Nan
التطبيقية	codsaday	None
التطور	horumarin	Nan
التطورات	horumar	None
التطوير	horumarin	Nan
الثبات	joogto	None
التعاليم	waxbarista	Nan
التعاون	cooperat	Nan
التعبير	muujinta	Nan
التعداد	tirakoobka	Nan
التعديل	hagaajinta	Nan
التعديلات	is-hagaajinta	Nan
التعرض	u	None
التعرف	aqoonso	Nan
التعامل	ka	None
الترجمات	tarjumida	Nan
الثدي	naas	Nan
الثروات	qani	Nan
الجمع	jamac	None
الجمعة	jimce	None
الجمعيات	ururada	None
الجمعية	ururka	None
الجمل	geel	None
الجملة	xukunka	None
الجمهور	dhagaystayaasha	Nan
الجمهوري	jamhuuriga	Nan
الجمهورية	jamhuuriyadda	None
الجميع	walba	None
الجن	jinn	Nan
الجنائية	dembi	None
الجناح	waadhka	Nan
الجنة	jannada	None
الجند	askarta	None
الجمباز	jimicsiga	Nan
الجندي	askariga	Nan
الجماهير	badiyaa	None
الجماعية	wadajir	None
الجسر	buundada	Nan
الجسم	jirka	None
الجسور	buundooyinka	Nan
الجسيمات	waxyaabaha	None
الجغرافي	ahaan	None
الجغرافيا	juqraafi	None
الجغرافية	juqraafi	None
الجفاف	abaarta	None
الجلد	maqaarka	Nan
الجليد	baraf	None
الجليدية	icy	Nan
الجليل	galili	Nan
الجماع	galmo	Nan
الجماعة	bulshada	None
الجماعي	wadajir	None
الجمال	qurux	None
الجسد	jirka	None
الجنرال	guud	None
الجنسي	galmo	Nan
الجولان	golan	Nan
الجوهرة	dahabka	None
الجوي	hawada	None
الجوية	hawada	None
الجيد	fiican	None
الجيدة	wanaagsan	None
الجيزة	giza	Nan
الجيش	ciidan	None
الجيل	jiil	Nan
الجينات	hidayaasha	Nan
الجينوم	hiddo-wadaha	Nan
الجيني	ahaan	None
الجينية	ahaan	None
الجيوش	ciidamada	None
الجيولوجية	juqraafi	None
الجوفية	dhul	None
الجنس	galmo	Nan
الجودة	tayada	None
الجوار	deriska	None
الجنسيات	jinsiyadaha	Nan
الجنسية	muwaadin	Nan
الجنسين	jeneraalada	Nan
الجنوب	koonfurta	None
الجنوبي	koonfurta	None
الجنود	askarta	None
الجنين	uurjiifka	Nan
الجهات	aktarada	Nan
الجهاز	qalabka	None
الجهة	goobta	None
الجهد	dadaal	None
الجهل	jaahil	Nan
الجهود	dadaal	None
الجو	jawiga	None
الجوائز	abaalmarino	Nan
الجوانب	dhinacyada	None
الجزيرة	al	None
الجزية	qabiil	None
الجزيئي	molecular	Nan
الثمانية	sideeda	Nan
الثمانينات	sideetanyadii	Nan
الثمانينيات	sideetanyadii	Nan
الثنائي	lammaanaha	Nan
الثنائية	dhinac	None
الثوار	kacaankii	None
الثورات	kacdoonada	Nan
الثورة	kacaan	None
الثوري	kacaan	None
الثورية	kacaan	None
الجائزة	abaalmarinta	Nan
الجابر	al-jaber	Nan
الجاحظ	bigeye	Nan
الجاذبية	cufnaanta	Nan
الجاز	jazz	Nan
الثلوج	baraf	None
الجاف	qalalan	Nan
الثلج	barafka	Nan
الثلاثينات	konton	Nan
الثروة	dhaqaale	None
الثقافات	dhaqamada	Nan
الثقافة	dhaqanka	None
الثقافي	dhaqan	None
الثقب	godka	None
الثقة	kalsoonida	Nan
الثقفي	dhaqan	None
الثقوب	godad	Nan
الثقيل	culus	None
الثقيلة	culus	None
الثلاث	saddexda	None
الثلاثاء	talaado	None
الثلاثة	saddexda	None
الثلاثي	trio	Nan
الثلاثين	soddon	None
الثلاثينيات	soddonkii	Nan
الجافة	qalalan	Nan
الجاليات	bulshooyinka	Nan
الجالية	bulsho	None
الجديدة	cusub	None
الجدير	yahay	None
الجذور	xididada	Nan
الجرائم	dembiyada	Nan
الجراثيم	jeermiska	Nan
الجراح	dhakhtar qalliin	Nan
الجرمانية	jarmal	None
الجريدة	wargeys	Nan
الجريمة	dembiga	None
الجزء	qaybta	None
الجزائر	algeria	Nan
الجزائري	reer	None
الجزائريين	aljeeriya	None
الجزر	karootada	Nan
الجزيئات	molecules	Nan
الجديد	cusub	None
الجدول	jadwal	Nan
الجدل	khilaaf	None
الجدد	neo	Nan
الجامع	dhamaan	None
الجامعات	jaamacadaha	None
الجامعة	jaamacadda	None
الجامعي	jaamacadda	None
الجامعية	shahaadada	None
الجانب	dhinaca	None
الجانبية	dambe	None
الثدييات	naasaha	None
الجانبين	fadhiyo	Nan
الجاهلية	jaahil	Nan
الجبال	buuraha	None
الجبر	aljebra	Nan
الجبل	buurta	None
الجبلية	buurta	None
الجبهة	horta	Nan
الجدار	darbiga	None
الجاهلي	islaamka	None
الترتيب	diyaarin	Nan
التربية	waxbarasho	None
التربة	ciidda	None
البابوية	papacy-ga	Nan
البابية	dacwad	None
الباحث	cilmi	None
الباحثون	baarayaasha	Nan
الباحثين	baarayaasha	Nan
البارد	qabow	None
الباردة	qabow	None
البارزة	oga	None
البارزين	dhawaan	None
الباطنية	esoteric	Nan
الباقي	kale	None
الباقية	kale	None
البالغ	waaweyn	None
البالغة	waaweyn	None
البالغين	waaweyn	None
البابلية	baabiloon	Nan
البتراء	petra	Nan
البابلي	baabiloon	Nan
الباب	albaabka	None
الانتقال	soo	None
الانتقالية	guurka	None
الانتقام	aargudasho	Nan
الانتهاء	dhameystiray	Nan
الاندلس	andalus	Nan
الاندماج	midnimo	None
الانسحاب	jiidista	Nan
الانضمام	biir	None
الانطروبولوجيا	anthropology	Nan
الانفجار	qaraxa	Nan
الانفصال	go	None
الانقسام	qayb	None
الانقلاب	afgambigii	None
الاهتمام	dan	None
الايكولوجية	deegaanka	None
البابا	baadari	Nan
الانتقادات	dhaleecayn	Nan
البترول	batroolka	None
البحار	badaha	Nan
البراكين	volcanoes	Nan
البرامج	barnaamijyada	None
البربر	berberi	Nan
البربرية	xumo	None
البرتغال	boortaqiiska	Nan
البرتغالي	boortaqiiska	Nan
البرتغالية	boortaqiiska	Nan
البرتغاليين	boortaqiiska	Nan
البرج	qalcaddii	Nan
البركان	qulqulka	Nan
البركاني	volcanic	Nan
البركانية	volcanic	Nan
البرلمان	baarlamaanka	None
البرلمانية	baarlamaan	None
البرمجيات	software	None
البرازيلي	baraasiil	Nan
البث	warbaahin	None
البرازيل	baraasiil	Nan
البذور	seeds	Nan
البحر	badda	None
البحري	badda	None
البحرية	navy	Nan
البحرين	labada	None
البحوث	baaris	None
البحيرات	laamiyada	Nan
البحيرة	harada	Nan
البخار	steam	Nan
البخاري	bukhaari	None
البدء	bilow	None
البدائي	hoose	None
البدائية	aasaasi	None
البداية	bilowga	Nan
البدنية	ahaan	None
البدو	baadiyaha	Nan
البر	xaqnimada	Nan
الانتفاضة	kacdoon	None
الانتصارات	guul	None
الانتصار	guul	None
الاستثمار	maalgashiga	Nan
الاستثمارات	maalgashiga	Nan
الاستخبارات	caqli	None
الاستخدام	isticmaalka	None
الاستخدامات	adeegsada	Nan
الاستراتيجي	istaraatiijiyadeed	Nan
الاستراتيجية	istaraatiijiyadda	Nan
الاستسلام	siinta	Nan
الاستعمار	gumeysiga	None
الاستعماري	gumeystihii	None
الاستعمارية	gumeystihii	None
الاستعمال	adeegso	Nan
الاستفتاء	aftida	Nan
الاستقرار	deganaansho	Nan
الاستقلال	madax-bannaanida	Nan
الازدهار	barwaaqo	None
الاستنساخ	taranka	Nan
الارتفاع	dherer	None
الاختيار	doorashada	None
الاجتماع	ka	None
الاجتماعات	kulamada	Nan
الاجتماعي	bulsho	None
الاجتماعية	bulsho	None
الاجتهاد	diligence	Nan
الاحتباس	haysashada	Nan
الاحتفاظ	hayso	None
الاحتفال	damaashaad	Nan
الاحتفالات	dabaaldegyada	Nan
الاحتكاك	khilaaf	None
الاحتلال	shaqo	None
الاحتياجات	baahiyaha	Nan
الاختبار	tijaabada	Nan
الاختلاف	u	None
الاختلافات	kala	None
الارتباط	xiriirka	None
الاستهلاك	isticmaal	None
الاستواء	heerka	None
الاستوائية	tropical	Nan
الاعمال	ganacsiga	None
الاغنية	heesta	None
الاقتصاد	dhaqaalaha	None
الاقتصادي	dhaqaale	None
الاقتصادية	dhaqaale	None
الاكتشاف	daahfurka	Nan
الاكتشافات	baadhitaanno	Nan
الالتزام	balanqaad	Nan
الامام	imaam	None
الامبراطورية	boqortooyada	None
الامير	amiirka	None
الانتخابات	doorashada	None
الانتخابية	doorashada	None
الانتداب	waajibaadka	Nan
الانتشار	faafitaan	Nan
الاعلام	warbaahinta	None
الاعتماد	aqoonsi	None
الاعتقاد	caqiido	Nan
الاعتراف	aqoonsi	None
الاستيلاء	suuxdin	Nan
الاسكندنافية	scandinavian	Nan
الاسم	magaca	None
الاسود	ah	None
الاشتراك	diiwaan-gelinta	Nan
الاشتراكي	hantiwadaag	Nan
الاشتراكية	hantiwadaagnimada	Nan
البرنامج	barnaamijka	None
الاشتراكيون	hantiwadaagnimada	Nan
الاصطناعي	ahaan	None
الاضطراب	fadeexad	Nan
الاضطرابات	darro	None
الاضطهاد	cadaadiska	Nan
الاضطهادات	cadaadiska	Nan
الاعتبار	tixgelin	Nan
الاعتداء	weerar	None
الاصطناعى	sunta	None
البروتستانت	protestant	Nan
البروتستانتية	faqiirka	Nan
البروتوكولات	hab-raacyada	Nan
التأكيد	xaqiijin	Nan
التأليف	qoreynta	Nan
التأمين	caymis	Nan
التائية	t	None
التابع	socotada	None
التابعة	xiriirka	None
التابعين	soco	None
التاج	taajkii	Nan
التاريخ	taariikh	None
التاريخي	taariikh	None
التاريخية	taariikh	None
التاسع	sagaalaad	None
التاسعة	sagaalaad	None
التالي	xigta	None
التالية	xiga	None
التأكد	hubinta	Nan
التبادل	sarrifka	Nan
التأثيرات	saamaynta	None
البيولوجية	bayoolaji	Nan
البيئات	deegaanka	None
البيئة	deegaanka	None
البيئي	deegaanka	None
البيان	bayaanka	Nan
البيانات	xogta	Nan
البيت	hoyga	None
البيروني	al-biruni	Nan
البيزنطي	byzantin	Nan
البيزنطية	byzantin	Nan
البيزنطيين	biyo-xireyaasha	Nan
البيض	ukunta	Nan
البيضاء	caddaan	Nan
البيعة	ballanqaadka daacadnimada	Nan
البيوت	guryo	None
البيولوجي	bayoolaji	Nan
التأثير	saamaynta	None
التبانة	way	None
التبرعات	tabarucaad	Nan
التبغ	tubaakada	Nan
التحليلية	falanqayn	Nan
التحول	wareejinta	Nan
التحويلية	isbadal	None
التخصص	takhasus	Nan
التخصصات	takhasusyada	Nan
التخطيط	qorshaynta	Nan
التخلص	ka	None
التخلي	dhiib	None
التدخل	dhexgalka	Nan
التدخين	sigaar cabista	Nan
التدريب	tababar	Nan
التدريس	waxbarista	Nan
التراب	wasakh	Nan
التراث	dhaxalka	None
التراجع	soo	None
التحليل	falanqaynta	Nan
التحكيم	xalinta khilaafaadka	Nan
التحكم	xakamayn	Nan
التحقيق	baadhitaan	Nan
التتار	tatar	Nan
التجار	ganacsato	None
التجارب	khibradaha	Nan
التجارة	ganacsi	None
التجاري	ganacsi	None
التجارية	ganacsi	None
التجديد	cusboonaysiinta	Nan
البويضة	ukunta	Nan
التجربة	khibrad	None
التجريبية	tijaabinta	Nan
التجنيد	diiwaangelinta	Nan
التحتية	kaabayaasha	Nan
التحدث	hadal	None
التحرك	guur	None
التحرير	tafatirka	Nan
التحق	isqoray	Nan
التجريبي	demo	Nan
الحائط	darbiga	None
البونيقية	ciil	None
البولندية	polish	Nan
البضائع	badeecada	Nan
البطالة	shaqo	None
البطل	halyeey	None
البطن	caqli	None
البطولات	horyaalada	Nan
البطولة	tartanka	None
البظر	kintirka	Nan
البعث	soobixinta	Nan
البعثات	ergooyinka	Nan
البعثة	hawsha	Nan
البعد	mitirka	Nan
البعض	qaar	None
البعيدة	far	None
البغدادي	al-baghdadi	Nan
البق	dhiqlaha	Nan
البصرية	muuqaal	Nan
البقاء	joog	None
البصريات	optics	Nan
البصرة	basra	Nan
البروتونات	protons	Nan
البروتين	borotiin	Nan
البروتينات	borotiinnada	Nan
البري	duur	None
البرية	duur	None
البريد	boosta	Nan
البريطاني	ingiriiska	None
البريطانية	ingiriiska	None
البريطانيون	ingiriiska	None
البريطانيين	ingiriiska	None
البسيط	fudud	None
البسيطة	fudud	None
البشر	aadanaha	None
البشري	aadanaha	None
البشرية	dadnimo	Nan
البصري	fiican	None
البقر	lo&#39;da	Nan
البقرة	lo&#39;da	Nan
البقعة	sull	Nan
البنك	bangiga	None
البنوك	bangiyada	Nan
البنى	bunni	Nan
البنية	qaabka	None
البهاء	iftiin	Nan
البهائي	bahaa&#39;i	Nan
البهائية	bahaa&#39;iyiinta	Nan
البهائيون	bahaa&#39;iyiinta	Nan
البهائيين	bahaa&#39;iyiinta	Nan
البوابة	irridda	Nan
البوب	boos	Nan
البوذية	buddhism	Nan
البوسفور	bosphorus	Nan
البوسنة	boosniya	Nan
البول	kaadi	Nan
البنفسجية	khafiif	Nan
البنات	gabdhaha	None
البنائية	dhismaha	None
البناء	dhismaha	None
البكارة	bikradnimada	Nan
البكتيريا	bakteeriyada	Nan
البكر	pristine	Nan
البلاد	dalka	None
البلاغة	hadalka	None
البلد	wadan	None
البلدان	wadamada	None
البوم	owls	Nan
البلدة	magaalada	None
البلدية	hoose	None
البلدين	dal	None
البلطيق	baltigga	Nan
البلغارية	bulgaria	None
البلقان	balkans	Nan
البلوغ	baaluqnimada	Nan
البنا	banna	None
البلديات	degmooyinka	None
الاثنين	isniinta	Nan
الحاجة	baahida	None
الحادث	shilka	Nan
الروسي	ruushku	Nan
الروسية	ruush	None
الروضة	xannaanada	Nan
الروم	rum	Nan
الرومان	roomanka	Nan
الرومانسية	jacayl	None
الروماني	roman	None
الرومانية	roomaania	Nan
الرومي	rumi	Nan
الري	waraabka	Nan
الرياح	dabeysha	Nan
الرياض	riyadh	Nan
الرياضات	ciyaaraha	None
الرياضة	ciyaaraha	None
الرياضي	ciyaartooy	Nan
الروس	rushka	Nan
الرياضيات	xisaabaadka	None
الروحية	ruux	None
الروح	ruuxa	Nan
الركن	geeska	None
الركود	isdhaafsiga	Nan
الرمال	ciid	None
الرمز	code	Nan
الرمزي	calaamadaha	Nan
الرمزية	calaamadaha	Nan
الرمل	ciidda	None
الرملية	ciid	None
الرموز	astaamo	None
الرنا	rana	Nan
الرها	edessa	Nan
الرهبان	wadaadadu	Nan
الروابط	xiriirimaha	Nan
الروايات	buugag	Nan
الرواية	sheekada	None
الروحي	ruux	None
الركاب	rakaabka	Nan
الرياضية	ciyaaraha	None
الريف	baadiyaha	Nan
الزهراء	zahra	Nan
الزهرة	ubax	None
الزهري	waraabow	Nan
الزهور	ubaxyada	Nan
الزواج	guur	None
الزواحف	leh	None
الزوار	booqdeyaasha	Nan
الزوايا	fasaxyada	Nan
الزوج	ninka	None
الزوجة	afada	Nan
الزي	dharka	None
الزيادة	kordhinta	None
الزيت	saliida	None
الزيتون	saytuun	Nan
الزيدية	zaidi	Nan
الزمنية	waqtiga	None
الريح	dabeysha	Nan
الزمني	waqtiga	None
الزمرة	clique	Nan
الريفية	miyiga	None
الزاوية	geeska	None
الزبير	zubair	Nan
الزجاج	dhalada	Nan
الزراعة	beeraha	None
الزراعي	beeraha	None
الزراعية	beeraha	None
الزرقاء	buluug	Nan
الزعتر	thyme	Nan
الزعماء	hogaamiyaasha	Nan
الزعيم	hogaamiyaha	None
الزكاة	zakada	Nan
الزلازل	dhulgariirrada	Nan
الزلزال	dhulgariir	None
الزمان	waqtiga	None
الزمن	waqtiga	None
الرقيق	nooca	None
الرقم	tirada	None
الرقص	qoob-ka-ciyaarka	Nan
الرئيسية	weyn	None
الرائدة	hogaanka	None
الرابطة	ah	None
الرابع	afraad	Nan
الرابعة	afaraad	None
الراحة	raaxo	None
الراحل	dambe	None
الراديو	raadiyaha	Nan
الرازي	al-razi	Nan
الراشدين	waaweyn	None
الرافدين	mesopotamia	None
الراقية	dhamaad	Nan
الراهن	ah	None
الرايخ	reer	None
الرب	ilaahow	Nan
الرئيسي	weyn	None
الرباط	rabat	Nan
الرئيسة	madaxweynaha	None
الرئة	sambabka	Nan
الذكري	lab	None
الذكور	lab	None
الذهاب	socda	None
الذهب	dahab	None
الذهبي	dahab	None
الذهبية	dahab	None
الذي	kee	Nan
الذين	kuwee	Nan
الرأس	madaxa	None
الرأسمالي	caasumada	Nan
الرأسمالية	kaabayasha	Nan
الرأي	fikradda	Nan
الرؤية	himilo	Nan
الرئاسة	madaxtooyada	None
الرئاسية	madaxweynaha	None
الرئيس	madaxweynaha	None
الربح	faa&#39;iido	Nan
الربط	isku	None
الربع	quarter	Nan
الرسول	nabiga	None
الرسولي	rasuul	None
الرسوم	lacagta	None
الرشيد	caqliga	None
الرصاص	hogaanka	None
الرصافي	al	None
الرصد	socodka	None
الرضا	qanacsanaanta	Nan
الرطوبة	qoyaan	Nan
الرعاية	daryeel	None
الرغبة	rabitaanka	None
الرغم	kastoo	None
الرفاعي	al-rifai	Nan
الرفض	diidmada	None
الرقابة	xakamaynta	Nan
الرسمية	ah	None
الرسمي	sarkaalku	Nan
الرسم	sawir	None
الرسل	dadkii	None
الربيع	guga	None
الرتب	darajooyin	Nan
الرجال	ragga	None
الرجل	ninka	None
الرجوع	noqo	None
الرحالة	boorso-dhabarka	Nan
الرحلات	safarrada	None
السؤال	su’aasha	Nan
الرحلة	safarka	None
الرحمة	naxariis	None
الرحمن	badan	None
الرحيم	naxariis	None
الرد	jawaabta	Nan
الردة	riddada	Nan
الرسائل	farriimaha	Nan
الرسالة	fariinta	Nan
الرحم	ilmo	None
الذكر	xusuustii	Nan
السائد	adkaaday	None
السائل	dareeraha	Nan
السنوات	sanadihii	None
السنوريات	felidae	Nan
السنوي	sannadle	Nan
السنوية	sannadle	Nan
السني	sunni	None
السنية	sunni	None
السنين	sanadihii	None
السنّة	sanadka	None
السهل	fudud	None
السهول	bannaanka	Nan
السوائل	dareeraha	Nan
السواحل	xeebaha	None
السوبر	super	None
السوداء	madoow	Nan
السودان	suudaan	None
السند	boondhiga	Nan
السوداني	suudaan	None
السنة	sanadka	None
السمك	kalluunka	None
السلطة	maamulka	None
السلطنة	suldaan	None
السلع	alaabada	Nan
السلف	saadaaliye	Nan
السلفية	salafism	Nan
السلم	jaranjarada	Nan
السلمية	nabadoon	None
السلوك	dhaqanka	None
السلوكية	dhaqanka	None
السليم	habboon	None
السليمة	cod	None
السم	sunta	None
السماء	cirka	None
السمات	astaamaha	None
السماح	u	None
السن	da	None
السلطانية	bowlka	Nan
السودانية	suudaan	None
السورة	surah	Nan
السيادة	gobanimada	Nan
السيارات	gawaarida	Nan
السيارة	gaariga	Nan
السياسات	siyaasadaha	Nan
السياسة	siyaasadda	None
السياسي	siyaasadeed	None
السياسية	siyaasadeed	None
السياسيين	siyaasiyiinta	None
السياق	dulucda	None
السيد	sayidkii	Nan
السيدة	marwo	None
السير	soco	None
السيرة	manhajka	None
السيطرة	xakamaynta	Nan
السيف	seefta	Nan
السياحية	dalxiis	None
السور	deedka	Nan
السياحي	dalxiis	None
السياح	dalxiisayaasha	None
السوري	suuriya	None
السورية	suuriya	None
السوفياتي	soofiyeeti	Nan
السوفياتية	soofiyeeti	Nan
السوفيتي	soofiyeeti	Nan
السوفيتية	soofiyeeti	Nan
السوفييت	soviets-ka	Nan
السوفييتي	soofiyeeti	Nan
السوق	suuqa	None
السويد	sweden	None
السويدي	iswidish	Nan
السويدية	iswidish	Nan
السويس	suez	Nan
السويسري	swiss	Nan
السيئة	xun	None
السياحة	dalxiiska	None
السلطان	suldaanku	Nan
السلطات	maamulada	Nan
السلسلة	taxanaha	Nan
السبت	sabti	None
السبع	toddobada	Nan
السبعة	toddobada	Nan
السبعينات	toddobaadkii	Nan
السبعينيات	toddobaadkii	Nan
السبيل	jidka	None
الست	lixda	None
الستة	lixda	None
الستينات	lixdameeyadii	Nan
الستينيات	lixdameeyadii	Nan
السجن	xabsiga	None
السجون	xabsiyada	Nan
السحابة	daruurtii	Nan
السحب	daruuro	None
السد	dam	Nan
السبب	sababta	None
السديري	al-sudairy	Nan
السباحة	dabaasha	Nan
السامة	ah	None
السائلة	dareeraha	Nan
السابع	toddobadii	Nan
السابعة	toddobadii	Nan
السابق	hore	None
السابقة	hore	None
السابقين	ex	None
الساحة	arena	Nan
الساحل	xeebta	None
الساحلي	xeebta	None
الساحلية	xeebta	None
الساخنة	kulul	None
السادات	sadat	Nan
السادس	vi	Nan
الساعة	saacadda	Nan
الساكنة	xasilooni	None
السامية	sare	None
السر	sirta	None
السرطان	kansarka	Nan
السرطانات	kansarka	Nan
السكر	sonkorta	None
السكري	sonkorow	Nan
السكك	tareenka	Nan
السكن	nolosha	None
السكنية	degane	Nan
السلاجقة	seljuks	Nan
السلاح	hubka	None
السلاسل	silsilado	Nan
السلاطين	sultans	Nan
السلالات	harag	None
السلالة	cadaadiska	Nan
السلام	nabadda	None
السلبي	passive	Nan
السلبية	daallanimo	Nan
السلة	dambiisha	Nan
السكانية	dadweynaha	None
السكاني	dadweynaha	None
السكان	dadweynaha	None
السفينة	markabka	Nan
السرطانية	ah	None
السريانية	syriac	Nan
السرية	qarsoodinimada	Nan
السريع	ah	None
السريعة	ah	None
السطح	saqafka	Nan
السطحية	sare	None
السائدة	guuldareysiga	Nan
السعادة	happinese	Nan
السعودية	sacuudiga	None
السعي	baaris	None
السفر	safarka	None
السفلى	hoose	None
السفلي	hoose	None
السفن	maraakiibta	None
السفير	safiirka	None
السعودي	sacuudiga	None
الذكاء	caqli	None
الذرية	farac	None
الذري	atomic	Nan
الحكم	xukunka	None
الحكمة	xikmad	None
الحكومات	dowladaha	None
الحكومة	dowladda	None
الحكومي	dowlada	None
الحكومية	dowlada	None
الحكيم	leh	None
الحل	xalka	Nan
الحلفاء	xulafada	Nan
الحلقات	dhacdooyinka	None
الحلقة	faraantiga	Nan
الحلم	riyada	None
الحلول	xalka	Nan
الحلي	qurxinta	Nan
الحليب	caanaha	None
الحكام	taliyayaasha	Nan
الحليم	halim	Nan
الحقيقية	ah	None
الحقيقة	runta	None
الحصول	hel	Nan
الحضارات	degmooyinka	None
الحضارة	ilbaxnimo	Nan
الحضاري	degan	None
الحضرية	magaalada	None
الحظ	nasiib	None
الحظر	mamnuucida	Nan
الحفاظ	hayso	None
الحفلات	xisbiyada	None
الحق	midig	None
الحقائق	xaqiiqooyinka	Nan
الحقبة	qabta	Nan
الحقل	goob	None
الحقوق	xuquuqda	None
الحقول	beeraha	None
الحقيقي	xaqiiqada	None
الحصان	faraska	None
الحمام	musqusha	Nan
الحماية	ilaalinta	None
الحين	hadda	None
الحيوان	xayawaanka	Nan
الحيوانات	xayawaanka	Nan
الحيوانية	xayawaanka	Nan
الحيوي	biyo	None
الحيوية	ah	None
الخ	iwm	None
الخارج	banaanka	None
الخارجي	dibadda	None
الخارجية	dibadda	None
الخاص	gaar	None
الخاصة	leh	None
الخاصية	hantida	None
الخاضعة	mawduuc	Nan
الخالق	abuuraha	Nan
الحية	toos	None
الحمامات	musqulaha	Nan
الحياد	dhex-dhexaadnimo	Nan
الحي	degmo	None
الحمد	amaan	None
الحمر	py	Nan
الحمراء	casaan	Nan
الحمض	aashito	Nan
الحمل	uurka	Nan
الحملات	ololeyaal	Nan
الحملة	ololaha	Nan
الحميد	hameed	Nan
الحنبلي	hambali	Nan
الحنفي	xanafi	Nan
الحوادث	shilalka	Nan
الحوار	wadahadal	None
الحواس	dareenka	None
الحواسيب	kombiyuutaro	Nan
الحوض	xarkaha	Nan
الحياة	nolosha	None
الحصار	go&#39;doominta	Nan
الحشيش	caano	None
الحشرية	cayayaanka	Nan
الحبيب	gacaliye	Nan
الحج	xajka	None
الحجاب	xaraashka	Nan
الحجاج	xajka	None
الحجارة	dhagxaanta	Nan
الحجاز	xijaz	Nan
الحجة	doodda	Nan
الحجر	dhagax	None
الحجرية	dhagax	None
الحجم	cabirka	None
الحد	xadka	None
الحدائق	beeraha	None
الحداثة	casriga	None
الحدث	dhacdada	Nan
الحدود	xadka	None
الحبوب	midho	Nan
الحدودية	borderlands	Nan
الحبل	xarig	Nan
الحب	jacaylka	None
الحادثة	shilka	Nan
الحار	diirimaad	Nan
الحارة	diirimaad	Nan
الحارث	tiller	Nan
الحاسوب	kombiyuutarka	Nan
الحاصل	qaybta	None
الحاضر	ah	None
الحافظ	geeyaha	Nan
الحافلات	basaska	Nan
الحاكم	taliyihii	None
الحاكمة	xukunka	None
الحال	adverb	Nan
الحالات	kiisaska	Nan
الحالي	hada	None
الحالية	hada	None
الحبشة	itoobiya	None
الحديبية	tubercle	Nan
الحديث	hadalka	None
الحديثة	ah	None
الحروب	dagaal	None
الحروف	xarfaha	None
الحريات	xoriyadaha	Nan
الحرية	xorriyadda	Nan
الحرير	xariir	None
الحريري	al-xariri	Nan
الحزام	xadhiga	Nan
الحزب	xisbiga	None
الحساب	koontada	Nan
الحسن	xasan	None
الحسنة	fiican	None
الحسين	elhussein	Nan
الحسيني	al-hussaini	Nan
الحشرات	cayayaanka	Nan
الحشرة	cayayaanka	Nan
الحرمين	ah	None
الحرم	ah	None
الحركة	dhaqdhaqaaqa	None
الحركات	dhaqdhaqaaqyada	Nan
الحديد	birta	None
الحديدي	ironman	Nan
الحديدية	birta	None
الحديقة	beerta	None
الحذر	taxaddar	Nan
الحر	bilaash	Nan
الحرائق	dabka	None
الخام	caano	None
الحرارة	kuleylka	Nan
الحرارية	dhirta	None
الحرب	dagaalka	None
الحربي	al-xarbi	Nan
الحربية	dagaalka	None
الحرة	bilaash	Nan
الحرس	waardiyaha	Nan
الحرف	dabeecadda	Nan
الحراري	dhirta	None
الخامس	shanaad	None
الخامسة	shanaad	None
الخان	reer	None
الدفاع	difaaca	None
الدفاعية	difaac	Nan
الدقة	go&#39;aan	Nan
الدقيق	fuud	Nan
الدقيقة	daqiiqada	Nan
الدكتوراه	phd	Nan
الدلائل	tilmaamaha	Nan
الدلالة	tilmaam	Nan
الدليل	tilmaanta	Nan
الدم	dhiiga	Nan
الدماء	dhiiga	Nan
الدمار	burbur	None
الدماغ	maskaxda	None
الدمشقي	damascene	Nan
الدموية	dhiiga	Nan
الدعوة	casuumada	Nan
الدنا	dna	Nan
الدعم	taageerada	None
الدعارة	dhillo	Nan
الدجال	quus	Nan
الدخان	qiiq	None
الدخل	dakhli	Nan
الدخول	gaaritaan	Nan
الدراسات	daraasadaha	Nan
الدراسة	barashada	None
الدراسية	waxbarista	Nan
الدراما	riwaayadda	Nan
الدرجات	darajooyinka	Nan
الدرجة	fasalka	Nan
الدروز	qallaji	Nan
الدستور	dastuurka	None
الدستوري	dastuur	None
الدستورية	dastuur	None
الدعاء	soo	None
الدعاية	hype	Nan
الدنمارك	danmark	Nan
الدنيا	aduunka	None
الدهون	dufanka	Nan
الدين	diinta	None
الدينار	dinar	Nan
الديناصور	daroogada	Nan
الديناصورات	diinsoor	None
الدينية	diin	None
الديوان	diwan	Nan
الديون	daynta	Nan
الذئب	yeey	Nan
الذات	isaga	None
الذاتي	isaga	None
الذاتية	mawduuc	Nan
الذاكرة	xusuusta	Nan
الذرات	atom	None
الذراع	gacanta	None
الذرة	galley	Nan
الديموقراطية	dimuqraadiyadda	None
الديموغرافيا	demography	Nan
الديمقراطية	dimuqraadiyadda	None
الديمقراطيات	dimuqraadiyada	None
الدوائر	goobaabin	Nan
الدوافع	dhiirigelinta	Nan
الدوحة	dooxa	None
الدور	doorka	None
الدوران	wareega	None
الدورة	koorsada	Nan
الدوري	horyaal	None
الدجاج	digaag	Nan
الدورية	muddo	None
الدولة	wadan	None
الدولتين	gobol	None
الدولية	caalami	None
الديار	hoyga	None
الديانات	diimaha	None
الديانة	diinta	None
الديمقراطي	dimuqraadi	Nan
الدول	wadamada	None
الحادة	ba&#39;an	Nan
الدبلوماسية	dibloomaasiyadda	Nan
الدار	guriga	None
الخط	khad	None
الخطأ	khaladaadka	Nan
الخطة	qorshaha	Nan
الخطر	khatarta	Nan
الخطط	qorshayaasha	Nan
الخطوات	tallaabooyinka	Nan
الخطوة	tallaabada	Nan
الخطوط	khadadka	Nan
الخطيب	khatib	Nan
الخطيرة	ah	None
الخفيفة	iftiimin	Nan
الخلاص	badbaado	Nan
الخلافات	farqiyada	Nan
الخلافة	guul	None
الخلايا	unugyada	None
الخضراء	cagaar	Nan
الخلف	noqo	None
الخصيب	ciid	None
الخصوبة	taranka	Nan
الخانات	lambarrada	Nan
الخبر	warka	Nan
الخبراء	khubarada	None
الخدمات	adeegyada	None
الخدمة	adeegga	Nan
الخديوي	reer	None
الخرائط	khariidadaha	Nan
الخروج	ka	None
الخريطة	khariidada	Nan
الخسائر	khasaaraha	Nan
الخشب	qoryaha	Nan
الخشبية	wolood	Nan
الخصائص	guri	None
الخصبة	lush	Nan
الخصم	qiimo	None
الخصوص	ahaan	None
الخلفاء	kalfadhiyada	Nan
الخلفية	asalka	None
الخلق	abuurista	Nan
الخوف	cabsida	None
الخيال	imaatinka	Nan
الخيالة	fuulay	None
الخيام	teendhooyinka	Nan
الخير	fiican	None
الخيرية	sadaqo	None
الخيل	faraska	None
الخيول	fardo	None
الدائرة	goobaabin	Nan
الدائري	garaac	Nan
الدائم	ah	None
الدائمة	istaag	Nan
الداخل	gudaha	None
الداخلي	habka	None
الداخلية	gudaha	None
الخواص	guri	None
الخوارزمي	alkhawarizmi	Nan
الخوارج	kharijites	Nan
الخندق	la	None
الخلوي	gacanta	None
الخلوية	gacanta	None
الخلية	qolka	Nan
الخليج	gacanka	None
الخليجي	al	None
الخليجية	gacanka	None
الخليفة	khaliif	None
الدانوب	danube	Nan
الخليل	xebroon	Nan
الخمس	shanta	None
الخمسة	shanta	None
الخمسينات	iyo	None
الخمسينيات	iyo	None
الخميس	khamiista	None
الخنازير	doofaarrada	Nan
الخنافس	beetles	Nan
الخمر	khamri	Nan
الاثني	qowmiyadeed	Nan
الاتهام	eedaynta	Nan
الاتفاقية	heshiis	None
أنهما	waa	None
أنهى	dhammayn	Nan
أنواع	noocyada	None
أنواعها	noocyadeeda	None
أنوبيس	anubis	Nan
أنور	anwar	Nan
أني	ahay	None
أنّ	taasi	None
أنّه	a	None
أهالي	dadka	None
أهداف	yoolalka	Nan
أهدافها	hadafyadeeda	Nan
أهل	dadka	None
أهله	qoyskiisa	Nan
أهلها	qoyskeeda	Nan
أنهم	ay	None
أهلية	u-qalmitaanka	Nan
أنهار	burburtay	None
أنه	a	None
أنس	anas	Nan
أنسجة	tissue	Nan
أنشأت	aasaasay	None
أنشئ	abuur	Nan
أنشئت	aasaasay	None
أنشطة	hawlaha	None
أنصار	taageerayaasha	None
أنطاكية	antiyokh	Nan
أنظر	fiiri	None
أنظمة	nidaamyada	Nan
أنفسهم	naftooda	None
أنقرة	ankara	Nan
أنك	tahay	None
أنماط	naqshadaha	Nan
أننا	nahay	None
أنها	waxaa	None
أندية	naadiyada	Nan
أهم	muhiimsan	None
أهمية	muhiimadda	Nan
أوسع	balaadhan	None
أوسلو	oslo	Nan
أوصى	talin	None
أوضاع	hababka	None
أوضح	sharaxay	Nan
أوضحت	waxay	None
أوقات	waqtiyo	None
أوقطاي	waqtigeyga	Nan
أوكرانيا	yukreeniyaan	Nan
أول	hore	None
أولئك	kuwaas	None
أولا	hore	None
أولاد	caruurta	None
أولاده	caruurtiisa	None
أولاً	hore	None
أوساط	warbaahinta	None
أهمها	muhiimsan	None
أوروبية	yurub	None
أوروبا	yurub	None
أهميتها	muhiimadeeda	Nan
أو	ama	None
أوائل	hore	None
أواخر	dambe	None
أواسط	dhexe	None
أوامر	amarada	None
أوامره	amarkiisa	Nan
أوباما	obama	None
أوبرا	oprah	Nan
أوج	apogee	Nan
أوجه	xaraash	Nan
أوراق	caleemaha	Nan
أورانوس	uranus	Nan
أورخان	orhan	Nan
أورشليم	yeruusaalem	Nan
أوروبي	yurub	None
أنحاء	weyn	None
أنجلوسكسونيون	isxigxiga	Nan
أنجبت	dhalasho	None
ألعاب	alaabada	Nan
ألف	kun	None
ألفا	alfa	Nan
ألفًا	alfa	Nan
ألقاب	naaneystayaal	Nan
ألقى	u	None
ألكسندر	alexander	Nan
ألكيل	alkyl	Nan
ألمانيا	jarmalka	None
ألمانية	jarmalka	None
ألوان	midabada	Nan
أم	hooyo	None
أما	sida	None
أماكن	meelaha	None
أمام	kahor	None
ألدهيد	aldehyde	Nan
أمامه	hortiisa	None
ألبوم	album	Nan
ألبانيا	albania	None
أقوى	badan	None
أقيم	waan	None
أقيمت	sax	None
أكاديمية	akadeemiyada	Nan
أكان	akan	Nan
أكتوبر	oktoobar	None
أكثر	inbadan	None
أكثرها	badan	None
أكد	xaqiijiyay	Nan
أكدت	xaqiijiyay	Nan
أكسيد	oxide	Nan
أكل	cunay	None
أكمل	dhameystiran	Nan
ألا	reebo	None
ألاسكا	alaska	Nan
ألبرت	albert	Nan
أمانة	daacadnimo	Nan
أمة	hooyadiis	None
أمثال	jeceshahay	Nan
أمور	waxyaabaha	None
أمية	aqoon	None
أمير	amiir	None
أمين	aaminaad	Nan
أمّا	sida	None
أن	taasi	None
أنا	aniga	None
أنابيب	tuubooyinka	Nan
أناكوندا	anaconda	Nan
أنباء	news	None
أنبياء	nabiyada	Nan
أنت	adiga	None
أنتج	saaray	None
أنتجت	saaray	None
أنثى	dhedig	Nan
أموال	lacagaha	None
أمه	hooyadiis	None
أمن	amniga	None
أمم	ummadaha	None
أمثلة	tusaalooyin	Nan
أمر	taliska	None
أمرا	amarka	Nan
أمراء	amiirrada	Nan
أمراض	cudurrada	Nan
أمره	amarkiisa	Nan
أمرهم	amray	None
أولها	midkoodna	Nan
أمريكا	usa	None
أمريكية	ah	None
أمريكيون	mareykan	Nan
أمرًا	amarka	Nan
أمطار	roob	None
أمفورة	amphora	Nan
أمكن	suurtagal	Nan
أمل	leh	None
أمريكي	ah	None
أقواله	hadaladiisa	Nan
أولى	hore	None
أوّل	hore	None
إلهام	muhiim	None
إلى	ii	None
إلي	ii	None
إليك	adiga	None
إلينا	anaga	Nan
إليه	farsamada	None
إليها	iyada	None
إليهم	iyaga	None
إم	hooyo	None
إما	sida	None
إمارة	emirate	Nan
إمام	kahor	None
إمبراطور	boqor	None
إمبراطورية	boqortooyada	None
إمكانية	suurtagal	Nan
إله	mashiinka	Nan
إنا	aniga	None
إلقاء	tuur	None
إلاّ	reebo	None
إطلاق	sii	None
إعادة	noqo	None
إعداد	diyaarinta	Nan
إعطاء	sii	None
إعلامية	wargelin	Nan
إعلان	xayeysiinta	Nan
إف	f	None
إفراز	sirta	None
إفريقيا	afrika	None
إفريقية	ah	None
إقامة	degaan	None
إقليم	gobolka	None
إقليمية	gobol	None
إل	the	None
إلا	reebo	None
إلغاء	joojinta	Nan
إطار	guud	None
إنتاج	soosaarid	Nan
إنتاجها	saarkooda	None
إياها	waxaa	None
إيجاد	raadinta	Nan
إيران	iiraan	None
إيرث	dhulka	None
إيطاليا	italia	Nan
إيفان	ivan	Nan
إيفل	eiffel	Nan
إيقاف	leexinta	Nan
إيه	aayadda	None
إِلا	reebo	None
إِلَى	ii	None
ا	a	None
ابتداء	bilaabo	None
ابتناء	cudurka	None
ابن	wiil	None
إياه	isaga	None
إنتاجه	soosaar	Nan
إنّ	taasi	None
إنهم	ay	None
إنترنت	internetka	None
إنجازات	guul	None
إنجلترا	ingiriiska	None
إنجليزية	ingiriis	None
إنجيل	injiilka	Nan
إندونيسيا	indonesia	None
إنسان	nin	None
إنسانية	humane	Nan
إنشاء	dhiso	None
إنشائها	iyaga	None
إنفلونزا	hargab	Nan
إنكار	diidmada	None
إنما	halkii	None
إنها	waxaa	None
إنهاء	dhamaanaya	Nan
إني	aniga	None
إضافية	ah	None
إضافةً	dheer	None
إضافة	dheer	None
أَنْ	taasi	None
إبادة	xasuuq	None
إبان	lagu	None
إبراهيم	ibraahim	None
إثارة	farax	None
إثبات	cadayn	Nan
إثر	saameyn	Nan
إثيوبيا	itoobiya	None
إجراء	habka	None
إجراءات	nidaamyada	Nan
إجماع	ogolaansho	Nan
إجمالي	wadarta	None
إحباط	jahwareer	Nan
إحداث	dhacdooyinka	None
إحدى	mid	None
أَنَّ	taasi	None
إحصاء	tirinta	Nan
أيوب	ayoub	Nan
أينشتاين	einstein	Nan
أى	kee	Nan
أي	kee	Nan
أيام	maalmood	None
أيامه	maalmihiisii	Nan
أيبك	aybak	Nan
أية	aayadda	None
أيدي	gacmaha	None
أيديهم	gacmahooda	Nan
أيرلندا	ireland	Nan
أيضا	kale	None
أيضاً	kale	None
أيضًا	kale	None
أيلول	sebtember	Nan
أيمن	aimen	Nan
أين	halkee	Nan
أيها	hey	Nan
إحصاءات	tirakoobka	Nan
إحصائيات	tirakoobka	Nan
إحياء	bayoolaji	Nan
إسرائيل	israa&#39;iil	Nan
إسطنبول	istanbul	Nan
إسقاط	saadaasha	Nan
إسلام	islaamka	None
إسلامه	islaamnimadiisa	None
إسلامي	islaami	None
إسلامية	islaam	None
إسماعيل	ismaaciil	None
إشارات	calaamadaha	Nan
إشارة	saxeex	Nan
إشعاع	shucaac	Nan
إصابة	caabuq	Nan
إصدار	soo	None
إصلاح	dayactir	None
إصلاحات	dayactir	None
إسحاق	isxaaq	None
إستراتيجية	istiraatiijiyad	Nan
إسبانيا	isbaanish	Nan
إس	s.	Nan
إخراج	isku	None
إخوته	walaalihiis	Nan
إدارة	maareynta	Nan
إداري	maamulka	None
إدارية	maamulka	None
إدخال	gal	None
إدراك	xaqiijinta	Nan
أولية	horudhac	Nan
إذ	darteed	None
إذاعة	warbaahinta	None
إذن	dhegaha	None
إرادة	doonaa	None
إرتريا	ereteriya	None
إرسال	dir	None
إرهابية	argagixiso	Nan
إزالة	saarid	Nan
إذا	haddii	None
أقوال	ereyada	None
أقمار	dayaxa	None
أقلية	yahay	None
أحسن	ugufiican	Nan
أحكام	qodobbada	Nan
أحلام	riyooyin	Nan
أحمد	axmad	None
أحمدي	axmad	None
أحمر	casaan	Nan
أحوال	xaaladaha	None
أحياء	bayoolaji	Nan
أحيان	qaar	None
أحيانا	qaar	None
أحياناً	qaar	None
أحيانًا	qaar	None
أخاه	walaalkiis	None
أخبار	wararka	None
أخت	walaasha	Nan
أحزاب	dhinacyada	None
أخته	walaashiis	Nan
أحدهما	ah	None
أحدث	dambeeyay	None
أجريت	sameeyay	None
أجزاء	qaybo	None
أجسام	jidhka	Nan
أجل	haa	None
أجمع	waan	None
أجمل	badan	None
أجنبية	dibadda	None
أجنحة	baalasheeda	Nan
أجهزة	aaladda	Nan
أحادي	hal	None
أحاديث	xadiiska	None
أحب	waan	None
أحجية	xujooyin	Nan
أحد	mid	None
أحداث	dhacdooyinka	None
أحدهم	qof	None
أجرى	orod	None
أخذ	qaadashada	None
أخر	kale	None
أدوار	ciyaaraha	None
أدولف	adolf	Nan
أدوية	daawooyin	Nan
أدى	gaaray	None
أدّت	gaaray	None
أدّى	sameeyay	None
أذربيجان	azerbaijan	Nan
أراد	raba	None
أرادت	rabtay	None
أراض	dhul	None
أراضي	dhul	None
أراضيها	dhulkeeda	None
أرباع	quarters	Nan
أربع	afar	None
أربعة	afar	None
أدنى	yar	None
أخذت	qaatay	None
أدناه	ka	None
أدرك	xaqiiqsaday	Nan
أخرج	bax	Nan
أخرى	kale	None
أخطاء	khaladaadka	Nan
أخطر	badan	None
أخلاقية	ahaan	None
أخوه	walaalayaal	Nan
أخيرا	ugu	None
أخيه	walaalkiis	None
أخيون	walaal	None
أداء	waxqabadka	Nan
أداة	qalab	None
أدب	suugaanta	None
أدبية	suugaanta	None
أدت	gaaray	None
أدخل	gal	None
أدلة	tilmaamaha	Nan
أجراها	sameeyay	None
أجرام	danbi	None
أجبر	qasbay	None
آلات	mashiinnada	Nan
آلاف	kumanaan	None
آلام	hooyada	None
آلة	mashiinka	Nan
آلهة	illaah	Nan
آلية	farsamada	None
آمن	amniga	None
آمنة	nabdoon	Nan
آمون	aamoon	Nan
آن	taasi	None
آنذاك	wakhtigaas	None
آي	kee	Nan
آيات	aayadaha	None
آية	aayadda	None
أ	a	None
آل	the	None
أئمة	imaamyada	Nan
آشوربانيبال	ashurbanipal	Nan
آسكي	ascii	Nan
+	+	None
=	=	None
==	==	None
|	|	None
°	°	Nan
°م	c	None
آثار	saamaynta	None
آثارها	saamayntooda	Nan
آخر	kale	None
آخرها	dambeeyay	None
آخرون	kale	None
آخرين	kale	None
آخيل	achilles	Nan
آدم	aadan	None
آراء	fikradaha	Nan
آسيا	aasiya	None
أب	aabe	None
أبا	oppa	Nan
أباتيت	apatite	Nan
أتاتورك	ataturk	Nan
أتباع	socda	None
أتباعه	asxaabtiisa	None
أتت	yimid	None
أتى	yimid	None
أثار	saamaynta	None
أثارت	carooday	Nan
أثبت	cadeeyay	None
أثبتت	muujiyay	Nan
أثر	saameyn	Nan
أثرت	saameeyay	Nan
أثره	saameynteeda	Nan
أثرية	ah	None
أثناء	lagu	None
أثينا	athena	Nan
أبيه	aabihiis	None
أبيب	telefoon	None
أبي	aabahay	Nan
أبى	aabahay	Nan
أباه	aabihiis	None
أبحاث	baaris	None
أبدا	bilow	None
أبداً	bilow	None
أبدًا	bilow	None
أبرز	mudan	None
أبرزها	mudan	None
أربعين	afartan	Nan
أبريل	abriil	None
أبعد	fog	None
أبناء	carruurta	None
أبنائه	wiilashiisa	Nan
أبو	abuu	None
أبواب	albaab	Nan
أبوظبي	abu	None
أبوه	aabihiis	None
أبطال	horyaal	None
أرجاء	loo	None
أرخبيل	archipelago	Nan
أرخميدس	archimedes	Nan
أعداء	cadawga	None
أعدائه	cadaawayaashiisa	Nan
أعداد	diyaarinta	Nan
أعراض	calaamadaha	Nan
أعضاء	xubnaha	None
أعطى	siiyay	None
أعظم	weyn	None
أعقاب	dib	None
أعلام	calanka	None
أعلاه	kor	None
أعلم	waan	None
أعلن	xayeysiin	Nan
أعلنت	dhawaaqday	None
أعلى	sare	None
أعمال	ganacsiga	None
أعاد	celi	None
أعماله	shaqadiisa	None
أظهرت	waan	None
أطول	dheer	None
أصله	ahaan	None
أصلها	ahaan	None
أصوات	codadka	Nan
أصول	ahaan	None
أصيب	dhaawacmay	None
أضاف	ayuu	None
أضخم	weyn	None
أضرار	khasaaraha	Nan
أضعاف	labanlaab	Nan
أضلاع	feeraha	Nan
أطراف	dhinacyada	None
أطفال	caruurta	None
أطلق	siideyn	Nan
أطلقت	bilaabay	None
أطوال	dhererka	Nan
أظهر	is	None
أعمالها	ganacsigeeda	Nan
أعمدة	tiirarka	None
أعوام	sanado	None
أفلام	filimaan	Nan
أفلامه	filimadiisa	Nan
أفندي	effendi	Nan
أقاليم	degmooyinka	None
أقام	joog	None
أقبل	aqbal	Nan
أقدم	weyn	None
أقر	gudubtay	Nan
أقرب	dhow	None
أقسام	qaybaha	None
أقصر	gaaban	None
أقصى	ugu	None
أقطار	dhexroor	Nan
أقل	kayar	Nan
أقليات	yahay	None
أفلاطون	plato	Nan
أفكاره	fikradihiisa	Nan
أفكار	fikradaha	Nan
أفغانستان	afgaanistaan	None
أعيد	noqday	None
أغاني	heeso	None
أغراض	ujeeddooyin	Nan
أغسطس	ogast	Nan
أغلب	badan	None
أغلبها	badankood	None
أغلبية	aqlabiyad	None
أصلاً	ahaan	None
أغنى	taajirsan	None
أفراد	shakhsiyaadka	Nan
أفرادها	xubnaheeda	Nan
أفرودة	afroda	Nan
أفريقيا	afrika	None
أفريقية	ah	None
أفضل	ugufiican	Nan
أفعال	afkaarta	Nan
أغنية	heesta	None
ابنة	gabar	None
أصلا	ahaan	None
أصفر	ah	None
أساسًا	ahaan	None
أساليب	farsamooyinka	Nan
أسامة	ossama	Nan
أسباب	sababaha	None
أسبانيا	isbaanish	Nan
أسبوع	todobaad	None
أستاذ	borofisar	Nan
أستراليا	australia	None
أسد	libaax	None
أسر	qabashada	Nan
أسرار	sirta	None
أسرة	reerka	None
أسرته	qoyskiisa	Nan
أسرع	ah	None
أسس	aasaasid	Nan
أساسية	ah	None
أسست	aasaasay	None
أساسيا	ah	None
أساساً	ahaan	None
أرسطو	aristotle	Nan
أرسل	dir	None
أرسلان	arslan	Nan
أرسلت	diray	None
أرسله	dir	None
أرض	dhul	None
أرضية	dabaqa	None
أرقام	lambarada	Nan
أركان	sidiyo	Nan
أرمينيا	armenia	Nan
أزمة	qalalaase	None
أس	ace	Nan
أسابيع	toddobaadyo	Nan
أساس	aasaaska	None
أساسا	ahaan	None
أساسي	ah	None
أسسها	aasaasay	None
أسطورة	halyeeyo	Nan
أسطول	diyaarad	Nan
أشد	tougher	Nan
أشرف	ashraf	Nan
أشعة	fallaaraha	Nan
أشكال	qaababka	None
أشهر	bilooyin	Nan
أشهرها	caansan	None
أشياء	waxyaabaha	None
أصابع	faraha	None
أصبح	noqday	None
أصبحوا	noqdeen	None
أصحاب	asxaabta	Nan
أصحابه	ehelka	Nan
أصدر	saaray	None
أصدرت	saaray	None
أصغر	kayar	Nan
أشخاص	dadka	None
أشجار	geedaha	None
أشبه	ah	None
أشارت	waxay	None
أسعار	qiimaha	None
أسعد	farxad	None
أسفر	saar	None
أسفرت	siiyay	None
أسفل	hoos	None
أسلحة	hubka	None
أسلم	ammaan	None
أصل	ahaan	None
أسلوب	qaab	None
أسمهان	asmahan	Nan
أسهم	kaydka	None
أسوأ	xumaa	None
أسوار	dayrarka	Nan
أسواق	suuqyada	None
أسود	madow	None
أشار	tilmaamay	None
أسماء	magacyada	None
ابنته	gabadhiisa	Nan
ابنه	gabar	None
ابي	aabahay	Nan
الأمد	muddada	Nan
الأمر	arinta	None
الأمراء	amiirrada	Nan
الأمراض	cudurrada	Nan
الأمريكتين	ameerika	None
الأمريكي	ah	None
الأمريكية	ah	None
الأمريكيون	ah	None
الأمريكيين	ah	None
الأمصار	baaskiillada	Nan
الأمطار	roob	None
الأمعاء	intestine	Nan
الأمل	rajo	None
الأملاح	cusbada	Nan
الأمم	ummadaha	None
الأمثلة	tusaalooyin	Nan
الأمن	amniga	None
الأمثال	maahmaah	Nan
الأمانة	daacadnimo	Nan
الألبانية	albaaniyaan	Nan
الألف	alif	None
الألفية	millennium	Nan
الألم	xanuunka	Nan
الألمان	jarmalka	None
الألماني	jarmalka	None
الألمانية	jarmalka	None
الألواح	taargooyinka	Nan
الألوان	midabada	Nan
الأم	hooyada	None
الأمازيغ	beeraleyda	Nan
الأمازيغية	berber	Nan
الأماكن	meelaha	None
الأمام	soco	None
الأمان	nabdoonaanta	Nan
الأمة	qaran	None
الألبان	caano	None
الأمنية	hamiga	Nan
الأموال	lacag	None
الأندية	naadiyada	Nan
الأنسجة	tissue	Nan
الأنسولين	insulin	Nan
الأنشطة	hawlaha	None
الأنصار	ansar	Nan
الأنصاري	al	None
الأنطروبولوجيا	anthropology	Nan
الأنظمة	nidaamyada	Nan
الأنف	sanka	None
الأنفاق	tunelada	Nan
الأنماط	qaababka	None
الأنهار	webiyada	Nan
الأنواع	noocyada	None
الأهالي	waaliddiinta	Nan
الأهداف	ujeeddooyinka	Nan
الأندلس	andalus	Nan
الأمواج	hirarka	Nan
الأنثى	dumar	None
الأنبياء	nebiyadii	Nan
الأمور	dhaca	None
الأموي	umayyad	Nan
الأموية	umayyad	Nan
الأمويون	umayyads	Nan
الأمويين	umayyads	Nan
الأمية	aqoon	None
الأمير	amiirka	None
الأميرة	amiirad	Nan
الأميركي	ah	None
الأميركية	ah	None
الأمين	xoghayaha	None
الأنا	ego	Nan
الأناجيل	baybalka	None
الأناضول	anatolia	Nan
الأنباء	wararka	None
الأنثروبولوجيا	cilmu-nafsiga	Nan
الألب	alps	Nan
الأكسجين	ogsajiinta	Nan
الأكراد	kurdiyiinta	Nan
الأصول	ahaan	None
الأضحى	al-adha	Nan
الأضرار	khasaaraha	Nan
الأضلاع	feeraha	Nan
الأطباء	dhakhaatiirta	Nan
الأطباق	suxuunta	Nan
الأطراف	xisbiyada	None
الأطرش	atrash	Nan
الأطعمة	cunnooyinka	Nan
الأطفال	carruurta	None
الأطلس	atlas	Nan
الأطلسي	atlanta	Nan
الأعداء	cadawga	None
الأعداد	diyaarinta	Nan
الأعراض	astaamaha	None
الأصوات	codadka	Nan
الأعراق	qowmiyadaha	Nan
الأصناف	noocyada	None
الأصليون	dhaladka	Nan
الأشجار	geedaha	None
الأشخاص	shakhsiyaadka	Nan
الأشراف	kormeerka	Nan
الأشرف	ashraf	Nan
الأشعة	rays	Nan
الأشعري	al-ashcari	Nan
الأشكال	qaababka	None
الأشهر	bilooyin	Nan
الأشياء	waxyaabaha	None
الأصدقاء	asxaabta	Nan
الأصغر	yar	None
الأصفر	jaale	None
الأصل	ahaan	None
الأصلي	ah	None
الأصلية	asalka	None
الأصليين	ah	None
الأعشاب	dhirta	None
الأعصاب	dareemayaasha	Nan
الأعضاء	xubnaha	None
الأفلام	filimada	Nan
الأفيون	opium	Nan
الأقاليم	degmooyinka	None
الأقدس	ugu	None
الأقدم	weyn	None
الأقرب	dhow	None
الأقسام	qaybaha	None
الأقصى	far	None
الأقطار	diagonals	Nan
الأقل	yar	None
الأقليات	yahay	None
الأقمار	dayaxa	None
الأقوال	ereyada	None
الأكاديمية	akadeemiyada	Nan
الأكبر	weyn	None
الأفكار	fikradaha	Nan
الأفغاني	afgaanistaan	None
الأفعال	falalka	None
الأفضل	ugufiican	Nan
الأعظم	weyn	None
الأعلام	warbaahinta	None
الأعلى	xusan	None
الأعمال	ganacsiga	None
الأعمدة	tiirarka	None
الأعوام	sanado	None
الأغالبة	aghlabis	Nan
الأهرام	pyramids	Nan
الأغاني	heeso	None
الأغراض	alaabtii	Nan
الأغلب	badanaa	None
الأغلبية	badan	None
الأغنية	heesta	None
الأفراد	shakhsiyaadka	Nan
الأفريقي	ah	None
الأفريقية	ah	None
الأغذية	cunto	None
الأهرامات	pyramids	Nan
الأهلي	al-ahly	Nan
الأهلية	u-qalmitaanka	Nan
الإقليمي	gobol	None
الإقليمية	gobol	None
الإلحاد	diin	None
الإلكترون	elektarooniga	Nan
الإلكترونات	elektaroonigga	Nan
الإلكترونية	e	None
الإله	ilaah	None
الإلهي	ilaahnimadiisa	Nan
الإلهية	ilaahnimadiisa	Nan
الإمارات	uae	Nan
الإمارة	emirate-ka	Nan
الإمامة	imaam	None
الإمامية	imaami	Nan
الإمبراطور	amiirka	None
الإمبراطورية	boqortooyada	None
الإقليم	territory	Nan
الإمدادات	sahayda	Nan
الإقامة	degenaansho	None
الإفريقي	ah	None
الإصابة	dhaawac	None
الإصدار	siideyn	Nan
الإصلاح	hagaaji	Nan
الإصلاحات	dayactirka	Nan
الإصلاحية	asluubta	None
الإطار	jirku	Nan
الإطلاق	bilaabida	Nan
الإعدام	dilalka	Nan
الإعلام	warbaahinta	None
الإعلامي	wargelin	Nan
الإعلان	xayeysiinta	Nan
الإعلانات	xayeysiis	Nan
الإغريق	giriiggii	Nan
الإغريقي	giriig	None
الإغريقية	giriig	None
الإفريقية	ah	None
الإناث	dumar	None
الإنتاج	soosaarid	Nan
الإنتاجية	saar	None
الإيطاليين	talyaani	None
الإيمان	iimaan	None
الا	reebo	None
الائتلاف	isbahaysiga	Nan
الابتدائي	aasaaska	None
الابتدائية	aasaaska	None
الابن	wiil	None
الاتجاه	jihada	Nan
الاتجاهات	jihooyinka	Nan
الاتحاد	midowga	None
الاتحادية	federaalka	None
الاتصال	iskuxirka	Nan
الاتصالات	isgaarsiinta	None
الاتفاق	heshiiska	None
الاتفاقيات	heshiisyada	Nan
الإيطالية	talyaani	None
الإيطالي	talyaani	None
الإيرانية	iiraaniyiin	Nan
الإيراني	iiraaniyiin	Nan
الإنترنت	internetka	None
الإنجليز	ingiriisiga	None
الإنجليزي	ingiriisiga	None
الإنجليزية	ingiriisiga	None
الإنجيل	injiilka	Nan
الإنسان	aadanaha	None
الإنساني	aadanaha	None
الإشعاعي	raadiyaha	Nan
الإنسانية	dadnimo	Nan
الإنفاق	bixinta	None
الإنفلونزا	hargab	Nan
الإنكشارية	janissaries	Nan
الإنكليزي	ingiriis	None
الإنكليزية	ingiriis	None
الإيجابية	fiican	None
الإيدز	aids	Nan
الإنشاء	abuurista	Nan
الأسود	ah	None
الإشعاع	shucaaca	Nan
الإسماعيلية	ismaaciilia	Nan
الأوقات	jeer	None
الأوكراني	yukreeniyaan	Nan
الأوكرانية	yukreeniyaan	Nan
الأول	horreeyay	None
الأولمبية	olombikada	None
الأولى	hore	None
الأولي	bilow	None
الأولية	aasaaska	None
الأيام	maalmaha	None
الأيبيرية	iberian	Nan
الأيسر	bidix	None
الأيمن	midig	None
الأيوبي	al	None
الأيوبية	ayyubid	Nan
الإباحية	filimka filimka	Nan
الأوعية	bambooyinka	Nan
الإبادة	burburinta	None
الأوضاع	xaaladaha	None
الأوسط	dhexe	None
الأهم	muhiimsan	None
الأهمية	muhiimadda	Nan
الأوائل	sare	None
الأوامر	amarada	None
الأوبرا	opera	Nan
الأودية	dooxooyinka	Nan
الأوراق	caleemaha	Nan
الأورام	bambooyin	Nan
الأوربية	yurub	None
الأوروبي	yurub	None
الأوروبية	yurub	None
الأوروبيون	yurub	None
الأوروبيين	yurub	None
الأوزون	ozone	Nan
الأوساط	goobaabin	Nan
الأوسمة	qurxinta	Nan
الإباضية	ibadi	Nan
الإبداع	hal-abuurnimo	Nan
الإبراهيمية	ibraahim	None
الإرادة	doono	None
الإرشاد	la-talin	Nan
الإرهاب	argagixisanimo	Nan
الإسبان	isbaanishka	Nan
الإسباني	isbaanishka	Nan
الإسبانية	isbaanish	Nan
الإسراء	isra	Nan
الإسرائيلي	israa’iil	Nan
الإسرائيلية	israa’iil	Nan
الإسرائيليين	israa’iil	Nan
الإسكندر	alexander	Nan
الإسكندرية	alexandria	Nan
الإسلام	islaamka	None
الإسلامي	islaam	None
الإسلامية	islaam	None
الإذاعة	idaacadda	Nan
الإدعشري	el	None
الإدارية	maamulka	None
الإداري	maamulka	None
الإبل	geela	None
الإتحاد	midowga	None
الإثارة	farxad	None
الإثنين	isniinta	Nan
الإجابة	jawaabta	Nan
الإجراءات	tallaabooyinka	Nan
الإجماع	isku	None
الإشارات	calaamadaha	Nan
الإجمالي	wadarta	None
الإحساس	dareenka	None
الإحصاء	tirakoobka	Nan
الإحصاءات	tirakoobka	Nan
الإحصائيات	tirakoobka	Nan
الإحصائية	tirakoob	None
الإخوان	walaal	None
الإدارة	maamulka	None
الإجمالية	wadarta	None
السينما	shineemo	None
الأسواق	suuqyada	None
الأسمدة	bacriminta	Nan
استقرار	xasiloonida	None
استقرت	degen	None
استقلال	madaxbanaanida	None
استقلالها	xornimadeeda	Nan
استكشاف	sahaminta	Nan
استمر	sii	None
استمرار	sii	None
استمرت	waa	None
استنادا	ku	None
استنادًا	ku	None
استهلاك	isticmaalka	None
استولى	qabtay	None
استيراد	soo	None
اسم	noor	Nan
اسمه	magaceeda	None
استقر	xasil	Nan
اسمها	magaceeda	None
استقبال	rasiid	Nan
استفتاء	aftida	Nan
استخراج	bixi	None
استراتيجية	istiraatiijiyad	Nan
استرجاع	soo	None
استسلام	dhiib	None
استسلمت	waan	None
استضافة	gelinta	None
استطاع	kari	None
استطاعت	way	None
استطلاع	u	None
استعادة	soo	None
استعداد	diyaar	None
استعمال	isticmaal	None
استعمالها	adeegso	Nan
استعمل	isticmaal	None
استغلال	ka	None
استقالته	iscasilaadiisa	Nan
استخدمها	adeegso	Nan
اشتد	adkeyn	Nan
اشتهر	yaqaan	None
اعتمادا	waxay	None
اعتمد	aaminid	Nan
اعتمدت	korsaday	Nan
اعتناق	duub	None
اعتنق	laabtay	None
اغتيال	dilaaga	Nan
اغتياله	dilkiisa	None
افتتاح	furitaanka	Nan
افتتح	furay	None
افتتحت	furay	None
اقتراب	dariiqa	Nan
اقتراح	soojeedin	Nan
اقترح	soo	None
اقتصاد	dhaqaale	None
اقتصادها	dhaqaalaheeda	Nan
اعتماد	ansixinta	Nan
اشتراكية	hantiwadaag	Nan
اعتقد	ka	None
اعتقاد	caqiido	Nan
اشتهرت	noqotay	None
اصدار	soo	None
اضطر	qasbay	None
اضطراب	khalkhal	Nan
اضطرابات	khilaafka	None
اضطهاد	cadaadis	None
اعادة	noqo	None
اعتبار	tixgelin	Nan
اعتبارا	saameyn	Nan
اعتباراً	tixgeli	Nan
اعتبارها	maskaxda	None
اعتبر	tixgelin	Nan
اعتبرت	tixgelin	Nan
اعتراف	aqoonsi	None
اعترف	qirayaa	None
اعتقال	qabashada	Nan
استخدمت	waan	None
استخدم	isticmaal	None
استخدامها	adeegso	Nan
اتهام	eedeyn	Nan
اتهم	dacweyn	Nan
اثنان	laba	None
اثنتين	laba	None
اثنين	laba	None
اجتماع	kulan	None
اجتماعات	kulamada	Nan
اجتماعي	bulsho	None
اجتماعية	bulsho	None
اجتمع	kulmay	None
اجتياح	duulaan	None
اجل	haa	None
احتراق	gubasho	Nan
احترام	ixtiraam	Nan
احتفظ	hayn	None
اتفق	ogolaaday	None
احتل	shaqo	None
اتفاقية	heshiis	None
اتفاق	heshiis	None
اتباع	socda	None
اتباعه	asxaabtiisa	None
اتبع	soco	None
اتجاه	jihada	Nan
اتجاهات	isbeddelada	Nan
اتجه	leexo	Nan
اتحاد	midowga	None
اتخاذ	qaado	None
اتخذ	qaatay	None
اتخذت	qaaday	None
اتساع	ballaadhka	Nan
اتسعت	fidiyay	Nan
اتسمت	la	None
اتصال	xiriir	None
اتصالات	telecom	Nan
اتفاقيات	heshiisyada	Nan
احتلال	shaqo	None
احتلت	shaqeynayay	None
احتمال	prospect	Nan
ارتفاعه	dhererkeeda	Nan
ارتفاعها	dhererkeeda	Nan
ارتفع	ayaa	None
ارتفعت	rose	Nan
ازداد	kordhay	Nan
ازدادت	kordhay	Nan
ازدهار	barwaaqo	None
ازدهر	laqday	Nan
ازدهرت	laqday	Nan
ازدياد	kordhiyo	None
اس	s.	Nan
استبدال	beddel	Nan
استخدام	ka	None
استخدامات	adeegsada	Nan
استخدامه	adeegso	Nan
ارتفاع	dherer	None
ارتبطت	kaqaybqaatay	Nan
ارتبط	xir	None
ارتباط	hawlgelinta	Nan
احتياجات	baahiyaha	Nan
احتياطي	tuulo	None
احمد	axmed	None
اختار	xullo	Nan
اختبار	tijaabad	Nan
اختبارات	tijaabooyin	Nan
اختراع	curinta	Nan
اقتصادي	dhaqaale	None
اختراق	burburin	Nan
اختلاف	kala	None
اختلافات	kala	None
اختلفت	duwan	None
اختيار	xulasho	Nan
اختياره	xulkiisa	Nan
اخر	kale	None
اديسون	edison	Nan
اخترع	abuurtay	None
اقتصاديا	ahaan	None
اقتصادية	dhaqaale	None
اقرأ	akhriso	None
الأديان	diimaha	None
الأذربيجانية	azerbaijani	Nan
الأراضي	dhul	None
الأرانب	bakayle	Nan
الأربع	ilaa	None
الأربعة	afarta	None
الأربعين	afartan	Nan
الأرثوذكس	orthodox	Nan
الأرثوذكسية	orthodox	Nan
الأرجح	yaab	None
الأرجنتين	argentina	Nan
الأردن	jordan	Nan
الأردني	reer	None
الأردنية	reer	None
الأرز	bariiska	None
الأدوية	daawo	None
الأرضي	dhul	None
الأدوار	doorarka	Nan
الأدنى	hooseeya	None
الأخر	kale	None
الأخرى	kale	None
الأخضر	cagaarka	None
الأخطاء	khaladaadka	Nan
الأخلاق	akhlaaq	Nan
الأخلاقية	akhlaaq	Nan
الأخوان	walaalayaal	Nan
الأخير	dambeeyay	None
الأخيرة	ugu	None
الأداء	waxqabadka	Nan
الأدب	suugaanta	None
الأدباء	qorayaasha	Nan
الأدبي	suugaanta	None
الأدبية	suugaanta	None
الأدلة	caddaynta	None
الأدوات	qalab	None
الأرضية	dabaqa	None
الأرقام	lambarada	Nan
الأرمن	armenia	Nan
الأسبوع	usbuuca	None
الأستاذ	borofisarka	Nan
الأسترالية	australiyaan	Nan
الأسد	libaaxa	None
الأسر	qoysas	Nan
الأسرة	qoyska	None
الأسرى	maxaabiista	Nan
الأسطورة	halyeeyga	Nan
الأسطول	maraakiibta	None
الأسعار	qiimaha	None
الأسفل	hoose	None
الأسلحة	hubka	None
الأسلوب	habka	None
الأسماء	magacyada	None
الأسماك	kalluunka	None
الأسبق	hore	None
الأسبرين	aspirin	Nan
الأسبانية	isbaanish	Nan
الأسباني	isbaanish	Nan
الأرمني	armeniyaan	Nan
الأرمنية	armeniyaan	Nan
الأرنب	bakaylaha	Nan
الأرواح	jinniyo	Nan
الأزرق	buluug	Nan
الأزمات	dhibaatooyinka	None
الأزمة	dhibaatada	None
الأخذ	qaadashada	None
الأزهر	al-azhar	Nan
الأسئلة	su&#39;aalo	Nan
الأساس	aasaaska	None
الأساسي	aasaaska	None
الأساسية	ah	None
الأساطير	khuraafaad	Nan
الأساليب	dariiqooyinka	Nan
الأسباب	sababaha	None
الأزياء	fanka	None
الأسنان	ilkaha	None
الأخبار	wararka	None
الأحيان	qaar	None
الآستانة	astana	Nan
الآسيوي	aasiya	None
الآسيوية	aasiya	None
الآشورية	reer	None
الآفات	cayayaanka	Nan
الآلات	mashiinnada	Nan
الآلاف	kumanaan	None
الآلام	xanuunka	Nan
الآلة	ilaah	None
الآلهة	illaah	Nan
الآلي	automatic	Nan
الآلية	farsamada	None
الآن	haddadaan	Nan
الآونة	dhawaan	None
الآيات	aayadaha	None
الآرامية	aramaic	Nan
الآية	aayadda	None
الآر	aar	None
الآخرين	kale	None
اكتساب	helitaan	Nan
اكتسبت	helay	None
اكتشاف	daahfurka	Nan
اكتشافه	soo	None
اكتشافها	iyaga	None
اكتشف	baadi	None
اكتشفت	gartay	None
ال	the	None
الآب	aabaha	None
الآباء	waalidiinta	Nan
الآبار	ceelal	None
الآتي	socda	None
الآثار	archeology	Nan
الآخر	kale	None
الآخرة	gadaal	None
الآداب	suugaanta	None
الأئمة	imaamyada	Nan
الأب	aabaha	None
الأباطرة	amiirrada	Nan
الأجنحة	baalalkii	Nan
الأجهزة	aaladda	Nan
الأجيال	jiil	Nan
الأحاديث	xadiiska	None
الأحد	axad	None
الأحداث	dhacdooyinka	None
الأحرار	ah	None
الأحرف	calaamadaha	Nan
الأحزاب	xisbiyada	None
الأحكام	qodobbada	Nan
الأحماض	acids	Nan
الأحمد	al-axmad	Nan
الأحمر	casaanka	Nan
الأحوال	xaaladaha	None
الأحياء	bayoolaji	Nan
الأجنبية	dibadda	None
الأجنبي	shisheeyaha	Nan
الأجناس	jinsiyadaha	Nan
الأجسام	waxyaabaha	None
الأبجدية	alifbeetada	Nan
الأبحاث	baaris	None
الأبطال	geesiyaasha	Nan
الأبعاد	cabirrada	Nan
الأبناء	caruurta	None
الأبواب	albaabada	Nan
الأبيض	caddaanka	Nan
الأخ	walaal	None
الأتراك	turkiyiintii	Nan
الأثر	saamayn	Nan
الأثرية	archaeological	Nan
الأثناء	waqti	None
الأثير	ether	Nan
الأجانب	ajaanibta	None
الأجرام	jidhka	Nan
الأجزاء	qaybaha	None
الأثار	archeology	Nan
السينمائي	filim	Nan
السينمائية	shineemo	None
السينية	x	None
الوزن	culeyska	Nan
الوزير	wasiirka	None
الوسائل	macnaheedu	None
الوسط	dhexda	None
الوسطى	bartamaha	None
الوسواس	kormeer	Nan
الوسيط	dhex	None
الوصف	tilmaanta	Nan
الوصول	gaaritaan	Nan
الوصيف	orodyahanka	Nan
الوضع	xaaladda	None
الوطن	hooyo	None
الوطني	qaranka	None
الوطنية	qaranka	None
الوظائف	shaqooyinka	None
الوزراء	wasiirada	None
الوظيفة	shaqo	None
الوزارة	wasaaradda	None
الورق	waraaq	Nan
الوثائق	dukumiintiyada	Nan
الوثنية	sanam caabudid	Nan
الوثيقة	dokumenti	Nan
الوجبات	cunnada	Nan
الوجه	wajiga	Nan
الوجود	jiritaanka	None
الوحدات	cutubyo	Nan
الوحدة	cutubka	Nan
الوحي	muujintii	Nan
الوحيد	kaliya	None
الوحيدة	keliya	None
الوديان	dooxooyinka	Nan
الوراء	gadaal	None
الوراثة	hidaha	Nan
الوراثية	ahaan	None
الورم	burooyinka	Nan
الوالي	ku-xigeenka	Nan
الوظيفي	xirfadle	Nan
الوفاة	dhimasho	None
اليابانية	jabaaniyaan	Nan
اليابسة	dhul	None
اليد	gacanta	None
اليدوية	gacmo-gacmeed	Nan
اليرموك	yarmouk	Nan
اليسار	bidix	None
اليسرى	bidix	None
اليقين	hubaal	None
اليمامة	al-yamamah	Nan
اليمن	loo	None
اليمنى	midig	None
اليمنية	yaman	None
اليمين	sax	None
اليه	farsamada	None
اليهود	yuhuudda	Nan
الياباني	jabaaniyaan	Nan
الوعي	ogaal	None
اليابان	jabaan	None
الوهابية	wahaabiyada	Nan
الوفد	waftiga	Nan
الوفيات	dhimashada	Nan
الوقائع	xaqiiqooyinka	Nan
الوقاية	ilaalin	None
الوقت	waqtiga	None
الوقود	shidaalka	None
الوقوف	istaag	Nan
الوكالة	wakaalad	Nan
الولاء	daacadnimo	Nan
الولاة	ah	None
الولادة	dhalasho	None
الولايات	gobolada	None
الولاية	gobolka	None
الوليد	alwaleed	Nan
الوهاب	dhammaan	None
الويب	webka	Nan
الوالد	aabe	None
الواقعية	ah	None
الواقعة	xaqiiqda	None
النيتروجين	nitrogen	Nan
النيجر	niger	None
النيل	niil	None
الهائل	phenomenal	Nan
الهائلة	cajiib	None
الهاتف	taleefanka	Nan
الهادئ	xasilloon	Nan
الهادي	guul-wade	Nan
الهاشمي	hashemi	Nan
الهاشمية	hashemite	Nan
الهامة	muhiim	None
الهبوط	soo	None
الهجان	beelo	None
الهجرة	socdaalka	None
الهجري	hijri	Nan
النيازك	meteorites	Nan
الهجمات	weerarada	Nan
النووية	nuclear	Nan
النوم	hurdo	None
النهائي	dhamaadka	None
النهائية	finalka	Nan
النهار	maalintii	None
النهاية	dhamaad	Nan
النهج	dariiqa	Nan
النهر	wabiga	None
النهرين	webi	None
النهضة	renaissance	Nan
النواب	kuxigeenada	Nan
النواحي	siyaabaha	Nan
النوادي	naadiyada	Nan
النواعير	isha	None
النور	nalka	Nan
النوع	nooca	None
النوعية	tayada	None
النووي	nuclear	Nan
الهجوم	weerar	None
الهدنة	cadaalad darada	Nan
الهرم	ahraamta	Nan
الهيئة	gudiga	None
الهياكل	qaab	None
الهيثم	al-haytham	Nan
الهيدروجين	hydrogen	Nan
الهيكل	qaab	None
الواجب	guriga	None
الواجهة	dhex-dhexaadin	Nan
الواحد	midka	None
الوادي	dooxada	None
الواردات	dhoofinta	Nan
الواردة	hayaa	None
الواسع	balaadhan	None
الواسعة	balaadhan	None
الواضح	cad	None
الواقع	xaqiiqda	None
الهيئات	ururada	None
الهوية	aqoonsiga	Nan
الهولوكوست	holocaust	Nan
الهولندية	nederlandays	Nan
الهروب	baxsad	Nan
الهزيمة	guuldareystay	Nan
الهضاب	saxanka	Nan
الهضبة	plateau	Nan
الهلال	dayax	None
الهند	hindiya	None
الهندسة	injineerinka	Nan
اليهودي	yuhuudi	Nan
الهندسية	injineerinka	Nan
الهندوسية	hinduuga	Nan
الهندي	hindida	None
الهندية	hindi	None
الهنود	hindi	None
الهواء	hawada	None
الهوائية	aerobic	Nan
الهولندي	nederlandays	Nan
الهندوس	hinda	Nan
النمور	tigers	Nan
اليهودية	yuhuuda	None
اليورو	euro	Nan
بإصدار	saaro	None
بإضافة	daray	None
بإطلاق	ahaanba	None
بإعادة	re	Nan
بإقامة	samee	Nan
بإنتاج	soosaarid	Nan
بإنشاء	abuurista	Nan
بئر	hagaag	Nan
باب	iridda	Nan
بابا	baba	Nan
بابل	baabuloon	Nan
بابن	wiil	None
بات	noqday	None
باتجاه	dhanka	None
باحتلال	shaqeynaya	None
بإرسال	dir	None
باختلاف	duwan	None
بإجراء	qabto	None
بأول	soco	None
بأحد	qofkasta	None
بأداء	qabto	None
بأسلوب	hab	None
بأسماء	magacyo	None
بأشكال	qaabab	Nan
بأعمال	shaqeynaya	None
بأكثر	inbadan	None
بأكمله	dhan	None
بألمانيا	jarmalka	None
بأمر	amarka	Nan
بأن	taasi	None
بأنه	waa	None
بأنها	sida	None
بأنهم	waa	None
بأوروبا	dhexdeeda	None
بأي	kasta	None
بأبي	aabahay	Nan
بادئ	bilowga	Nan
باديس	badis	Nan
باكو	baku	Nan
بالأرض	kalaxan	Nan
بالأمر	saabsan	None
بالإسكندرية	alexandria	Nan
بالإسلام	islaamka	None
بالإضافة	dheer	None
بالإمكان	macquul	None
بالإنجليزية	ingiriisiga	None
بالاشتراك	ah	None
بالبلاد	wadanka	None
بالتالي	xigta	None
بالتجارة	ganacsiga	None
بالتركية	turkiga	None
بالتعاون	wadashaqayn	Nan
بالجامعة	jaamacad	None
باكستان	bakistaan	None
بادية	badia	Nan
باقي	xusuusin	Nan
باعتباره	sida	None
بارتفاع	kor	None
بارد	qabow	None
بارز	ah	None
بارزة	oga	None
باريس	paris	None
باستثناء	reebo	None
باستخدام	isticmaalka	None
باستعمال	adeegsiga	None
باستقلال	madaxbanaan	None
باستمرار	ah	None
باسم	basim	Nan
باسمه	magaciisa	None
باشا	pasha	Nan
باطن	soles	Nan
باعتبار	tixgalinta	Nan
باعتبارها	sida	None
ب	b	None
اي	kee	Nan
اهل	dadka	None
انبعاث	qulqulka	Nan
انبعاثات	xashiishka	Nan
انتخاب	doorashada	None
انتخابات	doorashooyinka	None
انتخابه	doorashadiisa	Nan
انتخب	doortay	None
انتزاز	baadinta	Nan
انتشار	faafitaan	Nan
انتشارا	ka	None
انتشاراً	ka	None
انتشارها	fiditaankiisa	Nan
انتشارًا	ka	None
انتشر	likaha	Nan
انتشرت	faafiyey	None
انتصار	guul	None
ان	taasi	None
انتصارات	guul	None
امساخ	wasakh	Nan
امتلكت	hayaa	None
اليوم	maanta	None
اليومية	walba	None
اليونان	giriigga	None
اليوناني	giriig	None
اليونانية	giriig	None
اليونانيون	giriiggii	Nan
اليونانيين	gariigta	Nan
اليونسكو	unesco	Nan
ام	hooyo	None
اما	sida	None
امام	kahor	None
امتد	faafitaan	Nan
امتداد	kordhinta	None
امتدت	fidsan	None
امتصاص	baqdin	Nan
امرأة	naag	None
انتصر	guuleystay	None
انتفاضة	kacdoon	None
انتقاد	cambaareyn	Nan
انظر	fiiri	None
انعقاد	wadahadal	None
انفجار	qarax	Nan
انفصال	go	None
انقراض	baabi&#39;inta	Nan
انقسام	go	None
انقطاع	go	None
انقلاب	afgambi	None
انه	a	None
انها	waxaa	None
انهم	ay	None
انهيار	duub	None
اهتم	ilaali	None
اهتمام	daneyn	Nan
اهتمامه	daneyntiisii	Nan
انطلقت	bilaabay	None
انطلق	soco	None
انضمت	biirtay	None
انضمام	ku	None
انتقادات	dhaleecayn	Nan
انتقال	guur	None
انتقالية	guurka	None
انتقد	dhaleecayn	Nan
انتقل	dhaqaaqay	None
انتقلت	dhaqaaqay	None
انتهاء	dhamaad	Nan
اليورانيوم	uranium	Nan
انتهت	dhacay	None
انخفاض	daadasho	Nan
انخفض	dhacay	None
انخفضت	dhacay	None
اندلعت	burbur	None
اندونيسيا	indonesia	None
انسحاب	bixitaan	Nan
انضم	biir	None
انتهى	dhammaaday	Nan
النموذج	muunad	Nan
النمل	qudhaanjadu	Nan
النمط	qaabka	None
المناصب	meelaha	None
المناطق	gobollada	None
المناعة	xasaanad	Nan
المناعي	immunofluorescence	Nan
المنافسة	tartanka	None
المناهج	manhajka	None
المناهضة	anti	Nan
المنتج	sheyga	Nan
المنتجات	alaabada	Nan
المنتجة	saaray	None
المنتخب	doortay	None
المنتخبات	kooxo	None
المنتدى	madal	Nan
المنتشرة	kala	None
المنتظر	sugitaanka	Nan
المناسبة	dhacdooyin	None
المنخفضة	hoose	None
المناسبات	dhacdooyinka	None
المنازل	guryaha	None
الممالك	boqortooyooyinka	Nan
المماليك	mamluks	Nan
الممتاز	ah	None
الممتدة	farsamaynta	Nan
الممتلكات	guri	None
الممثل	jilaa	None
الممثلة	jilaa	None
الممثلين	jilayaasha	Nan
الممكن	suurtagal	Nan
المملكة	boqortooyada	None
المملوكي	mamluk	Nan
المملوكية	mamluk	Nan
المميزة	kala	None
المناخ	cimilada	None
المناخية	cimilada	None
المناسب	habboon	None
الممارسة	ku	None
المندائية	mandaean	Nan
المنزلي	gudaha	None
المهرجانات	dabaaldegyada	Nan
المهلهل	sleazy	Nan
المهم	ah	None
المهمة	howlgalka	Nan
المهنة	shaqo	None
المهندس	injineerka	Nan
المهندسين	injineerada	Nan
المهنية	xirfadlayaal	Nan
المواجهة	hor	None
المواد	qalabka	None
الموارد	kheyraadka	None
المواصلات	gaadiidka	None
المواضيع	xargaha	Nan
المواطن	muwaadin	Nan
المواطنين	muwaadiniinta	None
المهدي	mahdi	None
المنزل	hoyga	None
المهبل	siilka	Nan
المهارات	xirfado	Nan
المنزلية	reerka	None
المنشآت	xarumaha	None
المنصب	mowqifka	Nan
المنصور	al-mansuur	Nan
المنصورة	mansoura	Nan
المنطق	ah	None
المنطقة	gobol	None
المنظمات	ururada	None
المنظمة	ururka	None
المنعم	munim	Nan
المنفى	dibad	None
المنهج	manhajka	None
المنورة	madiina	None
المنوية	shahwada	Nan
المهاجرين	soogalootiga	Nan
المهام	howlgalka	Nan
الملوك	boqorradii	Nan
الملوثة	fiiqday	Nan
الملوثات	wasakheynta	Nan
المفسرين	tarjubaanada	Nan
المفضلة	jeceshahay	Nan
المفكرين	fikirka	Nan
المفهوم	fahmay	None
المقابر	qabuuraha	Nan
المقابل	soo	None
المقابلة	wareysiga	Nan
المقارنة	isbarbar dhig	Nan
المقاطعات	gobollada	None
المقاطعة	qaansoor	Nan
المقاعد	kuraasta	Nan
المقال	maqaalka	Nan
المقالات	maqaallada	Nan
المقالة	qodobka	None
المقام	maqam	Nan
المفروضة	rogay	None
المقاومة	iska	None
المفردات	erayada	None
المفترض	qiyaasay	None
المغاربة	morooko	Nan
المغرب	dhaca	None
المغربي	moroccan	Nan
المغربية	moroccan	Nan
المغلقة	ku	None
المغناطيس	magnet	Nan
المغناطيسي	magnetic	Nan
المغناطيسية	magnetism	Nan
المغول	the	None
المغولي	mughal	Nan
المغولية	mongolian	Nan
المفاتيح	furayaasha	None
المفاعلات	dhaqaalayaasha	Nan
المفاهيم	fikradaha	Nan
المفاوضات	wadahadal	None
المفتوحة	furan	None
المقاييس	mitirka	Nan
المقدس	qoduus	Nan
المقدسة	quduus	Nan
الملائكة	malaa&#39;igta	Nan
الملابس	dharka	None
الملاحة	jihada	Nan
الملاحظات	xusuusin	Nan
الملاحظة	u	None
الملايو	malays	Nan
الملايين	malaayiin	Nan
الملح	cusbada	Nan
الملعب	garoomada	None
الملفات	faylasha	Nan
الملقب	cabaas	None
الملك	boqorka	None
الملكة	boqorada	Nan
الملكي	boqortooyo	None
الملكية	hanti	None
المكي	meccan	Nan
المكونة	qaybta	None
المكونات	maaddooyinka	Nan
المكون	qaybta	None
المقدسي	qudus	None
المقدمة	hordhac	None
المقدوني	macedon	Nan
المقر	dhexe	None
المقربين	kuwa	None
المقرر	go&#39;aan	Nan
المقصود	ku	None
الموافق	xiriirinta	Nan
المقيمين	deganeyaasha	Nan
المكتب	miiska	None
المكتبات	maktabadaha	Nan
المكتبة	maktabadda	Nan
المكتوبة	qoraa	None
المكرمة	al	None
المكسيك	meksiko	None
المكسيكية	meksiko	None
المكان	meesha	None
الموافقة	hagaag	Nan
المواقع	goobaha	None
المواقف	meelaha	None
النسبي	qaraabo	Nan
النسبية	niyad-jab	Nan
النسخ	diiwaangelinta	Nan
النسخة	siideyn	Nan
النسق	laydh	None
النسيج	dharka	None
النشأة	aasaaska	None
النشاط	waxqabadka	Nan
النشاطات	nashaadaadka	Nan
النشر	daabacaadda	Nan
النشطة	firfircoon	None
النشيد	calanka	None
النص	qoraal	None
النصارى	masiixiyiinta	Nan
النصر	guul	None
النسبة	saamiga	Nan
النصف	qeybtii	Nan
النسب	qiyaasaha	Nan
النساء	haweenka	None
النجار	nijaarka	Nan
النجم	xiddiga	Nan
النجوم	xiddigo	Nan
النحاس	naxaas	Nan
النحت	sawirka	None
النحل	bees	Nan
النحو	sida	None
النخبة	aqoonyahanada	Nan
النخيل	palm	Nan
النرويج	norwey	None
النرويجي	noorwiijiga	Nan
النرويجية	noorwiijiga	Nan
النزاع	khilaaf	None
النزاعات	khilaafaadka	Nan
النزعة	feejignaan	Nan
النسائية	haweenka	None
النصوص	qoraallada	Nan
النضر	guul	None
النطاق	xadka	None
النقاد	dhaleecayn	Nan
النقاط	dhibco	Nan
النقد	cambaareyn	Nan
النقدي	lacag	None
النقدية	lacag	None
النقص	caasinnimo	Nan
النقطة	barta	None
النقل	gaadiidka	None
النقود	lacagta	None
النقيض	isbadal	None
النماذج	moodooyinka	Nan
النمر	tiger	Nan
النمسا	austria	Nan
النمساوي	austrian	Nan
النمساوية	austrian	Nan
النفوس	nafta	None
النفوذ	saamayn	Nan
النفقات	kharashaadka	Nan
النفطية	saliid	None
النطق	bixin	None
النظام	nidaamka	None
النظامي	xeerarka	None
النظامية	qaabdhismeed	Nan
النظر	eegid	Nan
النظرة	muuqaalka	None
النظريات	fikradaha	Nan
النجاح	guul	None
النظرية	aragtida	None
النعمان	anemone	Nan
النفايات	qashinka	Nan
النفس	naftaada	Nan
النفسي	cilmi	None
النفسية	maskaxda	None
النفط	saliida	None
النفطي	saliida	None
النظير	isir	Nan
بالجزائر	aljeeriya	None
النثر	baadhitaan	Nan
النتائج	natiijooyinka	Nan
الموسيقار	fanaaniinta	None
الموسيقى	muusig	None
الموسيقي	muusig	None
الموسيقية	muusig	None
الموضوع	mawduuc	Nan
الموضوعات	mawduucyada	Nan
الموظفين	shaqaalaha	None
الموقع	goob	None
الموقف	xaaladda	None
المولد	dhashay	None
المولود	dhashay	None
المولى	sire	Nan
المياه	biyo	None
الميت	dhintay	None
الميثاق	axdiga	None
الموسوعة	encyclopedia	Nan
الميثان	methane	Nan
الموسمية	xilliga xilliga	Nan
المورثة	hidde	Nan
الموالية	pro	Nan
المواليد	dhallaanka	Nan
الموانئ	dekedaha	Nan
الموت	geerida	None
الموتى	dhintay	None
الموجات	duufaanta	Nan
الموجة	hirarka	Nan
الموجهة	jiheeyay	Nan
الموجود	helay	None
الموجودة	jiritaanka	None
الموجي	waveform	Nan
الموجية	waveform	Nan
الموحد	iskujira	Nan
الموحدة	jaangooyo	Nan
الموحدين	unitarians	Nan
الموسم	xilli	None
الميدالية	biladaha	Nan
الميدان	goob	None
الميزانية	miisaaniyad	Nan
الناشئة	soo	None
الناصر	naasir	Nan
الناطقة	hadalka	None
الناطقين	afayeenada	Nan
النامية	horumar	None
النبات	geedka	None
النباتات	dhirta	None
النباتي	khudaarta	Nan
النباتية	khudaarta	Nan
النبلاء	ahaa	None
النبوة	sheeg	None
النبوي	nabiga	None
النبوية	nabiga	None
النبي	nabiga	None
النبيذ	khamri	Nan
الناس	dadka	None
النازية	naasiyiinta	Nan
النازي	naasiis	Nan
النارية	mootada	Nan
الميكانيكا	farsamada	None
الميكانيكية	ahaan	None
الميلاد	kirismas	Nan
الميلادية	gregori	Nan
الميلاديين	ad	None
الميناء	dekadda	None
الميول	leanings	Nan
النتيجة	natiijada	None
الناتج	dhashay	None
الناتو	nato	None
الناجحة	guul	None
الناجمة	sababay	None
الناحية	dhinac	None
النادرة	dhif	Nan
النادي	naadiga	Nan
النار	dab	None
الناتجة	natiijada	None
بالجنة	cirka	None
بالحرب	dagaal	None
بالحكم	xukun	None
بيوم	maalin	None
بُني	ah	None
ت	t	None
تأثر	saameeyay	Nan
تأثرت	soo	None
تأثير	saameyn	Nan
تأثيرا	saamayn	Nan
تأثيرات	saamaynta	None
تأثيره	saameynteeda	Nan
تأثيرها	saameynteeda	Nan
تأخذ	qaado	None
تأسس	aasaasay	None
تأسست	aasaasay	None
تأسيس	aasaasidda	Nan
تأسيسها	aasaaskeeda	Nan
بيوت	guryo	None
تأكيد	xoojinta	None
بينهما	dhexdood	Nan
بينها	dhexdood	Nan
بيبرس	madaarkii	Nan
بيت	guri	None
بيته	gurigiisii	None
بيد	ha	None
بيده	gacantiisa	None
بيروت	beirut	Nan
بيعة	iib	Nan
بيك	beck	Nan
بيكو	pico	Nan
بيكومتر	sawir	None
بيل	biil	Nan
بيليوس	peleus	Nan
بين	dhexeeya	None
بينما	halka	None
بينه	caddeyn	Nan
بينهم	dhexdooda	None
بيانات	xog	None
تأليف	qoray	None
تأييد	taageero	None
تبث	warbaahin	None
تبدأ	bilow	None
تبدو	fiiri	None
تبرز	istaag	Nan
تبع	soco	None
تبعا	waxay	None
تبعد	baxsan	None
تبقى	joog	None
تبلغ	warbixin	None
تبنت	korsaday	Nan
تبنى	korsasho	Nan
تبني	korsasho	Nan
تبوك	tabuk	Nan
تبين	leexday	None
تتأثر	saameeyay	Nan
تبادل	sarrifka	Nan
تأمين	caymis	Nan
تايوان	taiwan	Nan
تامة	ah	None
تؤثر	saamayn	Nan
تؤدي	u	None
تؤكد	adkeeyay	Nan
تؤمن	rumee	Nan
تابع	soco	None
تابعة	hoose	None
تاج	boqortooyada	None
تاريخ	taariikh	None
تاريخه	taariikhdeeda	Nan
تاريخها	taariikhdeeda	Nan
تاريخي	taariikh	None
تاريخيا	ahaan	None
تاريخياً	ahaan	None
تاريخية	taariikh	None
تاشفين	aragtaa	None
تايمز	waqtiyo	None
بيان	bayaan	Nan
بيئة	deegaanka	None
بي	aniga	None
بنشر	loo	None
بنظام	nidaam	None
بنغازي	benghazi	Nan
بنفس	ah	None
بنفسه	isaga	None
بنفسها	nafteeda	Nan
بنقل	wareejinta	Nan
بنك	bangiga	None
بنو	caruurta	None
بنوع	ah	None
بنى	ah	None
بني	ah	None
بنية	qaab	None
بنيت	dhisay	None
به	leh	None
بنسبة	heerka	None
بها	baxay	None
بنزوين	benzoin	Nan
بنحو	saabsan	None
بممارسة	jimicsi	Nan
بمناسبة	calaamadeynta	Nan
بمنطقة	meel	None
بموجب	under	Nan
بن	wiilkii	None
بنا	digirta	None
بناء	dhismaha	None
بناءً	dhismaha	None
بنائها	dhis	None
بنات	gabdhaha	None
بناه	wax	None
بناها	dhisay	None
بنت	gabar	None
بنتيجة	natiijo	Nan
بنجاح	guul	None
بندر	bender	Nan
بهاء	baha	Nan
بهجوم	qaaday	None
بهدف	hadaf	Nan
بوصفها	sida	None
بوضع	dhigo	None
بوضوح	cad	None
بوقت	waqti	None
بوك	facebook	Nan
بول	bawlos	Nan
بولاية	dawladnimo	None
بولس	bawlos	Nan
بولندا	booland	Nan
بولينا	paulina	Nan
بومدين	boumediene	Nan
بونابرت	bonaparte	Nan
بونيقيون	ciil	None
بوهيميا	bohemia	Nan
بويع	iib!	Nan
بوصفه	sida	None
بوش	bush	None
بورصة	suuqa	None
بورسعيد	port	None
بهذا	tan	None
بهذه	tan	None
بهلوي	pahlavi	Nan
بهم	iyaga	None
بهما	iyaga	None
بو	bo	Nan
بوابات	gates	None
تتألف	kooban	None
بوابة	albaab	Nan
بواسطة	by	None
بوجه	wejiga	None
بوجود	jira	None
بوحدة	kali	None
بوذا	buddha	Nan
بور	bohr	Nan
بورتو	porto	Nan
بواس	boas	Nan
تتبع	lasoco	Nan
تتجاوز	dhaaf	None
تتجمع	duub	None
تخفيض	dhimis	Nan
تدار	maamulay	Nan
تدخين	sigaar cabista	Nan
تدرس	ladiiday	Nan
تدريب	tababar	Nan
تدريجيا	tartiib tartiib	Nan
تدريجياً	tartiib tartiib	Nan
تدريجيًا	tartiib tartiib	Nan
تدعم	taageero	None
تدعو	martiqaadyo	Nan
تدفع	waad	None
تدفق	qulqulka	Nan
تدل	u	None
تدمير	halaag	None
تدهور	go&#39;doon	Nan
تخطيط	qorshaynta	Nan
تدور	isweydaarsiga	Nan
تخضع	mawduuc	Nan
تخصص	takhasus	Nan
تحكم	xakamaynta	Nan
تحل	la	None
تحليل	falanqaynta	Nan
تحمل	qaadashada	None
تحميل	soo	None
تحول	isbadal	None
تحولت	leexday	None
تحوي	hayso	None
تحويل	isbadal	None
تحوّل	isbadal	None
تحيط	wareegsan	None
تختلف	duwan	None
تخدم	adeeg	None
تخرج	qalin-jabinta	Nan
تخزين	kaydinta	Nan
تخصيص	habayn	Nan
تدوين	geli	None
تدير	way	None
تذكر	xusuusnow	Nan
تركيا	turkiga	None
تركيب	rakibaadda	Nan
تركية	turkiga	None
تركيز	diiradda	Nan
ترى	eeg	None
تريد	waad	None
ترير	tijaabiye	Nan
تزال	weli	None
تزايد	kordhiyo	None
تزداد	badan	None
تزوج	guursado	None
تزوجت	guursaday	None
تزوجها	guursado	None
تزيد	kordhiyo	None
تساعد	i	None
تركي	turki	None
تركها	daa	None
تركز	diiradda	Nan
تركت	bidix	None
تراث	dhaxalka	None
تراجع	baxsashada	Nan
تراجعت	xirnaa	None
تراقيا	thrace	Nan
ترانسفيراز	gudbin	None
تربة	ciid	None
تربط	xir	None
تحقيق	baadhitaan	Nan
تربية	waxbarasho	None
ترتفع	u	None
ترتيب	amarka	Nan
ترجع	soo	None
ترجم	tarjunto	Nan
ترجمة	tarjumida	Nan
تردد	soo	None
ترك	bax	Nan
ترتبط	iskuxiran	Nan
بمكة	makka	None
تحقق	hubi	Nan
تحصل	hel	Nan
تتعلق	laxiriira	Nan
تتغذى	waxay	None
تتغير	beddel	Nan
تتكون	sameeyay	None
تتم	dhameeyay	None
تتمتع	ku	None
تتمثل	waa	None
تتمكن	waad	None
تتميز	lagu	None
تتناول	cuntada	None
تتنوع	duwan	None
تتواجد	jiritaan	Nan
تتوفر	karo	None
تتوقف	jooji	Nan
تتيح	kuu	None
تتعرض	faafin	Nan
تثبت	caddayn	None
تتعامل	ganacsi	None
تتطلب	baahan	None
تتجه	madaxa	None
تتحدث	way	None
تتحرك	guuritaanka	Nan
تتحول	baxay	None
تتخذ	qaado	None
تتدخل	dhexgalka	Nan
تتراوح	range	Nan
تتركز	xannaan	Nan
تتسبب	sababta	None
تتسع	karaa	None
تتسم	dabeecad	None
تتشابه	ah	None
تتشكل	sameeyay	None
تتصل	xiriir	None
تتضمن	jira	None
تتطور	beddel	Nan
تجار	ganacsadayaal	Nan
تجارب	khibradaha	Nan
تجارة	ganacsiga	None
تحتفظ	kaydka	None
تحتل	shaqo	None
تحتها	hoosta	None
تحتوى	waxaa	None
تحتوي	waxaa	None
تحد	loolan	Nan
تحدث	hadal	None
تحدد	go’aaminta	Nan
تحديث	cusboonaysiinta	Nan
تحديد	go’aaminta	Nan
تحرر	xornimo	None
تحرك	guur	None
تحرير	siideyn	Nan
تحسن	horumar	None
تحسين	horumar	None
تحتاج	baahi	None
تحت	under	Nan
تحاول	iskuday	Nan
تحاميل	kaalmooyinka	Nan
تجاري	ganacsi	None
تجارية	ganacsi	None
تجاه	dhanka	None
تجاوز	qulqulka	Nan
تجد	heshay	None
تجديد	cusboonaysiinta	Nan
تجربة	tijaabinta	Nan
تحظى	leh	None
تجري	meel	None
تجمع	isu	None
تجمعات	isu	None
تجميع	darka	None
تجنب	ilaali	None
تجهيز	diyaarinta	Nan
تحافظ	hayso	None
تحالف	isbahaysiga	Nan
تجعل	samee	Nan
المعي	cirridka	Nan
بمكان	meel	None
بمعنى	micnaha	None
بحيرة	haro	Nan
بخار	uumi	Nan
بخصوص	saabsan	None
بخط	gacanta	None
بخلاف	kale	None
بد	in	None
بدء	bilow	None
بدءا	bilaabo	None
بدءاً	bilaabo	None
بدءًا	bilaabo	None
بدأ	eg	None
بدأت	bilaabatay	None
بدا	eg	None
بداخل	gudaha	None
بدايات	bilaabashada	Nan
بحيرات	laamiyada	Nan
بداية	bilow	None
بحيث	oo	None
بحوالي	saabsan	None
بجوار	dhaw	None
بجيش	ciidan	None
بجيشه	ciidankiisii	None
بحاجة	baahi	None
بحال	ha	None
بحث	raadin	Nan
بحجة	muranka	Nan
بحد	xaddid	Nan
بحر	badda	None
بحري	nautical	Nan
بحرية	ah	None
بحسب	xigtay	None
بحق	midig	None
بحكم	eebbe	None
بحلول	qoray	None
بحوث	baaris	None
بجميع	dhamaantiin	Nan
بدايتها	bilowgeedu	Nan
بدر	badr	Nan
برج	munaarad	Nan
برز	istaag	Nan
برزت	kutub	None
برسم	lacag	None
برشلونة	barcelona	Nan
برعاية	curated	Nan
برفع	qaado	None
برقة	ah	None
بركان	volcano	Nan
بركة	balli	Nan
برلمان	baarlamaanka	None
برلمانية	baarlamaan	None
برلين	berlin	Nan
برنامج	barnaamij	Nan
بروبيلين	propylene	Nan
براون	bunni	Nan
بدخول	gal	None
براكودة	barracuda	Nan
بذلك	taas	None
بدراسة	daraasad	Nan
بدرجة	degree	None
بدعم	la	None
بدفع	bixinta	None
بدقة	ah	None
بدلا	halkii	None
بدلاً	halkii	None
بدمشق	dimishiq	None
بدن	jirka	None
بدور	doorka	None
بدوره	dhanka	None
بدورها	dhanka	None
بدولة	dal	None
بدون	la’aan	Nan
بديلة	beddelka	Nan
برئاسة	madaxa	None
بجمع	ururiyaa	Nan
بجعة	swan	Nan
بجانب	dhaw	None
بالفرنسية	faransiis	None
بالفشل	fashilmay	None
بالفعل	ahaantii	None
بالقاهرة	qaahira	Nan
بالقدس	dhexdeeda	None
بالقرب	dhow	None
بالقوة	xoog	None
بالكثير	waxbadan	Nan
باللاتينية	laatiin	Nan
باللغات	karaa	None
باللغة	ahaan	None
بالله	allah	None
باللون	midab	None
بالماء	biyo	None
بالمدينة	magaalada	None
بالغة	waaweyn	None
بالمرض	jirroow	Nan
بالغ	waaweyn	None
بالعمل	shaqada	None
بالخط	safka	Nan
بالخلافة	guul	None
بالدولة	gobolka	None
بالذات	aad	None
بالذكر	muujinta	Nan
بالرغم	kastoo	None
بالسكان	dadweynaha	None
بالسنة	sanad	None
بالسيطرة	xakamee	Nan
بالشكل	ahaan	None
بالطاقة	awood	None
بالعالم	adduunyada	None
بالعبرية	af	None
بالعديد	inbadan	None
بالعربية	carabi	None
بالعين	indhaha	None
بالمعنى	dareenka	None
بالمغرب	dalka	None
بالمقابل	labadaba	None
بتطبيق	ahaan	None
بتعيين	deji	Nan
بتغيير	beddel	Nan
بتقديم	gudbi	Nan
بتلك	taas	None
بتنظيم	abaabulay	None
بتنفيذ	hirgalinta	Nan
بتهمة	dacwadaha	Nan
بتوجيه	hoosta	None
بتونس	tuniisiya	Nan
بث	baahin	Nan
بثلاث	saddex	None
بثلاثة	saddex	None
بجائزة	marin	None
بجامعة	jaamacadda	None
بتشكيل	ah	None
بتحويل	beddel	Nan
بتاريخ	on	None
بتأسيس	aasaasay	None
بالمقارنة	dhigo	None
بالمملكة	boqortooyada	None
بالمنطقة	aagga	None
بالمياه	biyo	None
بالنسبة	saabsan	None
باليونانية	ahaan	None
بان	mamnuuc	Nan
بروتوكول	hab	None
باوني	pawnee	Nan
بايزيد	bayezid	Nan
ببساطة	sifudud	Nan
ببطء	ah	None
ببطولة	geesinimo	None
ببعض	qaar	None
ببعضها	wadajir	None
ببناء	qaab	None
باي	haye	Nan
بروتون	proton	Nan
بروز	balanqaad	Nan
بروسيا	prussia	Nan
بقتله	dilo	None
بقدر	inbadan	None
بقرار	go&#39;aan	Nan
بقعة	kaalinta	None
بقلم	qoray	None
بقليل	yar	None
بقوة	xoog	None
بقوله	leh	None
بقي	joogtay	None
بقيادة	waxaa	None
بقية	naso	Nan
بقيت	joogtay	None
بك|	|	None
بكتابة	ahaan	None
بكتيريا	bakteeriyada	Nan
بقتل	dilo	None
بكثرة	waxbadan	Nan
بقايا	hadhay	None
بق	cayayaanka	Nan
بعيدا	baxsan	None
بعيداً	baxsan	None
بعيدة	fog	None
بعين	il	None
بغداد	baqdaad	None
بغزو	duulay	None
بغض	loo	None
بغير	ahayn	None
بـ	iyadoo	None
بفتح	furan	None
بفترة	muddo	None
بفضل	mahadsanid	Nan
بفعل	samaynaya	None
بفكرة	fikrad	None
بفيروس	leh	None
بقاء	badbaado	Nan
بكثير	badan	None
بكر	bakhayl	Nan
بكرة	roller	Nan
بلغت	ku	None
بلفور	balfour	Nan
بلقب	cinwaanka	None
بلقيس	belques	Nan
بليحائية	allaah	None
بما	ku	None
بمثابة	sida	None
بمجرد	mar	None
بمحمد	muxammad	Nan
بمختلف	duwan	None
بمرض	jirroow	Nan
بمرور	gudub	Nan
بمساعدة	caawinta	Nan
بمصر	dhexdeeda	None
بمعدل	qiyaasta	None
بلغة	ahaan	None
بلغاريا	bulgaria	None
بلغ	gaadho	None
بلعمية	phagocytosis	Nan
بكل	dhamaantiin	Nan
بكميات	ahaan	None
بكونها	ahaanshaha	None
بكين	beijing	Nan
بل	laakiin	None
بلا	la’aan	Nan
بلاد	wadamada	None
بعيد	fog	None
بلاده	caajisnimo	Nan
بلاط	tiles	Nan
بلال	belal	Nan
بلجيكا	beljamka	Nan
بلد	wadanka	None
بلدان	wadamada	None
بلدة	magaalada	None
بلدية	degmo	None
بلادهم	dalkooda	None
بمقدار	qoray	None
بعنوان	qoran	None
بعمليات	hawlgallada	Nan
بشأن	saabsan	None
بشار	bashaar	Nan
بشدة	leh	None
بشر	aadanaha	None
بشراء	iibsaday	None
بشرط	ahaan	None
بشركة	shirkad	None
بشري	aadanaha	None
بشرية	aadanaha	None
بشكل	qaab	None
بشيء	leh	None
بشير	bashiir	None
بصفة	sida	None
بصفته	uu	None
بصورة	sawir	None
بسيطة	fudud	None
بضرورة	ah	None
بسيط	fudud	None
بسم	magaca	None
بروسيلا	brucella	Nan
بروناي	brunei	Nan
بري	duur	None
برية	cidlada	Nan
بريد	boosta	Nan
بريشة	caano	None
بريطانيا	ingiriiska	None
بريطانية	ingiriiska	None
بزعامة	waxaa	None
بزيادة	kor	None
بزيارة	booqasho	Nan
بسبب	ah	None
بسرطان	kansarka	Nan
بسرعة	ah	None
بسط	fidin	None
بسهولة	fudud	None
بضع	yaroo	None
بضعة	yaroo	None
بضم	darka	None
بعدم	in	None
بعدما	kadib	None
بعده	isaga	None
بعدها	kadib	None
بعدهم	dib	None
بعرض	ballac	Nan
بعض	qaar	None
بعضها	qaarkood	None
بعضهم	qaarkood	None
بعضهما	kale	None
بعقد	qandaraas	Nan
بعل	hubby	Nan
بعلم	ogaal	None
بعمر	nool	None
بعمل	samaynta	Nan
بعدد	ahaan	None
بعدة	dhawr	None
بعد	masaafada	None
بعثة	dalxiis	None
بطاقات	kaararka	Nan
بطاقة	kaarka	Nan
بطبيعة	dabcan	Nan
بطرس	butros	Nan
بطرق	siyaabo	Nan
بطريق	penguin	Nan
بطريقة	hab	None
بعملية	howlgal	None
بطل	geesi	None
بطن	caqli	None
بطوطة	batuta	Nan
بطولات	horyaalada	Nan
بطولة	horyaalnimada	Nan
بطيئة	gaabis	Nan
بعام	sanad	None
بعث	diray	None
بطليموس	ptolemy	Nan
تساوي	isleeg	None
المعهد	machadka	None
المعنى	micnaha	None
العوامل	sababaha	None
العود	lute	Nan
العودة	noqo	None
العولمة	gobanimada	Nan
العيد	ciid	None
العيش	toos	None
العين	isha	None
العينين	indhaha	None
العيون	indhaha	None
الغابات	kaymaha	None
الغابة	xaabada	Nan
الغاز	gaas	Nan
الغازات	meelaha	None
الغازي	casuumad	Nan
الغالب	badanaa	None
العوام	maxaabiista	Nan
الغالبية	badan	None
العواصف	duufaano	Nan
العنف	rabshad	Nan
العملاق	rafaa	Nan
العملاقة	rafaa	Nan
العملة	lacagta	None
العملي	ficil	None
العمليات	hababka	None
العملية	hawlgalka	Nan
العمود	safka	Nan
العموم	jumlada	Nan
العمومية	ahaan	None
العميق	dheer	None
العميقة	dheer	None
العناصر	qaybaha	None
العناية	daryeel	None
العنب	canab	Nan
العنصر	element	Nan
العهد	axdiga	None
العمل	shaqada	None
الغبار	ciidda	None
الغذاء	cunto	None
الغني	taajiriinta	Nan
الغنية	taajir	None
الغير	kale	None
الـ	the	None
الفئات	qeybaha	None
الفئة	nooca	None
الفائدة	faa&#39;iido	Nan
الفائز	guuleyste	Nan
الفاتح	al	None
الفاتحة	al-fatiha	Nan
الفاتيكان	vatican	Nan
الفارابي	al-farabi	Nan
الفارسي	faaris	Nan
الفارسية	faaris	Nan
الفاشية	faadumo	None
الغموض	sirta	None
الغدد	qanjirrada	Nan
الغليون	pipe	Nan
الغلاف	dabool	Nan
الغذائي	cunto	None
الغذائية	cunto	None
الغرب	galbeedka	None
الغربي	galbeed	None
الغربية	galbeedka	None
الغربيين	reer-galbeedka	Nan
الغرض	ujeedada	None
الغرفة	qolka	Nan
الغزاة	duulay	None
الغزالي	al-ghazali	Nan
الغزل	lafdhabarta	None
الغزو	duullaanka	Nan
الغزوات	la	None
الغشاء	xuubka	Nan
الغطاء	daboolka	Nan
الغلوكوز	gulukoos	Nan
العمق	dheer	None
العمري	al-omari	Nan
العمرة	cumra	Nan
العصبي	neerfaha	Nan
العصبية	neerfaha	Nan
العصر	da	None
العصور	da&#39;da	Nan
العضلات	muruqyada	Nan
العضو	xubinta	Nan
العضوية	xubinnimada	Nan
العطل	ciidaha	Nan
العظام	lafo	Nan
العظم	lafta	Nan
العظمى	weyn	None
العظمي	lafaha	None
العظيم	weyn	None
العظيمة	weyn	None
العفو	cafisyada	Nan
العصابات	burcadda	Nan
العقائد	khudbadaha	Nan
العشرينات	labaatankii	None
العشرة	tobanka	None
العرقي	qowmiyadeed	Nan
العرقية	qowmiyadeed	Nan
العروض	bixinta	None
العريضة	codsi	None
العريقة	waayeel	None
العزيز	gacaliye	Nan
العسكر	militariga	None
العسكري	militariga	None
العسكرية	ciidan	None
العسكريين	militariga	None
العسل	malab	Nan
العش	buulkeedii	Nan
العشاء	casho	None
العشائر	qabiilooyinka	Nan
العشر	tobanka	None
العشرين	labaatan	None
العقائدية	dogmatic	Nan
العقاد	akkad	Nan
العقبة	caqabada	Nan
العلمي	cilmiga	None
العلمية	cilmiga	None
العلوم	cilmiga	None
العلوي	sare	None
العلوية	sare	None
العلويين	alawites	Nan
العلي	ugu	None
العمارة	dhismaha	None
العمال	shaqaalayaal	Nan
العمالة	shaqada	None
العمالية	foosha	Nan
العمر	da	None
العمران	magaalooyinka	None
العمراني	magaalada	None
العمرانية	magaalooyinka	None
العلمانية	amni-darrada	Nan
العلماء	seynisyahanno	Nan
العلم	sayniska	None
العلل	qadhmuun	Nan
العقد	qandaraas	Nan
العقل	maskaxda	None
العقلي	maskaxda	None
العقلية	maskaxda	None
العقوبات	ciqaabaha	Nan
العقود	qandaraasyada	Nan
العقول	maskaxda	None
الفاصل	kala	None
العقيد	kornayl	Nan
العكس	soo	None
العلاء	sare	None
العلاج	daaweynta	Nan
العلاجية	daaweyn	Nan
العلاقات	xiriirka	None
العلاقة	xiriirka	None
العلامة	astaan	None
العقيدة	caqiido	Nan
العرق	dhidid	Nan
الفاطمي	fatimid	Nan
الفاطميين	fadeexada	Nan
الفهم	fahamka	None
الفوائد	faa&#39;iidooyinka	Nan
الفور	booska	Nan
الفوز	guusha	None
الفوضى	fowdo	Nan
الفولاذ	birta	None
الفوهات	nozzles	Nan
الفيدرالي	federaalka	None
الفيدرالية	federalism	Nan
الفيديو	fiidiyowga	Nan
الفيروس	fayruuska	Nan
الفيروسات	fayrasyada	Nan
الفيروسي	fayras	Nan
الفيروسية	fayras	Nan
الفيزياء	fiisigiska	Nan
الفهد	xabbad	Nan
الفيزيائية	ahaan	None
الفنية	farshaxannimo	Nan
الفنون	farshaxanka	None
الفلسفي	ahaan	None
الفلسفية	ahaan	None
الفلك	astronomy	Nan
الفلكي	astronomer	Nan
الفلكية	astronomical	Nan
الفلكيون	astronomers	Nan
الفلم	filimka	Nan
الفم	afka	None
الفن	farshaxanka	None
الفنادق	hoteellada	Nan
الفنان	fannaanka	Nan
الفنانة	fannaanka	Nan
الفنانين	fannaaniinta	Nan
الفنلندي	finn	Nan
الفنلندية	finnish	Nan
الفني	farshaxanka	None
الفلسفة	falsafada	Nan
الفيس	elvis	Nan
الفيضانات	daadadka	Nan
القاعدة	al-qaacida	Nan
القانون	sharciga	None
القانوني	sharci	None
القانونية	sharci	None
القبائل	qabiilooyinka	Nan
القبة	xamar	None
القبر	xabaal	None
القبض	qabtay	None
القبطي	coptic	Nan
القبطية	coptic	Nan
القبلة	dhunkashada	Nan
القبلي	qabiil	None
القبول	ogolaanshaha	Nan
القبيلة	qabiilka	None
القتال	dagaal	None
القاضي	garsooraha	Nan
الفيضان	daadka	Nan
القاسم	hooseeyaha	Nan
القارة	qaaradda	None
الفيفا	fifa	Nan
الفيل	maroodiga	None
الفيلة	maroodiyaasha	Nan
الفيلسوف	falsafadle	Nan
الفيلم	filimka	Nan
الفينيقية	fonisooleyda	Nan
القائد	hogaamiye	None
القائلة	dheh	None
القائم	ku	None
القائمة	liiska	None
القادم	xiga	None
القادمة	imaatinka	Nan
القادمين	imaatinka	Nan
القارئ	akhristaha	Nan
القارات	qaaradaha	None
القارية	continental	Nan
الفلسطينيين	falastiin	None
الفلسطينيون	falastiin	None
الفلسطينية	falastiin	None
الفرد	shakhsiga	Nan
الفردي	kali	None
الفردية	shaqsi	None
الفرس	faaristii	Nan
الفرسان	laydhka	Nan
الفرصة	fursada	Nan
الفرع	laanta	None
الفرعونية	fircoonic	Nan
الفرعية	sub	Nan
الفرق	u	None
الفرقة	guutadii	Nan
الفرن	foornada	Nan
الفرنجة	franks-ka	Nan
الفرنسي	faransiiska	None
الفرنسية	faransiiska	None
الفرج	vulva	Nan
الفرنسيون	faransiiska	None
الفراغ	fasax	None
الفراش	gogosha sariirta	Nan
الفتاة	gabadha	None
الفتح	guusha	None
الفترات	wakhtiyada	Nan
الفترة	muddada	Nan
الفتنة	khilaaf	None
الفتوح	al-futouh	Nan
الفتوحات	guul	None
الفجر	waaberigii	Nan
الفجوة	farqiga	Nan
الفحص	baadhitaan	Nan
الفحم	dhuxul	None
الفخار	foornada	Nan
الفدرالي	federaalka	None
الفدرالية	federalism	Nan
الفرات	yufraad	Nan
الفراعنة	fircoon	None
الفرنسيين	faransiiska	None
الفروع	laamaha	Nan
الفريدة	caadi	None
الفقري	dhabarka	None
الفقه	xukunka	None
الفقهاء	garsoorayaasha	Nan
الفقهية	xukunka	None
الفقيرة	liita	Nan
الفقيه	faqih	Nan
الفكر	ka	None
الفكرة	fikradda	Nan
الفكري	caqli	None
الفكرية	caqli	None
الفلاحين	beeraleyda	Nan
الفلاسفة	falsafadayaasha	Nan
الفلبين	filibiin	Nan
الفلبينية	filibiin	Nan
الفلسطيني	falastiin	None
الفقراء	ah	None
الفقر	saboolnimo	Nan
الفعلية	ah	None
الفعلي	xaqiiqda	None
الفريق	kooxda	None
الفريقان	koox	None
الفريقين	koox	None
الفساد	musuqmaasuq	Nan
الفصائل	kooxaha	None
الفصح	ciida	None
الفصحى	classical	Nan
الفاطمية	argagixiso	Nan
الفصل	fasalka	Nan
الفضائي	shisheeye	None
الفضائية	satalaytka	Nan
الفضة	qalin	None
الفضل	xun	None
الفطر	mushroom	Nan
الفعالة	ah	None
الفعل	fal	None
الفضاء	booska	Nan
العرض	bandhig	Nan
العرش	carshiga	Nan
العربية	carabi	None
الصحابة	asxaabta	Nan
الصحابي	saaxiib	None
الصحاري	cunaha	Nan
الصحافة	saxaafadda	None
الصحة	caafimaadka	None
الصحراء	lamadegaanka	Nan
الصحراوي	cidlada	Nan
الصحراوية	cidlada	Nan
الصحف	wargeysyada	Nan
الصحفي	saxafi	Nan
الصحفيين	suxufiyiinta	Nan
الصحية	caafimaadka	None
الصحيح	ah	None
الصخرة	dhagaxii	None
الصخري	dhagax	None
الصباح	subaxdii	Nan
الصخرية	dhagax	None
الصالحة	ah	None
الصادق	daacad	None
الشيخة	sheikha	Nan
الشيطان	shar	Nan
الشيعة	shia	Nan
الشيعي	shiite	Nan
الشيعية	shiite	Nan
الشيوخ	odayaasha	None
الشيوعي	wadaag	Nan
الشيوعية	wadaag	Nan
الشيوعيين	shuuciyada	Nan
الصابئة	sabriye	None
الصابئي	sabean	Nan
الصابون	saabuunta	Nan
الصادر	dibedda	None
الصادرات	dhoofinta	Nan
الصادرة	saaray	None
الصالح	fiican	None
الشيخ	sheekha	None
الصخور	dhagaxyada	Nan
الصدد	iskuxirka	Nan
الصفراء	jaale	None
الصفويين	reer	None
الصلاة	ducada	None
الصلال	dhuumashada	Nan
الصلب	birta	None
الصلبة	adag	None
الصلة	xiriirka	None
الصلح	u	None
الصلوات	salaada	Nan
الصليب	isugeyn	Nan
الصليبي	halgankii	None
الصليبية	burburkii	None
الصليبيون	halyeeyada	Nan
الصليبيين	burburinta	None
الصناعات	warshadaha	None
الصفر	eber	Nan
الصداقة	saaxiibtinimada	Nan
الصفحة	bogga	None
الصفا	al-safa	Nan
الصدر	xabadka	Nan
الصدري	thoracic	Nan
الصديق	saaxiibka	None
الصراع	khilaaf	None
الصراعات	khilaafaadka	Nan
الصرب	adeegyo	None
الصرف	sarrifka	Nan
الصعب	dhibaato	None
الصعيد	sare	None
الصغار	yar	None
الصغر	filigree	Nan
الصغرى	micro	Nan
الصغير	yar	None
الصغيرة	yar	None
الصف	fasalka	Nan
الصفة	ujeedo	Nan
الشيء	waxyaabaha	None
الشورى	shuura	Nan
الشواطئ	xeebaha	None
الشبه	lindiess	Nan
الشتاء	jiilaalka	Nan
الشجاعة	dulqaad	None
الشجرة	geedka	None
الشحنات	doomaha	Nan
الشحنة	shixnadaha	Nan
الشخص	qofka	None
الشخصي	taariikhda	None
الشخصيات	calaamadaha	Nan
الشخصية	shaqsiyeed	Nan
الشديد	ba&#39;an	Nan
الشديدة	ba&#39;an	Nan
الشذوذ	xanuunada	Nan
الشر	xun	None
الشرائية	iibsashada	Nan
الشبكة	shabakadda	Nan
الشرط	xaalada	None
الشبكات	shabakado	Nan
الشاي	shaah	None
الشأن	arinta	None
الشؤون	arimaha	None
الشائع	wadajir	None
الشائعة	wadajir	None
الشابي	ahaa	None
الشارع	wadada	None
الشاشة	shaashadda	Nan
الشاطئ	xeebta	None
الشاعر	gabay	None
الشافعي	al-shafii	Nan
الشام	shaam	None
الشامل	mass	Nan
الشامي	shami	Nan
الشامية	birta	None
الشاه	shaam	None
الشباب	dhallinyar	Nan
الشرطة	booliska	None
الشرعي	sharci	None
الشرعية	ahaan	None
الشك	shaki	None
الشكل	qaabka	None
الشكوك	shakiga	Nan
الشمال	woqooyi	None
الشمالي	woqooyiga	None
الشمالية	woqooyi	None
الشمس	qorraxda	Nan
الشمسية	qorax	None
الشهادة	shahaadada	None
الشهداء	shuhadada	Nan
الشهر	bishii	None
الشهيد	shahiid	Nan
الشهير	caan	None
الشهيرة	caan	None
الشوارع	dariiqyada	Nan
الشفاء	bogsiin	Nan
الشعور	dareemid	Nan
الشعرية	nooc	None
الشعراوي	shaarawy	Nan
الشرف	maamuus	Nan
الشرق	bariga	None
الشرقي	bari	None
الشرقية	bari	None
الشرك	polytheism	Nan
الشركات	shirkadaha	None
الشركة	shirkadda	None
الصناعة	warshadaha	None
الشروط	shuruudaha	Nan
الشطرنج	chess	Nan
الشعار	astaanta	None
الشعب	dadka	None
الشعبي	folk	Nan
الشعبية	ah	None
الشعر	timaha	Nan
الشعراء	gabayaaga	Nan
الشريعة	islaamka	None
الصناعي	warshadaha	None
الصناعية	warshadaha	None
الصنع	sameeyay	None
العادل	ah	None
العادي	ah	None
العادية	ah	None
العاشر	tobnaad	None
العاشرة	tobnaad	None
العاص	aas	None
العاصمة	caasimad	None
العالم	aduunka	None
العالمي	caalamka	None
العالمية	caalamka	None
العالمين	caalamka	None
العالي	sare	None
العالية	sare	None
العام	sanad	None
العامة	shacabka	None
العادة	caado	None
العامل	shaqaalaha	None
العادات	caadooyin	Nan
العائلة	reerka	None
الطيب	fiican	None
الطيران	duulista	Nan
الطيف	muuqaal	Nan
الطين	clay	Nan
الطيور	shimbiraha	None
الظاهر	muuqda	None
الظاهرة	phenomenon	Nan
الظاهري	virtual	Nan
الظروف	duruufaha	Nan
الظلام	gudcurka	Nan
الظلم	darro	None
الظهر	duhur	None
الظهور	muuqda	None
الظواهر	phenomena	Nan
العائلات	qoysas	Nan
العابدين	cibaadada	None
العاملة	shaqeynaya	None
العاملين	shaqaalaha	None
العامية	vernacular	Nan
العدالة	cadaaladda	None
العدد	tirada	None
العدل	cadaaladda	None
العدو	cadowga	Nan
العدوان	caydiid	None
العدوى	caabuq	Nan
العديد	inbadan	None
العديدة	badan	None
العذبة	cusub	None
العذراء	bikro	Nan
العراق	ciraaq	None
العراقية	ciraaq	None
العراقيين	ciraaqiyiinta	Nan
العرب	carabaha	Nan
العربي	carabi	None
العجز	awood	None
العثور	soo	None
العثمانيين	ottomans-ka	Nan
العثمانيون	ottomans-ka	Nan
العامّة	shacabka	None
العباد	addoomada	None
العبادات	cibaadada	None
العبادة	cibaadada	None
العبارة	hadalka	None
العباس	cabbaas	None
العباسي	cabaasid	Nan
الطويلة	dheer	None
العباسية	cabaasid	Nan
العباسيين	cabaasid	Nan
العبد	addoonkii	None
العبرية	cibraaniga	Nan
العبودية	addoonsiga	Nan
العبّاسية	abbassieh	Nan
العثماني	ottoman	Nan
العثمانية	ottoman	Nan
العباسيون	cabaasid	Nan
القتالية	dagaal	None
الطويل	dheer	None
الطور	wajiga	Nan
الصينيين	shiinaha	None
الضارة	waxyeello	Nan
الضباط	saraakiisha	None
الضحايا	dhibanayaashu	Nan
الضحية	dhibbanaha	Nan
الضخم	weyn	None
الضخمة	mega	Nan
الضرائب	canshuuraha	Nan
الضربة	dhuftay	None
الضروري	yahay	None
الضعف	tabardarro	Nan
الضغط	cadaadis	None
الضغوط	cadaadis	None
الضفة	bangiga	None
الضوء	nalka	Nan
الصينيون	shiine	Nan
الضوئي	photosynthesis	Nan
الصينية	shiine	Nan
الصين	shiinaha	None
الصهيوني	zionist	Nan
الصهيونية	siinis	Nan
الصواريخ	gantaallada	Nan
الصوت	dhawaaqa	Nan
الصوتية	sonic	Nan
الصور	sawirada	None
الصورة	sawir	None
الصوفية	suufi	None
الصوم	soonka	None
الصومال	soomaaliya	None
الصومالي	soomaali	None
الصومالية	soomaali	None
الصيد	ugaarsiga	Nan
الصيف	xagaaga	Nan
الصيفية	xagaaga	Nan
الصيني	shiine	Nan
الضوئية	nalka taraafikada	Nan
الطائرات	diyaaradaha	None
الطائرة	diyaaradda	Nan
الطراز	qaabka	None
الطرف	xisbi	None
الطرفين	dhinac	None
الطرق	wadooyinka	None
الطريق	wadada	None
الطريقة	jid	None
الطعام	cuntada	None
الطفل	ilmo	None
الطفولة	carruurnimada	Nan
الطقس	cimilo	None
الطقوس	rituals	Nan
الطلاب	ardayda	None
الطلب	baahida	None
الطلبة	ardayda	None
الطوائف	qeybaha	None
الطرائد	ciyaar	None
الطبيعية	dabiici	None
الطبيعي	dabiici	None
الطبيعة	dabeecad	None
الطائف	taif	Nan
الطائفة	qayb	None
الطابع	astaamaha	None
الطابق	dabaqa	None
الطاعون	daacuunka	Nan
الطاقة	tamar	None
الطالب	codsade	Nan
الطول	dhererka	Nan
الطب	daawo	None
الطباعة	daabacaadda	Nan
الطبري	al-tabari	Nan
الطبعة	daabacaadda	Nan
الطبقة	fasalka	Nan
الطبي	caafimaadka	None
الطبيب	dhakhtarka	Nan
الطبية	caafimaadka	None
الطباشيري	cretaceous	Nan
القتل	dilaaga	Nan
القتلى	dhintay	None
القدامى	hore	None
المدنيين	rayidka	None
المدونات	blogger	Nan
المدونة	blog	Nan
المدى	muddo	None
المديح	amaan	None
المدير	maamulaha	None
المدينة	magaalada	None
المذاهب	khudbadaha	Nan
المذكور	xusay	None
المذكورة	xusay	None
المذنبات	comets	Nan
المذهب	hoose	None
المرء	leh	None
المرأة	naag	None
المرئي	muuqaal	Nan
المدنية	ah	None
المرابطين	almoravids	Nan
المدني	ah	None
المدفعية	madaafiicda	Nan
المخصص	deganaa	None
المخصصة	loo	None
المخطط	nidaamka	None
المخطوطات	ah	None
المخلص	badbaadiye	Nan
المخلوقات	abuurista	Nan
المد	dheeraad	None
المدارس	iskuulada	None
المداري	orbital	Nan
المدارية	tropical	Nan
المدافع	cannons-ka	Nan
المدة	muddada	Nan
المدرب	tababaraha	Nan
المدرسة	iskuulka	None
المدرعة	gaari	None
المدن	magaalooyinka	None
المخرج	agaasime	None
المراجع	tixraacyada	None
المراد	ahaado	None
المركزي	bartamaha	None
المركزية	bartamaha	None
المرمى	hadafka	Nan
المرور	taraafikada	Nan
المريخ	mars	Nan
المريض	bukaan	Nan
المزارعون	beeraleyda	Nan
المزارعين	beeraley	Nan
المزروعة	kobciyay	Nan
المزيد	inbadan	None
المسألة	arinta	None
المسؤول	maamulaha	None
المسؤولة	masuul	None
المسؤولية	masuuliyada	Nan
المسؤولين	masuul	None
المركز	xarunta	None
المراحل	marxaladaha	Nan
المركبة	gaariga	Nan
المركب	xarunta	None
المرافق	lahaanshaha	None
المراقبة	soco	None
المراكز	xarumaha	None
المرة	waqtiga	None
المرتبة	darajo	None
المرتبط	iskuxiran	Nan
المرتبطة	leh	None
المرتفع	sare	None
المرتفعات	sare	None
المرتفعة	sare	None
المرجانية	coral	Nan
المرحلة	marxalad	None
المرشد	hogaamiye	None
المرض	cudurka	None
المرضى	bukaanka	Nan
المركبات	gawaarida	Nan
المخدرات	dawada	Nan
المختلفة	duwan	None
المختصة	tartan	Nan
المثلثات	saddex-xagal	Nan
المثلية	homeopathy	Nan
المثليين	qaniisyada	Nan
المجاعة	gaajo	None
المجال	duurka	None
المجالات	degmooyinka	None
المجالس	golayaasha	Nan
المجاهدين	mujaahid	Nan
المجاورة	dariska	None
المجتمع	bulshada	None
المجتمعات	bulshooyinka	Nan
المجر	hangari	Nan
المجرات	galaxies	Nan
المجرة	guusha	None
المجردة	qaawan	Nan
المثلث	saddex-xagalka	Nan
المجري	hangari	Nan
المثل	maahmaah	Nan
المتوكل	al-mutawakkil	Nan
المتعددة	kumbuyuutar	None
المتعلقة	laxiriira	Nan
المتقدم	hormarsan	None
المتقدمة	hormarsan	None
المتكاملة	isku	None
المتمثلة	la	None
المتميزة	fog	None
المتنبي	mutanabbi	Nan
المتنوعة	duwan	None
المتواجدة	karo	None
المتوسط	ahaan	None
المتوسطة	dhexaad	None
المتوفرة	karo	None
المتوفى	dhintay	None
المتوقع	filayo	None
المثال	tusaale	None
المجرية	hangari	Nan
المجلات	joornaalada	Nan
المجلة	joornaalka	Nan
المحطات	xarumaha	None
المحطة	xarunta	None
المحكمة	maxakamada	Nan
المحلة	mahalla	Nan
المحلي	deegaanka	None
المحلية	deegaanka	None
المحليين	degmooyinka	None
المحور	xarunta	None
المحيط	badweynta	None
المحيطات	badda	None
المحيطة	wareegsan	None
المخ	maskaxda	None
المخاطر	khataraha	Nan
المخاوف	cabsi	None
المختار	doortay	None
المحسن	kobciyay	Nan
المحركات	motors	Nan
المحرك	matoorka	Nan
المحرقة	holocaust	Nan
المجلس	golaha	None
المجمع	dhismaha	None
المجموع	wadarta	None
المجموعات	kooxo	None
المجموعة	kooxda	None
المجيد	sharaf	None
المحاسبة	xisaabaadka	None
المساء	fiidkii	Nan
المحاصيل	dalagyada	None
المحافظة	maamulka	None
المحاولات	isku	None
المحاولة	dayo	None
المحبة	jacayl	None
المحتلة	shaqeynayay	None
المحتمل	yaab	None
المحدودة	ltd.	Nan
المحافظات	gobollada	None
المسائل	arimaha	None
المسابقات	tartamada	Nan
المسابقة	tartan	Nan
المطلب	shuruud	Nan
المطلة	rimbiga	Nan
المطلق	xaqiiqada	None
المطلقة	furiin	Nan
المطلوب	yahay	None
المطلوبة	yahay	None
المطيرة	roob-roobaadka	Nan
المظاهرات	banaanbaxyo	Nan
المظلمة	madoow	Nan
المعابد	macbudyo	Nan
المعادن	macdanta	Nan
المعادية	cadaawad	Nan
المعارض	bandhigyo	Nan
المعارضة	mucaaradka	None
المعارضين	horjeeda	None
المطر	roobka	None
المعارف	aqoon	None
المطبخ	jikada	Nan
المطاعم	makhaayadaha	Nan
المصانع	warshadaha	None
المصحف	quraanka	None
المصدر	xigasho	Nan
المصري	masriyiinta	Nan
المصرية	masriyiintii	Nan
المصريون	masriyiintii	Nan
المصريين	masriyiintii	Nan
المصطلح	muddo	None
المصطلحات	bixin	None
المضاد	ka	None
المضادة	ka	None
المضيف	yahay	None
المضيفة	marti-qaade	Nan
المطار	diyaaradaha	None
المطارات	diyaaradaha	None
المطاف	dhamaadka	None
المعارك	dagaaladii	None
المعاصر	casriga	None
المعاصرة	casriga	None
المعرفة	aqoon	None
المعرفي	garashada	None
المعرفية	garashada	None
المعركة	dagaalkii	None
المعروف	yaqaan	None
المعروفة	yaqaan	None
المعري	maari	Nan
المعز	riyaha	None
المعسكر	xerada	None
المعقدة	isku	None
المعلم	macalinka	Nan
المعلمين	macallimiinta	None
المعلومات	macluumaadka	Nan
المعماري	naqshadeeyaha	Nan
المعمارية	dhismaha	None
المعرض	bandhigga	Nan
المعدية	cudur	None
المعدنية	macdanta	Nan
المعدلة	laga	None
المعاصرين	qoraallada	Nan
المعالم	nololeed	None
المعاني	macnayaasha	Nan
المعاهد	machadyada	Nan
المعاهدات	heshiisyada	Nan
المعاهدة	heshiis	None
المعايير	heerarka	Nan
المصالح	leh	None
المعبد	macbudka	Nan
المعتزلة	mu’tazilah	Nan
المعتقدات	caqiidada	None
المعتمد	ogolaaday	None
المعتمدة	ogolaaday	None
المعدات	qalabka	None
المعدة	xanuun	None
المعدل	ahaan	None
المعتدل	ah	None
المتعة	farxad	None
المصارف	bangiyada	Nan
المصاحف	quraanka	None
المستعمرة	gumeysiga	None
المستعملة	loo	None
المستقبل	mustaqbalka	None
المستقبلية	mustaqbalka	None
المستقلة	madaxbannaan	None
المستمر	ah	None
المستمرة	ah	None
المستوطنات	degsiimooyinka	Nan
المستوى	heerka	None
المستويات	heerarka	Nan
المسجد	masaajidka	None
المسرح	tiyaatarka	Nan
المسرحي	tiyaatarka	Nan
المسرحيات	ciyaar	None
المسرحية	ciyaarta	None
المستعمرات	gawaarida	Nan
المسلح	ninka	None
المستشفيات	cisbitaalada	Nan
المستشار	lataliyaha	Nan
المساجد	masaajidda	Nan
المساحة	booska	Nan
المساعدات	caawinaad	Nan
المساعدة	i	None
المسافات	jidadka	Nan
المسافة	masaafada	None
المساكن	guriyeynta	Nan
المساهمة	tabarucaad	Nan
المساواة	sinnaan	Nan
المسبار	baadhitaanka	Nan
المسببة	sababta	None
المستخدم	adeegsadaha	Nan
المستخدمة	loo	None
المستخدمين	isticmaalayaasha	None
المستدامة	waara	Nan
المستشفى	isbitaalka	None
المسلحة	hubaysan	None
المسلسل	taxanaha	Nan
المسلسلات	taxanaha	Nan
المشركين	mushrikiinta	Nan
المشروبات	cabitaanno	Nan
المشروع	mashruuca	None
المشروعات	mashaariicda	Nan
المشعة	shucaac	Nan
المشكلات	dhibaatooyinka	None
المشكلة	dhibaatada	None
المشهد	goobta	None
المشهور	ah	None
المشهورة	caan	None
المشهورين	caan	None
المشير	field	None
المصاب	dhaawacmay	None
المصابة	qaadey	None
المصابين	dhaawacmay	None
المشرفة	horjoogaha	Nan
المشتري	iibsade	Nan
المشترى	iibsade	Nan
المشتركة	wadaag	Nan
المسلمة	dhaji	Nan
المسلمون	muslimiinta	None
المسلمين	muslimiinta	None
المسمى	magacaabay	None
المسيحي	ah	None
المسيحية	masiixiyada	Nan
المسيحيون	masiixiyiinta	Nan
المصادر	ilo	None
المسيحيين	masiixiyiinta	Nan
المشاركة	kaqeybgal	Nan
المشاركين	kaqeybgalayaasha	Nan
المشاريع	mashaariicda	Nan
المشاعر	dareenka	None
المشاكل	dhibaatooyinka	None
المشاهد	muuqaalka	None
المشترك	macmiil	Nan
المشاة	lugeeyayaasha	Nan
المعنية	ka	None
المتطورة	gees	None
المتزايد	koraaya	Nan
القومية	waddaniyad	Nan
القوى	awooda	None
القوي	xoogga	None
القوية	xiran	None
القيادة	hogaanka	None
القياس	analogga	Nan
القياسي	jaangooyo	Nan
القياسية	jaangooyo	Nan
القيام	waxqabadka	Nan
القيامة	soobixinta	Nan
القيروان	kairouan	Nan
القيس	cabbiraad	Nan
القيصر	the	None
القيم	qiimaha	None
القيمة	qiimaha	None
القومي	qaranka	None
القيود	xaddidaadaha	Nan
القوم	folk	Nan
القوقاز	caanood	Nan
القمح	galley	Nan
القمر	dayaxa	None
القمرية	lunar	Nan
القمني	apical	Nan
القنابل	bambaanooyinka	Nan
القناة	kanaalka	None
القنوات	idaacadaha	None
القهري	khasab	None
القوائم	liisaska	Nan
القوات	ciidan	None
القواعد	xeerarka	None
القوافل	xawilaada	Nan
القوانين	sharciyada	None
القوس	qaansada	Nan
القوط	goths	Nan
القول	dhaho	None
القمة	sare	None
الكأس	koobka	Nan
الكائنات	fadhiyada	Nan
الكثافة	cufnaanta	Nan
الكثير	badan	None
الكثيرة	inbadan	None
الكثيرون	inbadan	None
الكثيرين	inbadan	None
الكثيفة	cufan	Nan
الكحول	khamriga	Nan
الكحولية	khamriga	Nan
الكذب	beenta	None
الكرامة	sharaf	None
الكربون	kaarboon	Nan
الكردية	kurdiyiinta	Nan
الكرسي	kursiga	None
الكرك	karak	Nan
الكريم	deeqsi	None
الكتلة	gaadhiga	Nan
الكائن	shayga	None
الكتل	baloogyada	Nan
الكتابة	qoraalka	None
الكاتب	qoraa	None
الكاثوليكية	kaatoolig	Nan
الكاريبي	kaaribiyaan	Nan
الكافي	filan	None
الكافية	filan	None
الكامل	buuxa	None
الكاملة	buuxa	None
الكبار	koray	None
الكبد	beerka	Nan
الكبرى	weyn	None
الكبريت	sulfur	Nan
الكبير	weyn	None
الكبيرة	weyn	None
الكتاب	buugga	None
الكتابات	qoraallada	Nan
الكتب	buugaag	Nan
القماش	dharka	None
القليلة	yar	None
القليل	yar	None
القران	quraanka	None
القرشي	qurashi	Nan
القرص	ah	None
القرضاوي	al-qaradawi	Nan
القرم	crimea	Nan
القرن	qarnigii	None
القرنين	gees	None
القرون	boorar	Nan
القرويين	tuulooyinka	None
القرى	tuulooyinka	None
القريب	dhow	None
القريبة	dhow	None
القرية	tuulada	None
القزمة	cawska	Nan
القسطنطينية	constantinople	Nan
القرارات	go’aamada	Nan
القسم	qaybta	None
القرار	go&#39;aanka	Nan
القراء	akhristayaasha	Nan
القدر	aayaha	Nan
القدرات	awoodda	None
القدرة	awooda	None
القدس	yeruusaalem	Nan
القدسي	al-qudsi	Nan
القدم	cagta	None
القدماء	hore	None
القديس	saint	None
القديسين	salaadiinta	Nan
القديم	hore	None
القذافي	qadaafi	None
القذف	tuurid	Nan
القرآن	quraanka	None
القرآني	quraanka	None
القرآنية	quraanka	None
القراءة	akhrinta	None
القشرة	dandruff	Nan
القصبة	reer	None
القصة	sheekada	None
القطبية	ballaarin	Nan
القطبين	ulaha	Nan
القطر	dhexroor	Nan
القطرية	wadan	None
القطط	bisadaha	Nan
القطع	goynta	Nan
القطن	suufka	Nan
القعدة	aasaaska	None
القفز	boodboodid	Nan
القلاع	qalcado	Nan
القلب	wadnaha	None
القلبية	furan	None
القلعة	qalcaddii	Nan
القلق	welwel	Nan
القلوب	qalbiga	None
القطبي	ballaarin	Nan
القطب	cirif	Nan
القطاعات	waaxaha	Nan
القطاع	qeybta	None
القصر	qasriga	Nan
القصص	sheekooyinka	None
القصف	qaraxyada	Nan
القصور	cilladaha	Nan
القصوى	caddaaladda	Nan
القصيدة	gabayga	None
القصيرة	gaaban	None
الكريمة	mahadsanidiin	Nan
القضاء	ciribtirka	Nan
القضائية	garsoorka	None
القضاة	garsoorayaasha	Nan
القضايا	arimaha	None
القضيب	guska	Nan
القضية	kiiska	Nan
القطار	tareenka	Nan
القطارات	tareenada	Nan
القضائي	garsoorka	None
الكسوف	ciida	None
الكعبة	kaaba	Nan
الكفاءة	waxqabadka	Nan
المؤرخون	taariikhyahannada	Nan
المؤرخين	taariikhyahannada	Nan
المؤسس	aasaasaha	None
المؤسسات	hay&#39;adaha	Nan
المؤسسة	ganacsi	None
المؤسسين	aasaasayaashii	None
المؤكد	hubaal	None
المؤلف	qoraaga	None
المؤلفات	suugaanta	None
المؤمن	rumaystayaal	Nan
المؤمنين	aamin	None
المؤيدين	taageerayaasha	None
المئات	boqolaal	Nan
الماء	biyo	None
المائة	xarunta	None
المؤرخ	taariikhyahan	None
المائدة	miiska	None
المؤثرة	saamayn	Nan
المؤتمر	shirka	Nan
اللواء	guud	None
اللوحات	rinjiyeynta	Nan
اللوحة	guddi	Nan
اللون	midabka	None
الليبرالية	xorriyadda	Nan
الليبي	liibiya	None
الليبية	liibiya	None
الليزر	laser	Nan
الليل	habeenkii	None
الليلة	caawa	None
الليمفاوية	liif	Nan
اللَّهُ	allah	None
اللّه	allah	None
المأكولات	cunto	None
المأمون	nabdoonaanta	Nan
المؤتمرات	shirarka	Nan
المائي	biyo	None
المائية	biyo-biyoodka	Nan
المادة	mawduuc	Nan
المبدأ	mabda &#39;	Nan
المبشرين	weriyeyaasha	Nan
المبكر	hore	None
المبكرة	hore	None
المبنى	dhismaha	None
المبيدات	sunta	None
المتاحة	karo	None
المتاحف	madxafyada	Nan
المتبقية	hadhaagii	Nan
المتجددة	karo	None
المتحدة	united	None
المتحدثين	afayeenada	Nan
المتحركة	animation	Nan
المتحف	madxafka	Nan
المتخصصة	niche	Nan
المباني	dhismooyinka	Nan
المباشرة	toos	None
المباشر	toos	None
المباريات	kulamada	Nan
المادي	ahaan	None
المادية	ahaan	None
الماركسية	marxism	Nan
الماسونية	freemasonry	Nan
الماشية	lo&#39;da	Nan
الماضي	dhaafay	None
الماضية	hore	None
اللهِ	allah	None
المال	lacagta	None
المالكي	al-maliki	Nan
المالي	dhaqaalaha	None
المالية	dhaqaalaha	None
الماليزية	malaysiyaan	Nan
المبادئ	mabaadi&#39;da	Nan
المبادرة	dadaalka	None
المباراة	ciyaarta	None
المالكة	boqortooyada	None
المتزايدة	koraaya	Nan
اللهم	allahayow	Nan
اللهجات	xarafyada	None
الكهربائية	koronto	None
الكهربية	electrophysiology	Nan
الكهرومغناطيسية	elektromagnetism	Nan
الكهنة	wadaaddadii	Nan
الكهوف	godad	Nan
الكوارث	musiibada	Nan
الكواكب	meerayaasha	Nan
الكورية	kuuriyaan	Nan
الكوفة	kufa	Nan
الكوفي	kufi	Nan
الكوكب	dunida	None
الكومنولث	dhexe	None
الكون	caalamka	None
الكونغرس	golaha	None
الكونغو	kongo	None
الكهربائي	electrophoresis	Nan
الكوني	cosmic	Nan
الكهرباء	koronto	None
الكندية	kanadiyaan	Nan
الكلاب	eeyo	Nan
الكلاسيكي	caadi	None
الكلاسيكية	caadi	None
الكلام	hadal	None
الكلمات	ereyada	None
الكلمة	erey	None
الكلي	kelyaha	Nan
الكليات	xirfadaha	Nan
الكلية	kulliyadda	None
الكم	kuur	Nan
الكمال	ah	None
الكمبيوتر	kombiyuuter	Nan
الكمية	tirada	None
الكنائس	kaniisadaha	Nan
الكندي	kanadiyaan	Nan
الكنيسة	kaniisadda	None
الكونية	cosmic	Nan
الكويت	kuweyt	Nan
الكويتي	kuwaiti	Nan
اللحظة	daqiiqada	Nan
اللحم	hilibka	None
اللحوم	hilib	Nan
اللذان	aduunka	None
اللسان	carrabka	Nan
اللطيف	quruxda	None
اللعب	ciyaar	None
اللعبة	ciyaarta	None
اللغات	luuqadaha	None
اللغة	luqadda	None
اللغوية	luuqad	Nan
اللفظ	bixin	None
اللقاء	kulan	None
اللقب	cinwaanka	None
الله	allah	None
اللجوء	doon	None
اللجنة	gudiga	None
اللبنانيين	ah	None
اللبنانية	lubnaan	None
الكويتية	kuwaiti	Nan
الكويكبات	asteroids	Nan
الكيماوية	kiimikada	Nan
الكيمياء	kiimikada	Nan
الكيميائي	farmasiiga	Nan
الكيميائية	kiimikada	Nan
اللاتيني	laatiin	Nan
اللهجة	oggolaansho	Nan
اللاتينية	laatiin	Nan
اللاحقة	suffix	Nan
اللاذقية	lattakia	Nan
اللازم	maarmaan	None
اللازمة	maarmaan	None
اللاعب	ciyaartoyda	Nan
اللاعبين	ciyaartoyda	Nan
اللبناني	lubnaan	None
اللاجئين	qaxooti	None
يُمكن	karaa	None
