$	$	Nan
عانى	страждати	Nan
عبادة	поклонітися	Nan
عبارة	словосполучення	Nan
عباس	абас	Nan
عبد	раб	Nan
عبده	раб	Nan
عبر	через	None
عبرانيون	євреї	None
عبور	перетинання	Nan
عبيد	раби	None
عبيدة	обаїда	Nan
عتبة	поріг	Nan
عثر	був знайдений	Nan
عثمان	отман	Nan
عثمانية	османська	None
عانت	вона страждала	Nan
عجائب	дива	Nan
عامًا	роки	None
عامي	розмовне	Nan
عاصمتها	її капітал	Nan
عالم	вчений	None
عالمي	мій світ	Nan
عالميا	світової	None
عالمياً	світової	None
عالمية	міжнародний	None
عالي	високий	None
عالية	високий	None
عام	рік	None
عاما	років	None
عاماً	рік	None
عامة	загальні	None
عامر	амер	Nan
عامل	фактор	None
عاملاً	фактор	None
عاميّ	сленг	Nan
عاصمته	його столиця	Nan
عدا	за винятком	Nan
عدد	номер	None
عرضت	пропонується	Nan
عرضه	сприйнятливий	Nan
عرضها	відображається	Nan
عرف	він знав	Nan
عرفات	арафат	Nan
عرفة	арафа	Nan
عرفت	я знав	Nan
عرفوا	вони знали	Nan
عروة	вкладка	Nan
عز	всемогутній	Nan
عزل	ізоляція	Nan
عزم	рішучість	Nan
عزيز	шановний	Nan
عسكري	солдат	Nan
عسكرية	військові	None
عرضة	сприйнятливий	Nan
عدة	декілька	None
عرض	показати	None
عربية	арабською	Nan
عددا	число	None
عدداً	число	None
عددها	їх кількість	Nan
عددهم	їх кількість	Nan
عددًا	число	None
عدل	справедливості	None
عدم	non	Nan
عدن	аден	Nan
عدنان	аднан	Nan
عدوى	інфекція	Nan
عدي	одай	Nan
عديدة	багато	None
عدّة	декілька	None
عرب	араби	Nan
عربي	арабською	Nan
عرش	трон	None
عاصمة	капітал	None
عاصم	ассем	Nan
عاصفة	буря	Nan
طلاب	студенти	None
طلال	талал	Nan
طلب	запит	Nan
طلبة	студенти	None
طلبت	запитано	Nan
طلبه	його прохання	Nan
طلحة	талха	Nan
طن	тон	None
طنجة	танжер	Nan
طه	таха	Nan
طهران	тегеран	Nan
طوائف	культи	Nan
طوال	на всьому протязі	Nan
طور	розвивайте	Nan
طورت	розроблено	None
طلائعيات	піонер	Nan
طول	довжина	None
طقوس	ритуал	Nan
طفل	дитина	None
طبيعية	природні	None
طرابلس	тріполі	Nan
طراز	стиль	None
طرازات	робить	None
طرح	відняти	Nan
طرد	удар	Nan
طرف	партія	None
طرفاوية	термінал	Nan
طرق	методи	None
طرول	кельми	Nan
طريق	шлях	None
طريقة	метод	None
طريقه	метод	None
طريقها	її шлях	Nan
طعام	їжа	Nan
طفولته	його дитинство	Nan
طولها	її довжина	Nan
طويل	довго	None
طويلا	довго	None
عابرة	проходить	None
عاد	повернувся	None
عادات	звички	Nan
عادة	звичка	Nan
عادةً	звичка	Nan
عادت	вона повернулася	Nan
عادل	просто	None
عادوا	вони повернулися	Nan
عادي	нормальний	Nan
عادية	нормальний	Nan
عارض	глядач	Nan
عارف	знаючи	Nan
عاش	наживо	Nan
عاشت	вона жила	Nan
عاشوراء	ашура	Nan
عائلته	його сім&#39;я	Nan
عائلة	родина	None
عائلات	сімей	None
عائشة	айша	Nan
طويلاً	довго	None
طويلة	довго	None
طيبة	добрий	None
طيران	політ	None
طيلة	на всьому протязі	Nan
طيور	птахи	None
ظاهر	очевидний	Nan
عسل	мед	None
ظاهرة	явище	None
ظل	відтінок	Nan
ظلت	залишилися	None
ظهر	назад	None
ظهرت	з&#39;явились	Nan
ظهره	його спина	Nan
ظهور	зовнішній вигляд	Nan
ظواهر	явища	None
ظروف	обставини	None
طبيعي	природні	None
عسير	важко	None
عشر	десять	None
عندما	коли	None
عنده	має	None
عندها	тоді	None
عندهم	вони мають	Nan
عنصر	предмет	None
عنق	шия	Nan
عنه	про нього	Nan
عنها	про неї	Nan
عنهم	про них	Nan
عنهما	про них	Nan
عنوان	назва	None
عني	про мене	Nan
عنيفة	насильницькі	Nan
عهد	угода	None
عهده	опіка	Nan
عندئذ	тоді	None
عهود	угоди	None
عند	в	None
عنترة	антара	Nan
عمليات	операції	None
عملية	процес	None
عمه	тітка	Nan
عمود	полюс	Nan
عموم	каструля	Nan
عموما	взагалі	None
عموماً	взагалі	None
عمومًا	взагалі	None
عمير	амір	Nan
عميق	глибокий	None
عميقة	глибокий	None
عمّان	оман	Nan
عن	про	None
عناصر	предмети	None
عناية	увага	None
عنخ	анкх	Nan
عملها	її робота	Nan
عواصم	столиці	None
عوامل	фактори	None
غازات	гази	None
غازي	газоподібні	Nan
غالب	галіб	Nan
غالبا	часто	None
غالباً	часто	None
غالبية	більшість	None
غالبًا	часто	None
غاما	гамма	Nan
غاميلان	гамілан	Nan
غاندي	ганді	Nan
غانم	ганем	Nan
غاية	пункт призначення	Nan
غباء	дурість	Nan
غذاء	їжа	Nan
غرار	подібно до	Nan
غاز	газ	None
عواقب	наслідки	None
غار	лавр	Nan
غابات	ліси	None
عودة	назад	None
عودته	його повернення	Nan
عوف	ауф	Nan
عيد	свято	None
عيسى	есса	Nan
عين	око	None
عينات	зразки	None
عينيه	його очі	Nan
عيون	очі	None
عَلَى	алі	Nan
عَلَيْهِ	на нього	Nan
عُثر	був знайдений	Nan
عُرف	він знав	Nan
عُرفت	вона знала	Nan
عُمان	оман	Nan
غادر	зліва	None
عمله	валюта	Nan
عملت	я працював	Nan
عملة	валюта	Nan
عظيم	чудово	Nan
عظيمة	чудово	Nan
عفان	аффан	Nan
عفص	шкіряний завод	Nan
عقارب	руки	None
عقب	після	None
عقبة	перешкода	Nan
عقد	намисто	Nan
عقدت	відбувся	None
عقل	розум	None
عقوبة	покарання	None
عقود	десятиліття	None
عقيدة	вчення	None
عكا	акр	Nan
عكس	зворотний	Nan
عظمى	кістлявий	Nan
علاء	алаа	Nan
عظمة	велич	Nan
عظام	кістки	None
عشرات	десятки	None
عشرة	десять	None
عشرية	десяткові	Nan
عشرين	двадцять	Nan
عصام	ессам	Nan
عصبة	ліга	None
عصر	вичавити	Nan
عصره	його епоха	Nan
عصور	ера	Nan
عصير	сік	Nan
عضوا	член	None
عضواً	член	None
عضوية	членство	None
عطارد	ртуть	Nan
عطلة	свято	None
عظم	кістка	Nan
علاج	терапія	Nan
علاقات	відносини	None
علاقاتها	її стосунки	Nan
عليهم	на них	Nan
عليهما	на них	Nan
عليّ	алі	Nan
عم	дядько	Nan
عما	про	None
عماد	емад	Nan
عمال	робітники	None
عمان	оман	Nan
عمد	хрещений	Nan
عمر	омар	Nan
عمره	його вік	Nan
عمرو	amr	Nan
عمق	глибина	None
عمل	дія	None
عملاق	гігант	Nan
عليها	на ній	Nan
عليه	на нього	Nan
علينا	ми	None
عليكم	на тобі	Nan
علاقة	відносини	None
علامات	знаки	None
علامة	знак	None
علاوة	бонус	Nan
علاوةً	більше того	Nan
علم	наука	None
علما	примітка	Nan
عش	наживо	Nan
علماء	науковці	None
علماً	примітка	Nan
علمه	його знання	Nan
علمية	науковий	None
علوم	наук	None
على	на	None
علي	алі	Nan
عليك	на тобі	Nan
علمانية	секуляризм	Nan
طبيعة	природи	None
طبية	медичні	None
طبيب	лікар	None
شخصيته	його характер	Nan
شداد	щільність	None
شديد	інтенсивні	Nan
شديداً	дуже важкий	Nan
شديدًا	дуже важкий	Nan
شراء	купівля	Nan
شراكة	партнерство	Nan
شرب	випити	Nan
شرج	анус	Nan
شرح	пояснив	Nan
شرط	хвороба	None
شرع	продовжували	None
شرعية	законність	Nan
شرف	честь	None
شرق	схід	None
شخصية	характер	None
شرقا	схід	None
شخصيات	достойники	Nan
شحنة	відвантаження	Nan
شامل	всебічний	Nan
شاملة	включно	None
شاه	шах	Nan
شاهد	побачити	None
شاهين	шахін	Nan
شباب	молодь	None
شبابه	його юність	Nan
شبكات	мережі	None
شبكة	мережа	None
شبه	те саме	Nan
شبيه	подібно до	Nan
شبيهة	схожий на	Nan
شتى	різноманітні	None
شجرة	дерево	None
شجع	підбадьорений	Nan
شخص	персона	Nan
شامة	моль	Nan
شرقاً	схід	None
شركات	компанії	None
شعوب	люди	None
شغل	заливка	Nan
شق	розріз	Nan
شقيقه	сестра	None
شك	сумніви	Nan
شكل	форма	None
شكلت	сформовано	Nan
شكله	його форма	Nan
شكلها	його форма	Nan
شمال	північ	None
شمالا	північ	None
شمالاً	північ	None
شمالي	північна	None
شمس	сонце	None
شمسية	парасолька	Nan
شعره	волосся	None
شرقي	схід	None
شعراء	поети	None
شعبية	популярність	None
شركة	компанія	None
شروط	умови	None
شريط	стрічка	Nan
شريعة	закон	None
شريف	шериф	Nan
شريك	партнер	Nan
شطرنج	шахи	None
شعائر	ритуали	Nan
شعار	логотип	Nan
شعاع	промінь	Nan
شعب	люди	None
شعبان	шаабан	Nan
شعبة	розділ	None
شعبه	розділ	None
شعبي	популярний	None
شعر	поезія	None
شاكلة	подібно до	Nan
شاكر	шейкер	Nan
شاطئ	пляжний	Nan
سوري	сирійський	Nan
سوريا	сирія	Nan
سورية	сирійський	Nan
سوف	буде	None
سوق	ринок	None
سومطرة	суматра	None
سوى	але	None
سويسرا	швейцарія	None
سي	c.	Nan
سيئة	поганий	Nan
سياحة	туризм	None
سياحية	туризм	None
سيادة	суверенітет	None
سيارات	автомобілі	Nan
سيارة	автомобіль	Nan
سورة	сура	Nan
سياسات	політика	None
سور	паркан	Nan
سواحل	береги	None
سنغافورة	сінгапур	None
سنن	сунан	Nan
سنه	рік	None
سنوات	роки	None
سنويا	щорічно	None
سنوياً	щорічно	None
سنوية	щорічно	None
سنويًا	щорічно	None
سنين	роки	None
سهل	легко	None
سهول	рівнини	None
سهولة	легкість	Nan
سهيل	suhail	Nan
سوء	хворіти	Nan
سواء	чи	None
سوداء	чорний	None
سياسة	політика	None
سياسي	політик	Nan
سياسيا	політично	Nan
سيناء	синай	Nan
شأن	матерія	None
شأنه	би	None
شأنها	подібно до	Nan
شؤون	справи	None
شئون	справи	None
شاء	він заповідає	Nan
شائع	звичайний	None
شائعة	чутка	Nan
شارع	св	None
شارك	поділитися	Nan
شاركت	я брав участь	Nan
شارل	карла	None
شاسعة	величезна	None
شاش	марля	Nan
سيما	особливо	None
سيلينيوم	селен	None
سيكون	буде	None
سيكلامين	цикламен	Nan
سياسية	політичні	None
سياق	контекст	Nan
سيتم	буде	None
سيتي	місто	None
سيد	містер	Nan
سيدة	леді	Nan
سيدي	сер	None
شمل	включати	Nan
سير	ходити	Nan
سيرته	його біографія	Nan
سيطر	беріть під контроль	Nan
سيطرة	контроль	None
سيطرت	взяв контроль	Nan
سيطرتها	її контроль	Nan
سيف	меч	Nan
سيفه	його меч	Nan
سيرة	біографія	None
شملت	у комплекті	Nan
شن	шень	Nan
شهاب	падаюча зірка	Nan
صوتية	голос	None
صور	фото	None
صورة	картина	None
صوفيا	софія	None
صياغة	редагування	Nan
صيد	полювання	None
صيغة	формула	None
صيف	літо	None
صَلَّى	молитися	Nan
ضئيلة	тонкий	Nan
ضابط	офіцер	Nan
ضباط	офіцери	Nan
ضبط	налаштування	Nan
ضحايا	жертв	None
ضخم	величезний	None
صوت	голос	None
ضخمة	величезний	None
صوب	мета	None
صنف	клас	None
صلاة	молитва	Nan
صلاح	салах	Nan
صلاحيات	коло повноважень	Nan
صلادة	твердість	None
صلب	суцільний	Nan
صلبة	суцільний	Nan
صلة	посилання	None
صلح	примирення	Nan
صلى	молитися	Nan
صناعات	галузі	None
صناعة	виготовлення	None
صناعي	промислові	None
صناعية	промислові	None
صندوق	коробка	Nan
صنع	виготовлення	None
صواريخ	ракети	Nan
ضد	проти	None
ضده	проти нього	Nan
ضربة	удар	Nan
طائرة	літак	Nan
طائفة	секта	Nan
طابع	штамп	Nan
طارق	тарік	Nan
طاعة	послух	Nan
طاقة	енергії	None
طالب	студент	Nan
طالبت	вона вимагала	Nan
طالع	побачити	None
طالما	так довго	Nan
طاهر	непорочний	Nan
طب	ліки	Nan
طبقا	відповідно	None
طبقاً	відповідно	None
طبقة	шар	None
طائرات	літаки	None
ضيقة	тісно	None
ضيق	тісний	Nan
ضواحي	передмістя	Nan
ضرورة	необхідність	None
ضرورية	необхідні	None
ضريبة	податок	None
ضريح	святиня	Nan
ضعف	слабкість	Nan
ضعيف	слабкий	Nan
ضعيفة	слабкий	Nan
صقلية	сицилія	Nan
ضغط	тиск	None
ضم	об’єднайте	Nan
ضمان	гарантія	Nan
ضمت	у комплекті	Nan
ضمن	всередині	None
ضمنها	всередині нього	Nan
ضوء	світло	None
ضوئية	світло	None
ضفاف	банки	None
غرب	захід	None
صقر	сокіл	Nan
صفوف	рядки	None
شيوخ	старійшини	Nan
شيوعا	поширені	None
شيوعاً	поширені	None
شيوعية	комунізм	None
شيوعًا	поширені	None
ص	с	None
صاحب	власник	None
صاحبه	його власник	Nan
صادرات	експорт	None
صادق	чесний	Nan
صار	це сталося	Nan
صارت	вона стала	Nan
صارمة	суворий	Nan
صالح	дійсний	Nan
صالحة	дійсний	Nan
شيد	побудований	None
صباح	ранок	Nan
شيخ	шейх	Nan
شيئاً	щось	None
شهادة	ступінь	None
شهد	свідок	Nan
شهدت	бачили	None
شهدوا	вони бачили	Nan
شهر	місяць	None
شهرة	слава	None
شهور	місяці	None
شوارع	вулиці	None
شواطئ	пляжі	Nan
شوال	shawwal	Nan
شوقي	шокі	Nan
شي	ши	Nan
شيء	річ	None
شيءًا	щось	None
شيئا	щось	None
شيث	сет	Nan
صبحي	собхі	Nan
صبري	моє терпіння	Nan
صحة	здоров&#39;я	Nan
صرح	він заявив	Nan
صريح	явний	Nan
صعب	важкий	None
صعبة	складно	Nan
صعوبة	труднощі	None
صعيد	рівень	None
صغار	молодший	Nan
صغير	маленький	Nan
صغيرة	маленький	Nan
صف	рядок	Nan
صفات	якості	None
صفة	опис	None
صفحات	сторінки	None
صفحة	сторінки	None
صفر	нуль	Nan
صربيا	сербія	None
صراع	конфлікт	None
صديقه	подруга	Nan
صديق	друг	None
صحراء	пустеля	Nan
صحف	газети	None
صحية	здоровий	Nan
صحيح	правда	None
صحيحة	правильно	None
صحيحه	правильно	None
صحيفة	газета	None
صفين	два ряди	Nan
صخرية	скелястий	Nan
صد	ліф	Nan
صداقة	дружба	None
صدام	саддам	Nan
صدر	випущено	Nan
صدرت	виданий	None
صدق	істина	Nan
صدور	скриня	Nan
صخور	скелі	None
سنتين	два роки	Nan
غربا	захід	None
غربي	західний	None
كأس	чашка	Nan
كأنه	ніби	None
كائن	об&#39;єкт	Nan
كائنات	об&#39;єкти	Nan
كاتب	діловод	Nan
كاتدرائية	собор	None
كاترين	катрін	Nan
كاجو	кешью	Nan
كاد	майже	None
كادميوم	кадмій	None
كارل	карл	None
كارلوس	карлос	Nan
كاروانسرا	карвансра	Nan
كارولين	керолайн	Nan
كاسترو	кастро	Nan
قُتل	вбивство	None
كاظم	казем	Nan
قَالَ	він сказав	Nan
قيمة	цінності	None
قومية	націоналізм	None
قوى	сильний	None
قوي	сильний	None
قوياً	сильний	None
قوية	сильний	None
قويسة	шавлія	None
قي	ставка	None
قيادة	лідерство	Nan
قياس	вимірювання	None
قيام	зробіть	Nan
قيد	обмежити	Nan
قيس	каї	Nan
قيصر	цезар	None
قيل	було сказано	Nan
قيم	цінності	None
قيود	обмеження	None
قومي	національний	None
كافة	всі	None
كافية	достатньо	None
كبيراً	чудово	Nan
كبيرة	великий	None
كبيرًا	великий	None
كتائب	батальйони	Nan
كتاب	книга	None
كتابات	писання	None
كتابة	написання	None
كتابه	написання	None
كتب	написав	None
كتبت	я написав	Nan
كتبغا	написано	None
كتبه	написано	None
كتبها	написано	None
كتل	блоки	Nan
كتلة	меса	Nan
كبيرا	чудово	Nan
كافور	камфора	Nan
كبير	великий	None
كبر	зростати	Nan
كالتالي	як слід	Nan
كاليفورنيا	каліфорнія	Nan
كامب	табір	None
كامل	цілі	None
كاملاً	повністю	None
كاملة	досконалий	Nan
كان	це було	Nan
كانا	вони були	Nan
كاناميسين	канаміцин	Nan
كانت	вона була	Nan
كانتا	вони були	Nan
كانوا	вони були	Nan
كانون	canon	Nan
كايبر	кіппер	Nan
كبار	старший	None
كبرى	чудово	Nan
قومه	його люди	Nan
قوم	люди	None
قوله	говорячи це	Nan
قصائده	його вірші	Nan
قصة	історія	None
قصد	я маю на увазі	Nan
قصر	палац	None
قصص	історії	None
قصف	обстріли	Nan
قصور	невдача	Nan
قصيدة	вірш	None
قصير	короткий	None
قصيرة	короткий	None
قضاء	витратити	Nan
قضايا	випуски	Nan
قضى	витрачено	Nan
قضيبه	його пеніс	Nan
قضية	проблема	None
قصائد	вірші	None
قط	ніколи	None
قسمين	два розділи	Nan
قسم	відділ	None
قرر	він вирішив	Nan
قرص	планшет	Nan
قرطاج	карфаген	Nan
قرطاجنة	картахена	None
قرطبة	кордова	Nan
قرن	століття	None
قرون	століття	None
قرى	села	None
قريب	закрити	Nan
قريبة	закрити	Nan
قرية	село	None
قريش	курайш	Nan
قريظة	курайза	Nan
قزوين	каспійський	Nan
قسطنطين	костянтин	None
قسمت	поділений	Nan
قطار	поїзд	Nan
قطاع	розділ	None
قطاعات	сектори	Nan
قمر	місяць	None
قمع	придушення	None
قناة	канал	None
قنوات	канали	None
قوائم	списки	None
قوات	сили	None
قواته	його сили	Nan
قواتها	її сили	Nan
قواعد	правила	None
قوانين	правила	None
قوبلاي	кублай	Nan
قوة	енергія	None
قوتها	його сила	Nan
قوس	арк	Nan
قول	сказати	None
قمة	саміт	Nan
قم	зареєструйтесь	Nan
قليلة	декілька	None
قليلاً	трохи	None
قطب	полюс	Nan
قطر	діаметр	Nan
قطرها	діаметр	Nan
قطز	кутуз	Nan
قطع	вирізати	Nan
قطعة	шматок	Nan
قلاوون	калавун	Nan
كتيبة	батальйон	Nan
قلب	серце	None
قلبي	моє серце	Nan
قلة	відсутність	None
قلت	я сказав	Nan
قلعة	замок	None
قلوب	серця	None
قليل	маленький	Nan
قليلا	трохи	None
قلبه	його серце	Nan
قرب	біля	None
كثافة	щільність	None
كثرة	достаток	Nan
لألمانيا	для німеччини	Nan
لأن	тому що	Nan
لأنه	тому що він	Nan
لأنها	тому що вона	Nan
لأهل	до людей	Nan
لأوروبا	для європи	Nan
لأول	для перших	Nan
لأي	для будь-якого	Nan
لإثبات	щоб довести	Nan
لإجراء	провести	None
لإدارة	керувати	None
لإسرائيل	до ізраїлю	Nan
لإعادة	для скидання	Nan
لإقامة	встановити	None
لإنتاج	виробляти	Nan
لأكثر	для більш	Nan
لإنشاء	створити	None
لأفضل	для кращого	Nan
لأسباب	з причин	Nan
كيشيون	касіон	Nan
كيف	як	None
كيفية	як	None
كيلومتر	кілометр	Nan
كيمياء	хімія	None
كيميائي	хімічна	None
كيميائية	хімічна	None
كييف	київ	None
ل	до	None
لآخر	для іншого	Nan
لأبي	для мого тата	Nan
لأجل	заради	None
لأحد	для будь-кого	Nan
لأداء	виконувати	None
لأرسطو	аристотелю	Nan
لأغراض	для цілей	Nan
كيشوا	кечуа	Nan
لإيجاد	знайти	None
لابد	потрібно	None
لاَ	немає	None
لبث	наполягати	Nan
لبعض	для деяких	Nan
لبلاد	для країни	Nan
لبناء	конструювати	Nan
لبنانية	ліванці	Nan
لتجنب	уникати	Nan
لتحديد	щоб визначити	Nan
لتحرير	для редагування	Nan
لتحسين	покращувати	Nan
لتحقيق	досягати	Nan
لتشكل	позувати	Nan
لتشكيل	формувати	Nan
لتشمل	включити	Nan
لتصبح	ставати	Nan
لاين	лінія	None
لا	немає	None
لايف	наживо	Nan
لاند	земля	None
لابن	синові	Nan
لاتخ	не звинувачуйте	Nan
لاحظ	зауважте	Nan
لاحق	пізніше	None
لاحقا	пізніше	None
لاحقاً	пізніше	None
لاحقة	суфікс	Nan
لادن	ладен	Nan
لاسم	для імені	Nan
لاسيما	особливо	None
لاعب	гравець	Nan
لاعبي	мої гравці	Nan
لاقت	зустрівся	Nan
لامدا	лямбда	Nan
لان	тому що	Nan
لانه	тому що він	Nan
كيان	сутність	None
كي	кі	Nan
كونها	буття	None
كسر	зламався	Nan
كشف	розкрити	Nan
كشفت	виявлено	None
كعب	каблук	Nan
كفر	невіра	Nan
كقوة	як сила	Nan
ككل	в цілому	Nan
كل	кожен	None
كلا	і те й інше	Nan
كلام	говорити	None
كلثوم	kulthum	Nan
كلغة	як мова	Nan
كلما	коли завгодно	Nan
كلمات	лірика	None
كلمة	слово	None
كسب	заробити	Nan
كله	цілий	None
كريت	крит	None
كركيات	crocs	Nan
كثير	багато	None
كثيرا	багато чого	Nan
كثيراً	багато чого	Nan
كثيرة	багато	None
كثيرون	багато	None
كثيف	щільна	Nan
كثيفة	важкий	None
كجزء	як частина	Nan
كدولة	як країна	Nan
كذا	такі	None
كذلك	також	None
كرات	кульки	Nan
كربلاء	карбала	Nan
كرة	м&#39;яч	Nan
كرسي	стілець	Nan
كريات	гранули	Nan
كلها	все це	Nan
كلهم	усі	None
كليات	факультети	Nan
كهربائي	електромонтажник	Nan
كهربائية	електричний	None
كواكب	планети	None
كوايك	квік	Nan
كوبا	куба	None
كوريا	корея	Nan
كوريوم	кюрій	None
كوزميد	козумід	Nan
كوسيلة	як засіб	Nan
كوكب	планети	None
كولوم	кулон	Nan
كولومبيا	колумбія	Nan
كون	всесвіт	None
كونان	конан	Nan
كونه	буття	None
كهرباء	електрика	Nan
كنيسة	церква	None
كنعان	ханаан	Nan
كندا	канада	None
كليب	кліп	Nan
كلية	коледж	None
كلينتون	клінтон	Nan
كليوباترا	клеопатра	Nan
كلّ	кожен	None
كم	як багато	Nan
كما	як такий	Nan
كثر	багато	None
كمال	вдосконалення	None
كميات	кількості	None
كمية	кількість	None
كنا	ми були	Nan
كنائس	церкви	None
كنانة	кінаана	Nan
كنت	я був	Nan
كنتيجة	як результат	Nan
كمصدر	як джерело	Nan
قرارات	рішення	None
قرار	дозвіл	None
قرابة	про	None
فرسان	лицарі	Nan
فرساي	версаль	Nan
فرص	можливості	None
فرصة	шанс	Nan
فرض	накладати	Nan
فرضت	затиснутий	Nan
فرضية	гіпотеза	None
فرع	філія	None
فرعون	фараон	None
فرعية	вторинні	Nan
فرق	різниця	None
فرقة	загін	None
فرنسا	франція	None
فرنسي	французький	None
فرنسية	французький	None
فردية	індивідуальний	Nan
فروع	гілки	None
فرد	фізична особа	Nan
فرانك	френк	Nan
فترة	інтервал	Nan
فتكون	ти будеш	Nan
فتم	ftm	Nan
فتنة	спокуса	Nan
فجاء	так він прийшов	Nan
فجر	світанок	Nan
فجعل	він зробив	Nan
فحسب	тільки	None
فحص	перевіряти	Nan
فخرج	тож він вийшов	Nan
فخلال	під час	Nan
فدخل	так він увійшов	Nan
فذهب	тож він пішов	Nan
فراس	фірас	Nan
فرانسيسكو	франциско	Nan
فرانكو	франко	None
فترات	періоди	None
فرويد	фрейд	Nan
فريدة	фарида	Nan
فعلاً	дійсно	None
فعله	зроблено	None
فعلى	фактичний	Nan
فعندما	коли	None
ففي	в	None
فقال	він сказав	Nan
فقالت	і вона сказала	Nan
فقالوا	так вони сказали	Nan
فقام	тож він підвівся	Nan
فقامت	так вона встала	Nan
فقبل	до цього	Nan
فقد	загублений	Nan
فقدان	втрата	None
فقدت	втрачено	Nan
فقر	бідність	Nan
فعلا	дійсно	None
فريد	унікальний	None
فعل	акт	None
فعالة	ефективна	Nan
فريدريك	фредерік	Nan
فريق	команда	None
فشل	невдача	Nan
فشلت	не вдалося	Nan
فصائل	види	None
فصل	сезон	None
فصول	глави	Nan
فضاء	космос	Nan
فضائية	космос	Nan
فضل	дякую	Nan
فضلا	так само, як	Nan
فضلاً	так само, як	Nan
فطلب	запитав він	Nan
فطيرة	пиріг	Nan
فعال	ефективний	Nan
فعالية	ефективність	None
فتحي	фаті	Nan
فتحها	відкрий це	Nan
فتحت	відкрили	None
غلطة	помилка	Nan
غلوكوز	глюкоза	Nan
غلوون	глуон	Nan
غناء	спів	None
غناها	її багатство	Nan
غني	багатий	None
غنية	багатий	None
غوستاف	густав	Nan
غياب	відсутність	None
غير	non	Nan
غيره	ревнивий	Nan
غيرها	інший	None
غيرهم	інші	None
غيفارا	гевара	Nan
غينيا	гвінея	Nan
غلاف	кожух	Nan
فأخذ	тому він взяв	Nan
غطاء	обкладинка	Nan
غضب	гнів	Nan
غربية	західний	None
غربًا	захід	None
غرفة	кімната	Nan
غرناطة	гранада	Nan
غريب	незнайомець	Nan
غريبة	дивно	None
غرين	грін	Nan
غزا	підкорив	Nan
غزة	газа	Nan
غزو	вторгся	Nan
غزوات	фори	Nan
غزوة	набіг	Nan
غسق	сутінки	Nan
غسل	мити	Nan
غشاء	мембрана	None
غضون	у межах	Nan
فأرسل	він послав	Nan
فأصبح	він став	Nan
فأصبحت	я став	Nan
فاطمة	фатіма	Nan
فاعلية	ефективність	None
فالج	геміплегія	Nan
فالكيري	валькірія	Nan
فالنتين	валентин	None
فان	ван	Nan
فاندانغو	фанданго	Nan
فايمار	веймар	Nan
فبدأ	так він і почав	Nan
فبراير	лютий	None
فبعد	після	None
فبعض	дещо	None
فتاة	дівчина	None
فتح	відчинено	Nan
فتحة	виїмка	Nan
فاس	сокира	Nan
فازت	вона перемогла	Nan
فاز	виграв	Nan
فاروق	фарук	Nan
فأمر	так він наказав	Nan
فأن	тоді	None
فؤاد	fouad	Nan
فإذا	так	None
فإن	the	Nan
فإننا	ми будемо	Nan
فإنه	це робить	Nan
فقرر	тому він вирішив	Nan
فإنها	вони будуть	Nan
فئات	категорії	None
فئة	категорія	None
فائدة	вигода	Nan
فائقة	супер	Nan
فاراداي	фарадей	Nan
فارس	лицар	None
فارسي	перська	Nan
فإنهم	вони є	Nan
فقط	просто	None
فقلت	так я сказав	Nan
فقه	юриспруденція	Nan
قارات	континенти	Nan
قارة	континент	Nan
قاسم	знаменник	Nan
قاسية	жорстокий	Nan
قاعة	зал	None
قاعدة	база	None
قال	він сказав	Nan
قالت	вона сказала	Nan
قاله	він сказав це	Nan
قالوا	вони сказали	Nan
قام	роза	Nan
قامت	вона зробила	Nan
قاموا	вони піднялися	Nan
قاموس	словник	None
قانون	закон	None
قادرين	здатний	None
قانوني	юридичний	None
قادرة	здатний	None
قادت	вона вела	Nan
فيهما	у них	Nan
فيينا	відень	None
فِي	в	None
ق	s	Nan
قائد	ведучий	Nan
قائلا	приказка	Nan
قائلاً	приказка	Nan
قائم	існуючі	None
قائمة	список	None
قابل	зустрівся	Nan
قابلة	зустрів його	Nan
قابوس	кабус	Nan
قاتل	вбивця	Nan
قاد	заїхав	Nan
قادة	лідери	None
قادر	здатний	None
قانونية	юридичні	None
قايتباي	qaitbay	Nan
قباء	куба	None
قدرته	його здібності	Nan
قدرتها	його здатність	Nan
قدرها	її доля	Nan
قدم	стопа	Nan
قدماء	древні	None
قدمت	надіслано	Nan
قدمه	подавайте його	Nan
قدمها	подавайте його	Nan
قدوم	наближається	Nan
قديم	старий	None
قديما	в минулому	Nan
قديمًا	давні часи	Nan
قذف	стріляти	Nan
قرأ	читати	None
قراءة	читання	None
قدرت	я підрахував	Nan
قدرة	ємність	Nan
قدر	соусник	Nan
قد	може бути	Nan
قبائل	племена	None
قباني	кинь мене	Nan
قبة	купол	Nan
قبر	могила	None
قبرص	кіпр	Nan
قبره	жайворонок	Nan
قبض	виловити	Nan
فيهم	у тому числі	Nan
قبل	до цього	Nan
قبول	прийняття	None
قبيلة	плем&#39;я	Nan
قتال	боротьба	None
قتل	вбивство	None
قتلة	вбивць	Nan
قتله	вбивць	Nan
قتلوا	були вбиті	Nan
قبله	поцілунок	Nan
غرباً	захід	None
فيها	у котрому	Nan
فينول	фенол	None
فلك	астрономія	None
فلم	фільм	None
فلما	чому?	Nan
فلمّا	чому?	Nan
فلن	ти не	Nan
فلو	flo	Nan
فلورنسا	флоренція	None
فليس	це не	Nan
فما	і що	Nan
فمثلا	наприклад	None
فمثلاً	наприклад	None
فمن	це є	Nan
فمنذ	з тих пір	Nan
فمنهم	саме від них	Nan
فن	мистецтво	None
فلقد	це має	Nan
فنان	художник	None
فلسفة	філософія	None
فلسطيني	палестинська	Nan
فقهاء	юристи	Nan
فقيل	було сказано	Nan
فك	розшифруйте	Nan
فكان	це було	Nan
فكانت	це було	Nan
فكانوا	вони були	Nan
فكر	думка	None
فكرة	ідея	None
فكل	так усі	Nan
فلا	це не	Nan
فلاح	фермер	None
فلاديمير	володимир	None
فلاسفة	філософи	None
فلدسبار	польовий шпат	Nan
فلسطين	палестина	Nan
فلسطينية	палестинська	Nan
فندق	готель	None
فنزويلا	венесуела	Nan
فنلندا	фінляндія	None
فيديو	відео	None
فيرفكس	firefox	Nan
فيروس	вірус	None
فيروسات	віруси	None
فيرونا	верона	None
فيزيائية	фізичні	None
فيس	facebook	Nan
فيصل	файсал	Nan
فيقول	він каже	Nan
فيكون	так воно і є	Nan
فيلم	кіно	None
فيليب	філіп	Nan
فيما	стосовно	None
فيمكن	це може	Nan
فينشي	вінчі	None
فيجب	це повинно	Nan
فيتنام	в&#39;єтнам	Nan
في	в	None
فوهة	насадка	Nan
فنون	мистецтво	None
فني	технічні	None
فنية	художній	None
فهد	леопард	Nan
فهذا	це	None
فهذه	так це	Nan
فهم	розуміння	None
فيه	в цьому	Nan
فهمي	моє розуміння	Nan
فهو	він є	Nan
فهي	вона є	Nan
فوائد	переваги	None
فور	відразу	None
فوضى	безлад	Nan
فوق	вище	None
فون	iphone	Nan
فهناك	там	None
سنة	рік	None
سنان	зуби	None
سن	вік	None
جديدة	нові	None
جديدًا	нові	None
جدير	гідний	Nan
جدًا	дуже	None
جذب	залучати	Nan
جذور	коріння	None
جراء	лялечка	Nan
جرائم	злочини	None
جرانيت	граніт	None
جرت	відбувся	None
جرى	він втік	Nan
جريدة	газета	None
جزء	частина	None
جزءا	частина	None
جزءاً	частина	None
جديداً	нові	None
جزءًا	частина	None
جديدا	нові	None
جدوى	технічність	Nan
جبران	джубран	Nan
جبريل	габріель	Nan
جبلية	гора	None
جبهة	передня	Nan
جد	дідусь	Nan
جدا	дуже	None
جدار	стіна	Nan
جدال	суперечки	None
جداً	дуже	None
جدة	бабуся	Nan
جدد	новенькі	Nan
جدران	стіни	None
جدل	аргумент	Nan
جده	бабуся	Nan
جدول	таблиця	None
جديد	нові	None
جبال	гори	None
جزئيا	частково	None
جزيئات	молекули	None
جلب	приніс	Nan
جلد	шкіра	Nan
جلسة	сесія	Nan
جماع	статевий акт	Nan
جماعات	групи	None
جماعية	колективний	Nan
جمال	краса	None
جمع	множина	None
جمعة	п’ятниця	Nan
جمعت	зібрано	Nan
جمعه	п’ятниця	Nan
جمعها	зібрано	Nan
جمعية	об&#39;єднання	Nan
جملة	вирок	Nan
جمهور	громадські	None
جلال	целал	Nan
جزر	морква	Nan
جل	гель	Nan
جغرافية	географія	None
جزيرة	острів	None
جساس	шпигун	Nan
جسد	тіло	None
جسده	його тіло	Nan
جسدها	її тіло	Nan
جسر	міст	None
جسم	тіло	None
جسمه	його тіло	Nan
جسيمات	частинки	None
جعفر	джафар	Nan
جعل	зробити	None
جعلت	зроблено	None
جعله	зроби це	Nan
جعلها	зроби це	Nan
جغرافيا	географія	None
جفاف	посуха	Nan
جانبي	сторона	None
جانبه	його сторона	Nan
جانب	сторона	None
تيمية	таймія	Nan
تُشكل	форма	None
تُظهر	з&#39;являються	Nan
تُعتبر	вважається як	Nan
تُعد	підготуватися	Nan
تُعرف	відомий	None
ثابتة	виправлено	Nan
ثار	помсти	Nan
ثالث	третій	None
ثاليوم	талій	None
ثانوية	вища школа	Nan
ثاني	другий	None
ثانيا	по-друге	Nan
ثانية	секунда	Nan
ثبت	доведено	Nan
تيمور	тимур	Nan
ثروة	багатство	None
تيفوس	тиф	Nan
تيار	потік	None
توقع	очікування	Nan
توقف	стій	Nan
توقيع	підпис	None
توكيس	токіси	Nan
تولد	народжуючи	Nan
تولى	взяв на себе	Nan
توليد	покоління	None
توليه	інавгурація	Nan
تولّى	взяв на себе	Nan
توما	тома	Nan
توماس	томас	None
تونس	туніс	Nan
تويوتا	toyota	Nan
تويودا	toyoda	Nan
تي	т	None
تيارات	потоки	None
ثقافات	культури	None
ثقافة	культури	None
ثقافي	культурні	None
جاء	прийшов	None
جاءت	вона прийшла	Nan
جائزة	нагорода	Nan
جابر	джабер	Nan
جاذبية	сила тяжіння	Nan
جاسم	джассім	Nan
جاك	джек	Nan
جاكسون	джексон	Nan
جالوت	голіаф	Nan
جاليليو	галілей	Nan
جالينوس	гален	Nan
جامع	мечеть	Nan
جامعات	університети	None
جامعة	університет	None
جان	січ	None
ج	с	None
ثيوديسيا	теодізія	Nan
ثورة	революція	None
ثورات	революції	None
ثقافية	культурні	None
ثقب	отвір	Nan
ثقة	впевненість	Nan
ثلاث	три	None
ثلاثة	три	None
ثلاثية	трилогія	Nan
ثلاثين	тридцять	Nan
جمهوري	республіканський	Nan
ثلث	одна третя	Nan
ثمان	вісім	None
ثماني	вісім	None
ثمانية	вісім	None
ثمة	є	None
ثمّ	тоді	None
ثنائية	дуалізм	Nan
ثور	віл	None
ثم	тоді	None
توفيق	примиритись	Nan
جمهورية	республіка	None
جميعا	усі	None
حدائق	сади	Nan
حدة	різкість	Nan
حدث	подія	None
حدثت	оновлено	Nan
حدثنا	скажи нам	Nan
حدد	знайдіть	Nan
حدودها	її межі	Nan
حديث	сучасний	None
حديثا	недавно	Nan
حديثة	сучасний	None
حديثًا	недавно	Nan
حديد	залізо	None
حديدية	чорний	None
حديقة	садовий	Nan
حراء	хіра	Nan
حد	обмеження	None
حرارة	тепло	Nan
حجوالة	передача	None
حجما	за розміром	Nan
حاليا	в даний час	Nan
حالياً	в даний час	Nan
حاليًا	в даний час	Nan
حامد	хамед	Nan
حامل	вагітна	Nan
حاول	намагатися	Nan
حاولت	я намагався	Nan
حب	любов	None
حبيب	коханець	Nan
حبيبي	дитина	None
حتى	поки	None
حتي	поки	None
حجة	аргумент	Nan
حجر	камінь	None
حجم	розмір	None
حجمها	її розмір	Nan
حالته	його стан	Nan
حرارته	його тепло	Nan
حرام	заборонено	None
حساسة	чутливий	Nan
حسان	хассан	Nan
حسب	згідно з	Nan
حسن	хассан	Nan
حسنة	добрий вчинок	Nan
حسني	хосні	Nan
حسين	хусейна	Nan
حشد	натовп	None
حشرات	комахи	Nan
حشيشة	хашиш	Nan
حصار	облога	Nan
حصة	період	None
حصدت	урожай	Nan
حصل	сталося	None
حصلت	я отримав	Nan
حسابات	рахунки	Nan
حرارتها	його тепло	Nan
حساب	рахунок	None
حزن	саднес	Nan
حرب	війни	None
حربية	військовий корабель	Nan
حرة	безкоштовно	Nan
حرس	охоронець	Nan
حرف	лист	None
حرق	спалити	Nan
حركات	рухи	None
حركة	руху	None
حرم	заборонено	None
حروب	війни	None
حروف	листи	None
حرية	свобода	None
حزام	пояс	None
حزب	партія	None
حزم	ремінь	Nan
حزيران	червень	None
حالة	статус	None
حالب	сечовід	Nan
حالات	справ	None
جهات	пункти призначення	Nan
جهاد	джихад	Nan
جهاز	пристрій	None
جهة	сторона	None
جهد	зусилля	None
جهود	зусилля	None
جو	атмосфера	None
جوائز	нагороди	None
جواز	паспорт	Nan
جوانب	аспекти	None
جواهر	коштовності	Nan
جوجل	google	None
جودة	якість	None
جورج	джордж	None
جورجيا	грузія	None
جنوده	його солдати	Nan
جورجيون	грузини	None
جنود	солдати	None
جنوبي	південний	None
جميعاً	усі	None
جميعًا	усі	None
جميل	прекрасна	Nan
جميلة	гарний	Nan
جناح	люкс	Nan
جنب	сторона	None
جندي	солдат	Nan
جنس	секс	None
جنسي	сексуальні	None
جنسية	національність	None
جنطيانية	генціанство	Nan
جنكيز	чингіс	Nan
جنو	gnu	Nan
جنوب	південь	None
جنوبا	південь	None
جنوبًا	південь	None
جوزيف	йосип	None
جولة	тур	None
جون	джон	None
حائل	радуйся	Nan
حاتم	хатем	Nan
حاجة	потреба	None
حادة	різкий	Nan
حادث	аварія	Nan
حادثة	інцидент	Nan
حار	гарячий	Nan
حارب	боротися	Nan
حارة	лейн	Nan
حاز	має	None
حاسوب	комп&#39;ютер	Nan
حافة	край	None
حافظ	хафіз	Nan
حافظت	підтримується	Nan
حال	хвороба	None
حائط	стіна	Nan
جيوش	армії	None
جينات	гени	None
جين	гена	None
جوهر	сутність	None
جوي	повітряна	Nan
جوية	повітря	None
جي	інж	Nan
جيبوتي	джибуті	Nan
جيجابت	гігабіт	Nan
جيد	добре	None
جميع	всі	None
جيدا	ну	Nan
جيدة	хороший	Nan
جيش	армії	None
جيشه	його армія	Nan
جيشًا	армія	None
جيفارا	гевара	Nan
جيل	покоління	None
جيمس	джеймс	None
جيداً	ну	Nan
توفير	надати	None
توفيت	вона померла	Nan
توفي	помер	None
تضع	покладіть	Nan
تضم	включає	None
تطبق	застосовувати	None
تطبيق	впровадження	None
تطبيقات	програми	None
تطل	подивитися вниз	Nan
تطلب	запитайте	Nan
تطلق	звільнений	Nan
تطهير	дезінфекція	Nan
تطور	еволюціонувала	Nan
تطورا	витончений	Nan
تطورت	еволюціонував	Nan
تطوير	розвиток	None
تطوّر	еволюціонувала	Nan
تظل	залишаються	None
تضخم	опух	Nan
تظهر	з&#39;являються	Nan
تضاعف	помножено	Nan
تصوير	сфотографувати	Nan
تصنيفعلم	класифікаційний прапор	Nan
تصنيفعلماء	класифікація вчених	Nan
تصنيفعواصم	класифікація столиць	Nan
تصنيففلاسفة	класифікація філософів	Nan
تصنيفقادة	рейтинг лідерів	Nan
تصنيفكتاب	класифікаційна книга	Nan
تصنيفلاعبو	класифікація гравців	Nan
تصنيفمدن	класифікація міст	Nan
تصنيفمصريون	рейтинг єгиптян	Nan
تصنيفممثلات	класифікація актрис	Nan
تصنيفممثلون	рейтинг акторів	Nan
تصنيفمواليد	класифікація новонароджених	Nan
تصنيفوزراء	класифікація міністрів	Nan
تصنيفوفيات	класифікації	None
تصور	уявіть собі	Nan
تصيب	інфекція	Nan
تصنيفصحابة	супутник класифікації	Nan
تعارض	не погоджуюсь	Nan
تعالى	прийти	Nan
تعطى	дано	Nan
تعطي	дайте	Nan
تعكس	відбийте	Nan
تعلم	дізнайтеся	Nan
تعليم	освіта	None
تعليمه	освічена	Nan
تعليمية	навчальна	Nan
تعمل	робочий	Nan
تعني	засоби	None
تعود	повернення	None
تعيش	наживо	Nan
تغطي	покриття	Nan
تغطية	покриття	Nan
تغلب	здолати	Nan
تغير	змінити	None
تعزيز	зміцнювати	Nan
تعاطي	зловживання	Nan
تعرّض	контакт	None
تعرف	знай	Nan
تعاليم	навчання	None
تعامل	угода	None
تعاني	страждати	Nan
تعاون	співпраця	None
تعبر	хрест	None
تعتبر	вважається як	Nan
تعترف	визнайте	Nan
تعتمد	залежить	None
تعد	підготуватися	Nan
تعداد	перерахування	Nan
تعددت	я примножив	Nan
تعديل	модифікація	Nan
تعرض	контакт	None
تعرضت	був викритий	Nan
تعرضوا	вони були викриті	Nan
تعريف	визначення	None
تصنيفشعراء	класифікація поетів	Nan
تصنيفرؤساء	класифікація голів	Nan
تصنيفديمقراطيات	класифікація демократії	Nan
تسمية	називання	Nan
تسونامي	цунамі	Nan
تسوية	поселення	None
تسير	збирається	Nan
تسيطر	управління	None
تشاد	чад	Nan
تشارك	залучений	Nan
تشارلز	карла	None
تشبه	подібно до	Nan
تشترك	поділитися	Nan
تشتمل	включати	Nan
تشتهر	відомий за	Nan
تشجيع	заохочуйте	Nan
تشخيص	діагностовано	Nan
تشرف	почесний	None
تسمى	це називається	Nan
تشريع	законодавство	None
تسمح	дозволити	Nan
تسلم	отримано	Nan
تستخدم	б / в	Nan
تستطع	ти можеш	Nan
تستطيع	можеш ти	Nan
تستعمل	б / в	Nan
تستغرق	приймати	None
تستمر	це триває	Nan
تستهلك	споживайте	Nan
تسجيل	зареєструйтесь	Nan
تسخين	опалення	Nan
تسرب	витік	Nan
تسع	дев&#39;ять	Nan
تسعة	дев&#39;ять	Nan
تسعى	шукаю	Nan
تسقط	падіння	None
تسلسل	послідовність	None
تسليم	доставка	Nan
تشرين	тишрін	Nan
تشغل	біжить	Nan
تشغيل	біг	Nan
تصغير|مسجد	мінімізувати | мечеть	Nan
تصف	опишіть	Nan
تصل	досягай	Nan
تصميم	дизайн	Nan
تصنع	виготовлено	Nan
تصنف	класифіковані	Nan
تصنيع	виготовлення	None
تصنيف	рейтинг	None
تصنيفآل	класифікація	None
تصنيفأشخاص	класифікація осіб	Nan
تصنيفأعلام	класифікаційні прапори	Nan
تصنيفبلدان	класифікація країн	Nan
تصنيفتاريخ	дата оцінки	Nan
تصنيفخريجو	класифікація випускників	Nan
تصنيفدول	класифікаційні країни	Nan
تصغير|صورة	мінімізувати | зображення	Nan
تصغير|رسم	мінімізувати | малювати	Nan
تصغير|بك|رسم	мінімізуйте | свій | розіграш	Nan
تصغير|	мінімізувати |	Nan
تشكل	форма	None
تشكلت	сформовано	Nan
تشكيل	формування	None
تشمل	включати	Nan
تشهد	свідчити	Nan
تشي	че	Nan
تشير	укажіть	Nan
تغيرات	зміни	None
تشيكوسلوفاكيا	чехословаччина	None
تشييد	будівництво	None
تشييط	перевірка	Nan
تصاعد	монтаж	Nan
تصب	залити	Nan
تصبح	стань	Nan
تصدر	виданий	None
تصدير	експорт	None
تشين	чень	Nan
تغيرت	змінено	Nan
تغيير	зміна	None
تفاصيل	деталі	None
تمنع	запобігати	Nan
تمويل	фінанси	None
تميز	розрізняють	None
تميزت	позначено	Nan
تميل	схиляються	Nan
تميم	тамім	Nan
تمييز	дискримінація	Nan
تمّ	зроблено	None
تنازل	відмова	None
تناول	їсть	Nan
تناولت	їсти	Nan
تنبأ	прогнозували	Nan
تنتج	виробляти	Nan
تنتشر	поширене	Nan
تنتقل	рухатися	Nan
تمنح	здійснено	None
تنتمي	належать	None
تملك	володіє	None
تمرد	заколот	Nan
تم	зроблено	None
تمارس	практикується	Nan
تمام	гаразд	Nan
تماما	повністю	None
تماماً	повністю	None
تمامًا	повністю	None
تمت	зроблено	None
تمتاز	excel	Nan
تمتد	розтягування	Nan
تمتعت	я насолоджувався	Nan
تمتلك	володіє	None
تمثال	статуя	None
تمثلت	на зображенні	Nan
تمثيل	представництво	None
تمر	перехід	None
تمكن	керований	Nan
تنتهي	закінчується	None
تنخفض	спускайся	Nan
تنسيق	координувати	Nan
توتونيون	тевтонський	Nan
توجد	існує	None
توجه	орієнтація	Nan
توجيه	керівництво	None
توحيد	стандартизація	Nan
توزيع	розповсюдження	None
توسع	розширення	None
توسعت	розширено	Nan
توسيع	розширення	None
توصل	прибути	Nan
توصيل	підключення	Nan
توضح	уточнити	Nan
توضع	будьте поміщені	Nan
توفر	доступність	Nan
توفى	помер	None
توت	чорниця	None
توافق	згоден	Nan
توازن	баланс	Nan
تواجه	обличчя	None
تنشأ	встань	Nan
تنص	штати	None
تنظم	організувати	Nan
تنظيم	групи	None
تنفيذ	впровадження	None
تنقسم	поділений	Nan
تنقل	передача	None
تليها	слідом за	Nan
تنمو	зростати	Nan
تنوع	різноманітність	None
تهتم	турбота	Nan
تهدد	загрожує	Nan
تهدف	цілі	None
تهيمن	домінувати	Nan
توابل	спеції	Nan
تواجد	існування	None
تنمية	розвиток	None
حصن	форт	Nan
تلوث	забруднення	None
تلك	це	None
تقدمه	пропонуйте це	Nan
تقدمها	за умови	Nan
تقدير	вдячність	Nan
تقديرات	оцінки	None
تقديم	надіслати	Nan
تقرر	вирішіть	Nan
تقريبا	приблизно	None
تقريباً	приблизно	None
تقريبًا	приблизно	None
تقرير	звіт	Nan
تقسم	розділити	Nan
تقسيم	поділ	None
تقضي	витратити	Nan
تقع	розташований	None
تقف	встаньте	Nan
تقدمت	розширений	Nan
تقل	менше	None
تقدم	прогрес	None
تقتصر	обмежений	None
تفاعل	взаємодія	None
تفاعلات	взаємодії	None
تفرض	накладати	Nan
تفسير	пояснення	None
تفصل	окремі	None
تفعل	роблять	None
تفقد	втрачати	Nan
تفكك	розвалився	Nan
تفوق	відмінник	Nan
تفيد	вигода	Nan
تقارب	зближення	None
تقارير	звіти	Nan
تقاليد	традиції	None
تقام	проводяться	None
تقبل	прийміть	Nan
تقدر	цінує	Nan
تقلل	зменшити	Nan
تقليد	традиції	None
تقليدية	традиційні	None
تكنولوجيا	технології	None
تكون	бути	None
تكونت	сформовано	Nan
تكوين	формування	None
تكيف	адаптація	Nan
تل	пагорб	Nan
تلال	пагорби	Nan
تلاميذه	його учні	Nan
تلبية	знайомтесь	Nan
تلت	слідкував	Nan
تلعب	грати	None
تلف	пошкодження	Nan
تلفزيون	телевізор	Nan
تلفزيونية	телебачення	None
تلقى	отримати	None
تكن	бути	None
تكمن	брехня	Nan
تكليس	прожарювання	Nan
تكلفة	вартість	None
تقليل	зменшити	Nan
تقنيات	технології	None
تقنية	техніка	None
تقود	вести	None
تقول	каже	None
تقوم	вставай	Nan
تقوية	посилення	None
تلو	після	None
تقويم	оцінка	None
تقييم	оцінка	None
تكاد	майже	None
تكاليف	витрати	None
تكتب	вона пише	Nan
تكثر	багато	None
تكرار	повторення	Nan
تكساس	техас	Nan
تقي	благочестивий	Nan
حصول	отримайте	Nan
حضارات	цивілізації	None
حضارة	цивілізація	None
ركن	куточок	Nan
رمزا	символ	None
رمزية	символіка	None
رمسيس	рамзес	Nan
رمضان	рамадан	Nan
رموز	символи	None
رمي	кинути	Nan
روابط	посилання	None
رواد	піонери	Nan
رواه	розповів	Nan
روايات	романи	None
رواية	новела	Nan
روبرت	роберт	None
روثينيوم	рутеній	None
روح	дух	None
ركام	щебінь	Nan
روس	росс	Nan
رقيقة	тонка	Nan
رقعة	патч	Nan
رصد	монітор	Nan
رضا	задоволення	None
رضي	задоволений	Nan
رعاف	епістаксис	Nan
رعاية	догляд	Nan
رعد	грім	None
رغبة	бажання	None
رغم	попри	None
رفض	відмова	None
رفضت	вона відмовилася	Nan
رفضه	відхилили його	Nan
رفع	завантажити	Nan
رفعت	підняли	Nan
رفيعة	струнка	Nan
رفيق	супутник	Nan
رقم	число	None
رشيد	рашид	Nan
روستوك	росток	None
روسيا	росія	None
زالت	все-таки	Nan
زاوية	кут	None
زايد	заєд	Nan
زحف	повзати	Nan
زحل	сатурн	Nan
زراعة	сільське господарство	Nan
زراعية	сільськогосподарські	None
زرع	посадка	Nan
زرنيخيد	арсенід	Nan
زعامة	керівництво	None
زعماء	лідери	None
زعيم	ведучий	Nan
زغلول	заглоул	Nan
زكريا	закарія	Nan
زكي	закі	Nan
زال	все-таки	Nan
روسو	руссо	None
زار	відвідати	Nan
زاد	збільшена	Nan
روما	рим	None
رومانيا	румунія	None
رومانية	румунська	Nan
رونالدو	роналду	Nan
روى	розповів	Nan
روي	рой	Nan
رياح	вітер	None
رياض	ріад	Nan
رياضة	спорт	None
رياضية	атлетичний	Nan
ريال	ріал	Nan
ريتشارد	річард	None
ريشة	квіл	Nan
ريكشا	рікша	Nan
ريولوجيا	реологія	None
زادت	збільшена	Nan
رشد	дорослість	Nan
رسوم	збори	None
رسول	посланник	Nan
رئاسة	президентство	Nan
رئيس	президент	None
رئيسا	як президент	Nan
رئيساً	як президент	Nan
رئيسة	голова	Nan
رئيسيا	майор	Nan
رئيسياً	майор	Nan
رئيسية	майор	Nan
رئيسيين	майор	Nan
رئيسًا	президент	None
رائحة	запах	Nan
رائد	піонер	Nan
رائدة	ведучий	Nan
رائعة	чудовий	Nan
رابط	посилання	None
رؤيتها	побачити це	Nan
رابطة	асоціація	None
رؤية	зір	Nan
رؤوس	голови	None
ذوات	жінки	None
ذوي	з	None
ذي	зроблено	None
ذُكر	чоловік	None
رآه	бачив це	Nan
رأت	вона побачила	Nan
رأس	голова	Nan
رأسه	його голова	Nan
رأسها	її голова	Nan
رأسهم	їх голова	Nan
رأى	думка	None
رأي	думка	None
رأيت	я бачив	Nan
رأيه	банер	Nan
رؤساء	голови	None
رؤيا	зір	Nan
رابع	четвертий	None
راجع	побачити	None
راشد	рашид	Nan
رحل	пропав	Nan
رحلات	круїзи	Nan
رحلة	подорож	None
رحلته	його політ	Nan
ردود	відповіді	None
رسائل	повідомлення	None
رسالة	повідомлення	None
رسالته	його повідомлення	Nan
رستم	рустем	Nan
رسم	малювати	Nan
رسمها	намальовано	Nan
رسمي	офіційна	None
رسميا	офіційно	None
رسمياً	офіційно	None
رسميًا	офіційно	None
رجم	побито камінням	Nan
رجليها	її ноги	Nan
رجلاً	чоловік	None
رجلا	чоловік	None
رام	лучник	Nan
راية	банер	Nan
رب	аллах	Nan
ربط	посилання	None
ربع	чверть	None
ربما	ймовірно	None
ربه	господи	Nan
زلزال	землетрус	Nan
ربيع	весна	None
رتب	сортувати	Nan
رتبة	ранг	Nan
رجال	чоловіки	None
رجاله	його люди	Nan
رجب	регеп	Nan
رجع	повернувся	None
رجل	нога	Nan
ربيعة	рабіа	Nan
زمان	час	None
زمانه	його час	Nan
زمن	час	None
سعودية	саудівська	Nan
سعوديون	саудівці	Nan
سعى	подивився	Nan
سعيد	щасливі	Nan
سفر	подорожі	None
سفن	кораблі	None
سفيان	суфьян	Nan
سفينة	корабель	None
سقراط	сократ	None
سقط	впав	Nan
سقطت	впав	Nan
سقوط	відкиньте	Nan
سكان	населення	None
سكانديوم	скандія	Nan
سكانها	його населення	Nan
سعودي	саудівська	Nan
سكانية	населення	None
سعود	сауд	Nan
سعت	я шукав	Nan
سراح	випущено	Nan
سرطان	рак	Nan
سرعان	скоро	None
سرعة	швидкість	None
سرقة	крадіжка	Nan
سرو	кипарис	Nan
سري	секрет	Nan
سرية	секретність	Nan
سريع	швидкий	None
سريعة	швидкий	None
سريعًا	скоро	None
سطح	поверхня	None
سطحه	її поверхня	Nan
سطحها	її поверхня	Nan
سعاد	суад	Nan
سعر	ціна	None
سكة	залізничний	None
سكر	цукор	Nan
سكك	рейки	Nan
سلوك	поведінка	None
سليم	салім	Nan
سليمان	сулейман	Nan
سم	см	Nan
سمات	особливості	None
سماه	він назвав це	Nan
سمة	риса	None
سمح	дозволено	Nan
سمحت	дозволено	Nan
سمع	він почув	Nan
سمعت	я чув	Nan
سمك	риба	None
سمي	названий	None
سميت	її назвали	Nan
سمير	той самий	Nan
سلمية	спокійний	Nan
سلمة	салама	Nan
سلمان	салман	Nan
سلم	сходи	None
سكن	проживання	None
سلاح	зброя	None
سلاسل	ланцюги	Nan
سلاطين	султани	Nan
سلالات	штам	Nan
سلالة	напружувати	Nan
سلام	здравствуйте	Nan
سر	таємно	Nan
سلامة	безпека	Nan
سلسلة	серія	None
سلطات	влади	None
سلطان	султан	None
سلطة	салат	Nan
سلطنة	султанат	Nan
سلف	кредити	Nan
سلفوناميد	сульфонамід	Nan
سلبية	негативний	Nan
ذو	зроблено	None
سدة	вилка	Nan
سحب	виведення	None
زيدان	зідан	Nan
زين	заїн	Nan
زينب	зайнаб	Nan
س	с	None
سأل	запитали	Nan
سؤال	питання	None
سائر	інший	None
سائل	рідина	Nan
سابق	колишній	None
سابقا	раніше	None
سابقاً	раніше	None
سابقة	прецедент	Nan
سابقًا	раніше	None
ساحة	двір	None
ساحل	узбережжя	None
زيد	заїд	Nan
ساحلية	прибережні	Nan
زيت	олія	Nan
زيادة	плюс	None
زمني	мій час	Nan
زمنية	час	None
زنكي	цинк	Nan
زهرة	квітка	None
زواج	одруження	Nan
زواجه	його шлюб	Nan
زوال	смерть	None
زوج	чоловік	None
زوجات	дружини	None
زوجاته	його дружини	Nan
زوجة	дружина	None
زوجته	його дружина	Nan
زوجها	її чоловік	Nan
زوكربيرج	цукерберг	Nan
زياد	зіяд	Nan
زيارة	відвідати	Nan
سار	він ходив	Nan
ساراكينوس	сарацен	Nan
سارة	сара	Nan
سبعة	сім	None
سبعين	сімдесят	Nan
سبق	вже	None
سبقت	підбігайте	Nan
سبيس	мій простір	Nan
سبيل	шлях	None
ست	шість	None
ستالين	сталін	None
ستة	шість	None
ستكون	це буде	Nan
ستيرول	стерол	Nan
ستين	шістдесят	Nan
سجل	запишіть	Nan
سجن	тюрма	Nan
سحابة	хмара	Nan
سبع	сім	None
سبحانه	слава йому	Nan
سبتمبر	вересень	None
سببا	причина	None
ساعات	години	None
ساعة	година	Nan
ساعد	допомога	None
ساعدت	допомогли	Nan
سافر	подорож	None
سالم	салем	Nan
سامي	самі	None
سد	вилка	Nan
سامية	піднесений	Nan
سانت	св.	Nan
ساهم	внесли свій внесок	Nan
ساهمت	внесли свій внесок	Nan
سبأ	шиба	Nan
سباق	гонка	Nan
سباقات	гонки	Nan
سبب	причина	None
سان	сан	None
لتصل	досягти	None
ذهبية	золотий	None
ذلك	що	None
خاصا	спеціально	None
خاصة	особливо	None
خاصةً	особливо	None
خاصية	власність	None
خاض	билися	Nan
خاضعة	тема	None
خالد	безсмертний	Nan
خالص	чистий	None
خالية	порожній	Nan
خام	сирий	Nan
خان	хан	None
ختان	обрізання	Nan
خدمات	послуги	None
خدمة	сервіс	Nan
خديجة	хатис	Nan
خاص	спеціальний	None
خرائط	карти	None
خارجية	зовнішні	None
خادم	слуга	Nan
حياتها	її життя	Nan
حياتهم	їхні життя	Nan
حياتي	моє життя	Nan
حيان	хайян	Nan
حية	жваво	Nan
حيث	де	None
حيفا	хайфа	Nan
حين	коли	None
حينما	щоразу	Nan
حينها	тоді	None
حيوان	тварина	Nan
حيوانات	тварини	None
حيوانية	тварина	Nan
حيوية	живучість	Nan
خابية	кеш	Nan
خارجي	зовнішній	None
حياته	його життя	Nan
خراسان	хорасан	Nan
خرجت	вийшов	None
خطبة	мовлення	None
خطة	план	None
خطر	ризик	Nan
خطط	плани	None
خطف	викрадення дітей	Nan
خطوة	крок	None
خطورة	небезпека	Nan
خطوط	лінії	None
خطيرة	серйозний	Nan
خفض	масштабувати вниз	Nan
خفيف	світла	None
خفيفة	світло	None
خلاف	суперечка	Nan
خلافته	його спадкоємність	Nan
خلال	через	None
خطاب	виступ	None
خرج	вийшов	None
خطأ	помилка	Nan
خضعت	пройшли	None
خرجوا	вони вийшли	Nan
خروج	вхід	None
خريطة	мапа	None
خزيمة	поразка	None
خسائر	збитків	Nan
خسارة	втрата	None
خسر	загублений	Nan
خصائص	властивості	None
خصبة	родючі	Nan
خصوصا	особливо	None
خصوصاً	особливо	None
خصوصًا	особливо	None
خصومه	суперечка	Nan
خضراء	зелений	None
خضع	предмет	None
خط	лінія	None
حياة	життя	None
حي	сусідство	Nan
حولها	навколо	None
حكام	лінійки	Nan
حكايات	казки	None
حكاية	казка	None
حكم	правило	None
حكمة	мудрість	None
حكمت	вона правила	Nan
حكمه	мудрість	None
حكمها	її правило	Nan
حكمهم	їх правило	Nan
حكومات	уряди	None
حكومة	уряд	None
حكومي	урядові	None
حكومية	урядові	None
حكيم	мудрець	Nan
حلال	халяль	Nan
حقيقية	справжній	None
حلب	алеппо	Nan
حقيقي	справжній	None
حقول	поля	None
حضر	відвідав	None
حضور	присутність	Nan
حطين	хіттин	Nan
حظر	заборона	None
حفر	буріння	Nan
حفظ	зберегти	None
حفل	партія	None
حق	правильно	None
حقائق	факти	None
حقبة	ера	Nan
حقق	досягніть	Nan
حققت	досягнуто	Nan
حقل	поле	None
حقه	його право	Nan
حقوق	прав	None
حقيقة	факт	None
حلت	розформовано	Nan
حلف	присягай	Nan
حلقات	епізоди	Nan
حمير	віслюки	Nan
حنا	ганна	None
حنبعل	ганнібал	Nan
حنبل	ханбал	Nan
حنك	піднебіння	None
حنيفة	ганіфа	Nan
حنين	ностальгія	Nan
حواء	єва	Nan
حوادث	нещасні випадки	Nan
حوار	діалог	None
حوالي	навколо	None
حوذانية	лютик	Nan
حوض	таз	Nan
حول	про	None
حوله	навколо нього	Nan
حملته	його кампанія	Nan
حملت	завантажено	Nan
حملة	кампанія	None
حملات	кампанії	None
حلقة	каблучка	Nan
حلمي	моя мрія	Nan
حلول	рішення	None
حلويات	цукерки	Nan
حماة	протектори	Nan
حماد	хаммад	Nan
حماس	ентузіазм	Nan
خلاله	під час нього	Nan
حماية	захист	None
حمدان	хамдан	Nan
حمدي	хамді	Nan
حمراء	червоний	None
حمزة	хамза	Nan
حمص	нут	Nan
حمض	кислота	Nan
حمل	вагітність	Nan
حمد	він похвалив	Nan
خلالها	під час нього	Nan
خلايا	клітини	None
خلدون	халдун	Nan
دورات	курси	None
دوران	обертання	None
دوراً	роль	None
دورة	курс	None
دوره	курс	None
دورها	її роль	Nan
دوري	циклічний	Nan
دورية	патруль	Nan
دورًا	роль	None
دول	країни	None
دولار	доларів	None
دولة	країна	None
دولته	його країна	Nan
دولتهم	їхній стан	Nan
دولتين	дві держави	Nan
دورا	роль	None
دولي	міжнародні	None
دور	роль	None
دو	ду	Nan
دفن	поховання	None
دقائق	хвилин	Nan
دقة	точність	None
دقيق	борошно	Nan
دقيقة	точні	None
دلائل	докази	Nan
دلالة	вказівка	Nan
دلتا	дельта	None
دليل	посібник	None
دم	кров	None
دمج	злиття	None
دمرت	знищено	None
دمشق	дамаск	Nan
دمياط	даміетта	Nan
دنيا	донія	Nan
دوائر	кола	None
دولياً	на міжнародному рівні	Nan
دولية	міжнародний	None
دون	без	None
ذاته	те саме	Nan
ذاتها	сам	None
ذاتي	суб&#39;єктивно	Nan
ذاتية	резюме	Nan
ذاك	що	None
ذاكرة	пам&#39;ять	Nan
ذرات	атоми	None
ذروة	кульмінація	Nan
ذروتها	клімакс	Nan
ذرية	потомство	Nan
ذكر	чоловік	None
ذكره	згадав це	Nan
ذكرها	згадайте це	Nan
ذكرى	пам&#39;ять	Nan
ذكور	чоловік	None
ذات	пов&#39;язані	Nan
ذا	the	Nan
ديوان	діван	Nan
دينًا	релігія	None
دياب	діаб	Nan
ديانة	релігія	None
دير	монастир	None
ديزني	діснея	Nan
ديسمبر	груд	Nan
ديفنباخيا	девенпахія	Nan
ديفيد	девід	None
دفعت	оплачено	Nan
ديل	dell	Nan
دين	борг	Nan
دينار	динар	Nan
ديناصور	динозавр	Nan
دينه	його релігія	Nan
دينهم	їх релігія	Nan
ديني	релігійні	None
دينية	релігійні	None
ديمقراطية	демократії	None
ذهب	іди	Nan
دفعة	оплачено	Nan
دعى	він подзвонив	Nan
خوف	страх	None
خوفو	хуфу	Nan
خياطة	шиття	Nan
خيبر	хайбар	Nan
خير	добре	None
د	лікар	None
دا	s	Nan
داء	захворювання	None
دائرة	коло	None
دائرية	круговий	Nan
دائم	постійний	None
دائما	завжди	None
دائماً	завжди	None
دائمة	завжди	None
دائمًا	завжди	None
خوسيه	хосе	Nan
داخل	всередині	None
خوان	хуан	Nan
خمسة	п’ять	Nan
خلع	позбавлений	None
خلف	позаду	Nan
خلفاء	наступники	Nan
خلفه	за ним	Nan
خلفها	залишився	None
خلفية	тло	Nan
خلقه	його створення	Nan
خلل	дефект	Nan
خلنجية	хізер	Nan
خلية	клітина	None
خليج	затока	None
خليط	суміш	None
خليفة	наступник	None
خليل	халил	Nan
خمس	п’ять	Nan
خمسين	п’ятдесят	Nan
داخلي	внутрішній	None
داخلية	внутрішня	None
دار	дар: будинок	Nan
درس	урок	Nan
درع	щит	None
درهم	aed	Nan
دروس	підручники	None
درويش	дарвіш	Nan
دريد	дурайд	Nan
دستور	конституція	None
دستوري	конституційний	None
دستورية	конституційність	Nan
دعا	дзвінок	Nan
دعاء	молитва	Nan
دعت	вона подзвонила	Nan
دعم	підтримка	None
دعوة	дзвінок	Nan
دعوته	його дзвінок	Nan
درجة	ступінь	None
درجات	градуси	Nan
درب	шлях	None
دراما	драма	None
دارت	дартс	Nan
داروين	дарвін	Nan
دام	запізнюється	Nan
دامت	так довго, як	Nan
داود	девід	None
داوود	девід	None
دبلوماسية	дипломатія	Nan
دفع	платити	Nan
دبي	дубай	Nan
دخل	дохід	None
دخلت	я увійшов	Nan
دخول	вхід	None
دخوله	ввівши його	Nan
دراسات	дослідження	None
دراسته	вивчіть це	Nan
دراسية	вивчення	None
دجلة	тигр	None
لتطور	розробляти	Nan
لتطوير	розробляти	Nan
لتعداد	перерахувати	Nan
وتكون	і бути	Nan
وتكوين	і налаштувати	Nan
وتلك	і ті	Nan
وتم	і це було зроблено	Nan
وتمت	і це було зроблено	Nan
وتمتد	розтягування	Nan
وتمتلك	і володіє	Nan
وتمثل	і представляти	Nan
وتمكن	йому вдалося	Nan
وتنتج	це виробляє	Nan
وتنتشر	і поширити	Nan
وتنظيم	і регулювання	Nan
وتنقسم	поділений	Nan
وتهدف	мета	None
وتوجد	існує	None
وتقوم	і на основі	Nan
وتوزيع	і розподіл	Nan
وتقول	і вона каже	Nan
وتقدم	надається	None
وتطور	це розвивалося	Nan
وتطورت	і воно розвивалося	Nan
وتطوير	і розвиватися	Nan
وتظهر	і шоу	Nan
وتعالى	всемогутній	Nan
وتعتبر	розглядаються	None
وتعتمد	це залежить	Nan
وتعد	і готуйся	Nan
وتعرف	і ти знаєш	Nan
وتعزيز	і просування	Nan
وتعمل	це працює	Nan
وتعني	це означає	Nan
وتعود	і назад	Nan
وتعيين	і встановити	Nan
وتغطي	і покриття	Nan
وتقع	падіння	None
وتطبيق	і застосування	Nan
وتوفي	він помер	Nan
وتونس	і туніс	Nan
وجعلها	і зробити це	Nan
وجل	піднесений	Nan
وجمع	і збирати	Nan
وجمهورية	і республіка	Nan
وجميع	і все	Nan
وجنوب	і південь	Nan
وجه	обличчя	None
وجهات	пункти призначення	Nan
وجهة	місце призначення	Nan
وجهه	його обличчя	Nan
وجهها	її обличчя	Nan
وجوب	обов’язково	Nan
وجود	присутність	Nan
وجوده	його присутність	Nan
وجودها	його наявність	Nan
وجعل	і зробити	Nan
وتولى	він взяв	Nan
وجزيرة	і острів	Nan
وجدير	варто	None
وتيرة	темп	None
وثائق	документи	None
وثائقي	документальний фільм	Nan
وثاني	і друге	Nan
وثلاثة	і три	Nan
وثلاثون	тридцять	Nan
وثلاثين	тридцять	Nan
وثيقة	документ	None
وجاء	він прийшов	Nan
وجاءت	вона прийшла	Nan
وجامعة	і університет	Nan
وجبال	і гори	Nan
وجبل	і монтуйте	Nan
وجد	знаходиться	None
وجدت	знайдено	None
وجزر	і острови	Nan
وتضم	складається	None
وتصل	і вгору	Nan
وتصبح	і стати	Nan
وبريطانيا	і британія	Nan
وبسبب	і через	Nan
وبشكل	і певним чином	Nan
وبصفة	і певним чином	Nan
وبعد	і все ж	Nan
وبعدها	і потім	Nan
وبعض	і деякі	Nan
وبعضها	деякі є	Nan
وبعضهم	і деякі з них	Nan
وبقي	він залишився	Nan
وبقية	а решта	Nan
وبقيت	я залишався	Nan
وبلاد	і країна	Nan
وبلغ	і вдарити	Nan
وبلغاريا	і болгарія	Nan
وبذلك	цим	None
وبلغت	удар	Nan
وبدأت	це почалося	Nan
وبخاصة	особливо	None
وبأن	і це	Nan
وباء	епідемія	Nan
وباقي	а решта	Nan
وباكستان	і пакистан	Nan
وبالأخص	зокрема	None
وبالإضافة	в додаток	Nan
وبالتالي	і таким чином	Nan
وبالتحديد	і конкретно	Nan
وبالرغم	хоча	None
وبالفعل	і справді	Nan
وبالمثل	так само	Nan
وبالنسبة	і за	Nan
وبحر	і морем	Nan
وبحسب	згідно з	Nan
وبحلول	за	None
وبدأ	він почав	Nan
وبما	у тому числі	Nan
وبناء	і будувати	Nan
وبناءً	і конструктивно	Nan
وتحسين	і вдосконалюватися	Nan
وتحقيق	і досягти	Nan
وتحليل	і аналіз	Nan
وتحمل	і нести	Nan
وتختلف	і відрізняються	Nan
وتربية	і розведення	Nan
وترجمت	і переклали	Nan
وترك	і піти	Nan
وتركيا	і туреччина	Nan
وتستخدم	використовуються	None
وتسعين	дев&#39;яносто	Nan
وتسمى	називається	None
وتشكل	складати	None
وتشمل	включати	Nan
وتشير	і вкажіть	Nan
وتحديد	і фіксація	Nan
وتحدث	він говорив	Nan
وتحتوي	і містять	Nan
وتحتل	і зайняли	Nan
وبنى	він будував	Nan
وبه	і з ним	Nan
وبها	і з ним	Nan
وبهذا	з цим	Nan
وبين	і між	Nan
وبينما	і поки	Nan
وتأتي	і приходь	Nan
وجوه	об&#39;єкт	Nan
وتأسيس	і встановити	Nan
وتبادل	і обмін	Nan
وتبلغ	це сягає	Nan
وتتضمن	це включає	Nan
وتتكون	він складається	Nan
وتتم	і це робиться	Nan
وتتميز	її розрізняють	Nan
وتحت	і під	Nan
وتاريخ	і дата	Nan
واهتم	і подбайте	Nan
وجيزة	короткий виклад	Nan
وحتى	і навіть	Nan
وصل	прибути	Nan
وصلات	посилання	None
وصلت	досягнув	Nan
وصلوا	прибув	Nan
وصناعة	і промисловість	Nan
وصنع	і виготовлення	Nan
وصول	доступ	None
وصوله	прибуття	Nan
وصية	буде	None
وضرب	і вдарити	Nan
وضع	поставити	None
وضعت	розроблено	None
وضعف	слабкість	Nan
وضعها	покласти його вниз	Nan
وطرق	і способи	Nan
وصفه	рецепт	Nan
وطريق	і дорога	Nan
وصفاته	його атрибути	Nan
وصدر	і звільнили	Nan
وسرعان	і так далі	Nan
وسط	центр	None
وسقوط	і падіння	Nan
وسلم	його	None
وسميت	це називалося	Nan
وسوريا	і сирія	Nan
وسوق	і ринок	Nan
وشبه	і подобу	Nan
وشرح	і поясніть	Nan
وشرق	і схід	Nan
وشركة	і компанія	Nan
وشمال	північ	None
وشهد	і побачив	Nan
وشهدت	і побачив	Nan
وصار	і це стало	Nan
وصف	опишіть	Nan
وسبب	і причина	Nan
وطريقة	і метод	Nan
وطن	батьківщина	None
وعرض	він представив	Nan
وعرف	він знав	Nan
وعرفت	я знав	Nan
وعشرون	двадцять	Nan
وعشرين	і двадцять	Nan
وعضو	і член	Nan
وعقد	і тримайте	Nan
وعلاوة	більше того	Nan
وعلم	і знаючи	Nan
وعلماء	і науковці	Nan
وعلوم	і наук	Nan
وعلى	і на	Nan
وعلي	і на	Nan
وعليه	і на ньому	Nan
وعمر	і омар	Nan
وعدم	і не бути	Nan
وطلب	запитав він	Nan
وعددها	і його кількість	Nan
وعد	обіцянка	Nan
وطني	національний	None
وطنية	патріотизм	Nan
وظائف	кар&#39;єра	Nan
وظل	і тримали	Nan
وظلت	вона залишилася	Nan
وظهر	він з’явився	Nan
وظهرت	це з’явилося	Nan
وظهور	і зовнішній вигляд	Nan
وظيفة	робота	None
وعاد	він повернувся	Nan
وعادة	і зазвичай	Nan
وعاش	він жив	Nan
وعاصمتها	і його капітал	Nan
وعبد	і раб	Nan
وعبر	і поперек	Nan
وعدد	і ряд	Nan
وسام	віссам	Nan
وساعد	це допомогло	Nan
وسائل	засоби	None
وحيدة	поодинці	Nan
وحين	і коли	Nan
وخاصة	особливо	None
وخاصةً	особливо	None
وخرج	він вийшов	Nan
وخصوصا	особливо	None
وخصوصاً	особливо	None
وخصوصًا	особливо	None
وخلال	і наскрізь	Nan
وخلفه	і за ним	Nan
وخلق	і творити	Nan
وخمسين	і п’ятдесят	Nan
ودار	і будинок	Nan
ودخل	і увійшов	Nan
ودراسة	і вчитися	Nan
وحيد	неодружений	Nan
ودرجة	і ступінь	Nan
وحيث	і де	Nan
وحول	і про	Nan
وحدات	одиниці	None
وحدة	поодинці	Nan
وحده	поодинці	Nan
وحدها	поодинці	Nan
وحركة	і рух	Nan
وحرية	і свобода	Nan
وحسب	і просто	Nan
وحسن	і добре	Nan
وحصل	і він отримав	Nan
وحضر	і відвідували	Nan
وحفظ	і економити	Nan
وحقوق	і права	Nan
وحكم	і судження	Nan
وحماية	і захищати	Nan
وحمل	і скачайте	Nan
وحي	натхнення	Nan
ودرس	він вивчав	Nan
ودعا	називається	None
ودعت	вона подзвонила	Nan
ورغم	хоча	None
ورفض	він відмовився	Nan
ورفع	і піднімати	Nan
ورق	папір	None
ورقة	аркуш	Nan
وروسيا	і росія	Nan
وزاد	і збільшився	Nan
وزارة	міністерство	None
وزراء	міністрів	None
وزن	вага	None
وزوجته	і його дружина	Nan
وزيادة	і більше	Nan
وزيت	і масло	Nan
وزير	міністр	None
وسائر	і всі інші	Nan
وردت	отримано	Nan
وردة	троянда	Nan
ورد	квітка	None
ورجال	і чоловіки	Nan
ودعم	і підтримка	Nan
ودفن	і поховали	Nan
ودمشق	і дамаск	Nan
ودور	і роль	Nan
ودول	і країни	Nan
ودولة	і країна	Nan
ودون	і без	Nan
وحاول	і спробуйте	Nan
وذكر	він згадав	Nan
وذهب	і він пішов	Nan
ورأى	і побачив	Nan
ورئيس	і голова	Nan
وراء	позаду	Nan
وراثيا	генетично	None
وراح	і він пішов	Nan
وربما	а може бути	Nan
وذلك	і це	Nan
وانخفاض	і низький	Nan
وانتهى	це закінчено	Nan
وانتهت	і закінчився	Nan
والبعض	і деякі	Nan
والبنية	і структура	Nan
والبيئة	і довкілля	Nan
والتاريخ	і історія	Nan
والتجارة	і торгувати	Nan
والتحليل	і аналіз	Nan
والتخلص	і позбутися	Nan
والتدريب	і тренування	Nan
والتطور	і еволюція	Nan
والتطوير	і розвиток	Nan
والتعاون	і співпраця	Nan
والتعليم	і освіта	Nan
والتقاليد	і традиції	Nan
والتكنولوجيا	і технології	Nan
والتلفزيون	і телевізор	Nan
والبحرين	і бахрейн	Nan
والتنمية	і розвиток	Nan
والبحرية	морська	None
والباحثين	і дослідники	Nan
والإسلام	і іслам	Nan
والإسلامية	і ісламська	Nan
والإعلام	і змі	Nan
والإمارات	і емірати	Nan
والإمام	і імам	Nan
والإمبراطورية	і імперія	Nan
والإنسان	і людські	Nan
والإيمان	і віра	Nan
والاتحاد	і союз	Nan
والاتصالات	і спілкування	Nan
والاجتماعي	і соціальні	Nan
والاجتماعية	і соціальні	Nan
والاقتصاد	і економіка	Nan
والاقتصادي	і економний	Nan
والاقتصادية	і економічні	Nan
والبحر	і море	Nan
والإدارة	і управління	Nan
والتوزيع	і розподіл	Nan
والثالث	і третє	Nan
والحرية	і свобода	Nan
والحزب	і вечірка	Nan
والحسن	і добре	Nan
والحسين	і хусейна	Nan
والحضارة	і цивілізація	Nan
والحفاظ	і тримай	Nan
والحكم	і судження	Nan
والحكومات	і уряди	Nan
والحكومة	і уряд	Nan
والحياة	і життя	Nan
والحيوانات	і тварини	Nan
والخارجية	і зовнішні	Nan
والخاصة	і особливі	Nan
والخدمات	і послуги	Nan
والد	батько	None
والحروب	і війни	Nan
والتي	і це	Nan
والحركة	і рух	Nan
والحديد	і залізо	Nan
والثاني	і друге	Nan
والثانية	і друге	Nan
والثقافة	і культура	Nan
والجامعات	і університети	Nan
والجدير	і варто	Nan
والجزء	і частина	Nan
والجزائر	і алжир	Nan
والجزر	і острови	Nan
والجماعة	і група	Nan
والجمال	і краса	Nan
والجنوب	і південь	Nan
والجنوبية	і південний	Nan
والجيش	і армія	Nan
والحجاز	і хіджаз	Nan
والحديث	і говорити	Nan
والحرب	і війна	Nan
والأنهار	і річки	Nan
والأنصار	і прихильники	Nan
والأميرة	і принцеса	Nan
وإنشاء	і творити	Nan
وإنما	але радше	Nan
وإيران	і іран	Nan
وإيطاليا	і італія	Nan
وائل	ваель	Nan
وابن	і син	Nan
وابنه	і його син	Nan
واجب	мито	Nan
واجه	обличчя	None
واجهة	інтерфейс	None
واجهت	зіткнувся	Nan
واحد	один	None
واحدا	один	None
واحداً	один	None
واحدة	один	None
وإنتاج	і виробництво	Nan
واحدًا	один	None
وإن	і точно	Nan
وإلا	інакше	None
وأهمها	найважливіший	Nan
وأوائل	і рано	Nan
وأوروبا	і європа	Nan
وأول	і перше	Nan
وأي	і будь-який	Nan
وأيضا	і також	Nan
وأيضاً	і також	Nan
وأيضًا	і також	Nan
وإدارة	і управління	Nan
وإذا	якщо	None
وإسبانيا	і іспанія	Nan
وإسرائيل	і ізраїль	Nan
وإعادة	і знову	Nan
وإعلان	і оголошення	Nan
وإقامة	і встановити	Nan
وإلى	і до	Nan
وادي	долина	None
وارتفاع	і високий	Nan
واستخدام	і використовувати	Nan
والآلات	і машини	Nan
والأحزاب	і вечірки	Nan
والأخرى	і інший	Nan
والأخلاق	і мораль	Nan
والأدب	і література	Nan
والأراضي	і землі	Nan
والأردن	і йордан	Nan
والأرض	і земля	Nan
والأطفال	і діти	Nan
والأعمال	і бізнес	Nan
والأفكار	і ідеї	Nan
والأكثر	і більше	Nan
والأمراء	і князі	Nan
والأمن	і безпека	Nan
والأمير	і князь	Nan
والآداب	і манери	Nan
والآخر	а інший	Nan
والآثار	і ефекти	Nan
واقعة	інцидент	Nan
واستخدم	і використовувати	Nan
واستطاعت	і їй вдалося	Nan
واستمر	і продовжували	Nan
واستمرت	і продовжували	Nan
واسع	широкий	None
واسعة	широкий	None
واسم	і назва	Nan
والدة	мати	None
واسمه	і його ім&#39;я	Nan
واصل	так тримати	Nan
واضح	ясно	None
واضحة	ясно	None
واعتبر	було розглянуто	Nan
وافق	він погодився	Nan
وافقت	затверджено	None
واقع	реальність	None
واشنطن	вашингтон	Nan
والدته	його мама	Nan
والدراسات	і навчання	Nan
والدفاع	і оборона	Nan
والماء	і вода	Nan
والمحيط	і океан	Nan
والمدارس	і школи	Nan
والمدن	і міста	Nan
والمدينة	і місто	Nan
والمرأة	і жінка	Nan
والمسجد	і мечеть	Nan
والمسيحية	і християнство	Nan
والمسيحيين	і християни	Nan
والمعادن	і мінерали	Nan
والمعاهد	і інститути	Nan
والمعدات	і обладнання	Nan
والمعراج	і міраж	Nan
والمعرفة	і знання	Nan
والمعروف	відомий	None
والمؤسسات	і установи	Nan
والمعروفة	відомий	None
والله	клянусь	Nan
واللغات	і мови	Nan
والفيزياء	і фізика	Nan
والقانون	і закон	Nan
والقدرة	і вміння	Nan
والقرآن	і коран	Nan
والقضاء	і усунення	Nan
والقمر	і місяць	Nan
والقوات	і сили	Nan
والقوانين	і закони	Nan
والقوة	і сила	Nan
والكتاب	і книга	Nan
والكتابة	і пишіть	Nan
والكثير	і набагато більше	Nan
والكنيسة	і церква	Nan
والكواكب	і планети	Nan
والكيمياء	і хімія	Nan
واللغة	і мова	Nan
والمغرب	і марокко	Nan
والمكسيك	і мексика	Nan
والملك	і король	Nan
والهند	індія	Nan
والهندسة	і інженерія	Nan
والواقع	справді	None
والولايات	і держави	Nan
والي	валі	Nan
واليابان	і японія	Nan
واليمن	і ємен	Nan
واليهود	і євреї	Nan
واليهودية	і іудаїзм	Nan
واليوم	і сьогодні	Nan
واليونان	греція	None
وان	і точно	Nan
وانتشار	і поширити	Nan
وانتشر	він поширився	Nan
وانتشرت	і розкласти	Nan
والهرسك	і герцеговина	Nan
والنهاية	і, нарешті	Nan
والنمسا	і австрія	Nan
والنقل	і транспорт	Nan
والمملكة	і царство	Nan
والمناخ	і клімат	Nan
والمناطق	і регіони	Nan
والمنتجات	і продукти	Nan
والمنطق	і логіка	Nan
والمنطقة	і регіон	Nan
والمواد	і матеріали	Nan
والفنون	і мистецтва	Nan
والمواصلات	перевезення	None
والمياه	і вода	Nan
والنباتات	і рослини	Nan
والنجوم	і зорі	Nan
والنرويج	норвегія	None
والنساء	і жінки	Nan
والنسيج	і тканина	Nan
والنقد	і критика	Nan
والموسيقى	і музика	Nan
وعن	і про	Nan
والفن	і мистецтво	Nan
والفلسفة	і філософія	Nan
والسبب	і причина	Nan
والسعودية	і саудівська аравія	Nan
والسلام	і мир	Nan
والسنة	і рік	Nan
والسودان	і судан	Nan
والسويد	швеція	None
والسياسة	і політика	Nan
والسياسي	і політик	Nan
والسياسية	і політичні	Nan
والسيطرة	і контроль	Nan
والشام	і левант	Nan
والشرق	і схід	Nan
والشركات	і компанії	Nan
والشعر	і волосся	Nan
والشمال	і північ	Nan
والسادس	і шостий	Nan
والشيخ	і шейх	Nan
والزهرة	і квітка	Nan
والزبير	і зубаїр	Nan
والدليل	доказ	Nan
والده	мати	None
والدها	її тато	Nan
والدول	і держави	Nan
والدولة	і держава	Nan
والدين	батьків	None
والدينية	релігійні	None
والذي	а хто	Nan
والذين	а хто	Nan
والرئيس	і президент	Nan
والرابع	і четвертий	Nan
والرومان	і римляни	Nan
والرومانية	і румунською	Nan
والرياح	і вітер	Nan
والرياضيات	і математика	Nan
والزراعة	і сільське господарство	Nan
والشيعة	шиїти	Nan
والصفات	і атрибути	Nan
والصلاة	і молитва	Nan
والعلوم	і наука	Nan
والعمارة	і архітектура	Nan
والعمل	і працювати	Nan
والعمليات	і операції	Nan
والعناية	і подбайте	Nan
والغابات	і ліси	Nan
والغاز	і газ	Nan
والغرب	і захід	Nan
والغربية	західний	None
والغناء	і спів	Nan
والفارسية	і перська	Nan
والفرات	євфрат	Nan
والفرنسية	і французькою	Nan
والفضة	і срібло	Nan
والفقه	правознавство	Nan
والعلمية	і науковий	Nan
والعلماء	і вчені	Nan
والعلم	і наука	Nan
والعلاقات	і стосунки	Nan
والصناعات	і галузі	Nan
والصناعة	і промисловість	Nan
والصين	і китай	Nan
والطاقة	і енергія	Nan
والطب	і медицина	Nan
والطيور	і птахи	Nan
والعالم	і світ	Nan
والفلك	і астрономія	Nan
والعديد	і багато іншого	Nan
والعرب	і араби	Nan
والعربية	і арабською	Nan
والعسكرية	і військові	Nan
والعشرون	двадцять	Nan
والعشرين	двадцять	Nan
والعطلات	і свята	Nan
والعلاج	і лікування	Nan
والعراق	і ірак	Nan
وعند	і в	Nan
وعندها	і потім	Nan
وعين	він призначив	Nan
يستخدمون	вони використовують	Nan
يستطع	можна	None
يستطيع	можна	None
يستعمل	б / в	Nan
يستقبل	отримати	None
يستمر	продовжуйте	Nan
يسجل	зареєструйтесь	Nan
يسعى	шукає	Nan
يسكن	наживо	Nan
يسمح	дозволити	Nan
يسمى	це називається	Nan
يسميه	він дзвонить	Nan
يسهل	полегшує	Nan
يسود	царювання верховне	Nan
يسوع	ісус	None
يستخدمها	використовує його	Nan
يسيطر	управління	None
يستخدم	використання	None
يسبب	це викликає	Nan
يركز	концентрат	Nan
يرمز	символізує	None
يرون	вони бачать	Nan
يروى	розповідає	None
يروي	розповідає	None
يرى	бути побаченим	Nan
يريد	хоче	None
يريفان	єреван	Nan
يزال	все-таки	Nan
يزداد	зростає	None
يزيد	збільшується	None
يسار	зліва	None
يساعد	довідка	Nan
يساهم	сприяти	Nan
يساوي	рівний	Nan
يسبق	передує	Nan
يرفع	підйомники	Nan
يشار	посилаються	Nan
يشبه	виглядає наче	Nan
يصيب	це впливає	Nan
يضاف	додано	Nan
يضع	ставить	None
يضم	будинок	None
يضمن	гарантія	Nan
يطلب	запити	Nan
يطلق	запуск	Nan
يظل	залишки	None
يظهر	з&#39;являється	Nan
يعادل	еквівалент	Nan
يعانون	страждати	Nan
يعاني	страждає	Nan
يعبر	пропуск	Nan
يعتبر	розглянуто	Nan
يعتبره	вважав це	Nan
يصنع	зробіть	Nan
يشارك	залучений	Nan
يصلي	він молиться	Nan
يصف	опишіть	Nan
يشتمل	включає	None
يشتهر	відомий за	Nan
يشرب	він п&#39;є	Nan
يشرف	почесний	None
يشعر	відчуваю	Nan
يشغل	біжить	Nan
يشكل	пози	Nan
يشكلون	складати	None
يشمل	включає	None
يشهد	свідок	Nan
يشير	вказує	None
يصبح	стань	Nan
يصح	правильно	None
يصدر	виданий	None
يصعب	складно	Nan
يصل	досягай	Nan
يرفض	він відмовляється	Nan
يرغب	побажання	Nan
يرسل	надсилає	Nan
يحتاج	потреба	None
يحتفظ	тримає	None
يحتفل	святкуйте	Nan
يحتل	заняття	None
يحتمل	можливо	None
يحتوي	містять	None
يحد	обмеження	None
يحدث	статися чи відбутися	Nan
يحدد	визначає	None
يحدها	обмежений	None
يحصل	отримує	None
يحضر	принесіть	Nan
يحق	має право на	Nan
يحقق	досягніть	Nan
يحكم	судили	Nan
يحب	любить	None
يحل	вирішити	None
يحاول	спробуйте	Nan
يجمع	збирання	None
يتواجد	існує	None
يتوقع	очікуйте	Nan
يتوقف	це зупиняється	Nan
يتولى	взяти на себе	Nan
يتيح	давайте	Nan
يثبت	доведіть	Nan
يثرب	ятріб	Nan
يجب	потрібно	None
يجتمع	зустрічається	None
يجد	знайдіть	Nan
يجري	буття	None
يجعل	робить	None
يجعله	робить це	Nan
يجعلها	робить це	Nan
يجلس	сидячи	Nan
يجوز	допустимо	Nan
يحمل	нести	Nan
يحملون	вони несуть	Nan
يحمي	захищати	None
يده	його рука	Nan
يدور	закрутки	Nan
يدي	моя рука	Nan
يدير	управляє	Nan
يديه	його руки	Nan
يذكر	згадується	None
يذهب	він йде	Nan
يرابيع	подавайте	Nan
يراه	він це бачить	Nan
يراها	він це бачить	Nan
يربط	прикласти	Nan
يرتبط	асоційований	Nan
يرتفع	піднімається	Nan
يرجع	належне	Nan
يرد	відповідь	None
يدل	позначає	None
يدفع	платити	Nan
يدعي	- стверджує він	Nan
يدعى	- стверджує він	Nan
يحوي	містить	None
يحيط	оточує	Nan
يحيى	яхіа	Nan
يختار	виберіть	Nan
يختلف	відмінності	None
يخدم	подавайте	Nan
يخرج	вийшов	None
يعتبرون	вони вважають	Nan
يخص	з повагою	Nan
يد	рукою	Nan
يدخل	входить	None
يدرس	викладання	None
يدرك	усвідомити	Nan
يدعم	підтримує	None
يدعو	дзвінок	Nan
يدعون	вони заявляють	Nan
يخضع	тема	None
يعترف	признається	Nan
يعتقد	вважає	None
يعتقدون	вони думають	Nan
ينتمون	належать	None
ينتمي	належить	None
ينتهي	закінчити	Nan
ينجب	народити	Nan
ينجح	досягати успіху	Nan
ينزل	рухається вниз	Nan
ينسب	віднесено	Nan
ينشأ	виникає	None
ينص	штати	None
ينطبق	застосовує	Nan
ينظر	погляд	None
ينظم	організуйте	Nan
ينقسم	поділений	Nan
ينقل	передати	None
ينكر	заперечує	None
ينتقل	рухатися	Nan
يهتم	дбає про	Nan
ينتشر	поширене	Nan
ينتج	виробляти	Nan
يمثل	представляти	Nan
يمثلون	вони діють	Nan
يمكن	можна	None
يمكننا	ми можемо	Nan
يمكنه	він може	Nan
يمكنها	це може	Nan
يملك	володіє	None
يمنع	запобігає	Nan
يموت	вмирає	Nan
يميز	розрізняє	Nan
يميل	тенденція	None
يمين	правильно	None
ينادي	дзвінок	Nan
ينبع	стебла	Nan
ينبغي	повинен	None
ينتخب	бути обраним	Nan
يهدف	прагнемо	Nan
يهود	єврейський	Nan
يهودي	єврейський	Nan
يومًا	днів	None
يونانية	грецька	None
يونايتد	об&#39;єднані	Nan
يونيو	червень	None
يوهان	йохан	Nan
يَملك	володіє	None
يُحتمل	можливо	None
يُسمى	це називається	Nan
يُشكل	формується	None
يُطلق	запуск	Nan
يُظهر	з&#39;являється	Nan
يُعتقد	вважає	None
يُعد	підготуватися	Nan
يُعرف	відомий	None
يُقال	це сказано	Nan
يوميا	щодня	None
يومنا	наш день	Nan
يوماً	одного дня	Nan
يوما	днів	None
يهودية	єврейський	Nan
يهوذا	іуда	Nan
يو	йо	Nan
يواجه	обличчя	None
يوان	юань	Nan
يوتيوب	youtube	Nan
يوجد	існують	None
يمتلك	володіє	None
يوحنا	джон	None
يوسف	юсуф	Nan
يوضح	показує	None
يوفر	забезпечує	None
يولد	народжується	Nan
يوليو	липень	None
يوم	день	None
يومئذ	той день	Nan
يوروبيوم	європанія	Nan
يتناول	має справу з	Nan
يمتد	проміжки	Nan
يمارس	практика	None
يغطي	обкладинки	Nan
يغلب	бити	Nan
يغير	зміна	None
يفتح	відкривається	None
يفترض	нібито	None
يفرض	нав&#39;язує	Nan
يفسر	пояснює	None
يفصل	розділяється	Nan
يفضل	кращі	None
يفعل	зробіть	Nan
يفقد	втрачати	Nan
يفكر	подумайте	Nan
يفهم	зрозумів	Nan
يفوز	перемагає	Nan
يفوق	перевищує	None
يعين	позначення	None
يفيد	вигода	Nan
يعيشون	вони живуть	Nan
يعيد	повторіть	Nan
يعتمد	залежить	None
يعد	підготуватися	Nan
يعرض	показує	None
يعرف	відомий	None
يعرفه	пізнай його	Nan
يعرفون	вони знають	Nan
يعطي	дайте	Nan
يعقوب	якуб	Nan
يعكس	роздуми	Nan
يعلم	знай	Nan
يعلن	оголосити	Nan
يعمل	працює	None
يعملون	робочий	Nan
يعني	засоби	None
يعود	повертається	None
يعيش	наживо	Nan
يقارب	прибл	Nan
يقال	це сказано	Nan
يقام	відбувається, має місце, проходить	Nan
يقيم	живе	None
يكاد	близько	None
يكتب	пише	None
يكثر	багато	None
يكفي	достатньо	None
يكن	не бути	Nan
يكون	в даний час	Nan
يكونوا	вони є	Nan
يكونون	вони є	Nan
يلاحظ	повідомлення	None
يلتقي	знайомтесь	Nan
يلزم	потрібні	None
يلعب	грати	None
يلقى	поставити	None
يلي	слідкує	Nan
يقومون	вони роблять	Nan
يقوم	вставай	Nan
يقولون	вони кажуть	Nan
يقول	каже	None
يقبل	приймає	None
يقتصر	обмежений	None
يقتل	вбиває	Nan
يقدر	цінувати	Nan
يقدم	забезпечує	None
يقرأ	читає	Nan
يقرب	прибл	Nan
يمارسون	вони практикують	Nan
يقسم	присягає	Nan
يقضي	витрачає	Nan
يقع	розташований	None
يقف	встає	Nan
يقل	зменшується	None
يقلل	зменшення	None
يقم	зліва	None
يقود	водіння	Nan
يقصد	засоби	None
وأهم	і найголовніше	Nan
يتميز	показуючи	Nan
يتمتعون	насолоджуйтесь	Nan
ولعلّ	можливо,	Nan
ولغة	і мова	Nan
ولقب	і назва	Nan
ولقد	і я маю	Nan
ولكل	і для кожного	Nan
ولكنه	але це	Nan
ولكنها	але це	Nan
ولكنهم	але вони є	Nan
ولكي	і за	Nan
ولم	і не став	Nan
ولما	і чому	Nan
ولمّا	чому?	Nan
وله	і для нього	Nan
ولها	і її	Nan
ولهذا	для цього	Nan
ولعل	можливо,	Nan
ولو	навіть	None
ولذلك	тому	None
ولديه	і має	Nan
وكيف	і як	Nan
ولأن	і тому	Nan
ولا	ні	None
ولاة	губернаторів	Nan
ولادة	народження	None
ولادته	його народження	Nan
ولاسيما	особливо	None
ولايات	штати	None
ولاية	держава	None
ولايته	його мандат	Nan
ولبنان	і ліван	Nan
ولد	хлопчик	Nan
ولدت	я народився	Nan
ولده	його син	Nan
ولدى	і я маю	Nan
ولذا	тому	None
وكوريا	і корея	Nan
ولي	опікун	Nan
وليبيا	і лівія	Nan
ومسلم	і мусульманський	Nan
ومصر	і єгипет	Nan
ومع	і з	Nan
ومعرفة	і дізнайтеся	Nan
ومعظم	і більшість	Nan
ومعناها	і його значення	Nan
ومعه	і з ним	Nan
ومكان	місце	None
ومما	і з чого	Nan
ومملكة	і королівство	Nan
ومن	і від	Nan
ومناطق	і регіони	Nan
ومنذ	і відтоді	Nan
ومنطقة	і область	Nan
ومنظمة	і організація	Nan
ومسجد	і мечеть	Nan
وليام	вільям	None
ومركز	і центр	Nan
ومراجع	і посилання	Nan
وليد	waleed	Nan
وليس	це не	Nan
وليست	ні	None
وليلة	і однієї ночі	Nan
وليم	вільям	None
وما	жестикулювати	Nan
وماض	минуле	None
ومثل	і як	Nan
ومجلس	і дошка	Nan
ومجموعة	і група	Nan
ومحاولة	і спробуйте	Nan
ومحمد	і мухаммед	Nan
ومدرسة	і школа	Nan
ومدى	і як далеко	Nan
ومدينة	і місто	Nan
ومراكز	і центри	Nan
وكنيسة	і церква	Nan
وكندا	і канада	Nan
وكما	і як	Nan
وفقًا	відповідно	None
وفلسطين	і палестина	Nan
وفنلندا	фінляндія	None
وفى	виконав	None
وفي	і в	Nan
وفيما	з	None
وفيه	і в ньому	Nan
وفيها	і в ньому	Nan
وقائع	факти	None
وقاد	і вела	Nan
وقال	і сказав він	Nan
وقالت	і вона сказала	Nan
وقالوا	і вони сказали	Nan
وقام	він піднявся	Nan
وقامت	вона зробила	Nan
وفقاً	відповідно	None
وقاموا	і вони встали	Nan
وفقا	відповідно	None
وفرنسا	і франція	Nan
وغالبا	і часто	Nan
وغالباً	і часто	Nan
وغالبًا	і часто	Nan
وغرب	і захід	Nan
وغير	і більше	Nan
وغيره	і більше	Nan
وغيرها	і інші	Nan
وغيرهم	і інші	Nan
وفاة	смерть	None
وفاته	він помер	Nan
وفاتها	вона померла	Nan
وفتح	і відкрити	Nan
وفد	делегація	Nan
وفر	зберегти	None
وفرة	достаток	Nan
وفق	згідно з	Nan
وقبل	і раніше	Nan
وقت	час	None
وقتل	був убитий	Nan
وكان	і це було	Nan
وكانت	і вона була	Nan
وكانوا	і вони були	Nan
وكتاب	і книга	Nan
وكتب	він написав	Nan
وكثير	і багато	Nan
وكثيرا	і дуже багато	Nan
وكذا	і такі	Nan
وكذلك	і також	Nan
وكرة	м&#39;яч	Nan
وكل	і все	Nan
وكلاهما	обидва є	Nan
وكلما	і коли завгодно	Nan
وكلمة	і слово	Nan
وكلها	і всі вони	Nan
وكالة	агентство	None
وكالات	агентства	Nan
وكأنه	подібно до	Nan
وقيل	було сказано	Nan
وقته	його час	Nan
وقتها	настав час	Nan
وقد	був	None
وقدم	він дав	Nan
وقرر	і вирішили	Nan
وقصر	палац	None
وقطاع	і смуга	Nan
ومنع	і блокувати	Nan
وقطر	і катар	Nan
وقع	підписав	None
وقعت	виникло	None
وقف	встав	Nan
وقلة	і мало	Nan
وقوة	і сила	Nan
وقود	пальне	Nan
وقوع	виникнення	None
وقطع	і вирізати	Nan
ومنه	і від цього	Nan
ومنها	як от	Nan
ومنهم	і від них	Nan
ويوجد	і є	Nan
ويوسف	і йосип	Nan
وَلاَ	ні	None
وُلد	хлопчик	Nan
يأتي	приходь	Nan
يأخذ	бере	None
يأكل	їсти	Nan
يأمر	замовлення	None
يؤثر	вплив	None
يؤخذ	приймати	None
يؤدى	вести	None
يؤدي	вести	None
يؤكد	підтверджує	Nan
يؤمن	повірте	Nan
يؤمنون	вірити у	Nan
وينقسم	він розділений	Nan
يا	ой	None
ويندوز	windows	Nan
ويمكن	і це може	Nan
ويعني	це означає	Nan
ويعود	і назад	Nan
ويعيش	і жити	Nan
ويقال	сказано	None
ويقدر	оцінюється	None
ويقدم	це забезпечує	Nan
ويقع	і падає	Nan
ويقول	і скажи	Nan
ويقوم	він заснований	Nan
ويكون	і бути	Nan
ويكي	wiki	Nan
ويكيبيديا	вікіпедія	None
ويلز	колодязі	Nan
ويليام	вільям	None
ويمثل	він являє собою	Nan
وينتج	це виробляє	Nan
ياسر	яссер	Nan
ياسين	яссен	Nan
يبحث	шукати	None
يترك	залишати	Nan
يتسبب	причина	None
يتصل	спілкуватися	Nan
يتضح	ілюстрований	Nan
يتضمن	це включає	Nan
يتطلب	вимагає	None
يتعرض	викритий	Nan
يتعلق	з повагою	Nan
يتغير	змінюється	None
يتفق	погодьтеся	Nan
يتكلم	висловлюватися	Nan
يتكون	складається з	Nan
يتلقى	отримувати	None
يتم	повна	None
يتمتع	насолоджуйтесь	Nan
يترتب	це слідує	Nan
يتراوح	діапазони	Nan
يتخذ	приймати	None
يتحول	виявляється	None
يبدأ	почав	None
يبدو	звук	None
يبعد	у гостях	Nan
يبق	залишки	None
يبقى	залишки	None
يبلغ	звіт	Nan
يبين	показати	None
ويعمل	і це працює	Nan
يتأثر	постраждали	Nan
يتأهل	кваліфікуйте	Nan
يتبع	продовження	None
يتجاوز	перевищення	Nan
يتجه	заголовок	Nan
يتحدث	він розмовляє	Nan
يتحدثون	вони говорять	Nan
يتحرك	рухається	Nan
يتألف	складається	None
يتمكن	управління	None
ويعرف	він знає	Nan
ويعتمد	це залежить	Nan
وهناك	і там	Nan
وهو	і він	Nan
وهولندا	нідерланди	None
وهى	котрий	None
وهي	котрий	None
ووادي	і долина	Nan
ووجد	він знайшов	Nan
ووجدت	і знайшли	Nan
ووجود	і присутність	Nan
ووسائل	засоби	None
ووسط	і середній	Nan
ووصل	він прибув	Nan
ووصلت	і я приїхав	Nan
ووضع	і покласти	Nan
ووفقا	відповідно	None
وهنا	і ось тут	Nan
ووفقاً	відповідно	None
وهما	а їх два	Nan
وهكذا	і так далі	Nan
ونادي	і клуб	Nan
ونتيجة	як результат	Nan
ونشأته	і його виховання	Nan
ونشر	і публікувати	Nan
ونصف	півтора	Nan
ونظام	і система	Nan
ونظرا	дано	Nan
ونظرًا	і дивись	Nan
ونظم	і системи	Nan
ونقل	і рухатися	Nan
ونهر	і річка	Nan
وهؤلاء	і ці	Nan
وهبي	вехбе	Nan
وهذا	і це	Nan
وهذه	і це	Nan
وهم	і вони є	Nan
ووفقًا	відповідно	None
ويأتي	це приходить	Nan
ويؤدي	і веде	Nan
ويرى	він бачить	Nan
ويستخدم	він використовує	Nan
ويستطيع	і він може	Nan
ويسمى	це називається	Nan
ويشمل	це включає	Nan
ويشير	примітки	None
ويصبح	і це стає	Nan
ويصل	і вгору	Nan
ويضم	це включає	Nan
ويضيف	він додає	Nan
ويطلق	це називається	Nan
ويظهر	здається	None
ويعتبر	це вважається	Nan
ويعتقد	і вірили	Nan
ويعتقدون	і вони думають	Nan
ويروي	він розповідає	Nan
ويرجع	це повертається	Nan
ويذكر	він згадує	Nan
ويدخل	і входить	Nan
ويؤكد	він підтверджує	Nan
ويؤمن	і повірте	Nan
ويب	веб	Nan
ويبدو	здається	None
ويبقى	залишається	None
ويبلغ	це інформує	Nan
ويتحدث	він розмовляє	Nan
ويعد	і обіцянки	Nan
ويتراوح	це діапазон	Nan
ويتم	і це робиться	Nan
ويتميز	це особливості	Nan
ويجب	обов’язково	Nan
ويجوز	це допустимо	Nan
ويحتوي	це містить	Nan
ويحدث	і буває	Nan
ويختلف	він відрізняється	Nan
ويتكون	він складається	Nan
تسببت	викликано	Nan
وأهل	і люди	Nan
وأنها	і вона	Nan
مبكرة	рано	None
مبلغ	кількість	None
مبنى	будівництво	None
مبني	будівництво	None
مبنية	побудований	None
مبيعات	продажів	Nan
متابعة	продовжуйте	Nan
متاحة	в наявності	Nan
متتالية	послідовні	Nan
متحركة	рухомий	Nan
متحف	музей	None
متحقق	досягнуто	Nan
متخصصة	спеціалізовані	None
متر	метр	Nan
مترو	метро	None
مبكر	рано	None
متزايد	зростаючий	Nan
مبرهنة	теорема	None
مباشرة	безпосередньо	None
مالي	фінансові	None
مالية	фінанси	None
ماليزيا	малайзія	Nan
مان	людина	None
مانشستر	манчестер	Nan
مايكروسوفت	microsoft	Nan
مايكل	майкл	Nan
مايو	може	None
مبابان	мбабане	Nan
مبادئ	принципи	None
مبادرة	ініціатива	Nan
مباراة	матч	None
مبارك	благословення	Nan
مباريات	сірники	Nan
مباشر	прямий	None
مبدأ	принцип	None
مالك	власник	None
متزايدة	зростає	None
متساوية	рівний	Nan
مثلث	трикутник	None
مثلما	як	None
مثله	як він	Nan
مثلها	як вона	Nan
مثيرة	захоплююче	Nan
مثيل	екземпляр	Nan
مجاعة	голод	None
مجال	поле	None
مجالات	поля	None
مجالس	дошки	None
مجتمع	громада	None
مجتمعات	громади	None
مجددًا	знову	None
مجرة	галактика	Nan
مجرد	просто	None
مثلاً	наприклад	None
متزوج	одружений	Nan
مثلا	наприклад	None
مثال	приклад	None
متصلة	підключено	Nan
متطلبات	вимоги	None
متطورة	витончений	Nan
متعدد	кілька	None
متعددة	кілька	None
متفاوتة	різноманітні	None
متفرقة	розсипаний	Nan
متقدمة	передовий	Nan
متكررة	часті	None
متميزة	виразний	Nan
متنوعة	різне	Nan
متوسط	середній	None
متوسطة	середній	None
متوفرة	доступні	None
متى	коли	None
مثل	як от	Nan
مال	капітал	None
ماكسويل	максвелл	Nan
مافيا	мафія	None
ليبرالية	ліберальна	None
ليبيا	лівія	Nan
ليتم	повинно бути зроблено	Nan
ليتو	лето	None
ليزر	лазерний	Nan
ليس	ні	None
ليست	це не	Nan
ليسوا	вони не	Nan
ليصبح	ставати	Nan
ليصل	прибувати	Nan
ليكون	бути	None
ليلاً	ніч	None
ليلة	ніч	None
ليلى	лейла	Nan
لينكون	лінкольн	Nan
ليالي	ночі	None
لينين	ленін	None
لي	шахта	Nan
لونه	її колір	Nan
لواء	генерал-майор	Nan
لوثر	лютер	None
لوجود	існувати	None
لوح	планка	Nan
لوحات	тарілки	Nan
لوحة	живопис	None
لوزارة	до міністерства	Nan
لوس	лос	Nan
لوصف	описати	Nan
لوضع	покласти	Nan
لوقا	лука	Nan
لوقف	зупинитися	Nan
لولا	лула	Nan
لولاية	для держави	Nan
لون	колір	None
لويس	льюїс	Nan
ليون	ліон	Nan
ليوناردو	леонардо	None
مأهولة	населений	Nan
ماتت	вона померла	Nan
ماجد	маджід	Nan
مادة	матерія	None
مادية	матеріал	None
ماذا	що	None
مارتن	мартін	Nan
مارس	березень	None
مارك	позначити	Nan
ماركس	маркс	None
ماركوس	маркус	Nan
ماري	марі	Nan
ماريا	марія	None
مارينر	маринець	Nan
ماسنجر	месенджер	Nan
ماعدا	за винятком	Nan
مات	помер	None
مائية	аква	Nan
مائة	сто	None
ما	що	None
مؤتمر	конференція	None
مؤخرا	останнім часом	Nan
مؤخراً	останнім часом	Nan
مؤخرًا	останнім часом	Nan
مؤسس	засновник	None
مؤسسات	установи	None
مؤسسة	корпорація	Nan
مجرى	потік	None
مؤشر	індикатор	None
مؤكدة	підтверджено	Nan
مؤلف	автор	None
مؤلفات	автори	None
مؤلفاته	його твори	Nan
مئات	сприятливий	Nan
مئة	сто	None
مئوية	процент	Nan
مؤقتة	тимчасовий	None
لو	якщо	None
مجلة	журнал	None
مجمع	складний	None
مركبات	транспортні засоби	Nan
مركبة	транспортний засіб	Nan
مركز	центр	None
مركزا	центр	None
مركزاً	центр	None
مركزية	централізація	Nan
مركزًا	по центру	Nan
مرمرة	мармара	Nan
مروان	марван	Nan
مرور	прохід	Nan
مريم	маріам	Nan
مزارع	фермер	None
مزايا	переваги	None
مزيج	змішайте	Nan
مزيد	більше	None
مركب	композитний	Nan
مسألة	проблема	None
مرقس	позначити	Nan
مرض	захворювання	None
مراقبة	контроль	None
مراكز	центри	None
مراكش	марракеш	Nan
مربع	майдан	None
مرة	раз	None
مرت	пройшов	None
مرتبة	ранг	Nan
مرتبطة	пов&#39;язані	Nan
مرتفع	високий	None
مرتفعات	висоти	None
مرتفعة	високий	None
مرتين	двічі	None
مرحلة	етап	None
مرسوم	указ	None
مرصد	обсерваторія	Nan
مرضى	пацієнти	Nan
مراقب	бригадир	Nan
مسؤول	відповідальний	None
مسؤولية	відповідальність	None
مستقرة	стійкий	Nan
مستقل	незалежний	Nan
مستقلة	незалежний	Nan
مستمر	безперервне	Nan
مستمرة	триває	None
مستوطنة	поселення	None
مستوى	рівень	None
مستويات	рівні	None
مسجد	мечеть	Nan
مسح	опитування	None
مسرح	етап	None
مسرحية	гра	None
مسعود	масуд	Nan
مسقط	мускат	Nan
مسلسل	серія	None
مستقبل	майбутнє	None
مسؤولة	відповідальний	None
مستعمرة	колонія	Nan
مستشفى	лікарня	None
مساء	вечір	Nan
مسائل	випуски	Nan
مسابقات	змагання	None
مسابقة	конкуренція	None
مساجد	мечеті	Nan
مساحة	простір	None
مساحتها	його площа	Nan
مسار	шлях	None
مساعد	асистент	Nan
مساعدة	довідка	Nan
مسافة	відстань	None
مساندة	підтримка	None
مساهمة	вхідні дані	Nan
مستخدم	користувач	None
مستخدمي	користувачі	Nan
مستعمرات	колонії	Nan
مراعاة	поміркуйте	Nan
مراد	інтенд	Nan
مراحل	фаза	None
محدود	обмежений	None
محدودة	обмежений	None
محركات	двигуни	Nan
محرم	мухаррам	Nan
محط	станція	None
محطات	станції	None
محطة	станція	None
محفز	каталізатор	Nan
محفوظ	збережено	Nan
محل	магазин	Nan
محلول	рішення	None
محلي	підсолоджений	Nan
محلية	місцеві	None
محمد	мухаммед	Nan
محمدًا	мохамед а	Nan
محددة	конкретні	None
محمود	махмуд	Nan
محدد	специфічні	None
محاولة	спроба	None
مجمل	загалом	None
مجموع	сума	None
مجموعات	групи	None
مجموعتين	дві групи	Nan
مجهول	невідомо	None
مجهولة	невідомо	None
مجيء	наближається	Nan
محاسبة	бухгалтерський облік	Nan
محاطة	оточений	Nan
محافظات	провінції	None
محافظة	губернаторство	Nan
محاكاة	моделювання	None
محاكم	суди	None
محاكمة	випробування	None
محاولات	зусилля	None
محايدة	нейтральний	Nan
محمودية	махмудія	Nan
محمية	захищений	Nan
محو	стерти	Nan
مدنها	її міста	Nan
مدني	цивільний	Nan
مدنية	цивільний	Nan
مدونة	блог	Nan
مدى	безель	Nan
مدير	директор	None
مدينة	місто	None
مدينتي	моє місто	Nan
مذاهب	вчення	None
مذكرات	щоденник	None
مذكراته	його замітки	Nan
مر	над	None
مرات	часи	None
مراجع	список літератури	Nan
مراجعة	огляд	None
مدن	міста	None
مدعوم	підтримується	Nan
مدريد	мадрид	Nan
مدرسة	школа	None
محور	вісь	Nan
محيط	океан	None
مخاطر	ризики	Nan
مخالفة	інфраструктура	None
مخاوف	страхи	Nan
مختلف	інший	None
مختلفة	інший	None
مجلس	дошки	None
مختلفين	дві різні	Nan
مخطط	заплановано	Nan
مخطوطة	рукопис	Nan
مخيم	табір	None
مدارات	орбіти	Nan
مدارس	школи	None
مدة	тривалість	None
مدخل	вихід	None
مخصصة	відданий	Nan
لهما	для них	Nan
لهم	для них	Nan
لهذه	для цього	Nan
لقاح	вакцина	Nan
لقب	назва	None
لقبه	його прізвисько	Nan
لقتال	боротися	Nan
لقد	lhave	Nan
لقوات	до сил	Nan
لقوانين	закони	None
لقول	сказати	None
لقي	знайдено	None
لقياس	для вимірювання	Nan
لك	це твоє	Nan
لكتاب	за книгу	Nan
لكثرة	забагато	Nan
لكثير	для багатьох	Nan
لكرة	за бал	Nan
لقاء	зустріч	None
لكل	для кожного	Nan
لفهم	зрозуміти	None
لفكرة	для ідеї	Nan
لعمل	працювати	None
لعملية	в процесі	Nan
لغات	мови	None
لغة	мова	None
لغتهم	їх мова	Nan
لغرض	з метою	Nan
لغزو	вторгнутись	Nan
لغوية	мовна	None
لغير	для інших	Nan
لـ	для	None
لفتح	відкривати	Nan
لفترات	для періодів	Nan
لفترة	на деякий час	Nan
لفرنسا	для франції	Nan
لفظة	слово	None
لفلسطين	для палестини	Nan
لعلي	може бути	Nan
لكلمة	на слово	Nan
لكن	але	None
للاتحاد	за союз	Nan
للاتصالات	телеком	Nan
للاقتصاد	для економіки	Nan
للبحث	пошук	None
للبحر	до моря	Nan
للبشر	для людей	Nan
للبلاد	для країни	Nan
للتاريخ	для історії	Nan
للتجارة	торгівля	None
للتخلص	щоб позбутися від	Nan
للتدخين	для куріння	Nan
للتدريب	для тренувань	Nan
للتربة	для ґрунту	Nan
للتعبير	щоб висловити	Nan
للتعليم	для освіти	Nan
للإنسان	для людини	Nan
لكم	тобі	None
للإمبراطورية	для імперії	Nan
للإصابة	за травму	Nan
لكنه	але він	Nan
لكنها	але вона	Nan
لكنهم	але вони є	Nan
لكوكب	для планети	Nan
لكون	для всесвіту	Nan
لكونه	за буття	Nan
لكي	щоб	None
للأراضي	для земель	Nan
للأرض	за землю	Nan
للأطفال	для дітей	Nan
للأمم	націй	None
للأندية	для клубів	Nan
للإتحاد	за союз	Nan
للإسلام	до ісламу	Nan
للإشارة	на сигнал	Nan
للإمام	імаму	Nan
لعلماء	для науковців	Nan
لعلم	для інформації	Nan
لعلاج	лікувати	Nan
لحد	зменшити	Nan
لحركة	для руху	Nan
لحزب	для вечірки	Nan
لحساب	для розрахунку	Nan
لحظة	момент	None
لحفظ	зберегти	None
لحقوق	за права	Nan
لحكم	правити	Nan
لحل	вирішувати	Nan
لحم	м&#39;ясо	Nan
لحماية	захищати	None
لحن	мелодія	Nan
لحوالي	для о	Nan
لخدمة	служити	None
لدراسة	навчатися	Nan
لحام	зварювання	None
لدرجة	до певної міри	Nan
لجيش	для армії	Nan
لجميع	для усіх	Nan
لتعزيز	сприяти	Nan
لتفسير	для пояснення	Nan
لتقديم	забезпечувати	Nan
لتكون	бути	None
لتكوين	для налаштування	Nan
لتلك	для тих	Nan
لتنظيم	організувати	Nan
لتنفيذ	впровадити	Nan
لتوفير	забезпечувати	Nan
لتوليد	генерувати	Nan
لجأ	притулок	Nan
لجامعة	університет	None
لجعل	робити	None
لجمع	збирати	Nan
لجمهورية	до республіки	Nan
لجنة	комітет	None
لدعم	підтримувати	None
لدول	до країн	Nan
لدولة	в країну	Nan
لصناعة	для виготовлення	Nan
لضمان	гарантувати	Nan
لطفي	лотфі	Nan
لطيفة	латифа	Nan
لظهور	з&#39;явитися	Nan
لعام	за рік	Nan
لعب	грати	None
لعبة	іграшка	Nan
لعبت	я грав	Nan
لعبد	до слуги	Nan
لعدة	для кількох	Nan
لعدد	для ряду	Nan
لعدم	бо ні	Nan
لعطارد	до меркурія	Nan
لعل	можливо	None
لصالح	улюбленість	Nan
لشركة	для компанії	Nan
لشبونة	лісабон	Nan
لشبه	за подобу	Nan
لدى	у мене є	Nan
لدي	у мене є	Nan
لدينا	у нас є	Nan
لديه	він має	Nan
لديها	вона має	Nan
لديهم	вони мають	Nan
لذا	так	None
للتنمية	для розвитку	Nan
لذلك	так	None
لرعاية	піклуватися про	Nan
لزيادة	збільшувати	Nan
لسان	язик	Nan
لسكان	для мешканців	Nan
لسنة	впродовж року	Nan
لسنوات	протягом багатьох років	Nan
لسياسة	за політику	Nan
لرئيس	для голови	Nan
للثقافة	для культури	Nan
للثورة	з революції	Nan
للجدل	суперечливий	Nan
للموسيقى	до музики	Nan
للمياه	для води	Nan
للميلاد	на день народження	Nan
للنادي	для клубу	Nan
للناس	для людей	Nan
للنبي	пророкові	Nan
للنساء	для жінок	Nan
للنظام	для системи	Nan
للنفط	для олії	Nan
للنقل	для передачі	Nan
لله	аллах	Nan
للهجوم	атакувати	Nan
للوزراء	міністрам	Nan
للوصول	досягти	None
للولايات	державам	Nan
للمواد	для матеріалів	Nan
لليهود	до євреїв	Nan
للمنطقة	для регіону	Nan
للملك	до короля	Nan
للكواكب	для планет	Nan
للكوكب	для планети	Nan
للكويت	для кувейт	Nan
للماء	водонепроникний	Nan
للمجتمع	до громади	Nan
للمجلس	до ради	Nan
للمجموعة	для групи	Nan
للمدينة	для міста	Nan
للمرة	на час	Nan
للمساعدة	для допомоги	Nan
للمستخدمين	для користувачів	Nan
للمسجد	для мечеті	Nan
للمسلمين	для мусульман	Nan
للمسيحية	за християнство	Nan
للمغرب	для марокко	Nan
للمملكة	бо царство	Nan
لم	не	None
لما	коли	None
لماذا	чому?	Nan
لن	не буде	Nan
لنا	наші	None
لندن	лондон	None
لنظام	до системи	Nan
لنظرية	для теорії	Nan
لنفسه	для себе	Nan
لنقل	скажімо	None
لنكدوك-روسيون	лангедок-руссільйон	Nan
لنهر	для річки	Nan
له	для нього	Nan
لها	їй	None
لهتلر	для гітлера	Nan
لهجات	акценти	Nan
لهجة	діалект	None
لهذا	для цього	Nan
لمواجهة	в обличчя	Nan
لمنع	запобігати	Nan
لمنظمة	для організації	Nan
لمنطقة	для району	Nan
لمجلس	для дошки	Nan
لمجموعة	для групи	Nan
لمحاربة	боротися	Nan
لمحاولة	спробувати	Nan
لمحمد	мухаммеду	Nan
لمختلف	для різних	Nan
لمدة	на деякий час	Nan
للكنيسة	для церкви	Nan
لمدينة	для міста	Nan
لمساعدة	допомагати	Nan
لمصر	для єгипту	Nan
لمعالجة	адресувати	Nan
لمعرفة	знайти	None
لمعظم	для більшості	Nan
لمكافحة	боротися	Nan
لمن	чий	Nan
لمرض	за хвороби	Nan
مسلسلات	серія	None
للكثير	для багатьох	Nan
للقيام	робити	None
للخليفة	до халіфа	Nan
للدراسات	для досліджень	Nan
للدراسة	навчатися	Nan
للدفاع	захищати	None
للدلالة	позначати	Nan
للدول	державам	Nan
للدولة	державі	None
للدين	для релігії	Nan
للرئيس	до президента	Nan
للرجال	для чоловіків	Nan
للرجل	для чоловіка	Nan
للزراعة	для сільського господарства	Nan
للزهرة	для квітки	Nan
للسكان	для населення	Nan
للسلام	мир	None
للخلافة	за правонаступництво	Nan
للسلطان	султану	Nan
للحيوانات	для тварин	Nan
للحكومة	уряду	None
للجزائر	для алжиру	Nan
للجسم	для тіла	Nan
للجمعية	до асоціації	Nan
للجمهورية	республіки	None
للجميع	для всіх	Nan
للجنة	до комісії	Nan
للجيش	для армії	Nan
للحد	для обмеження	Nan
للحرارة	гріти	Nan
للحرب	для війни	Nan
للحركة	для руху	Nan
للحزب	для партії	Nan
للحصول	отримати	None
للحفاظ	зберігати	None
للحكم	судити	None
للحياة	для життя	Nan
للسلطة	до влади	Nan
للسيارات	для автомобілів	Nan
للسيطرة	контролювати	None
للعناصر	для предметів	Nan
للعهد	для заповіту	Nan
للعولمة	для глобалізації	Nan
للغاية	надзвичайно	None
للغة	для мови	Nan
للفرد	для особистості	Nan
للفنون	для мистецтв	Nan
للفيروسات	для вірусів	Nan
للقارات	міжконтинентальний	Nan
للقتال	боротися	Nan
للقدس	для єрусалиму	Nan
للقرآن	для корану	Nan
للقرن	за століття	Nan
للقضاء	для усунення	Nan
للقوات	для військ	Nan
للعمل	для роботи	Nan
للعلوم	науки	None
للعلماء	для науковців	Nan
للعلم	для інформації	Nan
للشباب	для молоді	Nan
للشعب	до людей	Nan
للشمس	для сонця	Nan
للشيخ	шейх	Nan
للصلاة	молитися	Nan
للضوء	світити	Nan
للطاقة	за енергію	Nan
للكتاب	для книги	Nan
للطبيعة	з природи	Nan
للطيران	літати	Nan
للعالم	для світу	Nan
للعام	за рік	Nan
للعديد	для кількох	Nan
للعراق	для іраку	Nan
للعرب	арабам	Nan
للعلاج	для лікування	Nan
للطلاب	для студентів	Nan
مسلم	мусульманський	Nan
مسلمة	мусульманський	Nan
مسلمون	мусульмани	None
نصف	половина	None
نصوص	тексти	None
نصيب	поділитися	Nan
نصير	прихильник	Nan
نطاق	домен	None
نظام	система	None
نظر	розгляд	None
نظرا	належне	Nan
نظراً	належне	Nan
نظرة	погляд	None
نظريات	теорії	None
نظرية	теорія	None
نظريته	його теорія	Nan
نظرًا	належне	Nan
نظم	організовано	None
نصر	перемога	None
نظير	матч	None
نصب	налаштуйте	Nan
نشوب	спалах	Nan
نسمة	вітер	None
نشأ	крохмаль	Nan
نشأة	буття	None
نشأت	походження	None
نشأته	я виріс	Nan
نشأتها	воно виникло	Nan
نشاط	діяльність	None
نشاطات	діяльності	None
نشبت	виламати	Nan
نشر	поширення	None
نشرت	опубліковано	None
نشرها	опублікував	None
نشط	активний	None
نشطة	активний	None
نشوء	виникнення	None
نص	текст	None
نسل	насіння	Nan
نعرف	ми знаємо	Nan
نفر	вимкнути	Nan
نمر	тигр	None
نمط	стиль	None
نمو	зростання	None
نموذج	форма	None
نهائي	фінал	Nan
نهائيات	фінал	Nan
نهاية	кінець	None
نهج	підхід	None
نهر	річка	None
نهضة	відродження	None
نهيان	nahyan	Nan
نواب	депутати	None
نواة	ядро	None
نواس	маятник	Nan
نوبل	благородний	Nan
نمت	виросли	Nan
نعيم	naeem	Nan
نماذج	форми	None
نقله	перемістити його	Nan
نفس	так само	Nan
نفسه	сам	None
نفسها	себе	None
نفسي	я сам	Nan
نفسية	психологічні	Nan
نفط	олія	Nan
نفوذه	його вплив	Nan
نفوذها	її вплив	Nan
نفوس	душі	None
نفي	заперечення	None
نقاط	бали	Nan
نقد	готівкою	Nan
نقص	нестача	Nan
نقطة	точка	None
نقل	передача	None
نقول	ми кажемо	Nan
نسخة	скопіювати	Nan
نسخ	копії	None
نستطيع	ми можемо	Nan
نابلس	наблус	Nan
نابليون	наполеон	Nan
ناتج	вихідні дані	Nan
ناجحة	успішно	None
ناحية	рука	Nan
نادرة	рідкісний	Nan
نادى	клуб	None
نادي	клуб	None
نار	вогонь	None
ناسا	наса	Nan
ناصر	насер	Nan
ناطقة	виступаючи	Nan
نال	він отримав	Nan
نالت	вона отримала	Nan
نانسي	ненсі	Nan
ناب	бивня	Nan
نايف	найєф	Nan
نائب	заступник	None
مِنْ	з	None
ميدان	майдан	None
ميزانية	бюджет	None
ميزة	особливість	None
ميسي	мессі	Nan
ميكانيكا	механіка	None
ميل	схильність	Nan
ميلاد	народження	None
ميلان	мілан	None
ميلانو	мілан	None
ميلودراما	мелодрама	Nan
ميناء	гавань	Nan
ميونيخ	мюнхен	None
مَا	що	None
مَنْ	з	None
مِن	з	None
ن	n	None
نبات	рослина	Nan
نباتات	рослини	None
نبتون	нептун	Nan
نحو	назустріч	Nan
نذكر	згадаємо	Nan
نرى	ми бачимо	Nan
نزار	назар	Nan
نزل	завантажити	Nan
نزلت	я зійшов	Nan
نزول	спускається	Nan
نساء	жінки	None
نسب	ряд	None
نسبة	ставка	None
نسبته	його співвідношення	Nan
نسبه	процент	Nan
نسبيا	відносно	None
نسبياً	відносно	None
نسبيًا	відносно	None
نحن	ми	None
نجيب	наджиб	Nan
نجوم	зірки	None
نجمة	зірка	None
نبذة	короткий виклад	Nan
نبي	пророк	Nan
نبيل	набіл	Nan
نت	чистий	None
نتائج	наслідки	None
نتاج	продукт	None
نتج	результат	None
نوح	ной	Nan
نتيجة	календар	None
نجاحاً	успіх	None
نجاد	наджад	Nan
نجح	йому це вдалося	Nan
نجحت	я здав	Nan
نجد	ми знаходимо	Nan
نجران	найран	Nan
نجم	зірка	None
نجاح	успіх	None
نور	світло	None
نورة	нура	Nan
نوستراداموس	нострадамус	Nan
وأبي	а мій тато	Nan
وأتباعه	і його послідовники	Nan
وأثناء	і під час	Nan
وأجزاء	і частини	Nan
وأجهزة	і сервопривід	Nan
وأحد	один	None
وأحمد	і ахмед	Nan
وأحيانا	а іноді	Nan
وأخذ	і беру	Nan
وأخذت	і вона взяла	Nan
وأخرى	і ще	Nan
وأخيرا	і, нарешті	Nan
وأخيراً	нарешті	None
وأخيرًا	і, нарешті	Nan
وأدت	і вела	Nan
وأبو	і абу	Nan
وأدى	долина	None
وأبرزها	найпомітніший	Nan
وآله	і його родина	Nan
هي	вона	None
هيئة	тіло	None
هيا	давай	Nan
هياكل	структури	None
هيدروجين	водень	None
هيفاء	хайфа	Nan
هيكل	будова	None
هيلين	олена	None
هيم	гем	Nan
هينايانا	хінаяна	Nan
هُوَ	він є	Nan
و	і	None
وآخر	і ще	Nan
وآخرون	і інші	Nan
وآسيا	і азії	Nan
وأبرز	більшість виділених	Nan
وأذربيجان	і азербайджан	Nan
وأربعين	і сорок	Nan
وأرسل	він послав	Nan
وأقدم	і старше	Nan
وأقل	і менше	Nan
وأكبر	і більший	Nan
وأكثر	і більше	Nan
وأكثرها	і більшість із них	Nan
وأكد	підтверджено	Nan
وألمانيا	і німеччина	Nan
وأما	або	None
وأمر	він наказав	Nan
وأمريكا	і америка	Nan
وأمه	і його мати	Nan
وأن	і точно	Nan
وأنا	і я	Nan
وأنشأ	встановлено	None
وأنه	і воно є	Nan
وأقام	він залишився	Nan
وأقاليم	і території	Nan
وأفغانستان	і афганістан	Nan
وأفريقيا	і африка	Nan
وأساليب	і методи	Nan
وأسباب	і причини	Nan
وأستراليا	і австралія	Nan
وأسس	і фундаменти	Nan
وأشار	зазначив	Nan
وأشهر	найвідоміший	None
وأصبح	і це стало	Nan
هوية	ідентифікація	Nan
وأصبحت	і я став	Nan
وأصحابه	і його супутники	Nan
وأضاف	він додав	Nan
وأطلق	був звільнений	Nan
وأعضاء	і члени	Nan
وأعلن	він оголосив	Nan
وأعلنت	про це було оголошено	Nan
وأغلب	і більшість	Nan
وأصحاب	і власники	Nan
ميخائيل	майкл	Nan
هولندا	голландія	Nan
هوراس	горацій	None
هاجر	емігрували	Nan
هاجروا	вони мігрували	Nan
هاجم	напали	Nan
هاجمت	напали	Nan
هارفارد	гарвард	Nan
هارون	аарон	Nan
هاري	гаррі	None
هاشم	хашем	Nan
هام	важливо	None
هاما	важливо	None
هاماً	важливо	None
هامة	важливо	None
هاواي	гаваї	Nan
هايدا	хайда	Nan
هتلر	гітлер	None
هاتين	ці два	Nan
هجرة	міграція	Nan
هائلة	величезний	None
هؤلاء	ці	None
نوع	тип	None
نوعا	щось на зразок	Nan
نوعان	два типи	Nan
نوعه	його тип	Nan
نوعها	його тип	Nan
نوعية	якість	None
نوعين	два типи	Nan
نوفمبر	лис	Nan
نووي	ядерний	Nan
نووية	ядерний	Nan
نيتشه	ніцше	None
نيجيريا	нігерія	Nan
نيوتن	ньютон	Nan
نيوزيلندا	нова зеландія	Nan
نيويورك	нью-йорк	Nan
هائل	величезний	None
هجمات	напади	Nan
هجوم	напад	Nan
هدف	мета	None
هـم	гм	Nan
هكتور	гектор	None
هكذا	так	None
هل	чи ти	Nan
هلال	півмісяць	Nan
هم	вони	None
هما	вони	None
هنا	ось	None
هناك	там	None
هنالك	там	None
هند	задні	Nan
هندسة	інженерія	Nan
هنري	генрі	Nan
هو	він є	Nan
هواء	повітря	None
هـ	е	None
هطول	опадів	None
هضبة	плато	None
هشام	гешам	Nan
هدفه	його мета	Nan
هدم	знищити	None
هدنة	перемир&#39;я	Nan
هدى	керівництво	None
هذا	це	None
هذان	ці два	Nan
هذة	це	None
هولاكو	хулагу	Nan
هذه	це	None
هرب	втік	Nan
هرقل	геркулес	Nan
هرقليطس	геракліт	None
هرم	піраміда	None
هريرة	кошеня	Nan
هزم	переможений	Nan
هزيمة	поразка	None
هذين	ці два	Nan
وأنواع	і типи	Nan
ميثيونين	метіонін	Nan
ميت	мертвий	Nan
معقد	складні	None
معقدة	складні	None
معلومات	інформації	None
معمر	старший	None
معناه	його значення	Nan
معناها	його значення	Nan
معنى	значення	None
معه	з ним	Nan
معهد	інститут	None
معهم	з ними	Nan
معينة	певна	None
معًا	разом	None
مغادرة	залишаючи	Nan
مغامرات	пригоди	Nan
مغربي	марокканський	Nan
معظمهم	більшість з них	Nan
مغناطيسي	магнітний	Nan
معظمها	більша частина	Nan
معسكرات	будівельні табори	Nan
معتدل	помірний	None
معتدلة	помірний	None
معترف	акредитований	Nan
معجزة	чудо	Nan
معد	за призначенням	Nan
معدات	обладнання	None
معدة	шлунок	None
معدل	ставка	None
معدلات	ціни	None
معدنية	металеві	Nan
معرفة	знання	None
معركة	битва	None
معروف	улюблене	Nan
معروفة	відомий	None
معسكر	табір	None
معظم	більшість	None
معبد	храм	None
مغناطيسية	магнітний	Nan
مفاهيم	поняття	None
مقاومة	опір	None
مقبرة	кладовище	Nan
مقبولة	прийнятний	Nan
مقتل	загинув	None
مقتله	вбив його	Nan
مقدار	кількість	None
مقدسة	священний	Nan
مقدم	ведучий	Nan
مقدمة	вступ	None
مقدونيا	македонія	None
مقديشيو	могадішу	Nan
مقر	штаб-квартира	Nan
مقرا	бюро	None
مقرها	на основі	Nan
مقسمة	поділений	Nan
مقام	знаменник	Nan
مفاعل	реактор	None
مقالة	стаття	None
مقال	стаття	None
مفاوضات	переговори	None
مفتاح	ключ	Nan
مفتوحة	відчинено	Nan
مفتي	муфтій	Nan
مفصلة	петля	Nan
مفهوم	концепція	None
مفيدة	корисні	None
مقابر	кладовища	Nan
مقابل	навпроти	Nan
مقابلة	інтерв&#39;ю	Nan
مقاتل	винищувач	Nan
مقارنة	порівняння	None
مقاطعات	округи	None
مقاطعة	бойкот	Nan
مقاعد	сидіння	Nan
مقالات	статті	None
معاً	разом	None
معايير	стандарти	None
معاوية	сид	Nan
مشتقة	похідне	Nan
مشروع	проект	None
مشعل	факел	Nan
مشكلة	проблема	None
مشهد	сцена	None
مشهور	відомий	None
مشهورة	відомий	None
مشيخة	вона стара	Nan
مصادر	джерела	None
مصانع	заводи	None
مصحف	мушаф	Nan
مصدر	джерело	None
مصر	єгипет	None
مصرف	банк	None
مصري	єгипетський	Nan
مشتركة	спільний	None
مصريات	єгипетські жінки	Nan
مشترك	взаємне	Nan
مشاهدة	дивіться	None
مسلمين	мусульмани	None
مسمى	названий	None
مسند	підставка для ніг	Nan
مسيحية	християнин	Nan
مسيرة	марш	Nan
مسيرته	його кар&#39;єра	Nan
مشابه	подібний	None
مشابهة	подібні	None
مشاة	пішохід	Nan
مشاركة	обмін	None
مشاريع	проекти	None
مشاعر	почуття	None
مشاعل	спалахи	Nan
مشاكل	проблеми	None
مشاهد	вид	None
مشاهير	відомий	None
مصرية	єгипетський	Nan
مصريون	єгиптяни	Nan
مصطفى	мустафа	Nan
مظاهر	зовнішній вигляд	Nan
مظاهرات	протести	Nan
مظهر	зовнішній вигляд	Nan
مع	з	None
معا	разом	None
معاداة	ворожнеча	Nan
معارض	проти	None
معارضة	опозиція	None
معارك	бої	None
معالجة	обробка	None
معالم	віхи	Nan
معامل	фактор	None
معاملة	лікування	None
معاني	значення	None
معاهدة	договір	None
مطلقة	розлучилися	Nan
مطلع	початок	None
مطلة	з видом	Nan
مطرب	співачка	None
مصطلح	термін	None
مصطلحات	умови	None
مصلحة	процентний інтерес	Nan
مصنع	заводська	Nan
مصنوع	зроблено	None
مصنوعة	зроблено	None
مصير	доля	None
مقياس	масштаб	Nan
مضادة	лічильник	Nan
مضى	пішов на	Nan
مضيق	протока	Nan
مطابقة	узгодження	Nan
مطار	аеропорт	None
مطارات	аеропорти	Nan
مطالب	попити	Nan
مطر	дощ	Nan
مضخم	підсилювач	Nan
مكاتب	офіси	Nan
مكافحة	боротьба	None
مكان	місце	None
مهد	колиска	Nan
مهدي	махді	Nan
مهرجان	фестиваль	None
مهم	важливо	None
مهما	що б там не було	Nan
مهمة	місія	Nan
مهمًا	що б там не було	Nan
مهنة	професія	Nan
مهندس	інженер	None
مواجهة	протистояння	None
مواد	матеріал	None
موارد	ресурси	None
مواضيع	теми	None
مواطن	громадянин	None
مواطني	мої земляки	Nan
مهام	завдання	None
موافقة	згода	Nan
مهارات	навички	Nan
منيرة	муніра	Nan
منصب	позиція	None
منصبه	офіс	Nan
منصور	мансар	Nan
منطقة	площа	None
منظمات	організації	None
منظور	перспектива	Nan
منع	блок	None
منعت	попереджено	Nan
منغوليا	монголія	Nan
منها	з яких	Nan
منهج	метод	None
منهم	хто вони	Nan
منهما	хто вони	Nan
منى	мона	Nan
مني	мона	Nan
مهاجمة	напад	Nan
مواقع	сайти	None
مواقف	ситуації	None
مواليد	бебі-бумери	Nan
موطن	головна	None
موعد	зустріч	None
موقع	розташування	None
موقعة	підписано	Nan
موقعه	підписано	Nan
موقعها	його місцезнаходження	Nan
موقف	ставлення	None
موقفه	його позиція	Nan
مول	торговий центр	Nan
مولاي	мулей	Nan
مولده	його народження	Nan
موليبدنوم	молібден	None
مونتانا	монтана	Nan
مونكو	монко	Nan
مياه	води	None
موضي	маді	Nan
موضوع	тема	None
موضع	положення	None
موسيقية	музичний	None
موانئ	порти	None
موت	смерть	None
موته	його смерть	Nan
موجات	хвилі	None
موجة	хвиля	None
موجودة	знайдено	None
موحد	уніфікований	Nan
منزله	його дім	Nan
موحدة	уніформа	Nan
موريتانيا	мавританія	Nan
موسكو	москва	None
موسم	сезон	None
موسوعة	енциклопедія	None
موسوليني	муссоліні	Nan
موسى	муса	Nan
موسيقى	музика	None
مورد	постачальник	Nan
ميثاق	статут	None
منزلة	його дім	Nan
منذ	аго	Nan
ملجأ	притулок	Nan
ملحوظ	позначено	Nan
ملحوظة	nb	Nan
ملعب	стадіон	None
ملعقة	ложка	Nan
ملف	файл	None
ملفات	файли	None
ملك	король	None
ملكة	королева	Nan
ملكي	королівський	None
ملكية	власність	None
ملكًا	король	None
ملوك	царі	None
مليار	мільярд	Nan
مليون	мільйон	Nan
ملايين	мільйони	None
مما	чому	None
ملامح	особливості	None
ملاحظة	примітка	Nan
مكانة	статус	None
مكانته	його ріст	Nan
مكانه	статус	None
مكانها	його місце	Nan
مكة	мекка	Nan
مكتب	офіс	Nan
مكتبة	бібліотека	None
مكتوب	написана	None
مكتوبة	написана	None
مكتوم	приглушений	Nan
مكنسة	мітла	Nan
مكون	інгредієнт	Nan
مكونات	інгредієнти	Nan
مكونة	складено	Nan
ملاحظات	примітки	None
ملاك	ангел	Nan
مماثل	подібний	None
مماثلة	подібні	None
ممارسة	практика	None
مناف	монаф	Nan
منافسة	конкуренція	None
مناقشة	дебати	Nan
مناهج	навчальні програми	Nan
منتج	виробник	None
منتجات	продукція	None
منتخب	обраний	None
منتشرة	широке поширення	Nan
منتصف	середина	None
منتظم	регулярні	Nan
منتظمة	регулярні	Nan
منح	грант	Nan
منحت	здійснено	None
منخفض	низький	None
منخفضة	низький	None
مناطق	регіони	None
مناصب	позиції	None
مناسبة	нагода	Nan
مناسب	відповідний	None
ممالك	королівства	None
مماليك	мамлюки	Nan
ممثل	актор	None
ممثلة	акторка	Nan
ممرض	медсестра	Nan
ممكن	може бути	Nan
ممكنة	можливо	None
منزل	будинок	None
مملكة	царство	None
مميزات	особливості	None
مميزة	відмітний	Nan
من	з	None
منا	від нас	Nan
مناخ	клімат	None
منارة	маяк	Nan
منازل	будинки	None
ممن	з яких	Nan
يُلاحظ	повідомлення	None
تسبب	це викликає	Nan
تساهم	внесіть внесок	Nan
التلفاز	телебачення	None
التلفزيون	телебачення	None
التلفزيونية	телебачення	None
التلوث	забруднення	None
التمثيل	в.о.	Nan
التمرد	повстання	None
التمويل	фінансування	None
التميمي	аль-тамімі	Nan
التمييز	дискримінація	Nan
التنازل	відмова	None
التناسلي	генітальний	Nan
التناسلية	генітальний	Nan
التنافس	конкуренція	None
التنبؤ	прогнозування	Nan
التنسيق	координація	Nan
التلاميذ	вихованці	Nan
التنظيم	організація	None
التكيف	адаптація	Nan
التكنولوجية	технологічна	Nan
التقسيم	перегородка	Nan
التقسيمات	підрозділи	None
التقليد	традиції	None
التقليدي	традиційні	None
التقليدية	традиційні	None
التقنيات	технології	None
التقنية	технологія	None
التقويم	календар	None
التقى	він зустрів	Nan
التقييم	оцінка	None
التكاثر	відтворення	None
التكافؤ	валентність	Nan
التكتونية	тектонічний	Nan
التكلفة	вартість	None
التكنولوجيا	технологія	None
التكوين	конфігурація	Nan
التقرير	звіт	Nan
التنفس	дихання	None
التنفيذي	виконавча влада	Nan
التونسية	туніський	Nan
التي	котрий	None
التيار	поточний	Nan
التيارات	струми	Nan
الثابت	постійний	None
الثابتة	виправлено	Nan
الثالث	третій	None
الثالثة	третій	None
الثالوث	трійця	Nan
الثامن	viii	None
الثامنة	восьмий	Nan
الثانوي	вторинні	Nan
الثانوية	вища школа	Nan
الثاني	секунда	Nan
الثانية	секунда	Nan
التونسي	туніський	Nan
التنفيذ	впровадження	None
التوقيع	підпис	None
التوسع	розширення	None
التنفيذية	виконавчий	None
التنقل	мобільність	Nan
التنقيب	розвідувальні роботи	Nan
التنمية	розвиток	None
التنوع	різноманітність	None
التنوير	просвітництво	Nan
التهاب	запалення	Nan
التوازن	баланс	Nan
التواصل	зв&#39;язок	Nan
التوالي	прямо	None
التوبة	покаяння	Nan
التوتر	стрес	Nan
التوجه	орієнтація	Nan
التوحيد	монотеїзм	Nan
التوراة	тора	Nan
التوصل	досягай	Nan
التقديرات	оцінки	None
التقدم	прогрес	None
التقاليد	традиції	None
التشريح	анатомія	None
التشريع	законодавство	None
التشريعات	законодавство	None
التشريعي	законодавча	None
التشريعية	законодавча	None
التشكيل	становлення	None
التصحر	опустелення	Nan
التصدي	протистояти	Nan
التصديق	сертифікація	Nan
التصرف	акт	None
التصفيات	плей-офф	Nan
التصميم	дизайн	Nan
التصنيع	виробництво	None
التصنيف	категорія	None
التصنيفات	класифікації	None
التشخيص	діагностика	Nan
التصوف	суфізм	Nan
التشابه	подібність	Nan
التسونامي	цунамі	Nan
الترجمة	переклад	None
الترفيهية	рекреаційні	Nan
الترك	турок	Nan
التركي	турецька	Nan
التركيب	склад	None
التركية	турецька	Nan
التركيز	концентрація	None
الترمذي	тірміді	Nan
التزاوج	спаровування	Nan
التزلج	катання на лижах	Nan
التسامح	толерантність	Nan
التسجيل	зареєструйтесь	Nan
التسعينيات	дев&#39;яностих років	Nan
التسلسل	послідовність	None
التسمية	етикетка	Nan
التسويق	маркетинг	None
التصويت	голосувати	Nan
التصوير	фотографія	Nan
التضاريس	земельні форми	Nan
التعليم	освіта	None
التعليمي	навчальна	Nan
التعليمية	навчальна	Nan
التغذية	харчування	None
التغير	зміна	None
التغيرات	зміни	None
التغيير	зміна	None
التغييرات	зміни	None
التفاصيل	деталі	None
التفاعل	взаємодія	None
التفسير	пояснення	None
التفسيرات	пояснення	None
التفكير	мислення	None
التفوق	перевагу	None
التقارير	звіти	Nan
التعلم	навчання	None
التعريفات	визначення	None
التعريف	визначення	None
التعرية	зачистка	Nan
التضخم	інфляція	None
التطبيق	застосування	None
التطبيقات	програми	None
التطبيقية	застосовується	None
التطور	розвиток	None
التطورات	розробки	None
التطوير	розвиток	None
الثبات	наполегливість	Nan
التعاليم	навчання	None
التعاون	кооперат	Nan
التعبير	вираз	None
التعداد	перепис населення	Nan
التعديل	регулювання	None
التعديلات	коригування	Nan
التعرض	контакт	None
التعرف	визначте	Nan
التعامل	справа	None
الترجمات	переклади	None
الثدي	груди	Nan
الثروات	багатство	None
الجمع	множина	None
الجمعة	п’ятниця	Nan
الجمعيات	асоціації	None
الجمعية	асоціація	None
الجمل	верблюд	Nan
الجملة	вирок	Nan
الجمهور	аудиторія	Nan
الجمهوري	республіканський	Nan
الجمهورية	республіка	None
الجميع	всі	None
الجن	джин	Nan
الجنائية	кримінальний	Nan
الجناح	підопічний	Nan
الجنة	рай	None
الجند	солдати	None
الجمباز	гімнастика	Nan
الجندي	солдат	Nan
الجماهير	маси	None
الجماعية	колективний	Nan
الجسر	міст	None
الجسم	тіло	None
الجسور	мости	None
الجسيمات	частинки	None
الجغرافي	географічні	None
الجغرافيا	географія	None
الجغرافية	географічні	None
الجفاف	засуха	Nan
الجلد	шкіра	Nan
الجليد	лід	Nan
الجليدية	крижаний	Nan
الجليل	галілея	Nan
الجماع	зношення	Nan
الجماعة	громада	None
الجماعي	колективний	Nan
الجمال	краса	None
الجسد	тіло	None
الجنرال	загальне	None
الجنسي	сексуальні	None
الجولان	голан	Nan
الجوهرة	коштовність	Nan
الجوي	повітря	None
الجوية	повітря	None
الجيد	добре	None
الجيدة	гарний вигляд	Nan
الجيزة	гіза	Nan
الجيش	армії	None
الجيل	покоління	None
الجينات	гени	None
الجينوم	геном	Nan
الجيني	генетичні	Nan
الجينية	генетичні	Nan
الجيوش	армії	None
الجيولوجية	геологічні	Nan
الجوفية	підземний	Nan
الجنس	секс	None
الجودة	якість	None
الجوار	сусідство	Nan
الجنسيات	національності	Nan
الجنسية	національність	None
الجنسين	стать	Nan
الجنوب	південь	None
الجنوبي	південний	None
الجنود	солдати	None
الجنين	плід	Nan
الجهات	актори	None
الجهاز	пристрій	None
الجهة	місце призначення	Nan
الجهد	зусилля	None
الجهل	невігластво	Nan
الجهود	зусилля	None
الجو	погода	None
الجوائز	нагороди	None
الجوانب	аспекти	None
الجزيرة	аль-джазіра	Nan
الجزية	данина	Nan
الجزيئي	молекулярний	Nan
الثمانية	вісім	None
الثمانينات	вісімдесяті	Nan
الثمانينيات	вісімдесяті	Nan
الثنائي	пара	None
الثنائية	двосторонній	Nan
الثوار	революціонери	Nan
الثورات	революції	None
الثورة	революція	None
الثوري	революційний	Nan
الثورية	революційний	Nan
الجائزة	приз	Nan
الجابر	аль-джабер	Nan
الجاحظ	біге	Nan
الجاذبية	сила тяжіння	Nan
الجاز	джаз	None
الثلوج	сніг	Nan
الجاف	сухий	Nan
الثلج	сніг	Nan
الثلاثينات	тридцяті роки	Nan
الثروة	багатство	None
الثقافات	культури	None
الثقافة	культура	None
الثقافي	культурні	None
الثقب	отвір	Nan
الثقة	впевненість	Nan
الثقفي	культурні	None
الثقوب	отвори	Nan
الثقيل	важка	None
الثقيلة	важка	None
الثلاث	три	None
الثلاثاء	вівторок	Nan
الثلاثة	три	None
الثلاثي	тріо	Nan
الثلاثين	тридцять	Nan
الثلاثينيات	тридцяті роки	Nan
الجافة	сухий	Nan
الجاليات	громади	None
الجالية	громада	None
الجديدة	нові	None
الجدير	варто	None
الجذور	коріння	None
الجرائم	злочини	None
الجراثيم	мікроби	Nan
الجراح	хірург	Nan
الجرمانية	німецький	None
الجريدة	газета	None
الجريمة	злочину	Nan
الجزء	розділ	None
الجزائر	алжир	Nan
الجزائري	алжирський	Nan
الجزائريين	алжирці	Nan
الجزر	морква	Nan
الجزيئات	молекули	None
الجديد	новий	None
الجدول	графік	None
الجدل	суперечки	None
الجدد	нео	Nan
الجامع	цілий	None
الجامعات	університети	None
الجامعة	університет	None
الجامعي	університет	None
الجامعية	бакалаврат	Nan
الجانب	сторона	None
الجانبية	бічні	Nan
الثدييات	ссавці	Nan
الجانبين	сторони	None
الجاهلية	невігластво	Nan
الجبال	гори	None
الجبر	алгебра	Nan
الجبل	гора	None
الجبلية	гора	None
الجبهة	перед	None
الجدار	стіна	Nan
الجاهلي	доісламський	Nan
الترتيب	домовленість	Nan
التربية	освіта	None
التربة	грунт	Nan
البابوية	папство	Nan
البابية	крило	Nan
الباحث	дослідник	None
الباحثون	дослідники	None
الباحثين	дослідники	None
البارد	холодний	None
الباردة	холодний	None
البارزة	помітний	None
البارزين	видатний	None
الباطنية	езотеричні	Nan
الباقي	решта	None
الباقية	решта	None
البالغ	дорослий	Nan
البالغة	дорослий	Nan
البالغين	дорослі	Nan
البابلية	вавилонський	Nan
البتراء	петра	None
البابلي	вавилонський	Nan
الباب	двері	Nan
الانتقال	переїзд	Nan
الانتقالية	перехідний	None
الانتقام	помста	Nan
الانتهاء	готово	Nan
الاندلس	андалус	Nan
الاندماج	злиття	None
الانسحاب	витягуючи	Nan
الانضمام	приєднуйтесь	Nan
الانطروبولوجيا	антропологія	Nan
الانفجار	вибух	Nan
الانفصال	поділ	None
الانقسام	відділ	None
الانقلاب	переворот	None
الاهتمام	відсотки	Nan
الايكولوجية	екологічні	Nan
البابا	тато	Nan
الانتقادات	критика	None
البترول	нафта	None
البحار	мори	Nan
البراكين	вулкани	Nan
البرامج	програми	None
البربر	бербери	Nan
البربرية	варварство	Nan
البرتغال	португалія	None
البرتغالي	португальська	None
البرتغالية	португальська	None
البرتغاليين	португальці	Nan
البرج	башта	Nan
البركان	вулкан	Nan
البركاني	вулканічний	Nan
البركانية	вулканічний	Nan
البرلمان	парламент	None
البرلمانية	парламентська	Nan
البرمجيات	програмне забезпечення	Nan
البرازيلي	бразильський	Nan
البث	трансляція	Nan
البرازيل	бразилія	None
البذور	насіння	Nan
البحر	море	None
البحري	морська	None
البحرية	вмс	Nan
البحرين	два моря	Nan
البحوث	дослідження	None
البحيرات	озера	None
البحيرة	озеро	None
البخار	пара	None
البخاري	бухарі	Nan
البدء	старт	Nan
البدائي	примітивні	Nan
البدائية	первинний	Nan
البداية	початок	None
البدنية	фізичні	None
البدو	бедуїни	Nan
البر	праведність	Nan
الانتفاضة	повстання	None
الانتصارات	перемоги	None
الانتصار	перемога	None
الاستثمار	інвестиції	None
الاستثمارات	інвестиції	None
الاستخبارات	інтелект	Nan
الاستخدام	використання	None
الاستخدامات	використання	None
الاستراتيجي	стратегічний	Nan
الاستراتيجية	стратегія	Nan
الاستسلام	поступатися	Nan
الاستعمار	колонізація	None
الاستعماري	колоніальний	Nan
الاستعمارية	колоніальний	Nan
الاستعمال	використовуйте	Nan
الاستفتاء	референдум	Nan
الاستقرار	стабільність	None
الاستقلال	незалежність	None
الازدهار	процвітання	Nan
الاستنساخ	відтворення	None
الارتفاع	висота	None
الاختيار	вибір	None
الاجتماع	зустріч	None
الاجتماعات	зустрічі	None
الاجتماعي	соціальна	None
الاجتماعية	соціальна	None
الاجتهاد	старанність	Nan
الاحتباس	утримання	None
الاحتفاظ	тримайте	Nan
الاحتفال	святкування	None
الاحتفالات	урочистості	Nan
الاحتكاك	тертя	Nan
الاحتلال	професія	Nan
الاحتياجات	потреби	None
الاختبار	тест	None
الاختلاف	різниця	None
الاختلافات	відмінності	None
الارتباط	посилання	None
الاستهلاك	споживання	None
الاستواء	вирівнювання	Nan
الاستوائية	тропічний	Nan
الاعمال	бізнес	None
الاغنية	пісня	None
الاقتصاد	економіка	None
الاقتصادي	економічний	None
الاقتصادية	економічний	None
الاكتشاف	відкриття	None
الاكتشافات	відкриття	None
الالتزام	прихильність	None
الامام	імам	Nan
الامبراطورية	імперія	None
الامير	принц	Nan
الانتخابات	вибори	None
الانتخابية	виборчий	Nan
الانتداب	мандат	Nan
الانتشار	поширення	None
الاعلام	змі	None
الاعتماد	акредитація	Nan
الاعتقاد	віра	None
الاعتراف	визнання	None
الاستيلاء	напад	Nan
الاسكندنافية	скандинавський	Nan
الاسم	ім&#39;я	Nan
الاسود	чорний	None
الاشتراك	підписка	Nan
الاشتراكي	соціалістичні	None
الاشتراكية	соціалізм	None
البرنامج	програма	None
الاشتراكيون	соціалісти	Nan
الاصطناعي	штучний	Nan
الاضطراب	безлад	Nan
الاضطرابات	хвилювання	Nan
الاضطهاد	переслідування	None
الاضطهادات	переслідування	None
الاعتبار	розгляд	None
الاعتداء	штурм	Nan
الاصطناعى	синтетичний	Nan
البروتستانت	протестант	Nan
البروتستانتية	протестантизм	Nan
البروتوكولات	протоколи	Nan
التأكيد	підтвердження	None
التأليف	авторство	None
التأمين	страхування	None
التائية	т	None
التابع	послідовник	Nan
التابعة	партнерська компанія	Nan
التابعين	послідовники	None
التاج	корона	None
التاريخ	історія	None
التاريخي	історичний	None
التاريخية	історичний	None
التاسع	дев&#39;ятий	Nan
التاسعة	дев&#39;ятий	Nan
التالي	наступний	None
التالية	наступний	None
التأكد	переконуватися	Nan
التبادل	обмін	None
التأثيرات	вплив	None
البيولوجية	біологічні	None
البيئات	середовища	None
البيئة	навколишнє середовище	Nan
البيئي	екологічні	Nan
البيان	заява	Nan
البيانات	дані	None
البيت	головна	None
البيروني	аль-біруні	Nan
البيزنطي	візантійська	None
البيزنطية	візантійська	None
البيزنطيين	візантійці	Nan
البيض	яйця	None
البيضاء	білий	None
البيعة	порука вірності	Nan
البيوت	будинки	None
البيولوجي	біологічні	None
التأثير	вплив	None
التبانة	чумацький шлях	Nan
التبرعات	пожертви	Nan
التبغ	тютюн	Nan
التحليلية	аналітичний	Nan
التحول	зсув	Nan
التحويلية	трансформаційні	Nan
التخصص	спеціалізація	Nan
التخصصات	спеціальність	Nan
التخطيط	планування	None
التخلص	спекатися	Nan
التخلي	здаватися	Nan
التدخل	втручання	None
التدخين	куріння	Nan
التدريب	навчання	None
التدريس	навчання	None
التراب	бруд	Nan
التراث	спадщина	None
التراجع	відступ	Nan
التحليل	аналіз	None
التحكيم	арбітраж	Nan
التحكم	контроль	None
التحقيق	розслідування	None
التتار	татарські	Nan
التجار	купці	Nan
التجارب	досвід	None
التجارة	торгівля	None
التجاري	комерційний	Nan
التجارية	комерційний	Nan
التجديد	поновлення	Nan
البويضة	яйце	None
التجربة	досвід	None
التجريبية	експериментальний	Nan
التجنيد	зарахування	Nan
التحتية	інфраструктура	None
التحدث	говоріть	Nan
التحرك	рухатися	Nan
التحرير	редагування	Nan
التحق	зарахували	Nan
التجريبي	демо	Nan
الحائط	стіна	Nan
البونيقية	пунічний	Nan
البولندية	польська	None
البضائع	товари	None
البطالة	безробіття	None
البطل	герой	None
البطن	живіт	Nan
البطولات	чемпіонати	Nan
البطولة	чемпіонат	None
البظر	клітор	None
البعث	воскресіння	None
البعثات	місії	None
البعثة	місія	Nan
البعد	вимір	Nan
البعض	дещо	None
البعيدة	далеко	None
البغدادي	аль-багдаді	Nan
البق	клопи	Nan
البصرية	візуальний	Nan
البقاء	залишайтеся	Nan
البصريات	оптика	Nan
البصرة	басра	Nan
البروتونات	протони	Nan
البروتين	білок	None
البروتينات	білки	None
البري	дикі	Nan
البرية	дикі	Nan
البريد	пошта	Nan
البريطاني	британці	Nan
البريطانية	британці	Nan
البريطانيون	британці	Nan
البريطانيين	британський	None
البسيط	простий	None
البسيطة	простий	None
البشر	люди	None
البشري	людська	Nan
البشرية	людство	None
البصري	оптичний	Nan
البقر	корова	Nan
البقرة	корова	Nan
البقعة	гладкий	Nan
البنك	банк	None
البنوك	банки	None
البنى	коричневий	Nan
البنية	структура	None
البهاء	пишність	Nan
البهائي	бахаї	Nan
البهائية	бахаї	Nan
البهائيون	бахаї	Nan
البهائيين	бахаї	Nan
البوابة	ворота	None
البوب	поп	Nan
البوذية	буддизм	None
البوسفور	босфор	Nan
البوسنة	боснія	Nan
البول	сеча	Nan
البنفسجية	фіолетовий	Nan
البنات	дівчата	Nan
البنائية	конструктивізм	Nan
البناء	будівництво	None
البكارة	дівочість	Nan
البكتيريا	бактерії	None
البكر	приштина	Nan
البلاد	країна	None
البلاغة	риторика	None
البلد	країна	None
البلدان	країни	None
البوم	сови	Nan
البلدة	місто	None
البلدية	муніципальний	Nan
البلدين	дві країни	Nan
البلطيق	прибалтики	Nan
البلغارية	болгарка	Nan
البلقان	балкани	Nan
البلوغ	статеве дозрівання	Nan
البنا	банна	Nan
البلديات	муніципалітети	Nan
الاثنين	понеділок	None
الحاجة	потреба	None
الحادث	інцидент	Nan
الروسي	росіянин	Nan
الروسية	російський	None
الروضة	дитячий садок	Nan
الروم	ром	Nan
الرومان	римляни	None
الرومانسية	романтика	Nan
الروماني	роман	None
الرومانية	румунська	Nan
الرومي	румі	Nan
الري	полив	Nan
الرياح	вітер	None
الرياض	ер-ріяд	Nan
الرياضات	спорт	None
الرياضة	спорт	None
الرياضي	спортсмен	Nan
الروس	росіяни	None
الرياضيات	математика	None
الروحية	духовна	None
الروح	дух	None
الركن	кут	None
الركود	застій	Nan
الرمال	пісок	Nan
الرمز	код	None
الرمزي	символічний	Nan
الرمزية	символіка	None
الرمل	пісок	Nan
الرملية	сенді	Nan
الرموز	значки	Nan
الرنا	рана	Nan
الرها	едесса	Nan
الرهبان	монахи	Nan
الروابط	посилання	None
الروايات	романи	None
الرواية	роман	None
الروحي	духовна	None
الركاب	пасажири	Nan
الرياضية	спорт	None
الريف	в сільській місцевості	Nan
الزهراء	захра	Nan
الزهرة	квітка	None
الزهري	сифіліс	Nan
الزهور	квіти	None
الزواج	одруження	Nan
الزواحف	рептилії	Nan
الزوار	відвідувачі	Nan
الزوايا	куточки	Nan
الزوج	чоловік	None
الزوجة	дружина	None
الزي	обмундирування	Nan
الزيادة	збільшення	None
الزيت	олія	Nan
الزيتون	оливки	Nan
الزيدية	заїді	Nan
الزمنية	хронологія	None
الريح	вітер	None
الزمني	хронологія	None
الزمرة	клік	Nan
الريفية	сільські	Nan
الزاوية	кут	None
الزبير	зубаїр	Nan
الزجاج	стакан	Nan
الزراعة	сільське господарство	Nan
الزراعي	сільськогосподарські	None
الزراعية	сільськогосподарські	None
الزرقاء	синій	None
الزعتر	чебрець	Nan
الزعماء	лідери	None
الزعيم	лідер	None
الزكاة	закат	Nan
الزلازل	землетруси	Nan
الزلزال	землетрус	Nan
الزمان	час	None
الزمن	час	None
الرقيق	вид	None
الرقم	кількість	None
الرقص	танок	Nan
الرئيسية	основна	None
الرائدة	провідна	None
الرابطة	nexus	Nan
الرابع	четвертий	None
الرابعة	четверте	Nan
الراحة	комфорт	Nan
الراحل	пізно	None
الراديو	радіо	None
الرازي	аль-разі	Nan
الراشدين	дорослі	Nan
الرافدين	месопотамія	Nan
الراقية	високого класу	Nan
الراهن	сьогодення	Nan
الرايخ	рейх	Nan
الرب	боже	Nan
الرئيسي	головний	None
الرباط	рабат	Nan
الرئيسة	президент	None
الرئة	легеня	Nan
الذكري	чоловік	None
الذكور	чоловік	None
الذهاب	збирається	Nan
الذهب	золото	None
الذهبي	золотий	None
الذهبية	золотий	None
الذي	котрий	None
الذين	чий	Nan
الرأس	голова	Nan
الرأسمالي	капіталістичний	Nan
الرأسمالية	капіталізм	Nan
الرأي	думка	None
الرؤية	зір	Nan
الرئاسة	президентство	Nan
الرئاسية	президентська	Nan
الرئيس	президент	None
الربح	прибуток	None
الربط	зв&#39;язок	Nan
الربع	чверть	None
الرسول	пророк	Nan
الرسولي	апостольський	Nan
الرسوم	збори	None
الرشيد	раціональне	Nan
الرصاص	вести	None
الرصافي	аль русафі	Nan
الرصد	моніторинг	None
الرضا	задоволення	None
الرطوبة	вологість	None
الرعاية	турбота	Nan
الرغبة	бажання	None
الرغم	хоч	None
الرفاعي	аль-ріфай	Nan
الرفض	неприйняття	Nan
الرقابة	контроль	None
الرسمية	офіційна	None
الرسمي	чиновник	Nan
الرسم	малюємо	Nan
الرسل	месенджери	Nan
الربيع	весна	None
الرتب	чини	Nan
الرجال	чоловіки	None
الرجل	чоловік	None
الرجوع	повернення	None
الرحالة	рюкзак	Nan
الرحلات	поїздки	None
السؤال	питання	None
الرحلة	подорож	None
الرحمة	милосердя	Nan
الرحمن	милосердний	Nan
الرحيم	милосердний	Nan
الرد	відповідь	None
الردة	відступництво	Nan
الرسائل	повідомлення	None
الرسالة	повідомлення	None
الرحم	матка	Nan
الذكر	поминання	Nan
السائد	переважаючий	Nan
السائل	рідина	Nan
السنوات	років	None
السنوريات	felidae	Nan
السنوي	щорічні	Nan
السنوية	щорічні	Nan
السني	суніт	Nan
السنية	суніт	Nan
السنين	роки	None
السنّة	рік	None
السهل	легко	None
السهول	рівнини	None
السوائل	рідини	Nan
السواحل	береги	None
السوبر	супер	Nan
السوداء	чорний	None
السودان	судан	Nan
السند	облігація	Nan
السوداني	суданський	Nan
السنة	рік	None
السمك	риба	None
السلطة	авторитет	None
السلطنة	султанат	Nan
السلع	товари	None
السلف	попередник	None
السلفية	салафізм	Nan
السلم	сходи	None
السلمية	спокійний	Nan
السلوك	поведінку	None
السلوكية	поведінкові	Nan
السليم	власне	None
السليمة	звук	None
السم	отрута	Nan
السماء	небо	None
السمات	особливості	None
السماح	дозволити	Nan
السن	вік	None
السلطانية	чаша	Nan
السودانية	суданський	Nan
السورة	сура	Nan
السيادة	суверенітет	None
السيارات	автомобілі	Nan
السيارة	машина	None
السياسات	політика	None
السياسة	політика	None
السياسي	політичні	None
السياسية	політичні	None
السياسيين	політики	None
السياق	контекст	Nan
السيد	майстер	None
السيدة	місіс	Nan
السير	прогулянка	Nan
السيرة	навчальна програма	Nan
السيطرة	контроль	None
السيف	меч	Nan
السياحية	туристична	Nan
السور	паркан	Nan
السياحي	туристична	Nan
السياح	туристи	Nan
السوري	сирійський	Nan
السورية	сирійський	Nan
السوفياتي	радянський	None
السوفياتية	радянські	None
السوفيتي	радянські	None
السوفيتية	радянські	None
السوفييت	рад	None
السوفييتي	радянський	None
السوق	ринок	None
السويد	швеція	None
السويدي	шведська	Nan
السويدية	шведська	Nan
السويس	суец	Nan
السويسري	швейцарський	Nan
السيئة	погані	Nan
السياحة	туризм	None
السلطان	султан	None
السلطات	владі	None
السلسلة	серія	None
السبت	субота	Nan
السبع	сім	None
السبعة	сім	None
السبعينات	сімдесяті роки	Nan
السبعينيات	сімдесяті роки	Nan
السبيل	шлях	None
الست	шість	None
الستة	шість	None
الستينات	шістдесятники	Nan
الستينيات	шістдесятники	Nan
السجن	тюрма	Nan
السجون	в&#39;язниці	Nan
السحابة	хмара	Nan
السحب	хмари	Nan
السد	гребля	Nan
السبب	причина	None
السديري	аль-судайрі	Nan
السباحة	плавання	None
السامة	токсичний	Nan
السائلة	рідина	Nan
السابع	сьомий	Nan
السابعة	сьомий	Nan
السابق	попередній	None
السابقة	попередній	None
السابقين	вих	Nan
الساحة	арена	Nan
الساحل	узбережжя	None
الساحلي	прибережні	Nan
الساحلية	прибережні	Nan
الساخنة	гарячий	Nan
السادات	садат	Nan
السادس	vi	None
الساعة	годинник	Nan
الساكنة	статичний	Nan
السامية	високий	None
السر	секрет	Nan
السرطان	рак	Nan
السرطانات	раки	Nan
السكر	цукор	Nan
السكري	діабет	Nan
السكك	залізничний	None
السكن	живу	Nan
السكنية	житлова	Nan
السلاجقة	сельджуки	Nan
السلاح	зброя	None
السلاسل	ланцюги	Nan
السلاطين	султани	Nan
السلالات	штам	Nan
السلالة	штам	Nan
السلام	мир	None
السلبي	пасивний	Nan
السلبية	негативність	Nan
السلة	кошик	Nan
السكانية	населення	None
السكاني	населення	None
السكان	населення	None
السفينة	корабель	None
السرطانية	передракові	Nan
السريانية	сирійський	Nan
السرية	конфіденційність	Nan
السريع	швидкий	None
السريعة	швидкий	None
السطح	дах	Nan
السطحية	поверхня	None
السائدة	переважаючий	Nan
السعادة	гаппінезе	Nan
السعودية	саудівська	Nan
السعي	переслідування	None
السفر	подорож	None
السفلى	нижній	None
السفلي	нижній	None
السفن	кораблі	None
السفير	посол	Nan
السعودي	саудівська	Nan
الذكاء	інтелект	Nan
الذرية	потомство	Nan
الذري	атомний	Nan
الحكم	судження	Nan
الحكمة	мудрість	None
الحكومات	уряди	None
الحكومة	уряд	None
الحكومي	уряд	None
الحكومية	уряд	None
الحكيم	мудрий	None
الحل	рішення	None
الحلفاء	союзники	Nan
الحلقات	епізоди	Nan
الحلقة	кільце	Nan
الحلم	мрія	Nan
الحلول	рішення	None
الحلي	прикраси	None
الحليب	молоко	Nan
الحكام	лінійки	Nan
الحليم	халім	Nan
الحقيقية	справжній	None
الحقيقة	істина	Nan
الحصول	отримайте	Nan
الحضارات	цивілізації	None
الحضارة	цивілізація	None
الحضاري	цивілізований	Nan
الحضرية	міська територія	Nan
الحظ	удача	Nan
الحظر	заборона	None
الحفاظ	тримайте	Nan
الحفلات	сторони	None
الحق	правильно	None
الحقائق	факти	None
الحقبة	зловити його	Nan
الحقل	поле	None
الحقوق	права	None
الحقول	поля	None
الحقيقي	справжній	None
الحصان	кінь	Nan
الحمام	туалет	Nan
الحماية	захист	None
الحين	зараз	None
الحيوان	тварина	Nan
الحيوانات	тварини	None
الحيوانية	тварина	Nan
الحيوي	біо	Nan
الحيوية	живучість	Nan
الخ	тощо	None
الخارج	зовні	Nan
الخارجي	зовнішній	None
الخارجية	зовнішні	None
الخاص	приватний	None
الخاصة	власний	None
الخاصية	власність	None
الخاضعة	тема	None
الخالق	творець	None
الحية	наживо	Nan
الحمامات	ванні кімнати	Nan
الحياد	нейтральність	Nan
الحي	район	None
الحمد	похвала	Nan
الحمر	пі	Nan
الحمراء	червоний	None
الحمض	кислота	Nan
الحمل	вагітність	Nan
الحملات	кампанії	None
الحملة	кампанія	None
الحميد	хамед	Nan
الحنبلي	хамбалі	Nan
الحنفي	ханафі	Nan
الحوادث	аварії	None
الحوار	діалог	None
الحواس	почуття	None
الحواسيب	комп&#39;ютери	Nan
الحوض	таз	Nan
الحياة	життя	None
الحصار	облога	Nan
الحشيش	газон	Nan
الحشرية	комаха	Nan
الحبيب	коханий	Nan
الحج	паломництво	Nan
الحجاب	завіса	Nan
الحجاج	паломники	Nan
الحجارة	камені	None
الحجاز	хіджаз	Nan
الحجة	аргумент	Nan
الحجر	камінь	None
الحجرية	камінь	None
الحجم	розмір	None
الحد	межа	None
الحدائق	сади	Nan
الحداثة	сучасність	None
الحدث	подія	None
الحدود	кордон	None
الحبوب	зерно	None
الحدودية	пограниччя	Nan
الحبل	шнур	Nan
الحب	кохання	None
الحادثة	нещасний випадок	Nan
الحار	теплий	Nan
الحارة	теплий	Nan
الحارث	мотоблок	Nan
الحاسوب	комп&#39;ютер	Nan
الحاصل	коефіцієнт	None
الحاضر	сьогодення	Nan
الحافظ	хранитель	Nan
الحافلات	автобуси	None
الحاكم	правитель	None
الحاكمة	постанова	Nan
الحال	прислівник	None
الحالات	справи	None
الحالي	подарунок	Nan
الحالية	поточний	Nan
الحبشة	ефіопія	Nan
الحديبية	туберкульоз	None
الحديث	розмова	Nan
الحديثة	сучасний	None
الحروب	війни	None
الحروف	букви	Nan
الحريات	свободи	None
الحرية	свобода	None
الحرير	шовк	Nan
الحريري	аль-харірі	Nan
الحزام	пояс	None
الحزب	вечірка	Nan
الحساب	рахунок	None
الحسن	хассан	Nan
الحسنة	добре	None
الحسين	elhussein	Nan
الحسيني	аль-хусейні	Nan
الحشرات	комахи	Nan
الحشرة	комаха	Nan
الحرمين	дві святі місця	Nan
الحرم	святилище	Nan
الحركة	рух	None
الحركات	рухи	None
الحديد	залізо	None
الحديدي	залізна людина	Nan
الحديدية	залізо	None
الحديقة	сад	None
الحذر	обережність	Nan
الحر	безкоштовно	Nan
الحرائق	пожежі	None
الخام	сирий	Nan
الحرارة	тепло	Nan
الحرارية	теплові	Nan
الحرب	війна	None
الحربي	аль-харбі	Nan
الحربية	військовий корабель	Nan
الحرة	безкоштовно	Nan
الحرس	охоронець	Nan
الحرف	персонаж	Nan
الحراري	теплові	Nan
الخامس	п&#39;ятий	Nan
الخامسة	п&#39;ятий	Nan
الخان	хан	None
الدفاع	оборона	None
الدفاعية	оборонний	Nan
الدقة	точність	None
الدقيق	борошно	Nan
الدقيقة	хвилинка	Nan
الدكتوراه	кандидат наук	Nan
الدلائل	довідники	Nan
الدلالة	вказівка	Nan
الدليل	посібник	None
الدم	кров	None
الدماء	кров	None
الدمار	знищення	None
الدماغ	мозок	None
الدمشقي	дамасцен	Nan
الدموية	кривавий	Nan
الدعوة	запрошення	None
الدنا	днк	None
الدعم	підтримка	None
الدعارة	проституція	Nan
الدجال	шарлатан	Nan
الدخان	дим	Nan
الدخل	дохід	None
الدخول	доступ	None
الدراسات	дослідження	None
الدراسة	навчання	None
الدراسية	навчання	None
الدراما	драма	None
الدرجات	сорти	None
الدرجة	клас	None
الدروز	друз	Nan
الدستور	конституція	None
الدستوري	конституційний	None
الدستورية	конституційний	None
الدعاء	молитися за	Nan
الدعاية	хайп	Nan
الدنمارك	данія	None
الدنيا	світ	None
الدهون	жири	Nan
الدين	релігія	None
الدينار	динар	Nan
الديناصور	динозавр	Nan
الديناصورات	динозаври	Nan
الدينية	релігійні	None
الديوان	діван	Nan
الديون	борги	Nan
الذئب	вовк	Nan
الذات	я	None
الذاتي	я	None
الذاتية	суб’єктивність	Nan
الذاكرة	пам&#39;ять	Nan
الذرات	атоми	None
الذراع	рука	Nan
الذرة	кукурудза	Nan
الديموقراطية	демократія	None
الديموغرافيا	демографія	None
الديمقراطية	демократія	None
الديمقراطيات	демократії	None
الدوائر	кола	None
الدوافع	мотивація	Nan
الدوحة	доха	Nan
الدور	роль	None
الدوران	обертання	None
الدورة	курс	None
الدوري	ліга	None
الدجاج	курка	Nan
الدورية	періодичність	Nan
الدولة	країна	None
الدولتين	дві держави	Nan
الدولية	міжнародний	None
الديار	головна	None
الديانات	релігії	None
الديانة	релігія	None
الديمقراطي	демократ	Nan
الدول	країни	None
الحادة	гострий	Nan
الدبلوماسية	дипломатія	Nan
الدار	будинок	None
الخط	лінія	None
الخطأ	помилка	Nan
الخطة	план	None
الخطر	небезпека	Nan
الخطط	плани	None
الخطوات	сходи	None
الخطوة	крок	None
الخطوط	лінії	None
الخطيب	хатиб	Nan
الخطيرة	серйозний	Nan
الخفيفة	світло	None
الخلاص	порятунок	Nan
الخلافات	відмінності	None
الخلافة	речення	None
الخلايا	клітини	None
الخضراء	зелений	None
الخلف	назад	None
الخصيب	родючі	Nan
الخصوبة	народжуваність	None
الخانات	цифри	Nan
الخبر	новини	None
الخبراء	експерти	None
الخدمات	послуги	None
الخدمة	сервіс	Nan
الخديوي	хедів	Nan
الخرائط	карти	None
الخروج	вхід	None
الخريطة	карта	None
الخسائر	втрати	None
الخشب	ліс	None
الخشبية	вуді	Nan
الخصائص	властивості	None
الخصبة	пишні	Nan
الخصم	знижка	Nan
الخصوص	особливо	None
الخلفاء	халіфи	Nan
الخلفية	фон	None
الخلق	створення	None
الخوف	страх	None
الخيال	уява	Nan
الخيالة	монтується	Nan
الخيام	намети	Nan
الخير	добре	None
الخيرية	благодійність	Nan
الخيل	кінь	Nan
الخيول	коні	None
الدائرة	коло	None
الدائري	каблучка	Nan
الدائم	постійний	None
الدائمة	стоячи	Nan
الداخل	всередині	None
الداخلي	порядок	None
الداخلية	інтер&#39;єр	Nan
الخواص	властивості	None
الخوارزمي	алхаваризм	Nan
الخوارج	харійці	Nan
الخندق	траншея	Nan
الخلوي	стільниковий	Nan
الخلوية	стільниковий	Nan
الخلية	клітина	None
الخليج	затока	None
الخليجي	аль-халіджі	Nan
الخليجية	затока	None
الخليفة	халіф	Nan
الدانوب	дунай	None
الخليل	геброн	Nan
الخمس	п&#39;ять	Nan
الخمسة	п&#39;ять	Nan
الخمسينات	п’ятдесяті роки	Nan
الخمسينيات	п’ятдесяті роки	Nan
الخميس	четвер	Nan
الخنازير	свині	Nan
الخنافس	жуки	Nan
الخمر	вино	None
الاثني	етнічність	Nan
الاتهام	звинувачення	None
الاتفاقية	угоду	None
أنهما	вони є	Nan
أنهى	закінчити	Nan
أنواع	види	None
أنواعها	її види	Nan
أنوبيس	анубіс	None
أنور	анвар	Nan
أني	це я	Nan
أنّ	що	None
أنّه	це	None
أهالي	люди	None
أهداف	цілі	None
أهدافها	її цілі	Nan
أهل	люди	None
أهله	його сім&#39;я	Nan
أهلها	її сім&#39;я	Nan
أنهم	що вони	Nan
أهلية	придатність	Nan
أنهار	він обвалився	Nan
أنه	це	None
أنس	анас	Nan
أنسجة	тканина	Nan
أنشأت	встановлено	None
أنشئ	створіть	Nan
أنشئت	встановлено	None
أنشطة	діяльності	None
أنصار	прихильники	None
أنطاكية	антіохія	Nan
أنظر	подивіться	Nan
أنظمة	системи	None
أنفسهم	себе	None
أنقرة	анкара	None
أنك	що ти є	Nan
أنماط	візерунки	Nan
أننا	це ми	Nan
أنها	це	None
أندية	клуби	None
أهم	найбільш важливим	Nan
أهمية	важливість	Nan
أوسع	ширші	Nan
أوسلو	осло	Nan
أوصى	я рекомендую	Nan
أوضاع	режими	None
أوضح	пояснив	Nan
أوضحت	вона пояснила	Nan
أوقات	часи	None
أوقطاي	мій час	Nan
أوكرانيا	україна	None
أول	перший	None
أولئك	ті	None
أولا	перший	None
أولاد	діти	None
أولاده	його діти	Nan
أولاً	перший	None
أوساط	змі	None
أهمها	найбільш важливим	Nan
أوروبية	європейський	None
أوروبا	європа	None
أهميتها	його значення	Nan
أو	або	None
أوائل	рано	None
أواخر	пізно	None
أواسط	середній	None
أوامر	накази	Nan
أوامره	його накази	Nan
أوباما	обама	None
أوبرا	опра	Nan
أوج	апогей	Nan
أوجه	ація	Nan
أوراق	листя	None
أورانوس	уран	Nan
أورخان	орхан	Nan
أورشليم	єрусалим	Nan
أوروبي	європейський	None
أنحاء	над	None
أنجلوسكسونيون	анджелессіон	Nan
أنجبت	народила	Nan
ألعاب	іграшки	Nan
ألف	тисяч	None
ألفا	альфа	Nan
ألفًا	альфа	Nan
ألقاب	псевдоніми	Nan
ألقى	скинути	Nan
ألكسندر	олександр	None
ألكيل	алкил	Nan
ألمانيا	німеччина	None
ألمانية	німецька	None
ألوان	кольори	None
أم	мати	None
أما	що стосується	Nan
أماكن	місця	None
أمام	до цього	Nan
ألدهيد	альдегід	Nan
أمامه	перед нею	Nan
ألبوم	альбом	None
ألبانيا	албанія	Nan
أقوى	більш потужний	Nan
أقيم	я залишаюсь	Nan
أقيمت	зведений	Nan
أكاديمية	академії	None
أكان	акань	Nan
أكتوبر	жовтень	None
أكثر	більше	None
أكثرها	більшість його	Nan
أكد	підтверджено	Nan
أكدت	вона підтвердила	Nan
أكسيد	оксид	Nan
أكل	їли	Nan
أكمل	повна	None
ألا	за винятком	Nan
ألاسكا	аляска	Nan
ألبرت	альберт	None
أمانة	чесність	Nan
أمة	його мама	Nan
أمثال	любить	None
أمور	речі	None
أمية	неграмотність	Nan
أمير	принц	Nan
أمين	надійний	Nan
أمّا	що стосується	Nan
أن	що	None
أنا	мені	None
أنابيب	трубки	Nan
أناكوندا	анаконда	Nan
أنباء	новини	None
أنبياء	пророки	Nan
أنت	ти є	Nan
أنتج	виробляється	Nan
أنتجت	виробляється	Nan
أنثى	жіночий	None
أموال	кошти	None
أمه	його мама	Nan
أمن	безпека	Nan
أمم	нації	None
أمثلة	приклади	None
أمر	командування	None
أمرا	замовлення	None
أمراء	князі	None
أمراض	хвороби	None
أمره	його командування	Nan
أمرهم	він наказав їм	Nan
أولها	перший з них	Nan
أمريكا	сша	None
أمريكية	американський	None
أمريكيون	американці	Nan
أمرًا	замовлення	None
أمطار	дощ	Nan
أمفورة	амфора	Nan
أمكن	можливо	None
أمل	надійний	Nan
أمريكي	американський	None
أقواله	його приказки	Nan
أولى	перший	None
أوّل	перший	None
إلهام	важливо	None
إلى	мені	None
إلي	мені	None
إليك	тобі	None
إلينا	до нас	Nan
إليه	механізм	None
إليها	їй	None
إليهم	їм	None
إم	мати	None
إما	що стосується	Nan
إمارة	емірат	Nan
إمام	до цього	Nan
إمبراطور	імператор	None
إمبراطورية	імперія	None
إمكانية	можливість	None
إله	машина	None
إنا	мені	None
إلقاء	кинути	Nan
إلاّ	за винятком	Nan
إطلاق	звільнення	None
إعادة	повернення	None
إعداد	підготовка	None
إعطاء	дайте	Nan
إعلامية	інформативний	Nan
إعلان	реклама	None
إف	ж	None
إفراز	секреція	Nan
إفريقيا	африка	None
إفريقية	африканський	Nan
إقامة	проживання	None
إقليم	провінція	None
إقليمية	регіональний	None
إل	the	Nan
إلا	за винятком	Nan
إلغاء	скасування	None
إطار	рамка	Nan
إنتاج	виробляти	Nan
إنتاجها	їх виробництво	Nan
إياها	це	None
إيجاد	знахідка	Nan
إيران	іран	None
إيرث	земля	None
إيطاليا	італія	None
إيفان	іван	None
إيفل	ейфелева	Nan
إيقاف	відключення	Nan
إيه	вірш	None
إِلا	за винятком	Nan
إِلَى	мені	None
ا	а	None
ابتداء	початок	None
ابتناء	анаболізм	Nan
ابن	сину	Nan
إياه	його	None
إنتاجه	виробляють це	Nan
إنّ	що	None
إنهم	що вони	Nan
إنترنت	інтернет	None
إنجازات	досягнення	None
إنجلترا	англія	None
إنجليزية	англійська	None
إنجيل	євангеліє	None
إندونيسيا	індонезія	None
إنسان	людина	None
إنسانية	гуманний	Nan
إنشاء	нарощувати	Nan
إنشائها	створіть їх	Nan
إنفلونزا	грип	Nan
إنكار	заперечення	None
إنما	швидше	None
إنها	це	None
إنهاء	закінчення	None
إني	мені	None
إضافية	додатковий	Nan
إضافةً	доповнення	None
إضافة	доповнення	None
أَنْ	що	None
إبادة	винищення	Nan
إبان	під час	Nan
إبراهيم	ібрагім	Nan
إثارة	хвилювання	Nan
إثبات	доказ	Nan
إثر	ефект	None
إثيوبيا	ефіопія	Nan
إجراء	порядок	None
إجراءات	процедури	None
إجماع	консенсус	Nan
إجمالي	всього	None
إحباط	розчарування	Nan
إحداث	події	None
إحدى	один	None
أَنَّ	що	None
إحصاء	підрахунок	Nan
أيوب	аюб	Nan
أينشتاين	ейнштейн	None
أى	котрий	None
أي	котрий	None
أيام	днів	None
أيامه	його дні	Nan
أيبك	айбак	Nan
أية	вірш	None
أيدي	руки	None
أيديهم	їх руки	Nan
أيرلندا	ірландія	None
أيضا	також	None
أيضاً	також	None
أيضًا	також	None
أيلول	вересень	None
أيمن	еймен	Nan
أين	де	None
أيها	гей	Nan
إحصاءات	статистика	None
إحصائيات	статистика	None
إحياء	біологія	Nan
إسرائيل	ізраїль	None
إسطنبول	стамбул	Nan
إسقاط	проекція	Nan
إسلام	іслам	None
إسلامه	його іслам	Nan
إسلامي	ісламі	Nan
إسلامية	ісламська	Nan
إسماعيل	ісмаїл	Nan
إشارات	сигнали	Nan
إشارة	сигнал	Nan
إشعاع	випромінювання	None
إصابة	інфекція	Nan
إصدار	видача	Nan
إصلاح	ремонт	Nan
إصلاحات	ремонт	Nan
إسحاق	ісаак	Nan
إستراتيجية	стратегія	Nan
إسبانيا	іспанія	None
إس	s.	Nan
إخراج	режисер:	Nan
إخوته	його брати	Nan
إدارة	управління	None
إداري	адміністративна	None
إدارية	адміністративна	None
إدخال	введіть	Nan
إدراك	реалізація	None
أولية	попередній	None
إذ	тому	None
إذاعة	мовлення	None
إذن	вухо	Nan
إرادة	буде	None
إرتريا	еритрея	Nan
إرسال	надіслати	Nan
إرهابية	терористичний	Nan
إزالة	видалення	Nan
إذا	якщо	None
أقوال	приказки	Nan
أقمار	місяці	None
أقلية	меншість	Nan
أحسن	найкраще	None
أحكام	положення	None
أحلام	мрії	Nan
أحمد	ахмад	Nan
أحمدي	ахмаді	Nan
أحمر	червоний	None
أحوال	умови	None
أحياء	біологія	Nan
أحيان	іноді	None
أحيانا	іноді	None
أحياناً	іноді	None
أحيانًا	іноді	None
أخاه	його брат	Nan
أخبار	новини	None
أخت	сестра	None
أحزاب	сторони	None
أخته	його сестра	Nan
أحدهما	один з них	Nan
أحدث	останній	None
أجريت	проводиться	None
أجزاء	частини	None
أجسام	органи	None
أجل	так	None
أجمع	я збираю	Nan
أجمل	найкрасивіший	Nan
أجنبية	іноземна жінка	Nan
أجنحة	крила	None
أجهزة	прилади	None
أحادي	неодружений	Nan
أحاديث	хадиси	Nan
أحب	я кохаю	Nan
أحجية	пазл	Nan
أحد	один	None
أحداث	події	None
أحدهم	хтось	None
أجرى	йти бігти	Nan
أخذ	приймаючи	Nan
أخر	ще	None
أدوار	приміщення	None
أدولف	адольф	Nan
أدوية	препарати	Nan
أدى	світлодіодний	Nan
أدّت	світлодіодний	Nan
أدّى	виконується	None
أذربيجان	азербайджан	None
أراد	хочу	None
أرادت	вона хоче	Nan
أراض	землі	None
أراضي	землі	None
أراضيها	його територія	Nan
أرباع	квартали	Nan
أربع	четверо	Nan
أربعة	чотири	None
أدنى	мінімум	None
أخذت	я взяв	Nan
أدناه	внизу	Nan
أدرك	усвідомив	Nan
أخرج	забирайся	Nan
أخرى	інший	None
أخطاء	помилки	None
أخطر	найнебезпечніший	Nan
أخلاقية	етичні	None
أخوه	брати	None
أخيرا	нарешті	None
أخيه	його брат	Nan
أخيون	брат	None
أداء	виконання	None
أداة	інструмент	None
أدب	література	None
أدبية	літературні	None
أدت	світлодіодний	Nan
أدخل	введіть	Nan
أدلة	підказки	Nan
أجراها	зроблено	None
أجرام	злочин	None
أجبر	примусово	Nan
آلات	машини	None
آلاف	тисячі	None
آلام	мати	None
آلة	машина	None
آلهة	боги	None
آلية	механізм	None
آمن	безпека	Nan
آمنة	сейф	Nan
آمون	амон	Nan
آن	що	None
آنذاك	в той час	Nan
آي	котрий	None
آيات	вірші	None
آية	вірш	None
أ	а	None
آل	the	Nan
أئمة	імамам	Nan
آشوربانيبال	ашурбаніпал	Nan
آسكي	ascii	Nan
+	+	Nan
=	=	Nan
==	==	Nan
|	|	Nan
°	°	Nan
°م	° c	Nan
آثار	ефекти	Nan
آثارها	його наслідки	Nan
آخر	ще	None
آخرها	найсвіжіші	Nan
آخرون	інші	None
آخرين	інші	None
آخيل	ахілл	Nan
آدم	адам	None
آراء	думки	None
آسيا	азії	None
أب	батько	None
أبا	оппа	Nan
أباتيت	апатит	None
أتاتورك	ататюрк	Nan
أتباع	наступні	None
أتباعه	його послідовники	Nan
أتت	прийшов	None
أتى	прийшов	None
أثار	ефекти	Nan
أثارت	збуджений	Nan
أثبت	доведено	Nan
أثبتت	демонстрували	Nan
أثر	ефект	None
أثرت	постраждали	Nan
أثره	його дія	Nan
أثرية	античний	Nan
أثناء	під час	Nan
أثينا	афіна	Nan
أبيه	його батько	Nan
أبيب	тел	None
أبي	мій батько	Nan
أبى	мій батько	Nan
أباه	його тато	Nan
أبحاث	дослідження	None
أبدا	старт	Nan
أبداً	старт	Nan
أبدًا	старт	Nan
أبرز	найпомітніший	Nan
أبرزها	найпомітніший	Nan
أربعين	сорок	Nan
أبريل	квітень	None
أبعد	далеко	None
أبناء	діти	None
أبنائه	його сини	Nan
أبو	абу	Nan
أبواب	двері	Nan
أبوظبي	абу-дабі	Nan
أبوه	його тато	Nan
أبطال	чемпіони	Nan
أرجاء	відкладено	Nan
أرخبيل	архіпелаг	None
أرخميدس	архімед	None
أعداء	вороги	Nan
أعدائه	його вороги	Nan
أعداد	підготовка	None
أعراض	синдром	Nan
أعضاء	члени	None
أعطى	дав	None
أعظم	найбільший	None
أعقاب	після	None
أعلام	прапори	Nan
أعلاه	вище	None
أعلم	я знаю	Nan
أعلن	реклама	None
أعلنت	вона оголосила	Nan
أعلى	зверху	None
أعمال	бізнес	None
أعاد	повторити	Nan
أعماله	його твори	Nan
أظهرت	я показав	Nan
أطول	найдовший	Nan
أصله	її походження	Nan
أصلها	її походження	Nan
أصوات	голоси	Nan
أصول	витоки	None
أصيب	був травмований	Nan
أضاف	він додав	Nan
أضخم	найбільший	None
أضرار	пошкодження	Nan
أضعاف	подвійний	Nan
أضلاع	ребра	Nan
أطراف	сторони	None
أطفال	діти	None
أطلق	відпустіть	Nan
أطلقت	запущено	Nan
أطوال	довжини	None
أظهر	проявити	Nan
أعمالها	її бізнес	Nan
أعمدة	стовпці	Nan
أعوام	роки	None
أفلام	фільми	None
أفلامه	його фільми	Nan
أفندي	ефенді	Nan
أقاليم	території	None
أقام	залишайтеся	Nan
أقبل	прийміть	Nan
أقدم	найстаріший	Nan
أقر	пройшов	None
أقرب	ближче	None
أقسام	розділи	None
أقصر	коротше	Nan
أقصى	максимум	Nan
أقطار	діаметри	Nan
أقل	менше	None
أقليات	меншини	Nan
أفلاطون	платон	None
أفكاره	його думки	Nan
أفكار	думки	None
أفغانستان	афганістан	Nan
أعيد	був повернутий	Nan
أغاني	пісні	None
أغراض	цілі	None
أغسطس	серпень	None
أغلب	найбільше	None
أغلبها	більша частина	Nan
أغلبية	більшість	None
أصلاً	спочатку	None
أغنى	найбагатший	Nan
أفراد	фізичні особи	Nan
أفرادها	її члени	Nan
أفرودة	афрода	Nan
أفريقيا	африка	None
أفريقية	африканський	Nan
أفضل	найкраще	None
أفعال	дієслова	None
أغنية	пісня	None
ابنة	дочка	None
أصلا	спочатку	None
أصفر	жовтий	None
أساسًا	в основному	Nan
أساليب	техніки	None
أسامة	оссама	Nan
أسباب	причини	None
أسبانيا	іспанія	None
أسبوع	тиждень	None
أستاذ	професор	Nan
أستراليا	австралія	None
أسد	лев	None
أسر	захоплення	None
أسرار	секрети	Nan
أسرة	сім&#39;я	Nan
أسرته	його сім&#39;я	Nan
أسرع	швидше	None
أسس	встановити	None
أساسية	основні	None
أسست	заснований	None
أساسيا	основні	None
أساساً	в основному	Nan
أرسطو	арістотель	None
أرسل	надіслати	Nan
أرسلان	арслан	Nan
أرسلت	я надіслав	Nan
أرسله	відправити	Nan
أرض	земля	None
أرضية	підлогу	Nan
أرقام	числа	None
أركان	стовпи	Nan
أرمينيا	вірменія	None
أزمة	криза	None
أس	туз	Nan
أسابيع	тижні	None
أساس	основа	None
أساسا	в основному	Nan
أساسي	основні	None
أسسها	заснував це	Nan
أسطورة	легенда	None
أسطول	флот	None
أشد	жорсткіше	Nan
أشرف	ашраф	Nan
أشعة	промені	Nan
أشكال	форми	None
أشهر	місяці	None
أشهرها	найвідоміший	None
أشياء	речі	None
أصابع	пальці	Nan
أصبح	став	None
أصبحوا	вони стали	Nan
أصحاب	друзі	Nan
أصحابه	товариші	Nan
أصدر	виданий	None
أصدرت	виданий	None
أصغر	менший	None
أشخاص	люди	None
أشجار	дерева	None
أشبه	більше, як	Nan
أشارت	вона вказала	Nan
أسعار	ціни	None
أسعد	найщасливіші	Nan
أسفر	вихід	None
أسفرت	поступився	Nan
أسفل	вниз	Nan
أسلحة	зброї	None
أسلم	безпечніше	Nan
أصل	походження	None
أسلوب	стиль	None
أسمهان	асмахан	Nan
أسهم	запаси	None
أسوأ	найгірший	Nan
أسوار	забори	Nan
أسواق	ринки	None
أسود	чорний	None
أشار	зазначив	Nan
أسماء	імена	None
ابنته	його дочка	Nan
ابنه	дочка	None
ابي	мій батько	Nan
الأمد	тривалість	None
الأمر	причина	None
الأمراء	князі	None
الأمراض	хвороби	None
الأمريكتين	америки	None
الأمريكي	американський	None
الأمريكية	американський	None
الأمريكيون	американці	Nan
الأمريكيين	американці	Nan
الأمصار	циклони	Nan
الأمطار	дощ	Nan
الأمعاء	кишечник	Nan
الأمل	надія	None
الأملاح	солі	None
الأمم	нації	None
الأمثلة	приклади	None
الأمن	безпека	Nan
الأمثال	прислів’я	Nan
الأمانة	чесність	Nan
الألبانية	албанська	Nan
الألف	аліф	Nan
الألفية	тисячоліття	None
الألم	біль	None
الألمان	німців	None
الألماني	німецька	None
الألمانية	німецька	None
الألواح	тарілки	Nan
الألوان	кольори	None
الأم	мати	None
الأمازيغ	бербери	Nan
الأمازيغية	tamazight	Nan
الأماكن	місця	None
الأمام	вперед	None
الأمان	безпека	Nan
الأمة	нація	None
الألبان	молочна	Nan
الأمنية	бажання	None
الأموال	гроші	None
الأندية	клуби	None
الأنسجة	тканина	Nan
الأنسولين	інсулін	Nan
الأنشطة	діяльності	None
الأنصار	ансар	Nan
الأنصاري	аль ансарі	Nan
الأنطروبولوجيا	антропологія	Nan
الأنظمة	системи	None
الأنف	ніс	Nan
الأنفاق	тунелі	Nan
الأنماط	стилі	None
الأنهار	річки	None
الأنواع	види	None
الأهالي	батьки	None
الأهداف	цілі	None
الأندلس	андалус	Nan
الأمواج	хвилі	None
الأنثى	самка	Nan
الأنبياء	пророки	Nan
الأمور	речі бувають	Nan
الأموي	умаяд	Nan
الأموية	умаяд	Nan
الأمويون	омейяди	Nan
الأمويين	омейяди	Nan
الأمية	неграмотність	Nan
الأمير	принц	Nan
الأميرة	принцеса	Nan
الأميركي	американський	None
الأميركية	американський	None
الأمين	секретар	None
الأنا	его	None
الأناجيل	біблії	None
الأناضول	анатолія	Nan
الأنباء	новини	None
الأنثروبولوجيا	антрополог	Nan
الألب	альпи	Nan
الأكسجين	кисень	None
الأكراد	курди	Nan
الأصول	витоки	None
الأضحى	аль-адха	Nan
الأضرار	пошкодження	Nan
الأضلاع	ребра	Nan
الأطباء	лікарі	None
الأطباق	страви	None
الأطراف	сторони	None
الأطرش	атраш	Nan
الأطعمة	продукти харчування	Nan
الأطفال	діти	None
الأطلس	атлас	Nan
الأطلسي	атлантичний	None
الأعداء	вороги	Nan
الأعداد	підготовка	None
الأعراض	симптоми	Nan
الأصوات	звуки	None
الأعراق	етноси	Nan
الأصناف	різновиди	None
الأصليون	рідні	Nan
الأشجار	дерева	None
الأشخاص	особи	None
الأشراف	нагляд	Nan
الأشرف	ашраф	Nan
الأشعة	промені	Nan
الأشعري	аль-аш&#39;арі	Nan
الأشكال	форми	None
الأشهر	місяці	None
الأشياء	речі	None
الأصدقاء	друзі	Nan
الأصغر	найменший	Nan
الأصفر	жовтий	None
الأصل	походження	None
الأصلي	оригінальний	None
الأصلية	оригінальний	None
الأصليين	корінні	Nan
الأعشاب	трави	Nan
الأعصاب	нерви	Nan
الأعضاء	члени	None
الأفلام	фільми	None
الأفيون	опіум	Nan
الأقاليم	території	None
الأقدس	найсвятіший	Nan
الأقدم	найстаріший	Nan
الأقرب	найближчий	Nan
الأقسام	розділи	None
الأقصى	далеко	None
الأقطار	діагоналі	Nan
الأقل	найменший	Nan
الأقليات	меншини	Nan
الأقمار	місяці	None
الأقوال	приказки	Nan
الأكاديمية	академія	None
الأكبر	найбільший	None
الأفكار	ідеї	None
الأفغاني	афганський	Nan
الأفعال	дії	None
الأفضل	найкраще	None
الأعظم	найбільша	None
الأعلام	змі	None
الأعلى	вище	None
الأعمال	бізнес	None
الأعمدة	стовпці	Nan
الأعوام	роки	None
الأغالبة	аглабіди	Nan
الأهرام	піраміди	None
الأغاني	пісні	None
الأغراض	речі	None
الأغلب	переважно	None
الأغلبية	більшість	None
الأغنية	пісня	None
الأفراد	фізичні особи	Nan
الأفريقي	африканський	Nan
الأفريقية	африканський	Nan
الأغذية	їжа	Nan
الأهرامات	піраміди	None
الأهلي	аль-ахлі	Nan
الأهلية	придатність	Nan
الإقليمي	регіональний	None
الإقليمية	регіональний	None
الإلحاد	атеїзм	Nan
الإلكترون	електрон	Nan
الإلكترونات	електрони	None
الإلكترونية	е	None
الإله	бог	None
الإلهي	божественне	Nan
الإلهية	божественне	Nan
الإمارات	оае	Nan
الإمارة	емірат	Nan
الإمامة	імамат	Nan
الإمامية	імамі	Nan
الإمبراطور	імператора	None
الإمبراطورية	імперія	None
الإقليم	територія	None
الإمدادات	поставки	Nan
الإقامة	проживання	None
الإفريقي	африканський	Nan
الإصابة	травма	Nan
الإصدار	відпустіть	Nan
الإصلاح	виправити	Nan
الإصلاحات	ремонт	Nan
الإصلاحية	виправні	Nan
الإطار	каркас	Nan
الإطلاق	запуск	Nan
الإعدام	виконання	None
الإعلام	змі	None
الإعلامي	інформативний	Nan
الإعلان	реклама	None
الإعلانات	оголошення	None
الإغريق	греки	None
الإغريقي	грецька	None
الإغريقية	грецька	None
الإفريقية	африканський	Nan
الإناث	самка	Nan
الإنتاج	виробництво	None
الإنتاجية	продуктивність	None
الإيطاليين	італійці	Nan
الإيمان	віра	None
الا	за винятком	Nan
الائتلاف	коаліція	None
الابتدائي	первинний	Nan
الابتدائية	первинний	Nan
الابن	сину	Nan
الاتجاه	напрямок	None
الاتجاهات	directione	Nan
الاتحاد	союз	None
الاتحادية	федеральний	None
الاتصال	з&#39;єднання	Nan
الاتصالات	телекомунікації	Nan
الاتفاق	угода	None
الاتفاقيات	угоди	None
الإيطالية	італійська	None
الإيطالي	італійська	None
الإيرانية	іранський	Nan
الإيراني	іранський	Nan
الإنترنت	інтернет	None
الإنجليز	англійська	None
الإنجليزي	англійська	None
الإنجليزية	англійська	None
الإنجيل	євангеліє	None
الإنسان	людська	Nan
الإنساني	людська	Nan
الإشعاعي	рентгенологічне	Nan
الإنسانية	людство	None
الإنفاق	витрати	None
الإنفلونزا	грип	Nan
الإنكشارية	яничари	Nan
الإنكليزي	англійська	None
الإنكليزية	англійська	None
الإيجابية	позитивне	Nan
الإيدز	снід	None
الإنشاء	створення	None
الأسود	чорний	None
الإشعاع	випромінювання	None
الإسماعيلية	ісмаїлія	Nan
الأوقات	разів	None
الأوكراني	українська	None
الأوكرانية	українська	None
الأول	перший	None
الأولمبية	олімпійський	None
الأولى	перший	None
الأولي	початкові	Nan
الأولية	первинний	Nan
الأيام	дні	None
الأيبيرية	іверський	Nan
الأيسر	зліва	None
الأيمن	правильно	None
الأيوبي	аль-аюбі	Nan
الأيوبية	айюбід	Nan
الإباحية	порнографія	Nan
الأوعية	чаші	Nan
الإبادة	винищення	Nan
الأوضاع	умови	None
الأوسط	середній	None
الأهم	більш важливим	Nan
الأهمية	важливість	Nan
الأوائل	зверху	None
الأوامر	команди	None
الأوبرا	опера	None
الأودية	долини	None
الأوراق	листя	None
الأورام	пухлини	Nan
الأوربية	європейський	None
الأوروبي	європейський	None
الأوروبية	європейський	None
الأوروبيون	європейці	Nan
الأوروبيين	європейці	Nan
الأوزون	озон	Nan
الأوساط	кола	None
الأوسمة	прикраси	None
الإباضية	ібаді	Nan
الإبداع	творчість	None
الإبراهيمية	авраамічний	Nan
الإرادة	буде	None
الإرشاد	консультування	Nan
الإرهاب	тероризм	Nan
الإسبان	іспанець	Nan
الإسباني	іспанець	Nan
الإسبانية	іспанська	None
الإسراء	ісра	Nan
الإسرائيلي	ізраїльські	Nan
الإسرائيلية	ізраїльські	Nan
الإسرائيليين	ізраїльтяни	Nan
الإسكندر	олександр	None
الإسكندرية	олександрія	Nan
الإسلام	іслам	None
الإسلامي	ісламська	Nan
الإسلامية	ісламська	Nan
الإذاعة	радіо	None
الإدعشري	ель-адхарі	Nan
الإدارية	адміністративна	None
الإداري	адміністративна	None
الإبل	верблюди	Nan
الإتحاد	союз	None
الإثارة	хвилювання	Nan
الإثنين	понеділок	None
الإجابة	відповідь	None
الإجراءات	заходи	None
الإجماع	консенсус	Nan
الإشارات	знаки	None
الإجمالي	всього	None
الإحساس	сенсація	Nan
الإحصاء	статистика	None
الإحصاءات	статистика	None
الإحصائيات	статистика	None
الإحصائية	статистичні	None
الإخوان	братство	None
الإدارة	адміністрація	None
الإجمالية	всього	None
السينما	кіно	None
الأسواق	ринки	None
الأسمدة	добрива	None
استقرار	стабільність	None
استقرت	оселився	Nan
استقلال	незалежність	None
استقلالها	її незалежність	Nan
استكشاف	розвідка	Nan
استمر	продовжувати	None
استمرار	продовження	None
استمرت	продовження	None
استنادا	на основі	Nan
استنادًا	на основі	Nan
استهلاك	споживання	None
استولى	вилучено	Nan
استيراد	імпорт	None
اسم	іменник	None
اسمه	його назва	Nan
استقر	осідати	Nan
اسمها	її ім&#39;я	Nan
استقبال	приймання	Nan
استفتاء	референдум	Nan
استخراج	витяг	Nan
استراتيجية	стратегія	Nan
استرجاع	одужання	Nan
استسلام	здатися	Nan
استسلمت	я здався	Nan
استضافة	хостинг	Nan
استطاع	міг	None
استطاعت	їй вдалося	Nan
استطلاع	розвідка	Nan
استعادة	відновлення	None
استعداد	готовий	None
استعمال	використання	None
استعمالها	використай це	Nan
استعمل	використання	None
استغلال	експлуатувати	Nan
استقالته	його відставка	Nan
استخدمها	використай це	Nan
اشتد	інтенсифікуйте	Nan
اشتهر	найбільш відомі	Nan
اعتمادا	залежно	None
اعتمد	покладатися	Nan
اعتمدت	прийнято	None
اعتناق	обійми	Nan
اعتنق	обняв	Nan
اغتيال	вбивство	None
اغتياله	його вбивство	Nan
افتتاح	відкриття	None
افتتح	відкрили	None
افتتحت	я відкрив	Nan
اقتراب	підхід	None
اقتراح	пропозиція	None
اقترح	підказати	Nan
اقتصاد	економ	Nan
اقتصادها	її економіка	Nan
اعتماد	схвалення	Nan
اشتراكية	соціалізм	None
اعتقد	подумайте	Nan
اعتقاد	віра	None
اشتهرت	вона стала відомою	Nan
اصدار	видача	Nan
اضطر	примусово	Nan
اضطراب	порушення	None
اضطرابات	порушення	None
اضطهاد	переслідування	None
اعادة	повернення	None
اعتبار	розгляд	None
اعتبارا	ефект	None
اعتباراً	розглянемо	Nan
اعتبارها	розум	None
اعتبر	розглянуто	Nan
اعتبرت	розглянуто	Nan
اعتراف	визнання	None
اعترف	я визнаю	Nan
اعتقال	арешт	None
استخدمت	вживали	None
استخدم	використання	None
استخدامها	використай це	Nan
اتهام	звинувачення	None
اتهم	звинувачувати	Nan
اثنان	два	None
اثنتين	два	None
اثنين	два	None
اجتماع	зустріч	None
اجتماعات	зустрічі	None
اجتماعي	соціальний	None
اجتماعية	соціальна	None
اجتمع	зустрівся	Nan
اجتياح	вторгнення	None
اجل	так	None
احتراق	горіння	Nan
احترام	повага	Nan
احتفظ	тримати	None
اتفق	домовились	Nan
احتل	зайняти	Nan
اتفاقية	угоду	None
اتفاق	угода	None
اتباع	наступні	None
اتباعه	його послідовники	Nan
اتبع	слідкувати далі	Nan
اتجاه	напрямок	None
اتجاهات	тенденції	None
اتجه	поворот	Nan
اتحاد	союз	None
اتخاذ	приймати	None
اتخذ	було прийнято	Nan
اتخذت	забрано	Nan
اتساع	вшир	Nan
اتسعت	розширений	Nan
اتسمت	був відзначений	Nan
اتصال	контактна інформація	Nan
اتصالات	телеком	Nan
اتفاقيات	угоди	None
احتلال	заняття	None
احتلت	окуповані	Nan
احتمال	перспектива	Nan
ارتفاعه	його висота	Nan
ارتفاعها	його висота	Nan
ارتفع	воскрес	Nan
ارتفعت	роза	Nan
ازداد	підвищився	Nan
ازدادت	збільшена	Nan
ازدهار	процвітати	Nan
ازدهر	розквіт	None
ازدهرت	розквіт	None
ازدياد	збільшити	None
اس	s.	Nan
استبدال	замініть	Nan
استخدام	утилізація	Nan
استخدامات	використання	None
استخدامه	використай це	Nan
ارتفاع	висота	None
ارتبطت	заручилася	Nan
ارتبط	підключення	Nan
ارتباط	заручини	Nan
احتياجات	потреби	None
احتياطي	запасні	Nan
احمد	ахмед	Nan
اختار	виберіть	Nan
اختبار	тест	None
اختبارات	тести	Nan
اختراع	винахід	None
اقتصادي	економічні	None
اختراق	прорив	Nan
اختلاف	різниця	None
اختلافات	відмінності	None
اختلفت	різні	None
اختيار	вибір	None
اختياره	його вибір	Nan
اخر	ще	None
اديسون	едісон	Nan
اخترع	винайдено	Nan
اقتصاديا	економічно	None
اقتصادية	економний	Nan
اقرأ	прочитайте	Nan
الأديان	релігії	None
الأذربيجانية	азербайджанці	None
الأراضي	землі	None
الأرانب	кролики	Nan
الأربع	чверть до	Nan
الأربعة	четверо	Nan
الأربعين	сорок	Nan
الأرثوذكس	православні	None
الأرثوذكسية	православні	None
الأرجح	ймовірно	None
الأرجنتين	аргентина	None
الأردن	йорданія	Nan
الأردني	йорданський	Nan
الأردنية	йорданський	Nan
الأرز	рис	None
الأدوية	фармацевтична	Nan
الأرضي	земля	None
الأدوار	ролі	None
الأدنى	найнижчий	Nan
الأخر	інший	None
الأخرى	інші	None
الأخضر	зелений	None
الأخطاء	помилки	None
الأخلاق	моральний	None
الأخلاقية	моральний	None
الأخوان	брати	None
الأخير	останній	None
الأخيرة	остання	None
الأداء	вистава	Nan
الأدب	література	None
الأدباء	письменники	None
الأدبي	літературні	None
الأدبية	літературні	None
الأدلة	докази	Nan
الأدوات	інструменти	None
الأرضية	підлога	Nan
الأرقام	числа	None
الأرمن	вірмени	None
الأسبوع	тиждень	None
الأستاذ	професор	Nan
الأسترالية	австралійський	Nan
الأسد	лев	None
الأسر	сім&#39;ї	Nan
الأسرة	сім&#39;я	Nan
الأسرى	в&#39;язні	Nan
الأسطورة	легенда	None
الأسطول	флот	None
الأسعار	ціни	None
الأسفل	нижній	None
الأسلحة	зброя	None
الأسلوب	метод	None
الأسماء	імена	None
الأسماك	риба	None
الأسبق	колишній	None
الأسبرين	аспірин	Nan
الأسبانية	іспанська	None
الأسباني	іспанська	None
الأرمني	вірменська	Nan
الأرمنية	вірменська	Nan
الأرنب	кролик	Nan
الأرواح	духи	Nan
الأزرق	синій	None
الأزمات	кризи	None
الأزمة	криза	None
الأخذ	приймаючи	Nan
الأزهر	аль-азхар	Nan
الأسئلة	питання	None
الأساس	фундамент	Nan
الأساسي	первинний	Nan
الأساسية	основний	None
الأساطير	міфи	None
الأساليب	методи	None
الأسباب	причини	None
الأزياء	мода	Nan
الأسنان	зуби	None
الأخبار	новини	None
الأحيان	іноді	None
الآستانة	астана	Nan
الآسيوي	азіатські	Nan
الآسيوية	азіатські	Nan
الآشورية	ассирійський	Nan
الآفات	шкідники	Nan
الآلات	машини	None
الآلاف	тисячі	None
الآلام	біль	None
الآلة	бог	None
الآلهة	боги	None
الآلي	автоматизовані	Nan
الآلية	механізм	None
الآن	зараз	None
الآونة	останнім часом	Nan
الآيات	вірші	None
الآرامية	арамейська	Nan
الآية	вірш	None
الآر	аар	Nan
الآخرين	інші	None
اكتساب	придбання	None
اكتسبت	придбаний	Nan
اكتشاف	відкриття	None
اكتشافه	відкрийте це	Nan
اكتشافها	відкрийте їх	Nan
اكتشف	відкрийте для себе	Nan
اكتشفت	я виявив	Nan
ال	the	Nan
الآب	батько	None
الآباء	батьків	None
الآبار	колодязі	Nan
الآتي	наступні	None
الآثار	археологія	Nan
الآخر	інший	None
الآخرة	надалі	None
الآداب	література	None
الأئمة	імамам	Nan
الأب	батько	None
الأباطرة	імператори	Nan
الأجنحة	крила	None
الأجهزة	прилади	None
الأجيال	покоління	None
الأحاديث	хадиси	Nan
الأحد	неділя	Nan
الأحداث	події	None
الأحرار	вільні люди	Nan
الأحرف	персонажі	None
الأحزاب	сторони	None
الأحكام	положення	None
الأحماض	кислоти	None
الأحمد	аль-ахмад	Nan
الأحمر	червоний	None
الأحوال	умови	None
الأحياء	біологія	Nan
الأجنبية	іноземні	None
الأجنبي	іноземець	Nan
الأجناس	гонки	Nan
الأجسام	об&#39;єкти	Nan
الأبجدية	алфавіт	None
الأبحاث	дослідження	None
الأبطال	герої	None
الأبعاد	розміри	None
الأبناء	діти	None
الأبواب	двері	Nan
الأبيض	білий	None
الأخ	брат	None
الأتراك	турки	None
الأثر	вплив	None
الأثرية	археологічні	None
الأثناء	тим часом	Nan
الأثير	ефір	Nan
الأجانب	іноземці	Nan
الأجرام	органи	None
الأجزاء	частини	None
الأثار	археологія	Nan
السينمائي	фільм	None
السينمائية	кінематографічний	Nan
السينية	х	None
الوزن	вага	None
الوزير	міністр	None
الوسائل	засоби	None
الوسط	середина	None
الوسطى	центральний	None
الوسواس	нав&#39;язливий	Nan
الوسيط	посередник	Nan
الوصف	опис	None
الوصول	доступ	None
الوصيف	забіг	Nan
الوضع	ситуація	None
الوطن	батьківщина	None
الوطني	національний	None
الوطنية	національний	None
الوظائف	вакансії	Nan
الوزراء	міністри	Nan
الوظيفة	професія	Nan
الوزارة	міністерство	None
الورق	папір	None
الوثائق	документи	None
الوثنية	ідолопоклонство	Nan
الوثيقة	документ	None
الوجبات	харчування	None
الوجه	обличчя	None
الوجود	існування	None
الوحدات	одиниці	None
الوحدة	одиниця	None
الوحي	одкровення	Nan
الوحيد	єдиний	None
الوحيدة	єдиний	None
الوديان	долини	None
الوراء	відсталий	Nan
الوراثة	генетика	Nan
الوراثية	генетичні	Nan
الورم	пухлина	Nan
الوالي	намесник	Nan
الوظيفي	кар&#39;єра	Nan
الوفاة	смерть	None
اليابانية	японці	Nan
اليابسة	земля	None
اليد	рука	Nan
اليدوية	ручної роботи	Nan
اليرموك	ярмук	Nan
اليسار	ліворуч	None
اليسرى	зліва	None
اليقين	визначеність	Nan
اليمامة	аль-ямама	Nan
اليمن	кому	None
اليمنى	правильно	None
اليمنية	ємен	Nan
اليمين	правильно	None
اليه	механізм	None
اليهود	євреї	None
الياباني	японці	Nan
الوعي	інформованість	Nan
اليابان	японія	None
الوهابية	вахабізм	Nan
الوفد	делегація	Nan
الوفيات	смерть	None
الوقائع	факти	None
الوقاية	захист	None
الوقت	час	None
الوقود	паливо	Nan
الوقوف	встати	Nan
الوكالة	агентство	None
الولاء	лояльність	Nan
الولاة	префект	Nan
الولادة	народження	None
الولايات	штати	None
الولاية	стан	None
الوليد	alwaleed	Nan
الوهاب	дарувач усіх	Nan
الويب	мережа	None
الوالد	батько	None
الواقعية	реалізм	None
الواقعة	факт	None
النيتروجين	азот	None
النيجر	нігер	Nan
النيل	ніл	Nan
الهائل	феноменальний	Nan
الهائلة	дивовижно	Nan
الهاتف	телефон	Nan
الهادئ	тихо	Nan
الهادي	екскурсовод	Nan
الهاشمي	хашемі	Nan
الهاشمية	хашеміт	Nan
الهامة	важливо	None
الهبوط	посадка	Nan
الهجان	гібридний	Nan
الهجرة	імміграція	Nan
الهجري	хіджі	Nan
النيازك	метеорити	Nan
الهجمات	напади	Nan
النووية	ядерний	Nan
النوم	сон	None
النهائي	фінал	Nan
النهائية	останній	None
النهار	денний час	Nan
النهاية	кінець	None
النهج	підхід	None
النهر	річка	None
النهرين	дві річки	Nan
النهضة	відродження	None
النواب	депутати	None
النواحي	шляхи	None
النوادي	клуби	None
النواعير	фонтани	Nan
النور	світло	None
النوع	тип	None
النوعية	якість	None
النووي	ядерний	Nan
الهجوم	напад	Nan
الهدنة	перемир&#39;я	Nan
الهرم	піраміда	None
الهيئة	комісії	None
الهياكل	структури	None
الهيثم	аль-хайтем	Nan
الهيدروجين	водень	None
الهيكل	будова	None
الواجب	домашнє завдання	Nan
الواجهة	інтерфейс	None
الواحد	один	None
الوادي	долина	None
الواردات	імпорт	None
الواردة	міститься	None
الواسع	широкий	None
الواسعة	широкий	None
الواضح	очевидно	None
الواقع	реальність	None
الهيئات	організації	None
الهوية	ідентичність	Nan
الهولوكوست	голокост	None
الهولندية	голландська	Nan
الهروب	втеча	Nan
الهزيمة	поразка	None
الهضاب	плато	None
الهضبة	плато	None
الهلال	півмісяць	Nan
الهند	індія	Nan
الهندسة	техніка	None
اليهودي	єврей	Nan
الهندسية	техніка	None
الهندوسية	індуїзм	None
الهندي	індійський	Nan
الهندية	хінді	Nan
الهنود	індіанці	Nan
الهواء	повітря	None
الهوائية	аеробні	Nan
الهولندي	голландська	Nan
الهندوس	індуїстський	Nan
النمور	тигри	None
اليهودية	іудаїзм	Nan
اليورو	євро	None
بإصدار	видавати	Nan
بإضافة	додавши	Nan
بإطلاق	абсолютно	None
بإعادة	re	Nan
بإقامة	встановити	None
بإنتاج	виробляти	Nan
بإنشاء	створює	None
بئر	ну	Nan
باب	двері	Nan
بابا	баба	Nan
بابل	вавилон	Nan
بابن	син	None
بات	став	None
باتجاه	назустріч	Nan
باحتلال	окупація	None
بإرسال	надіслати	Nan
باختلاف	по-різному	Nan
بإجراء	виконувати	None
بأول	продовжуй	Nan
بأحد	будь-кому	Nan
بأداء	виконувати	None
بأسلوب	у манері	Nan
بأسماء	з іменами	Nan
بأشكال	у формах	Nan
بأعمال	працює	None
بأكثر	більше	None
بأكمله	цілий	None
بألمانيا	німеччина	None
بأمر	за наказом	Nan
بأن	це	None
بأنه	це він	Nan
بأنها	це як	Nan
بأنهم	що вони є	Nan
بأوروبا	в європі	Nan
بأي	у будь-якому	Nan
بأبي	мій батько	Nan
بادئ	початкові	Nan
باديس	бадіс	Nan
باكو	баку	Nan
بالأرض	згладжений	Nan
بالأمر	про це	Nan
بالإسكندرية	в олександрії	Nan
بالإسلام	з ісламом	Nan
بالإضافة	в додаток	Nan
بالإمكان	можливо	None
بالإنجليزية	англійською	None
بالاشتراك	спільно	None
بالبلاد	у країні	Nan
بالتالي	згодом	None
بالتجارة	торгівля	None
بالتركية	турецькою	Nan
بالتعاون	у співпраці	Nan
بالجامعة	в університеті	Nan
باكستان	пакистан	Nan
بادية	бадія	Nan
باقي	залишок	Nan
باعتباره	як	None
بارتفاع	вгору	None
بارد	круто	Nan
بارز	видатний	None
بارزة	помітний	None
باريس	париж	None
باستثناء	крім	None
باستخدام	використовуючи	None
باستعمال	використання	None
باستقلال	самостійно	None
باستمرار	безперервно	Nan
باسم	басим	Nan
باسمه	в його ім’я	Nan
باشا	паша	Nan
باطن	підошви	Nan
باعتبار	враховуючи	Nan
باعتبارها	як	None
ب	б	Nan
اي	котрий	None
اهل	люди	None
انبعاث	викид	Nan
انبعاثات	викиди	Nan
انتخاب	вибори	None
انتخابات	вибори	None
انتخابه	його обрання	Nan
انتخب	був обраний	Nan
انتزاز	напад	Nan
انتشار	поширення	None
انتشارا	поширений	None
انتشاراً	поширений	None
انتشارها	її поширення	Nan
انتشارًا	поширеність	Nan
انتشر	гриб	Nan
انتشرت	поширився	None
انتصار	перемога	None
ان	що	None
انتصارات	перемагає	Nan
امساخ	бруд	Nan
امتلكت	я володію	Nan
اليوم	сьогодні	None
اليومية	щодня	None
اليونان	греція	None
اليوناني	грецька	None
اليونانية	грецька	None
اليونانيون	греки	None
اليونانيين	греки	None
اليونسكو	юнеско	None
ام	мати	None
اما	що стосується	Nan
امام	до цього	Nan
امتد	поширення	None
امتداد	розширення	None
امتدت	простягнув	Nan
امتصاص	поглинання	None
امرأة	жінка	None
انتصر	він виграв	Nan
انتفاضة	повстання	None
انتقاد	критика	None
انظر	подивіться	Nan
انعقاد	скликання	None
انفجار	вибух	Nan
انفصال	поділ	None
انقراض	вимирання	Nan
انقسام	розколоти	Nan
انقطاع	перерва	Nan
انقلاب	переворот	None
انه	це	None
انها	це	None
انهم	що вони	Nan
انهيار	згорнути	Nan
اهتم	піклуватися	Nan
اهتمام	інтерес	None
اهتمامه	його інтерес	Nan
انطلقت	запущено	Nan
انطلق	йти вперед	Nan
انضمت	вона приєдналася	Nan
انضمام	приєднання	None
انتقادات	критика	None
انتقال	перехід	None
انتقالية	перехідний	None
انتقد	критикуйте	Nan
انتقل	він рушив	Nan
انتقلت	я переїхав	Nan
انتهاء	кінець	None
اليورانيوم	уран	Nan
انتهت	термін дії закінчився	Nan
انخفاض	крапля	Nan
انخفض	зменшився	Nan
انخفضت	зменшився	Nan
اندلعت	виламати	Nan
اندونيسيا	індонезія	None
انسحاب	виведення	None
انضم	приєднатися	Nan
انتهى	закінчено	Nan
النموذج	зразок	None
النمل	мурахи	Nan
النمط	візерунок	Nan
المناصب	позиції	None
المناطق	регіони	None
المناعة	імунітет	None
المناعي	імунофлуоресценція	Nan
المنافسة	змагання	None
المناهج	навчальні програми	Nan
المناهضة	анти	Nan
المنتج	продукт	None
المنتجات	продукція	None
المنتجة	виробляється	Nan
المنتخب	обранці	Nan
المنتخبات	команди	None
المنتدى	форум	None
المنتشرة	розсипаний	Nan
المنتظر	чекати на	Nan
المناسبة	нагода	Nan
المنخفضة	низький	None
المناسبات	нагоди	None
المنازل	будинки	None
الممالك	королівства	None
المماليك	мамлюки	Nan
الممتاز	відмінно	Nan
الممتدة	розтягування	Nan
الممتلكات	властивості	None
الممثل	актор	None
الممثلة	актриса	Nan
الممثلين	актори	None
الممكن	можливо	None
المملكة	царство	None
المملوكي	мамлюк	Nan
المملوكية	мамлюк	Nan
المميزة	відмітний	Nan
المناخ	клімат	None
المناخية	кліматичний	Nan
المناسب	відповідне	Nan
الممارسة	практика	None
المندائية	мандейський	Nan
المنزلي	вітчизняний	Nan
المهرجانات	фестивалі	None
المهلهل	слабкий	Nan
المهم	важливе	None
المهمة	місія	Nan
المهنة	професія	Nan
المهندس	інженер	None
المهندسين	інженери	Nan
المهنية	професійні	None
المواجهة	протистояння	None
المواد	матеріали	None
الموارد	ресурси	None
المواصلات	перевезення	None
المواضيع	нитки	Nan
المواطن	громадянин	None
المواطنين	громадяни	None
المهدي	махді	Nan
المنزل	головна	None
المهبل	піхву	Nan
المهارات	навички	Nan
المنزلية	побутові	None
المنشآت	вигоди	Nan
المنصب	позиція	None
المنصور	аль-мансур	Nan
المنصورة	мансура	Nan
المنطق	логіка	None
المنطقة	область	None
المنظمات	організації	None
المنظمة	організація	None
المنعم	мунім	Nan
المنفى	вигнання	Nan
المنهج	навчальна програма	Nan
المنورة	медіна	Nan
المنوية	сперма	Nan
المهاجرين	іммігранти	Nan
المهام	місія	Nan
الملوك	царі	None
الملوثة	забруднений	Nan
الملوثات	забруднювачі	Nan
المفسرين	перекладачі	None
المفضلة	улюблений	Nan
المفكرين	мислителі	None
المفهوم	зрозумів	Nan
المقابر	кладовища	Nan
المقابل	повернення	None
المقابلة	співбесіда	Nan
المقارنة	порівняння	None
المقاطعات	провінції	None
المقاطعة	бойкот	Nan
المقاعد	сидіння	Nan
المقال	стаття	None
المقالات	статті	None
المقالة	стаття	None
المقام	макам	Nan
المفروضة	накладений	Nan
المقاومة	опір	None
المفردات	лексика	None
المفترض	передбачається	Nan
المغاربة	марокканці	Nan
المغرب	марокко, захід, захід сонця	Nan
المغربي	марокканський	Nan
المغربية	марокканський	Nan
المغلقة	укладений	Nan
المغناطيس	магніт	Nan
المغناطيسي	магнітний	Nan
المغناطيسية	магнетизм	Nan
المغول	монголи	Nan
المغولي	моголь	Nan
المغولية	монгольська	Nan
المفاتيح	ключі	Nan
المفاعلات	реактори	Nan
المفاهيم	поняття	None
المفاوضات	переговори	None
المفتوحة	відчинено	Nan
المقاييس	метрики	Nan
المقدس	святий	None
المقدسة	святий	None
الملائكة	ангели	Nan
الملابس	одяг	None
الملاحة	навігація	Nan
الملاحظات	примітки	None
الملاحظة	спостереження	None
الملايو	малайська	Nan
الملايين	мільйони	None
الملح	сіль	None
الملعب	стадіон	None
الملفات	файли	None
الملقب	псевдонім	Nan
الملك	король	None
الملكة	королева	Nan
الملكي	рояліст	Nan
الملكية	власність	None
المكي	мекканський	Nan
المكونة	компонент	Nan
المكونات	інгредієнти	Nan
المكون	компонент	Nan
المقدسي	єрусалим	Nan
المقدمة	вступ	None
المقدوني	македон	Nan
المقر	штаб-квартира	Nan
المقربين	близькі	None
المقرر	рішення	None
المقصود	призначався	Nan
الموافق	відповідний	None
المقيمين	мешканці	None
المكتب	стіл	None
المكتبات	бібліотеки	None
المكتبة	бібліотека	None
المكتوبة	написано	None
المكرمة	аль мукаррама	Nan
المكسيك	мексика	None
المكسيكية	мексиканський	Nan
المكان	місце	None
الموافقة	добре	None
المواقع	місцеположення	Nan
المواقف	позиції	None
النسبي	відносна	None
النسبية	відносність	Nan
النسخ	транскрипція	Nan
النسخة	відпустіть	Nan
النسق	макет	Nan
النسيج	тканина	Nan
النشأة	фундація	Nan
النشاط	діяльність	None
النشاطات	діяльність	None
النشر	видавництво	None
النشطة	активний	None
النشيد	гімн	None
النص	текст	None
النصارى	християни	None
النصر	перемога	None
النسبة	співвідношення	None
النصف	половина	None
النسب	пропорції	Nan
النساء	жінки	None
النجار	тесляр	Nan
النجم	зірка	None
النجوم	зірок	None
النحاس	мідь	None
النحت	скульптурні	Nan
النحل	бджоли	Nan
النحو	як	None
النخبة	еліта	Nan
النخيل	долоня	Nan
النرويج	норвегія	None
النرويجي	норвезька	Nan
النرويجية	норвезька	Nan
النزاع	конфлікт	None
النزاعات	конфлікти	None
النزعة	схильність	Nan
النسائية	феміністка	Nan
النصوص	тексти	None
النضر	соковитий	Nan
النطاق	асортимент	Nan
النقاد	критики	None
النقاط	очки	Nan
النقد	критика	None
النقدي	готівкою	Nan
النقدية	готівкою	Nan
النقص	недосконалість	Nan
النقطة	точка	None
النقل	транспорт	None
النقود	гроші	None
النقيض	контрастність	Nan
النماذج	моделі	None
النمر	тигр	None
النمسا	австрія	None
النمساوي	австрійська	None
النمساوية	австрійська	None
النفوس	душі	None
النفوذ	вплив	None
النفقات	витрати	None
النفطية	нафта	None
النطق	вимова	Nan
النظام	система	None
النظامي	чергові	Nan
النظامية	системний	Nan
النظر	погляд	None
النظرة	погляд	None
النظريات	теорії	None
النجاح	успіх	None
النظرية	теорія	None
النعمان	анемона	Nan
النفايات	відходи	Nan
النفس	я	None
النفسي	психологічні	Nan
النفسية	психічний	Nan
النفط	олія	Nan
النفطي	олія	Nan
النظير	однолітка	Nan
بالجزائر	в алжирі	Nan
النثر	проза	None
النتائج	результати	None
الموسيقار	музикант	Nan
الموسيقى	музика	None
الموسيقي	музика	None
الموسيقية	музичний	None
الموضوع	тема	None
الموضوعات	теми	None
الموظفين	службовців	None
الموقع	сайт	None
الموقف	ситуація	None
المولد	народився	None
المولود	народився	None
المولى	сир	Nan
المياه	вода	None
الميت	мертвий	Nan
الميثاق	хартія	Nan
الموسوعة	енциклопедія	None
الميثان	метан	Nan
الموسمية	сезонність	Nan
المورثة	ген	Nan
الموالية	про	None
المواليد	новонароджені	Nan
الموانئ	порти	None
الموت	смерть	None
الموتى	мертві	Nan
الموجات	хвилі	None
الموجة	хвиля	None
الموجهة	направлений	Nan
الموجود	знайдено	None
الموجودة	існуючі	None
الموجي	форма хвилі	Nan
الموجية	форма хвилі	Nan
الموحد	консолідований	Nan
الموحدة	стандартний	Nan
الموحدين	унітарії	Nan
الموسم	сезон	None
الميدالية	медаль	Nan
الميدان	поле	None
الميزانية	бюджет	None
الناشئة	виникаючі	Nan
الناصر	насер	Nan
الناطقة	виступаючи	Nan
الناطقين	доповідачі	Nan
النامية	розвиваюча	Nan
النبات	рослина	Nan
النباتات	рослини	None
النباتي	вегетаріанський	Nan
النباتية	вегетаріанський	Nan
النبلاء	дворяни	Nan
النبوة	пророцтво	Nan
النبوي	пророк	Nan
النبوية	пророк	Nan
النبي	пророк	Nan
النبيذ	вино	None
الناس	люди	None
النازية	нацизм	Nan
النازي	нацист	Nan
النارية	мотоцикл	Nan
الميكانيكا	механіка	None
الميكانيكية	механічні	Nan
الميلاد	різдво	Nan
الميلادية	григоріанська	Nan
الميلاديين	ad	Nan
الميناء	порт	None
الميول	нахили	Nan
النتيجة	результат	None
الناتج	отриманий результат	Nan
الناتو	нато	None
الناجحة	успішно	None
الناجمة	викликано	Nan
الناحية	сторона	None
النادرة	рідкісний	Nan
النادي	клуб	None
النار	вогонь	None
الناتجة	результат	None
بالجنة	небо	None
بالحرب	з війною	Nan
بالحكم	за рішенням суду	Nan
بيوم	день	None
بُني	заростати	Nan
ت	т	None
تأثر	постраждали	Nan
تأثرت	вражений	Nan
تأثير	ефект	None
تأثيرا	вплив	None
تأثيرات	ефекти	Nan
تأثيره	його дія	Nan
تأثيرها	його дія	Nan
تأخذ	приймати	None
تأسس	встановлено	None
تأسست	було встановлено	Nan
تأسيس	встановлення	None
تأسيسها	його основа	Nan
بيوت	будинки	None
تأكيد	наголос	Nan
بينهما	між ними	Nan
بينها	між ними	Nan
بيبرس	перець	Nan
بيت	будинок	None
بيته	його дім	Nan
بيد	однак	None
بيده	рукою	Nan
بيروت	бейрут	Nan
بيعة	продаж	None
بيك	бек	Nan
بيكو	піко	Nan
بيكومتر	пікометри	Nan
بيل	білл	Nan
بيليوس	пелеус	Nan
بين	між	None
بينما	поки	None
بينه	докази	Nan
بينهم	між ними	Nan
بيانات	дані	None
تأليف	написано	None
تأييد	підтримка	None
تبث	трансляція	Nan
تبدأ	почати	Nan
تبدو	подивіться	Nan
تبرز	виділитися	Nan
تبع	слідкував	Nan
تبعا	залежно від	Nan
تبعد	у гостях	Nan
تبقى	залишайтеся	Nan
تبلغ	звіт	Nan
تبنت	прийнято	None
تبنى	усиновлення	Nan
تبني	усиновлення	Nan
تبوك	табук	Nan
تبين	виявляється	None
تتأثر	постраждали	Nan
تبادل	обмін	None
تأمين	страхування	None
تايوان	тайвань	None
تامة	саме так	Nan
تؤثر	ефект	None
تؤدي	вести до	Nan
تؤكد	підкреслює	Nan
تؤمن	вірити	Nan
تابع	дотримуйтесь	Nan
تابعة	підлеглий	Nan
تاج	корона	None
تاريخ	історія	None
تاريخه	його історія	Nan
تاريخها	його історія	Nan
تاريخي	історичний	None
تاريخيا	історично	None
تاريخياً	історично	None
تاريخية	історичний	None
تاشفين	розумієш	Nan
تايمز	часи	None
بيان	заява	Nan
بيئة	середовище	None
بي	в мені	Nan
بنشر	опублікувати	Nan
بنظام	система	None
بنغازي	бенгазі	Nan
بنفس	з тим же	Nan
بنفسه	самостійно	None
بنفسها	сама	None
بنقل	передача	None
بنك	банк	None
بنو	діти	None
بنوع	типу	None
بنى	заростати	Nan
بني	заростати	Nan
بنية	будова	None
بنيت	збудований	None
به	з цим	Nan
بنسبة	у розмірі	Nan
بها	це виходить	Nan
بنزوين	бензойн	Nan
بنحو	про	None
بممارسة	вправа	Nan
بمناسبة	маркування	Nan
بمنطقة	у районі	Nan
بموجب	під	None
بن	син о	Nan
بنا	кавові зерна	Nan
بناء	будівництво	None
بناءً	будівництво	None
بنائها	побудуйте його	Nan
بنات	дочки	None
بناه	будівельники	Nan
بناها	він його збудував	Nan
بنت	дівчина	None
بنتيجة	з результатом	Nan
بنجاح	успішно	None
بندر	бендер	Nan
بهاء	баха	None
بهجوم	з нападом	Nan
بهدف	з метою	Nan
بوصفها	як	None
بوضع	покласти	Nan
بوضوح	чітко	None
بوقت	з часом	Nan
بوك	facebook	Nan
بول	пол	None
بولاية	з державою	Nan
بولس	пол	None
بولندا	польща	None
بولينا	поліна	Nan
بومدين	бумедієн	Nan
بونابرت	бонапарт	Nan
بونيقيون	пунічний	Nan
بوهيميا	богемія	Nan
بويع	продаж!	Nan
بوصفه	як	None
بوش	буша	Nan
بورصة	ринок	None
بورسعيد	порт саїд	Nan
بهذا	цим	None
بهذه	з цим	Nan
بهلوي	пахлаві	Nan
بهم	їх	None
بهما	з ними	Nan
بو	бо	None
بوابات	ворота	None
تتألف	складено	Nan
بوابة	ворота	None
بواسطة	від	None
بوجه	обличчя	None
بوجود	там	None
بوحدة	поодинці	Nan
بوذا	будда	Nan
بور	бор	Nan
بورتو	порто	Nan
بواس	удари	Nan
تتبع	доріжка	Nan
تتجاوز	перевищення	Nan
تتجمع	з’єднати	Nan
تخفيض	знижка	Nan
تدار	керований	Nan
تدخين	куріння	Nan
تدرس	навчався	None
تدريب	навчання	None
تدريجيا	поступово	None
تدريجياً	поступово	None
تدريجيًا	поступово	None
تدعم	підтримка	None
تدعو	запрошує	Nan
تدفع	ти платиш	Nan
تدفق	потік	None
تدل	позначимо	Nan
تدمير	руйнування	None
تدهور	погіршення стану	Nan
تخطيط	планування	None
تدور	спіна	Nan
تخضع	тема	None
تخصص	спеціальність	Nan
تحكم	контроль	None
تحل	вирішено	None
تحليل	аналізуючи	Nan
تحمل	підшипник	Nan
تحميل	завантажити	Nan
تحول	трансформація	Nan
تحولت	обернувся	Nan
تحوي	містять	None
تحويل	трансформація	Nan
تحوّل	трансформація	Nan
تحيط	оточений	Nan
تختلف	інший	None
تخدم	подавайте	Nan
تخرج	градація	Nan
تخزين	зберігання	None
تخصيص	налаштувати	Nan
تدوين	запишіть	Nan
تدير	вона біжить	Nan
تذكر	пам’ятати	Nan
تركيا	туреччина	None
تركيب	установка	Nan
تركية	турецька	Nan
تركيز	фокус	Nan
ترى	побачити	None
تريد	ти хочеш	Nan
ترير	трір	Nan
تزال	все-таки	Nan
تزايد	збільшити	None
تزداد	отримати більше	Nan
تزوج	одружуватися	Nan
تزوجت	одружився	None
تزوجها	одружитися з нею	Nan
تزيد	збільшити	None
تساعد	допомогу	None
تركي	турки	None
تركها	залиш це	Nan
تركز	фокус	Nan
تركت	зліва	None
تراث	спадщина	None
تراجع	відступ	Nan
تراجعت	моргнув	Nan
تراقيا	фракія	None
ترانسفيراز	трансфераза	Nan
تربة	грунт	Nan
تربط	підключення	Nan
تحقيق	розслідування	None
تربية	освіта	None
ترتفع	підніматися	Nan
ترتيب	замовлення	None
ترجع	повертається	None
ترجم	перекладати	Nan
ترجمة	переклад	None
تردد	частота	None
ترك	залишати	Nan
ترتبط	пов&#39;язані	Nan
بمكة	у мекці	Nan
تحقق	перевірка	Nan
تحصل	отримати	None
تتعلق	пов&#39;язані	Nan
تتغذى	вони годують	Nan
تتغير	зміна	None
تتكون	складено	Nan
تتم	зроблено	None
تتمتع	насолоджуйтесь	Nan
تتمثل	це є	Nan
تتمكن	ти можеш	Nan
تتميز	характеризується	None
تتناول	маючи їжу	Nan
تتنوع	різноманітний	None
تتواجد	існують	None
تتوفر	доступні	None
تتوقف	стій	Nan
تتيح	дозволяє	None
تتعرض	викритий	Nan
تثبت	доведіть	Nan
تتعامل	робіть бізнес	Nan
تتطلب	вимагають	None
تتجه	заголовок	Nan
تتحدث	вона розмовляє	Nan
تتحرك	переміщення	None
تتحول	вийди	Nan
تتخذ	приймати	None
تتدخل	втручається	Nan
تتراوح	дальність	Nan
تتركز	концентрований	Nan
تتسبب	причина	None
تتسع	може вмістити	Nan
تتسم	характеризується	None
تتشابه	подібні	None
تتشكل	сформовано	Nan
تتصل	ставляться до	Nan
تتضمن	включає	None
تتطور	еволюціонувати	Nan
تجار	дилери	Nan
تجارب	досвід	None
تجارة	торгівля	None
تحتفظ	заповідники	Nan
تحتل	зайняти	Nan
تحتها	під ним	Nan
تحتوى	містить	None
تحتوي	містить	None
تحد	виклик	Nan
تحدث	розмова	Nan
تحدد	визначається	None
تحديث	оновлення	None
تحديد	визначте	Nan
تحرر	визволення	None
تحرك	рухатися	Nan
تحرير	відпустіть	Nan
تحسن	поліпшення	None
تحسين	поліпшення	None
تحتاج	потреба	None
تحت	під	None
تحاول	ти спробуй	Nan
تحاميل	супозиторії	Nan
تجاري	комерційний	Nan
تجارية	комерційний	Nan
تجاه	назустріч	Nan
تجاوز	переповнення	Nan
تجد	ви знайдете	Nan
تجديد	оновлення	None
تجربة	експеримент	Nan
تحظى	мають	None
تجري	відбуватися	Nan
تجمع	збір	None
تجمعات	збір	None
تجميع	агрегація	Nan
تجنب	уникайте	Nan
تجهيز	підготовка	None
تحافظ	тримайте	Nan
تحالف	союз	None
تجعل	зробіть	Nan
المعي	кишки	Nan
بمكان	у місці	Nan
بمعنى	значення	None
بحيرة	озеро	None
بخار	пар	None
بخصوص	стосовно	None
بخط	почерком	Nan
بخلاف	окрім	None
بد	потрібно	None
بدء	старт	Nan
بدءا	починаючи	None
بدءاً	починаючи з	Nan
بدءًا	починаючи	None
بدأ	здається	None
بدأت	це почалося	Nan
بدا	здається	None
بداخل	всередині	None
بدايات	початок	None
بحيرات	озера	None
بداية	старт	Nan
بحيث	у котрому	Nan
بحوالي	о	None
بجوار	поруч з	Nan
بجيش	з армією	Nan
بجيشه	з його армією	Nan
بحاجة	потреба	None
بحال	все одно	Nan
بحث	пошук	None
بحجة	сперечаючись	Nan
بحد	обмеження	None
بحر	море	None
بحري	морські	None
بحرية	безкоштовно	Nan
بحسب	згідно з	Nan
بحق	правильно	None
بحكم	доброчесність	Nan
بحلول	за	None
بحوث	дослідження	None
بجميع	у всьому	Nan
بدايتها	її початок	Nan
بدر	badr	Nan
برج	башта	Nan
برز	виділитися	Nan
برزت	вискочив	Nan
برسم	за окрему плату	Nan
برشلونة	барселона	Nan
برعاية	курований	Nan
برفع	підвищувати	Nan
برقة	ніжно	Nan
بركان	вулкан	Nan
بركة	ставок	Nan
برلمان	парламент	None
برلمانية	парламентська	Nan
برلين	берлін	None
برنامج	програма	None
بروبيلين	пропілен	Nan
براون	коричневий	Nan
بدخول	введіть	Nan
براكودة	барракуда	Nan
بذلك	з цим	Nan
بدراسة	вивчення	None
بدرجة	ступінь	None
بدعم	підтримується	Nan
بدفع	платити	Nan
بدقة	точно	None
بدلا	замість	None
بدلاً	замість	None
بدمشق	у дамаску	Nan
بدن	тіло	None
بدور	роль	None
بدوره	у свою чергу	Nan
بدورها	у свою чергу	Nan
بدولة	у країні	Nan
بدون	без	None
بديلة	альтернатива	Nan
برئاسة	очолив	None
بجمع	збирає	Nan
بجعة	лебідь	Nan
بجانب	поруч з	Nan
بالفرنسية	французькою	None
بالفشل	не вдалося	Nan
بالفعل	справді	None
بالقاهرة	у каїрі	Nan
بالقدس	в єрусалимі	Nan
بالقرب	біля	None
بالقوة	силою	None
بالكثير	багато	None
باللاتينية	латиною	Nan
باللغات	також є в наявності	Nan
باللغة	мовою	None
بالله	в бога	Nan
باللون	за кольором	Nan
بالماء	з водою	Nan
بالمدينة	за містом	Nan
بالغة	дорослий	Nan
بالمرض	хворіють	Nan
بالغ	дорослий	Nan
بالعمل	на роботі	Nan
بالخط	в лінію	Nan
بالخلافة	речення	None
بالدولة	стан	None
بالذات	дуже	None
بالذكر	згадування	Nan
بالرغم	хоч	None
بالسكان	населений	Nan
بالسنة	рік	None
بالسيطرة	беріть під контроль	Nan
بالشكل	в формі	Nan
بالطاقة	працює	None
بالعالم	в світі	Nan
بالعبرية	на івриті	Nan
بالعديد	багато	None
بالعربية	арабською мовою	Nan
بالعين	оком	Nan
بالمعنى	в тому сенсі	Nan
بالمغرب	у марокко	Nan
بالمقابل	і навпаки	Nan
بتطبيق	застосовуючи	Nan
بتعيين	встановити	None
بتغيير	зміна	None
بتقديم	надіслати	Nan
بتلك	з цим	Nan
بتنظيم	організовано	None
بتنفيذ	реалізація	None
بتهمة	на звинувачення	Nan
بتوجيه	під керівництвом	Nan
بتونس	у тунісі	Nan
بث	мовлення	None
بثلاث	три	None
بثلاثة	на три	Nan
بجائزة	приз	Nan
بجامعة	університет	None
بتشكيل	формально	None
بتحويل	перетворити	Nan
بتاريخ	на	None
بتأسيس	заснований	None
بالمقارنة	в порівнянні з	Nan
بالمملكة	у королівстві	Nan
بالمنطقة	поблизу	None
بالمياه	з водою	Nan
بالنسبة	о	None
باليونانية	грецькою	None
بان	заборона	None
بروتوكول	протокол	Nan
باوني	поні	Nan
بايزيد	баєзид	Nan
ببساطة	просто	None
ببطء	повільно	None
ببطولة	героїчно	Nan
ببعض	дещо	None
ببعضها	разом	None
ببناء	конструктивно	Nan
باي	до побачення	Nan
بروتون	протона	Nan
بروز	визначення	None
بروسيا	пруссія	Nan
بقتله	щоб його вбити	Nan
بقدر	стільки	None
بقرار	з рішенням	Nan
بقعة	пляма	Nan
بقلم	за	None
بقليل	трішки	Nan
بقوة	сильно	None
بقوله	сказавши	Nan
بقي	залишився	None
بقيادة	на чолі з	Nan
بقية	відпочинок	None
بقيت	вона залишилася	Nan
بك|	ваш |	Nan
بكتابة	письмово	Nan
بكتيريا	бактерії	None
بقتل	вбивати	Nan
بكثرة	в достатку	Nan
بقايا	залишається	None
بق	помилка	Nan
بعيدا	у гостях	Nan
بعيداً	у гостях	Nan
بعيدة	далеко	None
بعين	з оком	Nan
بغداد	багдад	Nan
بغزو	вторглися	Nan
بغض	незалежно	None
بغير	якщо тільки	Nan
بـ	з	None
بفتح	відчинено	Nan
بفترة	деякий час	Nan
بفضل	завдяки	None
بفعل	роблячи	Nan
بفكرة	з ідеєю	Nan
بفيروس	з вірусом	Nan
بقاء	виживання	None
بكثير	багато чого	Nan
بكر	бакр	Nan
بكرة	валик	Nan
بلغت	удар	Nan
بلفور	бальфур	Nan
بلقب	з назвою	Nan
بلقيس	белькес	Nan
بليحائية	blahy	Nan
بما	у тому числі	Nan
بمثابة	як	None
بمجرد	раз	None
بمحمد	мухаммед	Nan
بمختلف	по-різному	Nan
بمرض	хворіють	Nan
بمرور	проходити повз	Nan
بمساعدة	за допомогою	Nan
بمصر	в єгипті	Nan
بمعدل	за ставкою	Nan
بلغة	мовою	None
بلغاريا	болгарія	None
بلغ	охопити	Nan
بلعمية	фагоцитоз	Nan
بكل	у всьому	Nan
بكميات	у кількостях	Nan
بكونها	буттям	Nan
بكين	пекін	Nan
بل	але	None
بلا	без	None
بلاد	країни	None
بعيد	далеко	None
بلاده	тупість	Nan
بلاط	черепиця	Nan
بلال	белал	Nan
بلجيكا	бельгія	None
بلد	країна	None
بلدان	країни	None
بلدة	місто	None
بلدية	муніципалітет	Nan
بلادهم	їхня країна	Nan
بمقدار	за	None
بعنوان	право	None
بعمليات	операції	None
بشأن	о	None
بشار	башар	Nan
بشدة	сильно	None
بشر	людські істоти	Nan
بشراء	придбано	Nan
بشرط	за умови	Nan
بشركة	з компанією	Nan
بشري	людська	Nan
بشرية	людство	None
بشكل	в певному сенсі	Nan
بشيء	з чимось	Nan
بشير	башир	Nan
بصفة	як	None
بصفته	як його	Nan
بصورة	фото	None
بسيطة	простий	None
بضرورة	імператив	Nan
بسيط	просто	None
بسم	в ім’я	Nan
بروسيلا	бруселла	Nan
بروناي	бруней	Nan
بري	дикі	Nan
برية	пустеля	Nan
بريد	пошта	Nan
بريشة	перо	Nan
بريطانيا	британія	None
بريطانية	британці	Nan
بزعامة	на чолі з	Nan
بزيادة	вгору	None
بزيارة	відвідати	Nan
بسبب	тому що	Nan
بسرطان	рак	Nan
بسرعة	швидко	None
بسط	розширити	Nan
بسهولة	легко	None
بضع	декілька	None
بضعة	декілька	None
بضم	комбінуючи	Nan
بعدم	не до	Nan
بعدما	після	None
بعده	за ним	Nan
بعدها	тоді	None
بعدهم	після них	Nan
بعرض	ширина	None
بعض	дещо	None
بعضها	дехто з них	Nan
بعضهم	дехто з них	Nan
بعضهما	один одного	Nan
بعقد	з контрактом	Nan
بعل	гомін	Nan
بعلم	свідомо	None
بعمر	з життям	Nan
بعمل	робимо	Nan
بعدد	у кількості	Nan
بعدة	кілька	None
بعد	відстань	None
بعثة	експедиція	Nan
بطاقات	картки	Nan
بطاقة	картка	Nan
بطبيعة	звичайно	None
بطرس	петро	None
بطرق	у способах	Nan
بطريق	пінгвін	Nan
بطريقة	в певному сенсі	Nan
بعملية	операція	None
بطل	герой	None
بطن	живіт	Nan
بطوطة	батута	Nan
بطولات	чемпіонати	Nan
بطولة	чемпіонат	None
بطيئة	повільний	Nan
بعام	рік	None
بعث	він послав	Nan
بطليموس	птолемей	Nan
تساوي	рівний	Nan
المعهد	інститут	None
المعنى	сенс	None
العوامل	фактори	None
العود	лютня	Nan
العودة	назад	None
العولمة	глобалізація	Nan
العيد	ід	Nan
العيش	наживо	Nan
العين	око	None
العينين	очі	None
العيون	очі	None
الغابات	ліси	None
الغابة	ліси	None
الغاز	газ	None
الغازات	гази	None
الغازي	зловмисник	Nan
الغالب	переважно	None
العوام	прості люди	Nan
الغالبية	більшість	None
العواصف	бурі	None
العنف	насильство	Nan
العملاق	гігант	Nan
العملاقة	гігант	Nan
العملة	валюта	Nan
العملي	практична	Nan
العمليات	процеси	None
العملية	операція	None
العمود	стовпчик	Nan
العموم	the commons	Nan
العمومية	загальність	Nan
العميق	глибина	None
العميقة	глибокий	None
العناصر	елементи	None
العناية	турбота	Nan
العنب	виноград	Nan
العنصر	стихія	Nan
العهد	заповіту	None
العمل	робота	None
الغبار	пил	Nan
الغذاء	їжа	Nan
الغني	багатій	Nan
الغنية	багатий	None
الغير	інші	None
الـ	the	Nan
الفئات	категорії	None
الفئة	категорія	None
الفائدة	вигода	Nan
الفائز	переможець	None
الفاتح	аль фатех	Nan
الفاتحة	аль-фатіха	Nan
الفاتيكان	ватикан	None
الفارابي	аль-фарабі	Nan
الفارسي	перська	Nan
الفارسية	перська	Nan
الفاشية	фашизм	Nan
الغموض	таємниця	Nan
الغدد	залози	None
الغليون	труба	Nan
الغلاف	обкладинка	Nan
الغذائي	їжа	Nan
الغذائية	їжа	Nan
الغرب	захід	None
الغربي	західний	None
الغربية	західний	None
الغربيين	західники	Nan
الغرض	ціль	Nan
الغرفة	кімната	Nan
الغزاة	окупанти	Nan
الغزالي	аль-газалі	Nan
الغزل	прядіння	Nan
الغزو	вторгнення	None
الغزوات	інвазії	Nan
الغشاء	мембрана	None
الغطاء	кришка	Nan
الغلوكوز	глюкоза	Nan
العمق	глибина	None
العمري	аль-омарі	Nan
العمرة	умра	Nan
العصبي	нервовий	Nan
العصبية	нервовість	Nan
العصر	вік	None
العصور	віки	None
العضلات	м&#39;язи	Nan
العضو	член	None
العضوية	членство	None
العطل	свята	None
العظام	кістки	None
العظم	кістка	Nan
العظمى	чудово	Nan
العظمي	скелет	None
العظيم	великий	None
العظيمة	чудово	Nan
العفو	вибачте	Nan
العصابات	банди	Nan
العقائد	вчення	None
العشرينات	двадцяті роки	Nan
العشرة	десять	None
العرقي	етнічні	None
العرقية	етнічні	None
العروض	пропозиції	None
العريضة	петиція	Nan
العريقة	стародавній	None
العزيز	шановний	Nan
العسكر	військо	None
العسكري	військо	None
العسكرية	військові	None
العسكريين	військо	None
العسل	дорогий	Nan
العش	гніздо	Nan
العشاء	обід	Nan
العشائر	клани	Nan
العشر	десять	None
العشرين	двадцять	Nan
العقائدية	догматичний	Nan
العقاد	аккад	Nan
العقبة	перешкода	Nan
العلمي	науковий	None
العلمية	науковий	None
العلوم	наук	None
العلوي	верхній	None
العلوية	накладні	Nan
العلويين	алавити	Nan
العلي	найвищий	None
العمارة	архітектура	None
العمال	робітники	None
العمالة	зайнятість	Nan
العمالية	праця	None
العمر	вік	None
العمران	урбанізм	Nan
العمراني	міський	None
العمرانية	урбанізм	Nan
العلمانية	секуляризм	Nan
العلماء	вчені	Nan
العلم	наука	None
العلل	злість	Nan
العقد	договір	None
العقل	розум	None
العقلي	психічний	Nan
العقلية	психічний	Nan
العقوبات	штрафні санкції	Nan
العقود	контракти	Nan
العقول	мізки	Nan
الفاصل	сепаратор	Nan
العقيد	полковник	None
العكس	протилежність	Nan
العلاء	високий	None
العلاج	лікування	None
العلاجية	цілющі	Nan
العلاقات	відносини	None
العلاقة	відносини	None
العلامة	бренд	Nan
العقيدة	символ віри	Nan
العرق	пот	Nan
الفاطمي	фатімід	Nan
الفاطميين	фатіміди	Nan
الفهم	розуміння	None
الفوائد	переваги	None
الفور	місце	None
الفوز	виграш	Nan
الفوضى	хаос	Nan
الفولاذ	сталь	None
الفوهات	сопла	Nan
الفيدرالي	федеральний	None
الفيدرالية	федералізм	Nan
الفيديو	відео	None
الفيروس	вірус	None
الفيروسات	віруси	None
الفيروسي	вірусний	Nan
الفيروسية	вірусний	Nan
الفيزياء	фізика	None
الفهد	гепард	Nan
الفيزيائية	фізичні	None
الفنية	художній	None
الفنون	мистецтво	None
الفلسفي	філософський	None
الفلسفية	філософський	None
الفلك	астрономія	None
الفلكي	астроном	Nan
الفلكية	астрономічний	Nan
الفلكيون	астрономи	Nan
الفلم	кінострічка	Nan
الفم	рот	Nan
الفن	мистецтво	None
الفنادق	готелі	None
الفنان	артист	None
الفنانة	артист	None
الفنانين	художники	None
الفنلندي	фінн	Nan
الفنلندية	фінська	Nan
الفني	художній твір	Nan
الفلسفة	філософія	None
الفيس	елвіс	Nan
الفيضانات	повені	Nan
القاعدة	аль-каїда	Nan
القانون	закон	None
القانوني	юридичні	None
القانونية	юридичні	None
القبائل	племена	None
القبة	купол	Nan
القبر	могила	None
القبض	заарештований	Nan
القبطي	коптська	Nan
القبطية	коптська	Nan
القبلة	поцілунок	Nan
القبلي	племінний	Nan
القبول	вступ	None
القبيلة	плем&#39;я	Nan
القتال	боротьба	None
القاضي	суддя	Nan
الفيضان	повінь	Nan
القاسم	знаменник	Nan
القارة	континент	Nan
الفيفا	фіфа	Nan
الفيل	слон	Nan
الفيلة	слони	Nan
الفيلسوف	філософ	None
الفيلم	кінострічка	Nan
الفينيقية	фінікійський	Nan
القائد	ведучий	Nan
القائلة	говорячи	Nan
القائم	на основі	Nan
القائمة	список	None
القادم	далі	None
القادمة	прийдеш	Nan
القادمين	прийдеш	Nan
القارئ	читач	Nan
القارات	континенти	Nan
القارية	континентальний	None
الفلسطينيين	палестинці	Nan
الفلسطينيون	палестинці	Nan
الفلسطينية	палестинська	Nan
الفرد	індивід	Nan
الفردي	синглів	Nan
الفردية	індивідуальний	Nan
الفرس	перси	Nan
الفرسان	лицарі	Nan
الفرصة	можливість	None
الفرع	гілка	Nan
الفرعونية	фараонський	Nan
الفرعية	під	None
الفرق	різниця	None
الفرقة	група	None
الفرن	піч	Nan
الفرنجة	франки	Nan
الفرنسي	французький	None
الفرنسية	французький	None
الفرج	вульва	Nan
الفرنسيون	французький	None
الفراغ	пустота	Nan
الفراش	постільна білизна	Nan
الفتاة	дівчина	None
الفتح	завоювання	None
الفترات	періоди	None
الفترة	період	None
الفتنة	розбрат	Nan
الفتوح	аль-футу	Nan
الفتوحات	завоювання	None
الفجر	світанок дня	Nan
الفجوة	розрив	None
الفحص	експертиза	Nan
الفحم	вугілля	None
الفخار	гончарство	Nan
الفدرالي	федеральний	None
الفدرالية	федералізм	Nan
الفرات	євфрат	Nan
الفراعنة	фараони	Nan
الفرنسيين	французький	None
الفروع	гілки	None
الفريدة	унікальний	None
الفقري	хребет	None
الفقه	правознавство	Nan
الفقهاء	юристи	Nan
الفقهية	правознавство	Nan
الفقيرة	бідні	Nan
الفقيه	faqih	Nan
الفكر	думка	None
الفكرة	ідея	None
الفكري	інтелектуальний	Nan
الفكرية	інтелектуальний	Nan
الفلاحين	селяни	None
الفلاسفة	філософи	None
الفلبين	філіппіни	Nan
الفلبينية	філіппінська	Nan
الفلسطيني	палестинська	Nan
الفقراء	незаможні	Nan
الفقر	бідність	Nan
الفعلية	фактичні	Nan
الفعلي	фактична	Nan
الفريق	команда	None
الفريقان	дві команди	Nan
الفريقين	дві команди	Nan
الفساد	корупція	Nan
الفصائل	фракції	None
الفصح	великдень	None
الفصحى	класичний	None
الفاطمية	фатимідизм	Nan
الفصل	класна кімната	Nan
الفضائي	чужий	Nan
الفضائية	супутник	Nan
الفضة	срібло	None
الفضل	улюбленість	Nan
الفطر	гриби	None
الفعالة	ефективна	Nan
الفعل	дієслово	None
الفضاء	простір	None
العرض	дисплей	Nan
العرش	престол	None
العربية	арабською	Nan
الصحابة	супутники	Nan
الصحابي	супутник	Nan
الصحاري	пустелі	None
الصحافة	преса	None
الصحة	здоров&#39;я	Nan
الصحراء	пустеля	Nan
الصحراوي	пустеля	Nan
الصحراوية	пустеля	Nan
الصحف	газети	None
الصحفي	журналіст	None
الصحفيين	журналісти	Nan
الصحية	здоров&#39;я	Nan
الصحيح	правильний	None
الصخرة	скеля	Nan
الصخري	скелястий	Nan
الصباح	ранок	Nan
الصخرية	скелястий	Nan
الصالحة	праведник	Nan
الصادق	щирий	Nan
الشيخة	шейха	Nan
الشيطان	зло	None
الشيعة	шия	Nan
الشيعي	шиїт	Nan
الشيعية	шиїт	Nan
الشيوخ	старійшини	Nan
الشيوعي	комуністична	None
الشيوعية	комунізм	None
الشيوعيين	комуністи	Nan
الصابئة	сабеї	Nan
الصابئي	сабей	Nan
الصابون	мило	Nan
الصادر	вихідний	Nan
الصادرات	експорт	None
الصادرة	виданий	None
الصالح	добре	None
الشيخ	шейх	Nan
الصخور	скелі	None
الصدد	з&#39;єднання	Nan
الصفراء	жовтий	None
الصفويين	сафавіди	Nan
الصلاة	молитва	Nan
الصلال	шкіри	None
الصلب	сталь	None
الصلبة	суцільний	Nan
الصلة	посилання	None
الصلح	примирення	Nan
الصلوات	молитви	None
الصليب	хрест	None
الصليبي	хрестоносець	Nan
الصليبية	хрестоносців	Nan
الصليبيون	хрестоносці	Nan
الصليبيين	хрестоносці	Nan
الصناعات	галузі	None
الصفر	нуль	Nan
الصداقة	дружба	None
الصفحة	сторінки	None
الصفا	аль-сафа	Nan
الصدر	груди	Nan
الصدري	грудний	Nan
الصديق	друг	None
الصراع	конфлікт	None
الصراعات	конфлікти	None
الصرب	серби	Nan
الصرف	обмін	None
الصعب	складно	Nan
الصعيد	верхній єгипет	Nan
الصغار	маленькі діти	Nan
الصغر	філігрань	Nan
الصغرى	мікро	Nan
الصغير	маленький	Nan
الصغيرة	маленький	Nan
الصف	клас	None
الصفة	прикметник	None
الشيء	річ	None
الشورى	шура	Nan
الشواطئ	пляжі	Nan
الشبه	подоба	Nan
الشتاء	зима	None
الشجاعة	мужність	Nan
الشجرة	дерево	None
الشحنات	відвантаження	Nan
الشحنة	відвантаження	Nan
الشخص	людина	None
الشخصي	профіль	Nan
الشخصيات	персонажі	None
الشخصية	особисті	None
الشديد	сильний	None
الشديدة	сильний	None
الشذوذ	аномалії	Nan
الشر	зло	None
الشرائية	придбання	None
الشبكة	мережа	None
الشرط	умова	Nan
الشبكات	мережі	None
الشاي	чай	Nan
الشأن	причина	None
الشؤون	справи	None
الشائع	поширені	None
الشائعة	поширені	None
الشابي	юнак	Nan
الشارع	вулиця	None
الشاشة	екран	Nan
الشاطئ	пляж	Nan
الشاعر	поет	None
الشافعي	аль-шафій	Nan
الشام	шаман	Nan
الشامل	меса	Nan
الشامي	шамі	Nan
الشامية	левантин	Nan
الشاه	шах	Nan
الشباب	молоді	None
الشرطة	поліція	None
الشرعي	законний	Nan
الشرعية	легітимність	Nan
الشك	сумніви	Nan
الشكل	форма	None
الشكوك	сумніви	Nan
الشمال	північ	None
الشمالي	північна	None
الشمالية	північ	None
الشمس	сонце	None
الشمسية	сонячна	None
الشهادة	свідоцтво	Nan
الشهداء	мученики	Nan
الشهر	місяць	None
الشهيد	мученик	Nan
الشهير	відомий	None
الشهيرة	відомий	None
الشوارع	вулиці	None
الشفاء	загоєння	Nan
الشعور	почуття	None
الشعرية	локшина	Nan
الشعراوي	шаараві	Nan
الشرف	честь	None
الشرق	схід	None
الشرقي	схід	None
الشرقية	східний	None
الشرك	політеїзм	Nan
الشركات	компанії	None
الشركة	компанія	None
الصناعة	промисловість	None
الشروط	умови	None
الشطرنج	шахи	None
الشعار	логотип	Nan
الشعب	люди	None
الشعبي	народні	None
الشعبية	популярні	None
الشعر	волосся	None
الشعراء	поети	None
الشريعة	ісламське право	Nan
الصناعي	промислові	None
الصناعية	промислові	None
الصنع	зроблено	None
العادل	справедливий	Nan
العادي	звичайний	None
العادية	регулярні	Nan
العاشر	десятий	Nan
العاشرة	десятий	Nan
العاص	the aas	Nan
العاصمة	капітал	None
العالم	світ	None
العالمي	глобальний	Nan
العالمية	глобалізм	Nan
العالمين	світи	Nan
العالي	вища	None
العالية	високий	None
العام	рік	None
العامة	громадського	None
العادة	звичка	Nan
العامل	робітник	Nan
العادات	звички	Nan
العائلة	сім&#39;я	Nan
الطيب	добре	None
الطيران	авіація	Nan
الطيف	спектр	None
الطين	глина	Nan
الطيور	птахи	None
الظاهر	мабуть	None
الظاهرة	феномен	None
الظاهري	віртуальний	Nan
الظروف	обставини	None
الظلام	темрява	Nan
الظلم	несправедливість	Nan
الظهر	полудень	Nan
الظهور	з&#39;являються	Nan
الظواهر	явища	None
العائلات	сім&#39;ї	Nan
العابدين	поклонники	Nan
العاملة	робочий	Nan
العاملين	персонал	Nan
العامية	народний	None
العدالة	справедливість	None
العدد	кількість	None
العدل	справедливість	None
العدو	ворог	Nan
العدوان	агресія	Nan
العدوى	інфекція	Nan
العديد	багато	None
العديدة	численні	None
العذبة	свіжий	Nan
العذراء	діва	Nan
العراق	ірак	Nan
العراقية	ірак	Nan
العراقيين	іракці	Nan
العرب	араби	Nan
العربي	арабі	Nan
العجز	імпотенція	Nan
العثور	знайдіть	Nan
العثمانيين	османи	Nan
العثمانيون	османи	Nan
العامّة	громадського	None
العباد	слуги	Nan
العبادات	поклоніння	None
العبادة	поклоніння	None
العبارة	фраза	Nan
العباس	абас	Nan
العباسي	аббасид	Nan
الطويلة	довгий	None
العباسية	аббасид	Nan
العباسيين	аббасиди	Nan
العبد	слуга	Nan
العبرية	іврит	Nan
العبودية	рабство	Nan
العبّاسية	аббасія	Nan
العثماني	османська	None
العثمانية	османська	None
العباسيون	аббасиди	Nan
القتالية	боротьба	None
الطويل	довгий	None
الطور	фаза	None
الصينيين	китайці	Nan
الضارة	шкідливий	Nan
الضباط	офіцери	Nan
الضحايا	потерпілі	Nan
الضحية	потерпілий	Nan
الضخم	величезний	None
الضخمة	мега	Nan
الضرائب	податки	None
الضربة	хіт	Nan
الضروري	необхідне	None
الضعف	слабкість	Nan
الضغط	тиск	None
الضغوط	тиск	None
الضفة	банк	None
الضوء	світло	None
الصينيون	китайці	Nan
الضوئي	фотосинтез	Nan
الصينية	китайці	Nan
الصين	китай	None
الصهيوني	сіоніст	Nan
الصهيونية	сіонізм	Nan
الصواريخ	ракети	Nan
الصوت	звук	None
الصوتية	сонічний	Nan
الصور	картинки	Nan
الصورة	зображення	None
الصوفية	суфізм	Nan
الصوم	пост	None
الصومال	сомалі	Nan
الصومالي	сомалі	Nan
الصومالية	сомалі	Nan
الصيد	полювання	None
الصيف	літо	None
الصيفية	літо	None
الصيني	китайці	Nan
الضوئية	світлофор	Nan
الطائرات	літаки	None
الطائرة	літак	Nan
الطراز	стиль	None
الطرف	партія	None
الطرفين	дві сторони	Nan
الطرق	дороги	None
الطريق	дорога	None
الطريقة	шлях	None
الطعام	їжа	Nan
الطفل	дитина	None
الطفولة	дитинство	None
الطقس	погода	None
الطقوس	ритуали	Nan
الطلاب	студенти	None
الطلب	попит	None
الطلبة	студенти	None
الطوائف	секти	Nan
الطرائد	гра	None
الطبيعية	природні	None
الطبيعي	природні	None
الطبيعة	природа	None
الطائف	тайф	Nan
الطائفة	секта	Nan
الطابع	характер	None
الطابق	підлога	Nan
الطاعون	чума	None
الطاقة	енергії	None
الطالب	запитувач	Nan
الطول	довжина	None
الطب	ліки	Nan
الطباعة	друк	None
الطبري	аль-табарі	Nan
الطبعة	видання	None
الطبقة	клас	None
الطبي	медичні	None
الطبيب	лікар	None
الطبية	медичні	None
الطباشيري	крейдова	Nan
القتل	вбивство	None
القتلى	мертві	Nan
القدامى	старожили	Nan
المدنيين	цивільні	Nan
المدونات	ведення блогів	Nan
المدونة	блог	Nan
المدى	термін	None
المديح	похвала	Nan
المدير	менеджер	Nan
المدينة	місто	None
المذاهب	вчення	None
المذكور	згадується	None
المذكورة	згадується	None
المذنبات	комети	Nan
المذهب	номінал	Nan
المرء	свою власну	Nan
المرأة	жінка	None
المرئي	видно	None
المدنية	цивільний	Nan
المرابطين	альморавіди	Nan
المدني	цивільний	Nan
المدفعية	артилерія	Nan
المخصص	виділено	Nan
المخصصة	призначається	None
المخطط	схема	None
المخطوطات	рукописи	Nan
المخلص	спаситель	Nan
المخلوقات	істоти	None
المد	розширення	None
المدارس	школи	None
المداري	орбітальний	Nan
المدارية	тропічний	Nan
المدافع	гармати	Nan
المدة	тривалість	None
المدرب	тренер	None
المدرسة	школа	None
المدرعة	броньована машина	Nan
المدن	міста	None
المخرج	режисер	None
المراجع	список літератури	Nan
المراد	бути	None
المركزي	центральний	None
المركزية	центральний	None
المرمى	мета	None
المرور	трафік	Nan
المريخ	марс	None
المريض	терплячий	Nan
المزارعون	аграрії	Nan
المزارعين	фермери	Nan
المزروعة	культивується	Nan
المزيد	більше	None
المسألة	причина	None
المسؤول	адміністратор	Nan
المسؤولة	відповідальний	None
المسؤولية	відповідальність	None
المسؤولين	відповідальний	None
المركز	центр	None
المراحل	етапи	None
المركبة	транспортний засіб	Nan
المركب	човен	Nan
المرافق	супровід	Nan
المراقبة	дивіться	None
المراكز	центри	None
المرة	час	None
المرتبة	ранг	Nan
المرتبط	пов&#39;язані	Nan
المرتبطة	асоціюється з	Nan
المرتفع	високий	None
المرتفعات	нагір&#39;я	Nan
المرتفعة	високий	None
المرجانية	коралів	Nan
المرحلة	етап	None
المرشد	лідер	None
المرض	захворювання	None
المرضى	хворі	Nan
المركبات	транспортні засоби	Nan
المخدرات	препарат	Nan
المختلفة	інший	None
المختصة	компетентний	Nan
المثلثات	трикутники	None
المثلية	гомеопатія	Nan
المثليين	гомосексуалісти	Nan
المجاعة	голодування	Nan
المجال	поле	None
المجالات	домени	Nan
المجالس	рад	None
المجاهدين	моджахеди	Nan
المجاورة	сусідні	None
المجتمع	суспільство	None
المجتمعات	товариства	None
المجر	угорщина	None
المجرات	галактики	Nan
المجرة	галактика	Nan
المجردة	голий	Nan
المثلث	трикутник	None
المجري	угорська	None
المثل	прислів’я	Nan
المتوكل	аль-мутаваккіл	Nan
المتعددة	мультіплеер	Nan
المتعلقة	пов&#39;язані	Nan
المتقدم	розширений	Nan
المتقدمة	розширений	Nan
المتكاملة	інтегрована	Nan
المتمثلة	представлений	None
المتميزة	видатний	None
المتنبي	мутанаббі	Nan
المتنوعة	різне	Nan
المتواجدة	доступні	None
المتوسط	середня	None
المتوسطة	середній	None
المتوفرة	доступні	None
المتوفى	мертвий	Nan
المتوقع	очікувано	Nan
المثال	приклад	None
المجرية	угорська	None
المجلات	журнали	None
المجلة	журнал	None
المحطات	станції	None
المحطة	станція	None
المحكمة	суд	None
المحلة	махалла	Nan
المحلي	місцеві	None
المحلية	місцеві	None
المحليين	місцеві жителі	Nan
المحور	хаб	Nan
المحيط	океан	None
المحيطات	океани	Nan
المحيطة	оточуючий	Nan
المخ	мозок	None
المخاطر	ризики	Nan
المخاوف	страхи	Nan
المختار	обраний	None
المحسن	розширений	Nan
المحركات	двигуни	Nan
المحرك	двигун	Nan
المحرقة	голокост	None
المجلس	рада	None
المجمع	комплекс	None
المجموع	всього	None
المجموعات	групи	None
المجموعة	група	None
المجيد	славний	Nan
المحاسبة	бухгалтерський облік	Nan
المساء	вечір	Nan
المحاصيل	урожай	Nan
المحافظة	губернаторство	Nan
المحاولات	спроби	None
المحاولة	спробувати	Nan
المحبة	любов	None
المحتلة	окуповані	Nan
المحتمل	ймовірно	None
المحدودة	тов	None
المحافظات	провінції	None
المسائل	питання	None
المسابقات	змагання	None
المسابقة	конкуренція	None
المطلب	вимога	Nan
المطلة	ободок	Nan
المطلق	абсолют	Nan
المطلقة	розлучилися	Nan
المطلوب	вимагається	Nan
المطلوبة	вимагається	Nan
المطيرة	тропічний ліс	Nan
المظاهرات	демонстрації	None
المظلمة	темний	Nan
المعابد	храми	None
المعادن	корисні копалини	Nan
المعادية	вороже	Nan
المعارض	виставки	None
المعارضة	опозиція	None
المعارضين	опоненти	Nan
المطر	дощ	Nan
المعارف	знання	None
المطبخ	кухня	None
المطاعم	ресторани	Nan
المصانع	заводи	None
المصحف	коран	None
المصدر	джерело	None
المصري	єгипетський	Nan
المصرية	єгипетський	Nan
المصريون	єгиптяни	Nan
المصريين	єгиптяни	Nan
المصطلح	термін	None
المصطلحات	термінологія	None
المضاد	контратака	Nan
المضادة	контрзаходи	Nan
المضيف	господар	None
المضيفة	господиня	Nan
المطار	аеропорт	None
المطارات	аеропорти	Nan
المطاف	кінець	None
المعارك	бійки	Nan
المعاصر	сучасний	None
المعاصرة	сучасний	None
المعرفة	знання	None
المعرفي	пізнавальний	Nan
المعرفية	пізнавальний	Nan
المعركة	битва	None
المعروف	відомий	None
المعروفة	відомий	None
المعري	маарі	Nan
المعز	кози	Nan
المعسكر	табір	None
المعقدة	складні	None
المعلم	вчитель	Nan
المعلمين	вчителі	Nan
المعلومات	інформація	None
المعماري	архітектор	None
المعمارية	архітектурна	Nan
المعرض	шоу	None
المعدية	інфекційний	Nan
المعدنية	мінеральні	None
المعدلة	змінено	Nan
المعاصرين	сучасники	None
المعالم	віхи	Nan
المعاني	значення	None
المعاهد	інститути	None
المعاهدات	договори	None
المعاهدة	договір	None
المعايير	стандарти	None
المصالح	інтереси	None
المعبد	храм	None
المعتزلة	мутазіла	Nan
المعتقدات	переконання	None
المعتمد	затверджено	None
المعتمدة	затверджено	None
المعدات	обладнання	None
المعدة	шлунок	None
المعدل	середня	None
المعتدل	помірний	None
المتعة	радість	Nan
المصارف	банки	None
المصاحف	коран	None
المستعمرة	колонія	Nan
المستعملة	б / в	Nan
المستقبل	майбутнє	None
المستقبلية	майбутнє	None
المستقلة	незалежний	Nan
المستمر	безперервне	Nan
المستمرة	наполегливі	Nan
المستوطنات	поселення	None
المستوى	рівень	None
المستويات	рівні	None
المسجد	мечеть	Nan
المسرح	театр	None
المسرحي	театральний	None
المسرحيات	п&#39;єси	Nan
المسرحية	гра	None
المستعمرات	колонії	Nan
المسلح	стрілець	Nan
المستشفيات	лікарні	None
المستشار	радник	Nan
المساجد	мечеті	Nan
المساحة	простір	None
المساعدات	допомога	None
المساعدة	довідка	Nan
المسافات	відстані	None
المسافة	відстань	None
المساكن	житло	None
المساهمة	внесок	None
المساواة	рівність	None
المسبار	зонд	Nan
المسببة	викликаючи	Nan
المستخدم	користувач	None
المستخدمة	б / в	Nan
المستخدمين	користувачі	Nan
المستدامة	сталий	Nan
المستشفى	лікарня	None
المسلحة	озброєний	Nan
المسلسل	серія	None
المسلسلات	серія	None
المشركين	політеїсти	Nan
المشروبات	напої	None
المشروع	проект	None
المشروعات	проекти	None
المشعة	радіоактивний	Nan
المشكلات	проблеми	None
المشكلة	проблема	None
المشهد	сцена	None
المشهور	знаменитий	None
المشهورة	відомий	None
المشهورين	відомий	None
المشير	фельдмаршал	Nan
المصاب	поранений	Nan
المصابة	заражений	Nan
المصابين	травмовані	Nan
المشرفة	наглядач	Nan
المشتري	покупець	Nan
المشترى	покупець	Nan
المشتركة	спільний	None
المسلمة	постулювати	Nan
المسلمون	мусульмани	None
المسلمين	мусульмани	None
المسمى	названий	None
المسيحي	християнин	Nan
المسيحية	християнство	None
المسيحيون	християни	None
المصادر	джерела	None
المسيحيين	християни	None
المشاركة	беріть участь	Nan
المشاركين	учасники	None
المشاريع	проекти	None
المشاعر	почуття	None
المشاكل	проблеми	None
المشاهد	глядач	Nan
المشترك	абонент	Nan
المشاة	пішоходів	Nan
المعنية	стурбований	Nan
المتطورة	передній край	Nan
المتزايد	зростає	None
القومية	націоналізм	None
القوى	повноваження	None
القوي	сильний	None
القوية	погладжений	Nan
القيادة	лідерство	Nan
القياس	аналогія	Nan
القياسي	стандартний	Nan
القياسية	стандартний	Nan
القيام	вистава	Nan
القيامة	воскресіння	None
القيروان	кайруан	Nan
القيس	вимірювання	None
القيصر	цезар	None
القيم	значення	None
القيمة	значення	None
القومي	національний	None
القيود	обмеження	None
القوم	народні	None
القوقاز	кавказ	None
القمح	пшениця	None
القمر	місяць	None
القمرية	місячні	Nan
القمني	апікальний	Nan
القنابل	бомби	Nan
القناة	канал	None
القنوات	канали	None
القهري	нав&#39;язливий	Nan
القوائم	списки	None
القوات	сили	None
القواعد	правила	None
القوافل	конвоїри	Nan
القوانين	закони	None
القوس	лук	Nan
القوط	готи	None
القول	сказати	None
القمة	топ	Nan
الكأس	кубок	None
الكائنات	буття	None
الكثافة	щільність	None
الكثير	багато	None
الكثيرة	багато	None
الكثيرون	багато	None
الكثيرين	багато	None
الكثيفة	щільна	Nan
الكحول	алкоголь	Nan
الكحولية	алкоголік	Nan
الكذب	лежачи	Nan
الكرامة	гідність	Nan
الكربون	вуглець	Nan
الكردية	курдський	Nan
الكرسي	стілець	Nan
الكرك	карак	Nan
الكريم	щедрий	Nan
الكتلة	блок	None
الكائن	об&#39;єкт	Nan
الكتل	блоки	Nan
الكتابة	написання	None
الكاتب	письменник	None
الكاثوليكية	католицизм	None
الكاريبي	карибський басейн	Nan
الكافي	адекватний	Nan
الكافية	адекватний	Nan
الكامل	повна	None
الكاملة	повна	None
الكبار	дорослі	Nan
الكبد	печінка	Nan
الكبرى	чудово	Nan
الكبريت	сірка	None
الكبير	чудово	Nan
الكبيرة	великий	None
الكتاب	книга	None
الكتابات	писання	None
الكتب	книги	None
القماش	полотно	Nan
القليلة	кілька	None
القليل	маленький	Nan
القران	коран	None
القرشي	кураші	Nan
القرص	диск	Nan
القرضاوي	аль-карадаві	Nan
القرم	крим	None
القرن	століття	None
القرنين	два роги	Nan
القرون	стручки	Nan
القرويين	селяни	None
القرى	села	None
القريب	біля	None
القريبة	поруч	None
القرية	село	None
القزمة	гном	Nan
القسطنطينية	константинополь	None
القرارات	рішення	None
القسم	розділ	None
القرار	рішення	None
القراء	читачі	Nan
القدر	доля	None
القدرات	ємність	Nan
القدرة	здатність	None
القدس	єрусалим	Nan
القدسي	аль-кудсі	Nan
القدم	стопа	Nan
القدماء	древні	None
القديس	св	None
القديسين	святі	Nan
القديم	старий	None
القذافي	каддафі	Nan
القذف	кидання	Nan
القرآن	коран	None
القرآني	коран	None
القرآنية	коран	None
القراءة	читання	None
القشرة	лупа	Nan
القصبة	касба	Nan
القصة	історія	None
القطبية	полярний	Nan
القطبين	полюси	Nan
القطر	діаметр	Nan
القطرية	країна	None
القطط	коти	Nan
القطع	різання	Nan
القطن	бавовна	Nan
القعدة	основоположність	Nan
القفز	стрибки	Nan
القلاع	замки	None
القلب	серце	None
القلبية	сердечно	Nan
القلعة	замок	None
القلق	тривога	Nan
القلوب	серця	None
القطبي	полярний	Nan
القطب	полюс	Nan
القطاعات	сектори	Nan
القطاع	сектор	None
القصر	палац	None
القصص	історії	None
القصف	бомбардування	Nan
القصور	недоліки	None
القصوى	крайній	None
القصيدة	вірш	None
القصيرة	короткий	None
الكريمة	милостивий	Nan
القضاء	усунення	None
القضائية	судовий	Nan
القضاة	судді	None
القضايا	випуски	Nan
القضيب	пеніс	Nan
القضية	справа	None
القطار	поїзд	Nan
القطارات	потяги	Nan
القضائي	судовий	Nan
الكسوف	затемнення	Nan
الكعبة	кааба	Nan
الكفاءة	ефективність	None
المؤرخون	історики	None
المؤرخين	історики	None
المؤسس	засновник	None
المؤسسات	установи	None
المؤسسة	підприємство	None
المؤسسين	засновники	Nan
المؤكد	певна	None
المؤلف	автор	None
المؤلفات	література	None
المؤمن	віруючий	Nan
المؤمنين	вірний	Nan
المؤيدين	прихильники	None
المئات	сотні	None
الماء	вода	None
المائة	цент	None
المؤرخ	історик	None
المائدة	стіл	None
المؤثرة	впливовий	Nan
المؤتمر	конференція	None
اللواء	генерал-майор	Nan
اللوحات	картини	None
اللوحة	правління	None
اللون	колір	None
الليبرالية	лібералізм	None
الليبي	лівійський	Nan
الليبية	лівійський	Nan
الليزر	лазерний	Nan
الليل	ніч	None
الليلة	сьогодні вночі	Nan
الليمفاوية	лімфа	Nan
اللَّهُ	аллах	Nan
اللّه	аллах	Nan
المأكولات	їжа	Nan
المأمون	сейф	Nan
المؤتمرات	конференції	None
المائي	водянистий	Nan
المائية	акварель	Nan
المادة	тема	None
المبدأ	принцип	None
المبشرين	місіонери	Nan
المبكر	рано	None
المبكرة	рано	None
المبنى	будівництво	None
المبيدات	пестициди	Nan
المتاحة	доступні	None
المتاحف	музеї	None
المتبقية	залишився	None
المتجددة	поновлювані	Nan
المتحدة	об&#39;єднані	Nan
المتحدثين	доповідачі	Nan
المتحركة	анімація	Nan
المتحف	музей	None
المتخصصة	ніша	Nan
المباني	будинки	None
المباشرة	прямий	None
المباشر	прямий	None
المباريات	сірники	Nan
المادي	фізичні	None
المادية	фізичні	None
الماركسية	марксизм	None
الماسونية	масонство	None
الماشية	врх	Nan
الماضي	минуле	None
الماضية	минуле	None
اللهِ	аллах	Nan
المال	гроші	None
المالكي	аль-малікі	Nan
المالي	фінансові	None
المالية	фінанси	None
الماليزية	малайзійська	Nan
المبادئ	принципи	None
المبادرة	ініціатива	Nan
المباراة	матч	None
المالكة	королівський	None
المتزايدة	зростає	None
اللهم	о аллах	Nan
اللهجات	діалекти	None
الكهربائية	електричні	Nan
الكهربية	електрофізіологія	Nan
الكهرومغناطيسية	електромагнетизм	Nan
الكهنة	священики	None
الكهوف	печери	Nan
الكوارث	катастрофи	None
الكواكب	планети	None
الكورية	корейська	Nan
الكوفة	куфа	Nan
الكوفي	куфі	Nan
الكوكب	планета	None
الكومنولث	співдружність	Nan
الكون	всесвіт	None
الكونغرس	конгрес	None
الكونغو	конго	Nan
الكهربائي	електрофорез	Nan
الكوني	космічний	Nan
الكهرباء	електрика	Nan
الكندية	канадський	Nan
الكلاب	собаки	Nan
الكلاسيكي	класичний	None
الكلاسيكية	класичний	None
الكلام	розмовляти	Nan
الكلمات	слова	None
الكلمة	слово	None
الكلي	нирки	Nan
الكليات	факультети	Nan
الكلية	коледж	None
الكم	квантовий	Nan
الكمال	вдосконалення	None
الكمبيوتر	комп&#39;ютер	Nan
الكمية	кількість	None
الكنائس	церкви	None
الكندي	канадський	Nan
الكنيسة	церква	None
الكونية	космічний	Nan
الكويت	кувейт	Nan
الكويتي	кувейт	Nan
اللحظة	момент	None
اللحم	м&#39;ясо	Nan
اللحوم	м&#39;ясо	Nan
اللذان	вооз	Nan
اللسان	язик	Nan
اللطيف	симпатичне	Nan
اللعب	грати	None
اللعبة	гра	None
اللغات	мови	None
اللغة	мова	None
اللغوية	мовна	None
اللفظ	вимова	Nan
اللقاء	зустріч	None
اللقب	назва	None
الله	аллах	Nan
اللجوء	шукати притулку	Nan
اللجنة	комісія	None
اللبنانيين	ліванець	Nan
اللبنانية	ліванці	Nan
الكويتية	кувейт	Nan
الكويكبات	астероїди	Nan
الكيماوية	хімічна	None
الكيمياء	хімія	None
الكيميائي	хімік	Nan
الكيميائية	хімічна	None
اللاتيني	латинська	None
اللهجة	акцент	None
اللاتينية	латинська	None
اللاحقة	суфікс	Nan
اللاذقية	латтакія	Nan
اللازم	необхідні	None
اللازمة	необхідні	None
اللاعب	гравець	Nan
اللاعبين	гравці	None
اللبناني	ліванці	Nan
اللاجئين	біженці	Nan
يُمكن	можна	None
