$	$	None
عانى	szenvedni	Nan
عبادة	imádat	Nan
عبارة	kifejezés	None
عباس	abbas	Nan
عبد	rabszolga	Nan
عبده	rabszolga	Nan
عبر	keresztül	None
عبرانيون	zsid	Nan
عبور	átkelés	Nan
عبيد	rabszolgák	None
عبيدة	obaida	Nan
عتبة	küszöb	Nan
عثر	megtalálták	None
عثمان	othman	Nan
عثمانية	török	None
عانت	szenvedett	None
عجائب	csodák	Nan
عامًا	évek	None
عامي	köznyelvi	Nan
عاصمتها	fővárosa	None
عالم	tudós	None
عالمي	az én világom	Nan
عالميا	világszerte	None
عالمياً	világszerte	None
عالمية	nemzetközi	None
عالي	magas	None
عالية	magas	None
عام	év	None
عاما	éves	None
عاماً	év	None
عامة	tábornok	None
عامر	amer	Nan
عامل	tényező	None
عاملاً	egy tényező	Nan
عاميّ	szleng	Nan
عاصمته	fővárosa	None
عدا	kivéve	None
عدد	szám	None
عرضت	felajánlott	Nan
عرضه	fogékony	Nan
عرضها	megjelenik	None
عرف	tudta	None
عرفات	arafat	Nan
عرفة	arafa	Nan
عرفت	tudtam	Nan
عرفوا	tudták	None
عروة	lap	None
عز	mindenható	Nan
عزل	elkülönítés	Nan
عزم	meghatározás	Nan
عزيز	kedves	None
عسكري	katona	None
عسكرية	katonai	None
عرضة	fogékony	Nan
عدة	számos	None
عرض	előadás	None
عربية	arab	None
عددا	egy szám	Nan
عدداً	egy szám	Nan
عددها	a számuk	Nan
عددهم	a számuk	Nan
عددًا	egy szám	Nan
عدل	igazságszolgáltatás	None
عدم	nem	None
عدن	aden	Nan
عدنان	adnan	Nan
عدوى	fertőzés	None
عدي	oday	Nan
عديدة	sok	None
عدّة	számos	None
عرب	arabok	None
عربي	arab	None
عرش	trón	None
عاصمة	főváros	None
عاصم	assem	Nan
عاصفة	vihar	None
طلاب	diákok	None
طلال	talal	Nan
طلب	kérés	Nan
طلبة	diákok	None
طلبت	kért	Nan
طلبه	az ő kérése	Nan
طلحة	talha	Nan
طن	tonna	Nan
طنجة	tanger	Nan
طه	taha	Nan
طهران	teherán	Nan
طوائف	kultuszokat	Nan
طوال	egész	None
طور	fejleszt	Nan
طورت	fejlett	None
طلائعيات	úttörő	Nan
طول	hossz	Nan
طقوس	szertartás	Nan
طفل	gyermek	None
طبيعية	természetes	None
طرابلس	tripoli	Nan
طراز	stílus	None
طرازات	teszi	None
طرح	levon	Nan
طرد	rúgás	Nan
طرف	buli	Nan
طرفاوية	terminál	Nan
طرق	mód	None
طرول	trowels	Nan
طريق	út	None
طريقة	módszer	None
طريقه	módszer	None
طريقها	az útja	Nan
طعام	étel	None
طفولته	az ő gyerekkora	Nan
طولها	hossza	None
طويل	hosszú	None
طويلا	hosszú	None
عابرة	elhaladó	Nan
عاد	visszatért	None
عادات	szokások	None
عادة	szokás	None
عادةً	szokás	None
عادت	visszatért	None
عادل	éppen	None
عادوا	visszajöttek	Nan
عادي	normál	None
عادية	normál	None
عارض	néző	None
عارف	ismerve	Nan
عاش	élő	None
عاشت	ő élt	Nan
عاشوراء	ashura	Nan
عائلته	az ő családja	Nan
عائلة	egy család	Nan
عائلات	családok	None
عائشة	aisha	Nan
طويلاً	hosszú	None
طويلة	hosszú	None
طيبة	kedves	None
طيران	repülési	Nan
طيلة	az egész	Nan
طيور	madarak	None
ظاهر	látszólagos	None
عسل	édesem	Nan
ظاهرة	jelenség	None
ظل	árnyék	Nan
ظلت	megmaradtak	Nan
ظهر	vissza	None
ظهرت	megjelent	None
ظهره	az ő háta	Nan
ظهور	megjelenése	None
ظواهر	jelenségek	None
ظروف	körülmények	None
طبيعي	természetes	None
عسير	nehéz	None
عشر	tíz	None
عندما	amikor	None
عنده	van	Nan
عندها	azután	None
عندهم	van nekik	Nan
عنصر	elem	None
عنق	nyak	None
عنه	róla	None
عنها	róla	None
عنهم	róluk	None
عنهما	róluk	None
عنوان	cím	None
عني	rólam	Nan
عنيفة	erőszakos	None
عهد	szövetség	None
عهده	őrizet	Nan
عندئذ	azután	None
عهود	szövetségek	Nan
عند	nál nél	Nan
عنترة	antara	Nan
عمليات	tevékenységek	None
عملية	folyamat	None
عمه	néni	None
عمود	pólus	Nan
عموم	pán	Nan
عموما	általában	None
عموماً	általában	None
عمومًا	általában	None
عمير	emír	Nan
عميق	mély	None
عميقة	mély	None
عمّان	omán	Nan
عن	ról ről	Nan
عناصر	példány	Nan
عناية	figyelem	Nan
عنخ	ankh	Nan
عملها	a munkája	Nan
عواصم	capitals	Nan
عوامل	tényezők	None
غازات	gázok	None
غازي	gáznemű	Nan
غالب	ghalib	Nan
غالبا	gyakran	None
غالباً	gyakran	None
غالبية	nagy része a	Nan
غالبًا	gyakran	None
غاما	gamma	Nan
غاميلان	gamilan	Nan
غاندي	gandhi	None
غانم	ghanem	Nan
غاية	rendeltetési hely	Nan
غباء	hülyeség	Nan
غذاء	étel	None
غرار	tetszik	None
غاز	gáz	None
عواقب	következményei	None
غار	babér	Nan
غابات	az erdők	Nan
عودة	vissza	None
عودته	visszatérése	None
عوف	aouf	Nan
عيد	ünnep	None
عيسى	essa	Nan
عين	szem	None
عينات	minták	Nan
عينيه	a szemei	Nan
عيون	szemek	Nan
عَلَى	ali	None
عَلَيْهِ	rajta	None
عُثر	megtalálták	None
عُرف	tudta	None
عُرفت	tudta	None
عُمان	omán	Nan
غادر	bal	None
عمله	valuta	Nan
عملت	dolgoztam	Nan
عملة	valuta	Nan
عظيم	nagy	None
عظيمة	nagy	None
عفان	affan	Nan
عفص	tímárság	Nan
عقارب	hands	Nan
عقب	utána	None
عقبة	akadály	Nan
عقد	egy nyaklánc	Nan
عقدت	held	Nan
عقل	ész	None
عقوبة	büntetés	None
عقود	évtizedek	None
عقيدة	elmélet	None
عكا	acre	Nan
عكس	fordított	None
عظمى	csontos	Nan
علاء	alaa	Nan
عظمة	nagyság	Nan
عظام	csontok	Nan
عشرات	tíz	None
عشرة	tíz	None
عشرية	decimális	Nan
عشرين	húsz	None
عصام	essam	Nan
عصبة	liga	None
عصر	kicsal	Nan
عصره	kora	None
عصور	a korszakok	Nan
عصير	gyümölcslé	Nan
عضوا	tag	None
عضواً	tag	None
عضوية	tagság	Nan
عطارد	higany	Nan
عطلة	ünnep	None
عظم	csont	Nan
علاج	terápia	None
علاقات	relations	Nan
علاقاتها	a kapcsolatai	Nan
عليهم	rajtuk	None
عليهما	rajtuk	None
عليّ	ali	None
عم	nagybácsi	Nan
عما	ról ről	Nan
عماد	emad	Nan
عمال	dolgozók	None
عمان	omán	Nan
عمد	megkeresztelt	Nan
عمر	omar	Nan
عمره	a kora	Nan
عمرو	amr	Nan
عمق	mélység	Nan
عمل	akció	None
عملاق	óriás	None
عليها	rajta	None
عليه	rajta	None
علينا	mi	None
عليكم	rajtad	Nan
علاقة	kapcsolat	None
علامات	jelek	None
علامة	jel	None
علاوة	pótlék	Nan
علاوةً	ráadásul	None
علم	tudomány	None
علما	jegyzet	Nan
عش	élő	None
علماء	tudósok	None
علماً	jegyzet	Nan
علمه	tudása	Nan
علمية	tudományos	None
علوم	sciences	Nan
على	tovább	None
علي	ali	None
عليك	rajtad	Nan
علمانية	szekularizmus	Nan
طبيعة	természet	None
طبية	orvosi	None
طبيب	orvos	None
شخصيته	karakterét	Nan
شداد	szigorítása	Nan
شديد	erős	None
شديداً	nagyon nehéz	Nan
شديدًا	nagyon nehéz	Nan
شراء	vásárlás	Nan
شراكة	társaság	None
شرب	ital	None
شرج	végbélnyílás	Nan
شرح	magyarázható	None
شرط	feltétel	None
شرع	folytatta	None
شرعية	törvényesség	Nan
شرف	becsület	Nan
شرق	keleti	None
شخصية	karakter	None
شرقا	keleti	None
شخصيات	méltóságok	Nan
شحنة	szállítmány	Nan
شامل	átfogó	None
شاملة	befogadó	Nan
شاه	sah	Nan
شاهد	lát	None
شاهين	shaheen	Nan
شباب	ifjúság	None
شبابه	az ifjúságában	Nan
شبكات	networks	Nan
شبكة	hálózat	None
شبه	azonos	None
شبيه	mint	None
شبيهة	hasonló	None
شتى	különféle	None
شجرة	fa	None
شجع	felbátorodva	Nan
شخص	személy	None
شامة	anyajegy	Nan
شرقاً	keleti	None
شركات	cégek	None
شعوب	emberek	None
شغل	tölt	None
شق	metszés	Nan
شقيقه	lánytestvér	Nan
شك	kétség	Nan
شكل	forma	None
شكلت	alakított	None
شكله	alakja	None
شكلها	alakja	None
شمال	északi	None
شمالا	északi	None
شمالاً	északi	None
شمالي	északi	None
شمس	nap	None
شمسية	esernyő	Nan
شعره	haj	Nan
شرقي	keleti	None
شعراء	költők	None
شعبية	népszerűség	Nan
شركة	a cég	Nan
شروط	feltételek	None
شريط	szalag	Nan
شريعة	törvény	None
شريف	sherif	Nan
شريك	partner	Nan
شطرنج	sakk	None
شعائر	rituálék	Nan
شعار	logo	Nan
شعاع	gerenda	Nan
شعب	emberek	None
شعبان	shaaban	Nan
شعبة	szakasz	None
شعبه	szakasz	None
شعبي	népszerű	None
شعر	költészet	None
شاكلة	tetszik	None
شاكر	rázó	Nan
شاطئ	strand	Nan
سوري	szír	Nan
سوريا	szíria	Nan
سورية	szír	Nan
سوف	akarat	None
سوق	piac	None
سومطرة	sumatra	Nan
سوى	de	None
سويسرا	svájc	None
سي	c.	Nan
سيئة	rossz	None
سياحة	idegenforgalom	None
سياحية	idegenforgalom	None
سيادة	szuverenitás	Nan
سيارات	cars	Nan
سيارة	autó	None
سورة	surah	Nan
سياسات	házirendje	Nan
سور	kerítés	Nan
سواحل	tengerpartok	Nan
سنغافورة	singapore	Nan
سنن	szunani	Nan
سنه	év	None
سنوات	évek	None
سنويا	évente	None
سنوياً	évente	None
سنوية	évi	None
سنويًا	évente	None
سنين	évek	None
سهل	könnyen	None
سهول	plains	Nan
سهولة	nyugalom	Nan
سهيل	suhail	Nan
سوء	beteg	None
سواء	vajon	None
سوداء	fekete	None
سياسة	irányelv	Nan
سياسي	politikus	None
سياسيا	politikailag	None
سيناء	sinai	Nan
شأن	ügy	None
شأنه	vajon	None
شأنها	tetszik	None
شؤون	ügyek	None
شئون	ügyek	None
شاء	meg akarja tenni	Nan
شائع	gyakori	None
شائعة	szóbeszéd	Nan
شارع	utca	None
شارك	ossza meg	Nan
شاركت	részt vettem	Nan
شارل	károly	None
شاسعة	hatalmas	None
شاش	géz	Nan
سيما	különösen	None
سيلينيوم	szelén	None
سيكون	lesz	None
سيكلامين	ciklámen	None
سياسية	politikai	None
سياق	kontextus	Nan
سيتم	lesz	None
سيتي	város	None
سيد	úr	None
سيدة	hölgy	None
سيدي	úr	None
شمل	tartalmaz	None
سير	séta	Nan
سيرته	életrajza	None
سيطر	viselkedj	Nan
سيطرة	ellenőrzés	None
سيطرت	átvette az irányítást	Nan
سيطرتها	az ő irányítása	Nan
سيف	kard	None
سيفه	a kardját	Nan
سيرة	életrajz	None
شملت	beleértve	None
شن	shen	Nan
شهاب	hullócsillag	Nan
صوتية	hang	None
صور	fénykép	Nan
صورة	kép	None
صوفيا	sofia	Nan
صياغة	szerkesztés	Nan
صيد	vadászat	None
صيغة	képlet	Nan
صيف	nyár	None
صَلَّى	imádkozik	Nan
ضئيلة	vékony	None
ضابط	tiszt	None
ضباط	tisztek	None
ضبط	beállítás	Nan
ضحايا	áldozatai	None
ضخم	hatalmas	None
صوت	hang	None
ضخمة	hatalmas	None
صوب	cél	None
صنف	osztály	None
صلاة	ima	Nan
صلاح	salah	Nan
صلاحيات	feladatmeghatározás	Nan
صلادة	keménység	None
صلب	szilárd	None
صلبة	szilárd	None
صلة	link	Nan
صلح	egyeztetés	Nan
صلى	imádkozik	Nan
صناعات	industries	Nan
صناعة	így	None
صناعي	ipari	None
صناعية	ipari	None
صندوق	doboz	Nan
صنع	így	None
صواريخ	rakéták	Nan
ضد	ellen	None
ضده	ellene	None
ضربة	találat	Nan
طائرة	repülőgép	None
طائفة	szekta	Nan
طابع	egy bélyeg	Nan
طارق	tariq	Nan
طاعة	engedelmesség	Nan
طاقة	energia	None
طالب	diák	None
طالبت	- követelte	Nan
طالع	lát	None
طالما	amíg	None
طاهر	hibátlan	Nan
طب	gyógyszer	None
طبقا	szerint	None
طبقاً	szerint	None
طبقة	réteg	None
طائرات	planes	Nan
ضيقة	szoros	None
ضيق	szoros	None
ضواحي	suburbs	Nan
ضرورة	szükségesség	Nan
ضرورية	szükséges	None
ضريبة	adó	None
ضريح	ereklyetartó	Nan
ضعف	gyengeség	Nan
ضعيف	gyenge	None
ضعيفة	gyenge	None
صقلية	szicília	Nan
ضغط	nyomás	None
ضم	kombájn	Nan
ضمان	garancia	Nan
ضمت	beleértve	None
ضمن	belül	None
ضمنها	ezen belül	Nan
ضوء	fény	None
ضوئية	fény	None
ضفاف	banks	Nan
غرب	nyugat	None
صقر	sólyom	None
صفوف	sorok	None
شيوخ	idősek	Nan
شيوعا	gyakori	None
شيوعاً	gyakori	None
شيوعية	kommunizmus	None
شيوعًا	gyakori	None
ص	s	None
صاحب	tulajdonos	None
صاحبه	a tulajdonosa	Nan
صادرات	export	None
صادق	becsületes	None
صار	ez történt	Nan
صارت	vált	None
صارمة	szigorú	None
صالح	érvényes	None
صالحة	érvényes	None
شيد	szerkesztett	None
صباح	reggel	None
شيخ	sejk	Nan
شيئاً	valami	None
شهادة	fokozat	None
شهد	tanú	Nan
شهدت	láthattuk	Nan
شهدوا	láttak	None
شهر	hónap	None
شهرة	hírnév	Nan
شهور	hónapok	None
شوارع	streets	Nan
شواطئ	strandok	Nan
شوال	shawwal	Nan
شوقي	shawky	Nan
شي	shi	Nan
شيء	dolog	None
شيءًا	valami	None
شيئا	valami	None
شيث	seth	Nan
صبحي	sobhi	Nan
صبري	türelmem	Nan
صحة	egészség	Nan
صرح	állította	None
صريح	kifejezett	Nan
صعب	kemény	None
صعبة	nehéz	None
صعوبة	nehézség	Nan
صعيد	szint	None
صغار	beosztott	Nan
صغير	kicsi	None
صغيرة	kicsi	None
صف	sor	None
صفات	a tulajdonságok	Nan
صفة	leírás	None
صفحات	oldalak	None
صفحة	oldal	None
صفر	nulla	None
صربيا	szerbia	None
صراع	összeütközés	Nan
صديقه	barátnő	Nan
صديق	barát	None
صحراء	sivatag	Nan
صحف	újságok	None
صحية	egészséges	None
صحيح	igaz	None
صحيحة	helyes	None
صحيحه	helyes	None
صحيفة	újság	None
صفين	két sor	Nan
صخرية	sziklás	Nan
صد	női mellény	Nan
صداقة	barátság	None
صدام	szaddám	Nan
صدر	felszabadított	Nan
صدرت	kiadott	None
صدق	igazság	None
صدور	mellkas	Nan
صخور	rocks	Nan
سنتين	két év	Nan
غربا	nyugat	None
غربي	nyugati	None
كأس	csésze	Nan
كأنه	mintha	None
كائن	egy tárgy	Nan
كائنات	tárgyak	None
كاتب	hivatalnok	Nan
كاتدرائية	székesegyház	None
كاترين	katrin	Nan
كاجو	kesudió	Nan
كاد	majdnem	None
كادميوم	kadmium	Nan
كارل	carl	None
كارلوس	carlos	None
كاروانسرا	karwansra	Nan
كارولين	caroline	Nan
كاسترو	castro	None
قُتل	ölés	Nan
كاظم	kazem	Nan
قَالَ	ő mondta	Nan
قيمة	értékek	None
قومية	nacionalizmus	None
قوى	erős	None
قوي	erős	None
قوياً	erős	None
قوية	erős	None
قويسة	zsálya	Nan
قي	mérték	Nan
قيادة	vezetés	None
قياس	mérés	Nan
قيام	do	Nan
قيد	korlátoz	Nan
قيس	qais	Nan
قيصر	caesar	None
قيل	azt mondták	Nan
قيم	értékek	None
قيود	korlátozások	Nan
قومي	nemzeti	None
كافة	összes	None
كافية	elég	None
كبيراً	nagy	None
كبيرة	nagy	None
كبيرًا	nagy	None
كتائب	zászlóaljak	Nan
كتاب	könyv	None
كتابات	írások	None
كتابة	írás	None
كتابه	írás	None
كتب	írt	None
كتبت	írtam	Nan
كتبغا	írott	None
كتبه	írta	None
كتبها	írta	None
كتل	blocks	Nan
كتلة	tömeg	None
كبيرا	nagy	None
كافور	kámfor	Nan
كبير	nagy	None
كبر	felnő	Nan
كالتالي	alábbiak szerint	Nan
كاليفورنيا	kalifornia	None
كامب	tábor	None
كامل	egész	None
كاملاً	teljesen	None
كاملة	tökéletes	None
كان	ez volt	Nan
كانا	ők voltak	Nan
كاناميسين	kanamicint	Nan
كانت	ő volt	Nan
كانتا	ők voltak	Nan
كانوا	ők voltak	Nan
كانون	kánon	Nan
كايبر	lazac	Nan
كبار	idősebb	None
كبرى	nagy	None
قومه	az ő népe	Nan
قوم	emberek	None
قوله	mondván	None
قصائده	versei	None
قصة	egy történet	Nan
قصد	értem	Nan
قصر	palota	None
قصص	történetek	None
قصف	bombázás	Nan
قصور	kudarc	None
قصيدة	vers	None
قصير	rövid	None
قصيرة	rövid	None
قضاء	tölt	None
قضايا	problémák	None
قضى	költött	Nan
قضيبه	a péniszét	Nan
قضية	probléma	None
قصائد	versek	None
قط	soha	None
قسمين	két szakasz	Nan
قسم	osztály	None
قرر	elhatározta	None
قرص	tabletta	Nan
قرطاج	carthage	Nan
قرطاجنة	cartagena	Nan
قرطبة	cordoba	Nan
قرن	egy évszázad	Nan
قرون	évszázadokkal	Nan
قرى	falvak	None
قريب	bezárás	Nan
قريبة	bezárás	Nan
قرية	falu	None
قريش	quraysh	Nan
قريظة	qurayza	Nan
قزوين	caspian	Nan
قسطنطين	constantine	Nan
قسمت	megosztott	None
قطار	vonat	Nan
قطاع	szakasz	None
قطاعات	ágazatok	None
قمر	hold	None
قمع	elnyomás	Nan
قناة	csatorna	None
قنوات	csatornák	None
قوائم	list	Nan
قوات	erők	None
قواته	az ő erõi	Nan
قواتها	erõi	Nan
قواعد	szabályok	None
قوانين	szabályok	None
قوبلاي	kublai	Nan
قوة	energia	None
قوتها	erőssége	None
قوس	boltív	Nan
قول	mond	None
قمة	csúcstalálkozó	Nan
قم	regisztrálj	Nan
قليلة	néhány	None
قليلاً	némileg	None
قطب	pólus	Nan
قطر	átmérő	Nan
قطرها	átmérő	Nan
قطز	al-muzaffar kutuz egyiptomi szultán	Nan
قطع	vágott	None
قطعة	darab	None
قلاوون	qalawun	Nan
كتيبة	zászlóalj	Nan
قلب	szív	None
قلبي	a szívem	Nan
قلة	hiány	Nan
قلت	mondtam	Nan
قلعة	kastély	None
قلوب	szívek	Nan
قليل	kis	None
قليلا	némileg	None
قلبه	a szíve	Nan
قرب	közel	None
كثافة	sűrűség	None
كثرة	bőven	None
لألمانيا	németország részéről	Nan
لأن	mivel	None
لأنه	mert ő	Nan
لأنها	mert ő	Nan
لأهل	az embereknek	Nan
لأوروبا	európa számára	Nan
لأول	elsőre	Nan
لأي	bármilyen	None
لإثبات	bizonyítani	Nan
لإجراء	vezetni	None
لإدارة	menedzselni	Nan
لإسرائيل	izraelhez	Nan
لإعادة	alaphelyzetbe állítás	Nan
لإقامة	létrehozni	None
لإنتاج	termelni	Nan
لأكثر	többért	Nan
لإنشاء	készíteni	None
لأفضل	jobbért	Nan
لأسباب	okokból	None
كيشيون	kasion	Nan
كيف	hogyan	None
كيفية	hogyan kell	Nan
كيلومتر	kilométer	None
كيمياء	kémia	None
كيميائي	kémiai	None
كيميائية	kémiai	None
كييف	kijev	Nan
ل	nak nek	Nan
لآخر	egy másikra	Nan
لأبي	apámnak	Nan
لأجل	kedvéért	None
لأحد	bárkinek	Nan
لأداء	előadni	Nan
لأرسطو	arisztotelésznek	Nan
لأغراض	célra	None
كيشوا	kecsua	Nan
لإيجاد	megtalálni	None
لابد	kell	None
لاَ	nem	None
لبث	betölt	Nan
لبعض	néhány	None
لبلاد	egy ország számára	Nan
لبناء	építeni	None
لبنانية	libanoni	Nan
لتجنب	elkerülni	Nan
لتحديد	hogy meghatározza	Nan
لتحرير	szerkeszteni	Nan
لتحسين	fejleszteni	Nan
لتحقيق	elérni	None
لتشكل	pózolni	Nan
لتشكيل	alakítani	Nan
لتشمل	hogy tartalmazza	Nan
لتصبح	válni	None
لاين	vonal	None
لا	nem	None
لايف	élő	None
لاند	föld	None
لابن	a fiúnak	Nan
لاتخ	ne hibáztasd	Nan
لاحظ	értesítés	Nan
لاحق	később	None
لاحقا	később	None
لاحقاً	később	None
لاحقة	képző	Nan
لادن	megrakott	Nan
لاسم	névre	None
لاسيما	különösen	None
لاعب	játékos	None
لاعبي	a játékosok	Nan
لاقت	találkozott	None
لامدا	lambda	Nan
لان	mivel	None
لانه	mert ő	Nan
كيان	egység	None
كي	ki	None
كونها	lény	None
كسر	lerobbant	Nan
كشف	felfed	Nan
كشفت	feltárta	Nan
كعب	sarok	Nan
كفر	hitetlenség	Nan
كقوة	erőként	Nan
ككل	mint egész	Nan
كل	minden egyes	Nan
كلا	mindkét	None
كلام	beszél	None
كلثوم	kulthum	Nan
كلغة	mint egy nyelv	Nan
كلما	bármikor	None
كلمات	dalszöveg	Nan
كلمة	egy szó	Nan
كسب	pénzt keres	Nan
كله	teljes	None
كريت	kréta	None
كركيات	crocs	Nan
كثير	nagyon	None
كثيرا	sokkal	None
كثيراً	sokkal	None
كثيرة	nagyon	None
كثيرون	sok	None
كثيف	sűrű	None
كثيفة	nehéz	None
كجزء	részeként	None
كدولة	mint ország	Nan
كذا	ilyen	None
كذلك	is	None
كرات	balls	Nan
كربلاء	karbala	Nan
كرة	egy labda	Nan
كرسي	egy szék	Nan
كريات	pellet	Nan
كلها	amelyek mindegyike	Nan
كلهم	mindegyikük	None
كليات	karok	Nan
كهربائي	villanyszerelő	Nan
كهربائية	elektromos	None
كواكب	bolygók	None
كوايك	quik	Nan
كوبا	kuba	None
كوريا	korea	Nan
كوريوم	kűrium	Nan
كوزميد	cozumid	Nan
كوسيلة	mint úgy	Nan
كوكب	bolygó	None
كولوم	ampermásodperc	Nan
كولومبيا	colombia	Nan
كون	világegyetem	None
كونان	conan	Nan
كونه	lény	None
كهرباء	elektromosság	Nan
كنيسة	egy templom	Nan
كنعان	kánaán	Nan
كندا	kanada	None
كليب	csipesz	Nan
كلية	főiskola	None
كلينتون	clinton	Nan
كليوباترا	kleopátra	Nan
كلّ	minden egyes	Nan
كم	mennyi	None
كما	mint olyan	Nan
كثر	sok	None
كمال	tökéletesség	Nan
كميات	mennyiségek	Nan
كمية	mennyiség	None
كنا	voltunk	Nan
كنائس	templomok	None
كنانة	kinaanah	Nan
كنت	én voltam	Nan
كنتيجة	ennek eredményeként	Nan
كمصدر	forrásként	Nan
قرارات	határozatok	Nan
قرار	felbontás	Nan
قرابة	ról ről	Nan
فرسان	knights	Nan
فرساي	versailles	Nan
فرص	lehetőségek	None
فرصة	véletlen	None
فرض	szabhat	Nan
فرضت	befogott	Nan
فرضية	hipotézis	Nan
فرع	egy ág	Nan
فرعون	fáraó	None
فرعية	másodlagos	None
فرق	különbség	None
فرقة	osztag	Nan
فرنسا	franciaország	None
فرنسي	francia	None
فرنسية	francia	None
فردية	egyedi	None
فروع	ágak	Nan
فرد	egyéni	None
فرانك	őszinte	Nan
فترة	intervallum	Nan
فتكون	te leszel	Nan
فتم	ftm	Nan
فتنة	kísértés	Nan
فجاء	így jött	Nan
فجر	hajnal	None
فجعل	csinált	None
فحسب	csak	None
فحص	kivizsgál	Nan
فخرج	szóval kiment	Nan
فخلال	alatt	None
فدخل	így belépett	Nan
فذهب	szóval elment	Nan
فراس	firas	Nan
فرانسيسكو	francisco	None
فرانكو	franco	None
فترات	időszakok	Nan
فرويد	freud	None
فريدة	farida	Nan
فعلاً	igazán	None
فعله	kész	None
فعلى	tényleges	None
فعندما	amikor	None
ففي	ban ben	Nan
فقال	ő mondta	Nan
فقالت	és mondta	Nan
فقالوا	így mondták	Nan
فقام	szóval felállt	Nan
فقامت	szóval felállt	Nan
فقبل	előtt	None
فقد	elveszett	None
فقدان	veszteség	Nan
فقدت	elveszett	None
فقر	szegénység	None
فعلا	igazán	None
فريد	egyedi	None
فعل	törvény	None
فعالة	hatékony	None
فريدريك	frederick	Nan
فريق	csapat	None
فشل	kudarc	None
فشلت	nem sikerült	Nan
فصائل	faj	None
فصل	évszak	None
فصول	fejezetek	Nan
فضاء	tér	None
فضائية	tér	None
فضل	kösz	Nan
فضلا	szintén	None
فضلاً	szintén	None
فطلب	- kérdezte	Nan
فطيرة	pite	Nan
فعال	hatékony	None
فعالية	hatékonyság	Nan
فتحي	fathi	Nan
فتحها	nyisd ki	Nan
فتحت	megnyitotta	None
غلطة	hiba	None
غلوكوز	szőlőcukor	Nan
غلوون	gluon	Nan
غناء	éneklés	Nan
غناها	gazdagsága	Nan
غني	gazdag	None
غنية	gazdag	None
غوستاف	gustav	Nan
غياب	hiány	Nan
غير	nem	None
غيره	irigy	Nan
غيرها	egyéb	None
غيرهم	egyéb	None
غيفارا	guevara	None
غينيا	guinea	Nan
غلاف	burkolat	Nan
فأخذ	szóval ő vette	Nan
غطاء	borító	None
غضب	harag	Nan
غربية	nyugati	None
غربًا	nyugat	None
غرفة	szoba	Nan
غرناطة	granada	Nan
غريب	egy idegen	Nan
غريبة	furcsa	None
غرين	greene	Nan
غزا	meghódított	Nan
غزة	gáza	Nan
غزو	betör	Nan
غزوات	forays	Nan
غزوة	fosztogat	Nan
غسق	szürkület	None
غسل	mosás	Nan
غشاء	membrán	Nan
غضون	belül	None
فأرسل	ő küldte	Nan
فأصبح	lett	None
فأصبحت	valamivé váltam	Nan
فاطمة	fatima	Nan
فاعلية	hatékonyság	Nan
فالج	hemiplegia	Nan
فالكيري	valkyrie	Nan
فالنتين	valentin	Nan
فان	kisteherautó	Nan
فاندانغو	fandango	Nan
فايمار	weimar	Nan
فبدأ	szóval elkezdett	Nan
فبراير	február	None
فبعد	utána	None
فبعض	néhány	None
فتاة	lány	None
فتح	nyisd ki	Nan
فتحة	rés	Nan
فاس	fejsze	Nan
فازت	ő nyerte	Nan
فاز	nyerte	None
فاروق	farooq	Nan
فأمر	szóval elrendelte	Nan
فأن	azután	None
فؤاد	fouad	Nan
فإذا	így	None
فإن	a	None
فإننا	mi fogunk	Nan
فإنه	igen	None
فقرر	szóval úgy döntött	Nan
فإنها	fognak	None
فئات	kategóriák	Nan
فئة	kategória	None
فائدة	haszon	Nan
فائقة	szuper	Nan
فاراداي	faraday	Nan
فارس	lovag	None
فارسي	perzsa	None
فإنهم	ők	None
فقط	éppen	None
فقلت	tehát mondtam	Nan
فقه	jogtudomány	Nan
قارات	kontinensek	Nan
قارة	kontinens	None
قاسم	névadó	Nan
قاسية	kegyetlen	None
قاعة	előszoba	Nan
قاعدة	bázis	None
قال	ő mondta	Nan
قالت	azt mondta	Nan
قاله	azt mondta	Nan
قالوا	azt mondták	Nan
قام	rózsa	None
قامت	csinált	None
قاموا	felkeltek	Nan
قاموس	szótár	None
قانون	törvény	None
قادرين	képes	None
قانوني	jogi	None
قادرة	képes	None
قادت	ő vezette	Nan
فيهما	bennük	None
فيينا	bécs	None
فِي	egy a	Nan
ق	s	None
قائد	vezető	None
قائلا	mondás	Nan
قائلاً	mondás	Nan
قائم	létező	None
قائمة	lista	None
قابل	találkozott	None
قابلة	találkoztam vele	Nan
قابوس	qaboos	Nan
قاتل	gyilkos	None
قاد	hajtott, vezetett	Nan
قادة	vezetők	None
قادر	képes	None
قانونية	jogi	None
قايتباي	qaitbay	Nan
قباء	quba	Nan
قدرته	képessége	None
قدرتها	képessége	None
قدرها	a sorsa	Nan
قدم	láb	None
قدماء	ancients	Nan
قدمت	benyújtott	Nan
قدمه	tálaljuk	Nan
قدمها	tálaljuk	Nan
قدوم	eljövetel	Nan
قديم	régi	None
قديما	a múltban	Nan
قديمًا	régi idő	Nan
قذف	lő	Nan
قرأ	olvas	Nan
قراءة	olvasás	Nan
قدرت	becsültem	Nan
قدرة	kapacitás	Nan
قدر	lábas	Nan
قد	lehet	None
قبائل	törzsek	None
قباني	dákó nekem	Nan
قبة	kupola	Nan
قبر	síremlék	Nan
قبرص	ciprus	None
قبره	pacsirta	Nan
قبض	fogás	Nan
فيهم	beleértve	None
قبل	előtt	None
قبول	elfogadás	Nan
قبيلة	törzs	None
قتال	harcoló	None
قتل	ölés	Nan
قتلة	gyilkosok	Nan
قتله	gyilkosok	Nan
قتلوا	megölve	Nan
قبله	csók	Nan
غرباً	nyugat	None
فيها	amiben	None
فينول	fenol	None
فلك	csillagászat	None
فلم	film	None
فلما	miért	None
فلمّا	miért	None
فلن	nem fogsz	Nan
فلو	összekötő tiszt	Nan
فلورنسا	firenze	None
فليس	ez nem	Nan
فما	és akkor mi van	Nan
فمثلا	például	None
فمثلاً	például	None
فمن	ez	None
فمنذ	mivel	None
فمنهم	tőlük van	Nan
فن	művészet	None
فلقد	megvan	None
فنان	művész	None
فلسفة	filozófia	None
فلسطيني	palesztin	None
فقهاء	jogászok	Nan
فقيل	azt mondták	Nan
فك	megfejtés	Nan
فكان	ez volt	Nan
فكانت	ez volt	Nan
فكانوا	ők voltak	Nan
فكر	gondolat	None
فكرة	ötlet	None
فكل	tehát minden	Nan
فلا	ez nem	Nan
فلاح	a mezőgazdasági termelő	Nan
فلاديمير	vladimir	Nan
فلاسفة	filozófusok	None
فلدسبار	földpát	Nan
فلسطين	palesztina	None
فلسطينية	palesztin	None
فندق	szálloda	Nan
فنزويلا	venezuela	None
فنلندا	finnország	None
فيديو	videó	None
فيرفكس	firefox	None
فيروس	vírus	None
فيروسات	vírusok	None
فيرونا	verona	Nan
فيزيائية	fizikai	None
فيس	facebook	None
فيصل	faisal	Nan
فيقول	mondja	None
فيكون	így van	Nan
فيلم	film	None
فيليب	philip	None
فيما	tekintettel	None
فيمكن	az tud	Nan
فينشي	vinci	None
فيجب	kellene	None
فيتنام	vietnam	None
في	egy a	Nan
فوهة	szórófej	Nan
فنون	arts	Nan
فني	műszaki	None
فنية	művészeti	None
فهد	leopárd	Nan
فهذا	ez	None
فهذه	szóval ez	Nan
فهم	megértés	Nan
فيه	benne	None
فهمي	az értelmezésem	Nan
فهو	ő van	Nan
فهي	ő az	Nan
فوائد	előnyök	Nan
فور	azonnal	None
فوضى	rendetlenség	Nan
فوق	felett	None
فون	iphone	None
فهناك	ott van	Nan
سنة	év	None
سنان	fogak	None
سن	kor	None
جديدة	új	None
جديدًا	új	None
جدير	méltó	None
جدًا	nagyon	None
جذب	vonz	Nan
جذور	roots	Nan
جراء	báb	Nan
جرائم	bűncselekmények	None
جرانيت	gránit	None
جرت	került sor	Nan
جرى	futott	None
جريدة	újság	None
جزء	rész	None
جزءا	rész	None
جزءاً	rész	None
جديداً	új	None
جزءًا	rész	None
جديدا	új	None
جدوى	megvalósíthatósági	Nan
جبران	jubran	Nan
جبريل	gabriel	None
جبلية	hegy	None
جبهة	elülső	None
جد	nagyapa	Nan
جدا	nagyon	None
جدار	fal	None
جدال	vita	None
جداً	nagyon	None
جدة	nagymama	Nan
جدد	újakat	Nan
جدران	walls	Nan
جدل	érv	Nan
جده	nagymama	Nan
جدول	asztal	Nan
جديد	új	None
جبال	hegység	None
جزئيا	részben	None
جزيئات	molekulák	None
جلب	hozott	None
جلد	bőr	None
جلسة	ülés	Nan
جماع	közösülés	Nan
جماعات	csoportok	None
جماعية	kollektív	None
جمال	szépség	None
جمع	többes szám	Nan
جمعة	péntek	Nan
جمعت	összegyűjtött	Nan
جمعه	péntek	Nan
جمعها	összegyűjtött	Nan
جمعية	egyesület	None
جملة	mondat	None
جمهور	nyilvános	None
جلال	celal	Nan
جزر	sárgarépa	Nan
جل	gél	Nan
جغرافية	földrajz	None
جزيرة	sziget	None
جساس	kém	Nan
جسد	test	None
جسده	a teste	Nan
جسدها	a teste	Nan
جسر	híd	None
جسم	test	None
جسمه	a teste	Nan
جسيمات	részecskék	None
جعفر	jafar	Nan
جعل	make	Nan
جعلت	készült	None
جعله	csináld meg	Nan
جعلها	csináld meg	Nan
جغرافيا	földrajz	None
جفاف	aszály	Nan
جانبي	oldal	None
جانبه	az ő oldala	Nan
جانب	oldal	None
تيمية	taymiyya	Nan
تُشكل	forma	None
تُظهر	megjelenik	None
تُعتبر	tekinthető	None
تُعد	készít	None
تُعرف	ismert	None
ثابتة	rögzített	None
ثار	bosszú	Nan
ثالث	harmadik	None
ثاليوم	tallium	None
ثانوية	gimnázium	None
ثاني	második	None
ثانيا	másodszor	None
ثانية	egy második	Nan
ثبت	igazolt	None
تيمور	timur	Nan
ثروة	jólét	Nan
تيفوس	tífusz	None
تيار	folyam	Nan
توقع	elvárás	Nan
توقف	álljon meg	Nan
توقيع	aláírás	Nan
توكيس	tokis	Nan
تولد	szülni	Nan
تولى	elfoglalta	None
توليد	generáció	Nan
توليه	beiktatás	Nan
تولّى	elfoglalta	None
توما	toma	Nan
توماس	tamás	None
تونس	tunézia	Nan
تويوتا	toyota	Nan
تويودا	toyoda	Nan
تي	t	Nan
تيارات	streams	Nan
ثقافات	kultúrák	None
ثقافة	kultúra	None
ثقافي	kulturális	None
جاء	jött	None
جاءت	jött	None
جائزة	díjat	None
جابر	jaber	Nan
جاذبية	súly	Nan
جاسم	jasszim	Nan
جاك	jack	None
جاكسون	jackson	None
جالوت	góliát	Nan
جاليليو	galileo	None
جالينوس	galen	Nan
جامع	mecset	Nan
جامعات	egyetemek	None
جامعة	egyetemi	None
جان	január	None
ج	c	Nan
ثيوديسيا	theodisia	Nan
ثورة	forradalom	None
ثورات	forradalmak	Nan
ثقافية	kulturális	None
ثقب	lyuk	None
ثقة	bizalom	Nan
ثلاث	három	None
ثلاثة	három	None
ثلاثية	trilógia	Nan
ثلاثين	harminc	None
جمهوري	köztársasági	None
ثلث	egy harmad	Nan
ثمان	nyolc	None
ثماني	nyolc	None
ثمانية	nyolc	None
ثمة	van	Nan
ثمّ	azután	None
ثنائية	dualizmus	Nan
ثور	ökör	Nan
ثم	azután	None
توفيق	reconcile	Nan
جمهورية	köztársaság	None
جميعا	mindegyikük	None
حدائق	kertek	Nan
حدة	élesség	Nan
حدث	esemény	None
حدثت	korszerűsített	Nan
حدثنا	mondd el nekünk	Nan
حدد	elhelyez	Nan
حدودها	határai	Nan
حديث	modern	None
حديثا	újonnan	None
حديثة	modern	None
حديثًا	újonnan	None
حديد	vas	None
حديدية	vastartalmú	Nan
حديقة	kert	None
حراء	hira	Nan
حد	határ	None
حرارة	hőség	Nan
حجوالة	átutalás	Nan
حجما	méretben	Nan
حاليا	jelenleg	None
حالياً	jelenleg	None
حاليًا	jelenleg	None
حامد	hamed	Nan
حامل	terhes	None
حاول	megpróbálni	Nan
حاولت	megpróbáltam	Nan
حب	szerelem	None
حبيب	szerető	Nan
حبيبي	baba	Nan
حتى	amíg	None
حتي	amíg	None
حجة	érv	Nan
حجر	kő	None
حجم	méret	None
حجمها	a mérete	Nan
حالته	az állapota	Nan
حرارته	melege	Nan
حرام	tiltott	None
حساسة	érzékeny	None
حسان	hassan	Nan
حسب	alapján	None
حسن	hassan	Nan
حسنة	jó cselekedet	Nan
حسني	hoszni	Nan
حسين	hussain	Nan
حشد	tömeg	None
حشرات	rovarok	Nan
حشيشة	hasis	Nan
حصار	ostrom	None
حصة	időszak	None
حصدت	aratott	None
حصل	történt	None
حصلت	kaptam	Nan
حسابات	fiókok	Nan
حرارتها	a hő	Nan
حساب	számla	Nan
حزن	sadnes	Nan
حرب	háború	None
حربية	hadihajó	Nan
حرة	ingyenes	None
حرس	őr	Nan
حرف	levél	None
حرق	éget	Nan
حركات	mozgások	None
حركة	mozgalom	None
حرم	tiltott	None
حروب	háborúk	None
حروف	levelek	None
حرية	szabadság	None
حزام	öv	Nan
حزب	buli	Nan
حزم	szíj	Nan
حزيران	június	None
حالة	állapot	None
حالب	húgyvezeték	Nan
حالات	esetek	None
جهات	úticél	Nan
جهاد	dzsihád	Nan
جهاز	eszköz	None
جهة	oldal	None
جهد	erőfeszítés	Nan
جهود	erőfeszítések	Nan
جو	légkör	None
جوائز	díjak	None
جواز	útlevél	Nan
جوانب	szempontok	Nan
جواهر	jewels	Nan
جوجل	google	None
جودة	minőség	Nan
جورج	györgy	None
جورجيا	grúzia	Nan
جنوده	a katonái	Nan
جورجيون	grúzok	Nan
جنود	katonák	None
جنوبي	déli	None
جميعاً	mindegyikük	None
جميعًا	mindegyikük	None
جميل	bájos	Nan
جميلة	gyönyörű	None
جناح	lakosztály	Nan
جنب	oldal	None
جندي	katona	None
جنس	szex	None
جنسي	szexuális	None
جنسية	állampolgárság	Nan
جنطيانية	gentianism	Nan
جنكيز	dzsingisz	Nan
جنو	gnú	Nan
جنوب	déli	None
جنوبا	déli	None
جنوبًا	déli	None
جوزيف	joseph	None
جولة	egy túra	Nan
جون	jános	None
حائل	jégeső	Nan
حاتم	hatem	Nan
حاجة	szükség	None
حادة	éles	None
حادث	baleset	None
حادثة	incidens	Nan
حار	forró	None
حارب	harc	None
حارة	sáv	None
حاز	van	Nan
حاسوب	egy számítógép	Nan
حافة	él	None
حافظ	hafiz	Nan
حافظت	fenntartott	Nan
حال	feltétel	None
حائط	fal	None
جيوش	sereg	None
جينات	gének	None
جين	gén	None
جوهر	lényeg	Nan
جوي	légi	None
جوية	levegő	None
جي	ing	Nan
جيبوتي	dzsibuti	Nan
جيجابت	gigabit	Nan
جيد	jó	None
جميع	összes	None
جيدا	jól	None
جيدة	jó	None
جيش	hadsereg	None
جيشه	az ő serege	Nan
جيشًا	egy sereg	Nan
جيفارا	guevara	None
جيل	generáció	Nan
جيمس	james	None
جيداً	jól	None
توفير	biztosítani	None
توفيت	meghalt	None
توفي	meghalt	None
تضع	put	Nan
تضم	magába foglalja	Nan
تطبق	alkalmaz	Nan
تطبيق	végrehajtás	None
تطبيقات	alkalmazások	None
تطل	nézz le	Nan
تطلب	kérdez	Nan
تطلق	kirúgott	Nan
تطهير	fertőtlenítés	Nan
تطور	fejlődött	None
تطورا	kifinomult	Nan
تطورت	evolved	Nan
تطوير	fejlődés	None
تطوّر	fejlődött	None
تظل	marad	None
تضخم	dagad	Nan
تظهر	megjelenik	None
تضاعف	szorzatát	Nan
تصوير	fotót készíteni	Nan
تصنيفعلم	osztályozási zászló	Nan
تصنيفعلماء	osztályozó tudósok	Nan
تصنيفعواصم	a nagybetűk osztályozása	Nan
تصنيففلاسفة	a filozófusok osztályozása	Nan
تصنيفقادة	minősítési vezetők	Nan
تصنيفكتاب	osztályozási könyv	Nan
تصنيفلاعبو	a játékosok besorolása	Nan
تصنيفمدن	a városok osztályozása	Nan
تصنيفمصريون	értékelés egyiptomiak	Nan
تصنيفممثلات	színésznők besorolása	Nan
تصنيفممثلون	értékelés szereplők	Nan
تصنيفمواليد	újszülöttek osztályozása	Nan
تصنيفوزراء	a miniszterek osztályozása	Nan
تصنيفوفيات	kategóriák	Nan
تصور	képzeld el	Nan
تصيب	infect	Nan
تصنيفصحابة	osztályozási társ	Nan
تعارض	nem ért egyet	Nan
تعالى	jön	None
تعطى	adott	None
تعطي	adni	None
تعكس	tükröznie	Nan
تعلم	tanul	Nan
تعليم	oktatás	None
تعليمه	művelt	None
تعليمية	nevelési	Nan
تعمل	dolgozó	None
تعني	eszközök	None
تعود	visszatérés	None
تعيش	élő	None
تغطي	fedő	Nan
تغطية	lefedettség	Nan
تغلب	túljut	Nan
تغير	változás	None
تعزيز	meg kell erősíteni	Nan
تعاطي	visszaélés	None
تعرّض	kitettség	Nan
تعرف	tud	None
تعاليم	tanításai	Nan
تعامل	üzlet	Nan
تعاني	szenvedni	Nan
تعاون	együttműködés	None
تعبر	kereszt	None
تعتبر	tekinthető	None
تعترف	elismerik	Nan
تعتمد	attól függ	Nan
تعد	készít	None
تعداد	felsorolás	Nan
تعددت	megsokszoroztam	Nan
تعديل	módosítás	Nan
تعرض	kitettség	Nan
تعرضت	ki volt téve	Nan
تعرضوا	ki voltak téve	Nan
تعريف	meghatározása	None
تصنيفشعراء	a költők osztályozása	Nan
تصنيفرؤساء	a fejek osztályozása	Nan
تصنيفديمقراطيات	demokrácia osztályozása	Nan
تسمية	elnevezési	Nan
تسونامي	tsunami	Nan
تسوية	település	None
تسير	haladó	None
تسيطر	controls	Nan
تشاد	csád	Nan
تشارك	magában foglal	Nan
تشارلز	károly	None
تشبه	tetszik	None
تشترك	ossza meg	Nan
تشتمل	tartalmaz	None
تشتهر	híres valamiről	Nan
تشجيع	ösztönözni	Nan
تشخيص	diagnosztizált	Nan
تشرف	megbecsült	Nan
تسمى	ezt hívják	Nan
تشريع	törvényhozás	None
تسمح	lehetővé teszi	Nan
تسلم	kapott	None
تستخدم	használt	None
تستطع	tudsz	Nan
تستطيع	tudnál	Nan
تستعمل	használt	None
تستغرق	vesz	None
تستمر	folytatódik	None
تستهلك	fogyaszt	Nan
تسجيل	regisztrálj	Nan
تسخين	fűtés	Nan
تسرب	szivárog	Nan
تسع	kilenc	None
تسعة	kilenc	None
تسعى	keres	None
تسقط	leesik	Nan
تسلسل	sorrend	None
تسليم	kézbesítés	Nan
تشرين	tishreen	Nan
تشغل	fut	None
تشغيل	futás	Nan
تصغير|مسجد	minimalizálás | mecset	Nan
تصف	ismertesse	Nan
تصل	reach	Nan
تصميم	tervezés	Nan
تصنع	gyártott	Nan
تصنف	osztályozva vannak	Nan
تصنيع	gyártás	None
تصنيف	értékelés	Nan
تصنيفآل	osztályozás	Nan
تصنيفأشخاص	személyek osztályozása	Nan
تصنيفأعلام	osztályozási zászlók	Nan
تصنيفبلدان	országok osztályozása	Nan
تصنيفتاريخ	értékelés dátuma	Nan
تصنيفخريجو	a diplomások osztályozása	Nan
تصنيفدول	osztályozási országok	Nan
تصغير|صورة	kép minimalizálása |	Nan
تصغير|رسم	minimalizálás | rajzolás	Nan
تصغير|بك|رسم	minimalizálja | a | rajzolását	Nan
تصغير|	minimalizálás |	Nan
تشكل	forma	None
تشكلت	alakított	None
تشكيل	képződés	Nan
تشمل	tartalmaz	None
تشهد	arról tanúskodnak,	Nan
تشي	che	None
تشير	jelez	Nan
تغيرات	változtatások	Nan
تشيكوسلوفاكيا	csehszlovákia	None
تشييد	építkezés	None
تشييط	jelölje be	Nan
تصاعد	beépítési	Nan
تصب	önt	Nan
تصبح	válik	None
تصدر	kiadott	None
تصدير	export	None
تشين	chen	Nan
تغيرت	megváltozott	None
تغيير	változás	None
تفاصيل	részletek	None
تمنع	prevent	Nan
تمويل	pénzügy	Nan
تميز	kiváló	None
تميزت	megjelölt	Nan
تميل	hajlamos	Nan
تميم	tamim	Nan
تمييز	megkülönböztetés	Nan
تمّ	kész	None
تنازل	lemondás	Nan
تناول	enni	Nan
تناولت	eszik	Nan
تنبأ	előre látható	Nan
تنتج	termel	Nan
تنتشر	kiterjed	Nan
تنتقل	mozog	None
تمنح	megadott	None
تنتمي	belong	Nan
تملك	tulajdonában	None
تمرد	felkelés	None
تم	kész	None
تمارس	gyakorolta	Nan
تمام	rendben	None
تماما	teljesen	None
تماماً	teljesen	None
تمامًا	teljesen	None
تمت	kész	None
تمتاز	excel	Nan
تمتد	nyújtás	Nan
تمتعت	élveztem	Nan
تمتلك	rendelkezik	None
تمثال	szobor	None
تمثلت	a képen	Nan
تمثيل	reprezentáció	Nan
تمر	pass	Nan
تمكن	irányított	None
تنتهي	lejár	Nan
تنخفض	menj le	Nan
تنسيق	koordináta	Nan
توتونيون	teuton	Nan
توجد	vannak	None
توجه	orientáció	Nan
توجيه	tanácsadás	Nan
توحيد	szabványosítás	Nan
توزيع	terjesztés	Nan
توسع	terjeszkedés	Nan
توسعت	kiterjesztett	Nan
توسيع	terjeszkedés	Nan
توصل	megérkezik	Nan
توصيل	csatlakozó	None
توضح	tisztázza	Nan
توضع	helyezni kell	Nan
توفر	elérhetőség	Nan
توفى	meghalt	None
توت	áfonya	Nan
توافق	egyetért	Nan
توازن	egyensúly	Nan
تواجه	arc	Nan
تنشأ	merülnek fel	Nan
تنص	államok	None
تنظم	szervez	None
تنظيم	csoport	None
تنفيذ	végrehajtása	Nan
تنقسم	megosztott	None
تنقل	átutalás	Nan
تليها	követte	None
تنمو	nő	None
تنوع	sokféleség	Nan
تهتم	gondoskodás	Nan
تهدد	fenyegető	Nan
تهدف	célok	Nan
تهيمن	dominálnak	Nan
توابل	fűszerek	Nan
تواجد	létezés	None
تنمية	fejlődés	None
حصن	erőd	Nan
تلوث	környezetszennyezés	Nan
تلك	hogy	None
تقدمه	felajánlja	Nan
تقدمها	biztosítani	None
تقدير	felértékelődés	Nan
تقديرات	becslések	None
تقديم	beküldés	Nan
تقرر	döntsd el	Nan
تقريبا	hozzávetőlegesen, körülbelül	Nan
تقريباً	hozzávetőlegesen, körülbelül	Nan
تقريبًا	hozzávetőlegesen, körülbelül	Nan
تقرير	jelentés	None
تقسم	feloszt	Nan
تقسيم	osztály	None
تقضي	tölt	None
تقع	található	None
تقف	állj fel	Nan
تقدمت	fejlett	None
تقل	kevésbé	None
تقدم	előrehalad	Nan
تقتصر	korlátozott	None
تفاعل	kölcsönhatás	None
تفاعلات	interakciók	Nan
تفرض	impose	Nan
تفسير	magyarázat	None
تفصل	különálló	None
تفعل	csinálnak	Nan
تفقد	elveszít	Nan
تفكك	szétesett	Nan
تفوق	kiválóság	Nan
تفيد	haszon	Nan
تقارب	kiengesztelődés	Nan
تقارير	jelentések	Nan
تقاليد	hagyományok	None
تقام	tartott	None
تقبل	elfogad	Nan
تقدر	megértését	Nan
تقلل	csökkentse	Nan
تقليد	hagyomány	None
تقليدية	hagyományos	None
تكنولوجيا	technológia	None
تكون	lenni	None
تكونت	alakított	None
تكوين	képződés	Nan
تكيف	alkalmazkodás	Nan
تل	hegy	None
تلال	hills	Nan
تلاميذه	tanítványai	None
تلبية	találkozik	None
تلت	követi	None
تلعب	játék	None
تلف	kár	Nan
تلفزيون	tévé	Nan
تلفزيونية	televízió	None
تلقى	kap	None
تكن	lenni	None
تكمن	fekszik	None
تكليس	kalcinálódási	Nan
تكلفة	költség	Nan
تقليل	csökkentse	Nan
تقنيات	technologies	Nan
تقنية	technika	None
تقود	vezet	None
تقول	says	Nan
تقوم	felkelni	Nan
تقوية	erősítése	Nan
تلو	utána	None
تقويم	értékelés	Nan
تقييم	értékelés	Nan
تكاد	majdnem	None
تكاليف	kiadások	None
تكتب	ő ír	Nan
تكثر	bővelkedik	Nan
تكرار	ismétlés	Nan
تكساس	texas	None
تقي	jámbor	Nan
حصول	kap	None
حضارات	civilizációk	Nan
حضارة	civilizáció	None
ركن	sarok	Nan
رمزا	egy szimbólum	Nan
رمزية	szimbolizmus	Nan
رمسيس	ramses	Nan
رمضان	ramadan	Nan
رموز	szimbólumok	Nan
رمي	dobás	Nan
روابط	linkek	None
رواد	pioneers	Nan
رواه	narrátor	Nan
روايات	regények	None
رواية	egy regény	Nan
روبرت	robert	None
روثينيوم	ruténium	None
روح	szellem	None
ركام	terméskő	Nan
روس	ross	None
رقيقة	vékony	None
رقعة	tapasz	Nan
رصد	monitor	Nan
رضا	megelégedettség	Nan
رضي	elégedett	Nan
رعاف	orrvérzés	None
رعاية	gondoskodás	Nan
رعد	mennydörgés	None
رغبة	vágy	Nan
رغم	annak ellenére	Nan
رفض	elutasítás	Nan
رفضت	elutasította	None
رفضه	elutasította	None
رفع	feltöltés	Nan
رفعت	felemelte	Nan
رفيعة	karcsú	Nan
رفيق	társ	Nan
رقم	szám	None
رشيد	rashid	Nan
روستوك	rostock	Nan
روسيا	oroszország	None
زالت	még mindig	Nan
زاوية	szög	None
زايد	zayed	Nan
زحف	csúszó	Nan
زحل	szaturnusz	None
زراعة	mezőgazdaság	None
زراعية	mezőgazdasági	None
زرع	ültetés	Nan
زرنيخيد	arsenide	Nan
زعامة	vezetés	None
زعماء	vezetők	None
زعيم	vezető	None
زغلول	zaghloul	Nan
زكريا	zakaria	Nan
زكي	zaki	Nan
زال	még mindig	Nan
روسو	russo	Nan
زار	látogatás	Nan
زاد	megnövekedett	None
روما	róma	None
رومانيا	románia	None
رومانية	román	None
رونالدو	ronaldo	None
روى	narrátor	Nan
روي	roy	Nan
رياح	szél	None
رياض	riad	Nan
رياضة	sport	None
رياضية	atlétikai	Nan
ريال	rial	Nan
ريتشارد	richard	None
ريشة	írótoll	Nan
ريكشا	riksha	Nan
ريولوجيا	reológia	None
زادت	megnövekedett	None
رشد	felnőttkor	Nan
رسوم	díjak	None
رسول	hírnök	Nan
رئاسة	elnökség	Nan
رئيس	elnök	None
رئيسا	elnökként	Nan
رئيساً	elnökként	Nan
رئيسة	elnöknő	Nan
رئيسيا	jelentősebb	None
رئيسياً	jelentősebb	None
رئيسية	jelentősebb	None
رئيسيين	jelentősebb	None
رئيسًا	elnök	None
رائحة	szag	Nan
رائد	úttörő	Nan
رائدة	vezető	None
رائعة	egy csodálatos	Nan
رابط	link	Nan
رؤيتها	nézd	Nan
رابطة	egyesület	None
رؤية	látomás	Nan
رؤوس	heads	Nan
ذوات	nők	None
ذوي	val vel	Nan
ذي	dhi	Nan
ذُكر	férfi	None
رآه	látta azt	Nan
رأت	látta	None
رأس	fej	None
رأسه	a fejét	Nan
رأسها	a feje	Nan
رأسهم	a fejük	Nan
رأى	vélemény	None
رأي	vélemény	None
رأيت	láttam	Nan
رأيه	transzparens	Nan
رؤساء	heads	Nan
رؤيا	látomás	Nan
رابع	negyedik	None
راجع	lát	None
راشد	rashid	Nan
رحل	elmúlt	None
رحلات	hajóutak	Nan
رحلة	utazás	None
رحلته	az ő repülése	Nan
ردود	válaszok	Nan
رسائل	üzenetek	Nan
رسالة	üzenet	None
رسالته	az üzenetét	Nan
رستم	rustem	Nan
رسم	húz	Nan
رسمها	húzott	Nan
رسمي	hivatalos	None
رسميا	hivatalosan	None
رسمياً	hivatalosan	None
رسميًا	hivatalosan	None
رجم	kövezett	Nan
رجليها	a lába	Nan
رجلاً	egy férfi	Nan
رجلا	egy férfi	Nan
رام	íjász	Nan
راية	transzparens	Nan
رب	allah	Nan
ربط	link	Nan
ربع	negyed	None
ربما	valószínűleg	None
ربه	lord	None
زلزال	földrengés	None
ربيع	tavaszi	None
رتب	fajta	Nan
رتبة	rang	Nan
رجال	férfiak	None
رجاله	az emberei	Nan
رجب	regep	Nan
رجع	visszament	Nan
رجل	egy láb	Nan
ربيعة	rabia	Nan
زمان	idő	None
زمانه	az ő ideje	Nan
زمن	idő	None
سعودية	szaúd-	Nan
سعوديون	szaúdiak	Nan
سعى	keresett	None
سعيد	boldog	None
سفر	utazás	None
سفن	hajók	None
سفيان	soufyan	Nan
سفينة	hajó	None
سقراط	socrates	Nan
سقط	leesett	Nan
سقطت	fell	Nan
سقوط	lehull	Nan
سكان	népesség	None
سكانديوم	scandium	Nan
سكانها	a lakosság	Nan
سعودي	szaúd-	Nan
سكانية	népesség	None
سعود	saud	Nan
سعت	kerestem	Nan
سراح	felszabadított	Nan
سرطان	rák	None
سرعان	hamar	None
سرعة	sebesség	None
سرقة	lopás	Nan
سرو	ciprus	None
سري	titok	Nan
سرية	titoktartás	Nan
سريع	gyors	None
سريعة	egy gyors	Nan
سريعًا	hamar	None
سطح	felület	None
سطحه	felszíne	None
سطحها	felszíne	None
سعاد	suad	Nan
سعر	ár	None
سكة	vasút	None
سكر	cukor	None
سكك	sínek	Nan
سلوك	viselkedés	None
سليم	salim	Nan
سليمان	szulejmán	Nan
سم	cm	None
سمات	jellemzők	None
سماه	hívta	None
سمة	jellemvonás	Nan
سمح	engedélyezett	None
سمحت	engedélyezett	None
سمع	hallotta	Nan
سمعت	hallottam	Nan
سمك	hal	None
سمي	nevezett	None
سميت	ez volt a neve	Nan
سمير	sameer	Nan
سلمية	békés	None
سلمة	salamah	Nan
سلمان	salman	Nan
سلم	létra	Nan
سكن	rezidencia	Nan
سلاح	fegyver	None
سلاسل	láncok	Nan
سلاطين	sultans	Nan
سلالات	törzsek	None
سلالة	deformáció	Nan
سلام	szia	Nan
سر	titok	Nan
سلامة	biztonság	None
سلسلة	sorozat	None
سلطات	hatóság	None
سلطان	szultán	None
سلطة	saláta	Nan
سلطنة	szultánság	Nan
سلف	kölcsönök	Nan
سلفوناميد	szulfonamid	Nan
سلبية	negatív	None
ذو	kész	None
سدة	dugó	Nan
سحب	visszavonás	Nan
زيدان	zidane	Nan
زين	zain	Nan
زينب	zaynab	Nan
س	s	None
سأل	kérdezte	Nan
سؤال	kérdés	None
سائر	egyéb	None
سائل	folyadék	Nan
سابق	korábbi	None
سابقا	korábban	None
سابقاً	korábban	None
سابقة	precedens	Nan
سابقًا	korábban	None
ساحة	udvar	None
ساحل	tengerpart	None
زيد	zaid	Nan
ساحلية	parti	None
زيت	olaj	None
زيادة	egy plusz	Nan
زمني	az időm	Nan
زمنية	idő	None
زنكي	cink	Nan
زهرة	virág	None
زواج	házasság	None
زواجه	a házassága	Nan
زوال	kimúlását	Nan
زوج	férj	None
زوجات	feleségek	None
زوجاته	a feleségei	Nan
زوجة	feleség	None
زوجته	az ő felesége	Nan
زوجها	férje	None
زوكربيرج	zuckerberg	Nan
زياد	ziyad	Nan
زيارة	látogatás	Nan
سار	sétált	Nan
ساراكينوس	saracenus	Nan
سارة	sara	Nan
سبعة	hét	None
سبعين	hetven	Nan
سبق	már	None
سبقت	felfut	Nan
سبيس	az én helyem	Nan
سبيل	pálya	None
ست	hat	None
ستالين	sztálin	None
ستة	hat	None
ستكون	lesz	None
ستيرول	sterol	Nan
ستين	hatvan	Nan
سجل	rekord	None
سجن	börtön	Nan
سحابة	felhő	Nan
سبع	hét	None
سبحانه	dicsőség neki	Nan
سبتمبر	szeptember	None
سببا	ok	None
ساعات	órák	None
ساعة	óra	None
ساعد	segít	Nan
ساعدت	segített	None
سافر	utazás	None
سالم	salem	Nan
سامي	sami	Nan
سد	dugó	Nan
سامية	fenséges	Nan
سانت	utca.	Nan
ساهم	hozzájárult	None
ساهمت	hozzájárult	None
سبأ	sheeba	Nan
سباق	verseny	None
سباقات	versenyek	Nan
سبب	ok	None
سان	san	None
لتصل	elérni	None
ذهبية	aranysárga	Nan
ذلك	hogy	None
خاصا	különösen	None
خاصة	különösen	None
خاصةً	különösen	None
خاصية	ingatlan	Nan
خاض	harcolt	None
خاضعة	tantárgy	Nan
خالد	halhatatlan	Nan
خالص	tiszta	None
خالية	üres	None
خام	nyers	None
خان	kán	None
ختان	körülmetélés	Nan
خدمات	szolgáltatások	None
خدمة	szolgáltatás	None
خديجة	hatice	Nan
خاص	különleges	None
خرائط	térképek	None
خارجية	külső	None
خادم	szolgáló	None
حياتها	az ő élete	Nan
حياتهم	az életük	Nan
حياتي	az életem	Nan
حيان	hayyan	Nan
حية	élénk	None
حيث	ahol	None
حيفا	haifa	Nan
حين	amikor	None
حينما	bármikor	None
حينها	akkoriban	None
حيوان	állat	None
حيوانات	állatok	None
حيوانية	állat	None
حيوية	életerő	Nan
خابية	gyorsítótár	Nan
خارجي	külső	None
حياته	az ő élete	Nan
خراسان	khorasan	Nan
خرجت	kijött	Nan
خطبة	beszéd	None
خطة	terv	None
خطر	kockázat	Nan
خطط	tervek	None
خطف	emberrablás	Nan
خطوة	lépés	None
خطورة	veszély	None
خطوط	vonalak	None
خطيرة	komoly	None
خفض	arányosan lecsökkent	Nan
خفيف	fény	None
خفيفة	fény	None
خلاف	vita	None
خلافته	az utódja	Nan
خلال	keresztül	None
خطاب	beszéd	None
خرج	kiment	Nan
خطأ	hiba	None
خضعت	átesett	Nan
خرجوا	jöttek ki	Nan
خروج	kijárat	Nan
خريطة	egy térkép	Nan
خزيمة	vereség	None
خسائر	veszteség	Nan
خسارة	veszteség	Nan
خسر	elveszett	None
خصائص	a tulajdonságok	Nan
خصبة	termékeny	None
خصوصا	különösen	None
خصوصاً	különösen	None
خصوصًا	különösen	None
خصومه	vita	None
خضراء	zöld	None
خضع	tantárgy	Nan
خط	vonal	None
حياة	élet	None
حي	szomszédság	Nan
حولها	körül	None
حكام	vonalzók	Nan
حكايات	tales	Nan
حكاية	mese	Nan
حكم	szabály	None
حكمة	bölcsesség	Nan
حكمت	ő uralkodott	Nan
حكمه	bölcsesség	Nan
حكمها	a szabály	Nan
حكمهم	az ő szabályuk	Nan
حكومات	a kormányok	Nan
حكومة	kormány	None
حكومي	kormányzati	None
حكومية	kormányzati	None
حكيم	zsálya	Nan
حلال	halal	Nan
حقيقية	igazi	None
حلب	aleppo	Nan
حقيقي	igazi	None
حقول	fields	Nan
حضر	részt vett	Nan
حضور	jelenlét	Nan
حطين	hittin	Nan
حظر	tilalom	None
حفر	fúrás	Nan
حفظ	mentés	Nan
حفل	buli	Nan
حق	jobb	None
حقائق	tények	None
حقبة	korszak	None
حقق	elér	Nan
حققت	elért	None
حقل	terület	None
حقه	joga van	Nan
حقوق	jogok	None
حقيقة	tény	None
حلت	feloszlik	Nan
حلف	esküszik	Nan
حلقات	epizódok	None
حمير	szamarak	Nan
حنا	hanna	Nan
حنبعل	hannibal	Nan
حنبل	hanbal	Nan
حنك	szájpadlás	Nan
حنيفة	hanifa	Nan
حنين	nosztalgia	Nan
حواء	eva	Nan
حوادث	balesetek	Nan
حوار	párbeszéd	Nan
حوالي	körül	None
حوذانية	boglárka	Nan
حوض	mosdó	Nan
حول	ról ről	Nan
حوله	körül	None
حملته	az ő kampánya	Nan
حملت	töltött	None
حملة	kampány	Nan
حملات	kampányok	Nan
حلقة	gyűrű	None
حلمي	az álmom	Nan
حلول	megoldások	Nan
حلويات	cukorka	Nan
حماة	védőfelszerelés	Nan
حماد	hammad	Nan
حماس	lelkesedés	Nan
خلاله	közben	None
حماية	védelem	None
حمدان	hamdan	Nan
حمدي	hamdi	Nan
حمراء	piros	None
حمزة	hamza	Nan
حمص	csicseriborsó	Nan
حمض	sav	Nan
حمل	terhesség	None
حمد	dicsérte	Nan
خلالها	közben	None
خلايا	a sejteket	Nan
خلدون	khaldoun	Nan
دورات	tanfolyamok	Nan
دوران	forgás	Nan
دوراً	egy szerep	Nan
دورة	tanfolyam	Nan
دوره	tanfolyam	Nan
دورها	a szerepe	Nan
دوري	ciklikus	Nan
دورية	járőr	Nan
دورًا	egy szerep	Nan
دول	országok	None
دولار	dollár	None
دولة	ország	None
دولته	az ő országa	Nan
دولتهم	az államuk	Nan
دولتين	két állam	Nan
دورا	egy szerep	Nan
دولي	nemzetközi	None
دور	szerep	None
دو	du	None
دفن	temetés	Nan
دقائق	percek	Nan
دقة	pontosság	Nan
دقيق	liszt	None
دقيقة	pontos	Nan
دلائل	bizonyíték	None
دلالة	jelzés	Nan
دلتا	delta	Nan
دليل	útmutató	Nan
دم	vér	None
دمج	összeolvad	Nan
دمرت	elpusztított	Nan
دمشق	damaszkusz	Nan
دمياط	damietta	Nan
دنيا	donia	Nan
دوائر	körök	None
دولياً	nemzetközileg	None
دولية	nemzetközi	None
دون	nélkül	None
ذاته	azonos	None
ذاتها	maga	None
ذاتي	szubjektív	None
ذاتية	önéletrajz	Nan
ذاك	hogy	None
ذاكرة	memória	None
ذرات	atomok	None
ذروة	tetőpont	Nan
ذروتها	tetőpont	Nan
ذرية	utódok	Nan
ذكر	férfi	None
ذكره	megemlítette	Nan
ذكرها	említsd meg	Nan
ذكرى	memória	None
ذكور	férfi	None
ذات	összefüggő	None
ذا	a	None
ديوان	diwan	Nan
دينًا	vallás	None
دياب	diab	Nan
ديانة	vallás	None
دير	kolostor	None
ديزني	disney	None
ديسمبر	december	None
ديفنباخيا	devenpachia	Nan
ديفيد	david	None
دفعت	fizetett	None
ديل	kis erdős völgy	Nan
دين	adósság	Nan
دينار	dinár	Nan
ديناصور	dinoszaurusz	None
دينه	az ő vallása	Nan
دينهم	a vallásuk	Nan
ديني	vallási	None
دينية	vallási	None
ديمقراطية	demokrácia	None
ذهب	megy	None
دفعة	fizetett	None
دعى	hívott	None
خوف	félelem	None
خوفو	hufu	Nan
خياطة	varrás	None
خيبر	khaibar	Nan
خير	jó	None
د	dr	None
دا	s	None
داء	betegség	None
دائرة	kör	None
دائرية	kör alakú	Nan
دائم	állandó	None
دائما	mindig	None
دائماً	mindig	None
دائمة	mindig	None
دائمًا	mindig	None
خوسيه	jose	Nan
داخل	belül	None
خوان	juan	None
خمسة	öt	None
خلع	levette	Nan
خلف	mögött	None
خلفاء	utódai	None
خلفه	mögötte	None
خلفها	maradék	None
خلفية	háttér	None
خلقه	az ő alkotása	Nan
خلل	disszidál	Nan
خلنجية	hanga	Nan
خلية	sejt	None
خليج	öböl	None
خليط	keverék	None
خليفة	utód	Nan
خليل	khalil	Nan
خمس	öt	None
خمسين	ötven	None
داخلي	belső	None
داخلية	belső	None
دار	dar: ház	Nan
درس	lecke	Nan
درع	pajzs	None
درهم	dirham	Nan
دروس	oktatóanyagok	Nan
درويش	darwish	Nan
دريد	duraid	Nan
دستور	alkotmány	None
دستوري	alkotmányos	None
دستورية	alkotmányosság	Nan
دعا	hívás	Nan
دعاء	ima	Nan
دعت	ő hívott	Nan
دعم	támogatás	None
دعوة	hívás	Nan
دعوته	az ő hívása	Nan
درجة	fokozat	None
درجات	fok	Nan
درب	pálya	None
دراما	dráma	None
دارت	dárda	Nan
داروين	darwin	None
دام	tartott	None
دامت	amíg	None
داود	david	None
داوود	david	None
دبلوماسية	diplomácia	Nan
دفع	fizetés	Nan
دبي	dubai	Nan
دخل	jövedelem	Nan
دخلت	beléptem	Nan
دخول	belépés	Nan
دخوله	belépés	Nan
دراسات	tanulmányok	None
دراسته	tanulja meg	Nan
دراسية	tanulmány	None
دجلة	tigris	None
لتطور	fejleszteni	Nan
لتطوير	fejleszteni	Nan
لتعداد	felsorolni	Nan
وتكون	és legyen	Nan
وتكوين	és konfigurálni	Nan
وتلك	és azok	Nan
وتم	és meg is történt	Nan
وتمت	és meg is történt	Nan
وتمتد	nyújtás	Nan
وتمتلك	és birtokolja	Nan
وتمثل	és képviselje	Nan
وتمكن	sikerült	None
وتنتج	termel	Nan
وتنتشر	és elterjedt	Nan
وتنظيم	és a szabályozás	Nan
وتنقسم	megosztott	None
وتهدف	cél	None
وتوجد	vannak	None
وتقوم	és alapul	Nan
وتوزيع	és a disztribúció	Nan
وتقول	és azt mondja	Nan
وتقدم	biztosított	None
وتطور	fejlett	None
وتطورت	és fejlődött	Nan
وتطوير	és fejleszteni	Nan
وتظهر	és mutasd	Nan
وتعالى	mindenható	Nan
وتعتبر	tartott	None
وتعتمد	attól függ	Nan
وتعد	és készülj fel	Nan
وتعرف	és tudod	Nan
وتعزيز	és promóció	Nan
وتعمل	működik	None
وتعني	azt jelenti	Nan
وتعود	és vissza	Nan
وتعيين	és meg	Nan
وتغطي	és fedezi	Nan
وتقع	esik	None
وتطبيق	és alkalmazás	Nan
وتوفي	meghalt	None
وتونس	és tunézia	Nan
وجعلها	és csináld	Nan
وجل	emelkedett	None
وجمع	és gyűjtsük össze	Nan
وجمهورية	és egy köztársaság	Nan
وجميع	és minden	Nan
وجنوب	és délre	Nan
وجه	arc	Nan
وجهات	úticél	Nan
وجهة	rendeltetési hely	Nan
وجهه	az arca	Nan
وجهها	az ő arca	Nan
وجوب	kötelező	None
وجود	jelenlét	Nan
وجوده	jelenléte	None
وجودها	a jelenléte	Nan
وجعل	és készíts	Nan
وتولى	elvette	Nan
وجزيرة	és egy sziget	Nan
وجدير	érdemes	Nan
وتيرة	sebesség	None
وثائق	dokumentumok	None
وثائقي	dokumentumfilm	None
وثاني	és a második	Nan
وثلاثة	és három	Nan
وثلاثون	harminc	None
وثلاثين	harminc	None
وثيقة	dokumentum	None
وجاء	jött	None
وجاءت	jött	None
وجامعة	és az egyetemet	Nan
وجبال	és a hegyek	Nan
وجبل	és szerelje fel	Nan
وجد	található	None
وجدت	megtalált	Nan
وجزر	és a szigetek	Nan
وتضم	magába foglalja	Nan
وتصل	és fel	Nan
وتصبح	és válj	Nan
وبريطانيا	és nagy-britannia	Nan
وبسبب	és mert	Nan
وبشكل	és bizonyos módon	Nan
وبصفة	és bizonyos módon	Nan
وبعد	és mégis	Nan
وبعدها	és akkor	Nan
وبعض	és néhány	Nan
وبعضها	néhányan	None
وبعضهم	és néhány közülük	Nan
وبقي	maradt	None
وبقية	és a többi	Nan
وبقيت	maradtam	Nan
وبلاد	és ország	Nan
وبلغ	és megüt	Nan
وبلغاريا	és bulgária	Nan
وبذلك	azáltal	Nan
وبلغت	találat	Nan
وبدأت	elkezdődött	None
وبخاصة	különösen	None
وبأن	és az	Nan
وباء	járvány	None
وباقي	és a többi	Nan
وباكستان	és pakisztán	Nan
وبالأخص	különösen	None
وبالإضافة	továbbá	None
وبالتالي	és ezért	Nan
وبالتحديد	és konkrétan	Nan
وبالرغم	habár	None
وبالفعل	és valóban	Nan
وبالمثل	hasonlóképpen	None
وبالنسبة	és azért	Nan
وبحر	és a tengeren	Nan
وبحسب	alapján	None
وبحلول	által	None
وبدأ	ő kezdte	Nan
وبما	beleértve	None
وبناء	és építs	Nan
وبناءً	és konstruktívan	Nan
وتحسين	és javítsd	Nan
وتحقيق	és elérni	Nan
وتحليل	és elemzés	Nan
وتحمل	és hordd	Nan
وتختلف	és különböznek egymástól	Nan
وتربية	és tenyésztés	Nan
وترجمت	és lefordítva	Nan
وترك	és elmegy	Nan
وتركيا	és törökország	Nan
وتستخدم	használt	None
وتسعين	kilencven	Nan
وتسمى	hívott	None
وتشكل	smink	Nan
وتشمل	tartalmaz	None
وتشير	és jelezze	Nan
وتحديد	és rögzítés	Nan
وتحدث	ő beszélt	Nan
وتحتوي	és tartalmazzák	Nan
وتحتل	és elfoglalták	Nan
وبنى	ő épített	Nan
وبه	és vele	Nan
وبها	és vele	Nan
وبهذا	ezzel	None
وبين	és közöttük	Nan
وبينما	és miközben	Nan
وتأتي	és gyere	Nan
وجوه	tárgy	None
وتأسيس	és létrehozni	Nan
وتبادل	és csere	Nan
وتبلغ	eléri	None
وتتضمن	magába foglalja	Nan
وتتكون	ez áll	Nan
وتتم	és megtörtént	Nan
وتتميز	megkülönböztetik	Nan
وتحت	és alatt	Nan
وتاريخ	és dátum	Nan
واهتم	és vigyázzon	Nan
وجيزة	rövid	None
وحتى	sőt még	Nan
وصل	megérkezik	Nan
وصلات	linkek	None
وصلت	elérte	None
وصلوا	megérkezett	None
وصناعة	és az ipar	Nan
وصنع	és készítés	Nan
وصول	hozzáférés	Nan
وصوله	érkezés	Nan
وصية	akarat	None
وضرب	és megüt	Nan
وضع	tesz	None
وضعت	fejlett	None
وضعف	gyengeség	Nan
وضعها	tedd le	Nan
وطرق	és módon	Nan
وصفه	recept	Nan
وطريق	és egy út	Nan
وصفاته	az ő tulajdonságai	Nan
وصدر	és elengedték	Nan
وسرعان	stb	None
وسط	központ	None
وسقوط	és esik	Nan
وسلم	neki	None
وسميت	úgy hívták	Nan
وسوريا	és szíria	Nan
وسوق	és piacra	Nan
وشبه	és hasonlóság	Nan
وشرح	és magyarázd el	Nan
وشرق	és keletre	Nan
وشركة	és egy társaság	Nan
وشمال	északi	None
وشهد	és látta	Nan
وشهدت	és látta	Nan
وصار	és az lett	Nan
وصف	ismertesse	Nan
وسبب	és egy ok	Nan
وطريقة	és módszer	Nan
وطن	haza	None
وعرض	bemutatta	None
وعرف	tudta	None
وعرفت	tudtam	Nan
وعشرون	húsz	None
وعشرين	és húsz	Nan
وعضو	és tag	Nan
وعقد	és tartsd	Nan
وعلاوة	ráadásul	None
وعلم	és tudva	Nan
وعلماء	és tudósok	Nan
وعلوم	és a tudományok	Nan
وعلى	és tovább	Nan
وعلي	és tovább	Nan
وعليه	és rajta	Nan
وعمر	és omar	Nan
وعدم	és nem az	Nan
وطلب	kérdezte	Nan
وعددها	és annak száma	Nan
وعد	ígéret	Nan
وطني	nemzeti	None
وطنية	hazaszeretet	Nan
وظائف	karrier	Nan
وظل	és tartották	Nan
وظلت	megmaradt	None
وظهر	megjelent	None
وظهرت	megjelent	None
وظهور	és a megjelenés	Nan
وظيفة	munka	None
وعاد	visszatért	None
وعادة	és általában	Nan
وعاش	élt	None
وعاصمتها	és a fővárosa	Nan
وعبد	és rabszolga	Nan
وعبر	és az egész	Nan
وعدد	és egy számot	Nan
وسام	wissam	Nan
وساعد	segített	None
وسائل	eszközök	None
وحيدة	egyedül	None
وحين	és mikor	Nan
وخاصة	különösen	None
وخاصةً	különösen	None
وخرج	és kijött	Nan
وخصوصا	különösen	None
وخصوصاً	különösen	None
وخصوصًا	különösen	None
وخلال	és keresztül	Nan
وخلفه	és mögötte	Nan
وخلق	és hozzon létre	Nan
وخمسين	és ötven	Nan
ودار	és ház	Nan
ودخل	és belépett	Nan
ودراسة	és tanulj	Nan
وحيد	egyetlen	None
ودرجة	és fok	Nan
وحيث	és hol	Nan
وحول	és róla	Nan
وحدات	egységek	None
وحدة	egyedül	None
وحده	egyedül	None
وحدها	egyedül	None
وحركة	és a mozgás	Nan
وحرية	és a szabadság	Nan
وحسب	és csak	Nan
وحسن	és jó	Nan
وحصل	és megvan	Nan
وحضر	és részt vett	Nan
وحفظ	és takarítson meg	Nan
وحقوق	és a jogok	Nan
وحكم	és ítélet	Nan
وحماية	és védje meg	Nan
وحمل	és töltse le	Nan
وحي	ihlet	Nan
ودرس	tanult	None
ودعا	hívott	None
ودعت	ő hívott	Nan
ورغم	habár	None
ورفض	ő visszautasította	Nan
ورفع	és emelj fel	Nan
ورق	papír	None
ورقة	egy lap	Nan
وروسيا	és oroszország	Nan
وزاد	és növekedett	Nan
وزارة	minisztérium	None
وزراء	a miniszterek	Nan
وزن	súly	Nan
وزوجته	és a felesége	Nan
وزيادة	és több	Nan
وزيت	és olaj	Nan
وزير	miniszter	None
وسائر	és minden más	Nan
وردت	kapott	None
وردة	rózsa	None
ورد	virág	None
ورجال	és a férfiak	Nan
ودعم	és támogatás	Nan
ودفن	és eltemették	Nan
ودمشق	és damaszkusz	Nan
ودور	és szerepe	Nan
ودول	és országok	Nan
ودولة	és ország	Nan
ودون	és anélkül	Nan
وحاول	és próbál	Nan
وذكر	megemlítette	Nan
وذهب	és elment	Nan
ورأى	és látta	Nan
ورئيس	és fej	Nan
وراء	mögött	None
وراثيا	genetikailag	Nan
وراح	és elment	Nan
وربما	és talán	Nan
وذلك	és az	Nan
وانخفاض	és csepp	Nan
وانتهى	ennek vége van	Nan
وانتهت	és véget ért	Nan
والبعض	és néhány	Nan
والبنية	és a szerkezet	Nan
والبيئة	és a környezet	Nan
والتاريخ	és a történelem	Nan
والتجارة	és a kereskedelem	Nan
والتحليل	és elemzés	Nan
والتخلص	és megszabadulj	Nan
والتدريب	és a képzés	Nan
والتطور	és az evolúció	Nan
والتطوير	és a fejlődés	Nan
والتعاون	és az együttműködés	Nan
والتعليم	és az oktatás	Nan
والتقاليد	és a hagyományok	Nan
والتكنولوجيا	és a technológia	Nan
والتلفزيون	és tv	Nan
والبحرين	és bahrein	Nan
والتنمية	és a fejlődés	Nan
والبحرية	tengeri	None
والباحثين	és kutatók	Nan
والإسلام	és az iszlám	Nan
والإسلامية	és az iszlám	Nan
والإعلام	és a média	Nan
والإمارات	és az emírségek	Nan
والإمام	és az imám	Nan
والإمبراطورية	és a birodalom	Nan
والإنسان	és az ember	Nan
والإيمان	és a hit	Nan
والاتحاد	és az unió	Nan
والاتصالات	és a kommunikáció	Nan
والاجتماعي	és társadalmi	Nan
والاجتماعية	és társadalmi	Nan
والاقتصاد	és a gazdaság	Nan
والاقتصادي	és gazdaságos	Nan
والاقتصادية	és gazdasági	Nan
والبحر	és a tenger	Nan
والإدارة	és a menedzsment	Nan
والتوزيع	és a disztribúció	Nan
والثالث	és a harmadik	Nan
والحرية	és a szabadság	Nan
والحزب	és buli	Nan
والحسن	és jó	Nan
والحسين	és husszein	Nan
والحضارة	és a civilizáció	Nan
والحفاظ	és tartsd meg	Nan
والحكم	és ítélet	Nan
والحكومات	és a kormányok	Nan
والحكومة	és a kormány	Nan
والحياة	és az élet	Nan
والحيوانات	és állatok	Nan
والخارجية	és külső	Nan
والخاصة	és különleges	Nan
والخدمات	és szolgáltatások	Nan
والد	apa	None
والحروب	és háborúk	Nan
والتي	és az	Nan
والحركة	és a mozgás	Nan
والحديد	és vas	Nan
والثاني	és a második	Nan
والثانية	és a második	Nan
والثقافة	és a kultúra	Nan
والجامعات	és az egyetemek	Nan
والجدير	és érdemes	Nan
والجزء	és a rész	Nan
والجزائر	és algéria	Nan
والجزر	és a szigetek	Nan
والجماعة	és a csoport	Nan
والجمال	és a szépség	Nan
والجنوب	és délen	Nan
والجنوبية	és déli	Nan
والجيش	és a hadsereg	Nan
والحجاز	és hijaz	Nan
والحديث	és beszélj	Nan
والحرب	és a háború	Nan
والأنهار	és a folyók	Nan
والأنصار	és a szurkolók	Nan
والأميرة	és a hercegnő	Nan
وإنشاء	és hozzon létre	Nan
وإنما	de inkább	Nan
وإيران	és irán	Nan
وإيطاليا	és olaszország	Nan
وائل	wael	Nan
وابن	és fiam	Nan
وابنه	és a fia	Nan
واجب	kötelesség	Nan
واجه	arc	Nan
واجهة	felület	None
واجهت	szembe	None
واحد	egy	None
واحدا	egy	None
واحداً	egy	None
واحدة	egy	None
وإنتاج	és a termelés	Nan
واحدًا	egy	None
وإن	és biztosan	Nan
وإلا	másképp	Nan
وأهمها	a legfontosabb	Nan
وأوائل	és korán	Nan
وأوروبا	és európa	Nan
وأول	és az első	Nan
وأي	és bármilyen	Nan
وأيضا	és még	Nan
وأيضاً	és még	Nan
وأيضًا	és még	Nan
وإدارة	és a menedzsment	Nan
وإذا	ha	None
وإسبانيا	és spanyolország	Nan
وإسرائيل	és izrael	Nan
وإعادة	és újra	Nan
وإعلان	és egy bejelentés	Nan
وإقامة	és létrehozni	Nan
وإلى	és hogy	Nan
وادي	völgy	Nan
وارتفاع	és magas	Nan
واستخدام	és használja	Nan
والآلات	és gépek	Nan
والأحزاب	és partik	Nan
والأخرى	és a másik	Nan
والأخلاق	és az erkölcs	Nan
والأدب	és irodalom	Nan
والأراضي	és földek	Nan
والأردن	és jordánia	Nan
والأرض	és a föld	Nan
والأطفال	és gyerekek	Nan
والأعمال	és működik	Nan
والأفكار	és ötletek	Nan
والأكثر	és több	Nan
والأمراء	és a hercegek	Nan
والأمن	és a biztonság	Nan
والأمير	és a herceg	Nan
والآداب	és a modor	Nan
والآخر	és a másik	Nan
والآثار	és hatások	Nan
واقعة	incidens	Nan
واستخدم	és használja	Nan
واستطاعت	és sikerült	Nan
واستمر	és folytatta	Nan
واستمرت	és folytatta	Nan
واسع	széles	None
واسعة	széles	None
واسم	és a név	Nan
والدة	anya	None
واسمه	és a neve	Nan
واصل	csak így tovább	Nan
واضح	egyértelmű	None
واضحة	egyértelmű	None
واعتبر	ítélték	None
وافق	egyetértett	Nan
وافقت	jóváhagyott	Nan
واقع	valóság	None
واشنطن	washington	None
والدته	anyja	None
والدراسات	és tanulmányok	Nan
والدفاع	és a védelem	Nan
والماء	és a víz	Nan
والمحيط	és az óceán	Nan
والمدارس	és az iskolák	Nan
والمدن	és a városok	Nan
والمدينة	és a város	Nan
والمرأة	és a nő	Nan
والمسجد	és a mecset	Nan
والمسيحية	és a kereszténység	Nan
والمسيحيين	és a keresztények	Nan
والمعادن	és ásványi anyagok	Nan
والمعاهد	és intézetek	Nan
والمعدات	és felszerelés	Nan
والمعراج	és a mirage	Nan
والمعرفة	és a tudás	Nan
والمعروف	ismert	None
والمؤسسات	és intézmények	Nan
والمعروفة	ismert	None
والله	esküszöm	Nan
واللغات	és a nyelvek	Nan
والفيزياء	és a fizika	Nan
والقانون	és a törvény	Nan
والقدرة	és képesség	Nan
والقرآن	és a korán	Nan
والقضاء	és megsemmisítés	Nan
والقمر	és a hold	Nan
والقوات	és erők	Nan
والقوانين	és törvények	Nan
والقوة	és az erő	Nan
والكتاب	és a könyv	Nan
والكتابة	és írj	Nan
والكثير	és még sok más	Nan
والكنيسة	és a templom	Nan
والكواكب	és a bolygók	Nan
والكيمياء	és a kémia	Nan
واللغة	és a nyelv	Nan
والمغرب	és marokkó	Nan
والمكسيك	és mexikóban	Nan
والملك	és a király	Nan
والهند	india	None
والهندسة	és a mérnöki munka	Nan
والواقع	valóban	None
والولايات	és az államok	Nan
والي	wali	Nan
واليابان	és japán	Nan
واليمن	és jemen	Nan
واليهود	és a zsidók	Nan
واليهودية	és a judaizmus	Nan
واليوم	és ma	Nan
واليونان	görögország	None
وان	és biztosan	Nan
وانتشار	és elterjedt	Nan
وانتشر	elterjedt	None
وانتشرت	és eloszlik	Nan
والهرسك	és hercegovina	Nan
والنهاية	és végül	Nan
والنمسا	és ausztria	Nan
والنقل	és a szállítás	Nan
والمملكة	és a királyság	Nan
والمناخ	és az éghajlat	Nan
والمناطق	és régiók	Nan
والمنتجات	és termékek	Nan
والمنطق	és logika	Nan
والمنطقة	és a régió	Nan
والمواد	és anyagok	Nan
والفنون	és a művészetek	Nan
والمواصلات	szállítás	Nan
والمياه	és a víz	Nan
والنباتات	és növények	Nan
والنجوم	és a csillagok	Nan
والنرويج	norvégia	None
والنساء	és nők	Nan
والنسيج	és az anyag	Nan
والنقد	és a kritika	Nan
والموسيقى	és a zene	Nan
وعن	és róla	Nan
والفن	és a művészet	Nan
والفلسفة	és a filozófia	Nan
والسبب	és az ok	Nan
والسعودية	és szaúd-arábia	Nan
والسلام	és a béke	Nan
والسنة	és az év	Nan
والسودان	és szudán	Nan
والسويد	svédország	None
والسياسة	és a politika	Nan
والسياسي	és a politikus	Nan
والسياسية	és politikai	Nan
والسيطرة	és az irányítás	Nan
والشام	és a lévant	Nan
والشرق	és keletre	Nan
والشركات	és a társaságok	Nan
والشعر	és a haj	Nan
والشمال	és észak	Nan
والسادس	és a hatodik	Nan
والشيخ	és sheikh	Nan
والزهرة	és a virág	Nan
والزبير	és zubair	Nan
والدليل	a bizonyíték	Nan
والده	anya	None
والدها	az apja	Nan
والدول	és az államok	Nan
والدولة	és az állam	Nan
والدين	szülők	None
والدينية	vallási	None
والذي	és ki	Nan
والذين	és ki	Nan
والرئيس	és az elnök	Nan
والرابع	és a negyedik	Nan
والرومان	és a rómaiak	Nan
والرومانية	és a román	Nan
والرياح	és a szél	Nan
والرياضيات	és a matematika	Nan
والزراعة	és a mezőgazdaság	Nan
والشيعة	síiták	Nan
والصفات	és attribútumok	Nan
والصلاة	és az ima	Nan
والعلوم	és a tudomány	Nan
والعمارة	és az építészet	Nan
والعمل	és munka	Nan
والعمليات	és a műveletek	Nan
والعناية	és vigyázz magadra	Nan
والغابات	és az erdők	Nan
والغاز	és a gáz	Nan
والغرب	és a nyugat	Nan
والغربية	nyugati	None
والغناء	és énekelni	Nan
والفارسية	és perzsa	Nan
والفرات	az eufrátus	Nan
والفرنسية	és franciául	Nan
والفضة	és ezüst	Nan
والفقه	jogtudomány	Nan
والعلمية	és tudományos	Nan
والعلماء	és tudósok	Nan
والعلم	és a tudomány	Nan
والعلاقات	és kapcsolatok	Nan
والصناعات	és az iparágak	Nan
والصناعة	és az ipar	Nan
والصين	és kína	Nan
والطاقة	és az energia	Nan
والطب	és az orvostudomány	Nan
والطيور	és a madarak	Nan
والعالم	és a világ	Nan
والفلك	és csillagászat	Nan
والعديد	és még sok más	Nan
والعرب	és az arabok	Nan
والعربية	és arabul	Nan
والعسكرية	és a katonaság	Nan
والعشرون	húsz	None
والعشرين	húsz	None
والعطلات	és ünnepek	Nan
والعلاج	és a kezelés	Nan
والعراق	és irak	Nan
وعند	és	None
وعندها	és akkor	Nan
وعين	kinevezte	Nan
يستخدمون	használják	None
يستطع	tud	None
يستطيع	tud	None
يستعمل	használt	None
يستقبل	kap	None
يستمر	folytatni	None
يسجل	regisztráció	Nan
يسعى	keresi	None
يسكن	élő	None
يسمح	lehetővé teszi	Nan
يسمى	nak, nek hívják	Nan
يسميه	ő hív	Nan
يسهل	megkönnyíti	Nan
يسود	uralkodj a legfelsőbbben	Nan
يسوع	jézus	None
يستخدمها	használja	None
يسيطر	controls	Nan
يستخدم	felhasználások	Nan
يسبب	okoz	None
يركز	sűrítmény	Nan
يرمز	szimbolizálja	Nan
يرون	látnak	Nan
يروى	jelzi	None
يروي	jelzi	None
يرى	látni kell	Nan
يريد	akar	None
يريفان	jereván	Nan
يزال	még mindig	Nan
يزداد	növekszik	None
يزيد	növeli	None
يسار	bal	None
يساعد	segítség	None
يساهم	constribte	Nan
يساوي	egyenlő	None
يسبق	precedes	Nan
يرفع	felvonók	Nan
يشار	említett	None
يشبه	úgy néz ki, mint a	Nan
يصيب	ez érinti	Nan
يضاف	hozzáadott	Nan
يضع	helyezi	None
يضم	otthont	None
يضمن	garancia	Nan
يطلب	kéri	None
يطلق	dob	Nan
يظل	maradványok	Nan
يظهر	megjelenik	None
يعادل	egyenértékű	Nan
يعانون	szenvedni	Nan
يعاني	szenved	None
يعبر	elhalad	Nan
يعتبر	figyelembe vett	Nan
يعتبره	figyelembe vették	Nan
يصنع	készít	None
يشارك	magában foglal	Nan
يصلي	imádkozik	Nan
يصف	ismertesse	Nan
يشتمل	magába foglalja	Nan
يشتهر	híres valamiről	Nan
يشرب	iszik	Nan
يشرف	megbecsült	Nan
يشعر	érez	Nan
يشغل	fut	None
يشكل	pózok	Nan
يشكلون	smink	Nan
يشمل	magába foglalja	Nan
يشهد	tanú	Nan
يشير	azt jelzi	Nan
يصبح	válik	None
يصح	helyes	None
يصدر	kiadott	None
يصعب	nehéz	None
يصل	reach	Nan
يرفض	megtagadja	Nan
يرغب	szeretnék	Nan
يرسل	elküldi	Nan
يحتاج	szükség	None
يحتفظ	tartja	None
يحتفل	ünnepel	Nan
يحتل	foglal	None
يحتمل	esetleg	None
يحتوي	tartalmaz	None
يحد	korlátok	Nan
يحدث	megtörténik vagy előfordul	Nan
يحدد	azt határozza meg,	Nan
يحدها	korlátos	Nan
يحصل	gets	Nan
يحضر	hoz	None
يحق	jogosult	Nan
يحقق	elér	Nan
يحكم	a versenybizottság	Nan
يحب	kedveltek	Nan
يحل	megfejt	Nan
يحاول	próbáld ki	Nan
يجمع	gyűjtő	Nan
يتواجد	létezik	None
يتوقع	elvár	Nan
يتوقف	megáll	Nan
يتولى	átvenni	Nan
يتيح	lets	Nan
يثبت	bizonyít	Nan
يثرب	yathrib	Nan
يجب	kell	None
يجتمع	megfelel	None
يجد	megtalálja	Nan
يجري	lény	None
يجعل	teszi	None
يجعله	teszi	None
يجعلها	teszi	None
يجلس	ülés	Nan
يجوز	megengedhető	Nan
يحمل	visz	Nan
يحملون	ők hordozzák	Nan
يحمي	protect	Nan
يده	az ő keze	Nan
يدور	pörgetések	Nan
يدي	a kezem	Nan
يدير	kezeli	None
يديه	a kezei	Nan
يذكر	mentionsed	Nan
يذهب	elmegy	None
يرابيع	szolgál	None
يراه	látja	None
يراها	látja	None
يربط	csatolni	Nan
يرتبط	társult	None
يرتفع	emelkedik	None
يرجع	esedékes	Nan
يرد	reagál	Nan
يدل	jelöli	None
يدفع	fizetés	Nan
يدعي	azt állítja	Nan
يدعى	azt állítja	Nan
يحوي	tartalmazza	None
يحيط	körülveszi	Nan
يحيى	yahia	Nan
يختار	választ	None
يختلف	különbözik	None
يخدم	szolgál	None
يخرج	ki	None
يعتبرون	úgy gondolják	Nan
يخص	üdvözlettel	Nan
يد	kéz	None
يدخل	belép	Nan
يدرس	tanítás	None
يدرك	rájön	None
يدعم	támaszok	Nan
يدعو	hívás	Nan
يدعون	azt állítják	Nan
يخضع	tantárgy	Nan
يعترف	elismeri	None
يعتقد	úgy véli,	Nan
يعتقدون	azt gondolják	Nan
ينتمون	belong	Nan
ينتمي	hozzá tartozik	Nan
ينتهي	befejez	Nan
ينجب	megszül	Nan
ينجح	sikerül	None
ينزل	lemegy	Nan
ينسب	tulajdonított	Nan
ينشأ	felmerül	Nan
ينص	államok	None
ينطبق	vonatkozik	None
ينظر	néz	None
ينظم	szervez	None
ينقسم	megosztott	None
ينقل	adás	Nan
ينكر	tagadja	Nan
ينتقل	mozog	None
يهتم	érdekli	Nan
ينتشر	kiterjed	Nan
ينتج	produce	Nan
يمثل	képvisel	Nan
يمثلون	cselekednek	Nan
يمكن	tud	None
يمكننا	tudunk	None
يمكنه	ő tud	Nan
يمكنها	az tud	Nan
يملك	tulajdonában	None
يمنع	megakadályozza	Nan
يموت	dies	Nan
يميز	megkülönbözteti	Nan
يميل	hajlamos	Nan
يمين	jobb	None
ينادي	hívás	Nan
ينبع	szára	Nan
ينبغي	kellene	None
ينتخب	légy megválasztva	Nan
يهدف	célozni	Nan
يهود	zsidó	None
يهودي	zsidó	None
يومًا	napok	None
يونانية	görög	None
يونايتد	egyesült	None
يونيو	június	None
يوهان	johan	Nan
يَملك	tulajdonában	None
يُحتمل	esetleg	None
يُسمى	nak, nek hívják	Nan
يُشكل	alakult	None
يُطلق	dob	Nan
يُظهر	megjelenik	None
يُعتقد	úgy véli,	Nan
يُعد	készít	None
يُعرف	ismert	None
يُقال	azt mondta	Nan
يوميا	napi	None
يومنا	a mi napunk	Nan
يوماً	egy nap	Nan
يوما	napok	None
يهودية	zsidó	None
يهوذا	juda	Nan
يو	yo	Nan
يواجه	arcok	Nan
يوان	yuan	Nan
يوتيوب	a youtube	Nan
يوجد	létezik	None
يمتلك	rendelkezik	None
يوحنا	jános	None
يوسف	yousuf	Nan
يوضح	műsorok	Nan
يوفر	biztosítja	None
يولد	megszületett	None
يوليو	július	None
يوم	nap	None
يومئذ	azon a napon	Nan
يوروبيوم	europeanium	Nan
يتناول	azzal számol	Nan
يمتد	spanokat	Nan
يمارس	gyakorlat	None
يغطي	borítók	Nan
يغلب	üt	Nan
يغير	változás	None
يفتح	megnyitja	Nan
يفترض	állítólag	None
يفرض	ró	Nan
يفسر	elmagyarázza	Nan
يفصل	elkülöníti	Nan
يفضل	előnyben részesített	Nan
يفعل	do	Nan
يفقد	elveszít	Nan
يفكر	gondol	Nan
يفهم	megértett	Nan
يفوز	győzelmek	Nan
يفوق	meghaladja	None
يعين	jelöl	None
يفيد	haszon	Nan
يعيشون	élnek	None
يعيد	ismétlés	Nan
يعتمد	attól függ	Nan
يعد	készít	None
يعرض	kijelzők	Nan
يعرف	ismert	None
يعرفه	ismerem őt	Nan
يعرفون	tudják	None
يعطي	adni	None
يعقوب	yacoub	Nan
يعكس	tükrözi	None
يعلم	tud	None
يعلن	bejelent	Nan
يعمل	művek	None
يعملون	dolgozó	None
يعني	eszközök	None
يعود	visszatér	None
يعيش	élő	None
يقارب	kb	None
يقال	azt mondta	Nan
يقام	zajlik	None
يقيم	életek	Nan
يكاد	közel	None
يكتب	írások	None
يكثر	bővelkedik	Nan
يكفي	elég	None
يكن	nem lehet	Nan
يكون	létezik	None
يكونوا	ők	None
يكونون	ők	None
يلاحظ	értesítés	Nan
يلتقي	találkozik	None
يلزم	szükséges	None
يلعب	játék	None
يلقى	szállít	Nan
يلي	következik	None
يقومون	csinálják	Nan
يقوم	felkelni	Nan
يقولون	azt mondják	Nan
يقول	says	Nan
يقبل	elfogadja	None
يقتصر	korlátozott	None
يقتل	kills	Nan
يقدر	méltányol	Nan
يقدم	biztosítja	None
يقرأ	olvas	Nan
يقرب	kb	None
يمارسون	gyakorolnak	Nan
يقسم	esküszik	Nan
يقضي	költ	None
يقع	található	None
يقف	feláll	Nan
يقل	csökkenés	Nan
يقلل	csökken	None
يقم	bal	None
يقود	vezetés	None
يقصد	eszközök	None
وأهم	és a legfontosabb	Nan
يتميز	közreműködő	Nan
يتمتعون	élvezd	Nan
ولعلّ	talán	None
ولغة	és a nyelv	Nan
ولقب	és a cím	Nan
ولقد	és nekem van	Nan
ولكل	és mindegyikre	Nan
ولكنه	de ez	Nan
ولكنها	de ez	Nan
ولكنهم	de ők vannak	Nan
ولكي	és azért	Nan
ولم	és nem	Nan
ولما	és miért	Nan
ولمّا	miért	None
وله	és neki	Nan
ولها	és ő	Nan
ولهذا	ezért	None
ولعل	talán	None
ولو	még	None
ولذلك	ezért	None
ولديه	és van	Nan
وكيف	és hogyan	Nan
ولأن	és mert	Nan
ولا	sem	None
ولاة	kormányzótanács	Nan
ولادة	születés	None
ولادته	születése	None
ولاسيما	különösen	None
ولايات	államok	None
ولاية	állapot	None
ولايته	megbízatása	Nan
ولبنان	és libanon	Nan
ولد	fiú	None
ولدت	születtem	Nan
ولده	az ő fia	Nan
ولدى	és nekem van	Nan
ولذا	ezért	None
وكوريا	és korea	Nan
ولي	gyám	Nan
وليبيا	és líbia	Nan
ومسلم	és muszlim	Nan
ومصر	és egyiptom	Nan
ومع	és velük	Nan
ومعرفة	és megtudja	Nan
ومعظم	és a legtöbb	Nan
ومعناها	és annak jelentése	Nan
ومعه	és vele	Nan
ومكان	egy hely	Nan
ومما	és miből	Nan
ومملكة	és egy királyság	Nan
ومن	és innen	Nan
ومناطق	és régiók	Nan
ومنذ	és azóta	Nan
ومنطقة	és a terület	Nan
ومنظمة	és a szervezés	Nan
ومسجد	és egy mecset	Nan
وليام	vilmos	None
ومركز	és középen	Nan
ومراجع	és referenciák	Nan
وليد	waleed	Nan
وليس	ez nem	Nan
وليست	nem	None
وليلة	és egy éjszaka	Nan
وليم	vilmos	None
وما	gesztikulál	Nan
وماض	múlt	None
ومثل	és tetszik	Nan
ومجلس	és a fedélzeten	Nan
ومجموعة	és egy csoport	Nan
ومحاولة	és próbál	Nan
ومحمد	és muhammad	Nan
ومدرسة	és egy iskola	Nan
ومدى	és milyen messzire	Nan
ومدينة	és a város	Nan
ومراكز	és központok	Nan
وكنيسة	és egy templom	Nan
وكندا	és kanada	Nan
وكما	és mint	Nan
وفقًا	szerint	None
وفلسطين	és palesztina	Nan
وفنلندا	finnország	None
وفى	teljesített	None
وفي	és be	Nan
وفيما	val vel	Nan
وفيه	és benne	Nan
وفيها	és benne	Nan
وقائع	tények	None
وقاد	és vezetett	Nan
وقال	és ő mondta	Nan
وقالت	és mondta	Nan
وقالوا	és mondták	Nan
وقام	felkelt	Nan
وقامت	ő készítette	Nan
وفقاً	szerint	None
وقاموا	és felálltak	Nan
وفقا	szerint	None
وفرنسا	és franciaország	Nan
وغالبا	és gyakran	Nan
وغالباً	és gyakran	Nan
وغالبًا	és gyakran	Nan
وغرب	és nyugatra	Nan
وغير	és több	Nan
وغيره	és több	Nan
وغيرها	és mások	Nan
وغيرهم	és mások	Nan
وفاة	halál	None
وفاته	meghalt	None
وفاتها	meghalt	None
وفتح	és nyitva	Nan
وفد	delegáció	Nan
وفر	mentés	Nan
وفرة	bőség	Nan
وفق	alapján	None
وقبل	és korábban	Nan
وقت	idő	None
وقتل	megölték	None
وكان	és az volt	Nan
وكانت	és ő volt	Nan
وكانوا	és voltak	Nan
وكتاب	és egy könyv	Nan
وكتب	írt	None
وكثير	és sok	Nan
وكثيرا	és nagyon sok	Nan
وكذا	és ilyen	Nan
وكذلك	és még	Nan
وكرة	egy labda	Nan
وكل	és minden	Nan
وكلاهما	mindkettő	Nan
وكلما	és bármikor	Nan
وكلمة	és egy szót	Nan
وكلها	és mindet	Nan
وكالة	ügynökség	Nan
وكالات	ügynökségek	Nan
وكأنه	tetszik	None
وقيل	azt mondták	Nan
وقته	az ő ideje	Nan
وقتها	itt az idő	Nan
وقد	volt	None
وقدم	ő adta	Nan
وقرر	és úgy döntött	Nan
وقصر	egy palota	Nan
وقطاع	és szalag	Nan
ومنع	és blokkolja	Nan
وقطر	és katar	Nan
وقع	aláírt	Nan
وقعت	történt	None
وقف	felállt	Nan
وقلة	és kevés	Nan
وقوة	és az erő	Nan
وقود	üzemanyag	None
وقوع	esemény	None
وقطع	és vágni	Nan
ومنه	és belőle	Nan
ومنها	mint például	Nan
ومنهم	és közülük	Nan
ويوجد	és van	Nan
ويوسف	és joseph	Nan
وَلاَ	sem	None
وُلد	fiú	None
يأتي	jön	None
يأخذ	tudomásul	Nan
يأكل	eszik	Nan
يأمر	rendelés	Nan
يؤثر	hatás	None
يؤخذ	el kell venni	Nan
يؤدى	vezet	None
يؤدي	vezet	None
يؤكد	megerősíti	Nan
يؤمن	hinni	Nan
يؤمنون	hinni benne	Nan
وينقسم	ez meg van osztva	Nan
يا	oh	Nan
ويندوز	ablakok	Nan
ويمكن	és lehet	Nan
ويعني	azt jelenti	Nan
ويعود	és vissza	Nan
ويعيش	és élj	Nan
ويقال	azt mondják	Nan
ويقدر	becslések szerint	Nan
ويقدم	ez biztosítja	Nan
ويقع	és esik	Nan
ويقول	és azt mondják	Nan
ويقوم	ez alapja	Nan
ويكون	és legyen	Nan
ويكي	wiki	Nan
ويكيبيديا	wikipedia	Nan
ويلز	wells	Nan
ويليام	vilmos	None
ويمثل	képviseli	None
وينتج	termel	Nan
ياسر	yasser	Nan
ياسين	yassen	Nan
يبحث	törekszik	Nan
يترك	elhagy	Nan
يتسبب	ok	None
يتصل	kommunikálni	Nan
يتضح	illusztrált	Nan
يتضمن	magába foglalja	Nan
يتطلب	igényel	None
يتعرض	kitett	Nan
يتعلق	tekintet	Nan
يتغير	változik	None
يتفق	egyetért	Nan
يتكلم	beszélj	Nan
يتكون	tartalmaz	None
يتلقى	kap	None
يتم	teljes	None
يتمتع	élvezd	Nan
يترتب	ebből következik	Nan
يتراوح	tartományok	None
يتخذ	vesz	None
يتحول	felbukkan	Nan
يبدأ	lépések	Nan
يبدو	hang	None
يبعد	el	None
يبق	maradványok	Nan
يبقى	maradványok	Nan
يبلغ	jelentés	None
يبين	előadás	None
ويعمل	és működik	Nan
يتأثر	érintett	None
يتأهل	juss	Nan
يتبع	folytatás	Nan
يتجاوز	meghaladja	None
يتجه	cím	None
يتحدث	beszél	None
يتحدثون	beszélnek	None
يتحرك	mozog	None
يتألف	áll	None
يتمكن	kezel	Nan
ويعرف	tudja	None
ويعتمد	attól függ	Nan
وهناك	és ott	Nan
وهو	és ő	Nan
وهولندا	hollandia	None
وهى	melyik	None
وهي	melyik	None
ووادي	és völgy	Nan
ووجد	megtalálta	None
ووجدت	és megtalált	Nan
ووجود	és a jelenlét	Nan
ووسائل	eszközök	None
ووسط	és középen	Nan
ووصل	megérkezett	None
ووصلت	és megérkeztem	Nan
ووضع	és beállítás	Nan
ووفقا	szerint	None
وهنا	és itt	Nan
ووفقاً	szerint	None
وهما	és ők ketten	Nan
وهكذا	stb	None
ونادي	és klub	Nan
ونتيجة	ennek eredményeként	Nan
ونشأته	és nevelése	Nan
ونشر	és tegye közzé	Nan
ونصف	és egy fél	Nan
ونظام	és a rendszer	Nan
ونظرا	adott	None
ونظرًا	és nézd	Nan
ونظم	és rendszerek	Nan
ونقل	és mozogni	Nan
ونهر	és egy folyó	Nan
وهؤلاء	és ezek	Nan
وهبي	wehbe	Nan
وهذا	és ez az	Nan
وهذه	és ez	Nan
وهم	és ők	Nan
ووفقًا	szerint	None
ويأتي	jön	None
ويؤدي	és vezet	Nan
ويرى	meglát	Nan
ويستخدم	használja	None
ويستطيع	és ő is képes	Nan
ويسمى	ez az úgynevezett	Nan
ويشمل	magába foglalja	Nan
ويشير	megjegyzések	None
ويصبح	és az lesz	Nan
ويصل	és fel	Nan
ويضم	magába foglalja	Nan
ويضيف	- tette hozzá	Nan
ويطلق	ez az úgynevezett	Nan
ويظهر	úgy tűnik	Nan
ويعتبر	figyelembe veszik	Nan
ويعتقد	és hitt	Nan
ويعتقدون	és azt hiszik	Nan
ويروي	ő mondta	Nan
ويرجع	visszatér	None
ويذكر	megemlíti	Nan
ويدخل	és belép	Nan
ويؤكد	megerősíti	Nan
ويؤمن	és hidd el	Nan
ويب	háló	Nan
ويبدو	úgy tűnik	Nan
ويبقى	marad	None
ويبلغ	tájékoztatja	Nan
ويتحدث	beszél	None
ويعد	és ígéreteket	Nan
ويتراوح	ez tartomány	Nan
ويتم	és megtörtént	Nan
ويتميز	jellemzői	None
ويجب	muszáj	Nan
ويجوز	megengedett	None
ويحتوي	tartalmaz	None
ويحدث	és megtörténik	Nan
ويختلف	ez különbözik	Nan
ويتكون	ez áll	Nan
تسببت	okozott	None
وأهل	és az emberek	Nan
وأنها	és ő	Nan
مبكرة	korai	None
مبلغ	összeg	Nan
مبنى	épület	None
مبني	épület	None
مبنية	épült	None
مبيعات	értékesítés	Nan
متابعة	folytatni	None
متاحة	elérhető	None
متتالية	egymást követő	Nan
متحركة	mozgó	None
متحف	múzeum	None
متحقق	elért	None
متخصصة	specializált	Nan
متر	méter	None
مترو	metró	None
مبكر	korai	None
متزايد	növekvő	None
مبرهنة	elv	None
مباشرة	közvetlenül	None
مالي	pénzügyi	None
مالية	pénzügy	Nan
ماليزيا	malaysia	Nan
مان	férfi	None
مانشستر	manchester	None
مايكروسوفت	microsoft	None
مايكل	michael	None
مايو	lehet	None
مبابان	mbabane	Nan
مبادئ	elvek	Nan
مبادرة	kezdeményezés	None
مباراة	mérkőzés	None
مبارك	áldás	Nan
مباريات	gyufa	Nan
مباشر	közvetlen	None
مبدأ	elv	None
مالك	tulajdonos	None
متزايدة	növekvő	None
متساوية	egyenlő	None
مثلث	háromszög	None
مثلما	mint	None
مثله	mint ő	Nan
مثلها	mint ő	Nan
مثيرة	izgalmas	Nan
مثيل	egy példa	Nan
مجاعة	éhínség	Nan
مجال	terület	None
مجالات	mezők	Nan
مجالس	alaplapok	Nan
مجتمع	közösség	None
مجتمعات	közösségek	None
مجددًا	újra	None
مجرة	galaktika	Nan
مجرد	éppen	None
مثلاً	például	None
متزوج	házas	Nan
مثلا	például	None
مثال	példa	None
متصلة	csatlakoztatva	Nan
متطلبات	követelmények	Nan
متطورة	kifinomult	Nan
متعدد	többszörös	None
متعددة	többszörös	None
متفاوتة	változó	None
متفرقة	elszórt	Nan
متقدمة	fejlett	None
متكررة	gyakori	None
متميزة	különböző	None
متنوعة	vegyes	None
متوسط	átlagos	None
متوسطة	közepes	None
متوفرة	elérhető	None
متى	amikor	None
مثل	mint például	Nan
مال	főváros	None
ماكسويل	maxwell	Nan
مافيا	maffia	None
ليبرالية	liberális	None
ليبيا	líbia	Nan
ليتم	kész lenni	Nan
ليتو	leto	Nan
ليزر	lézer	Nan
ليس	nem	None
ليست	ez nem	Nan
ليسوا	ezek nem	Nan
ليصبح	válni	None
ليصل	megérkezni	Nan
ليكون	lenni	None
ليلاً	éjszaka	None
ليلة	egy éjszaka	Nan
ليلى	layla	Nan
لينكون	lincoln	None
ليالي	éjszaka	None
لينين	lenin	None
لي	enyém	Nan
لونه	a színe	Nan
لواء	dandártábornok	Nan
لوثر	luther	None
لوجود	létezni	Nan
لوح	deszka	Nan
لوحات	tányérok	Nan
لوحة	festmény	None
لوزارة	a minisztériumhoz	Nan
لوس	los	None
لوصف	leírására	Nan
لوضع	rakni	Nan
لوقا	luke	None
لوقف	megállni	Nan
لولا	lula	Nan
لولاية	egy államért	Nan
لون	szín	None
لويس	lewis	None
ليون	lyon	Nan
ليوناردو	leonardo	None
مأهولة	lakott	None
ماتت	meghalt	None
ماجد	majid	Nan
مادة	ügy	None
مادية	anyag	None
ماذا	mit	None
مارتن	márton	None
مارس	március	None
مارك	mark	None
ماركس	marx	None
ماركوس	marcus	None
ماري	marie	None
ماريا	maria	None
مارينر	tengerész	Nan
ماسنجر	hírnök	Nan
ماعدا	kivéve	None
مات	meghalt	None
مائية	aqua	Nan
مائة	száz	None
ما	mit	None
مؤتمر	konferencia	None
مؤخرا	nemrég	Nan
مؤخراً	nemrég	Nan
مؤخرًا	nemrég	Nan
مؤسس	alapító	None
مؤسسات	intézmények	None
مؤسسة	vállalat	None
مجرى	folyam	Nan
مؤشر	indikátor	Nan
مؤكدة	megerősített	None
مؤلف	szerző	None
مؤلفات	szerzői	None
مؤلفاته	írásait	Nan
مئات	kedvező	None
مئة	száz	None
مئوية	százalék	Nan
مؤقتة	ideiglenes	None
لو	ha	None
مجلة	magazin	None
مجمع	összetett	None
مركبات	járművek	None
مركبة	jármű	None
مركز	központ	None
مركزا	központ	None
مركزاً	központ	None
مركزية	központosítás	Nan
مركزًا	központ	None
مرمرة	marmara	Nan
مروان	marwan	Nan
مرور	átjáró, átkelés	Nan
مريم	mariam	Nan
مزارع	gazda	None
مزايا	előnyök	Nan
مزيج	keverd össze	Nan
مزيد	több	None
مركب	összetett	None
مسألة	probléma	None
مرقس	mark	None
مرض	betegség	None
مراقبة	ellenőrzés	None
مراكز	központok	Nan
مراكش	marrakesh	Nan
مربع	négyzet	Nan
مرة	egyszer	None
مرت	elmúlt	None
مرتبة	rang	Nan
مرتبطة	összekapcsolt	Nan
مرتفع	magas	None
مرتفعات	magasság	None
مرتفعة	magas	None
مرتين	kétszer	None
مرحلة	színpad	Nan
مرسوم	rendelet	None
مرصد	obszervatórium	Nan
مرضى	betegek	None
مراقب	művezető	Nan
مسؤول	felelős	None
مسؤولية	felelősség	Nan
مستقرة	stabil	None
مستقل	független	None
مستقلة	független	None
مستمر	folyamatos	None
مستمرة	folyamatban lévő	Nan
مستوطنة	település	None
مستوى	szint	None
مستويات	levels	Nan
مسجد	mecset	Nan
مسح	felmérés	Nan
مسرح	színpad	Nan
مسرحية	a játék	Nan
مسعود	masoud	Nan
مسقط	muskotály	Nan
مسلسل	sorozat	None
مستقبل	jövő	None
مسؤولة	felelős	None
مستعمرة	kolónia	Nan
مستشفى	kórház	None
مساء	este	None
مسائل	problémák	None
مسابقات	versenyek	Nan
مسابقة	verseny	None
مساجد	mecsetek	Nan
مساحة	tér	None
مساحتها	a terület	Nan
مسار	egy utat	Nan
مساعد	helyettes	Nan
مساعدة	segítség	None
مسافة	távolság	None
مساندة	támogatás	None
مساهمة	bemenet	Nan
مستخدم	használó	None
مستخدمي	felhasználók	None
مستعمرات	a telepeket	Nan
مراعاة	előzékeny	Nan
مراد	szándékozik	Nan
مراحل	fázis	None
محدود	korlátozott	None
محدودة	korlátozott	None
محركات	motorok	None
محرم	muharram	Nan
محط	állomás	None
محطات	állomások	Nan
محطة	állomás	None
محفز	katalizátor	Nan
محفوظ	mentett	Nan
محل	üzlet	Nan
محلول	megoldás	None
محلي	cukrozott	Nan
محلية	helyi	None
محمد	mohamed	None
محمدًا	mohamed a	Nan
محددة	különleges	None
محمود	mahmud	Nan
محدد	különleges	None
محاولة	kísérlet	None
مجمل	átfogó	None
مجموع	összeg	Nan
مجموعات	csoportok	None
مجموعتين	két csoport	Nan
مجهول	ismeretlen	None
مجهولة	ismeretlen	None
مجيء	eljövetel	Nan
محاسبة	könyvelés	Nan
محاطة	körülvett	Nan
محافظات	tartományok	None
محافظة	kormányzóság	Nan
محاكاة	tettetés	Nan
محاكم	bíróságok	None
محاكمة	próba	Nan
محاولات	erőfeszítések	Nan
محايدة	semleges	None
محمودية	mahmoudia	Nan
محمية	védett	None
محو	törli	Nan
مدنها	a városai	Nan
مدني	civil	None
مدنية	polgári	None
مدونة	blog	None
مدى	drágakőfoglalat	Nan
مدير	rendező	None
مدينة	város	None
مدينتي	az én városom	Nan
مذاهب	tanok	Nan
مذكرات	napló	None
مذكراته	jegyzetei	Nan
مر	felett	None
مرات	times	Nan
مراجع	irodalom	None
مراجعة	felülvizsgálat	Nan
مدن	városok	None
مدعوم	támogatott	None
مدريد	madrid	None
مدرسة	iskola	None
محور	tengely	None
محيط	óceán	None
مخاطر	kockázatok	Nan
مخالفة	megszegés	Nan
مخاوف	félelmek	Nan
مختلف	különböző	None
مختلفة	különböző	None
مجلس	tábla	None
مختلفين	két különböző	Nan
مخطط	tervezett	None
مخطوطة	kézirat	Nan
مخيم	tábor	None
مدارات	pályák	Nan
مدارس	iskolák	None
مدة	tartam	Nan
مدخل	bejárat	Nan
مخصصة	dedikált	Nan
لهما	nekik	None
لهم	nekik	None
لهذه	ezért	None
لقاح	vakcina	Nan
لقب	cím	None
لقبه	beceneve	None
لقتال	harcolni	Nan
لقد	nekem van	Nan
لقوات	erőkre	Nan
لقوانين	törvények	None
لقول	mondani	None
لقي	megtalált	Nan
لقياس	megmérni	Nan
لك	a tied	Nan
لكتاب	egy könyvet	Nan
لكثرة	túl sok	Nan
لكثير	sokaknak	Nan
لكرة	a labdaért	Nan
لقاء	találkozó	None
لكل	minden	None
لفهم	megérteni	Nan
لفكرة	egy ötletért	Nan
لعمل	dolgozni	None
لعملية	feldolgozás	Nan
لغات	nyelvek	None
لغة	nyelv	None
لغتهم	a nyelvük	Nan
لغرض	egy célból	Nan
لغزو	betörni	Nan
لغوية	nyelvi	None
لغير	másnak	Nan
لـ	mert	None
لفتح	kinyitni	Nan
لفترات	periódusokra	Nan
لفترة	egy ideig	Nan
لفرنسا	franciaország számára	Nan
لفظة	szó	None
لفلسطين	palesztinának	Nan
لعلي	talán	None
لكلمة	egy szót	Nan
لكن	de	None
للاتحاد	az unióért	Nan
للاتصالات	telecom	Nan
للاقتصاد	a gazdaság számára	Nan
للبحث	keresés	Nan
للبحر	a tengerhez	Nan
للبشر	az emberek számára	Nan
للبلاد	az országért	Nan
للتاريخ	a történelemért	Nan
للتجارة	kereskedelmi	None
للتخلص	megszabadulni	Nan
للتدخين	dohányzáshoz	Nan
للتدريب	edzéshez	Nan
للتربة	a talaj számára	Nan
للتعبير	kifejezni	Nan
للتعليم	oktatáshoz	Nan
للإنسان	egy ember számára	Nan
لكم	neked	Nan
للإمبراطورية	a birodalom számára	Nan
للإصابة	sérülés miatt	Nan
لكنه	de ő	Nan
لكنها	de ő	Nan
لكنهم	de ők vannak	Nan
لكوكب	egy bolygó számára	Nan
لكون	egy univerzumért	Nan
لكونه	azért, mert	Nan
لكي	azért, hogy	Nan
للأراضي	a földek számára	Nan
للأرض	a földért	Nan
للأطفال	gyerekeknek	Nan
للأمم	nemzetek közül	Nan
للأندية	klubok számára	Nan
للإتحاد	az unióért	Nan
للإسلام	az iszlámhoz	Nan
للإشارة	jelezni	Nan
للإمام	az imámnak	Nan
لعلماء	tudósok számára	Nan
لعلم	információért	Nan
لعلاج	kezelni	None
لحد	csökkentse	Nan
لحركة	mozgáshoz	Nan
لحزب	bulira	Nan
لحساب	számolni	Nan
لحظة	pillanat	Nan
لحفظ	menteni	Nan
لحقوق	jogokért	Nan
لحكم	uralkodni	Nan
لحل	megoldani	None
لحم	hús	None
لحماية	megvédeni	Nan
لحن	dallam	Nan
لحوالي	körülbelül	None
لخدمة	kiszolgálni	Nan
لدراسة	tanulni	None
لحام	hegesztés	None
لدرجة	bizonyos mértékig	Nan
لجيش	egy hadseregért	Nan
لجميع	mindenkinek	None
لتعزيز	előléptetni	Nan
لتفسير	magyarázat	None
لتقديم	szolgáltatni	Nan
لتكون	lenni	None
لتكوين	beállítás	Nan
لتلك	azoknak	None
لتنظيم	szervezni	Nan
لتنفيذ	megvalósít	Nan
لتوفير	szolgáltatni	Nan
لتوليد	generálni	Nan
لجأ	menedék	Nan
لجامعة	egyetemi	None
لجعل	csinálni	Nan
لجمع	gyűjteni	Nan
لجمهورية	a köztársaság felé	Nan
لجنة	egy bizottság	Nan
لدعم	támogatni	Nan
لدول	országokba	Nan
لدولة	egy országba	Nan
لصناعة	előállítani	Nan
لضمان	garantálni	Nan
لطفي	lotfi	Nan
لطيفة	latifa	Nan
لظهور	megjelenni	Nan
لعام	az évre	Nan
لعب	játék	None
لعبة	játék	None
لعبت	játszottam	Nan
لعبد	egy szolgának	Nan
لعدة	többnek	Nan
لعدد	számra	Nan
لعدم	mert nem	Nan
لعطارد	a merkúrhoz	Nan
لعل	esetleg	None
لصالح	favor	Nan
لشركة	egy társaság számára	Nan
لشبونة	lisszabon	Nan
لشبه	a hasonlóságért	Nan
لدى	nekem van	Nan
لدي	nekem van	Nan
لدينا	megvan	None
لديه	van neki	Nan
لديها	neki van	Nan
لديهم	van nekik	Nan
لذا	így	None
للتنمية	fejlesztéshez	Nan
لذلك	így	None
لرعاية	hogy vigyázzon	Nan
لزيادة	növelni	Nan
لسان	nyelv	None
لسكان	lakók számára	Nan
لسنة	egy évre	Nan
لسنوات	éveken át	Nan
لسياسة	a politikához	Nan
لرئيس	fejre	Nan
للثقافة	a kultúra számára	Nan
للثورة	a forradalomból	Nan
للجدل	vitatott	None
للموسيقى	zenére	Nan
للمياه	vízhez	Nan
للميلاد	a születésnapra	Nan
للنادي	a klub számára	Nan
للناس	embereknek	None
للنبي	a próféta felé	Nan
للنساء	nőknek	Nan
للنظام	a rendszer számára	Nan
للنفط	az olaj	Nan
للنقل	transzferhez	Nan
لله	allah	Nan
للهجوم	támadni	Nan
للوزراء	a minisztereknek	Nan
للوصول	elérni	None
للولايات	az államokhoz	Nan
للمواد	anyagokhoz	Nan
لليهود	a zsidóknak	Nan
للمنطقة	a régió számára	Nan
للملك	a királynak	Nan
للكواكب	a bolygók számára	Nan
للكوكب	a bolygó számára	Nan
للكويت	kuvait számára	Nan
للماء	vízálló	Nan
للمجتمع	a közösség felé	Nan
للمجلس	a tanácshoz	Nan
للمجموعة	a csoport számára	Nan
للمدينة	a városnak	Nan
للمرة	az időre	Nan
للمساعدة	segítségért	Nan
للمستخدمين	a felhasználók számára	Nan
للمسجد	a mecset számára	Nan
للمسلمين	a muszlimok számára	Nan
للمسيحية	a kereszténységért	Nan
للمغرب	marokkó számára	Nan
للمملكة	a királyságért	Nan
لم	nem	None
لما	amikor	None
لماذا	miért	None
لن	nem fog	Nan
لنا	a	None
لندن	london	None
لنظام	a rendszerhez	Nan
لنظرية	az elméletért	Nan
لنفسه	magának	None
لنقل	mondjuk	Nan
لنكدوك-روسيون	languedoc-roussillon	Nan
لنهر	a folyóért	Nan
له	neki	None
لها	neki	None
لهتلر	hitlernek	Nan
لهجات	ékezetek	Nan
لهجة	nyelvjárás	None
لهذا	ezért	None
لمواجهة	szembenézni	Nan
لمنع	megelőzni	Nan
لمنظمة	egy szervezet számára	Nan
لمنطقة	egy területre	Nan
لمجلس	a deszkához	Nan
لمجموعة	egy csoport számára	Nan
لمحاربة	harcolni	Nan
لمحاولة	megpróbálni	Nan
لمحمد	muhammadnak	Nan
لمختلف	különböző	None
لمدة	egy ideig	Nan
للكنيسة	a templom számára	Nan
لمدينة	egy város számára	Nan
لمساعدة	segíteni	None
لمصر	egyiptomért	Nan
لمعالجة	címhez	Nan
لمعرفة	utána járni	Nan
لمعظم	legtöbbnek	Nan
لمكافحة	harcolni	Nan
لمن	akinek	None
لمرض	betegség esetén	Nan
مسلسلات	sorozat	None
للكثير	sokaknak	Nan
للقيام	csinálni	Nan
للخليفة	a kalifushoz	Nan
للدراسات	tanulmányokhoz	Nan
للدراسة	tanulni	None
للدفاع	megvédeni	Nan
للدلالة	jelölni	Nan
للدول	az államokhoz	Nan
للدولة	az államnak	Nan
للدين	a vallásért	Nan
للرئيس	az elnöknek	Nan
للرجال	férfiaknak	Nan
للرجل	az ember számára	Nan
للزراعة	a mezőgazdaság számára	Nan
للزهرة	a virágért	Nan
للسكان	a lakosság számára	Nan
للسلام	béke	None
للخلافة	az utódlásért	Nan
للسلطان	a szultánnak	Nan
للحيوانات	állatok számára	Nan
للحكومة	a kormánynak	Nan
للجزائر	algéria részéről	Nan
للجسم	a test számára	Nan
للجمعية	az egyesületnek	Nan
للجمهورية	köztársaság	None
للجميع	mindenkinek	None
للجنة	a bizottságnak	Nan
للجيش	a hadsereg számára	Nan
للحد	behatárolni	Nan
للحرارة	melegíteni	Nan
للحرب	a háborúért	Nan
للحركة	mozgáshoz	Nan
للحزب	a bulihoz	Nan
للحصول	kapni	None
للحفاظ	tartani	None
للحكم	ítélni	Nan
للحياة	életért	Nan
للسلطة	a hatalomért	Nan
للسيارات	autókhoz	Nan
للسيطرة	ellenőrzés alatt tartani	Nan
للعناصر	az elemekhez	Nan
للعهد	a szövetségért	Nan
للعولمة	a globalizációért	Nan
للغاية	rendkívüli módon	Nan
للغة	a nyelv	Nan
للفرد	az egyén számára	Nan
للفنون	a művészetekért	Nan
للفيروسات	vírusok ellen	Nan
للقارات	interkontinentális	Nan
للقتال	harcolni	Nan
للقدس	jeruzsálemért	Nan
للقرآن	a koránért	Nan
للقرن	az évszázadra	Nan
للقضاء	megszüntetni	Nan
للقوات	a csapatok számára	Nan
للعمل	munkához	Nan
للعلوم	a tudományból	Nan
للعلماء	tudósok számára	Nan
للعلم	információért	Nan
للشباب	fiataloknak	Nan
للشعب	az embereknek	Nan
للشمس	a nap számára	Nan
للشيخ	sejk	Nan
للصلاة	imádkozni	Nan
للضوء	felvilágosítani	Nan
للطاقة	energiaért	Nan
للكتاب	a könyvért	Nan
للطبيعة	természetből	Nan
للطيران	repülni	Nan
للعالم	a világért	Nan
للعام	az évre	Nan
للعديد	többre	Nan
للعراق	irak számára	Nan
للعرب	az araboknak	Nan
للعلاج	kezelésre	Nan
للطلاب	diákoknak	Nan
مسلم	muszlim	None
مسلمة	muszlim	None
مسلمون	muszlimok	None
نصف	fél	None
نصوص	szövegek	Nan
نصيب	ossza meg	Nan
نصير	támogató	None
نطاق	tartomány	None
نظام	rendszer	None
نظر	megfontolás	Nan
نظرا	esedékes	Nan
نظراً	esedékes	Nan
نظرة	pillantás	Nan
نظريات	elméletek	None
نظرية	elmélet	None
نظريته	az ő elmélete	Nan
نظرًا	esedékes	Nan
نظم	szervezett	None
نصر	győzelem	None
نظير	mérkőzés	None
نصب	beállít	Nan
نشوب	kitörés	None
نسمة	szellő	Nan
نشأ	keményítő	Nan
نشأة	genezis	Nan
نشأت	visszaszármaztatott	Nan
نشأته	felnőttem	Nan
نشأتها	eredetileg	None
نشاط	tevékenység	None
نشاطات	tevékenységek	None
نشبت	kitört	None
نشر	terjedés	Nan
نشرت	közzétett	Nan
نشرها	feladta	None
نشط	aktív	None
نشطة	aktív	None
نشوء	megjelenése	None
نص	szöveg	None
نسل	mag	None
نعرف	tudjuk	None
نفر	kikapcsolni	Nan
نمر	tigris	None
نمط	stílus	None
نمو	növekedés	None
نموذج	forma	None
نهائي	végső	None
نهائيات	döntő	None
نهاية	vég	Nan
نهج	megközelítés	None
نهر	folyó	None
نهضة	reneszánsz	None
نهيان	nahyan	Nan
نواب	képviselőház	None
نواة	atommag	Nan
نواس	inga	Nan
نوبل	nemes	None
نمت	felnőtt	None
نعيم	naeem	Nan
نماذج	forms	Nan
نقله	mozgatni	Nan
نفس	ugyanaz	None
نفسه	saját maga	Nan
نفسها	maga	None
نفسي	magamat	Nan
نفسية	pszichológiai	None
نفط	olaj	None
نفوذه	befolyása	None
نفوذها	befolyása	None
نفوس	souls	Nan
نفي	tagadás	Nan
نقاط	pont	None
نقد	készpénz	Nan
نقص	hiány	Nan
نقطة	pont	None
نقل	átutalás	Nan
نقول	azt mondjuk	Nan
نسخة	másolat	Nan
نسخ	példányban	Nan
نستطيع	tudunk	None
نابلس	nablus	Nan
نابليون	napóleon	None
ناتج	kimenet	Nan
ناجحة	sikeres	None
ناحية	kéz	None
نادرة	ritka	None
نادى	klub	None
نادي	klub	None
نار	tűz	None
ناسا	nasa	None
ناصر	naser	Nan
ناطقة	beszélő	None
نال	megkapta	None
نالت	neki van	Nan
نانسي	nancy	Nan
ناب	agyar	Nan
نايف	nayef	Nan
نائب	helyettes	Nan
مِنْ	tól től	Nan
ميدان	négyzet	Nan
ميزانية	költségvetés	None
ميزة	funkció	None
ميسي	messi	None
ميكانيكا	mechanika	Nan
ميل	tendencia	Nan
ميلاد	születés	None
ميلان	milánó	None
ميلانو	milánó	None
ميلودراما	melodráma	Nan
ميناء	kikötő	None
ميونيخ	münchen	None
مَا	mit	None
مَنْ	tól től	Nan
مِن	tól től	Nan
ن	n	None
نبات	növény	None
نباتات	növények	None
نبتون	neptun	Nan
نحو	felé	None
نذكر	megemlítjük	Nan
نرى	látjuk	None
نزار	nazar	Nan
نزل	letöltés	Nan
نزلت	kiszálltam	Nan
نزول	jön le	Nan
نساء	nők	None
نسب	leszármazás	Nan
نسبة	mérték	Nan
نسبته	aránya	None
نسبه	százalék	Nan
نسبيا	viszonylag	None
نسبياً	viszonylag	None
نسبيًا	viszonylag	None
نحن	mi	None
نجيب	najib	Nan
نجوم	csillag	None
نجمة	csillag	None
نبذة	rövid	None
نبي	próféta	None
نبيل	nabil	Nan
نت	háló	Nan
نتائج	következményei	None
نتاج	termék	None
نتج	eredményezett	None
نوح	noé	Nan
نتيجة	naptár	None
نجاحاً	egy siker	Nan
نجاد	najad	Nan
نجح	sikerült neki	Nan
نجحت	átmentem	Nan
نجد	találunk	None
نجران	najran	Nan
نجم	a csillag	Nan
نجاح	siker	None
نور	fény	None
نورة	noura	Nan
نوستراداموس	nostradamus	None
وأبي	és apám	Nan
وأتباعه	és követői	Nan
وأثناء	és közben	Nan
وأجزاء	és alkatrészek	Nan
وأجهزة	és szervó	Nan
وأحد	egy	None
وأحمد	és ahmed	Nan
وأحيانا	és néha	Nan
وأخذ	és figyelembe	Nan
وأخذت	és elvitte	Nan
وأخرى	és egy másik	Nan
وأخيرا	és végül	Nan
وأخيراً	végül	None
وأخيرًا	és végül	Nan
وأدت	és vezetett	Nan
وأبو	és abu	Nan
وأدى	völgy	Nan
وأبرزها	a legfigyelemreméltóbb	Nan
وآله	és a családja	Nan
هي	ő	None
هيئة	test	None
هيا	gyerünk	Nan
هياكل	struktúrák	Nan
هيدروجين	hidrogén	Nan
هيفاء	haifa	Nan
هيكل	szerkezet	None
هيلين	helen	Nan
هيم	szegély	Nan
هينايانا	hinajána	Nan
هُوَ	ő van	Nan
و	és	None
وآخر	és egy másik	Nan
وآخرون	és mások	Nan
وآسيا	és ázsia	Nan
وأبرز	leginkább kiemelve	Nan
وأذربيجان	és azerbajdzsán	Nan
وأربعين	és negyven	Nan
وأرسل	ő küldte	Nan
وأقدم	és idősebb	Nan
وأقل	és kevesebb	Nan
وأكبر	és nagyobb	Nan
وأكثر	és több	Nan
وأكثرها	és a legtöbbjük	Nan
وأكد	megerősített	None
وألمانيا	és németország	Nan
وأما	vagy	None
وأمر	ő rendelt	Nan
وأمريكا	és amerika	Nan
وأمه	és az anyja	Nan
وأن	és biztosan	Nan
وأنا	és én	Nan
وأنشأ	alapított	None
وأنه	és ez	Nan
وأقام	maradt	None
وأقاليم	és területek	Nan
وأفغانستان	és afganisztán	Nan
وأفريقيا	és afrika	Nan
وأساليب	és módszerek	Nan
وأسباب	és okok	Nan
وأستراليا	és ausztrália	Nan
وأسس	és az alapok	Nan
وأشار	rámutatott	Nan
وأشهر	a leghíresebb	Nan
وأصبح	és az lett	Nan
هوية	azonosítás	Nan
وأصبحت	és én lettem	Nan
وأصحابه	és társai	Nan
وأضاف	hozzátette	Nan
وأطلق	kirúgták	Nan
وأعضاء	és a tagok	Nan
وأعلن	bejelentette	None
وأعلنت	bejelentették	Nan
وأغلب	és a legtöbb	Nan
وأصحاب	és a tulajdonosok	Nan
ميخائيل	michael	None
هولندا	hollandia	None
هوراس	horace	Nan
هاجر	kivándorolt	Nan
هاجروا	vándoroltak	None
هاجم	megtámadta	None
هاجمت	megtámadta	None
هارفارد	harvard	None
هارون	áron	None
هاري	harry	None
هاشم	hashem	Nan
هام	fontos	None
هاما	fontos	None
هاماً	fontos	None
هامة	fontos	None
هاواي	hawaii	None
هايدا	haida	Nan
هتلر	hitler	None
هاتين	ez a kettő	Nan
هجرة	elvándorlás	Nan
هائلة	hatalmas	None
هؤلاء	ezek	None
نوع	típus	None
نوعا	valami hasonló	Nan
نوعان	kétféle	None
نوعه	a típusa	Nan
نوعها	a típusa	Nan
نوعية	minőség	Nan
نوعين	kétféle	None
نوفمبر	november	None
نووي	nukleáris	None
نووية	nukleáris	None
نيتشه	nietzsche	None
نيجيريا	nigéria	Nan
نيوتن	newton	None
نيوزيلندا	új zéland	Nan
نيويورك	new york	Nan
هائل	hatalmas	None
هجمات	megtámadja	Nan
هجوم	támadás	None
هدف	cél	None
هـم	hm	Nan
هكتور	hector	Nan
هكذا	így	None
هل	te?	Nan
هلال	félhold	Nan
هم	ők	None
هما	ők	None
هنا	itt	None
هناك	ott	None
هنالك	ott	None
هند	hátsó	None
هندسة	mérnöki	Nan
هنري	henrik	None
هو	ő van	Nan
هواء	levegő	None
هـ	e	Nan
هطول	csapadék	None
هضبة	fennsík	Nan
هشام	hesham	Nan
هدفه	célja	Nan
هدم	elpusztítani	Nan
هدنة	fegyverszünet	Nan
هدى	tanácsadás	Nan
هذا	ez	None
هذان	ez a kettő	Nan
هذة	ez	None
هولاكو	hulagu	Nan
هذه	ez	None
هرب	megszökött	Nan
هرقل	herkules	Nan
هرقليطس	hérakleitosz	Nan
هرم	piramis	Nan
هريرة	cica	Nan
هزم	legyőzött	Nan
هزيمة	vereség	None
هذين	ez a kettő	Nan
وأنواع	és típusok	Nan
ميثيونين	metionin	None
ميت	halott	None
معقد	összetett	None
معقدة	bonyolult	None
معلومات	információk	None
معمر	idősebb	None
معناه	a jelentése	Nan
معناها	a jelentése	Nan
معنى	jelentése	None
معه	vele	None
معهد	intézet	None
معهم	velük	None
معينة	bizonyos	None
معًا	együtt	None
مغادرة	kilépő	Nan
مغامرات	adventures	Nan
مغربي	marokkói	Nan
معظمهم	többségük	None
مغناطيسي	mágneses	None
معظمها	a legtöbb	Nan
معسكرات	boot táborok	Nan
معتدل	mérsékelt	None
معتدلة	mérsékelt	None
معترف	meghatalmazott	Nan
معجزة	csoda	None
معد	szándékolt	Nan
معدات	felszerelés	Nan
معدة	gyomor	None
معدل	mérték	Nan
معدلات	az árak	Nan
معدنية	fém	None
معرفة	tudás	None
معركة	csata	None
معروف	szívesség	Nan
معروفة	ismert	None
معسكر	tábor	None
معظم	a legtöbb	Nan
معبد	templom	None
مغناطيسية	mágneses	None
مفاهيم	fogalmak	None
مقاومة	ellenállás	None
مقبرة	temető	None
مقبولة	elfogadható	None
مقتل	elesett	None
مقتله	megölte őt	Nan
مقدار	összeg	Nan
مقدسة	szentelt	None
مقدم	bemutató	None
مقدمة	bevezetés	None
مقدونيا	macedónia	None
مقديشيو	mogadishu	Nan
مقر	központ	None
مقرا	asztal	Nan
مقرها	székhelyű	Nan
مقسمة	megosztott	None
مقام	névadó	Nan
مفاعل	reaktor	None
مقالة	cikk	None
مقال	cikk	None
مفاوضات	tárgyalások	None
مفتاح	kulcs	Nan
مفتوحة	nyisd ki	Nan
مفتي	mufti	Nan
مفصلة	zsanér	Nan
مفهوم	koncepció	None
مفيدة	hasznos	None
مقابر	temetők	Nan
مقابل	szemben	None
مقابلة	interjú	None
مقاتل	harcos	None
مقارنة	összehasonlítás	Nan
مقاطعات	kerületek	None
مقاطعة	bojkott	Nan
مقاعد	ülés	Nan
مقالات	cikkek	None
معاً	együtt	None
معايير	szabványok	Nan
معاوية	sid	Nan
مشتقة	derivált	Nan
مشروع	program	None
مشعل	fáklya	Nan
مشكلة	probléma	None
مشهد	színhely	Nan
مشهور	híres	None
مشهورة	híres	None
مشيخة	ő öreg	Nan
مصادر	források	None
مصانع	gyárak	Nan
مصحف	mus&#39;haf	Nan
مصدر	forrás	None
مصر	egyiptom	None
مصرف	bank	None
مصري	egyiptomi	None
مشتركة	közös	None
مصريات	egyiptomi nők	Nan
مشترك	kölcsönös	None
مشاهدة	néz	None
مسلمين	muszlimok	None
مسمى	nevezett	None
مسند	lábtartó	Nan
مسيحية	keresztény	None
مسيرة	március	None
مسيرته	az ő karrierje	Nan
مشابه	hasonló	None
مشابهة	hasonló	None
مشاة	gyalogos	Nan
مشاركة	megosztása	Nan
مشاريع	projektek	Nan
مشاعر	érzés	None
مشاعل	flares	Nan
مشاكل	problémák	None
مشاهد	kilátás	Nan
مشاهير	híres	None
مصرية	egyiptomi	None
مصريون	egyiptomiak	Nan
مصطفى	mustafa	Nan
مظاهر	megjelenések	Nan
مظاهرات	tiltakozások	Nan
مظهر	megjelenés	None
مع	val vel	Nan
معا	együtt	None
معاداة	ellenségeskedés	Nan
معارض	ellentétes	None
معارضة	ellenzék	None
معارك	harcol	Nan
معالجة	feldolgozás	Nan
معالم	mérföldkövek	Nan
معامل	tényező	None
معاملة	kezelés	None
معاني	jelentésük	Nan
معاهدة	szerződés	None
مطلقة	elvált	Nan
مطلع	kezdet	Nan
مطلة	kilátással	Nan
مطرب	énekes	None
مصطلح	kifejezés	None
مصطلحات	feltételek	None
مصلحة	érdeklődés	None
مصنع	gyár	None
مصنوع	készült	None
مصنوعة	készült	None
مصير	sors	None
مقياس	skála	Nan
مضادة	számláló	Nan
مضى	mentem	Nan
مضيق	tengerszoros	Nan
مطابقة	matching	Nan
مطار	repülőtér	None
مطارات	repülőterek	None
مطالب	igények	Nan
مطر	eső	None
مضخم	erősítő	Nan
مكاتب	irodák	Nan
مكافحة	harc	None
مكان	hely	None
مهد	bölcső	Nan
مهدي	mahdi	Nan
مهرجان	fesztivál	None
مهم	fontos	None
مهما	tök mindegy	Nan
مهمة	küldetés	None
مهمًا	tök mindegy	Nan
مهنة	szakma	Nan
مهندس	mérnök	None
مواجهة	szembesítés	Nan
مواد	anyag	None
موارد	erőforrások	Nan
مواضيع	témakörök	Nan
مواطن	polgár	None
مواطني	honfitársaim	Nan
مهام	feladatok	None
موافقة	hozzájárulás	Nan
مهارات	szakértelem	Nan
منيرة	munira	Nan
منصب	pozíció	Nan
منصبه	hivatal	None
منصور	mansoor	Nan
منطقة	terület	None
منظمات	szervezetek	None
منظور	távlati	Nan
منع	blokk	None
منعت	megakadályozták	Nan
منغوليا	mongólia	Nan
منها	amelyből	None
منهج	módszer	None
منهم	kik ők	Nan
منهما	kik ők	Nan
منى	mona	None
مني	mona	None
مهاجمة	támadás	None
مواقع	sites	Nan
مواقف	helyzetek	Nan
مواليد	baby boomers	Nan
موطن	itthon	None
موعد	találkozó	None
موقع	elhelyezkedés	Nan
موقعة	aláírt	Nan
موقعه	aláírt	Nan
موقعها	a helyzete	Nan
موقف	hozzáállás	Nan
موقفه	helyzete	None
مول	pláza	Nan
مولاي	moulay	Nan
مولده	születése	None
موليبدنوم	molibdén	None
مونتانا	montana	Nan
مونكو	monco	Nan
مياه	vizek	None
موضي	moudy	Nan
موضوع	téma	None
موضع	pozíció	Nan
موسيقية	zenei	None
موانئ	portok	Nan
موت	halál	None
موته	az ő halála	Nan
موجات	hullámok	None
موجة	hullám	None
موجودة	megtalált	Nan
موحد	egységes	None
منزله	az ő háza	Nan
موحدة	egyenruha	Nan
موريتانيا	mauritánia	Nan
موسكو	moszkva	None
موسم	évszak	None
موسوعة	enciklopédia	None
موسوليني	mussolini	None
موسى	mousa	Nan
موسيقى	zene	None
مورد	támogató	None
ميثاق	különjárat	Nan
منزلة	az ő háza	Nan
منذ	ezelőtt	None
ملجأ	menedék	Nan
ملحوظ	megjelölt	Nan
ملحوظة	nb	None
ملعب	stádium	Nan
ملعقة	kanál	Nan
ملف	fájl	None
ملفات	files	Nan
ملك	király	None
ملكة	királynő	None
ملكي	királyi	None
ملكية	ingatlan	Nan
ملكًا	király	None
ملوك	kings	Nan
مليار	milliárd, ezermillió	Nan
مليون	millió	None
ملايين	milliók	Nan
مما	mint	None
ملامح	jellemzők	None
ملاحظة	jegyzet	Nan
مكانة	állapot	None
مكانته	az arca	Nan
مكانه	állapot	None
مكانها	a hely	Nan
مكة	mekka	Nan
مكتب	hivatal	None
مكتبة	könyvtár	None
مكتوب	írott	None
مكتوبة	írott	None
مكتوم	bebugyolált	Nan
مكنسة	seprű	Nan
مكون	hozzávaló	Nan
مكونات	hozzávalók	Nan
مكونة	készült	None
ملاحظات	megjegyzések	None
ملاك	angyal	None
مماثل	hasonló	None
مماثلة	hasonló	None
ممارسة	gyakorlat	None
مناف	munaf	Nan
منافسة	verseny	None
مناقشة	vita	None
مناهج	tantervek	Nan
منتج	termelő	Nan
منتجات	termékek	None
منتخب	megválasztott	None
منتشرة	széles körben elterjedt	Nan
منتصف	középső	None
منتظم	szabályos	None
منتظمة	szabályos	None
منح	grant	None
منحت	megadott	None
منخفض	alacsony	None
منخفضة	alacsony	None
مناطق	régiók	None
مناصب	pozíciók	Nan
مناسبة	alkalom	None
مناسب	megfelelő	None
ممالك	kingdoms	Nan
مماليك	mamelukok	Nan
ممثل	színész	None
ممثلة	színésznő	None
ممرض	ápoló	Nan
ممكن	talán	None
ممكنة	lehetséges	None
منزل	ház	None
مملكة	királyság	None
مميزات	jellemzők	None
مميزة	megkülönböztető	Nan
من	tól től	Nan
منا	tőlünk	Nan
مناخ	éghajlat	None
منارة	világítótorony	Nan
منازل	homes	Nan
ممن	kinek a	Nan
يُلاحظ	értesítés	Nan
تسبب	okoz	None
تساهم	hozzájárul	None
التلفاز	a televízió	Nan
التلفزيون	televízió	None
التلفزيونية	televízió	None
التلوث	környezetszennyezés	Nan
التمثيل	a színész	Nan
التمرد	a lázadás	Nan
التمويل	finanszírozás	Nan
التميمي	al-tamimi	Nan
التمييز	megkülönböztetés	Nan
التنازل	lemondás	Nan
التناسلي	nemi	None
التناسلية	nemi	None
التنافس	verseny	None
التنبؤ	az előrejelzés	Nan
التنسيق	egyeztetés	Nan
التلاميذ	a tanulók	Nan
التنظيم	szervezet	None
التكيف	alkalmazkodás	Nan
التكنولوجية	technikai	None
التقسيم	feloszt	Nan
التقسيمات	osztályok	Nan
التقليد	hagyomány	None
التقليدي	hagyományos	None
التقليدية	hagyományos	None
التقنيات	technologies	Nan
التقنية	technológia	None
التقويم	naptár	None
التقى	ő találkozott	Nan
التقييم	értékelés	Nan
التكاثر	reprodukció	Nan
التكافؤ	vegyérték	Nan
التكتونية	szerkezeti	None
التكلفة	a költség	Nan
التكنولوجيا	technológia	None
التكوين	configuration	Nan
التقرير	a jelentés	Nan
التنفس	lélegző	Nan
التنفيذي	az ügyvezető	Nan
التونسية	tunéziai	Nan
التي	melyik	None
التيار	a jelenlegi	Nan
التيارات	aktualitások	Nan
الثابت	állandó	None
الثابتة	rögzített	None
الثالث	a harmadik	Nan
الثالثة	a harmadik	Nan
الثالوث	szentháromság	Nan
الثامن	viii	None
الثامنة	nyolcadik	None
الثانوي	másodlagos	None
الثانوية	gimnázium	None
الثاني	a második	Nan
الثانية	a második	Nan
التونسي	tunéziai	Nan
التنفيذ	végrehajtás	None
التوقيع	aláírás	Nan
التوسع	terjeszkedés	Nan
التنفيذية	végrehajtó	None
التنقل	mobilitás	Nan
التنقيب	geológiai	None
التنمية	fejlődés	None
التنوع	sokféleség	Nan
التنوير	felvilágosodás	None
التهاب	gyulladás	None
التوازن	egyensúly	Nan
التواصل	közlés	Nan
التوالي	egyenes	None
التوبة	bűnbánat	Nan
التوتر	feszültség	None
التوجه	orientáció	Nan
التوحيد	monoteizmus	Nan
التوراة	tóra	Nan
التوصل	reach	Nan
التقديرات	becslések	None
التقدم	előrehalad	Nan
التقاليد	hagyományok	None
التشريح	anatómia	Nan
التشريع	törvényhozás	None
التشريعات	törvényhozás	None
التشريعي	törvényhozó	None
التشريعية	törvényhozó	None
التشكيل	képződés	Nan
التصحر	az elsivatagosodás	Nan
التصدي	szembe	None
التصديق	tanúsítvány	Nan
التصرف	törvény	None
التصفيات	selejtezők	Nan
التصميم	a dizájn	Nan
التصنيع	gyártás	None
التصنيف	kategória	None
التصنيفات	eurovoc	Nan
التشخيص	diagnózis	None
التصوف	sufism	Nan
التشابه	hasonlóságok	Nan
التسونامي	tsunami	Nan
الترجمة	fordítás	None
الترفيهية	szórakozási	Nan
الترك	a török	Nan
التركي	török	None
التركيب	fogalmazás	Nan
التركية	török	None
التركيز	koncentráció	Nan
الترمذي	tirmidhi	Nan
التزاوج	párosodás	Nan
التزلج	síelés	Nan
التسامح	megértés	Nan
التسجيل	regisztráció	Nan
التسعينيات	a kilencvenes évek	Nan
التسلسل	a szekvencia	Nan
التسمية	a címke	Nan
التسويق	értékesítés	Nan
التصويت	szavazás	None
التصوير	fényképezés	Nan
التضاريس	landforms	Nan
التعليم	oktatás	None
التعليمي	nevelési	Nan
التعليمية	nevelési	Nan
التغذية	táplálás	Nan
التغير	a változás	Nan
التغيرات	a változások	Nan
التغيير	változás	None
التغييرات	a változások	Nan
التفاصيل	a részletek	Nan
التفاعل	kölcsönhatás	None
التفسير	magyarázat	None
التفسيرات	magyarázatok	Nan
التفكير	gondolkodás	None
التفوق	fölény	Nan
التقارير	jelentések	Nan
التعلم	tanulás	Nan
التعريفات	definíciók	Nan
التعريف	a meghatározás	Nan
التعرية	csupaszítási	Nan
التضخم	infláció	None
التطبيق	alkalmazás	None
التطبيقات	alkalmazások	None
التطبيقية	alkalmazott	None
التطور	fejlődés	None
التطورات	fejlesztések	None
التطوير	fejlődés	None
الثبات	kitartás	Nan
التعاليم	tanításai	Nan
التعاون	cooperat	Nan
التعبير	kifejezés	None
التعداد	népszámlálás	None
التعديل	beállítás	Nan
التعديلات	korrekciók	Nan
التعرض	kitettség	Nan
التعرف	azonosítani	Nan
التعامل	kezelése	None
الترجمات	fordítása	None
الثدي	mell	Nan
الثروات	gazdagság	Nan
الجمع	többes szám	Nan
الجمعة	péntek	Nan
الجمعيات	egyesületek	Nan
الجمعية	egyesület	None
الجمل	teve	Nan
الجملة	mondat	None
الجمهور	a közönség	Nan
الجمهوري	köztársasági	None
الجمهورية	a köztársaság	Nan
الجميع	mindenki	None
الجن	jinn	Nan
الجنائية	bűnügyi	None
الجناح	a kórterem	Nan
الجنة	a paradicsom	Nan
الجند	katonák	None
الجمباز	gimnasztika	Nan
الجندي	a katona	Nan
الجماهير	tömegek	None
الجماعية	kollektív	None
الجسر	a híd	Nan
الجسم	a test	Nan
الجسور	bridges	Nan
الجسيمات	részecskék	None
الجغرافي	földrajzi	None
الجغرافيا	földrajz	None
الجغرافية	földrajzi	None
الجفاف	aszály	Nan
الجلد	a bőr	Nan
الجليد	jég	None
الجليدية	jeges	None
الجليل	galileában	Nan
الجماع	közösülés	Nan
الجماعة	közösség	None
الجماعي	kollektív	None
الجمال	szépség	None
الجسد	a test	Nan
الجنرال	az általános	Nan
الجنسي	szexuális	None
الجولان	a golan	Nan
الجوهرة	az ékszer	Nan
الجوي	levegő	None
الجوية	levegő	None
الجيد	a jó	Nan
الجيدة	jól néz ki	Nan
الجيزة	giza	Nan
الجيش	hadsereg	None
الجيل	generáció	Nan
الجينات	gének	None
الجينوم	a genom	Nan
الجيني	genetikai	None
الجينية	genetikai	None
الجيوش	sereg	None
الجيولوجية	geológiai	None
الجوفية	föld alatti	Nan
الجنس	szex	None
الجودة	a minőség	Nan
الجوار	szomszédság	Nan
الجنسيات	nemzetiségek	None
الجنسية	állampolgárság	Nan
الجنسين	nemek	Nan
الجنوب	a dél	Nan
الجنوبي	déli	None
الجنود	a katonák	Nan
الجنين	a magzat	Nan
الجهات	a szineszek	Nan
الجهاز	az eszköz	Nan
الجهة	az úticél	Nan
الجهد	erőfeszítés	Nan
الجهل	tudatlanság	Nan
الجهود	erőfeszítések	Nan
الجو	az időjárás	Nan
الجوائز	díjak	None
الجوانب	aspects	Nan
الجزيرة	al jazeera	Nan
الجزية	tisztelgés	Nan
الجزيئي	molekuláris	None
الثمانية	a nyolc	Nan
الثمانينات	a nyolcvanas évek	Nan
الثمانينيات	a nyolcvanas évek	Nan
الثنائي	a pár	Nan
الثنائية	kétoldalú	Nan
الثوار	forradalmárok	Nan
الثورات	forradalmak	Nan
الثورة	forradalom	None
الثوري	forradalmi	None
الثورية	forradalmi	None
الجائزة	a díj	Nan
الجابر	al-jaber	Nan
الجاحظ	nagy szem	Nan
الجاذبية	súly	Nan
الجاز	dzsessz	Nan
الثلوج	hó	None
الجاف	száraz	None
الثلج	a hó	Nan
الثلاثينات	harmincas	None
الثروة	jólét	Nan
الثقافات	kultúrák	None
الثقافة	a kultúra	Nan
الثقافي	kulturális	None
الثقب	a lyuk	Nan
الثقة	bizalom	Nan
الثقفي	kulturális	None
الثقوب	holes	Nan
الثقيل	nehéz	None
الثقيلة	nehéz	None
الثلاث	a három	Nan
الثلاثاء	kedd	Nan
الثلاثة	a három	Nan
الثلاثي	trió	Nan
الثلاثين	harminc	None
الثلاثينيات	a harmincas évek	Nan
الجافة	száraz	None
الجاليات	közösségek	None
الجالية	közösség	None
الجديدة	új	None
الجدير	érdemes	Nan
الجذور	a gyökerek	Nan
الجرائم	crimes	Nan
الجراثيم	baktériumok	None
الجراح	sebész	Nan
الجرمانية	germán	None
الجريدة	újság	None
الجريمة	a bűntény	Nan
الجزء	szakasz	None
الجزائر	algéria	Nan
الجزائري	az algériai	Nan
الجزائريين	az algériaiak	Nan
الجزر	sárgarépa	Nan
الجزيئات	molekulák	None
الجديد	az új	Nan
الجدول	menetrend	Nan
الجدل	vita	None
الجدد	neo	Nan
الجامع	az egész	Nan
الجامعات	egyetemek	None
الجامعة	az egyetem	Nan
الجامعي	egyetemi	None
الجامعية	egyetemi	None
الجانب	az oldal	Nan
الجانبية	oldalsó	Nan
الثدييات	emlősök	None
الجانبين	sides	Nan
الجاهلية	tudatlanság	Nan
الجبال	hegység	None
الجبر	algebra	Nan
الجبل	a hegy	Nan
الجبلية	hegy	None
الجبهة	az eleje	Nan
الجدار	a fal	Nan
الجاهلي	pre-iszlám	Nan
الترتيب	elrendezés	Nan
التربية	oktatás	None
التربة	a talaj	Nan
البابوية	a pápaság	Nan
البابية	ablakszárny	Nan
الباحث	kutató	None
الباحثون	kutatók	None
الباحثين	kutatók	None
البارد	hideg	None
الباردة	hideg	None
البارزة	jelentős	None
البارزين	kimagasló	None
الباطنية	rejtett	None
الباقي	a maradék	Nan
الباقية	a maradék	Nan
البالغ	felnőtt	None
البالغة	felnőtt	None
البالغين	felnőttek	None
البابلية	babiloni	Nan
البتراء	petra	Nan
البابلي	babiloni	Nan
الباب	az ajtó	Nan
الانتقال	beköltözni	Nan
الانتقالية	átmeneti	None
الانتقام	bosszú	Nan
الانتهاء	befejezett	None
الاندلس	andalúz	Nan
الاندماج	egyesülés	Nan
الانسحاب	kihúzni	Nan
الانضمام	csatlakozik	None
الانطروبولوجيا	embertan	Nan
الانفجار	a robbanás	Nan
الانفصال	elválasztás	Nan
الانقسام	osztály	None
الانقلاب	a puccs	Nan
الاهتمام	érdeklődés	None
الايكولوجية	ökológiai	None
البابا	a pápa	Nan
الانتقادات	kritika	None
البترول	petróleum	Nan
البحار	a tengerek	Nan
البراكين	vulkánok	None
البرامج	programok	None
البربر	berberek	Nan
البربرية	barbárság	Nan
البرتغال	portugália	None
البرتغالي	portugál	None
البرتغالية	portugál	None
البرتغاليين	a portugál	Nan
البرج	a torony	Nan
البركان	a vulkán	Nan
البركاني	vulkanikus	None
البركانية	vulkanikus	None
البرلمان	parlament	None
البرلمانية	parlamenti	None
البرمجيات	szoftver	None
البرازيلي	brazil	None
البث	adás	Nan
البرازيل	brazília	None
البذور	magok	Nan
البحر	a tenger	Nan
البحري	tengeri	None
البحرية	haditengerészet	None
البحرين	a két tenger	Nan
البحوث	kutatás	None
البحيرات	lakes	Nan
البحيرة	a tó	Nan
البخار	gőz	Nan
البخاري	bukhari	Nan
البدء	rajt	Nan
البدائي	primitív	Nan
البدائية	eredeti	None
البداية	a kezdet	Nan
البدنية	fizikai	None
البدو	beduinok	Nan
البر	igazságosság	Nan
الانتفاضة	felkelés	None
الانتصارات	eredmények	None
الانتصار	győzelem	None
الاستثمار	beruházás	Nan
الاستثمارات	beruházások	Nan
الاستخبارات	intelligencia	Nan
الاستخدام	a használat	Nan
الاستخدامات	felhasználások	Nan
الاستراتيجي	stratégiai	None
الاستراتيجية	a stratégia	Nan
الاستسلام	beadni	Nan
الاستعمار	gyarmatosítás	Nan
الاستعماري	gyarmati	None
الاستعمارية	gyarmati	None
الاستعمال	használat	None
الاستفتاء	a népszavazás	Nan
الاستقرار	stabilitás	Nan
الاستقلال	függetlenség	None
الازدهار	jólét	Nan
الاستنساخ	reprodukció	Nan
الارتفاع	magasság	None
الاختيار	a választás	Nan
الاجتماع	a találkozás	Nan
الاجتماعات	találkozók	Nan
الاجتماعي	szociális	None
الاجتماعية	szociális	None
الاجتهاد	szorgalom	Nan
الاحتباس	visszatartás	Nan
الاحتفاظ	tart	None
الاحتفال	ünneplés	Nan
الاحتفالات	ünnepségek	Nan
الاحتكاك	súrlódás	Nan
الاحتلال	foglalkozása	Nan
الاحتياجات	igények	Nan
الاختبار	a teszt	Nan
الاختلاف	a különbség	Nan
الاختلافات	a különbségek	Nan
الارتباط	a kapcsolat	Nan
الاستهلاك	fogyasztás	Nan
الاستواء	önterülő	Nan
الاستوائية	tropikus	Nan
الاعمال	üzleti	None
الاغنية	a dal	Nan
الاقتصاد	gazdaság	None
الاقتصادي	gazdasági	None
الاقتصادية	gazdasági	None
الاكتشاف	felfedezés	Nan
الاكتشافات	felfedezések	None
الالتزام	elkötelezettség	Nan
الامام	imám	Nan
الامبراطورية	a birodalom	Nan
الامير	a herceg	Nan
الانتخابات	a választás	Nan
الانتخابية	választói	Nan
الانتداب	a megbízás	Nan
الانتشار	terjedés	Nan
الاعلام	média	None
الاعتماد	akkreditáció	Nan
الاعتقاد	hit	None
الاعتراف	elismerés	Nan
الاستيلاء	elkobzás	Nan
الاسكندنافية	skandináv	None
الاسم	a név	Nan
الاسود	a fekete	Nan
الاشتراك	feliratkozás	Nan
الاشتراكي	szocialista	None
الاشتراكية	szocializmus	None
البرنامج	a program	Nan
الاشتراكيون	szocialisták	Nan
الاصطناعي	mesterséges	None
الاضطراب	légörvény	Nan
الاضطرابات	nyugtalanság	Nan
الاضطهاد	üldözés	Nan
الاضطهادات	üldöztetések	Nan
الاعتبار	megfontolás	Nan
الاعتداء	támadás	None
الاصطناعى	szintetikus	Nan
البروتستانت	protestáns	None
البروتستانتية	protestantizmus	Nan
البروتوكولات	jegyzőkönyvek	Nan
التأكيد	megerősítés	Nan
التأليف	szerzőség	Nan
التأمين	biztosítás	Nan
التائية	t	Nan
التابع	a követő	Nan
التابعة	partner	Nan
التابعين	követő	None
التاج	a korona	Nan
التاريخ	történelem	None
التاريخي	történelmi	None
التاريخية	történelmi	None
التاسع	kilencedik	None
التاسعة	kilencedik	None
التالي	következő	None
التالية	következő	None
التأكد	biztosra menni	Nan
التبادل	csere	None
التأثيرات	hatások	None
البيولوجية	biológiai	None
البيئات	környezetek	Nan
البيئة	a környezet	Nan
البيئي	környezeti	None
البيان	nyilatkozat	None
البيانات	adat	None
البيت	itthon	None
البيروني	al-biruni	Nan
البيزنطي	bizánci	None
البيزنطية	bizánci	None
البيزنطيين	bizánciak	Nan
البيض	tojás	Nan
البيضاء	fehér	None
البيعة	a hűség záloga	Nan
البيوت	házak	None
البيولوجي	biológiai	None
التأثير	a befolyás	Nan
التبانة	a tejút	Nan
التبرعات	adományok	Nan
التبغ	dohány	None
التحليلية	analitikai	Nan
التحول	a műszak	Nan
التحويلية	transzformációs	Nan
التخصص	szakosodás	Nan
التخصصات	sajátosságok	Nan
التخطيط	tervezés	Nan
التخلص	megszabadul	Nan
التخلي	felad	Nan
التدخل	közbelépés	Nan
التدخين	dohányzó	Nan
التدريب	kiképzés	Nan
التدريس	tanítás	None
التراب	piszok	Nan
التراث	örökség	None
التراجع	meghátrál, visszatáncol, visszavonul	Nan
التحليل	az elemzés	Nan
التحكيم	döntőbíráskodás	Nan
التحكم	ellenőrzés	None
التحقيق	vizsgálat	None
التتار	tatár	None
التجار	kereskedők	None
التجارب	tapasztalatok	None
التجارة	kereskedés	Nan
التجاري	kereskedelmi	None
التجارية	kereskedelmi	None
التجديد	megújítás	Nan
البويضة	a tojás	Nan
التجربة	tapasztalat	None
التجريبية	kísérleti	None
التجنيد	sorozás	Nan
التحتية	infrastruktúra	None
التحدث	beszél	None
التحرك	mozog	None
التحرير	szerkesztés	Nan
التحق	letárolt	Nan
التجريبي	demó	Nan
الحائط	a fal	Nan
البونيقية	pun	Nan
البولندية	fényesít	Nan
البضائع	áruk	None
البطالة	a munkanélküliség	Nan
البطل	hős	None
البطن	has	Nan
البطولات	bajnokságok	Nan
البطولة	bajnokság	None
البظر	a csikló	Nan
البعث	feltámadás	Nan
البعثات	missions	Nan
البعثة	a küldetés	Nan
البعد	a dimenzió	Nan
البعض	néhány	None
البعيدة	messze	None
البغدادي	al-baghdadi	Nan
البق	bugs	Nan
البصرية	vizuális	None
البقاء	marad	None
البصريات	optika	Nan
البصرة	bászrában	Nan
البروتونات	protonok	Nan
البروتين	fehérje	Nan
البروتينات	fehérjék	None
البري	vad	None
البرية	vad	None
البريد	levél	None
البريطاني	angol	None
البريطانية	angol	None
البريطانيون	angol	None
البريطانيين	a brit	Nan
البسيط	egyszerű	None
البسيطة	egyszerű	None
البشر	az emberek	Nan
البشري	emberi	None
البشرية	emberiség	None
البصري	optikai	None
البقر	a tehén	Nan
البقرة	a tehén	Nan
البقعة	sima	None
البنك	a bank	Nan
البنوك	banks	Nan
البنى	barna	None
البنية	a szerkezet	Nan
البهاء	ragyogás	Nan
البهائي	bahá&#39;í	Nan
البهائية	bahá&#39;ís	Nan
البهائيون	bahá&#39;ís	Nan
البهائيين	bahá&#39;ís	Nan
البوابة	a kapu	Nan
البوب	pop	None
البوذية	buddhizmus	None
البوسفور	boszporusz	Nan
البوسنة	bosznia	None
البول	vizelet	Nan
البنفسجية	lila	None
البنات	a lányok	Nan
البنائية	konstruktivizmus	Nan
البناء	épület	None
البكارة	szüzesség	Nan
البكتيريا	baktériumok	None
البكر	ősi	None
البلاد	az ország	Nan
البلاغة	retorika	Nan
البلد	ország	None
البلدان	az országok	Nan
البوم	baglyok	Nan
البلدة	a város	Nan
البلدية	városi	None
البلدين	a két ország	Nan
البلطيق	balti	None
البلغارية	bolgár	None
البلقان	balkán	Nan
البلوغ	pubertás	Nan
البنا	banna	Nan
البلديات	önkormányzatok	None
الاثنين	hétfő	Nan
الحاجة	annak szükségességét	Nan
الحادث	az eset	Nan
الروسي	az orosz	Nan
الروسية	orosz	None
الروضة	óvoda	None
الروم	rum	Nan
الرومان	a rómaiak	Nan
الرومانسية	románc	Nan
الروماني	római	Nan
الرومانية	román	None
الرومي	rumi	Nan
الري	öntözés	Nan
الرياح	a szél	Nan
الرياض	riyadh	Nan
الرياضات	sport	None
الرياضة	sport	None
الرياضي	sportoló	Nan
الروس	az oroszok	Nan
الرياضيات	matematika	None
الروحية	lelki	None
الروح	szellem	None
الركن	a sarok	Nan
الركود	stagnálás	Nan
الرمال	homok	Nan
الرمز	kód	None
الرمزي	szimbolikus	None
الرمزية	szimbolizmus	Nan
الرمل	a homok	Nan
الرملية	homokos	Nan
الرموز	ikonok	Nan
الرنا	rana	Nan
الرها	edessa	Nan
الرهبان	a szerzetesek	Nan
الروابط	linkek	None
الروايات	regények	None
الرواية	a regény	Nan
الروحي	lelki	None
الركاب	az utasok	Nan
الرياضية	sport	None
الريف	a vidék	Nan
الزهراء	zahra	Nan
الزهرة	virág	None
الزهري	szifilisz	Nan
الزهور	a virágok	Nan
الزواج	házasság	None
الزواحف	hüllők	Nan
الزوار	látogatók	None
الزوايا	corners	Nan
الزوج	a férj	Nan
الزوجة	a feleség	Nan
الزي	egyenruha	Nan
الزيادة	a növekedés	Nan
الزيت	az olaj	Nan
الزيتون	olívabogyó	Nan
الزيدية	zaidi	Nan
الزمنية	idővonal	Nan
الريح	a szél	Nan
الزمني	idővonal	Nan
الزمرة	klikk	Nan
الريفية	vidéki	None
الزاوية	a sarok	Nan
الزبير	zubair	Nan
الزجاج	az üveg	Nan
الزراعة	mezőgazdaság	None
الزراعي	mezőgazdasági	None
الزراعية	mezőgazdasági	None
الزرقاء	kék	None
الزعتر	kakukkfű	Nan
الزعماء	a vezetők	Nan
الزعيم	a vezető	Nan
الزكاة	zakát	Nan
الزلازل	földrengések	None
الزلزال	földrengés	None
الزمان	idő	None
الزمن	idő	None
الرقيق	fajta	Nan
الرقم	a szám	Nan
الرقص	a tánc	Nan
الرئيسية	fő	None
الرائدة	vezető	None
الرابطة	a nexus	Nan
الرابع	a negyedik	Nan
الرابعة	negyedik	None
الراحة	kényelmi	Nan
الراحل	a késő	Nan
الراديو	a rádió	Nan
الرازي	al-razi	Nan
الراشدين	felnőttek	None
الرافدين	mezopotámia	None
الراقية	high-end	Nan
الراهن	jelen	None
الرايخ	a birodalom	Nan
الرب	isten	None
الرئيسي	a fő	Nan
الرباط	rabat	Nan
الرئيسة	az elnök	Nan
الرئة	tüdő	Nan
الذكري	férfi	None
الذكور	férfi	None
الذهاب	haladó	None
الذهب	arany	None
الذهبي	aranysárga	Nan
الذهبية	aranysárga	Nan
الذي	melyik	None
الذين	akinek	None
الرأس	fej	None
الرأسمالي	a kapitalista	Nan
الرأسمالية	kapitalizmus	None
الرأي	a vélemény	Nan
الرؤية	látomás	Nan
الرئاسة	az elnökség	Nan
الرئاسية	elnöki	None
الرئيس	elnök	None
الربح	nyereség	Nan
الربط	kapcsolódás	Nan
الربع	negyed	None
الرسول	próféta	None
الرسولي	apostoli	Nan
الرسوم	díjak	None
الرشيد	a racionális	Nan
الرصاص	vezet	None
الرصافي	al rusafi	Nan
الرصد	monitoring	Nan
الرضا	az elégedettség	Nan
الرطوبة	páratartalom	Nan
الرعاية	gondoskodás	Nan
الرغبة	a vágy	Nan
الرغم	bár	None
الرفاعي	al-rifai	Nan
الرفض	elutasítás	Nan
الرقابة	ellenőrzés	None
الرسمية	hivatalos	None
الرسمي	a hivatalos	Nan
الرسم	húz	Nan
الرسل	futárok	Nan
الربيع	a tavasz	Nan
الرتب	rangok	Nan
الرجال	férfiak	None
الرجل	a férfi	Nan
الرجوع	visszatérés	None
الرحالة	hátizsákos	Nan
الرحلات	kirándulások	Nan
السؤال	a kérdés	Nan
الرحلة	az utazás	Nan
الرحمة	kegyelem	Nan
الرحمن	irgalmas	Nan
الرحيم	könyörületes	Nan
الرد	a válasz	Nan
الردة	hitehagyás	Nan
الرسائل	üzenetek	Nan
الرسالة	az üzenet	Nan
الرحم	méh	Nan
الذكر	az emlékezés	Nan
السائد	az uralkodó	Nan
السائل	a folyadék	Nan
السنوات	az évek	Nan
السنوريات	felidae	Nan
السنوي	évi	None
السنوية	évi	None
السني	szunnita	Nan
السنية	szunnita	Nan
السنين	az évek	Nan
السنّة	az év	Nan
السهل	könnyen	None
السهول	plains	Nan
السوائل	folyadékok	Nan
السواحل	tengerpartok	Nan
السوبر	szuper	Nan
السوداء	fekete	None
السودان	szudán	Nan
السند	a kötés	Nan
السوداني	szudáni	Nan
السنة	az év	Nan
السمك	hal	None
السلطة	hatóság	None
السلطنة	szultánság	Nan
السلع	áruk	None
السلف	előző	None
السلفية	salafism	Nan
السلم	a létra	Nan
السلمية	békés	None
السلوك	a viselkedés	Nan
السلوكية	viselkedési	Nan
السليم	megfelelő	None
السليمة	hang	None
السم	méreg	Nan
السماء	az ég	Nan
السمات	jellemzők	None
السماح	lehetővé teszi	Nan
السن	kor	None
السلطانية	a tál	Nan
السودانية	szudáni	Nan
السورة	surah	Nan
السيادة	szuverenitás	Nan
السيارات	az autók	Nan
السيارة	az autó	Nan
السياسات	házirendje	Nan
السياسة	politika	None
السياسي	politikai	None
السياسية	politikai	None
السياسيين	politikusok	None
السياق	kontextus	Nan
السيد	a mester	Nan
السيدة	asszony	None
السير	séta	Nan
السيرة	tanterv	Nan
السيطرة	az irányítás	Nan
السيف	kard	None
السياحية	turista	Nan
السور	a kerítés	Nan
السياحي	turista	Nan
السياح	a turisták	Nan
السوري	szír	Nan
السورية	szír	Nan
السوفياتي	a szovjet	Nan
السوفياتية	szovjet	None
السوفيتي	szovjet	None
السوفيتية	szovjet	None
السوفييت	a szovjetek	Nan
السوفييتي	a szovjet	Nan
السوق	piac	None
السويد	svédország	None
السويدي	svéd	None
السويدية	svéd	None
السويس	suez	Nan
السويسري	svájci	None
السيئة	a rosszok	Nan
السياحة	idegenforgalom	None
السلطان	a szultán	Nan
السلطات	a hatóságok	Nan
السلسلة	sorozat	None
السبت	szombat	Nan
السبع	a hét	Nan
السبعة	a hét	Nan
السبعينات	a hetvenes évek	Nan
السبعينيات	a hetvenes évek	Nan
السبيل	az út	Nan
الست	a hat	Nan
الستة	a hat	Nan
الستينات	a hatvanas évek	Nan
الستينيات	a hatvanas évek	Nan
السجن	a börtön	Nan
السجون	börtönök	Nan
السحابة	a felhő	Nan
السحب	felhők	Nan
السد	gát	Nan
السبب	ok	None
السديري	al-sudairy	Nan
السباحة	úszás	Nan
السامة	mérgező	None
السائلة	a folyadék	Nan
السابع	a hetedik	Nan
السابعة	a hetedik	Nan
السابق	az előző	Nan
السابقة	előző	None
السابقين	volt	None
الساحة	küzdőtér	Nan
الساحل	a tengerpart	Nan
الساحلي	parti	None
الساحلية	parti	None
الساخنة	forró	None
السادات	szadat	Nan
السادس	vi	None
الساعة	az óra	Nan
الساكنة	statikus	Nan
السامية	magas	None
السر	a titok	Nan
السرطان	rák	None
السرطانات	rákok	Nan
السكر	cukor	None
السكري	cukorbetegség	None
السكك	vasút	None
السكن	élő	None
السكنية	lakó	None
السلاجقة	seljuks	Nan
السلاح	a fegyver	Nan
السلاسل	láncok	Nan
السلاطين	sultans	Nan
السلالات	törzsek	None
السلالة	a törzs	Nan
السلام	béke	None
السلبي	passzív	None
السلبية	negatívság	Nan
السلة	a kosár	Nan
السكانية	népesség	None
السكاني	népesség	None
السكان	népesség	None
السفينة	a hajó	Nan
السرطانية	rákmegelőző	Nan
السريانية	szír	Nan
السرية	titoktartási	Nan
السريع	gyors	None
السريعة	gyors	None
السطح	a tető	Nan
السطحية	felület	None
السائدة	uralkodó	None
السعادة	happinese	Nan
السعودية	szaúd-	Nan
السعي	törekvés	None
السفر	utazás	None
السفلى	alsó	None
السفلي	alsó	None
السفن	hajók	None
السفير	nagykövet	Nan
السعودي	a szaúdi	Nan
الذكاء	intelligencia	Nan
الذرية	utódok	Nan
الذري	atom	None
الحكم	ítélet	None
الحكمة	bölcsesség	Nan
الحكومات	a kormányok	Nan
الحكومة	a kormány	Nan
الحكومي	kormány	None
الحكومية	kormány	None
الحكيم	a bölcs	Nan
الحل	a megoldás	Nan
الحلفاء	a szövetségesek	Nan
الحلقات	epizódok	None
الحلقة	a kör	Nan
الحلم	az álom	Nan
الحلول	megoldások	Nan
الحلي	dísztárgyak	Nan
الحليب	a tej	Nan
الحكام	vonalzók	Nan
الحليم	halim	Nan
الحقيقية	az igazi	Nan
الحقيقة	igazság	None
الحصول	kap	None
الحضارات	civilizációk	Nan
الحضارة	civilizáció	None
الحضاري	civilizált	Nan
الحضرية	városi terület	Nan
الحظ	szerencse	Nan
الحظر	a tiltás	Nan
الحفاظ	tart	None
الحفلات	a bulik	Nan
الحق	jobb	None
الحقائق	a tények	Nan
الحقبة	kapd el	Nan
الحقل	terület	None
الحقوق	jogok	None
الحقول	mezők	Nan
الحقيقي	igazi	None
الحصان	a ló	Nan
الحمام	a wc-t	Nan
الحماية	védelem	None
الحين	most	None
الحيوان	állat	None
الحيوانات	az állatok	Nan
الحيوانية	állat	None
الحيوي	bio	Nan
الحيوية	életerő	Nan
الخ	stb.	Nan
الخارج	a külső	Nan
الخارجي	külső	None
الخارجية	külső	None
الخاص	a magán	Nan
الخاصة	saját	None
الخاصية	a tulajdon	Nan
الخاضعة	tantárgy	Nan
الخالق	a teremtő	Nan
الحية	élő	None
الحمامات	a fürdőszobák	Nan
الحياد	semlegesség	Nan
الحي	kerület	None
الحمد	dicséret	Nan
الحمر	py	Nan
الحمراء	piros	None
الحمض	sav	Nan
الحمل	terhesség	None
الحملات	kampányok	Nan
الحملة	a kampány	Nan
الحميد	hameed	Nan
الحنبلي	hambali	Nan
الحنفي	hanafi	Nan
الحوادث	balesetek	Nan
الحوار	párbeszéd	Nan
الحواس	senses	Nan
الحواسيب	számítógépek	None
الحوض	a medence	Nan
الحياة	élet	None
الحصار	az ostrom	Nan
الحشيش	gyep	Nan
الحشرية	rovar	Nan
الحبيب	a szeretett	Nan
الحج	zarándoklat	Nan
الحجاب	fátyol	Nan
الحجاج	zarándokok	Nan
الحجارة	stones	None
الحجاز	hijaz	Nan
الحجة	a vita	Nan
الحجر	kő	None
الحجرية	kő	None
الحجم	a méret	Nan
الحد	a határ	Nan
الحدائق	gardens	Nan
الحداثة	modernség	Nan
الحدث	az esemény	Nan
الحدود	a határ	Nan
الحبوب	gabona	Nan
الحدودية	borderlands	Nan
الحبل	zsinór	Nan
الحب	a szerelem	Nan
الحادثة	a baleset	Nan
الحار	meleg	None
الحارة	meleg	None
الحارث	földművelő	Nan
الحاسوب	a számítógép	Nan
الحاصل	a hányados	Nan
الحاضر	jelen	None
الحافظ	az őrző	Nan
الحافلات	a buszok	Nan
الحاكم	a vonalzó	Nan
الحاكمة	uralkodó	None
الحال	határozószó	None
الحالات	olyan esetek,	Nan
الحالي	ajándék	Nan
الحالية	jelenlegi	None
الحبشة	etiópia	Nan
الحديبية	gümő	Nan
الحديث	a beszéd	Nan
الحديثة	modern	None
الحروب	háborúk	None
الحروف	a levelek	Nan
الحريات	szabadságok	Nan
الحرية	szabadság	None
الحرير	selyem	Nan
الحريري	al-hariri	Nan
الحزام	öv	Nan
الحزب	a buli	Nan
الحساب	a számla	Nan
الحسن	hassan	Nan
الحسنة	a jó	Nan
الحسين	elhussein	Nan
الحسيني	al-hussaini	Nan
الحشرات	rovarok	Nan
الحشرة	a rovar	Nan
الحرمين	a két szent hely	Nan
الحرم	a szentély	Nan
الحركة	a mozgalom	Nan
الحركات	mozgások	None
الحديد	vas	None
الحديدي	vasember	Nan
الحديدية	vas	None
الحديقة	a kert	Nan
الحذر	vigyázat	Nan
الحر	ingyenes	None
الحرائق	tüzek	Nan
الخام	nyers	None
الحرارة	a hő	Nan
الحرارية	termikus	Nan
الحرب	a háború	Nan
الحربي	al-harbi	Nan
الحربية	hadihajó	Nan
الحرة	ingyenes	None
الحرس	az őr	Nan
الحرف	a karakter	Nan
الحراري	termikus	Nan
الخامس	ötödik	None
الخامسة	ötödik	None
الخان	a kán	Nan
الدفاع	védelem	None
الدفاعية	védekező	None
الدقة	pontosság	Nan
الدقيق	liszt	None
الدقيقة	a perc	Nan
الدكتوراه	phd	Nan
الدلائل	a könyvtárak	Nan
الدلالة	jelzés	Nan
الدليل	útmutató	Nan
الدم	a vér	Nan
الدماء	a vér	Nan
الدمار	megsemmisítés	Nan
الدماغ	az agy	Nan
الدمشقي	damaszkuszi	Nan
الدموية	véres	None
الدعوة	a meghívót	Nan
الدنا	dns	None
الدعم	a támogatás	Nan
الدعارة	prostitúció	Nan
الدجال	kuruzsló	Nan
الدخان	füst	Nan
الدخل	jövedelem	Nan
الدخول	hozzáférés	Nan
الدراسات	tanulmányok	None
الدراسة	tanul	Nan
الدراسية	tandíj	None
الدراما	a dráma	Nan
الدرجات	fokozat	None
الدرجة	osztály	None
الدروز	drúz	Nan
الدستور	az alkotmány	Nan
الدستوري	alkotmányos	None
الدستورية	alkotmányos	None
الدعاء	imádkozni érte	Nan
الدعاية	hype	Nan
الدنمارك	dánia	None
الدنيا	a világ	Nan
الدهون	fats	Nan
الدين	vallás	None
الدينار	a dinár	Nan
الديناصور	a dinoszaurusz	Nan
الديناصورات	dinoszauruszok	None
الدينية	vallási	None
الديوان	diwan	Nan
الديون	tartozások	Nan
الذئب	a farkas	Nan
الذات	maga	None
الذاتي	maga	None
الذاتية	alanyiság	Nan
الذاكرة	memória	None
الذرات	atomok	None
الذراع	a kar	Nan
الذرة	kukorica	None
الديموقراطية	demokrácia	None
الديموغرافيا	demográfia	Nan
الديمقراطية	demokrácia	None
الديمقراطيات	demokráciák	Nan
الدوائر	körök	None
الدوافع	motiváció	Nan
الدوحة	doha	Nan
الدور	a szerep	Nan
الدوران	forgás	Nan
الدورة	a kurzus	Nan
الدوري	liga	None
الدجاج	csirke	Nan
الدورية	időszakosság	Nan
الدولة	ország	None
الدولتين	a két állam	Nan
الدولية	nemzetközi	None
الديار	itthon	None
الديانات	vallások	None
الديانة	vallás	None
الديمقراطي	demokrata	None
الدول	országok	None
الحادة	akut	Nan
الدبلوماسية	diplomácia	Nan
الدار	a ház	Nan
الخط	vonal	None
الخطأ	a hiba	Nan
الخطة	a terv	Nan
الخطر	a veszély	Nan
الخطط	tervek	None
الخطوات	a lépések	Nan
الخطوة	a lépés	Nan
الخطوط	vonalak	None
الخطيب	khatib	Nan
الخطيرة	komoly	None
الخفيفة	fény	None
الخلاص	megváltás	Nan
الخلافات	különbségek	None
الخلافة	öröklés	Nan
الخلايا	a sejteket	Nan
الخضراء	zöld	None
الخلف	vissza	None
الخصيب	termékeny	None
الخصوبة	termékenység	Nan
الخانات	számjegy	Nan
الخبر	a hírek	Nan
الخبراء	szakértők	None
الخدمات	szolgáltatások	None
الخدمة	a szolgáltatás	Nan
الخديوي	a khedive	Nan
الخرائط	maps	Nan
الخروج	kijárat	Nan
الخريطة	a térkép	Nan
الخسائر	veszteség	Nan
الخشب	a fa	Nan
الخشبية	fás	Nan
الخصائص	tulajdonságok	None
الخصبة	buja	Nan
الخصم	kedvezmény	Nan
الخصوص	különös	None
الخلفاء	kalifák	Nan
الخلفية	a háttér	Nan
الخلق	teremtés	Nan
الخوف	a félelem	Nan
الخيال	képzelet	Nan
الخيالة	felszerelt	None
الخيام	sátrak	Nan
الخير	a jó	Nan
الخيرية	adomány	Nan
الخيل	a ló	Nan
الخيول	lovak	None
الدائرة	kör	None
الدائري	gyűrű	None
الدائم	az állandó	Nan
الدائمة	álló	None
الداخل	belül	None
الداخلي	eljárás	None
الداخلية	a belső terek	Nan
الخواص	tulajdonságok	None
الخوارزمي	alkhawarizmi	Nan
الخوارج	kharijites	Nan
الخندق	az árok	Nan
الخلوي	sejtes	Nan
الخلوية	sejtes	Nan
الخلية	sejt	None
الخليج	öböl	None
الخليجي	al khaliji	Nan
الخليجية	öböl	None
الخليفة	kalifa	Nan
الدانوب	duna	None
الخليل	hebron	Nan
الخمس	az öt	Nan
الخمسة	az öt	Nan
الخمسينات	az ötvenes évek	Nan
الخمسينيات	az ötvenes évek	Nan
الخميس	csütörtök	Nan
الخنازير	sertés	Nan
الخنافس	bogarak	Nan
الخمر	bor	None
الاثني	etnikum	Nan
الاتهام	a vádat	Nan
الاتفاقية	megegyezés	Nan
أنهما	ők	None
أنهى	befejez	Nan
أنواع	faj	None
أنواعها	a típusai	Nan
أنوبيس	anubis	Nan
أنور	anwar	Nan
أني	hogy én vagyok	Nan
أنّ	hogy	None
أنّه	ez egy	Nan
أهالي	emberek	None
أهداف	célok	Nan
أهدافها	céljai	Nan
أهل	emberek	None
أهله	az ő családja	Nan
أهلها	a családja	Nan
أنهم	hogy azok	Nan
أهلية	jogosultsági	Nan
أنهار	összeomlott	None
أنه	ez egy	Nan
أنس	anas	Nan
أنسجة	a szöveteket	Nan
أنشأت	alapított	None
أنشئ	teremt	Nan
أنشئت	alapított	None
أنشطة	tevékenységek	None
أنصار	támogatóink	Nan
أنطاكية	antiochia	Nan
أنظر	néz	None
أنظمة	systems	Nan
أنفسهم	maguk	None
أنقرة	ankara	Nan
أنك	hogy te vagy	Nan
أنماط	minták	Nan
أننا	hogy mi vagyunk	Nan
أنها	azt	None
أندية	klubok	None
أهم	a legfontosabb	Nan
أهمية	fontosság	Nan
أوسع	szélesebb	None
أوسلو	oslo	Nan
أوصى	ajánlom	Nan
أوضاع	módok	Nan
أوضح	magyarázatai	Nan
أوضحت	elmagyarázta	Nan
أوقات	times	Nan
أوقطاي	az időm	Nan
أوكرانيا	ukrajna	None
أول	első	None
أولئك	azok	None
أولا	első	None
أولاد	gyermekek	None
أولاده	a gyerekei	Nan
أولاً	első	None
أوساط	média	None
أهمها	a legfontosabb	Nan
أوروبية	európai	None
أوروبا	európa	None
أهميتها	fontossága	Nan
أو	vagy	None
أوائل	korai	None
أواخر	késő	None
أواسط	középső	None
أوامر	rendelés	Nan
أوامره	az ő parancsai	Nan
أوباما	obama	None
أوبرا	oprah	Nan
أوج	tetőpont	Nan
أوجه	áció	Nan
أوراق	a levelek	Nan
أورانوس	uránusz	None
أورخان	orhan	Nan
أورشليم	jeruzsálem	None
أوروبي	európai	None
أنحاء	felett	None
أنجلوسكسونيون	angelesxionion	Nan
أنجبت	született	None
ألعاب	játékok	None
ألف	ezer	None
ألفا	alfa	None
ألفًا	alfa	None
ألقاب	becenevek	Nan
ألقى	lehangol	Nan
ألكسندر	sándor	None
ألكيل	alkil-	Nan
ألمانيا	németország	None
ألمانية	német	None
ألوان	színek	None
أم	anya	None
أما	ami	None
أماكن	helyek	None
أمام	előtt	None
ألدهيد	aldehid	None
أمامه	azzal szemben	Nan
ألبوم	album	None
ألبانيا	albánia	None
أقوى	erősebb	None
أقيم	maradok	Nan
أقيمت	emelt	None
أكاديمية	akadémia	None
أكان	akan	Nan
أكتوبر	október	None
أكثر	több	None
أكثرها	a legtöbb	Nan
أكد	megerősített	None
أكدت	megerősített	None
أكسيد	oxid	Nan
أكل	evett	Nan
أكمل	teljes	None
ألا	kivéve	None
ألاسكا	alaszka	None
ألبرت	albert	None
أمانة	őszinteség	Nan
أمة	az anyja	Nan
أمثال	kedveltek	Nan
أمور	dolgok	None
أمية	írástudatlanság	Nan
أمير	herceg	None
أمين	megbízható	None
أمّا	ami	None
أن	hogy	None
أنا	én vagyok	Nan
أنابيب	tubes	Nan
أناكوندا	anakonda	Nan
أنباء	hírek	None
أنبياء	próféták	Nan
أنت	te vagy	Nan
أنتج	készült	None
أنتجت	készült	None
أنثى	női	None
أموال	alapok	Nan
أمه	az anyja	Nan
أمن	biztonság	None
أمم	nemzetek	None
أمثلة	példák	None
أمر	parancs	None
أمرا	megrendelés	Nan
أمراء	princes	Nan
أمراض	betegségek	None
أمره	parancsnoka	None
أمرهم	parancsolta nekik	Nan
أولها	az első közülük	Nan
أمريكا	egyesült államok	Nan
أمريكية	amerikai	None
أمريكيون	amerikaiak	None
أمرًا	megrendelés	Nan
أمطار	eső	None
أمفورة	amfora	Nan
أمكن	lehetséges	None
أمل	hopefull	Nan
أمريكي	amerikai	None
أقواله	az ő mondásai	Nan
أولى	első	None
أوّل	első	None
إلهام	fontos	None
إلى	nekem	None
إلي	nekem	None
إليك	neked	Nan
إلينا	nekünk	Nan
إليه	gépezet	Nan
إليها	neki	None
إليهم	nekik	None
إم	anya	None
إما	ami	None
إمارة	emirátus	Nan
إمام	előtt	None
إمبراطور	császár	None
إمبراطورية	birodalom	None
إمكانية	lehetőség	None
إله	gép	None
إنا	én vagyok	Nan
إلقاء	dobás	Nan
إلاّ	kivéve	None
إطلاق	kiadás	None
إعادة	visszatérés	None
إعداد	készítmény	Nan
إعطاء	adni	None
إعلامية	tájékoztató	Nan
إعلان	hirdető	Nan
إف	f	Nan
إفراز	kiválasztás	Nan
إفريقيا	afrika	None
إفريقية	afrikai	None
إقامة	szállás	Nan
إقليم	tartomány	None
إقليمية	regionális	None
إل	a	None
إلا	kivéve	None
إلغاء	törlés	Nan
إطار	keretrendszer	Nan
إنتاج	produce	Nan
إنتاجها	a termelésük	Nan
إياها	azt	None
إيجاد	lelet	None
إيران	irán	None
إيرث	föld	None
إيطاليا	italia	Nan
إيفان	ivan	None
إيفل	eiffel	Nan
إيقاف	kikapcsolni	Nan
إيه	vers	None
إِلا	kivéve	None
إِلَى	nekem	None
ا	egy	None
ابتداء	kezdet	Nan
ابتناء	anabolizmus	Nan
ابن	fiú	None
إياه	neki	None
إنتاجه	készítsd el	Nan
إنّ	hogy	None
إنهم	hogy azok	Nan
إنترنت	internet	None
إنجازات	kitüntetések	Nan
إنجلترا	anglia	None
إنجليزية	angol	None
إنجيل	evangélium	Nan
إندونيسيا	indonézia	None
إنسان	férfi	None
إنسانية	humánus	Nan
إنشاء	felépít	Nan
إنشائها	hozza létre őket	Nan
إنفلونزا	influenza	None
إنكار	tagadás	Nan
إنما	inkább	None
إنها	azt	None
إنهاء	befejező	Nan
إني	én vagyok	Nan
إضافية	további	None
إضافةً	kiegészítés	Nan
إضافة	kiegészítés	Nan
أَنْ	hogy	None
إبادة	kiirtás	Nan
إبان	alatt	None
إبراهيم	ibrahim	Nan
إثارة	izgalom	Nan
إثبات	bizonyíték	None
إثر	hatás	None
إثيوبيا	etiópia	Nan
إجراء	eljárás	None
إجراءات	eljárások	None
إجماع	megegyezés	Nan
إجمالي	teljes	None
إحباط	csalódottság	Nan
إحداث	események	None
إحدى	egy	None
أَنَّ	hogy	None
إحصاء	számolás	Nan
أيوب	ayoub	Nan
أينشتاين	einstein	None
أى	melyik	None
أي	melyik	None
أيام	napok	None
أيامه	az ő napjai	Nan
أيبك	aybak	Nan
أية	vers	None
أيدي	hands	Nan
أيديهم	a kezeik	Nan
أيرلندا	írország	None
أيضا	szintén	None
أيضاً	szintén	None
أيضًا	szintén	None
أيلول	szeptember	None
أيمن	aimen	Nan
أين	ahol	None
أيها	hé	Nan
إحصاءات	statisztika	Nan
إحصائيات	statisztika	Nan
إحياء	biológia	Nan
إسرائيل	izrael	None
إسطنبول	isztambul	None
إسقاط	kivetítés	Nan
إسلام	iszlám	None
إسلامه	az iszlám	Nan
إسلامي	islami	Nan
إسلامية	iszlám	None
إسماعيل	ismail	Nan
إشارات	jelzések	Nan
إشارة	jel	None
إشعاع	sugárzás	None
إصابة	fertőzés	None
إصدار	kiadás	None
إصلاح	javítás	Nan
إصلاحات	javítások	Nan
إسحاق	isaac	None
إستراتيجية	stratégia	Nan
إسبانيا	spanyolország	None
إس	s.	Nan
إخراج	rendezte	None
إخوته	testvérei	None
إدارة	vezetés	None
إداري	közigazgatási	None
إدارية	közigazgatási	None
إدخال	belép	Nan
إدراك	megvalósítás	Nan
أولية	előzetes	None
إذ	ezért	None
إذاعة	broadcasting	Nan
إذن	fül	Nan
إرادة	akarat	None
إرتريا	eritrea	Nan
إرسال	küld	Nan
إرهابية	terrorista	Nan
إزالة	eltávolítás	Nan
إذا	ha	None
أقوال	közmondások	Nan
أقمار	moons	Nan
أقلية	kisebbség	None
أحسن	legjobb	None
أحكام	rendelkezések	None
أحلام	álmok	Nan
أحمد	ahmad	Nan
أحمدي	ahmadi	Nan
أحمر	piros	None
أحوال	körülmények	None
أحياء	biológia	Nan
أحيان	néha	None
أحيانا	néha	None
أحياناً	néha	None
أحيانًا	néha	None
أخاه	a testvére	Nan
أخبار	hírek	None
أخت	lánytestvér	Nan
أحزاب	a felek	Nan
أخته	a nővére	Nan
أحدهما	egyikük	None
أحدث	a legutolsó	Nan
أجريت	vezetett	None
أجزاء	alkatrészek	None
أجسام	bodies	Nan
أجل	igen	None
أجمع	gyűjtök	Nan
أجمل	a leggyönyörűbb	Nan
أجنبية	külföldi	None
أجنحة	szárnyak	Nan
أجهزة	eszközök	None
أحادي	egyetlen	None
أحاديث	hadiths	Nan
أحب	imádom	Nan
أحجية	kirakós játék	Nan
أحد	egy	None
أحداث	események	None
أحدهم	valaki	None
أجرى	menj futni	Nan
أخذ	átadás	Nan
أخر	más	None
أدوار	megbízatási idő	Nan
أدولف	adolf	None
أدوية	gyógyszerek	None
أدى	vezette	None
أدّت	vezette	None
أدّى	teljesített	None
أذربيجان	azerbajdzsán	Nan
أراد	akar	None
أرادت	akarta	None
أراض	lands	Nan
أراضي	lands	Nan
أراضيها	területét	None
أرباع	szállás	Nan
أربع	négy	None
أربعة	négy	None
أدنى	minimális	None
أخذت	elvettem	Nan
أدناه	lent	Nan
أدرك	realizált	Nan
أخرج	kifelé	None
أخرى	egyéb	None
أخطاء	hibák	None
أخطر	a legveszélyesebb	Nan
أخلاقية	etikai	None
أخوه	brothers	None
أخيرا	végül	None
أخيه	a testvére	Nan
أخيون	fiú testvér	Nan
أداء	teljesítmény	None
أداة	egy eszköz	Nan
أدب	irodalom	None
أدبية	irodalmi	None
أدت	vezette	None
أدخل	belép	Nan
أدلة	nyomokat	Nan
أجراها	készítette	None
أجرام	bűn	None
أجبر	kényszerű	Nan
آلات	gép	None
آلاف	ezrek	Nan
آلام	az anya	Nan
آلة	gép	None
آلهة	istenek	None
آلية	gépezet	Nan
آمن	biztonság	None
آمنة	biztonságos	None
آمون	amon	Nan
آن	hogy	None
آنذاك	abban az időben	Nan
آي	melyik	None
آيات	verses	None
آية	vers	None
أ	egy	None
آل	a	None
أئمة	imámok	Nan
آشوربانيبال	asszurbanipalnak	Nan
آسكي	ascii	Nan
+	+	Nan
=	=	None
==	==	Nan
|	|	Nan
°	°	None
°م	° c	Nan
آثار	hatások	None
آثارها	ennek hatásai	Nan
آخر	más	None
آخرها	a legutóbbi	Nan
آخرون	mások	None
آخرين	egyéb	None
آخيل	achilles	Nan
آدم	ádám	None
آراء	vélemények	None
آسيا	ázsia	None
أب	apa	None
أبا	oppa	Nan
أباتيت	apatit	Nan
أتاتورك	atatürk	Nan
أتباع	következő	None
أتباعه	követői	None
أتت	jött	None
أتى	jött	None
أثار	hatások	None
أثارت	felkeltette	Nan
أثبت	bizonyított	None
أثبتت	igazolták	Nan
أثر	hatás	None
أثرت	érintett	None
أثره	hatása	None
أثرية	antik	None
أثناء	alatt	None
أثينا	athéné	Nan
أبيه	apja	None
أبيب	tel	Nan
أبي	az apám	Nan
أبى	az apám	Nan
أباه	az ő apja	Nan
أبحاث	kutatás	None
أبدا	rajt	Nan
أبداً	rajt	Nan
أبدًا	rajt	Nan
أبرز	a legfigyelemreméltóbb	Nan
أبرزها	a legfigyelemreméltóbb	Nan
أربعين	negyven	None
أبريل	április	None
أبعد	messze	None
أبناء	gyermekek	None
أبنائه	a fiai	Nan
أبو	abu	None
أبواب	ajtó	Nan
أبوظبي	abu dhabi	Nan
أبوه	az ő apja	Nan
أبطال	champions	Nan
أرجاء	halasztott	Nan
أرخبيل	szigetvilág	Nan
أرخميدس	archimedes	Nan
أعداء	ellenségek	Nan
أعدائه	az ellenségei	Nan
أعداد	készítmény	Nan
أعراض	szindróma	Nan
أعضاء	belépés	Nan
أعطى	adott	None
أعظم	legnagyobb	None
أعقاب	utóhatás	Nan
أعلام	zászlók	Nan
أعلاه	felett	None
أعلم	tudom	None
أعلن	hirdet	Nan
أعلنت	bejelentette	None
أعلى	felső	None
أعمال	üzleti	None
أعاد	ismétlés	Nan
أعماله	művei	None
أظهرت	megmutattam	Nan
أطول	a leghosszabb	Nan
أصله	eredete	None
أصلها	eredete	None
أصوات	voices	Nan
أصول	eredet	Nan
أصيب	megsérült	None
أضاف	hozzátette	Nan
أضخم	a legnagyobb	Nan
أضرار	kártérítés	Nan
أضعاف	kettős	None
أضلاع	borda	Nan
أطراف	a felek	Nan
أطفال	gyermekek	None
أطلق	kiadás	None
أطلقت	elindította	Nan
أطوال	hosszúságban	Nan
أظهر	megjelenik	None
أعمالها	az üzlet	Nan
أعمدة	oszlopok	Nan
أعوام	évek	None
أفلام	filmek	None
أفلامه	az ő filmjei	Nan
أفندي	effendi	Nan
أقاليم	területek	None
أقام	marad	None
أقبل	elfogad	Nan
أقدم	a legrégebbi	Nan
أقر	elmúlt	None
أقرب	közelebb	None
أقسام	szakaszok	None
أقصر	rövidebb	None
أقصى	maximális	None
أقطار	az átmérő	Nan
أقل	kevésbé	None
أقليات	kisebbségek	None
أفلاطون	plató	Nan
أفكاره	a gondolatai	Nan
أفكار	gondolatok	None
أفغانستان	afganisztán	None
أعيد	visszatértek	None
أغاني	dalok	None
أغراض	cél	None
أغسطس	augusztus	None
أغلب	a legtöbb	Nan
أغلبها	a legtöbb	Nan
أغلبية	többség	None
أصلاً	eredetileg	None
أغنى	a leggazdagabb	Nan
أفراد	egyének	None
أفرادها	tagjai	None
أفرودة	afroda	Nan
أفريقيا	afrika	None
أفريقية	afrikai	None
أفضل	legjobb	None
أفعال	igék	None
أغنية	dal	None
ابنة	lánya	None
أصلا	eredetileg	None
أصفر	sárga	None
أساسًا	alapvetően	None
أساليب	technikák	None
أسامة	ossama	Nan
أسباب	okok	None
أسبانيا	spanyolország	None
أسبوع	egy hét	Nan
أستاذ	egyetemi tanár	Nan
أستراليا	ausztrália	None
أسد	oroszlán	None
أسر	befogó	Nan
أسرار	titkok	Nan
أسرة	család	None
أسرته	az ő családja	Nan
أسرع	gyorsabb	None
أسس	létrehozni	None
أساسية	alapvető	None
أسست	alapított	None
أساسيا	alapvető	None
أساساً	alapvetően	None
أرسطو	arisztotelész	None
أرسل	küld	Nan
أرسلان	arslan	Nan
أرسلت	küldtem	Nan
أرسله	küldje el	Nan
أرض	föld	None
أرضية	padló	Nan
أرقام	szám	None
أركان	pillérei	Nan
أرمينيا	örményország	Nan
أزمة	válság	None
أس	ász	Nan
أسابيع	hetek	None
أساس	bázis	None
أساسا	alapvetően	None
أساسي	alapvető	None
أسسها	megalapította	None
أسطورة	legenda	None
أسطول	flotta	None
أشد	keményebb	None
أشرف	ashraf	Nan
أشعة	sugarak	Nan
أشكال	alakzatok	Nan
أشهر	hónapok	None
أشهرها	a leghíresebb	Nan
أشياء	dolgok	None
أصابع	fingers	Nan
أصبح	vált valamivé	Nan
أصبحوا	ők lettek	Nan
أصحاب	barátok	None
أصحابه	társak	Nan
أصدر	kiadott	None
أصدرت	kiadott	None
أصغر	kisebb	None
أشخاص	emberek	None
أشجار	fák	None
أشبه	inkább	None
أشارت	- mondta	Nan
أسعار	árak	Nan
أسعد	legboldogabb	Nan
أسفر	hozam	Nan
أسفرت	így	None
أسفل	le	None
أسلحة	fegyver	None
أسلم	biztonságosabb	Nan
أصل	eredet	Nan
أسلوب	stílus	None
أسمهان	asmahan	Nan
أسهم	készletek	Nan
أسوأ	legrosszabb	None
أسوار	kerítések	Nan
أسواق	piacok	Nan
أسود	fekete	None
أشار	rámutatott	Nan
أسماء	a nevek	Nan
ابنته	lánya	None
ابنه	lánya	None
ابي	az apám	Nan
الأمد	tartam	Nan
الأمر	az ügyet	Nan
الأمراء	a hercegek	Nan
الأمراض	betegségek	None
الأمريكتين	az amerikaiak	Nan
الأمريكي	amerikai	None
الأمريكية	amerikai	None
الأمريكيون	az amerikaiak	Nan
الأمريكيين	az amerikaiak	Nan
الأمصار	a ciklonok	Nan
الأمطار	eső	None
الأمعاء	bél	Nan
الأمل	remény	None
الأملاح	sók	Nan
الأمم	nemzetek	None
الأمثلة	példák	None
الأمن	biztonság	None
الأمثال	példabeszédek	Nan
الأمانة	őszinteség	Nan
الألبانية	albán	None
الألف	alif	Nan
الألفية	a millennium	Nan
الألم	a fájdalom	Nan
الألمان	németek	None
الألماني	német	None
الألمانية	német	None
الألواح	tányérok	Nan
الألوان	színek	None
الأم	az anya	Nan
الأمازيغ	a berberek	Nan
الأمازيغية	tamazight	Nan
الأماكن	a helyek	Nan
الأمام	előre	None
الأمان	biztonság	None
الأمة	nemzet	None
الألبان	tejtermék	Nan
الأمنية	a kívánság	Nan
الأموال	pénz	None
الأندية	klubok	None
الأنسجة	szövet	Nan
الأنسولين	inzulin	None
الأنشطة	tevékenységek	None
الأنصار	ansar	Nan
الأنصاري	al ansari	Nan
الأنطروبولوجيا	embertan	Nan
الأنظمة	systems	Nan
الأنف	az orr	Nan
الأنفاق	alagutak	Nan
الأنماط	stílusok	None
الأنهار	rivers	Nan
الأنواع	faj	None
الأهالي	a szülők	Nan
الأهداف	célok	Nan
الأندلس	andalúz	Nan
الأمواج	a hullámok	Nan
الأنثى	a nőstény	Nan
الأنبياء	a próféták	Nan
الأمور	a dolgok történnek	Nan
الأموي	omajjád	Nan
الأموية	omajjád	Nan
الأمويون	az umayyadok	Nan
الأمويين	az umayyadok	Nan
الأمية	írástudatlanság	Nan
الأمير	a herceg	Nan
الأميرة	a hercegnő	Nan
الأميركي	amerikai	None
الأميركية	amerikai	None
الأمين	a titkár	Nan
الأنا	ego	Nan
الأناجيل	bibliák	Nan
الأناضول	anatólia	Nan
الأنباء	hírek	None
الأنثروبولوجيا	antropológus	Nan
الألب	alpok	None
الأكسجين	az oxigén	Nan
الأكراد	a kurdok	Nan
الأصول	eredet	Nan
الأضحى	al-adha	Nan
الأضرار	kártérítés	Nan
الأضلاع	borda	Nan
الأطباء	az orvosok	Nan
الأطباق	az ételek	Nan
الأطراف	a bulik	Nan
الأطرش	atrash	Nan
الأطعمة	élelmiszerek	None
الأطفال	gyermekek	None
الأطلس	az atlasz	Nan
الأطلسي	atlanti	Nan
الأعداء	ellenségek	Nan
الأعداد	készítmény	Nan
الأعراض	tünetek	None
الأصوات	hangok	None
الأعراق	etnikumok	Nan
الأصناف	fajták	None
الأصليون	a bennszülött	Nan
الأشجار	a fák	Nan
الأشخاص	személyek	None
الأشراف	felügyelet	None
الأشرف	ashraf	Nan
الأشعة	rays	Nan
الأشعري	al-ash&#39;ari	Nan
الأشكال	alakzatok	Nan
الأشهر	hónapok	None
الأشياء	a dolgok	Nan
الأصدقاء	barátok	None
الأصغر	legkisebb	None
الأصفر	sárga	None
الأصل	az eredet	Nan
الأصلي	az eredeti	Nan
الأصلية	az eredeti	Nan
الأصليين	az őslakosok	Nan
الأعشاب	gyógynövények	Nan
الأعصاب	idegek	Nan
الأعضاء	belépés	Nan
الأفلام	a filmek	Nan
الأفيون	ópium	Nan
الأقاليم	területek	None
الأقدس	a legszentebb	Nan
الأقدم	a legrégebbi	Nan
الأقرب	a legközelebbi	Nan
الأقسام	szakaszok	None
الأقصى	messze	None
الأقطار	diagonal vonalok	Nan
الأقل	legkevesebb	Nan
الأقليات	kisebbségek	None
الأقمار	moons	Nan
الأقوال	közmondások	Nan
الأكاديمية	akadémia	None
الأكبر	a legnagyobb	Nan
الأفكار	ötletek	Nan
الأفغاني	afgán	None
الأفعال	hozzászólások	Nan
الأفضل	legjobb	None
الأعظم	a legnagyobb	Nan
الأعلام	média	None
الأعلى	a fenti	Nan
الأعمال	üzleti	None
الأعمدة	oszlopok	Nan
الأعوام	évek	None
الأغالبة	aghlabis	Nan
الأهرام	piramisok	None
الأغاني	dalok	None
الأغراض	a cucc	Nan
الأغلب	többnyire	None
الأغلبية	a többség	Nan
الأغنية	a dal	Nan
الأفراد	egyének	None
الأفريقي	afrikai	None
الأفريقية	afrikai	None
الأغذية	étel	None
الأهرامات	piramisok	None
الأهلي	al-ahly	Nan
الأهلية	jogosultsági	Nan
الإقليمي	regionális	None
الإقليمية	regionális	None
الإلحاد	ateizmus	Nan
الإلكترون	elektron	Nan
الإلكترونات	az elektronok	Nan
الإلكترونية	e	Nan
الإله	isten	None
الإلهي	isteni	None
الإلهية	isteni	None
الإمارات	uae	Nan
الإمارة	az emirátus	Nan
الإمامة	imamate	Nan
الإمامية	imami	Nan
الإمبراطور	a császár	Nan
الإمبراطورية	a birodalom	Nan
الإقليم	terület	None
الإمدادات	készletek	Nan
الإقامة	rezidencia	Nan
الإفريقي	afrikai	None
الإصابة	sérülés	Nan
الإصدار	kiadás	None
الإصلاح	fix	Nan
الإصلاحات	javítás	Nan
الإصلاحية	bűnügyi	None
الإطار	a keret	Nan
الإطلاق	az indítás	Nan
الإعدام	kivégzések	Nan
الإعلام	média	None
الإعلامي	tájékoztató	Nan
الإعلان	hirdető	Nan
الإعلانات	a hirdetések	Nan
الإغريق	a görögök	Nan
الإغريقي	görög	None
الإغريقية	görög	None
الإفريقية	afrikai	None
الإناث	női	None
الإنتاج	termelés	None
الإنتاجية	termelékenység	Nan
الإيطاليين	olaszok	None
الإيمان	hit	None
الا	kivéve	None
الائتلاف	a koalíció	Nan
الابتدائي	elsődleges	None
الابتدائية	elsődleges	None
الابن	fiú	None
الاتجاه	irány	None
الاتجاهات	directione	Nan
الاتحاد	az unió	Nan
الاتحادية	szövetségi	None
الاتصال	kapcsolat	None
الاتصالات	távközlési	Nan
الاتفاق	a megállapodás	Nan
الاتفاقيات	megállapodások	Nan
الإيطالية	olasz	None
الإيطالي	olasz	None
الإيرانية	iráni	None
الإيراني	iráni	None
الإنترنت	internet	None
الإنجليز	az angol	Nan
الإنجليزي	angol	None
الإنجليزية	angol	None
الإنجيل	evangélium	Nan
الإنسان	emberi	None
الإنساني	az ember	Nan
الإشعاعي	radiológiai	Nan
الإنسانية	emberiség	None
الإنفاق	költési	Nan
الإنفلونزا	influenza	None
الإنكشارية	janicsárok	Nan
الإنكليزي	angol	None
الإنكليزية	angol	None
الإيجابية	a pozitív	Nan
الإيدز	aids	None
الإنشاء	teremtés	Nan
الأسود	a fekete	Nan
الإشعاع	sugárzás	None
الإسماعيلية	ismailia	Nan
الأوقات	alkalommal	None
الأوكراني	ukrán	None
الأوكرانية	ukrán	None
الأول	az első	Nan
الأولمبية	olimpiai	None
الأولى	az első	Nan
الأولي	a kezdeti	Nan
الأولية	elsődleges	None
الأيام	a napok	Nan
الأيبيرية	ibériai	Nan
الأيسر	bal	None
الأيمن	jobb	None
الأيوبي	al ayoubi	Nan
الأيوبية	ayyubid	Nan
الإباحية	pornográfia	Nan
الأوعية	golyózás	Nan
الإبادة	kiirtás	Nan
الأوضاع	körülmények	None
الأوسط	középső	None
الأهم	fontosabb	None
الأهمية	fontosság	Nan
الأوائل	felső	None
الأوامر	parancsok	Nan
الأوبرا	az opera	Nan
الأودية	völgyek	Nan
الأوراق	a levelek	Nan
الأورام	daganatok	Nan
الأوربية	európai	None
الأوروبي	európai	None
الأوروبية	európai	None
الأوروبيون	az európaiak	Nan
الأوروبيين	az európaiak	Nan
الأوزون	ózon	Nan
الأوساط	körök	None
الأوسمة	kitüntetések	Nan
الإباضية	ibadi	Nan
الإبداع	kreativitás	Nan
الإبراهيمية	ábrahámi	Nan
الإرادة	akarat	None
الإرشاد	tanácsadás	Nan
الإرهاب	terrorizmus	Nan
الإسبان	a spanyol	Nan
الإسباني	a spanyol	Nan
الإسبانية	spanyol	None
الإسراء	isra	Nan
الإسرائيلي	izraeli	None
الإسرائيلية	izraeli	None
الإسرائيليين	az izraeliek	Nan
الإسكندر	sándor	None
الإسكندرية	alexandria	Nan
الإسلام	iszlám	None
الإسلامي	iszlám	None
الإسلامية	iszlám	None
الإذاعة	rádió	None
الإدعشري	el adhari	Nan
الإدارية	közigazgatási	None
الإداري	közigazgatási	None
الإبل	a teveket	Nan
الإتحاد	az unió	Nan
الإثارة	izgalom	Nan
الإثنين	hétfő	Nan
الإجابة	a válasz	Nan
الإجراءات	intézkedések	None
الإجماع	megegyezés	Nan
الإشارات	a jelek	Nan
الإجمالي	teljes	None
الإحساس	szenzáció	Nan
الإحصاء	statisztika	Nan
الإحصاءات	statisztika	Nan
الإحصائيات	statisztika	Nan
الإحصائية	statisztikai	None
الإخوان	testvériség	Nan
الإدارة	adminisztráció	Nan
الإجمالية	teljes	None
السينما	mozi	None
الأسواق	piacok	Nan
الأسمدة	trágyák	Nan
استقرار	stabilitás	Nan
استقرت	letelepedett	Nan
استقلال	függetlenség	None
استقلالها	függetlensége	Nan
استكشاف	felfedezés	Nan
استمر	folytatni	None
استمرار	folytatás	Nan
استمرت	folytatás	Nan
استنادا	alapján	None
استنادًا	alapján	None
استهلاك	fogyasztás	Nan
استولى	lefoglalt	Nan
استيراد	import	Nan
اسم	főnév	None
اسمه	annak a neve	Nan
استقر	megállapodni	Nan
اسمها	a neve	Nan
استقبال	recepion	Nan
استفتاء	népszavazás	None
استخراج	kivonat	Nan
استراتيجية	stratégia	Nan
استرجاع	felépülés	Nan
استسلام	megadás	Nan
استسلمت	feladtam	Nan
استضافة	tárhely	Nan
استطاع	tudott	None
استطاعت	sikerült	None
استطلاع	felderítés	Nan
استعادة	felépülés	Nan
استعداد	kész	None
استعمال	használat	None
استعمالها	használd	Nan
استعمل	használat	None
استغلال	exploit	Nan
استقالته	lemondása	Nan
استخدمها	használd	Nan
اشتد	erősödik	Nan
اشتهر	legismertebb	None
اعتمادا	attól	Nan
اعتمد	támaszkodni	Nan
اعتمدت	fogadott	None
اعتناق	ölelés	Nan
اعتنق	felkarolta	Nan
اغتيال	orgyilkosság	Nan
اغتياله	meggyilkossága	Nan
افتتاح	nyítás	Nan
افتتح	nyitott	None
افتتحت	kinyitottam	Nan
اقتراب	megközelítés	None
اقتراح	javaslat	Nan
اقترح	javasol	Nan
اقتصاد	economie	Nan
اقتصادها	gazdaságának	Nan
اعتماد	jóváhagyás	Nan
اشتراكية	szocializmus	None
اعتقد	gondol	Nan
اعتقاد	hit	None
اشتهرت	híressé vált	Nan
اصدار	kiadás	None
اضطر	kényszerű	Nan
اضطراب	zavarás	Nan
اضطرابات	zavarok	None
اضطهاد	üldözés	Nan
اعادة	visszatérés	None
اعتبار	megfontolás	Nan
اعتبارا	hatás	None
اعتباراً	fontolgat	Nan
اعتبارها	ész	None
اعتبر	figyelembe vett	Nan
اعتبرت	figyelembe vett	Nan
اعتراف	elismerés	Nan
اعترف	elismerem	Nan
اعتقال	letartóztatás	Nan
استخدمت	használt	None
استخدم	használat	None
استخدامها	használd	Nan
اتهام	vád	None
اتهم	vádol	Nan
اثنان	kettő	None
اثنتين	kettő	None
اثنين	kettő	None
اجتماع	találkozó	None
اجتماعات	találkozók	Nan
اجتماعي	szociális	None
اجتماعية	szociális	None
اجتمع	találkozott	None
اجتياح	invázió	Nan
اجل	igen	None
احتراق	égő	Nan
احترام	tisztelet	Nan
احتفظ	tart	None
اتفق	egyetért	Nan
احتل	occupy	Nan
اتفاقية	megegyezés	Nan
اتفاق	megállapodás	None
اتباع	következő	None
اتباعه	követői	None
اتبع	követni	Nan
اتجاه	irány	None
اتجاهات	trendek	Nan
اتجه	fordulat	None
اتحاد	unió	None
اتخاذ	vesz	None
اتخذ	elvitték	Nan
اتخذت	taken	Nan
اتساع	szélesség	Nan
اتسعت	kiszélesedett	Nan
اتسمت	meg volt jelölve	Nan
اتصال	kapcsolatba lépni	Nan
اتصالات	telecom	Nan
اتفاقيات	megállapodások	Nan
احتلال	foglalkozása	Nan
احتلت	megszállt	None
احتمال	kilátás	Nan
ارتفاعه	a magassága	Nan
ارتفاعها	a magassága	Nan
ارتفع	nőtt	None
ارتفعت	rózsa	None
ازداد	nőtt	None
ازدادت	megnövekedett	None
ازدهار	fejlődik	None
ازدهر	virágzott	None
ازدهرت	virágzott	None
ازدياد	növekedés	None
اس	s.	Nan
استبدال	cserélje	Nan
استخدام	hasznosítás	Nan
استخدامات	felhasználások	Nan
استخدامه	használd	Nan
ارتفاع	magasság	None
ارتبطت	eljegyezték	Nan
ارتبط	csatlakozás	Nan
ارتباط	eljegyzés	Nan
احتياجات	igények	Nan
احتياطي	tartalék	Nan
احمد	ahmed	Nan
اختار	választ	None
اختبار	teszt	None
اختبارات	vizsgálatok	None
اختراع	találmány	Nan
اقتصادي	gazdasági	None
اختراق	áttörés	Nan
اختلاف	különbség	None
اختلافات	különbségek	None
اختلفت	különbözött	Nan
اختيار	kiválasztás	Nan
اختياره	az ő választása	Nan
اخر	más	None
اديسون	edison	None
اخترع	feltalált	Nan
اقتصاديا	gazdaságosan	Nan
اقتصادية	gazdaságos	Nan
اقرأ	olvas	Nan
الأديان	vallások	None
الأذربيجانية	azerbajdzsáni	Nan
الأراضي	lands	Nan
الأرانب	nyulak	Nan
الأربع	háromnegyed	Nan
الأربعة	a négy	Nan
الأربعين	negyven	None
الأرثوذكس	ortodox	None
الأرثوذكسية	ortodox	None
الأرجح	valószínűleg	None
الأرجنتين	argentína	None
الأردن	jordánia	Nan
الأردني	jordanian	Nan
الأردنية	jordanian	Nan
الأرز	a rizs	Nan
الأدوية	gyógyszerészeti	Nan
الأرضي	talaj	None
الأدوار	szerepek	Nan
الأدنى	a legalacsonyabb	Nan
الأخر	a másik	Nan
الأخرى	a másik	Nan
الأخضر	a zöld	Nan
الأخطاء	hibák	None
الأخلاق	erkölcsi	None
الأخلاقية	erkölcsi	None
الأخوان	brothers	None
الأخير	az utolsó	Nan
الأخيرة	utolsó	None
الأداء	az előadás	Nan
الأدب	irodalom	None
الأدباء	írók	None
الأدبي	irodalmi	None
الأدبية	irodalmi	None
الأدلة	a bizonyíték	Nan
الأدوات	eszközök	None
الأرضية	a padló	Nan
الأرقام	számok	None
الأرمن	örmények	Nan
الأسبوع	a hét	Nan
الأستاذ	a professzor	Nan
الأسترالية	ausztrál	None
الأسد	az oroszlán	Nan
الأسر	családok	None
الأسرة	a család	Nan
الأسرى	elítéltek	Nan
الأسطورة	a legenda	Nan
الأسطول	a flotta	Nan
الأسعار	az árak	Nan
الأسفل	alsó	None
الأسلحة	fegyverek	None
الأسلوب	módszer	None
الأسماء	nevek	None
الأسماك	hal	None
الأسبق	az egykori	Nan
الأسبرين	aszpirin	Nan
الأسبانية	spanyol	None
الأسباني	spanyol	None
الأرمني	örmény	None
الأرمنية	örmény	None
الأرنب	a nyúl	Nan
الأرواح	szellemek	Nan
الأزرق	kék	None
الأزمات	válságok	Nan
الأزمة	a krízis	Nan
الأخذ	átadás	Nan
الأزهر	al-azhar	Nan
الأسئلة	kérdések	None
الأساس	az alapítás	Nan
الأساسي	az elsődleges	Nan
الأساسية	az alap	Nan
الأساطير	tévhitek	Nan
الأساليب	mód	None
الأسباب	az okok	Nan
الأزياء	divat	None
الأسنان	a fog	Nan
الأخبار	hírek	None
الأحيان	néha	None
الآستانة	astana	Nan
الآسيوي	ázsiai	None
الآسيوية	ázsiai	None
الآشورية	asszír	Nan
الآفات	kártevők	Nan
الآلات	gép	None
الآلاف	ezrek	Nan
الآلام	a fájdalom	Nan
الآلة	isten	None
الآلهة	istenek	None
الآلي	automatizált	Nan
الآلية	a mechanizmus	Nan
الآن	épp most	Nan
الآونة	nemrég	Nan
الآيات	verses	None
الآرامية	arameus	Nan
الآية	a vers	Nan
الآر	az aar	Nan
الآخرين	egyéb	None
اكتساب	beszerzés	Nan
اكتسبت	szerzett	None
اكتشاف	felfedezés	Nan
اكتشافه	fedezze fel	Nan
اكتشافها	fedezze fel őket	Nan
اكتشف	felfedez	Nan
اكتشفت	felfedeztem	Nan
ال	a	None
الآب	az apa	Nan
الآباء	szülők	None
الآبار	wells	Nan
الآتي	következő	None
الآثار	régészet	Nan
الآخر	a másik	Nan
الآخرة	jövőben	None
الآداب	irodalom	None
الأئمة	imámok	Nan
الأب	az apa	Nan
الأباطرة	a császárok	Nan
الأجنحة	a szárnyak	Nan
الأجهزة	eszközök	None
الأجيال	generációk	Nan
الأحاديث	hadiths	Nan
الأحد	vasárnap	None
الأحداث	események	None
الأحرار	szabad emberek	Nan
الأحرف	karakterek	None
الأحزاب	a bulik	Nan
الأحكام	rendelkezések	None
الأحماض	savak	Nan
الأحمد	al-ahmad	Nan
الأحمر	a piros	Nan
الأحوال	körülmények	None
الأحياء	biológia	Nan
الأجنبية	külföldi	None
الأجنبي	a külföldi	Nan
الأجناس	versenyek	Nan
الأجسام	tárgyak	None
الأبجدية	az ábécé	Nan
الأبحاث	kutatás	None
الأبطال	a hősök	Nan
الأبعاد	méretek	Nan
الأبناء	gyermekek	None
الأبواب	az ajtók	Nan
الأبيض	a fehér	Nan
الأخ	a báty	Nan
الأتراك	a törökök	Nan
الأثر	hatás	None
الأثرية	régészeti	None
الأثناء	addig	None
الأثير	éter	Nan
الأجانب	külföldiek	Nan
الأجرام	bodies	Nan
الأجزاء	a részek	Nan
الأثار	régészet	Nan
السينمائي	film	None
السينمائية	cinematic	Nan
السينية	x	Nan
الوزن	a súlyt	Nan
الوزير	a miniszter	Nan
الوسائل	eszközök	None
الوسط	a közép	Nan
الوسطى	központi	None
الوسواس	kínzó	Nan
الوسيط	közvetítő	Nan
الوصف	a leírás	Nan
الوصول	hozzáférés	Nan
الوصيف	a második helyezett	Nan
الوضع	a helyzet	Nan
الوطن	haza	None
الوطني	a nemzeti	Nan
الوطنية	nemzeti	None
الوظائف	állás	None
الوزراء	a miniszterek	Nan
الوظيفة	foglalkozása	Nan
الوزارة	a minisztérium	Nan
الورق	papír	None
الوثائق	dokumentumok	None
الوثنية	bálványimádás	Nan
الوثيقة	dokumentum	None
الوجبات	étkezés	Nan
الوجه	az arc	Nan
الوجود	létezés	None
الوحدات	egységek	None
الوحدة	mértékegység	Nan
الوحي	kinyilatkoztatás	Nan
الوحيد	az egyetlen	Nan
الوحيدة	az egyetlen	Nan
الوديان	a völgyek	Nan
الوراء	hátrafelé	Nan
الوراثة	genetika	Nan
الوراثية	genetikai	None
الورم	a daganat	Nan
الوالي	alelnök	None
الوظيفي	karrier	Nan
الوفاة	halál	None
اليابانية	japán	None
اليابسة	föld	None
اليد	kéz	None
اليدوية	kézzel készített	Nan
اليرموك	yarmouk	Nan
اليسار	a bal	Nan
اليسرى	bal	None
اليقين	bizonyosság	Nan
اليمامة	al-yamamah	Nan
اليمن	kinek	None
اليمنى	jobb	None
اليمنية	jemeni	Nan
اليمين	jobb	None
اليه	gépezet	Nan
اليهود	a zsidók	Nan
الياباني	japán	None
الوعي	tudatosság	Nan
اليابان	japán	None
الوهابية	vahabizmus	Nan
الوفد	a küldöttség	Nan
الوفيات	a halálesetek	Nan
الوقائع	a tények	Nan
الوقاية	védelem	None
الوقت	idő	None
الوقود	az üzemanyag	Nan
الوقوف	állj fel	Nan
الوكالة	ügynökség	Nan
الولاء	hűség	Nan
الولاة	prefektus	Nan
الولادة	születés	None
الولايات	az államok	Nan
الولاية	az állam	Nan
الوليد	alwaleed	Nan
الوهاب	mindenki adója	Nan
الويب	a háló	Nan
الوالد	apa	None
الواقعية	realizmus	None
الواقعة	az a tény	Nan
النيتروجين	nitrogén	Nan
النيجر	niger	Nan
النيل	nílus	None
الهائل	rendkívüli	None
الهائلة	fantasztikus	None
الهاتف	a telefon	Nan
الهادئ	csendes	None
الهادي	a vezető	Nan
الهاشمي	hashemi	Nan
الهاشمية	hasemita	Nan
الهامة	fontos	None
الهبوط	leszállás	None
الهجان	hibrid	Nan
الهجرة	bevándorlás	None
الهجري	hijri	Nan
النيازك	meteorites	Nan
الهجمات	megtámadja	Nan
النووية	nukleáris	None
النوم	alvás	Nan
النهائي	végső	None
النهائية	a végső	Nan
النهار	nappal	None
النهاية	vég	Nan
النهج	megközelítés	None
النهر	a folyó	Nan
النهرين	a két folyó	Nan
النهضة	reneszánsz	None
النواب	képviselőház	None
النواحي	módokon	Nan
النوادي	klubok	None
النواعير	a szökőkutak	Nan
النور	a fény	Nan
النوع	típus	None
النوعية	minőség	Nan
النووي	nukleáris	None
الهجوم	támadás	None
الهدنة	fegyverszünet	Nan
الهرم	a piramis	Nan
الهيئة	jutalék	Nan
الهياكل	struktúrák	Nan
الهيثم	al-haytham	Nan
الهيدروجين	hidrogén	Nan
الهيكل	a szerkezet	Nan
الواجب	házi feladat	Nan
الواجهة	felület	None
الواحد	az egyik	Nan
الوادي	a völgy	Nan
الواردات	behozatal	Nan
الواردة	foglalt	None
الواسع	széles	None
الواسعة	széles	None
الواضح	magától értetődően	Nan
الواقع	valóság	None
الهيئات	szervezetek	None
الهوية	identitás	Nan
الهولوكوست	a holokauszt	Nan
الهولندية	holland	None
الهروب	menekülni	None
الهزيمة	vereség	None
الهضاب	a fennsík	Nan
الهضبة	a fennsík	Nan
الهلال	félhold	Nan
الهند	india	None
الهندسة	mérnöki	Nan
اليهودي	a zsidó	Nan
الهندسية	mérnöki	Nan
الهندوسية	hinduizmus	None
الهندي	az indiai	Nan
الهندية	hindi	Nan
الهنود	indiánok	None
الهواء	a levegő	Nan
الهوائية	aerobic	Nan
الهولندي	holland	None
الهندوس	a hindu	Nan
النمور	tigers	Nan
اليهودية	judaizmus	None
اليورو	euro	Nan
بإصدار	kibocsátására	Nan
بإضافة	hozzáadásával	Nan
بإطلاق	teljesen	None
بإعادة	újra	None
بإقامة	létrehozni	None
بإنتاج	produce	Nan
بإنشاء	létrehoz	Nan
بئر	jól	None
باب	ajtó	Nan
بابا	baba	Nan
بابل	babilon	Nan
بابن	egy fiú	Nan
بات	lett	None
باتجاه	felé	None
باحتلال	elfoglal	Nan
بإرسال	küld	Nan
باختلاف	eltérően	None
بإجراء	előadni	Nan
بأول	tovább	None
بأحد	bárkinek	Nan
بأداء	előadni	Nan
بأسلوب	olyan módon	Nan
بأسماء	nevekkel	Nan
بأشكال	formákban	Nan
بأعمال	művek	None
بأكثر	több	None
بأكمله	teljes	None
بألمانيا	németország	None
بأمر	sorrendben	None
بأن	hogy	None
بأنه	hogy ő	Nan
بأنها	úgy van	Nan
بأنهم	hogy vannak	Nan
بأوروبا	európában	None
بأي	bármilyen	None
بأبي	az apám	Nan
بادئ	a kezdeti	Nan
باديس	badis	Nan
باكو	baku	Nan
بالأرض	lapított	Nan
بالأمر	erről	None
بالإسكندرية	alexandriában	Nan
بالإسلام	az iszlámmal	Nan
بالإضافة	továbbá	None
بالإمكان	lehetséges	None
بالإنجليزية	angolul	None
بالاشتراك	közösen	None
بالبلاد	az országban	Nan
بالتالي	később	None
بالتجارة	kereskedelmi	None
بالتركية	törökül	Nan
بالتعاون	együttműködésben	Nan
بالجامعة	az egyetemen	Nan
باكستان	pakisztán	None
بادية	badia	Nan
باقي	maradék	None
باعتباره	mint a	Nan
بارتفاع	fel	None
بارد	menő	Nan
بارز	kiemelkedő	None
بارزة	jelentős	None
باريس	párizs	None
باستثناء	kivéve	None
باستخدام	használva	None
باستعمال	használata	None
باستقلال	függetlenül	None
باستمرار	folyamatosan	None
باسم	basim	Nan
باسمه	az ő nevében	Nan
باشا	pasa	Nan
باطن	talpak	Nan
باعتبار	figyelembe véve	Nan
باعتبارها	mint a	Nan
ب	b	Nan
اي	melyik	None
اهل	emberek	None
انبعاث	kibocsátás	Nan
انبعاثات	kibocsátások	Nan
انتخاب	választás	None
انتخابات	választások	None
انتخابه	az ő választása	Nan
انتخب	megválasztott	None
انتزاز	elkobzás	Nan
انتشار	terjedés	Nan
انتشارا	uralkodó	None
انتشاراً	uralkodó	None
انتشارها	terjedése	Nan
انتشارًا	előfordulás	Nan
انتشر	gomba	None
انتشرت	elterjedt	None
انتصار	győzelem	None
ان	hogy	None
انتصارات	győzelmek	Nan
امساخ	piszok	Nan
امتلكت	birtokom	Nan
اليوم	ma	None
اليومية	minden nap	Nan
اليونان	görögország	None
اليوناني	görög	None
اليونانية	görög	None
اليونانيون	a görögök	Nan
اليونانيين	görögök	None
اليونسكو	unesco	None
ام	anya	None
اما	ami	None
امام	előtt	None
امتد	terjedés	Nan
امتداد	kiterjesztés	Nan
امتدت	kinyújtott	Nan
امتصاص	abszorpció	Nan
امرأة	egy nőt	Nan
انتصر	megnyerte	None
انتفاضة	felkelés	None
انتقاد	kritika	None
انظر	néz	None
انعقاد	összehívása	Nan
انفجار	robbanás	None
انفصال	elválasztás	Nan
انقراض	kihalás	Nan
انقسام	hasított	Nan
انقطاع	félbeszakítás	Nan
انقلاب	puccs	Nan
انه	ez egy	Nan
انها	azt	None
انهم	hogy azok	Nan
انهيار	összeomlás	Nan
اهتم	vigyázz magadra	Nan
اهتمام	érdeklődés	None
اهتمامه	érdeklődése	None
انطلقت	elindította	Nan
انطلق	menj tovább	Nan
انضمت	csatlakozott	None
انضمام	összekötő	None
انتقادات	kritika	None
انتقال	átmenet	Nan
انتقالية	átmeneti	None
انتقد	kritizál	Nan
انتقل	elköltözött	Nan
انتقلت	elköltöztem	Nan
انتهاء	vég	Nan
اليورانيوم	uránium	Nan
انتهت	lejárt	Nan
انخفاض	csepp	Nan
انخفض	csökkent	None
انخفضت	csökkent	None
اندلعت	kitört	None
اندونيسيا	indonézia	None
انسحاب	visszavonás	Nan
انضم	csatlakozik	None
انتهى	vége	None
النموذج	minta	Nan
النمل	a hangyák	Nan
النمط	a minta	Nan
المناصب	pozíciók	Nan
المناطق	régiók	None
المناعة	immunitás	Nan
المناعي	immunfluoreszcenciás	Nan
المنافسة	a verseny	Nan
المناهج	tantervek	Nan
المناهضة	elleni	None
المنتج	a termék	Nan
المنتجات	termékek	None
المنتجة	készült	None
المنتخب	a választottak	Nan
المنتخبات	csapatok	None
المنتدى	fórum	None
المنتشرة	elszórt	Nan
المنتظر	várok	Nan
المناسبة	alkalom	None
المنخفضة	alacsony	None
المناسبات	alkalmak	Nan
المنازل	homes	Nan
الممالك	kingdoms	Nan
المماليك	mamelukok	Nan
الممتاز	kiváló	None
الممتدة	felöleli	Nan
الممتلكات	tulajdonságok	None
الممثل	a színész	Nan
الممثلة	színésznő	None
الممثلين	színészek	None
الممكن	lehetséges	None
المملكة	a királyság	Nan
المملوكي	mameluk	Nan
المملوكية	mameluk	Nan
المميزة	megkülönböztető	Nan
المناخ	az éghajlat	Nan
المناخية	éghajlati	None
المناسب	a megfelelő	Nan
الممارسة	gyakorlat	None
المندائية	mandai	Nan
المنزلي	belföldi	None
المهرجانات	fesztiválok	Nan
المهلهل	laza	None
المهم	a fontos	Nan
المهمة	a küldetés	Nan
المهنة	foglalkozása	Nan
المهندس	a mérnök	Nan
المهندسين	mérnökök	Nan
المهنية	szakmai	None
المواجهة	szembesítés	Nan
المواد	anyagok	None
الموارد	erőforrások	Nan
المواصلات	szállítás	Nan
المواضيع	témák	None
المواطن	polgár	None
المواطنين	állampolgárok	Nan
المهدي	a mahdi	Nan
المنزل	itthon	None
المهبل	hüvely	Nan
المهارات	szakértelem	Nan
المنزلية	háztartás	Nan
المنشآت	felszerelés	Nan
المنصب	a pozíció	Nan
المنصور	al-mansour	Nan
المنصورة	mansoura	Nan
المنطق	logika	None
المنطقة	vidék	None
المنظمات	szervezetek	None
المنظمة	a szervezet	Nan
المنعم	munim	Nan
المنفى	száműzetés	Nan
المنهج	tanterv	Nan
المنورة	medina	Nan
المنوية	sperma	Nan
المهاجرين	a bevándorlók	Nan
المهام	küldetés	None
الملوك	kings	Nan
الملوثة	szennyezett	Nan
الملوثات	szennyező anyagok	Nan
المفسرين	a tolmácsok	Nan
المفضلة	kedvenc	None
المفكرين	gondolkodók	None
المفهوم	megértett	Nan
المقابر	temetők	Nan
المقابل	a visszatérés	Nan
المقابلة	az interjú	Nan
المقارنة	összehasonlítás	Nan
المقاطعات	a tartományok	Nan
المقاطعة	bojkott	Nan
المقاعد	az ülések	Nan
المقال	a cikk	Nan
المقالات	cikkek	None
المقالة	cikk	None
المقام	a maqam	Nan
المفروضة	kiszabott	Nan
المقاومة	ellenállás	None
المفردات	szójegyzék	None
المفترض	feltételezte	Nan
المغاربة	marokkóiak	Nan
المغرب	marokkó, nyugat, naplemente	Nan
المغربي	marokkói	Nan
المغربية	marokkói	Nan
المغلقة	zárt	None
المغناطيس	mágnes	Nan
المغناطيسي	mágneses	None
المغناطيسية	mágnesesség	Nan
المغول	a mongolok	Nan
المغولي	mogul	Nan
المغولية	mongol	None
المفاتيح	a kulcsok	Nan
المفاعلات	reaktorok	Nan
المفاهيم	fogalmak	None
المفاوضات	tárgyalások	None
المفتوحة	nyisd ki	Nan
المقاييس	mérőszámok	Nan
المقدس	szent	None
المقدسة	szent	None
الملائكة	angyalok	None
الملابس	ruházat	Nan
الملاحة	navigáció	Nan
الملاحظات	megjegyzések	None
الملاحظة	megfigyelés	Nan
الملايو	maláj	None
الملايين	milliók	Nan
الملح	a só	Nan
الملعب	a stadion	Nan
الملفات	files	Nan
الملقب	álnév	Nan
الملك	a király	Nan
الملكة	a királynő	Nan
الملكي	királypárti	Nan
الملكية	ingatlan	Nan
المكي	mekkai	Nan
المكونة	összetevő	Nan
المكونات	a hozzávalók	Nan
المكون	összetevő	Nan
المقدسي	jeruzsálemi	None
المقدمة	bevezetés	None
المقدوني	macedon	Nan
المقر	központ	None
المقربين	közeliek	Nan
المقرر	döntés	None
المقصود	szándékolt	Nan
الموافق	megfelelő	None
المقيمين	lakosság	None
المكتب	az asztal	Nan
المكتبات	könyvtárak	None
المكتبة	a könyvtár	Nan
المكتوبة	írott	None
المكرمة	al mukarramah	Nan
المكسيك	mexikó	None
المكسيكية	mexikói	None
المكان	a hely	Nan
الموافقة	oké	Nan
المواقع	helyszínek	None
المواقف	pozíciók	Nan
النسبي	relatív	None
النسبية	relativitás	Nan
النسخ	átírás	Nan
النسخة	kiadás	None
النسق	elrendezés	Nan
النسيج	a szövet	Nan
النشأة	alapítvány	None
النشاط	tevékenység	None
النشاطات	a tevékenységek	Nan
النشر	kiadás	None
النشطة	aktív	None
النشيد	a himnusz	Nan
النص	szöveg	None
النصارى	keresztények	None
النصر	győzelem	None
النسبة	az arány	Nan
النصف	a fele	Nan
النسب	az arányok	Nan
النساء	nők	None
النجار	az ács	Nan
النجم	a csillag	Nan
النجوم	csillagok	None
النحاس	réz	None
النحت	sculpting	Nan
النحل	méhek	Nan
النحو	mint	None
النخبة	az elit	Nan
النخيل	tenyér	Nan
النرويج	norvégia	None
النرويجي	norvég	None
النرويجية	norvég	None
النزاع	összeütközés	Nan
النزاعات	konfliktusok	None
النزعة	tendencia	Nan
النسائية	feminista	Nan
النصوص	szövegek	Nan
النضر	nedvdús	Nan
النطاق	a tartomány	Nan
النقاد	a kritikusok	Nan
النقاط	pont	None
النقد	kritika	None
النقدي	készpénz	Nan
النقدية	készpénz	Nan
النقص	tökéletlenség	Nan
النقطة	a lényeg	Nan
النقل	szállítás	Nan
النقود	a pénz	Nan
النقيض	kontraszt	Nan
النماذج	összes	None
النمر	tigris	None
النمسا	ausztria	None
النمساوي	osztrák	None
النمساوية	osztrák	None
النفوس	souls	Nan
النفوذ	befolyás	None
النفقات	költségek	None
النفطية	olaj	None
النطق	kiejtés	Nan
النظام	a rendszer	Nan
النظامي	törzsvendégek	Nan
النظامية	a szisztémás	Nan
النظر	néz	None
النظرة	a megjelenés	Nan
النظريات	elméletek	None
النجاح	siker	None
النظرية	az elmélet	Nan
النعمان	kökörcsin	Nan
النفايات	pazarlás	Nan
النفس	maga	None
النفسي	pszichológiai	None
النفسية	szellemi	None
النفط	az olaj	Nan
النفطي	az olaj	Nan
النظير	peer	Nan
بالجزائر	algériában	Nan
النثر	próza	Nan
النتائج	eredmények	None
الموسيقار	zenész	None
الموسيقى	zene	None
الموسيقي	zene	None
الموسيقية	zenei	None
الموضوع	téma	None
الموضوعات	témakörök	Nan
الموظفين	alkalmazottak	Nan
الموقع	webhely	Nan
الموقف	helyzet	None
المولد	született	None
المولود	született	None
المولى	apamén	Nan
المياه	víz	None
الميت	halott	None
الميثاق	a charta	Nan
الموسوعة	enciklopédia	None
الميثان	metán	Nan
الموسمية	a szezonalitás	Nan
المورثة	gén	None
الموالية	pro	None
المواليد	újszülött	Nan
الموانئ	portok	Nan
الموت	a halál	Nan
الموتى	a halott	Nan
الموجات	hullámok	None
الموجة	a hullám	Nan
الموجهة	directed	Nan
الموجود	megtalált	Nan
الموجودة	létező	None
الموجي	hullámforma	Nan
الموجية	hullámforma	Nan
الموحد	összevont	Nan
الموحدة	alapértelmezett	Nan
الموحدين	unitáriusok	Nan
الموسم	évszak	None
الميدالية	az érmet	Nan
الميدان	terület	None
الميزانية	költségvetés	None
الناشئة	feltörekvő	Nan
الناصر	nasser	Nan
الناطقة	beszélő	None
الناطقين	hangszórók	Nan
النامية	fejlesztés	None
النبات	a növény	Nan
النباتات	a növények	Nan
النباتي	vegetáriánus	Nan
النباتية	vegetáriánus	Nan
النبلاء	a nemesek	Nan
النبوة	jóslat	Nan
النبوي	a próféta	Nan
النبوية	a próféta	Nan
النبي	a próféta	Nan
النبيذ	bor	None
الناس	emberek	None
النازية	fasizmus	Nan
النازي	náci	None
النارية	motorkerékpár	Nan
الميكانيكا	mechanika	Nan
الميكانيكية	mechanikai	None
الميلاد	karácsony	None
الميلادية	gergely	None
الميلاديين	hirdetés	Nan
الميناء	a kikötő	Nan
الميول	tendencies	Nan
النتيجة	az eredmény	Nan
الناتج	az eredményül	Nan
الناتو	nato	None
الناجحة	sikeres	None
الناجمة	okozott	None
الناحية	oldal	None
النادرة	ritka	None
النادي	a klub	Nan
النار	tűz	None
الناتجة	kapott	None
بالجنة	menny	Nan
بالحرب	a háborúval	Nan
بالحكم	ítélet alapján	Nan
بيوم	egy nap	Nan
بُني	brouwn	Nan
ت	t	Nan
تأثر	érintett	None
تأثرت	lenyűgözött	Nan
تأثير	hatás	None
تأثيرا	hatás	None
تأثيرات	hatások	None
تأثيره	hatása	None
تأثيرها	hatása	None
تأخذ	vesz	None
تأسس	alapított	None
تأسست	jött létre	Nan
تأسيس	létrehozó	Nan
تأسيسها	alapja	None
بيوت	házak	None
تأكيد	hangsúly	None
بينهما	közöttük	None
بينها	közöttük	None
بيبرس	peppers	Nan
بيت	ház	None
بيته	az ő háza	Nan
بيد	azonban	None
بيده	a kezével	Nan
بيروت	bejrút	Nan
بيعة	eladás	Nan
بيك	intés	Nan
بيكو	pico	Nan
بيكومتر	picometers	Nan
بيل	számla	Nan
بيليوس	peleus	Nan
بين	között	None
بينما	míg	None
بينه	bizonyíték	None
بينهم	közöttük	None
بيانات	adat	None
تأليف	írta	None
تأييد	támogatás	None
تبث	adás	Nan
تبدأ	rajt	Nan
تبدو	néz	None
تبرز	kiáll	Nan
تبع	követi	None
تبعا	attól függ	Nan
تبعد	el	None
تبقى	marad	None
تبلغ	jelentés	None
تبنت	fogadott	None
تبنى	örökbefogadás	Nan
تبني	örökbefogadás	Nan
تبوك	tabuk	Nan
تبين	kiderül	None
تتأثر	érintett	None
تبادل	csere	None
تأمين	biztosítás	Nan
تايوان	taiwan	Nan
تامة	pontosan	None
تؤثر	hatás	None
تؤدي	vezet	None
تؤكد	hangsúlyozza	Nan
تؤمن	hinni	Nan
تابع	kövesse	Nan
تابعة	alárendelt	Nan
تاج	korona	None
تاريخ	történelem	None
تاريخه	ez történelem	Nan
تاريخها	ez történelem	Nan
تاريخي	történelmi	None
تاريخيا	történelmileg	Nan
تاريخياً	történelmileg	Nan
تاريخية	történelmi	None
تاشفين	látod	Nan
تايمز	times	Nan
بيان	nyilatkozat	None
بيئة	környezet	None
بي	bennem	Nan
بنشر	kiadni	Nan
بنظام	rendszer	None
بنغازي	bengázi	Nan
بنفس	ugyanazzal	Nan
بنفسه	egyedül	None
بنفسها	egyedül	None
بنقل	átadó	Nan
بنك	bank	None
بنو	gyermekek	None
بنوع	olyasmi	Nan
بنى	brouwn	Nan
بني	brouwn	Nan
بنية	szerkezet	None
بنيت	épült	None
به	ezzel	None
بنسبة	arányban	None
بها	ki	None
بنزوين	benzoin	Nan
بنحو	ról ről	Nan
بممارسة	gyakorlat	None
بمناسبة	jelzés	Nan
بمنطقة	egy területen	Nan
بموجب	alatt	None
بن	a fia	Nan
بنا	kávébab	Nan
بناء	épület	None
بناءً	épület	None
بنائها	építsd meg	Nan
بنات	lányai	Nan
بناه	építők	Nan
بناها	építette	None
بنت	egy lány	Nan
بنتيجة	eredménnyel	None
بنجاح	sikeresen	None
بندر	hajlító	Nan
بهاء	baha	Nan
بهجوم	támadással	Nan
بهدف	céllal	None
بوصفها	mint a	Nan
بوضع	rakni	Nan
بوضوح	tisztán	None
بوقت	idővel	None
بوك	facebook	None
بول	pál	None
بولاية	állammal	Nan
بولس	pál	None
بولندا	lengyelország	None
بولينا	paulina	None
بومدين	boumediene	Nan
بونابرت	bonaparte	None
بونيقيون	pun	Nan
بوهيميا	csehország	None
بويع	eladás!	Nan
بوصفه	mint	None
بوش	bokor	Nan
بورصة	piac	None
بورسعيد	port said	Nan
بهذا	ezáltal	None
بهذه	ezzel	None
بهلوي	pahlavi	Nan
بهم	őket	None
بهما	velük	None
بو	bo	Nan
بوابات	gates	Nan
تتألف	tagjai:	Nan
بوابة	kapu	None
بواسطة	által	None
بوجه	arc	Nan
بوجود	ott	None
بوحدة	egyedül	None
بوذا	buddha	None
بور	bohr	Nan
بورتو	porto	None
بواس	boas	Nan
تتبع	vágány	Nan
تتجاوز	meghaladja	None
تتجمع	összejön	Nan
تخفيض	kedvezmény	Nan
تدار	irányított	None
تدخين	dohányzó	Nan
تدرس	tanult	None
تدريب	kiképzés	Nan
تدريجيا	fokozatosan	None
تدريجياً	fokozatosan	None
تدريجيًا	fokozatosan	None
تدعم	támogatás	None
تدعو	meghívottak	Nan
تدفع	te fizetsz	Nan
تدفق	folyam	Nan
تدل	jelöli	None
تدمير	megsemmisítés	Nan
تدهور	romló	Nan
تخطيط	tervezés	Nan
تدور	pörgés	Nan
تخضع	tantárgy	Nan
تخصص	különlegesség	Nan
تحكم	ellenőrzés	None
تحل	megoldva	Nan
تحليل	elemző	Nan
تحمل	csapágy	Nan
تحميل	letöltés	Nan
تحول	átalakítás	Nan
تحولت	fordult	None
تحوي	tartalmaz	None
تحويل	átalakítás	Nan
تحوّل	átalakítás	Nan
تحيط	körülvett	Nan
تختلف	különböző	None
تخدم	szolgál	None
تخرج	fokozatokra osztás	Nan
تخزين	tárolás	Nan
تخصيص	testreszab	Nan
تدوين	rekord	None
تدير	ő fut	Nan
تذكر	emlékezik	Nan
تركيا	pulyka	Nan
تركيب	telepítés	Nan
تركية	török	None
تركيز	fókusz	Nan
ترى	lát	None
تريد	akarsz	Nan
ترير	trier	Nan
تزال	még mindig	Nan
تزايد	növekedés	None
تزداد	minél több	Nan
تزوج	megházasodni	Nan
تزوجت	összeházasodtak	Nan
تزوجها	feleségül venni	Nan
تزيد	növekedés	None
تساعد	segítség	None
تركي	turki	Nan
تركها	hagyja	None
تركز	fókusz	Nan
تركت	bal	None
تراث	örökség	None
تراجع	visszavonulás	Nan
تراجعت	csukott	Nan
تراقيا	trákia	Nan
ترانسفيراز	transzferáz	Nan
تربة	talaj	None
تربط	csatlakozás	Nan
تحقيق	vizsgálat	None
تربية	oktatás	None
ترتفع	felmegy	Nan
ترتيب	rendelés	Nan
ترجع	visszatér	None
ترجم	fordít	Nan
ترجمة	fordítás	None
تردد	frekvencia	None
ترك	elhagy	Nan
ترتبط	összekapcsolt	Nan
بمكة	mekkában	Nan
تحقق	jelölje be	Nan
تحصل	szerezze	Nan
تتعلق	összefüggő	None
تتغذى	táplálkoznak	Nan
تتغير	változás	None
تتكون	készült	None
تتم	kész	None
تتمتع	élvezd	Nan
تتمثل	képviselt	None
تتمكن	tudsz	Nan
تتميز	jellemzi	None
تتناول	ételt	Nan
تتنوع	változatos	None
تتواجد	létezik	None
تتوفر	elérhető	None
تتوقف	álljon meg	Nan
تتيح	lehetővé teszi	Nan
تتعرض	kitett	Nan
تثبت	bizonyít	Nan
تتعامل	üzletelni	Nan
تتطلب	kíván	None
تتجه	cím	None
تتحدث	ő beszél	Nan
تتحرك	mozgó	None
تتحول	kiderül	None
تتخذ	vesz	None
تتدخل	közbenjár	Nan
تتراوح	hatótávolság	Nan
تتركز	sűrített	Nan
تتسبب	ok	None
تتسع	befogadható	Nan
تتسم	jellemzett	Nan
تتشابه	hasonló	None
تتشكل	alakított	None
تتصل	vonatkozik	None
تتضمن	magába foglalja	Nan
تتطور	fejlődik	None
تجار	kereskedők	None
تجارب	tapasztalatok	None
تجارة	kereskedelmi	None
تحتفظ	tartalékok	Nan
تحتل	occupy	Nan
تحتها	alatta	None
تحتوى	tartalmazza	None
تحتوي	tartalmazza	None
تحد	kihívás	Nan
تحدث	beszélgetés	None
تحدد	eltökélt	Nan
تحديث	frissítés	Nan
تحديد	határozzuk	Nan
تحرر	felszabadulás	Nan
تحرك	mozog	None
تحرير	kiadás	None
تحسن	javulás	Nan
تحسين	javulás	Nan
تحتاج	szükség	None
تحت	alatt	None
تحاول	próbáld	Nan
تحاميل	a kúpok	Nan
تجاري	kereskedelmi	None
تجارية	kereskedelmi	None
تجاه	felé	None
تجاوز	túlcsordulás	Nan
تجد	megtalálod	Nan
تجديد	megújítás	Nan
تجربة	kísérlet	None
تحظى	saját	None
تجري	megtörténik	Nan
تجمع	összejövetel	Nan
تجمعات	összejövetel	Nan
تجميع	összesítése	Nan
تجنب	elkerül	Nan
تجهيز	készítmény	Nan
تحافظ	tart	None
تحالف	szövetség	None
تجعل	készít	None
المعي	a bél	Nan
بمكان	egy helyen	Nan
بمعنى	jelentés	None
بحيرة	tó	None
بخار	gőz	Nan
بخصوص	vonatkozó	None
بخط	kézírásban	Nan
بخلاف	más mint	Nan
بد	kell	None
بدء	rajt	Nan
بدءا	kezdve	None
بدءاً	kezdve	None
بدءًا	kezdve	None
بدأ	látszik	None
بدأت	elkezdődött	None
بدا	látszik	None
بداخل	belsejében	None
بدايات	kezdetek	None
بحيرات	lakes	Nan
بداية	rajt	Nan
بحيث	amiben	None
بحوالي	ról ről	Nan
بجوار	mellett	None
بجيش	hadsereggel	Nan
بجيشه	a seregével	Nan
بحاجة	szükség	None
بحال	különben is	Nan
بحث	keresés	Nan
بحجة	vitatkozik	Nan
بحد	határ	None
بحر	tenger	None
بحري	tengeri	None
بحرية	ingyenes	None
بحسب	alapján	None
بحق	jobb	None
بحكم	erejénél fogva	Nan
بحلول	által	None
بحوث	kutatás	None
بجميع	mindenben	Nan
بدايتها	a kezdete	Nan
بدر	badr	Nan
برج	torony	None
برز	kiáll	Nan
برزت	felugrott	Nan
برسم	díj ellenében	Nan
برشلونة	barcelona	None
برعاية	válogatott	None
برفع	emelni	Nan
برقة	gyengéden	Nan
بركان	vulkán	None
بركة	tavacska	Nan
برلمان	parlament	None
برلمانية	parlamenti	None
برلين	berlin	None
برنامج	egy program	Nan
بروبيلين	propilén	None
براون	barna	None
بدخول	belép	Nan
براكودة	barracuda	Nan
بذلك	azzal	None
بدراسة	tanulmány	None
بدرجة	fokozat	None
بدعم	támogatott	None
بدفع	fizetni	None
بدقة	pontosan	None
بدلا	ahelyett	Nan
بدلاً	ahelyett	Nan
بدمشق	damaszkuszban	Nan
بدن	test	None
بدور	szerep	None
بدوره	viszont	None
بدورها	viszont	None
بدولة	egy országban	Nan
بدون	nélkül	None
بديلة	alternatív	None
برئاسة	fejes	Nan
بجمع	összegyűjti	Nan
بجعة	hattyú	Nan
بجانب	mellett	None
بالفرنسية	franciául	None
بالفشل	nem sikerült	Nan
بالفعل	valóban	None
بالقاهرة	kairóban	Nan
بالقدس	jeruzsálemben	Nan
بالقرب	közel	None
بالقوة	erővel	None
بالكثير	nagyon	None
باللاتينية	latinul	None
باللغات	rendelkezésre áll	Nan
باللغة	nyelven	None
بالله	istenben	Nan
باللون	színes	None
بالماء	vízzel	None
بالمدينة	városonként	Nan
بالغة	felnőtt	None
بالمرض	megbetegszik	Nan
بالغ	felnőtt	None
بالعمل	munkában	Nan
بالخط	sorban	None
بالخلافة	öröklés	Nan
بالدولة	az állam	Nan
بالذات	nagyon	None
بالذكر	megemlíteni	Nan
بالرغم	bár	None
بالسكان	benépesített	Nan
بالسنة	év	None
بالسيطرة	viselkedj	Nan
بالشكل	formában	None
بالطاقة	hajtású	Nan
بالعالم	a világban	Nan
بالعبرية	héberül	Nan
بالعديد	sok	None
بالعربية	arabul	Nan
بالعين	szemmel	None
بالمعنى	abban az értelemben	Nan
بالمغرب	marokkóban	Nan
بالمقابل	fordítva	None
بتطبيق	jelentkezés által	Nan
بتعيين	készlet	Nan
بتغيير	változás	None
بتقديم	beküldés	Nan
بتلك	azzal	None
بتنظيم	szervezett	None
بتنفيذ	végrehajtja	Nan
بتهمة	díjakkal	Nan
بتوجيه	irányítás alatt	Nan
بتونس	tunéziában	Nan
بث	adás	Nan
بثلاث	három	None
بثلاثة	hárman	Nan
بجائزة	díj	None
بجامعة	egyetemi	None
بتشكيل	formálisan	Nan
بتحويل	alakítani	Nan
بتاريخ	tovább	None
بتأسيس	alapított	None
بالمقارنة	ezt összehasonlítva	Nan
بالمملكة	a királyságban	Nan
بالمنطقة	a területen	Nan
بالمياه	vízzel	None
بالنسبة	ról ről	Nan
باليونانية	görögül	None
بان	tilalom	None
بروتوكول	jegyzőkönyv	Nan
باوني	záloghitelező	Nan
بايزيد	bajazid	Nan
ببساطة	egyszerűen	None
ببطء	lassan	None
ببطولة	hősiesen	Nan
ببعض	néhány	None
ببعضها	együtt	None
ببناء	szerkezetileg	Nan
باي	viszlát	Nan
بروتون	proton	Nan
بروز	kiemelkedés	Nan
بروسيا	poroszország	Nan
بقتله	megölni	Nan
بقدر	annyi	None
بقرار	döntéssel	Nan
بقعة	folt	Nan
بقلم	által	None
بقليل	egy kis	Nan
بقوة	erősen	None
بقوله	mondva	Nan
بقي	tartózkodott	None
بقيادة	által vezetett	Nan
بقية	pihenés	Nan
بقيت	maradt	None
بك|	ön |	Nan
بكتابة	írásban	None
بكتيريا	baktériumok	None
بقتل	ölni	Nan
بكثرة	bőségesen	Nan
بقايا	maradványok	Nan
بق	bogár	Nan
بعيدا	el	None
بعيداً	el	None
بعيدة	messze	None
بعين	szemmel	None
بغداد	bagdad	Nan
بغزو	megszállta	None
بغض	tekintet nélkül	Nan
بغير	hacsak	Nan
بـ	val vel	Nan
بفتح	nyisd ki	Nan
بفترة	egy darabig	Nan
بفضل	köszönet	Nan
بفعل	csinálva	Nan
بفكرة	egy ötlettel	Nan
بفيروس	vírussal	Nan
بقاء	túlélés	Nan
بكثير	sokkal	None
بكر	bakr	Nan
بكرة	henger	Nan
بلغت	találat	Nan
بلفور	balfour	Nan
بلقب	a címmel	Nan
بلقيس	belques	Nan
بليحائية	blahy	Nan
بما	beleértve	None
بمثابة	mint	None
بمجرد	egyszer	None
بمحمد	muhammad	Nan
بمختلف	eltérően	None
بمرض	megbetegszik	Nan
بمرور	elhalad	Nan
بمساعدة	segítségével	None
بمصر	egyiptomban	None
بمعدل	egy sebességgel	Nan
بلغة	egy nyelven	Nan
بلغاريا	bulgária	None
بلغ	megközelíthető	Nan
بلعمية	fagocitózis	Nan
بكل	mindenben	Nan
بكميات	mennyiségekben	Nan
بكونها	azáltal, hogy	Nan
بكين	peking	Nan
بل	de	None
بلا	nélkül	None
بلاد	országok	None
بعيد	messze	None
بلاده	unalom	Nan
بلاط	csempe	Nan
بلال	belal	Nan
بلجيكا	belgium	None
بلد	ország	None
بلدان	országok	None
بلدة	város	None
بلدية	község	None
بلادهم	az ő országuk	Nan
بمقدار	által	None
بعنوان	jogosult	Nan
بعمليات	tevékenységek	None
بشأن	ról ről	Nan
بشار	bashar	Nan
بشدة	súlyosan	None
بشر	emberi lények	Nan
بشراء	vásárolt	None
بشرط	azzal a feltétellel	Nan
بشركة	társasággal	Nan
بشري	emberi	None
بشرية	emberiség	None
بشكل	oly módon	Nan
بشيء	valamit	None
بشير	bashir	Nan
بصفة	mint	None
بصفته	mint az övé	Nan
بصورة	kép	None
بسيطة	egyszerű	None
بضرورة	parancsoló	Nan
بسيط	egyszerű	None
بسم	a nevében	Nan
بروسيلا	brucella	Nan
بروناي	brunei	Nan
بري	vad	None
برية	vadon	None
بريد	levél	None
بريشة	madártoll	Nan
بريطانيا	britannia	None
بريطانية	angol	None
بزعامة	által vezetett	Nan
بزيادة	fel	None
بزيارة	látogatás	Nan
بسبب	mivel	None
بسرطان	rák	None
بسرعة	gyorsan	None
بسط	kiterjeszt	Nan
بسهولة	könnyen	None
بضع	néhány	None
بضعة	néhány	None
بضم	kombinálásával	Nan
بعدم	nem az	Nan
بعدما	utána	None
بعده	utána	None
بعدها	azután	None
بعدهم	utánuk	Nan
بعرض	szélesség	Nan
بعض	néhány	None
بعضها	néhány közülük	Nan
بعضهم	néhány közülük	Nan
بعضهما	egymás	None
بعقد	szerződéssel	Nan
بعل	férj	None
بعلم	tudatosan	None
بعمر	egy életen át	Nan
بعمل	doing	Nan
بعدد	számban	None
بعدة	számos	None
بعد	távolság	None
بعثة	expedíció	None
بطاقات	kártyák	Nan
بطاقة	kártya	None
بطبيعة	természetesen	None
بطرس	péter	None
بطرق	bizonyos módon	Nan
بطريق	pingvin	Nan
بطريقة	oly módon	Nan
بعملية	művelet	None
بطل	egy hős	Nan
بطن	has	Nan
بطوطة	batuta	Nan
بطولات	bajnokságok	Nan
بطولة	bajnokság	None
بطيئة	lassú	None
بعام	egy év	Nan
بعث	ő küldte	Nan
بطليموس	ptolemaiosz	Nan
تساوي	egyenlő	None
المعهد	az intézet	Nan
المعنى	a jelentés	Nan
العوامل	tényezők	None
العود	a lant	Nan
العودة	vissza	None
العولمة	globalizáció	None
العيد	eid	Nan
العيش	élő	None
العين	szem	None
العينين	szemek	Nan
العيون	a szemek	Nan
الغابات	az erdők	Nan
الغابة	fák	None
الغاز	gáz	None
الغازات	gázok	None
الغازي	határsértő	Nan
الغالب	többnyire	None
العوام	a közemberek	Nan
الغالبية	a többség	Nan
العواصف	viharok	Nan
العنف	erőszak	None
العملاق	az óriás	Nan
العملاقة	az óriás	Nan
العملة	a valuta	Nan
العملي	gyakorlati	None
العمليات	eljárások	None
العملية	a művelet	Nan
العمود	oszlop	None
العموم	a commons	Nan
العمومية	általánosság	Nan
العميق	mélység	Nan
العميقة	mély	None
العناصر	elements	Nan
العناية	gondoskodás	Nan
العنب	szőlő	None
العنصر	elem	None
العهد	a szövetség	Nan
العمل	a munka	Nan
الغبار	a por	Nan
الغذاء	étel	None
الغني	a gazdagok	Nan
الغنية	gazdag	None
الغير	egyéb	None
الـ	a	None
الفئات	kategóriák	Nan
الفئة	kategória	None
الفائدة	haszon	Nan
الفائز	győztes	None
الفاتح	al fateh	Nan
الفاتحة	al-fatiha	Nan
الفاتيكان	vatikán	None
الفارابي	al-farabi	Nan
الفارسي	perzsa	None
الفارسية	perzsa	None
الفاشية	fasizmus	Nan
الغموض	rejtély	None
الغدد	nyálmirigyek	Nan
الغليون	pipa	Nan
الغلاف	borító	None
الغذائي	étel	None
الغذائية	étel	None
الغرب	a nyugat	Nan
الغربي	nyugati	None
الغربية	nyugati	None
الغربيين	nyugatiak	Nan
الغرض	a cél	Nan
الغرفة	a szoba	Nan
الغزاة	a betolakodók	Nan
الغزالي	al-ghazali	Nan
الغزل	fonás	Nan
الغزو	az invázió	Nan
الغزوات	inváziók	Nan
الغشاء	a membrán	Nan
الغطاء	a fedél	Nan
الغلوكوز	szőlőcukor	Nan
العمق	mélység	Nan
العمري	al-omari	Nan
العمرة	umrah	Nan
العصبي	ideges	Nan
العصبية	idegesség	Nan
العصر	kor	None
العصور	a korok	Nan
العضلات	az izmok	Nan
العضو	a tag	Nan
العضوية	tagság	Nan
العطل	ünnepek	None
العظام	bones	Nan
العظم	a csont	Nan
العظمى	nagy	None
العظمي	a csontváz	Nan
العظيم	a nagy	Nan
العظيمة	nagy	None
العفو	bocsánat	Nan
العصابات	bandák	Nan
العقائد	tanok	Nan
العشرينات	húszas évek	Nan
العشرة	a tíz	Nan
العرقي	etnikai	None
العرقية	etnikai	None
العروض	ajánlatok	Nan
العريضة	a petíció	Nan
العريقة	ősi	None
العزيز	kedves	None
العسكر	a katonaság	Nan
العسكري	a katonaság	Nan
العسكرية	katonai	None
العسكريين	a katonaság	Nan
العسل	édesem	Nan
العش	a fészek	Nan
العشاء	a vacsora	Nan
العشائر	klánok	Nan
العشر	a tíz	Nan
العشرين	húsz	None
العقائدية	dogmatikus	Nan
العقاد	akkád	Nan
العقبة	az akadály	Nan
العلمي	tudományos	None
العلمية	tudományos	None
العلوم	sciences	Nan
العلوي	felső	None
العلوية	felső	None
العلويين	alaviták	Nan
العلي	a legmagasabb	Nan
العمارة	építészet	None
العمال	munkások	None
العمالة	foglalkoztatás	Nan
العمالية	munkaerő	None
العمر	kor	None
العمران	urbanisztikai	Nan
العمراني	városi	None
العمرانية	urbanisztikai	Nan
العلمانية	szekularizmus	Nan
العلماء	a tudósok	Nan
العلم	tudomány	None
العلل	csapás	None
العقد	szerződés	None
العقل	az elme	Nan
العقلي	szellemi	None
العقلية	szellemi	None
العقوبات	szankciók	Nan
العقود	szerződések	Nan
العقول	agyvelő	Nan
الفاصل	az elválasztó	Nan
العقيد	ezredes	None
العكس	az ellenkező	Nan
العلاء	a magasság	Nan
العلاج	kezelés	None
العلاجية	gyógyhatású	Nan
العلاقات	kapcsolatok	None
العلاقة	kapcsolat	None
العلامة	márka	Nan
العقيدة	hitvallás	Nan
العرق	izzad	Nan
الفاطمي	fatimid	Nan
الفاطميين	a fatimidek	Nan
الفهم	megértés	Nan
الفوائد	az előnyök	Nan
الفور	a helyszínen	Nan
الفوز	a győzelem	Nan
الفوضى	káosz	Nan
الفولاذ	acél	None
الفوهات	fúvókák	Nan
الفيدرالي	szövetségi	None
الفيدرالية	föderalizmus	Nan
الفيديو	a videó	Nan
الفيروس	a vírus	Nan
الفيروسات	vírusok	None
الفيروسي	vírusos	Nan
الفيروسية	vírusos	Nan
الفيزياء	fizika	None
الفهد	gepárd	Nan
الفيزيائية	fizikai	None
الفنية	művészeti	None
الفنون	arts	Nan
الفلسفي	filozófiai	None
الفلسفية	filozófiai	None
الفلك	csillagászat	None
الفلكي	csillagász	None
الفلكية	csillagászati	None
الفلكيون	a csillagászok	Nan
الفلم	a film	Nan
الفم	a száj	Nan
الفن	a művészet	Nan
الفنادق	szállodák	Nan
الفنان	a művész	Nan
الفنانة	a művész	Nan
الفنانين	művészek	None
الفنلندي	finn	None
الفنلندية	finn	None
الفني	alkotás	None
الفلسفة	filozófia	None
الفيس	elvis	None
الفيضانات	árvizek	Nan
القاعدة	al-kaida	Nan
القانون	törvény	None
القانوني	jogi	None
القانونية	jogi	None
القبائل	törzsek	None
القبة	a kupola	Nan
القبر	sír	Nan
القبض	elfogott	Nan
القبطي	kopt	Nan
القبطية	kopt	Nan
القبلة	a csók	Nan
القبلي	törzsi	None
القبول	felvételi	None
القبيلة	a törzs	Nan
القتال	harcoló	None
القاضي	a bíró	Nan
الفيضان	az áradás	Nan
القاسم	a nevező	Nan
القارة	a kontinens	Nan
الفيفا	fifa	None
الفيل	az elefánt	Nan
الفيلة	az elefántok	Nan
الفيلسوف	filozófus	None
الفيلم	a film	Nan
الفينيقية	föníciai	Nan
القائد	vezető	None
القائلة	mondás	Nan
القائم	székhelyű	Nan
القائمة	a lista	Nan
القادم	következő	None
القادمة	eljövetel	Nan
القادمين	eljövetel	Nan
القارئ	az olvasó	Nan
القارات	kontinensek	Nan
القارية	kontinentális	None
الفلسطينيين	palesztinok	Nan
الفلسطينيون	a palesztinok	Nan
الفلسطينية	palesztin	None
الفرد	az egyén	Nan
الفردي	egyedülállók	Nan
الفردية	egyedi	None
الفرس	a perzsa	Nan
الفرسان	knights	Nan
الفرصة	a lehetőség	Nan
الفرع	az ág	Nan
الفرعونية	fáraók	Nan
الفرعية	alatti	None
الفرق	a különbség	Nan
الفرقة	a zenekar	Nan
الفرن	a sütő	Nan
الفرنجة	a frank	Nan
الفرنسي	a francia	Nan
الفرنسية	francia	None
الفرج	szeméremajak	Nan
الفرنسيون	a francia	Nan
الفراغ	üres	None
الفراش	az ágynemű	Nan
الفتاة	a lány	Nan
الفتح	a hódítás	Nan
الفترات	időszakok	Nan
الفترة	időszak	None
الفتنة	viszály	Nan
الفتوح	al-futouh	Nan
الفتوحات	hódítások	Nan
الفجر	pirkadat	Nan
الفجوة	rés	Nan
الفحص	vizsgálat	None
الفحم	szén	None
الفخار	fazekasság	Nan
الفدرالي	szövetségi	None
الفدرالية	föderalizmus	Nan
الفرات	eufrátesz	Nan
الفراعنة	fáraók	Nan
الفرنسيين	a francia	Nan
الفروع	ágak	Nan
الفريدة	egyedi	None
الفقري	gerinc	Nan
الفقه	jogtudomány	Nan
الفقهاء	jogászok	Nan
الفقهية	jogtudomány	Nan
الفقيرة	szegény	None
الفقيه	faqih	Nan
الفكر	gondolat	None
الفكرة	az ötlet	Nan
الفكري	szellemi	None
الفكرية	szellemi	None
الفلاحين	parasztok	None
الفلاسفة	filozófusok	None
الفلبين	fülöp-szigetek	Nan
الفلبينية	filippínó	Nan
الفلسطيني	palesztin	None
الفقراء	a szegények	Nan
الفقر	szegénység	None
الفعلية	az aktuális	Nan
الفعلي	az aktuális	Nan
الفريق	a csapat	Nan
الفريقان	a két csapat	Nan
الفريقين	a két csapat	Nan
الفساد	vesztegetés	Nan
الفصائل	a frakciók	Nan
الفصح	húsvéti	None
الفصحى	klasszikus	None
الفاطمية	fatimidism	Nan
الفصل	a tanterem	Nan
الفضائي	idegen	None
الفضائية	műhold	Nan
الفضة	ezüst	None
الفضل	favor	Nan
الفطر	gomba	None
الفعالة	hatékony	None
الفعل	ige	None
الفضاء	az űr	Nan
العرض	kijelző	Nan
العرش	a trón	Nan
العربية	arab	None
الصحابة	társak	Nan
الصحابي	társ	Nan
الصحاري	megérdemelt jutalom vagy büntetés	Nan
الصحافة	a sajtó	Nan
الصحة	az egészség	Nan
الصحراء	a sivatag	Nan
الصحراوي	sivatag	Nan
الصحراوية	sivatag	Nan
الصحف	újságok	None
الصحفي	újságíró	None
الصحفيين	újságírók	None
الصحية	egészség	Nan
الصحيح	a helyes	Nan
الصخرة	a szikla	Nan
الصخري	sziklás	Nan
الصباح	a reggel	Nan
الصخرية	sziklás	Nan
الصالحة	az igazak	Nan
الصادق	őszinte	Nan
الشيخة	sheikha	Nan
الشيطان	gonosz	None
الشيعة	shia	Nan
الشيعي	síita	None
الشيعية	síita	None
الشيوخ	az idősebbek	Nan
الشيوعي	kommunista	None
الشيوعية	kommunizmus	None
الشيوعيين	kommunisták	None
الصابئة	sabeans	Nan
الصابئي	sabean	Nan
الصابون	a szappan	Nan
الصادر	induló	None
الصادرات	az export	Nan
الصادرة	kiadott	None
الصالح	a jó	Nan
الشيخ	a sheik	Nan
الصخور	rocks	Nan
الصدد	kapcsolat	None
الصفراء	sárga	None
الصفويين	a szafavidok	Nan
الصلاة	ima	Nan
الصلال	elrejti	Nan
الصلب	acél	None
الصلبة	szilárd	None
الصلة	a kapcsolat	Nan
الصلح	egyeztetés	Nan
الصلوات	imák	Nan
الصليب	kereszt	None
الصليبي	a keresztes	Nan
الصليبية	keresztes lovag	Nan
الصليبيون	a keresztesek	Nan
الصليبيين	crusaders	Nan
الصناعات	industries	Nan
الصفر	nulla	None
الصداقة	a barátság	Nan
الصفحة	az oldal	Nan
الصفا	al-safa	Nan
الصدر	a mellkas	Nan
الصدري	mellkasi	Nan
الصديق	a barát	Nan
الصراع	összeütközés	Nan
الصراعات	konfliktusok	None
الصرب	szerbek	None
الصرف	csere	None
الصعب	nehéz	None
الصعيد	felső egyiptom	Nan
الصغار	kisgyerekek	Nan
الصغر	finom	None
الصغرى	micro	Nan
الصغير	kis	None
الصغيرة	kicsi	None
الصف	osztály	None
الصفة	melléknév	None
الشيء	a dolog	Nan
الشورى	sura	Nan
الشواطئ	strandok	Nan
الشبه	hasonlóság	Nan
الشتاء	téli	None
الشجاعة	bátorság	Nan
الشجرة	a fa	Nan
الشحنات	szállítások	Nan
الشحنة	a szállítmány	Nan
الشخص	a személy	Nan
الشخصي	profil	Nan
الشخصيات	karakterek	None
الشخصية	személyes	None
الشديد	szigorú	None
الشديدة	szigorú	None
الشذوذ	rendellenességek	Nan
الشر	gonosz	None
الشرائية	beszerzési	Nan
الشبكة	a hálózat	Nan
الشرط	az állapot	Nan
الشبكات	networks	Nan
الشاي	tea	None
الشأن	az ügyet	Nan
الشؤون	ügyek	None
الشائع	gyakori	None
الشائعة	gyakori	None
الشابي	a fiatal ember	Nan
الشارع	az utca	Nan
الشاشة	a képernyőn	Nan
الشاطئ	a strand	Nan
الشاعر	költő	None
الشافعي	al-shafii	Nan
الشام	ál	Nan
الشامل	tömeg	None
الشامي	shami	Nan
الشامية	a levantine	Nan
الشاه	a sah	Nan
الشباب	fiatal	None
الشرطة	a rendőrség	Nan
الشرعي	jogos	Nan
الشرعية	törvényesség	Nan
الشك	kétség	Nan
الشكل	a forma	Nan
الشكوك	kétségek	Nan
الشمال	északi	None
الشمالي	északi	None
الشمالية	északi	None
الشمس	a nap	Nan
الشمسية	nap	None
الشهادة	bizonyítvány	Nan
الشهداء	a mártírok	Nan
الشهر	a hónap	Nan
الشهيد	mártír	Nan
الشهير	híres	None
الشهيرة	híres	None
الشوارع	streets	Nan
الشفاء	gyógyulás	Nan
الشعور	érzés	None
الشعرية	tészta	Nan
الشعراوي	shaarawy	Nan
الشرف	becsület	Nan
الشرق	kelet	None
الشرقي	keleti	None
الشرقية	keleti	None
الشرك	politeizmus	Nan
الشركات	cégek	None
الشركة	a cég	Nan
الصناعة	ipar	None
الشروط	a feltételek	Nan
الشطرنج	sakk	None
الشعار	a logó	Nan
الشعب	az emberek	Nan
الشعبي	népi	None
الشعبية	népszerű	None
الشعر	haj	Nan
الشعراء	költők	None
الشريعة	iszlám törvény	Nan
الصناعي	ipari	None
الصناعية	ipari	None
الصنع	készült	None
العادل	becsületes	None
العادي	rendes	None
العادية	szabályos	None
العاشر	a tizedik	Nan
العاشرة	tizedik	None
العاص	az aas	Nan
العاصمة	főváros	None
العالم	a világ	Nan
العالمي	globális	None
العالمية	globalizmus	Nan
العالمين	worlds	Nan
العالي	magasabb	None
العالية	magas	None
العام	év	None
العامة	a nyilvánosság	Nan
العادة	szokás	None
العامل	a munkás	Nan
العادات	szokások	None
العائلة	a család	Nan
الطيب	a jó	Nan
الطيران	repülés	None
الطيف	színkép	Nan
الطين	agyag	Nan
الطيور	a madarak	Nan
الظاهر	látszólagos	None
الظاهرة	jelenség	None
الظاهري	tényleges	None
الظروف	körülmények	None
الظلام	a sötétség	Nan
الظلم	igazságtalanság	Nan
الظهر	dél	None
الظهور	feltűnik	None
الظواهر	jelenségek	None
العائلات	családok	None
العابدين	worshipers	Nan
العاملة	dolgozó	None
العاملين	személyzet	None
العامية	nemzeti nyelv	Nan
العدالة	igazságszolgáltatás	None
العدد	a szám	Nan
العدل	igazságszolgáltatás	None
العدو	az ellenség	Nan
العدوان	agresszió	Nan
العدوى	fertőzés	None
العديد	sok	None
العديدة	számos	None
العذبة	friss	None
العذراء	szűz	None
العراق	irak	Nan
العراقية	iraki	None
العراقيين	irakiak	Nan
العرب	az arabok	Nan
العربي	arabi	Nan
العجز	impotencia	Nan
العثور	megtalálja	Nan
العثمانيين	a török	Nan
العثمانيون	a török	Nan
العامّة	a nyilvánosság	Nan
العباد	alkalmazottaira	Nan
العبادات	imádat	Nan
العبادة	imádat	Nan
العبارة	kifejezés	None
العباس	abbas	Nan
العباسي	abbasid	Nan
الطويلة	a hosszú	Nan
العباسية	abbasid	Nan
العباسيين	az abbasids	Nan
العبد	a cseléd	Nan
العبرية	héber	None
العبودية	rabszolgaság	Nan
العبّاسية	abbassieh	Nan
العثماني	török	None
العثمانية	török	None
العباسيون	az abbasids	Nan
القتالية	harc	None
الطويل	a hosszú	Nan
الطور	fázis	None
الصينيين	a kínaiak	Nan
الضارة	káros	None
الضباط	a tisztek	Nan
الضحايا	az áldozatok	Nan
الضحية	az áldozat	Nan
الضخم	a hatalmas	Nan
الضخمة	mega	Nan
الضرائب	adók	None
الضربة	a találat	Nan
الضروري	a szükséges	Nan
الضعف	gyengeség	Nan
الضغط	nyomás	None
الضغوط	nyomás	None
الضفة	a bank	Nan
الضوء	a fény	Nan
الصينيون	kínai	None
الضوئي	fotoszintézis	Nan
الصينية	kínai	None
الصين	kína	None
الصهيوني	cionista	Nan
الصهيونية	cionizmus	Nan
الصواريخ	rakéták	Nan
الصوت	a hang	Nan
الصوتية	szonikus	Nan
الصور	képek	None
الصورة	kép	None
الصوفية	sufism	Nan
الصوم	böjtölés	Nan
الصومال	szomáliában	Nan
الصومالي	szomáliai	Nan
الصومالية	szomáliai	Nan
الصيد	vadászat	None
الصيف	a nyár	Nan
الصيفية	nyár	None
الصيني	kínai	None
الضوئية	közlekedési lámpa	Nan
الطائرات	planes	Nan
الطائرة	a repülő	Nan
الطراز	stílus	None
الطرف	buli	Nan
الطرفين	a két fél	Nan
الطرق	utakon	Nan
الطريق	az út	Nan
الطريقة	út	None
الطعام	étel	None
الطفل	gyermek	None
الطفولة	gyermekkor	Nan
الطقس	időjárás	None
الطقوس	rituálék	Nan
الطلاب	a diákok	Nan
الطلب	a kereslet	Nan
الطلبة	diákok	None
الطوائف	szekták	Nan
الطرائد	játszma, meccs	Nan
الطبيعية	természetes	None
الطبيعي	természetes	None
الطبيعة	természet	None
الطائف	taif	Nan
الطائفة	szekta	Nan
الطابع	karakter	None
الطابق	padló	Nan
الطاعون	a pestis	Nan
الطاقة	energia	None
الطالب	kérelmező	Nan
الطول	hossz	Nan
الطب	gyógyszer	None
الطباعة	nyomtatás	None
الطبري	al-tabari	Nan
الطبعة	kiadás	None
الطبقة	osztály	None
الطبي	orvosi	None
الطبيب	az orvos	Nan
الطبية	orvosi	None
الطباشيري	krétaszerű	Nan
القتل	az ölés	Nan
القتلى	a halott	Nan
القدامى	old-timer	Nan
المدنيين	civilek	Nan
المدونات	blogolás	Nan
المدونة	blog	None
المدى	kifejezés	None
المديح	dicséret	Nan
المدير	menedzser	Nan
المدينة	város	None
المذاهب	tanok	Nan
المذكور	említett	None
المذكورة	említett	None
المذنبات	üstökösök	Nan
المذهب	megnevezés	None
المرء	a saját	Nan
المرأة	nő	None
المرئي	látható	None
المدنية	polgári	None
المرابطين	az almoravids	Nan
المدني	polgári	None
المدفعية	tüzérségi	None
المخصص	lekötött	Nan
المخصصة	kijelölt	None
المخطط	a séma	Nan
المخطوطات	a kéziratok	Nan
المخلص	megmentő	Nan
المخلوقات	creatures	Nan
المد	kiterjesztés	Nan
المدارس	iskolák	None
المداري	orbital	Nan
المدارية	tropikus	Nan
المدافع	az ágyúk	Nan
المدة	tartam	Nan
المدرب	az edző	Nan
المدرسة	az iskola	Nan
المدرعة	páncélozott jármű	Nan
المدن	a városok	Nan
المخرج	rendező	None
المراجع	irodalom	None
المراد	lenni	None
المركزي	központi	None
المركزية	központi	None
المرمى	a cél	Nan
المرور	a forgalom	Nan
المريخ	mars	None
المريض	türelmes	Nan
المزارعون	a gazdák	Nan
المزارعين	a mezőgazdasági termelők	Nan
المزروعة	művelt	None
المزيد	több	None
المسألة	az ügyet	Nan
المسؤول	adminisztrátor	Nan
المسؤولة	felelős	None
المسؤولية	a felelősség	Nan
المسؤولين	felelős	None
المركز	központ	None
المراحل	szakasz	None
المركبة	a jármű	Nan
المركب	a vegyület	Nan
المرافق	kísérő	Nan
المراقبة	néz	None
المراكز	központok	Nan
المرة	idő	None
المرتبة	rang	Nan
المرتبط	összekapcsolt	Nan
المرتبطة	társult, összekapcsolt, társított valamivel	Nan
المرتفع	a magasság	Nan
المرتفعات	highlands	Nan
المرتفعة	magas	None
المرجانية	korall	Nan
المرحلة	színpad	Nan
المرشد	vezető	None
المرض	a betegség	Nan
المرضى	a betegek	Nan
المركبات	járművek	None
المخدرات	a drog	Nan
المختلفة	különböző	None
المختصة	illetékes	Nan
المثلثات	háromszögek	Nan
المثلية	homeopátia	Nan
المثليين	a homoszexuálisok	Nan
المجاعة	éhezés	Nan
المجال	területén	None
المجالات	domains	Nan
المجالس	tanácsok	None
المجاهدين	mudzsahedin	Nan
المجاورة	szomszédos	None
المجتمع	a társadalom	Nan
المجتمعات	societies	Nan
المجر	magyarország	None
المجرات	galaxies	Nan
المجرة	a galaxis	Nan
المجردة	meztelen	None
المثلث	a háromszög	Nan
المجري	magyar	None
المثل	közmondás	Nan
المتوكل	al-mutawakkil	Nan
المتعددة	multiplayer	Nan
المتعلقة	összefüggő	None
المتقدم	fejlett	None
المتقدمة	fejlett	None
المتكاملة	integrált	Nan
المتمثلة	képviselt	None
المتميزة	kiemelkedő	None
المتنبي	mutanabbi	Nan
المتنوعة	vegyes	None
المتواجدة	elérhető	None
المتوسط	az átlagos	Nan
المتوسطة	közepes	None
المتوفرة	elérhető	None
المتوفى	halott	None
المتوقع	várt	None
المثال	példa	None
المجرية	magyar	None
المجلات	magazinok	Nan
المجلة	a magazin	Nan
المحطات	állomások	Nan
المحطة	az állomás	Nan
المحكمة	a bíróság	Nan
المحلة	mahalla	Nan
المحلي	a helyi	Nan
المحلية	helyi	None
المحليين	a helyiek	Nan
المحور	az agy	Nan
المحيط	óceán	None
المحيطات	oceans	Nan
المحيطة	környező	None
المخ	az agy	Nan
المخاطر	kockázatok	Nan
المخاوف	félelmek	Nan
المختار	a kiválasztott	Nan
المحسن	továbbfejlesztett	Nan
المحركات	motors	Nan
المحرك	a motor	Nan
المحرقة	holocaust	None
المجلس	a tanács	Nan
المجمع	a komplexum	Nan
المجموع	teljes	None
المجموعات	csoportok	None
المجموعة	a csoport	Nan
المجيد	dicső	Nan
المحاسبة	könyvelés	Nan
المساء	este	None
المحاصيل	növények	None
المحافظة	kormányzóság	Nan
المحاولات	kísérletek	None
المحاولة	megpróbálni	Nan
المحبة	szeretet	None
المحتلة	megszállt	None
المحتمل	valószínűleg	None
المحدودة	kft	None
المحافظات	tartományok	None
المسائل	ügyekben	Nan
المسابقات	versenyek	Nan
المسابقة	verseny	None
المطلب	követelmény	Nan
المطلة	a felni	Nan
المطلق	az abszolút	Nan
المطلقة	elvált	Nan
المطلوب	kívánt	None
المطلوبة	kívánt	None
المطيرة	esőerdő	Nan
المظاهرات	bemutatók	Nan
المظلمة	sötét	None
المعابد	templomok	None
المعادن	ásványok	Nan
المعادية	ellenséges	None
المعارض	bemutatók	Nan
المعارضة	az ellenzék	Nan
المعارضين	ellenfelek	Nan
المطر	az eső	Nan
المعارف	tudás	None
المطبخ	a konyha	Nan
المطاعم	éttermek	Nan
المصانع	gyárak	Nan
المصحف	a korán	Nan
المصدر	forrás	None
المصري	az egyiptomi	Nan
المصرية	egyiptomi	None
المصريون	az egyiptomiak	Nan
المصريين	az egyiptomiak	Nan
المصطلح	kifejezés	None
المصطلحات	terminológia	Nan
المضاد	ellentámadás	Nan
المضادة	ellenintézkedések	Nan
المضيف	a gazda	Nan
المضيفة	hosztesz	Nan
المطار	a repülőtér	Nan
المطارات	repülőterek	None
المطاف	vége	None
المعارك	a harcok	Nan
المعاصر	kortárs	None
المعاصرة	kortárs	None
المعرفة	tudás	None
المعرفي	megismerő	Nan
المعرفية	megismerő	Nan
المعركة	a csata	Nan
المعروف	ismert	None
المعروفة	ismert	None
المعري	maari	Nan
المعز	kecskék	Nan
المعسكر	a tábor	Nan
المعقدة	összetett	None
المعلم	a tanár	Nan
المعلمين	tanárok	Nan
المعلومات	az információ	Nan
المعماري	az építész	Nan
المعمارية	építészeti	None
المعرض	a show	Nan
المعدية	fertőző	None
المعدنية	ásványi	None
المعدلة	módosított	None
المعاصرين	contemporaries	Nan
المعالم	mérföldkövek	Nan
المعاني	jelentésük	Nan
المعاهد	intézetek	Nan
المعاهدات	szerződések	Nan
المعاهدة	szerződés	None
المعايير	szabványok	Nan
المصالح	interests	Nan
المعبد	a templom	Nan
المعتزلة	mu&#39;tazilah	Nan
المعتقدات	hitek	Nan
المعتمد	jóváhagyott	Nan
المعتمدة	jóváhagyott	Nan
المعدات	hardver	Nan
المعدة	gyomor	None
المعدل	az átlagos	Nan
المعتدل	mérsékelt	None
المتعة	öröm	Nan
المصارف	banks	Nan
المصاحف	a korán	Nan
المستعمرة	a gyarmat	Nan
المستعملة	használt	None
المستقبل	a jövő	Nan
المستقبلية	jövő	None
المستقلة	független	None
المستمر	folyamatos	None
المستمرة	kitartó	Nan
المستوطنات	települések	None
المستوى	a szint	Nan
المستويات	levels	Nan
المسجد	a mecset	Nan
المسرح	a színház	Nan
المسرحي	színházi	None
المسرحيات	plays	Nan
المسرحية	a játék	Nan
المستعمرات	a telepeket	Nan
المسلح	a fegyver	Nan
المستشفيات	kórházak	Nan
المستشار	advisor	Nan
المساجد	mecsetek	Nan
المساحة	az űr	Nan
المساعدات	támogatás	None
المساعدة	segítség	None
المسافات	távolságok	Nan
المسافة	távolság	None
المساكن	ház	None
المساهمة	hozzájárulás	Nan
المساواة	egyenlőség	None
المسبار	a szonda	Nan
المسببة	okozó	None
المستخدم	a felhasználó	Nan
المستخدمة	használt	None
المستخدمين	felhasználók	None
المستدامة	fenntartható	Nan
المستشفى	a kórház	Nan
المسلحة	fegyveres	None
المسلسل	a sorozat	Nan
المسلسلات	sorozat	None
المشركين	a politikusok	Nan
المشروبات	italok	None
المشروع	a projekt	Nan
المشروعات	projektek	Nan
المشعة	radioaktív	None
المشكلات	a problémák	Nan
المشكلة	a probléma	Nan
المشهد	a jelenet	Nan
المشهور	a híres	Nan
المشهورة	híres	None
المشهورين	híres	None
المشير	tábornagy	Nan
المصاب	a sérült	Nan
المصابة	fertőzött	None
المصابين	a sérült	Nan
المشرفة	a felügyelő	Nan
المشتري	vásárló	Nan
المشترى	vevő	None
المشتركة	közös	None
المسلمة	posztulátum	Nan
المسلمون	muszlimok	None
المسلمين	muszlimok	None
المسمى	nevezett	None
المسيحي	keresztény	None
المسيحية	kereszténység	None
المسيحيون	keresztények	None
المصادر	források	None
المسيحيين	keresztények	None
المشاركة	részt venni	Nan
المشاركين	résztvevők	None
المشاريع	projektek	Nan
المشاعر	érzések	Nan
المشاكل	problémák	None
المشاهد	a néző	Nan
المشترك	előfizető	Nan
المشاة	gyalogosok	Nan
المعنية	az érintett	Nan
المتطورة	élvonalbeli	Nan
المتزايد	növekvő	None
القومية	nacionalizmus	None
القوى	powers	Nan
القوي	az erős	Nan
القوية	megsimogatta	Nan
القيادة	vezetés	None
القياس	az analógia	Nan
القياسي	alapértelmezett	Nan
القياسية	alapértelmezett	Nan
القيام	az előadás	Nan
القيامة	feltámadás	Nan
القيروان	kairouan	Nan
القيس	mérés	Nan
القيصر	a cesár	Nan
القيم	érték	Nan
القيمة	az érték	Nan
القومي	a nemzeti	Nan
القيود	korlátozások	Nan
القوم	népi	None
القوقاز	kaukázus	None
القمح	búza	None
القمر	a hold	Nan
القمرية	hold	None
القمني	csúcs	Nan
القنابل	a bombák	Nan
القناة	a csatorna	Nan
القنوات	csatornák	None
القهري	kényszeres	Nan
القوائم	list	Nan
القوات	erők	None
القواعد	a szabályok	Nan
القوافل	konvojok	Nan
القوانين	törvények	None
القوس	az ív, az íj	Nan
القوط	a góták	Nan
القول	mondani	None
القمة	a csúcs	Nan
الكأس	a kupa	Nan
الكائنات	lények	None
الكثافة	sűrűség	None
الكثير	sok	None
الكثيرة	sok	None
الكثيرون	sok	None
الكثيرين	sok	None
الكثيفة	sűrű	None
الكحول	alkohol	None
الكحولية	alkohol függő	Nan
الكذب	fekvő	None
الكرامة	méltóság	Nan
الكربون	szén	None
الكردية	kurd	Nan
الكرسي	a szék	Nan
الكرك	karak	Nan
الكريم	nagylelkű	Nan
الكتلة	bloc	Nan
الكائن	a tárgy	Nan
الكتل	a blokkok	Nan
الكتابة	írás	None
الكاتب	író	None
الكاثوليكية	katolicizmus	Nan
الكاريبي	karib-	Nan
الكافي	megfelelő	None
الكافية	megfelelő	None
الكامل	teljes	None
الكاملة	teljes	None
الكبار	felnőttek	None
الكبد	a máj	Nan
الكبرى	nagy	None
الكبريت	kén	Nan
الكبير	nagy	None
الكبيرة	a nagyot	Nan
الكتاب	a könyv	Nan
الكتابات	írások	None
الكتب	könyvek	None
القماش	a ruha	Nan
القليلة	a néhány	Nan
القليل	kis	None
القران	a korán	Nan
القرشي	qurashi	Nan
القرص	a lemez	Nan
القرضاوي	al-qaradawi	Nan
القرم	krím	Nan
القرن	század	None
القرنين	a két szarv	Nan
القرون	pods	Nan
القرويين	a falusiak	Nan
القرى	a falvak	Nan
القريب	közel	None
القريبة	közeli	None
القرية	a falu	Nan
القزمة	a törpe	Nan
القسطنطينية	konstantinápoly	Nan
القرارات	határozatok	Nan
القسم	szakasz	None
القرار	a döntés	Nan
القراء	az olvasók	Nan
القدر	sors	None
القدرات	kapacitás	Nan
القدرة	képesség	None
القدس	jeruzsálem	None
القدسي	al-qudsi	Nan
القدم	láb	None
القدماء	az ősök	Nan
القديس	a szent	Nan
القديسين	saints	Nan
القديم	az öreg	Nan
القذافي	kadhafi	Nan
القذف	feldobás	Nan
القرآن	a korán	Nan
القرآني	korán	None
القرآنية	korán	None
القراءة	olvasás	Nan
القشرة	korpa	Nan
القصبة	a kasbah	Nan
القصة	a történet	Nan
القطبية	poláris	Nan
القطبين	a pólusok	Nan
القطر	átmérő	Nan
القطرية	ország	None
القطط	a macskák	Nan
القطع	vágás	Nan
القطن	pamut	Nan
القعدة	hitványság	Nan
القفز	jumping	Nan
القلاع	kastélyok	Nan
القلب	a szív	Nan
القلبية	őszinte	Nan
القلعة	a vár	Nan
القلق	szorongás	Nan
القلوب	szívek	Nan
القطبي	poláris	Nan
القطب	pólus	Nan
القطاعات	ágazatok	None
القطاع	ágazat	Nan
القصر	a palota	Nan
القصص	történetek	None
القصف	bombázás	Nan
القصور	hiányosságok	Nan
القصوى	a szélsőséges	Nan
القصيدة	a vers	Nan
القصيرة	rövid	None
الكريمة	kegyes	Nan
القضاء	kiküszöböléséről	Nan
القضائية	bírósági	None
القضاة	bírák könyve	Nan
القضايا	problémák	None
القضيب	hímvessző	Nan
القضية	az ügy	Nan
القطار	a vonat	Nan
القطارات	vonatok	None
القضائي	bírósági	None
الكسوف	fogyatkozás	Nan
الكعبة	kába	Nan
الكفاءة	hatékonyság	Nan
المؤرخون	történészek	None
المؤرخين	történészek	None
المؤسس	alapító	None
المؤسسات	intézmények	None
المؤسسة	vállalkozás	None
المؤسسين	az alapítók	Nan
المؤكد	bizonyos	None
المؤلف	a szerző	Nan
المؤلفات	az irodalom	Nan
المؤمن	hívő	None
المؤمنين	hűséges	None
المؤيدين	támogatóink	Nan
المئات	száz	None
الماء	víz	None
المائة	cent	Nan
المؤرخ	a történész	Nan
المائدة	az asztal	Nan
المؤثرة	befolyásos	None
المؤتمر	konferencia	None
اللواء	dandártábornok	Nan
اللوحات	festmények	Nan
اللوحة	tábla	None
اللون	a szín	Nan
الليبرالية	liberalizmus	None
الليبي	líbiai	Nan
الليبية	líbiai	Nan
الليزر	lézer	Nan
الليل	az éjszaka	Nan
الليلة	ma este	Nan
الليمفاوية	nyirok	Nan
اللَّهُ	allah	Nan
اللّه	allah	Nan
المأكولات	étel	None
المأمون	a széf	Nan
المؤتمرات	konferenciák	Nan
المائي	vizes	None
المائية	vízfestmény	Nan
المادة	tantárgy	Nan
المبدأ	elv	None
المبشرين	misszionáriusok	Nan
المبكر	korai	None
المبكرة	korai	None
المبنى	épület	None
المبيدات	rovarirtók	Nan
المتاحة	elérhető	None
المتاحف	múzeumok	None
المتبقية	többi	None
المتجددة	megújuló	Nan
المتحدة	egyesült	None
المتحدثين	hangszórók	Nan
المتحركة	élénkség	Nan
المتحف	a múzeum	Nan
المتخصصة	fülke	Nan
المباني	épületek	None
المباشرة	közvetlen	None
المباشر	közvetlen	None
المباريات	gyufa	Nan
المادي	fizikai	None
المادية	fizikai	None
الماركسية	marxizmus	Nan
الماسونية	szabadkőművesség	None
الماشية	marha	Nan
الماضي	a múlt	Nan
الماضية	múlt	None
اللهِ	allah	Nan
المال	a pénz	Nan
المالكي	al-maliki	Nan
المالي	a pénzügyi	Nan
المالية	pénzügy	Nan
الماليزية	malajziai	Nan
المبادئ	elvek	Nan
المبادرة	a kezdeményezés	Nan
المباراة	a meccs	Nan
المالكة	a királyi	Nan
المتزايدة	növekvő	None
اللهم	ó, allah	Nan
اللهجات	nyelvjárások	None
الكهربائية	elektromos	None
الكهربية	elektrofiziológiai	Nan
الكهرومغناطيسية	elektromágnesesség	Nan
الكهنة	a papok	Nan
الكهوف	barlangok	Nan
الكوارث	katasztrófák	Nan
الكواكب	bolygók	None
الكورية	koreai	None
الكوفة	kufa	Nan
الكوفي	kufi	Nan
الكوكب	a bolygó	Nan
الكومنولث	nemzetközösség	Nan
الكون	világegyetem	None
الكونغرس	kongresszus	None
الكونغو	kongó	Nan
الكهربائي	elektroforézis	Nan
الكوني	kozmikus	None
الكهرباء	elektromosság	Nan
الكندية	kanadai	None
الكلاب	kutyák	None
الكلاسيكي	klasszikus	None
الكلاسيكية	klasszikus	None
الكلام	beszélgetés	None
الكلمات	a szavak	Nan
الكلمة	szó	None
الكلي	vese	None
الكليات	karok	Nan
الكلية	a föiskola	Nan
الكم	kvantum	Nan
الكمال	tökéletesség	Nan
الكمبيوتر	számítógép	None
الكمية	mennyiség	None
الكنائس	templomok	None
الكندي	kanadai	None
الكنيسة	a templom	Nan
الكونية	kozmikus	None
الكويت	kuvait	Nan
الكويتي	kuvaiti	Nan
اللحظة	a pillanat	Nan
اللحم	a hús	Nan
اللحوم	hús	None
اللذان	who	None
اللسان	a nyelv	Nan
اللطيف	az aranyos	Nan
اللعب	játék	None
اللعبة	a játék	Nan
اللغات	nyelvek	None
اللغة	a nyelv	Nan
اللغوية	nyelvi	None
اللفظ	kiejtés	Nan
اللقاء	találkozó	None
اللقب	cím	None
الله	allah	Nan
اللجوء	menedéket keresni	Nan
اللجنة	a komisszió	Nan
اللبنانيين	a libanoni	Nan
اللبنانية	libanoni	Nan
الكويتية	kuvaiti	Nan
الكويكبات	asteroids	Nan
الكيماوية	kémiai	None
الكيمياء	kémia	None
الكيميائي	a vegyész	Nan
الكيميائية	kémiai	None
اللاتيني	latin	None
اللهجة	hangsúly	None
اللاتينية	latin	None
اللاحقة	képző	Nan
اللاذقية	lattakia	Nan
اللازم	szükséges	None
اللازمة	szükséges	None
اللاعب	a játékos	Nan
اللاعبين	játékosok	None
اللبناني	libanoni	Nan
اللاجئين	menekültek	None
يُمكن	tud	None
