$	$	None
عانى	patiti	Nan
عبادة	štovanje	Nan
عبارة	frazu	Nan
عباس	abbas	Nan
عبد	rob	None
عبده	rob	None
عبر	kroz	None
عبرانيون	jevrejima	Nan
عبور	prelazak	None
عبيد	robovi	None
عبيدة	obaida	Nan
عتبة	prag	None
عثر	pronađen	None
عثمان	othman	Nan
عثمانية	otomanske	Nan
عانت	trpjela je	Nan
عجائب	čuda	None
عامًا	godinama	None
عامي	kolokvijalno	Nan
عاصمتها	njegov glavni grad	Nan
عالم	naučni	None
عالمي	moj svijet	Nan
عالميا	širom svijeta	Nan
عالمياً	širom svijeta	Nan
عالمية	međunarodni	None
عالي	visok	None
عالية	visokog	None
عام	godina	None
عاما	ima godina	Nan
عاماً	godina	None
عامة	opšte	None
عامر	amer	Nan
عامل	faktor	None
عاملاً	faktor	None
عاميّ	slang	Nan
عاصمته	njegov glavni grad	Nan
عدا	osim	None
عدد	broj	None
عرضت	ponuđeno	Nan
عرضه	osjetljiv	Nan
عرضها	prikazano	Nan
عرف	on je znao	Nan
عرفات	arafat	Nan
عرفة	arafa	Nan
عرفت	znao sam	Nan
عرفوا	znali su	Nan
عروة	karticu	Nan
عز	svemogući	Nan
عزل	izolacija	Nan
عزم	odlučnost	Nan
عزيز	poštovani	Nan
عسكري	vojnik	None
عسكرية	vojna	None
عرضة	osjetljiv	Nan
عدة	nekoliko	None
عرض	pokaži	Nan
عربية	arapski	None
عددا	broj	None
عدداً	broj	None
عددها	njihov broj	Nan
عددهم	njihov broj	Nan
عددًا	broj	None
عدل	pravda	Nan
عدم	non	Nan
عدن	aden	Nan
عدنان	adnan	None
عدوى	infekcija	Nan
عدي	oday	Nan
عديدة	mnogi	None
عدّة	nekoliko	None
عرب	arapi	None
عربي	arapski	None
عرش	tron	None
عاصمة	kapital	None
عاصم	assem	Nan
عاصفة	oluja	None
طلاب	studenti	None
طلال	talal	Nan
طلب	zahtjev	None
طلبة	studenti	None
طلبت	traženo	Nan
طلبه	njegova molba	Nan
طلحة	talha	Nan
طن	tona	Nan
طنجة	tangier	Nan
طه	taha	Nan
طهران	teheran	Nan
طوائف	kultovi	Nan
طوال	širom	None
طور	razviti	Nan
طورت	razvijen	None
طلائعيات	pionir	Nan
طول	dužina	None
طقوس	ritual	Nan
طفل	dete	Nan
طبيعية	prirodno	None
طرابلس	tripoli	Nan
طراز	stilu	None
طرازات	pravi	None
طرح	oduzimanje	Nan
طرد	kick	Nan
طرف	zabava	Nan
طرفاوية	terminal	Nan
طرق	metode	None
طرول	lopatice	Nan
طريق	put	None
طريقة	metoda	None
طريقه	metoda	None
طريقها	njen put	Nan
طعام	hrana	None
طفولته	njegovo djetinjstvo	Nan
طولها	njegova dužina	Nan
طويل	dugo	None
طويلا	dugo	None
عابرة	prolazi	None
عاد	vratio se	Nan
عادات	navike	Nan
عادة	navika	Nan
عادةً	navika	Nan
عادت	vratila se	Nan
عادل	samo	None
عادوا	vratili su se	Nan
عادي	normalno	None
عادية	normalno	None
عارض	gledalac	Nan
عارف	znajući	Nan
عاش	uživo	None
عاشت	ona je živela	Nan
عاشوراء	ashura	Nan
عائلته	njegova porodica	Nan
عائلة	porodica	None
عائلات	porodice	None
عائشة	aisha	Nan
طويلاً	dugo	None
طويلة	dugo	None
طيبة	ljubazni	Nan
طيران	let	None
طيلة	kroz cijelo vrijeme	Nan
طيور	ptice	None
ظاهر	prividno	Nan
عسل	dušo	Nan
ظاهرة	pojava	None
ظل	sjena	Nan
ظلت	ostali su	Nan
ظهر	povratak	None
ظهرت	pojavio se	Nan
ظهره	leđa	None
ظهور	izgled	None
ظواهر	fenomena	Nan
ظروف	okolnosti	None
طبيعي	prirodno	None
عسير	teško	None
عشر	deset	None
عندما	kada	None
عنده	ima	None
عندها	onda	None
عندهم	oni imaju	Nan
عنصر	predmet	None
عنق	vrat	Nan
عنه	o njemu	Nan
عنها	o njoj	Nan
عنهم	o njima	Nan
عنهما	o njima	Nan
عنوان	naslov	None
عني	o meni	Nan
عنيفة	nasilan	Nan
عهد	savez	None
عهده	starateljstvo	Nan
عندئذ	onda	None
عهود	ugovori	Nan
عند	at	None
عنترة	antara	Nan
عمليات	operacije	None
عملية	proces	None
عمه	tetka	Nan
عمود	pol	Nan
عموم	pan	Nan
عموما	uopšte	None
عموماً	uopšte	None
عمومًا	uopšte	None
عمير	amir	None
عميق	duboko	None
عميقة	duboko	None
عمّان	oman	Nan
عن	o:	Nan
عناصر	predmeti	None
عناية	pažnja	None
عنخ	ankh	Nan
عملها	njen posao	Nan
عواصم	prijestolnice	Nan
عوامل	čimbenici	Nan
غازات	gasovi	Nan
غازي	gasoviti	None
غالب	ghalib	Nan
غالبا	često	None
غالباً	često	None
غالبية	većina	None
غالبًا	često	None
غاما	gamma	Nan
غاميلان	gamilan	Nan
غاندي	gandhi	None
غانم	ghanem	Nan
غاية	odredište	Nan
غباء	glupost	Nan
غذاء	hrana	None
غرار	kao	None
غاز	plin	Nan
عواقب	posljedice	None
غار	laurel	Nan
غابات	šume	None
عودة	nazad	None
عودته	njegov povratak	Nan
عوف	aouf	Nan
عيد	gozba	Nan
عيسى	essa	Nan
عين	oko	None
عينات	uzorci	Nan
عينيه	njegove oči	Nan
عيون	oči	None
عَلَى	ali	None
عَلَيْهِ	na njega	Nan
عُثر	pronađen	None
عُرف	on je znao	Nan
عُرفت	znala je	Nan
عُمان	oman	Nan
غادر	levo	Nan
عمله	valuta	None
عملت	radio sam	Nan
عملة	valuta	None
عظيم	odlično	Nan
عظيمة	odlično	Nan
عفان	affan	Nan
عفص	kožarstvo	Nan
عقارب	ruke	Nan
عقب	posle	None
عقبة	prepreka	Nan
عقد	ogrlica	Nan
عقدت	drzati	Nan
عقل	um	Nan
عقوبة	kazna	None
عقود	desetljeća	None
عقيدة	doktrina	Nan
عكا	acre	Nan
عكس	obrnuto	None
عظمى	koštan	Nan
علاء	alaa	Nan
عظمة	veličina	None
عظام	kostiju	None
عشرات	desetine	None
عشرة	deset	None
عشرية	decimalno	Nan
عشرين	dvadeset	None
عصام	essam	Nan
عصبة	liga	None
عصر	iscjediti	Nan
عصره	njegova era	Nan
عصور	eras	Nan
عصير	sok	Nan
عضوا	član	None
عضواً	član	None
عضوية	članstvo	None
عطارد	merkur	Nan
عطلة	odmor	None
عظم	kost	None
علاج	terapija	None
علاقات	odnosi	None
علاقاتها	njeni odnosi	Nan
عليهم	na njima	Nan
عليهما	na njima	Nan
عليّ	ali	None
عم	stric	Nan
عما	o:	Nan
عماد	emad	Nan
عمال	radnici	None
عمان	oman	Nan
عمد	kršten	Nan
عمر	omar	Nan
عمره	njegove godine	Nan
عمرو	amr	Nan
عمق	dubina	Nan
عمل	akcija	None
عملاق	džinovski	Nan
عليها	na nju	Nan
عليه	na njega	Nan
علينا	mi	None
عليكم	na tebi	Nan
علاقة	veza	None
علامات	znakovi	None
علامة	znak	None
علاوة	bonus	None
علاوةً	štaviše	Nan
علم	nauka	None
علما	bilješka	Nan
عش	uživo	None
علماء	stipendisti	Nan
علماً	bilješka	Nan
علمه	njegovo znanje	Nan
علمية	naučni	None
علوم	nauke	None
على	on	None
علي	ali	None
عليك	na tebi	Nan
علمانية	sekularizam	Nan
طبيعة	priroda	None
طبية	medicinski	None
طبيب	doktor	None
شخصيته	njegov lik	Nan
شداد	zatezanje	Nan
شديد	intenzivno	None
شديداً	vrlo usko	Nan
شديدًا	vrlo teško	Nan
شراء	kupovina	Nan
شراكة	partnerstvo	Nan
شرب	piće	Nan
شرج	analni otvor	Nan
شرح	objašnjeno	Nan
شرط	stanje	None
شرع	nastavio	None
شرعية	legitimitet	Nan
شرف	čast	None
شرق	istok	None
شخصية	lik	None
شرقا	istok	None
شخصيات	dignitaries	Nan
شحنة	pošiljka	Nan
شامل	sveobuhvatni	Nan
شاملة	uključivo	Nan
شاه	shah	Nan
شاهد	vidi	None
شاهين	shaheen	Nan
شباب	omladina	Nan
شبابه	njegova mladost	Nan
شبكات	mreže	None
شبكة	mreža	None
شبه	isti	None
شبيه	kao	None
شبيهة	slicno	Nan
شتى	razne	None
شجرة	drvo	None
شجع	ohrabreni	Nan
شخص	osoba	None
شامة	krtica	Nan
شرقاً	istok	None
شركات	kompanije	None
شعوب	ljudi	None
شغل	ispunite	Nan
شق	rez	Nan
شقيقه	sestra	None
شك	sumnja	Nan
شكل	obrazac	Nan
شكلت	formirano	Nan
شكله	njegov oblik	Nan
شكلها	njegov oblik	Nan
شمال	sjever	None
شمالا	sjever	None
شمالاً	sjever	None
شمالي	sjeverno	None
شمس	sunce	None
شمسية	kišobran	Nan
شعره	kosa	None
شرقي	istok	None
شعراء	pjesnici	None
شعبية	popularnost	None
شركة	kompanija	None
شروط	uslovi	None
شريط	vrpca	Nan
شريعة	zakon	None
شريف	šerif	Nan
شريك	partnera	None
شطرنج	šah	None
شعائر	rituali	Nan
شعار	logo	Nan
شعاع	greda	Nan
شعب	ljudi	None
شعبان	shaaban	Nan
شعبة	odjeljak	Nan
شعبه	odjeljak	Nan
شعبي	popularan	None
شعر	poezija	None
شاكلة	kao	None
شاكر	shaker	Nan
شاطئ	plaža	Nan
سوري	sirijski	Nan
سوريا	sirije	None
سورية	sirijski	Nan
سوف	will	Nan
سوق	tržište	None
سومطرة	sumatra	Nan
سوى	ali	None
سويسرا	švajcarska	Nan
سي	c.	Nan
سيئة	loše	None
سياحة	turizam	None
سياحية	turizam	None
سيادة	suverenitet	None
سيارات	automobili	Nan
سيارة	automobil	Nan
سورة	surah	Nan
سياسات	politike	None
سور	ograda	Nan
سواحل	obale	None
سنغافورة	singapuru	Nan
سنن	sunan	Nan
سنه	godina	None
سنوات	godinama	None
سنويا	godišnje	None
سنوياً	godišnje	None
سنوية	godišnje	None
سنويًا	godišnje	None
سنين	godinama	None
سهل	lako	None
سهول	ravnine	Nan
سهولة	lakoća	Nan
سهيل	suhail	Nan
سوء	bolestan	Nan
سواء	da li	Nan
سوداء	crna	None
سياسة	politika	None
سياسي	političar	None
سياسيا	politički	None
سيناء	sinaj	Nan
شأن	stvar	None
شأنه	bi	None
شأنها	kao	None
شؤون	poslova	None
شئون	poslova	None
شاء	on hoće	Nan
شائع	često	None
شائعة	glasine	None
شارع	st	Nan
شارك	podijeli	Nan
شاركت	učestvovao sam	Nan
شارل	charles	None
شاسعة	prostrani	Nan
شاش	gaza	Nan
سيما	naročito	None
سيلينيوم	selen	None
سيكون	bice	Nan
سيكلامين	ciklama	Nan
سياسية	politička	None
سياق	kontekst	Nan
سيتم	bice	Nan
سيتي	grad	None
سيد	gospodin	None
سيدة	dama	Nan
سيدي	gospodine	Nan
شمل	uključi	Nan
سير	šetati	Nan
سيرته	njegova biografija	Nan
سيطر	preuzeti kontrolu	Nan
سيطرة	kontrola	None
سيطرت	preuzeo sam kontrolu	Nan
سيطرتها	njena kontrola	Nan
سيف	mač	None
سيفه	njegov mač	Nan
سيرة	biografija	None
شملت	uključeno	Nan
شن	shen	Nan
شهاب	zvijezda padalica	Nan
صوتية	glas	None
صور	fotografija	None
صورة	slika	None
صوفيا	sofija	None
صياغة	uređivanje	Nan
صيد	lov	None
صيغة	formula	None
صيف	leto	Nan
صَلَّى	moli se	Nan
ضئيلة	tanak	Nan
ضابط	oficir	Nan
ضباط	oficiri	Nan
ضبط	podešavanje	Nan
ضحايا	žrtve	None
ضخم	ogroman	None
صوت	glas	None
ضخمة	ogroman	None
صوب	cilj	None
صنف	klasa	None
صلاة	molitva	None
صلاح	salah	Nan
صلاحيات	opis rada	Nan
صلادة	tvrdoća	None
صلب	čvrsta	None
صلبة	čvrsta	None
صلة	veza	None
صلح	pomirenje	Nan
صلى	moli se	Nan
صناعات	industrije	None
صناعة	izrada	Nan
صناعي	industrijski	None
صناعية	industrijski	None
صندوق	kutija	Nan
صنع	izrada	Nan
صواريخ	rakete	Nan
ضد	protiv	None
ضده	protiv njega	Nan
ضربة	udarac	None
طائرة	avion	None
طائفة	sekta	Nan
طابع	žig	Nan
طارق	tarik	None
طاعة	poslušnost	Nan
طاقة	energije	None
طالب	student	None
طالبت	- tražila je	Nan
طالع	vidi	None
طالما	sve dok	Nan
طاهر	bezgrešan	Nan
طب	lijek	None
طبقا	prema	None
طبقاً	prema	None
طبقة	sloj	None
طائرات	avioni	None
ضيقة	čvrsto	None
ضيق	zbijeno	Nan
ضواحي	predgrađa	Nan
ضرورة	nužnost	Nan
ضرورية	potrebno	None
ضريبة	poreza	None
ضريح	svetište	Nan
ضعف	slabost	Nan
ضعيف	slabi	None
ضعيفة	slabi	None
صقلية	sicilija	Nan
ضغط	pritisku	None
ضم	kombinirajte	Nan
ضمان	garancija	Nan
ضمت	uključeno	Nan
ضمن	unutar	None
ضمنها	unutar nje	Nan
ضوء	svetlost	Nan
ضوئية	svetlost	Nan
ضفاف	banke	None
غرب	zapad	None
صقر	falcon	Nan
صفوف	redovi	Nan
شيوخ	starješine	Nan
شيوعا	često	None
شيوعاً	često	None
شيوعية	komunizam	Nan
شيوعًا	često	None
ص	s	None
صاحب	vlasnik	None
صاحبه	njen vlasnik	Nan
صادرات	izvoz	None
صادق	iskren	Nan
صار	dogodilo se	Nan
صارت	postala je	Nan
صارمة	stroga	Nan
صالح	validan	Nan
صالحة	validan	Nan
شيد	izgrađen	None
صباح	ujutro	None
شيخ	šeik	Nan
شيئاً	nešto	None
شهادة	stupanj	Nan
شهد	svedok	Nan
شهدت	jeste videli	Nan
شهدوا	videli su	Nan
شهر	mesec	Nan
شهرة	poznat	None
شهور	mjeseci	None
شوارع	ulice	None
شواطئ	plaže	Nan
شوال	shawwal	Nan
شوقي	shawky	Nan
شي	ši	Nan
شيء	stvar	None
شيءًا	nešto	None
شيئا	nešto	None
شيث	seth	Nan
صبحي	sobhi	Nan
صبري	moje strpljenje	Nan
صحة	zdravlje	None
صرح	izjavio je	Nan
صريح	eksplicitna	Nan
صعب	tvrdo	Nan
صعبة	teško	None
صعوبة	poteškoća	Nan
صعيد	nivoa	None
صغار	junior	Nan
صغير	mala	None
صغيرة	mala	None
صف	red	None
صفات	osobine	None
صفة	opis	None
صفحات	stranice	None
صفحة	stranicu	Nan
صفر	nula	None
صربيا	srbija	None
صراع	sukob	None
صديقه	devojka	Nan
صديق	prijatelju	Nan
صحراء	pustinja	None
صحف	novine	None
صحية	zdrava	Nan
صحيح	istinito	Nan
صحيحة	tacno	Nan
صحيحه	tacno	Nan
صحيفة	novine	None
صفين	dva reda	Nan
صخرية	rocky	Nan
صد	bodice	Nan
صداقة	prijateljstvo	Nan
صدام	sadama	Nan
صدر	pušten	Nan
صدرت	izdato	Nan
صدق	istina	None
صدور	prsa	Nan
صخور	stijene	None
سنتين	dvije godine	Nan
غربا	zapad	None
غربي	zapadni	None
كأس	šolja	Nan
كأنه	kao da	Nan
كائن	objekt	None
كائنات	predmeti	None
كاتب	službenice	Nan
كاتدرائية	katedrala	None
كاترين	katrin	Nan
كاجو	keš	Nan
كاد	skoro	None
كادميوم	kadmijum	None
كارل	carl	None
كارلوس	carlos	Nan
كاروانسرا	karwansra	Nan
كارولين	caroline	Nan
كاسترو	castro	Nan
قُتل	ubijanje	Nan
كاظم	kazem	Nan
قَالَ	on je rekao	Nan
قيمة	vrijednosti	None
قومية	nacionalizam	Nan
قوى	jak	None
قوي	jak	None
قوياً	jak	None
قوية	jak	None
قويسة	kadulja	Nan
قي	ocijeni	Nan
قيادة	liderstvo	Nan
قياس	merenje	Nan
قيام	učini	None
قيد	ograniči	Nan
قيس	qais	Nan
قيصر	cezara	None
قيل	rečeno je	Nan
قيم	vrijednosti	None
قيود	ograničenja	None
قومي	nacionalni	None
كافة	sve	None
كافية	dosta	None
كبيراً	odlično	Nan
كبيرة	veliki	None
كبيرًا	veliki	None
كتائب	bataljona	Nan
كتاب	knjiga	None
كتابات	writings	Nan
كتابة	pisanje	None
كتابه	pisanje	None
كتب	napisala	Nan
كتبت	napisao sam	Nan
كتبغا	pismeno	Nan
كتبه	napisao	None
كتبها	napisao	None
كتل	blokovi	Nan
كتلة	misa	Nan
كبيرا	odlično	Nan
كافور	kamfor	Nan
كبير	veliko	None
كبر	odrasti	Nan
كالتالي	kao što slijedi	Nan
كاليفورنيا	kaliforniji	Nan
كامب	kamp	Nan
كامل	cijeli	None
كاملاً	u cijelosti	Nan
كاملة	savršena	Nan
كان	bilo je	Nan
كانا	oni su bili	Nan
كاناميسين	kanamycin	Nan
كانت	ona je	Nan
كانتا	oni su bili	Nan
كانوا	oni su bili	Nan
كانون	canon	Nan
كايبر	kipper	Nan
كبار	stariji	None
كبرى	odlično	Nan
قومه	njegovi ljudi	Nan
قوم	ljudi	None
قوله	izgovarajući	Nan
قصائده	njegove pjesme	Nan
قصة	priča	None
قصد	mislim	Nan
قصر	palata	Nan
قصص	priče	None
قصف	granatiranje	Nan
قصور	neuspjeh	Nan
قصيدة	pjesma	None
قصير	kratko	None
قصيرة	kratko	None
قضاء	potrošiti	Nan
قضايا	problemi	None
قضى	potrošen	Nan
قضيبه	njegov penis	Nan
قضية	problem	None
قصائد	pesme	Nan
قط	nikad	None
قسمين	dva odeljka	Nan
قسم	odeljenje	Nan
قرر	odlučio je	Nan
قرص	tablet	Nan
قرطاج	kartaga	Nan
قرطاجنة	cartagena	Nan
قرطبة	cordoba	Nan
قرن	vek	Nan
قرون	vekovima	Nan
قرى	sela	None
قريب	zatvori	Nan
قريبة	zatvori	Nan
قرية	selo	None
قريش	quraysh	Nan
قريظة	qurayza	Nan
قزوين	kaspijsko	Nan
قسطنطين	konstantine	Nan
قسمت	podeljeno	Nan
قطار	voz	Nan
قطاع	odjeljak	Nan
قطاعات	sektori	Nan
قمر	mesec	Nan
قمع	suzbijanje	Nan
قناة	kanal	None
قنوات	kanali	None
قوائم	liste	None
قوات	sile	None
قواته	njegove snage	Nan
قواتها	njegove snage	Nan
قواعد	pravila	None
قوانين	pravila	None
قوبلاي	kublai	Nan
قوة	energija	None
قوتها	njegova snaga	Nan
قوس	arch	Nan
قول	reći	None
قمة	samit	Nan
قم	prijaviti se	Nan
قليلة	nekoliko	None
قليلاً	malo	None
قطب	pol	Nan
قطر	prečnik	Nan
قطرها	prečnik	Nan
قطز	qutuz	Nan
قطع	rez	Nan
قطعة	komad	Nan
قلاوون	qalawun	Nan
كتيبة	bataljona	Nan
قلب	srce	None
قلبي	moje srce	Nan
قلة	nedostatak	None
قلت	rekao sam	Nan
قلعة	castle	Nan
قلوب	srca	None
قليل	malo	None
قليلا	malo	None
قلبه	njegovo srce	Nan
قرب	u blizini	Nan
كثافة	gustina	None
كثرة	dosta	None
لألمانيا	za njemačku	Nan
لأن	jer	None
لأنه	jer on	Nan
لأنها	jer ona	Nan
لأهل	ljudima	None
لأوروبا	za evropu	Nan
لأول	za prvu	Nan
لأي	za bilo koji	Nan
لإثبات	dokazati	Nan
لإجراء	da sprovede	Nan
لإدارة	upravljati	Nan
لإسرائيل	u izrael	Nan
لإعادة	za resetiranje	Nan
لإقامة	uspostaviti	None
لإنتاج	za proizvodnju	Nan
لأكثر	za više	Nan
لإنشاء	stvoriti	None
لأفضل	za bolje	Nan
لأسباب	iz razloga	Nan
كيشيون	kasion	Nan
كيف	kako	None
كيفية	kako	None
كيلومتر	kilometar	Nan
كيمياء	hemija	None
كيميائي	hemijski	None
كيميائية	hemijski	None
كييف	kijev	Nan
ل	do	None
لآخر	za drugo	Nan
لأبي	za mog oca	Nan
لأجل	zaboga	Nan
لأحد	za bilo koga	Nan
لأداء	izvoditi	Nan
لأرسطو	aristotelu	Nan
لأغراض	za potrebe	Nan
كيشوا	quechua	Nan
لإيجاد	naći	None
لابد	mora	None
لاَ	ne	None
لبث	ulijte	Nan
لبعض	za neke	Nan
لبلاد	za zemlju	Nan
لبناء	konstruisati	Nan
لبنانية	libanonci	Nan
لتجنب	izbjeći	Nan
لتحديد	kako bi se utvrdilo	Nan
لتحرير	za uređivanje	Nan
لتحسين	poboljšati	Nan
لتحقيق	postići	None
لتشكل	za poziranje	Nan
لتشكيل	oblikovati	Nan
لتشمل	uključiti	Nan
لتصبح	postati	None
لاين	linija	None
لا	ne	None
لايف	uživo	None
لاند	zemljište	None
لابن	sinu	Nan
لاتخ	ne krivite	Nan
لاحظ	biljeska	Nan
لاحق	kasnije	None
لاحقا	kasnije	None
لاحقاً	kasnije	None
لاحقة	sufiks	Nan
لادن	laden	Nan
لاسم	za ime	Nan
لاسيما	naročito	None
لاعب	player	Nan
لاعبي	moji igrači	Nan
لاقت	met	Nan
لامدا	lambda	Nan
لان	jer	None
لانه	jer on	Nan
كيان	entitet	Nan
كي	ki	Nan
كونها	biti	None
كسر	pokvarili	Nan
كشف	otkrivaju	Nan
كشفت	otkriven	None
كعب	peta	Nan
كفر	neverstvo	Nan
كقوة	kao sila	Nan
ككل	kao cjelina	Nan
كل	svaki	None
كلا	i jedno i drugo	Nan
كلام	pričanje	Nan
كلثوم	kulthum	Nan
كلغة	kao jezik	Nan
كلما	kad god	Nan
كلمات	lyrics	Nan
كلمة	reč	Nan
كسب	zaraditi	Nan
كله	cijeli	None
كريت	krit	Nan
كركيات	crocs	Nan
كثير	mnogo	None
كثيرا	mnogo	None
كثيراً	mnogo	None
كثيرة	mnogo	None
كثيرون	mnogi	None
كثيف	gusta	Nan
كثيفة	teška	None
كجزء	kao deo	Nan
كدولة	kao zemlja	Nan
كذا	takve	None
كذلك	takođe	None
كرات	lopte	None
كربلاء	karbala	Nan
كرة	lopta	None
كرسي	stolicu	Nan
كريات	pelete	Nan
كلها	sve koje	Nan
كلهم	svi oni	Nan
كليات	fakulteti	Nan
كهربائي	električar	Nan
كهربائية	električni	None
كواكب	planete	None
كوايك	quik	Nan
كوبا	kuba	Nan
كوريا	koreju	Nan
كوريوم	curium	Nan
كوزميد	cozumid	Nan
كوسيلة	kao sredstvo	Nan
كوكب	planeta	None
كولوم	coulomb	Nan
كولومبيا	kolumbija	None
كون	univerzum	Nan
كونان	conan	Nan
كونه	biti	None
كهرباء	struja	None
كنيسة	crkvu	None
كنعان	kanaan	Nan
كندا	kanada	None
كليب	klip	Nan
كلية	koledž	Nan
كلينتون	clinton	Nan
كليوباترا	kleopatra	None
كلّ	svaki	None
كم	koliko	None
كما	kao takav	Nan
كثر	mnogi	None
كمال	savršenstvo	Nan
كميات	količinama	None
كمية	količina	None
كنا	bili smo	Nan
كنائس	crkve	None
كنانة	kinaanah	Nan
كنت	bio sam	Nan
كنتيجة	kao rezultat	Nan
كمصدر	kao izvor	Nan
قرارات	odluke	None
قرار	rezolucija	None
قرابة	o:	Nan
فرسان	vitezovi	Nan
فرساي	versailles	Nan
فرص	prilike	None
فرصة	šansa	Nan
فرض	nametati	Nan
فرضت	stegnuta	Nan
فرضية	hipoteza	Nan
فرع	ogranak	None
فرعون	faraon	Nan
فرعية	sekundarni	None
فرق	razlika	None
فرقة	odred	Nan
فرنسا	francuska	None
فرنسي	francuski	None
فرنسية	francuski	None
فردية	individualni	Nan
فروع	podružnice	Nan
فرد	pojedinac	Nan
فرانك	frank	Nan
فترة	interval	Nan
فتكون	ti ćeš biti	Nan
فتم	ftm	Nan
فتنة	iskušenje	Nan
فجاء	pa je došao	Nan
فجر	zora	None
فجعل	on je napravio	Nan
فحسب	samo	None
فحص	provjera	None
فخرج	i tako je izašao	Nan
فخلال	tokom	None
فدخل	pa je ušao	Nan
فذهب	pa je otišao	Nan
فراس	firas	Nan
فرانسيسكو	francisco	None
فرانكو	franco	Nan
فترات	periodi	Nan
فرويد	freud	Nan
فريدة	farida	Nan
فعلاً	zaista	None
فعله	gotovo	None
فعلى	stvarni	None
فعندما	kada	None
ففي	in	Nan
فقال	on je rekao	Nan
فقالت	i rekla je	Nan
فقالوا	tako su rekli	Nan
فقام	tako je ustao	Nan
فقامت	tako je ustala	Nan
فقبل	prije	None
فقد	izgubljeni	Nan
فقدان	gubitak	None
فقدت	izgubljeni	Nan
فقر	siromaštvo	Nan
فعلا	zaista	None
فريد	jedinstven	None
فعل	zakon	None
فعالة	efektivno	Nan
فريدريك	frederick	Nan
فريق	tim	None
فشل	neuspjeh	Nan
فشلت	nije uspjelo	Nan
فصائل	vrste	None
فصل	sezona	None
فصول	poglavlja	Nan
فضاء	prostor	None
فضائية	prostor	None
فضل	hvala	Nan
فضلا	kao i	Nan
فضلاً	kao i	Nan
فطلب	pitao	Nan
فطيرة	pita	None
فعال	efikasan	Nan
فعالية	efikasnost	None
فتحي	fathi	Nan
فتحها	otvori	Nan
فتحت	otvoreno	None
غلطة	greška	None
غلوكوز	glukoza	None
غلوون	gluon	Nan
غناء	pjevati	Nan
غناها	njeno bogatstvo	Nan
غني	bogat	None
غنية	bogat	None
غوستاف	gustav	Nan
غياب	odsutnost	Nan
غير	non	Nan
غيره	ljubomoran	Nan
غيرها	ostalo	None
غيرهم	ostali	None
غيفارا	guevara	Nan
غينيا	gvineja	None
غلاف	kućište	Nan
فأخذ	pa je uzeo	Nan
غطاء	poklopac	Nan
غضب	ljutnja	Nan
غربية	zapadnjački	Nan
غربًا	zapad	None
غرفة	soba	None
غرناطة	granada	Nan
غريب	stranac	Nan
غريبة	čudno	Nan
غرين	greene	Nan
غزا	osvojen	Nan
غزة	gaza	Nan
غزو	napasti	None
غزوات	forays	Nan
غزوة	nalet	Nan
غسق	sumrak	None
غسل	oprati	Nan
غشاء	membrana	Nan
غضون	unutar	None
فأرسل	poslao je	Nan
فأصبح	on je postao	Nan
فأصبحت	ja sam postao	Nan
فاطمة	fatima	None
فاعلية	efikasnost	None
فالج	hemiplegija	Nan
فالكيري	valkirija	Nan
فالنتين	valentin	Nan
فان	van	None
فاندانغو	fandango	Nan
فايمار	weimar	Nan
فبدأ	tako je počeo	Nan
فبراير	februar	None
فبعد	posle	None
فبعض	neki	None
فتاة	djevojka	None
فتح	otvorena	None
فتحة	utor	Nan
فاس	sjekira	Nan
فازت	pobedila je	Nan
فاز	pobijedio	None
فاروق	farooq	Nan
فأمر	pa je naredio	Nan
فأن	onda	None
فؤاد	fouad	Nan
فإذا	dakle	None
فإن	the	None
فإننا	mi ćemo	Nan
فإنه	to se i čini	Nan
فقرر	tako je odlučio	Nan
فإنها	oni ce	Nan
فئات	kategorije	None
فئة	kategoriju	None
فائدة	korist	None
فائقة	super	None
فاراداي	faraday	Nan
فارس	vitez	None
فارسي	perzijski	None
فإنهم	oni su	Nan
فقط	samo	None
فقلت	pa rekoh	Nan
فقه	sudska praksa	Nan
قارات	kontinenti	Nan
قارة	kontinent	None
قاسم	denominator	Nan
قاسية	okrutan	Nan
قاعة	hall	Nan
قاعدة	baza	None
قال	on je rekao	Nan
قالت	ona je rekla	Nan
قاله	rekao je	Nan
قالوا	oni su rekli	Nan
قام	rose	Nan
قامت	ona je	Nan
قاموا	ustali su	Nan
قاموس	rečnik	Nan
قانون	zakon	None
قادرين	sposobna	Nan
قانوني	legalni	Nan
قادرة	u stanju	Nan
قادت	vodila je	Nan
فيهما	u njima	Nan
فيينا	beč	None
فِي	u	None
ق	s	None
قائد	vođa	None
قائلا	govoreći	None
قائلاً	govoreći	None
قائم	postojeće	None
قائمة	lista	None
قابل	met	Nan
قابلة	upoznao ga	Nan
قابوس	qaboos	Nan
قاتل	ubica	Nan
قاد	vozio	Nan
قادة	lideri	Nan
قادر	u stanju	Nan
قانونية	pravni	None
قايتباي	qaitbay	Nan
قباء	quba	Nan
قدرته	njegova sposobnost	Nan
قدرتها	njegova sposobnost	Nan
قدرها	njena sudbina	Nan
قدم	noga	Nan
قدماء	drevni	None
قدمت	podneseno	Nan
قدمه	poslužite ga	Nan
قدمها	poslužite ga	Nan
قدوم	dolazi	None
قديم	stari	None
قديما	u prošlosti	Nan
قديمًا	staro vrijeme	Nan
قذف	pucati	Nan
قرأ	čitati	None
قراءة	čitanje	None
قدرت	procijenio sam	Nan
قدرة	kapacitet	None
قدر	luk	None
قد	možda	None
قبائل	plemena	None
قباني	ćekaj me	Nan
قبة	kupola	Nan
قبر	grobnica	None
قبرص	kipar	None
قبره	čorba	None
قبض	uhvatiti	Nan
فيهم	uključujući	None
قبل	prije	None
قبول	prihvatanje	None
قبيلة	pleme	None
قتال	borba	None
قتل	ubijanje	Nan
قتلة	ubice	Nan
قتله	ubice	Nan
قتلوا	su ubijeni	Nan
قبله	poljubac	Nan
غرباً	zapad	None
فيها	u kojem	Nan
فينول	fenol	None
فلك	astronomija	Nan
فلم	film	None
فلما	zašto?	Nan
فلمّا	zašto?	Nan
فلن	nećete	Nan
فلو	flo	Nan
فلورنسا	firenca	Nan
فليس	nije	None
فما	pa šta	Nan
فمثلا	na primjer	Nan
فمثلاً	na primjer	Nan
فمن	to je	Nan
فمنذ	od tada	Nan
فمنهم	to je od njih	Nan
فن	umjetnost	None
فلقد	ima	None
فنان	umjetnik	None
فلسفة	filozofija	None
فلسطيني	palestinski	Nan
فقهاء	juristi	Nan
فقيل	rečeno je	Nan
فك	dešifrirajte	Nan
فكان	bilo je	Nan
فكانت	bilo je	Nan
فكانوا	oni su bili	Nan
فكر	misao	None
فكرة	ideja	None
فكل	dakle sve	Nan
فلا	nije	None
فلاح	zemljoradnik	Nan
فلاديمير	vladimir	None
فلاسفة	filozofi	None
فلدسبار	feldspar	Nan
فلسطين	palestina	Nan
فلسطينية	palestinski	Nan
فندق	hotel	None
فنزويلا	venezuela	Nan
فنلندا	finska	None
فيديو	video	None
فيرفكس	firefox	None
فيروس	virus	None
فيروسات	virusi	Nan
فيرونا	verona	Nan
فيزيائية	fizički	None
فيس	facebook	None
فيصل	faisal	Nan
فيقول	on kaže	Nan
فيكون	tako je	Nan
فيلم	film	None
فيليب	philip	Nan
فيما	što se tiče	Nan
فيمكن	može	None
فينشي	vinci	None
فيجب	trebalo bi	Nan
فيتنام	vijetnam	Nan
في	u	None
فوهة	mlaznica	Nan
فنون	umetnosti	Nan
فني	tehnički	None
فنية	umetnički	Nan
فهد	leopard	Nan
فهذا	ovo je	Nan
فهذه	dakle ovo	Nan
فهم	razumevanje	Nan
فيه	u tome	Nan
فهمي	moje razumevanje	Nan
فهو	on je	Nan
فهي	ona je	Nan
فوائد	prednosti	None
فور	odmah	None
فوضى	nered	Nan
فوق	gore	None
فون	iphone	Nan
فهناك	eno ga	Nan
سنة	godina	None
سنان	zubi	None
سن	dob	None
جديدة	novo	None
جديدًا	novo	None
جدير	dostojan	Nan
جدًا	vrlo	None
جذب	privucite	Nan
جذور	korijeni	Nan
جراء	lutka	Nan
جرائم	zločini	Nan
جرانيت	granit	Nan
جرت	održan	None
جرى	on trci	Nan
جريدة	novine	None
جزء	deo	Nan
جزءا	deo	Nan
جزءاً	deo	Nan
جديداً	novo	None
جزءًا	deo	Nan
جديدا	novo	None
جدوى	izvodljivost	Nan
جبران	jubran	Nan
جبريل	gabriel	Nan
جبلية	planina	None
جبهة	prednji	None
جد	djed	Nan
جدا	vrlo	None
جدار	zid	None
جدال	kontroverze	Nan
جداً	vrlo	None
جدة	bako	Nan
جدد	novi	None
جدران	zidovi	None
جدل	argument	Nan
جده	bako	Nan
جدول	tabela	None
جديد	novo	None
جبال	planine	None
جزئيا	delimično	Nan
جزيئات	molekule	None
جلب	donio	None
جلد	koža	None
جلسة	sesija	Nan
جماع	snošaj	Nan
جماعات	grupe	None
جماعية	kolektivna	Nan
جمال	ljepota	Nan
جمع	množina	Nan
جمعة	petak	None
جمعت	prikupljeno	Nan
جمعه	petak	None
جمعها	prikupljeno	Nan
جمعية	udruženje	None
جملة	rečenica	None
جمهور	javni	None
جلال	celal	Nan
جزر	mrkva	Nan
جل	gel	Nan
جغرافية	geografija	None
جزيرة	ostrvo	None
جساس	špijun	Nan
جسد	telo	Nan
جسده	njegovo tijelo	Nan
جسدها	njeno tijelo	Nan
جسر	most	None
جسم	telo	Nan
جسمه	njegovo tijelo	Nan
جسيمات	čestice	None
جعفر	jaafar	Nan
جعل	čine	None
جعلت	napravljeno	Nan
جعله	napravi to	Nan
جعلها	napravi to	Nan
جغرافيا	geografija	None
جفاف	suša	None
جانبي	strana	None
جانبه	njegova strana	Nan
جانب	strana	None
تيمية	taymiyya	Nan
تُشكل	forma	None
تُظهر	pojaviti se	Nan
تُعتبر	smatra se kao	Nan
تُعد	pripremite se	Nan
تُعرف	poznat	None
ثابتة	fiksno	Nan
ثار	osveta	Nan
ثالث	treća	None
ثاليوم	talijum	None
ثانوية	srednja škola	Nan
ثاني	sekunda	Nan
ثانيا	drugo	None
ثانية	sekundu	Nan
ثبت	dokazan	Nan
تيمور	timur	Nan
ثروة	bogatstvo	None
تيفوس	tifus	Nan
تيار	potok	None
توقع	očekivanje	Nan
توقف	stani	Nan
توقيع	potpis	Nan
توكيس	tokis	Nan
تولد	porođaj	None
تولى	preuzeti	Nan
توليد	generacija	None
توليه	inauguracija	Nan
تولّى	preuzeti	Nan
توما	toma	Nan
توماس	thomas	None
تونس	tunis	None
تويوتا	toyota	Nan
تويودا	toyoda	Nan
تي	t	Nan
تيارات	struje	None
ثقافات	kulture	None
ثقافة	kultura	None
ثقافي	kulturni	None
جاء	došli	None
جاءت	ona je došla	Nan
جائزة	nagradu	None
جابر	jaber	Nan
جاذبية	gravitacija	Nan
جاسم	jassim	Nan
جاك	jack	Nan
جاكسون	jackson	None
جالوت	golijat	Nan
جاليليو	galileo	Nan
جالينوس	galen	Nan
جامع	džamija	None
جامعات	univerziteti	Nan
جامعة	univerzitet	None
جان	jan	Nan
ج	c	None
ثيوديسيا	teodisija	Nan
ثورة	revolucija	None
ثورات	revolucije	None
ثقافية	kulturni	None
ثقب	rupa	None
ثقة	samopouzdanje	Nan
ثلاث	tri	None
ثلاثة	tri	None
ثلاثية	trilogija	Nan
ثلاثين	trideset	None
جمهوري	republički	Nan
ثلث	jedna trećina	Nan
ثمان	osam	None
ثماني	osam	None
ثمانية	osam	None
ثمة	tu je	Nan
ثمّ	onda	None
ثنائية	dualizam	Nan
ثور	vola	Nan
ثم	onda	None
توفيق	pomiriti se	Nan
جمهورية	republika	None
جميعا	svi oni	Nan
حدائق	bašte	Nan
حدة	oštrina	Nan
حدث	događaj	None
حدثت	ažurirano	Nan
حدثنا	reci nam	Nan
حدد	locirajte	Nan
حدودها	njegove granice	Nan
حديث	moderna	None
حديثا	novo	None
حديثة	moderna	None
حديثًا	novo	None
حديد	gvožđe	Nan
حديدية	ferrous	Nan
حديقة	vrt	None
حراء	hira	Nan
حد	limit	Nan
حرارة	toplina	Nan
حجوالة	transfer	Nan
حجما	po veličini	Nan
حاليا	trenutno	None
حالياً	trenutno	None
حاليًا	trenutno	None
حامد	hamed	Nan
حامل	trudna	None
حاول	pokusaj	Nan
حاولت	pokušao sam	Nan
حب	ljubav	None
حبيب	ljubavnik	Nan
حبيبي	dušo	Nan
حتى	sve dok	Nan
حتي	sve dok	Nan
حجة	argument	Nan
حجر	stone	Nan
حجم	veličina	None
حجمها	njegovu veličinu	Nan
حالته	njegovo stanje	Nan
حرارته	njegova vrućina	Nan
حرام	zabranjeno	None
حساسة	osetljiv	Nan
حسان	hassan	Nan
حسب	prema	None
حسن	hassan	Nan
حسنة	dobro djelo	Nan
حسني	hosni	Nan
حسين	hussain	Nan
حشد	gužva	Nan
حشرات	insekti	Nan
حشيشة	hašiš	Nan
حصار	opsada	None
حصة	period	None
حصدت	ubrano	Nan
حصل	dogodilo	None
حصلت	dobio sam	Nan
حسابات	računi	Nan
حرارتها	njegova vrućina	Nan
حساب	račun	None
حزن	sadnes	Nan
حرب	rata	None
حربية	ratni brod	Nan
حرة	besplatno	Nan
حرس	čuvar	Nan
حرف	pismo	None
حرق	spali	Nan
حركات	kretanja	None
حركة	pokreta	None
حرم	zabranjeno	None
حروب	ratovi	None
حروف	pisma	None
حرية	sloboda	None
حزام	pojas	None
حزب	zabava	Nan
حزم	remen	Nan
حزيران	juna	None
حالة	statusa	None
حالب	ureter	Nan
حالات	slučajeva	None
جهات	odredišta	Nan
جهاد	džihad	Nan
جهاز	uređaj	None
جهة	side	Nan
جهد	napor	None
جهود	naporima	Nan
جو	atmosfera	None
جوائز	nagrade	None
جواز	pasoš	Nan
جوانب	aspekti	Nan
جواهر	nakit	Nan
جوجل	google	None
جودة	kvaliteta	None
جورج	george	None
جورجيا	gruzije	Nan
جنوده	njegovi vojnici	Nan
جورجيون	gruzijci	Nan
جنود	vojnici	None
جنوبي	južna	None
جميعاً	svi oni	Nan
جميعًا	svi oni	Nan
جميل	divno	Nan
جميلة	divno	Nan
جناح	apartman	Nan
جنب	side	Nan
جندي	vojnik	None
جنس	seks	None
جنسي	seksualni	Nan
جنسية	nacionalnost	Nan
جنطيانية	gentianstvo	Nan
جنكيز	džingis	Nan
جنو	gnu	None
جنوب	jug	None
جنوبا	jug	None
جنوبًا	jug	None
جوزيف	joseph	None
جولة	tura	Nan
جون	john	None
حائل	zdravo!	Nan
حاتم	hatem	Nan
حاجة	potreba	None
حادة	oštro	None
حادث	nesreća	Nan
حادثة	incident	Nan
حار	vruće	Nan
حارب	borba	None
حارة	lane	Nan
حاز	ima	None
حاسوب	kompjuter	Nan
حافة	ivica	None
حافظ	hafiz	Nan
حافظت	održava	None
حال	stanje	None
حائط	zid	None
جيوش	vojske	None
جينات	geni	Nan
جين	gene	Nan
جوهر	suština	Nan
جوي	vazdušna	Nan
جوية	zrak	None
جي	ing	Nan
جيبوتي	džibuti	Nan
جيجابت	gigabit	Nan
جيد	dobro	None
جميع	sve	None
جيدا	pa	None
جيدة	dobar	None
جيش	vojska	None
جيشه	njegova vojska	Nan
جيشًا	vojska	None
جيفارا	guevara	Nan
جيل	generacija	None
جيمس	james	None
جيداً	pa	None
توفير	navedite	Nan
توفيت	umrla je	Nan
توفي	umro	None
تضع	staviti	None
تضم	uključuje	None
تطبق	primijeniti	Nan
تطبيق	implementacija	Nan
تطبيقات	aplikacije	None
تطل	pogledaj dole	Nan
تطلب	pitajte	Nan
تطلق	otpušten	Nan
تطهير	dezinfekcija	Nan
تطور	evoluirala	Nan
تطورا	sofisticiran	Nan
تطورت	evoluirao	Nan
تطوير	razvoj	None
تطوّر	evoluirala	Nan
تظل	ostani	Nan
تضخم	swell	Nan
تظهر	pojaviti se	Nan
تضاعف	pomnoženo	Nan
تصوير	uslikaj	Nan
تصنيفعلم	klasifikacijska zastava	Nan
تصنيفعلماء	klasifikacija naučnika	Nan
تصنيفعواصم	klasifikacija glavnih gradova	Nan
تصنيففلاسفة	klasifikacija filozofa	Nan
تصنيفقادة	vođe rejtinga	Nan
تصنيفكتاب	klasifikacijska knjiga	Nan
تصنيفلاعبو	klasifikacija igrača	Nan
تصنيفمدن	klasifikacija gradova	Nan
تصنيفمصريون	ocjena egipćana	Nan
تصنيفممثلات	klasifikacija glumica	Nan
تصنيفممثلون	ocjenjivanje aktera	Nan
تصنيفمواليد	klasifikacija novorođenčadi	Nan
تصنيفوزراء	klasifikacija ministara	Nan
تصنيفوفيات	klasifikacije	Nan
تصور	zamislite	Nan
تصيب	zarazno	Nan
تصنيفصحابة	prateći klasifikacija	Nan
تعارض	ne slažem se	Nan
تعالى	dođi	Nan
تعطى	s obzirom	Nan
تعطي	daj	Nan
تعكس	reflektiraju	Nan
تعلم	naučite	Nan
تعليم	obrazovanja	None
تعليمه	obrazovani	Nan
تعليمية	obrazovni	Nan
تعمل	radno	Nan
تعني	znači	None
تعود	povratak	None
تعيش	uživo	None
تغطي	pokrivanje	Nan
تغطية	pokrivenost	Nan
تغلب	preboli	Nan
تغير	promjena	None
تعزيز	ojačaj	Nan
تعاطي	zloupotreba	Nan
تعرّض	izloženost	Nan
تعرف	znaš	Nan
تعاليم	predavanja	None
تعامل	deal	Nan
تعاني	patiti	Nan
تعاون	saradnja	None
تعبر	križ	Nan
تعتبر	smatra se kao	Nan
تعترف	prepoznati	Nan
تعتمد	zavisi	None
تعد	pripremite se	Nan
تعداد	popisivanje	Nan
تعددت	umnožio sam se	Nan
تعديل	modifikacija	None
تعرض	izloženost	Nan
تعرضت	bio je izložen	Nan
تعرضوا	bili su izloženi	Nan
تعريف	definicija	None
تصنيفشعراء	klasifikacija pjesnika	Nan
تصنيفرؤساء	klasifikacija glava	Nan
تصنيفديمقراطيات	klasifikacija demokratije	Nan
تسمية	imenovanje	Nan
تسونامي	tsunami	Nan
تسوية	nagodba	Nan
تسير	ide	None
تسيطر	kontrole	None
تشاد	čad	None
تشارك	uključeni	Nan
تشارلز	charles	None
تشبه	kao	None
تشترك	podijeli	Nan
تشتمل	uključi	Nan
تشتهر	poznat je po	Nan
تشجيع	ohrabrite	Nan
تشخيص	dijagnosticirano	Nan
تشرف	poštovani	Nan
تسمى	to se zove	Nan
تشريع	zakonodavstvo	Nan
تسمح	dopustiti	Nan
تسلم	primljeno	Nan
تستخدم	rabljeni	Nan
تستطع	možeš	Nan
تستطيع	dali bi mogao	Nan
تستعمل	rabljeni	Nan
تستغرق	uzmi	Nan
تستمر	to se nastavlja	Nan
تستهلك	konzumirajte	Nan
تسجيل	prijaviti se	Nan
تسخين	grejanje	Nan
تسرب	propuštanje	Nan
تسع	devet	Nan
تسعة	devet	Nan
تسعى	tražim	Nan
تسقط	padajući	Nan
تسلسل	niz	None
تسليم	dostava	Nan
تشرين	tishreen	Nan
تشغل	trči	Nan
تشغيل	trčanje	Nan
تصغير|مسجد	smanjite | džamiju	Nan
تصف	opišite	Nan
تصل	dosegni	Nan
تصميم	dizajn	None
تصنع	proizvedeno	Nan
تصنف	razvrstani su	Nan
تصنيع	proizvodnja	None
تصنيف	ocena	Nan
تصنيفآل	klasifikacija	None
تصنيفأشخاص	klasifikacija osoba	Nan
تصنيفأعلام	klasifikacijske zastave	Nan
تصنيفبلدان	klasifikacija zemlje	Nan
تصنيفتاريخ	datum ocjenjivanja	Nan
تصنيفخريجو	klasifikacija diplomanata	Nan
تصنيفدول	zemlje klasifikacije	Nan
تصغير|صورة	smanji | slika	Nan
تصغير|رسم	smanjite | crtajte	Nan
تصغير|بك|رسم	smanjite | svoj | crtež	Nan
تصغير|	smanji |	Nan
تشكل	forma	None
تشكلت	formirano	Nan
تشكيل	formacija	None
تشمل	uključi	Nan
تشهد	svjedočiti	Nan
تشي	che	Nan
تشير	ukazati	Nan
تغيرات	promjene	None
تشيكوسلوفاكيا	čehoslovačka	Nan
تشييد	izgradnja	None
تشييط	proverite	Nan
تصاعد	montaža	Nan
تصب	sipati	Nan
تصبح	postanite	Nan
تصدر	izdato	Nan
تصدير	izvoz	None
تشين	chen	Nan
تغيرت	promenjeno	Nan
تغيير	promjena	None
تفاصيل	detalji	Nan
تمنع	sprečiti	Nan
تمويل	finansije	None
تميز	istaknuti	None
تميزت	označeno	Nan
تميل	tend	Nan
تميم	tamim	Nan
تمييز	diskriminacija	Nan
تمّ	gotovo	None
تنازل	odricanje	Nan
تناول	prehrana	Nan
تناولت	jedi	Nan
تنبأ	predviđeno	Nan
تنتج	proizvodi	None
تنتشر	raširiti	Nan
تنتقل	pomicanje	Nan
تمنح	odobreno	Nan
تنتمي	belong	Nan
تملك	posjeduje	None
تمرد	pobuna	None
تم	gotovo	None
تمارس	vježba	Nan
تمام	uredu	Nan
تماما	u potpunosti	Nan
تماماً	u potpunosti	Nan
تمامًا	u potpunosti	Nan
تمت	gotovo	None
تمتاز	excel	Nan
تمتد	istezanje	None
تمتعت	uživao sam	Nan
تمتلك	posjeduje	None
تمثال	kip	None
تمثلت	na slici	Nan
تمثيل	reprezentacija	None
تمر	pass	Nan
تمكن	upravljani	Nan
تنتهي	ističe	None
تنخفض	ići dole	Nan
تنسيق	koordinat	Nan
توتونيون	teutonski	Nan
توجد	oni su	Nan
توجه	orijentacija	Nan
توجيه	uputstvo	Nan
توحيد	standardizacija	Nan
توزيع	distribucija	None
توسع	ekspanzija	Nan
توسعت	prošireno	Nan
توسيع	ekspanzija	Nan
توصل	dođite	Nan
توصيل	povezivanje	None
توضح	pojasnite	Nan
توضع	budite smešteni	Nan
توفر	dostupnost	Nan
توفى	umro	None
توت	borovnica	Nan
توافق	slažete se	Nan
توازن	bilans	Nan
تواجه	lice	None
تنشأ	ustani	Nan
تنص	države	None
تنظم	organizovati	Nan
تنظيم	grupa	None
تنفيذ	implementacija	Nan
تنقسم	podeljeno	Nan
تنقل	transfer	Nan
تليها	pratio	Nan
تنمو	rasti	Nan
تنوع	raznolikost	Nan
تهتم	briga	Nan
تهدد	prijeteći	Nan
تهدف	ciljevi	None
تهيمن	dominirajte	Nan
توابل	začini	Nan
تواجد	postojanje	None
تنمية	razvoj	None
حصن	fort	Nan
تلوث	zagađenje	Nan
تلك	to	None
تقدمه	ponudi	Nan
تقدمها	pod uvjetom	Nan
تقدير	zahvalnost	Nan
تقديرات	procjene	None
تقديم	pošaljite	Nan
تقرر	odlučite	Nan
تقريبا	otprilike	None
تقريباً	otprilike	None
تقريبًا	otprilike	None
تقرير	izveštaj	Nan
تقسم	podijelite	Nan
تقسيم	divizija	None
تقضي	potrošiti	Nan
تقع	smješten	None
تقف	ustani	Nan
تقدمت	napredno	Nan
تقل	manje	None
تقدم	napredak	None
تقتصر	zatvoren	None
تفاعل	interakcija	Nan
تفاعلات	interakcije	None
تفرض	nametnuti	Nan
تفسير	objašnjenje	None
تفصل	odvojeni	None
تفعل	rade	None
تفقد	izgubiti	None
تفكك	raspalo	Nan
تفوق	izvrsnost	Nan
تفيد	benefit	Nan
تقارب	zbližavanje	Nan
تقارير	izveštaji	Nan
تقاليد	tradicije	None
تقام	održavaju se	Nan
تقبل	prihvati	None
تقدر	cene	Nan
تقلل	smanjite	Nan
تقليد	tradicija	None
تقليدية	tradicionalno	None
تكنولوجيا	tehnologija	None
تكون	budi	None
تكونت	formirano	Nan
تكوين	formacija	None
تكيف	adaptacija	Nan
تل	brdo	None
تلال	hills	Nan
تلاميذه	njegovi učenici	Nan
تلبية	upoznajte	Nan
تلت	praćen	Nan
تلعب	sviraj	Nan
تلف	oštećenja	None
تلفزيون	tv	None
تلفزيونية	televizija	None
تلقى	primanje	Nan
تكن	budi	None
تكمن	laži	Nan
تكليس	kalcinacija	Nan
تكلفة	trošak	None
تقليل	smanjite	Nan
تقنيات	tehnologije	None
تقنية	tehnika	None
تقود	olovo	None
تقول	kaže	None
تقوم	ustani	Nan
تقوية	jačanje	Nan
تلو	posle	None
تقويم	procena	Nan
تقييم	procena	Nan
تكاد	skoro	None
تكاليف	troškovi	Nan
تكتب	ona piše	Nan
تكثر	obilno	Nan
تكرار	ponavljanje	None
تكساس	texas	Nan
تقي	pobožni	Nan
حصول	get	Nan
حضارات	civilizacije	None
حضارة	civilizaciji	Nan
ركن	ugao	None
رمزا	simbol	None
رمزية	simbolizam	Nan
رمسيس	ramses	Nan
رمضان	ramazan	None
رموز	simboli	None
رمي	baci	Nan
روابط	veze	None
رواد	pioniri	Nan
رواه	pričao	Nan
روايات	novele	None
رواية	roman	None
روبرت	roberte	Nan
روثينيوم	rutenijum	Nan
روح	duhu	None
ركام	rubble	Nan
روس	ross	Nan
رقيقة	tanka	Nan
رقعة	patch	Nan
رصد	monitor	None
رضا	zadovoljstvo	Nan
رضي	zadovoljan	Nan
رعاف	epistaksa	Nan
رعاية	njega	None
رعد	grom	Nan
رغبة	želja	None
رغم	uprkos tome	Nan
رفض	odbijanje	Nan
رفضت	odbila je	Nan
رفضه	odbacili	Nan
رفع	upload	Nan
رفعت	podignuta	Nan
رفيعة	vitko	Nan
رفيق	društvo	None
رقم	broj	None
رشيد	rashid	Nan
روستوك	rostock	Nan
روسيا	rusija	None
زالت	ipak	None
زاوية	ugao	None
زايد	zayed	Nan
زحف	puzeći	Nan
زحل	saturn	Nan
زراعة	poljoprivreda	None
زراعية	poljoprivredne	None
زرع	sadnja	Nan
زرنيخيد	arsenid	Nan
زعامة	rukovodstvo	Nan
زعماء	lideri	Nan
زعيم	vođa	None
زغلول	zaghloul	Nan
زكريا	zakaria	Nan
زكي	zaki	Nan
زال	ipak	None
روسو	russo	Nan
زار	posetite	Nan
زاد	povećana	Nan
روما	rim	None
رومانيا	rumunija	None
رومانية	rumunski	None
رونالدو	ronaldo	Nan
روى	pričala	Nan
روي	roy	Nan
رياح	vjetar	None
رياض	riad	Nan
رياضة	sport	None
رياضية	atletski	Nan
ريال	rial	Nan
ريتشارد	richard	None
ريشة	quill	Nan
ريكشا	riksha	Nan
ريولوجيا	reologija	Nan
زادت	povećana	Nan
رشد	odrasla osoba	Nan
رسوم	naknade	Nan
رسول	glasnik	None
رئاسة	predsjedavanje	Nan
رئيس	predsjedniče	Nan
رئيسا	kao predsjednik	Nan
رئيساً	kao predsjednik	Nan
رئيسة	predsjedavajuća	Nan
رئيسيا	bojniče	Nan
رئيسياً	bojniče	Nan
رئيسية	bojniče	Nan
رئيسيين	bojniče	Nan
رئيسًا	predsjedniče	Nan
رائحة	miris	None
رائد	pionir	Nan
رائدة	vođa	None
رائعة	divno	Nan
رابط	veza	None
رؤيتها	vidi to	Nan
رابطة	udruženje	None
رؤية	vizija	Nan
رؤوس	glave	None
ذوات	žene	None
ذوي	sa	None
ذي	dhi	Nan
ذُكر	muško	Nan
رآه	vidio sam	Nan
رأت	videla je	Nan
رأس	glava	None
رأسه	glavu	None
رأسها	glava joj	Nan
رأسهم	njihova glava	Nan
رأى	mišljenje	None
رأي	mišljenje	None
رأيت	vidio sam	Nan
رأيه	baner	Nan
رؤساء	glave	None
رؤيا	vizija	Nan
رابع	četvrto	Nan
راجع	vidi	None
راشد	rashid	Nan
رحل	gone	Nan
رحلات	krstarenja	Nan
رحلة	putovanje	None
رحلته	njegov let	Nan
ردود	odgovori	Nan
رسائل	poruke	None
رسالة	poruka	None
رسالته	njegova poruka	Nan
رستم	rustem	Nan
رسم	izvući	Nan
رسمها	izvučeno	Nan
رسمي	zvanična	None
رسميا	zvanično	None
رسمياً	zvanično	None
رسميًا	zvanično	None
رجم	kamenovan	Nan
رجليها	njene noge	Nan
رجلاً	čovjek	None
رجلا	čovjek	None
رام	archer	Nan
راية	baner	Nan
رب	allah	None
ربط	veza	None
ربع	četvrtina	Nan
ربما	vjerovatno	None
ربه	gospode	Nan
زلزال	zemljotres	Nan
ربيع	proljeće	None
رتب	sortirati	Nan
رتبة	rang	None
رجال	muškarci	None
رجاله	njegovi ljudi	Nan
رجب	regep	Nan
رجع	vratio se	Nan
رجل	noga	Nan
ربيعة	rabia	Nan
زمان	vreme	None
زمانه	njegovo vreme	Nan
زمن	vreme	None
سعودية	saudijski	Nan
سعوديون	saudijci	Nan
سعى	tražio	None
سعيد	sretno	Nan
سفر	putovanje	None
سفن	brodovi	None
سفيان	soufyan	Nan
سفينة	brod	None
سقراط	sokrat	None
سقط	pasti	Nan
سقطت	pad	None
سقوط	odustani	Nan
سكان	stanovništva	None
سكانديوم	scandium	Nan
سكانها	njegova populacija	Nan
سعودي	saudijski	Nan
سكانية	stanovništvo	None
سعود	saud	Nan
سعت	tražio sam	Nan
سراح	pušten	Nan
سرطان	rak	None
سرعان	uskoro	None
سرعة	brzina	None
سرقة	krađa	Nan
سرو	čempres	Nan
سري	tajna	None
سرية	tajnost	Nan
سريع	brzo	None
سريعة	brzo	None
سريعًا	uskoro	None
سطح	površina	None
سطحه	njegova površina	Nan
سطحها	njegova površina	Nan
سعاد	suad	Nan
سعر	cijena	None
سكة	rail	Nan
سكر	šećer	None
سكك	šine	Nan
سلوك	ponašanje	None
سليم	salim	Nan
سليمان	sulaiman	Nan
سم	cm	Nan
سمات	značajke	Nan
سماه	nazvao ga je	Nan
سمة	osobina	None
سمح	dozvoljeno	None
سمحت	dozvoljeno	None
سمع	cuo je	Nan
سمعت	čuo sam	Nan
سمك	riba	None
سمي	imenovana	Nan
سميت	ime je dobilo	Nan
سمير	isti	None
سلمية	mirno	None
سلمة	salamah	Nan
سلمان	salman	Nan
سلم	ljestve	Nan
سكن	rezidencija	Nan
سلاح	oružje	None
سلاسل	lanci	None
سلاطين	sultani	Nan
سلالات	sojevi	Nan
سلالة	naprezanje	Nan
سلام	zdravo	Nan
سر	tajna	None
سلامة	sigurnost	None
سلسلة	serija	None
سلطات	vlasti	None
سلطان	sultan	None
سلطة	salata	Nan
سلطنة	sultanat	Nan
سلف	krediti	Nan
سلفوناميد	sulfonamid	Nan
سلبية	negativno	None
ذو	gotovo	None
سدة	utikač	Nan
سحب	povlačenje	Nan
زيدان	zidane	Nan
زين	zain	Nan
زينب	zaynab	Nan
س	s	None
سأل	pitan	Nan
سؤال	pitanje	None
سائر	ostalo	None
سائل	tečnost	None
سابق	bivša	None
سابقا	ranije	None
سابقاً	ranije	None
سابقة	presedan	Nan
سابقًا	ranije	None
ساحة	dvorište	Nan
ساحل	obala	None
زيد	zaid	Nan
ساحلية	primorski	Nan
زيت	ulje	Nan
زيادة	plus	None
زمني	moje vreme	Nan
زمنية	vreme	None
زنكي	cink	None
زهرة	cvijet	None
زواج	brak	None
زواجه	njegov brak	Nan
زوال	smrt	None
زوج	muž	None
زوجات	žene	None
زوجاته	njegove žene	Nan
زوجة	supruga	None
زوجته	njegova žena	Nan
زوجها	njen muž	Nan
زوكربيرج	zuckerberg	Nan
زياد	ziyad	Nan
زيارة	posetite	Nan
سار	on je hodao	Nan
ساراكينوس	saracenus	Nan
سارة	sara	Nan
سبعة	sedam	None
سبعين	sedamdeset	Nan
سبق	već	None
سبقت	potrči gore	Nan
سبيس	moj prostor	Nan
سبيل	put	None
ست	šest	None
ستالين	staljin	Nan
ستة	šest	None
ستكون	biti će	Nan
ستيرول	sterol	Nan
ستين	šezdeset	Nan
سجل	zapis	None
سجن	zatvor	Nan
سحابة	oblak	None
سبع	sedam	None
سبحانه	slava mu	Nan
سبتمبر	septembra	None
سببا	razlog	None
ساعات	sati	None
ساعة	sat	None
ساعد	assist	Nan
ساعدت	pomoglo	Nan
سافر	putovanje	None
سالم	salem	Nan
سامي	sami	None
سد	utikač	Nan
سامية	uzvišeno	Nan
سانت	st.	Nan
ساهم	doprinosi	None
ساهمت	doprinosi	None
سبأ	sheeba	Nan
سباق	trka	Nan
سباقات	trke	Nan
سبب	razlog	None
سان	san	None
لتصل	da se dosegne	Nan
ذهبية	zlatna	None
ذلك	da	None
خاصا	posebno	None
خاصة	naročito	None
خاصةً	naročito	None
خاصية	vlasništvo	None
خاض	tukao	Nan
خاضعة	predmet	None
خالد	besmrtna	Nan
خالص	čisto	None
خالية	prazno	Nan
خام	sirovog	Nan
خان	khan	Nan
ختان	obrezivanje	Nan
خدمات	usluge	None
خدمة	usluga	None
خديجة	hatice	Nan
خاص	poseban	None
خرائط	karte	None
خارجية	spoljni	Nan
خادم	sluga	Nan
حياتها	njen život	Nan
حياتهم	njihovi životi	Nan
حياتي	moj život	Nan
حيان	hayyan	Nan
حية	živahno	Nan
حيث	gde	None
حيفا	haifa	Nan
حين	kada	None
حينما	kad god	Nan
حينها	tada	None
حيوان	životinja	None
حيوانات	životinje	None
حيوانية	životinja	None
حيوية	vitalnost	Nan
خابية	skladiste	Nan
خارجي	eksterni	Nan
حياته	njegov zivot	Nan
خراسان	khorasan	Nan
خرجت	izašao	None
خطبة	govor	None
خطة	plan	None
خطر	rizik	None
خطط	planovi	None
خطف	otmica	Nan
خطوة	korak	None
خطورة	opasnost	None
خطوط	linije	None
خطيرة	ozbiljno	Nan
خفض	smanjiti	Nan
خفيف	svjetlost	None
خفيفة	svetlost	Nan
خلاف	spor	Nan
خلافته	njegova sukcesija	Nan
خلال	kroz	None
خطاب	govor	None
خرج	izašao	None
خطأ	greška	None
خضعت	prošli ste	Nan
خرجوا	izašli su	Nan
خروج	izlaz	None
خريطة	karta	None
خزيمة	poraz	None
خسائر	gubici	Nan
خسارة	gubitak	None
خسر	izgubljeni	Nan
خصائص	svojstva	None
خصبة	plodna	Nan
خصوصا	posebno	None
خصوصاً	posebno	None
خصوصًا	posebno	None
خصومه	spor	Nan
خضراء	zeleno	None
خضع	predmet	None
خط	linija	None
حياة	život	None
حي	susjedstvo	Nan
حولها	okolo	Nan
حكام	vladari	None
حكايات	priče	None
حكاية	priča	None
حكم	pravilo	None
حكمة	mudrost	Nan
حكمت	vladala je	Nan
حكمه	mudrost	Nan
حكمها	njegovo pravilo	Nan
حكمهم	njihova vladavina	Nan
حكومات	vlade	None
حكومة	vlada	None
حكومي	vladina	Nan
حكومية	vladina	Nan
حكيم	kadulja	Nan
حلال	halal	Nan
حقيقية	pravi	None
حلب	aleppo	Nan
حقيقي	stvaran	Nan
حقول	polja	None
حضر	pohađao	Nan
حضور	prisutnost	None
حطين	hittin	Nan
حظر	zabrana	Nan
حفر	bušenje	Nan
حفظ	uštedjeti	Nan
حفل	party	Nan
حق	tačno	None
حقائق	činjenice	None
حقبة	era	None
حقق	postići	None
حققت	postignuto	Nan
حقل	polje	None
حقه	njegovo pravo	Nan
حقوق	prava	None
حقيقة	činjenica	None
حلت	raspušteno	Nan
حلف	kunem se	Nan
حلقات	epizode	Nan
حمير	magarci	Nan
حنا	hanna	Nan
حنبعل	hannibal	Nan
حنبل	hanbal	Nan
حنك	nepce	Nan
حنيفة	hanifa	Nan
حنين	nostalgija	Nan
حواء	eve	Nan
حوادث	nesreće	Nan
حوار	dijalog	Nan
حوالي	okolo	Nan
حوذانية	leptir	Nan
حوض	umivaonik	Nan
حول	o:	Nan
حوله	oko njega	Nan
حملته	njegova kampanja	Nan
حملت	napunjeno	Nan
حملة	kampanju	Nan
حملات	kampanje	Nan
حلقة	prsten	None
حلمي	moj san	Nan
حلول	rešenja	Nan
حلويات	candy	Nan
حماة	zaštitnici	Nan
حماد	hammad	Nan
حماس	entuzijazam	Nan
خلاله	tokom njega	Nan
حماية	zaštita	None
حمدان	hamdan	Nan
حمدي	hamdija	None
حمراء	crveno	Nan
حمزة	hamza	Nan
حمص	slanutak	Nan
حمض	kiselina	None
حمل	trudnoća	None
حمد	pohvalio se	Nan
خلالها	tokom njega	Nan
خلايا	ćelije	None
خلدون	khaldoun	Nan
دورات	kursevi	Nan
دوران	rotacija	Nan
دوراً	uloga	None
دورة	kurs	Nan
دوره	kurs	Nan
دورها	njena uloga	Nan
دوري	ciklički	Nan
دورية	patrola	Nan
دورًا	uloga	None
دول	zemlje	None
دولار	dolara	None
دولة	država	None
دولته	njegova zemlja	Nan
دولتهم	njihova država	Nan
دولتين	dve države	Nan
دورا	uloga	None
دولي	međunarodni	None
دور	uloga	None
دو	du	None
دفن	ukop	Nan
دقائق	minuta	None
دقة	tačnost	Nan
دقيق	brašno	Nan
دقيقة	tacno	Nan
دلائل	dokazi	None
دلالة	indikacija	Nan
دلتا	delta	None
دليل	vodič	None
دم	krv	None
دمج	spajanje	Nan
دمرت	uništeno	Nan
دمشق	damask	Nan
دمياط	damietta	Nan
دنيا	donia	Nan
دوائر	krugove	Nan
دولياً	međunarodno	None
دولية	međunarodni	None
دون	bez	None
ذاته	isto	None
ذاتها	sebe	None
ذاتي	subjektivno	Nan
ذاتية	nastavi	Nan
ذاك	da	None
ذاكرة	memorija	None
ذرات	atomi	Nan
ذروة	vrhunac	None
ذروتها	climax	Nan
ذرية	potomstvo	Nan
ذكر	muško	Nan
ذكره	spomenuo je	Nan
ذكرها	spomenite to	Nan
ذكرى	memorija	None
ذكور	muško	Nan
ذات	srodni	Nan
ذا	the	None
ديوان	diwan	Nan
دينًا	religija	None
دياب	diab	Nan
ديانة	religija	None
دير	manastira	Nan
ديزني	disney	Nan
ديسمبر	dec	Nan
ديفنباخيا	devenpachia	Nan
ديفيد	david	None
دفعت	plaćeno	Nan
ديل	dell	Nan
دين	dug	None
دينار	dinar	None
ديناصور	dinosaur	Nan
دينه	njegova religija	Nan
دينهم	njihova religija	Nan
ديني	vjerski	None
دينية	vjerski	None
ديمقراطية	demokratija	None
ذهب	idi	Nan
دفعة	plaćeno	Nan
دعى	zvao je	Nan
خوف	strah	None
خوفو	khufu	Nan
خياطة	šivanje	Nan
خيبر	khaibar	Nan
خير	dobro	None
د	dr	None
دا	s	None
داء	bolest	None
دائرة	krug	None
دائرية	kružna	Nan
دائم	stalni	None
دائما	uvek	Nan
دائماً	uvek	Nan
دائمة	uvek	Nan
دائمًا	uvek	Nan
خوسيه	jose	Nan
داخل	iznutra	Nan
خوان	juan	None
خمسة	pet	None
خلع	skinuta	Nan
خلف	iza	None
خلفاء	nasljednici	None
خلفه	iza njega	Nan
خلفها	prepušteno	Nan
خلفية	pozadina	Nan
خلقه	njegova kreacija	Nan
خلل	defekt	Nan
خلنجية	heather	Nan
خلية	ćelija	None
خليج	zaljev	Nan
خليط	mešavina	Nan
خليفة	naslednik	Nan
خليل	khalil	Nan
خمس	pet	None
خمسين	pedeset	None
داخلي	interne	Nan
داخلية	interni	Nan
دار	dar: kuća	Nan
درس	lekcija	Nan
درع	štit	None
درهم	dirham	Nan
دروس	tutoriali	Nan
درويش	darwish	Nan
دريد	duraid	Nan
دستور	ustav	None
دستوري	ustavni	None
دستورية	ustavnost	Nan
دعا	pozovite	Nan
دعاء	molitva	None
دعت	zvala je	Nan
دعم	podrška	None
دعوة	pozovite	Nan
دعوته	njegov poziv	Nan
درجة	stupanj	Nan
درجات	stepeni	Nan
درب	put	None
دراما	drame	None
دارت	dart	Nan
داروين	darwin	None
دام	kasnio	Nan
دامت	sve dok	Nan
داود	david	None
داوود	david	None
دبلوماسية	diplomacija	Nan
دفع	platite	Nan
دبي	dubai	Nan
دخل	prihodi	None
دخلت	ušao sam	Nan
دخول	ulogovati se	Nan
دخوله	ulazeći u njega	Nan
دراسات	studije	None
دراسته	proučite	Nan
دراسية	studija	None
دجلة	tigris	Nan
لتطور	razviti	Nan
لتطوير	razviti	Nan
لتعداد	da nabrojim	Nan
وتكون	i biti	Nan
وتكوين	i konfigurirati	Nan
وتلك	i one	Nan
وتم	i to je učinjeno	Nan
وتمت	i to je učinjeno	Nan
وتمتد	istezanje	None
وتمتلك	i posjeduje	Nan
وتمثل	i predstavljaju	Nan
وتمكن	uspio je	Nan
وتنتج	to proizvodi	Nan
وتنتشر	i širi se	Nan
وتنظيم	i regulacija	Nan
وتنقسم	podeljeno	Nan
وتهدف	cilj	None
وتوجد	oni su	Nan
وتقوم	i na osnovu	Nan
وتوزيع	i distribucija	Nan
وتقول	i ona kaže	Nan
وتقدم	omogućeno je	Nan
وتطور	razvila se	Nan
وتطورت	i evoluiralo se	Nan
وتطوير	i razvijati se	Nan
وتظهر	i pokazati	Nan
وتعالى	svemogući	Nan
وتعتبر	smatraju se	Nan
وتعتمد	zavisi	None
وتعد	i pripremite se	Nan
وتعرف	a znate	Nan
وتعزيز	i promocija	Nan
وتعمل	radi	None
وتعني	to znači	Nan
وتعود	i natrag	Nan
وتعيين	i postavite	Nan
وتغطي	i pokrivanje	Nan
وتقع	pad	None
وتطبيق	i aplikacija	Nan
وتوفي	on je umro	Nan
وتونس	i tunis	Nan
وجعلها	i napravi	Nan
وجل	uzvišen	Nan
وجمع	i skupljajte	Nan
وجمهورية	i republika	Nan
وجميع	i sve	Nan
وجنوب	i jug	Nan
وجه	lice	None
وجهات	odredišta	Nan
وجهة	odredište	Nan
وجهه	njegovo lice	Nan
وجهها	njeno lice	Nan
وجوب	obavezno	None
وجود	prisutnost	None
وجوده	njegovo prisustvo	Nan
وجودها	njegovo prisustvo	Nan
وجعل	i napravi	Nan
وتولى	uzeo je	Nan
وجزيرة	i ostrvo	Nan
وجدير	vrijedi	None
وتيرة	pace	Nan
وثائق	dokumenata	None
وثائقي	dokumentarni	None
وثاني	i drugo	Nan
وثلاثة	i tri	Nan
وثلاثون	trideset	None
وثلاثين	trideset	None
وثيقة	dokument	None
وجاء	on je došao	Nan
وجاءت	ona je došla	Nan
وجامعة	i univerzitet	Nan
وجبال	i planine	Nan
وجبل	i montirati	Nan
وجد	je pronađeno	Nan
وجدت	pronađeno	Nan
وجزر	i ostrva	Nan
وتضم	sastoji se	Nan
وتصل	i gore	Nan
وتصبح	i postani	Nan
وبريطانيا	i britanija	Nan
وبسبب	i zbog	Nan
وبشكل	i na neki način	Nan
وبصفة	i na neki način	Nan
وبعد	i jos	Nan
وبعدها	i onda	Nan
وبعض	i neke	Nan
وبعضها	neki su	Nan
وبعضهم	a neke od njih	Nan
وبقي	ostao je	Nan
وبقية	i ostalo	Nan
وبقيت	ostao sam	Nan
وبلاد	i zemlju	Nan
وبلغ	i pogodi	Nan
وبلغاريا	i bugarska	Nan
وبذلك	po tome	Nan
وبلغت	hit	None
وبدأت	počelo je	Nan
وبخاصة	naročito	None
وبأن	i to	Nan
وباء	epidemija	None
وباقي	i ostalo	Nan
وباكستان	i pakistan	Nan
وبالأخص	posebno	None
وبالإضافة	pored toga	Nan
وبالتالي	i zbog toga	Nan
وبالتحديد	i to konkretno	Nan
وبالرغم	iako	None
وبالفعل	i zaista	Nan
وبالمثل	isto tako	Nan
وبالنسبة	i za	Nan
وبحر	i morskim putem	Nan
وبحسب	prema	None
وبحلول	by	Nan
وبدأ	on je počeo	Nan
وبما	uključujući	None
وبناء	i graditi	Nan
وبناءً	i konstruktivno	Nan
وتحسين	i poboljšati	Nan
وتحقيق	i postići	Nan
وتحليل	i analiza	Nan
وتحمل	i nose	Nan
وتختلف	i razlikuju se	Nan
وتربية	i uzgoj	Nan
وترجمت	i prevedeno	Nan
وترك	i odlazite	Nan
وتركيا	i turska	Nan
وتستخدم	koriste se	Nan
وتسعين	devedeset	Nan
وتسمى	nazvani	Nan
وتشكل	šminka	Nan
وتشمل	uključi	Nan
وتشير	i naznačite	Nan
وتحديد	i sređivanje	Nan
وتحدث	on je govorio	Nan
وتحتوي	i sadrže	Nan
وتحتل	i zauzeta	Nan
وبنى	izgradio je	Nan
وبه	i s tim	Nan
وبها	i s tim	Nan
وبهذا	s ovim	Nan
وبين	i između	Nan
وبينما	i dok	Nan
وتأتي	i dođi	Nan
وجوه	objekt	None
وتأسيس	i uspostaviti	Nan
وتبادل	i razmena	Nan
وتبلغ	doseže	Nan
وتتضمن	to uključuje	Nan
وتتكون	sastoji se	Nan
وتتم	i to je učinjeno	Nan
وتتميز	odlikuje se	Nan
وتحت	i ispod	Nan
وتاريخ	i datum	Nan
واهتم	i vodi računa	Nan
وجيزة	ukratko	None
وحتى	i čak	Nan
وصل	dođite	Nan
وصلات	veze	None
وصلت	dosegnuo	Nan
وصلوا	stigao	None
وصناعة	i industrija	Nan
وصنع	napravljeno	Nan
وصول	pristup	None
وصوله	dolazak	None
وصية	will	Nan
وضرب	i pogodi	Nan
وضع	staviti	None
وضعت	razvijen	None
وضعف	slabost	Nan
وضعها	spusti	Nan
وطرق	i načine	Nan
وصفه	recept	Nan
وطريق	i put	Nan
وصفاته	njegove atribute	Nan
وصدر	i pušten	Nan
وسرعان	i tako dalje	Nan
وسط	centar	None
وسقوط	i pad	Nan
وسلم	njega	None
وسميت	zvalo se	Nan
وسوريا	i siriju	Nan
وسوق	i tržište	Nan
وشبه	i ličnost	Nan
وشرح	i objasnite	Nan
وشرق	i istok	Nan
وشركة	i kompanija	Nan
وشمال	sjever	None
وشهد	i video	Nan
وشهدت	i video	Nan
وصار	i postalo je	Nan
وصف	opišite	Nan
وسبب	i razlog	Nan
وطريقة	i metoda	Nan
وطن	domovina	None
وعرض	on je predstavio	Nan
وعرف	on je znao	Nan
وعرفت	znao sam	Nan
وعشرون	dvadeset	None
وعشرين	i dvadeset	Nan
وعضو	i član	Nan
وعقد	i čekaj	Nan
وعلاوة	štaviše	Nan
وعلم	i znajući	Nan
وعلماء	i učenjaci	Nan
وعلوم	i nauke	Nan
وعلى	i dalje	Nan
وعلي	i dalje	Nan
وعليه	i na njemu	Nan
وعمر	i omar	Nan
وعدم	a ne biti	Nan
وطلب	pitao	Nan
وعددها	i njegov broj	Nan
وعد	obećanje	Nan
وطني	nacionalni	None
وطنية	patriotizam	Nan
وظائف	karijere	None
وظل	i zadržali	Nan
وظلت	ona je ostala	Nan
وظهر	pojavio se	Nan
وظهرت	pojavio se	Nan
وظهور	i izgled	Nan
وظيفة	posao	None
وعاد	vratio se	Nan
وعادة	i obično	Nan
وعاش	živio je	Nan
وعاصمتها	i njen kapital	Nan
وعبد	i rob	Nan
وعبر	i preko puta	Nan
وعدد	i broj	Nan
وسام	wissam	Nan
وساعد	to je pomoglo	Nan
وسائل	znači	None
وحيدة	sam	None
وحين	i kada	Nan
وخاصة	naročito	None
وخاصةً	naročito	None
وخرج	izašao je	Nan
وخصوصا	naročito	None
وخصوصاً	naročito	None
وخصوصًا	naročito	None
وخلال	i kroz	Nan
وخلفه	a iza toga	Nan
وخلق	i stvarajte	Nan
وخمسين	i pedeset	Nan
ودار	i kuća	Nan
ودخل	i ušli	Nan
ودراسة	i studiranje	Nan
وحيد	jednokrevetna	Nan
ودرجة	i stepen	Nan
وحيث	i gdje	Nan
وحول	i o	Nan
وحدات	jedinice	None
وحدة	sam	None
وحده	sam	None
وحدها	sam	None
وحركة	i kretanje	Nan
وحرية	i sloboda	Nan
وحسب	i samo	Nan
وحسن	i dobro	Nan
وحصل	i dobio je	Nan
وحضر	i prisustvovao	Nan
وحفظ	i uštedite	Nan
وحقوق	i prava	Nan
وحكم	i presuda	Nan
وحماية	i zaštiti	Nan
وحمل	i preuzmi	Nan
وحي	inspiracija	Nan
ودرس	studirao	None
ودعا	nazvani	Nan
ودعت	zvala je	Nan
ورغم	iako	None
ورفض	odbio je	Nan
ورفع	i podići	Nan
ورق	papir	None
ورقة	list	None
وروسيا	i rusija	Nan
وزاد	i povećana	Nan
وزارة	ministarstvo	None
وزراء	ministri	None
وزن	težina	None
وزوجته	i njegova supruga	Nan
وزيادة	i više	Nan
وزيت	i ulje	Nan
وزير	ministra	None
وسائر	i sve ostale	Nan
وردت	primljeno	Nan
وردة	ruža	None
ورد	cvijet	None
ورجال	i muškarci	Nan
ودعم	i podrška	Nan
ودفن	i sahranjeni	Nan
ودمشق	i damask	Nan
ودور	i uloga	Nan
ودول	i države	Nan
ودولة	i zemlju	Nan
ودون	i bez	Nan
وحاول	i probajte	Nan
وذكر	spomenuo je	Nan
وذهب	i on ode	Nan
ورأى	i video	Nan
ورئيس	i glava	Nan
وراء	iza	None
وراثيا	genetski	Nan
وراح	i on ode	Nan
وربما	a možda	Nan
وذلك	i to	Nan
وانخفاض	i niska	Nan
وانتهى	završeno je	Nan
وانتهت	i završilo	Nan
والبعض	a neki	Nan
والبنية	i struktura	Nan
والبيئة	i okruženje	Nan
والتاريخ	i istorija	Nan
والتجارة	i trgovina	Nan
والتحليل	i analiza	Nan
والتخلص	i riješi se	Nan
والتدريب	i treninga	Nan
والتطور	i evolucija	Nan
والتطوير	i razvoj	Nan
والتعاون	i saradnja	Nan
والتعليم	i obrazovanje	Nan
والتقاليد	i tradicije	Nan
والتكنولوجيا	i tehnologija	Nan
والتلفزيون	i tv	Nan
والبحرين	i bahrein	Nan
والتنمية	i razvoj	Nan
والبحرية	marine	Nan
والباحثين	i istraživači	Nan
والإسلام	i islam	Nan
والإسلامية	i islamska	Nan
والإعلام	i mediji	Nan
والإمارات	i emirati	Nan
والإمام	i imam	Nan
والإمبراطورية	i carstvo	Nan
والإنسان	i ljudski	Nan
والإيمان	i vjera	Nan
والاتحاد	i sindikat	Nan
والاتصالات	i komunikacija	Nan
والاجتماعي	i društveni	Nan
والاجتماعية	i društveni	Nan
والاقتصاد	i ekonomija	Nan
والاقتصادي	i ekonomičan	Nan
والاقتصادية	i ekonomski	Nan
والبحر	i more	Nan
والإدارة	i menadžment	Nan
والتوزيع	i distribucija	Nan
والثالث	i treća	Nan
والحرية	i sloboda	Nan
والحزب	i zabava	Nan
والحسن	i dobro	Nan
والحسين	i husein	Nan
والحضارة	i civilizacija	Nan
والحفاظ	i zadrži	Nan
والحكم	i presuda	Nan
والحكومات	i vlade	Nan
والحكومة	i vlada	Nan
والحياة	i život	Nan
والحيوانات	i životinje	Nan
والخارجية	i vanjski	Nan
والخاصة	i posebna	Nan
والخدمات	i usluge	Nan
والد	otac	None
والحروب	i ratovi	Nan
والتي	i to	Nan
والحركة	i kretanje	Nan
والحديد	i gvožđe	Nan
والثاني	i drugo	Nan
والثانية	i drugo	Nan
والثقافة	i kultura	Nan
والجامعات	i univerziteti	Nan
والجدير	i vrijedi	Nan
والجزء	i dio	Nan
والجزائر	i alžir	Nan
والجزر	i ostrva	Nan
والجماعة	i grupa	Nan
والجمال	i lepota	Nan
والجنوب	i juga	Nan
والجنوبية	i južne	Nan
والجيش	i vojska	Nan
والحجاز	i hidžaz	Nan
والحديث	i razgovaraj	Nan
والحرب	i rat	Nan
والأنهار	i reke	Nan
والأنصار	i pristalice	Nan
والأميرة	i princeza	Nan
وإنشاء	i stvarajte	Nan
وإنما	ali radije	Nan
وإيران	i iran	Nan
وإيطاليا	i italija	Nan
وائل	wael	Nan
وابن	i sin	Nan
وابنه	i njegov sin	Nan
واجب	dužnost	None
واجه	lice	None
واجهة	interfejs	None
واجهت	suočen	Nan
واحد	jedan	None
واحدا	jedan	None
واحداً	jedan	None
واحدة	jedan	None
وإنتاج	i proizvodnja	Nan
واحدًا	jedan	None
وإن	i sigurno	Nan
وإلا	inače	None
وأهمها	najvažniji	None
وأوائل	i rano	Nan
وأوروبا	i evropa	Nan
وأول	a prvo	Nan
وأي	i bilo koji	Nan
وأيضا	a takođe	Nan
وأيضاً	a takođe	Nan
وأيضًا	a takođe	Nan
وإدارة	i menadžment	Nan
وإذا	ako	None
وإسبانيا	i španija	Nan
وإسرائيل	i izrael	Nan
وإعادة	i ponovo	Nan
وإعلان	i najava	Nan
وإقامة	i uspostaviti	Nan
وإلى	i na	Nan
وادي	dolina	None
وارتفاع	i visoko	Nan
واستخدام	i koristi	Nan
والآلات	i mašine	Nan
والأحزاب	i zabave	Nan
والأخرى	i drugo	Nan
والأخلاق	i moral	Nan
والأدب	i književnost	Nan
والأراضي	i zemljišta	Nan
والأردن	i jordan	Nan
والأرض	i zemlja	Nan
والأطفال	i djeca	Nan
والأعمال	i posao	Nan
والأفكار	i ideje	Nan
والأكثر	i više	Nan
والأمراء	i knezovi	Nan
والأمن	i sigurnost	Nan
والأمير	i princ	Nan
والآداب	i maniri	Nan
والآخر	i onaj drugi	Nan
والآثار	i efekti	Nan
واقعة	incident	Nan
واستخدم	i koristi	Nan
واستطاعت	i uspjela je	Nan
واستمر	i nastavilo	Nan
واستمرت	i nastavilo	Nan
واسع	široki	None
واسعة	široki	None
واسم	i ime	Nan
والدة	majke	None
واسمه	i njegovo ime	Nan
واصل	nastavi	Nan
واضح	jasno	None
واضحة	jasno	None
واعتبر	smatrano je	Nan
وافق	pristao je	Nan
وافقت	odobreno	Nan
واقع	stvarnost	None
واشنطن	washington	None
والدته	njegova majka	Nan
والدراسات	i studije	Nan
والدفاع	i odbrana	Nan
والماء	i vode	Nan
والمحيط	i okean	Nan
والمدارس	i škole	Nan
والمدن	i gradovi	Nan
والمدينة	i grad	Nan
والمرأة	i žena	Nan
والمسجد	i džamija	Nan
والمسيحية	i hrišćanstvo	Nan
والمسيحيين	i hrišćani	Nan
والمعادن	i minerali	Nan
والمعاهد	i instituti	Nan
والمعدات	i oprema	Nan
والمعراج	i mirage	Nan
والمعرفة	i znanje	Nan
والمعروف	poznat	None
والمؤسسات	i institucije	Nan
والمعروفة	poznat	None
والله	kunem se	Nan
واللغات	i jezicima	Nan
والفيزياء	i fizika	Nan
والقانون	i zakon	Nan
والقدرة	i sposobnost	Nan
والقرآن	i kur&#39;an	Nan
والقضاء	i eliminacija	Nan
والقمر	i mjesec	Nan
والقوات	i snage	Nan
والقوانين	i zakoni	Nan
والقوة	i snaga	Nan
والكتاب	i knjiga	Nan
والكتابة	i pisati	Nan
والكثير	i još puno toga	Nan
والكنيسة	i crkva	Nan
والكواكب	i planete	Nan
والكيمياء	i hemija	Nan
واللغة	i jezik	Nan
والمغرب	i maroko	Nan
والمكسيك	i meksiko	Nan
والملك	i kralj	Nan
والهند	indija	None
والهندسة	i inžinjering	Nan
والواقع	zaista	None
والولايات	i države	Nan
والي	wali	Nan
واليابان	i japan	Nan
واليمن	i jemen	Nan
واليهود	a židovi	Nan
واليهودية	i judaizam	Nan
واليوم	i danas	Nan
واليونان	grčka	None
وان	i sigurno	Nan
وانتشار	i širi se	Nan
وانتشر	to se širilo	Nan
وانتشرت	i raširi se	Nan
والهرسك	i hercegovina	Nan
والنهاية	i na kraju	Nan
والنمسا	i austrija	Nan
والنقل	i prevoz	Nan
والمملكة	i kraljevstvo	Nan
والمناخ	a klima	Nan
والمناطق	i regioni	Nan
والمنتجات	i proizvodi	Nan
والمنطق	i logika	Nan
والمنطقة	i region	Nan
والمواد	i materijali	Nan
والفنون	i umetnost	Nan
والمواصلات	prevoz	Nan
والمياه	i vode	Nan
والنباتات	i biljke	Nan
والنجوم	i zvezde	Nan
والنرويج	norveška	None
والنساء	i žene	Nan
والنسيج	i tkanina	Nan
والنقد	i kritika	Nan
والموسيقى	i muzika	Nan
وعن	i o	Nan
والفن	i umetnost	Nan
والفلسفة	i filozofija	Nan
والسبب	i razlog	Nan
والسعودية	i saudijska arabija	Nan
والسلام	i mir	Nan
والسنة	i godine	Nan
والسودان	i sudan	Nan
والسويد	švedska	None
والسياسة	i politika	Nan
والسياسي	i političar	Nan
والسياسية	i politički	Nan
والسيطرة	i kontrola	Nan
والشام	i levant	Nan
والشرق	i istok	Nan
والشركات	i kompanije	Nan
والشعر	i kosu	Nan
والشمال	i sever	Nan
والسادس	i šesta	Nan
والشيخ	i šeik	Nan
والزهرة	i cvijet	Nan
والزبير	i zubair	Nan
والدليل	dokaz	None
والده	majke	None
والدها	njen otac	Nan
والدول	i države	Nan
والدولة	i država	Nan
والدين	roditelji	None
والدينية	vjerski	None
والذي	i ko	Nan
والذين	i ko	Nan
والرئيس	i predsjednik	Nan
والرابع	i četvrta	Nan
والرومان	i rimljani	Nan
والرومانية	i rumunski	Nan
والرياح	i vjetar	Nan
والرياضيات	i matematika	Nan
والزراعة	i poljoprivreda	Nan
والشيعة	šiiti	Nan
والصفات	i atribute	Nan
والصلاة	i molitva	Nan
والعلوم	i nauka	Nan
والعمارة	i arhitekture	Nan
والعمل	i radite	Nan
والعمليات	i operacije	Nan
والعناية	i vodi računa	Nan
والغابات	i šume	Nan
والغاز	i gas	Nan
والغرب	i zapad	Nan
والغربية	zapadnjački	Nan
والغناء	i peva	Nan
والفارسية	i perzijski	Nan
والفرات	eufrata	Nan
والفرنسية	i francuski	Nan
والفضة	i srebro	Nan
والفقه	nadležnost	Nan
والعلمية	i naučno	Nan
والعلماء	i učenjaci	Nan
والعلم	i nauka	Nan
والعلاقات	i veze	Nan
والصناعات	i industrije	Nan
والصناعة	i industrija	Nan
والصين	i kina	Nan
والطاقة	i energija	Nan
والطب	i lek	Nan
والطيور	i ptice	Nan
والعالم	i svijet	Nan
والفلك	i astronomija	Nan
والعديد	i još mnogo toga	Nan
والعرب	i arapi	Nan
والعربية	i arapski	Nan
والعسكرية	i vojska	Nan
والعشرون	dvadeset	None
والعشرين	dvadeset	None
والعطلات	i praznici	Nan
والعلاج	i lečenje	Nan
والعراق	i irak	Nan
وعند	i na	Nan
وعندها	i onda	Nan
وعين	imenovao je	Nan
يستخدمون	oni koriste	Nan
يستطع	može	None
يستطيع	može	None
يستعمل	rabljeni	Nan
يستقبل	primanje	Nan
يستمر	nastavite	Nan
يسجل	registrirajte se	Nan
يسعى	traži	None
يسكن	uživo	None
يسمح	dopustiti	Nan
يسمى	zove se	Nan
يسميه	on zove	Nan
يسهل	olakšava	Nan
يسود	vladati vrhovno	Nan
يسوع	isuse	Nan
يستخدمها	koristi ga	Nan
يسيطر	kontrole	None
يستخدم	upotrebe	None
يسبب	izaziva	None
يركز	koncentrirati	Nan
يرمز	simbolizuje	Nan
يرون	vide	None
يروى	kaže	None
يروي	kaže	None
يرى	biti viđen	Nan
يريد	želi	None
يريفان	erevan	Nan
يزال	ipak	None
يزداد	povećava se	Nan
يزيد	povećava	None
يسار	levo	Nan
يساعد	pomoć	None
يساهم	constribte	Nan
يساوي	jednako	None
يسبق	prethodi	Nan
يرفع	dizala	Nan
يشار	navedeno	None
يشبه	izgleda kao	Nan
يصيب	to utiče	Nan
يضاف	dodano	Nan
يضع	stavlja	None
يضم	smešteni	Nan
يضمن	garancija	Nan
يطلب	zahtjevi	Nan
يطلق	lansiranje	Nan
يظل	ostaci	None
يظهر	pojavljuje se	Nan
يعادل	ekvivalentno	Nan
يعانون	patiti	Nan
يعاني	trpi	Nan
يعبر	proći	None
يعتبر	razmatrano	Nan
يعتبره	smatrali su to	Nan
يصنع	napravite	Nan
يشارك	uključeni	Nan
يصلي	on se moli	Nan
يصف	opišite	Nan
يشتمل	uključuje	None
يشتهر	poznat je po	Nan
يشرب	on pije	Nan
يشرف	poštovani	Nan
يشعر	osjećati	Nan
يشغل	trči	Nan
يشكل	poza	Nan
يشكلون	šminka	Nan
يشمل	uključuje	None
يشهد	svedok	Nan
يشير	označava	None
يصبح	postanite	Nan
يصح	tacno	Nan
يصدر	izdato	Nan
يصعب	teško	None
يصل	dosegni	Nan
يرفض	on odbija	Nan
يرغب	želja	None
يرسل	šalje	None
يحتاج	treba	None
يحتفظ	drži	None
يحتفل	proslavite	Nan
يحتل	okupacije	None
يحتمل	možda	None
يحتوي	sadrže	None
يحد	granice	None
يحدث	dogodi se ili se dogodi	Nan
يحدد	određuje	None
يحدها	obrubljen	Nan
يحصل	dobiva	Nan
يحضر	donesi	Nan
يحق	ima pravo na	Nan
يحقق	postići	None
يحكم	sudilo	Nan
يحب	likes	Nan
يحل	riješite	Nan
يحاول	pokušaj	None
يجمع	sakupljanje	Nan
يتواجد	postoji	None
يتوقع	ocekujte	Nan
يتوقف	zaustavlja se	Nan
يتولى	preuzmi	Nan
يتيح	ostavimo	Nan
يثبت	dokazati	Nan
يثرب	yathrib	Nan
يجب	mora	None
يجتمع	odgovara	None
يجد	pronađi	Nan
يجري	biti	None
يجعل	pravi	None
يجعله	stvara	None
يجعلها	stvara	None
يجلس	sjedeći	Nan
يجوز	dozvoljeno	None
يحمل	nositi	None
يحملون	oni nose	Nan
يحمي	zaštititi	Nan
يده	njegova ruka	Nan
يدور	spins	Nan
يدي	moja ruka	Nan
يدير	upravlja	None
يديه	njegove ruke	Nan
يذكر	spomenuto	Nan
يذهب	on ide	Nan
يرابيع	poslužite	Nan
يراه	on to vidi	Nan
يراها	on to vidi	Nan
يربط	priložiti	Nan
يرتبط	pridruženi	Nan
يرتفع	ustaje	Nan
يرجع	zbog	None
يرد	odgovori	Nan
يدل	označava	None
يدفع	platite	Nan
يدعي	tvrdi on	Nan
يدعى	tvrdi on	Nan
يحوي	sadrži	None
يحيط	okolina	None
يحيى	yahia	Nan
يختار	odaberite	Nan
يختلف	razlike	None
يخدم	poslužite	Nan
يخرج	napolje	Nan
يعتبرون	oni smatraju	Nan
يخص	pozdravi	Nan
يد	ruka	None
يدخل	ulazi	None
يدرس	podučavanje	Nan
يدرك	shvatiti	None
يدعم	podržava	None
يدعو	poziv	None
يدعون	oni tvrde	Nan
يخضع	predmet	None
يعترف	priznaje	None
يعتقد	veruje	Nan
يعتقدون	oni misle	Nan
ينتمون	belong	Nan
ينتمي	pripada	None
ينتهي	završiti	Nan
ينجب	porodila	Nan
ينجح	uspeti	Nan
ينزل	pada	None
ينسب	pripisana	Nan
ينشأ	ustaje	Nan
ينص	države	None
ينطبق	primjenjuje se	Nan
ينظر	pogledaj	Nan
ينظم	organizovati	Nan
ينقسم	podeljeno	Nan
ينقل	prenesite	Nan
ينكر	negira	Nan
ينتقل	pomicanje	Nan
يهتم	brine oko	Nan
ينتشر	raširiti	Nan
ينتج	proizvesti	Nan
يمثل	predstavljati	None
يمثلون	oni djeluju	Nan
يمكن	može	None
يمكننا	možemo	None
يمكنه	on može	Nan
يمكنها	može	None
يملك	posjeduje	None
يمنع	sprječava	Nan
يموت	umire	None
يميز	razlikuje	None
يميل	teži	None
يمين	tačno	None
ينادي	poziv	None
ينبع	stabljike	Nan
ينبغي	trebalo bi	Nan
ينتخب	biti izabran	Nan
يهدف	cilj je	Nan
يهود	jevrejski	Nan
يهودي	jevrejski	Nan
يومًا	dani	None
يونانية	grčki	None
يونايتد	united	None
يونيو	juna	None
يوهان	johan	Nan
يَملك	posjeduje	None
يُحتمل	možda	None
يُسمى	zove se	Nan
يُشكل	formira se	Nan
يُطلق	lansiranje	Nan
يُظهر	pojavljuje se	Nan
يُعتقد	veruje	Nan
يُعد	pripremite se	Nan
يُعرف	poznat	None
يُقال	rečeno je	Nan
يوميا	svakodnevno	None
يومنا	naš dan	Nan
يوماً	jednog dana	Nan
يوما	dani	None
يهودية	jevrejski	Nan
يهوذا	juda	Nan
يو	yo	Nan
يواجه	lica	None
يوان	juan	None
يوتيوب	youtube	Nan
يوجد	postoje	None
يمتلك	posjeduje	None
يوحنا	john	None
يوسف	yousuf	Nan
يوضح	prikazuje	None
يوفر	pruža	None
يولد	rođen je	Nan
يوليو	jula	None
يوم	dan	None
يومئذ	taj dan	Nan
يوروبيوم	europeanium	Nan
يتناول	posao sa	Nan
يمتد	rasponi	Nan
يمارس	vežba	Nan
يغطي	omoti	Nan
يغلب	beat	Nan
يغير	promjena	None
يفتح	otvara se	Nan
يفترض	navodno	None
يفرض	nameće	None
يفسر	objašnjava	None
يفصل	razdvaja	Nan
يفضل	poželjno	None
يفعل	učini	None
يفقد	izgubiti	None
يفكر	razmisli	Nan
يفهم	razumeo	Nan
يفوز	pobjeđuje	None
يفوق	prelazi	None
يعين	označava	None
يفيد	benefit	Nan
يعيشون	oni žive	Nan
يعيد	ponovite	Nan
يعتمد	zavisi	None
يعد	pripremite se	Nan
يعرض	prikazuje	None
يعرف	poznat	None
يعرفه	poznajem ga	Nan
يعرفون	znaju	None
يعطي	daj	Nan
يعقوب	yacoub	Nan
يعكس	reflects	Nan
يعلم	znaš	Nan
يعلن	najaviti	Nan
يعمل	radi	None
يعملون	radno	Nan
يعني	znači	None
يعود	vraća	None
يعيش	uživo	None
يقارب	približno	None
يقال	rečeno je	Nan
يقام	odvija se	Nan
يقيم	živi	None
يكاد	skoro	None
يكتب	piše	None
يكثر	obilno	Nan
يكفي	dosta	None
يكن	ne bude	Nan
يكون	biće	None
يكونوا	oni su	Nan
يكونون	oni su	Nan
يلاحظ	biljeska	Nan
يلتقي	upoznajte	Nan
يلزم	potrebno	None
يلعب	sviraj	Nan
يلقى	isporuči	Nan
يلي	prati	None
يقومون	jesu	None
يقوم	ustani	Nan
يقولون	oni kazu	Nan
يقول	kaže	None
يقبل	prihvaća	Nan
يقتصر	ograničen je	Nan
يقتل	ubija	None
يقدر	cijeniti	Nan
يقدم	pruža	None
يقرأ	čita	None
يقرب	približno	None
يمارسون	oni vežbaju	Nan
يقسم	psuje	Nan
يقضي	troši	Nan
يقع	smješten	None
يقف	ustaje	Nan
يقل	opada	None
يقلل	smanjenje	None
يقم	levo	Nan
يقود	vožnja	Nan
يقصد	znači	None
وأهم	i najvažnije	Nan
يتميز	featuring	Nan
يتمتعون	uživajte	Nan
ولعلّ	možda	None
ولغة	i jezik	Nan
ولقب	i naslov	Nan
ولقد	i jesam	Nan
ولكل	i za svakog	Nan
ولكنه	ali to je	Nan
ولكنها	ali to je	Nan
ولكنهم	ali jesu	Nan
ولكي	i za	Nan
ولم	a nisu	Nan
ولما	i zašto	Nan
ولمّا	zašto?	Nan
وله	i za njega	Nan
ولها	i nju	Nan
ولهذا	za ovo	Nan
ولعل	možda	None
ولو	čak	None
ولذلك	stoga	None
ولديه	i ima	Nan
وكيف	i kako	Nan
ولأن	i zato	Nan
ولا	niti	None
ولاة	guverneri	Nan
ولادة	rođenje	None
ولادته	njegovo rođenje	Nan
ولاسيما	naročito	None
ولايات	države	None
ولاية	država	None
ولايته	njegov mandat	Nan
ولبنان	i libanon	Nan
ولد	dečko	Nan
ولدت	rođen sam	Nan
ولده	njegov sin	Nan
ولدى	i jesam	Nan
ولذا	stoga	None
وكوريا	i koreja	Nan
ولي	guardian	Nan
وليبيا	i libija	Nan
ومسلم	i muslimanska	Nan
ومصر	i egipat	Nan
ومع	i sa	Nan
ومعرفة	i saznajte	Nan
ومعظم	i većina	Nan
ومعناها	i njegovo značenje	Nan
ومعه	i s njim	Nan
ومكان	mjesto	None
ومما	i iz čega	Nan
ومملكة	i kraljevstvo	Nan
ومن	i od	Nan
ومناطق	i regioni	Nan
ومنذ	i od tada	Nan
ومنطقة	i područje	Nan
ومنظمة	i organizacija	Nan
ومسجد	i džamija	Nan
وليام	william	None
ومركز	i centar	Nan
ومراجع	i reference	Nan
وليد	waleed	Nan
وليس	nije	None
وليست	ne	None
وليلة	i jedne noći	Nan
وليم	william	None
وما	gestikulirati	Nan
وماض	prošlost	None
ومثل	i slično	Nan
ومجلس	i daska	Nan
ومجموعة	i grupa	Nan
ومحاولة	i probajte	Nan
ومحمد	i muhammed	Nan
ومدرسة	i škola	Nan
ومدى	i koliko daleko	Nan
ومدينة	i grad	Nan
ومراكز	i centri	Nan
وكنيسة	i crkva	Nan
وكندا	i kanada	Nan
وكما	i kao	Nan
وفقًا	prema	None
وفلسطين	i palestina	Nan
وفنلندا	finska	None
وفى	ispunjeno	Nan
وفي	i unutra	Nan
وفيما	sa	None
وفيه	i u njemu	Nan
وفيها	i u njemu	Nan
وقائع	činjenice	None
وقاد	i vodio	Nan
وقال	i rekao je	Nan
وقالت	i rekla je	Nan
وقالوا	i rekli su	Nan
وقام	ustao je	Nan
وقامت	ona je napravila	Nan
وفقاً	prema	None
وقاموا	i ustali su	Nan
وفقا	prema	None
وفرنسا	i francuska	Nan
وغالبا	i to često	Nan
وغالباً	i to često	Nan
وغالبًا	i to često	Nan
وغرب	i zapadno	Nan
وغير	i više	Nan
وغيره	i više	Nan
وغيرها	i drugi	Nan
وغيرهم	i drugi	Nan
وفاة	smrt	None
وفاته	on je umro	Nan
وفاتها	umrla je	Nan
وفتح	i otvoreno	Nan
وفد	delegacija	Nan
وفر	uštedjeti	Nan
وفرة	obilje	None
وفق	prema	None
وقبل	i prije	Nan
وقت	vreme	None
وقتل	je ubijen	Nan
وكان	i bilo je	Nan
وكانت	i bila je	Nan
وكانوا	a bili su	Nan
وكتاب	i knjiga	Nan
وكتب	napisao je	Nan
وكثير	i mnogi	Nan
وكثيرا	i puno toga	Nan
وكذا	i takve	Nan
وكذلك	a takođe	Nan
وكرة	lopta	None
وكل	i sve	Nan
وكلاهما	oboje su	Nan
وكلما	i kad god	Nan
وكلمة	i reč	Nan
وكلها	i svi oni	Nan
وكالة	agencija	None
وكالات	agencije	None
وكأنه	kao	None
وقيل	rečeno je	Nan
وقته	njegovo vreme	Nan
وقتها	vrijeme je	Nan
وقد	je bio	Nan
وقدم	on je dao	Nan
وقرر	i odlučili	Nan
وقصر	palata	Nan
وقطاع	i skinuti	Nan
ومنع	i blok	Nan
وقطر	i katar	Nan
وقع	potpisan	None
وقعت	pojavio se	Nan
وقف	ustao	Nan
وقلة	i malo njih	Nan
وقوة	i snaga	Nan
وقود	gorivo	None
وقوع	pojava	None
وقطع	i rezati	Nan
ومنه	i iz toga	Nan
ومنها	kao što su	Nan
ومنهم	i njih	Nan
ويوجد	i postoji	Nan
ويوسف	i joseph	Nan
وَلاَ	niti	None
وُلد	dečko	Nan
يأتي	dođi	Nan
يأخذ	uzima	None
يأكل	jedi	Nan
يأمر	naručivanje	Nan
يؤثر	uticaj	None
يؤخذ	biti uzet	Nan
يؤدى	olovo	None
يؤدي	olovo	None
يؤكد	potvrđuje	None
يؤمن	verujte	Nan
يؤمنون	vjerovati u	Nan
وينقسم	podijeljen je	Nan
يا	oh	Nan
ويندوز	windows	Nan
ويمكن	i može	Nan
ويعني	to znači	Nan
ويعود	i natrag	Nan
ويعيش	i uživo	Nan
ويقال	rečeno je	Nan
ويقدر	procjenjuje se	Nan
ويقدم	ona pruža	Nan
ويقع	i pada	Nan
ويقول	i kaže	Nan
ويقوم	ona se zasniva	Nan
ويكون	i biti	Nan
ويكي	wiki	None
ويكيبيديا	wikipedija	Nan
ويلز	wells	Nan
ويليام	william	None
ويمثل	predstavlja	None
وينتج	to proizvodi	Nan
ياسر	yasser	Nan
ياسين	yassen	Nan
يبحث	tražiti	None
يترك	ostavite	Nan
يتسبب	uzrok	None
يتصل	komunicirati	Nan
يتضح	ilustrovano	Nan
يتضمن	to uključuje	Nan
يتطلب	zahtijeva	None
يتعرض	izloženo	Nan
يتعلق	u pogledu	Nan
يتغير	mijenja se	Nan
يتفق	slažem se	Nan
يتكلم	progovoriti	Nan
يتكون	sastoji se od	Nan
يتلقى	primiti	Nan
يتم	kompletna	None
يتمتع	uživajte	Nan
يترتب	prati	None
يتراوح	raspon	Nan
يتخذ	uzmi	Nan
يتحول	ispada	Nan
يبدأ	započeo	None
يبدو	zvuk	None
يبعد	away	Nan
يبق	ostaci	None
يبقى	ostaci	None
يبلغ	izveštaj	Nan
يبين	pokaži	Nan
ويعمل	i uspijeva	Nan
يتأثر	pogođeni	Nan
يتأهل	kvalifikujte	Nan
يتبع	nastavak	None
يتجاوز	prekoračiti	Nan
يتجه	heading	Nan
يتحدث	on govori	Nan
يتحدثون	oni govore	Nan
يتحرك	kreće se	Nan
يتألف	sastoji se	Nan
يتمكن	upravljajte	Nan
ويعرف	on zna	Nan
ويعتمد	zavisi	None
وهناك	a tu	Nan
وهو	i on	Nan
وهولندا	holandija	None
وهى	koji	None
وهي	koji	None
ووادي	i dolina	Nan
ووجد	našao je	Nan
ووجدت	i pronađena	Nan
ووجود	i prisustvo	Nan
ووسائل	znači	None
ووسط	i srednja	Nan
ووصل	stigao je	Nan
ووصلت	i stigao sam	Nan
ووضع	i stavi	Nan
ووفقا	prema	None
وهنا	a evo	Nan
ووفقاً	prema	None
وهما	a njih dvoje	Nan
وهكذا	i tako dalje	Nan
ونادي	i klub	Nan
ونتيجة	kao rezultat	Nan
ونشأته	i njegov odgoj	Nan
ونشر	i objavite	Nan
ونصف	i pol	Nan
ونظام	i sistem	Nan
ونظرا	s obzirom	Nan
ونظرًا	i gledaj	Nan
ونظم	i sistemi	Nan
ونقل	i kreni	Nan
ونهر	i reka	Nan
وهؤلاء	i ove	Nan
وهبي	wehbe	Nan
وهذا	a ovo je	Nan
وهذه	i to	Nan
وهم	a jesu	Nan
ووفقًا	prema	None
ويأتي	dolazi	None
ويؤدي	i vodi	Nan
ويرى	on vidi	Nan
ويستخدم	koristi	None
ويستطيع	i može	Nan
ويسمى	to se zove	Nan
ويشمل	to uključuje	Nan
ويشير	napomene	Nan
ويصبح	i to postaje	Nan
ويصل	i gore	Nan
ويضم	to uključuje	Nan
ويضيف	dodaje	None
ويطلق	to se zove	Nan
ويظهر	izgleda	None
ويعتبر	smatra se	Nan
ويعتقد	i vjerovali	Nan
ويعتقدون	i oni misle	Nan
ويروي	on govori	Nan
ويرجع	vraća se	Nan
ويذكر	spominje	None
ويدخل	i ulazi	Nan
ويؤكد	on potvrđuje	Nan
ويؤمن	i vjerujte	Nan
ويب	web	Nan
ويبدو	izgleda	None
ويبقى	ostaje	None
ويبلغ	obavještava	Nan
ويتحدث	on govori	Nan
ويعد	i obećanja	Nan
ويتراوح	raspon je	Nan
ويتم	i to je učinjeno	Nan
ويتميز	ima mogućnosti	Nan
ويجب	obavezno	None
ويجوز	dozvoljeno je	Nan
ويحتوي	sadrži	None
ويحدث	i desi se	Nan
ويختلف	razlikuje se	Nan
ويتكون	sastoji se	Nan
تسببت	uzrok	None
وأهل	i ljudi	Nan
وأنها	i ona	Nan
مبكرة	rano	None
مبلغ	iznos	None
مبنى	zgrada	None
مبني	zgrada	None
مبنية	izgrađeno	Nan
مبيعات	prodaja	None
متابعة	nastavite	Nan
متاحة	na raspolaganju	Nan
متتالية	uzastopno	Nan
متحركة	krećući se	Nan
متحف	muzej	None
متحقق	postignuto	Nan
متخصصة	specijalizirani	Nan
متر	metar	None
مترو	podzemna	Nan
مبكر	rano	None
متزايد	raste	None
مبرهنة	teorem	None
مباشرة	direktno	None
مالي	finansijski	Nan
مالية	finansije	None
ماليزيا	malezija	Nan
مان	čovječe	Nan
مانشستر	manchester	Nan
مايكروسوفت	microsoft	None
مايكل	michael	None
مايو	maja	None
مبابان	mbabane	Nan
مبادئ	principa	None
مبادرة	inicijativa	Nan
مباراة	utakmicu	None
مبارك	blagoslov	Nan
مباريات	utakmice	None
مباشر	direktan	Nan
مبدأ	princip	None
مالك	vlasnik	None
متزايدة	raste	None
متساوية	jednako	None
مثلث	trougao	None
مثلما	kao	None
مثله	kao on	Nan
مثلها	kao ona	Nan
مثيرة	uzbudljivo	Nan
مثيل	primjer	None
مجاعة	glad	Nan
مجال	polje	None
مجالات	polja	None
مجالس	odbori	Nan
مجتمع	zajednica	None
مجتمعات	zajednice	None
مجددًا	opet	None
مجرة	galaksija	Nan
مجرد	samo	None
مثلاً	na primjer	Nan
متزوج	oženjen	None
مثلا	na primjer	Nan
مثال	primjer	None
متصلة	povezano	None
متطلبات	zahtevi	Nan
متطورة	sofisticiran	Nan
متعدد	višestruko	Nan
متعددة	višestruko	Nan
متفاوتة	različite	None
متفرقة	razbacani	Nan
متقدمة	napredni	Nan
متكررة	česta	None
متميزة	različita	None
متنوعة	razno	Nan
متوسط	prosječno	None
متوسطة	srednja	None
متوفرة	dostupno	Nan
متى	kada	None
مثل	kao što su	Nan
مال	kapital	None
ماكسويل	maxwell	Nan
مافيا	mafija	None
ليبرالية	liberalni	Nan
ليبيا	libija	Nan
ليتم	da se uradi	Nan
ليتو	leto	Nan
ليزر	laser	Nan
ليس	ne	None
ليست	nije	None
ليسوا	oni nisu	Nan
ليصبح	postati	None
ليصل	stići	Nan
ليكون	biti	None
ليلاً	noć	None
ليلة	noć	None
ليلى	layla	Nan
لينكون	lincoln	Nan
ليالي	noći	None
لينين	lenjin	Nan
لي	moja	None
لونه	njegova boja	Nan
لواء	general major	Nan
لوثر	luther	Nan
لوجود	postojati	None
لوح	plank	Nan
لوحات	ploče	None
لوحة	slikanje	Nan
لوزارة	ministarstvu	Nan
لوس	los	None
لوصف	opisati	Nan
لوضع	staviti	None
لوقا	luke	None
لوقف	zaustaviti	Nan
لولا	lula	Nan
لولاية	za državu	Nan
لون	boja	None
لويس	lewis	Nan
ليون	lyon	Nan
ليوناردو	leonardo	None
مأهولة	naseljeni	None
ماتت	umrla je	Nan
ماجد	majid	Nan
مادة	stvar	None
مادية	materijal	None
ماذا	šta	None
مارتن	martin	None
مارس	marta	None
مارك	mark	None
ماركس	marx	None
ماركوس	marcus	Nan
ماري	marie	None
ماريا	maria	None
مارينر	mariner	None
ماسنجر	messenger	Nan
ماعدا	osim	None
مات	umro	None
مائية	aqua	Nan
مائة	stotinu	None
ما	šta	None
مؤتمر	konferencija	Nan
مؤخرا	nedavno	None
مؤخراً	nedavno	None
مؤخرًا	nedavno	None
مؤسس	osnivač	None
مؤسسات	institucije	None
مؤسسة	corporation	Nan
مجرى	potok	None
مؤشر	pokazatelj	Nan
مؤكدة	potvrđeno	None
مؤلف	autor	None
مؤلفات	autori	None
مؤلفاته	njegovi spisi	Nan
مئات	povoljno	Nan
مئة	stotinu	None
مئوية	procenat	None
مؤقتة	privremeni	Nan
لو	ako	None
مجلة	časopis	Nan
مجمع	kompleks	None
مركبات	vozila	None
مركبة	vozilo	Nan
مركز	centar	None
مركزا	centar	None
مركزاً	centar	None
مركزية	centralizacija	Nan
مركزًا	centar	None
مرمرة	marmara	Nan
مروان	marwan	Nan
مرور	prolaz	None
مريم	mariam	Nan
مزارع	farmer	Nan
مزايا	prednosti	None
مزيج	mix	Nan
مزيد	još	None
مركب	kompozitni	Nan
مسألة	problem	None
مرقس	mark	None
مرض	bolest	None
مراقبة	kontrola	None
مراكز	centri	None
مراكش	marakeš	Nan
مربع	kvadrat	Nan
مرة	jednom	None
مرت	prošao	None
مرتبة	rang	None
مرتبطة	povezano	None
مرتفع	visokog	None
مرتفعات	visine	None
مرتفعة	visokog	None
مرتين	dvaput	Nan
مرحلة	pozornica	Nan
مرسوم	uredbom	Nan
مرصد	opservatorija	Nan
مرضى	pacijenti	Nan
مراقب	foreman	Nan
مسؤول	odgovorni	Nan
مسؤولية	odgovornost	None
مستقرة	stabilan	Nan
مستقل	nezavisna	None
مستقلة	nezavisna	None
مستمر	kontinuirano	Nan
مستمرة	u toku	Nan
مستوطنة	naselje	None
مستوى	nivoa	None
مستويات	nivoi	Nan
مسجد	džamija	None
مسح	anketa	Nan
مسرح	pozornica	Nan
مسرحية	predstava	Nan
مسعود	masoud	Nan
مسقط	muškat	Nan
مسلسل	serije	None
مستقبل	budućnost	None
مسؤولة	odgovoran	None
مستعمرة	kolonija	None
مستشفى	bolnica	None
مساء	veče	Nan
مسائل	problemi	None
مسابقات	takmičenja	None
مسابقة	konkurencija	Nan
مساجد	džamije	None
مساحة	prostor	None
مساحتها	njegova oblast	Nan
مسار	put	None
مساعد	asistent	Nan
مساعدة	pomoć	None
مسافة	razdaljina	Nan
مساندة	podrška	None
مساهمة	ulaz	None
مستخدم	korisnik	None
مستخدمي	korisnici	None
مستعمرات	kolonije	None
مراعاة	razmotriti	Nan
مراد	intend	Nan
مراحل	faza	None
محدود	ograničena	None
محدودة	ograničena	None
محركات	motori	Nan
محرم	muharram	Nan
محط	stanica	None
محطات	stanice	None
محطة	stanica	None
محفز	katalizator	Nan
محفوظ	spremljeno	Nan
محل	prodavnica	Nan
محلول	rešenje	Nan
محلي	slatko	Nan
محلية	lokalno	None
محمد	mohammed	Nan
محمدًا	mohamed a	Nan
محددة	specifično	Nan
محمود	mahmud	None
محدد	specifično	Nan
محاولة	pokušaj	None
مجمل	sveukupno	Nan
مجموع	suma	Nan
مجموعات	grupe	None
مجموعتين	dvije grupe	Nan
مجهول	nepoznato	None
مجهولة	nepoznato	None
مجيء	dolazi	None
محاسبة	računovodstvo	None
محاطة	okružen	None
محافظات	provincije	None
محافظة	governorate	Nan
محاكاة	simulacija	Nan
محاكم	sudovi	None
محاكمة	suđenje	Nan
محاولات	napori	Nan
محايدة	neutralno	Nan
محمودية	mahmoudia	Nan
محمية	zaštićeno	Nan
محو	obriši	Nan
مدنها	njeni gradovi	Nan
مدني	civil	Nan
مدنية	civilna	Nan
مدونة	blog	None
مدى	bezel	Nan
مدير	direktor	None
مدينة	grad	None
مدينتي	moj grad	Nan
مذاهب	doktrine	Nan
مذكرات	dnevnik	Nan
مذكراته	njegove beleške	Nan
مر	preko	None
مرات	vremena	None
مراجع	reference	None
مراجعة	pregled	None
مدن	gradovi	None
مدعوم	podržani	Nan
مدريد	madrid	Nan
مدرسة	škola	None
محور	osa	Nan
محيط	ocean	Nan
مخاطر	rizici	Nan
مخالفة	infraction	Nan
مخاوف	strahovi	Nan
مختلف	različite	None
مختلفة	različite	None
مجلس	ploča	None
مختلفين	dve različite	Nan
مخطط	planirano	Nan
مخطوطة	rukopis	Nan
مخيم	kamp	Nan
مدارات	orbite	Nan
مدارس	škole	None
مدة	trajanje	None
مدخل	ulaz	None
مخصصة	posvećena	None
لهما	za njih	Nan
لهم	za njih	Nan
لهذه	za ovo	Nan
لقاح	vakcina	Nan
لقب	naslov	None
لقبه	njegov nadimak	Nan
لقتال	boriti se	Nan
لقد	lhave	Nan
لقوات	na sile	Nan
لقوانين	zakoni	None
لقول	reći	None
لقي	pronađeno	Nan
لقياس	izmjeriti	Nan
لك	je tvoje	Nan
لكتاب	za knjigu	Nan
لكثرة	previse	Nan
لكثير	za mnoge	Nan
لكرة	za loptu	Nan
لقاء	sastanak	Nan
لكل	za svaki	Nan
لفهم	razumjeti	None
لفكرة	za ideju	Nan
لعمل	raditi	None
لعملية	za obradu	Nan
لغات	jezici	None
لغة	jezik	None
لغتهم	njihov jezik	Nan
لغرض	za svrhu	Nan
لغزو	da napadnu	Nan
لغوية	lingvistički	Nan
لغير	za ostale	Nan
لـ	za	None
لفتح	otvoriti	Nan
لفترات	za periode	Nan
لفترة	nakratko	Nan
لفرنسا	za francusku	Nan
لفظة	riječ	None
لفلسطين	za palestinu	Nan
لعلي	možda	None
لكلمة	za reč	Nan
لكن	ali	None
للاتحاد	za sindikat	Nan
للاتصالات	telekom	Nan
للاقتصاد	za ekonomiju	Nan
للبحث	traži	None
للبحر	do mora	Nan
للبشر	za ljude	Nan
للبلاد	za zemlju	Nan
للتاريخ	za istoriju	Nan
للتجارة	trgovina	None
للتخلص	da se oslobodi	Nan
للتدخين	za pušenje	Nan
للتدريب	za trening	Nan
للتربة	za tlo	Nan
للتعبير	izraziti	None
للتعليم	za obrazovanje	Nan
للإنسان	za osobu	Nan
لكم	za tebe	Nan
للإمبراطورية	za carstvo	Nan
للإصابة	zbog povrede	Nan
لكنه	ali on	Nan
لكنها	ali ona	Nan
لكنهم	ali jesu	Nan
لكوكب	za planetu	Nan
لكون	u svemir	Nan
لكونه	jer biti	Nan
لكي	da bi se	Nan
للأراضي	za zemlje	Nan
للأرض	za zemlju	Nan
للأطفال	za djecu	Nan
للأمم	nacija	None
للأندية	za klubove	Nan
للإتحاد	za sindikat	Nan
للإسلام	na islam	Nan
للإشارة	da signalizira	Nan
للإمام	imamu	Nan
لعلماء	za učenjake	Nan
لعلم	za informaciju	Nan
لعلاج	tretirati	Nan
لحد	smanjite	Nan
لحركة	za kretanje	Nan
لحزب	za zabavu	Nan
لحساب	da izračunamo	Nan
لحظة	momenat	Nan
لحفظ	da biste uštedjeli	Nan
لحقوق	za prava	Nan
لحكم	da vladaju	Nan
لحل	riješiti	None
لحم	meso	None
لحماية	zaštititi	Nan
لحن	melodija	Nan
لحوالي	za otprilike	Nan
لخدمة	služiti	None
لدراسة	učiti	Nan
لحام	zavarivanje	Nan
لدرجة	do neke mere	Nan
لجيش	za vojsku	Nan
لجميع	za sve	Nan
لتعزيز	promovirati	Nan
لتفسير	za objašnjenje	Nan
لتقديم	da obezbedim	Nan
لتكون	biti	None
لتكوين	za konfiguriranje	Nan
لتلك	za one	Nan
لتنظيم	organizovati	Nan
لتنفيذ	implementirati	Nan
لتوفير	da obezbedim	Nan
لتوليد	za generisanje	Nan
لجأ	izbeglica	Nan
لجامعة	univerzitet	None
لجعل	napraviti	None
لجمع	za prikupljanje	Nan
لجمهورية	za republiku	Nan
لجنة	odbor	None
لدعم	podrzati	Nan
لدول	u zemlje	Nan
لدولة	u neku zemlju	Nan
لصناعة	za proizvodnju	Nan
لضمان	da garantujemo	Nan
لطفي	lotfi	Nan
لطيفة	latifa	Nan
لظهور	da se pojavi	Nan
لعام	za godinu	Nan
لعب	igra	None
لعبة	igračka	Nan
لعبت	igrao sam	Nan
لعبد	slugi	Nan
لعدة	za nekoliko	Nan
لعدد	za broj	Nan
لعدم	za ne	Nan
لعطارد	za merkur	Nan
لعل	može	None
لصالح	favor	Nan
لشركة	za kompaniju	Nan
لشبونة	lisabon	Nan
لشبه	zbog sličnosti	Nan
لدى	imam	None
لدي	imam	None
لدينا	imamo	None
لديه	on ima	Nan
لديها	ona ima	Nan
لديهم	oni imaju	Nan
لذا	dakle	None
للتنمية	za razvoj	Nan
لذلك	dakle	None
لرعاية	da se brinemo	Nan
لزيادة	povećati	Nan
لسان	jezik	None
لسكان	za stanovnike	Nan
لسنة	za godinu	Nan
لسنوات	godinama	None
لسياسة	za politiku	Nan
لرئيس	za glavu	Nan
للثقافة	za kulturu	Nan
للثورة	revolucije	None
للجدل	kontroverzni	Nan
للموسيقى	za muziku	Nan
للمياه	za vodu	Nan
للميلاد	za rođendan	Nan
للنادي	za klub	Nan
للناس	za ljude	Nan
للنبي	poslaniku	None
للنساء	za ženu	Nan
للنظام	za sistem	Nan
للنفط	za ulje	Nan
للنقل	za transfer	Nan
لله	allah	None
للهجوم	da napadne	Nan
للوزراء	ministrima	Nan
للوصول	posegnuti	Nan
للولايات	državama	None
للمواد	za materijale	Nan
لليهود	jevrejima	Nan
للمنطقة	za regiju	Nan
للملك	kralju	None
للكواكب	za planete	Nan
للكوكب	za planetu	Nan
للكويت	za kuvajt	Nan
للماء	vodootporan	Nan
للمجتمع	zajednici	None
للمجلس	vijeću	Nan
للمجموعة	za grupu	Nan
للمدينة	za grad	Nan
للمرة	za sada	Nan
للمساعدة	za pomoc	Nan
للمستخدمين	za korisnike	Nan
للمسجد	za džamiju	Nan
للمسلمين	za muslimane	Nan
للمسيحية	za hrišćanstvo	Nan
للمغرب	za maroko	Nan
للمملكة	za kraljevstvo	Nan
لم	nije	None
لما	kada	None
لماذا	zašto?	Nan
لن	neću	None
لنا	naši	Nan
لندن	london	None
لنظام	u sistem	Nan
لنظرية	za teoriju	Nan
لنفسه	za sebe	Nan
لنقل	recimo	None
لنكدوك-روسيون	languedoc-roussillon	Nan
لنهر	za rijeku	Nan
له	za njega	Nan
لها	njoj	None
لهتلر	za hitlera	Nan
لهجات	akcenti	Nan
لهجة	dijalekt	None
لهذا	za ovo	Nan
لمواجهة	u lice	Nan
لمنع	spriječiti	None
لمنظمة	za organizaciju	Nan
لمنطقة	za područje	Nan
لمجلس	za dasku	Nan
لمجموعة	za grupu	Nan
لمحاربة	boriti se	Nan
لمحاولة	probati	Nan
لمحمد	muhammedu	None
لمختلف	za različite	Nan
لمدة	nakratko	Nan
للكنيسة	za crkvu	Nan
لمدينة	za grad	Nan
لمساعدة	pomoći	None
لمصر	za egipat	Nan
لمعالجة	na adresu	Nan
لمعرفة	saznati	Nan
لمعظم	za većinu	Nan
لمكافحة	boriti se	Nan
لمن	čiji	None
لمرض	za bolest	Nan
مسلسلات	serija	None
للكثير	za mnoge	Nan
للقيام	uraditi	None
للخليفة	kalifu	Nan
للدراسات	za studije	Nan
للدراسة	učiti	Nan
للدفاع	braniti	Nan
للدلالة	da označimo	Nan
للدول	državama	None
للدولة	državi	None
للدين	za religiju	Nan
للرئيس	predsjedniku	None
للرجال	za muškarce	Nan
للرجل	za čoveka	Nan
للزراعة	za poljoprivredu	Nan
للزهرة	za cvijet	Nan
للسكان	za stanovništvo	Nan
للسلام	mir	None
للخلافة	za sukcesijom	Nan
للسلطان	sultanu	Nan
للحيوانات	za životinje	Nan
للحكومة	vladi	None
للجزائر	za alžir	Nan
للجسم	za tijelo	Nan
للجمعية	udruženju	Nan
للجمهورية	republike	None
للجميع	za svakoga	Nan
للجنة	u komisiju	Nan
للجيش	za vojsku	Nan
للحد	da biste ograničili	Nan
للحرارة	za zagrevanje	Nan
للحرب	zbog rata	Nan
للحركة	za kretanje	Nan
للحزب	za zabavu	Nan
للحصول	dobiti	None
للحفاظ	zadržati	None
للحكم	da presudi	Nan
للحياة	za život	Nan
للسلطة	za snagu	Nan
للسيارات	za automobile	Nan
للسيطرة	kontroli	Nan
للعناصر	za predmete	Nan
للعهد	za savez	Nan
للعولمة	za globalizaciju	Nan
للغاية	ekstremno	None
للغة	za jezik	Nan
للفرد	za pojedinca	Nan
للفنون	za umetnost	Nan
للفيروسات	za viruse	Nan
للقارات	interkontinentalni	Nan
للقتال	boriti se	Nan
للقدس	za jeruzalem	Nan
للقرآن	za kur&#39;an	Nan
للقرن	vijekom	Nan
للقضاء	za eliminaciju	Nan
للقوات	za trupe	Nan
للعمل	za rad	Nan
للعلوم	nauke	None
للعلماء	za učenjake	Nan
للعلم	za informaciju	Nan
للشباب	za mlade	Nan
للشعب	ljudima	None
للشمس	za sunce	Nan
للشيخ	šeik	Nan
للصلاة	da se mole	Nan
للضوء	zapaliti	Nan
للطاقة	za energiju	Nan
للكتاب	za knjigu	Nan
للطبيعة	prirode	None
للطيران	letjeti	Nan
للعالم	za svijet	Nan
للعام	za godinu	Nan
للعديد	za nekoliko	Nan
للعراق	za irak	Nan
للعرب	arapima	Nan
للعلاج	za lečenje	Nan
للطلاب	za studente	Nan
مسلم	muslimanski	None
مسلمة	muslimanski	None
مسلمون	muslimani	None
نصف	polovina	None
نصوص	tekstovi	None
نصيب	podeliti	Nan
نصير	pristalice	Nan
نطاق	domena	None
نظام	sistem	None
نظر	razmatranje	Nan
نظرا	zbog	None
نظراً	zbog	None
نظرة	pogled	None
نظريات	teorije	None
نظرية	teorija	None
نظريته	njegova teorija	Nan
نظرًا	zbog	None
نظم	organizovano	Nan
نصر	pobeda	Nan
نظير	utakmicu	None
نصب	postaviti	Nan
نشوب	izbijanje	Nan
نسمة	vetar	None
نشأ	škrob	Nan
نشأة	postanak	None
نشأت	porijeklom	None
نشأته	odrastao sam	Nan
نشأتها	nastao je	Nan
نشاط	aktivnost	None
نشاطات	aktivnosti	None
نشبت	provalili	Nan
نشر	širenje	None
نشرت	objavljeno	Nan
نشرها	objavio	None
نشط	aktivan	None
نشطة	aktivno	None
نشوء	nastajanje	None
نص	tekst	None
نسل	seme	Nan
نعرف	mi znamo	Nan
نفر	ugasiti	Nan
نمر	tigar	Nan
نمط	stilu	None
نمو	rast	None
نموذج	obrazac	Nan
نهائي	konačno	None
نهائيات	finale	None
نهاية	kraj	None
نهج	pristup	None
نهر	river	Nan
نهضة	renesansa	Nan
نهيان	nahyan	Nan
نواب	poslanici	None
نواة	jezgra	None
نواس	klatno	Nan
نوبل	plemenita	Nan
نمت	odrastao	Nan
نعيم	naeem	Nan
نماذج	obrasci	Nan
نقله	pomeri se	Nan
نفس	isto	None
نفسه	sebe	None
نفسها	sama sebe	Nan
نفسي	ja	None
نفسية	psihološki	Nan
نفط	ulje	Nan
نفوذه	njegov uticaj	Nan
نفوذها	njegov uticaj	Nan
نفوس	duše	None
نفي	uskraćivanje	Nan
نقاط	bodova	None
نقد	gotovina	Nan
نقص	nedostatak	None
نقطة	tačka	None
نقل	transfer	Nan
نقول	kažemo	None
نسخة	kopiraj	Nan
نسخ	kopija	Nan
نستطيع	možemo	None
نابلس	nablus	Nan
نابليون	napoleon	None
ناتج	izlaz	None
ناجحة	uspešno	Nan
ناحية	ruka	None
نادرة	retko	Nan
نادى	klub	None
نادي	klub	None
نار	vatra	None
ناسا	nasa	Nan
ناصر	naser	None
ناطقة	govoreći	None
نال	je dobio	Nan
نالت	ima	None
نانسي	nancy	Nan
ناب	kljova	Nan
نايف	nayef	Nan
نائب	zamenik	Nan
مِنْ	od	None
ميدان	kvadrat	Nan
ميزانية	budžet	Nan
ميزة	značajka	Nan
ميسي	messi	Nan
ميكانيكا	mehanika	Nan
ميل	sklonost	None
ميلاد	rođenje	None
ميلان	milan	None
ميلانو	milan	None
ميلودراما	melodrama	Nan
ميناء	luka	None
ميونيخ	minhen	Nan
مَا	šta	None
مَنْ	od	None
مِن	od	None
ن	n	None
نبات	biljka	None
نباتات	biljke	None
نبتون	neptun	Nan
نحو	prema	None
نذكر	spominjemo	Nan
نرى	vidimo	None
نزار	nazar	Nan
نزل	skinuti	Nan
نزلت	sišao sam	Nan
نزول	silazi	Nan
نساء	žene	None
نسب	linija	None
نسبة	ocijeni	Nan
نسبته	njegov omjer	Nan
نسبه	postotak	None
نسبيا	relativno	None
نسبياً	relativno	None
نسبيًا	relativno	None
نحن	mi	None
نجيب	najib	Nan
نجوم	zvezde	Nan
نجمة	zvijezda	None
نبذة	ukratko	None
نبي	poslaniče	Nan
نبيل	nabil	Nan
نت	neto	Nan
نتائج	posljedice	None
نتاج	proizvod	None
نتج	rezultat	None
نوح	noah	Nan
نتيجة	kalendara	None
نجاحاً	uspeh	Nan
نجاد	najad	Nan
نجح	uspeo je	Nan
نجحت	prošao sam	Nan
نجد	mi nalazimo	Nan
نجران	najran	Nan
نجم	zvijezda	None
نجاح	uspeh	Nan
نور	svetlost	Nan
نورة	noura	Nan
نوستراداموس	nostradamus	Nan
وأبي	i moj otac	Nan
وأتباعه	i njegovi sledbenici	Nan
وأثناء	i tokom	Nan
وأجزاء	i delovi	Nan
وأجهزة	i servo	Nan
وأحد	jedan	None
وأحمد	i ahmed	Nan
وأحيانا	a ponekad	Nan
وأخذ	i uzimanje	Nan
وأخذت	i ona je uzela	Nan
وأخرى	i još jedna	Nan
وأخيرا	i na kraju	Nan
وأخيراً	napokon	None
وأخيرًا	i na kraju	Nan
وأدت	i vodio	Nan
وأبو	i abu	Nan
وأدى	dolina	None
وأبرزها	najistaknutiji	Nan
وآله	i njegova porodica	Nan
هي	ona	None
هيئة	telo	Nan
هيا	hajde	Nan
هياكل	strukture	None
هيدروجين	vodonik	None
هيفاء	haifa	Nan
هيكل	struktura	None
هيلين	helen	Nan
هيم	hem	Nan
هينايانا	hinayana	Nan
هُوَ	on je	Nan
و	i	None
وآخر	i još jedna	Nan
وآخرون	i drugi	Nan
وآسيا	a azija	Nan
وأبرز	najviše istaknuto	Nan
وأذربيجان	i azerbejdžan	Nan
وأربعين	i četrdeset	Nan
وأرسل	poslao je	Nan
وأقدم	i stariji	Nan
وأقل	i manje	Nan
وأكبر	i veće	Nan
وأكثر	i više	Nan
وأكثرها	i većina njih	Nan
وأكد	potvrđeno	None
وألمانيا	i nemačka	Nan
وأما	ili	None
وأمر	naredio je	Nan
وأمريكا	i amerika	Nan
وأمه	i njegova majka	Nan
وأن	i sigurno	Nan
وأنا	i ja	Nan
وأنشأ	uspostavljeno	Nan
وأنه	i jeste	Nan
وأقام	ostao je	Nan
وأقاليم	i teritorije	Nan
وأفغانستان	i avganistan	Nan
وأفريقيا	i afrika	Nan
وأساليب	i metode	Nan
وأسباب	i razlozi	Nan
وأستراليا	i australija	Nan
وأسس	i temelje	Nan
وأشار	istaknuto	Nan
وأشهر	najpoznatiji	None
وأصبح	i postalo je	Nan
هوية	identifikacija	Nan
وأصبحت	i postao sam	Nan
وأصحابه	i njegovi drugovi	Nan
وأضاف	dodao je	Nan
وأطلق	otpušten je	Nan
وأعضاء	i članovi	Nan
وأعلن	najavio je	Nan
وأعلنت	bilo je najavljeno	Nan
وأغلب	i većina	Nan
وأصحاب	i vlasnici	Nan
ميخائيل	michael	None
هولندا	holland	Nan
هوراس	horace	Nan
هاجر	emigrirali	Nan
هاجروا	oni su migrirali	Nan
هاجم	napadani	Nan
هاجمت	napadani	Nan
هارفارد	harvard	Nan
هارون	aaron	Nan
هاري	harry	Nan
هاشم	hashem	Nan
هام	bitan	None
هاما	bitan	None
هاماً	bitan	None
هامة	bitan	None
هاواي	havaji	Nan
هايدا	haida	Nan
هتلر	hitler	None
هاتين	ovo dvoje	Nan
هجرة	migracija	None
هائلة	ogroman	None
هؤلاء	ove	None
نوع	tip	None
نوعا	nešto kao	Nan
نوعان	dve vrste	Nan
نوعه	njegova vrsta	Nan
نوعها	njegova vrsta	Nan
نوعية	kvaliteta	None
نوعين	dve vrste	Nan
نوفمبر	nov	Nan
نووي	nuklearni	None
نووية	nuklearna	None
نيتشه	nietzsche	None
نيجيريا	nigerija	Nan
نيوتن	newton	Nan
نيوزيلندا	novi zeland	Nan
نيويورك	njujork	Nan
هائل	ogroman	None
هجمات	napadi	None
هجوم	napad	None
هدف	cilj	None
هـم	hm	Nan
هكتور	hektor	Nan
هكذا	dakle	None
هل	da li ti	Nan
هلال	polumesec	Nan
هم	oni	None
هما	oni	None
هنا	evo	None
هناك	tamo	None
هنالك	tamo	None
هند	hind	Nan
هندسة	inženjering	None
هنري	henry	None
هو	on je	Nan
هواء	zrak	None
هـ	e	None
هطول	padavine	None
هضبة	visoravan	None
هشام	hesham	Nan
هدفه	njegov cilj	Nan
هدم	uništiti	None
هدنة	primirje	None
هدى	uputstvo	Nan
هذا	ovo	None
هذان	ovo dvoje	Nan
هذة	ovo je	Nan
هولاكو	hulagu	Nan
هذه	ovo je	Nan
هرب	pobegli	Nan
هرقل	hercules	Nan
هرقليطس	heraklit	Nan
هرم	piramida	None
هريرة	mače	Nan
هزم	poražen	None
هزيمة	poraz	None
هذين	ovo dvoje	Nan
وأنواع	i vrste	Nan
ميثيونين	metionin	Nan
ميت	smrt	None
معقد	kompleks	None
معقدة	komplikovano	Nan
معلومات	informacije	None
معمر	stariji	None
معناه	njegovo značenje	Nan
معناها	njegovo značenje	Nan
معنى	značenje	None
معه	s njim	Nan
معهد	institut	None
معهم	sa njima	Nan
معينة	izvesno	Nan
معًا	zajedno	None
مغادرة	odlazeći	Nan
مغامرات	avanture	Nan
مغربي	marokanski	Nan
معظمهم	većina njih	Nan
مغناطيسي	magnetska	Nan
معظمها	većinom	None
معسكرات	kampovi za dizanje	Nan
معتدل	umeren	Nan
معتدلة	umeren	Nan
معترف	akreditovani	Nan
معجزة	čudo	None
معد	predviđeno	Nan
معدات	opreme	None
معدة	želudac	None
معدل	ocijeni	Nan
معدلات	cijene	None
معدنية	metal	None
معرفة	znanje	None
معركة	bitka	None
معروف	uslugu	Nan
معروفة	poznat	None
معسكر	kamp	Nan
معظم	većina	None
معبد	hram	None
مغناطيسية	magnetska	Nan
مفاهيم	pojmovi	None
مقاومة	otpor	None
مقبرة	groblje	None
مقبولة	prihvatljivo	Nan
مقتل	ubijen	None
مقتله	ubio ga je	Nan
مقدار	iznos	None
مقدسة	sveto	None
مقدم	presenter	Nan
مقدمة	uvod	None
مقدونيا	makedonija	None
مقديشيو	mogadishu	Nan
مقر	sjedište	None
مقرا	sto	None
مقرها	na osnovu	Nan
مقسمة	podeljeno	Nan
مقام	denominator	Nan
مفاعل	reaktor	Nan
مقالة	članak	None
مقال	članak	None
مفاوضات	pregovori	None
مفتاح	ključ	None
مفتوحة	otvori	Nan
مفتي	muftija	Nan
مفصلة	šarke	Nan
مفهوم	koncept	None
مفيدة	korisno	Nan
مقابر	groblja	None
مقابل	nasuprot	None
مقابلة	intervju	None
مقاتل	borac	None
مقارنة	poređenje	None
مقاطعات	okrug	None
مقاطعة	bojkot	Nan
مقاعد	sjedala	Nan
مقالات	članci	None
معاً	zajedno	None
معايير	standardi	None
معاوية	sid	Nan
مشتقة	derivat	None
مشروع	projekat	None
مشعل	baklja	Nan
مشكلة	problem	None
مشهد	scena	Nan
مشهور	poznat	None
مشهورة	poznat	None
مشيخة	ona je stara	Nan
مصادر	izvori	None
مصانع	fabrike	None
مصحف	mus&#39;haf	Nan
مصدر	izvor	None
مصر	egipat	None
مصرف	banka	None
مصري	egipatski	Nan
مشتركة	deljeno	Nan
مصريات	egipatske žene	Nan
مشترك	uzajamno	Nan
مشاهدة	pazi	Nan
مسلمين	muslimani	None
مسمى	imenovana	Nan
مسند	podnožje za noge	Nan
مسيحية	hrišćanin	Nan
مسيرة	marš	Nan
مسيرته	njegova karijera	Nan
مشابه	slično	None
مشابهة	slično	None
مشاة	pješački	Nan
مشاركة	deljenje	Nan
مشاريع	projekti	None
مشاعر	osećam	Nan
مشاعل	flares	Nan
مشاكل	problemi	None
مشاهد	pogled	None
مشاهير	poznat	None
مصرية	egipatski	Nan
مصريون	egipćani	None
مصطفى	mustafa	None
مظاهر	izgledi	Nan
مظاهرات	protesti	Nan
مظهر	izgled	None
مع	sa	None
معا	zajedno	None
معاداة	neprijateljstvo	Nan
معارض	suprotstavljeni	Nan
معارضة	opozicija	Nan
معارك	borbe	None
معالجة	obrada	None
معالم	prekretnice	Nan
معامل	faktor	None
معاملة	tretman	None
معاني	značenja	None
معاهدة	ugovor	None
مطلقة	razveden	Nan
مطلع	početak	None
مطلة	s pogledom	Nan
مطرب	pevačica	Nan
مصطلح	pojam	None
مصطلحات	uslovi	None
مصلحة	kamata	Nan
مصنع	fabrika	None
مصنوع	napravljeno	Nan
مصنوعة	napravljeno	Nan
مصير	sudbina	None
مقياس	skala	Nan
مضادة	counter	Nan
مضى	otići na	Nan
مضيق	tjesnac	Nan
مطابقة	odgovarajući	None
مطار	zračna luka	Nan
مطارات	zračne luke	Nan
مطالب	potražnje	Nan
مطر	kiša	None
مضخم	pojačalo	Nan
مكاتب	uredi	Nan
مكافحة	borba	None
مكان	mesto	Nan
مهد	kolijevka	Nan
مهدي	mahdi	Nan
مهرجان	festivalu	None
مهم	bitan	None
مهما	kako god	Nan
مهمة	misija	None
مهمًا	kako god	Nan
مهنة	profesija	Nan
مهندس	inženjer	Nan
مواجهة	sukob	None
مواد	materijal	None
موارد	resursa	None
مواضيع	teme	None
مواطن	građanin	None
مواطني	moji zemljaci	Nan
مهام	zadaci	Nan
موافقة	saglasnost	Nan
مهارات	vještine	None
منيرة	munira	Nan
منصب	pozicija	None
منصبه	ured	Nan
منصور	mansoor	Nan
منطقة	područje	None
منظمات	organizacije	None
منظور	perspektiva	Nan
منع	blok	None
منعت	sprečeno	Nan
منغوليا	mongolija	Nan
منها	od kojeg	Nan
منهج	metoda	None
منهم	ko su oni	Nan
منهما	ko su oni	Nan
منى	mona	Nan
مني	mona	Nan
مهاجمة	napad	None
مواقع	web stranice	Nan
مواقف	situacije	None
مواليد	baby boomeri	Nan
موطن	dom	None
موعد	sastanak	Nan
موقع	lokacija	None
موقعة	potpisan	None
موقعه	potpisan	None
موقعها	njegova lokacija	Nan
موقف	stav	None
موقفه	njegova pozicija	Nan
مول	tržni centar	Nan
مولاي	moulay	Nan
مولده	njegovo rođenje	Nan
موليبدنوم	molibden	None
مونتانا	montana	Nan
مونكو	monco	Nan
مياه	vode	None
موضي	moudy	Nan
موضوع	tema	None
موضع	pozicija	None
موسيقية	mjuzikl	Nan
موانئ	portovi	Nan
موت	smrt	None
موته	njegova smrt	Nan
موجات	talasi	Nan
موجة	talas	Nan
موجودة	pronađeno	Nan
موحد	objedinjena	Nan
منزله	njegova kuća	Nan
موحدة	uniformna	Nan
موريتانيا	mauritanija	Nan
موسكو	moskva	None
موسم	sezona	None
موسوعة	enciklopedija	None
موسوليني	mussolini	Nan
موسى	mousa	Nan
موسيقى	muzika	None
مورد	dobavljač	Nan
ميثاق	povelja	None
منزلة	njegova kuća	Nan
منذ	prije	None
ملجأ	izbeglica	Nan
ملحوظ	označeno	Nan
ملحوظة	nb	Nan
ملعب	stadion	None
ملعقة	kašika	Nan
ملف	datoteka	None
ملفات	datoteke	None
ملك	kralju	None
ملكة	kraljice	None
ملكي	royal	Nan
ملكية	vlasništvo	None
ملكًا	kralju	None
ملوك	kraljevi	None
مليار	milijardi	Nan
مليون	milion	None
ملايين	milionima	Nan
مما	than	Nan
ملامح	karakteristikama	None
ملاحظة	bilješka	Nan
مكانة	statusa	None
مكانته	njegov stas	Nan
مكانه	statusa	None
مكانها	njegovo mesto	Nan
مكة	meka	Nan
مكتب	ured	Nan
مكتبة	biblioteka	None
مكتوب	napisano	Nan
مكتوبة	napisano	Nan
مكتوم	prigušen	Nan
مكنسة	metla	Nan
مكون	sastojak	None
مكونات	sastojci	Nan
مكونة	izmišljeno	Nan
ملاحظات	napomene	Nan
ملاك	anđeo	Nan
مماثل	slično	None
مماثلة	slično	None
ممارسة	vežba	Nan
مناف	munaf	Nan
منافسة	konkurencija	Nan
مناقشة	debata	Nan
مناهج	curricula	Nan
منتج	producent	None
منتجات	proizvodi	None
منتخب	izabran	None
منتشرة	široko rasprostranjena	Nan
منتصف	sredina	Nan
منتظم	redovan	Nan
منتظمة	redovno	None
منح	grant	Nan
منحت	odobreno	Nan
منخفض	nizak	None
منخفضة	nizak	None
مناطق	regioni	Nan
مناصب	pozicije	None
مناسبة	prilika	None
مناسب	odgovarajuće	None
ممالك	kraljevstva	None
مماليك	mamluks	Nan
ممثل	glumca	Nan
ممثلة	glumica	None
ممرض	sestra	None
ممكن	možda	None
ممكنة	moguće	None
منزل	kuća	None
مملكة	kraljevstvo	None
مميزات	značajke	Nan
مميزة	prepoznatljiv	None
من	od	None
منا	od nas	Nan
مناخ	klima	None
منارة	svjetionik	Nan
منازل	kuće	None
ممن	od koga	Nan
يُلاحظ	biljeska	Nan
تسبب	izaziva	None
تساهم	doprinosi	None
التلفاز	televizija	None
التلفزيون	televizija	None
التلفزيونية	televizija	None
التلوث	zagađenje	Nan
التمثيل	glume	Nan
التمرد	pobuna	None
التمويل	finansiranje	Nan
التميمي	al-tamimi	Nan
التمييز	diskriminacija	Nan
التنازل	odricanje	Nan
التناسلي	genitalni	Nan
التناسلية	genitalni	Nan
التنافس	konkurencija	Nan
التنبؤ	prognoziranje	Nan
التنسيق	koordinacija	Nan
التلاميذ	zenice	None
التنظيم	organizacija	None
التكيف	adaptacija	Nan
التكنولوجية	tehnološki	None
التقسيم	particija	Nan
التقسيمات	odjeljenja	Nan
التقليد	tradicija	None
التقليدي	tradicionalno	None
التقليدية	tradicionalno	None
التقنيات	tehnologije	None
التقنية	tehnologija	None
التقويم	kalendar	None
التقى	on je upoznao	Nan
التقييم	procena	Nan
التكاثر	reprodukcija	Nan
التكافؤ	valensija	Nan
التكتونية	tektonski	Nan
التكلفة	troškova	None
التكنولوجيا	tehnologija	None
التكوين	konfiguracija	Nan
التقرير	izvjestaj	Nan
التنفس	disanje	None
التنفيذي	izvršna	None
التونسية	tunižanin	Nan
التي	koji	None
التيار	struja	None
التيارات	struje	None
الثابت	konstantno	None
الثابتة	fiksno	Nan
الثالث	treći	None
الثالثة	treći	None
الثالوث	trojstvo	Nan
الثامن	viii	None
الثامنة	osmo	Nan
الثانوي	sekundarni	None
الثانوية	srednja škola	Nan
الثاني	drugi	None
الثانية	drugi	None
التونسي	tunižanin	Nan
التنفيذ	implementacija	Nan
التوقيع	potpis	Nan
التوسع	proširenje	None
التنفيذية	izvršni	Nan
التنقل	mobilnost	Nan
التنقيب	istraživanje u vodi	Nan
التنمية	razvoj	None
التنوع	raznolikost	Nan
التنوير	prosvetljenje	Nan
التهاب	upala	None
التوازن	bilans	Nan
التواصل	komunikacija	None
التوالي	ravno	None
التوبة	pokajanje	Nan
التوتر	stres	Nan
التوجه	orijentacija	Nan
التوحيد	monoteizam	Nan
التوراة	tore	Nan
التوصل	dosegni	Nan
التقديرات	procjene	None
التقدم	napredak	None
التقاليد	tradicije	None
التشريح	anatomija	None
التشريع	zakonodavstvo	Nan
التشريعات	zakonodavstvo	Nan
التشريعي	zakonodavni	Nan
التشريعية	zakonodavni	Nan
التشكيل	formiranje	None
التصحر	dezertifikacija	Nan
التصدي	suočiti	Nan
التصديق	certifikat	Nan
التصرف	zakon	None
التصفيات	doigravanje	Nan
التصميم	dizajn	None
التصنيع	proizvodnja	None
التصنيف	kategorija	None
التصنيفات	klasifikacije	Nan
التشخيص	dijagnoza	None
التصوف	sufizam	Nan
التشابه	sličnosti	None
التسونامي	tsunami	Nan
الترجمة	prevod	Nan
الترفيهية	rekreacijski	Nan
الترك	turk	Nan
التركي	turski	None
التركيب	sastav	None
التركية	turski	None
التركيز	koncentraciju	Nan
الترمذي	tirmidhi	Nan
التزاوج	parenje	Nan
التزلج	skijanje	Nan
التسامح	tolerancija	Nan
التسجيل	registrirajte se	Nan
التسعينيات	devedesete	Nan
التسلسل	slijed	Nan
التسمية	etiketa	Nan
التسويق	marketing	None
التصويت	glasanje	Nan
التصوير	fotografija	None
التضاريس	landforms	Nan
التعليم	obrazovanje	None
التعليمي	obrazovni	Nan
التعليمية	obrazovni	Nan
التغذية	ishrana	Nan
التغير	promjena	None
التغيرات	promjene	None
التغيير	promjena	None
التغييرات	promjene	None
التفاصيل	detalji	Nan
التفاعل	interakcija	Nan
التفسير	objašnjenje	None
التفسيرات	objašnjenja	Nan
التفكير	razmišljam	Nan
التفوق	superiornost	Nan
التقارير	izveštaji	Nan
التعلم	učenje	None
التعريفات	tarife	Nan
التعريف	definicija	None
التعرية	skidanje	Nan
التضخم	inflacija	Nan
التطبيق	primjena	None
التطبيقات	aplikacije	None
التطبيقية	primenjeno	Nan
التطور	razvoj	None
التطورات	razvoja	None
التطوير	razvoj	None
الثبات	upornost	Nan
التعاليم	predavanja	None
التعاون	cooperat	Nan
التعبير	izraz	None
التعداد	popis	None
التعديل	podešavanje	Nan
التعديلات	podešavanja	Nan
التعرض	izloženost	Nan
التعرف	prepoznajte	Nan
التعامل	suočavanje	Nan
الترجمات	prijevodi	Nan
الثدي	grudi	Nan
الثروات	bogatstvo	None
الجمع	množina	Nan
الجمعة	petak	None
الجمعيات	udruženja	None
الجمعية	udruženje	None
الجمل	deva	Nan
الجملة	rečenica	None
الجمهور	publika	None
الجمهوري	republikanski	Nan
الجمهورية	republika	None
الجميع	svi	None
الجن	jinn	Nan
الجنائية	zločinački	Nan
الجناح	odeljenje	Nan
الجنة	raj	None
الجند	vojnici	None
الجمباز	gimnastika	None
الجندي	vojnik	None
الجماهير	mase	None
الجماعية	kolektivna	Nan
الجسر	most	None
الجسم	tijelo	None
الجسور	mostovi	None
الجسيمات	čestice	None
الجغرافي	geografski	None
الجغرافيا	geografija	None
الجغرافية	geografski	None
الجفاف	suša	None
الجلد	koža	None
الجليد	led	None
الجليدية	ledena	Nan
الجليل	galileja	Nan
الجماع	razgovor	None
الجماعة	zajednica	None
الجماعي	kolektivna	Nan
الجمال	ljepota	Nan
الجسد	tijelo	None
الجنرال	općenito	None
الجنسي	seksualni	Nan
الجولان	golan	Nan
الجوهرة	dragulj	Nan
الجوي	zrak	None
الجوية	zrak	None
الجيد	dobro	None
الجيدة	zgodna	Nan
الجيزة	giza	Nan
الجيش	vojska	None
الجيل	generacija	None
الجينات	geni	Nan
الجينوم	genom	Nan
الجيني	genetski	Nan
الجينية	genetski	Nan
الجيوش	vojske	None
الجيولوجية	geološki	None
الجوفية	podzemna	Nan
الجنس	seks	None
الجودة	kvaliteta	None
الجوار	susjedstvo	Nan
الجنسيات	nacionalnosti	None
الجنسية	nacionalnost	Nan
الجنسين	spol	None
الجنوب	jug	None
الجنوبي	južna	None
الجنود	vojnici	None
الجنين	fetus	Nan
الجهات	glumci	None
الجهاز	uređaj	None
الجهة	odredište	Nan
الجهد	napor	None
الجهل	neznanje	Nan
الجهود	napori	Nan
الجو	vrijeme	None
الجوائز	nagrade	None
الجوانب	aspekti	Nan
الجزيرة	al jazeera	Nan
الجزية	tribute	Nan
الجزيئي	molekularni	Nan
الثمانية	osam	None
الثمانينات	osamdesete	Nan
الثمانينيات	osamdesete	Nan
الثنائي	par	None
الثنائية	bilateralna	Nan
الثوار	revolucionari	Nan
الثورات	revolucije	None
الثورة	revolucija	None
الثوري	revolucionarni	Nan
الثورية	revolucionarni	Nan
الجائزة	nagrada	None
الجابر	al jaber	Nan
الجاحظ	bigeye	Nan
الجاذبية	gravitacija	Nan
الجاز	jazz	None
الثلوج	snijeg	None
الجاف	suva	Nan
الثلج	snijeg	None
الثلاثينات	tridesete	Nan
الثروة	bogatstvo	None
الثقافات	kulture	None
الثقافة	kultura	None
الثقافي	kulturni	None
الثقب	rupa	None
الثقة	povjerenje	None
الثقفي	kulturni	None
الثقوب	rupe	None
الثقيل	teški	None
الثقيلة	teški	None
الثلاث	tri	None
الثلاثاء	utorak	Nan
الثلاثة	tri	None
الثلاثي	trio	Nan
الثلاثين	trideset	None
الثلاثينيات	tridesete	Nan
الجافة	suva	Nan
الجاليات	zajednice	None
الجالية	zajednica	None
الجديدة	novo	None
الجدير	vrijedi	None
الجذور	korenje	Nan
الجرائم	zločini	Nan
الجراثيم	klice	Nan
الجراح	hirurg	Nan
الجرمانية	germanska	Nan
الجريدة	novine	None
الجريمة	zločin	None
الجزء	odjeljak	Nan
الجزائر	alžir	None
الجزائري	alžir	None
الجزائريين	alžirci	Nan
الجزر	mrkva	Nan
الجزيئات	molekule	None
الجديد	novi	None
الجدول	raspored	None
الجدل	kontroverze	Nan
الجدد	neo	Nan
الجامع	cjelinu	None
الجامعات	univerziteti	Nan
الجامعة	univerzitet	None
الجامعي	univerzitet	None
الجامعية	dodiplomski	Nan
الجانب	strana	None
الجانبية	bočni	Nan
الثدييات	sisari	None
الجانبين	strane	None
الجاهلية	neznanje	Nan
الجبال	planine	None
الجبر	algebra	Nan
الجبل	planina	None
الجبلية	planina	None
الجبهة	prednji	None
الجدار	zid	None
الجاهلي	predislamsko	Nan
الترتيب	dogovor	None
التربية	obrazovanje	None
التربة	tla	None
البابوية	papinstvo	Nan
البابية	prekrivanje	Nan
الباحث	istraživač	None
الباحثون	istraživači	None
الباحثين	istraživači	None
البارد	hladno	Nan
الباردة	hladno	Nan
البارزة	primetna	Nan
البارزين	eminentni	Nan
الباطنية	ezoterični	Nan
الباقي	ostalo	None
الباقية	ostalo	None
البالغ	odrasli	Nan
البالغة	odrasli	Nan
البالغين	odrasli	Nan
البابلية	babilonski	Nan
البتراء	petra	None
البابلي	babilonski	Nan
الباب	vrata	None
الانتقال	useljenje	Nan
الانتقالية	prelazni	Nan
الانتقام	osveta	Nan
الانتهاء	gotov	Nan
الاندلس	andalus	Nan
الاندماج	spajanje	Nan
الانسحاب	izvlaciti	Nan
الانضمام	pridružite se	Nan
الانطروبولوجيا	antropologija	None
الانفجار	eksplozija	Nan
الانفصال	razdvajanje	None
الانقسام	divizija	None
الانقلاب	državni udar	Nan
الاهتمام	kamate	Nan
الايكولوجية	ekološki	Nan
البابا	papa	None
الانتقادات	kritika	None
البترول	nafta	None
البحار	mora	None
البراكين	vulkani	Nan
البرامج	programi	None
البربر	berberi	Nan
البربرية	varvarstvo	Nan
البرتغال	portugal	None
البرتغالي	portugalski	Nan
البرتغالية	portugalski	Nan
البرتغاليين	portugalci	Nan
البرج	toranj	None
البركان	vulkan	Nan
البركاني	vulkanski	Nan
البركانية	vulkanski	Nan
البرلمان	parlament	None
البرلمانية	parlamentarni	Nan
البرمجيات	softver	None
البرازيلي	brazilski	Nan
البث	emitovanje	Nan
البرازيل	brazil	None
البذور	sjeme	Nan
البحر	more	None
البحري	marine	Nan
البحرية	mornarica	Nan
البحرين	dva mora	Nan
البحوث	istraživanje	None
البحيرات	jezera	None
البحيرة	jezero	None
البخار	steam	Nan
البخاري	buhari	Nan
البدء	početak	None
البدائي	primitivna	Nan
البدائية	primal	Nan
البداية	početak	None
البدنية	fizički	None
البدو	beduini	Nan
البر	pravednost	Nan
الانتفاضة	ustanka	None
الانتصارات	pobede	Nan
الانتصار	pobeda	Nan
الاستثمار	investicije	Nan
الاستثمارات	ulaganja	None
الاستخبارات	inteligencija	None
الاستخدام	upotreba	None
الاستخدامات	upotrebe	None
الاستراتيجي	strateški	None
الاستراتيجية	strategija	None
الاستسلام	popustiti	Nan
الاستعمار	kolonizacija	Nan
الاستعماري	kolonijalni	Nan
الاستعمارية	kolonijalni	Nan
الاستعمال	upotreba	None
الاستفتاء	referendum	None
الاستقرار	stabilnost	None
الاستقلال	nezavisnost	None
الازدهار	prosperitet	Nan
الاستنساخ	reprodukcija	Nan
الارتفاع	visina	None
الاختيار	izbor	None
الاجتماع	sastanak	Nan
الاجتماعات	sastanci	Nan
الاجتماعي	društveni	None
الاجتماعية	društveni	None
الاجتهاد	diligence	Nan
الاحتباس	zadržavanje	Nan
الاحتفاظ	zadržati	None
الاحتفال	proslava	Nan
الاحتفالات	proslave	Nan
الاحتكاك	trenje	None
الاحتلال	zanimanje	None
الاحتياجات	potrebe	None
الاختبار	test	Nan
الاختلاف	razlika	None
الاختلافات	razlike	None
الارتباط	link	Nan
الاستهلاك	potrošnja	Nan
الاستواء	izravnavanje	Nan
الاستوائية	tropska	Nan
الاعمال	posao	None
الاغنية	pjesma	None
الاقتصاد	ekonomija	None
الاقتصادي	ekonomski	None
الاقتصادية	ekonomski	None
الاكتشاف	otkriće	None
الاكتشافات	otkrića	None
الالتزام	posvećenost	Nan
الامام	imam	None
الامبراطورية	carstvo	None
الامير	princ	None
الانتخابات	izbori	None
الانتخابية	izborni	Nan
الانتداب	mandat	None
الانتشار	širenje	None
الاعلام	mediji	None
الاعتماد	akreditacija	Nan
الاعتقاد	verovanje	Nan
الاعتراف	prepoznavanje	Nan
الاستيلاء	napadaj	Nan
الاسكندنافية	skandinavski	Nan
الاسم	ime	None
الاسود	crna	None
الاشتراك	pretplata	Nan
الاشتراكي	socijalistička	None
الاشتراكية	socijalizam	None
البرنامج	program	None
الاشتراكيون	socijalisti	Nan
الاصطناعي	veštačka	Nan
الاضطراب	uznemirenost	Nan
الاضطرابات	nemir	Nan
الاضطهاد	progon	Nan
الاضطهادات	progoni	Nan
الاعتبار	razmatranje	Nan
الاعتداء	napada	None
الاصطناعى	sintetički	Nan
البروتستانت	protestantski	Nan
البروتستانتية	protestantizam	None
البروتوكولات	protokoli	None
التأكيد	potvrda	Nan
التأليف	autorstvo	Nan
التأمين	osiguranje	Nan
التائية	t	Nan
التابع	sljedbenik	Nan
التابعة	pridružite se	Nan
التابعين	sljedbenici	None
التاج	kruna	None
التاريخ	istorija	None
التاريخي	istorijskog	Nan
التاريخية	istorijskog	Nan
التاسع	deveti	Nan
التاسعة	deveti	Nan
التالي	sljedeći	None
التالية	sljedeći	None
التأكد	biti siguran	Nan
التبادل	razmjena	None
التأثيرات	uticaji	Nan
البيولوجية	biološki	None
البيئات	okruženja	None
البيئة	okoliš	Nan
البيئي	ekološka	Nan
البيان	izjava	Nan
البيانات	podataka	None
البيت	dom	None
البيروني	al-biruni	Nan
البيزنطي	vizantijski	Nan
البيزنطية	vizantijski	Nan
البيزنطيين	vizantijci	Nan
البيض	jaja	None
البيضاء	bijelo	None
البيعة	zalog vernosti	Nan
البيوت	kuće	None
البيولوجي	biološki	None
التأثير	uticaj	None
التبانة	mliječni put	Nan
التبرعات	donacije	Nan
التبغ	duhan	None
التحليلية	analitički	Nan
التحول	smjena	Nan
التحويلية	transformacijski	Nan
التخصص	specijalizacija	Nan
التخصصات	specijalnosti	Nan
التخطيط	planiranje	None
التخلص	riješiti se	Nan
التخلي	odustati	Nan
التدخل	intervencija	None
التدخين	pušenje	None
التدريب	trening	Nan
التدريس	nastava	None
التراب	prljavština	Nan
التراث	baština	None
التراجع	odustajanje	Nan
التحليل	analiza	None
التحكيم	arbitraža	Nan
التحكم	kontrola	None
التحقيق	istraga	Nan
التتار	tatarski	Nan
التجار	trgovci	None
التجارب	iskustva	None
التجارة	trgovanje	Nan
التجاري	komercijalno	Nan
التجارية	komercijalno	Nan
التجديد	obnavljanje	Nan
البويضة	jaje	Nan
التجربة	iskustvo	None
التجريبية	eksperimentalno	Nan
التجنيد	uvrštenje	Nan
التحتية	infrastruktura	None
التحدث	govori	None
التحرك	pomicanje	Nan
التحرير	uređivanje	Nan
التحق	upisano	Nan
التجريبي	demo	Nan
الحائط	zid	None
البونيقية	punic	Nan
البولندية	poljski	None
البضائع	robe	None
البطالة	nezaposlenost	None
البطل	heroj	None
البطن	trbuh	Nan
البطولات	prvenstva	None
البطولة	prvenstvo	None
البظر	klitoris	None
البعث	uskrsnuće	Nan
البعثات	misije	Nan
البعثة	misija	None
البعد	dimenzija	None
البعض	neki	None
البعيدة	daleko	None
البغدادي	al-bagdadi	Nan
البق	kukci	Nan
البصرية	vizuelno	Nan
البقاء	ostani	Nan
البصريات	optika	Nan
البصرة	basra	Nan
البروتونات	protoni	Nan
البروتين	protein	Nan
البروتينات	proteini	None
البري	divlji	Nan
البرية	divlji	Nan
البريد	pošta	None
البريطاني	britanski	None
البريطانية	britanski	None
البريطانيون	britanski	None
البريطانيين	britanci	None
البسيط	jednostavno	None
البسيطة	jednostavno	None
البشر	ljudi	None
البشري	čovjek	None
البشرية	čovečanstvo	Nan
البصري	optički	None
البقر	krava	None
البقرة	krava	None
البقعة	glatka	Nan
البنك	banka	None
البنوك	banke	None
البنى	smeđe	None
البنية	struktura	None
البهاء	sjaj	Nan
البهائي	bahá&#39;í	Nan
البهائية	bahá&#39;ís	Nan
البهائيون	bahá&#39;ís	Nan
البهائيين	bahá&#39;ís	Nan
البوابة	kapija	None
البوب	pop	None
البوذية	budizam	None
البوسفور	bosfor	Nan
البوسنة	bosne	None
البول	urin	Nan
البنفسجية	ljubičasta	Nan
البنات	djevojke	Nan
البنائية	konstruktivizam	Nan
البناء	zgrada	None
البكارة	devičanstvo	Nan
البكتيريا	bakterije	None
البكر	priština	None
البلاد	zemlja	None
البلاغة	retorika	Nan
البلد	država	None
البلدان	zemlje	None
البوم	sove	Nan
البلدة	grad	None
البلدية	opštinska	Nan
البلدين	dvije zemlje	Nan
البلطيق	baltik	Nan
البلغارية	bugarski	None
البلقان	balkana	None
البلوغ	pubertet	Nan
البنا	banna	Nan
البلديات	opštine	None
الاثنين	ponedeljak	Nan
الحاجة	potreba	None
الحادث	incidenta	Nan
الروسي	rus	Nan
الروسية	ruski	None
الروضة	predškolska ustanova	Nan
الروم	ruma	Nan
الرومان	rimljani	None
الرومانسية	romantika	Nan
الروماني	rimski	None
الرومانية	rumunski	None
الرومي	rumi	Nan
الري	navodnjavanje	Nan
الرياح	vjetar	None
الرياض	rijad	Nan
الرياضات	sport	None
الرياضة	sport	None
الرياضي	sportista	None
الروس	rusi	None
الرياضيات	matematika	None
الروحية	duhovno	None
الروح	duhu	None
الركن	ugao	None
الركود	stagnacija	Nan
الرمال	pesak	Nan
الرمز	kod	None
الرمزي	simbolična	Nan
الرمزية	simbolizam	Nan
الرمل	pesak	Nan
الرملية	sandy	Nan
الرموز	ikone	Nan
الرنا	rana	None
الرها	edessa	Nan
الرهبان	redovnici	Nan
الروابط	veze	None
الروايات	novele	None
الرواية	roman	None
الروحي	duhovno	None
الركاب	putnici	None
الرياضية	sport	None
الريف	selu	None
الزهراء	zahra	Nan
الزهرة	cvijet	None
الزهري	sifilis	Nan
الزهور	cvjetovi	None
الزواج	brak	None
الزواحف	reptili	Nan
الزوار	posetioci	Nan
الزوايا	uglovi	Nan
الزوج	muž	None
الزوجة	supruga	None
الزي	uniforme	Nan
الزيادة	povećanje	None
الزيت	ulje	Nan
الزيتون	masline	Nan
الزيدية	zaidi	Nan
الزمنية	vremenska linija	Nan
الريح	vjetar	None
الزمني	vremenska linija	Nan
الزمرة	clique	Nan
الريفية	seoski	None
الزاوية	ugao	None
الزبير	zubair	Nan
الزجاج	čaša	Nan
الزراعة	poljoprivreda	None
الزراعي	poljoprivredne	None
الزراعية	poljoprivredne	None
الزرقاء	plava	None
الزعتر	timijan	Nan
الزعماء	vođe	None
الزعيم	lider	Nan
الزكاة	zakat	Nan
الزلازل	zemljotresi	Nan
الزلزال	potres	Nan
الزمان	vreme	None
الزمن	vreme	None
الرقيق	vrsta	None
الرقم	broj	None
الرقص	ples	Nan
الرئيسية	glavni	None
الرائدة	vodeći	None
الرابطة	nexus	Nan
الرابع	četvrti	None
الرابعة	četvrto	Nan
الراحة	udobnost	Nan
الراحل	kasni	Nan
الراديو	radio	None
الرازي	al-razi	Nan
الراشدين	odrasli	Nan
الرافدين	mezopotamija	Nan
الراقية	high-end	Nan
الراهن	sadašnjosti	Nan
الرايخ	rajh	Nan
الرب	bože	None
الرئيسي	glavni	None
الرباط	rabat	Nan
الرئيسة	predsjednik	None
الرئة	pluća	None
الذكري	muško	Nan
الذكور	muško	Nan
الذهاب	ide	None
الذهب	zlato	None
الذهبي	zlatna	None
الذهبية	zlatna	None
الذي	koji	None
الذين	čiji	None
الرأس	glava	None
الرأسمالي	kapitalistički	Nan
الرأسمالية	kapitalizam	Nan
الرأي	mišljenje	None
الرؤية	vizija	Nan
الرئاسة	predsjedništvo	None
الرئاسية	predsjednički	Nan
الرئيس	predsjedniče	Nan
الربح	profit	Nan
الربط	povezivanje	None
الربع	četvrtina	Nan
الرسول	poslaniče	Nan
الرسولي	apostolski	Nan
الرسوم	naknade	Nan
الرشيد	racionalno	Nan
الرصاص	olovo	None
الرصافي	al rusafi	Nan
الرصد	monitoring	Nan
الرضا	zadovoljstvo	Nan
الرطوبة	vlažnost	None
الرعاية	briga	Nan
الرغبة	želja	None
الرغم	iako	None
الرفاعي	al-rifai	Nan
الرفض	odbacivanje	Nan
الرقابة	kontrola	None
الرسمية	zvanična	None
الرسمي	zvaničnik	Nan
الرسم	crtanje	Nan
الرسل	glasnici	Nan
الربيع	proljeće	None
الرتب	rangira	Nan
الرجال	muškarci	None
الرجل	čovjek	None
الرجوع	povratak	None
الرحالة	backpacker	Nan
الرحلات	izleti	Nan
السؤال	pitanje	None
الرحلة	putovanje	None
الرحمة	milost	Nan
الرحمن	milostiv	Nan
الرحيم	saosećajni	Nan
الرد	odgovor	None
الردة	otpad	Nan
الرسائل	poruke	None
الرسالة	poruka	None
الرحم	maternica	Nan
الذكر	sjećanje	Nan
السائد	prevladavajući	Nan
السائل	tečnost	None
السنوات	godine	None
السنوريات	felidae	Nan
السنوي	godišnje	None
السنوية	godišnje	None
السني	sunitski	None
السنية	sunitski	None
السنين	godine	None
السنّة	godine	None
السهل	lako	None
السهول	ravnine	Nan
السوائل	tečnosti	None
السواحل	obale	None
السوبر	super	None
السوداء	crna	None
السودان	sudan	Nan
السند	obveznica	Nan
السوداني	sudanski	Nan
السنة	godine	None
السمك	riba	None
السلطة	vlast	None
السلطنة	sultanat	Nan
السلع	roba	None
السلف	prethodnika	Nan
السلفية	salafizam	Nan
السلم	ljestve	Nan
السلمية	mirno	None
السلوك	ponašanje	None
السلوكية	bihevioralni	Nan
السليم	ispravno	None
السليمة	zvuk	None
السم	otrov	None
السماء	nebo	None
السمات	značajke	Nan
السماح	dopustiti	Nan
السن	dob	None
السلطانية	posuda	Nan
السودانية	sudanski	Nan
السورة	surah	Nan
السيادة	suverenitet	None
السيارات	automobili	Nan
السيارة	auto	Nan
السياسات	politike	None
السياسة	politika	None
السياسي	politička	None
السياسية	politička	None
السياسيين	političari	None
السياق	kontekst	Nan
السيد	gospodar	None
السيدة	gđa	Nan
السير	šetnja	Nan
السيرة	nastavni plan i program	Nan
السيطرة	kontrola	None
السيف	mač	None
السياحية	turist	Nan
السور	ograda	Nan
السياحي	turist	Nan
السياح	turisti	Nan
السوري	sirijski	Nan
السورية	sirijski	Nan
السوفياتي	sovjetski	None
السوفياتية	sovjetski	None
السوفيتي	sovjetski	None
السوفيتية	sovjetski	None
السوفييت	sovjeti	Nan
السوفييتي	sovjetski	None
السوق	tržište	None
السويد	švedska	None
السويدي	švedski	None
السويدية	švedski	None
السويس	suez	Nan
السويسري	švajcarski	Nan
السيئة	loših	Nan
السياحة	turizam	None
السلطان	sultan	None
السلطات	vlasti	None
السلسلة	serija	None
السبت	subota	Nan
السبع	sedam	None
السبعة	sedam	None
السبعينات	sedamdesete	Nan
السبعينيات	sedamdesete	Nan
السبيل	put	None
الست	njih šest	Nan
الستة	njih šest	Nan
الستينات	šezdesete	Nan
الستينيات	šezdesete	Nan
السجن	zatvor	Nan
السجون	zatvori	Nan
السحابة	oblak	None
السحب	oblaci	None
السد	brana	Nan
السبب	razlog	None
السديري	al-sudairy	Nan
السباحة	plivanje	Nan
السامة	toksično	Nan
السائلة	tečnost	None
السابع	sedma	Nan
السابعة	sedma	Nan
السابق	prethodni	Nan
السابقة	prethodni	Nan
السابقين	ex	Nan
الساحة	arena	Nan
الساحل	obala	None
الساحلي	primorski	Nan
الساحلية	primorski	Nan
الساخنة	vruće	Nan
السادات	sadat	Nan
السادس	vi	None
الساعة	sat	None
الساكنة	statički	Nan
السامية	visokog	None
السر	tajna	None
السرطان	rak	None
السرطانات	rak	None
السكر	šećer	None
السكري	dijabetes	Nan
السكك	rail	Nan
السكن	živim	None
السكنية	stambeni	Nan
السلاجقة	seljuks	Nan
السلاح	oružje	None
السلاسل	lanci	None
السلاطين	sultani	Nan
السلالات	sojevi	Nan
السلالة	soj	Nan
السلام	mir	None
السلبي	pasivan	Nan
السلبية	negativnost	Nan
السلة	korpa	Nan
السكانية	stanovništvo	None
السكاني	stanovništvo	None
السكان	stanovništvo	None
السفينة	brod	None
السرطانية	predrakavi	Nan
السريانية	sirijac	Nan
السرية	poverljivost	Nan
السريع	brzo	None
السريعة	brzo	None
السطح	krov	Nan
السطحية	površina	None
السائدة	preovlađujući	Nan
السعادة	happinese	Nan
السعودية	saudijski	Nan
السعي	težnja	None
السفر	putovanje	None
السفلى	niže	None
السفلي	niže	None
السفن	brodovi	None
السفير	ambasadora	Nan
السعودي	saudijski	Nan
الذكاء	inteligencija	None
الذرية	potomstvo	Nan
الذري	atomska	Nan
الحكم	osuda	Nan
الحكمة	mudrost	Nan
الحكومات	vlade	None
الحكومة	vlada	None
الحكومي	vlada	None
الحكومية	vlada	None
الحكيم	mudri	Nan
الحل	rjesenje	Nan
الحلفاء	saveznici	None
الحلقات	epizode	Nan
الحلقة	prsten	None
الحلم	san	None
الحلول	rešenja	Nan
الحلي	ukrasi	Nan
الحليب	mlijeko	None
الحكام	vladari	None
الحليم	halim	Nan
الحقيقية	pravi	None
الحقيقة	istina	None
الحصول	get	Nan
الحضارات	civilizacije	None
الحضارة	civilizacija	None
الحضاري	civilizirano	Nan
الحضرية	urbano područje	Nan
الحظ	sreća	Nan
الحظر	zabrana	Nan
الحفاظ	zadržati	None
الحفلات	stranke	None
الحق	tačno	None
الحقائق	činjenice	None
الحقبة	uhvati ga	Nan
الحقل	polje	None
الحقوق	prava	None
الحقول	polja	None
الحقيقي	pravi	None
الحصان	konj	None
الحمام	toalet	Nan
الحماية	zaštita	None
الحين	sad	None
الحيوان	životinja	None
الحيوانات	životinje	None
الحيوانية	životinja	None
الحيوي	bio	None
الحيوية	vitalnost	Nan
الخ	itd	None
الخارج	spolja	Nan
الخارجي	vanjska	None
الخارجية	spoljni	Nan
الخاص	privatno	None
الخاصة	vlastita	None
الخاصية	vlasništvo	None
الخاضعة	predmet	None
الخالق	tvorac	None
الحية	uživo	None
الحمامات	kupatila	Nan
الحياد	neutralnost	Nan
الحي	okrug	None
الحمد	pohvale	Nan
الحمر	py	Nan
الحمراء	crveno	Nan
الحمض	kiselina	None
الحمل	trudnoća	None
الحملات	kampanje	Nan
الحملة	kampanju	Nan
الحميد	hameed	Nan
الحنبلي	hambali	Nan
الحنفي	hanafi	Nan
الحوادث	nesreća	Nan
الحوار	dijalog	Nan
الحواس	osjetila	Nan
الحواسيب	računari	None
الحوض	umivaonik	Nan
الحياة	život	None
الحصار	opsada	None
الحشيش	travnjak	Nan
الحشرية	insekt	Nan
الحبيب	voljena	Nan
الحج	hodočašće	Nan
الحجاب	veo	Nan
الحجاج	hodočasnici	Nan
الحجارة	kamenje	None
الحجاز	hidžaz	Nan
الحجة	argument	Nan
الحجر	stone	Nan
الحجرية	stone	Nan
الحجم	veličina	None
الحد	granica	None
الحدائق	vrtovi	Nan
الحداثة	modernost	Nan
الحدث	događaj	None
الحدود	granica	None
الحبوب	zrno	Nan
الحدودية	borderlands	Nan
الحبل	cord	Nan
الحب	ljubav	None
الحادثة	nesreca	Nan
الحار	toplo	Nan
الحارة	toplo	Nan
الحارث	tiller	Nan
الحاسوب	računar	None
الحاصل	kvocijent	Nan
الحاضر	sadašnjosti	Nan
الحافظ	čuvar	Nan
الحافلات	autobusi	Nan
الحاكم	vladar	None
الحاكمة	vladati	Nan
الحال	prilog	None
الحالات	slučajevi	None
الحالي	sadašnjost	Nan
الحالية	aktuelna	Nan
الحبشة	etiopija	Nan
الحديبية	tubercle	Nan
الحديث	razgovor	None
الحديثة	moderna	None
الحروب	ratovi	None
الحروف	pisma	None
الحريات	slobode	None
الحرية	sloboda	None
الحرير	svila	Nan
الحريري	al-hariri	Nan
الحزام	pojas	None
الحزب	zabava	Nan
الحساب	račun	None
الحسن	hassan	Nan
الحسنة	dobro	None
الحسين	elhussein	Nan
الحسيني	al-hussaini	Nan
الحشرات	insekti	Nan
الحشرة	insekt	Nan
الحرمين	dva sveta mesta	Nan
الحرم	svetište	Nan
الحركة	pokreta	None
الحركات	kretanja	None
الحديد	gvožđe	Nan
الحديدي	čelični čovjek	Nan
الحديدية	gvožđe	Nan
الحديقة	vrt	None
الحذر	oprez	Nan
الحر	besplatno	Nan
الحرائق	požari	Nan
الخام	sirova	Nan
الحرارة	vručina	Nan
الحرارية	termalno	Nan
الحرب	rata	None
الحربي	al-harbi	Nan
الحربية	ratni brod	Nan
الحرة	besplatno	Nan
الحرس	stražar	Nan
الحرف	lik	None
الحراري	termalno	Nan
الخامس	peto	Nan
الخامسة	peto	Nan
الخان	kan	Nan
الدفاع	odbrana	None
الدفاعية	odbrambeni	None
الدقة	preciznost	Nan
الدقيق	brašno	Nan
الدقيقة	minut	Nan
الدكتوراه	dr	None
الدلائل	katalozi	Nan
الدلالة	indikacija	Nan
الدليل	vodič	None
الدم	krv	None
الدماء	krv	None
الدمار	uništenje	Nan
الدماغ	mozak	None
الدمشقي	damascen	Nan
الدموية	krvava	Nan
الدعوة	poziv	None
الدنا	dnk	Nan
الدعم	podrška	None
الدعارة	prostitucija	Nan
الدجال	drhtanje	Nan
الدخان	dim	Nan
الدخل	prihodi	None
الدخول	pristup	None
الدراسات	studije	None
الدراسة	studiranje	Nan
الدراسية	školovanje	None
الدراما	drama	None
الدرجات	ocjene	None
الدرجة	klasa	None
الدروز	druze	Nan
الدستور	ustav	None
الدستوري	ustavni	None
الدستورية	ustavni	None
الدعاء	moliti za	Nan
الدعاية	hype	Nan
الدنمارك	danska	None
الدنيا	svijet	None
الدهون	masti	None
الدين	religija	None
الدينار	dinar	None
الديناصور	dinosaur	Nan
الديناصورات	dinosauri	Nan
الدينية	vjerski	None
الديوان	diwan	Nan
الديون	dugovi	Nan
الذئب	vuk	None
الذات	ja	None
الذاتي	ja	None
الذاتية	subjektivnost	Nan
الذاكرة	memorija	None
الذرات	atomi	Nan
الذراع	ruka	None
الذرة	kukuruz	None
الديموقراطية	demokratija	None
الديموغرافيا	demografija	None
الديمقراطية	demokratija	None
الديمقراطيات	demokratije	None
الدوائر	krugovi	None
الدوافع	motivacija	Nan
الدوحة	doha	Nan
الدور	uloga	None
الدوران	rotacija	Nan
الدورة	kurs	Nan
الدوري	liga	None
الدجاج	piletina	Nan
الدورية	periodičnost	Nan
الدولة	država	None
الدولتين	dve države	Nan
الدولية	međunarodni	None
الديار	dom	None
الديانات	religije	None
الديانة	religija	None
الديمقراطي	demokrata	Nan
الدول	zemlje	None
الحادة	akutna	Nan
الدبلوماسية	diplomacija	Nan
الدار	kuća	None
الخط	linija	None
الخطأ	greška	None
الخطة	plan	None
الخطر	opasnost	None
الخطط	planovi	None
الخطوات	koraci	None
الخطوة	korak	None
الخطوط	linije	None
الخطيب	khatib	Nan
الخطيرة	ozbiljno	Nan
الخفيفة	svetlost	Nan
الخلاص	spasenje	Nan
الخلافات	razlike	None
الخلافة	uspjeh	None
الخلايا	ćelije	None
الخضراء	zeleno	None
الخلف	povratak	None
الخصيب	plodna	Nan
الخصوبة	plodnost	Nan
الخانات	cifre	Nan
الخبر	vijesti	None
الخبراء	stručnjaci	None
الخدمات	usluge	None
الخدمة	servis	None
الخديوي	khedive	Nan
الخرائط	karte	None
الخروج	izlaz	None
الخريطة	karta	None
الخسائر	gubici	Nan
الخشب	drvo	None
الخشبية	drveni	Nan
الخصائص	svojstva	None
الخصبة	bujna	Nan
الخصم	popust	Nan
الخصوص	posebno	None
الخلفاء	kalifi	Nan
الخلفية	pozadina	Nan
الخلق	kreacija	Nan
الخوف	strah	None
الخيال	mašta	Nan
الخيالة	montiran	Nan
الخيام	šatori	Nan
الخير	dobro	None
الخيرية	dobrotvorna organizacija	Nan
الخيل	konj	None
الخيول	konji	None
الدائرة	krug	None
الدائري	prsten	None
الدائم	stalni	None
الدائمة	stojeći	Nan
الداخل	unutra	Nan
الداخلي	postupak	None
الداخلية	unutrasnjost	Nan
الخواص	svojstva	None
الخوارزمي	alkhawarizmi	Nan
الخوارج	kharijites	Nan
الخندق	u rov	Nan
الخلوي	cellular	Nan
الخلوية	cellular	Nan
الخلية	ćelija	None
الخليج	zaljev	Nan
الخليجي	al kaliji	Nan
الخليجية	zaljev	Nan
الخليفة	kalif	Nan
الدانوب	dunav	None
الخليل	hebron	Nan
الخمس	pet	None
الخمسة	pet	None
الخمسينات	pedesete	Nan
الخمسينيات	pedesete	Nan
الخميس	četvrtak	None
الخنازير	svinje	None
الخنافس	bube	Nan
الخمر	vino	None
الاثني	etnicitet	Nan
الاتهام	optužba	Nan
الاتفاقية	ugovor	None
أنهما	oni su	Nan
أنهى	završiti	Nan
أنواع	vrste	None
أنواعها	njegove vrste	Nan
أنوبيس	anubis	Nan
أنور	anwar	Nan
أني	to sam ja	Nan
أنّ	da	None
أنّه	to je	Nan
أهالي	ljudi	None
أهداف	ciljevi	None
أهدافها	njeni ciljevi	Nan
أهل	ljudi	None
أهله	njegova porodica	Nan
أهلها	njena porodica	Nan
أنهم	da oni	Nan
أهلية	ispunjavanje uslova	Nan
أنهار	srušila se	Nan
أنه	to je	Nan
أنس	anas	Nan
أنسجة	tkivo	None
أنشأت	uspostavljeno	Nan
أنشئ	stvoriti	None
أنشئت	uspostavljeno	Nan
أنشطة	aktivnosti	None
أنصار	pristalice	Nan
أنطاكية	antiohija	Nan
أنظر	pogledaj	Nan
أنظمة	sistemi	None
أنفسهم	sebe	None
أنقرة	ankara	Nan
أنك	to si ti	Nan
أنماط	obrasci	Nan
أننا	to smo mi	Nan
أنها	to	None
أندية	klubovi	None
أهم	najvažniji	None
أهمية	važnost	None
أوسع	šire	None
أوسلو	oslo	Nan
أوصى	predlažem	Nan
أوضاع	načini rada	Nan
أوضح	objašnjeno	Nan
أوضحت	objasnila je	Nan
أوقات	vremena	None
أوقطاي	moje vreme	Nan
أوكرانيا	ukrajina	None
أول	prvo	None
أولئك	oni	None
أولا	prvo	None
أولاد	deca	Nan
أولاده	njegova djeca	Nan
أولاً	prvo	None
أوساط	mediji	None
أهمها	najvažniji	None
أوروبية	evropski	None
أوروبا	evropi	None
أهميتها	njegova važnost	Nan
أو	ili	None
أوائل	rano	None
أواخر	kasno	None
أواسط	srednja	None
أوامر	naređenja	Nan
أوامره	njegove naredbe	Nan
أوباما	obama	Nan
أوبرا	oprah	Nan
أوج	apogee	Nan
أوجه	ation	Nan
أوراق	lišće	Nan
أورانوس	uran	Nan
أورخان	orhan	Nan
أورشليم	jeruzalem	Nan
أوروبي	evropski	None
أنحاء	preko	None
أنجلوسكسونيون	angelesxionion	Nan
أنجبت	rođen sam	Nan
ألعاب	igračke	None
ألف	hiljadu	None
ألفا	alfa	Nan
ألفًا	alfa	Nan
ألقاب	nadimci	Nan
ألقى	odbačen	Nan
ألكسندر	aleksandra	None
ألكيل	alkil	Nan
ألمانيا	nemačke	Nan
ألمانية	njemački	None
ألوان	boje	None
أم	majko	None
أما	kao za	Nan
أماكن	mjesta	None
أمام	prije	None
ألدهيد	aldehid	Nan
أمامه	ispred njega	Nan
ألبوم	album	None
ألبانيا	albanija	None
أقوى	moćniji	Nan
أقيم	ostajem	Nan
أقيمت	podignuta	Nan
أكاديمية	akademiju	None
أكان	akan	Nan
أكتوبر	oktobar	Nan
أكثر	još	None
أكثرها	većina	None
أكد	potvrđeno	None
أكدت	potvrđeno	None
أكسيد	oksid	None
أكل	jeo	Nan
أكمل	kompletna	None
ألا	osim	None
ألاسكا	aljaska	Nan
ألبرت	albert	None
أمانة	iskrenost	Nan
أمة	njegova mama	Nan
أمثال	likes	Nan
أمور	stvari	None
أمية	nepismenost	Nan
أمير	princ	None
أمين	pouzdan	Nan
أمّا	kao za	Nan
أن	da	None
أنا	ja sam	Nan
أنابيب	cevi	Nan
أناكوندا	anakonda	Nan
أنباء	vijesti	None
أنبياء	poslanice	None
أنت	ti si	Nan
أنتج	proizvedeno	Nan
أنتجت	proizvedeno	Nan
أنثى	žensko	Nan
أموال	sredstva	None
أمه	njegova mama	Nan
أمن	sigurnost	None
أمم	nacije	None
أمثلة	primjeri	None
أمر	komanda	Nan
أمرا	naredba	None
أمراء	prinčevi	Nan
أمراض	bolesti	None
أمره	njegova zapovest	Nan
أمرهم	komandirao im je	Nan
أولها	prva od njih	Nan
أمريكا	sad	None
أمريكية	američko	Nan
أمريكيون	amerikanci	None
أمرًا	naredba	None
أمطار	kiša	None
أمفورة	amfora	Nan
أمكن	moguće	None
أمل	nadam se	Nan
أمريكي	američko	Nan
أقواله	njegove izreke	Nan
أولى	prvo	None
أوّل	prvo	None
إلهام	bitan	None
إلى	meni	None
إلي	meni	None
إليك	za tebe	Nan
إلينا	nama	None
إليه	mehanizam	None
إليها	njoj	None
إليهم	njima	None
إم	majko	None
إما	kao za	Nan
إمارة	emirate	Nan
إمام	prije	None
إمبراطور	cara	None
إمبراطورية	imperija	None
إمكانية	mogućnost	None
إله	mašina	None
إنا	ja sam	Nan
إلقاء	baciti	Nan
إلاّ	osim	None
إطلاق	pustiti	Nan
إعادة	povratak	None
إعداد	priprema	None
إعطاء	daj	Nan
إعلامية	informativan	Nan
إعلان	oglašavanje	Nan
إف	f	Nan
إفراز	sekrecija	Nan
إفريقيا	afrika	None
إفريقية	afrički	Nan
إقامة	smeštaj	Nan
إقليم	provincija	None
إقليمية	regionalni	None
إل	the	None
إلا	osim	None
إلغاء	otkazivanje	Nan
إطار	okvir	None
إنتاج	proizvesti	Nan
إنتاجها	njihova proizvodnja	Nan
إياها	to	None
إيجاد	nalaz	Nan
إيران	iran	None
إيرث	zemlja	None
إيطاليا	italia	Nan
إيفان	ivan	None
إيفل	eiffel	Nan
إيقاف	isključivanje	Nan
إيه	stih	Nan
إِلا	osim	None
إِلَى	meni	None
ا	a	None
ابتداء	početak	None
ابتناء	anabolizam	Nan
ابن	sine	Nan
إياه	njega	None
إنتاجه	produci	Nan
إنّ	da	None
إنهم	da oni	Nan
إنترنت	internet	None
إنجازات	postignuća	Nan
إنجلترا	engleska	None
إنجليزية	engleski	None
إنجيل	evanđelje	Nan
إندونيسيا	indonezija	None
إنسان	čoveče	Nan
إنسانية	humane	Nan
إنشاء	napraviti	None
إنشائها	kreirajte ih	Nan
إنفلونزا	gripa	Nan
إنكار	poricanje	Nan
إنما	umjesto toga	Nan
إنها	to	None
إنهاء	kraj	None
إني	ja sam	Nan
إضافية	dodatno	None
إضافةً	dodatak	None
إضافة	dodatak	None
أَنْ	da	None
إبادة	istrebljenje	Nan
إبان	tokom	None
إبراهيم	ibrahim	None
إثارة	uzbuđenje	Nan
إثبات	dokaz	None
إثر	efekat	None
إثيوبيا	etiopija	Nan
إجراء	postupak	None
إجراءات	postupci	None
إجماع	konsenzus	Nan
إجمالي	ukupno	None
إحباط	frustracija	Nan
إحداث	događaji	None
إحدى	jedan	None
أَنَّ	da	None
إحصاء	brojanje	Nan
أيوب	ayoub	Nan
أينشتاين	ajnštajn	Nan
أى	koji	None
أي	koji	None
أيام	dana	None
أيامه	njegovi dani	Nan
أيبك	aybak	Nan
أية	stih	Nan
أيدي	ruke	Nan
أيديهم	njihove ruke	Nan
أيرلندا	irska	None
أيضا	takođe	None
أيضاً	takođe	None
أيضًا	takođe	None
أيلول	septembra	None
أيمن	aimen	Nan
أين	gde	None
أيها	hej	Nan
إحصاءات	statistika	None
إحصائيات	statistika	None
إحياء	biologija	None
إسرائيل	izraela	None
إسطنبول	istanbul	None
إسقاط	projekcija	Nan
إسلام	islam	None
إسلامه	njegov islam	Nan
إسلامي	islami	Nan
إسلامية	islamska	None
إسماعيل	ismail	Nan
إشارات	signali	Nan
إشارة	signal	None
إشعاع	zračenje	None
إصابة	infekcija	Nan
إصدار	izdavanje	Nan
إصلاح	popravak	Nan
إصلاحات	popravke	Nan
إسحاق	isaac	Nan
إستراتيجية	strategiju	Nan
إسبانيا	španija	None
إس	s.	Nan
إخراج	režija:	Nan
إخوته	njegova braća	Nan
إدارة	menadžment	None
إداري	administrativna	None
إدارية	administrativna	None
إدخال	unesite	Nan
إدراك	realizacija	Nan
أولية	preliminarni	Nan
إذ	stoga	None
إذاعة	emitovanje	Nan
إذن	uho	Nan
إرادة	volja	None
إرتريا	eritreja	Nan
إرسال	poslati	Nan
إرهابية	teroristički	Nan
إزالة	odstranjivanje	Nan
إذا	ako	None
أقوال	izreke	Nan
أقمار	mjeseci	None
أقلية	manjina	None
أحسن	najbolje	None
أحكام	odredbe	Nan
أحلام	snovi	Nan
أحمد	ahmad	Nan
أحمدي	ahmadi	Nan
أحمر	crveno	Nan
أحوال	uslovi	None
أحياء	biologija	None
أحيان	ponekad	None
أحيانا	ponekad	None
أحياناً	ponekad	None
أحيانًا	ponekad	None
أخاه	njegov brat	Nan
أخبار	vijesti	None
أخت	sestra	None
أحزاب	stranke	None
أخته	njegova sestra	Nan
أحدهما	jedan od njih	Nan
أحدث	najnovije	Nan
أجريت	izvedeno	Nan
أجزاء	dijelovi	None
أجسام	tijela	None
أجل	da	None
أجمع	ja sakupljam	Nan
أجمل	najljepše	None
أجنبية	strani	None
أجنحة	krila	None
أجهزة	uređaji	None
أحادي	jednokrevetna	Nan
أحاديث	hadisi	Nan
أحب	volim	None
أحجية	slagalica	Nan
أحد	jedan	None
أحداث	događaji	None
أحدهم	neko	None
أجرى	idi trči	Nan
أخذ	uzimam	Nan
أخر	drugo	None
أدوار	pansioni	Nan
أدولف	adolf	None
أدوية	lijekovi	None
أدى	led	None
أدّت	led	None
أدّى	izvedeno	Nan
أذربيجان	azerbejdžan	None
أراد	željeti	Nan
أرادت	željela je	Nan
أراض	zemljišta	None
أراضي	zemljišta	None
أراضيها	njegova teritorija	Nan
أرباع	četvrtine	Nan
أربع	četiri	None
أربعة	četiri	None
أدنى	minimum	None
أخذت	uzeo sam	Nan
أدناه	ispod	None
أدرك	realizirao	Nan
أخرج	izaći	Nan
أخرى	ostalo	None
أخطاء	greške	None
أخطر	najopasnije	Nan
أخلاقية	etično	Nan
أخوه	braćo	Nan
أخيرا	napokon	None
أخيه	njegov brat	Nan
أخيون	brate	Nan
أداء	performans	Nan
أداة	alat	None
أدب	književnosti	None
أدبية	književni	None
أدت	led	None
أدخل	unesite	Nan
أدلة	tragovi	None
أجراها	izradio	Nan
أجرام	zločin	None
أجبر	prisilno	Nan
آلات	mašine	None
آلاف	hiljade	None
آلام	majka	None
آلة	mašina	None
آلهة	bogovi	None
آلية	mehanizam	None
آمن	sigurnost	None
آمنة	siguran	Nan
آمون	amon	Nan
آن	da	None
آنذاك	u to vrijeme	Nan
آي	koji	None
آيات	stihovi	None
آية	stih	Nan
أ	a	None
آل	the	None
أئمة	imams	Nan
آشوربانيبال	ashurbanipal	Nan
آسكي	ascii	Nan
+	+	None
=	=	Nan
==	==	Nan
|	|	Nan
°	°	Nan
°م	° c	Nan
آثار	efekti	None
آثارها	njeni efekti	Nan
آخر	drugo	None
آخرها	najnovije	Nan
آخرون	drugi	None
آخرين	ostali	None
آخيل	ahil	Nan
آدم	adame	Nan
آراء	mišljenja	None
آسيا	aziji	None
أب	oče	Nan
أبا	oppa	Nan
أباتيت	apatite	Nan
أتاتورك	ataturk	Nan
أتباع	sledeći	Nan
أتباعه	njegovi sledbenici	Nan
أتت	došao	None
أتى	došli	None
أثار	efekti	None
أثارت	uzbuđen	Nan
أثبت	dokazano	Nan
أثبتت	demonstrirano	Nan
أثر	efekat	None
أثرت	pogođeni	Nan
أثره	njegovo dejstvo	Nan
أثرية	antikni	Nan
أثناء	tokom	None
أثينا	atina	None
أبيه	njegov otac	Nan
أبيب	tel	Nan
أبي	moj otac	Nan
أبى	moj otac	Nan
أباه	njegov otac	Nan
أبحاث	istraživanje	None
أبدا	početak	None
أبداً	početak	None
أبدًا	početak	None
أبرز	najistaknutiji	Nan
أبرزها	najistaknutiji	Nan
أربعين	četrdeset	None
أبريل	aprila	None
أبعد	daleko	None
أبناء	deca	Nan
أبنائه	njegovi sinovi	Nan
أبو	abu	None
أبواب	vrata	None
أبوظبي	abu dhabi	Nan
أبوه	njegov otac	Nan
أبطال	šampioni	Nan
أرجاء	odgođeno	Nan
أرخبيل	arhipelag	None
أرخميدس	arhimed	Nan
أعداء	neprijatelji	Nan
أعدائه	njegovi neprijatelji	Nan
أعداد	priprema	None
أعراض	sindrom	None
أعضاء	članovi	None
أعطى	dao	None
أعظم	najveći	None
أعقاب	poslije	None
أعلام	zastave	None
أعلاه	iznad	None
أعلم	znam	None
أعلن	oglasite	Nan
أعلنت	najavila je	Nan
أعلى	vrh	None
أعمال	posao	None
أعاد	ponovite	Nan
أعماله	njegova dela	Nan
أظهرت	pokazao sam	Nan
أطول	najduži	Nan
أصله	njeno poreklo	Nan
أصلها	njeno poreklo	Nan
أصوات	glasovi	None
أصول	poreklo	Nan
أصيب	povređena je	Nan
أضاف	dodao je	Nan
أضخم	najveća	None
أضرار	štete	None
أضعاف	dvostruko	Nan
أضلاع	rebra	Nan
أطراف	stranke	None
أطفال	deca	Nan
أطلق	pustiti	Nan
أطلقت	lansiran	Nan
أطوال	dužine	None
أظهر	pojaviti se	Nan
أعمالها	njeno poslovanje	Nan
أعمدة	stupci	Nan
أعوام	godinama	None
أفلام	filmovi	None
أفلامه	njegovi filmovi	Nan
أفندي	effendi	Nan
أقاليم	teritoriji	None
أقام	ostani	Nan
أقبل	prihvati	None
أقدم	najstariji	None
أقر	prošao	None
أقرب	bliže	None
أقسام	odjeljci	Nan
أقصر	kraće	None
أقصى	maksimalno	None
أقطار	promjer	Nan
أقل	manje	None
أقليات	manjine	None
أفلاطون	platon	None
أفكاره	njegove misli	Nan
أفكار	misli	None
أفغانستان	afganistan	None
أعيد	je vraćen	Nan
أغاني	pesme	Nan
أغراض	svrhe	None
أغسطس	avgusta	Nan
أغلب	većina	None
أغلبها	većinom	None
أغلبية	većina	None
أصلاً	prvobitno	None
أغنى	najbogatiji	Nan
أفراد	pojedinci	None
أفرادها	njeni članovi	Nan
أفرودة	afroda	Nan
أفريقيا	afrika	None
أفريقية	afrički	Nan
أفضل	najbolje	None
أفعال	glagoli	Nan
أغنية	pjesma	None
ابنة	kćerka	None
أصلا	prvobitno	None
أصفر	žuto	None
أساسًا	u osnovi	Nan
أساليب	tehnike	None
أسامة	ossama	Nan
أسباب	razlozi	None
أسبانيا	španija	None
أسبوع	sedmica	None
أستاذ	profesor	None
أستراليا	australija	None
أسد	lav	None
أسر	hvatanje	Nan
أسرار	tajne	None
أسرة	porodica	None
أسرته	njegova porodica	Nan
أسرع	brže	None
أسس	uspostaviti	None
أساسية	osnovni	None
أسست	osnovan	None
أساسيا	bitno	None
أساساً	u osnovi	Nan
أرسطو	aristotel	None
أرسل	pošalji	Nan
أرسلان	arslan	Nan
أرسلت	poslao sam	Nan
أرسله	poslati	Nan
أرض	zemljište	None
أرضية	kat	Nan
أرقام	brojevima	None
أركان	stubovi	Nan
أرمينيا	jermenija	Nan
أزمة	kriza	None
أس	as	None
أسابيع	sedmice	None
أساس	osnove	None
أساسا	u osnovi	Nan
أساسي	osnovni	None
أسسها	osnovao sam ga	Nan
أسطورة	legenda	None
أسطول	flota	Nan
أشد	čvršće	Nan
أشرف	ashraf	Nan
أشعة	zrake	None
أشكال	oblici	None
أشهر	mjeseci	None
أشهرها	najpoznatiji	None
أشياء	stvari	None
أصابع	prsti	Nan
أصبح	postao	None
أصبحوا	oni su postali	Nan
أصحاب	prijatelji	None
أصحابه	drugovi	Nan
أصدر	izdato	Nan
أصدرت	izdato	Nan
أصغر	manje	None
أشخاص	ljudi	None
أشجار	drveće	Nan
أشبه	više kao	Nan
أشارت	ona je naznačila	Nan
أسعار	cijene	None
أسعد	srećnije	Nan
أسفر	prinos	Nan
أسفرت	prinos	Nan
أسفل	dole	Nan
أسلحة	oružja	None
أسلم	sigurniji	Nan
أصل	porijeklo	None
أسلوب	stilu	None
أسمهان	asmahan	Nan
أسهم	zalihe	None
أسوأ	najgore	Nan
أسوار	ograde	Nan
أسواق	tržišta	None
أسود	crna	None
أشار	istaknuo	Nan
أسماء	imena	None
ابنته	njegova kćerka	Nan
ابنه	kćerka	None
ابي	moj otac	Nan
الأمد	trajanje	None
الأمر	stvar je u tome	Nan
الأمراء	prinčevi	Nan
الأمراض	bolesti	None
الأمريكتين	amerike	None
الأمريكي	američko	Nan
الأمريكية	američko	Nan
الأمريكيون	amerikanci	None
الأمريكيين	amerikanci	None
الأمصار	cikloni	Nan
الأمطار	kiša	None
الأمعاء	crijeva	None
الأمل	nada	None
الأملاح	soli	None
الأمم	nacije	None
الأمثلة	primjeri	None
الأمن	sigurnost	None
الأمثال	poslovice	Nan
الأمانة	iskrenost	Nan
الألبانية	albanski	None
الألف	alif	Nan
الألفية	milenijum	Nan
الألم	bol	None
الألمان	nemci	Nan
الألماني	njemački	None
الألمانية	njemački	None
الألواح	ploče	None
الألوان	boje	None
الأم	majka	None
الأمازيغ	berberi	Nan
الأمازيغية	berber	Nan
الأماكن	mjesta	None
الأمام	napred	Nan
الأمان	sigurnost	None
الأمة	nacija	None
الألبان	mljekara	Nan
الأمنية	želja	None
الأموال	novac	None
الأندية	klubovi	None
الأنسجة	tkivo	None
الأنسولين	inzulin	Nan
الأنشطة	aktivnosti	None
الأنصار	ansar	Nan
الأنصاري	al ansari	Nan
الأنطروبولوجيا	antropologija	None
الأنظمة	sistemi	None
الأنف	nosa	Nan
الأنفاق	tuneli	Nan
الأنماط	stilovi	Nan
الأنهار	rijeke	None
الأنواع	vrste	None
الأهالي	roditelji	None
الأهداف	ciljevi	None
الأندلس	andalus	Nan
الأمواج	talasi	Nan
الأنثى	ženka	None
الأنبياء	proroci	Nan
الأمور	dešavaju se stvari	Nan
الأموي	umayyad	Nan
الأموية	umayyad	Nan
الأمويون	umayyadi	Nan
الأمويين	umayyadi	Nan
الأمية	nepismenost	Nan
الأمير	princ	None
الأميرة	princeza	None
الأميركي	američko	Nan
الأميركية	američko	Nan
الأمين	sekretara	Nan
الأنا	ego	Nan
الأناجيل	biblije	None
الأناضول	anatolija	Nan
الأنباء	vijesti	None
الأنثروبولوجيا	antropolog	Nan
الألب	alpe	Nan
الأكسجين	kiseonik	None
الأكراد	kurdi	Nan
الأصول	poreklo	Nan
الأضحى	al-adha	Nan
الأضرار	štete	None
الأضلاع	rebra	Nan
الأطباء	doktori	Nan
الأطباق	posuđe	Nan
الأطراف	stranaka	None
الأطرش	atrash	Nan
الأطعمة	hrana	None
الأطفال	deca	Nan
الأطلس	atlas	Nan
الأطلسي	atlantik	Nan
الأعداء	neprijatelji	Nan
الأعداد	priprema	None
الأعراض	simptomi	None
الأصوات	zvuči	Nan
الأعراق	etničke pripadnosti	Nan
الأصناف	sorte	None
الأصليون	native	Nan
الأشجار	drveće	Nan
الأشخاص	osobe	None
الأشراف	nadzor	None
الأشرف	ashraf	Nan
الأشعة	zraci	Nan
الأشعري	al-ash&#39;ari	Nan
الأشكال	oblici	None
الأشهر	mjeseci	None
الأشياء	stvari	None
الأصدقاء	prijatelji	None
الأصغر	najmanji	None
الأصفر	žuto	None
الأصل	poreklo	Nan
الأصلي	original	Nan
الأصلية	original	Nan
الأصليين	autohtoni	Nan
الأعشاب	bilje	None
الأعصاب	nervi	Nan
الأعضاء	članovi	None
الأفلام	filmove	Nan
الأفيون	opijum	Nan
الأقاليم	teritoriji	None
الأقدس	najsvetiji	Nan
الأقدم	najstariji	None
الأقرب	najbliži	Nan
الأقسام	sekcije	Nan
الأقصى	daleko	None
الأقطار	dijagonale	Nan
الأقل	zadnje	None
الأقليات	manjine	None
الأقمار	mjeseci	None
الأقوال	izreke	Nan
الأكاديمية	akademija	None
الأكبر	najveći	None
الأفكار	ideje	None
الأفغاني	afganistanski	Nan
الأفعال	akcije	None
الأفضل	najbolje	None
الأعظم	najveći	None
الأعلام	mediji	None
الأعلى	gore navedenog	Nan
الأعمال	posao	None
الأعمدة	stupci	Nan
الأعوام	godinama	None
الأغالبة	aghlabids	Nan
الأهرام	piramide	None
الأغاني	pesme	Nan
الأغراض	stvari	None
الأغلب	uglavnom	None
الأغلبية	većina	None
الأغنية	pjesma	None
الأفراد	pojedinci	None
الأفريقي	afrički	Nan
الأفريقية	afrički	Nan
الأغذية	hrana	None
الأهرامات	piramide	None
الأهلي	al-ahly	Nan
الأهلية	ispunjavanje uslova	Nan
الإقليمي	regionalni	None
الإقليمية	regionalni	None
الإلحاد	ateizam	Nan
الإلكترون	electron	Nan
الإلكترونات	elektroni	Nan
الإلكترونية	e	None
الإله	bože	None
الإلهي	božanstveno	Nan
الإلهية	božanstveno	Nan
الإمارات	uae	Nan
الإمارة	emirat	Nan
الإمامة	imamate	Nan
الإمامية	imami	Nan
الإمبراطور	cara	None
الإمبراطورية	carstvo	None
الإقليم	teritorij	None
الإمدادات	potrošni materijal	Nan
الإقامة	rezidencija	Nan
الإفريقي	afrički	Nan
الإصابة	ozljeda	Nan
الإصدار	pustiti	Nan
الإصلاح	popravi	Nan
الإصلاحات	popravci	Nan
الإصلاحية	ispravni	Nan
الإطار	okvir	None
الإطلاق	lansiranje	Nan
الإعدام	izvršenja	Nan
الإعلام	mediji	None
الإعلامي	informativan	Nan
الإعلان	oglašavanje	Nan
الإعلانات	oglasi	Nan
الإغريق	grci	None
الإغريقي	grčki	None
الإغريقية	grčki	None
الإفريقية	afrički	Nan
الإناث	ženski	None
الإنتاج	proizvodnja	None
الإنتاجية	produktivnost	Nan
الإيطاليين	italijani	None
الإيمان	vjera	None
الا	osim	None
الائتلاف	koalicija	None
الابتدائي	primarno	None
الابتدائية	primarno	None
الابن	sine	Nan
الاتجاه	smjer	None
الاتجاهات	directione	Nan
الاتحاد	uniju	Nan
الاتحادية	federalni	None
الاتصال	veza	None
الاتصالات	telekomunikacije	None
الاتفاق	sporazum	None
الاتفاقيات	ugovori	Nan
الإيطالية	italijanski	None
الإيطالي	italijanski	None
الإيرانية	iranski	Nan
الإيراني	iranski	Nan
الإنترنت	internet	None
الإنجليز	engleski	None
الإنجليزي	engleski	None
الإنجليزية	engleski	None
الإنجيل	evanđelje	Nan
الإنسان	čovjek	None
الإنساني	ljudski	None
الإشعاعي	radiološki	Nan
الإنسانية	čovečanstvo	Nan
الإنفاق	trošenje	Nan
الإنفلونزا	gripa	Nan
الإنكشارية	janičari	Nan
الإنكليزي	engleski	None
الإنكليزية	engleski	None
الإيجابية	pozitivno	Nan
الإيدز	aids	Nan
الإنشاء	kreacija	Nan
الأسود	crna	None
الإشعاع	zračenje	None
الإسماعيلية	ismailia	Nan
الأوقات	puta	None
الأوكراني	ukrajinski	Nan
الأوكرانية	ukrajinski	Nan
الأول	prvi	None
الأولمبية	olimpijski	None
الأولى	prvi	None
الأولي	početni	Nan
الأولية	primarno	None
الأيام	dana	None
الأيبيرية	iberijski	Nan
الأيسر	levo	Nan
الأيمن	tačno	None
الأيوبي	al ayoubi	Nan
الأيوبية	ayyubid	Nan
الإباحية	pornografija	Nan
الأوعية	posude	Nan
الإبادة	istrebljenje	Nan
الأوضاع	uslovi	None
الأوسط	srednja	None
الأهم	važnije	None
الأهمية	važnost	None
الأوائل	vrh	None
الأوامر	naredbe	None
الأوبرا	opera	None
الأودية	doline	None
الأوراق	lišće	Nan
الأورام	tumori	None
الأوربية	evropski	None
الأوروبي	evropski	None
الأوروبية	evropski	None
الأوروبيون	evropljani	None
الأوروبيين	evropljani	None
الأوزون	ozon	Nan
الأوساط	krugovi	None
الأوسمة	ukrasi	Nan
الإباضية	ibadi	Nan
الإبداع	kreativnost	Nan
الإبراهيمية	abrahamic	Nan
الإرادة	will	Nan
الإرشاد	savjetovanje	Nan
الإرهاب	terorizam	Nan
الإسبان	špancima	Nan
الإسباني	špancima	Nan
الإسبانية	španski	None
الإسراء	isra	Nan
الإسرائيلي	izraelski	Nan
الإسرائيلية	izraelski	Nan
الإسرائيليين	izraelci	Nan
الإسكندر	aleksandra	None
الإسكندرية	aleksandrija	Nan
الإسلام	islam	None
الإسلامي	islamska	None
الإسلامية	islamska	None
الإذاعة	radio	None
الإدعشري	el adhari	Nan
الإدارية	administrativna	None
الإداري	administrativna	None
الإبل	the camels	Nan
الإتحاد	uniju	Nan
الإثارة	uzbuđenje	Nan
الإثنين	ponedeljak	Nan
الإجابة	odgovor	None
الإجراءات	mere	Nan
الإجماع	konsenzus	Nan
الإشارات	znakovi	None
الإجمالي	ukupno	None
الإحساس	senzacija	Nan
الإحصاء	statistika	None
الإحصاءات	statistika	None
الإحصائيات	statistika	None
الإحصائية	statistički	None
الإخوان	bratstvo	None
الإدارة	administracija	Nan
الإجمالية	ukupno	None
السينما	kino	Nan
الأسواق	tržišta	None
الأسمدة	gnojiva	Nan
استقرار	stabilnost	None
استقرت	odložen	Nan
استقلال	nezavisnost	None
استقلالها	njegova nezavisnost	Nan
استكشاف	istraživanje	None
استمر	nastavi	Nan
استمرار	nastavak	None
استمرت	nastavak	None
استنادا	na osnovu	Nan
استنادًا	na osnovu	Nan
استهلاك	potrošnja	Nan
استولى	zaplijenjeno	Nan
استيراد	uvoz	Nan
اسم	imenica	Nan
اسمه	njegovo ime	Nan
استقر	smjestiti se	Nan
اسمها	njeno ime	Nan
استقبال	recepion	Nan
استفتاء	referendum	None
استخراج	ekstrakt	Nan
استراتيجية	strategiju	Nan
استرجاع	oporavak	Nan
استسلام	predati	Nan
استسلمت	odustao sam	Nan
استضافة	hosting	Nan
استطاع	mogao	None
استطاعت	uspjela je	Nan
استطلاع	izviđanje	Nan
استعادة	oporavak	Nan
استعداد	spreman	Nan
استعمال	upotreba	None
استعمالها	iskoristite ga	Nan
استعمل	upotreba	None
استغلال	exploit	Nan
استقالته	njegova ostavka	Nan
استخدمها	iskoristite ga	Nan
اشتد	intenzivirajte	Nan
اشتهر	najpoznatiji	None
اعتمادا	zavisno	None
اعتمد	pouzdati se	Nan
اعتمدت	usvojena	None
اعتناق	zagrli	Nan
اعتنق	zagrljeni	Nan
اغتيال	atentat	Nan
اغتياله	njegovo atentat	Nan
افتتاح	otvaranje	None
افتتح	otvoreno	None
افتتحت	otvorio sam	Nan
اقتراب	pristup	None
اقتراح	prijedlog	None
اقترح	sugerisati	Nan
اقتصاد	economie	Nan
اقتصادها	njegova ekonomija	Nan
اعتماد	odobrenje	Nan
اشتراكية	socijalizam	None
اعتقد	razmisli	Nan
اعتقاد	verovanje	Nan
اشتهرت	postala je poznata	Nan
اصدار	izdavanje	Nan
اضطر	prisilno	Nan
اضطراب	uznemiravanje	Nan
اضطرابات	poremećaji	None
اضطهاد	progon	Nan
اعادة	povratak	None
اعتبار	razmatranje	Nan
اعتبارا	efekat	None
اعتباراً	razmislite	Nan
اعتبارها	um	Nan
اعتبر	razmatrano	Nan
اعتبرت	razmatrano	Nan
اعتراف	prepoznavanje	Nan
اعترف	priznajem	Nan
اعتقال	hapšenje	Nan
استخدمت	koristili su	Nan
استخدم	upotreba	None
استخدامها	iskoristite ga	Nan
اتهام	optužba	Nan
اتهم	optuživati	Nan
اثنان	dva	None
اثنتين	dva	None
اثنين	dva	None
اجتماع	sastanak	Nan
اجتماعات	sastanci	Nan
اجتماعي	socijalni	None
اجتماعية	društveni	None
اجتمع	met	Nan
اجتياح	invazija	Nan
اجل	da	None
احتراق	gorenje	Nan
احترام	poštovanje	None
احتفظ	zadržati	None
اتفق	dogovoreno	Nan
احتل	zauzeti	None
اتفاقية	sporazum	None
اتفاق	sporazum	None
اتباع	sledeći	Nan
اتباعه	njegovi sledbenici	Nan
اتبع	slijedi dalje	Nan
اتجاه	pravac	None
اتجاهات	trendovi	Nan
اتجه	skrenite	Nan
اتحاد	sindikat	Nan
اتخاذ	uzmi	Nan
اتخذ	uhvaćen je	Nan
اتخذت	uzeto	Nan
اتساع	širina	Nan
اتسعت	široki	None
اتسمت	bio je obeležen	Nan
اتصال	kontakt	None
اتصالات	telekom	Nan
اتفاقيات	ugovori	Nan
احتلال	okupacija	Nan
احتلت	okupirani	Nan
احتمال	prospekt	Nan
ارتفاعه	njegova visina	Nan
ارتفاعها	njegova visina	Nan
ارتفع	ustao	Nan
ارتفعت	rose	Nan
ازداد	je povećan	Nan
ازدادت	povećana	Nan
ازدهار	cvjetati	Nan
ازدهر	cvjetao	Nan
ازدهرت	cvjetao	Nan
ازدياد	povećati	Nan
اس	s.	Nan
استبدال	zamijenite	Nan
استخدام	upotreba	None
استخدامات	upotrebe	None
استخدامه	iskoristite ga	Nan
ارتفاع	visina	None
ارتبطت	zaručili	Nan
ارتبط	povežite se	Nan
ارتباط	angažman	Nan
احتياجات	potrebe	None
احتياطي	rezervni	Nan
احمد	ahmed	None
اختار	odaberite	Nan
اختبار	test	Nan
اختبارات	testovi	None
اختراع	izum	Nan
اقتصادي	ekonomski	None
اختراق	proboj	Nan
اختلاف	razlika	None
اختلافات	razlike	None
اختلفت	razlikuje se	Nan
اختيار	izbor	None
اختياره	njegov izbor	Nan
اخر	drugo	None
اديسون	edison	Nan
اخترع	izmislio	Nan
اقتصاديا	ekonomski	None
اقتصادية	ekonomičan	Nan
اقرأ	pročitajte	Nan
الأديان	religije	None
الأذربيجانية	azerbejdžani	Nan
الأراضي	zemljišta	None
الأرانب	kunići	Nan
الأربع	četvrt do	Nan
الأربعة	četiri	None
الأربعين	četrdeset	None
الأرثوذكس	pravoslavni	None
الأرثوذكسية	pravoslavni	None
الأرجح	vjerovatno	None
الأرجنتين	argentina	None
الأردن	jordan	None
الأردني	jordanski	Nan
الأردنية	jordanski	Nan
الأرز	rižu	Nan
الأدوية	farmaceutski	Nan
الأرضي	ground	Nan
الأدوار	uloge	None
الأدنى	najniži	Nan
الأخر	drugi	None
الأخرى	drugi	None
الأخضر	zeleno	None
الأخطاء	greške	None
الأخلاق	moralni	None
الأخلاقية	moralni	None
الأخوان	braćo	Nan
الأخير	posljednji	None
الأخيرة	poslednja	Nan
الأداء	predstava	Nan
الأدب	književnosti	None
الأدباء	pisci	None
الأدبي	književni	None
الأدبية	književni	None
الأدلة	dokazi	None
الأدوات	alati	None
الأرضية	pod	None
الأرقام	brojevi	None
الأرمن	armenci	Nan
الأسبوع	sedmice	None
الأستاذ	profesor	None
الأسترالية	australijski	Nan
الأسد	lav	None
الأسر	porodice	None
الأسرة	porodica	None
الأسرى	zatvorenici	Nan
الأسطورة	legenda	None
الأسطول	flota	Nan
الأسعار	cene	Nan
الأسفل	niže	None
الأسلحة	oružje	None
الأسلوب	metoda	None
الأسماء	imena	None
الأسماك	riba	None
الأسبق	bivši	None
الأسبرين	aspirin	None
الأسبانية	španski	None
الأسباني	španski	None
الأرمني	armenski	Nan
الأرمنية	armenski	Nan
الأرنب	zec	Nan
الأرواح	duhovi	Nan
الأزرق	plava	None
الأزمات	krize	None
الأزمة	kriza	None
الأخذ	uzimam	Nan
الأزهر	al-azhar	Nan
الأسئلة	pitanja	None
الأساس	temelj	None
الأساسي	primarno	None
الأساسية	osnovni	None
الأساطير	mitovi	None
الأساليب	metode	None
الأسباب	razlozi	None
الأزياء	moda	Nan
الأسنان	zubi	None
الأخبار	vijesti	None
الأحيان	ponekad	None
الآستانة	astana	Nan
الآسيوي	azijski	Nan
الآسيوية	azijski	Nan
الآشورية	asirski	Nan
الآفات	štetočine	Nan
الآلات	mašine	None
الآلاف	hiljade	None
الآلام	bol	None
الآلة	bože	None
الآلهة	bogovi	None
الآلي	automatizirano	Nan
الآلية	mehanizam	None
الآن	upravo sada	Nan
الآونة	nedavno	None
الآيات	stihovi	None
الآرامية	aramejski	Nan
الآية	ajet	None
الآر	the aar	Nan
الآخرين	ostali	None
اكتساب	akvizicija	Nan
اكتسبت	stečeno	Nan
اكتشاف	otkriće	None
اكتشافه	otkrijte	Nan
اكتشافها	otkrijte ih	Nan
اكتشف	otkrijte	Nan
اكتشفت	otkrio sam	Nan
ال	the	None
الآب	otac	None
الآباء	roditelji	None
الآبار	wells	Nan
الآتي	sledeći	Nan
الآثار	arheologija	Nan
الآخر	drugi	None
الآخرة	u nastavku	Nan
الآداب	literatura	None
الأئمة	imams	Nan
الأب	otac	None
الأباطرة	carevi	Nan
الأجنحة	krila	None
الأجهزة	uređaji	None
الأجيال	generacije	None
الأحاديث	hadisi	Nan
الأحد	nedjelja	None
الأحداث	događaji	None
الأحرار	slobodni ljudi	Nan
الأحرف	likovi	None
الأحزاب	stranke	None
الأحكام	odredbe	Nan
الأحماض	kiseline	None
الأحمد	al-ahmed	Nan
الأحمر	crveno	Nan
الأحوال	uslovi	None
الأحياء	biologija	None
الأجنبية	strani	None
الأجنبي	stranac	Nan
الأجناس	trke	Nan
الأجسام	predmeti	None
الأبجدية	abeceda	Nan
الأبحاث	istraživanje	None
الأبطال	junaci	Nan
الأبعاد	dimenzije	None
الأبناء	deca	Nan
الأبواب	vrata	None
الأبيض	bijeli	None
الأخ	brat	None
الأتراك	turci	None
الأثر	uticaj	None
الأثرية	arheološki	None
الأثناء	u međuvremenu	Nan
الأثير	eter	Nan
الأجانب	stranci	None
الأجرام	tijela	None
الأجزاء	delovi	Nan
الأثار	arheologija	Nan
السينمائي	film	None
السينمائية	kinematografski	Nan
السينية	x	None
الوزن	težina	None
الوزير	ministar	None
الوسائل	znači	None
الوسط	sredina	Nan
الوسطى	centralni	None
الوسواس	opsesivna	Nan
الوسيط	posrednik	Nan
الوصف	opis	None
الوصول	pristup	None
الوصيف	pobjednik	None
الوضع	situacija	None
الوطن	domovina	None
الوطني	nacionalnog	None
الوطنية	nacionalni	None
الوظائف	poslovi	Nan
الوزراء	ministri	None
الوظيفة	zanimanje	None
الوزارة	ministarstvo	None
الورق	papir	None
الوثائق	dokumenata	None
الوثنية	idolopoklonstvo	Nan
الوثيقة	dokument	None
الوجبات	obroci	Nan
الوجه	lice	None
الوجود	postojanje	None
الوحدات	jedinice	None
الوحدة	jedinica	None
الوحي	otkrivenje	Nan
الوحيد	jedini	None
الوحيدة	jedini	None
الوديان	dolinama	None
الوراء	unazad	Nan
الوراثة	genetika	Nan
الوراثية	genetski	Nan
الورم	tumor	None
الوالي	viceroy	Nan
الوظيفي	karijera	None
الوفاة	smrt	None
اليابانية	japanci	Nan
اليابسة	zemljište	None
اليد	ruka	None
اليدوية	ručno izrađene	Nan
اليرموك	yarmouk	Nan
اليسار	levo	Nan
اليسرى	levo	Nan
اليقين	izvjesnost	Nan
اليمامة	al-yamamah	Nan
اليمن	kome	None
اليمنى	tačno	None
اليمنية	jemeni	Nan
اليمين	tačno	None
اليه	mehanizam	None
اليهود	jevreji	None
الياباني	japanci	Nan
الوعي	svest	Nan
اليابان	japan	None
الوهابية	vehabizam	Nan
الوفد	delegacija	Nan
الوفيات	poginuli	Nan
الوقائع	činjenice	None
الوقاية	zaštita	None
الوقت	vreme	None
الوقود	gorivo	None
الوقوف	ustani	Nan
الوكالة	agencija	None
الولاء	lojalnost	Nan
الولاة	župan	Nan
الولادة	rođenje	None
الولايات	države	None
الولاية	država	None
الوليد	alwaleed	Nan
الوهاب	davalac svih	Nan
الويب	web	Nan
الوالد	otac	None
الواقعية	realizam	Nan
الواقعة	cinjenica	Nan
النيتروجين	nitrogen	Nan
النيجر	niger	Nan
النيل	nil	Nan
الهائل	fenomenalni	Nan
الهائلة	izvrsno	Nan
الهاتف	telefon	Nan
الهادئ	tiho	Nan
الهادي	vodič	None
الهاشمي	hashemi	Nan
الهاشمية	hashemite	Nan
الهامة	bitan	None
الهبوط	sletanje	Nan
الهجان	hibridni	Nan
الهجرة	imigracija	Nan
الهجري	hidžri	Nan
النيازك	meteoriti	Nan
الهجمات	napadi	None
النووية	nuklearna	None
النوم	spavaj	Nan
النهائي	konačno	None
النهائية	finale	None
النهار	dnevno	None
النهاية	kraj	None
النهج	pristup	None
النهر	reka	Nan
النهرين	dvije rijeke	Nan
النهضة	renesansa	Nan
النواب	poslanici	None
النواحي	načini	None
النوادي	klubovi	None
النواعير	fontane	Nan
النور	svjetlo	None
النوع	tip	None
النوعية	kvaliteta	None
النووي	nuklearna	None
الهجوم	napad	None
الهدنة	prihvatanje	None
الهرم	piramida	None
الهيئة	komisija	None
الهياكل	strukture	None
الهيثم	al-haytham	Nan
الهيدروجين	vodonik	None
الهيكل	strukturu	None
الواجب	zadaća	None
الواجهة	interfejs	None
الواحد	jedan	None
الوادي	dolini	None
الواردات	uvoz	Nan
الواردة	sadržani	Nan
الواسع	široki	None
الواسعة	široki	None
الواضح	očigledno	Nan
الواقع	stvarnost	None
الهيئات	organizacije	None
الهوية	identitet	None
الهولوكوست	holokaust	Nan
الهولندية	holandski	None
الهروب	bijeg	Nan
الهزيمة	poraz	None
الهضاب	visoravni	None
الهضبة	visoravan	None
الهلال	polumjesec	Nan
الهند	indija	None
الهندسة	inženjering	None
اليهودي	jevrejin	Nan
الهندسية	inženjering	None
الهندوسية	hinduizam	Nan
الهندي	indijski	None
الهندية	hindski	Nan
الهنود	indijanci	Nan
الهواء	zrak	None
الهوائية	aerobni	Nan
الهولندي	holandski	None
الهندوس	hinduisti	Nan
النمور	tigrovi	Nan
اليهودية	judaizam	None
اليورو	evro	Nan
بإصدار	da izdaju	Nan
بإضافة	dodavanjem	None
بإطلاق	apsolutno	None
بإعادة	re	Nan
بإقامة	uspostaviti	None
بإنتاج	proizvesti	Nan
بإنشاء	stvara	None
بئر	pa	None
باب	vrata	None
بابا	baba	Nan
بابل	babilon	Nan
بابن	sin	None
بات	je postao	Nan
باتجاه	prema	None
باحتلال	zauzimaju	None
بإرسال	pošalji	Nan
باختلاف	drugačije	None
بإجراء	izvoditi	Nan
بأول	nastavi	Nan
بأحد	bilo kome	Nan
بأداء	izvoditi	Nan
بأسلوب	na način	Nan
بأسماء	sa imenima	Nan
بأشكال	u oblicima	Nan
بأعمال	radi	None
بأكثر	još	None
بأكمله	cijeli	None
بألمانيا	nemačke	Nan
بأمر	po nalogu	Nan
بأن	to	None
بأنه	to je on	Nan
بأنها	kao	None
بأنهم	to su oni	Nan
بأوروبا	u evropi	Nan
بأي	u bilo kojem	Nan
بأبي	moj otac	Nan
بادئ	početni	Nan
باديس	badis	Nan
باكو	baku	Nan
بالأرض	spljoštena	Nan
بالأمر	o tome	Nan
بالإسكندرية	u aleksandriji	Nan
بالإسلام	sa islamom	Nan
بالإضافة	pored toga	Nan
بالإمكان	moguće je	Nan
بالإنجليزية	na engleskom	Nan
بالاشتراك	zajednički	None
بالبلاد	u zemlji	Nan
بالتالي	naknadno	None
بالتجارة	trgovina	None
بالتركية	na turskom	Nan
بالتعاون	u saradnji	Nan
بالجامعة	na univerzitetu	Nan
باكستان	pakistan	None
بادية	badia	Nan
باقي	ostatak	None
باعتباره	kao	None
بارتفاع	gore	None
بارد	cool	Nan
بارز	istaknuti	None
بارزة	primetna	Nan
باريس	pariz	None
باستثناء	osim	None
باستخدام	koristeći	None
باستعمال	upotreba	None
باستقلال	nezavisno	None
باستمرار	neprekidno	None
باسم	basim	Nan
باسمه	u njegovo ime	Nan
باشا	pasha	Nan
باطن	đonovi	Nan
باعتبار	razmatrati	Nan
باعتبارها	kao	None
ب	b	None
اي	koji	None
اهل	ljudi	None
انبعاث	emisija	Nan
انبعاثات	emisije	Nan
انتخاب	izbori	None
انتخابات	izbori	None
انتخابه	njegov izbor	Nan
انتخب	izabran je	Nan
انتزاز	napadaj	Nan
انتشار	širenje	None
انتشارا	prevalentan	Nan
انتشاراً	prevalentan	Nan
انتشارها	njeno širenje	Nan
انتشارًا	rasprostranjenost	None
انتشر	pečurka	Nan
انتشرت	širio	Nan
انتصار	pobjeda	None
ان	da	None
انتصارات	pobjeđuje	None
امساخ	prljavština	Nan
امتلكت	ja posedujem	Nan
اليوم	danas	None
اليومية	svaki dan	Nan
اليونان	grčka	None
اليوناني	grčki	None
اليونانية	grčki	None
اليونانيون	grci	None
اليونانيين	grci	None
اليونسكو	unesco	Nan
ام	majko	None
اما	kao za	Nan
امام	prije	None
امتد	širenje	None
امتداد	produžetak	Nan
امتدت	ispružena	Nan
امتصاص	apsorpcija	Nan
امرأة	žena	None
انتصر	on je osvojio	Nan
انتفاضة	ustanak	None
انتقاد	kritika	None
انظر	pogledaj	Nan
انعقاد	sazivanje	Nan
انفجار	eksplozija	Nan
انفصال	razdvajanje	None
انقراض	izumiranje	Nan
انقسام	podijeliti	None
انقطاع	prekid	None
انقلاب	puč	Nan
انه	to je	Nan
انها	to	None
انهم	da oni	Nan
انهيار	collapse	Nan
اهتم	čuvaj se	Nan
اهتمام	kamata	Nan
اهتمامه	njegovo interesovanje	Nan
انطلقت	lansiran	Nan
انطلق	nastavi	Nan
انضمت	ona se pridružila	Nan
انضمام	pridruživanje	Nan
انتقادات	kritika	None
انتقال	tranzicija	Nan
انتقالية	prelazni	Nan
انتقد	kritikovati	Nan
انتقل	on se preselio	Nan
انتقلت	preselila sam se	Nan
انتهاء	kraj	None
اليورانيوم	uranijum	None
انتهت	istekao	Nan
انخفاض	kap	Nan
انخفض	smanjen	Nan
انخفضت	smanjen	Nan
اندلعت	provalili	Nan
اندونيسيا	indonezija	None
انسحاب	povlačenje	Nan
انضم	pridruži se	Nan
انتهى	je gotov	Nan
النموذج	uzorak	Nan
النمل	mravi	Nan
النمط	obrazac	Nan
المناصب	pozicije	None
المناطق	regioni	Nan
المناعة	imunitet	Nan
المناعي	imunofluorescencija	Nan
المنافسة	takmičenje	None
المناهج	curricula	Nan
المناهضة	anti	Nan
المنتج	proizvod	None
المنتجات	proizvodi	None
المنتجة	proizvedeno	Nan
المنتخب	izabrani	None
المنتخبات	timovi	None
المنتدى	forum	None
المنتشرة	razbacani	Nan
المنتظر	čekam	Nan
المناسبة	povodom	None
المنخفضة	nizak	None
المناسبات	pogodi	Nan
المنازل	kuće	None
الممالك	kraljevstva	None
المماليك	mamluks	Nan
الممتاز	odlična	Nan
الممتدة	rastezanje	Nan
الممتلكات	svojstva	None
الممثل	glumca	Nan
الممثلة	glumica	None
الممثلين	glumci	None
الممكن	moguće	None
المملكة	kraljevstvo	None
المملوكي	mamluk	Nan
المملوكية	mamluk	Nan
المميزة	prepoznatljiv	None
المناخ	klima	None
المناخية	klimatski	None
المناسب	odgovarajuće	None
الممارسة	vežba	Nan
المندائية	mandajski	Nan
المنزلي	domaći	None
المهرجانات	festivali	None
المهلهل	ljigav	Nan
المهم	važno	None
المهمة	misija	None
المهنة	zanimanje	None
المهندس	inženjer	Nan
المهندسين	inžinjeri	Nan
المهنية	profesionalni	Nan
المواجهة	konfrontacija	Nan
المواد	materijali	None
الموارد	resursi	None
المواصلات	prevoz	Nan
المواضيع	niti	None
المواطن	građanin	None
المواطنين	građani	None
المهدي	mahdi	Nan
المنزل	dom	None
المهبل	vagina	None
المهارات	vještine	None
المنزلية	domaćinstvo	Nan
المنشآت	sadržaji	Nan
المنصب	položaj	None
المنصور	al-mansour	Nan
المنصورة	mansoura	Nan
المنطق	logika	None
المنطقة	region	None
المنظمات	organizacije	None
المنظمة	organizacije	None
المنعم	munim	Nan
المنفى	izgnanstvo	Nan
المنهج	nastavni plan	Nan
المنورة	medina	None
المنوية	sperma	Nan
المهاجرين	imigranti	Nan
المهام	misija	None
الملوك	kraljevi	None
الملوثة	zagađeno	Nan
الملوثات	zagađivači	Nan
المفسرين	prevodioci	Nan
المفضلة	omiljena	Nan
المفكرين	mislioci	Nan
المفهوم	razumeo	Nan
المقابر	groblja	None
المقابل	povratak	None
المقابلة	intervju	None
المقارنة	poređenje	None
المقاطعات	pokrajine	None
المقاطعة	bojkot	Nan
المقاعد	sedišta	Nan
المقال	clanak	Nan
المقالات	članci	None
المقالة	član	None
المقام	the maqam	Nan
المفروضة	nametnuta	Nan
المقاومة	otpor	None
المفردات	vokabular	Nan
المفترض	pretpostavljeno	Nan
المغاربة	marokanci	Nan
المغرب	maroko, zapad, zalazak sunca	Nan
المغربي	marokanski	Nan
المغربية	marokanski	Nan
المغلقة	u prilogu	Nan
المغناطيس	magnet	Nan
المغناطيسي	magnetska	Nan
المغناطيسية	magnetizam	Nan
المغول	mongoli	Nan
المغولي	mughal	Nan
المغولية	mongolski	Nan
المفاتيح	ključevi	Nan
المفاعلات	reaktori	Nan
المفاهيم	pojmovi	None
المفاوضات	pregovori	None
المفتوحة	otvori	Nan
المقاييس	metrike	Nan
المقدس	sveti	None
المقدسة	sveto	None
الملائكة	anđeli	Nan
الملابس	odjeća	Nan
الملاحة	navigacija	Nan
الملاحظات	napomene	Nan
الملاحظة	posmatranje	Nan
الملايو	malajski	Nan
الملايين	milionima	Nan
الملح	so	None
الملعب	stadion	None
الملفات	datoteke	None
الملقب	alias	Nan
الملك	kralj	None
الملكة	kraljica	None
الملكي	rojalistički	Nan
الملكية	vlasništvo	None
المكي	meccan	Nan
المكونة	komponenta	Nan
المكونات	sastojci	Nan
المكون	komponenta	Nan
المقدسي	jeruzalemski	Nan
المقدمة	uvod	None
المقدوني	makedon	Nan
المقر	sjedište	None
المقربين	zatvori	Nan
المقرر	odluka	None
المقصود	namenjeno	Nan
الموافق	odgovarajuće	None
المقيمين	stanovnici	None
المكتب	sto	None
المكتبات	biblioteke	None
المكتبة	biblioteku	Nan
المكتوبة	pismeno	Nan
المكرمة	al mukarramah	Nan
المكسيك	meksiko	None
المكسيكية	meksički	Nan
المكان	mjesto	None
الموافقة	u redu	Nan
المواقع	lokacije	None
المواقف	pozicije	None
النسبي	relativno	None
النسبية	relativnost	Nan
النسخ	transkripcija	Nan
النسخة	pustiti	Nan
النسق	izgled	None
النسيج	tkanina	Nan
النشأة	fondacija	None
النشاط	aktivnost	None
النشاطات	aktivnosti	None
النشر	izdavaštvo	Nan
النشطة	aktivno	None
النشيد	himna	None
النص	tekst	None
النصارى	kršćani	None
النصر	pobeda	Nan
النسبة	odnos	None
النصف	polovina	None
النسب	proporcije	Nan
النساء	žene	None
النجار	stolar	Nan
النجم	zvijezda	None
النجوم	zvijezde	None
النحاس	bakar	None
النحت	vajarski	Nan
النحل	pčele	None
النحو	as	None
النخبة	elita	Nan
النخيل	dlan	Nan
النرويج	norveška	None
النرويجي	norveški	Nan
النرويجية	norveški	Nan
النزاع	sukob	None
النزاعات	sukobi	None
النزعة	sklonost	None
النسائية	feministička	Nan
النصوص	tekstovi	None
النضر	sukulentan	Nan
النطاق	raspon	Nan
النقاد	kritičari	None
النقاط	bodovi	Nan
النقد	kritika	None
النقدي	gotovina	Nan
النقدية	gotovina	Nan
النقص	nesavršenost	Nan
النقطة	poenta	Nan
النقل	transport	None
النقود	novac	None
النقيض	kontrast	None
النماذج	modeli	Nan
النمر	tigar	Nan
النمسا	austrija	None
النمساوي	austrijski	None
النمساوية	austrijski	None
النفوس	duše	None
النفوذ	uticaj	None
النفقات	troškovi	Nan
النفطية	ulje	Nan
النطق	izgovor	None
النظام	sistem	None
النظامي	redovnici	Nan
النظامية	sistemski	Nan
النظر	pogledaj	Nan
النظرة	pogled	None
النظريات	teorije	None
النجاح	uspeh	Nan
النظرية	teorija	None
النعمان	anemone	Nan
النفايات	otpad	Nan
النفس	sebe	None
النفسي	psihološki	Nan
النفسية	mentalno	Nan
النفط	ulje	Nan
النفطي	ulje	Nan
النظير	vršnjak	Nan
بالجزائر	u alžiru	Nan
النثر	proza	None
النتائج	rezultati	None
الموسيقار	muzičar	None
الموسيقى	muzika	None
الموسيقي	muzika	None
الموسيقية	mjuzikl	Nan
الموضوع	tema	None
الموضوعات	teme	None
الموظفين	zaposleni	Nan
الموقع	sajt	None
الموقف	situacija	None
المولد	rođen	None
المولود	rođen	None
المولى	sire	Nan
المياه	voda	None
الميت	smrt	None
الميثاق	povelja	None
الموسوعة	enciklopedija	None
الميثان	metan	Nan
الموسمية	sezonalnost	Nan
المورثة	gen	None
الموالية	pro	None
المواليد	novorođenčad	Nan
الموانئ	portovi	Nan
الموت	smrt	None
الموتى	mrtvi	Nan
الموجات	talasi	Nan
الموجة	val	None
الموجهة	režirano	Nan
الموجود	pronađeno	Nan
الموجودة	postojeće	None
الموجي	talasni oblik	Nan
الموجية	talasni oblik	Nan
الموحد	konsolidovani	Nan
الموحدة	standardno	Nan
الموحدين	unitarians	Nan
الموسم	sezona	None
الميدالية	medalja	None
الميدان	polje	None
الميزانية	budžet	Nan
الناشئة	emerging	Nan
الناصر	nasser	Nan
الناطقة	govoreći	None
الناطقين	zvučnici	Nan
النامية	razvija se	Nan
النبات	biljka	None
النباتات	biljke	None
النباتي	vegetarijanski	Nan
النباتية	vegetarijanski	Nan
النبلاء	plemići	Nan
النبوة	proročanstvo	Nan
النبوي	poslanik	None
النبوية	poslanik	None
النبي	poslanik	None
النبيذ	vino	None
الناس	ljudi	None
النازية	nacizam	None
النازي	nacisti	Nan
النارية	motocikl	Nan
الميكانيكا	mehanika	Nan
الميكانيكية	mehanički	None
الميلاد	božić	None
الميلادية	gregorian	Nan
الميلاديين	ad	None
الميناء	luka	None
الميول	tendencije	Nan
النتيجة	rezultat	None
الناتج	nastalo	None
الناتو	nato	None
الناجحة	uspešno	Nan
الناجمة	uzrok	None
الناحية	strana	None
النادرة	retko	Nan
النادي	klub	None
النار	vatra	None
الناتجة	rezultat	None
بالجنة	nebo	None
بالحرب	s ratom	Nan
بالحكم	presudom	Nan
بيوم	dan	None
بُني	brouwn	Nan
ت	t	Nan
تأثر	pogođeni	Nan
تأثرت	impresioniran	Nan
تأثير	efekat	None
تأثيرا	uticaj	None
تأثيرات	efekti	None
تأثيره	njegovo dejstvo	Nan
تأثيرها	njegovo dejstvo	Nan
تأخذ	uzmi	Nan
تأسس	uspostavljeno	Nan
تأسست	osnovano je	Nan
تأسيس	uspostavljanje	None
تأسيسها	njegova osnova	Nan
بيوت	kuće	None
تأكيد	naglasak	Nan
بينهما	između njih	Nan
بينها	između njih	Nan
بيبرس	paprike	Nan
بيت	kuća	None
بيته	njegova kuća	Nan
بيد	kako god	Nan
بيده	s njegovom rukom	Nan
بيروت	bejrut	None
بيعة	prodaja	None
بيك	beck	Nan
بيكو	pico	Nan
بيكومتر	picometri	Nan
بيل	bill	None
بيليوس	peleus	Nan
بين	između	None
بينما	dok	None
بينه	dokaz	None
بينهم	između njih	Nan
بيانات	podaci	None
تأليف	napisao	None
تأييد	podrška	None
تبث	emitovanje	Nan
تبدأ	start	Nan
تبدو	pogledaj	Nan
تبرز	isticati se	Nan
تبع	praćen	Nan
تبعا	ovisno o	Nan
تبعد	away	Nan
تبقى	ostani	Nan
تبلغ	izveštaj	Nan
تبنت	usvojena	None
تبنى	usvajanje	Nan
تبني	usvajanje	Nan
تبوك	tabuk	Nan
تبين	ispada	Nan
تتأثر	pogođeni	Nan
تبادل	razmjena	None
تأمين	osiguranje	Nan
تايوان	tajvan	Nan
تامة	upravo	None
تؤثر	efekat	None
تؤدي	voditi do	Nan
تؤكد	naglašava	Nan
تؤمن	vjerujte	Nan
تابع	pratiti	None
تابعة	podređeni	Nan
تاج	kruna	None
تاريخ	istorija	None
تاريخه	njegova istorija	Nan
تاريخها	njegova istorija	Nan
تاريخي	istorijskog	Nan
تاريخيا	istorijski	Nan
تاريخياً	istorijski	Nan
تاريخية	istorijskog	Nan
تاشفين	vidiš	Nan
تايمز	vremena	None
بيان	izjava	Nan
بيئة	životna sredina	Nan
بي	u meni	Nan
بنشر	za objavljivanje	Nan
بنظام	sistem	None
بنغازي	bengazi	Nan
بنفس	sa istim	Nan
بنفسه	sam	None
بنفسها	sama	None
بنقل	prenošenje	Nan
بنك	banka	None
بنو	deca	Nan
بنوع	vrsta	None
بنى	brouwn	Nan
بني	brouwn	Nan
بنية	struktura	None
بنيت	je izgrađeno	Nan
به	sa tim	Nan
بنسبة	u stopi od	Nan
بها	izlazi	None
بنزوين	benzoin	Nan
بنحو	o:	Nan
بممارسة	vježba	Nan
بمناسبة	označavanje	Nan
بمنطقة	na području	Nan
بموجب	under	Nan
بن	sin od	Nan
بنا	zrna kafe	Nan
بناء	zgrada	None
بناءً	zgrada	None
بنائها	napravi ga	Nan
بنات	kćeri	None
بناه	graditelji	Nan
بناها	sagradio je	Nan
بنت	djevojka	None
بنتيجة	sa rezultatom	Nan
بنجاح	uspješno	None
بندر	bender	Nan
بهاء	baha	Nan
بهجوم	sa napadom	Nan
بهدف	s ciljem	Nan
بوصفها	kao	None
بوضع	staviti	None
بوضوح	jasno	None
بوقت	sa vremenom	Nan
بوك	facebook	None
بول	paul	None
بولاية	sa državom	Nan
بولس	paul	None
بولندا	poljska	None
بولينا	paulina	Nan
بومدين	boumediene	Nan
بونابرت	bonaparte	None
بونيقيون	punic	Nan
بوهيميا	bohemija	Nan
بويع	prodaja	None
بوصفه	as	None
بوش	bush	Nan
بورصة	tržište	None
بورسعيد	port said	Nan
بهذا	ovim	None
بهذه	s ovim	Nan
بهلوي	pahlavi	Nan
بهم	njih	None
بهما	sa njima	Nan
بو	bo	Nan
بوابات	kapije	Nan
تتألف	sastavljeno	Nan
بوابة	kapija	None
بواسطة	od	None
بوجه	lice	None
بوجود	tamo	None
بوحدة	sam	None
بوذا	buda	Nan
بور	bohr	Nan
بورتو	porto	None
بواس	boas	None
تتبع	praćenje	Nan
تتجاوز	prekoračiti	Nan
تتجمع	congregate	Nan
تخفيض	popust	Nan
تدار	upravljani	Nan
تدخين	pušenje	None
تدرس	studirao	None
تدريب	trening	Nan
تدريجيا	postepeno	None
تدريجياً	postepeno	None
تدريجيًا	postepeno	None
تدعم	podrška	None
تدعو	poziva	None
تدفع	ti plaćaš	Nan
تدفق	protoka	Nan
تدل	označi	Nan
تدمير	uništenje	Nan
تدهور	pogoršanje	Nan
تخطيط	planiranje	None
تدور	okretanje	Nan
تخضع	predmet	None
تخصص	specijalnost	Nan
تحكم	kontrola	None
تحل	rešen	Nan
تحليل	analizirajući	Nan
تحمل	ležaj	Nan
تحميل	skinuti	Nan
تحول	transformacija	Nan
تحولت	okrenuto	Nan
تحوي	sadrže	None
تحويل	transformacija	Nan
تحوّل	transformacija	Nan
تحيط	okružen	None
تختلف	različite	None
تخدم	poslužite	Nan
تخرج	diplomiranje	Nan
تخزين	skladište	Nan
تخصيص	prilagodite	Nan
تدوين	zapis	None
تدير	ona trči	Nan
تذكر	zapamti	Nan
تركيا	turska	None
تركيب	instalacija	Nan
تركية	turski	None
تركيز	fokus	Nan
ترى	vidi	None
تريد	ti želiš	Nan
ترير	trier	Nan
تزال	ipak	None
تزايد	povećati	Nan
تزداد	dobijanje više	Nan
تزوج	vjenčati se	Nan
تزوجت	vjenčali se	Nan
تزوجها	oženi je	Nan
تزيد	povećati	Nan
تساعد	pomoć	None
تركي	turki	Nan
تركها	ostavi to	Nan
تركز	fokus	Nan
تركت	levo	Nan
تراث	baština	None
تراجع	povlačenje	Nan
تراجعت	treptao	Nan
تراقيا	trakija	Nan
ترانسفيراز	transferaza	Nan
تربة	tlo	None
تربط	povežite se	Nan
تحقيق	istraga	Nan
تربية	obrazovanja	None
ترتفع	ići gore	Nan
ترتيب	naredba	None
ترجع	vraća	None
ترجم	prevesti	Nan
ترجمة	prevod	Nan
تردد	učestalost	Nan
ترك	otići	Nan
ترتبط	povezano	None
بمكة	u meki	Nan
تحقق	proverite	Nan
تحصل	dobiti	None
تتعلق	srodni	Nan
تتغذى	oni se hrane	Nan
تتغير	promjena	None
تتكون	izmišljeno	Nan
تتم	gotovo	None
تتمتع	uživajte	Nan
تتمثل	zastupljeni	None
تتمكن	možeš	Nan
تتميز	karakterizira ga	Nan
تتناول	imajući hranu	Nan
تتنوع	raznoliko	Nan
تتواجد	postoje	None
تتوفر	dostupno	Nan
تتوقف	stani	Nan
تتيح	omogućuje	None
تتعرض	izloženo	Nan
تثبت	dokazati	Nan
تتعامل	poslujte	Nan
تتطلب	zahtijevajte	Nan
تتجه	heading	Nan
تتحدث	ona priča	Nan
تتحرك	krećući se	Nan
تتحول	isključi	Nan
تتخذ	uzmi	Nan
تتدخل	intervenira	Nan
تتراوح	domet	None
تتركز	koncentrirano	Nan
تتسبب	uzrok	None
تتسع	može se smjestiti	Nan
تتسم	karakterisano	Nan
تتشابه	slično	None
تتشكل	formirano	Nan
تتصل	odnosi se na	Nan
تتضمن	uključuje	None
تتطور	evoluirajte	Nan
تجار	dileri	Nan
تجارب	iskustva	None
تجارة	trgovina	None
تحتفظ	rezerve	None
تحتل	zauzeti	None
تحتها	pod njim	Nan
تحتوى	sadrži	None
تحتوي	sadrži	None
تحد	izazov	Nan
تحدث	talk	Nan
تحدد	odlučna	Nan
تحديث	ažuriraj	Nan
تحديد	odredite	Nan
تحرر	oslobođenje	None
تحرك	pomicanje	Nan
تحرير	pustiti	Nan
تحسن	poboljšanje	None
تحسين	poboljšanje	None
تحتاج	potreba	None
تحت	under	Nan
تحاول	pokušaš	Nan
تحاميل	supozitoriji	Nan
تجاري	komercijalno	Nan
تجارية	komercijalno	Nan
تجاه	prema	None
تجاوز	overflow	Nan
تجد	pronaći ćete	Nan
تجديد	obnavljanje	Nan
تجربة	eksperiment	Nan
تحظى	jeste	None
تجري	zauzmi mjesto	Nan
تجمع	okupljanje	Nan
تجمعات	okupljanje	Nan
تجميع	agregacija	Nan
تجنب	izbjegavajte	Nan
تجهيز	priprema	None
تحافظ	zadržati	None
تحالف	savez	None
تجعل	napravite	Nan
المعي	creva	Nan
بمكان	na nekom mestu	Nan
بمعنى	značenje	None
بحيرة	jezero	None
بخار	pare	None
بخصوص	što se tiče	Nan
بخط	rukopisom	Nan
بخلاف	osim toga	Nan
بد	mora	None
بدء	početak	None
بدءا	počinjati	Nan
بدءاً	počevši s	Nan
بدءًا	počinjati	Nan
بدأ	čini se	Nan
بدأت	počelo je	Nan
بدا	čini se	Nan
بداخل	unutar	None
بدايات	počeci	None
بحيرات	jezera	None
بداية	početak	None
بحيث	u kojem	Nan
بحوالي	otprilike	None
بجوار	pored	None
بجيش	sa vojskom	Nan
بجيشه	sa svojom vojskom	Nan
بحاجة	treba	None
بحال	svejedno	Nan
بحث	traži	None
بحجة	prepiru	Nan
بحد	limit	Nan
بحر	more	None
بحري	nautički	Nan
بحرية	besplatno	Nan
بحسب	prema	None
بحق	tačno	None
بحكم	vrlina	None
بحلول	by	Nan
بحوث	istraživanje	None
بجميع	u svemu	Nan
بدايتها	njegov početak	Nan
بدر	badr	Nan
برج	kule	None
برز	isticati se	Nan
برزت	izronio	Nan
برسم	uz plaćanje	Nan
برشلونة	barcelona	None
برعاية	kurirano	Nan
برفع	podići	Nan
برقة	nježno	Nan
بركان	vulkan	Nan
بركة	ribnjak	Nan
برلمان	parlament	None
برلمانية	parlamentarni	Nan
برلين	berlin	None
برنامج	program	None
بروبيلين	propilen	Nan
براون	smeđe	None
بدخول	unesite	Nan
براكودة	barracuda	Nan
بذلك	s tim	Nan
بدراسة	studija	None
بدرجة	stupanj	Nan
بدعم	podržani	Nan
بدفع	platiti	Nan
بدقة	tačno	None
بدلا	umjesto	None
بدلاً	umjesto	None
بدمشق	u damasku	Nan
بدن	telo	Nan
بدور	uloga	None
بدوره	zauzvrat	Nan
بدورها	zauzvrat	Nan
بدولة	u zemlji	Nan
بدون	bez	None
بديلة	alternativa	Nan
برئاسة	na čelu	Nan
بجمع	prikuplja	Nan
بجعة	labud	Nan
بجانب	pored	None
بالفرنسية	na francuskom	Nan
بالفشل	nije uspjelo	Nan
بالفعل	zaista	None
بالقاهرة	u kairu	Nan
بالقدس	u jeruzalemu	Nan
بالقرب	u blizini	Nan
بالقوة	na silu	Nan
بالكثير	mnogo	None
باللاتينية	na latinskom	Nan
باللغات	također je dostupna	Nan
باللغة	na jeziku	Nan
بالله	u boga	Nan
باللون	u boji	Nan
بالماء	sa vodom	Nan
بالمدينة	po gradu	Nan
بالغة	odrasli	Nan
بالمرض	razboli se	Nan
بالغ	odrasli	Nan
بالعمل	na poslu	Nan
بالخط	u redu	Nan
بالخلافة	uspjeh	None
بالدولة	država	None
بالذات	vrlo	None
بالذكر	spominjanje	Nan
بالرغم	iako	None
بالسكان	stanovništvo	None
بالسنة	godina	None
بالسيطرة	preuzeti kontrolu	Nan
بالشكل	u formi	Nan
بالطاقة	powered	Nan
بالعالم	u svijetu	Nan
بالعبرية	na hebrejskom	Nan
بالعديد	mnogi	None
بالعربية	na arapskom	Nan
بالعين	oko	None
بالمعنى	u smislu	Nan
بالمغرب	u maroku	Nan
بالمقابل	suprotno tome	Nan
بتطبيق	primjenom	Nan
بتعيين	set	None
بتغيير	promjena	None
بتقديم	pošaljite	Nan
بتلك	s tim	Nan
بتنظيم	organizovano	Nan
بتنفيذ	implementirati	Nan
بتهمة	pod optužbom	Nan
بتوجيه	pod vodstvom	Nan
بتونس	u tunisu	Nan
بث	emitovanje	Nan
بثلاث	tri	None
بثلاثة	po tri	Nan
بجائزة	nagrada	None
بجامعة	univerzitet	None
بتشكيل	formalno	None
بتحويل	pretvoriti	Nan
بتاريخ	on	None
بتأسيس	osnovan	None
بالمقارنة	u poredjenju sa	Nan
بالمملكة	u kraljevstvu	Nan
بالمنطقة	u okolini	Nan
بالمياه	sa vodom	Nan
بالنسبة	otprilike	None
باليونانية	na grčkom	Nan
بان	ban	None
بروتوكول	protokol	None
باوني	pawnee	Nan
بايزيد	bayezid	Nan
ببساطة	jednostavno	None
ببطء	polako	None
ببطولة	herojski	Nan
ببعض	neki	None
ببعضها	zajedno	None
ببناء	konstruktivno	Nan
باي	ćao	Nan
بروتون	protoni	Nan
بروز	istaknutost	Nan
بروسيا	prusija	Nan
بقتله	da ga ubijem	Nan
بقدر	toliko	None
بقرار	odlukom	None
بقعة	tacka	Nan
بقلم	by	Nan
بقليل	malo	None
بقوة	snažno	None
بقوله	izgovorom	Nan
بقي	ostao	None
بقيادة	vodio	None
بقية	odmor	None
بقيت	ona je ostala	Nan
بك|	vaš |	Nan
بكتابة	pismenim putem	Nan
بكتيريا	bakterija	None
بقتل	ubiti	None
بكثرة	obilno	Nan
بقايا	ostaje	None
بق	bug	Nan
بعيدا	away	Nan
بعيداً	away	Nan
بعيدة	daleko	None
بعين	s okom	Nan
بغداد	bagdad	Nan
بغزو	napadali	Nan
بغض	bez obzira	Nan
بغير	osim ako	Nan
بـ	sa	None
بفتح	otvori	Nan
بفترة	neko vrijeme	Nan
بفضل	hvala za	Nan
بفعل	radeći	Nan
بفكرة	sa idejom	Nan
بفيروس	sa virusom	Nan
بقاء	preživljavanje	Nan
بكثير	mnogo	None
بكر	bakr	Nan
بكرة	valjak	Nan
بلغت	hit	None
بلفور	balfour	Nan
بلقب	uz naslov	Nan
بلقيس	belques	Nan
بليحائية	blahy	Nan
بما	uključujući	None
بمثابة	as	None
بمجرد	jednom	None
بمحمد	muhammad	Nan
بمختلف	drugačije	None
بمرض	razboli se	Nan
بمرور	proći pored	Nan
بمساعدة	uz pomoć	Nan
بمصر	u egiptu	Nan
بمعدل	po stopi	Nan
بلغة	na jeziku	Nan
بلغاريا	bugarska	None
بلغ	doseg	Nan
بلعمية	fagocitoza	Nan
بكل	u svemu	Nan
بكميات	u količinama	Nan
بكونها	bićem	Nan
بكين	peking	Nan
بل	ali	None
بلا	bez	None
بلاد	zemlje	None
بعيد	daleko	None
بلاده	prigušenost	Nan
بلاط	pločice	Nan
بلال	belal	Nan
بلجيكا	belgija	None
بلد	država	None
بلدان	zemlje	None
بلدة	grad	None
بلدية	opština	Nan
بلادهم	njihova zemlja	Nan
بمقدار	by	Nan
بعنوان	pravo na rad	Nan
بعمليات	operacije	None
بشأن	otprilike	None
بشار	bashar	Nan
بشدة	jako	None
بشر	ljudska bića	Nan
بشراء	kupljeno	Nan
بشرط	pod uslovom	Nan
بشركة	sa kompanijom	Nan
بشري	čovjek	None
بشرية	čovječanstvo	Nan
بشكل	na neki način	Nan
بشيء	uz nešto	Nan
بشير	bashir	Nan
بصفة	as	None
بصفته	kao njegov	Nan
بصورة	slika	None
بسيطة	jednostavno	None
بضرورة	imperativ	Nan
بسيط	jednostavno	None
بسم	u ime	Nan
بروسيلا	brucella	Nan
بروناي	brunei	Nan
بري	divlji	Nan
برية	divljina	Nan
بريد	pošta	None
بريشة	pero	None
بريطانيا	britanija	None
بريطانية	britanski	None
بزعامة	vodio	None
بزيادة	gore	None
بزيارة	posetite	Nan
بسبب	jer	None
بسرطان	rak	None
بسرعة	brzo	None
بسط	produžiti	Nan
بسهولة	lako	None
بضع	nekoliko	None
بضعة	nekoliko	None
بضم	kombinovanjem	Nan
بعدم	ne treba	Nan
بعدما	posle	None
بعده	za njim	Nan
بعدها	onda	None
بعدهم	poslije njih	Nan
بعرض	širina	Nan
بعض	neki	None
بعضها	neki od njih	Nan
بعضهم	neki od njih	Nan
بعضهما	jedan drugog	Nan
بعقد	s ugovorom	Nan
بعل	muž	None
بعلم	svjesno	Nan
بعمر	sa životnim vekom	Nan
بعمل	radi	None
بعدد	u broju	Nan
بعدة	nekoliko	None
بعد	razdaljina	Nan
بعثة	ekspedicija	Nan
بطاقات	karte	None
بطاقة	kartica	None
بطبيعة	naravno	None
بطرس	peter	None
بطرق	na načine	Nan
بطريق	pingvin	Nan
بطريقة	na neki način	Nan
بعملية	operacija	None
بطل	heroj	None
بطن	trbuh	Nan
بطوطة	batuta	Nan
بطولات	prvenstva	None
بطولة	prvenstvo	None
بطيئة	sporo	None
بعام	godišnje	None
بعث	poslao je	Nan
بطليموس	ptolomej	Nan
تساوي	jednako	None
المعهد	institut	None
المعنى	značenje	None
العوامل	čimbenici	Nan
العود	lutnja	Nan
العودة	povratak	None
العولمة	globalizacija	None
العيد	bajram	None
العيش	uživo	None
العين	oko	None
العينين	oči	None
العيون	oči	None
الغابات	šume	None
الغابة	woods	Nan
الغاز	plin	Nan
الغازات	gasovi	Nan
الغازي	invader	Nan
الغالب	uglavnom	None
العوام	commoners	Nan
الغالبية	većina	None
العواصف	oluje	Nan
العنف	nasilje	Nan
العملاق	div	Nan
العملاقة	div	Nan
العملة	valuta	None
العملي	praktična	Nan
العمليات	procesi	None
العملية	operacija	None
العمود	stupac	Nan
العموم	the commons	Nan
العمومية	općenitost	Nan
العميق	duboko	None
العميقة	duboko	None
العناصر	elementi	None
العناية	briga	Nan
العنب	grožđe	Nan
العنصر	element	None
العهد	savez	None
العمل	posao	None
الغبار	prašina	Nan
الغذاء	hrana	None
الغني	bogati	None
الغنية	bogat	None
الغير	ostali	None
الـ	the	None
الفئات	kategorije	None
الفئة	kategorija	None
الفائدة	benefit	Nan
الفائز	pobednik	Nan
الفاتح	al fateh	Nan
الفاتحة	al-fatiha	Nan
الفاتيكان	vatikan	None
الفارابي	al-farabi	Nan
الفارسي	perzijski	None
الفارسية	perzijski	None
الفاشية	fašizam	Nan
الغموض	misterija	Nan
الغدد	žlezde	Nan
الغليون	cijev	None
الغلاف	cover	Nan
الغذائي	hrana	None
الغذائية	hrana	None
الغرب	zapad	None
الغربي	zapadni	None
الغربية	zapadnjački	Nan
الغربيين	zapadnjaci	Nan
الغرض	svrhu	None
الغرفة	soba	None
الغزاة	okupatori	Nan
الغزالي	al-ghazali	Nan
الغزل	predenje	Nan
الغزو	invazija	Nan
الغزوات	invazije	None
الغشاء	membrana	Nan
الغطاء	poklopac	Nan
الغلوكوز	glukoza	None
العمق	dubina	Nan
العمري	al-omari	Nan
العمرة	umrah	Nan
العصبي	nervozan	Nan
العصبية	nervoza	Nan
العصر	dob	None
العصور	vijekovima	None
العضلات	mišići	None
العضو	član	None
العضوية	članstvo	None
العطل	praznici	None
العظام	kosti	None
العظم	kost	None
العظمى	odlično	Nan
العظمي	kostur	None
العظيم	veliki	None
العظيمة	odlično	Nan
العفو	izvinite	Nan
العصابات	bande	Nan
العقائد	doktrine	Nan
العشرينات	dvadesete	Nan
العشرة	desetica	Nan
العرقي	etnički	None
العرقية	etnički	None
العروض	ponude	None
العريضة	peticija	Nan
العريقة	drevni	None
العزيز	draga	None
العسكر	vojska	None
العسكري	vojska	None
العسكرية	vojna	None
العسكريين	vojska	None
العسل	dušo	Nan
العش	gnijezdo	None
العشاء	večera	None
العشائر	klanovi	Nan
العشر	desetica	Nan
العشرين	dvadeset	None
العقائدية	dogmatski	Nan
العقاد	akkad	Nan
العقبة	prepreka	Nan
العلمي	naučni	None
العلمية	naučni	None
العلوم	nauke	None
العلوي	gornja	None
العلوية	nad glavom	Nan
العلويين	alaviti	Nan
العلي	najviši	None
العمارة	arhitektura	None
العمال	radnici	None
العمالة	zapošljavanje	Nan
العمالية	rad	None
العمر	dob	None
العمران	urbanizam	Nan
العمراني	urban	Nan
العمرانية	urbanizam	Nan
العلمانية	sekularizam	Nan
العلماء	naučnici	None
العلم	nauka	None
العلل	ills	Nan
العقد	ugovor	None
العقل	um	Nan
العقلي	mentalno	Nan
العقلية	mentalno	Nan
العقوبات	kazne	None
العقود	ugovori	Nan
العقول	mozak	None
الفاصل	separator	Nan
العقيد	pukovniče	Nan
العكس	suprotno	None
العلاء	visokog	None
العلاج	tretman	None
العلاجية	kurativno	Nan
العلاقات	odnosi	None
العلاقة	veza	None
العلامة	marka	None
العقيدة	vjerovanje	None
العرق	znoj	Nan
الفاطمي	fatimid	Nan
الفاطميين	the fatimidi	Nan
الفهم	razumevanje	Nan
الفوائد	prednosti	None
الفور	spot	Nan
الفوز	pobeda	Nan
الفوضى	haos	Nan
الفولاذ	čelik	None
الفوهات	mlaznice	Nan
الفيدرالي	federalni	None
الفيدرالية	federalizam	Nan
الفيديو	video	None
الفيروس	virus	None
الفيروسات	virusi	Nan
الفيروسي	virusnih	Nan
الفيروسية	virusnih	Nan
الفيزياء	fizika	None
الفهد	gepard	Nan
الفيزيائية	fizički	None
الفنية	umetnički	Nan
الفنون	umetnosti	Nan
الفلسفي	filozofski	None
الفلسفية	filozofski	None
الفلك	astronomija	Nan
الفلكي	astronom	Nan
الفلكية	astronomski	Nan
الفلكيون	astronomi	Nan
الفلم	film	None
الفم	usta	None
الفن	umjetnost	None
الفنادق	hoteli	None
الفنان	umjetnik	None
الفنانة	umjetnik	None
الفنانين	umetnici	Nan
الفنلندي	finn	Nan
الفنلندية	finski	None
الفني	umetnička dela	Nan
الفلسفة	filozofija	None
الفيس	elvis	None
الفيضانات	poplave	None
القاعدة	al kaida	Nan
القانون	zakon	None
القانوني	pravni	None
القانونية	pravni	None
القبائل	plemena	None
القبة	kupola	Nan
القبر	grave	Nan
القبض	uhvaćen	Nan
القبطي	koptski	Nan
القبطية	koptski	Nan
القبلة	poljubac	Nan
القبلي	plemenski	Nan
القبول	priznanja	None
القبيلة	pleme	None
القتال	borba	None
القاضي	sudija	None
الفيضان	poplava	None
القاسم	nazivnik	Nan
القارة	kontinent	None
الفيفا	fifa	None
الفيل	slon	Nan
الفيلة	slonovi	Nan
الفيلسوف	filozof	None
الفيلم	film	None
الفينيقية	feničanin	Nan
القائد	vođa	None
القائلة	govoreći	None
القائم	na osnovu	Nan
القائمة	lista	None
القادم	sljedeći	None
القادمة	dolazim	Nan
القادمين	dolazim	Nan
القارئ	čitač	Nan
القارات	kontinenti	Nan
القارية	kontinentalni	Nan
الفلسطينيين	palestinci	Nan
الفلسطينيون	palestinci	Nan
الفلسطينية	palestinski	Nan
الفرد	pojedinac	Nan
الفردي	samci	Nan
الفردية	individualni	Nan
الفرس	perzijanci	Nan
الفرسان	vitezovi	Nan
الفرصة	priliku	None
الفرع	ogranak	None
الفرعونية	faraonski	Nan
الفرعية	sub	Nan
الفرق	razlika	None
الفرقة	bend	None
الفرن	pečnica	Nan
الفرنجة	franci	Nan
الفرنسي	francuski	None
الفرنسية	francuski	None
الفرج	vulva	Nan
الفرنسيون	francuski	None
الفراغ	praznina	Nan
الفراش	posteljina	Nan
الفتاة	djevojka	None
الفتح	osvajanje	None
الفترات	periodi	Nan
الفترة	period	None
الفتنة	neslaganje	Nan
الفتوح	al-futouh	Nan
الفتوحات	osvajanja	None
الفجر	daybreak	Nan
الفجوة	gap	Nan
الفحص	ispitivanje	None
الفحم	ugljen	None
الفخار	keramika	Nan
الفدرالي	savezni	Nan
الفدرالية	federalizam	Nan
الفرات	eufrat	Nan
الفراعنة	faraoni	Nan
الفرنسيين	francuski	None
الفروع	podružnice	Nan
الفريدة	jedinstven	None
الفقري	kralježnica	Nan
الفقه	nadležnost	Nan
الفقهاء	juristi	Nan
الفقهية	nadležnost	Nan
الفقيرة	jadno	Nan
الفقيه	faqih	Nan
الفكر	misao	None
الفكرة	ideja	None
الفكري	intelektualni	Nan
الفكرية	intelektualni	Nan
الفلاحين	seljaci	Nan
الفلاسفة	filozofi	None
الفلبين	filipini	None
الفلبينية	filipinski	Nan
الفلسطيني	palestinski	Nan
الفقراء	sirotinja	Nan
الفقر	siromaštvo	Nan
الفعلية	stvarni	None
الفعلي	stvarni	None
الفريق	tim	None
الفريقان	dve ekipe	Nan
الفريقين	dve ekipe	Nan
الفساد	korupcija	Nan
الفصائل	frakcije	Nan
الفصح	uskrs	None
الفصحى	klasična	None
الفاطمية	fatimidizam	Nan
الفصل	učionica	Nan
الفضائي	vanzemaljac	Nan
الفضائية	satelitski	Nan
الفضة	srebrna	Nan
الفضل	favor	Nan
الفطر	gljive	None
الفعالة	efektivno	Nan
الفعل	glagol	Nan
الفضاء	prostor	None
العرض	prikaz	None
العرش	prestol	Nan
العربية	arapski	None
الصحابة	pratioci	Nan
الصحابي	društvo	None
الصحاري	pustinje	None
الصحافة	štampu	Nan
الصحة	zdravlje	None
الصحراء	pustinja	None
الصحراوي	pustinja	None
الصحراوية	pustinja	None
الصحف	novine	None
الصحفي	novinar	None
الصحفيين	novinari	None
الصحية	zdravlje	None
الصحيح	tačno	None
الصخرة	kamen	None
الصخري	rocky	Nan
الصباح	jutro	None
الصخرية	rocky	Nan
الصالحة	pravedni	Nan
الصادق	iskrena	Nan
الشيخة	sheikha	Nan
الشيطان	zlo	None
الشيعة	shia	Nan
الشيعي	šiitski	Nan
الشيعية	šiitski	Nan
الشيوخ	starješine	Nan
الشيوعي	komunistička	None
الشيوعية	komunizam	Nan
الشيوعيين	komunisti	Nan
الصابئة	sabeans	Nan
الصابئي	sabean	Nan
الصابون	sapun	Nan
الصادر	odlazni	Nan
الصادرات	izvoz	None
الصادرة	izdato	Nan
الصالح	dobro	None
الشيخ	šeik	Nan
الصخور	stijene	None
الصدد	veza	None
الصفراء	žuto	None
الصفويين	safavidi	Nan
الصلاة	molitva	None
الصلال	skriva	Nan
الصلب	čelik	None
الصلبة	čvrsta	None
الصلة	link	Nan
الصلح	pomirenje	Nan
الصلوات	molitve	None
الصليب	križ	Nan
الصليبي	križar	Nan
الصليبية	križar	Nan
الصليبيون	križari	Nan
الصليبيين	križari	Nan
الصناعات	industrije	None
الصفر	nula	None
الصداقة	prijateljstvo	Nan
الصفحة	stranicu	Nan
الصفا	al safa	Nan
الصدر	grudi	Nan
الصدري	thoracic	Nan
الصديق	prijatelja	None
الصراع	sukob	None
الصراعات	sukobi	None
الصرب	srbi	None
الصرف	razmjena	None
الصعب	teško	None
الصعيد	gornji egipat	Nan
الصغار	mala djeca	Nan
الصغر	filigran	Nan
الصغرى	micro	Nan
الصغير	malo	None
الصغيرة	mala	None
الصف	klasa	None
الصفة	pridjev	None
الشيء	stvar	None
الشورى	shura	Nan
الشواطئ	plaže	Nan
الشبه	ličnost	None
الشتاء	zimi	None
الشجاعة	hrabrost	None
الشجرة	drvo	None
الشحنات	pošiljke	Nan
الشحنة	pošiljka	Nan
الشخص	osoba	None
الشخصي	profil	None
الشخصيات	likovi	None
الشخصية	lični	None
الشديد	ozbiljan	Nan
الشديدة	ozbiljan	Nan
الشذوذ	anomalies	Nan
الشر	zlo	None
الشرائية	kupovinom	Nan
الشبكة	mreža	None
الشرط	stanje	None
الشبكات	mreže	None
الشاي	čaj	Nan
الشأن	stvar je u tome	Nan
الشؤون	poslova	None
الشائع	često	None
الشائعة	često	None
الشابي	mladić	None
الشارع	ulica	None
الشاشة	ekran	Nan
الشاطئ	plaža	Nan
الشاعر	pjesnik	None
الشافعي	al šafij	Nan
الشام	šam	Nan
الشامل	misa	Nan
الشامي	shami	Nan
الشامية	levantinci	Nan
الشاه	šah	None
الشباب	mladi	None
الشرطة	policija	None
الشرعي	legitimno	Nan
الشرعية	legitimnost	Nan
الشك	sumnja	Nan
الشكل	oblik	None
الشكوك	sumnje	None
الشمال	sjever	None
الشمالي	sjeverno	None
الشمالية	sjever	None
الشمس	sunce	None
الشمسية	solarno	Nan
الشهادة	sertifikat	Nan
الشهداء	mučenici	Nan
الشهر	mjesec	None
الشهيد	mučenik	Nan
الشهير	poznat	None
الشهيرة	poznat	None
الشوارع	ulice	None
الشفاء	izlječenje	Nan
الشعور	osećam	Nan
الشعرية	rezanci	Nan
الشعراوي	shaarawy	Nan
الشرف	čast	None
الشرق	istok	None
الشرقي	istok	None
الشرقية	istočno	None
الشرك	politeizam	Nan
الشركات	kompanije	None
الشركة	kompanija	None
الصناعة	industrija	None
الشروط	uslovi	None
الشطرنج	šah	None
الشعار	logotip	Nan
الشعب	ljudi	None
الشعبي	folk	None
الشعبية	popularno	None
الشعر	kosa	None
الشعراء	pjesnici	None
الشريعة	islamskog prava	Nan
الصناعي	industrijski	None
الصناعية	industrijski	None
الصنع	napravljeno	Nan
العادل	fer	Nan
العادي	običan	Nan
العادية	redovno	None
العاشر	deseta	Nan
العاشرة	deseti	Nan
العاص	the aas	Nan
العاصمة	kapital	None
العالم	svijet	None
العالمي	globalno	Nan
العالمية	globalizam	Nan
العالمين	svjetovi	Nan
العالي	viši	None
العالية	visokog	None
العام	godina	None
العامة	javnost	None
العادة	navika	Nan
العامل	radnik	None
العادات	navike	Nan
العائلة	porodica	None
الطيب	dobro	None
الطيران	vazduhoplovstvo	Nan
الطيف	spektar	None
الطين	glina	None
الطيور	ptice	None
الظاهر	očigledno	Nan
الظاهرة	fenomen	None
الظاهري	virtualna	Nan
الظروف	okolnosti	None
الظلام	tama	Nan
الظلم	nepravde	Nan
الظهر	podne	None
الظهور	pojavljuju se	Nan
الظواهر	fenomena	Nan
العائلات	porodice	None
العابدين	vernici	Nan
العاملة	radno	Nan
العاملين	osoblje	Nan
العامية	vernacular	Nan
العدالة	pravda	Nan
العدد	broj	None
العدل	pravda	Nan
العدو	neprijatelja	None
العدوان	agresija	None
العدوى	infekcija	Nan
العديد	mnogi	None
العديدة	mnogobrojne	None
العذبة	svježe	Nan
العذراء	djevica	Nan
العراق	irak	Nan
العراقية	irački	Nan
العراقيين	iračani	Nan
العرب	arapi	None
العربي	arabi	Nan
العجز	impotencija	Nan
العثور	pronađi	Nan
العثمانيين	osmanlije	None
العثمانيون	osmanlije	None
العامّة	javnost	None
العباد	sluge	Nan
العبادات	obožavanje	Nan
العبادة	obožavanje	Nan
العبارة	fraza	Nan
العباس	abbas	Nan
العباسي	abbasid	Nan
الطويلة	dugo	None
العباسية	abbasid	Nan
العباسيين	abasidi	Nan
العبد	sluga	Nan
العبرية	hebrejski	Nan
العبودية	ropstvo	None
العبّاسية	abbasija	Nan
العثماني	otomanske	Nan
العثمانية	otomanske	Nan
العباسيون	abasidi	Nan
القتالية	borba	None
الطويل	duga	None
الطور	faza	None
الصينيين	kinezi	Nan
الضارة	štetno	Nan
الضباط	oficiri	Nan
الضحايا	žrtve	None
الضحية	žrtva	None
الضخم	ogromna	Nan
الضخمة	mega	Nan
الضرائب	porezi	None
الضربة	hit	None
الضروري	neophodnog	Nan
الضعف	slabost	Nan
الضغط	pritisak	None
الضغوط	pritisak	None
الضفة	banka	None
الضوء	svjetlo	None
الصينيون	kinezi	Nan
الضوئي	fotosinteza	None
الصينية	kinezi	Nan
الصين	kina	None
الصهيوني	cionistički	Nan
الصهيونية	cionizam	Nan
الصواريخ	rakete	Nan
الصوت	zvuk	None
الصوتية	sonic	Nan
الصور	slike	None
الصورة	image	Nan
الصوفية	sufizam	Nan
الصوم	post	None
الصومال	somalija	Nan
الصومالي	somalijski	Nan
الصومالية	somalijski	Nan
الصيد	lov	None
الصيف	ljeto	None
الصيفية	ljeto	None
الصيني	kinezi	Nan
الضوئية	semafor	Nan
الطائرات	avioni	None
الطائرة	avion	None
الطراز	stil	None
الطرف	party	Nan
الطرفين	dvije stranke	Nan
الطرق	putevi	None
الطريق	put	None
الطريقة	put	None
الطعام	hrana	None
الطفل	dete	Nan
الطفولة	djetinjstvo	None
الطقس	vrijeme	None
الطقوس	rituali	Nan
الطلاب	studenti	None
الطلب	potražnja	Nan
الطلبة	studenti	None
الطوائف	sekte	None
الطرائد	igra	None
الطبيعية	prirodno	None
الطبيعي	prirodno	None
الطبيعة	priroda	None
الطائف	taif	Nan
الطائفة	sekta	Nan
الطابع	lik	None
الطابق	pod	None
الطاعون	kuga	Nan
الطاقة	energije	None
الطالب	tražilac	Nan
الطول	dužina	None
الطب	lijek	None
الطباعة	štamparija	Nan
الطبري	al-tabari	Nan
الطبعة	izdanje	None
الطبقة	klasa	None
الطبي	medicinski	None
الطبيب	doktor	None
الطبية	medicinski	None
الطباشيري	krede	Nan
القتل	ubojstvo	Nan
القتلى	mrtvi	Nan
القدامى	starci	Nan
المدنيين	civili	Nan
المدونات	blogging	Nan
المدونة	blog	None
المدى	izraz	None
المديح	pohvale	Nan
المدير	menadžer	None
المدينة	grad	None
المذاهب	doktrine	Nan
المذكور	pominje se	Nan
المذكورة	pominje se	Nan
المذنبات	komete	None
المذهب	nominacija	Nan
المرء	neke svoje	Nan
المرأة	žena	None
المرئي	vidljivo	None
المدنية	civilna	Nan
المرابطين	almoravidi	Nan
المدني	civilna	Nan
المدفعية	artiljerija	Nan
المخصص	dodijeljen	Nan
المخصصة	dodeljeno	Nan
المخطط	shema	Nan
المخطوطات	rukopisi	Nan
المخلص	spasitelju	Nan
المخلوقات	stvorenja	Nan
المد	produžetak	Nan
المدارس	škole	None
المداري	orbitalno	Nan
المدارية	tropska	Nan
المدافع	topovi	Nan
المدة	trajanje	None
المدرب	trener	None
المدرسة	škola	None
المدرعة	oklopno vozilo	Nan
المدن	gradovima	None
المخرج	redatelja	Nan
المراجع	reference	None
المراد	biti	None
المركزي	centralni	None
المركزية	centralni	None
المرمى	cilj	None
المرور	saobraćaja	None
المريخ	mars	None
المريض	pacijent	Nan
المزارعون	poljoprivrednici	Nan
المزارعين	poljoprivrednici	Nan
المزروعة	kultivirano	Nan
المزيد	još	None
المسألة	stvar je u tome	Nan
المسؤول	administrator	Nan
المسؤولة	odgovorni	Nan
المسؤولية	odgovornost	None
المسؤولين	odgovorni	Nan
المركز	centar	None
المراحل	faze	None
المركبة	vozilo	Nan
المركب	čamac	Nan
المرافق	u pratnji	Nan
المراقبة	pazi	Nan
المراكز	centri	None
المرة	vreme	None
المرتبة	rang	None
المرتبط	povezano	None
المرتبطة	povezano sa	Nan
المرتفع	visokog	None
المرتفعات	gorje	None
المرتفعة	visokog	None
المرجانية	koralj	Nan
المرحلة	pozornica	Nan
المرشد	vođa	None
المرض	bolest	None
المرضى	pacijenti	Nan
المركبات	vozila	None
المخدرات	lijek	None
المختلفة	različite	None
المختصة	kompetentan	Nan
المثلثات	trouglice	Nan
المثلية	homeopatija	Nan
المثليين	homoseksualci	Nan
المجاعة	izgladnjivanje	Nan
المجال	polje	None
المجالات	domene	Nan
المجالس	savete	Nan
المجاهدين	mudžahidi	Nan
المجاورة	susjedstvo	Nan
المجتمع	društvo	None
المجتمعات	društva	None
المجر	mađarska	None
المجرات	galaksije	Nan
المجرة	galaksija	Nan
المجردة	goli	Nan
المثلث	trougao	None
المجري	mađarski	None
المثل	poslovica	Nan
المتوكل	al-mutawakkil	Nan
المتعددة	multiplayer	Nan
المتعلقة	srodni	Nan
المتقدم	napredno	Nan
المتقدمة	napredno	Nan
المتكاملة	integrisana	Nan
المتمثلة	zastupljeni	None
المتميزة	izvanredan	Nan
المتنبي	mutanabbi	Nan
المتنوعة	razno	Nan
المتواجدة	dostupno	Nan
المتوسط	prosječna	None
المتوسطة	srednja	None
المتوفرة	dostupno	Nan
المتوفى	smrt	None
المتوقع	očekivano	Nan
المثال	primjer	None
المجرية	mađarski	None
المجلات	časopisi	Nan
المجلة	časopis	Nan
المحطات	stanice	None
المحطة	stanica	None
المحكمة	sud	None
المحلة	mahalla	Nan
المحلي	lokalno	None
المحلية	lokalno	None
المحليين	lokalci	Nan
المحور	čvorište	Nan
المحيط	ocean	Nan
المحيطات	okeani	Nan
المحيطة	okolina	None
المخ	mozak	None
المخاطر	rizici	Nan
المخاوف	strahovi	Nan
المختار	izabranici	Nan
المحسن	poboljšana	Nan
المحركات	motori	Nan
المحرك	motora	None
المحرقة	holokaust	Nan
المجلس	vijeće	None
المجمع	kompleks	None
المجموع	ukupno	None
المجموعات	grupe	None
المجموعة	grupa	None
المجيد	slavna	Nan
المحاسبة	računovodstvo	None
المساء	večer	None
المحاصيل	usevi	Nan
المحافظة	governorate	Nan
المحاولات	pokušaji	None
المحاولة	probati	Nan
المحبة	ljubav	None
المحتلة	okupirani	Nan
المحتمل	vjerovatno	None
المحدودة	ltd.	Nan
المحافظات	provincije	None
المسائل	materije	None
المسابقات	takmičenja	None
المسابقة	konkurencija	Nan
المطلب	uslov	None
المطلة	obruč	None
المطلق	apsolut	Nan
المطلقة	razveden	Nan
المطلوب	obavezno	None
المطلوبة	obavezno	None
المطيرة	rainforest	Nan
المظاهرات	demonstracije	Nan
المظلمة	mračno	Nan
المعابد	hramovi	Nan
المعادن	minerali	None
المعادية	neprijateljski	Nan
المعارض	izložbe	None
المعارضة	opozicija	Nan
المعارضين	protivnici	None
المطر	kisa	Nan
المعارف	znanje	None
المطبخ	kuhinja	Nan
المطاعم	restorani	Nan
المصانع	fabrike	None
المصحف	koran	Nan
المصدر	izvor	None
المصري	egipatska	Nan
المصرية	egipatski	Nan
المصريون	egipćani	None
المصريين	egipćani	None
المصطلح	izraz	None
المصطلحات	terminologija	Nan
المضاد	kontra napad	Nan
المضادة	protivmere	Nan
المضيف	domaćin	None
المضيفة	domaćice	Nan
المطار	aerodrom	None
المطارات	zračne luke	Nan
المطاف	kraj	None
المعارك	borbe	None
المعاصر	savremeni	None
المعاصرة	savremeni	None
المعرفة	znanje	None
المعرفي	kognitivni	Nan
المعرفية	kognitivni	Nan
المعركة	bitka	None
المعروف	poznat	None
المعروفة	poznat	None
المعري	maari	Nan
المعز	koze	Nan
المعسكر	kamp	Nan
المعقدة	kompleks	None
المعلم	ucitelj	Nan
المعلمين	nastavnici	Nan
المعلومات	informacije	None
المعماري	arhitekta	None
المعمارية	arhitektonski	None
المعرض	emisija	Nan
المعدية	zarazno	Nan
المعدنية	mineralne	None
المعدلة	izmijenjeno	Nan
المعاصرين	savremenici	Nan
المعالم	prekretnice	Nan
المعاني	značenja	None
المعاهد	instituti	Nan
المعاهدات	ugovori	Nan
المعاهدة	ugovor	None
المعايير	standardi	None
المصالح	interesi	Nan
المعبد	hram	None
المعتزلة	mu&#39;tazilah	Nan
المعتقدات	verovanja	Nan
المعتمد	odobreno	Nan
المعتمدة	odobreno	Nan
المعدات	hardver	None
المعدة	stomach	Nan
المعدل	prosječna	None
المعتدل	umeren	Nan
المتعة	radost	Nan
المصارف	banke	None
المصاحف	koran	Nan
المستعمرة	kolonija	None
المستعملة	rabljeni	Nan
المستقبل	budućnost	None
المستقبلية	budućnost	None
المستقلة	nezavisna	None
المستمر	kontinuirano	Nan
المستمرة	uporni	Nan
المستوطنات	naselja	None
المستوى	nivo	None
المستويات	nivoi	Nan
المسجد	džamija	None
المسرح	pozorište	None
المسرحي	kazališni	Nan
المسرحيات	predstave	None
المسرحية	igra	None
المستعمرات	kolonije	None
المسلح	puškarac	Nan
المستشفيات	bolnice	Nan
المستشار	savjetnik	Nan
المساجد	džamije	None
المساحة	prostor	None
المساعدات	pomoć	None
المساعدة	pomoć	None
المسافات	udaljenosti	None
المسافة	razdaljina	Nan
المساكن	kućište	Nan
المساهمة	doprinos	None
المساواة	jednakost	None
المسبار	sonda	Nan
المسببة	uzrokuje	None
المستخدم	korisnika	None
المستخدمة	rabljeni	Nan
المستخدمين	korisnici	None
المستدامة	održiva	Nan
المستشفى	bolnica	None
المسلحة	naoružani	Nan
المسلسل	serija	None
المسلسلات	serija	None
المشركين	politeisti	Nan
المشروبات	piće	Nan
المشروع	projekat	None
المشروعات	projekti	None
المشعة	radioaktivno	Nan
المشكلات	problemi	None
المشكلة	problem	None
المشهد	scenu	None
المشهور	čuveni	None
المشهورة	poznat	None
المشهورين	poznat	None
المشير	feldmaršal	Nan
المصاب	ozlijeđeni	Nan
المصابة	inficiran	Nan
المصابين	ozlijeđeni	Nan
المشرفة	supervizor	Nan
المشتري	naručilac	Nan
المشترى	kupac	Nan
المشتركة	deljeno	Nan
المسلمة	postulat	Nan
المسلمون	muslimani	None
المسلمين	muslimani	None
المسمى	imenovana	Nan
المسيحي	hrišćanin	Nan
المسيحية	hrišćanstvo	Nan
المسيحيون	kršćani	None
المصادر	izvori	None
المسيحيين	kršćani	None
المشاركة	učestvujte	Nan
المشاركين	učesnici	Nan
المشاريع	projekti	None
المشاعر	osjecanja	Nan
المشاكل	problemi	None
المشاهد	gledalac	Nan
المشترك	pretplatnik	Nan
المشاة	pješaka	Nan
المعنية	zabrinuti	Nan
المتطورة	prednja ivica	Nan
المتزايد	raste	None
القومية	nacionalizam	Nan
القوى	ovlaštenja	Nan
القوي	jaki	Nan
القوية	strokiran	Nan
القيادة	liderstvo	Nan
القياس	analogija	Nan
القياسي	standardno	Nan
القياسية	standardno	Nan
القيام	predstava	Nan
القيامة	uskrsnuće	Nan
القيروان	kairouan	Nan
القيس	merenje	Nan
القيصر	cesar	Nan
القيم	vrijednost	None
القيمة	vrijednost	None
القومي	nacionalni	None
القيود	ograničenja	None
القوم	folk	None
القوقاز	kavkaz	None
القمح	pšenica	None
القمر	mjesec	None
القمرية	lunar	Nan
القمني	apikalno	Nan
القنابل	bombe	None
القناة	kanal	None
القنوات	kanali	None
القهري	komulzivan	Nan
القوائم	liste	None
القوات	sile	None
القواعد	pravila	None
القوافل	konvoji	Nan
القوانين	zakoni	None
القوس	luk	None
القوط	goti	Nan
القول	reći	None
القمة	vrh	None
الكأس	šolju	Nan
الكائنات	bića	None
الكثافة	gustina	None
الكثير	mnogo	None
الكثيرة	mnogi	None
الكثيرون	mnogi	None
الكثيرين	mnogi	None
الكثيفة	gusta	Nan
الكحول	alkohol	None
الكحولية	alkohol	None
الكذب	laže	Nan
الكرامة	dostojanstvo	Nan
الكربون	ugljik	None
الكردية	kurdski	Nan
الكرسي	stolica	Nan
الكرك	karak	Nan
الكريم	velikodušno	Nan
الكتلة	blok	None
الكائن	objekt	None
الكتل	blokovi	Nan
الكتابة	pisanje	None
الكاتب	pisac	None
الكاثوليكية	katolicizam	Nan
الكاريبي	karibi	Nan
الكافي	adekvatno	Nan
الكافية	adekvatno	Nan
الكامل	pun	None
الكاملة	pun	None
الكبار	odrasli	Nan
الكبد	jetra	None
الكبرى	odlično	Nan
الكبريت	sumpor	None
الكبير	odlično	Nan
الكبيرة	velika	None
الكتاب	knjiga	None
الكتابات	writings	Nan
الكتب	knjige	None
القماش	krpa	Nan
القليلة	nekolicina	Nan
القليل	malo	None
القران	kur&#39;an	Nan
القرشي	qurashi	Nan
القرص	disk	None
القرضاوي	al-qaradawi	Nan
القرم	krim	Nan
القرن	veka	Nan
القرنين	dva roga	Nan
القرون	pods	Nan
القرويين	seljani	Nan
القرى	sela	None
القريب	u blizini	Nan
القريبة	u blizini	Nan
القرية	selo	None
القزمة	patuljak	Nan
القسطنطينية	carigrad	None
القرارات	odluke	None
القسم	odjeljak	Nan
القرار	odluka	None
القراء	čitaoci	Nan
القدر	sudbina	None
القدرات	kapacitet	None
القدرة	sposobnost	None
القدس	jeruzalem	Nan
القدسي	al-qudsi	Nan
القدم	noga	Nan
القدماء	drevni	None
القديس	sveti	None
القديسين	sveci	Nan
القديم	staro	None
القذافي	gadafi	Nan
القذف	bacanje	None
القرآن	kur&#39;an	Nan
القرآني	kur&#39;an	Nan
القرآنية	kur&#39;an	Nan
القراءة	čitanje	None
القشرة	perut	Nan
القصبة	kasbah	Nan
القصة	priča	None
القطبية	polarni	Nan
القطبين	stubovi	Nan
القطر	prečnik	Nan
القطرية	država	None
القطط	mačke	Nan
القطع	rezanje	Nan
القطن	pamuk	None
القعدة	bazinost	Nan
القفز	skakanje	None
القلاع	dvorci	Nan
القلب	srce	None
القلبية	srdačan	Nan
القلعة	dvorac	None
القلق	anksioznost	Nan
القلوب	srca	None
القطبي	polarni	Nan
القطب	pol	Nan
القطاعات	sektori	Nan
القطاع	sektor	None
القصر	palata	Nan
القصص	priče	None
القصف	bombardovanje	Nan
القصور	nedostaci	Nan
القصوى	ekstremnost	Nan
القصيدة	pesma	Nan
القصيرة	kratko	None
الكريمة	graciozan	Nan
القضاء	eliminacija	Nan
القضائية	sudska	None
القضاة	sudije	None
القضايا	problemi	None
القضيب	penis	None
القضية	slučaj	None
القطار	voz	Nan
القطارات	vozovi	Nan
القضائي	sudska	None
الكسوف	eklipsa	Nan
الكعبة	kaaba	Nan
الكفاءة	efikasnost	None
المؤرخون	istoričari	Nan
المؤرخين	istoričari	Nan
المؤسس	osnivač	None
المؤسسات	institucije	None
المؤسسة	enterprise	Nan
المؤسسين	osnivači	Nan
المؤكد	izvesno	Nan
المؤلف	autor	None
المؤلفات	literatura	None
المؤمن	vjernik	None
المؤمنين	vjerni	Nan
المؤيدين	pristalice	Nan
المئات	stotine	None
الماء	voda	None
المائة	cent	Nan
المؤرخ	istoričara	Nan
المائدة	stol	Nan
المؤثرة	uticajno	Nan
المؤتمر	konferencija	Nan
اللواء	general bojnik	Nan
اللوحات	slike	None
اللوحة	odbor	None
اللون	boja	None
الليبرالية	liberalizam	Nan
الليبي	libijski	Nan
الليبية	libijski	Nan
الليزر	laser	Nan
الليل	noć	None
الليلة	večeras	Nan
الليمفاوية	limfa	None
اللَّهُ	allah	None
اللّه	allah	None
المأكولات	hrana	None
المأمون	siguran	Nan
المؤتمرات	konferencije	Nan
المائي	vodena	Nan
المائية	akvarel	Nan
المادة	predmet	None
المبدأ	princip	None
المبشرين	misionari	Nan
المبكر	rano	None
المبكرة	rano	None
المبنى	zgrada	None
المبيدات	pesticidi	Nan
المتاحة	dostupno	Nan
المتاحف	muzeji	None
المتبقية	preostali	Nan
المتجددة	obnovljivi	Nan
المتحدة	united	None
المتحدثين	zvučnici	Nan
المتحركة	animacija	None
المتحف	muzej	None
المتخصصة	specijalizirani	Nan
المباني	zgrade	None
المباشرة	direktno	None
المباشر	direktno	None
المباريات	utakmice	None
المادي	fizički	None
المادية	fizički	None
الماركسية	marksizam	Nan
الماسونية	slobodno zidarstvo	Nan
الماشية	stoka	Nan
الماضي	prošlost	None
الماضية	prošlost	None
اللهِ	allah	None
المال	novac	None
المالكي	al-maliki	Nan
المالي	finansijski	Nan
المالية	finansije	None
الماليزية	malezijski	Nan
المبادئ	principa	None
المبادرة	inicijativa	Nan
المباراة	utakmicu	None
المالكة	kraljevski	Nan
المتزايدة	raste	None
اللهم	o allahu	Nan
اللهجات	dijalekti	Nan
الكهربائية	električni	None
الكهربية	elektrofiziologija	Nan
الكهرومغناطيسية	elektromagnetizam	Nan
الكهنة	svećenici	Nan
الكهوف	pećine	None
الكوارث	katastrofe	Nan
الكواكب	planete	None
الكورية	korejski	Nan
الكوفة	kufa	Nan
الكوفي	kufi	Nan
الكوكب	planeta	None
الكومنولث	commonwealth	Nan
الكون	univerzum	Nan
الكونغرس	kongres	None
الكونغو	kongo	Nan
الكهربائي	elektroforeza	Nan
الكوني	kosmički	Nan
الكهرباء	struja	None
الكندية	kanadski	Nan
الكلاب	psi	Nan
الكلاسيكي	klasično	Nan
الكلاسيكية	klasično	Nan
الكلام	razgovarati	Nan
الكلمات	riječi	None
الكلمة	riječ	None
الكلي	bubrega	None
الكليات	fakulteti	Nan
الكلية	koledž	Nan
الكم	kvant	Nan
الكمال	savršenstvo	Nan
الكمبيوتر	kompjuter	Nan
الكمية	količina	None
الكنائس	crkve	None
الكندي	kanadski	Nan
الكنيسة	crkvu	None
الكونية	kosmički	Nan
الكويت	kuvajt	None
الكويتي	kuvajt	None
اللحظة	trenutak	None
اللحم	meso	None
اللحوم	meso	None
اللذان	szo	Nan
اللسان	jezik	None
اللطيف	slatka	Nan
اللعب	sviraj	Nan
اللعبة	igra	None
اللغات	jezici	None
اللغة	jezik	None
اللغوية	lingvistički	Nan
اللفظ	izgovor	None
اللقاء	sastanak	Nan
اللقب	naslov	None
الله	allah	None
اللجوء	potražiti utočište	Nan
اللجنة	komisija	None
اللبنانيين	libanonci	Nan
اللبنانية	libanonci	Nan
الكويتية	kuvajt	None
الكويكبات	asteroidi	Nan
الكيماوية	hemijski	None
الكيمياء	hemija	None
الكيميائي	hemičarka	Nan
الكيميائية	hemijski	None
اللاتيني	latinski	None
اللهجة	akcent	Nan
اللاتينية	latinski	None
اللاحقة	sufiks	Nan
اللاذقية	lattakia	Nan
اللازم	potrebno	None
اللازمة	potrebno	None
اللاعب	igrač	None
اللاعبين	igrači	None
اللبناني	libanonci	Nan
اللاجئين	izbeglice	Nan
يُمكن	može	None
