$	$	None
prvo	أول	None
prvobitno	في الأصل	Nan
prvog	الأول	None
prvoj	الأول	None
prvom	أول	None
prvu	الأول	None
psihologija	علم النفس	Nan
ptica	طائر	Nan
ptice	الطيور	None
public	عامة	None
publici	الجمهور	None
publika	الجمهور	None
publike	الجمهور	None
publiku	الجمهور	None
puca	يطلق النار	Nan
prvim	أول	None
prvih	أول	None
prvi	أول	None
prvenstvu	بطولة	None
prošlost	الماضي	None
prošlosti	من الماضي	Nan
prsten	حلقة	None
pruga	سكة حديدية	Nan
pruge	شرائط	Nan
pruska	بروسيا	None
pruskog	البروسي	Nan
puka	أطلق النار	Nan
pruža	يوفر	None
prva	أول	None
prvaci	ابطال	Nan
prvaka	بطل	None
prve	أول	None
prvenstva	البطولات	None
prvenstveno	بالدرجة الأولى	Nan
prvenstvo	بطولة	None
pružaju	تزود	Nan
prošlog	من الماضي	Nan
pukovnik	كولونيل	Nan
pumpa	مضخة	Nan
putu	الطريق	None
putuje	يسافر	Nan
puše	ضربات	Nan
pušenja	التدخين	None
pušenje	التدخين	None
puškin	بوشكين	Nan
px|a	بكسل | أ	Nan
p|pobjednik	ص | الفائز	Nan
p|prvak	ف | بطل	Nan
pčela	نحلة	Nan
pčelarstvo	تربية النحل	Nan
pčele	النحل	None
pčelinjak	المنحل	Nan
pšenica	قمح	Nan
q	س	None
putovanje	السفر	None
putovanja	السفر	None
putnici	ركاب	Nan
putne	السفر	None
pumpe	مضخات	Nan
pun	التورية	Nan
puna	ممتلئ	Nan
pune	بونة	Nan
punih	ممتلئ	Nan
punim	ممتلئ	Nan
punk	فاسق	Nan
puli	البلي	Nan
puno	كثير	None
pustinja	صحراء	None
pustinje	الصحارى	Nan
put	الطريق	None
puta	مرات	None
putem	الطريق	None
puteva	الطرق	None
putevi	الطرق	None
punu	ممتلئ	Nan
quad	رباعي	Nan
prošlo	تم الاجتياز بنجاح	Nan
proširio	موسع	Nan
prosječni	معدل	None
prosječno	معدل	None
prosječnom	معدل	None
prostirala	الانتشار	None
prostire	تمتد	None
prostor	الفراغ	None
prostora	الفراغ	None
prostore	الفراغ	None
prostori	مسافات	Nan
prostorima	مسافات	Nan
prostoru	الفراغ	None
proteina	بروتين	Nan
proteini	البروتينات	None
proteklih	الماضي	None
protestanti	البروتستانت	None
prosječne	معدل	None
prosječna	معدل	None
prosjeku	معدل	None
propisima	اللوائح	Nan
prometu	حركة المرور	Nan
promijenila	تغير	None
promijenio	تغير	None
promijeniti	للتغيير	Nan
promjena	يتغيرون	Nan
promjenama	التغييرات	None
promjene	التغييرات	None
protestantizam	البروتستانتية	None
promjenu	يتغيرون	Nan
pronaći	لايجاد	Nan
pronađen	وجدت	None
pronađena	وجدت	None
pronađene	وجدت	None
pronađeni	وجدت	None
propast	هاوية	Nan
propasti	الموت	None
pronalazi	يجد	None
prošla	تم الاجتياز بنجاح	Nan
proteže	تمتد	None
protivnici	المعارضين	None
provincije	المحافظات	None
provinciji	المحافظة	None
provjera	التحقق من	Nan
provjere	الفحوصات	Nan
provodi	تجري	None
provođenje	التنفيذ	None
proza	نثر	Nan
prozi	نثر	Nan
prozor	نافذة او شباك	Nan
proći	البشري	None
prođe	يمر، يمرر، اجتاز بنجاح	Nan
prošao	تم الاجتياز بنجاح	Nan
proširenja	ملحقات	Nan
proširenje	توسيع	None
proširila	موسع	Nan
provincijama	المحافظات	None
provincija	المحافظة	None
proveo	أنفق	Nan
provela	أنفق	Nan
protivnik	الخصم	None
protivnika	الخصم	None
protivnički	عدائية	Nan
protivničkog	العدو	None
protivnom	غير ذلك	Nan
protiče	يطفو	Nan
protjerani	طرد	None
protiv	ضد	None
protok	تدفق	None
protokola	بروتوكول	None
protokoli	البروتوكولات	None
proučava	دراسات	None
proučavaju	دراسة	Nan
proučavanja	دراسات	None
proučavanje	دراسة	Nan
proučavanjem	بالدراسة	Nan
protokol	بروتوكول	None
queen	ملكة	None
queena	الملكة	None
quichémam	كيشمام	Nan
ravnomjerno	بالتساوي	Nan
ravnopravnost	المساواة	None
razaranja	تدمير	None
razdoblja	فترات	None
razdoblje	فترة	None
razdoblju	فترة	None
razdvajanja	انفصال	None
razdvajanje	انفصال	None
razgovor	محادثة	Nan
razgovora	محادثة	Nan
razini	مستوى	None
razlika	فرق	None
razlikama	اختلافات	None
razlike	اختلافات	None
razlikovanje	التفاضل	Nan
ravno	مستقيم	Nan
ravnice	السهول	None
ravnica	عادي	None
ravni	مستوى	None
ratna	الحرب	None
ratne	الحرب	None
ratni	الحرب	None
ratnici	المحاربون	Nan
ratnih	الحرب	None
ratnim	الحرب	None
ratnog	الحرب	None
razlikovati	يميز	None
ratom	الحرب	None
ratovanja	الحرب	None
ratove	الحروب	None
ratovi	الحروب	None
ratovima	الحروب	None
ratu	الحرب	None
ravan	مسطحة	Nan
ravna	مسطحة	Nan
ratova	الحروب	None
ratko	راتكو	Nan
razliku	فرق	None
razlikujemo	نحن نفرق	Nan
razni	مختلف	None
raznih	مختلف	None
raznim	مختلف	None
razuma	العقل	None
razumijevanja	فهم	None
razumijevanje	فهم	None
razumjeti	لفهم	None
razvija	المتقدمة	None
razvijaju	طور	None
razvijala	المتقدمة	None
razvijao	المتقدمة	None
razvijati	طور	None
razvije	يتطور	Nan
razvijen	المتقدمة	None
razvijena	المتقدمة	None
razne	مختلف	None
razna	مختلف	None
razmnožavanje	التكاثر	None
razmjera	مقياس	None
razlikuju	اختلف	Nan
različit	مختلف	None
različita	مختلف	None
različite	مختلف	None
različiti	مختلف	None
različitih	مختلف	None
različitim	مختلف	None
razlikuje	يختلف	None
različito	مختلف	None
različitu	مختلف	None
razlog	السبب	None
razloga	أسباب	None
razlozi	أسباب	None
razmišljanja	تفكير	Nan
razmjena	تبادل	None
razmjenu	تبادل	None
različitog	مختلف	None
rata	الحرب	None
rat	الحرب	None
rastvor	المحلول	Nan
radne	يعمل	None
radnici	عمال	None
radnik	عامل	None
radnika	عمال	None
radnički	يعمل	None
radnja	عمل	None
radnje	أجراءات	Nan
radnju	عمل	None
rado	بكل سرور	Nan
radom	عمل	None
radova	يعمل	None
radove	يعمل	None
radovi	يعمل	None
radovima	يعمل	None
radu	عمل	None
radna	يعمل	None
raditi	للعمل	None
radiotelevizije	الإذاعة والتلفزيون	Nan
radio	مذياع	Nan
quijote	quijote	Nan
r	ص	None
ra	را	Nan
rad	عمل	None
rada	عمل	None
rade	عمل	None
radi	يعمل	None
rafinerija	مصفاة	Nan
radija	مذياع	Nan
radijan	راديان	Nan
radije	بدلا	None
radijski	مذياع	Nan
radila	عمل	None
radili	عمل	None
radilice	أعمدة الكرنك	Nan
radilo	عمل	None
radijallahu	radijallahu	Nan
ragbi	كرة القدم الامريكية	Nan
raj	الجنة	None
raja	الجنة	None
raspad	تسوس	Nan
raspada	تسوس	Nan
raspadom	تسوس	Nan
raspolaže	يتصرف	Nan
raspoloženja	مزاج	Nan
raspored	جدول	None
rasprava	نقاش	Nan
rase	سباق	None
rasprave	مناقشات	Nan
rast	نمو	None
rasta	الراستا	Nan
rastao	نمت	None
raste	ينمو	Nan
rastom	نمو	None
rastu	تنمو	None
rastvara	يذوب	Nan
rasprostranjenost	انتشار	None
prometijum	بروميثيوم	Nan
rasa	سباق	None
ranog	مبكرا	Nan
rak	سرطان	None
raka	سرطان	None
ram	الرامات &quot;الذاكرة العشوائية في الهواتف والحواسيب	Nan
rama	الإطار	None
ramazan	رمضان	None
ramazana	رمضان	None
rana	جرح	Nan
ranom	مبكرا	Nan
rane	الجروح	Nan
rani	مبكرا	Nan
ranih	مبكرا	Nan
ranije	سابقا	None
ranim	مبكرا	Nan
ranjen	الجرحى	Nan
ranko	رانكو	Nan
rano	مبكرا	Nan
rang	مرتبة	None
razvijene	المتقدمة	None
prometa	حركة المرور	Nan
proljeće	ربيع	None
priključuje	يربط	None
prilika	فرصة	None
prilikama	الفرص	Nan
prilike	الفرص	Nan
prilikom	مناسبات	Nan
priliku	فرصة	None
prilično	جميلة	None
prilog	المرفق	Nan
prilozi	المرفقات	Nan
prima	بريما	Nan
primaju	لقد إستلموا	Nan
primarna	ابتدائي	Nan
primarne	ابتدائي	Nan
primarni	ابتدائي	Nan
primarno	بالدرجة الأولى	Nan
prikazuju	تبين	None
prikazuje	يعرض	None
prikazu	عرض	None
prikazivanje	تظهر	None
prije	قبل	None
prijedlog	اقتراح	None
prijedor	بريجدور	Nan
prijenos	الانتقال	None
prijestolje	عرش	None
prijestolnica	العاصمة	None
prijetnjom	التهديد	Nan
primio	تم الاستلام	Nan
prijetnju	التهديد	Nan
prijevoz	وسائل النقل	Nan
prikaz	عرض	None
prikaza	عرض	None
prikazan	يظهر	None
prikazana	يظهر	None
prikazati	ليعرض	Nan
prikazivanja	تظهر	None
prijevod	ترجمة	None
prijateljstva	الصداقات	Nan
primirja	هدنة	None
primitivizam	بدائية	Nan
principa	المبدأ	None
principe	مبادئ	None
principi	مبادئ	None
principima	مبادئ	None
principu	المبدأ	None
print	طباعة	Nan
pripada	ينتمي إلى	Nan
pripadaju	تنتمي	None
pripadala	ينتمي	None
pripadali	ينتمي	None
pripadalo	ينتمي	None
pripadao	ينتمي	None
pripadnici	أفراد	None
pripadnik	عضو	Nan
pripadnika	أفراد	None
princip	المبدأ	None
princeze	أميرة	Nan
princeza	أميرة	Nan
princ	أمير	None
primjena	تطبيق	None
primjene	تطبيق	None
primjeni	تطبيق	None
primjenjuje	ينطبق	None
primjenjuju	تطبيق	None
primjenu	تطبيق	None
primjer	مثال	None
primirje	هدنة	None
primjera	أمثلة	None
primjeri	أمثلة	None
primjerice	فمثلا	None
primjeru	مثال	None
primjećuje	ملاحظات	None
primorje	ساحل	None
primorju	ساحل	None
primus	بريموس	Nan
primjeraka	نسخ	None
pripadnost	الانتماء	Nan
prijatelji	اصحاب	Nan
prijatelj	صديق	None
preradu	معالجة	None
preselio	انتقل	None
preskok	تخطى	Nan
press	صحافة	Nan
prestaje	توقف	None
prestala	توقفت	Nan
prestanka	نهاية	None
pretežito	خاصة	None
pretežno	خاصة	None
prethodne	السابق	None
prethodnim	السابق	None
prethodno	سابقا	None
prethodnog	السابق	None
pretpostavke	الافتراضات	Nan
pretpostavlja	يفترض	None
prerade	معالجة	None
prerada	معالجة	None
prepoznatljivi	معترف بها	Nan
prepoznatljive	معترف بها	Nan
prelaze	تعبر	None
prelazi	الصلبان	Nan
prema	بالنسبة الى	Nan
premda	برغم من	Nan
premijer	الوزير الأول	Nan
premijera	الوزير الأول	Nan
preminuo	وافته المنية	Nan
pretraživači	محركات البحث	Nan
prenos	الانتقال	None
prenose	نقل	None
prenosi	التحويلات	Nan
preovladava	يسود	None
preovladavaju	تسود	Nan
preporod	ولادة جديدة	Nan
prepoznaje	يعترف	None
prepoznatljiv	معترف بها	Nan
prenosa	الانتقال	None
prijatelja	اصحاب	Nan
pretvara	يتحول	None
preuzeo	تولى	None
pridružile	انضم	None
pridružio	انضم	None
pridružuje	ينضم	Nan
prihoda	الإيرادات	Nan
prihode	الإيرادات	Nan
prihodi	الإيرادات	Nan
prihvata	يقبل	None
prihvataju	قبول	None
prihvatanje	قبول	None
prihvati	قبول	None
prihvatili	قبلت	Nan
prihvatio	قبلت	Nan
prihvatiti	لقبول	Nan
prihvaćen	قبلت	Nan
prihvaćena	قبلت	Nan
pridjev	الصفة	None
približno	تقريبا	None
približava	يقترب	Nan
pri	في	None
preuzima	يستحوذ على	Nan
preuzimanja	التحميلات	Nan
prevashodno	بالدرجة الأولى	Nan
previše	كثير جدا	Nan
prevladava	يسود	None
prevlast	السيادة	None
prevodi	الترجمات	None
pretvaraju	يحولون	Nan
prezentacija	عرض	None
preći	لكي اعبر	Nan
prečnika	قطر الدائرة	Nan
pređe	غزل	Nan
prešao	عبرت	Nan
prešla	عبرت	Nan
prešli	عبرت	Nan
preživjeli	الناجون	Nan
prezime	الكنية	Nan
pripadnosti	الانتماء	Nan
pripaja	تعلق	Nan
pripisuje	الصفات	Nan
produkciju	إنتاج	None
produkt	المنتج	None
prof	أستاذ	None
profesor	دكتور جامعى	Nan
profil	الملف الشخصي	Nan
proglasili	أعلن	None
proglasio	أعلن	None
proglašava	يعلن	None
proglašen	أعلن	None
proglašena	أعلن	None
proglašenja	الإعلانات	None
proglašenje	إعلان	None
program	برنامج	None
programa	برنامج	None
programe	برامج	Nan
produkcije	إنتاجات	Nan
produkcija	إنتاج	None
producent	منتج	None
prodati	للبيع	Nan
proces	معالجة	None
procesa	معالجة	None
procese	العمليات	None
procesi	العمليات	None
procesima	العمليات	None
procesor	المعالج	Nan
procesora	المعالج	Nan
programer	مبرمج	Nan
procesu	معالجة	None
procjene	التقديرات	None
procjeni	تقدير	None
procjenjuje	التقديرات	None
prodaja	مبيعات	None
prodaje	مبيعات	None
prodaju	تخفيض السعر	Nan
prodat	للبيع	Nan
procjenama	التقديرات	None
procenat	النسبة المئوية	Nan
programi	برامج	Nan
programiranja	برمجة	Nan
proizvodnog	إنتاج	None
proizvođač	الصانع	Nan
proizvođača	الصانع	Nan
proizvođači	الشركات المصنعة	Nan
projekat	مشروع	None
projekata	مشاريع	None
projekt	مشروع	None
projekta	مشروع	None
projekti	مشاريع	None
projektu	مشروع	None
prokurativama	النيابات	Nan
prolaz	الممر	Nan
prolaze	البشري	None
prolazi	يمر، يمرر، اجتاز بنجاح	Nan
proljeća	ربيع	None
proizvodnju	إنتاج	None
proizvodnjom	إنتاج	None
proizvodnji	إنتاج	None
proizvodnje	إنتاج	None
programiranje	برمجة	Nan
programski	برمجيا	Nan
programskih	البرمجيات	None
programskog	البرمجيات	None
programskom	البرمجيات	None
programu	برنامج	None
proizlazi	ينشأ	None
programima	برامج	Nan
proizvod	المنتج	None
proizvode	منتجات	None
proizvodi	منتجات	None
proizvodima	منتجات	None
proizvoditi	ينتج	None
proizvodni	إنتاج	None
proizvodnih	إنتاج	None
proizvodnja	إنتاج	None
proizvoda	المنتج	None
problemima	مشاكل	None
problemi	مشاكل	None
probleme	مشاكل	None
prisustva	حضور	None
prisustvo	حضور	None
prisustvu	حضور	None
prisutan	حاضر	Nan
prisutna	حاضر	Nan
prisutne	حاضر	Nan
prisutni	حاضر	Nan
prisutno	حاضر	Nan
prisutnost	حضور	None
prisutnosti	حضور	None
pritisak	الضغط	None
pritiska	الضغط	None
pritiskom	عن طريق الضغط	Nan
pritisku	الضغط	None
pritoke	الروافد	Nan
pristupa	التمكن من	Nan
pristup	التمكن من	Nan
prisilio	قسري	Nan
prirodu	طبيعة	None
pripovijetke	قصص	None
priprema	تجهيز	None
pripremaju	إعداد	None
pripreme	الاستعدادات	Nan
pripremu	تجهيز	None
priroda	طبيعة	None
prirode	من الطبيعة	Nan
pritom	للقيام بذلك	Nan
prirodi	طبيعة	None
prirodne	طبيعي &gt;&gt; صفة	Nan
prirodni	طبيعي &gt;&gt; صفة	Nan
prirodnih	طبيعي &gt;&gt; صفة	Nan
prirodnim	طبيعي &gt;&gt; صفة	Nan
prirodno	بطبيعة الحال	Nan
prirodnog	طبيعي &gt;&gt; صفة	Nan
prirodnu	طبيعي &gt;&gt; صفة	Nan
prirodna	طبيعي &gt;&gt; صفة	Nan
privatna	نشر	None
privatne	نشر	None
privatni	نشر	None
priznanja	التعرف على	Nan
priznanje	التعرف على	Nan
priznao	اعترف	None
priznat	معروف	None
priznata	معروف	None
priznati	ليعترف	Nan
priznavanje	التعرف على	Nan
priznala	اعترف	None
priča	قصة	None
priču	قصة	None
priština	بريشتينا	Nan
pro	طليعة	Nan
probavni	الجهاز الهضمي	Nan
probavnom	الجهاز الهضمي	Nan
problem	مشكلة	None
problema	مشاكل	None
priče	قصص	None
promet	حركة المرور	Nan
priznaju	يعترفون	Nan
privređivanja	اعمال	Nan
privatnih	نشر	None
privatno	بشكل خاص	Nan
privatnog	نشر	None
privreda	الاقتصاد	None
privrede	الاقتصاد	None
privredi	الاقتصاد	None
privredna	اقتصادية	None
priznaje	يعترف	None
privredne	اقتصادية	None
privrednih	اقتصادية	None
privrednim	اقتصادية	None
privredno	من الناحية الاقتصادية	Nan
privrednog	اقتصادية	None
privrednom	اقتصادية	None
privredu	الاقتصاد	None
privremeno	مؤقتا	Nan
privredni	اقتصادية	None
prelazak	انتقال	None
razvijeni	المتقدمة	None
razvijeno	المتقدمة	None
see	نرى	None
segmentima	شرائح	Nan
seid	صيد	None
seine	له	None
sejo	جلسة	None
sekretar	سكرتير	Nan
seks	الجنس	None
seksualne	جنسي	None
seksualno	جنسيا	Nan
seksualnog	جنسي	None
seksualnu	جنسي	None
sekte	القسم	None
sektor	قطاع	None
sektora	قطاع	None
sektoru	قطاع	None
sedmice	أسابيع	None
sedmica	أسبوع	None
sedamdesetih	السبعينات	None
sedam	سبعة	None
savremenom	مع الوقت	Nan
savu	سافو	Nan
saznanja	المعرفه	Nan
sačinjavaju	ميك أب	Nan
sačuvati	للحفاظ على	Nan
saša	ساشا	Nan
scenario	سيناريو	Nan
sekundarne	ثانوي	Nan
scene	مشهد	None
scenu	مشهد	None
sda	sda	Nan
sds	sds	Nan
se	حد ذاته	Nan
sead	أرسل	None
sebe	نفسي	None
sebi	نفسي	None
sceni	مشهد	None
savremenoj	عصري	Nan
sekundarni	ثانوي	Nan
sela	القرى	None
septembru	سبتمبر	None
sergei	سيرجي	Nan
sergej	سيرجي	Nan
sergio	سيرجيو	Nan
serija	سلسلة	None
serije	سلسلة	None
seriji	سلسلة	None
seriju	سلسلة	None
server	الخادم	Nan
servera	الخادم	Nan
servis	الخدمات	None
servisa	الخدمات	None
sestra	أخت	None
sestre	أخوات	Nan
sestrom	أخت	None
septembra	سبتمبر	None
seoski	قروي	Nan
seobe	الهجرة	None
senatu	مجلس الشيوخ	Nan
selen	السيلينيوم	Nan
selena	السيلينيوم	Nan
seli	سيلي	Nan
selima	سليمة	Nan
selimović	سليموفيتش	Nan
seljaka	الفلاحين	None
sellem	sellem	Nan
sekundi	ثواني	Nan
selo	قرية	None
sem	نصف	None
semantika	دلالات	Nan
semberije	semberije	Nan
semir	نصف	None
senad	سيناد	Nan
senat	مجلس الشيوخ	Nan
senata	مجلس الشيوخ	Nan
selu	القرية	None
sestru	أخت	None
savremenog	معاصر	Nan
savremenim	عصري	Nan
saradnje	تعاون	None
saradnji	تعاون	None
saradnju	تعاون	None
sarajeva	سراييفو	Nan
sarajevo	سراييفو	Nan
sarajevska	سراييفو	Nan
sarajevske	سراييفو	Nan
sarajevski	سراييفو	Nan
sarajevskim	سراييفو	Nan
sarajevskog	سراييفو	Nan
sarajevskoj	سراييفو	Nan
sarajevskom	سراييفو	Nan
sarajevu	سراييفو	Nan
sastanku	لقاء	None
sastav	تكوين	None
saradnja	تعاون	None
saobraćaja	حركة المرور	Nan
saobraćaj	حركة المرور	Nan
sanskog	سانسكوج	Nan
samog	نفسه	None
samoj	معظم	None
samom	نفسه	None
samostalne	مستقل	None
samostalnih	مستقل	None
samostalno	بشكل مستقل	Nan
samostan	ديرصومعة	Nan
sastava	تكوين	None
samoubistvo	انتحار	Nan
san	سان	None
sana	صنعاء	Nan
sandžak	sandzak	Nan
sandžaka	سنجق	Nan
sandžaku	sandzak	Nan
sane	عاقل	Nan
sanski	السنسكريتية	Nan
samu	وحده	None
savremeno	عصري	Nan
sastavljen	تتكون	None
sastavni	المقوم، مكون، جزء من	Nan
saveza	تحالف	None
savezna	اتحادي	Nan
savezne	اتحادي	Nan
saveznici	حلفاء	Nan
saveznih	اتحادي	Nan
saveznika	حلفاء	Nan
savezu	تحالف	None
savi	سافى	Nan
savjet	النصيحة	Nan
savjeta	نصائح	Nan
savjetnika	مستشار	Nan
savremena	معاصر	Nan
savremene	معاصر	Nan
savremeni	معاصر	Nan
savremenih	معاصر	Nan
savez	تحالف	None
save	حفظ	None
sava	سافا	Nan
sav	حفظ	None
sastavu	تكوين	None
sastojak	المكونات	None
sastojaka	مكونات	None
sastojala	يتألف	None
sastojao	يتكون من	Nan
sastoje	تتكون	None
sastoji	تتكون من	Nan
sastavljena	تتكون	None
sasvim	الى حد كبير	Nan
sata	ساعات	None
satelit	الأقمار الصناعية	Nan
sateliti	الأقمار الصناعية	Nan
sati	ساعات	None
saudijska	سعودي	None
saudijske	سعودي	None
saudijskoj	سعودي	None
sat	جلس	Nan
set	جلس	Nan
sevdah	سيفده	Nan
sevdalinka	سيفدالينكا	Nan
sjeverozapadnom	الشمال الغربي	Nan
sjeverozapadu	الشمال الغربي	Nan
sjeveru	شمال	None
sjećanja	ذكريات	Nan
skadar	سكادار	Nan
skakanje	القفز	None
skalari	العددية	Nan
skandijum	سكانديوم	None
skender	سكندر	Nan
skladu	في النسق	Nan
sklapanje	المجسم	Nan
skloništa	الملاجئ	Nan
sklonište	مأوى	Nan
sklonost	ميل	None
sklopiti	لتجميع	Nan
sjeveroistočnom	شمال شرق	Nan
sjeveroistočnoj	شمال شرق	Nan
sjeveroistočne	شمال شرق	Nan
sjeveroistoku	شمال شرق	Nan
sjedištem	مقر	None
sjemenke	بذور	Nan
sjenica	شرفة	Nan
sjever	شمال	None
sjevera	شمال	None
sjeverna	شمال	None
sjeverne	شمالي	None
sklopovi	جمعيات	Nan
sjeverni	شمالي	None
sjevernije	الشمال البعيد	Nan
sjevernim	شمالي	None
sjeverno	شمال	None
sjevernog	شمالي	None
sjevernoj	شمالي	None
sjevernom	شمال	None
sjevernu	شمال	None
sjevernih	شمالي	None
sjedište	مقر	None
sklopu	المجسم	Nan
skoro	هكذا	None
slavenska	السلافية	Nan
slavenske	السلافية	Nan
slavenski	السلافية	Nan
slavenskih	السلافية	Nan
slavi	يحتفل	None
slavu	مجد	Nan
slažu	يوافق على	Nan
slici	صور	None
slijede	إتبع	Nan
slijedeća	التالى	Nan
slijedeće	ما يلي	Nan
slijedeći	التالى	Nan
slijedećih	ما يلي	Nan
slijedećim	التالى	Nan
slijedi	يتبع	None
slaveni	السلاف	Nan
slavena	مشهور	None
slave	مجد	Nan
slanje	إرسال	None
skraćenica	اختصار	Nan
skraćeno	اختصار	Nan
skreće	يتحول	None
skup	مكلفة	Nan
skupa	مكلفة	Nan
skupine	مجموعات	None
skupština	المجسم	Nan
skoplje	سكوبي	Nan
skupštine	المجسم	Nan
sl	تين	Nan
slab	ضعيف	None
slabe	ضعيف	None
slabi	ضعيف	None
slabije	أضعف	Nan
slabo	ضعيف	None
slam	ضربة عنيفة	Nan
skupštinu	المجسم	Nan
sjedišta	المقاعد	None
sjedinjenim	متحد	Nan
sjedinjenih	متحد	Nan
sidran	مرساة	Nan
signal	الإشارة	Nan
signala	الإشارة	Nan
signale	إشارات	None
sigurni	بالتأكيد	Nan
sigurno	بالتأكيد	Nan
sigurnost	الأمان	None
sigurnosti	الأمان	None
sigurnošću	الأمان	None
sila	فرض	None
silama	القوات	None
sile	القوات	None
silu	فرض	None
simbol	رمز	Nan
simbola	رمز	Nan
sida	جانب	None
si	سي	None
shvatiti	لفهم	None
shvatanje	فهم	None
sevdalinke	سيفدالينك	Nan
sevdalinki	سيفدالينكي	Nan
severina	سيفينا	Nan
sex	الجنس	None
sezona	الموسم	None
sezone	الموسم	None
sezoni	الموسم	None
simboli	حرف او رمز	Nan
sezonu	الموسم	None
sfera	جسم كروى	Nan
sfrj	سفرج	Nan
shakespeare	شكسبير	Nan
shizofrenija	فصام	Nan
shodno	وبالمثل	None
shs	shs	Nan
shvatanja	التصورات	Nan
seže	يصل	None
simptoma	الأعراض	None
simptomi	الأعراض	None
sin	ابن	None
sistem	النظام	None
sistema	النظام	None
sistematski	بشكل منهجي	Nan
sisteme	أنظمة	None
sistemi	أنظمة	None
sistemima	أنظمة	None
sistemom	النظام	None
sisari	الثدييات	None
sistemu	النظام	None
situacija	موقف	None
situacijama	مواقف	None
situacije	مواقف	None
situaciji	موقف	None
situaciju	موقف	None
sive	اللون الرمادي	Nan
sjedinjene	متحد	Nan
site	موقع	None
samoa	ساموا	Nan
sisara	الحيوان الثديي	Nan
sirovina	مواد خام	Nan
sina	ابن	None
sinan	سنان	None
sindbad	سندباد	Nan
sindrom	متلازمة	Nan
singl	غير مرتبطة	Nan
singlovi	الفردي	None
sinonim	مرادف	Nan
sirovine	مواد أولية	Nan
sinova	أبناء	None
sinteza	نتيجة الجمع بين الطريحة والنقيضة	Nan
sintezu	نتيجة الجمع بين الطريحة والنقيضة	Nan
sinus	التجويف	Nan
sir	سيدي المحترم	Nan
sira	جبنه	Nan
sirije	سوريا	None
sirište	المنفحة	Nan
sintaksa	بناء الجملة	Nan
razvijenim	المتقدمة	None
samo	فقط	None
samim	وحده	None
reprezentativac	لاعب المنتخب الوطني	Nan
reproduktivni	الإنجابية	Nan
republici	جمهورية	None
republika	جمهورية	None
republike	جمهورية	None
republikom	جمهورية	None
republiku	جمهورية	None
republičkog	جمهوري	None
resursa	مصادر	None
resurse	مصادر	None
resursi	مصادر	None
resursima	مصادر	None
reunion	جمع شمل	Nan
revolucija	ثورة	None
revolucije	ثورة	None
reprezentaciju	الفريق الوطني	Nan
reprezentacije	المنتخبات الوطنية	Nan
reprezentacija	التمثيل	None
repa	لفت نبات	Nan
rekao	قال	None
rekli	قالوا	None
rekord	سجل	None
relativno	نسبيا	None
relativnosti	النسبية	None
relevantni	ذو صلة	Nan
religija	دين	None
revoluciju	ثورة	None
religije	دين	None
religiju	دين	None
reljef	ارتياح	Nan
reljefa	ارتياح	Nan
rem	rem	Nan
renesanse	عصر النهضة	Nan
renijum	الرينيوم	Nan
rep	اعادة \ عد	Nan
religiji	دين	None
reiki	الريكي	Nan
revolucionarne	ثوري	Nan
rezolucija	الدقة	None
rijeci	كلمات	None
rijeka	نهر	None
rijekama	الأنهار	None
rijeke	الأنهار	None
rijekom	بجوار النهر	Nan
rijeku	النهر	None
rijetka	نادر	Nan
rijetke	نادر	Nan
rijetki	نادر	Nan
rijetkih	نادر	Nan
rijetko	نادرا	Nan
riječ	كلمة	None
riječi	كلمات	None
riječima	بكلمات	Nan
riječna	نهر	None
richard	ريتشارد	None
ribozom	الريبوسوم	Nan
ribom	سمك	None
ribolov	صيد السمك	Nan
rezoluciju	الدقة	None
rezonanca	صدى	Nan
rezultat	نتيجة	None
rezultata	النتائج	None
rezultate	النتائج	None
rezultati	النتائج	None
rezultatom	النتائج	None
rezerve	محميات	Nan
rezultiralo	أسفرت	None
rečenica	جملة او حكم على	Nan
rečenice	جمل	Nan
rečeno	قال	None
režim	الوضع	None
režiser	مخرج	Nan
riba	سمك	None
ribe	سمك	None
reći	ليقول	Nan
riječne	نهر	None
reguliše	ينظم	None
regionalnim	إقليمي	Nan
računarom	الحاسوب	None
računarska	الحاسوب	None
računarske	الحاسوب	None
računarski	الحاسوب	None
računarskih	الحاسوب	None
računarskog	الحاسوب	None
računarstva	الحوسبة	Nan
računarstvo	الحوسبة	Nan
računaru	الحاسوب	None
računovodstva	محاسبة	None
računovodstvo	محاسبة	None
rbih	ربيح	Nan
reaguje	يتفاعل	Nan
reaguju	تتفاعل	Nan
reakcija	رد فعل	Nan
računarima	أجهزة الكمبيوتر	Nan
računari	أجهزة الكمبيوتر	Nan
računara	الحاسوب	None
računar	الحاسوب	None
razvijenom	المتقدمة	None
razvila	المتقدمة	None
razvili	المتقدمة	None
razvilo	المتقدمة	None
razvio	المتقدمة	None
razvitak	تطوير	None
razvitka	تطوير	None
reakcijama	تفاعلات	None
razvod	الطلاق	Nan
razvoja	تطوير	None
razvojem	تطوير	None
razvoju	تطوير	None
račun	الحساب	None
računa	الحساب	None
računanja	العمليات الحسابية	Nan
računanje	عملية حسابية	Nan
razvoj	تطوير	None
regionu	منطقة	None
reakcije	تفاعلات	None
reakciju	رد فعل	Nan
reflektuje	يعكس	None
reforma	اعادة تشكيل	Nan
reforme	الإصلاحات	None
reformi	اعادة تشكيل	Nan
regija	منطقة	None
regije	المناطق	None
regiji	منطقة	None
regiju	منطقة	None
regiment	فوج	Nan
region	منطقة	None
regiona	منطقة	None
regionalna	إقليمي	Nan
regionalne	إقليمي	Nan
regionalni	إقليمي	Nan
regionalnih	إقليمي	Nan
refleksi	ردود الفعل	Nan
refleksa	لا ارادي	Nan
refleks	لا ارادي	Nan
referendumu	استفتاء	None
receptor	مستقبلات	Nan
recimo	دعنا نقول	Nan
red	أحمر	None
reda	طلب	None
redoks	اختزال	Nan
redom	في صف واحد	Nan
redova	الصفوف	Nan
reakciji	رد فعل	Nan
redove	الصفوف	Nan
redovno	بشكل منتظم	Nan
redu	حسنا	Nan
redukcija	تخفيض	None
redukcije	تخفيضات	Nan
redžić	redžić	Nan
reference	مرجع	Nan
referendum	استفتاء	None
redovito	بشكل منتظم	Nan
riječni	نهر	None
riječnim	نهر	None
riješiti	لتحل	Nan
rupe	ثقوب	Nan
rusi	الروسية	None
rusija	روسيا	None
rusije	من روسيا	Nan
rusiji	روسيا	None
rusijom	روسيا	None
rusiju	روسيا	None
ruska	الروسية	None
ruske	الروسية	None
ruski	الروسية	None
ruskog	الروسية	None
ruskom	بالروسية	Nan
ručno	يدويًا	Nan
rušenja	هدم	None
ruža	الوردة	Nan
rupa	الفجوة	None
runjić	runjić	Nan
rumunski	روماني	Nan
rumuniji	رومانيا	None
rudarstvo	التعدين	Nan
rude	خام	None
rudnik	الخاص بي	Nan
rudnika	الخاص بي	Nan
rudolf	رودولف	Nan
rue	شارع	None
ruka	كف	Nan
s	س	None
rukama	اليدين	Nan
rukomet	كرة اليد	Nan
rukometna	كرة اليد	Nan
rukometni	كرة اليد	Nan
rukometu	كرة اليد	Nan
ruku	كف	Nan
rumunija	رومانيا	None
rumunije	رومانيا	None
rukom	باليد	Nan
rudar	عامل المنجم	Nan
sa	مع	None
sabiranje	إضافة	None
safvetbeg	safvetbeg	Nan
safvetbega	safvetbega	Nan
sagrađen	مبني	None
sagrađena	مبني	None
sahatkula	سهاتكولا	Nan
sahranjen	مدفون	Nan
sajt	موقع	None
salih	صالح	None
salinitet	الملوحة	Nan
salvador	سلفادور	Nan
sam	وحده	None
sama	وحده	None
same	نفسه	None
sami	وحده	None
samih	أنفسهم	None
safvet	safvet	Nan
safet	خزنة	Nan
sadu	sadu	Nan
sadrži	يحتوي على	Nan
sabor	كاتدرائية	None
sabora	سابورا	Nan
sabrana	جمعت	None
sad	الآن	None
sada	الآن	None
sadašnja	حاضر	Nan
sadašnje	حاضر	Nan
sabahnamaz	صباحناماز	Nan
sadašnji	حاضر	Nan
sadržaja	المحتوى	Nan
sadržaje	محتويات	Nan
sadržajem	المحتوى	Nan
sadržajima	محتويات	Nan
sadržaju	المحتوى	Nan
sadržavati	يحتوي	None
sadrže	يحتوي	None
sadržaj	المحتوى	Nan
rudama	خامات	Nan
ruda	خام	None
ruci	اليدين	Nan
rizvić	رضوي	Nan
riža	أرز	Nan
rječica	نهر صغير	Nan
rječice	الأنهار الصغيرة	Nan
rječnici	قواميس	Nan
rječnik	قاموس	None
rječnika	قاموس	None
rjeđe	كثير من الأحيان أقل	Nan
rješavanje	حل	Nan
rješenja	حلول	None
rješenje	المحلول	Nan
rob	عبد	None
roba	البضائع	None
robe	البضائع	None
robert	روبرت	None
rizika	خطر	None
rizik	خطر	None
ritma	على نفس المنوال	Nan
ritam	على نفس المنوال	Nan
rim	حافة	None
rima	قافية	Nan
rimljana	الرومان	None
rimljani	الرومان	None
rimokatoličke	الروم الكاثوليك	Nan
rimska	رومان	Nan
rimske	رومان	Nan
roberta	روبرتا	Nan
rimski	رومان	Nan
rimskim	رومان	Nan
rimsko	رومان	Nan
rimskog	رومان	Nan
rimskoj	رومان	Nan
rimskom	رومان	Nan
rimu	قافية	Nan
rio	ريو	Nan
rimskih	رومان	Nan
robom	عبد	None
robova	عبيد	None
robove	عبيد	None
romani	روايات	None
romanu	رواية	None
romeo	روميو	Nan
romi	روما	None
ropstva	عبودية	Nan
ropstvo	عبودية	Nan
rođen	مولود	Nan
romana	رواية	None
rođena	مولود	Nan
rođenja	ولادة	None
rođenje	ولادة	None
rs	روبية	Nan
rtv	rtv	Nan
rub	руб	Nan
ruba	حافة	None
rubu	حافة	None
rođeni	مولود	Nan
samir	سمير	None
roman	رواية	None
rom	ذاكرة للقراءة فقط	Nan
robovi	عبيد	None
rock	صخرة	Nan
rod	جنس	None
roda	طيب القلب	Nan
rodi	يولد	None
rodila	مولود	Nan
rodio	أنجبت	None
roma	روما	None
roditelja	الآباء	None
rodni	محلي	None
rodnice	المهبل	None
rodnom	محلي	None
roger	حاضر	Nan
rok	عام	None
roku	حد اقصى	Nan
roll	تدحرج	Nan
roditelji	الآباء	None
prelaza	الانتقالات	Nan
prelaska	العبور	Nan
prekršaj	جريمة	Nan
paris	باريس	None
pariz	باريس	None
pariza	باريس	None
parizu	باريس	None
pariška	باريسي	Nan
pariške	باريسي	Nan
pariški	باريسي	Nan
pariškog	باريسي	Nan
park	منتزه	Nan
parkova	الحدائق	None
parkovi	الحدائق	None
parku	منتزه	Nan
parlament	البرلمان	None
parlamenta	البرلمان	None
parlamentarna	برلماني	Nan
pare	بخار	None
parc	بارك	Nan
parazita	طفيلي	Nan
paravojne	شبه العسكرية	Nan
pamuk	قطن	Nan
pandora	باندورا	Nan
panonske	بانونيا	Nan
pao	سقط	None
papa	بابا	None
pape	بيب	Nan
papir	ورقة	None
parlamentarne	برلماني	Nan
papira	ورقة	None
para	إلى عن على	Nan
paradajza	طماطم	Nan
paradoks	المفارقة	Nan
paradoksi	مفارقات	Nan
paralelno	بالتوازي	Nan
paralelogram	متوازي الاضلاع	Nan
paramecijum	البارامسيوم	Nan
par	الاسم	None
pamti	تذكر	None
parlamentu	البرلمان	None
partija	حفل	None
pažnju	انتباه	Nan
pc	الكمبيوتر	None
pci	pci	Nan
pdf	بي دي إف	Nan
pdv	ضريبة القيمة المضافة	Nan
pedagogija	أصول تربية	Nan
pedeset	خمسون	Nan
penis	قضيب	Nan
penisa	قضيب	Nan
peraja	زعانف	Nan
peraje	زعانف	Nan
performanse	أداء	None
periferiji	المحيط	None
perikard	تامور	Nan
period	فترة	None
pažnje	انتباه	Nan
pažnja	انتباه	Nan
paše	يرعي	Nan
paša	رعي	Nan
partije	حفلات	Nan
partizan	حزبي	Nan
partizana	حزبي	Nan
partnera	شريك	None
partneri	شركاء	Nan
patnje	معاناة	Nan
patrijarh	البطريرك	Nan
parteru	الطابق الأرضي	Nan
patrijarha	البطريرك	Nan
pauk	العنكبوت	Nan
paul	بول	None
pauza	وقفة	Nan
pauze	وقفة	Nan
pavla	بول	None
pavle	بول	None
pazar	سوق	None
patrijaršija	البطريركية	Nan
perioda	فترة	None
pali	بالي	Nan
pale	باهت	Nan
ovim	مع هذا	Nan
ovisi	يعتمد على	Nan
ovisno	حسب	None
ovlasti	السلطات	None
ovo	هذه	None
ovog	من هذا	Nan
ovoga	من هذا	Nan
ovoj	هذا	None
ovom	هذه	None
ovome	هذه	None
ovu	هذه	None
oznaka	ضع الكلمة المناسبة	Nan
oznake	العلامات	Nan
označava	يعني	None
označavaju	دل	Nan
ovih	من هؤلاء	Nan
ovi	هؤلاء	None
over	على	None
ove	هؤلاء	None
otvorenog	افتح	Nan
otvorenom	في الهواء الطلق	Nan
out	خارج	Nan
ova	هذه	None
ovaca	خروف	Nan
ovaj	هذا	None
ovakav	مثله	None
ozren	اوزين	Nan
ovako	مثله	None
ovakve	مثله	None
ovakvi	مثله	None
ovakvim	مثله	None
ovakvo	مثله	None
ovakvog	مثله	None
ovde	هنا	None
ovdje	هنا	None
ovakva	مثله	None
palestine	فلسطين	None
očekivalo	متوقع	Nan
oči	عيون	None
padavine	ترسب	Nan
padne	سيسقط	Nan
padom	خريف	Nan
padu	خريف	Nan
pak	باك	Nan
pakistan	باكستان	None
pakt	حلف	None
pakta	حلف	None
pala	سقط	None
paladijum	البلاديوم	Nan
palais	قصر	None
palača	قصر	None
palače	القصور	None
palaču	قصر	None
paldum	paldum	Nan
padavina	ترسب	Nan
padaju	يسقطون	Nan
pada	نعم	Nan
pad	ضمادة	Nan
očiju	عيون	None
očima	عيون	None
očito	بوضوح	None
očituje	يتجلى	Nan
očne	عين	None
očuvanje	الحفاظ	None
oštećenja	ضرر	Nan
očekuje	تتوقع	Nan
oštra	حاد	Nan
oštro	بشكل حاد	Nan
oženio	متزوج	None
oženjen	متزوج	None
p	ص	None
pa	السلطة الفلسطينية	Nan
pacijenata	المرضى	None
pacijenta	صبور	Nan
oštre	حاد	Nan
periodima	فترات	None
periodu	فترة	None
pero	ريشة	None
planinskih	الجبل	None
planinskim	جبلية	None
planinsko	جبلية	None
planinskog	الجبل	None
planinskom	الجبل	None
planira	الخطط	None
planiranja	التخطيط	None
planiranje	التخطيط	None
planirao	المخطط لها	Nan
planova	الخطط	None
planove	الخطط	None
planovi	الخطط	None
planu	خطة	None
platon	أفلاطون	None
platona	أفلاطون	None
planinski	جبلية	None
planinske	الجبل	None
planinska	الجبل	None
planini	الجبال	None
pjevanje	الغناء	Nan
pjevao	غنى	Nan
pjevač	مغني	Nan
pjevača	مغني	Nan
pjevači	المطربين	Nan
pjevačica	مغني	Nan
pl	رر	Nan
plava	أزرق	Nan
place	بكاء	Nan
plan	خطة	None
plana	خطة	None
planeta	كوكب	None
planete	الكواكب	None
planina	الجبل	None
planinama	الجبال	None
planine	الجبال	None
plamen	لهب	Nan
pjevaju	هم يغنون	Nan
plave	أزرق	Nan
plavom	أزرق	Nan
ploči	لوحات	None
ploču	طبق	Nan
plus	زائد	Nan
pluća	رئتين	Nan
plućnog	الرئوي	Nan
pne	قبل الميلاد	Nan
po	بواسطة	None
pobačaj	الإجهاض	Nan
pobijedio	وين	Nan
pobjeda	فوز	Nan
pobjede	انتصارات	None
pobjedio	وون	Nan
pobjednici	الفائزون	Nan
pobjednik	الفائز	None
pobjednika	الفائز	None
ploče	لوحات	None
pločama	لوحات	None
ploča	طبق	Nan
plodovi	الفاكهة	Nan
play	لعب	None
playoff	يتنحنح	Nan
plazma	بلازما	Nan
plaća	يدفع	None
plaćanja	المدفوعات	Nan
pleme	قبيلة	None
plemena	القبائل	None
plavi	أزرق	Nan
plemenima	القبائل	None
plemstvo	نبل	Nan
plesni	قالب	Nan
plina	غاز	None
plod	فاكهة	Nan
ploda	فاكهة	Nan
plodne	خصبة	None
plodno	مثمر	Nan
plemstva	نبل	Nan
pjeva	يغني	Nan
pjesnika	شاعر	Nan
pjesnik	شاعر	Nan
pećine	الكهوف	None
pećini	الكهوف	None
pečat	عجل البحر	Nan
pgp	ص	None
ph	دكتوراه	Nan
pi	بي	None
pierre	بيير	Nan
piezoelektricitet	الكهربائية الضغطية	Nan
pijesak	رمال	Nan
piksela	بكسل	Nan
pilus	طيار	Nan
pingvina	البطريق	Nan
pingvini	طيور البطريق	Nan
piramida	هرم	None
piramide	هرم	None
pećina	كهف	Nan
peći	أفران	Nan
petén	بيتين	Nan
petrović	بتروفيتش	Nan
peru	بيرو	Nan
perzijski	اللغة الفارسية	Nan
perzijskog	اللغة الفارسية	Nan
pesnici	الشعراء	None
pesnika	الشاعر	None
pet	خمسة	None
petak	يوم الجمعة	Nan
pisac	كاتب	None
petar	بتار	Nan
peter	نفذ	Nan
peti	خامسا	Nan
petlje	حلقات	None
petnaest	خمسة عشر	Nan
petog	خامسا	Nan
petra	البتراء	None
petrovac	بتروفاك	Nan
pete	بيت	None
pisaca	الكتاب	None
pisali	كتب	None
pisan	مكتوبة	None
pitanja	الأسئلة	None
pitanje	سؤال	None
pitanjima	مسائل	None
pitanju	سؤال	None
pića	مشروبات	Nan
piše	هو يكتب	Nan
pišu	انا اكتب	Nan
pitagora	فيثاغورس	Nan
pjege	النمش	Nan
pjesma	أغنية	None
pjesmama	الأغاني	None
pjesme	الأغاني	None
pjesmi	الأغاني	None
pjesmom	أغنية	None
pjesmu	أغنية	None
pjesnici	الشعراء	None
pjesama	الأغاني	None
otvoreno	علانية	Nan
pita	سأل	None
pismom	رسالة	None
pisana	مكتوبة	None
pisane	مكتوبة	None
pisani	مكتوبة	None
pisanih	مكتوبة	None
pisanim	مكتوبة	None
pisanja	جاري الكتابة	Nan
pisanje	جاري الكتابة	Nan
pismu	رسالة	None
pisanju	جاري الكتابة	Nan
pisati	لأكتب	Nan
pisca	كاتب	None
pisci	الكتاب	None
pisma	حروف	None
pismenost	معرفة القراءة والكتابة	Nan
pismenosti	معرفة القراءة والكتابة	Nan
pismo	رسالة	None
pisao	كتب	None
pobjedom	فوز	Nan
otvoreni	افتح	Nan
otvorena	افتح	Nan
opreme	معدات	None
opremu	معدات	None
opsada	حصار	None
opsade	حصار	None
opstanak	نجاة	Nan
opticaju	بصريات	Nan
optički	بصري	Nan
optužen	المتهم	Nan
opus	التأليف	None
opća	جنرال لواء	Nan
opće	جنرال لواء	Nan
općeg	جنرال لواء	Nan
općem	جنرال لواء	Nan
općenito	بشكل عام	Nan
opći	جنرال لواء	Nan
oprema	معدات	None
oportunitetni	انتهازية	Nan
oporezivanja	تحصيل الضرائب	Nan
oplođena	مخصب	Nan
operacija	عملية	None
operacijama	عمليات	None
operacije	عمليات	None
operativni	التشغيل	Nan
operativnih	التشغيل	Nan
operativnog	التشغيل	Nan
opere	أوبرا	None
općih	جنرال لواء	Nan
opet	مرة أخرى	Nan
opisa	وصف	None
opisan	موصوف	Nan
opisani	موصوف	Nan
opisao	موصوف	Nan
opisivanje	وصف	None
opisuje	يصف	None
opisuju	وصف	None
opis	وصف	None
opera	أوبرا	None
općim	جنرال لواء	Nan
općinama	البلديات	None
organizira	ينظم	None
organizirana	منظم	Nan
organizirane	منظم	Nan
organizirao	منظم	Nan
organizma	كائن حي	Nan
organizmi	الكائنات الحية	Nan
organizmu	كائن حي	Nan
organizovana	منظم	Nan
organizovao	منظم	Nan
organizuje	ينظم	None
organizuju	تنظم	None
organske	عضوي	Nan
organskih	عضوي	Nan
originalni	أصلي	Nan
orijentacije	اتجاه	None
organizama	الكائنات الحية	Nan
organizam	كائن حي	Nan
organizaciju	منظمة	Nan
organizaciji	منظمة	Nan
općine	البلديات	None
općini	البلدية	None
općinu	البلدية	None
općoj	جنرال لواء	Nan
opšta	جنرال لواء	Nan
opšte	بشكل عام	Nan
opštine	البلديات	None
općina	البلدية	None
or	أو	None
organ	عضو	Nan
organa	الأعضاء	None
organe	الأعضاء	None
organi	الأعضاء	None
organima	الأعضاء	None
organizacija	منظمة	Nan
organizacije	المنظمات	None
orašje	المكسرات	Nan
orijentalnim	شرقي	None
open	افتح	Nan
opatiji	دير	None
oktobru	اكتوبر	Nan
oku	عين	None
okupacije	احتلال	None
okupacijom	احتلال	None
okupaciju	احتلال	None
okupatora	المحتل	Nan
okuplja	يجمع	None
okupljaju	جمع	None
okvir	الإطار	None
okviru	إطار العمل	Nan
olimpijade	الألعاب الأولمبية	Nan
olimpiji	أولمبيا	Nan
olimpijske	الأولمبية	None
olimpijski	الأولمبية	None
olimpijskih	الأولمبية	None
oktobra	اكتوبر	Nan
oksigen	الأكسجين	None
oksidacijsko	مؤكسد	Nan
oksidacije	أكسدة	Nan
okolnostima	ظروف	None
okrenut	تحول	None
okreće	يتحول	None
okrug	مقاطعة	None
okruga	منطقة	None
okrugu	منطقة	None
okružen	محاط	Nan
olimpijskim	الأولمبية	None
okružena	محاط	Nan
okruženje	بيئة	None
okruženju	بيئة	None
okružuje	يحيط	None
okružuju	تحيط	None
oksid	أكسيد	None
oksida	أكسيد	None
oksidacija	أكسدة	Nan
okruženja	محيط	None
opcija	اختيار	None
olimpijskog	الأولمبية	None
olimpizma	الأولمبية	None
oni	هم	None
onih	أولئك	None
onim	onim	Nan
onima	هو عنده	Nan
online	عبر الانترنت	Nan
ono	عليه	None
onog	onog	Nan
onoga	من ذلك	Nan
onom	ذرة	Nan
onome	onome	Nan
onu	واحد	None
opada	ينخفض	Nan
opasnost	خطر	None
opasnosti	الأخطار	Nan
opatija	دير	None
one	واحد	None
ondje	هناك	None
onda	ثم	None
onako	على أي حال	Nan
olovo	قيادة	None
oluja	عاصفة	None
omer	عمر	None
omerpaša	أومرباشا	Nan
omogućava	يسمح	None
omogućavaju	ممكن	None
omogućila	ممكن	None
olimpijskom	الأولمبية	None
omogućilo	ممكن	None
omogućuje	يسمح	None
omogućuju	ممكن	None
omot	التغطية	Nan
omotač	غلاف	None
on	هو	None
ona	هي	None
onaj	ذلك	None
omogućiti	ممكن	None
orić	orić	Nan
orkestar	أوركسترا	Nan
oružane	مسلح	Nan
ostoja	ostoja	Nan
ostrva	الجزر	None
ostrvima	الجزر	None
ostrvo	جزيرة	None
ostrvu	جزيرة	None
ostvarenja	الإنجازات	Nan
ostvarenje	ادراك	Nan
ostvarila	حقق	None
ostvario	حقق	None
ostvariti	لتدرك	Nan
ostvaruje	يدرك	None
ostvaruju	تدرك	Nan
osuđen	مدان	Nan
osvaja	ينتصر	Nan
osvajaju	يغزو	Nan
ostavlja	اوراق اشجار	Nan
ostavio	اليسار	None
ostavili	اليسار	None
ostatke	بقايا الطعام	Nan
ostacima	بقايا الطعام	Nan
ostaje	بقايا	None
ostaju	يبقون	Nan
ostala	البقية	Nan
ostale	آخر	None
ostali	الآخرين	None
ostalih	الآخرين	None
osvajanja	الفتوحات	None
ostalim	الآخرين	None
ostalog	البقية	Nan
ostane	البقاء	None
ostao	بقي	None
ostatak	البقية	Nan
ostataka	بقايا الطعام	Nan
ostati	لتبقى	Nan
ostatka	البقية	Nan
ostalo	آخر	None
ostaci	بقايا الطعام	Nan
osvajanje	غزو	None
osvajač	الفاتح	None
otok	جزيرة	None
otoka	الجزر	None
otpada	المخلفات	Nan
otpor	مقاومة	None
otpora	مقاومة	None
otprilike	تقريبا	None
otrov	السم	None
otuda	ومن ثم	Nan
otvara	يفتح	None
otvaraju	يفتحون	Nan
otvaranja	افتتاح	None
otvaranje	افتتاح	None
otvor	افتتاح	None
otvora	فتحات	Nan
otvoren	افتح	Nan
otkriće	اكتشاف	None
otkrića	الاكتشافات	None
otkriveno	اكتشف	None
otkriveni	اكتشف	None
osvajači	الفاتحون	Nan
osvojenih	غزا	None
osvoji	يفوز	None
osvojila	وون	Nan
osvojili	وون	Nan
osvojio	وون	Nan
otac	الآب	None
osvajanjem	عن طريق الفتح	Nan
otcijepljenje	انفصال	None
otišli	ذهب	None
otkrili	اكتشف	None
otkrio	اكتشف	None
otkriva	يكشف	Nan
otkriven	اكتشف	None
otkrivena	اكتشف	None
otkrivene	اكتشف	None
otišao	اليسار	None
osovine	المحاور	Nan
osobu	شخص	None
osobito	خصوصا	None
oslobođen	صدر	None
oslobođenja	تحرير	None
oslobođenje	تحرير	None
osmaci	الثمانيات	Nan
osman	عثمان	None
osmanagića	osmanagića	Nan
osmanlija	العثمانيون	None
osmanlijama	العثمانيون	None
osmanlije	العثمانيون	None
osmanlijska	العثماني	None
osmanlijske	العثماني	None
osmanlijski	العثماني	None
osmanlijskim	العثماني	None
osmanlijsko	العثماني	None
osmanlijskog	العثماني	None
osloboditi	للإفراج	Nan
oslobodio	صدر	None
oslobađanje	إطلاق سراح	Nan
oslobađa	يحرر	Nan
oružanih	مسلح	Nan
oružja	الأسلحة	None
oružje	سلاح	None
os	نظام التشغيل	Nan
osam	ثمانية	None
osamdesetih	الثمانينات	None
osciloskop	راسم الذبذبات	Nan
osmanlijskom	العثماني	None
osigura	تأمين	None
osigurava	يوفر	None
osim	إلا	None
osjeća	يشعر	None
osjećaj	شعور	Nan
osjećaja	مشاعر	None
osjećaju	يشعر	None
osjećanja	مشاعر	None
osigurao	قدمت	None
osmanlijsku	العثماني	None
osmanske	العثماني	None
osmanski	العثماني	None
osnovice	الأساسيات	Nan
osnovna	الأساسي	None
osnovne	الأساسي	None
osnovni	الأساسي	None
osnovnih	الأساسي	None
osnovnim	الأساسي	None
osnovno	الأساسي	None
osnovi	في الأساس	Nan
osnovnog	الأساسي	None
osnovu	أساس	None
osoba	شخص	None
osobama	الأشخاص	None
osobe	الأشخاص	None
osobina	خاصية	None
osobinama	الخصائص	None
osobine	الخصائص	None
osnovnu	ابتدائي	Nan
otvorene	افتح	Nan
osnove	الأساسيات	Nan
osnovano	تأسست	None
osmansko	العثماني	None
osmanskog	العثماني	None
osmanskom	العثماني	None
osniva	تأسست	None
osnivaju	إنشاء	None
osnivanja	مؤسسة	None
osnivanje	مؤسسة	None
osnovao	تأسست	None
osnivanju	مؤسسة	None
osnivača	مؤسس	None
osnivačem	مؤسس	None
osnova	أساس	None
osnovali	تأسست	None
osnovan	تأسست	None
osnovana	أنشئت	None
osnovane	أنشئت	None
osnivač	مؤسس	None
pobjedu	فوز	Nan
pobjegao	هرب	None
pobjegli	هرب	None
potpunosti	تماما	None
potpunu	اكتمال	Nan
potrazi	بحث	None
potreba	بحاجة إلى	Nan
potrebama	يحتاج	None
potreban	مطلوب	Nan
potrebe	يحتاج	None
potrebi	يحتاج	None
potrebna	مطلوب	Nan
potrebne	مطلوب	Nan
potrebno	بحاجة	None
potrebu	بحاجة إلى	Nan
potrošnje	استهلاك	None
potvrđena	تم تأكيد	Nan
potvrđeno	تم تأكيد	Nan
potpuno	تماما	None
potporu	الدعم	None
potpisivanja	التوقيع	None
potpisao	وقعت	None
posve	تماما	None
posvetio	مخصصة	None
posvećena	مخصصة	None
potencijal	محتمل	Nan
potencijala	محتمل	Nan
potencijalno	يحتمل	None
potiče	يشجع	Nan
potvrđuje	يؤكد	None
potiču	التشجيع	Nan
potkraj	في نهايةالمطاف	Nan
potok	مجرى	None
potom	ثم	None
potomci	أحفاد	Nan
potočarima	بروكس	Nan
potpisali	وقعت	None
potpisan	وقعت	None
potječe	ينشأ	None
posušje	جفاف	None
potvrđuju	تؤكد	None
povelja	ميثاق	None
povlačenja	الانسحابات	Nan
povlači	تسحب	Nan
povod	مناسبات	Nan
povodom	بهذه المناسبة	Nan
povoljan	ملائم	Nan
povoljni	ملائم	Nan
povratak	إرجاع	Nan
povratka	إرجاع	Nan
povratku	إرجاع	Nan
povreda	إصابة	None
povrede	الإصابات	Nan
povremeno	من حين اخر	Nan
povrća	خضروات	Nan
povrće	خضروات	Nan
površina	سطح - المظهر الخارجي	Nan
povjerenje	ثقة	None
povijest	التاريخ	None
povećava	يزيد	None
povećao	زيادة	None
povelje	ميثاق	None
povelji	مواثيق	Nan
povezan	متصل	Nan
povezana	متصل	Nan
povezane	ذات صلة	Nan
povezani	متصل	Nan
povezanih	ذات صلة	Nan
pouzdano	بثقة	Nan
povezano	متصل	Nan
povezivanje	توصيل	None
povezuje	يربط	None
povezuju	الاتصال	None
povećala	زيادة	None
povećanja	يزيد	None
povećanje	زيادة	None
povećanjem	بزيادة	None
povezanost	الاتصال	None
površinama	السطوح	Nan
postupno	تدريجيا	None
postupaka	الإجراءات	None
poslove	وظائف	None
poslovima	وظائف	None
poslovna	اعمال	Nan
poslovne	اعمال	Nan
poslovni	اعمال	Nan
posmatra	يلاحظ	None
posmatrati	لمراقبة	Nan
posmatrača	مراقب	None
posredstvom	عبر	None
post	بريد	None
postaje	يصبح	None
postaju	يصبحون	Nan
postala	أصبح	None
postale	أصبح	None
postali	أصبح	None
poslova	وظائف	None
posljednjim	الاخير	Nan
posljednjih	الأخير	None
posljednji	الاخير	Nan
poslanica	رسالة بولس الرسول	Nan
poslanice	رسائل	None
poslanici	النواب	None
poslanik	النائب	Nan
poslanika	النائب	Nan
poslaniku	للسفير	Nan
poslao	أرسلت	None
postalo	أصبح	None
posle	بعد	None
posljedica	نتيجة	None
posljedice	الآثار	None
posljedicu	نتيجة	None
posljednja	الاخير	Nan
posljednje	الاخير	Nan
posljednjeg	الاخير	Nan
posljednjem	الاخير	Nan
poslije	بعد	None
postupci	الإجراءات	None
postanak	منشأ	Nan
postanka	قف	Nan
postojali	موجود	Nan
postojalo	كان يوجد	Nan
postojanja	الوجود	None
postojanje	الوجود	None
postojanju	الوجود	None
postojao	موجود	Nan
postojati	أن تكون موجود	Nan
postoje	هناك	None
postojeće	موجود	Nan
postojeći	موجود	Nan
postojećih	موجود	Nan
postoji	يوجد	None
postotak	النسبة المئوية	Nan
postrojenja	منشأة	Nan
postupak	إجراء	None
postojale	موجود	Nan
postojala	موجود	Nan
postižu	التوصل	None
postiže	يحقق	None
postanku	قف	Nan
postao	أصبح	None
postati	لتصبح	None
postava	اقامة	Nan
postavi	جلس	Nan
postavio	جلس	Nan
postavlja	مجموعات	None
postane	يصبح	None
postavljanje	اعداد	Nan
postavljena	جلس	Nan
postepeno	تدريجيا	None
postigao	حقق	None
postigla	حقق	None
postigli	حقق	None
postizanja	الإنجازات	Nan
postići	ليحقق	Nan
postavljen	جلس	Nan
površine	السطوح	Nan
površini	سطح - المظهر الخارجي	Nan
površinom	سطح - المظهر الخارجي	Nan
pravoslavni	الأرثوذكسية	None
pravu	حق	None
praznici	الأعياد	Nan
praznik	يوم الاجازة	Nan
praznika	الأعياد	Nan
pre	قبل	None
preci	أسلاف	Nan
precizno	على وجه التحديد	Nan
pred	سلف	None
predaje	يستسلم	Nan
predaju	استسلام	None
predao	سلمت	Nan
predavanja	محاضرات	Nan
predjelima	المقبلات	Nan
predjelu	فاتح الشهية	Nan
pravoslavne	الأرثوذكسية	None
pravoslavna	الأرثوذكسية	None
pravoslavlje	الأرثوذكسية	None
pravoslavci	الأرثوذكسية	None
pravila	قواعد	None
pravilima	قواعد	None
pravilna	صيح	Nan
pravilno	بشكل صحيح	Nan
pravilo	قاعدة	None
pravilu	قاعدة	None
pravim	انا اقول	Nan
predlaže	وتقترح	Nan
pravima	حقوق	None
pravna	قانوني	None
pravne	قانوني	None
pravni	قانوني	None
pravnom	قانوني	None
pravo	حق	None
pravom	حق	None
pravopis	الإملائية	Nan
pravljenje	صناعة	None
pravih	حقيقة	None
predmet	موضوع	None
predmeti	العناصر	None
predstavnici	مندوب	Nan
predstavnik	وكيل	Nan
predstavnika	وكيل	Nan
predstavničkog	وكيل	Nan
preduzeća	الشركات	None
preduzeće	شركة	None
predvodio	يؤدى	None
pregled	مراجعة	None
pregovora	مفاوضات	None
pregovore	مفاوضات	None
pregovori	مفاوضات	None
prehrambena	طعام	None
prekid	استراحة	Nan
prekida	يقاطع	Nan
preko	على	None
predstavljen	قدم	None
predstavljati	لتمثيل	Nan
predstavljao	ممثلة	None
predstavljalo	ممثلة	None
predmetima	شاء	None
prednji	أمامي	Nan
prednost	مميزات	None
prednosti	مزايا	None
predrag	غالي جدا	Nan
predsjednik	رئيس	None
predsjednika	الرئيس	None
predmeta	العناصر	None
predsjednikom	من قبل الرئيس	Nan
predsjedništva	رئاسة	None
predsjedništvo	رئاسة	None
predstave	العروض	None
predstaviti	حاضر	Nan
predstavlja	يمثل	None
predstavljaju	تركيز	None
predstavljala	ممثلة	None
predsjedniku	إلى الرئيس	Nan
pravi	هو يقول	Nan
prave	إنهم يفعلون	Nan
pravdu	الحقيقة	None
poznatim	مشهور	None
poznato	معروف	None
poznatog	معروف	None
poznatom	مألوف	Nan
poznatu	معروف	None
poznavali	عرف	None
poznavanje	المعرفه	Nan
pozorišne	مسرحي	Nan
pozorišni	مسرحي	Nan
pozorišta	المسارح	Nan
pozorište	مسرح	None
pozvao	اتصل	Nan
počeci	البدايات	Nan
počela	بدأ	None
počele	بدأت	None
poznatijih	اكثر شهرة	Nan
poznatiji	اكثر شهرة	Nan
poznatije	اكثر شهرة	Nan
poznatih	مشهور	None
površinski	سطحي	Nan
površinu	سطح - المظهر الخارجي	Nan
povući	سحب. شد	Nan
pozadini	خلفية	None
pozicija	موضع	None
pozicije	المواقف	None
poziciji	موضع	None
počeli	بدأت	None
poziciju	موضع	None
poziv	مكالمة	Nan
poziva	المكالمات	Nan
pozivni	مكالمة	Nan
poznat	معروف	None
poznata	معروف	None
poznate	مشهور	None
poznati	مشهور	None
pozitivan	إيجابي	Nan
počelo	بدأت	None
počeo	بدأت	None
početak	البداية	None
praksi	ممارسة	None
praktički	عمليا	Nan
praktično	عمليا	Nan
prate	إتبع	Nan
prateći	مصاحب	Nan
prati	غسل	None
pratiti	للمتابعة	Nan
praksa	ممارسة	None
prava	حقوق	None
pravaca	الاتجاهات	None
pravca	اتجاه	None
pravcem	اتجاه	None
pravci	الاتجاهات	None
pravcima	الاتجاهات	None
pravcu	اتجاه	None
pravde	عدالة	Nan
pravac	اتجاه	None
posla	مهنة	None
prag	عتبة	None
poštovanje	احترام	None
početka	البداية	None
početkom	في البداية	Nan
početku	في البداية	Nan
početne	مبدئي	Nan
početnim	مبدئي	Nan
početnu	مبدئي	Nan
počev	بدأت	None
poželjno	ويفضل	Nan
počevši	بدء	None
počinju	يبدأون	Nan
počitelj	الجاني	Nan
pošalje	يرسل	None
pošta	بريد	None
poštanskih	بريدي	Nan
pošte	بريد	None
pošto	منذ	None
počinje	يبدأ	None
poskok	اقفز	Nan
posjetio	زار	None
posjeduju	تملك	None
pojma	مفهوم	None
pojmom	مفهوم	None
pojmova	شروط	None
pojmovi	شروط	None
pokazala	أظهر	None
pokazale	أظهر	None
pokazali	أظهر	None
pokazalo	أظهر	None
pokazao	أظهر	None
pokazati	ليعرض	Nan
pokazuje	عروض	Nan
pokazuju	تبين	None
poklapa	اعواد الكبريت	Nan
pokraj	بجوار	None
pokrajina	المحافظة	None
pojedinog	فرد	None
pojedinim	فرد	None
pojedinih	فرد	None
pojedini	فرد	None
pojavile	ظهر	None
pojavili	ظهر	None
pojavio	ظهر	None
pojaviti	يظهر	None
pojavljuje	يبدو	None
pojavljuju	يظهر	None
pojavom	مظهر خارجي	Nan
pokrajine	المحافظات	None
pojavu	حادثة	None
pojedinaca	الأفراد	None
pojedinačne	فرد	None
pojedinačni	فرد	None
pojedinačnih	فرد	None
pojedinca	فرد	None
pojedinci	الأفراد	None
pojedine	فرد	None
pojačava	يضخم	Nan
pojavila	ظهر	None
pokrajini	المحافظة	None
pokret	حركة	None
polako	ببطء	None
polazi	يبدأ	None
policija	شرطة	Nan
policije	شرطة	Nan
policiju	الشرطة	None
polisa	سياسات	None
polisaharidi	السكريات	Nan
politici	سياسات	None
politika	سياسة	None
politike	سياسات	None
politikom	سياسة	None
politiku	سياسات	None
političar	سياسي	None
političara	سياسة	None
političari	سياسة	None
polahko	ببطء	None
pola	نصف	None
pokušavali	حاول	None
pokušavaju	انهم يحاولون	Nan
pokreta	حركة	None
pokretanje	بدء	None
pokreti	الحركات	None
pokretima	الحركات	None
pokretu	حركة	None
pokreće	يبدأ	None
pokriva	أغلفة	Nan
pokrenuo	بدأت	None
pokušaj	محاولة	None
pokušaji	محاولات	None
pokušajima	محاولات	None
pokušaju	يحاولون	Nan
pokušali	حاول	None
pokušao	حاول	None
pokušati	لكي يحاول	Nan
pokušava	محاولة	None
pokušaja	محاولات	None
pojave	مرات الحدوث	Nan
pojava	حادثة	None
pojasu	حزام	None
podijeljeno	مشترك	None
podjela	قطاع	None
podjele	قطاع	None
podjeli	قطاع	None
podjeljena	منقسم	Nan
podjelu	قطاع	None
podloga	ضمادة	Nan
podloge	ركائز	Nan
podlogu	المادة المتفاعلة	Nan
podlozi	ركائز	Nan
podne	وقت الظهيرة	Nan
podnijeti	أن يقدم	Nan
podnožju	قدم	None
podrazumijeva	يدل	None
podrazumijevaju	لمح	Nan
podijeljeni	منقسم	Nan
podijeljene	منقسم	Nan
podijeljena	منقسم	Nan
podijeljen	منقسم	Nan
pobjeći	للهرب	Nan
pobjeđuje	يفوز	None
poboljšanje	تحسين	None
pobuna	تمرد	None
pobune	تمرد	None
pobunjenici	المتمردين	Nan
pobunu	تمرد	None
podrazumjeva	يدل	None
pod	أرضية	None
podacima	البيانات	None
podanika	المواضيع	None
podatak	البيانات	None
podataka	البيانات	None
podatke	البيانات	None
podigao	رفع	None
podijeliti	للمشاركه	Nan
podaci	البيانات	None
podrinja	بودرينجا	Nan
podrinju	بودرينجو	Nan
područja	المناطق	None
pogled	رأي	None
pogleda	الآراء	Nan
pogledajte	نظرة	None
pogledati	نظرة	None
pogledu	رأي	None
pogodila	نجاح	None
pogotovo	خصوصا	None
poginuo	مات	None
pogrešno	خطأ	None
pohod	رفع	None
pohoda	رفع	None
pohvaliti	إلى الثناء	Nan
pojam	مصطلح	None
pojas	حزام	None
pojasa	حزام	None
pojasom	حزام	None
pogubljena	أعدم	Nan
politička	سياسية	None
poginulo	مات	None
poeziji	الشعر	None
područje	منطقة	None
područjem	منطقة	None
područjima	المناطق	None
području	منطقة	None
podrška	الدعم	None
podrške	الدعم	None
podršku	الدعم	None
poeziju	الشعر	None
podržava	يدعم	None
podržavala	أيد	Nan
podsjeća	يذكر	None
podsjećaju	تذكير	Nan
podstiče	يشجع	Nan
poduzeća	الشركات	None
poezija	الشعر	None
poezije	الشعر	None
podržavaju	الدعم	None
slika	صورة	None
političke	سياسية	None
političkih	سياسية	None
poraženi	هزم	None
pored	بجوار	None
poredak	طلب	None
poremećaj	اضطراب	None
poremećaja	اضطرابات	None
poremećaji	اضطرابات	None
poretku	طلب	None
porez	ضريبة	None
poreza	الضرائب	None
porezi	الضرائب	None
porezne	ضريبة	None
porezni	ضريبة	None
poređenje	مقارنة	None
poređenju	مقارنة	None
porijekla	الأصل	None
poražen	هزم	None
porazio	هزم	None
porazili	هزم	None
poraza	يهزم	Nan
popović	بوبوفيتش	Nan
populacija	تعداد السكان	Nan
populacije	تعداد السكان	Nan
popularan	جمع	None
popularna	جمع	None
popularne	جمع	None
popularni	جمع	None
porijeklo	الأصل	None
popularno	جمع	None
popularnost	شعبية	None
popularnosti	شعبية	None
poput	مثل	None
porast	زيادة	None
porasta	زيادة	None
porastu	زيادة	None
poraz	يهزم	Nan
popularnoj	جمع	None
poplave	الفيضانات	None
porijeklom	الأصل	None
porodica	أسرة	None
posebne	مميز	Nan
posebni	مميز	Nan
posebnih	مميز	Nan
posebnim	مميز	Nan
posebno	خصوصا	None
posebnog	مميز	Nan
posebnom	مميز	Nan
posebnost	الخصوصية	Nan
posebnosti	مميزات خاصة	Nan
posebnu	مميز	Nan
posjed	ملكية	None
posjeda	ملكية	None
posjede	ممتلكات	Nan
posjedu	ملكية	None
posjeduje	يمتلك	None
posebna	مميز	Nan
poseban	مميز	Nan
posavini	بوسافيني	Nan
posavine	بوسافين	Nan
porodicama	العائلات	None
porodice	العائلات	None
porodici	العائلات	None
porodicom	أسرة	None
porodicu	أسرة	None
porođaj	الولادة	None
porođaja	الولادة	None
porijeklu	الأصل	None
portal	بوابة	None
portret	صورة	None
portugal	البرتغال	None
poruka	رسالة	None
poruke	الرسائل	None
poruku	رسالة	None
posao	عمل	None
posavina	بوسافينا	Nan
porto	ميناء	None
poplava	فيضان	Nan
popisu	قائمة	None
popisa	قائمة	None
poljskoj	بولندا	None
poljskom	تلميع	Nan
poljsku	بولندا	None
polju	حقل	None
polovina	نصف	None
polovine	أنصاف	Nan
polovini	أنصاف	Nan
polovinom	نصف	None
položaj	موضع	None
položaja	موضع	None
položaje	المواقف	None
položajem	موضع	None
položaju	موضع	None
poluga	رافعة	Nan
poluostrva	شبه جزيرة	Nan
poljski	تلميع	Nan
poljske	تلميع	Nan
poljska	بولندا	None
poljoprivredu	الزراعة	None
političkim	سياسية	None
političko	سياسيا	None
političkog	سياسية	None
političkoj	سياسية	None
političkom	سياسية	None
političku	سياسية	None
polja	مجالات	None
poluostrvo	شبه جزيرة	Nan
polje	حقل	None
poljoprivreda	الزراعة	None
poljoprivrede	الزراعة	None
poljoprivredi	الزراعة	None
poljoprivredna	زراعية	None
poljoprivredne	زراعية	None
poljoprivredni	زراعية	None
poljoprivrednih	زراعية	None
poljima	مجالات	None
poluostrvu	شبه جزيرة	Nan
poluotoka	شبه جزيرة	Nan
poluotoku	شبه جزيرة	Nan
ponašaju	تصرف	Nan
ponašanja	السلوكيات	Nan
ponašanje	سلوك	None
ponašanju	سلوك	None
ponegdje	مكان ما	Nan
ponekad	بعض الأحيان	Nan
ponovno	مرة أخرى	Nan
ponavljanje	تكرار	None
ponovnog	مرة أخرى	Nan
ponoći	في منتصف الليل	Nan
ponuda	عرض	None
ponude	عروض	Nan
ponudio	تقدم	None
ponudu	عرض	None
pop	البوب	None
popis	قائمة	None
ponovo	مرة أخرى	Nan
politički	سياسيا	None
ponavlja	يكرر	Nan
ponajprije	بالدرجة الأولى	Nan
poluprečnik	نصف القطر	Nan
poluprečnika	نصف القطر	Nan
pomalo	القليل	None
pomaže	يساعد	None
pomažu	مساعدة	None
pomenuti	المذكورة	None
pominje	يذكر	None
ponajviše	خاصة	None
pomogao	ساعد	None
pomorstvo	بحري	None
pomoć	مساعدة	None
pomoći	مساعدة	None
pomoćne	مساعد	None
pomoću	باستخدام	None
pompej	بومبي	Nan
pompeja	بومبي	Nan
pomogne	مساعدة	None
slikama	صور	None
slikar	دهان	Nan
slikari	الرسامين	Nan
vjetra	ريح	Nan
vjetrovi	رياح	None
vješti	ماهر	Nan
vještina	مهارة	Nan
vještine	مهارات	None
vježbe	تمارين	Nan
vježbi	تمارين	Nan
vlada	حكومة	None
vladaju	قاعدة	None
vladala	حكمت	None
vladali	حكمت	None
vladao	حكمت	None
vladar	مسطرة	Nan
vladara	مسطرة	Nan
vladari	الحكام	None
vjetar	ريح	Nan
vjeruju	هم يعتقدون	Nan
vjeruje	يعتقد	None
vjeru	الإيمان	None
vjernika	المؤمنين	None
vjeroispovijesti	دين	None
vjeroispovjesti	دين	None
vjerovali	يعتقد	None
vjerovalo	يعتقد	None
vjerovanja	المعتقدات	None
vjerovanje	الإيمان	None
vladavina	قاعدة	None
vjerovanju	الإيمان	None
vjerovatno	المحتمل	None
vjerska	متدين	Nan
vjerske	متدين	Nan
vjerski	متدين	Nan
vjerskih	متدين	Nan
vjerskim	متدين	Nan
vjerskog	متدين	Nan
vjerovao	يعتقد	None
vjernik	مؤمن	Nan
vladavine	قاعدة	None
vladavinu	قاعدة	None
vlastitim	خاصة	None
vlastitog	خاصة	None
vlastitom	خاصة	None
vlastitu	خاصة	None
vlašću	قوة	None
vlažna	رطب	Nan
vlažnost	رطوبة	Nan
voda	ماء	Nan
vodama	مياه	None
vode	ماء	Nan
vodene	ماء	Nan
vodeni	ماء	Nan
vodenih	ماء	Nan
vodenom	ماء	Nan
vodeći	قيادة	None
vlastiti	خاصة	None
vlastite	خاصة	None
vlastita	خاصة	None
vlastima	السلطات	None
vlade	حكومة	None
vladi	حكومة	None
vladimir	فلاديمير	None
vlado	حكومة	None
vladom	حكومة	None
vladu	حكومة	None
vlakna	ألياف	Nan
vladavini	قاعدة	None
vlasac	الثوم المعمر	Nan
vlasnik	صاحب	None
vlasnika	صاحب	None
vlasništvo	ملكية	None
vlasništvu	مملوكة	Nan
vlast	قوة	None
vlastela	النبلاء	None
vlasti	السلطات	None
vlasi	شعر	None
vodećih	قيادة	None
vjernici	المؤمنين	None
vjere	الإيمان	None
vidljive	مرئي	Nan
vidljivi	مرئي	Nan
vidljivo	مرئي	Nan
vidu	طيب القلب	Nan
vii	سابعا	Nan
viii	ثامنا	Nan
vijadukt	جسر	None
vijek	مئة عام	Nan
vijeka	مئة عام	Nan
vijekova	قرون	None
vijekovima	لقرون	Nan
vijeku	مئة عام	Nan
vijenac	إكليل	Nan
vijest	أخبار	None
vijesti	أخبار	None
vidljiva	مرئي	Nan
vidljiv	مرئي	Nan
vidjeti	لترى	Nan
vidjeli	رأيت	None
većinu	معظم	None
većoj	أكبر	Nan
veću	أكبر	Nan
večer	مساء	None
večera	وجبة عشاء	Nan
večeri	أمسيات	Nan
veže	أبراج	Nan
vijeća	مجلس	None
vežu	ربطة عنق	Nan
vid	فيد	Nan
vida	فيدا	Nan
vide	بالفيديو	Nan
video	فيديو	None
vidi	نرى	None
vidimo	نحن نرى	Nan
vidio	منشار	Nan
vi	أنت	None
vjeri	الإيمان	None
vijeće	مجلس	None
vina	نبيذ	Nan
visoravan	هضبة	None
visoravni	هضبة	None
vitamin	فيتامين	Nan
vitamina	فيتامين	Nan
vitez	فارس	None
viteza	فارس	None
viša	أعلى	None
više	أكثر	None
višeg	أعلى	None
višegrad	visegrad	Nan
višegradu	visegrad	Nan
viši	أول	None
viših	أعلى	None
višim	أعلى	None
vjera	الإيمان	None
visoku	عالي	None
visokom	عالي	None
visokog	عالي	None
visoko	عالي	None
vinci	فينشي	None
vino	نبيذ	Nan
virginia	فرجينيا	Nan
virus	الفيروس	None
virusa	الفيروس	None
visina	ارتفاع	None
visine	ارتفاع	None
vijećnica	قاعة المدينه	Nan
visini	ارتفاع	None
visinu	ارتفاع	None
visok	طويل	None
visoka	عالي	None
visoke	عالي	None
visoki	عالي	None
visokih	عالي	None
visokim	عالي	None
visinom	ارتفاع	None
vodi	يؤدي	None
vodik	هيدروجين	None
vodika	هيدروجين	None
vrline	مزايا	None
vrlo	للغاية	None
vrsta	طيب القلب	Nan
vrstama	محيط	None
vrste	محيط	None
vrsti	محيط	None
vrstom	اكتب	Nan
vrstu	اكتب	Nan
vrt	حديقة	None
vrše	ينفذ	Nan
vrši	ينفذ	Nan
vršiti	كي يؤدي	Nan
vuk	ذئب	Nan
vuka	ذئب	Nan
vukašinović	vukašinović	Nan
vrlina	استنادا	None
vrijeme	زمن	None
vrijednostima	القيم	None
vrijednosti	القيم	None
vremenu	زمن	None
vretena	المغزل	Nan
vrh	أعلى	None
vrha	أعلى	None
vrhbosna	vrhbosna	Nan
vrhova	قمم	Nan
vrhovi	قمم	Nan
vuku	فوكو	Nan
vrhovima	قمم	Nan
vrhovnog	أعلى فائق	Nan
vrhu	أعلى	None
vrhunac	ذروة	None
vrhuncu	قمة	None
vrijede	صالح	None
vrijedi	يستحق كل هذا العناء	Nan
vrijednost	القيمة	None
vrhovni	أعلى فائق	Nan
vremenskom	طقس	Nan
vukčić	ذئب	Nan
vuče	تسحب	Nan
xx	xx	Nan
y	ذ	Nan
yangtzea	yangtzea	Nan
york	يورك	Nan
yorka	يورك	Nan
yorku	يورك	Nan
yugioh	yugioh	Nan
z	ض	Nan
za	إلى عن على	Nan
zabavne	مرح	Nan
zabilježen	مسجل	Nan
zabilježena	مسجل	Nan
zabilježio	وأشار	None
zaboravi	انسى ذلك	Nan
zaboraviti	لتنسى	Nan
xviii	ثامن عشر	Nan
xvii	سابع عشر	Nan
xvi	السادس عشر	Nan
xv	الخامس عشر	Nan
washington	واشنطن	None
while	في حين	Nan
who	منظمة الصحة العالمية	Nan
wifi	واي فاي	Nan
wiki	ويكي	None
wikipedia	ويكيبيديا	None
wikipedije	ويكيبيديا	None
vulkana	بركان	None
wikipediji	ويكيبيديا	None
william	ويليام	None
wolfgang	الذئب	None
x	س	None
xi	حادي عشر	Nan
xii	ثاني عشر	Nan
xiv	الرابع عشر	Nan
xix	تاسع عشر	Nan
wilhelm	فيلهلم	Nan
vremenskih	طقس	Nan
vremenski	طقس	Nan
vremenske	طقس	Nan
vojnim	الجيش	None
vojno	الحرب	None
vojnog	الجيش	None
vojnoj	الحرب	None
vojnom	الحرب	None
vojnu	الحرب	None
vojsci	جيش	None
vojska	جيش	None
vojske	جيش	None
vojskom	جيش	None
vojskovođa	القائد العسكري	Nan
vojskovođe	القادة العسكريين	Nan
vojsku	جيش	None
vojvoda	دوق	Nan
vojvode	دوق	Nan
vojnike	الجنود	None
vojnika	الجنود	None
vojnik	جندي	None
vojnih	الجيش	None
vodila	يؤدى	None
vodili	يؤدى	None
vodio	يؤدى	None
voditi	قيادة	None
vodič	يرشد	Nan
vodom	ماء	Nan
vodonik	هيدروجين	None
vojvodina	فويفودينا	Nan
vodstvom	القيادة	None
vogošća	vogošća	Nan
vojičić	جندي	None
vojna	الحرب	None
vojne	الحروب	None
vojni	الحروب	None
vojnici	الجنود	None
vojnicima	الجنود	None
vodu	ماء	Nan
vojvodini	فويفودينا	Nan
vokal	غناء	None
vole	إرادة	None
vratili	عاد	None
vratima	الباب	None
vratio	عاد	None
vratiti	إرجاع	Nan
vratu	رقبه	Nan
vraća	عائدات	Nan
vraćaju	يعودون	Nan
vratila	الفتحة	Nan
vraćanje	إرجاع	Nan
vrbasa	vrbasa	Nan
vrela	الحار	None
vrelo	الحار	None
vreme	زمن	None
vremena	زمن	None
vremenima	مرات	None
vremenom	مع الوقت	Nan
vrbas	فرباس	Nan
većinski	أغلبية	None
vrati	إرجاع	Nan
vrabac	عصفور	Nan
volframat	التنغستن	Nan
voli	يحب	None
volim	أنا أحب	Nan
volio	محبوب	Nan
volja	إرادة	None
volje	إرادة	None
volumen	الصوت	None
vrata	باب	None
volumena	الصوت	None
vosak	الشمع	Nan
vozila	مركبات	None
voća	فاكهة	Nan
voćarstvo	نمو الفاكهة	Nan
voće	الفاكهة	Nan
vođa	زعيم	None
vođe	القادة	Nan
von	فون	None
zabranio	محظور	Nan
većinom	خاصة	None
većine	معظم	None
ustava	دستور	None
ustavna	دستوري	None
ustavne	دستوري	None
ustavni	دستوري	None
ustavnog	دستوري	None
ustavom	دستور	None
ustavu	دستور	None
ustima	فم	Nan
ustvari	حقيقة	None
usvojen	اعتمد	None
usvojena	اعتمد	None
utakmica	مباراة	None
utakmice	اعواد الكبريت	Nan
utakmici	اعواد الكبريت	Nan
utakmicu	مباراة	None
ustav	دستور	None
ustanove	المؤسسات	None
ustanova	المعهد	None
ustanka	الانتفاضة	None
uspješna	ناجح	Nan
uspješni	ناجح	Nan
uspješno	بنجاح	None
uspon	ترتفع	None
usporedba	مقارنة	None
usporedbi	مقارنة	None
uspostavili	أنشئت	None
utc	التوقيت العالمي	Nan
uspostaviti	إنشاء	None
uspostavljaju	إنشاء	None
uspostavljanja	مؤسسة	None
uspostavljanje	مؤسسة	None
uspostavljena	أنشئت	None
usprkos	على الرغم من	Nan
usta	فم	Nan
ustanak	الانتفاضة	None
uspostavlja	يؤسس	Nan
uspješan	ناجح	Nan
utemeljen	مؤرض	Nan
uticaj	تأثير	None
uvjet	شرط	None
uvjeta	الظروف	None
uvjete	الظروف	None
uvjeti	الظروف	None
uvjetima	الظروف	None
uvod	المقدمة	None
uvodi	مقدمات	Nan
uvođenja	المقدمة	None
uvođenje	المقدمة	None
uvođenjem	من خلال تقديم	Nan
uz	عز	None
uzeo	أخذ	None
uzeti	تؤخذ	Nan
uzgajaju	تتكاثر	Nan
uzgoj	تربية	None
uvijek	دائما	None
uveo	أدخلت	Nan
uveliko	إلى حد كبير	Nan
uveden	أدخلت	Nan
uticaja	تأثير	None
uticajem	تأثير	None
uticajima	تأثيرات	None
uticala	تأثر	None
utiče	يؤثر	None
utiču	تؤثر	None
utjecajem	تأثير	None
utemeljena	مؤرض	Nan
utvrda	حصن	None
utvrditi	لتحديد	None
utvrđena	تحدد	None
utvrđeni	تحدد	None
utvrđenja	التحصينات	Nan
utvrđenje	إغناء	Nan
utvrđeno	تحدد	None
utvrđuje	يحدد	None
utvrde	التحصينات	Nan
uzima	يأخذ	None
uspjesi	نجاحات	Nan
uspjele	نجح	None
uputa	تعليمات	Nan
upute	تعليمات	Nan
uputio	أمر	None
upućuje	يشير	None
upućuju	أشير	Nan
uradi	فعل	None
uradio	فعله	None
uraditi	لكى يفعل	Nan
uranijum	اليورانيوم	None
urbana	الحضاري	None
urbane	الحضاري	None
urbani	الحضاري	None
urednik	محرر	Nan
uređaj	جهاز	None
uređaja	جهاز	None
uprkos	بالرغم من	Nan
upravu	إدارة	None
upravom	إدارة	None
upravo	حق	None
upotreba	استعمال	None
upotrebe	استعمال	None
upotrebi	استعمال	None
upotrebljava	الاستخدامات	None
upotrebljavaju	استعمال	None
upotrebom	باستخدام	None
upotrebu	استعمال	None
uređaji	الأجهزة	None
upoznaje	يلتقي	None
uprava	إدارة	None
uprave	الادارة	Nan
upravlja	يدير	None
upravljaju	يدير	None
upravljanja	إدارة	None
upravljanje	إدارة	None
upravno	إداريا	Nan
upoznao	التقى	None
uspjeli	نجح	None
uređajima	الأجهزة	None
uređenja	ترتيبات	Nan
usluga	الخدمات	None
usluge	خدمات	None
usmena	عن طريق الفم	Nan
usne	الشفاه	Nan
usora	usora	Nan
usore	اغتصاب	Nan
usori	usori	Nan
uspijeva	ينجح	None
uspijevaju	هم نجحوا	Nan
uspio	نجح	None
uspjeh	نجاح	None
uspjeha	نجاح	None
uspjehe	نجاحات	Nan
uspjehom	نجاح	None
uspjela	نجح	None
uslovima	الظروف	None
uslovi	الظروف	None
uslove	الظروف	None
uslova	الظروف	None
uređenje	تنظيم	None
uređenju	تنظيم	None
us	نحن	None
usa	الولايات المتحدة الأمريكية	Nan
usb	يو اس بي	Nan
useljenika	المهاجرين	None
usko	ضيق	None
uređena	ترتيبها	Nan
uskoro	هكذا	None
uskrsa	عيد الفصح	Nan
uskufi	أوسكوفي	Nan
uslijed	بسبب	None
uslijedila	يتبع	None
uslijedio	يتبع	None
usljed	بسبب	None
uslov	شرط	None
uskrs	عيد الفصح	Nan
uzimaju	يأخذون	Nan
uzimanje	مع الأخذ	Nan
uzor	نمط	None
velež	velež	Nan
veleža	veleža	Nan
velik	كبير	None
velika	كبير	None
velike	كبير	None
veliki	كبير	None
velikih	كبير	None
velikim	كبير	None
veliko	كبير	None
velikog	عظيم	None
velikoj	عظيم	None
velikom	عظيم	None
veliku	عظيم	None
veličanstveni	رائع	Nan
veličanstvenog	رائع	Nan
vegetacija	الغطاء النباتي	Nan
vedad	vedad	Nan
ve	و	None
vc	ص	None
vatikan	الفاتيكان	None
vatra	نار	None
vaš	الخاص بك	Nan
važan	مهم	None
važi	صالح	None
važna	مهم	None
važne	مهم	None
veličina	بحجم	Nan
važni	مهم	None
važnije	اكثر اهمية	Nan
važniji	اكثر اهمية	Nan
važnijih	اكثر اهمية	Nan
važno	مهم	None
važnost	أهمية	None
važnosti	أهمية	None
važnu	مهم	None
važnih	مهم	None
vat	ضريبة القيمة المضافة	Nan
veličine	بحجم	Nan
veličinu	بحجم	Nan
veze	روابط	None
vezi	روابط	None
vezir	الوزير	None
vezira	الوزير	None
vezu	الإتصال	Nan
vezuje	يربط	None
već	سابقا	None
veća	أكبر	Nan
veće	ليل	Nan
većeg	أكبر	Nan
većem	أكبر	Nan
veći	أكبر	Nan
većih	أكبر	Nan
većim	أكبر	Nan
većina	معظم	None
vezano	ذات صلة	Nan
vezani	مقيد	Nan
vezane	مقيد	Nan
vezana	مقيد	Nan
vene	عروق	Nan
venecija	مدينة البندقية	Nan
venecije	مدينة البندقية	Nan
venera	كوكب الزهرة	Nan
venere	الوريد	Nan
veoma	للغاية	None
vergilije	فيرجيل	Nan
veličini	بحجم	Nan
verzija	الإصدار	None
verziji	الإصدار	None
verziju	الإصدار	None
veselin	فيسيلين	Nan
vetar	ريح	Nan
veza	الإتصال	Nan
vezama	روابط	None
vezan	مقيد	Nan
verzije	الإصدارات	Nan
vasiljevič	فاسيليفيتش	Nan
vas	أنت	None
varoš	فاروش	Nan
učestvovati	كي يشارك	Nan
učestvuje	تشارك	None
učestvuju	مشاركة	None
učešće	مشاركة	None
uči	يعلم	None
učini	افعلها	Nan
učinila	فعل	None
učinili	فعل	None
učinio	فعل	None
učiniti	لكى يفعل	Nan
učio	يعلم	None
učitelj	مدرس	Nan
uđe	يدخل	None
ušao	دخلت	None
ušla	اليسار	None
učestvovao	شارك	None
učestvovalo	شارك	None
učestvovali	شارك	None
učestvovala	شارك	None
uzoru	نمط	None
uzroci	الأسباب	None
uzrok	سبب	None
uzroka	سبب	None
uzrokovati	سبب	None
uzrokuje	الأسباب	None
uzrokuju	سبب	None
ušle	دخلت	None
uzvišenja	الارتفاعات	Nan
uče	تعلم	None
učenici	الطلاب	None
učenik	طالب علم	Nan
učenika	الطلاب	None
učenja	تعلم	None
učenje	تعلم	None
učenju	تعلم	None
ući	للدخول	Nan
ušli	اليسار	None
ušlo	ذهب	None
ušća	آذان	Nan
van	سيارة نقل	Nan
vanjska	خارجي	None
vanjske	خارجي	None
vanjski	خارجي	None
vanjskih	خارجي	None
vanjskim	خارجي	None
vanjsko	خارجي	None
vama	لك	None
vanjskog	خارجي	None
varijabla	متغير	Nan
varijable	المتغيرات	Nan
varijabli	المتغيرات	Nan
varijanta	البديل	Nan
varijante	المتغيرات	Nan
varira	يختلف	None
variraju	تختلف	None
vareš	انت تطبخ	Nan
većini	معظم	None
vam	لك	None
valute	عملة	None
ušće	مصب	Nan
ušću	أذن	Nan
uživali	استمتعت	Nan
uživao	استمتعت	Nan
uživo	حي	None
v	الخامس	None
vagina	المهبل	None
valutu	عملة	None
vagine	المهبل	None
vaju	فاجو	Nan
vakuf	وقف	None
vakufa	وقف	None
val	فال	Nan
valja	فالجا	Nan
valova	أمواج	Nan
valuta	عملة	None
vajta	أبيض	Nan
zabranjeno	ممنوع	Nan
zabranjenog	ممنوع	Nan
zadar	زادار	Nan
članovi	أفراد	None
članovima	أفراد	None
članstvo	عضوية	None
čola	جبين	Nan
čolić	مغص	Nan
čorba	حساء	Nan
čovjek	رجل	None
čovjeka	رجل	None
čovjeku	إلى رجل	Nan
čovječanstva	الإنسانية	None
čuda	المعجزات	Nan
čudo	معجزة	None
čuje	يسمع	Nan
čula	سمعت	None
čuo	سمعت	None
članove	أفراد	None
članova	أفراد	None
članku	مقالة - سلعة	Nan
članice	الدول الأعضاء	Nan
čitanje	قراءة	None
čitati	ليقرأ	Nan
čitav	أنا أقرا	Nan
čitava	يقرأ	None
čitave	اقرأ	None
čitavo	اقرأ	None
čitavog	كل	None
čuti	لكى اسمع	Nan
čitavu	أنا أقرا	Nan
čišćenja	تنظيف	Nan
čišćenje	تنظيف	Nan
član	عضو	Nan
člana	عضو	Nan
članak	مقالة - سلعة	Nan
članci	مقالات	None
članica	عضو	Nan
čitluk	chitluk	Nan
čitanja	قراءة٪ s	Nan
čuva	يحتفظ	None
čuvanje	تخزين	None
šantić	شانتيك	Nan
šef	رئيس	None
šest	ستة	None
šezdesetih	الستينات	None
šećer	السكر	None
šećera	السكر	None
šećerna	السكر	None
šipka	شريط	None
šira	أوسع	None
šire	أوسع	None
širem	انتشرت	None
širenja	توسيع	None
širenje	ينتشر	None
širenju	ينتشر	None
širi	الهوامش	Nan
šansu	فرصة	None
šansona	شانسون	Nan
šamca	شامكا	Nan
šamac	شاماك	Nan
čuvara	حارس	Nan
čuvari	حراس	Nan
čuvena	مشهور	None
čuveni	مشهور	None
čuvenu	مشهور	None
čvor	عقدة	Nan
čvrsta	صلب	None
čuvaju	احتفظ	None
čvrste	صلب	None
đelem	lemелем	Nan
đorđe	جورج	None
đuro	يورو	Nan
šaban	شعبان	None
šah	شطرنج	None
šalje	إرسال	None
šalju	يرسلون	Nan
čvrsto	قطعا	Nan
širila	الانتشار	None
čitaj	اقرأ	None
čisto	نظيف	Nan
čaršijska	šaršijska	Nan
časopisa	المجلات	None
čast	جزء	None
čega	ماذا	None
čehov	تشيخوف	Nan
čeka	انتظار	Nan
čekrk	ونش	Nan
čelik	صلب	None
čelika	صلب	None
čelo	جبين	Nan
čelu	جبين	Nan
čemu	لماذا ا	Nan
čengić	ćengić	Nan
čest	شرف	None
česta	متكرر	Nan
čaršiji	بازارات	Nan
čaršija	البازار	Nan
čapljina	مالك الحزين	Nan
čak	حتى في	Nan
ćatić	ćatić	Nan
ćazim	أنا آسف	Nan
će	إرادة	None
ćelija	زنزانة	Nan
ćelijama	الخلايا	None
ćelije	الخلايا	None
ćeliji	الخلايا	None
čestica	الجسيمات	None
ćelijski	خلوي	Nan
ćemo	سنقوم	Nan
ćirilica	السيريلية	Nan
ćirilice	السيريلية	Nan
ću	انا سوف	Nan
ćud	مزاج	Nan
ćuprija	أبرشية	Nan
čad	تشاد	None
ćeliju	زنزانة	Nan
čita	يقرأ	None
čestice	حبيبات	Nan
četiri	أربعة	None
čin	مرتبة	None
čine	ميك أب	Nan
čini	يبدو	None
činili	فعل	None
činilo	يبدو	None
činiti	لكى يفعل	Nan
činjenica	حقيقة	None
činjenice	حقائق	None
činjenici	حقائق	None
činjenicom	حقيقة	None
činjenicu	حقيقة	None
činom	فعل	None
činova	الرتب	None
čip	رقاقة	Nan
čist	نظيف	Nan
čime	ماذا	None
čim	من	None
čile	تشيلي	Nan
čiju	ملك من	Nan
četrdeset	أربعين	None
četverougao	رباعي	Nan
četvrt	ربع	None
četvrta	الرابع	None
četvrtak	الخميس	None
četvrti	الرابع	None
četvrtog	الرابع	None
često	غالبا	None
češka	جمهورية التشيك	Nan
češće	في كثير من الأحيان	Nan
čija	ملك من	Nan
čije	ملك من	Nan
čijem	ملك من	Nan
čiji	ملك من	Nan
čijim	ملك من	Nan
čijoj	ملك من	Nan
češke	التشيكية	Nan
širine	عرض	None
širiti	الانتشار	None
širok	على نطاق واسع	Nan
ženom	زوجة	None
ženska	النساء	None
ženske	نساء	None
ženski	أنثى	None
ženskog	أنثى	None
ženu	زوجة	None
žepče	جيوب	Nan
žestoke	شرسة	Nan
židova	اليهود	None
židovi	يهود	None
žigom	ختم	Nan
žitarice	الحبوب	None
živa	على قيد الحياة	Nan
žive	على قيد الحياة	Nan
živi	على قيد الحياة	Nan
ženki	الإناث	None
ženke	الإناث	None
ženka	أنثى	None
ženi	نساء	None
željeznice	السكك الحديدية	Nan
željezničar	سكة حديد	Nan
željezničara	سكة حديد	Nan
željeznička	سكة حديدية	Nan
željezničke	سكة حديدية	Nan
željeznički	سكة حديدية	Nan
željeznog	حديد	None
živih	على قيد الحياة	Nan
željezo	حديد	None
željo	رغبة	None
želuca	معدة	None
želudac	معدة	None
žena	النساء	None
ženama	نساء	None
žene	نساء	None
ženeva	جنيف	Nan
željko	زليجو	Nan
željeznica	سكة حديدية	Nan
živim	أعيش	Nan
živio	يسكن	None
životu	الحياة	None
žlijezda	السدادة	Nan
žlijezde	الغدد	None
žrtava	الضحايا	None
žrtva	ضحية	Nan
žrtve	الضحايا	None
župa	أبرشية	Nan
župe	الرعايا	Nan
župi	أبرشية	Nan
žuta	الأصفر	None
žute	الأصفر	None
žuti	الأصفر	None
žutica	اليرقان	Nan
žuto	الأصفر	None
јe	يكون	None
životom	الحياة	None
životnog	من الحياة	Nan
životnih	الحيوانات	None
životni	الحيوانات	None
živjela	يسكن	None
živjele	في صحتك	Nan
živjeli	في صحتك	Nan
živjelo	يسكن	None
živjeti	ليعيش	Nan
živković	kivković	Nan
življenja	من الحياة	Nan
živinice	دواجن	Nan
živo	حي	None
života	من الحياة	Nan
životinja	الحيوانات	None
životinjama	الحيوانات	None
životinje	الحيوانات	None
životinjskog	حيوان	None
životna	حيوان	None
životne	الحيوانات	None
život	الحياة	None
željezne	حديد	None
željeza	حديد	None
željeli	مطلوب	Nan
škotske	اسكتلندي	Nan
šlager	نجاح	None
šok	صدمة	Nan
šoka	صدمة	Nan
šoku	صدمة	Nan
španci	الإسبان	None
španija	إسبانيا	None
španije	من اسبانيا	Nan
španiji	إسبانيا	None
španske	الأسبانية	None
španski	الأسبانية	None
španskog	الأسبانية	None
španskom	بالإسبانية	Nan
šta	ماذا	None
štab	مقر	None
škotska	اسكتلندا	Nan
škorpioni	العقارب	Nan
školu	مدرسة	None
školstvo	التعليم	None
široke	على نطاق واسع	Nan
široki	على نطاق واسع	Nan
širokim	على نطاق واسع	Nan
široko	على نطاق واسع	Nan
širokom	على نطاق واسع	Nan
široku	على نطاق واسع	Nan
širom	بجانب	None
štaba	ماذا	None
šit	القرف	Nan
škola	مدرسة	None
školama	المدارس	None
škole	المدارس	None
školi	مدرسة	None
školovanja	التعليم	None
školovanje	التعليم	None
školskom	مدرسة	None
šiva	التماس	Nan
štajerska	ستيريا	Nan
štajerske	ستيريان	Nan
štajerskoj	ستيريا	Nan
šut	مهرج	Nan
švedska	السويد	None
švedske	السويدية	None
švedski	السويدية	None
švedskoj	السويدية	None
švicarska	سويسرا	None
švicarske	سويسري	Nan
šupljinu	تجويف	Nan
švicarskoj	سويسرا	None
žele	هلام	Nan
želeći	يريد	None
želi	هو يريد	Nan
želimo	نحن نريد	Nan
želio	مطلوب	Nan
želja	رغبة	None
želje	الرغبات	Nan
žalica	شفقة	Nan
 °c	درجة مئوية	Nan
šupljine	التجاويف	Nan
šume	الغابات	None
štajersku	ستيريا	Nan
štampa	صحافة	Nan
štampe	صحافة	Nan
šteta	شفقة	Nan
štete	ضرر	Nan
štetu	ضرر	Nan
štit	درع	None
šumom	الضوضاء	Nan
štita	درع	None
štiti	يحمي	None
štitna	غدة درقية	Nan
štitne	غدة درقية	Nan
što	ماذا	None
štokavski	oktokavian	Nan
šuma	غابة	Nan
šumama	الغابات	None
štite	يحمي	None
 mm ×  mm	مم × مم	Nan
 km²	كيلومتر مربع	Nan
 km	كم	Nan
zasluge	ميزة	None
zasniva	على أساس	Nan
zasnovan	على أساس	Nan
zasnovana	على أساس	Nan
zastava	العلم	None
zastave	أعلام	None
zastavu	العلم	None
zastupljen	ممثلة	None
zastupljena	ممثلة	None
zastupljeni	ممثلة	None
zastupljenost	التمثيل	None
zastupnici	مندوب	Nan
zastupnika	مندوب	Nan
zatim	ثم	None
zato	وبالتالي	None
zasjedanju	جلسة	None
zasigurno	بالتأكيد	Nan
zasebne	نشر	None
zapremina	الصوت	None
zapadnu	الغرب	None
zapadu	الغرب	None
zapis	سجل	None
zapisi	السجلات	Nan
zapisima	السجلات	Nan
zaposlenih	الموظفين	None
zaposleno	العاملين	None
zatražio	طلبت	None
zapovjednik	قائد	None
započela	بدأت	None
započeli	بدأت	None
započeo	بدأت	None
započinje	يبدأ	None
započinju	يبدأون	Nan
zapošljava	توظف	Nan
zapravo	حقيقة	None
zapovjedništvom	أمر	None
zapadnom	الغربي	None
zatvara	يغلق	Nan
zatvoren	مغلق	Nan
zavjet	نذر	Nan
zavnobiha	zavnobiha	Nan
zavod	نبات	None
završava	ينتهي	None
završen	منجز	Nan
završena	منجز	Nan
završetak	إكمال	Nan
završetka	إكمال	Nan
završetkom	إكمال	Nan
završetku	إكمال	Nan
završila	تم الانتهاء من	Nan
završio	تم الانتهاء من	Nan
završni	نهائي	None
zaštita	الحماية	None
zaštite	الحماية	None
zavisnosti	التبعيات	Nan
zavisno	حسب	None
zavisi	يعتمد على	Nan
zavise	هذا يعتمد	Nan
zatvorena	مغلق	Nan
zatvoreni	مغلق	Nan
zatvoru	السجن	None
zaustavlja	توقف	None
zauvijek	إلى الأبد	Nan
zauzela	احتل	None
zauzeli	احتل	None
zatvora	السجن	None
zauzeo	احتل	None
zauzima	تحتل	None
zauzimaju	تشغل	None
zauzimanja	المهن	Nan
zauzimanje	احتلال	None
zauzme	يستحوذ على	Nan
zavale	زافال	Nan
zavidovići	حسود	Nan
zauzeti	مشغول	Nan
zapadnoj	الغربي	None
zapadnog	الغربي	None
zapadno	الغرب	None
zahtjeva	المتطلبات	Nan
zahtjeve	المتطلبات	Nan
zahtjevima	المتطلبات	Nan
zahvaljujući	شكر	Nan
zahvata	قبضة	Nan
zaista	في الواقع	Nan
zajednica	تواصل اجتماعي	Nan
zajednicama	مجتمعات	None
zajednice	مجتمعات	None
zajednici	تواصل اجتماعي	Nan
zajednicu	تواصل اجتماعي	Nan
zajednička	مشترك	None
zajedničke	مشترك	None
zajednički	مشترك	None
zajedničko	مشترك	None
zahtjev	طلب	None
zahtijeva	يستوجب	Nan
zagrebu	زغرب	Nan
zagreba	زغرب	Nan
zadatak	مهمة	None
zadaća	واجب منزلي	Nan
zadaće	واجب منزلي	Nan
zadnja	الاخير	Nan
zadnje	الاخير	Nan
zadnjeg	الاخير	Nan
zadnjem	الاخير	Nan
zajedničkog	مشترك	None
zadnji	الاخير	Nan
zadržao	أبقى	Nan
zadržati	احتفظ	None
zadržava	يحتفظ	None
zadržavaju	الاحتفاظ	None
zadužbina	هبة او منحة	Nan
zadužen	ملزمة	Nan
zagreb	زغرب	Nan
zadnjih	الاخير	Nan
zajedničku	مشترك	None
zajedno	سويا	Nan
zaključak	خاتمة	Nan
zamijeniti	يحل محل	Nan
zamjenjuje	يستبدل	Nan
zanatlije	الحرفيين	Nan
zanimanja	المهن	Nan
zanimanje	احتلال	None
zanimljiv	مثير للإعجاب	Nan
zanimljiva	مثير للإعجاب	Nan
zamijenio	تم استبداله	Nan
zanimljivo	مثير للإعجاب	Nan
zapad	الغرب	None
zapada	الغرب	None
zapadna	الغربي	None
zapadne	الغربي	None
zapadni	الغربي	None
zapadnih	الغربي	None
zapadnim	الغربي	None
zanimljivosti	الفضول	Nan
zaštiti	يحمي	None
zaljeva	من الخليج	Nan
zalihe	مخزون	Nan
zaključio	انتهى	None
zaključiti	ليستنتج	Nan
zaključka	خاتمة	Nan
zakon	القانون	None
zakona	من القانون	Nan
zakone	القوانين	None
zakoni	القوانين	None
zaliv	خليج	None
zakonima	القوانين	None
zakonodavna	تشريعي	Nan
zakonodavnu	تشريعي	Nan
zakonom	بموجب القانون	Nan
zakonski	من الناحية القانونية	Nan
zakonu	القانون	None
zalagao	تعهد	Nan
zalaska	غروب الشمس	Nan
zakonitosti	الشرعية	None
uporišta	المعاقل	Nan
zaštitni	محمي	Nan
zašto	لماذا ا	Nan
značajne	كبير	None
značajni	كبير	None
značajnih	كبير	None
značajnije	أكثر أهمية	Nan
značajnijih	أكثر أهمية	Nan
značajnim	كبير	None
značajno	بشكل كبير	Nan
značajnu	كبير	None
značaju	الدلالة	None
značenja	المعاني	None
značenje	المعنى	None
značenju	المعنى	None
znači	يعني	None
značilo	يعني	None
zona	منطقة	None
značajna	كبير	None
značajan	كبير	None
značaja	الدلالة	None
značaj	الدلالة	None
znaka	إشارة	None
znakova	الشخصيات	None
znakove	علامات	None
znakovi	علامات	None
znala	هي تعرف	Nan
znali	عرفو	Nan
znam	أنا أعلم	Nan
zone	منطقة	None
znamenitosti	مشاهد	None
znanja	المعرفه	Nan
znanje	المعرفه	Nan
znao	هو يعرف	Nan
znatan	ضخم	None
znati	لتعرف	Nan
znatne	ضخم	None
znatno	إلى حد كبير	Nan
znamo	نعلم	Nan
znak	إشارة	None
zoni	منطقة	None
zora	فجر	None
zvaničan	الرسمية	None
zvanična	الرسمية	None
zvanični	الرسمية	None
zvanično	بشكل رسمي	Nan
zvaničnu	الرسمية	None
zvao	اتصل	Nan
zvijezda	نجمة	None
zvijezdama	النجوم	None
zvijezde	النجوم	None
zvornik	zvornik	Nan
zvornika	zvornika	Nan
zvuk	صوت	None
zvuka	صوت	None
zvučne	صوت	None
zvučni	صوتي	Nan
zvani	اتصل	Nan
zvane	اتصل	Nan
zvan	اتصل	Nan
zvali	اتصل	Nan
zoran	زوران	Nan
zore	فجر	None
zorica	زوريكا	Nan
zove	الاتصال	None
zovu	يسمونه	Nan
zrak	الهواء	None
zraka	الهواء	None
zonu	منطقة	None
zrake	أشعة	None
zračenja	إشعاع	None
zračenje	إشعاع	None
zračne	جوي	None
zračni	جوي	None
zub	سن	None
zubi	أسنان	Nan
zvala	اتصل	Nan
zraku	الهواء	None
znaju	هم يعرفون	Nan
znaci	يعني	None
zna	هو يعرف	Nan
zelenim	أخضر	Nan
zeleno	أخضر	Nan
zemalja	بلدان	None
zemaljska	ساكن الأرض	Nan
zemlja	أرض	None
zemljama	بلدان	None
zemlje	بلدان	None
zemlji	بلد	None
zemljine	أرض	None
zemljinoj	أرض	None
zemljišta	أرض	None
zemljište	أرض	None
zemljom	بلد	None
zemlju	أرض	None
zemnog	ساكن الأرض	Nan
zelenih	أخضر	Nan
zeleni	أخضر	Nan
zelene	أخضر	Nan
zelena	أخضر	Nan
zbir	مجموع	None
zbirci	مجموعات	None
zbirka	مجموعة	Nan
zbirke	مجموعات	None
zbirku	مجموعة	Nan
zbivanja	الأحداث	None
zbog	بسبب	None
zenica	التلميذ	Nan
zbornik	مجموعة	Nan
zdravko	مرحبا	Nan
zdravlja	الصحة	None
zdravlje	الصحة	None
zdravstvene	الصحة	None
zekat	زكاة	Nan
zeland	زيلاند	Nan
zelandu	زيلاند	Nan
zdenko	zdenko	Nan
zenice	التلاميذ	None
zenici	التلاميذ	None
zenit	ذروة	None
zlatna	ذهب	None
zlatne	ذهب	None
zlatni	ذهب	None
zlatnih	ذهب	None
zlatnim	ذهبي	Nan
zlatno	ذهب	None
zlatnu	ذهب	None
zlatko	عسل	None
zlato	ذهب	None
zlo	شرير	Nan
zločin	جريمة	Nan
zločina	جريمة	Nan
zločine	الجرائم	None
zlu	شرير	Nan
zmija	ثعبان	Nan
zmije	الثعابين	Nan
zli	شرير	Nan
zaštitu	الحماية	None
zlatan	ذهبي	Nan
zla	شرير	Nan
zeus	زيوس	Nan
zgrada	بناء	None
zgrade	البنايات	Nan
zid	حائط	None
zida	حائط	None
zidina	حائط	None
zidine	الجدران	Nan
zlata	ذهب	None
zidova	الجدران	Nan
zidovi	الجدران	Nan
zima	شتاء	Nan
zimama	الشتاء	None
zime	الشتاء	None
zimi	في الشتاء	Nan
zimske	شتاء	Nan
zimskim	شتاء	Nan
zidove	الجدران	Nan
okolnosti	ظروف	None
uporedo	بالتوازي	Nan
upale	التهاب	None
stećaka	شواهد القبور	Nan
stećci	شواهد القبور	Nan
stećcima	stećci	Nan
stick	عصا	Nan
stidne	عار	Nan
stigao	وصل	None
stigla	وصل	None
stigli	وصل	None
stihova	آيات	None
stihove	آيات	None
stihovi	آيات	None
stihovima	آيات	None
stijena	صخرة	Nan
stijenama	الصخور	None
stijene	الصخور	None
stećak	ستاك	Nan
steven	ستيفن	Nan
stepena	الدرجة العلمية	Nan
stepen	الدرجة العلمية	Nan
status	الحالة	Nan
statusa	الحالة	Nan
stav	موقف سلوك	Nan
stavio	وضع	None
staviti	وضع	None
stavlja	يضع	None
stavova	الاتجاهات	None
stil	أسلوب	None
staze	مسارات	Nan
ste	أنت	None
stefan	ستيفان	Nan
stefana	ستيفانا	Nan
stekao	اكتسبت	None
stekla	زجاج	Nan
stepa	السهوب	Nan
stepe	السهوب	Nan
stc	stc	Nan
statistički	إحصائيا	Nan
stila	أسلوب	None
stiče	يكتسب	Nan
strah	خوف	None
straha	خوف	None
strahu	خوف	None
strana	جانب	None
stranaca	أجانب	Nan
stranaka	حفلات	Nan
stranama	بلدان	None
stranci	أجانب	Nan
strane	الجانبين	None
strani	الصفحات	Nan
stranica	الصفحة	None
stranicama	الصفحات	Nan
stranice	الصفحات	Nan
stranici	الصفحة	None
stranih	أجنبي	Nan
stočarstvo	الماشية	None
stotinu	مائة	None
stotinjak	مائة	None
stotine	المئات	None
stiže	يصل	None
stjenovitih	صخري	Nan
stjepan	ستجيبان	Nan
stjepana	ستجيبانا	Nan
sto	مائة	None
stoca	ماشية	Nan
stoga	وبالتالي	None
stilu	أسلوب	None
stoje	يقفون	Nan
stolac	كرسي	None
stoljeća	مئة عام	Nan
stoljeću	مئة عام	Nan
stopa	معدل	None
stope	خطوات	Nan
stopu	معدل	None
stotina	مائة	None
stoji	البقاء	None
stranim	أجنبي	Nan
statistike	الإحصاء	None
states	تنص على	Nan
stabilna	مستقر	Nan
stabilnost	المزيد	None
stade	السلم	None
stadion	ملعب	None
stadiona	ملعب	None
stadionu	ملعب	None
stagnacije	ركود	Nan
stajališta	الآراء	Nan
stajalište	وجهة نظر	Nan
stalež	مخزون	Nan
staleža	مخزون	Nan
stalne	دائم	None
stalni	دائم	None
stalno	باستمرار	None
stambenih	الإسكان	Nan
sssra	سسرة	Nan
sssr	sssr	Nan
ss	ss	Nan
srž	نخاع	Nan
sreće	السعادة	None
sreću	السعادة	None
srpska	صربي	Nan
srpske	صربي	Nan
srpski	صربي	Nan
srpskih	صربي	Nan
srpskim	صربي	Nan
standard	اساسي	Nan
srpsko	صربي	Nan
srpskohrvatski	الصربية الكرواتية	Nan
srpskohrvatskog	الصربية الكرواتية	Nan
srpskoj	صربي	Nan
srpskom	صربي	Nan
srpsku	صربي	Nan
srušena	هدم	None
srčanog	عضلات قلبية	Nan
srpskog	صربي	Nan
statistika	الإحصاء	None
standarda	اساسي	Nan
standardima	المعايير	None
stari	رجل عجوز	Nan
starih	قديم	None
starije	اكبر سنا	Nan
starijeg	اكبر سنا	Nan
stariji	اكبر سنا	Nan
starijih	اكبر سنا	Nan
starim	قديم	None
staro	قديم	None
starog	رجل عجوز	Nan
staroj	قديم	None
starom	قديم	None
starost	عمر	None
starosti	عمر	None
staru	قديم	None
state	حالة	None
stare	قديم	None
stara	قديم	None
star	نجمة	None
stanovništvu	تعداد السكان	Nan
standardna	اساسي	Nan
standardni	اساسي	Nan
standardnog	اساسي	Nan
stanica	محطة	None
stanice	محطات	None
stanicu	محطة	None
stanja	الظروف	None
standardi	المعايير	None
stanje	شرط	None
stanovišta	الآراء	Nan
stanovnici	السكان	None
stanovnicima	السكان	None
stanovnika	مواطن	None
stanovništva	تعداد السكان	Nan
stanovništvo	تعداد السكان	Nan
stanovništvom	تعداد السكان	Nan
stanju	شرط	None
stranka	حفل	None
stranke	الزبائن	Nan
stranom	جانب	None
suprugu	زوجة	None
supstanca	مستوى	None
supstance	مواد	None
supstanci	مواد	None
sure	بالتأكيد	Nan
susjeda	الجيران	Nan
susjedima	الجيران	Nan
susjedne	متاخم	Nan
susjednih	المجاورة	None
susjednim	متاخم	Nan
susret	لقاء	None
susreće	يلتقي	None
susreću	يجتمع	None
suverenitet	سيادة	None
sučić	sučić	Nan
supruge	زوجات	None
supruga	زوجة	None
suprotnosti	المعاكسات	Nan
suprotnom	المقابل	None
sumnje	شكوك	Nan
sumpor	الكبريت	None
sumpora	الكبريت	None
sumrak	الغسق	Nan
sunca	من الشمس	Nan
sunce	الشمس	None
sunitski	سني	Nan
suđeno	محكوم	Nan
sunnet	سونيت	Nan
sunčeva	شمسي	Nan
sunčeve	الشموس	Nan
sunčevog	شمسي	Nan
sunčevom	شمسي	Nan
super	ممتاز	Nan
suprotan	ضد	None
suprotno	على العكس تماما	Nan
sunčev	شمسي	Nan
sultana	سلطان	None
suša	جفاف	None
suštini	المضمون	Nan
sveta	العالمية	None
svete	مقدس	Nan
sveti	مقدس	Nan
sveto	مقدس	Nan
svetog	مقدس	Nan
svetom	العالم	None
svetozar	سفيتوزار	Nan
svećenik	كاهن	Nan
svi	الكل	Nan
svih	الكل	Nan
svijest	وعي - إدراك	Nan
svijesti	وعي - إدراك	Nan
svijet	العالم	None
svijeta	من العالم	Nan
svijetli	مشرق	Nan
svemu	كل شىء	Nan
svemiru	الكون	None
svemirska	الفراغ	None
svemira	الكون	None
sv	الكل	Nan
sva	الكل	Nan
svaka	كل	None
svakako	من المؤكد	Nan
svake	كل	None
svaki	كل	None
svakih	لكل واحد	Nan
sušić	مجفف	Nan
svako	كل واحد	Nan
svakog	كل واحد	Nan
svakoj	لكل	None
svakom	للجميع	None
svaku	كل	None
sve	كل شىء	Nan
svega	كل شىء	Nan
svemir	الفراغ	None
svakodnevno	كل يوم	Nan
sultan	سلطان	None
sulejmana	السليمانية	Nan
sulejman	سليمان	None
student	طالب علم	Nan
studenti	الطلاب	None
studij	دراسة	Nan
studija	دراسة	Nan
studije	دراسات	None
studijski	الاستوديو	Nan
studio	الاستوديو	Nan
studirao	درس	None
stupio	دخلت	None
stvar	شيء	None
stvara	يخلق	Nan
stvaraju	خلق	Nan
stvaralaštva	إبداعات	Nan
stvaralaštvo	الإبداع	None
stvaranja	خلق	Nan
studenata	البرد	Nan
stručnjaka	خبراء	Nan
stručnjaci	خبراء	Nan
stručni	خبير	Nan
stranu	جانب	None
strategija	إستراتيجية	None
strategije	الاستراتيجيات	Nan
strateški	استراتيجيا	Nan
streptomicin	الستربتوميسين	Nan
strijelac	الرامي	Nan
strogo	بشكل صارم	Nan
stvaranje	خلق	Nan
struja	كهرباء	None
struju	كهرباء	None
struktura	بناء	None
strukture	الهياكل	None
strukturi	الهياكل	None
strukturom	بناء	None
strukturu	بناء	None
strume	تعثر	Nan
struje	كهرباء	None
stvaranjem	بواسطة انشاء	Nan
stvaranju	خلق	Nan
stvari	أشياء	None
sudbini	مصير	None
sudbinu	مصير	None
sudija	قاضي	Nan
sudije	القضاة	None
sudom	محكمة	Nan
sudova	المحاكم	Nan
sudovi	المحاكم	Nan
sudbine	مصير	None
sudska	قضائي	Nan
suha	جاف	Nan
suhe	جاف	Nan
sukob	نزاع	Nan
sukoba	نزاع	Nan
sukobe	الصراعات	None
sukobi	الصراعات	None
sukobu	نزاع	Nan
sudu	محكمة	Nan
sreza	يقطع	Nan
sudbina	مصير	None
sudaca	القضاة	None
stvarima	أشياء	None
stvarne	حقيقة	None
stvarni	حقيقة	None
stvarno	هل حقا	Nan
stvarnost	واقع	None
stvarnosti	واقع	None
stvoren	خلقت	Nan
sudačke	القضاة	None
stvorena	خلقت	Nan
stvorili	خلقت	Nan
stvorio	خلقت	Nan
stvoriti	لنصنع او لنبتكر	Nan
su	هم	None
subjekt	موضوع	None
sud	محكمة	Nan
suda	محكمة	Nan
stvori	خلق	Nan
svijetlo	ضوء	None
srez	شريحة	Nan
sredstvima	الأموال	None
smiju	انهم قد	Nan
smisao	المعنى	None
smisla	إحساس	Nan
smislu	إحساس	Nan
smjer	اتجاه	None
smjeru	اتجاه	None
smješten	تقع	None
smještena	تقع	None
smještene	تقع	None
smješteni	تقع	None
smješteno	تقع	None
smo	هم	None
smrt	الموت	None
smrti	الموت	None
smrću	الموت	None
smijer	اتجاه	None
smije	يضحك	Nan
smeđe	بنى	None
smetnje	التشوش	Nan
služio	خدم	Nan
služiti	ليخدم	Nan
smanjena	انخفاض	None
smanjenja	تخفيضات	Nan
smanjenje	تخفيض	None
smanjuje	يقلل	None
smanjuju	خفض	None
snaga	قوة	None
smatra	اعتبر	None
smatrajući	مع مراعاة	Nan
smatrala	اعتبر	None
smatrali	اعتبر	None
smatralo	اعتبر	None
smatrana	اعتبر	None
smatrao	اعتبر	None
smatrati	يعتبر	None
smatraju	اعتبر	None
služili	خدم	Nan
snagama	القوات	None
snagom	قوة	None
snimio	تم تصويره	Nan
snimka	لمحة	Nan
snimljen	مسجل	Nan
so	وبالتالي	None
soba	غرفة	None
sobe	غرف	Nan
sobom	معك	Nan
socijalistička	الاشتراكي	None
socijalističke	الاشتراكي	None
socijalističkih	الاشتراكي	None
socijalističkog	الاشتراكي	None
socijalizam	الاشتراكية	None
socijalizma	الاشتراكية	None
socijalna	اجتماعي	None
socijalne	اجتماعي	None
snimili	مسجل	Nan
snimila	مسجل	Nan
snimci	التسجيلات	Nan
snimanju	تسجيل	None
snagu	قوة	None
snazi	قوة	None
snažan	قوي	None
snažna	قوي	None
snažne	قوي	None
snažnim	قوي	None
snažno	بقوة	None
snage	قوة	None
snažnom	قوي	None
snijega	ثلج	Nan
snijegom	ثلج	Nan
snima	السجلات	Nan
snimak	لمحة	Nan
sniman	تم تصويره	Nan
snimanja	تسجيل	None
snimanje	تسجيل	None
snijeg	ثلج	Nan
socijalni	اجتماعي	None
služila	خدم	Nan
služe	تخدم	None
sljedećim	التالى	Nan
sloboda	حرية	None
slobodan	مجانا	Nan
slobodana	مجانا	Nan
slobode	حرية	None
slobodi	حرية	None
slobodna	مجانا	Nan
slobodne	مجانا	Nan
slobodni	مجانا	Nan
slobodnih	مجانا	Nan
slobodnim	مجانا	Nan
slobodno	مجانا	Nan
slobodnog	مجانا	Nan
slobodnoj	مجانا	Nan
slobodnom	مجانا	Nan
sljedećih	ما يلي	Nan
sljedeći	التالى	Nan
sljedeće	ما يلي	Nan
sljedeća	التالى	Nan
slike	صور	None
slikom	صورة	None
sliku	صورة	None
sliva	وظيفة محترمة	Nan
slivu	وظيفة محترمة	Nan
sličan	مماثل	None
slična	مماثل	None
slobodnu	مجانا	Nan
slične	مماثل	None
sličnih	مماثل	None
sličnim	مماثل	None
slično	مماثل	None
sličnost	تشابه	Nan
sličnosti	التشابه	None
sličnu	مماثل	None
sljedbenici	متابعون	Nan
slični	مماثل	None
služi	يخدم	None
slobodu	حرية	None
sloj	طبقة	None
slučajevi	الحالات	None
slučajevima	الحالات	None
slučajno	بالصدفة	Nan
slučaju	قضية	None
služba	الخدمات	None
službe	خدمات	None
službena	الرسمية	None
službene	الرسمية	None
službeni	الرسمية	None
službenih	الرسمية	None
službeno	بشكل رسمي	Nan
službenoj	الرسمية	None
službenom	الرسمية	None
službi	خدمات	None
službu	الخدمات	None
slučajeva	الحالات	None
slučaja	قضية	None
slučaj	قضية	None
složene	مركب	None
sloja	طبقة	None
slojeva	طبقات	Nan
slojevima	طبقات	Nan
slom	انفصال	None
sloma	انفصال	None
slonovače	عاج	Nan
slova	كلمات	None
sloga	مقطع	Nan
slovačka	سلوفاكيا	Nan
slovenci	السلوفينيون	Nan
slovenija	سلوفينيا	Nan
slovenije	سلوفينيا	Nan
sloveniji	سلوفينيا	Nan
slovo	كلمة	None
slovom	في كلمة واحدة	Nan
složena	مركب	None
slovenaca	السلوفينيون	Nan
socijalnih	اجتماعي	None
socijalno	اجتماعيا	Nan
socijalnu	اجتماعي	None
spuštaju	يذهبون إلى أسفل	Nan
spö	spö	Nan
sr	ريال سعودى	Nan
srba	الصرب	None
srbe	الصرب	None
srbi	الصرب	None
srbija	صربيا	None
srbije	صربيا	None
srbiji	صربيا	None
srbijom	صربيا	None
srbiju	صربيا	None
srbima	الصرب	None
srca	قلب	None
srce	قلب	None
srcem	قلب	None
spušta	ينزل	None
spriječiti	كى تمنع	Nan
spreče	يمنع	None
spreča	يمنع	None
sportova	رياضات	Nan
sportovi	رياضات	Nan
sportovima	رياضات	Nan
sportska	رياضات	Nan
sportske	رياضات	Nan
sportski	رياضات	Nan
sportskih	رياضات	Nan
srcu	قلب	None
sportskim	رياضات	Nan
sposobni	قادر	None
sposobnost	القدرة	None
sposobnosti	القدرة	None
spoznaja	معرفة	None
spoznaje	الإدراك	Nan
spoznati	فهم	None
sprave	الأجهزة	None
sportu	رياضات	Nan
sportom	رياضات	Nan
srebra	فضة	Nan
srebrenice	srebrenice	Nan
srednjih	متوسط	None
srednjim	متوسط	None
srednjoj	ثانوي	Nan
srednjovjekovna	في العصور الوسطى	Nan
srednjovjekovne	في العصور الوسطى	Nan
srednjovjekovni	في العصور الوسطى	Nan
srednjovjekovnih	في العصور الوسطى	Nan
srednjovjekovnog	في العصور الوسطى	Nan
srednjovjekovnoj	في العصور الوسطى	Nan
srednjovjekovnu	في العصور الوسطى	Nan
srednju	متوسط	None
sredozemna	البحر المتوسط	Nan
sredozemnom	البحر المتوسط	Nan
sredstava	الأموال	None
sredstva	الأموال	None
srednji	متوسط	None
srednjem	متوسط	None
srednjeg	متوسط	None
srednje	متوسط	None
srebrenici	srebrenici	Nan
srebrenicu	سريبرينيتسا	Nan
srebrenik	سريبرينيك	Nan
srebro	فضة	Nan
sredine	الوسط	None
sredini	في المنتصف	Nan
sredinom	في المنتصف	Nan
srebrenica	سريبرينيتسا	Nan
središnja	وسط	None
središnjem	وسط	None
središnji	وسط	None
središta	المراكز	None
središte	مركز	None
središtem	المركز	None
središtu	المركز	None
srednja	متوسط	None
središnje	وسط	None
sportisti	الرياضيين	Nan
sportista	رياضي	Nan
sporta	رياضات	Nan
sovjetski	سوفيتي	Nan
sovjetskog	سوفيتي	Nan
sp	س	None
spada	السقوط	Nan
spadaju	خريف	Nan
spahić	spahić	Nan
spaja	يربط	None
spajaju	الاتصال	None
sparta	سبارتا	Nan
sparte	سبارت	Nan
spavanja	ينام	Nan
spavanje	ينام	Nan
specifičan	محدد	None
specifična	محدد	None
specifične	محدد	None
sovjetske	سوفيتي	Nan
sovjetska	سوفيتي	Nan
sorte	فرز	Nan
sophie	صوفي	Nan
sociologija	علم الاجتماع	Nan
sociologije	علم الاجتماع	Nan
sofija	صوفيا	None
sofokle	smocles	Nan
softver	البرمجيات	None
softvera	البرمجيات	None
soko	الصقر	Nan
specifičnosti	النوعية	None
sokolović	سوكولوفيتش	Nan
sokova	عصير	None
sokrat	سقراط	None
solarni	شمسي	Nan
soli	ملح	Nan
solo	فقط	None
sonde	مسبار	Nan
sony	سوني	Nan
sokolovića	sokolovića	Nan
specijalne	مميز	Nan
specijalnih	مميز	Nan
specijalnim	مميز	Nan
spomenicima	آثار	None
spomenik	نصب تذكاري	Nan
spomenika	نصب تذكاري	Nan
spomenuti	ذكر	None
spominje	يذكر	None
spominju	أشير	Nan
spora	خلاف	None
spomenici	آثار	None
sporazum	اتفاق	None
sporazume	الاتفاقات	Nan
sporazumom	اتفاق	None
sporazumu	اتفاق	None
spore	الجراثيم	None
sporije	أبطأ	Nan
sporo	بطيء	Nan
sport	رياضة	None
sporazuma	اتفاق	None
sredstvo	يعني	None
spomen	نصب تذكاري	Nan
spolnih	جنسي	None
spektar	الطيف	None
spektra	الطيف	None
spermatozoid	الحيوانات المنوية	Nan
spisak	قائمة	None
spisi	كتابات	None
split	انشق، مزق	Nan
splita	انشق، مزق	Nan
spolnog	جنسي	None
splitski	splitski	Nan
splitu	انشق، مزق	Nan
spoj	مركب	None
spojeva	مجمعات سكنية	Nan
spojevi	مجمعات سكنية	Nan
spol	spol	Nan
spola	جنس	None
spolni	جنسي	None
splitskom	انشق، مزق	Nan
svijetom	العالم	None
svijetu	العالم	None
svim	للجميع	None
turizam	السياحة	None
turizma	السياحة	None
turneja	جولة	None
turneje	جولات	Nan
turneju	جولة	None
turnir	المسابقة	None
turnira	المسابقة	None
turniri	البطولات	None
turno	منعطف أو دور	Nan
turska	ديك رومي	Nan
turske	اللغة التركية	Nan
turski	اللغة التركية	Nan
turskim	اللغة التركية	Nan
turskog	اللغة التركية	Nan
turskoj	اللغة التركية	Nan
turistički	سائح	Nan
turističke	سائح	Nan
turistička	سائح	Nan
turista	سائح	Nan
trupe	القوات	None
tržišta	الأسواق	None
tržište	سوق	None
tržištu	سوق	None
tu	أنت	None
tuge	الحزن	Nan
tulijum	الثوليوم	Nan
turskom	اللغة التركية	Nan
tumačenja	تفسيرات	Nan
tumačenju	ترجمة	None
tumor	ورم	Nan
tumora	ورم	Nan
tumori	أورام	Nan
tunel	نفق	Nan
tunis	تونس	None
turci	أتراك	Nan
tumačenje	ترجمة	None
trupa	جثة	Nan
tursku	اللغة التركية	Nan
tuzlanskog	توزلا	Nan
tvrđava	قلعة	None
tvrđave	القلاع	None
tvrđavu	قلعة	None
tzv	ما يسمى ب	Nan
u	ش	Nan
ubija	يقتل	None
ubijaju	يقتلون	Nan
ubijen	قتل	None
ubijeni	قتل	None
ubijeno	قتل	None
ubio	قتل	None
ubistva	جرائم القتل	Nan
ubistvo	قتل	None
ubiti	ليقتل	Nan
ubraja	العد	Nan
tvrtko	شركة	None
tvrtka	شركة	None
tvrdoća	صلابة	Nan
tvrdnje	المطالبات	Nan
tuzle	ضجة	Nan
tuzli	توزلي	Nan
tuđman	tudjman	Nan
tuđmana	tudjman	Nan
tv	تلفزيون	None
tvari	مواد	None
tvoje	خاصة بك	Nan
tuzla	توزلا	Nan
tvorac	المنشئ	Nan
tvorevina	خلق	Nan
tvornica	مصنع	None
tvornice	المصانع	None
tvrde	يدعون	None
tvrdi	المطالبات	Nan
tvrdio	ادعى	Nan
tvrdnja	يطالب	Nan
tvore	شكل	None
ubrajaju	انهم يحصون	Nan
trudnoće	حمل	None
trudna	حامل	None
trebali	ينبغي	None
trebalo	ينبغي	None
trebao	ينبغي	None
trebinje	تريبينيي	Nan
trebinju	بحاجة إلى	Nan
trend	الاتجاه	None
trener	مدرب	Nan
trenera	مدرب	Nan
trenja	احتكاك	Nan
trenje	احتكاك	Nan
trenutak	لحظة	None
trenutka	لحظة	None
trenutku	لحظة	None
trenutni	تيار	None
trenutno	حاليا	None
trebale	ينبغي	None
trebala	ينبغي	None
trebaju	هم يحتاجون	Nan
treba	ينبغي	None
traje	يدوم	Nan
trajno	بشكل دائم	Nan
traju	الاخير	Nan
transakcija	عملية تجارية	Nan
transport	المواصلات	None
tranzistora	الترانزستورات	Nan
travnik	مرج	Nan
tretman	علاج او معاملة	Nan
travnika	مرج	Nan
traže	البحث عن	Nan
traženje	بحث	None
tražeći	يسأل	Nan
traži	بحث	None
tražio	طلبت	None
tražiti	يسعى ل	Nan
trbušne	البطني	Nan
travniku	الحديقة	None
trudnoća	حمل	None
tretmanu	علاج او معاملة	Nan
treće	الثالث	None
tri	ثلاثة	None
tribunalom	محكمة	Nan
trideset	ثلاثون	Nan
trifunović	trifunović	Nan
trigonometrijske	حساب المثاثات	Nan
triju	ثلاثة	None
trnovo	شوكة	Nan
troje	ثلاثة	None
tron	عرش	None
trougao	مثلث	None
trougla	مثلث	None
trovanja	تسمم	Nan
troy	طروادة	Nan
trošak	كلفة	Nan
troškova	التكاليف	Nan
trgu	ميدان	None
trgovinu	التجارة	None
trgovinom	التجارة	None
trgovini	التجارة	None
trećeg	الثالث	None
trećem	الثالث	None
treći	الثالث	None
trećina	الثالث	None
trećine	الثلثين	Nan
trećoj	الثالث	None
trešnja	كرز	Nan
treća	الثالث	None
trg	trg	Nan
trgovaca	التجار	None
trgovačka	تجارية	None
trgovačke	تجارية	None
trgovački	تجارية	None
trgovci	التجار	None
trgovina	متجر	Nan
trgovine	محلات	Nan
trga	ميدان	None
ubrzanje	التسريع	Nan
ubrzo	هكذا	None
ubuntu	أوبونتو	Nan
umjetničkih	فني	None
umjetnost	فن	None
umjetnosti	فن	None
umre	لقد توفى	Nan
umrežavanje	التواصل	None
umrla	مات	None
umro	مات	None
un	الأمم المتحدة	Nan
una	أونا	Nan
unaprijed	مقدما	Nan
unatoč	على الرغم من	Nan
und	و	None
une	واحد	None
unescoa	اليونسكو	None
uni	أحادي	None
umjetnički	فني	None
umjetničke	فني	None
umjetnička	فني	None
umjetnika	الفنانين	None
ulici	شارع	None
ulijeva	تصب	None
ulja	زيوت	Nan
ulkus	قرحة	Nan
ulkusa	قرحة	Nan
ulkusne	قرحة المعدة	Nan
uloga	وظيفة	None
unija	اتحاد	None
uloge	الأدوار	None
ulozi	حصص	Nan
umire	يموت	None
umjerena	معتدل	None
umjereno	معتدل	None
umjesto	في حين أن	Nan
umjetnici	الفنانين	None
umjetnik	فنان	None
ulogu	وظيفة	None
ulice	شوارع	None
unije	اتحاد	None
uniji	اتحاد	None
unutrašnji	داخلي	None
unutrašnjih	داخلي	None
unutrašnjim	داخلي	None
unutrašnjost	الداخلية	None
unutrašnjosti	الداخلية	None
uobičajena	مشترك	None
uobičajene	مشترك	None
uobičajeni	مشترك	None
uobičajeno	عادة	None
uopće	بشكل عام	Nan
uopšte	بشكل عام	Nan
uostalom	بعد كل شيء	Nan
uoči	قبل	None
uočio	لاحظت	Nan
upala	التهاب	None
unutrašnjeg	داخلي	None
unutrašnje	داخلي	None
unutrašnja	داخلي	None
unutar	في داخل	Nan
union	اتحاد	None
united	متحد	Nan
university	جامعة	None
univerzitet	جامعة	None
univerziteta	جامعة	None
univerzitetima	الجامعات	None
univerzitetski	جامعة	None
unijeti	للدخول	Nan
univerzitetu	جامعة	None
uništena	دمرت	None
uništenja	تدمير	None
uništiti	لتدمير	Nan
unosi	إدخالات	Nan
unprofora	غير محبوب	Nan
unskosanskog	unskosanskog	Nan
unuka	حفيدة	Nan
uništavanje	تدمير	None
ulica	شارع	None
ulazu	مدخل	None
ulaznih	إدخال	None
ugarskoj	المجري	None
ugarskom	المجري	None
ugarsku	المجري	None
ugla	الزوايا	None
uglavnom	خاصة	None
ugled	سمعة	Nan
uglja	فحم	Nan
ugljen	فحم	Nan
ugljik	كربون	Nan
ugljika	كربون	Nan
ugljikohidrati	الكربوهيدرات	Nan
uglom	زاوية	None
uglova	زوايا	Nan
uglu	ركن	None
ugovor	عقد	None
ugarskog	المجري	None
ugarski	المجري	None
ugarske	المجري	None
ugao	زاوية	None
ubuntua	أوبونتو	Nan
udaje	يتزوج	Nan
udala	متزوج	None
udaljena	التحكم عن بعد	Nan
udaljenost	مسافة	None
udaljenosti	المسافات	None
udar	سكتة دماغية	Nan
ugovora	عقد	None
udara	الضربات	Nan
udari	الضربات	Nan
udio	شارك	None
udovica	أرملة	Nan
udruženja	ذات الصلة	Nan
udruženje	جمعية	None
uefa	uefa	Nan
ugalj	فحم	Nan
udarac	نفخ	Nan
ugovorom	عقد	None
uhapšen	القى القبض	Nan
ujedinjene	متحد	Nan
ukratko	باختصار	Nan
ukupan	مجموع	None
ukupna	مجموع	None
ukupne	مجموع	None
ukupnim	مجموع	None
ukupno	مجموع	None
ukupnog	مجموع	None
ukras	زخرفة	Nan
ukupnom	مجموع	None
ulaganja	الاستثمارات	None
ulaska	دخول	None
ulaz	مدخل	None
ulaza	مدخل	None
ulazak	دخول	None
ulaze	يدخلون	Nan
ulazi	يدخل	None
ukus	المذاق	Nan
trajati	الاخير	Nan
ukrajinci	الأوكرانيين	Nan
ukraden	مسروق	Nan
ujedinjeni	متحد	Nan
ujedinjenih	متحد	Nan
ujedinjenim	متحد	Nan
ujedinjenje	توحيد	None
ujedinjeno	متحد	Nan
ujedinjenog	متحد	Nan
ujedno	في نفس الوقت	Nan
ukrajina	أوكرانيا	None
ujutro	في الصباح	Nan
ukazuje	يشير	None
ukazuju	تشير	None
uključuje	يشمل	None
uključuju	تضمن	Nan
uključujući	بما فيها	Nan
ukloniti	إزالة	None
ukoliko	إذا	None
ukazao	أشار	None
trajao	استمر	None
trajanje	المدة الزمنية	Nan
trajanja	المدة الزمنية	Nan
tački	نقاط	None
tačkom	نقطة	None
tačku	نقطة	None
tačna	صيح	Nan
tačnije	أكثر دقة	Nan
tačno	بالضبط	Nan
te	و	None
teatar	مسرح	None
tebe	أنت	None
tebi	لك	None
tehnika	تقنية	None
tehnike	التقنيات	None
tehniku	تقنية	None
tehnička	فني	None
tehničke	فني	None
tačke	النقاط	None
tačkama	نقاط	None
tačka	نقطة	None
tačan	صيح	Nan
takvi	هذه	None
takvih	هذه	None
takvim	هذه	None
takvo	هذه	None
takvog	هذه	None
takvom	هذه	None
takvu	هذه	None
tehnički	تقنيا	Nan
talasa	أمواج	Nan
talijum	الثاليوم	Nan
tamno	داكن	Nan
tamo	هناك	None
tarik	طارق	None
tastatura	لوحة المفاتيح	Nan
taylor	تايلور	Nan
tačaka	نقاط	None
talasne	أمواج	Nan
takve	هذه	None
tehničkih	فني	None
tehnologije	التقنيات	None
tema	موضوع	None
tematika	المواضيع	None
tematski	حسب الموضوع	Nan
teme	المواضيع	None
temelj	مؤسسة	None
temelja	أسس	None
temelje	أسس	None
temelji	على أساس	Nan
temeljna	أساسي	None
temelju	على أساس	Nan
temperatura	درجة الحرارة	Nan
temperaturama	درجات الحرارة	Nan
temperature	درجة الحرارة	Nan
temperaturi	درجة الحرارة	Nan
temperaturom	درجة الحرارة	Nan
televizijske	التلفاز	None
televiziji	التلفاز	None
televizije	التلفاز	None
televizija	التلفاز	None
tehnološki	التكنولوجية	None
tek	تك	Nan
tekija	تيك	Nan
tekije	تيك	Nan
tekst	نص	None
teksta	نص	None
tekstilna	الغزل والنسيج	Nan
tehnologija	تقنية	None
tekstova	النصوص	None
tekstovi	النصوص	None
tekstovima	النصوص	None
tekstu	نص	None
tekućina	سائل	None
tekućine	السوائل	None
telekomunikacije	الاتصالات	None
telekomunikacione	الاتصالات	None
tekstove	النصوص	None
takva	هذه	None
također	أيضا	None
takođe	أيضا	None
svjetskih	العالمية	None
svjetskim	دنيوي	Nan
svjetsko	دنيوي	Nan
svjetskog	العالمية	None
svjetskoj	العالمية	None
svjetskom	العالمية	None
svjetsku	العالمية	None
svo	svo	Nan
svog	له	None
svoga	له	None
svoj	خاصة	None
svoja	ملكه	Nan
svoje	خاصة بهم	Nan
svojih	خاصة بهم	Nan
svojim	انها	None
svjetski	دنيوي	Nan
svjetske	العالمية	None
svjetska	العالمية	None
svjetlosti	ضوء	None
svima	كل واحد	Nan
svinja	خنزير	Nan
svinje	الخنازير	None
svira	يلعب	None
sviraju	انهم يلعبون	Nan
svirali	لعب	None
svirao	لعب	None
svojoj	الخاص بي	Nan
svjedok	الشاهد	Nan
svjedoče	يشهد	None
svjedoči	يشهد	None
svjestan	واع	Nan
svjetla	أضواء	Nan
svjetlo	ضوء	None
svjetlosnog	من الضوء	Nan
svjetlost	ضوء	None
svjedoka	شهود عيان	Nan
svojom	له	None
svojstva	الخصائص	None
svojstvo	خاصية	None
tadašnjim	ثم	None
tadašnjoj	ثم	None
tadić	تاديتش	Nan
tag	بطاقة شعار	Nan
taj	ذلك	None
tajna	سر	None
tajne	أسرار	None
tadašnji	ثم	None
tajni	اسرار	Nan
takav	هذه	None
takmičenja	مسابقات	None
takmičenje	منافسة	None
takmičenjima	مسابقات	None
takmičenju	منافسة	None
tako	وبالتالي	None
takozvani	ما يسمى ب	Nan
tajno	في السر	Nan
temperaturu	درجة الحرارة	Nan
tadašnjeg	من ذلك الوقت	Nan
tada	ثم	None
svoju	الخاص بي	Nan
svom	له	None
svome	له	None
svrha	غرض	Nan
svrhe	المقاصد	Nan
svrhu	غرض	Nan
svrsi	غرض	Nan
tadašnje	ثم	None
svrstati	تصنيف	None
svu	الكل	Nan
syringa	حقنة	Nan
system	النظام	None
systems	أنظمة	None
ta	نعم	Nan
tabela	الطاولة	Nan
tad	ثم	None
svrstavaju	يصنف	Nan
upisuje	يدخل	None
temu	موضوع	None
tenis	تنس	Nan
tkiva	مناديل	Nan
tkivo	نسيج	Nan
tko	منظمة الصحة العالمية	Nan
tla	التربة	None
tlo	أرض	None
tlu	أرض	None
to	إلى	None
tog	أكسي	Nan
toga	سترة	Nan
toj	هو	None
tojšići	тојшићи	Nan
tok	تيار	None
toka	تيار	None
tokata	توكاتا	Nan
tokom	أثناء	None
tjera	محركات الأقراص	Nan
tjelesne	جسدي - بدني	Nan
tj	بمعنى آخر	Nan
tiče	اهتمامات	Nan
tip	اكتب	Nan
tipa	اكتب	Nan
tipičan	نموذجي	Nan
tipični	نموذجي	Nan
tipično	عادة	None
tipova	أنواع	None
tipovi	أنواع	None
tokove	يطفو	Nan
tipu	اكتب	Nan
tiražu	الدوران	None
tita	تيتا	Nan
titanijum	التيتانيوم	Nan
tito	تيتو	Nan
titula	عنوان	None
titule	عنوان	None
titulu	عنوان	None
tiranija	استبداد	Nan
timovi	فرق	None
tokovi	يطفو	Nan
toliko	بكثير	None
tradicionalna	تقليدي	Nan
tradicionalne	تقليدي	Nan
tradicionalni	تقليدي	Nan
tradicionalnih	تقليدي	Nan
tradicionalnim	تقليدي	Nan
tradicionalno	تقليديا	Nan
trag	أثر	None
tragedija	مأساة	Nan
tragedije	مأساة	Nan
tragova	آثار	None
tragove	آثار	None
tragovi	آثار	None
trajala	استمر	None
trajale	استمر	None
trajalo	استمر	None
tradiciju	التقليد	None
tradicijom	التقليد	None
tradiciji	التقليد	None
tradicije	التقاليد	None
tom	توم	Nan
tome	إلي	None
tomislav	توميسلاف	Nan
tone	طن	None
top	أعلى	None
topić	موضوع	None
topla	دافئ	Nan
toku	تيار	None
toplim	دافئ	Nan
toplota	الحرارة	None
toplote	الحرارة	None
toranj	برج	None
tornjevi	أبراج	Nan
torzo	جذع	Nan
tower	برج	None
tradicija	التقليد	None
topljenja	ذوبان	Nan
time	زمن	None
tima	الفريق	None
tim	الفريق	None
terezija	هناك	None
terezije	هناك	None
teritorij	منطقة	None
teritorija	منطقة	None
teritorijalna	إقليمي	Nan
teritorijalne	إقليمي	Nan
teritorijalno	إقليميا	Nan
teritorije	إقليم	None
teritoriji	منطقة	None
teritorijom	منطقة	None
teritoriju	منطقة	None
termalne	حراري	Nan
termin	مصطلح	None
termina	مصطلح	None
termini	شروط	None
tereza	تيريزا	Nan
teret	عبء	Nan
terenu	حقل	None
terenima	تضاريس	Nan
teniseri	لاعبي التنس	Nan
teniski	تنس	Nan
teorem	نظرية	None
teorema	نظرية	None
teoretičar	المنظر	Nan
teoretičari	المنظرون	Nan
teoretski	نظريا	Nan
terra	تيرا	Nan
teorija	نظرية	None
teoriji	نظرية	None
teorijski	نظريا	Nan
teoriju	نظرية	None
terapija	علاج نفسي	Nan
teren	تضاريس	Nan
terena	تضاريس	Nan
tereni	تضاريس	Nan
teorije	نظريات	None
tesla	تسلا	Nan
teslić	تسليتش	Nan
testisa	الخصيتين	Nan
težnja	طموح	Nan
that	ذلك	None
the	ال	None
thomas	توماس	None
thomasa	توماس	None
théâtre	مسرح	None
ti	أنت	None
težine	وزن	None
tifa	التيفوئيد	Nan
tihi	هادئ	Nan
tihog	هادئ	Nan
tihom	بهدوء	Nan
tijela	جثث	Nan
tijelo	الجسم	None
tijelom	الجسم	None
tijelu	الجسم	None
tih	هادئ	Nan
tendencija	نزعة	Nan
težina	وزن	None
teže	أثقل	Nan
testovi	الاختبارات	Nan
teze	أطروحة	Nan
teče	يطفو	Nan
tečnost	سائل	None
tečnosti	السوائل	None
tešanj	مواساة	Nan
teška	ثقيل	Nan
teži	يزن	Nan
teške	صعب	None
teških	ثقيل	Nan
teškim	صعب	None
teško	صعب	None
teškog	صعب	None
teškom	صعب	None
teža	أطروحة	Nan
težak	ثقيل	Nan
teški	ثقيل	Nan
okolnim	المحيط	None
okolnih	المحيط	None
okolna	المحيط	None
formira	نماذج	None
formiraju	شكل	None
formirala	شكلت	None
formirali	شكلت	None
formiran	شكلت	None
formirana	شكلت	None
formiranja	تشكيل - تكوين	Nan
formiranje	تشكيل	None
formu	شكل	None
formula	معادلة	Nan
formule	معادلة	Nan
forum	المنتدى	None
fosfat	فوسفات	Nan
fosfor	الفسفور	Nan
fosfora	الفوسفور	Nan
formi	نماذج	None
forme	نماذج	None
format	شكل	None
formalno	رسميا	None
fizičkog	جسدي - بدني	Nan
fk	ف	Nan
florida	فلوريدا	Nan
fluida	مائع	Nan
fojnica	فوينيكا	Nan
fojnice	فويسنيس	Nan
fojnici	fojnici	Nan
fosili	أحافير	Nan
folikula	بصيلات	Nan
fond	الأموال	None
fondacija	مؤسسة	None
for	إلى عن على	Nan
forma	شكل	None
formacija	تشكيل - تكوين	Nan
formacije	تشكيلات	Nan
formalne	رسمية	Nan
folk	قوم	None
fizičkih	جسدي - بدني	Nan
fotografija	التصوير	None
fotosinteza	البناء الضوئي	Nan
francuzi	الفرنسي	None
franje	فرانسيس	Nan
franjevački	الفرنسيسكان	Nan
franjevci	الفرنسيسكان	Nan
franjo	فرانجو	Nan
franz	فرانز	Nan
freddie	فريدي	Nan
frekvencija	تكرر	Nan
frekvencije	الترددات	Nan
frenkie	frenkie	Nan
friedrich	فريدريش	Nan
front	أمامي	Nan
frontu	أمامي	Nan
fuad	فؤاد	None
fudbal	كرة القدم	Nan
francuza	فرنسي	None
francusku	فرنسا	None
francuskom	بالفرنسية	None
francuskoj	فرنسا	None
fotosinteze	البناء الضوئي	Nan
fotosintezu	البناء الضوئي	Nan
foča	فوكا	Nan
foče	فوشى	Nan
foči	بؤر	Nan
fr	الاب	Nan
fra	فرا	Nan
fotografije	صور فوتوغرافية	Nan
frame	الإطار	None
francisco	فرانسيسكو	None
francuska	فرنسا	None
francuske	فرنسي	None
francuski	فرنسي	None
francuskih	فرنسي	None
francuskim	فرنسي	None
francuskog	فرنسي	None
france	فرنسا	None
fudbaler	لاعب كرة قدم	Nan
fizički	جسديا	Nan
fizička	جسدي - بدني	Nan
ferdinand	فرديناند	Nan
ferhadija	ferhadija	Nan
ferhatović	فرحاتوفيتش	Nan
feromon	فرمون	Nan
festival	مهرجان	None
festivala	مهرجان	None
festivali	مهرجانات	Nan
festivalima	مهرجانات	Nan
festivalskih	مهرجان	None
festivalu	مهرجان	None
fiba	فيبا	Nan
fifa	اتحاد كرة القدم	Nan
figura	الشكل	None
fikret	فكرت	Nan
fikreta	فكرتة	Nan
fenomen	ظاهرة	None
fenoli	الفينولات	Nan
fenol	الفينول	Nan
feminizam	النسوية	Nan
fazu	مرحلة	None
fbih	فبيه	Nan
fc	fc	Nan
fe	fe	Nan
februar	شهر فبراير	Nan
februara	شهر فبراير	Nan
februaru	شهر فبراير	Nan
filatelija	طائفية	Nan
federacija	اتحاد	None
federaciji	اتحاد	None
federalna	اتحادي	Nan
federalne	اتحادي	Nan
federalni	اتحادي	Nan
federativna	اتحادي	Nan
federativne	اتحادي	Nan
feldspat	الفلسبار	Nan
federacije	اتحاد	None
fizičke	جسدي - بدني	Nan
filip	فيليب	None
filipini	الفلبين	None
finale	خاتمة	Nan
finalu	نهائي	None
finansije	المالية	None
finansijskih	الأمور المالية	Nan
finska	فنلندا	None
finske	الفنلندية	None
finski	الفنلندية	None
finskoj	في فنلندا	Nan
firefox	ثعلب النار	Nan
firma	حازم	Nan
firme	الشركات	None
firmi	الشركات	None
fizici	الفيزياء	None
fizika	الفيزياء	None
fizike	الفيزياء	None
filozofski	فلسفيا	Nan
filozofske	فلسفي	Nan
filozofska	فلسفي	Nan
filozofiju	فلسفة	None
filipović	فيليبوفيتش	Nan
film	فيلم	None
filma	فيلم	None
filmografija	فيلموغرافيا	Nan
filmova	أفلام	None
filmovi	أفلام	None
filmske	فيلم	None
filipa	فيليب	None
filmski	سينمائي	Nan
filmu	فيلم	None
filozof	فيلسوف	Nan
filozofa	فيلسوف	Nan
filozofi	فلاسفة	None
filozofija	فلسفة	None
filozofije	فلسفة	None
filozofiji	فلسفة	None
filmskom	فيلم	None
fudbalski	كرة القدم	Nan
fudbalskog	كرة القدم	Nan
funkcija	وظيفة	None
goce	غريس	Nan
god	عام	None
godina	سنوات	None
godinama	سنوات	None
godine	سنوات	None
godini	سنوات	None
godinu	عام	None
godišnja	سنوي	Nan
godišnje	كل سنة	Nan
godišnji	سنوي	Nan
gogolj	جوجول	Nan
gol	هدف	None
golman	حارس مرمى	Nan
golova	الأهداف	None
google	جوجل	None
gnu	الحيوانات البرية	Nan
gnoseologija	نظرية المعرفة	Nan
gnijezdo	عش	None
gnijezda	أعشاش	Nan
gledaju	انهم يشاهدون	Nan
gledano	رأيت	None
gledišta	وجهة نظر	Nan
gledište	وجهة نظر	Nan
glikozidi	جليكوسيدات	Nan
glina	طين	Nan
gline	طين	Nan
gora	الجبل	None
gljiva	فطر	Nan
globalizacija	العولمة	None
glukagon	الجلوكاجون	Nan
glukoza	الجلوكوز	Nan
glumac	الممثل	None
glumaca	ممثلين	Nan
glumci	ممثلين	Nan
glumica	ممثلة	None
gljive	الفطر	None
gleda	مشاهدة	None
goran	غوران	Nan
goraždu	المدينة	None
govore	يتحدثون	None
govoreći	تكلم	Nan
govori	يتحدث	None
govorili	سلك	Nan
govorilo	سلك	Nan
govorimo	نحن نتكلم	Nan
govorio	سلك	Nan
govoriti	تحدث	None
govornici	مكبرات الصوت	Nan
govornika	مكبرات الصوت	Nan
govoru	خطاب	None
gpu	gpu	Nan
grad	1 ج	Nan
grada	مدينة	None
gradačac	الخريجين	Nan
govora	خطاب	None
govor	خطاب	None
gotovo	فعله	None
gosti	ضيوف	Nan
gordon	جوردون	Nan
gore	فوق	None
gori	احتراق	None
goriva	وقود	None
gorivo	وقود	None
gorja	الجبال	None
gorje	الجبال	None
goražde	غورايد	Nan
gornja	العلوي	None
gornjeg	العلوي	None
gornjem	العلوي	None
gornji	العلوي	None
gorom	جورم	Nan
gospodar	رئيس	None
gospodara	رئيس	None
gospodin	سيدي المحترم	Nan
gornje	في الاعلى	Nan
glavu	رئيس	None
glavobolje	الصداع	Nan
glavobolja	صداع الراس	Nan
gen	الجنرال	None
generacija	توليد	None
generacije	توليد	None
general	جنرال لواء	Nan
generala	جنرال لواء	Nan
generalno	بشكل عام	Nan
genocid	إبادة جماعية	Nan
genocida	إبادة جماعية	Nan
geografija	جغرافية	None
geografije	جغرافية	None
geografska	جغرافي	Nan
geografske	جغرافي	Nan
geografski	جغرافيا	None
geografskih	جغرافي	Nan
geografskim	جغرافي	Nan
gdje	أين	None
gde	أين	None
gc	جي سي	Nan
gazi	غازي	None
funkcije	المهام	None
funkciji	وظيفة	None
funkciju	وظيفة	None
fuzije	انصهار	Nan
ga	الجا	Nan
gabela	غابيلا	Nan
gabriella	غابرييلا	Nan
geografskog	جغرافي	Nan
gacko	جاكو	Nan
galenit	جالينا	Nan
galerija	صالة عرض	Nan
gandhi	غاندي	None
gas	غاز	None
gasa	غاز	None
gasova	غازات	None
gasoviti	الغازي	None
gaj	بستان	Nan
geografskom	جغرافي	Nan
geološke	جيولوجي	Nan
geološki	جيولوجي	Nan
glasine	الشائعات	Nan
glasnik	رسول	None
glasova	الأصوات	None
glasovi	أصوات	None
glava	رئيس	None
glave	الرؤوس	Nan
glavi	الرؤوس	Nan
glasi	يقرأ	None
glavna	الأساسية	None
glavni	الأساسية	None
glavnih	رائد	None
glavnim	الأساسية	None
glavno	في الأساس	Nan
glavnog	رئيس	None
glavnom	في الأساس	Nan
glavnu	الأساسية	None
glavne	الأساسية	None
fazi	مرحلة	None
glasa	صوت	None
glamoč	glamoč	Nan
geometrija	علم الهندسة	Nan
geometrijski	هندسي	Nan
george	جورج	None
germanijum	الجرمانيوم	Nan
germanskih	الجرمانية	None
gilgameš	جلجامش	Nan
gilgamešu	gilgameshu	Nan
glas	صوت	None
gimnastika	رياضة بدنية	Nan
gimnazije	المدارس النحوية	Nan
gimnaziju	المدرسة الثانوية	Nan
gitara	غيتار	Nan
gitare	غيتار	Nan
gitarista	عازف الجيتار	Nan
gitaru	غيتار	Nan
glagoljica	جلاجوليتيك	Nan
gimnazija	المدرسة الثانوية	Nan
gradačca	جراداكا	Nan
faze	مرحلة	None
fatima	فاطمة	None
dvaju	اثنان	None
dvanaest	اثني عشر	Nan
dvije	اثنان	None
dviju	اثنان	None
dvoboj	مبارزة	Nan
dvoboja	مبارزة	Nan
dvoje	اثنان	None
dvor	حديقة منزل	Nan
dvora	محكمة	Nan
dvorac	قلعة	None
dvorana	صالة	Nan
dvorani	صالة	Nan
dvorca	قلعة	None
dvoru	حديقة منزل	Nan
džamija	مسجد	None
dvadesetog	العشرين	None
dvadeset	عشرون	Nan
dva	اثنان	None
dužnosti	الواجبات	Nan
dunava	الدانوب	None
dunja	سفرجل	Nan
dunje	سفرجل	Nan
dućani	محلات	Nan
duša	الروح	None
dušan	دوشان	Nan
duše	النفوس	None
džamije	الجوامع	Nan
duško	طفل	None
duž	على طول	Nan
duže	طويل	None
dužina	الطول	None
dužine	الطول	None
dužini	الطول	None
dužinu	الطول	None
dužnost	مهمة	None
dušu	الروح	None
dunav	الدانوب	None
džamiji	مسجد	None
džeko	دزيكو	Nan
efekti	تأثيرات	None
efektor	المستجيب	Nan
efikasnost	كفاءة	Nan
efikasnosti	كفاءة	Nan
egipat	مصر	None
egipta	مصر	None
egiptu	مصر	None
egipćani	مصريون	None
egzistira	موجود	Nan
einstein	أينشتاين	None
ejalet	ejalet	Nan
ekipa	الفريق	None
ekipe	فرق	None
ekipu	الفريق	None
ekologija	علم البيئة	Nan
efekte	تأثيرات	None
efekta	تأثير	None
efekt	تأثير	None
efekata	التأثير	None
džemal	جمال	None
džemaludin	dalemaludin	Nan
džemat	مجمع	None
dževad	dževad	Nan
džez	موسيقى الجاز	Nan
džibril	جبريل	None
džumanamaz	جمانة	Nan
džamiju	مسجد	None
e	ه	Nan
edem	الوذمة	Nan
edema	الوذمة	Nan
edhem	وذمة	Nan
edin	عدن	None
edo	ايدو	Nan
edward	إدوارد	Nan
efekat	تأثير	None
ebu	ebu	Nan
ekonomija	الاقتصاد	None
duhu	روح	None
duhovno	روحيا	Nan
držali	مقبض	Nan
držanje	تحتجز	Nan
držao	مقبض	Nan
držati	معلق	Nan
država	حالة	None
državama	تنص على	Nan
državaupobnerpordgpgrazbod	državaupobnerpordgpgrazbod	Nan
države	بلدان	None
državi	بلدان	None
državna	حالة	None
državne	حالة	None
državni	حالة	None
državnih	حالة	None
državnim	حالة	None
državno	حالة	None
drvo	خشب	Nan
drveta	الأشجار	None
drvar	الحطاب	Nan
društvu	المجتمع	None
drugoplasirani	الوصيف	None
drugu	آخر	None
društava	مجتمعات	None
društva	المجتمع	None
društvena	اجتماعي	None
društvene	اجتماعي	None
društveni	اجتماعي	None
državnog	حالة	None
društvenih	اجتماعي	None
društveno	اجتماعيا	Nan
društvenog	اجتماعي	None
društvenoj	اجتماعي	None
društvenom	اجتماعي	None
društvenu	اجتماعي	None
društvima	مجتمعات	None
društvo	المجتمع	None
društvenim	اجتماعي	None
duhovnog	روحاني	Nan
državnom	حالة	None
državu	الولاية	None
dugi	طويل	None
dugih	طويل	None
dugim	طويل	None
dugme	زر	Nan
dugmeta	زر	Nan
dugo	طويل	None
dugog	طويل	None
dugotrajne	طويلة الأمد	Nan
dugu	طويل	None
duh	روح	None
duha	روح	None
duhan	التبغ	None
duhana	التبغ	None
duhovne	روحاني	Nan
duhovni	روحاني	Nan
duge	قوس المطر	Nan
duga	قوس المطر	Nan
dug	دين	None
duet	دويتو	Nan
drže	معلق	Nan
drži	يحمل	None
du	du	Nan
dubica	دوبيكا	Nan
dubine	عمق	None
duboke	عميق	None
duboko	عميق	None
državom	حالة	None
dubrave	رث	Nan
dubrovnika	دوبروفنيك	Nan
dubrovnikom	دوبروفنيك	Nan
dubrovniku	دوبروفنيك	Nan
dubrovčani	مواطني دوبروفنيك	Nan
dubrovčanima	لشعب دوبروفنيك	Nan
dudley	دادلي	Nan
duel	مبارزة	Nan
dubrovnik	دوبروفنيك	Nan
ekonomije	الاقتصاد	None
ekonomiji	الاقتصاد	None
ekonomiju	الاقتصاد	None
et	وآخرون	None
etan	الإيثان	Nan
etanol	الإيثانول	Nan
ethernet	إيثرنت	Nan
etika	أخلاق	Nan
etimologija	علم أصول الكلمات	Nan
etnička	عرقي	Nan
etničke	عرقي	Nan
etnički	عرقي	Nan
etničkih	عرقي	Nan
etničkim	عرقي	Nan
etničko	عرقي	Nan
etničkog	عرقي	Nan
eu	الاتحاد الأوروبي	Nan
euklid	إقليدس	Nan
estoniji	إستونيا	Nan
estonije	إستونيا	Nan
estonija	إستونيا	Nan
estetika	جماليات	Nan
enklavu	جيب	Nan
entiteta	شخصية	None
enver	يتحول	None
enzima	إنزيم	Nan
enzimi	إنزيمات	Nan
ep	الحلقة	None
epa	حسنا	Nan
euro	اليورو	None
epidemija	وبائي	Nan
epohe	عهد	None
epsilon	إبسيلون	Nan
epu	epu	Nan
era	حقبة	None
ere	حقبة	None
eric	اريك	Nan
ermenija	أرمينيا	None
epizoda	حلقة	None
enklave	جيب	Nan
eurosong	يوروسونج	Nan
eventualno	ربما	None
evropu	أوروبا	None
fabrika	مصنع	None
fabrike	مصنع	None
fabula	قطعة	None
facebook	موقع التواصل الاجتماعي الفيسبوك	Nan
facto	بحكم الواقع	Nan
fadil	فاضل	Nan
faktor	عامل	None
faktora	عامل	None
faktori	العوامل	None
fakultet	كلية	None
fakulteta	كلية	None
fakultetu	كلية	None
farska	هزل	Nan
faruk	فاروق	None
evropsku	أوروبي	None
evropskom	أوروبي	None
evropskoj	أوروبي	None
evropskog	أوروبي	None
evo	هنا	None
evolucija	تطور	None
evolucije	تطور	None
evolventa	لا إرادي	Nan
evropa	أوروبا	None
evrope	أوروبا	None
evropi	أوروبا	None
eventualne	في نهاية المطاف	Nan
evropljana	الأوروبيون	None
evropom	أوروبا	None
evropska	أوروبي	None
evropske	أوروبي	None
evropski	أوروبي	None
evropskih	أوروبي	None
evropskim	أوروبي	None
evropsko	أوروبي	None
evropljani	الأوروبيون	None
enklava	جيب	Nan
enkidu	إنكيدو	Nan
enigmatika	اللغز	Nan
električnih	كهربائي	None
električnog	كهربائي	None
električnu	كهربائي	None
elektroda	قطب كهربائي	Nan
elektrode	أقطاب كهربائية	Nan
elektrohemija	الكيمياء الكهربائية	Nan
elektrohemijske	الكهروكيميائية	Nan
elektrolit	بالكهرباء	Nan
elektrolita	بالكهرباء	Nan
elektroliza	التحليل الكهربائي	Nan
elektron	إلكترون	Nan
elektrona	إلكترونات	Nan
elektronika	الإلكترونيات	Nan
elektronski	إلكترونيا	Nan
elektrotehnike	الهندسة الكهربائية	Nan
električni	كهربائي	None
električne	كهربائي	None
električna	كهربائي	None
elektriciteta	كهرباء	None
ekonomska	اقتصادية	None
ekonomske	اقتصادية	None
ekonomski	من الناحية الاقتصادية	Nan
ekonomskih	اقتصادية	None
ekonomskim	اقتصادية	None
ekonomsko	من الناحية الاقتصادية	Nan
ekonomskog	اقتصادية	None
elemenata	عناصر	None
ekonomskoj	اقتصادية	None
ekonomsku	اقتصادية	None
ekrana	شاشة	Nan
ekspanziju	توسيع	None
eksperimenti	التجارب	None
ekstremno	أقصى	None
ekvador	إكوادور	Nan
el	ش	Nan
ekonomskom	اقتصادية	None
element	جزء	None
elementa	جزء	None
elemente	عناصر	None
energija	الطاقة	None
energije	الطاقة	None
energijom	الطاقة	None
energiju	الطاقة	None
eng	م	Nan
engl	engl	Nan
engleska	إنكلترا	Nan
energetski	نشيط	Nan
engleske	إنجلترا	None
engleskih	الإنجليزية	None
engleskim	باللغة الإنجليزية	Nan
engleskog	الإنجليزية	None
engleskoj	في انجلترا	Nan
engleskom	باللغة الإنجليزية	Nan
englesku	الإنجليزية	None
englezi	الإنجليزية	None
engleski	الإنجليزية	None
faza	مرحلة	None
eneju	eneju	Nan
endokard	الشغاف	Nan
elementi	عناصر	None
elementima	عناصر	None
elizabeta	إليزابيتا	Nan
elizabete	إليزابيتي	Nan
elizabeth	إليزابيث	Nan
elizabeti	إليزابيتي	Nan
elizabetu	إليزابيتو	Nan
eneja	eneja	Nan
elvir	الفير	Nan
email	البريد الإلكتروني	Nan
emina	امينة	Nan
emir	أمير	None
enciklopedija	موسوعة	None
enciklopedije	الموسوعات	Nan
end	النهاية	None
endbmatrix	مصفوفة النهاية	Nan
elvis	الفيس	None
gradačcu	gradačcu	Nan
gradaščević	gradaščević	Nan
gradaščevića	gradaščevića	Nan
inteligencije	الذكاء	None
intenzivno	بشكل مكثف	Nan
interakcije	التفاعلات	Nan
interes	فائدة	None
interesa	فائدة	None
interesantno	مثير للإعجاب	Nan
interese	فائدة	None
interesu	فائدة	None
interfejs	واجهه المستخدم	Nan
interfejsa	واجهه المستخدم	Nan
internacionalna	دولي	None
internacionalni	دولي	None
internet	الإنترنت	None
interneta	الإنترنت	None
internetu	الأنترنيت	Nan
inteligencija	الذكاء	None
insuficijencija	القصور	None
instrument	أداة	None
instrukcije	تعليمات	Nan
infekcije	الالتهابات	Nan
informacija	معلومات	None
informacije	معلومات	None
informatika	علوم الكمبيوتر	Nan
informativni	غنيا بالمعلومات	Nan
infrastruktura	بنية تحتية	Nan
inhibira	يمنع	None
interpolacija	إقحام	Nan
inka	الانكا	Nan
inovacija	ابتكار	Nan
insekata	الحشرات	None
instalacije	المنشآت	None
institucija	المعهد	None
institucije	المؤسسات	None
institut	معهد	None
instrukcija	تعليمات	Nan
inostranstvu	خارج البلاد	Nan
inercija	التعطيل	Nan
interpretaciji	ترجمة	None
intervenciju	تدخل قضائي	Nan
isabega	إيزابيجا	Nan
isaković	إيساكوفيتش	Nan
isbn	isbn	Nan
ishaković	إيشكوفيتش	Nan
ishakovića	إيشاكوفيتش	Nan
ishod	النتيجة	None
ishrani	حمية	Nan
isključivo	حصريا	Nan
iskoristio	مستخدم	None
iskoristiti	استغل الفرصة	Nan
iskorištava	يستغل	Nan
iskustva	خبرة	Nan
iskustvo	تجربة	None
iskustvu	تجربة	None
islam	دين الاسلام	Nan
isabeg	isabeg	Nan
isa	هو	None
irskoj	أيرلندا	None
irske	أيرلندي	Nan
intervju	مقابلة	None
intoksikacija	تسمم	Nan
invazije	غزو	None
investicija	الاستثمار	None
inženjering	هندسة	None
inženjerstvo	هندسة	None
iona	أيون	Nan
intervencija	تدخل قضائي	Nan
ip	الملكية الفكرية	Nan
iq	معدل الذكاء	Nan
iraku	العراق	None
iran	إيران	None
irana	إيران	None
irc	irc	Nan
iridijum	إيريديوم	Nan
irska	أيرلندا	None
ipak	على أية حال	Nan
islama	دين الاسلام	Nan
industriju	صناعة	None
industrijskim	صناعي	None
ilira	إليرا	Nan
iliri	الإليريون	Nan
ilirska	إليريان	Nan
ilirske	إليريان	Nan
ilirski	إليريان	Nan
ilirskih	إليريان	Nan
ilirskim	إليريان	Nan
ilirsko	إليريان	Nan
ilirskog	إليريان	Nan
im	انا	Nan
ima	يوجد	None
imaju	يملكون	Nan
imajući	نأخذ	Nan
imala	كان	None
imale	كان	None
ilijaš	ilijaš	Nan
ilijada	إلياد	Nan
ilija	أو أنا	Nan
ilidža	ilidža	Nan
igračima	لاعبين	Nan
igračke	ألعاب الأطفال	Nan
igre	ألعاب	None
igri	ألعاب	None
igru	لعبه	Nan
ih	معهم	None
ii	ثانيا	None
imali	كان	None
iii	ثالثا	Nan
ijekavskog	ijekavian	Nan
ikad	أبدا	None
ikada	أبدا	None
ikakve	أي	None
ikakvih	أي	None
ikru	كافيار	Nan
ili	أو	None
iili	أو	None
industrijsko	صناعي	None
imalo	كان	None
imama	عندي	Nan
indiji	الهند	None
indijski	هندي	Nan
indirektno	بشكل غير مباشر	Nan
indoevropski	الهندو أوروبية	Nan
indonezija	إندونيسيا	None
indonezije	إندونيسيا	None
indukcija	الحث	Nan
industrija	صناعة	None
industrije	صناعة	None
industriji	صناعة	None
industrijom	صناعة	None
industrijska	صناعي	None
industrijske	صناعي	None
industrijski	صناعي	None
industrijskih	صناعي	None
indije	الهند	None
indija	الهند	None
indexi	فهارس	Nan
indexa	فهرس	Nan
imamo	نملك	Nan
imamović	إماموفيتش	Nan
imao	كان	None
imati	امتلاك	Nan
ime	اسم	None
imena	الأسماء	None
imenice	الأسماء	None
imam	عندي	Nan
imenima	الأسماء	None
imenovan	عين	None
imenu	اسم	None
imenuje	يعين	None
imovine	خاصية	None
imperija	إمبراطورية	None
imperije	إمبراطورية	None
inače	غير ذلك	Nan
imenom	بالاسم	Nan
islamović	اسلاموفيتش	Nan
islamska	إسلامي	None
islamske	إسلامي	None
izbore	انتخابات	None
izbori	انتخابات	None
izborima	انتخابات	None
izdaje	خيانة	Nan
izdaju	خيانة	Nan
izdanja	الطبعات	Nan
izdanje	الإصدار	None
izdanju	الإصدار	None
izdao	نشر	None
izdat	نشر	None
izdata	نشر	None
izdavanja	إصدار	None
izdavač	الناشر	Nan
izdvaja	يفرد	Nan
izdvajaju	دافع عن كرامته	Nan
izbora	الاختيار	None
izbor	خيار	Nan
izbjeglice	اللاجئين	None
izbjeglica	اللاجئين	None
iza	خلف	None
izabran	انتخب	None
izabrana	المحدد	Nan
izabrane	المحدد	Nan
izabrani	اختيار	None
izaziva	يثير	Nan
izazove	التحديات	Nan
izdvojiti	الخروج منفردا	Nan
izazvala	استفزاز	Nan
izazvao	استفزاز	Nan
izazvati	لاستفزاز	Nan
izašao	خرج	None
izašla	خرج	None
izbačen	مطرود	Nan
izbijanja	تفشي المرض	Nan
izbio	اندلعت	None
izazvalo	تسبب	None
iz	من عند	Nan
izet	عزت	Nan
izgled	مظهر خارجي	Nan
izjavio	معلن	Nan
izjašnjavaju	يعلن	None
izlaska	خروج	None
izlasku	يخرج	None
izlaz	انتاج	Nan
izlaza	انتاج	Nan
izlazak	يخرج	None
izlaze	يظهر	None
izlazi	مخارج	Nan
izletišta	مناطق النزهة	Nan
izletište	منتزه	Nan
izložbe	المعارض	None
izloženi	مكشوف	Nan
izlučivanje	إفراز	None
izlučuje	يفرز	Nan
izgubiti	لتخسر	Nan
izgubio	ضائع	Nan
izgubili	ضائع	Nan
izgubila	ضائع	Nan
izgleda	يبدو	None
izgovara	يلفظ	Nan
izgovor	عذر	Nan
izgovora	عذر	Nan
izgradio	مبني	None
izgradnja	اعمال بناء	Nan
izgradnje	اعمال بناء	Nan
izetbegović	izetbegović	Nan
izgradnji	اعمال بناء	Nan
izgradnju	اعمال بناء	Nan
izgrađen	مبني	None
izgrađena	مبني	None
izgrađene	مبني	None
izgrađeni	مبني	None
izgrađenih	مبني	None
izgrađuje	يبني	Nan
izgradnjom	اعمال بناء	Nan
ix	التاسع	None
ivo	ivo	Nan
ivica	حافة	None
israel	إسرائيل	None
ista	نفس الشيء	Nan
istaknuti	للإشارة	None
istanbul	اسطنبول	Nan
istanbulu	اسطنبول	Nan
iste	نفس الشيء	Nan
istezanje	تمتد	None
isti	نفس الشيء	Nan
istih	نفس الشيء	Nan
istim	نفس الشيء	Nan
istina	الحقيقة	None
istine	حقيقة	None
ističe	تنتهي الصلاحية	Nan
ističu	دافع عن كرامته	Nan
isto	نفس الشيء	Nan
ispunjen	استيفاء	Nan
ispunjava	يلتقي	None
ispuni	ملء	Nan
isprva	في البدايه	Nan
islamski	إسلامي	None
islamskih	إسلامي	None
islamskim	إسلامي	None
islamskog	إسلامي	None
islamskoj	إسلامي	None
islamu	دين الاسلام	Nan
island	جزيرة	None
istog	نفس الشيء	Nan
ismet	عصمت	Nan
ispitivanja	اختبارات	None
ispitivanje	الفحص	None
ispod	أدناه	None
ispravan	صيح	Nan
ispravno	بشكل صحيح	Nan
ispred	امام	None
isprobavanje	اختبارات	None
iso	ايزو	Nan
istoimene	بنفس الاسم	Nan
istoj	نفس الشيء	Nan
istok	الشرق	None
isus	يسوع	None
isusa	يسوع	None
it	عليه	None
italija	إيطاليا	None
italijani	الإيطاليون	Nan
italijanski	إيطالي	Nan
italije	إيطاليا	None
istu	نفس الشيء	Nan
italiji	إيطاليا	None
italiju	إيطاليا	None
itd	إلخ	Nan
iv	رابعًا	Nan
iva	iva	Nan
ivan	إيفان	None
ivana	إيفانا	Nan
ive	لقد قمت	Nan
italijom	إيطاليا	None
igrači	لاعبين	Nan
istraživači	الباحثين	None
istraživanjima	ابحاث	Nan
istoka	الشرق	None
istom	نفس الشيء	Nan
istorija	التاريخ	None
istovremeno	في نفس الوقت	Nan
istočna	الشرقية	None
istočne	الشرقية	None
istočni	الشرقية	None
istraživač	إكسبلورر	Nan
istočnih	الشرقية	None
istočno	الشرق	None
istočnog	الشرقية	None
istočnoj	الشرقية	None
istočnom	الشرقية	None
istočnu	الشرقية	None
istraživanja	ابحاث	Nan
istraživanje	ابحاث	Nan
istočnim	الشرقية	None
igrače	ألعاب الأطفال	Nan
igrača	لاعبين	Nan
igrač	لاعب	None
grčki	اليونانية	None
grčkih	اليونانية	None
grčkim	اليونانية	None
grčko	اليونانية	None
grčkog	اليونانية	None
grčkoj	اليونانية	None
grčkom	باليوناني	Nan
grčku	اليونانية	None
guatemala	غواتيمالا	Nan
gube	يخسرون	Nan
gubi	تخسر	Nan
gubitak	خسارة	None
gubitka	خسارة	None
gubitke	خسائر	None
guide	يرشد	Nan
grčke	اليونانية	None
grčka	اليونان	None
grč	شد عضلي	Nan
gruzija	جورجيا	None
grka	اليونانية	None
grob	قبر	None
groblja	المقابر	None
groblje	مقبرة	None
grobnica	قبر	None
grobnice	المقابر	None
grobu	قبر	None
gustina	كثافة	None
grof	العد	Nan
grupa	مجموعة	Nan
grupacija	تجميع	None
grupama	مجموعات	None
grupe	مجموعات	None
grupi	مجموعات	None
grupom	مجموعة	Nan
grupu	مجموعة	Nan
grofa	العد	Nan
gripe	أنفلونزا	Nan
gustoća	كثافة	None
gušterača	البنكرياس	Nan
han	هان	Nan
hana	هناء	Nan
handžar	خنجر	Nan
hanka	هانكا	Nan
hard	الصعب	None
hardver	المعدات	None
hari	هاري	None
haris	حارس	Nan
has	لديها	None
hasan	حسن	None
hastati	hastati	Nan
have	يملك	None
haškog	لاهاي	Nan
hdz	hdz	Nan
he	هو	None
hamlet	قرية	None
hamdija	حميدة	Nan
halilović	خليلوفيتش	Nan
halid	هاليد	Nan
gušterače	البنكرياس	Nan
gužvan	مزدحما	Nan
gvatemala	غواتيمالا	Nan
gvatemale	غواتيمالا	Nan
gvatemali	غواتيمالا	Nan
gvineja	غينيا	None
gx	ز	Nan
guvernera	محافظ حاكم	Nan
h	ح	Nan
hadis	حديث	None
hadisu	حديث	None
hadž	الحج	None
hadža	الحج	None
hadži	الحاج	Nan
hadžiabdić	hadžiabdić	Nan
hajrudin	هاجردين	Nan
habsburg	هابسبورغ	Nan
grešku	خطأ	None
greške	الأخطاء	None
greška	خطأ	None
gradskih	الحضاري	None
gradsko	الحضاري	None
gradskog	الحضاري	None
gradskom	الحضاري	None
gradu	مدينة	None
grafika	الرسومات	Nan
grafička	الرسم	None
grafičke	الرسم	None
grafički	بيانيا	Nan
grafičkih	الرسم	None
grafičkog	الرسم	None
gramatika	قواعد	None
grana	فرع شجرة	Nan
granata	قنبلة يدوية	Nan
grand	كبير	None
gradski	مدينة	None
gradske	الحضاري	None
gradska	الحضاري	None
gradovima	مدن	None
grade	درجة	None
gradi	يبني	Nan
gradili	مبني	None
gradina	حديقة	None
gradine	الحصون	Nan
gradiška	gradiška	Nan
gradnja	اعمال بناء	Nan
grande	عظيم	None
gradnje	اعمال بناء	Nan
gradnju	اعمال بناء	Nan
gradom	المدينة	None
gradonačelnik	عمدة	Nan
gradonačelnika	العمدة	Nan
gradova	مدن	None
gradove	مدن	None
gradovi	مدن	None
gradnji	اعمال بناء	Nan
grane	الفروع	None
granica	الحدود	None
granicama	الحدود	None
građen	مبني	None
građena	مبني	None
građene	مبني	None
građevina	بناء	None
građevine	البنايات	Nan
građevinski	اعمال بناء	Nan
grb	معطف الاذرع	Nan
građe	المواد	None
grba	حدبة	Nan
grbavice	مطب	Nan
grbavici	مطب	Nan
grbom	معطف الاذرع	Nan
grbu	معطف الاذرع	Nan
grci	الإغريق	None
grcima	الإغريق	None
grešaka	الأخطاء	None
grbavica	الأحدب	Nan
heart	قلب	None
građanskog	مدني	None
građanski	مدني	None
granice	الحدود	None
granici	الحدود	None
granicu	الحدود	None
graniči	الحدود	None
gravitacije	الجاذبية	None
graz	غراتس	Nan
graza	غرازا	Nan
građanskih	مدني	None
grazu	غراتسو	Nan
građa	مواد	None
građana	المواطنين	None
građane	المواطنين	None
građani	المواطنين	None
građanima	المواطنين	None
građanin	مواطن	None
građanska	مدني	None
gračanica	gračanica	Nan
drugom	آخر	None
heavy	ثقيل	Nan
hemija	كيمياء	None
hrvatske	الكرواتية	Nan
hrvatski	الكرواتية	Nan
hrvatskih	الكرواتية	Nan
hrvatskim	الكرواتية	Nan
hrvatskog	الكرواتية	Nan
hrvatskoj	كرواتيا	Nan
hrvatskom	الكرواتية	Nan
hrvatskosrpski	الكرواتية-الصربية	Nan
hrvatsku	كرواتيا	Nan
htio	مطلوب	Nan
htjeli	مطلوب	Nan
html	لغة البرمجة	Nan
huang	هوانغ	Nan
huma	هيما	Nan
human	بشري	None
hrvatska	كرواتيا	Nan
hrvatima	الكروات	Nan
hrvati	الكروات	Nan
hrvate	الكروات	Nan
hotela	الفندق	Nan
hoteli	الفنادق	None
hotelu	الفندق	Nan
house	منزل	None
hoće	هو سوف	Nan
hrabrost	شجاعة	Nan
hram	معبد	None
humanizam	الإنسانية	None
hrama	معبد	None
hrane	طعام	None
hrani	طعام	None
hranom	طعام	None
hranu	طعام	None
hromatografija	اللوني	Nan
hronološki	زمنيا	Nan
hrvata	الكروات	Nan
hrana	طعام	None
hotel	الفندق	Nan
husein	حسين	None
huseinkapetan	huseinkapetan	Nan
identiteta	هوية	None
ideologija	أيديولوجية	Nan
ideologije	أيديولوجية	Nan
idiom	لغة. مثل	Nan
idu	انا اذهب	Nan
if	إذا	None
igara	ألعاب	None
igor	إيجور	Nan
igra	لعبه	Nan
igraju	انهم يلعبون	Nan
igrala	لعب	None
igrali	لعب	None
igrama	ألعاب	None
igrao	لعب	None
igrati	للعب	Nan
identitet	هوية	None
ideju	فكرة	None
ideji	الأفكار	None
ideje	الأفكار	None
husrevbeg	husrevbeg	Nan
husrevbegova	husrevbegova	Nan
hvo	hvo	Nan
hz	هرتز	Nan
hôtel	الفندق	Nan
i	أنا	None
iako	برغم من	Nan
huseina	حسين	None
ibn	ابن	None
ibrahima	الإبراهيم	Nan
ibrica	ibrica	Nan
ibuprofen	ايبوبروفين	Nan
ibuprofena	ايبوبروفين	Nan
ide	يذهب	None
idealno	المثالي	Nan
ideja	فكرة	None
ibrahim	ابراهيم	Nan
hosa	حوسة	Nan
hormoni	الهرمونات	Nan
hormone	الهرمونات	Nan
heroj	بطل	None
heroja	بطل	None
heteroseksualnost	العلاقة بين الجنسين	Nan
hidroelektrane	محطات الطاقة الكهرمائية	Nan
hidrografija	الهيدروغرافيا	Nan
hijerarhija	التسلسل الهرمي	Nan
hiljada	ألف	None
hiljade	آلاف	None
hiljadu	ألف	None
himna	نشيد وطني	Nan
hirurgija	جراحة	Nan
historija	التاريخ	None
historije	التاريخ	None
historiji	التاريخ	None
historijska	تاريخي	None
hercegovinu	البوسنة والهرسك	Nan
hercegovinom	البوسنة والهرسك	Nan
hercegovini	البوسنة والهرسك	Nan
hercegovine	البوسنة والهرسك	Nan
hemijska	المواد الكيميائية	Nan
hemijske	المواد الكيميائية	Nan
hemijski	المواد الكيميائية	Nan
hemijskih	المواد الكيميائية	Nan
hemijskim	المواد الكيميائية	Nan
hemijsku	المواد الكيميائية	Nan
hemodijaliza	غسيل الكلى	Nan
historijske	تاريخي	None
henri	هنري	None
henrika	هنريكا	Nan
henriku	هنري	None
henry	هنري	None
herceg	هرس	Nan
hercegbosne	hercegbosne	Nan
hercegovci	هيرزيغوفينيان	Nan
hercegovina	البوسنة والهرسك	Nan
henrik	هنريك	Nan
historijski	تاريخيا	None
historijskih	تاريخي	None
historijskim	تاريخي	None
hlorid	كلوريد	Nan
hlorida	كلوريد	Nan
hloroplasti	البلاستيدات الخضراء	Nan
ho	هو	None
hodžić	hodžić	Nan
hokej	الهوكي	Nan
hol	صالة	Nan
hljeba	خبز	Nan
holandija	هولندا	None
holden	هولدن	Nan
homoseksualnost	الشذوذ الجنسي	Nan
hor	الكورال	Nan
hordati	حرداتي	Nan
horde	حشد	None
horizonta	الأفق	Nan
hormona	الهرمونات	Nan
holandski	هولندي	Nan
heinrich	هاينريش	Nan
hladnog	البرد	Nan
hladne	البرد	Nan
historijsko	تاريخيا	None
historijskog	تاريخي	None
historijskom	تاريخي	None
historiju	التاريخ	None
historičar	مؤرخ	Nan
historičara	مؤرخ	Nan
historičari	المؤرخين	None
hladnim	البرد	Nan
historičarima	المؤرخين	None
hit	نجاح	None
hitler	هتلر	None
hitlera	هتلر	None
hitova	يضرب	Nan
hitove	يضرب	Nan
hitovi	يضرب	Nan
hladna	البرد	Nan
history	التاريخ	None
izmedju	ما بين	Nan
drugoj	آخر	None
drugo	ثانيا	None
bijelim	أبيض	Nan
bijeljina	بياض	Nan
bijelo	أبيض	Nan
bijelog	أبيض	Nan
bijelu	أبيض	Nan
bila	كان	None
bile	الصفراء	None
bileća	bileća	Nan
bili	كانوا	None
biljaka	النباتات	None
bilje	أعشاب	Nan
bilješke	ملاحظات	None
bilježe	يسجلون	Nan
bilježi	ملاحظات	None
biljka	نبات	None
bijeli	أبيض	Nan
bijele	أبيض	Nan
bijela	أبيض	Nan
bijaše	كانت	None
beču	فيينا	None
bešlagić	غرق	Nan
bešlić	نذل	Nan
bh	ب	None
bi	ثنائية	None
biblije	الأناجيل	None
bibliji	الكتاب المقدس	Nan
biljkama	النباتات	None
bibliografija	فهرس	Nan
biblioteke	مكتبات	Nan
bici	بيبي	Nan
bih	أود	Nan
bihać	بيهاتش	Nan
bihaća	bihaća	Nan
bihaćki	bihaćki	Nan
bihaću	انا سوف	Nan
biblioteka	مكتبة	None
beča	فيينا	None
biljke	النباتات	None
biljnih	نبات	None
bitan	البيتان	Nan
biti	كن	Nan
bitka	معركة	None
bitke	معارك	None
bitki	معارك	None
bitku	معركة	None
bitna	مهم	None
bitne	أساسى	Nan
bitno	أساسى	Nan
biva	بيفا	Nan
bivaju	هم انهم	Nan
bivša	على سبيل المثال	Nan
bivše	على سبيل المثال	Nan
bivšeg	على سبيل المثال	Nan
bivši	على سبيل المثال	Nan
bitaka	معركة	None
bit	قليلا	None
biskupa	الأسقف	Nan
biskup	الأسقف	Nan
biljnog	نبات	None
bill	مشروع قانون	Nan
bilo	كان	None
bin	سلة مهملات	Nan
binarni	الثنائية	None
bint	ضمادة	Nan
bio	كان	None
biljne	عشبي	Nan
biofizika	الفيزياء الحيوية	Nan
biologija	مادة الاحياء	Nan
biološka	بيولوجي	Nan
biološki	بيولوجي	Nan
biosfera	المحيط الحيوي	Nan
bira	بيرة	Nan
biraju	اختاروا	Nan
biseri	لآلئ	Nan
biografija	سيرة شخصية	Nan
bivših	على سبيل المثال	Nan
beč	فيينا	None
beta	بيتا	Nan
barem	على الأقل	Nan
barometar	مقياسا	Nan
barry	باري	Nan
bas	صوت عميق	Nan
basicu	basicu	Nan
baterija	البطارية	Nan
baterije	البطاريات	Nan
bave	تافه	Nan
bavi	صفقات	Nan
bavili	مطلقا	Nan
bavilo	مخطوب	Nan
baviti	لكى تتعامل مع	Nan
baza	يتمركز	Nan
baze	يتمركز	Nan
bazen	حوض السباحة	Nan
bare	عارية	Nan
barcelona	برشلونة	None
barbarez	بارباريز	Nan
bar	شريط	None
balkana	البلقان	None
balkanski	البلقان	None
balkanskih	البلقان	None
balkanskog	البلقان	None
balkanskom	البلقان	None
balkanu	البلقان	None
ban	المنع	Nan
bazena	حوض السباحة	Nan
bana	بانا	Nan
banje	منتجع صحي	Nan
banjoj	بانجوج	Nan
banka	مصرف	None
banke	البنوك	None
banovina	الموز	Nan
banovine	الموز	Nan
banovići	banovići	Nan
banja	منتجع صحي	Nan
bez	بدون	None
bazi	يتمركز	Nan
bazira	على أساس	Nan
belgije	بلجيكا	None
belgiji	بلجيكا	None
bell	جرس	Nan
bend	ينحني	Nan
benda	بندة	Nan
bendu	ينحني	Nan
benjamin	بنيامين	Nan
benu	بينو	Nan
beograd	بلغراد	Nan
beograda	بلغراد	Nan
beogradskom	بلغراد	Nan
beogradu	بلغراد	Nan
berlin	برلين	None
berlinu	برلين	None
besplatni	مجانا	Nan
belgija	بلجيكا	None
bejrut	بيروت	None
begova	يطرح	Nan
beg	إفترض جدلا	Nan
baziran	على أساس	Nan
bazirana	على أساس	Nan
bazu	يتمركز	Nan
baš	مجرد	None
bašagić	башагић	Nan
bašagića	башагића	Nan
bašeskija	башескија	Nan
bazilika	بازيليكا	Nan
baština	التراث	None
baštini	التراث	None
baščaršija	baščaršija	Nan
bdp	بي دي بي	Nan
bdpa	bdpa	Nan
be	كن	Nan
bebek	طفل	None
bedema	أسوار	None
baštine	التراث	None
bivšoj	السابق	None
bića	كائنات	None
biće	يجرى	Nan
bosanskom	البوسنية	Nan
bosanskome	البوسنية	Nan
bosansku	البوسنية	Nan
bosančica	البوسنية	Nan
bosančicom	البوسنية	Nan
bosna	البوسنة	None
bosne	البوسنة	None
bosni	البوسنة	None
bosnom	البوسنة	None
bosnu	البوسنة	None
bozon	بوزون	Nan
bočne	الجانبي	Nan
boško	boško	Nan
bošnjaci	البوشناق	Nan
bošnjacima	البوشناق	Nan
bosanskoj	البوسنية	Nan
bosanskohercegovačkog	البوسنة والهرسك	Nan
bosanskohercegovačkih	البوسنة والهرسك	Nan
bosanskohercegovački	البوسنية	Nan
borili	حارب	None
borio	حارب	None
boris	بوريس	Nan
borić	يقاتل	Nan
bos	بوس	Nan
bosanci	البوسنيون	Nan
bosanska	البوسنية	Nan
bošnjak	البوشناق	Nan
bosanske	البوسنية	Nan
bosanskih	البوسنية	Nan
bosanskim	البوسنية	Nan
bosansko	البوسنية	Nan
bosanskog	البوسنية	Nan
bosanskoga	البوسنية	Nan
bosanskohercegovačka	البوسنة والهرسك	Nan
bosanskohercegovačke	البوسنية	Nan
bosanski	البوسنية	Nan
bori	يحارب	Nan
bošnjaka	البوشناق	Nan
bošnjani	البوسنيون	Nan
bratstvo	الأخوة	Nan
bratu	شقيق	Nan
bratunac	ولد عم	Nan
brazil	البرازيل	None
braća	الإخوة	Nan
braće	الإخوة	Nan
brda	التلال	Nan
brdo	تل	None
brdski	التلال	Nan
brdu	تل	None
bregović	بريجوفيتش	Nan
breza	البتولا	Nan
brigade	الفرقة	None
brijeg	تل	None
brijegu	تل	None
brata	شقيق	Nan
brat	شقيق	Nan
branko	برانكو	Nan
branislav	برانيسلاف	Nan
bošnjačka	البوشناق	Nan
bošnjačke	البوشناق	Nan
bošnjački	البوسنية	Nan
bošnjačkih	البوشناق	Nan
bošnjačko	البوشناق	Nan
bošnjačkog	البوشناق	Nan
božanstva	الآلهة	None
bošnjake	البوشناق	Nan
bože	الله	None
božić	عيد الميلاد	Nan
br	لا	None
brak	زواج	None
braka	زواج	None
braku	زواج	None
brane	سد	None
brani	الدفاع	None
božiji	الله	None
bore	تجويف	Nan
borbu	يقاتل	Nan
borbi	يحارب	Nan
boban	بوبان	Nan
bobovac	بوبوفاك	Nan
bodova	نقاط	None
bog	الله	None
boga	الله	None
bogat	غني	None
bogata	غني	None
bogate	غني	None
bogati	غني	None
bogatih	غني	None
bogatim	غني	None
bogato	غني	None
bogatstva	الثروة	None
bogatstvo	الثروة	None
bogatu	غني	None
boas	البواء	Nan
blokova	الكتل	None
bloka	منع	None
blok	منع	None
bjelančevina	بروتين	Nan
bjelorusija	روسيا البيضاء	Nan
bjelorusije	روسيا البيضاء	Nan
bježi	اهرب	Nan
blagaj	السيولة النقدية	Nan
blage	خفيف	None
blago	كنز	Nan
boginja	إلهة	Nan
blaž	blaž	Nan
blažić	blažić	Nan
bliski	أغلق	Nan
bliskom	أغلق	Nan
blizini	مجاور	Nan
blizu	أغلق	Nan
bliže	أقرب	None
blog	مدونة	None
blaža	أخف	Nan
bogova	الآلهة	None
bogovi	الآلهة	None
bogovima	للآلهة	Nan
bolji	أفضل	None
bolnica	مستشفى	None
bolova	ألم	Nan
bomba	قنبلة	Nan
bombe	قنابل	Nan
bonaparte	بونابرت	None
bonus	علاوة	None
bolje	أفضل	None
bora	بورا	Nan
boraks	البوراكس	Nan
boravak	البقاء	None
boravka	البقاء	None
borba	يقاتل	Nan
borbama	يحارب	Nan
borbe	يحارب	Nan
borbeni	قتالية	Nan
borac	مقاتل	None
balkan	البلقان	None
bolja	أفضل	None
boleyn	ألم	Nan
bogu	الله	None
bohemian	البوهيمي	Nan
boja	اللون	None
bojama	الألوان	None
boje	الألوان	None
boji	الألوان	None
bojom	اللون	None
boli	يؤلم	Nan
boju	اللون	None
bol	بول	None
bola	ألم	Nan
bolesnik	صبور	Nan
bolesnika	المرضى	None
bolest	مرض	None
bolesti	الأمراض	None
bolestima	الأمراض	None
boksit	البوكسيت	Nan
brine	هموم	Nan
baljić	باليجيك	Nan
balada	أغنية	None
allah	الله	None
allaha	الله	None
allahov	الله	None
allahu	الله	None
alma	ألما	Nan
almir	المير	Nan
alpa	ألفا	None
alpha	ألفا	None
alternativni	لبديل	Nan
aluminij	الألومنيوم	Nan
aluminija	الألومنيوم	Nan
alžir	الجزائر	None
alžira	الجزائر	None
amar	حب	None
american	أمريكي	None
alkoholizma	إدمان الكحول	Nan
alkoholizam	إدمان الكحول	Nan
alkohola	الكحول	None
alkohol	الكحول	None
albumu	الألبوم	Nan
aleksa	اليكسا	Nan
aleksandar	الكسندر	Nan
aleksandra	الكسندر	Nan
alen	ألن	Nan
alexis	الكسيس	Nan
alge	الطحالب	Nan
americi	أمريكا	None
algi	الطحالب	Nan
algoritma	خوارزمية	Nan
algoritmi	الخوارزميات	Nan
alhamijado	الحميدو	Nan
ali	لكن	None
alija	اليجا	Nan
alije	لكن هو	Nan
alkini	الألكينات	Nan
algoritam	خوارزمية	Nan
albumi	ألبومات	Nan
americijum	أمريسيوم	Nan
amerikanci	أمريكيون	None
and	و	None
andora	أندورا	Nan
andrić	andrić	Nan
andrića	andrić	Nan
anemije	فقر دم	Nan
animacija	الرسوم المتحركة	Nan
anne	آن	None
anoda	الأنود	Nan
ansambl	فرقة	None
antarktika	أنتاركتيكا	Nan
ante	ما قبل	Nan
antibiotik	مضاد حيوي	Nan
antigona	أنتيجون	Nan
antioksidant	مضاد للأكسدة	Nan
antivirus	مضاد للفيروسات	Nan
anatomija	تشريح	Nan
analogni	التناظرية	Nan
analizu	تحليل	None
analizi	تحليل	None
amerike	أمريكا	None
ameriku	أمريكا	None
američka	أمريكي	None
američke	أمريكي	None
američki	أمريكي	None
američkih	أمريكي	None
američkim	أمريكي	None
amerika	أمريكا	None
američkog	أمريكي	None
američkom	أمريكي	None
amir	أفضل التحايا	Nan
amonijum	الأمونيوم	Nan
an	أ	None
ana	آنا	Nan
analiza	تحليل	None
analize	تحليل	None
američkoj	أمريكي	None
antička	عتيق	Nan
albuma	ألبومات	Nan
alberto	ألبرتو	Nan
adresa	عنوان	None
adresu	عنوان	None
adsorpcija	الامتزاز	Nan
aerodrom	مطار	None
aerodroma	مطار	None
afera	قضية	None
afganistan	أفغانستان	None
africi	أفريقيا	None
afrika	أفريقيا	None
afrike	أفريقيا	None
afriku	أفريقيا	None
afričke	الأفريقي	None
agencija	وكالة	None
agencije	وكالات	None
agresija	عدوان	Nan
adolf	أدولف	None
adobe	أدوبي	Nan
adnan	عدنان	None
administrativno	إداريا	Nan
+	+	None
a	أ	None
abc	أ ب	Nan
abdić	عبدي	Nan
abdića	عبده	None
abdul	عبد	None
abdulah	عبدالله	Nan
agresije	عدوان	Nan
abdullah	عبد الله	Nan
abraham	ابراهيم	Nan
abu	ابو	Nan
ad	ميلادي	Nan
adam	آدم	None
administrativna	إداري	None
administrativne	إداري	None
administrativni	إداري	None
abortus	الإجهاض	Nan
album	الألبوم	Nan
agresora	المعتدي	Nan
ahmed	أحمد	None
aktualizirano	محدث	Nan
akumulacije	تراكم	Nan
akutnog	حاد	Nan
al	آل	None
alat	أداة	None
alata	أدوات	Nan
alate	أدوات	Nan
alati	أدوات	Nan
albanaca	ألبان	Nan
albanci	ألبان	Nan
albanija	ألبانيا	None
albanije	ألبانيا	None
albaniji	ألبانيا	None
albanski	الألبانية	None
albert	ألبرت	None
aktivnosti	أنشطة	None
aktivnost	نشاط	None
aktivno	نشيط	Nan
aktivni	نشيط	Nan
ahmet	احمد	None
ahmeta	أحمد	None
aiša	عائشة	None
ajet	بيت شعر	Nan
ak	حزب العدالة	Nan
akademija	الأكاديمية	None
akademije	الأكاديمية	None
ahilej	أخيل	Nan
akademiji	الأكاديمية	None
akcija	عمل	None
akcije	أجراءات	Nan
ako	إذا	None
akrozom	اكروسوم	Nan
akt	فعل	None
aktivan	نشيط	Nan
aktivna	نشيط	Nan
akademiju	الأكاديمية	None
antičke	عتيق	Nan
antički	عتيق	Nan
antičkih	عتيق	Nan
austrija	النمسا	None
austrijanci	نمساويون	Nan
austrije	النمسا	None
austriji	النمسا	None
austrijom	النمسا	None
austrijska	النمساوي	None
austrijske	النمساوي	None
austrijski	النمساوي	None
austrijskog	النمساوي	None
austriju	النمسا	None
austrougarska	النمساوي المجري	Nan
austrougarske	النمساوي المجري	Nan
austrougarski	النمساوي المجري	Nan
austrougarsko	النمساوي المجري	Nan
austrougarskog	النمساوي المجري	Nan
australiji	أستراليا	None
australije	أستراليا	None
australija	أستراليا	None
auschwitz	أوشفيتز	Nan
atmosfere	الغلاف الجوي	Nan
atmosferi	الغلاف الجوي	Nan
atmosferu	الغلاف الجوي	Nan
atom	ذرة	Nan
atoma	ذرة	Nan
atomci	ذرات	None
atomsko	الذري	None
autizam	الخوض	Nan
atomskog	الذري	None
atp	atp	Nan
atrakcija	جاذبية	None
atrakcije	عوامل الجذب	Nan
august	أغسطس	None
augusta	أغسطس	None
augustin	أوغستين	Nan
augustu	أغسطس	None
aton	عليه	None
atmosfera	الغلاف الجوي	Nan
automatski	تلقائيا	Nan
autonomije	الحكم الذاتي	Nan
azije	آسيا	None
aziji	آسيا	None
aziju	آسيا	None
b	ب	None
bacanje	رمي	None
bach	باخ	Nan
bacte	البكتيريا	None
bad	سيئة	None
bajram	عيد	None
bajrama	عيد	None
bajramović	bajramović	Nan
bakar	نحاس	Nan
bakra	نحاس	Nan
bakterija	بكتيريا	None
bakterije	بكتيريا	None
azija	آسيا	None
azerbejdžan	أذربيجان	None
avioni	طائرات	None
aviona	الطائرات	None
autonomiju	الحكم الذاتي	Nan
autonomna	واثق من نفسه	Nan
autonomne	واثق من نفسه	Nan
autoput	الطريق السريع	Nan
autoputa	الطريق السريع	Nan
autoputeva	الطرق السريعة	Nan
autor	مؤلف	None
automobila	سيارات	None
autora	مؤلف	None
autorima	المؤلفون	Nan
autoritet	السلطة	None
autoru	للمؤلف	Nan
avaz	افاز	Nan
avgust	أغسطس	None
avijacija	طيران	None
avion	طائرة	None
autori	المؤلفون	Nan
atlantskog	الأطلسي	None
atlantski	الأطلسي	None
atini	أثينا	None
aprilu	أبريل	None
apsolutna	مطلق	Nan
apsolutni	مطلق	Nan
apsolutno	إطلاقا	Nan
ar	ع	Nan
arabija	شبه الجزيرة العربية	Nan
arabije	شبه الجزيرة العربية	Nan
arabiji	شبه الجزيرة العربية	Nan
arapa	عربا	Nan
arapi	عربى	Nan
arapska	عربى	Nan
arapske	عربى	Nan
arapski	عربى	Nan
arapskih	عربى	Nan
arapskim	عربى	Nan
aprila	أبريل	None
april	أبريل	None
apostola	الرسول	None
aplikacije	التطبيقات	None
antičko	عتيق	Nan
antičkog	عتيق	Nan
antičkoj	عتيق	Nan
anto	أنتو	Nan
antoaneta	أنطوانيتا	Nan
anton	أنتون	Nan
antonija	أنطونيا	Nan
arapskog	عربى	Nan
antonije	أنطونيج	Nan
antropologija	الأنثروبولوجيا	None
antropologije	الأنثروبولوجيا	None
antropologiju	الأنثروبولوجيا	None
antropolozi	علماء الأنثروبولوجيا	Nan
aparat	جهاز	None
aparata	جهاز	None
aplikacija	تطبيق	None
antonio	أنطونيو	Nan
arapskom	عربى	Nan
arbih	عربيه	Nan
argentina	الأرجنتين	None
arslanagić	أرسلاناجيك	Nan
art	فن	None
arterija	الشريان	Nan
arterije	الشرايين	Nan
artritis	التهاب المفاصل	Nan
as	مثل	None
asim	عاصم	None
arsen	الزرنيخ	Nan
asocijacija	جمعية	None
aspekta	جانب	None
aspekte	النواحي	None
aspirin	أسبرين	Nan
aspirina	أسبرين	Nan
at	في	None
atina	أثينا	None
atine	أثينا	None
aspekt	جانب	None
balade	القصص	None
armije	جيش	None
aritmetika	علم الحساب	Nan
arheolozi	علماء الآثار	Nan
arheološka	أثري	Nan
arheološki	أثري	Nan
arhipelag	أرخبيل	None
arhitekt	مهندس معماري	Nan
arhitekta	مهندس معماري	Nan
arhitektonski	معماريا	Nan
armija	جيش	None
arhitektura	هندسة معمارية	Nan
arhitekturi	هندسة معمارية	Nan
arhitekturu	هندسة معمارية	Nan
arhiv	أرشيف	Nan
arhiva	أرشيف	Nan
arija	الأغنية	None
aristotel	أرسطو	None
aristotela	أرسطو	None
arhitekture	هندسة معمارية	Nan
britanaca	من البريطانيين	Nan
britanci	البريطاني	None
britanija	بريطانيا	None
dnevna	اليومي	Nan
dnevne	اليومي	Nan
dnevnih	اليومي	Nan
dnevno	اليومي	Nan
dno	الأسفل	None
dns	نظام أسماء النطاقات	Nan
dnu	الأسفل	None
do	إلى	None
dob	عمر	None
doba	عمر	None
dobar	جيد	None
dobara	جيد	None
dobi	عمر	None
dobija	تم الاستلام	Nan
dobijaju	حصلوا عليها	Nan
dječja	الأطفال	None
djevojčice	الفتيات	Nan
djevojčica	فتاة	None
djevojka	فتاة	None
djelimično	في جزء	Nan
djelo	عمل	None
djelom	في جزء	Nan
djelomično	جزئيا	None
djelovanja	أجراءات	Nan
djelovanje	عمل	None
djelovanjem	عن طريق العمل	Nan
dobijali	تم الاستلام	Nan
djelovanju	عمل	None
djelu	عمل	None
djeluje	يعمل	None
djeluju	فعل	None
djeteta	طفل	None
djetinjstva	مرحلة الطفولة	Nan
djetinjstvo	مرحلة الطفولة	Nan
djetinjstvu	مرحلة الطفولة	Nan
djelovima	القطع	None
djelima	الأفعال	None
dobijanje	الحصول	None
dobiju	حصلوا عليها	Nan
dodati	أضف	Nan
dodatna	إضافي	Nan
dodatne	إضافي	Nan
dodatni	إضافي	Nan
dodatnim	إضافي	Nan
dodatno	بالإضافة إلى	Nan
dodatu	تمت الإضافة	Nan
dodavanja	الإضافات	Nan
dodavanje	مضيفا	Nan
dodavanjem	بإضافة	None
dodir	لمس. اتصال. صلة	Nan
dodirne	اللمسات	Nan
doduše	على أية حال	Nan
događa	يحدث	None
događaj	حدث	None
dodatak	إضافة	None
dodaje	هو يضيف	Nan
dobu	عمر	None
dobru	جيد	None
dobila	تم الاستلام	Nan
dobile	تم الاستلام	Nan
dobili	حصلت	None
dobilo	تم الاستلام	Nan
dobio	تم الاستلام	Nan
dobiti	احصل على	Nan
dobitnik	الفائز	None
dobije	يحصل على	Nan
doboj	doboj	Nan
dobra	جيد	None
dobre	جيد	None
dobri	جيد	None
dobrim	جيد	None
dobro	جيد	None
dobrog	جيد	None
dobrom	جيد	None
doboja	doboja	Nan
događaja	الأحداث	None
djelatnosti	أنشطة	None
djela	يعمل	None
dijamant	الماس	Nan
dijaspora	الشتات	Nan
dijela	جزء	None
dijele	شارك	None
dijeli	تشارك	None
dijelom	في جزء	Nan
dijelova	القطع	None
dijelove	القطع	None
dijelovi	القطع	None
dijelovima	القطع	None
dijelu	جزء	None
dijete	طفل	None
diktature	دكتاتورية	Nan
dimenzija	البعد	None
dimenzije	الأبعاد	None
dijalekta	لهجة	None
dijalekt	لهجة	None
dijagnoza	التشخيص	None
digitalnih	رقمي	Nan
desiti	أين أنت	Nan
desktop	سطح المكتب	Nan
desne	حق	None
desno	حق	None
desnoj	حق	None
desnom	حق	None
desnu	حق	None
din	الدين	None
detalja	تفاصيل	None
dezinflacija	إزالة التضخم	Nan
dešava	يحدث	None
dešavanja	الأحداث	None
di	دي	Nan
die	ال	None
digitalne	رقمي	Nan
digitalni	رقمي	Nan
devedesetih	التسعينات	Nan
djelatnost	نشاط	None
dinamo	دينامو	Nan
dinastija	سلالة حاكمة	Nan
distribucije	توزيع	None
distrikt	منطقة	None
distrikta	منطقة	None
diuretik	مدر للبول	Nan
divizija	قطاع	None
divizije	قطاع	None
divlje	بري	None
dizajn	التصميم	None
dizajna	التصميم	None
dizdar	ديزدار	Nan
djeca	أطفال	None
djece	الأطفال	None
djeci	الأطفال	None
djecom	الأطفال	None
djecu	الأطفال	None
distribucija	توزيع	None
disku	القرص	None
diskografija	التصوير	None
diska	القرص	None
dinastije	سلالة حاكمة	Nan
dino	دينو	Nan
dio	جزء	None
dioksid	ثاني أكسيد	Nan
dioksida	ثاني أكسيد	Nan
dionica	مخزون	Nan
dionice	مخازن	Nan
dinar	دينار	None
dioničar	شريك	None
direktor	مخرج	Nan
disanja	عمليه التنفس	Nan
disanje	عمليه التنفس	Nan
disciplina	انضباط	Nan
discipline	انضباط	Nan
disipacija	تبديد	Nan
disk	القرص	None
direktno	مباشرة	None
događaje	الأحداث	None
događaji	الأحداث	None
događajima	الأحداث	None
dovela	جلبت	Nan
dovele	جلبت	Nan
doveli	جلبت	Nan
dovelo	يؤدى	None
doveo	جلبت	Nan
dovesti	قيادة	None
dovode	يؤدي	None
dovodi	يؤدي	None
dovoljan	كاف	Nan
dovoljno	كافية	None
doza	جرعة	Nan
dozama	جرعات	Nan
doze	جرعات	Nan
dozvola	الإذن	Nan
dozvoljava	يسمح	None
dostupne	متاح	Nan
dostupna	متاح	Nan
dostupan	متاح	Nan
dostojevskog	دوستويفسكي	Nan
doprinijeli	ساهم	None
doprinijelo	ساهم	None
doprinos	إسهام	Nan
doprinosi	مساهمات	Nan
dopušta	يسمح	None
dosada	الملل	Nan
dosegla	وصلت	None
dozvoljeno	مسموح	Nan
doselili	هاجر	None
doslovno	حرفيا	Nan
dosta	كافية	None
dostigao	وصلت	None
dostignuća	الإنجازات	Nan
dostiže	يصل	None
dostižu	تصل	None
dostojevski	دوستويفسكي	Nan
doseljenika	المهاجرين	None
donošenja	تبني	None
dozvolu	الإذن	Nan
dočekao	رحب	Nan
dretar	دريتر	Nan
drevni	عتيق	Nan
drevnih	من القدماء	Nan
drevnog	عتيق	Nan
drina	درينا	Nan
drine	يشرب	None
drini	دريني	Nan
drinu	درينا	Nan
druga	آخر	None
drugačije	غير ذلك	Nan
druge	الآخرين	None
drugi	الآخرين	None
drugih	الآخرين	None
drugim	الآخرين	None
drugima	الى الاخرين	Nan
dream	حلم	Nan
draži	يغيظ	Nan
dražen	غضب	None
dramski	دراماتيكي	Nan
dođe	يأتي	None
došao	أتى	None
došla	أتى	None
došle	أتى	None
došli	أتى	None
došlo	أتى	None
doživio	يختبر	Nan
doći	ليأتي	Nan
doživjela	يختبر	Nan
doživljava	خبرة	Nan
dr	دكتور	Nan
draga	العزيز	None
dragan	دراغان	Nan
drago	العزيز	None
drama	دراما	None
drame	دراما	None
doživljaj	تجربة	None
donosi	يجلب	Nan
donose	احضر	Nan
donjim	خفض	None
dokument	المستند	Nan
dokumenta	مستندات	Nan
dokumentarni	وثائقي	None
dokumenti	مستندات	Nan
dokumentima	مستندات	Nan
dokumentu	المستند	Nan
dolar	دولار	None
dolara	دولار	None
dolaska	الوصول	None
dolaskom	الوصول	None
dolasku	الوصول	None
dolazak	الوصول	None
dolaze	انهم قادمون	Nan
dolazi	قادم	Nan
dolazili	أتى	None
dokumenata	مستندات	Nan
doktor	طبيب	None
dokazi	دليل	None
dokaze	دليل	None
događaju	حدث	None
događanja	الأحداث	None
dogodila	حدث	None
dogodilo	حدث	None
dogodio	حدث	None
dogovor	اتفاق	None
dogovora	اتفاق	None
dolazilo	كان سياتى	Nan
dohodak	الإيرادات	Nan
dojam	الانطباع	Nan
dojenje	الرضاعة الطبيعية	Nan
dojke	الثدي	None
dok	في حين	Nan
dokaz	دليل - إثبات	Nan
dokaza	دليل	None
dokazao	اثبت	Nan
dohotka	الإيرادات	Nan
dolina	الوادي	None
dolinama	الوديان	None
doline	الوديان	None
domove	دور	None
domovina	البلد الام	Nan
domovine	البلد الام	Nan
domovini	البلد الام	Nan
domovinu	البلد الام	Nan
domu	الصفحة الرئيسية	Nan
don	لا	None
dominiraju	تسيطر	None
donekle	إلى حد ما	Nan
donijeli	جلبت	Nan
donio	جلبت	Nan
donja	خفض	None
donje	خفض	None
donjeg	خفض	None
donjem	خفض	None
donji	خفض	None
donijela	جلبت	Nan
desio	منتديات	Nan
dominira	يهيمن	Nan
dominacije	هيمنة	Nan
dolini	الوادي	None
dolinom	الوادي	None
dolinu	الوادي	None
dolje	أسفل	None
dom	منزل	None
doma	في المنزل	Nan
domaća	المنزلي	None
dominantan	مهيمن	Nan
domaće	المنزلي	None
domaći	المنزلي	None
domaćih	المنزلي	None
domaćim	المنزلي	None
domaćin	المضيف	None
domaćina	المضيف	None
domena	نطاق	None
domet	نطاق	None
domaćeg	المنزلي	None
desilo	حدث	None
desetljeća	عقود	None
desetine	العشرات	Nan
centimetar	سنتيمتر	Nan
centra	مركز	None
centralna	وسط	None
centralne	وسط	None
centralni	وسط	None
centralnog	وسط	None
centralnoj	وسط	None
centralnom	وسط	None
centre	مركز	None
centri	المراكز	None
centrima	المراكز	None
centrom	مركز	None
centru	مركز	None
ceremonija	مراسم	Nan
cervantes	سرفانتس	Nan
center	مركز	None
centar|p|	مركز | ص |	Nan
centara	المراكز	None
centar	مركز	None
careva	الأباطرة	None
carevine	إمبراطورية	None
carigrad	القسطنطينية	None
carigrada	القسطنطينية	None
carl	كارل	None
carske	ملكي	None
carski	إمبراطوري	Nan
cesta	الطريق	None
carstva	إمبراطورية	None
carstvom	إمبراطورية	None
carstvu	مملكة	None
cazin	الكازين	Nan
cd	مؤتمر نزع السلاح	Nan
ce	إرادة	None
ceca	سيكا	Nan
celuloza	السليلوز	Nan
carstvo	مملكة	None
carem	ملك	None
ceste	الطرق	None
cezara	قيصر	None
ciklus	دورة	None
ciklusa	دورة	None
cilj	هدف	None
cilja	هدف	None
ciljem	هدف	None
ciljeva	الأهداف	None
ciljeve	الأهداف	None
ciljevi	الأهداف	None
cilju	هدف	None
cinabarit	الزنجفر	Nan
cink	زنك	Nan
cinka	زنك	Nan
cirkonijum	الزركونيوم	Nan
civila	المدنيين	None
civilizacija	حضارة	None
cijevi	أنابيب	None
cijev	يضخ	Nan
cijeni	السعر	Nan
cijene	الأسعار	None
cezijum	سيزيوم	Nan
charles	تشارلز	None
chicago	شيكاغو	Nan
christian	مسيحي	Nan
cia	وكالة المخابرات المركزية	Nan
cifara	رقم	None
cijela	كل	None
cezar	قيصر	None
cijele	كل	None
cijelim	كل	None
cijelo	بالكامل	Nan
cijelog	بالكامل	Nan
cijeloj	بالكامل	Nan
cijelom	على مدار	Nan
cijelu	بالكامل	Nan
cijena	السعر	Nan
cijeli	كل	None
cara	ملك	None
car	سيارة	None
california	كاليفورنيا	None
brojna	كثير	None
brojne	كثير	None
brojni	كثير	None
brojnih	كثير	None
brojnim	كثير	None
brojnost	وفرة	None
broju	رقم	None
bronhiole	القصيبات	Nan
bronzanog	برونز	Nan
bruno	برونو	Nan
brusnica	كرز	Nan
bruto	إجمالي	None
brz	بسرعة	None
brza	بسرعة	None
brze	بسرعة	None
broji	العد	Nan
brojevima	أعداد	None
brojevi	أعداد	None
brojeva	أعداد	None
britanije	بريطانيا	None
britaniji	بريطانيا	None
britannica	بريتانيكا	Nan
britanska	بريطاني	Nan
britanske	بريطاني	Nan
britanski	بريطاني	Nan
britanskih	بريطاني	Nan
brzi	بسرعة	None
britanskog	بريطاني	Nan
broda	سفينة	None
brodova	السفن	None
brodovi	السفن	None
brodu	سفينة	None
broj	رقم	None
broja	رقم	None
brojem	حسب الرقم	Nan
brod	سفينة	None
brzina	سرعة	None
brzine	سرعة	None
brzinom	سرعة	None
bugarske	البلغارية	None
bugarski	البلغارية	None
bugarskoj	البلغارية	None
bugarskom	البلغارية	None
bugojno	bugojno	Nan
buha	بوها	Nan
buhe	بوهي	Nan
bugarska	بلغاريا	None
bukal	بقال	Nan
bune	بون	Nan
busenje	حفر	None
busovača	busovača	Nan
bužim	bužim	Nan
byron	بايرون	Nan
c	ج	None
ca	كاليفورنيا.	Nan
bukvalno	حرفيا	Nan
civilizacije	حضارة	None
bugari	البلغار	Nan
budućnosti	من المستقبل	Nan
brzinu	سرعة	None
brzo	بسرعة	None
brčko	برتشكو	Nan
brže	بسرعة	None
brži	بسرعة	None
bubojedi	الخنافس	None
bubrega	الكلى	Nan
buenos	جيد	None
bubrezi	الكلى	Nan
budi	كن	Nan
budizam	البوذية	None
budu	انا سوف	Nan
buduće	مستقبل	None
budućeg	من المستقبل	Nan
budući	مستقبل	None
budućnost	المستقبل	None
bude	سوف يكون	Nan
drugog	آخر	None
civilizaciju	حضارة	None
cjeline	أجمعين	Nan
davao	أعطى	None
davati	لكي أعطي	Nan
david	ديفيد	None
davis	ديفيس	Nan
davnina	العصور القديمة	Nan
davno	منذ وقت طويل	Nan
davor	دافور	Nan
davorin	دافورين	Nan
daytonskog	من دايتون	Nan
dd	د	None
de	دي	Nan
debelog	سميك	Nan
decembra	ديسمبر	None
decembru	ديسمبر	None
decenija	عقد	None
datuma	تاريخ	None
datum	تاريخ	None
datoteku	ملف	None
datoteke	الملفات	None
danima	أيام	None
danska	الدنمارك	None
danske	دانماركي	Nan
danski	دانماركي	Nan
danskoj	دانماركي	Nan
dante	دانتي	Nan
dao	أعطى	None
decenijama	عقود	None
darko	داركو	Nan
dat	دات	Nan
date	تاريخ	None
dati	يعطى	Nan
datira	التعارف	Nan
datiraju	التعارف	Nan
datoteci	ملف	None
datoteka	ملف	None
darwin	داروين	None
daniel	دانيال	Nan
decenije	عقود	None
definicija	تعريف	None
demokratije	ديمقراطية	None
demokratiju	ديمقراطية	None
demokratska	ديمقراطي	Nan
demokratske	ديمقراطي	Nan
demokratski	ديمقراطي	Nan
denominacije	الطوائف	None
departmana	قسم	None
derivacija	الاشتقاق	Nan
derivat	المشتق	Nan
derivati	المشتقات	Nan
derventa	derventa	Nan
derviš	درويش	None
derviša	درويش	None
deset	عشرة	None
desetak	دستة	Nan
demokratija	ديمقراطية	None
demografija	الديموغرافيا	None
delčev	فتات	Nan
delta	دلتا	None
definicije	تعريفات	Nan
definiciji	تعريف	None
definiciju	تعريف	None
definira	يعرف	None
definisan	يعرف	None
definisana	يعرف	None
definisati	حدد	None
dedić	جد	None
definitivno	قطعا	Nan
dei	dei	Nan
dejtonski	دايتون	Nan
deklaracija	إعلان	None
dekonstrukcija	التفكيك	Nan
del	دل	Nan
delfi	دلفي	Nan
della	من	None
definiše	يعرف	None
dani	أيام	None
dane	نعم / لا	Nan
današnjoj	اليوم	None
crnih	أسود	None
crnim	أسود	None
crno	أسود	None
crnog	أسود	None
crnogorci	الجبل الأسود	Nan
crnogorski	الجبل الأسود	Nan
crnoj	أسود	None
crnom	أسود	None
crnomorskom	البحر الاسود	Nan
crnu	أسود	None
croatia	كرواتيا	Nan
crossfire	تبادل لإطلاق النار	Nan
crt	crt	Nan
crta	خط	None
crvena	أحمر	None
crni	أسود	None
crne	أسود	None
crna	أسود	None
crkvu	الكنيسة	None
cjelini	كل	None
cjelinu	كل	None
cjelokupne	شاملة	None
cjelokupnu	شاملة	None
co	شارك	None
columbia	كولومبيا	None
cpu	وحدة المعالجة المركزية	Nan
crvene	أحمر	None
crijeva	أمعاء	Nan
crkava	الكنائس	None
crkva	كنيسة	None
crkve	الكنائس	None
crkvene	كنسي	Nan
crkveni	كنسي	Nan
crkvi	كنيسة	None
crkvom	الكنيسة	None
crijevo	خرطوم	Nan
crveni	أحمر	None
crvenih	أحمر	None
crvenim	أحمر	None
daljnje	بالإضافة إلى ذلك	Nan
dalmacija	دالماتيا	Nan
dalmacije	دالماتيا	Nan
dalmaciji	دالماتيا	Nan
dalo	أعطى	None
damir	دامير	Nan
dan	يوم	None
dalji	بالإضافة إلى ذلك	Nan
dana	أيام	None
današnja	اليوم	None
današnje	اليوم	None
današnjeg	اليوم	None
današnjem	اليوم	None
današnji	اليوم	None
današnjih	اليوم	None
današnjim	اليوم	None
danas	اليوم	None
cjelina	كل	None
daljem	بالإضافة إلى ذلك	Nan
dali	سواء	None
crvenog	أحمر	None
crvenom	أحمر	None
cu	مع	None
cup	كوب	Nan
cvijet	زهرة	None
cvijeta	زهرة	None
cvijeće	زهور	Nan
dalje	بالإضافة إلى ذلك	Nan
cvjeta	تزهر	Nan
da	نعم	Nan
daje	اذا كانت	Nan
daju	يعطون	Nan
dajući	إعطاء	None
dakle	وبالتالي	None
dala	أعطى	None
daleko	بعيدا	None
cvjetovi	زهور	Nan
јuliјanski	جوليان	Nan
izmedu	ما بين	Nan
između	ما بين	Nan
mužu	الزوج	None
mz	م	Nan
münchen	ميونيخ	None
münchenu	ميونيخ	None
n	ن	None
n   z	nz	Nan
n  x	nx	Nan
na	على	None
naboja	الشحنة	None
nacija	الأمة	None
nacije	الأمم	None
nacionalna	الوطني	None
nacionalne	الوطني	None
nacionalni	الوطني	None
nacionalnih	الوطني	None
mužjaka	ذكور	None
mužjak	الذكر	None
mužjaci	ذكور	None
muža	الزوج	None
muzičke	موسيقي	Nan
muzički	موسيقيا	Nan
muzičkih	موسيقي	Nan
muzičkim	موسيقي	Nan
muzičkog	موسيقي	Nan
muzičku	موسيقى	None
muškarac	رجل	None
nacionalnim	الوطني	None
muškaraca	رجال	None
muškarce	رجال	None
muškarci	رجال	None
muške	رجال	None
muški	الذكر	None
muških	الذكر	None
muškog	الذكر	None
muž	الزوج	None
muškarca	رجل	None
muzička	موسيقي	Nan
nacionalno	وطنيا	Nan
nacionalnoj	الوطني	None
naglasiti	للتأكيد	Nan
naglo	بشكل مفاجئ	Nan
naglog	شديد الأنحدار	Nan
nagon	غريزه	Nan
nagrada	جائزة	None
nagrade	الجوائز	None
nagradu	جائزة	None
nagrađen	يكافأ	Nan
nahija	ناهيجا	Nan
nahije	ناهيج	Nan
nahiji	ناهيجي	Nan
naime	يسمى	None
najavljuje	تعلن	Nan
najbliže	الأقرب	None
najbolja	الأفضل	None
nafte	نفط	None
nafta	نفط	None
nadzorom	إشراف	Nan
nadzor	إشراف	Nan
nacionalnom	الوطني	None
nacionalnosti	الجنسية	None
nacionalnu	الوطني	None
nacističke	النازي	None
nacizam	النازية	None
nad	على	None
nada	أمل	None
nacionalnog	الوطني	None
nadalje	بالإضافة إلى ذلك	Nan
nade	أمل	None
nadimak	كنية	Nan
nadležnosti	الاختصاص القضائي	Nan
nadmorska	فوق مستوى سطح البحر	Nan
nadmorske	فوق مستوى سطح البحر	Nan
nadmorskoj	فوق مستوى سطح البحر	Nan
nadrealista	سريالي	Nan
nadbiskup	رئيس الأساقفة	Nan
najbolje	الأفضل	None
muzičari	الموسيقيين	Nan
muzičar	موسيقي او عازف	Nan
moć	قوة	None
moći	قوة	None
možda	يمكن	None
moždine	نخاع	Nan
može	يستطيع	None
možemo	نستطيع	None
možete	تستطيع	None
mramor	رخام	Nan
mrav	نملة	Nan
mreža	شبكة الاتصال	Nan
mrežama	الشبكات	None
mreže	الشبكات	None
mreži	الشبكات	None
mrežom	شبكة الاتصال	Nan
mrežu	شبكة الاتصال	Nan
mozilla	موزيلا	Nan
mozgu	الدماغ	None
mozga	الدماغ	None
mozart	موزارت	Nan
mosta	جسر	None
mostar	موستار	Nan
mostara	موستارا	Nan
mostarski	موستار	Nan
mostaru	موستارو	Nan
mostova	الجسور	None
mostovi	الجسور	None
mrkonjić	mrkonjić	Nan
mostu	جسر	None
motiva	الدافع	Nan
motive	الدوافع	None
motivi	الدوافع	None
moto	موتو	Nan
motora	محرك	Nan
mozaik	فسيفساء	Nan
mozak	الدماغ	None
motiv	الدافع	Nan
muzičara	الموسيقيين	Nan
mrtve	ميت	None
mu	له	None
muslimanima	المسلمون	None
muslimanska	مسلم	None
muslimanske	مسلم	None
muslimanski	مسلم	None
muslimanskih	مسلم	None
mustafa	مصطفى	None
muzej	متحف	None
muzeja	متحف	None
muzeji	المتاحف	None
muzejima	المتاحف	None
muzeju	متحف	None
muzici	موسيقى	None
muzika	موسيقى	None
muzike	موسيقى	None
muziku	موسيقى	None
muslimani	المسلمون	None
muslimane	المسلمون	None
muslimana	مسلم	None
musliman	مسلم	None
mudrosti	حكمة	None
muhamed	محمد	None
muhameda	محمد	None
muhammed	محمد	None
muhammeda	محمد	None
muhammedu	محمد	None
muhsin	محسن	Nan
msn	ام اس ان	Nan
mujo	موجو	Nan
mula	مولا	Nan
mulabdić	مولابديتش	Nan
mupa	موبا	Nan
murat	مراد	None
musa	موسى	None
musaka	مسقعة	Nan
music	موسيقى	None
muke	عذاب	Nan
najboljeg	الأفضل	None
najbolji	الأفضل	None
najboljih	الأفضل	None
napravi	يصنع	None
napravila	مصنوع	None
napravili	مصنوع	None
napravio	مصنوع	None
napraviti	يصنع	None
napravljen	مصنوع	None
napravljena	مصنوع	None
napravljene	مصنوع	None
napravljeni	مصنوع	None
napredak	تقدم	None
naprijed	إلى الأمام	Nan
naprimjer	فمثلا	None
naproksen	نابروكسين	Nan
napulj	نابولي	Nan
napusti	غادر	None
napose	خصوصا	None
napor	مجهود	Nan
napona	الجهد االكهربى	Nan
napon	الجهد االكهربى	Nan
napadima	الهجمات	None
napadne	هجوم	None
napadom	هجوم	None
napadu	هجوم	None
napamet	عن ظهر قلب	Nan
napao	هاجم	None
napasti	للهجوم	None
napustili	اليسار	None
napisan	مكتوبة	None
napisao	كتب	None
napisati	لأكتب	Nan
napokon	أخيرا	None
napoleon	نابليون	None
napoléon	نابليون	None
napomena	ملحوظة	None
napomenuti	للملاحظه	Nan
napisana	مكتوبة	None
napadi	الهجمات	None
napustio	اليسار	None
napušta	اوراق اشجار	Nan
narodnih	قوم	None
narodnim	قوم	None
narodno	وطنيا	Nan
narodnog	قوم	None
narodnom	قوم	None
narodu	اشخاص	Nan
naročito	خصوصا	None
nas	نحن	None
naselili	تسوية	None
naselja	المستوطنات	None
naseljavaju	تعيش في	Nan
naseljavali	مسكون	Nan
naselje	مستوطنة	None
naseljen	مسكون	Nan
naseljena	مسكون	Nan
narodni	قوم	None
narodne	قوم	None
narodna	قوم	None
narodima	الأمم	None
napuštaju	هم يغادرون	Nan
naraste	ينمو	Nan
naravi	طبيعة	None
naravno	بالتاكيد	Nan
naredba	أمر	None
naredbe	أوامر	None
naredbi	أمر	None
napustiti	يغادر	Nan
naredbu	أمر	None
naredne	التالى	Nan
narednih	التالى	Nan
narječje	لهجة	None
narod	اشخاص	Nan
naroda	اشخاص	Nan
narode	اشخاص	Nan
narodi	الأمم	None
naredio	أمر	None
napade	الهجمات	None
napada	هجوم	None
napad	هجوم	None
najstarije	الاكبر	Nan
najstariji	الاكبر	Nan
najstarijih	الاكبر	Nan
najteži	الاكثر صعوبة	Nan
najvažnija	الأكثر أهمية	Nan
najvažnije	الاكثر اهمية	Nan
najvažniji	الأكثر أهمية	Nan
najvažnijih	الأكثر أهمية	Nan
najveća	الاكبر	Nan
najveće	الأكبر	None
najvećeg	الأكبر	None
najvećem	الأكبر	None
najveći	الأكبر	None
najvećih	الاكبر	Nan
najvećim	الأكبر	None
najstarija	الاكبر	Nan
najprije	أول	None
najpoznatijih	الأكثر شهرة	Nan
najpoznatiji	الأكثر شهرة	Nan
najboljim	الأفضل	None
najbolju	الأفضل	None
najbrojniji	الأكثر عددًا	Nan
najduža	الأطول	Nan
najjača	الأقوى	Nan
najjači	الأقوى	Nan
najjačih	الأقوى	Nan
najvećoj	الأكبر	None
najljepše	الأجمل	Nan
najmanje	الأقل	None
najmanji	الأصغر	None
najniža	الأخفض	Nan
najpopularniji	الأكثر شعبية	Nan
najpopularnijih	الأكثر شعبية	Nan
najpoznatija	الأكثر شهرة	Nan
najpoznatije	الأكثر شهرة	Nan
najljepših	الأجمل	Nan
najveću	الأكبر	None
najviša	الاعلى	Nan
najviše	معظم	None
nalaziti	لايجاد	Nan
nalazišta	يجد	None
nalik	مثل	None
nam	نحن	None
nama	نحن	None
namaz	دعاء	None
namaza	نماز	Nan
nalazio	وجدت	None
nameće	يفرض	None
namjena	غرض	Nan
namjera	الهدف	Nan
namjere	نوايا	Nan
namjerno	عمدا	Nan
namještaja	أثاث المنزل	Nan
nanotehnologija	تكنولوجيا النانو	Nan
naoružanje	التسلح	Nan
namijenjen	مقصود	Nan
most	جسر	None
nalazimo	نجد	None
nalazili	وجدت	None
najviši	الاعلى	Nan
najvjerovatnije	على الأرجح	Nan
najznačajnija	الاكثر اهمية	Nan
najznačajnije	الاكثر اهمية	Nan
najznačajniji	الاكثر اهمية	Nan
najznačajnijih	الاكثر اهمية	Nan
najčešća	الاكثر انتشارا	Nan
nalazilo	وجدت	None
najčešće	اكثر شيوعا	Nan
naklada	الإصدار	None
naknadno	بعد ذلك	Nan
nakon	بعد	None
nalaze	يجد	None
nalazi	يجد	None
nalazila	وجدت	None
nalazile	وجدت	None
najčešći	الأكثر شيوعا	Nan
naseljeni	مسكون	Nan
moskvu	موسكو	None
moskve	موسكو	None
međunarodnom	دولي	None
međusobnim	متبادل	Nan
međusobno	لبعضهم البعض	Nan
međusobnom	متبادل	Nan
međutim	ومع ذلك	Nan
međuvremenu	في هذه الأثناء	Nan
meša	مزج	Nan
mg	ملغ	Nan
mi	نحن	None
michael	ميخائيل	None
michel	ميشيل	Nan
microsoft	مايكروسوفت	None
mig	أنا	None
migracija	الهجرة	None
migracije	الهجرة	None
međunarodnog	دولي	None
međunarodno	دوليا	Nan
međunarodnim	دولي	None
međunarodni	دولي	None
metalurgija	علم المعادن	Nan
metar	متر	None
metara	أمتار	Nan
metilen	الميثيلين	Nan
metod	طريقة	None
metoda	طريقة	None
metodama	طرق	None
miguel	ميغيل	Nan
metode	طرق	None
metodu	طريقة	None
mexico	المكسيك	None
mezheb	مذهب	Nan
meč	سيف	None
među	ما بين	Nan
međunarodna	دولي	None
međunarodne	دولي	None
metodologija	المنهجية	Nan
metalne	معدن	Nan
mijenja	التغييرات	None
mijenjati	للتغيير	Nan
mineralne	المعدنية	None
mineralnih	المعدنية	None
mineralogija	علم المعادن	Nan
mini	مصغرة	Nan
minimum	الحد الأدنى	Nan
ministar	وزير	None
ministara	الوزراء	None
ministarstva	الوزارات	Nan
ministarstvo	الوزارة	None
ministero	وزير	None
ministra	وزير	None
ministri	الوزراء	None
mini|indexi	فهارس صغيرة	Nan
minuta	الدقائق	Nan
miokarda	عضلة القلب	Nan
minerali	المعادن	None
minerale	المعادن	None
minerala	المعادن	None
mineral	المعدنية	None
mikrofon	ميكروفون	Nan
mikroskop	مجهر	Nan
mikroskopa	مجهر	Nan
milama	اميال	Nan
milan	ميلان	None
milana	ميلانا	Nan
mile	ميل	None
mijenjaju	يغيرون	Nan
milion	مليون	None
milić	حبيبي	None
miljacka	miljacka	Nan
miljacke	miljacke	Nan
milka	ميلكا	Nan
miloš	ميلوش	Nan
milošević	ميلوسيفيتش	Nan
miloševića	ميلوسيفيتش	Nan
miliona	مليون	None
mir	سلام	None
metali	المعادن	None
metal	معدن	Nan
medicini	الدواء	Nan
medicinska	طبي	Nan
medicinske	طبي	Nan
medicinski	طبي	Nan
medicinu	الدواء	Nan
medij	متوسط	None
medija	وسائل الإعلام	Nan
medije	وسائل الإعلام	Nan
mediji	وسائل الإعلام	Nan
medijima	وسائل الإعلام	Nan
medina	المدينة المنورة	Nan
medine	المدينة المنورة	Nan
medinu	المدينة المنورة	Nan
mediteran	البحر المتوسط	Nan
mediterana	البحر المتوسط	Nan
medicine	الدواء	Nan
medicina	الدواء	Nan
media	وسائل الإعلام	Nan
medalje	ميداليات	Nan
matrica	مصفوفة	Nan
matrice	مصفوفة	Nan
may	مايو	None
maya	مايا	Nan
mač	سيف	None
mađari	المجريون	Nan
mađarska	هنغاريا	Nan
mediteranu	المتوسطى	Nan
mađarske	المجري	None
mađarskoj	هنغاريا	Nan
mađarskom	المجري	None
mašina	آلة	None
mašine	الآلات	None
mašinski	ميكانيكي	Nan
me	أنا	None
medalja	ميدالية	Nan
mađarski	المجري	None
metala	معدن	Nan
medresa	المدرسة	None
mehaničke	ميكانيكي	Nan
menadžment	إدارة	None
mene	أنا	None
meni	إلي	None
menstruacije	الحيض	Nan
menstrualni	الحيض	Nan
menstrualnog	الحيض	Nan
mercury	الزئبق	Nan
merlin	ميرلين	Nan
mesa	لحم	None
meso	لحم	None
meta	الفوقية	Nan
metabolizam	التمثيل الغذائي	Nan
metabolizma	التمثيل الغذائي	Nan
metafizika	الميتافيزيقيا	Nan
metafora	تشابه مستعار	Nan
menadžer	مدير	None
memoriju	ذاكرة	None
memorije	ذاكرة	None
memorija	ذاكرة	None
mehanički	ميكانيكيا	Nan
mehmed	محمد	None
mehmeda	محمد	None
mehmedpaša	محمد باشا	Nan
mehmedpaše	محمد باشا	Nan
mehmedu	mehmedu	Nan
meho	الفراء	Nan
mehanizam	آلية	None
meke	ناعم	Nan
meksika	المكسيك	None
meksiko	المكسيك	None
meku	ناعم	Nan
melodije	ألحان	Nan
membrane	غشاء	None
memić	ميميتش	Nan
memići	memići	Nan
meki	ناعم	Nan
mira	ميرا	Nan
miraz	مهر	Nan
miris	رائحة	None
mogla	استطاع	None
mogle	استطاع	None
mogli	يقدروا	Nan
moglo	استطاع	None
mogu	يمكنني	Nan
moguć	ممكن	None
moguća	ممكن	None
moguće	ممكن	None
mogući	ممكن	None
mogućnost	إمكانية	None
mogućnosti	الفرص	Nan
mogućnostima	الفرص	Nan
moj	الخاص بي	Nan
moja	الخاص بي	Nan
moje	الخاص بي	Nan
mogao	استطاع	None
modriča	كدمات	Nan
modifikacija	تعديل	None
modernu	عصري	Nan
mnogobrojni	كثير	None
mnogobrojnih	كثير	None
mnogobrojnim	كثير	None
mnoštva	الحشود	Nan
mnoštvo	تعدد	Nan
mobilna	التليفون المحمول	Nan
model	نموذج	None
mokraćovod	الحالب	Nan
modela	نموذج	None
moderne	عصري	Nan
moderni	عصري	Nan
modernih	عصري	Nan
modernim	عصري	Nan
moderno	عصري	Nan
modernog	عصري	Nan
modernom	عصري	Nan
moderna	عصري	Nan
mnogobrojne	كثير	None
moldavija	مولدوفا	Nan
molekularna	جزيئي	Nan
moral	الأخلاق	None
morala	الأخلاق	None
morale	أخلاق	Nan
morali	أخلاق	Nan
moralna	أخلاقي	Nan
moralni	أخلاقي	Nan
moramo	علينا أن	Nan
morao	كان يجب ان	Nan
more	البحر	None
morem	عن طريق البحر	Nan
morfologija	علم التشكل المورفولوجيا	Nan
morima	البحار	None
morske	البحرية	None
moru	البحر	None
moskva	موسكو	None
moraju	يجب عليهم	Nan
mora	يجب	None
mooa	موا	Nan
moo	مو	Nan
molekule	جزيئات	None
moli	صلى	None
molibden	الموليبدينوم	Nan
molitva	دعاء	None
molitve	صلاة	None
momentu	لحظة	None
monarh	العاهل	Nan
molekula	مركب	None
monarha	العاهل	Nan
monarhije	الملكية	None
monitor	مراقب	None
monitora	مراقب	None
monitori	المراقبين	Nan
monociti	الوحيدات	Nan
monopol	احتكار	Nan
monteno	مونتينو	Nan
monarhija	الملكية	None
mnogobrojna	كثير	None
mnogo	كثير	None
mnogima	كثير جدا	Nan
mišića	عضلة	Nan
mišići	العضلات	None
mišićni	عضلي	Nan
mišićnih	عضلي	Nan
mišljenja	الآراء	Nan
mišljenje	رأي	None
mišljenju	رأي	None
mišo	الفأر	Nan
mjehur	مثانة	Nan
mjehura	مثانة	Nan
mjenja	التغييرات	None
mjera	قياس	None
mjere	تدابير	Nan
mjerenja	قياسات	Nan
mjerenje	قياس	None
mišić	عضلة	Nan
miš	الفأر	Nan
mitovi	الأساطير	None
mitologije	الأساطير	None
mirisa	رائحة	None
mirnim	امن	Nan
mirno	بهدوء	Nan
miroslav	ميروسلاف	Nan
mirovni	سلام	None
mirovnog	سلام	None
mirsad	مرصاد	Nan
mjeri	قياس	None
miru	سلام	None
misao	فكر	None
misija	مهمة	None
misli	أفكار	None
mislio	فكر	None
misticizam	التصوف	None
mit	مع	None
mitologija	الأساطير	None
mirza	ميرزا	Nan
mjerila	مقاييس	Nan
mjesec	شهر	None
mjeseca	الشهور	Nan
mladost	شباب	None
mladosti	شباب	None
mlađa	اصغر سنا	Nan
mlađe	اصغر سنا	Nan
mlađeg	اصغر سنا	Nan
mlađem	اصغر سنا	Nan
mlađi	اصغر سنا	Nan
mladog	شاب	Nan
mlađih	اصغر سنا	Nan
mlijeko	حليب	Nan
mm	مم	Nan
mnoga	كثير	None
mnoge	كثير	None
mnogi	كثير	None
mnogih	كثير	None
mnogim	كثير	None
mlijeka	حليب	Nan
moskvi	موسكو	None
mladića	شاب	Nan
mladim	شاب	Nan
mjeseci	الشهور	Nan
mjesecima	الشهور	Nan
mjesecu	شهر	None
mjesne	محلي	None
mjesta	أماكن	None
mjestima	أماكن	None
mjesto	مكان	None
mladić	شاب	Nan
mjestu	مكان	None
mješoviti	مختلط	Nan
mlad	شاب	Nan
mlada	شاب	Nan
mlade	شاب	Nan
mladen	شاب	Nan
mladi	شاب	Nan
mladih	الشباب	None
mješavina	خليط	None
naseljenih	مسكون	Nan
naseljeno	مسكون	Nan
naseljenosti	تعداد السكان	Nan
običajima	الجمارك	Nan
običnih	عادي	None
obično	عادة	None
objasniti	يشرح	Nan
objava	نشر	None
objave	المنشورات	Nan
objavila	نشرت	None
objavili	نشرت	None
objavio	نشرت	None
objavljen	نشرت	None
objavljena	نشرت	None
objavljivanja	نشر	None
objavljivanje	نشر	None
objavljuje	تنشر	Nan
objašnjava	يشرح	Nan
običaja	الجمارك	Nan
obitelji	أسرة	None
obim	الصوت	None
obiluje	تكثر	None
obaveza	التزام	Nan
obavezan	مطلوب	Nan
obaveze	التزامات	Nan
obavezno	مطلوب	Nan
obavlja	ينفذ	Nan
obavljaju	نفذ	Nan
obavljanje	أداء	None
objašnjenje	تفسير	None
obavljao	نفذت	Nan
obezbjeđuje	يوفر	None
obilje	وفرة	None
obilježava	علامات	None
obilježen	ملحوظ	None
obilježena	ملحوظ	None
obilježja	ميزات	Nan
obilježje	العلامات	Nan
obelisk	مسلة	Nan
obalu	ساحل	None
obje	على حد سواء	Nan
objekata	مرافق	Nan
obliku	شكل	None
obnove	التحديثات	Nan
obnovljena	رمم	Nan
oboljenja	الأمراض	None
oborina	ترسب	Nan
obrada	معالجة	None
obrade	معالجة	None
obradović	أوبرادوفيتش	Nan
obradu	معالجة	None
obrazovanja	التعليم	None
obrazovanje	التعليم	None
obrazuje	نماذج	None
obrađuje	العمليات	None
obreda	طقوس	None
obrnuto	والعكس صحيح	Nan
oblikovanje	التصميم	None
oblikom	شكل	None
oblike	الأشكال	None
oblika	شكل	None
objekt	موضوع	None
objekta	موضوع	None
objekte	شاء	None
objekti	شاء	None
objektima	مرافق	Nan
objektivne	هدف	None
objema	على حد سواء	Nan
objekat	موضوع	None
oblaci	سحاب	Nan
oblaka	سحاب	Nan
oblast	منطقة	None
oblasti	المناطق	None
oblastima	المناطق	None
oblici	الأشكال	None
oblicima	نماذج	None
oblik	شكل	None
oblak	غيم	Nan
obronci	المنحدرات	Nan
obalom	ساحل	None
obale	ساحل	None
nositi	ليرتدي	Nan
note	ملحوظة	None
nova	جديد	None
novac	مال	None
novca	مال	None
nove	جديد	None
novela	رواية	None
novele	روايات	None
novembra	شهر نوفمبر	Nan
novembru	شهر نوفمبر	Nan
novi	جديد	None
novih	جديد	None
novije	أحدث	None
noviji	أحدث	None
novim	جديد	None
nositelj	الناقل	Nan
nosioci	شركات النقل	Nan
nosio	حمل	None
nosili	ارتدى	Nan
nogometaši	لاعبي كرة القدم	Nan
nogometna	كرة القدم	Nan
nogometni	كرة القدم	Nan
nogometu	كرة القدم	Nan
nogu	رجل	None
normalan	عادي	None
normalna	عادي	None
novina	جريدة	None
normalnim	عادي	None
norme	أعراف	Nan
normi	أعراف	Nan
norveška	النرويج	None
nose	أنف	Nan
nosi	يلبس	Nan
nosila	نقالة	Nan
nosilac	الناقل	Nan
normalno	عادي	None
obali	ساحل	None
novinar	صحافي	Nan
novinarstvo	الصحافة	None
nuklearna	نووي	None
nuklearne	نووي	None
nuklearni	نووي	None
nuklearno	نووي	None
nuklearnog	نووي	None
nula	صفر	None
nule	صفر	None
numera	رقم	None
nuncije	nuncio	Nan
nušić	nušić	Nan
nužno	انه ضروري	Nan
o	س	None
oba	على حد سواء	Nan
obala	ساحل	None
obalama	ساحل	None
nudi	عروض	Nan
nude	ناقص	Nan
ns	نانوثانية	Nan
npr	على سبيل المثال	Nan
novine	الصحف	None
novković	نوفكوفيتش	Nan
novo	جديد	None
novog	جديد	None
novoj	جديد	None
novom	جديد	None
novu	جديد	None
novinari	الصحفيين	None
novčane	السيولة النقدية	Nan
novčanice	الأوراق النقدية	Nan
novčića	عملات معدنية	Nan
novčići	عملات معدنية	Nan
noć	ليل	Nan
noćas	هذه الليلة	Nan
noći	ليالي	None
noću	بالمساء	Nan
novčanica	ورقة نقدية	Nan
obroncima	المنحدرات	Nan
obruč	طارة	Nan
obuhvata	أغلفة	Nan
održan	مقبض	Nan
održana	مقبض	Nan
održane	مقبض	Nan
održao	مقبض	Nan
održati	للحفاظ عليها	Nan
održava	يحافظ	Nan
održavaju	صيانة	Nan
održavanja	اعمال صيانة	Nan
održavanje	اعمال صيانة	Nan
održavanju	اعمال صيانة	Nan
održavati	للحفاظ عليها	Nan
održi	معلق	Nan
odsjeci	أقسام	None
odsjek	الجزء	None
odsjeka	الجزء	None
održala	مقبض	Nan
određuju	تحديد	None
određuje	يحدد	None
određivanje	عزم	None
odrasle	الكبار	None
odraslih	الكبار	None
odražava	يعكس	None
odredio	تحدد	None
odrediti	لتحديد	None
određen	تحدد	None
određena	تحدد	None
oduvijek	دائما	None
određene	محدد	None
određenih	المؤكد	None
određenim	المؤكد	None
određeno	المؤكد	None
određenog	خاص	None
određenoj	المؤكد	None
određenom	المؤكد	None
određenu	المؤكد	None
određeni	المؤكد	None
odnosu	صلة	None
odvaja	يفترق	Nan
odvija	يأخذ مكانا	Nan
ogroman	ضخم	None
ogromne	ضخم	None
oi	منظمة العفو الدولية	Nan
oka	عين	None
okean	محيط	None
okeana	محيط	None
okeanu	محيط	None
oklop	درع	None
oko	عين	None
okolina	المحيط	None
okoline	بيئة	None
okolini	بيئة	None
okolinom	بيئة	None
okolinu	بيئة	None
okoliša	بيئة	None
ogrlicu	قلادة	Nan
ograničeno	محدودة	None
ograničenje	تقييد	Nan
ograničenja	قيود	None
odvijaju	تجري	None
odvojena	منفصل	Nan
odvojene	منفصل	Nan
odvojeni	فصل	None
odvojeno	بشكل منفصل	Nan
odžak	مدخنة	Nan
odžaku	مدخنة	Nan
odvajaju	منفصل	Nan
of	من	None
oficira	ضابط	None
og	og	Nan
ogleda	المرايا	Nan
ogledala	المرايا	Nan
ogranak	فرع شجرة	Nan
ograničen	محدودة	None
ograničena	محدودة	None
ofanziva	هجومي	Nan
odnosno	هذا هو	Nan
odnosima	العلاقات	None
odnosi	علاقات	None
odbili	رفض	None
odbio	رفض	None
odbojci	الكرة الطائرة	Nan
odbojka	الكرة الطائرة	Nan
odbojkaški	الكرة الطائرة	Nan
odbor	مجلس	None
odbora	مجلس	None
odbrambene	دفاعي	Nan
odbrambeni	دفاعي	Nan
odbrana	دفاع	Nan
odbrane	دفاع	Nan
odbrani	الدفاع	None
odbranu	دفاع	Nan
ode	قصيدة	None
odgoj	التعليم	None
odbila	رفض	None
odbija	رفض	None
odbacuju	يرفضون	Nan
odavno	منذ وقت طويل	Nan
obuhvataju	شمل	None
obuhvatala	يشمل	None
obuhvaća	يشمل	None
obzir	الاعتبار	None
obzira	بغض النظر	Nan
obzirom	مع مراعاة	Nan
oca	الآب	None
odgovara	تناسبها	Nan
ocem	الآب	None
ocjene	درجات	None
ocjenjivanje	وضع العلامات	Nan
ocjenu	درجة	None
od	من عند	Nan
odaje	الغرف	Nan
odakle	من أين	Nan
odatle	ومن ثم	Nan
ocjena	درجة	None
odgovaraju	مباراة	None
odgovarajuće	مناسب	None
odgovarajući	مناسب	None
odluka	قرار	None
odluke	قرارات	None
odlukom	قرار	None
odluku	قرار	None
odlučeno	قررت	Nan
odlučila	قررت	Nan
odlučili	قررت	Nan
odluci	قرارات	None
odlučio	قررت	Nan
odlučuju	يقررون	Nan
odmah	الآن	None
odmor	راحة	Nan
odmorište	منطقة استراحة	Nan
odnos	صلة	None
odnosa	العلاقات	None
odnose	علاقات	None
odlučuje	يقرر	Nan
nogometaš	لاعب كرة القدم	Nan
odličan	ممتاز	Nan
odlikovanja	الأوسمة	None
odgovarajućih	مناسب	None
odgovor	إجابة	Nan
odgovoran	مسؤول	None
odgovorio	رد	Nan
odgovornost	المسئولية	Nan
odgovornosti	المسؤوليات	Nan
odigrala	لعب	None
odlikuje	يتفوق	Nan
odigrana	لعب	None
odiseja	ملحمة	Nan
odjeću	ملابس	Nan
odlaska	مغادرة	None
odlaze	هم يغادرون	Nan
odlazi	ابتعد أو ارحل	Nan
odlika	جودة	None
odlike	ميزات	Nan
odigrao	لعب	None
nogometa	كرة القدم	Nan
nogomet	كرة القدم	Nan
noge	الساقين	Nan
načine	طرق	None
načini	طرق	None
načinom	الطريق	None
načinu	الطريق	None
nađe	يجد	None
nađeni	وجدت	None
naš	لنا	None
naša	لنا	None
našao	وجدت	None
naše	لنا	None
našeg	منا	None
našem	لنا	None
naših	لنا	None
našim	لنا	None
našla	وجدت	None
načina	طرق	None
način	الطريق	None
načelo	المبدأ	None
načelnik	عمدة	Nan
naziv	اسم	None
naziva	اتصل	Nan
nazivaju	اتصل	Nan
nazivali	اتصل	Nan
nazivamo	نحن نتصل	Nan
nazive	الأسماء	None
nazivi	الأسماء	None
našle	وجدت	None
nazivom	اسم الشيئ	Nan
nazvali	اتصل	Nan
nazvan	اتصل	Nan
nazvana	اتصل	Nan
nazvao	اتصل	Nan
nazvati	للإتصال	Nan
naći	لايجاد	Nan
načela	مبادئ	None
nazivu	اسم	None
nazad	عودة	None
našli	وجدت	None
našoj	لنا	None
negativni	سلبي	Nan
negativno	سلبي	Nan
negdje	مكان ما	Nan
nego	له	None
nejednakost	عدم المساواة	Nan
nek	نيك	Nan
neka	دع	Nan
nekad	بعض الاحيان	Nan
nekada	ذات مرة	Nan
nekadašnjeg	من السابق	Nan
neke	بعض	None
neki	بعض	None
nekih	بعض	None
nekim	لبعض	None
neko	شخصا ما	Nan
nedžad	نداد	Nan
nedugo	ليس طويل	Nan
nedovoljno	غير كاف	Nan
nedostatka	نقص	None
nažalost	للأسف	Nan
nba	نبأ	Nan
ndh	ndh	Nan
ne	لا	None
neba	السماء	None
nebeska	سماوي	Nan
nebesko	سماوي	Nan
našlo	وجدت	None
nebo	السماء	None
neboderi	ناطحات سحاب	Nan
nebu	السماء	None
neda	ندا	Nan
nedaleko	ليس بعيدًا	Nan
nedavno	مؤخرا	None
nedjelja	الأحد	None
nedostatak	نقص	None
nebodera	ناطحات سحاب	Nan
navrata	مرات	None
navodno	يزعم	Nan
navodi	ادعاءات	Nan
nastankom	الأصل	None
nastanku	الأصل	None
nastao	قام	None
nastava	تعليم	None
nastavak	واصلت	Nan
nastave	تعليم	None
nastavila	واصلت	Nan
nastavili	واصلت	Nan
nastavio	واصلت	Nan
nastaviti	لاستكمال	Nan
nastavlja	متواصل	Nan
nastavljaju	استمروا	Nan
nastavljeno	واصلت	Nan
nastojao	سعى	None
nastoji	المساعي	Nan
nastanka	المنشأ	Nan
nastanak	الأصل	None
nastalo	حدث	None
nastali	حدث	None
naseljima	المستوطنات	None
naselju	مستوطنة	None
naser	ناصر	None
nasilja	عنف	Nan
naslijedio	وارث	Nan
naslijeđe	التراث	None
nasljednici	ورثة	Nan
nastup	أداء	None
nasljednik	الوريث	Nan
nasljeđe	التراث	None
naslov	عنوان	None
nastajanje	تشكيل - تكوين	Nan
nastaje	يصبح	None
nastaju	تنشأ	None
nastala	قام	None
nastale	حدث	None
nasljednika	الوريث	Nan
nastupa	يحدث	None
nastupaju	نفذ	Nan
nastupali	نفذت	Nan
naučni	علمي	Nan
naučnici	العلماء	None
naučnih	علمي	Nan
naučnik	عالم	None
naučnika	عالم	None
naučno	علميا	Nan
naučnog	علمي	Nan
naučne	علمي	Nan
navedene	المدرجة	Nan
navedenih	المدرجة	Nan
navedenim	المدرجة	Nan
navedeno	معلن	Nan
navesti	على الدولة	Nan
navijača	المشجعين	Nan
navijači	المشجعين	Nan
navode	يقولون	None
navedeni	المدرجة	Nan
nekog	شخصا ما	Nan
naučna	علمي	Nan
nauku	علم	None
nastupao	نفذت	Nan
nastupe	العروض	None
nastupi	العروض	None
nastupima	العروض	None
nasuprot	على العكس تماما	Nan
natjecanja	مسابقات	None
nato	ثم	None
naučio	تعلمت	Nan
natoa	الناتو	None
natpisi	النقوش	Nan
natrag	عودة	None
natrijum	صوديوم	Nan
nauci	علم	None
nauka	علم	None
naukama	علوم	None
nauke	علم	None
natpis	نقش	Nan
matičnu	الأبوين	Nan
nekoj	شخصا ما	Nan
nekom	إلى شخص ما	Nan
njegove	له	None
njegovi	له	None
njegovih	له	None
njegovim	له	None
njegovo	له	None
njegovog	له	None
njegovoj	له	None
njegovom	له	None
njegovu	له	None
njeguje	يغذي	Nan
njem	انجم	Nan
njemačka	ألمانيا	None
njemačke	ألمانية	None
njemački	ألمانية	None
njemačkih	ألمانية	None
njegova	له	None
njegov	له	None
njega	له	None
nje	نجي	Nan
nivoima	المستويات	None
nivou	مستوى	None
niz	خيط	Nan
niza	خيط	Nan
nizak	منخفض	None
nizija	الأراضي المنخفضة	Nan
nizije	الأراضي المنخفضة	Nan
njemačkim	ألمانية	None
nizina	الأراضي المنخفضة	Nan
nizom	أسفل	None
nizu	خيط	Nan
ništa	لا شيئ	Nan
niža	خفض	None
niže	أدناه	None
niži	خفض	None
nižih	خفض	None
nizine	الأراضي المنخفضة	Nan
nivoa	المستويات	None
njemačkog	ألمانية	None
njemačkom	في المانيا	Nan
njihovo	لهم	None
njihovog	هم	None
njihovoj	لهم	None
njihovom	لهم	None
njihovu	لهم	None
njim	له	None
njima	معهم	None
njime	له	None
njoj	لها	None
njom	له	None
njome	نجوم	None
nju	لها	None
no	لا	None
nobelove	نوبل	None
nogama	أقدام	Nan
njihovim	لهم	None
njihovih	لهم	None
njihovi	لهم	None
njihove	لهم	None
njemačku	ألمانيا	None
njemu	له	None
njen	لها	None
njena	لها	None
njene	لها	None
njeni	لها	None
njenih	لها	None
njemačkoj	ألمانيا	None
njenim	لها	None
njenog	لها	None
njenoj	لها	None
njenom	لها	None
njenu	لها	None
njih	معهم	None
njihov	هم	None
njihova	هم	None
njeno	لها	None
nivo	مستوى	None
niti	ولا	None
nit	أحمق	Nan
neprestano	باستمرار	None
neprijatelj	العدو	None
neprijatelja	العدو	None
neprijatelje	أعداء	None
neretva	نيريتفا	Nan
neretve	نيريتفا	Nan
neretvi	neretvi	Nan
nerijetko	غالبا	None
nervni	متوتر	Nan
nervnog	متوتر	Nan
neslaganja	الخلافات	None
nestaje	يختفي	Nan
nestao	اختفى	Nan
network	شبكة الاتصال	Nan
neum	نيوم	Nan
neprekidno	بشكل متواصل	Nan
nepoznato	مجهول	None
nepoznati	مجهول	None
nepoznata	مجهول	None
nekropola	مقبرة	None
neku	بعض	None
nele	نيلي	Nan
nema	لا	None
nemaju	ليس لديهم	Nan
nemetal	اللافلزية	Nan
nemoguće	غير ممكن	Nan
nevesinje	nevesinje	Nan
nenad	فجأة	Nan
neophodne	ضروري	Nan
neophodni	ضروري	Nan
neophodno	ضروري	Nan
neopredijeljeni	غير محدد	Nan
neovisno	بشكل مستقل	Nan
neposredno	مباشرة	None
neposrednoj	فوري	Nan
neobično	غير عادي	Nan
news	أخبار	None
nezadovoljstvo	عدم الرضا	Nan
nezaposlenost	البطالة	None
nikako	لا يمكن	Nan
nikakve	لا شيء	Nan
nikakvog	لا شيء	Nan
niko	لا أحد	Nan
nikola	نيكولا	Nan
nikolaj	николай	Nan
nikole	نيكول	Nan
nikada	أبدا	None
nila	نيلا	Nan
nisam	لم أفعل	Nan
niska	منخفض	None
niske	منخفض	None
niskim	منخفض	None
niskog	منخفض	None
nismo	نحن لا	Nan
nisu	هم ليسوا	Nan
nimalo	على الاطلاق	Nan
nekoliko	قليلة	None
nikad	أبدا	None
nijemaca	الألمان	None
nezaposlenosti	البطالة	None
nezavisna	مستقل	None
nezavisne	مستقل	None
nezavisni	مستقل	None
nezavisno	مستقل	None
nezavisnost	استقلال	None
nezavisnosti	استقلال	None
nijemci	الألمان	None
neće	سوف لن	Nan
nešto	شيئا ما	Nan
ni	ني	Nan
nietzsche	نيتشه	None
nigdje	في أي مكان	Nan
nije	ليس	None
nijedan	لا شيء	Nan
nijedna	لا شيء	Nan
neću	لا	None
izmet	البراز	Nan
matičnih	الأبوين	Nan
matična	الأبوين	Nan
kategorijamedicina	فئة الطب	Nan
kategorijamediteranske	فئات البحر الأبيض المتوسط	Nan
kategorijamuškarac	فئات	None
kategorijanovi	مصنفة	Nan
kategorijaopćine	فئة البلدية	Nan
kategorijaračunarstvo	فئة الفئة	Nan
kategorijarijeke	كلمات الفئة	Nan
kategorijasoftver	فئة البرمجيات	Nan
kategorijasrednjobosanski	الفئة وسط البوسنة	Nan
kategorijaumjetnost	الفئةالفن	Nan
kategorijaunskosanski	فئة unskosanski	Nan
kategorijavoće	فئة الفاكهة	Nan
kategorijačlanovi	أعضاء الفئة	Nan
kategorijaženski	فئة أنثى	Nan
kategorije	التصنيفات	None
kategorijama	التصنيفات	None
kategorijaliteratura	أدب الفئة	Nan
kategorijaknjiževnost	فئة الأدب	Nan
kategorijajezici	فئة اللغات	Nan
kategorija	الفئة	None
kategorijabiografije	فئة السيرة الذاتية	Nan
kategorijabivše	الفئة	None
kategorijabosanski	فئة البوسنية	Nan
kategorijabosanskohercegovačka	فئة البوسنة والهرسك	Nan
kategorijabosanskohercegovačke	فئة البوسنة والهرسك	Nan
kategorijabosanskohercegovački	فئة البوسنة والهرسك	Nan
kategoriji	الفئة	None
kategorijadržave	فئة الدولة	Nan
kategorijageografija	التصنيف الجغرافي	Nan
kategorijaginekologija	فئة أمراض النساء	Nan
kategorijaglavni	فئةرئيسي	Nan
kategorijagradovi	الفئات	None
kategorijahemijski	فئة كيميائية	Nan
kategorijainternet	فئة الإنترنت	Nan
kategorijaislam	فئة الاسلام	Nan
kategorijafilozofija	فئة الفلسفة	Nan
katedrala	كاتدرائية	None
kategoriju	الفئة	None
katkad	بعض الأحيان	Nan
keramike	سيراميك	Nan
kernel	نواة	None
kesovija	kesovija	Nan
kihot	كيشوت	Nan
kilometara	كيلومترات	Nan
kina	الصين	None
kine	كين	Nan
kineska	صينى	Nan
kineski	صينى	Nan
kineskog	صينى	Nan
kini	الصين	None
kip	تمثال	None
kipar	نحات	Nan
kipra	قبرص	None
kipru	قبرص	None
kemal	كمال	None
kefir	الكفير	Nan
kažu	يقولون	None
kažemo	نحن نقول	Nan
katoda	الكاثود	Nan
katolici	الكاثوليك	Nan
katolika	كاثوليكي	Nan
katoličanstvo	الكاثوليكية	None
katolička	كاثوليكي	Nan
katoličke	كاثوليكي	Nan
katolički	كاثوليكي	Nan
katherine	كاثرين	Nan
kavkaz	القوقاز	None
kazahstan	كازاخستان	Nan
kazahstana	كازاخستان	Nan
kazasi	kazasi	Nan
kazna	عقاب	Nan
kazne	العقوبات	None
kaznu	عقاب	Nan
kaže	يقول	None
kavkaza	القوقاز	None
kirijum	كيريوم	Nan
katedra	كرسي	None
katarina	كاتارينا	Nan
kant	كانط	Nan
kanton	كانتون	Nan
kantona	كانتون	Nan
kantonu	كانتون	Nan
kao	مثل	None
kapacitet	سعة	Nan
kapaciteta	سعة	Nan
kapaciteti	القدرات	None
kapetan	قائد المنتخب	Nan
kapetana	قائد المنتخب	Nan
kapija	بوابة	None
kapital	عاصمة	None
kapitala	عاصمة	None
kapiten	قائد المنتخب	Nan
karadžić	كارادزيتش	Nan
kanalima	القنوات	None
kanali	القنوات	None
kanala	قناة	None
kanal	قناة	None
kalorija	سعرات حراريه	Nan
kamen	حصاة	Nan
kamena	حصاة	Nan
kamengrad	كامينغراد	Nan
kameni	الحجارة	None
kamenih	حصاة	Nan
kamenim	حصاة	Nan
karajlić	كاراجليتش	Nan
kamenje	الحجارة	None
kamenom	حصاة	Nan
kamenčića	الحصى	Nan
kamenčiće	الحصى	Nan
kanada	كندا	None
kanade	كندا	None
kanadi	كندا	None
kanadu	كندا	None
kamenog	من الحجر	Nan
katarinom	كاتارينوم	Nan
karakter	حرف	None
karakteristika	صفة مميزة	Nan
karlo	كارلو	Nan
karta	خريطة	None
karte	خرائط	None
kartica	بطاقة	None
kartice	بطاقات	None
kartu	خريطة	None
kasnih	في الآونة الأخيرة	Nan
kasnije	في وقت لاحق	Nan
kasniji	في وقت لاحق	Nan
kasnijih	في وقت لاحق	Nan
kasnijim	في وقت لاحق	Nan
kasnim	أنا متأخر	Nan
kasno	متأخر	Nan
kasnom	متأخر	Nan
kaspijskog	قزوين	None
karla	كارلا	Nan
karl	كارل	None
karijeru	مسار مهني مسار وظيفي	Nan
karijeri	مسار مهني مسار وظيفي	Nan
karakteristikama	مميزات	None
karakteristike	مميزات	None
karakterističan	صفة مميزة	Nan
karakteristična	صفة مميزة	Nan
karakteristične	صفة مميزة	Nan
karakteristično	صفة مميزة	Nan
karakteriše	يميز	None
karaktera	حرف	None
karakterišu	تميز	None
karata	خريطة	None
karate	الكاراتيه	Nan
karbonat	كربونات	Nan
karcinom	سرطان	None
kardiogenog	قلبية	Nan
karijera	مسار مهني مسار وظيفي	Nan
karijere	مسار مهني مسار وظيفي	Nan
karasi	كاراسي	Nan
kisela	حامض	Nan
kiselina	حامض	Nan
kiseline	الأحماض	None
kolo	دائرة	None
kolone	الأعمدة	None
kolonija	مستعمرة	None
kolonije	المستعمرات	None
kolumbija	كولومبيا	None
kom	أجهزة الكمبيوتر	Nan
komandant	قائد	None
komandanta	قائد	None
komandom	أمر	None
komandu	أمر	None
kombinacija	مزيج	None
kome	إلى من	Nan
komedija	كوميديا	Nan
komedije	كوميديا	Nan
komensalizam	معايشة	Nan
koljena	الركبتين	Nan
količinu	كمية	None
količinom	كمية	None
količini	كمية	None
kojem	إلى من	Nan
kojemu	إلى من	Nan
koji	الذي	None
kojih	الذي	None
kojim	الذي	None
kojima	الذي	None
kojoj	الذي	None
komete	مذنب	Nan
kojom	الذي	None
koktel	كوكتيل	Nan
kola	سيارة	None
kolekcija	مجموعة	Nan
koliko	كم الثمن	Nan
količina	كمية	None
količinama	كميات	None
količine	كميات	None
koju	الذي	None
kojega	الذي	None
komisija	عمولة	Nan
komora	غرفة	None
komunikacija	الاتصالات	None
komunikacije	مجال الاتصالات	Nan
komunikaciju	الاتصالات	None
komunista	شيوعي	Nan
komunistička	شيوعي	Nan
komunističke	شيوعي	Nan
komunizma	شيوعية	None
konami	كونامي	Nan
konačan	نهائي	None
konačna	نهائي	None
konačno	أخيرا	None
konačnom	نهائي	None
konačnu	نهائي	None
koncentracija	تركيز	None
koncentracije	تركيز	None
komuniciranje	الاتصالات	None
komuniciranja	الاتصالات	None
kompozitori	الملحنين	Nan
kompozitora	ملحن	Nan
komore	الغرف	Nan
kompajler	مترجم	Nan
kompanija	شركة	None
kompanije	الشركات	None
kompilacije	مصنفات	Nan
kompleks	مركب	None
kompleksa	مركب	None
komisije	عمولة	Nan
kompleksne	مركب	None
komplikacija	تعقيد	Nan
komponenata	المكونات	None
komponente	المكونات	None
komponenti	المكونات	None
kompozicija	تكوين	None
kompozicije	التراكيب	Nan
kompozitor	ملحن	Nan
kompletna	اكتمال	Nan
kojeg	الذي	None
koje	الذي	None
koja	الذي	None
klasifikacija	تصنيف	None
klasična	كلاسيكي	Nan
klasične	كلاسيكي	Nan
klasični	كلاسيكي	Nan
klasičnih	كلاسيكي	Nan
klasičnim	كلاسيكي	Nan
klasičnog	كلاسيكي	Nan
klasičnoj	كلاسيكي	Nan
klasu	صف دراسي	Nan
klavijature	لوحات المفاتيح	Nan
kleopatra	كليوباترا	None
klima	مناخ	None
klimatologija	علم المناخ	Nan
klimatske	مناخي	Nan
klimatski	مناخي	Nan
klase	صف دراسي	Nan
klasa	صف دراسي	Nan
klapa	كلابا	Nan
klanjati	العبادة	None
kiselinu	حامض	Nan
kiseljak	حميض	Nan
kiseljaka	حميض	Nan
kiseonik	الأكسجين	None
kiseonika	الأكسجين	None
kisik	الأكسجين	None
kisika	الأكسجين	None
klimatskim	مناخي	Nan
kisikom	الأكسجين	None
kičmenjaci	الفقاريات	Nan
kičmenjaka	الفقاريات	Nan
kiša	تمطر	Nan
kiše	تمطر	Nan
kk	ك ك	Nan
kladuša	kladuša	Nan
klanja	ذبح	Nan
kičmene	العمود الفقري	Nan
klime	مناخ	None
klimu	مناخ	None
klitoris	بظر	Nan
književnici	الكتاب	None
književnik	كاتب	None
književnika	الكتاب	None
književnim	أدبي	Nan
književno	أدبي	Nan
književnog	أدبي	Nan
književnost	المؤلفات	None
književni	أدبي	Nan
književnosti	المؤلفات	None
koalicija	الائتلاف	None
kocka	مكعب	Nan
kod	الشفرة	Nan
koda	الشفرة	Nan
kodu	الشفرة	Nan
kog	كوغ	Nan
koga	متى	None
ko	منظمة الصحة العالمية	Nan
kalinovik	كالينوفيك	Nan
književne	أدبي	Nan
knjizi	كتاب	None
kljove	أنياب	Nan
ključ	مفتاح	None
ključne	مفتاح	None
ključni	مفتاح	None
klub	النادي	None
kluba	النادي	None
klubova	الأندية	None
književna	أدبي	Nan
klubovi	الأندية	None
klubu	النادي	None
km	كم	None
knez	أمير	None
kneza	أمير	None
knjiga	كتاب	None
knjige	كتب	None
knjigu	كتاب	None
klubovima	الأندية	None
koncept	مفهوم	None
kalesije	كالسيجي	Nan
kalendaru	التقويم	None
jajna	بيض	Nan
jajne	بيض	Nan
jajnici	المبيضين	Nan
jajnika	المبيضين	Nan
jajovod	قناة فالوب	Nan
jajovoda	قناة فالوب	Nan
jak	مثل	None
jaka	قوي	None
jake	قوي	None
jakih	قوي	None
jakim	قوي	None
jako	مثل	None
jakog	قوي	None
jakov	جاكوف	Nan
jakova	جاكوف	Nan
jajcu	بيضة	Nan
jajce	بيضة	Nan
jajca	بيض	Nan
jaja	بيض	Nan
ići	توجو	Nan
išao	ذهب	None
išla	ذهب	None
ja	نعم	Nan
jablanica	شجرة تفاح	Nan
jabuka	تفاحة	Nan
jabuke	تفاح	Nan
james	جوامع	Nan
jackson	جاكسون	None
jaden	فقير	Nan
jadrana	الأدرياتيكي	Nan
jadransko	البحر الأدرياتيكي	Nan
jadranskog	البحر الأدرياتيكي	Nan
jagoda	الفراولة	Nan
jagode	الفراولة	Nan
jahić	متسابق	Nan
jacques	جاك	None
izvršnu	تنفيذي	Nan
jane	جين	None
janković	јанковић	Nan
javnom	عامة	None
javnost	الجمهور	None
javnosti	الجمهور	None
jazz	موسيقى الجاز	Nan
jača	أقوى	None
jače	أقوى	None
jači	أقوى	None
jačina	قوة	None
jd	دينار	None
je	يكون	None
jean	جان	None
jedan	واحد	None
jedina	فقط	None
jedine	الوحيدين	Nan
jedini	الوحيد	None
javnog	عامة	None
javno	عامة	None
javnih	عامة	None
javni	عامة	None
januar	كانون الثاني	Nan
januara	كانون الثاني	Nan
januaru	كانون الثاني	Nan
japan	اليابان	None
japana	اليابان	None
japanski	اليابانية	None
japanu	اليابان	None
janja	لحم ضأن	Nan
jasna	واضح	None
java	جافا	Nan
javi	مكالمة	Nan
javiti	نقل	None
javlja	التقارير	None
javljaju	يبلغون	Nan
javna	عامة	None
javne	عامة	None
jasno	واضح	None
jedinica	وحدة	None
izvršna	تنفيذي	Nan
izvršio	ملتزم	Nan
izrazito	بشكل واضح	Nan
izračunavanje	عملية حسابية	Nan
izražaja	التعبير	None
izražava	يعبر	None
izražen	أعربت	Nan
izražena	أعربت	Nan
izražene	أعربت	Nan
izričito	صراحة	Nan
izuzetak	استثناء	Nan
izuzetne	استثنائي	Nan
izuzetno	استثنائي	Nan
izuzev	إلا	None
izučava	دراسات	None
izučavaju	أنهم يدرسون	Nan
izučavanje	دراسة	Nan
izraziti	للتعبير	None
izrazi	التعبيرات	Nan
izraza	التعبير	None
izraz	التعبير	None
izmjena	يتغيرون	Nan
izmjene	التغييرات	None
izmjerena	يقاس	Nan
iznad	في الاعلى	Nan
iznimno	بشكل استثنائي	Nan
iznos	كمية	None
iznose	كميات	None
izvan	في الخارج	Nan
iznosi	كميات	None
iznosu	كمية	None
izomeraza	الأيزومراز	Nan
izrade	صناعة	None
izradu	صناعة	None
izrael	إسرائيل	None
izraela	إسرائيل	None
izravno	مباشرة	None
iznosio	أخرج	None
izvršiti	ينفذ	Nan
izvanredne	استثنائي	Nan
izveden	أخرجت	Nan
izvoznik	مصدر	None
izvozu	تصدير	None
izvođač	مقاول	Nan
izvođača	فناني الأداء	Nan
izvođači	فناني الأداء	Nan
izvođenja	أداء	None
izvođenje	أداء	None
izvršava	ينفذ	Nan
izvršavanja	تنفيذ	None
izvršavanje	تنفيذ	None
izvršavati	نفذ - اعدم	Nan
izvršen	أعدم	Nan
izvršenje	تنفيذ	None
izvrši	نفذ - اعدم	Nan
izvršila	أعدم	Nan
izvoze	صادرات	None
izvoz	تصدير	None
izvorno	في الأصل	Nan
izvorni	أصلي	Nan
izvedena	نفذت	Nan
izvedeni	مستمد	Nan
izveli	نفذت	Nan
izvesti	أخرج	None
izvire	الينابيع	Nan
izvještaj	نقل	None
izvještaju	نقل	None
izvedbe	أداء	None
izvlačenje	رسم	None
izvodi	المشتقات	Nan
izvodili	نفذت	Nan
izvor	مصدر	None
izvora	مصادر	None
izvore	مصادر	None
izvori	مصادر	None
izvorima	مصادر	None
izvode	نفذ	Nan
jedinicama	الوحدات	None
jedinice	الوحدات	None
jedinici	وحدة	None
jugoslovenske	يوغسلافيا	Nan
jugoton	جوغوتون	Nan
jugozapadnom	جنوب غرب	Nan
jugozapadu	جنوب غرب	Nan
jugu	جنوب	None
jula	يوليو	None
juli	يوليو	None
julija	يوليو	None
julije	يوليو	None
julska	يوليو	None
julu	يوليو	None
juna	يونيو	None
junak	بطل	None
junaka	أبطال	None
juni	يونيو	None
jugoslaviju	يوغوسلافيا	Nan
jugoslaviji	يوغوسلافيا	Nan
jugoslavije	يوغوسلافيا	Nan
jugoslavija	يوغوسلافيا	Nan
josip	القيل والقال	Nan
josipa	جوزيبا	Nan
jovan	جوفان	Nan
još	أكثر	None
ju	جو	None
juan	يوان	None
judaizam	اليهودية	None
junu	يونيو	None
jug	جنوب	None
jugoistoku	الجنوب الشرقي	Nan
jugoistočne	جنوبي شرقي	Nan
jugoistočnoj	جنوبي شرقي	Nan
jugoistočnom	جنوبي شرقي	Nan
jugoslaveni	اليوغسلافيون	Nan
jugoslavenske	يوغسلافيا	Nan
jugoslavenskih	يوغسلافيا	Nan
juga	جنوب	None
joseph	جوزيف	None
jure	بحكم القانون	Nan
jutro	صباح	None
kadr	الإطار	None
kajsija	مشمش	Nan
kakanj	كاكانج	Nan
kakav	اي نوع	Nan
kako	كيف	None
kakva	ماذا	None
kakve	ماذا	None
kakvi	ماذا	None
kakvo	ماذا	None
kakvu	ماذا	None
kalaj	الصفيح	Nan
kalcijum	الكالسيوم	Nan
kalcijuma	الكالسيوم	Nan
kalendar	التقويم	None
kalendara	التقويم	None
kadmijum	الكادميوم	Nan
kadiluk	kadiluk	Nan
kadija	قديجة	Nan
kada	متى	None
južna	جنوبي	None
južne	جنوبي	None
južni	جنوبي	None
južnih	جنوبي	None
južnim	جنوبي	None
južnjaci	الجنوبيون	Nan
južno	جنوب	None
jusić	إبتهج	Nan
južnog	جنوبي	None
južnom	جنوبي	None
južnu	جنوب	None
k	ك	Nan
ka	كا	Nan
kabe	كابي	Nan
kabriolet	قابلة للتحويل	Nan
kad	متى	None
južnoj	جنوبي	None
josef	جوزيف	None
jos	أكثر	None
jorgovan	أرجواني	Nan
jednačina	معادلة	Nan
jedne	واحد	None
jedni	واحد	None
jednim	واحد	None
jedno	واحد	None
jednog	واحد	None
jednoj	واحد	None
jednom	ذات مرة	Nan
jednostavan	بسيط	None
jednostavna	بسيط	None
jednostavne	بسيط	None
jednostavni	بسيط	None
jednostavnije	أبسط	Nan
jednostavno	ببساطة	None
jednu	واحد	None
jednakosti	المساواة	None
jednakost	المساواة	None
jednako	بالتساوي	Nan
jednaki	مساو	Nan
jedinjenja	مجمعات سكنية	Nan
jedinki	الأفراد	None
jedino	فقط	None
jedinstva	وحدة	None
jedinstven	فريد	None
jedinstvena	فريد	None
jedinstveni	فريد	None
jedu	هم ياكلون	Nan
jedinstveno	فريد	None
jedinstvenu	فريد	None
jedinstvo	وحدة	None
jedinu	الوحيد	None
jedna	واحد	None
jednak	مساو	Nan
jednaka	مساو	Nan
jednake	مساو	Nan
jedinstvenog	فريد	None
jedva	بالكاد	Nan
jela	أطباق	Nan
jelena	الغزال	Nan
jezik	لغة	None
jezika	لغة	None
jezike	اللغات	None
jezikom	لغة	None
jeziku	لغة	None
jezičke	نوافذ التبويب	Nan
jezički	لغويا	Nan
jezicima	اللغات	None
jezične	لغوي	Nan
ječam	شعير	Nan
jna	جنا	Nan
johann	جوهان	Nan
john	يوحنا	None
johna	جون	None
joj	عذرًا	Nan
jordan	الأردن	None
jezični	لغوي	Nan
kalesija	كالسيجا	Nan
jezici	اللغات	None
jezgra	النواة	Nan
jer	لان	None
jesen	الخريف	Nan
jeseni	الخريف	Nan
jesenjin	الخريف	Nan
jest	يكون	None
jeste	أنه	None
jesti	لتناول الطعام	Nan
jezgro	النواة	Nan
jesu	هم انهم	Nan
jetre	الكبد	None
jevreja	يهود	None
jevreji	يهود	None
jevrejska	يهودي	None
jevrejskog	يهودي	None
jezera	بحيرات	None
jezero	بحيرة	None
jetra	الكبد	None
koncerata	حفلة موسيقية	Nan
koncert	حفلة موسيقية	Nan
koncerta	حفلة موسيقية	Nan
ljubuški	حبيبة القلب	Nan
ljude	اشخاص	Nan
ljudi	اشخاص	Nan
ljudima	اشخاص	Nan
ljudska	بشري	None
ljudske	بشري	None
ljudski	بشري	None
ljudskih	بشري	None
ljudskim	بشري	None
ljudsko	بشري	None
ljudskog	بشري	None
ljudskom	بشري	None
ljudsku	بشري	None
lobanja	جمجمة	Nan
lociran	تقع	None
ljubljani	ليوبلياني	Nan
ljubljana	ليوبليانا	Nan
ljubavne	حب	None
ljubavna	محب	Nan
ličnost	الشخصية	None
ličnosti	شخصيات	None
lj	lj	Nan
ljekar	طبيب	None
ljepote	جمال	None
ljestvicama	مقاييس	Nan
ljeta	الصيف	None
logika	منطق	Nan
ljeti	في الصيف	Nan
ljetne	الصيف	None
ljetnim	الصيف	None
ljeto	الصيف	None
ljiljan	ليلي	Nan
ljiljana	زنبق	Nan
ljubav	حب	None
ljubavi	حب	None
ljetima	في الصيف	Nan
lično	شخصيا	Nan
logička	منطقي	Nan
logor	معسكر	None
londona	لندن	None
londonu	لندن	None
lopta	الكرة	Nan
lopte	كرات	None
loptica	كرة	None
loptice	كرات	None
lopticu	الكرة	Nan
loptom	كرة	None
loptu	الكرة	Nan
lord	يا رب	Nan
los	لوس	None
louis	لويس	None
louisa	لويزا	Nan
lov	الصيد	None
love	حب	None
london	لندن	None
lokalnom	محلي	None
lokalnog	محلي	None
lokalno	محليا	Nan
logora	معسكر	None
logoraša	سجناء المعسكر	Nan
logoraši	سجناء المعسكر	Nan
logore	المخيمات	Nan
logori	المخيمات	Nan
logoru	معسكر	None
lokacija	موقعك	Nan
logično	منطقي	Nan
lokacije	المواقع	None
lokaliteta	محلة	Nan
lokalitetu	محلة	Nan
lokalna	محلي	None
lokalne	محلي	None
lokalni	محلي	None
lokalnih	محلي	None
lokalnim	محلي	None
lokaciji	موقعك	Nan
loza	كرمة	Nan
lični	شخصي	Nan
livno	ليفنو	Nan
ligi	الدوري	None
ligu	الدوري	None
lijek	الدواء	Nan
lijekova	المخدرات	None
lijekovi	الأدوية	None
lijekovima	المخدرات	None
lijep	لطيف	Nan
lijepa	جميلة	None
lijepo	لطيف	Nan
lijeva	اليسار	None
lijeve	اليسار	None
lijevo	اليسار	None
lijevoj	اليسار	None
lijevom	اليسار	None
lijevu	اليسار	None
lige	الدوري	None
liga	الدوري	None
licu	وجه	None
licence	رخصة	Nan
legura	أشابة	Nan
legure	سبائك	Nan
leksikologija	علم المعاجم	Nan
leonardo	ليوناردو	None
let	دع	Nan
lete	يطير	Nan
letjelica	الطائرات	None
liječenja	علاج او معاملة	Nan
lezbejka	مثلية	Nan
leže	الأكاذيب	Nan
leži	الأكاذيب	Nan
ležišta	رمان	Nan
li	لي	None
liberalna	ليبرالية	None
lica	الوجوه	Nan
lice	وجه	None
leđa	عودة	None
livnu	دش	Nan
liječenje	علاج او معاملة	Nan
lik	حرف	None
lista	قائمة	None
liste	القوائم	None
listi	القوائم	None
listopadne	اكتوبر	Nan
listova	ملاءات	Nan
listove	ملاءات	Nan
listovi	اوراق اشجار	Nan
listovima	اوراق اشجار	Nan
listu	قائمة	None
literatura	المؤلفات	None
literature	المؤلفات	None
literaturi	المؤلفات	None
litvanija	ليتوانيا	Nan
livanjskog	ليفنجسكوج	Nan
livna	المصبوب	Nan
list	قائمة	None
lirika	كلمات الاغنية	Nan
linux	لينكس	Nan
linkovi	الروابط	None
lika	حرف	None
like	مثل	None
liker	ليكيور	Nan
likom	حرف	None
likova	الشخصيات	None
likovi	الشخصيات	None
likovna	غرامة	Nan
liječenju	علاج او معاملة	Nan
limfa	اللمف	Nan
lingvistika	اللغويات	Nan
linija	خط	None
linijama	خطوط	None
linije	خطوط	None
liniji	خط	None
linijom	خط	None
liniju	خط	None
linearno	خطي	Nan
loze	الكروم	Nan
loša	سيئة	None
loše	سيئة	None
marke	العلامات التجارية	Nan
marketing	تسويق	Nan
marki	العلامات التجارية	Nan
marko	ماركو	Nan
marković	ماركوفيتش	Nan
marks	علامات	None
maroka	المغرب	None
maroko	المغرب	None
maroku	المغرب	None
mars	مارس	None
marshall	مارشال	Nan
marsu	كوكب المريخ	Nan
mart	مارس	None
marta	مارس	None
martin	مارتن	None
markama	علامات	None
marka	العلامة التجارية	Nan
mark	علامة	None
mario	ماريو	Nan
manjinu	أقلية	None
manjoj	الأصغر	None
manju	أقل	None
mao	ماو	Nan
mapa	خريطة	None
maraka	طوابع بريدية	Nan
maria	ماريا	None
martu	مارس	None
marie	ماري	None
marije	مريم	None
mariji	ماريجي	Nan
marijin	الحشيش	None
marijom	مريم	None
mariju	الحشيش	None
mariner	بحار	Nan
marino	مارينو	Nan
marija	المريجة	Nan
manjine	الأقليات	None
marx	ماركس	None
maršala	مارشال	Nan
materija	شيء	None
materijal	مواد	None
materijala	مواد	None
materijale	المواد	None
materijali	المواد	None
materijalna	مواد	None
materijalne	مواد	None
materijalni	مواد	None
materijalnih	مواد	None
materijalnu	مواد	None
materijalom	مواد	None
materije	شيء	None
maternji	الأمهات	Nan
matica	البندق	Nan
matija	ماتيجا	Nan
materice	الرحم	None
materica	الرحم	None
matematički	رياضيا	Nan
matematičar	رياضياتي	Nan
masa	كتلة	None
masakr	مذبحة	Nan
masakra	مذبحة	Nan
mase	كتلة	None
masleša	زبدة	Nan
masovna	كتلة	None
masovne	كتلة	None
mary	ماري	None
masovnih	كتلة	None
masti	سمين	Nan
masu	كتلة	None
mata	ماتا	Nan
mate	زميل	Nan
matematici	الرياضيات	None
matematika	الرياضيات	None
matematike	الرياضيات	None
masovno	بشكل جماعي	Nan
manjina	أقلية	None
manjim	الأصغر	None
manjih	الأصغر	None
m	م	Nan
ma	أماه	Nan
maajka	أم	None
mac	ماك	Nan
mada	على أية حال	Nan
mafija	المافيا	Nan
maglaj	ضباب	Nan
magnetna	مغناطيسي	None
magnezijum	المغنيسيوم	Nan
magnezijuma	المغنيسيوم	Nan
mahala	المحلة	None
mahmud	محمود	None
mahom	خاصة	None
maj	مايو	None
maja	مايو	None
luči	أضواء	Nan
lučenje	إفراز	None
luče	أضواء	Nan
luxembourg	لوكسمبورج	Nan
lošeg	سيئة	None
lp	ليرة لبنانية	Nan
luci	لوسي	Nan
luj	لوج	Nan
luja	لوجا	Nan
luk	بصلة	Nan
luka	ميناء	None
majevice	majevice	Nan
lukavac	ماكرة	Nan
luksemburg	لوكسمبورج	Nan
luksemburga	لوكسمبورج	Nan
luksemburgu	لوكسمبورج	Nan
luksemburški	اللوكسمبرجية	Nan
luku	بصلة	Nan
luminiscencija	التلألؤ	Nan
lutecijum	اللوتيتيوم	Nan
luke	الموانئ	None
majka	أم	None
majke	أمهات	Nan
majko	أم	None
malo	قليل	None
malog	صغير	None
maloj	صغير	None
malom	صغير	None
malu	صغير	None
man	رجل	None
manastir	ديرصومعة	Nan
malim	صغير	None
manastiru	ديرصومعة	Nan
mangan	المنغنيز	Nan
manhattan	مانهاتن	Nan
manifestacija	تجلي	Nan
manifestacije	المظاهر	Nan
manja	الأصغر	None
manje	أقل	None
manji	الأصغر	None
mandat	امر رسمى	Nan
legionari	الفيلق	Nan
malih	صغير	None
mali	صغير	None
majkom	أم	None
major	رائد	None
majstori	سادة	Nan
maju	مايو	None
mak	ماك	Nan
makedonci	المقدونيون	Nan
makedonija	مقدونيا	None
maligni	خبيث	Nan
makedonije	مقدونيا	None
makedonski	المقدونية	Nan
makroekonomija	الاقتصاد الكلي	Nan
makromolekula	جزيء ضخم	Nan
maksimalno	أقصى	None
maksimum	أقصى	None
mala	صغير	None
male	قليل	None
makedoniji	مقدونيا	None
legionara	الفيلق	Nan
legio	الفيلق	Nan
legiji	الفيلق	Nan
koš	سلة	Nan
koša	سلة	Nan
košarci	كرة سلة	Nan
košarka	كرة سلة	Nan
košarkaš	لاعب كرة سلة	Nan
košarkaška	كرة سلة	Nan
košarkaški	كرة سلة	Nan
košarke	كرة سلة	Nan
košarku	كرة سلة	Nan
koševo	سلة	Nan
košu	سلة	Nan
koža	جلد	None
kože	الماعز	Nan
koјi	الذي	None
kraj	النهاية	None
kočić	ربط	None
kozara	كوزارا	Nan
koza	ماعز	Nan
kovačević	كوفاسيفيتش	Nan
korpusa	سلاح	None
kosa	شعر	None
kosača	جزازة	Nan
kose	الشعر	None
kosinus	جيب التمام	Nan
kosova	كوسوفو	Nan
kosovo	كوسوفو	Nan
kraja	النهاية	None
kosovu	كوسوفو	Nan
kosti	عظام	None
kostiju	عظام	None
kostur	هيكل عظمي	Nan
kotline	أحواض	Nan
kotromanić	kotromanić	Nan
kotromanića	kotromanića	Nan
kovač	حداد	Nan
kost	عظم	None
korpus	جسم	None
krajem	فى النهاية	Nan
krajeve	ينتهي	None
kraljevstvo	مملكة	None
kraljevstvu	مملكة	None
kraljica	الملكة	None
kraljice	الملكة	None
kraljicom	الملكة	None
kraljicu	الملكة	None
kralju	إلى الملك	Nan
kratak	قصيرة	None
kratka	قصيرة	None
kratke	قصيرة	None
kratki	قصيرة	None
kratkim	قصيرة	None
kratko	قصيرة	None
kratkog	قصيرة	None
kratkom	قصيرة	None
kraljevstva	مملكة	None
kraljevske	ملكي	None
kraljevska	ملكي	None
kraljevića	أمير	None
krajevi	ينتهي	None
krajevima	ينتهي	None
krajina	المناظر الطبيعيه	Nan
krajine	المناظر الطبيعيه	Nan
krajini	المناظر الطبيعيه	Nan
krajnjem	نهائي	None
krajnji	نهائي	None
krajeva	ينتهي	None
kraju	فى النهاية	Nan
kralja	الملك	None
kraljem	الملك	None
kraljeva	ملوك	None
kraljevi	ملوك	None
kraljevina	مملكة	None
kraljevine	الممالك	None
kraljević	أمير	None
kralj	الملك	None
korozije	تآكل	Nan
korozija	تآكل	Nan
korona	تاج	None
kontekstu	سياق الكلام	Nan
kontinenata	القارات	None
kontinent	القارة	None
kontinenta	القارة	None
kontinentalna	قاري	Nan
kontinentalne	قاري	Nan
kontinentu	القارة	None
kontinuitet	استمرارية	Nan
kontrast	التباين	Nan
kontrola	مراقبة	None
kontrole	مراقبة	None
kontroliše	ضوابط	Nan
kontrolom	مراقبة	None
kontrolu	مراقبة	None
konvekcija	الحمل الحراري	Nan
kontaktu	اتصل	Nan
kontakt	اتصل	Nan
konstrukcije	اعمال البناء	Nan
konstantno	باستمرار	None
koncerte	حفلات	Nan
koncerti	حفلات	Nan
koncertima	حفلات	Nan
koncertu	حفلة موسيقية	Nan
konferenciji	مؤتمر	None
kongres	الكونغرس	None
kongresa	الكونغرس	None
konvergencija	التقارب	Nan
kongresu	الكونغرس	None
konja	حصان	Nan
konji	خيل	Nan
konjic	سلاح الفرسان	Nan
konjica	سلاح الفرسان	Nan
konstanta	ثابت	Nan
konstante	الثوابت	Nan
konstantin	قسنطينة	Nan
konj	حصان	Nan
konvergira	يتلاقى	Nan
konzul	قنصل	Nan
kopito	حافر	Nan
koristi	الاستخدامات	None
koristila	مستخدم	None
koristile	مستخدم	None
koristili	مستخدم	None
koristimo	نحن نستخدم	Nan
koristio	مستخدم	None
koristiti	ليستخدم	Nan
koristeći	باستخدام	None
korišten	مستخدم	None
korišteni	مستخدم	None
korištenja	استعمال	None
korištenje	الاستخدام	None
korištenjem	باستخدام	None
korištenju	استعمال	None
kornjača	سلحفاة	Nan
kornjače	السلاحف	Nan
korištena	مستخدم	None
krava	بقرة	Nan
koriste	استعمال	None
korisniku	للمستخدم	Nan
koplja	الرماح	Nan
kopna	أرض	None
kopnene	أرض	None
kopnu	أرض	None
kora	لحاء الشجر	Nan
koraci	خطوات	Nan
korak	خطوة	None
korist	فائدة	None
koreja	كوريا	None
koridora	الرواق	Nan
korijen	جذر	Nan
korijene	الجذور	None
korisnici	المستخدمين	None
korisnicima	المستخدمين	None
korisnik	المستعمل	Nan
korisnika	المستخدمين	None
koridor	الرواق	Nan
matične	الأبوين	Nan
kraće	أقصر	None
krenuli	انطلقت	None
kuvajt	الكويت	None
kuća	منزل	None
kućama	منازل	None
kućanice	ربات البيوت	Nan
kuće	منازل	None
kući	الصفحة الرئيسية	Nan
kućni	الصفحة الرئيسية	Nan
kuću	منزل	None
kvadrata	مربعات	Nan
kvadratni	ميدان	None
kvalifikacijama	مؤهلات	Nan
kvalifikovana	تأهلت	Nan
kvalitet	جودة	None
kvaliteta	جودة	None
kvalitetu	جودة	None
kuter	قطع	None
kusturica	كوستوريكا	Nan
kustos	أمينة	Nan
kurtović	كورتوفيتش	Nan
kulturnim	ثقافي	None
kulturno	ثقافيا	Nan
kulturnog	ثقافي	None
kulturnoj	ثقافي	None
kulturnu	ثقافي	None
kulturom	حضاره	Nan
kulturu	حضاره	Nan
kvantne	الكم	None
kup	كوب	Nan
kupe	كوبيه	Nan
kupres	كوبرس	Nan
kupu	حفنة	Nan
kuran	القرآن	None
kurana	القرآن	None
kuranu	القرآن	None
kurban	تضحية	Nan
kupa	كوب	Nan
kulturnih	ثقافي	None
kćer	ابنة	None
kćerka	ابنة	None
latinski	لاتيني	Nan
latinsko	لاتيني	Nan
latinskog	لاتيني	Nan
latinskom	لاتيني	Nan
latvija	لاتفيا	Nan
lav	لاف	Nan
lazar	لازار	Nan
lcd	شاشات الكريستال السائل	Nan
le	لو	None
led	جليد	Nan
legenda	عنوان تفسيري	Nan
legende	الأساطير	None
legendi	الأساطير	None
legija	الفيلق	Nan
legije	جحافل	Nan
latinske	لاتيني	Nan
latinska	لاتيني	Nan
latinica	لاتيني	Nan
latin	اللاتينية	None
kćerke	بنات	None
kćerku	ابنة	None
l	ل	None
la	لا	None
lagano	سهل	None
laguna	البحيرة	None
lahko	يستطيع	None
kćeri	ابنة	None
lako	سهل	None
lakše	أسهل	Nan
lan	لان	None
lanac	سلسلة	None
lanci	السلاسل	None
langer	لانغر	Nan
larve	اليرقات	Nan
lat	خط العرض	Nan
laktoza	اللاكتوز	Nan
kulturni	ثقافي	None
kulturne	ثقافي	None
kulturna	ثقافي	None
kritičari	النقاد	None
kriza	أزمة	None
krize	أزمة	None
križa	تعبر	None
krleža	القراد	Nan
krležin	krležin	Nan
krompir	البطاطس	Nan
kroz	عبر	None
krpelj	القراد	Nan
krstaški	صليبي	Nan
krug	دائرة	None
kruga	دائرة	None
krugova	الدوائر	None
krugovi	الدوائر	None
krugovima	الدوائر	None
kritičara	النقاد	None
kritike	نقد	None
kritika	نقد	None
kristina	كريستينا	Nan
krenuo	انطلقت	None
kreont	كريون	Nan
kreta	جزيرة كريت	Nan
kretanja	الحركات	None
kretanje	حركة	None
kretanju	حركة	None
kreće	متحرك	Nan
krugu	دائرة	None
kreću	إنهم يتحركون	Nan
krila	أجنحة	None
krilo	جناح	None
kripton	الكريبتون	Nan
krist	كريست	Nan
krista	كريستا	Nan
kristala	بلورات	Nan
kristalni	بلوري	Nan
kreševo	kreševo	Nan
kruna	تاج	None
krune	تاج	None
krunidbe	تتويج	Nan
kršćanstva	النصرانية	Nan
kršćanstvo	النصرانية	Nan
kud	أين	None
kugle	كرات	None
kukuruz	حبوب ذرة	Nan
kula	برج	None
kule	أبراج	Nan
kršćanskih	مسيحي	Nan
kulenović	كولينوفيتش	Nan
kulina	كولينا	Nan
kulon	قلادة	Nan
kult	طائفة دينية	Nan
kultura	حضاره	Nan
kulturama	الثقافات	None
kulture	حضاره	Nan
kulturi	حضاره	Nan
kulin	كولين	Nan
krenula	بدأت	None
kršćanski	مسيحي	Nan
kršćanska	مسيحي	Nan
krunu	تاج	None
krupa	جريش	Nan
krupe	جريش	Nan
krupi	جريش	Nan
krutost	الكزازة	Nan
krv	دم	None
krvarenja	نزيف	Nan
kršćanske	مسيحي	Nan
krvarenje	نزيف	Nan
krvlju	دم	None
krvne	دم	None
krvni	دم	None
krvnih	دم	None
krvotok	تدفق الدم	Nan
krzno	الفراء	Nan
kršćani	المسيحيين	None
krvi	دم	None
је	يكون	None
