$	$	Nan
meirion	iṣọkan	Nan
meirw	òkú	None
meistr	ọga	Nan
meistrir	ọga	Nan
mekong	mekong	Nan
melan	melan	Nan
melanesia	melanesia	Nan
melanitta	melanitta	Nan
melanocorypha	melanocorypha	Nan
melayu	melayu	Nan
melbourne	ile iṣu	Nan
meles	meles	Nan
mellt	monomono	Nan
melyn	odo	Nan
melys	adun	Nan
meirch	ẹṣin	Nan
men	okunrin	None
meinweoedd	awọn asọ	Nan
meintiau	awọn titobi	Nan
meddylfryd	opolo	Nan
meddyliol	ọpọlọ	Nan
medi	oṣu kẹsan	Nan
media	media	Nan
medium	alabọde	Nan
medr	mita	Nan
medru	ni anfani lati	Nan
medrus	ti oye	Nan
megis	eleyi	None
mehefin	karun	None
mehmed	mehmed	Nan
meibion	ọmọ	None
meic	eg	Nan
meicrosgôp	ohun eegun	Nan
meini	okuta	Nan
meinwe	àsopọ	Nan
menai	menai	Nan
mendel	mendel	Nan
mendeleev	mendeleev	Nan
metal	irin	Nan
metalau	awọn irin	Nan
metamorffig	metamorphic	Nan
metel	irin	Nan
metelau	awọn irin	Nan
metelig	ti fadaka	Nan
meteoroleg	meteorology	Nan
methan	gaasi	Nan
methodd	o kuna	Nan
methu	kuna	Nan
metr	awọn mita	Nan
metrig	metiriki	Nan
mewn	ninu	Nan
mewnforio	gbewọle	Nan
mewnfudiad	iṣilọ	Nan
metabolig	ase ijẹ-ara	Nan
mesurir	ti diwọn	Nan
mesurau	awọn igbese	Nan
mesur	ìwọn	Nan
menevia	menevia	Nan
menna	mánà	Nan
menter	kekeke	Nan
menywod	obinrin	Nan
merch	omobinrin	Nan
merched	obinrin	Nan
mercher	ọjọru	Nan
meddygon	onisegun	Nan
merci	iṣọkan	Nan
meredith	meredith	Nan
merfyn	to	None
merganser	merganser	Nan
merlyn	poni	Nan
mers	kẹta	None
merthyr	ajé	Nan
mesopotamia	mesopotamia	Nan
mercia	mercia	Nan
meddygol	egbogi	Nan
meddyginiaeth	òògùn	Nan
meddygaeth	òògùn	Nan
mastiau	masts	Nan
maswedd	ipakupa	Nan
maswr	flywheel	Nan
mater	ọrọ	Nan
material	ohun elo	Nan
materion	awọn ọran	Nan
materol	ohun elo	Nan
math	o dara	Nan
mathafarn	eko	None
mathau	awọn oriṣi	Nan
mathemateg	eko	None
mathemategol	iṣiro	Nan
mathemategydd	oniṣiro-ọrọ	Nan
mathew	mathew	Nan
mathias	mathias	Nan
massif	ifọwọra	Nan
massachusetts	awọn ọgangan	Nan
masood	masood	Nan
masnachwyr	àwọn oníṣòwò	Nan
mars	ọkunrin	Nan
marseille	marshal	Nan
marsh	mars	None
marshall	marshall	Nan
martes	ogun	None
martin	martin	Nan
marw	kú	Nan
mathonwy	o dara	Nan
marwnad	agbada	Nan
marwolaethau	iku	None
mary	mary	Nan
mas	ti o ba ti	Nan
masjid	masjid	Nan
masnach	isowo	Nan
masnachol	ti iṣowo	Nan
masnachu	iṣowo	Nan
marwolaeth	iku	None
mewnfudo	iṣilọ	Nan
matt	matiresi	Nan
matthew	matthew	Nan
mecca	mekka	Nan
mecsico	meksiko	None
medal	medal	Nan
meddal	rirọ	Nan
meddalwedd	sọfitiwia	Nan
meddiannau	ohun-ini	Nan
meddiannodd	o si tẹdo	Nan
meddiannu	ohun-ini	Nan
meddiannwyd	ti tẹdo	Nan
meddiant	ohun-ini	Nan
meddianu	gbalaye	Nan
meddianwyd	ti tẹdo	Nan
meddu	gba	None
meddwl	lerongba	Nan
meddyg	dokita	Nan
mecanyddol	darí	Nan
mecanwaith	siseto	Nan
mecaneiddio	ẹrọ	Nan
mecaneg	awọn oye	Nan
maurice	maurice	Nan
mauricius	mauricius	Nan
mauritania	mauritania	Nan
mauritius	mauritius	Nan
mawr	nla	Nan
mawrion	nla	Nan
mawrth	kẹta	None
matterhorn	pataki	Nan
max	max	None
maximus	maximus	Nan
may	le	None
mccartney	mccartney	Nan
md	md	Nan
me	eg	Nan
means	ọna	Nan
mebyon	mebyon	Nan
maximinus	maximinus	Nan
marn	ero	Nan
mewnfudwyr	aṣikiri	Nan
mewnol	ti abẹnu	Nan
moleciwl	molikula	Nan
moleciwlaidd	molikula	Nan
moleciwlau	molikula	Nan
moment	akoko	Nan
mona	kan	None
monaco	monaco	Nan
monde	monde	Nan
mongolia	mongolia	Nan
mongoliaid	ara ilu mongolia	Nan
monica	monica	Nan
mons	mons	Nan
mont	mont	Nan
montana	montana	Nan
monte	monte	Nan
montenegro	montenegro	Nan
moldofa	moldofa	Nan
moonwalk	oṣupa	Nan
mohamed	mohamed	Nan
moesol	iwa	Nan
modern	igbalode	Nan
modfedd	iná	Nan
modification	iyipada	Nan
modifications	awọn iyipada	Nan
modify	yipada	None
modron	onina	Nan
modrwy	òrùka	Nan
modrwyau	oruka	Nan
modur	moto	Nan
moel	apari	Nan
moelfre	moelfre	Nan
moelona	moelona	Nan
moelwyn	apari	Nan
moelydd	moolu	Nan
moeseg	iwa	Nan
moesoldeb	iwa	Nan
mor	mor	Nan
more	diẹ sii	Nan
morffoleg	mofoloji	Nan
mosg	mọṣalaṣi	Nan
most	julọ	Nan
motacilla	motacilla	Nan
motown	òtútú	Nan
mount	òkè	Nan
mountain	òkè	Nan
mountains	awọn oke-nla	Nan
mozambique	mozambique	None
mozart	mozart	Nan
mozilla	mozilla	None
moçambique	moçambique	Nan
mpla	mpla	Nan
mr	mr	Nan
mrasil	ilu brazil	Nan
mrna	mrna	Nan
moses	moses	Nan
moscow	mọṣalaṣi	Nan
moscfa	mọṣalaṣi	Nan
mosambic	ẹfọn	Nan
morfil	ẹja	Nan
morgan	morgan	None
morgannwg	glamourgan	Nan
morgrugyn	kokoro	Nan
morocco	morocco	Nan
moroco	morocco	Nan
moroedd	òkun	Nan
modelau	awọn awoṣe	Nan
morol	omi	None
mortimer	apanirun	Nan
morton	amọ	Nan
morvan	morvan	Nan
morwennol	agbẹbi	Nan
morwenoliaid	terns	Nan
morwrol	omi	None
morwyr	atukọ̀	Nan
morris	morris	Nan
model	awoṣe	Nan
moddion	òògùn	Nan
modd	ona	Nan
michel	michel	Nan
michelangelo	michelangelo	Nan
microbau	awọn microbes	Nan
microorganebau	awọn alamọmọ	Nan
microsoft	microsoft	Nan
miguel	miguel	Nan
mihangel	mikaeli	Nan
mike	ji	Nan
mikhail	mikhail	Nan
mil	oyin	Nan
milan	malan	Nan
milano	milano	Nan
miles	maili	Nan
miley	maili	Nan
milfeddyg	vet	Nan
michael	olorin	Nan
mi	emi	Nan
mhrydain	gẹẹsi	Nan
mhriodweddaur	awọn ohun-ini	Nan
mewnwladol	t’ile	Nan
mewnwr	idaji	None
mexico	mexico	None
mey	mey	Nan
meysydd	awọn aaye	Nan
mhalesteina	palestine	Nan
mharc	samisi	Nan
miliwn	million	Nan
mharis	maris	Nan
mhedair	olè	Nan
mhencampwriaeth	aṣaju	Nan
mhencampwriaethau	awọn aṣaju-ija	Nan
mhentref	abule	Nan
mhob	gbogbo	Nan
mhortiwgal	ilu pọtugali	Nan
mhrifysgol	yunifasiti	Nan
mhatagonia	patagonia	Nan
mewnlifiad	ṣiṣan	Nan
miliwnyddion	millionaires	Nan
milland	milland	Nan
mississippi	mississippi	Nan
mit	mit	Nan
mitchell	mitchell	Nan
mitocondria	mitochondria	Nan
mk	mk	Nan
mlaenau	siwaju	Nan
mlwydd	ọdun	Nan
mlynedd	ọdun	Nan
mlynyddoedd	ọdun	Nan
mm	mm	Nan
mo	temi	Nan
mob	agbajo eniyan	Nan
moca	moca	Nan
moch	elede	None
mochyn	ẹlẹdẹ	Nan
miss	padanu	Nan
misoedd	awọn oṣu	Nan
mis	kan	None
mirror	digi	Nan
miller	miller	Nan
milltir	maili	Nan
miloedd	ẹgbẹẹgbẹrun	Nan
milvius	milvius	Nan
milwr	jagunjagun	Nan
milwrol	ologun	Nan
milwyr	jagunjagun	Nan
miliynau	miliọnu	Nan
mimosa	mimosa	Nan
minaret	minaret	Nan
mindanao	mindanao	Nan
ministerio	minisita	Nan
minor	kekere	None
minora	minora	Nan
minutus	iṣeju	Nan
miriam	miriam	Nan
min	min	Nan
mrwsel	biroseli	Nan
marmota	marmota	Nan
marmara	okuta didan	Nan
llysiau	ẹfọ	Nan
llysoedd	kootu	Nan
llythrennau	awọn lẹta	Nan
llythrennedd	imọwe	Nan
llythrennol	itumọ ọrọ gangan	Nan
llythyr	leta	Nan
llythyren	leta	Nan
llythyron	awọn lẹta	Nan
llyw	iriju	Nan
llywelyn	llywelyn	Nan
llywodraeth	ijọba	Nan
llywodraethau	awọn ijọba	Nan
llywodraethol	ti ijọba	Nan
llywodraethu	ijoba	Nan
llywodraethwr	gomina	None
llysenw	inagije	Nan
llywydd	adari	Nan
llys	kootu	Nan
llynnoedd	adagun-odo	Nan
llyfr	iwe	Nan
llyfrau	awọn iwe	Nan
llyfraur	igbọnsẹ	Nan
llyfrgell	ile ikawe	Nan
llyfrgelloedd	awọn ile ikawe	Nan
llyfrgellyddiaeth	ile ikawe	Nan
llyfryddiaeth	iwe itan	Nan
llygad	oju	Nan
llygaid	oju	Nan
llygoden	asin	Nan
llygredd	ibajẹ	Nan
llym	muna	Nan
llyn	adagun	Nan
llyncu	enibo	Nan
llynges	ogun	None
llyr	gbooro	Nan
llên	litireso	Nan
llŷn	llŷn	Nan
llŷr	oyimbo	Nan
lost	sọnu	Nan
lot	pupo	Nan
louis	louis	Nan
louvre	louvre	None
love	ni ife	Nan
lowry	onírẹlẹ	Nan
loxia	loxia	Nan
loxodonta	loxodonta	Nan
ltd	ltd	Nan
lu	lu	Nan
luc	luc	Nan
lucas	lucas	Nan
lucia	lucia	Nan
luciano	luciano	Nan
lucius	lucius	Nan
losgi	sisun	Nan
losgfynyddoedd	onina	Nan
los	los	Nan
lord	oluwa	Nan
lo	lo	Nan
location	ipo	None
loch	adagun	Nan
loegr	england	Nan
loeren	satẹlaiti	Nan
loerennau	awọn satẹlaiti	Nan
lofruddio	paniyan	Nan
llydewig	rustic	Nan
log	wọle	Nan
londinium	londinium	Nan
london	london	Nan
lonely	dawa	Nan
long	ọkọ oju-omi	Nan
longau	omi	None
longtailed	gigun	Nan
looks	woni	Nan
lolfa	rọgbọkú	Nan
llydaweg	bretoni	Nan
llydaw	arabinrin brittany	Nan
llydandroed	ẹsẹ	None
lliwiau	awọn awọ	Nan
lloches	ibi aabo	Nan
lloegr	england	Nan
lloeren	satẹlaiti	Nan
lloerennau	awọn satẹlaiti	Nan
llofruddiwyd	ti paniyan	Nan
llon	ọyaya	Nan
llong	ọkọ oju-omi	Nan
llongau	omi	None
llorweddol	nitosi	None
llosg	inu ọkan	Nan
llosgfynydd	onina	Nan
llosgfynyddoedd	onina	Nan
llosgi	sisun	Nan
llosgir	jo	None
lliwgar	awọ	Nan
lliwedd	awọ	Nan
lliw	awọ	Nan
llithro	isokuso	Nan
llewellyn	llewellyn	Nan
llewelyn	llewelyn	Nan
llewod	awọn kiniun	Nan
llewyrchus	ọlọrọ	Nan
llid	igbona	Nan
llif	ṣiṣan	Nan
llifo	ṣiṣan	Nan
llosgnwy	sisun	Nan
llifogydd	omi	None
llinell	laini	Nan
llinellau	awọn ila	Nan
llinos	flax	Nan
llinyn	okun	Nan
llinynnau	okun	Nan
llinynnol	okun	Nan
llipa	atẹlẹsẹ	Nan
llinach	oba	None
ludwig	ludwig	Nan
llosgwyd	sisun	Nan
llu	ipa	Nan
llwyddo	ṣaṣeyọri	Nan
llwyddodd	o ṣaṣeyọri	Nan
llwyddwyd	a ṣaṣeyọri	Nan
llwyfan	ipele	None
llwyfandir	pẹtẹlẹ	Nan
llwyni	igbo	Nan
llwynog	kọlọkọ	Nan
llwyr	patapata	Nan
llwyth	ẹru	Nan
llwythau	ẹya	Nan
llwythi	èyà	Nan
llychlyn	sikandina	Nan
llychlynaidd	ijẹjẹnujẹ	Nan
llychlynwyr	viking	Nan
llydan	gbooro	Nan
llwyddianus	aṣeyọri	Nan
llwyddiant	aṣeyọri	Nan
llwyddiannus	aṣeyọri	Nan
llwyddiannau	awọn aṣeyọri	Nan
lludd	rirẹ	Nan
lludw	eeru	Nan
llun	aworan	Nan
llundain	lọndọnu	None
lluniau	awọn aworan	Nan
llunio	kojọpọ	Nan
lluoedd	awọn ipa	Nan
lloyd	ọmọ	None
lluosog	lọpọlọpọ	Nan
llus	eso beri dudu	Nan
llw	ibura	Nan
llwch	eruku	Nan
llwy	sibi	Nan
llwybr	ọnà	Nan
llwybrau	awọn ọna	Nan
llwyd	grẹy	Nan
lluosogaeth	opo	Nan
marmot	ogun	None
luis	luis	Nan
lundain	lọndọnu	None
malus	malus	Nan
malwr	pẹkipẹki	Nan
mam	iya	Nan
mamal	mamma	Nan
mamaliaid	osin	Nan
mamau	àwọn ìyá	Nan
mamiaith	ìyá	Nan
mamwlad	ile-ile	Nan
mamwledydd	awọn orilẹ-ede ile	Nan
man	ọkunrin	Nan
manaw	manly	Nan
manaweg	manx	Nan
manawydan	ìpolongo	None
manceinion	manceinion	Nan
mandad	ase	Nan
maluku	maluku	Nan
mandarin	mandarin	Nan
malu	lilọ	Nan
maldives	aṣebiakọ	Nan
magu	atunwe	Nan
magyar	magyar	Nan
mahatma	mahatma	None
mahler	alumọni	Nan
mai	mai	Nan
main	tẹẹrẹ	Nan
maint	iwọn	Nan
mair	mairi	Nan
maith	o dara	Nan
majora	majora	Nan
make	ṣe	Nan
makes	ṣe	Nan
malaya	malaya	Nan
malaysia	malaysia	None
malcolm	ibi	Nan
mali	mali	None
mandela	mandela	Nan
mandelan	mandelan	Nan
mang	mang	Nan
marcsiaeth	maaki	Nan
marcus	ayase	Nan
maredudd	dariji	Nan
margaret	ẹla	Nan
marged	ọjà	Nan
mari	mari	Nan
maria	arabinrin	Nan
marie	ọkọ	Nan
mariner	omi	None
marino	igbafẹfẹ	Nan
marion	marion	Nan
marius	aya	None
mark	samisi	Nan
markup	isamisi	Nan
marlon	ọgagun	Nan
marco	ọkọ ofurufu	Nan
marchnata	titaja	Nan
marchnad	ọjà	Nan
march	irin-ajo	Nan
mangor	mangor	Nan
manhattan	manhattan	Nan
manic	manic	Nan
mann	mánà	Nan
mannau	àwọn ibò	Nan
mantais	anfani	Nan
manteisgar	anfani	Nan
magnolia	magnolia	Nan
mantell	aṣọ	Nan
manuel	manuel	Nan
manwl	alaye	Nan
manylion	awọn alaye	Nan
mao	mao	Nan
map	maapu	None
mapiau	maapu	None
marathon	ere-ije	Nan
manuals	awọn iwe afọwọkọ	Nan
magnetig	oofa	Nan
magma	magma	Nan
magic	idan	Nan
lydaw	arabinrin brittany	Nan
lydaweg	bretoni	Nan
lyfr	iwe	Nan
lyfrau	awọn iwe	Nan
lymff	omi-olodi	Nan
lyn	adagun	Nan
lynges	ogun	None
lynnoedd	adagun-odo	Nan
lyon	lyon	Nan
lys	kootu	Nan
lysgenhadon	ikọla	Nan
lythyr	leta	Nan
lythyren	leta	Nan
lywelyn	llywelyn	Nan
lywodraeth	ijọba	Nan
lwythau	ẹya	Nan
lwyth	consignment	Nan
lwyr	patapata	Nan
lwyfan	ipele	None
luniau	awọn aworan	Nan
lunio	agbekalẹ	Nan
luoedd	awọn ipa	Nan
luosog	lọpọlọpọ	Nan
lupus	lupus	Nan
luther	luther	None
luzon	luzon	Nan
lywodraethol	ẹgbẹ iṣakoso	Nan
lwch	eruku	Nan
lwtetiwm	lutetium	Nan
lwybr	ọnà	Nan
lwybrau	awọn ipa ọna	Nan
lwyd	grẹy	Nan
lwyddiannus	aṣeyọri	Nan
lwyddiant	aṣeyọri	Nan
lwyddodd	o ṣaṣeyọri	Nan
lwcsembwrg	luxembourg	Nan
luna	luna	Nan
lywodraethu	ijoba	Nan
lôn	ọna tooro	Nan
mad	aṣiwere	Nan
madagascar	madagascar	Nan
made	ṣe	Nan
madeira	ṣeira	Nan
madog	madog	Nan
madrid	isinwin	Nan
madryn	aṣiwere	Nan
mae	o wa	Nan
maen	okuta	Nan
maent	wọn	None
maer	arabinrin	Nan
maes	pápá	Nan
maesdrefi	ìgberiko	Nan
maeth	ounjẹ	Nan
maghreb	amọ	Nan
macsen	macsen	Nan
macrinus	macrinus	Nan
machynlleth	machynlleth	Nan
machlud	oorun	Nan
m	m	Nan
ma	ti o ba ti	Nan
maastricht	maastricht	Nan
mab	ọmọ	None
mabinogi	macinogi	Nan
mabon	oparun	Nan
mabwysiadu	isọdọmọ	Nan
lân	mọ	Nan
mabwysiadur	adari	Nan
mac	ọmọ	None
macau	macau	Nan
macdonald	macdonald	Nan
macedon	makedoni	Nan
macedoneg	makedoniki	Nan
macedonia	macedonia	Nan
machen	amọ	Nan
mabwysiadwyd	gba	None
llew	kiniun	Nan
mrwydr	ogun	None
mtv	mtv	Nan
olwyn	kẹkẹ	Nan
olygfa	ibi isẹlẹ	Nan
olygu	satunkọ	Nan
olygydd	olootu	Nan
olympaidd	olimpiiki	Nan
olympiad	olimiad	Nan
olynol	aṣeyọri	Nan
olynu	aṣeyọri	Nan
olynwyd	ṣaṣeyọri	Nan
olynwyr	arọpo	Nan
olynydd	agbapo	Nan
oman	ogun	None
omeara	omeara	Nan
omega	omega	Nan
on	loju	Nan
olwg	iriran	Nan
ond	ṣugbọn	Nan
olwen	olifi	Nan
oll	gbogbo	Nan
oherwydd	nitori	Nan
ohio	ohio	Nan
ohoni	ti o	Nan
ohono	ti o	Nan
ohonyn	ti o	Nan
ohonynt	wọn	None
oi	oi	Nan
ol	ol	Nan
olaf	lakotan	Nan
olau	ina	Nan
old	atijọ	Nan
olddodiad	suffix	Nan
olew	epo	Nan
olion	ku	None
oliver	ẹṣọ	Nan
olrhain	ipasẹ	Nan
one	ọkan	Nan
ongl	igun	Nan
oni	ayafi ti	Nan
orffen	pari	Nan
orffennaf	yoo	None
orfodi	agbara	None
orfodir	agbara	None
organ	eto ara eniyan	Nan
organau	awọn ara	Nan
organeb	oni-iye	Nan
organebau	oganisimu	Nan
organig	organic	Nan
orgraff	itanjẹ aranse	Nan
oriau	awọn wakati	Nan
oriel	àwòrán àwòrán	Nan
original	atilẹba	Nan
orlawn	opo eniyan	Nan
orllewin	iwọ oorun	Nan
oresgyn	bori	Nan
oren	ọsan	Nan
ordoficaidd	oluṣapẹẹrẹ	Nan
orchymyn	paṣẹ	Nan
only	nikan	Nan
onychoprion	onychoprion	Nan
opaque	akomo	Nan
opec	opec	None
opera	opera	Nan
operetta	operetta	Nan
oprah	oprah	Nan
oh	o	Nan
opsiwn	aṣayan	Nan
orange	ọsan	Nan
orau	dara julọ	Nan
orbit	orbitin	Nan
orbitol	orbital	Nan
orchfygu	ṣẹgun	Nan
orchfygwyd	ṣẹgun	Nan
orchuddio	ideri	Nan
or	tabi	None
ogystal	pelu	Nan
ogwr	ọkunrin	Nan
ogof	ihò	Nan
obama	obama	Nan
oc	oc	Nan
occidental	ohun airi	Nan
ocean	okun	Nan
oceania	òkun	Nan
oceanodroma	ẹja òkun	Nan
ochor	ẹgbẹ	Nan
ochr	ẹgbẹ	Nan
ocsigen	atẹgun	Nan
octavianus	octavianus	Nan
ocwltiwr	oṣó	Nan
odan	labẹ	Nan
oddeutu	feleto	Nan
oddi	pipa	Nan
oddiwrth	lati	Nan
obaith	ireti	Nan
oakeley	oakeley	Nan
o	o	Nan
nôl	sẹhin	Nan
number	nọmba	Nan
numenius	nọmba	Nan
nuremberg	nuremberg	Nan
nus	bayi	None
nwy	gaasi	Nan
nwyddau	ẹru	Nan
nwylo	ọwọ	Nan
oed	ori	None
nwylor	alafia	Nan
nwyrain	ila-oorun	Nan
nyddiau	àwọn ọjọ́	Nan
nyffryn	afonifoji	Nan
nythu	nọọsi	Nan
não	não	Nan
nîl	nil	Nan
nôd	iho	Nan
nwyon	ategun	Nan
orllewinol	iwọ oorun	Nan
oedd	wà	Nan
oeddynt	wọn	None
offeren	ibi	Nan
offeryn	irinse	Nan
offerynau	irinse	Nan
offerynnau	irinse	Nan
offerynnol	irinse	Nan
official	osise	Nan
ofn	bẹru	Nan
ofnadwy	ẹru	Nan
ofni	bẹru	Nan
ofyn	béèrè	Nan
ofynnodd	o beere	Nan
ogam	ogam	Nan
ogledd	ariwa	Nan
ogleddol	ariwa	Nan
ogleddorllewin	ariwa iwọ-oorun	Nan
offer	èlò	None
offeiriaid	awọn alufa	Nan
offeiriades	alufaa	Nan
offa	ẹyin	Nan
oedolion	agbalagba	Nan
oedolyn	agba	None
oedran	ori	None
oen	ọdọ aguntan	Nan
oenanthe	oenanthe	Nan
oer	tutu	Nan
oeraf	tutu julọ	Nan
oeddent	wọn	None
oeri	tutu	Nan
oesoedd	awọn ọjọ-ori	Nan
oesoffagws	esophagus	Nan
ofal	itọju	Nan
ofalus	farabalẹ	Nan
ofari	nipasẹ ọna	Nan
ofc	tic	Nan
off	pipa	Nan
oes	bẹẹni	Nan
nulyn	dublin	Nan
ormod	pupo ju	Nan
oroesodd	o ye	Nan
pasg	ajinde	Nan
pasha	pasha	Nan
pasio	gbako.leyin	Nan
pasiwyd	koja	Nan
passage	fi	None
passeriformes	awọn paati	Nan
pasteur	lẹẹmọ	Nan
patagonia	patagonia	Nan
patriarch	babalawo	Nan
patrick	patrick	Nan
patrwm	àpẹẹrẹ	Nan
patrymau	awọn apẹẹrẹ	Nan
patxi	patẹle	Nan
paul	poul	Nan
pavarotti	pavarotti	Nan
pas	iwe irinna	Nan
pawb	gbogbo eniyan	Nan
parvati	parvati	Nan
partneriaeth	ajọṣepọ	Nan
parcio	pa	Nan
parhad	tesiwaju	Nan
parhaodd	o tesiwaju	Nan
parhaol	titilai	Nan
parhau	tẹsiwaju	Nan
parhaun	tẹsiwaju	Nan
parhaus	lemọlemọfún	Nan
paris	paris	Nan
park	gbesile	Nan
parotiaid	awọn parrots	Nan
parry	parí	Nan
parryjones	parryjones	Nan
parrywilliams	parrywilliams	Nan
parth	ašẹ	Nan
parthiaid	awọn agbegbe ita	Nan
parva	parva	Nan
pawl	pawl	Nan
pdf	pdf	Nan
pe	pe	Nan
peldroed	bọọlu	Nan
pelecaniformes	awọn pelecaniformes	Nan
pelfis	pelvis	Nan
pell	jinna	Nan
pellach	siwaju	Nan
pellaf	gbooro	Nan
pellter	jinna	Nan
pen	ori	None
penbedw	biriki	Nan
pencadlys	olú	Nan
pencadlysoedd	olú	Nan
pencampwriaeth	aṣaju	Nan
pencampwyr	awọn aṣaju	Nan
pendant	asọye	Nan
penddu	agba	None
peiriant	ẹrọ	Nan
peiriannydd	ẹnjinia	Nan
peirianneg	ẹnjinia	Nan
peiriannau	ero	Nan
peach	eso pishi	Nan
pecyn	package	Nan
pedair	mẹrin	Nan
pedol	ẹṣin	Nan
pedr	pétérù	Nan
pedryn	mẹrinla	Nan
pedwar	mẹrin	Nan
parciau	ogba	Nan
pedwaredd	kẹrin	None
peel	peeli	Nan
pegwn	òpó	Nan
peidio	kii ṣe	Nan
peidiodd	dáwọ	Nan
peidiwch	ko	None
peintio	kikun	Nan
peirianeg	ẹnjinia	Nan
pedwerydd	kẹrin	None
parchedig	bọwọ	Nan
parch	ọwọ	Nan
parc	gbesile	Nan
ottomaniaid	otita	Nan
ou	ou	Nan
our	tiwa	Nan
out	jade	Nan
over	lori	Nan
owain	owain	Nan
owen	owen	Nan
owl	owiwi	Nan
oxford	oxford	Nan
p	p	Nan
pa	pa	Nan
pab	agbejade	Nan
pablo	awọn agọ	Nan
pac	idii	Nan
pacific	pacific	Nan
ottoman	otita	Nan
otto	otto	Nan
otomaniaid	ottomans	Nan
otho	otho	Nan
orsaf	ibudo	Nan
orsafoedd	awọn ibudo	Nan
orsedd	itẹ	Nan
orwedd	na gbalaja silẹ	Nan
orynys	ile larubawa	Nan
os	ti o ba ti	Nan
osaka	osaka	Nan
pacistan	pakistan	Nan
oscar	oscar	None
osman	osman	Nan
osod	fifi sori	Nan
osododd	o ṣeto	Nan
osodwyd	ṣeto	Nan
oson	osonu	Nan
ostrogothiaid	àwon eniyan	Nan
other	omiiran	Nan
osgoi	fun	None
oroesi	ye	Nan
padrig	paddock	Nan
pafiliwn	àtẹ	Nan
panamá	panamá	Nan
pandemig	àrùn	None
pantheistiaeth	pantheism	Nan
pantheistiol	pantheistic	Nan
pantheon	pantheon	Nan
panthera	panthera	Nan
pantycelyn	pantycelyn	Nan
papua	papua	Nan
papur	iwe	Nan
papurau	awọn iwe	Nan
papwa	papaya	Nan
para	para	Nan
paraguay	paraguay	Nan
paralel	pọgba	Nan
paratoi	igbaradi	Nan
panama	panama	Nan
pan	nigbawo	Nan
pam	idi	Nan
palma	paramọlẹ	Nan
paganaidd	keferi	Nan
paganiaeth	keferi	Nan
paganiaid	keferi	Nan
page	oju iwe	Nan
paill	adodo	Nan
pakistan	pakistan	Nan
palaiologos	ààfin ọba	Nan
paentio	kikun	Nan
palas	ààfin	Nan
palazzo	palazzo	Nan
paleolithig	tètè	None
paleontoleg	paleontology	Nan
palesteina	palestine	Nan
palesteinaidd	palestini	Nan
palesteiniaid	palestinians	Nan
pallass	pallass	Nan
palau	ààfin	Nan
ms	m	Nan
null	asan	Nan
nubia	nubia	Nan
natur	iseda	Nan
nature	iseda	Nan
naturiol	àbínibí	Nan
naturol	àbínibí	Nan
nauru	nauru	Nan
naw	mẹsan	Nan
nawdd	igbowo	Nan
nawddsant	olodumare	Nan
nawfed	ẹkẹsan	Nan
nawr	bayi	None
naws	iṣesi	Nan
ne	àí	Nan
neb	enikeni	Nan
neddwyrain	ila-oorun	Nan
nederlands	awọn orilẹẹde	Nan
natsïaidd	fẹẹrẹ	Nan
nefoedd	ọrun	Nan
natsïaid	ara nazi	Nan
nato	adaru	Nan
nain	agba	None
name	orukọ	Nan
namibia	namibia	None
nant	ṣiṣan	Nan
nantlle	nantlle	Nan
naoned	nae	Nan
napoleon	napoleon	Nan
nar	rárá	Nan
nasa	tirẹ	Nan
nash	nash	Nan
natal	natal	Nan
natblygiad	idagbasoke	None
nation	orílẹ-èdè	Nan
national	orilẹ-ede	Nan
nations	awọn orilẹ-ede	Nan
natsiaid	abinibi	Nan
nefyn	nefyn	Nan
neges	ifiranṣẹ	Nan
negeseuon	awọn ifiranṣẹ	Nan
nesaf	itele	Nan
net	àwọn	Nan
neu	tabi	None
neuadd	gbongan	Nan
neuchâtel	neuchâtel	Nan
neues	alẹ	Nan
neui	tabi	None
neun	tabi	None
neuquén	neuquén	Nan
neur	neur	Nan
never	rara	Nan
neverland	lailai	Nan
neville	neville	Nan
nevis	nevis	None
new	tuntun	None
nes	titi	Nan
nerthol	alagbara	Nan
nerth	okun	Nan
nerfol	aifọkanbalẹ	Nan
negesydd	ojiṣẹ	Nan
negro	negro	Nan
negyddol	odi	Nan
neidiodd	o fo	Nan
neifion	nept	Nan
neil	nil	Nan
neilltuo	gbe	None
naill	boya	Nan
neilltuol	ni pataki	Nan
nentydd	ehin	Nan
neolithig	neolithic	Nan
neopaganism	neopaganism	Nan
neorllewin	guusu	None
nepal	nepal	Nan
nepaleg	nepalese	Nan
nerfau	ara	Nan
nen	ọrun	Nan
nai	ọmọ	None
nagasaki	nagasaki	Nan
nag	ju	Nan
mwslemaidd	muslim	Nan
mwslemiaid	muslim	Nan
mwslim	muslim	Nan
mwslimiaid	muslim	Nan
mwsogl	mossi	Nan
mwy	diẹ sii	Nan
mwyaf	julọ	Nan
mwyafrif	poju	Nan
mwyalchen	ẹyẹ dudu	Nan
mwyn	irin	Nan
mwynau	ohun alumọni	Nan
mwynfeydd	maini	Nan
mwyngloddio	iwakusa	Nan
mwynhau	gbadun	Nan
mwynol	alumọni	Nan
mwnt	motte	Nan
mwmbwls	ẹṣẹ	Nan
mw	mw	Nan
mustela	mustela	Nan
mudiad	agbari	Nan
mudiadau	ajo	None
mudiant	išipopada	Nan
mudo	ijira	Nan
muhammad	muhammad	Nan
mulfrain	cormorant	Nan
mulfran	cormorant	Nan
mwynwyr	ohun alumọni	Nan
mur	mur	Nan
muriau	odi	Nan
murray	kigbe	Nan
museum	musiọmu	Nan
music	orin	Nan
musical	gaju ni	Nan
mussolini	mussolini	Nan
mustafa	mustafa	Nan
murat	murat	Nan
newid	yipada	None
my	temi	Nan
myd	agbaye	None
màs	ọpọ	Nan
más	ti o ba ti	Nan
mân	kekere	None
médica	mẹdica	Nan
méxico	méxico	Nan
mêl	oyin	Nan
môr	okun	Nan
môrhwyaden	igbinin	Nan
münchen	munich	Nan
n	n	Nan
na	rárá	Nan
nac	rárá	Nan
nad	kii ṣe	Nan
nadolig	keresimesi	Nan
nadroedd	ejo	Nan
mywyd	igbesi aye	Nan
mytholegol	itan aye atijọ	Nan
mytholeg	itan aye atijọ	Nan
mystery	ohun ijinlẹ	Nan
myfyrwyr	omo ile	Nan
mynach	araye	Nan
mynachlog	monastery	Nan
mynci	obo	Nan
mynd	lọ	Nan
mynediad	iraye si	Nan
mynegi	han	Nan
myanmar	madium	Nan
mynegodd	sọ	None
mynnu	ku	None
mynychodd	o wa	Nan
mynychu	wá	Nan
mynydd	òkè	Nan
mynyddig	olórí òkè	Nan
mynyddoedd	awọn oke-nla	Nan
mynyw	obinrin	Nan
mynnodd	o tenumo	Nan
nuevo	nuevo	Nan
newidiad	yipada	None
newidiodd	yipada	None
niwtronau	awọn ẹla ara	Nan
nixon	nixon	Nan
no	tabi	None
nobel	ọlọla	Nan
nobl	ọlọla	Nan
nod	ifọkansi	Nan
nodau	awọn akọsilẹ	Nan
nodedig	ohun akiyesi	Nan
nodi	akiyesi	Nan
nodiadau	awọn akọsilẹ	Nan
nodiant	akiyesi	Nan
nodir	o ti ṣe akiyesi	Nan
nododd	o ṣe akiyesi	Nan
nodwedd	ẹya	Nan
nodweddiadol	aṣoju	Nan
niwtral	didoju	Nan
nodweddion	awọn ẹya	Nan
niwmonia	àìsàn òtútù àyà	Nan
niwed	ipalara	Nan
nihon	kii ṣe wa	Nan
nikephoros	nikephoros	Nan
nin	ẹni	Nan
ninas	ilu	Nan
ninbych	denbigh	Nan
nino	nino	Nan
nippon	nippon	Nan
nishitokyo	nishitokyo	Nan
nitrig	oyibo	Nan
nitrogen	nitrogen	Nan
nivalis	nivalis	Nan
niwbwrch	tuntun	None
niwclear	iparun	Nan
niwclews	ẹyọ	Nan
niwcliotid	ẹyọkan	Nan
niwedd	ni ipari ti	Nan
nodweddir	ti wa ni characterized	Nan
nodwyddau	abẹrẹ	Nan
nodyn	akiyesi	Nan
nos	alẹ	Nan
noson	alẹ	Nan
noswaith	irọlẹ	Nan
noswyl	éù	Nan
not	iwon	Nan
nothing	ohunkohun	Nan
notice	akiyesi	Nan
notices	awọn akiyesi	Nan
notoc	ohun akiyesi	Nan
novello	aramada	Nan
novial	eeyan	Nan
now	bayi	None
nrk	nrk	Nan
nso	isunmọ	Nan
nsopherekgong	nsopherekgong	Nan
norwywyr	ṣọtẹ	Nan
norwyeg	nornithology	Nan
norwy	bẹni	Nan
northern	ariwa	Nan
noel	eemọ	Nan
noeth	ihoho	Nan
noethlymuniaeth	ìhoho	Nan
noethlymunwyr	aṣiri	Nan
nofel	aramada	Nan
nofelau	iwe	Nan
nofelydd	aramada	Nan
nightjar	alẹ alẹ	Nan
nofio	odo	Nan
non	kii ṣe	Nan
none	kò si	Nan
normal	deede	Nan
normanaidd	iwuwasi	Nan
normandi	iwulo	None
normaniaid	iwuwasi	Nan
north	ariwa	Nan
nokia	nokia	Nan
night	alẹ	Nan
nigeria	nigeria	Nan
niger	niger	Nan
nghanada	kánádà	None
nghanol	aarin	Nan
nghanolbarth	aarin wales	Nan
nghanolfan	aarin	Nan
nghastell	ile odi	Nan
nghefn	sẹhin	Nan
nghefnfor	okun	Nan
ngherddoriaeth	orin	Nan
nghilmeri	kilos	Nan
nghwm	afonifoji	Nan
nghwpan	ife	Nan
nghyfnod	asiko	Nan
nghymru	oyo	Nan
nghysawd	eto	Nan
nghywair	forukọsilẹ	Nan
nghalon	obi	Nan
nghaliffornia	california	Nan
nghaernarfon	caernarfon	Nan
nghaergystennin	cerebellum	Nan
newidiwyd	yipada	None
newidwyd	yipada	None
news	awọn iroyin	Nan
newton	newton	Nan
newydd	tuntun	None
newyddddyfodiaid	awọn ti o ṣẹṣẹ ṣe	Nan
newydddinas	tuntun	None
ngogledd	ariwa	Nan
newyddiaduraeth	iṣẹ irohin	Nan
newyddiadurwyr	awon oniroyin	Nan
newyddion	awọn iroyin	Nan
newyn	ìyàn	Nan
next	itele	Nan
nghaer	odi	Nan
nghaerdydd	cardiff	Nan
nghaerfyrddin	carmarthen	Nan
newyddiadurwr	akọrohin	Nan
newidiadau	awọn ayipada	Nan
ngogleddddwyrain	àríwá	Nan
ngorffennaf	ni oṣu keje	Nan
nhwrci	tọki	Nan
ni	àwa	Nan
nicaea	nicaea	Nan
nicaragua	nicaragua	Nan
nice	wuyi	Nan
nicholas	ohun inu-inu	Nan
nicholls	awọn ohun ọgbun	Nan
nicholson	orore	Nan
nick	lóyún	Nan
nickelodeon	nickelodeon	Nan
nid	kii ṣe	Nan
niederdeutsch	niederdeutsch	Nan
nifer	nọmba	Nan
niferoedd	awọn nọmba	Nan
niferus	lọpọlọpọ	Nan
nhwn	tune	Nan
nhw	wọn	None
nhrwyn	imu	Nan
nhrefn	paṣẹ	Nan
ngorllewin	iwọ oorun	Nan
ngwaelod	isalẹ	Nan
ngwaith	iṣẹ	Nan
ngwanwyn	omi	None
ngweddill	isimi na	Nan
ngweriniaeth	olominira	Nan
ngwlad	orilẹ-ede	Nan
ngogleddorllewin	ariwa iwọ-oorun	Nan
ngwledydd	awọn orilẹ-ede	Nan
ngwynedd	gwynedd	Nan
ngâl	galle	Nan
nhadau	baba	Nan
nhalaith	ipinle	Nan
nhermau	nso	None
nheyrnasiad	jọba	Nan
nhref	ilu	Nan
ngwleidyddiaeth	oselu	Nan
lleuad	osupa	Nan
lleu	lice	Nan
llethrau	àwọn òkè	Nan
hardal	agbegbe	Nan
hardd	lẹwa	Nan
harddegau	awọn ọdọ	Nan
harddwch	ẹwa	Nan
hare	ehoro	Nan
harlech	harleki	Nan
harold	harold	Nan
harpsicord	harpsichord	Nan
harri	harri	Nan
harrier	alairi	Nan
harrison	ẹwọn	Nan
harry	harry	Nan
harwain	darí	Nan
has	ní	None
hastings	awọn iyara	Nan
hard	ga	Nan
hastudio	iwadi	None
harbwr	abo	None
hanu	wá	Nan
hanes	itan	Nan
haneswyr	òpìtàn	Nan
hanesydd	akẹkọ itan-akọọlẹ	Nan
hanesyddol	itan	Nan
hanfod	lodi	Nan
hanfodol	pataki	Nan
hangen	nilo	Nan
haniaethol	áljẹbrà	Nan
hanmer	hanma	Nan
hannah	hannah	Nan
hanner	idaji	None
hannibal	hannibal	Nan
hannibyniaeth	ominira	Nan
hans	han	Nan
hanterth	tente oke	Nan
hapus	dun	None
hatal	da	None
haul	oorun	Nan
havana	havana	Nan
heddiw	loni	Nan
heddiwn	loni	Nan
heddlu	ọlọpa	Nan
heddluoedd	awọn ipa	Nan
heddwch	alafia	Nan
heddychlon	alaafia	None
hedfan	fò	Nan
heffeithio	kan	None
hefyd	tun	Nan
heibio	ti o ti kọja	Nan
heinrich	heinrich	None
heintiad	akoran	Nan
heintiadau	awọn àkóràn	Nan
heintiau	awọn àkóràn	Nan
heintio	akoran	Nan
hedd	alafia	Nan
hebron	ogun	None
hebreaid	ehoro	Nan
hebraeg	heberu	Nan
have	ni	Nan
hawaii	ilu hawahi	Nan
hawdd	rọrun	Nan
hawl	ni ọtun	Nan
hawlfraint	aṣẹkikọ	Nan
hawliau	awọn ẹtọ	Nan
hawlio	beere	Nan
handbook	iwe afọwọkọ	Nan
hawliwyd	so	None
hcl	hcl	Nan
he	oun	None
head	ori	None
heal	wosan	Nan
heb	laisi	Nan
heblaw	yàtò	None
hebog	egbe	None
haws	o rorun gan	Nan
hand	ọwọ	Nan
hamgylchynu	yika	Nan
hamgylch	yika	Nan
gysyniad	erongba	Nan
gysyniadau	awọn erongba	Nan
gytundeb	àdéhùn	Nan
gytundebau	awọn adehun	Nan
gytuno	gba	None
gywir	tọ	Nan
gâl	galle	Nan
gân	orin	Nan
gêm	eré	Nan
gïach	apanirun	Nan
gölü	gölü	Nan
gŵr	ọkọ	Nan
gŵydd	gusi	Nan
gŵyl	ajọdun	Nan
gŵyr	o mọ	Nan
gysylltu	kan	None
gysylltir	ti sopọ	Nan
gysylltiedig	ti o ni ibatan	Nan
gysylltiadau	awọn olubasọrọ	Nan
gyrfa	iṣẹ	Nan
gyrff	awọn ara	Nan
gyrhaeddodd	o de	Nan
gyrion	awọn gbagede	Nan
gyrraedd	de	Nan
gyrrodd	o wakọ	Nan
gyrru	iwakọ	Nan
h	ẹ	Nan
gyrrwyd	firanṣẹ	Nan
gysegredig	mimọ	Nan
gysgu	sun	None
gyson	nigbagbogbo	Nan
gystadlaethau	awọn idije	Nan
gystadleuaeth	idije	Nan
gystadlu	dije	Nan
gysylltiad	ìbáṣepọ	Nan
gysawd	eto	Nan
hel	ọdẹ	Nan
h+	h +	Nan
haag	ni	Nan
hail	yinyin	Nan
haint	akoran	Nan
haiti	haiti	None
hajj	haj	Nan
halbwm	awo-orin	Nan
halen	iyo	Nan
haley	haley	Nan
hall	gbongan	Nan
hallstatt	gbọngan gbọngan	Nan
hallt	iyo	Nan
halogenoalcan	halogenoalcan	Nan
hamas	hams	Nan
hamburg	hamburg	Nan
hamdden	fàájì	Nan
hamddiffyn	aabo	Nan
hagia	hagia	Nan
hafren	ẹgbẹ	Nan
hafod	hafod	Nan
hafau	awọn igba ooru	Nan
haarlem	haarlem	Nan
had	irugbin	Nan
hadau	awọn irugbin	Nan
haddoli	jọsin	Nan
haddysg	eko	None
hadeiladu	itumọ	Nan
hadnabod	idanimọ	Nan
ha	ha	Nan
hadrian	adrian	Nan
haelodau	ọmọ	None
haen	ipele	None
haenau	fẹlẹfẹlẹ	Nan
haf	igba ooru	Nan
hafal	dọgba	Nan
hafan	oju-ile	Nan
hafana	oju-ile	Nan
haearn	irin	Nan
gyrchfan	ajo	None
hela	ọdẹ	Nan
helar	igigirisẹ	Nan
ho	ho	Nan
ho+	ho +	Nan
hoddinott	hoddinott	Nan
hodgson	hodgson	Nan
hoes	hoes	Nan
hoff	ayanfẹ	Nan
hofrenyddion	awọn ọkọ ofurufu	Nan
holl	gbogbo	Nan
holland	landónì	Nan
hollol	egba	None
hollt	pin	Nan
holly	ṣofo	Nan
hollywood	agekuru	Nan
holocost	ipanu	Nan
home	ile	Nan
hn	loni	Nan
homo	jọpọ	Nan
hms	hms	Nan
hivaids	hivaids	Nan
hip	ibadi	Nan
hiphop	ologbo	Nan
hir	gun	None
hirach	gun	None
hiraf	gunjulo	Nan
hirdymor	igba gígun	Nan
hirgrwn	ofali	Nan
hirohito	hirohito	Nan
hiroshima	hiroshima	Nan
his	tirẹ	Nan
historia	itan	Nan
history	itan	Nan
hithau	arabinrin na	Nan
hitler	kọlu	Nan
hiv	hiv	Nan
hiwmor	yẹyẹ	Nan
hon	eyi	Nan
honduras	honduras	Nan
honedig	titẹnumọ	Nan
hoyw	onibaje	Nan
hoywon	gays	Nan
hrolf	hrolf	Nan
html	html	Nan
http	hẹ	Nan
hu	o	Nan
hua	hua	Nan
hud	idan	Nan
hudol	ti idan	Nan
hudson	hudson	Nan
huey	huey	Nan
hugain	ogun	None
huganod	hárá	Nan
hugh	ofiri	Nan
hughes	famọra	Nan
howard	bawo	Nan
how	bawo	Nan
houston	houston	Nan
house	ilé	None
hong	hong	Nan
honiad	esun	Nan
honiadau	esun	Nan
honni	beere	Nan
honno	iyẹn	Nan
honnon	titẹnumọ	Nan
honshu	honshu	Nan
hinsoddol	afefe	Nan
hooded	hó	Nan
hop	hop	Nan
hope	ireti	Nan
hopkins	hopkins	Nan
hormon	homonu	Nan
hormonau	homonu	Nan
horn	iwo	Nan
hot	gbona	Nan
hook	kio	Nan
hinsoddaur	onigita	Nan
hinsawdd	afefe	Nan
hindŵaidd	arakunrin hinia	Nan
henebion	awọn arabara atijọ	Nan
henffordd	eyiyika	Nan
henfyd	ohun atijọ	Nan
heniaith	ede	None
henlein	henlein	Nan
henoed	agbalagba	Nan
henri	henri	Nan
henrik	henrik	Nan
henry	henry	Nan
henson	henson	Nan
henw	orukọ	Nan
henwau	awọn orukọ	Nan
henwi	orukọ	Nan
hepburn	ẹgbin	Nan
her	ipenija	Nan
hendygwyn	atijọ funfun	Nan
hendrix	hendrix	Nan
hendre	hendre	Nan
henaint	arúgbó	None
helen	helen	Nan
helena	helena	Nan
helens	helens	Nan
heliwm	irinse	Nan
helmand	àṣíborí	Nan
helo	pẹlẹ o	Nan
help	egba	None
heraclius	igigirisẹ	Nan
helpu	egba	None
helsinki	helsinki	Nan
helvetica	helvetica	Nan
helvetii	helvetii	Nan
helyg	willow	Nan
helyntion	wahala	Nan
hemisffer	itatẹtẹ	Nan
hen	atijọ	Nan
helpur	iranlọwọ	Nan
helaeth	gbooro	Nan
herbert	herbert	Nan
heriau	awọn italaya	Nan
hiliaeth	ẹlẹyamẹya	Nan
hiliau	meya-ije	Nan
hiliol	ẹlẹyamẹya	Nan
hill	òkè	Nan
hilladdiad	idan	Nan
him	rẹ	None
himalaya	himalaya	Nan
himantopus	himantopus	Nan
hin	hin	Nan
hincks	idiwọ	Nan
hindenburg	hindenburg	Nan
hindi	hindi	Nan
hindu	hindu	Nan
hindwiaid	arakunrin hinia	Nan
hindŵaeth	hinduism	Nan
hilary	hilary	Nan
hil	ije	None
high	ga	Nan
hierarchaeth	olori	Nan
herodotus	akọni ọkunrin	Nan
heron	ogun	None
herschel	arabinrin	Nan
hertsegofina	hertsevina	Nan
herwfilwrol	ogun	None
herwydd	iyen	None
herzegovina	herzegovina	Nan
here	nibi	Nan
het	ijanilaya	Nan
hethol	dibo	Nan
heuldror	oorun	Nan
hi	bawo	Nan
hiaith	ede	None
hibernica	hibernica	Nan
hidl	àlẹmọ	Nan
hidlydd	àlẹmọ	Nan
heterorywioldeb	heterosexuality	Nan
human	ènìyàn	Nan
gyrch	igbogun ti	Nan
gynulleidfa	jepe	Nan
gwthior	looto	Nan
gwyach	gregarious	Nan
gwyachod	gẹdẹ	Nan
gwybedog	flycatcher	Nan
gwybedogion	midges	Nan
gwybod	mọ	Nan
gwybodaeth	alaye	Nan
gwybodeg	ti alaye	Nan
gwybyddol	imoye	Nan
gwych	nla	Nan
gwyddau	egan	Nan
gwyddbwyll	chess	Nan
gwyddeleg	irish	Nan
gwyddelig	irish	Nan
gwyddelod	irish	Nan
gwthio	ti	Nan
gwyddom	a mọ	Nan
gwsg	sun	None
gwryw	akọ	Nan
gwrthod	kọ	Nan
gwrthododd	o kọ	Nan
gwrthodwyd	kọ	Nan
gwrthrych	nnkan	Nan
gwrthrychau	nkan	None
gwrthryfel	iṣọtẹ	Nan
gwrthryfelwyr	ọlọtẹ	Nan
gwrthsefyll	atako	Nan
gwrthwyneb	idakeji	Nan
gwrthwynebiad	àtakò	Nan
gwrthwynebu	nnkan	Nan
gwrthwynebwyd	tako	Nan
gwrthwynebwyr	alatako	Nan
gwrthydd	alatako	Nan
gwrw	oti sekengberi	Nan
gwrywaidd	akọ	Nan
gwyddoniadur	encyclopedia	Nan
gwyddoniaduron	encyclopedias	Nan
gwyddoniaeth	sayensi	Nan
gwynfor	gwynfor	Nan
gwynfryn	gwynfryn	Nan
gwynion	ẹdun ọkan	Nan
gwynn	ẹdun	Nan
gwynt	afẹfẹ	Nan
gwyrdd	ewe	None
gwyrthiau	iyanu	Nan
gwythïen	iṣọn	Nan
gwŷr	ọkọ	Nan
gychwyn	bẹrẹ	Nan
gyd	gbogbo	Nan
gyda	pẹlu	Nan
gydag	pẹlu	Nan
gydai	rẹ	None
gydar	wọn	None
gwyneth	wundia	Nan
gwynegon	làkúrègbé	Nan
gwynedd	gwynedd	Nan
gwynant	won kerora	Nan
gwyddoniaethau	sáyẹnsì	Nan
gwyddonol	sayensi	Nan
gwyddonwyr	sayensi	Nan
gwyddonydd	onimo-jinlẹ	Nan
gwyddor	abidi	None
gwyddorau	sáyẹnsì	Nan
gwydr	gilasi	Nan
gwrthiant	atako	Nan
gwylan	gull	Nan
gwyliau	awọn isinmi	Nan
gwylio	wiwo	Nan
gwyllt	egan	Nan
gwylog	olofofo	Nan
gwylwyr	awọn oluwo	Nan
gwymp	subu	Nan
gwyn	funfun	Nan
gwylanod	gulls	Nan
gwrtheyrn	atako	Nan
gwrthdystiadau	awọn ifihan	Nan
gwrthdaro	rogbodiyan	None
gwisgo	wọ	Nan
gwlad	orilẹ-ede	Nan
gwladfa	ileto	Nan
gwladfaoedd	awọn ileto	Nan
gwladfar	amunisin	Nan
gwladfeydd	awọn ileto	Nan
gwladgarol	olufẹ orilẹ-ede	Nan
gwladol	ipinle	Nan
gwladweinydd	ipinlẹ	Nan
gwladwriaeth	kan	None
gwladwriaethau	awọn ipinlẹ	Nan
gwladychu	ilodi	Nan
gwledig	igberiko	None
gwledydd	awọn orilẹ-ede	Nan
gwleidydd	oloselu	Nan
gwisg	aṣọ	Nan
gwirionedd	ooto	Nan
gwirfoddol	atinuwa	Nan
gwir	ooto	Nan
gwerth	iye	Nan
gwerthfawr	niyelori	Nan
gwerthiant	awọn tita	Nan
gwerthodd	o ta	Nan
gwerthoedd	awọn iye	Nan
gwerthu	ta	Nan
gwestai	awọn hotẹẹli	Nan
gwleidyddiaeth	oselu	Nan
gweu	wiwun	Nan
gwfennau	awọn aṣọ atẹrin	Nan
gwib	lẹsẹkẹsẹ	Nan
gwibdaith	ijade	Nan
gwili	wili	Nan
gwilliam	william	Nan
gwilym	william	Nan
gwin	waini	Nan
gwfen	mo ṣe	Nan
gydau	wọn	None
gwleidyddion	oloselu	Nan
gwlff	gulfkun	Nan
gwragedd	aya	None
gwraidd	gbongbo	None
gwraig	iyawo	None
gwrandewch	gbọ	Nan
gwrando	nfeti	Nan
gwrdd	pàdé	Nan
gwregys	igbanu	Nan
gwreiddiau	wá	Nan
gwreiddiaur	gbongbo	None
gwreiddiol	atilẹba	Nan
gwreiddyn	gbongbo	None
gwres	igbona	Nan
gwrogaeth	itẹriba	Nan
gwrs	dajudaju	Nan
gwrtaith	ajile	Nan
gwrachod	awọn ajẹ	Nan
gwr	ọkọ	Nan
gwpan	kan	None
gwobrau	onipokinni	Nan
gwlt	egbeokunkun	Nan
gwlyb	ririn	Nan
gwlân	kìki irun	Nan
gwm	gomu	Nan
gwmni	ile-iṣẹ	Nan
gwmniau	awọn ile-iṣẹ	Nan
gwmnïau	awọn ile-iṣẹ	Nan
gwleidyddol	oselu	Nan
gwmpas	yika	Nan
gwnaeth	o ṣe	Nan
gwneir	yoo	None
gwneud	ṣe	Nan
gwneuthurwyr	awọn aṣelọpọ	Nan
gwnewch	ṣe	Nan
gwningen	ehoro	Nan
gwobr	joju	Nan
gwnaed	o ti ṣe	Nan
gynyddu	pọ si	Nan
gyddfgoch	pupa	None
gydnabod	itewogba	Nan
gymerodd	to	None
gymeryd	mu	Nan
gymharol	jo	None
gymharu	afiwe	Nan
gymhleth	eka	None
gymhwysol	gbẹyin	Nan
gymorth	egba	None
gymraeg	welsh	Nan
gymreig	elsdè welsh	Nan
gymro	awon egun	Nan
gymru	oyo	Nan
gymry	oyo	Nan
gymryd	mu	Nan
gymuned	agbegbe	Nan
gymunedau	awọn agbegbe	Nan
gymeriadau	ohun kikọ	Nan
gymunedol	agbegbe	Nan
gymeriad	ohun kikọ	Nan
gymdeithaswyr	sosialisiti	Nan
gyhoeddodd	o kede	Nan
gyhoeddus	gbangba	Nan
gyhoeddwyd	ti kede	Nan
gyhydedd	dọgbadọgba	Nan
gyhydeddol	dọgbadọgba	Nan
gylch	circle	Nan
gylchdro	iyipo	Nan
gylchgrawn	iwe irohin	Nan
gylchrediad	san	Nan
gylchredol	pin kaa kiri	Nan
gymaint	pupọ gaan	Nan
gymanwlad	l’owo	Nan
gymar	mate	Nan
gymdeithas	awujọ	Nan
gymdeithasol	lawujọ	Nan
gymdogaeth	adugbo	Nan
gymwys	yẹ	Nan
gymysg	dapọ	Nan
gymysgedd	adalu	Nan
gynllunio	gbimọ	Nan
gynnal	agbalejo	Nan
gynnar	kutukutu	Nan
gynnen	ariyanjiyan	Nan
gynnes	loworo	Nan
gynnig	išipopada	Nan
gynnwys	akoonu	Nan
gynnydd	ilọsiwaju	Nan
gynnyrch	ọja	Nan
gynorthwyo	ran	Nan
gynradd	kekere	None
gynrychioli	aṣoju	Nan
gynrychiolir	aṣoju	Nan
gynt	tẹlẹ	Nan
gyntaf	akoko	Nan
gynllun	gbero	Nan
gynigiwyd	dabaa	Nan
gynhyrchwyd	produced	None
gynhyrchu	gbóògì	Nan
gymysgu	dapọ	Nan
gynderfynol	pinnu	Nan
gyngerdd	ere orin	Nan
gyngherddau	awọn ere orin	Nan
gynghrair	ajumọṣe	Nan
gyngor	imọran	Nan
gyngres	apejọ alapejọ	Nan
gyhoeddir	yoo	None
gynharach	sẹyìn	Nan
gynhelir	waye	Nan
gynhenid	atorunwa	Nan
gynhesach	igbona	Nan
gynhwysai	o wa	Nan
gynhwysfawr	okeerẹ	Nan
gynhyrchion	awọn ọja	Nan
gynhyrchir	produced	None
gynharaf	alakoko	Nan
gyhoeddi	te	Nan
gyfystyr	amuṣiṣẹpọ	Nan
gyfyngu	ihamọ	Nan
gyfatebol	ibaramu	Nan
gyfathrach	ajọṣepọ	Nan
gyfathrebu	ibaraẹnisọrọ	Nan
gyfeiriad	itọsọna	Nan
gyfeiriadau	awọn itọkasi	Nan
gyfeirio	tọka	Nan
gyfer	fun	None
gyferbyn	idakeji	Nan
gyferbyniad	itansan	Nan
gyferbyniol	iyatọ	Nan
gyffredin	wọpọ	Nan
gyffredinol	gbogbogbo	None
gyffro	ayo	Nan
gyffroir	yiya	Nan
gyffuriau	awọn oogun	Nan
gyfarwydd	faramọ	Nan
gyfartaledd	aropin	Nan
gyfartal	boṣeyẹ	Nan
gyfarfod	ipade	Nan
gydol	jakejado	Nan
gydran	paati	Nan
gydymerawdwr	olú ọba	Nan
gyfaddawd	adehun adehun	Nan
gyfaill	ọ̀rẹ́	Nan
gyfan	gbogbo	Nan
gyfandir	kọntinia	Nan
gyflafan	ipakupa	Nan
gyfandiroedd	awọn aye	Nan
gyfangwbl	lapapọ	Nan
gyfansoddi	ikowe	Nan
gyfansoddiad	t’olofin	Nan
gyfansoddiadol	t’olofin	Nan
gyfansoddion	awọn iṣiro	Nan
gyfansoddodd	o kq	Nan
gyfansoddwyd	kq	Nan
gyfandirol	continental	Nan
gydfynd	baramu	Nan
gyflawn	pari	Nan
gyflawnir	yoo	None
gyfreithlon	t’olofin	Nan
gyfres	jara	Nan
gyfrifiadur	kọmputa	Nan
gyfrifol	lodidi	Nan
gyfrifoldeb	ojuse	None
gyfrinachol	igbekele	Nan
gyfrol	iwọn didun	Nan
gyfrwng	alabọde	Nan
gyfun	ni idapo	Nan
gyfundrefn	eto	Nan
gyfuniad	apapo	Nan
gyfuno	ni idapo	Nan
gyfunrywiol	fohun	Nan
gyfunrywioldeb	ilopọ	Nan
gyfyngedig	lopin	Nan
gyfreithiol	ni t’olofin	Nan
gyfreithiau	ofin	None
gyfrannu	tiwon	Nan
gyfraniadau	awọn ifunni	Nan
gyfleus	rọrun	Nan
gyflwr	majemu	Nan
gyflwyno	tẹriba	Nan
gyflym	yara	Nan
gyflymach	yara ju	Nan
gyflyrau	ipo	None
gyfnewid	paṣipaarọ	Nan
gyflawni	ṣaṣeyọri	Nan
gyfnod	asiko	Nan
gyfochrog	pọgba	Nan
gyfoes	imusin	None
gyfoeth	ọrọ	Nan
gyfoethog	ọlọrọ	Nan
gyfradd	oṣuwọn	Nan
gyfraith	ofin	None
gyfran	pin	Nan
gyfnodau	awọn aaye arin	Nan
hume	hume	Nan
humphrey	humphrey	Nan
hun	iho	Nan
lannau	eti okun	Nan
lannaur	atupa	Nan
lansiwyd	ti a se igbekale	Nan
lanthanidau	lanthanides	Nan
lao	ọmọ	None
laos	laos	Nan
lapwing	wiwakọ	Nan
large	tobi	Nan
lark	lark	Nan
larry	larry	Nan
larus	idin	Nan
larvivora	larvivora	Nan
las	bulu	Nan
last	kẹhin	Nan
later	nigbamii	Nan
lanka	lanka	None
latfia	latvia	None
lanius	lairi	Nan
langue	ìbá	Nan
lafur	laala	Nan
lagopus	lagopus	Nan
lahiya	lahiya	Nan
lai	ti o kere	Nan
lain	idite	Nan
lais	ohun	Nan
lakshmi	lakshmi	Nan
lamp	atupa	Nan
lan	sókè	Nan
lanberis	lanberis	Nan
lancastriaid	awọn adarọ-ese	Nan
land	ilẹ	None
lang	l’or	Nan
language	ede	None
languages	ede	None
lanio	ibalẹ	Nan
latfieg	ede	None
latifa	latifa	Nan
lauren	lauren	Nan
lee	lee	Nan
leeds	leeds	Nan
lefant	lefant	Nan
lefel	ipele	None
lefelau	ipele	None
lefydd	àwọn ibò	Nan
legal	t’olofin	Nan
legibly	legibly	Nan
leiaf	o kere ju	Nan
leiafrifoedd	kekere	None
leiafrifol	ẹlẹgbẹ	Nan
leihau	din	None
lein	laini	Nan
lencyndod	ọdọ	Nan
lenin	lenin	Nan
ledred	latitude	Nan
ledled	jakejado	Nan
leddfu	dinku	Nan
led	gbooro	Nan
law	ojo	None
lawer	lọpọlọpọ	Nan
lawgoch	o ṣe	Nan
lawn	kun	Nan
lawnsio	ifilole	None
lawnsiwyd	se igbekale	Nan
lawr	silẹ	Nan
lafar	ẹnu	Nan
lawrence	agbofinro	Nan
lawysgrifau	awọn iwe afọwọkọ	Nan
le	pẹlu	Nan
least	o kere ju	Nan
leblanc	leblanc	Nan
lechfaen	sileti	Nan
lechi	sileti	Nan
lechweddau	àwọn òkè	Nan
lawysgrif	iwe afọwọkọ	Nan
lafa	lava	Nan
laeth	wara	Nan
lady	iyaafin	Nan
keith	keith	Nan
kel	kel	Nan
kelly	kelly	Nan
keltoi	keltoi	Nan
kemal	kemal	Nan
kemmyn	kemmyn	Nan
ken	keno	Nan
kennedy	keniyan	Nan
kenneth	keno	Nan
kenny	omobirin	Nan
kenya	kenya	Nan
kernewek	kernewek	Nan
kernow	alagbara	Nan
kestrel	ẹyẹ	Nan
kevin	kevin	Nan
kazakstan	kasakisitani	Nan
kazakhstan	kasakisitani	Nan
katherine	katherine	Nan
kate	kate	Nan
jure	adaṣe	Nan
just	kan	None
justinianus	olominira	Nan
jôc	awada	Nan
k	k	Nan
ka	ka	Nan
kabul	kabul	Nan
key	bọtini	Nan
kaiser	kaiser	Nan
kali	kali	Nan
kalimantan	kalimantan	Nan
kanagawa	kanagawa	Nan
kanji	kanji	Nan
kapilavastu	kapilavastu	Nan
karakoram	karakoram	Nan
karl	karili	Nan
kaishek	kaishek	Nan
lennon	lennon	Nan
kg	kg	Nan
khmer	khmer	Nan
kurrentschrift	kurrentschrift	Nan
kush	kush	Nan
kuwait	ara ilu	Nan
kw	kw	Nan
kwazulu	kwazulu	Nan
kyoto	kyoto	Nan
kyrgyzstan	kyrgyzstan	Nan
l	l	Nan
la	la	Nan
label	aami	Nan
labia	labia	Nan
ladd	pa	Nan
laddodd	o pa	Nan
laddwyd	pa	Nan
ladin	ladin	Nan
kudrow	kudrow	Nan
kpa	iho	Nan
kosovo	kosovo	Nan
korea	koria	Nan
khoikhoi	khoikhoi	Nan
khoisan	khoisan	None
khorasan	khorasan	Nan
kimoon	kimoon	Nan
kind	irú	Nan
king	ọba	Nan
kingsley	kingley	Nan
khan	khan	Nan
kiribati	kiribati	Nan
klerk	àṣèré	Nan
km	km	Nan
km²	km²	Nan
know	mọ	Nan
known	mọ	Nan
komnenos	komnenos	Nan
kong	kong	None
kitts	ọmọ	None
jura	jura	Nan
lenorion	onkọwe	Nan
lenyddiaeth	litireso	Nan
llawysgrif	iwe afọwọkọ	Nan
llawysgrifau	awọn iwe afọwọkọ	Nan
llc	llc	Nan
lle	ibi	Nan
llechfaen	sileti	Nan
llechi	sileti	Nan
llechin	sileti	Nan
llechir	loro	Nan
llechwedd	iho	Nan
llechweddau	àwọn òkè	Nan
lled	fifẹ	Nan
lledaeniad	tànkálẹ	Nan
lledaenodd	o tan ka	Nan
lledaenu	tànkálẹ	Nan
lledodd	o tan ka	Nan
llawr	ilẹ	None
lledr	awọ	Nan
llawn	kun	Nan
llawer	lọpọlọpọ	Nan
llanbedr	lampeter	Nan
llanberis	alaigbọn	Nan
llanddona	pon si	Nan
llanddwyn	melancholy	Nan
llandudno	llandudno	Nan
llanelli	llanelli	Nan
llanelwy	st. asafu	Nan
llanfaethlu	oko	None
llanfihangel	llanfihangel	Nan
llangefni	llangefni	Nan
llangollen	llangollen	Nan
llangristiolus	llangristiolus	Nan
llanrwst	llanrwst	Nan
llanw	ṣiṣan	Nan
llaw	ọwọ	Nan
llawlyfr	afọwọkọ	Nan
lledred	latitude	Nan
lledrith	iruju	Nan
llefarydd	agbẹnusọ	Nan
llenorion	onkọwe	Nan
llenwi	kun	Nan
llenwir	o ti kun	Nan
llenyddiaeth	litireso	Nan
llenyddol	imọwe	Nan
lleoedd	àwọn ibò	Nan
lleol	agbegbe	Nan
lleoli	ipo	None
lleoliad	ipo	None
lleoliadau	ipo	None
lleolir	ti wa ni be	Nan
lleolwyd	ti wa ni be	Nan
ller	ler	Nan
lles	ire	None
llethol	lagbara	Nan
llenor	onkqwe	Nan
llengoedd	awọn ẹgbẹ	Nan
lleng	ẹgbẹ pataki	Nan
llen	aṣọ-ikele	Nan
llefelys	lagbara	Nan
lleferydd	ọrọ	Nan
llefrith	wara	Nan
llefydd	àwọn ibò	Nan
lleiaf	o kere ju	Nan
lleiafrif	kekere	None
lleiafrifoedd	kekere	None
llanbadarn	llanbadarn	Nan
lleiafrifol	ẹlẹgbẹ	Nan
lleihad	idinku	Nan
lleihaodd	o dinku	Nan
lleihau	din	None
lleihaur	kere	Nan
lleihawyd	dinku	Nan
lleisiol	t’ohun	Nan
lleithder	ọriniinitutu	Nan
lleian	arabinrin	Nan
llan	ile ijọsin	Nan
llall	omiiran	Nan
llaith	tutu	Nan
leuad	osupa	Nan
leucoptera	leucoptera	Nan
lev	lev	Nan
lewis	lewis	Nan
león	kiniun	Nan
lhdt	lhdt	Nan
lhuyd	lhuyd	Nan
li	irọ	Nan
libanus	libanus	Nan
liberia	liberiya	Nan
libia	libya	Nan
libya	libya	Nan
license	iwe-aṣẹ	Nan
liechtenstein	irọke-oniṣẹ	Nan
life	igbesi aye	Nan
lethraur	agbọnrin	Nan
lethrau	àwọn òkè	Nan
lesser	kere	Nan
lesotho	lesotho	Nan
lenyddol	imọwe	Nan
leo	wọn	None
leoedd	àwọn ibò	Nan
leol	agbegbe	Nan
leoli	wa	Nan
leoliad	ipo	None
leolir	wa	Nan
lillian	lillian	Nan
leon	kiniun	Nan
leonardo	leonardo	Nan
leone	leone	Nan
leonid	kiniun	Nan
lerpwl	ọfun	Nan
les	lesi	Nan
lesbiaidd	ọmọ	None
leslie	leslie	Nan
leonard	adẹtẹ	Nan
lenwi	kun	Nan
limosa	limosa	Nan
lincoln	linmọlẹ	Nan
liwcemia	lukimia	Nan
liwiau	awọn awọ	Nan
ll	l1	Nan
llachar	didan	Nan
lladd	pa	Nan
lladdedigion	pa	Nan
lladdodd	o pa	Nan
lladdwyd	ti pa	Nan
lladin	latini	None
llaeth	wara	Nan
llafar	ẹnu	Nan
llafur	laala	Nan
llai	ti o kere	Nan
llain	idite	Nan
llais	ohun	Nan
liw	awọ	Nan
living	ngbe	Nan
lives	laaye	Nan
liverpool	ẹdọfóró	Nan
linda	linda	Nan
lindsay	lindsay	Nan
linell	laini	Nan
lingua	lingua	Nan
linux	àlẹmọ	Nan
lion	àwọn	Nan
lisa	lisa	Nan
linach	idile	Nan
lisbon	lisbon	Nan
listed	ṣe akojọ	Nan
lithosffer	ile didi	Nan
lithuania	lithuania	Nan
lithwania	lithuania	Nan
lithwaniaid	lithuanians	Nan
little	diẹ	Nan
live	wa laaye	Nan
list	atokọ	Nan
julius	julius	Nan
juliet	juliet	Nan
julie	julie	Nan
iddewalmaeneg	jẹmánì	Nan
iddewiaeth	ọgbọn	Nan
iddewig	laisi	Nan
iddewon	juu	Nan
iddi	fún un	Nan
iddo	fún un	Nan
iddyn	wọn	None
iddynt	wọn	None
idf	idf	Nan
idris	idris	Nan
iduna	iduna	Nan
idwal	idwal	Nan
ie	bẹẹni	Nan
iechyd	ilera	Nan
ieir	adie	Nan
ich	ich	Nan
ieitheg	ẹkọ nipa ti ara	Nan
ibsen	ibsen	Nan
ibrahim	ibrahim	Nan
hŷn	agbalagba	Nan
i	emi	Nan
ia	bẹẹni	Nan
iach	ni ilera	Nan
iad	wọn	None
iago	iago	Nan
iaith	ede	None
ian	dẹlẹ	Nan
iarll	eti	Nan
iau	aburo	Nan
iawn	o dara	Nan
iaşi	iaşi	Nan
iberia	ara ilu iria	Nan
ibiza	ibiza	Nan
ibn	abinibi	Nan
ibric	abínibí	None
ieithoedd	ede	None
ieithydd	onkọwe-ede	Nan
ieithyddiaeth	ẹkọ ẹkọ	Nan
ill	aisan	Nan
illinois	itanna	Nan
im	bota	Nan
imiwnedd	ajesara	Nan
imperialaeth	ijọba ọba	Nan
imperialaidd	olú ọba	Nan
in	ninu	Nan
inc	inc	Nan
include	pẹlu	Nan
included	to	None
incwm	owo oya	Nan
indeed	nitootọ	Nan
india	india	Nan
indiaid	ara ilu inde	Nan
indiaidd	ara ilu	Nan
ildior	ildior	Nan
ildiodd	sílẹ̀	None
ildio	arasilẹ	Nan
il	il	Nan
ieithyddion	onkọwe-ede	Nan
ieithyddol	ede	None
iesu	jesu	None
ieuan	ajaga	Nan
ieuanc	odo	Nan
ieuenctid	ọdọ	Nan
if	ti o ba ti	Nan
héireann	orile-ede ireland	Nan
ifainc	odo	Nan
ifanc	odo	Nan
ifans	ifan	Nan
ifor	ifor	Nan
ifori	ehin-erin	Nan
igneaidd	igneous	Nan
ii	ii	Nan
iii	iii	Nan
ifan	ifan	Nan
há	haha	Nan
hywel	hywel	Nan
hytrach	dipo	Nan
hwngariaid	ara ilu hungaria	Nan
hwnnw	iyẹn	Nan
hwnnwn	a wa	Nan
hwnt	rekọja	Nan
hwy	wọn	None
hwyaden	pepeye	Nan
hwyaf	gunjulo	Nan
hwyl	igbadun	Nan
hwylio	ọkọ oju-omi	Nan
hwyluso	irọrun	Nan
hwyr	pẹ	Nan
hwyrach	nigbamii	Nan
hy	ie	Nan
hybu	igbega	Nan
hyd	gigun	Nan
hwngari	họnari	Nan
hwn	eyi	Nan
hwch	gbìn	Nan
huws	huws	Nan
hunain	awọn funrararẹ	Nan
hunan	iho	Nan
hunangofiant	iwe afọwọkọ	Nan
hunangynhaliol	ara-to	Nan
hunangysegru	ara-incriminating	Nan
hunaniaeth	idanimọ	Nan
hunanladdiad	igbẹmi ara ẹni	Nan
hyddgen	apọn-oyinbo	Nan
hunanleddfu	ara-ẹni	Nan
hunanlywodraethol	ṣàkóso ara ẹni	Nan
hund	hund	Nan
hur	hur	Nan
hurt	ipaya	Nan
hussein	hussein	Nan
hutton	hutton	Nan
huw	hu	Nan
hunanlywodraeth	ijọba ti ara ẹni	Nan
indian	ara ilu	Nan
hydoddi	tuka	Nan
hydred	jijin	Nan
hynafiaethau	antiquities	Nan
hynafiaethwyr	antiquarians	Nan
hynafiaid	awọn baba	Nan
hynafol	atijọ	Nan
hynny	iyẹn	Nan
hynnyn	iyẹn	Nan
hynod	o lapẹẹrẹ	Nan
hypertext	agba	None
hyrwyddo	igbega	Nan
hyrwyddor	olugbeleke	Nan
hysbys	mọ	Nan
hysbysebion	awọn ipolowo	Nan
hysbysebu	ipolowo	Nan
hysgrifennu	kikọ	Nan
hystyried	ronu	Nan
hynaf	akọbi	Nan
hyn	eyi	Nan
hymen	orin	Nan
hymarferiadau	awọn adaṣe	Nan
hydref	ewe	None
hydrin	alaiṣii	Nan
hydrocarbon	hydrocarbon	Nan
hydrocarbonau	hydrocarbons	Nan
hydroclorig	hydrochloric	Nan
hydrocsid	hydroxide	Nan
hydrogen	hydrogen	Nan
hydoddiant	ojutu	Nan
hydrograffeg	olomi-akọọlẹ	Nan
hydrosffer	hydrosphere	Nan
hyfforddiant	idanileko	Nan
hyfforddwr	olukọ	Nan
hyfryd	ẹlẹwa	Nan
hylif	omi	None
hylifau	awọn olomi	Nan
hylifol	omi	None
hydroniwm	hydronium	Nan
indigo	indigo	Nan
indoewropeaidd	àdògò	Nan
indonesia	ara ilu indonia	Nan
james	awọn orukọ james	Nan
jamie	jamie	Nan
jan	ọrun	Nan
jane	jane	Nan
janet	janet	Nan
japan	japan	Nan
japaneg	japanese	Nan
japanese	ede	None
jarman	akọni	Nan
java	java	Nan
jay	jay	Nan
jazeera	jazeera	Nan
jazz	jazz	Nan
je	je	Nan
jean	jean	Nan
jamaica	jamaica	None
jam	jam	Nan
jakarta	jakarta	Nan
jades	jades	Nan
iwerydd	keji	Nan
iwganda	uganda	Nan
iwgoslafaidd	yugoslav	Nan
iwgoslafia	yugoslavia	Nan
iwraniwm	kẹmika	Nan
iwterws	ile-ọmọ	Nan
iâ	yinyin	Nan
jebel	obìnrin	Nan
iâr	gboo	Nan
iː	iː	Nan
j	j	Nan
ja	ja	Nan
jabaliya	jabaliya	Nan
jac	jaketi	Nan
jacksons	jacksons	Nan
jade	jade	Nan
iŵl	ewi	Nan
iwerddon	orile-ede ireland	Nan
jefferson	jomorsoni	Nan
jennifer	jennifer	Nan
jonathan	jonathan	Nan
jones	awọn agbegbe	Nan
jonesparry	jonesparry	Nan
joplin	joplin	Nan
jordan	jordan	Nan
josef	josef	Nan
joseph	joseph	Nan
josé	josé	Nan
joyce	ayo	Nan
jr	jr	Nan
juan	juan	Nan
judith	idajo	None
julia	julia	Nan
julian	julian	Nan
juliana	juliana	Nan
jon	jon	Nan
johnson	johnson	Nan
johns	johns	Nan
johnny	johnny	Nan
jeriwsalem	jerusalẹmu	Nan
jerry	jeri	Nan
jersey	aso	Nan
jiang	jiang	Nan
jim	jimọọ	Nan
jimi	jimi	Nan
jimmy	jimmy	Nan
jenkins	aṣọ alaṣọ	Nan
jj	jj	Nan
joe	joe	Nan
joel	joel	Nan
joey	joey	Nan
johann	johann	None
johannes	johannes	Nan
johannesburg	johannesburg	Nan
john	john	Nan
jo	jo	None
pendefig	ọlọla	Nan
iwan	iwan	Nan
ivor	ivo	Nan
irac	iraaki	Nan
iran	iran	Nan
iraq	iraq	Nan
ireland	orile-ede ireland	Nan
irene	irene	Nan
irish	gẹẹsi	Nan
irma	irma	Nan
irving	irving	Nan
is	jẹ	Nan
isa	jẹ	Nan
isaac	isale	Nan
isabella	isabella	Nan
isaf	ni asuwon ti	Nan
isafrif	kekere	None
isalmaeneg	dutch	Nan
ira	iraye	Nan
ir	áì	Nan
ipa	ipa	Nan
iorwerth	iorwerth	Nan
indotsieina	indotsieina	Nan
indus	indus	None
industry	ile ise	Nan
injan	ẹnjinia	Nan
injans	ẹnjini	Nan
inkatha	inkatha	Nan
input	igbewọle	Nan
isblisgyn	t’olofin	Nan
international	kariaye	Nan
into	sinu	Nan
invariant	ajígun	Nan
io	io	Nan
ioan	ioan	Nan
iolo	iolo	Nan
ionawr	oṣu kini	Nan
iorddonen	jọ́dánì	Nan
internet	intanẹẹti	Nan
iw	iw	Nan
isbn	isbn	Nan
isdeulu	subfamily	Nan
israeliaid	ọmọ	None
isranbarth	subdistrict	Nan
israniadau	ipin	None
isrywogaeth	subspepes	Nan
isrywogaethau	subspepes	Nan
issn	issn	Nan
ist	aret	Nan
istanbul	tantanébúbù	Nan
istanbwl	tantanébúbù	Nan
it	rẹ	None
italaidd	italics	Nan
italiano	italiano	Nan
iv	iv	Nan
ive	ive	Nan
ives	ives	Nan
israelaiddpalesteinaidd	ọmọ	None
israelaidd	ọmọ	None
israel	israeli	Nan
isotopau	isotopes	Nan
isdrofannol	subtropical	Nan
isel	kekere	None
iseldiraidd	kekere	None
iseldireg	kekere	None
iseldiroedd	àwọn ilẹ̀ kéékèèké	Nan
iseldirwyr	onírẹlẹ	Nan
isffylwm	ẹja pẹtẹlẹ	Nan
isdeitlau	awọn atunkọ	Nan
isgoch	infurarẹẹdi	Nan
islam	islamu	Nan
islamaidd	islamic	Nan
island	erekusu	Nan
islwyn	islwyn	Nan
iso	ipin	None
isod	ni isalẹ	Nan
isopleth	isopleth	Nan
isgyfandir	iha-continent	Nan
gwersylloedd	ago	Nan
penderfyna	pinnu	Nan
penderfyniadau	awọn ipinnu	Nan
triongl	onigun mẹta	Nan
triphlyg	meteta	Nan
tripled	meteta	Nan
tripoli	tripoli	Nan
tro	nipasẹ	Nan
trochydd	ounjẹ	Nan
trodd	yipada	None
troed	ẹsẹ	None
troedfedd	ẹsẹ	None
troellwr	alẹ alẹ	Nan
troellwyr	alẹ alẹ	Nan
troes	yipada	None
trofannau	awọn nwaye	Nan
trofannol	tropical	Nan
troi	yiyi	Nan
trinidad	trinidad	Nan
troin	nipasẹ	Nan
triniaeth	itọju	Nan
trin	tọju	Nan
treisgar	iwa-ipa	Nan
trelew	trelew	Nan
trenau	awọn ọkọ oju-irin	Nan
trer	trer	Nan
tresglen	ẹṣẹ	Nan
treth	owo-ori	Nan
treuliad	walẹ	Nan
treulio	walẹ	Nan
treuliodd	o lo	Nan
tri	mẹta	Nan
triawd	meta	Nan
tribbiani	tribbiani	Nan
trigolion	olugbe	Nan
triliwn	aimọye	Nan
trimurti	trimurti	Nan
tringa	gígun	Nan
trol	kẹkẹ-ẹru	Nan
tros	lori	Nan
trosedd	ilufin	Nan
trwyddedau	awọn iwe-aṣẹ	Nan
trwyn	imu	Nan
trwynol	ti imu	Nan
trwyr	nipasẹ	Nan
trydan	ina	Nan
trydannol	itanna	Nan
trydanol	itanna	Nan
trydedd	kẹta	None
trydydd	kẹta	None
trydyddol	ile-ẹkọ giga	Nan
tryfan	inu bibi	Nan
tryfesur	opin	Nan
tryloyw	sihin	Nan
tryweryn	tryweryn	Nan
trên	ọkọ oju-irin	Nan
trwydded	iwe-aṣẹ	Nan
trwy	nipasẹ	Nan
trwm	wuwo	Nan
trwchus	nipọn	Nan
troseddau	awọn ẹṣẹ	Nan
troseddol	ọdaran	Nan
trosglwyddiant	gbigbe	Nan
trosglwyddir	gbe	None
trosglwyddo	gbigbe	Nan
trosglwyddor	atagba	Nan
trosglwyddwyd	gbe	None
treigladau	awọn iyipada	Nan
trosglwydydd	atagba	Nan
trosiad	afiwe	Nan
trosiannol	orilede	Nan
trosol	afiwe	Nan
trowyd	yipada	None
truly	iwongba	Nan
truman	trump	Nan
trwchach	aanu	None
trosi	iyipada	Nan
treialon	awọn idanwo	Nan
treftadaeth	ogún	Nan
trefol	ilu	Nan
tonga	eṣu	Nan
tonnau	igbi	Nan
tony	ikan	None
too	paapaa	None
top	oke	Nan
topograffig	àjẹjù	Nan
torah	torah	Nan
torchog	ògùṣọ	Nan
torfol	ọpọ	Nan
torri	fọ	Nan
torrin	torrin	Nan
torrir	ge	Nan
torrodd	bu	None
torrwyd	ṣẹ	Nan
town	ilu	Nan
tone	ohun orin	Nan
ton	ohun orin	Nan
tomé	si mi	Nan
tomos	àwo	Nan
tiwmor	iṣuu	Nan
tiwtonaidd	tunṣe	Nan
tlawd	talaka	None
tlodi	osi	Nan
tlotaf	talika	None
tlws	olowoiyebiye	Nan
to	orule	Nan
tra	nigba ti	Nan
tobago	tobago	Nan
together	papọ	Nan
togo	lati lọ	Nan
tokyo	tokyo	None
tolstoy	tolstoy	Nan
tom	tom	Nan
tomen	aba	Nan
tommy	ibojì	None
today	loni	Nan
tseina	ṣaina	Nan
trac	orin	Nan
traddodiad	atọwọdọwọ	Nan
trar	trar	Nan
traul	wọ ati yiya	Nan
trawiadol	yanilenu	Nan
trawsfynydd	transistor	Nan
trawsnewid	iyipada	Nan
trawyd	kọlu	Nan
tref	ilu	Nan
trefaldwyn	montgomery	Nan
trefedigaeth	ileto	Nan
trefedigaethol	amunisin	Nan
trefi	awọn ilu	Nan
trefn	paṣẹ	Nan
trefnodd	o ṣeto	Nan
trefnu	seto	Nan
trefnwyd	idayatọ	Nan
transvaal	iṣupọ	Nan
transparent	sihin	Nan
translation	translation	Nan
tran	tran	Nan
traddodiadau	aṣa	Nan
traddodiadol	ibile	None
traean	kẹta	None
traed	ẹsẹ	None
traeth	eti okun	Nan
traethau	awọn eti okun	Nan
trafferthion	wahala	Nan
traciau	awọn orin	Nan
traffig	ijabọ	Nan
trafnidiaeth	irinna	Nan
trafod	jiroro	Nan
trafodaethau	awọn ijiroro	Nan
trafododd	o jiroro	Nan
trais	iwa-ipa	Nan
trajan	trajan	Nan
tramor	ajeji	Nan
traffordd	opopona	Nan
tiwbiau	awọn iwẹ	Nan
tsiec	tsiec	Nan
tsieina	ṣaina	Nan
ugain	ogun	None
uganda	uganda	Nan
ugeinfed	ọdun keji	Nan
ugss	éú	Nan
uk	uk	Nan
ulster	ọgbẹ inu	Nan
ulysses	ulysses	Nan
umkhonto	umkhonto	Nan
un	ọkan	Nan
unarddeg	mọkanla	Nan
unben	apanirun	Nan
und	ati be be lo	Nan
undduwiaeth	monotheism	Nan
undeb	apapọ	Nan
undebol	apapọ ẹgbẹ	Nan
ue	u	Nan
under	labẹ	Nan
udd	udd	Nan
ucr	ucr	Nan
tú	iwo	Nan
tōkyō	tōkyō	Nan
tŵf	idagba	Nan
tŵr	ile-iṣọ	Nan
tŷ	ile	Nan
u	u	Nan
uc	uc	Nan
uchaf	loke	Nan
uchafbwynt	gongo	Nan
uchder	gíga	Nan
uchel	ga	Nan
ucheldiroedd	awọn oke-nla	Nan
uchelgeisiol	agbara	None
uchelwyr	awọn ọlọla	Nan
uchod	loke	Nan
uda	júdà	Nan
une	une	Nan
uned	ẹyọkan	Nan
unedau	awọn sipo	Nan
united	isọdọkan	Nan
universal	agbaye	None
university	yunifasiti	Nan
uno	iparapọ	Nan
unochrog	isọdọkan	Nan
unol	ni ibamu	Nan
unoliaethwyr	euroopu	Nan
unor	kii ṣe	Nan
unrhyw	eyikeyi	Nan
unrhywbeth	ohunkohun ti	Nan
unrwa	alaiwa	Nan
unwaith	lẹẹkan	Nan
unwyd	apapọ	Nan
unyes	oju	Nan
up	sókè	Nan
unita	unita	Nan
uniongyrchol	taara	Nan
uniongred	àtijọ	Nan
union	gangan	Nan
unedig	apapọ	Nan
unedol	ipinya	Nan
unesco	unesco	Nan
unfath	aami	Nan
unfed	kọkanla	Nan
unffurf	aṣọ	Nan
unhrc	unhrc	Nan
tîm	egbe	None
uniad	isọdọkan	Nan
unido	ìyàraẹniṣọtọ	Nan
unig	nikan	Nan
unigol	ẹnikọọkan	Nan
unigolion	olúkúlùkù	Nan
unigolyn	olúkúlùkù	Nan
unigrwydd	ipalọlọ	Nan
unigryw	alailẹgbẹ	Nan
uniaith	monolingual	Nan
tène	ọkan	Nan
tân	ina	Nan
tâl	sanwo	Nan
tunisia	tunisia	Nan
turdus	turdus	Nan
turkmenistan	turkmenistan	Nan
turner	oluṣọ	Nan
turtur	ẹyẹ	Nan
tuvalu	tuvalu	Nan
tv	tẹlifisiọnu	Nan
tweed	tọọsi	Nan
twf	idagba	Nan
twitter	twitter	Nan
twll	iho	Nan
twm	ibeji	None
twmffat	funnel	Nan
twneli	awọn tunes	Nan
two	meji	Nan
tunis	tunis	Nan
tun	tin	Nan
tueddu	ṣọ	Nan
tuedd	iwa	Nan
tsieineaidd	ṣaina	Nan
tsieinëeg	ṣaina	Nan
tsunami	tsunami	Nan
tsunamis	tsunami	Nan
tt	pp	Nan
tu	iwo	Nan
tua	feleto	Nan
twrcaidd	tooki	Nan
tuag	si ọna	Nan
tubal	tubali	Nan
tud	pg	Nan
tudalen	oju iwe	Nan
tudalennau	awọn oju-iwe	Nan
tudful	tudful	Nan
tudur	tudur	Nan
tuduriaid	ipalọlọ	Nan
tuar	awọn asọtẹlẹ	Nan
tsiecoslofacia	tsiecoslofacia	Nan
twrceg	tooki	Nan
twrciaid	tọki	Nan
tynnur	fẹẹrẹ	Nan
tynnwyd	kuro	Nan
types	awọn oriṣi	Nan
tystiolaeth	ẹri	Nan
tystion	awọn ẹlẹri	Nan
tywi	tywi	Nan
tywod	iyanrin	Nan
tywodfaen	okuta didan	Nan
tywydd	ojo	None
tywyll	dudu	Nan
tywyn	didan	Nan
tywys	itọsọna	Nan
tywysog	olori	Nan
tywysogaeth	ijoye	Nan
tywysogion	awọn ọmọ-alade	Nan
tynnu	fa	Nan
tynnodd	o fa	Nan
tynged	kadara	None
tymor	akoko	Nan
twristaidd	oniriajo	Nan
twristiaeth	irin-ajo	Nan
twristiaid	ajo	None
twyni	awọn ẹwa	Nan
tybiedig	ṣe agbelera	Nan
tyddewi	st davids	Nan
tyfiant	idagba	Nan
twrci	tọki	Nan
tyfodd	o dagba	Nan
tyfun	dagba	Nan
tyler	jeki o sele	Nan
tylluan	owiwi	Nan
tylluanod	owiwi	Nan
tylwyth	idile	Nan
tymheredd	otutu	None
tymherus	oninuuṣe	Nan
tyfu	ndagba	Nan
upon	lori	Nan
titwod	oriṣi	Nan
titus	titus	Nan
tannau	okun	Nan
tansania	tanzania	Nan
tant	okun	Nan
tanwydd	epo	Nan
tanwyddau	epo	Nan
tanzania	tanzania	Nan
tardda	pilẹṣẹ	Nan
tarddiad	oti	Nan
tarddiant	oti	Nan
tarddle	orisun	None
tarddodd	o ti ipilẹṣẹ	Nan
tarddu	oti	Nan
targedau	awọn ibi-afẹde	Nan
taro	lu	Nan
tasgau	awọn iṣẹ-ṣiṣe	Nan
tanio	ibọn	Nan
tasmania	tasmania	Nan
tango	tango	Nan
tanddaearol	ipamo	Nan
taleban	talban	Nan
taleithiau	agbegbe	Nan
tales	fun	None
talfan	iyipo	Nan
talfyriad	kikọkuro	Nan
taliesin	taliesin	Nan
talmud	talmud	Nan
talu	sanwo	Nan
talur	ga	Nan
talwrn	akukọ	Nan
talybont	afara giga	Nan
tamil	tamil	Nan
tan	tan	Nan
tanc	ojò	Nan
tanciau	awọn tanki	Nan
tangnefedd	alafia	Nan
taw	iyẹn	Nan
tawdd	didan	Nan
tawe	ipalọlọ	Nan
teigrod	ẹyẹ	Nan
teils	awọn alẹmọ	Nan
teimlad	rilara	Nan
teimladau	ikunsinu	Nan
teimlai	ro	None
teip	ikuna	Nan
teisen	akara oyinbo	Nan
teithiau	ajo	None
teithio	irin-ajo	Nan
teithiodd	ajo	None
teithwyr	ajo	None
teitl	akọle	Nan
teledu	tẹlifisiọnu	Nan
teledur	téréré	Nan
teleffon	tẹlifoonu	Nan
teigr	ẹyẹ	Nan
teifi	teifi	Nan
tehuelches	ori	None
tegla	degla	Nan
tawel	dakẹrọrọ	Nan
taylor	taylor	Nan
tchad	tchad	Nan
te	gbona	Nan
teal	tẹẹrẹ	Nan
tebot	tiipot	Nan
tebyg	jọra	Nan
talaith	igberiko	None
tebygol	seese	Nan
tebygrwydd	ibajọra	Nan
technegau	awọn imuposi	Nan
technoleg	imọ-ẹrọ	Nan
technolegol	imọ-ẹrọ	Nan
tectoneg	tectonics	Nan
tectonig	tectonic	Nan
teg	ẹwà	Nan
tebygolrwydd	iṣeeṣe	Nan
take	mu	Nan
tajikistan	tajikistan	Nan
taiwan	taiwan	Nan
symud	ronu	Nan
symuda	gbe	None
symudiad	ronu	Nan
symudiadau	awọn agbeka	Nan
symudiadaur	ronu	Nan
symudodd	gbe	None
symudol	alagbeka	Nan
symudwyd	gbe	None
symyd	gbe	None
syn	ti o jẹ	Nan
syndrom	aarun	Nan
synge	gbẹsun	Nan
synhwyrol	ni imọ	Nan
synhwyrydd	sensọ	Nan
syniad	imọran	Nan
symptomau	awọn aami aisan	Nan
syml	o rọrun	Nan
symiau	oye	Nan
symffoni	ohun afetigbọ	Nan
sylvia	sylvia	Nan
sylw	akiyesi	Nan
sylwadau	awọn asọye	Nan
sylwedd	nkan	None
sylweddau	oludoti	Nan
sylweddol	idaran	Nan
sylweddoli	mọ	Nan
syniadaeth	awọn imọran	Nan
sylweddolodd	o mọ	Nan
sylwi	akiyesi	Nan
sylwodd	o woye	Nan
sylwr	asọye	Nan
symbol	aami	Nan
symbolaidd	apẹẹrẹ	Nan
symbolau	awọn aami	Nan
symbyliad	ayun	Nan
sylwer	jọwọ ṣakiyesi	Nan
telegraph	tẹlifoonu	Nan
syniadau	awọn imọran	Nan
syrffio	hiho	Nan
tacsonomeg	asonwoori	Nan
tactegau	ilana	None
tad	baba	Nan
taf	daf	Nan
taffi	ẹyẹ tofe	Nan
taflegrau	awọn misaili	Nan
taflu	jabọ	Nan
tafod	ahọn	Nan
tafodiaith	iledìí	Nan
tafodieitheg	iledìí	Nan
tafodieithoedd	awọn iledìí	Nan
tafodieithol	iledìí	Nan
tai	ile	Nan
tair	mẹta	Nan
taith	irin-ajo	Nan
tacitus	tacitus	Nan
tachwedd	oṣu kọkanla	Nan
tabloid	tabloid	Nan
tabl	tabili	None
syria	aranmo	Nan
syrthio	ṣubu	Nan
syrthiodd	o ṣubu	Nan
system	eto	Nan
systemau	awọn ọna šiše	Nan
syth	taara	Nan
sâl	aisan	Nan
syr	sir	Nan
são	ãò	Nan
sêl	èdìdì	Nan
sêr	irawọ	Nan
sí	o n ni	Nan
sôn	mẹnuba	Nan
sŵn	ariwo	Nan
sŵoleg	ẹkọ oniye	Nan
t	p	Nan
sé	rẹ	None
titw	oriṣi	Nan
telesgop	ẹrọ iwoye	Nan
telford	telford	Nan
thri	mẹta	Nan
thrigolion	olugbe	Nan
thriller	asaragaga	Nan
thro	yiyi	Nan
throi	yiyi	Nan
throir	yiyi	Nan
thros	lori	Nan
throsglwyddo	gbigbe	Nan
through	nipasẹ	Nan
thrush	thrush	Nan
thrwy	nipasẹ	Nan
thrwyr	nipasẹ	Nan
thu	iwo	Nan
thua	nipa	Nan
thunder	ààrá	Nan
threuliodd	o lo	Nan
thwrci	tọki	Nan
threfn	paṣẹ	Nan
threfedigaethau	awọn ileto	Nan
think	ronu	Nan
thir	ilẹ	None
thiriogaeth	agbegbe	Nan
thiriogaethau	awọn agbegbe	Nan
thirwedd	ala-ilẹ	Nan
this	eyi	Nan
thomas	thomas	Nan
thomson	thomson	Nan
thoracs	thorax	Nan
those	awon na	Nan
thrace	itanran	Nan
thracia	orin	Nan
thraddodiad	atọwọdọwọ	Nan
thraddodiadau	aṣa	Nan
thref	ilu	Nan
threfi	awọn ilu	Nan
thwristiaeth	irin-ajo	Nan
thyfiant	idagba	Nan
thyfodd	o dagba	Nan
tirfeddianwyr	onile	Nan
tirffurf	ilẹ	None
tirffurfiau	landforms	Nan
tirgaeedig	ilẹ	None
tiriogaeth	agbegbe	Nan
tiriogaethau	awọn agbegbe	Nan
tiriogaethaur	awọn agbegbe	Nan
tirlun	ala-ilẹ	Nan
tiroedd	ilẹ	None
tirwedd	ala-ilẹ	Nan
tit	titẹsi	Nan
titan	titan	Nan
title	akọle	Nan
titles	awọn akọle	Nan
tito	tito	Nan
tirfeddiannwr	onile	Nan
tir	ilẹ	None
tipyn	kan	None
tinwen	tinwen	Nan
thymheredd	otutu	None
thŷ	ilé	None
ti	iwo	Nan
tiberius	tiberius	Nan
tibet	tibet	Nan
tibetiaid	tibettes	Nan
tierra	tierra	Nan
thing	ohun	Nan
tiger	ẹyẹ	Nan
tim	aago	Nan
time	aago	Nan
times	awọn akoko	Nan
timor	gẹẹsi	Nan
timothy	timoti	Nan
tin	tin	Nan
tingoch	pupa	None
tigris	tigris	Nan
they	wọn	None
theulu	idile	Nan
these	iwọnyi	Nan
testament	majemu	Nan
testun	ọrọ	Nan
testunau	awọn ọrọ	Nan
tetanws	ẹtan	Nan
teth	gbona	Nan
teulu	idile	Nan
teuluoedd	idile	Nan
teuluol	idile	Nan
tewdwr	nipọn	Nan
texas	texas	Nan
text	ọrọ	Nan
texts	awọn ọrọ	Nan
teyrn	ijọba	Nan
teyrnas	ijọba	Nan
teyrnasiad	jọba	Nan
terry	ilẹkun	Nan
tern	tern	Nan
terms	ofin	None
terminoleg	imọ-jinlẹ	Nan
telid	yoo	None
tell	sọ	None
telor	jagunjagun	Nan
teloriaid	jagunjagun	Nan
telyn	harp	Nan
teml	tẹmpili	Nan
tenis	tẹnisi	Nan
teyrnasodd	o jọba	Nan
tennessee	tennessee	Nan
terence	terence	Nan
teresa	teresa	Nan
terfyn	to	None
terfyniad	ifopinsi	Nan
terfysgol	apanilaya	Nan
term	igba	Nan
termau	ofin	None
tensiynau	aifokanbale	Nan
television	tẹlifisiọnu	Nan
teyrnasoedd	awọn ijọba	Nan
teyrngarwch	iṣootọ	Nan
theledu	tẹlifisiọnu	Nan
thema	akori	Nan
themar	wọn	None
thembu	wọnbu	Nan
themâu	awọn akori	Nan
then	lẹhinna	Nan
theo	ẹmọ	Nan
theodore	theodore	Nan
theodosius	theodosius	Nan
theori	yii	Nan
theorïau	awọn imọ-jinlẹ	Nan
there	ní	None
theres	awọn iṣan	Nan
thermodynameg	thermodynamics	Nan
thermol	igbona	Nan
theithio	irin-ajo	Nan
their	sọ	None
thebyg	jọra	Nan
theatrau	imiran	Nan
teyrnged	oriyin	Nan
th	th	Nan
thactegau	ilana	None
thad	baba	Nan
thai	ile	Nan
thaid	agba	None
thair	mẹta	Nan
teyrnasu	jọba	Nan
thalaith	igberiko	None
than	ju	Nan
thannau	ina	Nan
that	iyẹn	Nan
thatcher	alagbata	Nan
thats	iyẹn	Nan
theach	ilé	None
theatr	itage	Nan
thames	thames	Nan
sylffwr	efin	Nan
ur	ur	Nan
urddau	bibere	Nan
ymerawdwr	olú ọba	Nan
ymerodr	olú ọba	Nan
ymerodraeth	ọba	Nan
ymerodraethau	awọn ilu	Nan
ymerodraethol	olú ọba	Nan
ymerodres	emiri	Nan
ymerodrol	ọba	Nan
ymerodron	olú ọba	Nan
ymestyn	na	Nan
ymestynnodd	o gbooro	Nan
ymfudo	ijira	Nan
ymfudodd	iṣilọ	Nan
ymfudwyr	emigrant	Nan
ymgais	igbiyanju	Nan
ymgarthion	faeces	Nan
ymerawdr	olú ọba	Nan
ymgartrefu	yanu	Nan
ymeradwr	awọn ifọwọsi	Nan
ymdrin	ibaṣowo	Nan
ymddangosodd	han	Nan
ymddengys	o dabi pe	Nan
ymddeol	ifẹhinti	Nan
ymddiriedolaeth	gbekele	Nan
ymddiswyddiad	itusilẹ	Nan
ymddiswyddo	ipo	None
ymddiswyddodd	sile	None
ymddoleniad	ìsírasílẹ	Nan
ymddwyn	huwa	Nan
ymddygiad	ihuwasi	Nan
ymddygiadau	awọn ihuwasi	Nan
ymdeimlad	ori	None
ymdoddiad	ifun	Nan
ymdrech	akitiyan	Nan
ymdrechion	akitiyan	Nan
ymennydd	ọpọlọ	Nan
ymgeiswyr	oludije	Nan
ymgiprys	jiyan	Nan
ymgorfforwyd	dapọ	Nan
ymosod	kọlu	Nan
ymosodiad	kọlu	Nan
ymosodiadau	ku	None
ymosodiadaur	awọn olukopa	Nan
ymosododd	o kọlu	Nan
ymosodol	ibinu	Nan
ymosodwyd	ti kolu	Nan
ymostwng	tẹriba	Nan
ymostyngiad	tẹriba	Nan
ymraniad	pin	Nan
ymrannu	pin	Nan
ymreolaeth	ijọba ara ẹni	Nan
ymreolaethol	adase	Nan
ymrithiad	idalọwọduro	Nan
ymryson	ariyanjiyan	Nan
ymlynwyr	awọn alafaramọ	Nan
ymlusgiaid	reptiles	Nan
ymledu	tànkálẹ	Nan
ymledodd	o tan ka	Nan
ymgynghorol	imọran	Nan
ymgyrch	ipolongo	Nan
ymgyrchoedd	awọn ipolongo	Nan
ymgyrchu	npolongo	Nan
ymgyrchwyr	olupolowo	Nan
ymgyrchydd	olupolongo	Nan
ymhell	jinna	Nan
ymddangosiad	hihan	Nan
ymhellach	siwaju	Nan
ymhlith	laarin	None
ymhob	ninu gbogbo	Nan
ymhobman	ibi gbogbo	Nan
ymladd	ija	Nan
ymladdodd	ó	None
ymladdwyd	won ja	Nan
ymlaen	loju	Nan
ymhen	bajẹ	Nan
ymddangos	han	Nan
ymchwilio	iwadii	Nan
ymchwiliad	iwadii	Nan
xiaoping	xiaoping	Nan
xii	xii	Nan
xiii	xiii	Nan
xpx	xpx	Nan
xyz	xyz	Nan
y	awọn	Nan
ya	ya	Nan
yamuna	iṣuna	Nan
ych	akọmalu	Nan
ychen	malu	Nan
ychwaith	boya	Nan
ychwanegiadau	awọn afikun	Nan
ychwanegir	fi	None
ychwanegodd	fi	None
ychwanegol	afikun	Nan
xi	xi	Nan
x	x	Nan
wŷr	okunrin	None
wythïen	iṣọn	Nan
wyn	funfun	Nan
wyneb	oju	Nan
wynebu	oju	Nan
wynebur	oju	Nan
wynedd	gwynedd	Nan
wynion	funfun	Nan
wynne	ọpọlọpọ	Nan
ychwanegu	ṣafikun	Nan
wyntoedd	efuufu	Nan
wyrdd	ewe	None
wyt	se o	Nan
wyth	mẹjọ	Nan
wythfed	ikẹjọ	Nan
wythnos	kan	None
wythnosol	sẹsẹ	Nan
wythwr	mẹjọ	Nan
wyntyll	àìpẹ	Nan
ymsefydlodd	o yanju	Nan
ychwanegwyd	fi	None
ydd	ed	Nan
ymadael	ilọkuro	Nan
ymadawiad	ilọkuro	Nan
ymadrodd	gbolohun ọrọ	Nan
ymadroddion	awọn ikosile	Nan
ymaith	kuro	Nan
yman	nibi	Nan
ymarfer	adaṣe	Nan
ymarferiadau	awọn adaṣe	Nan
ymarferol	ilowo	Nan
ymarferwyr	awọn oṣiṣẹ	Nan
ymasiad	ifun	Nan
ymateb	esi	Nan
ymatebodd	o dahun	Nan
ymbelydredd	itu	None
ymchwil	iwadii	Nan
yma	nibi	Nan
ym	ym	Nan
yi	yi	Nan
yfed	inu mimu	Nan
ydoedd	oun	None
ydw	bẹẹni	Nan
ydy	bẹẹni	Nan
ydych	ti o ba wa	Nan
ydym	a wa	Nan
ydyn	bẹẹni	Nan
ydynt	wọn	None
ychydig	kekere	None
ydyr	oun	None
ydywr	bẹẹni	Nan
year	ọdun	Nan
years	ọdun	Nan
yeats	iwukara	Nan
yellow	odo	Nan
yemen	yemen	Nan
yerevan	yerevan	Nan
ydyw	oun	None
wylwyr	awọn oluwo	Nan
ymsefydlu	fifa irọbi	Nan
ymuno	darapo	None
ystyrid	o ti fiyesi	Nan
ystyried	ronu	Nan
ystyrir	ṣakiyesi	Nan
ystyriwyd	ṣakiyesi	Nan
ystyron	itumo	None
ystâd	ohun-ini	Nan
yswiriant	aṣeduro	Nan
yu	yu	Nan
yunis	yunis	Nan
yw	jẹ	Nan
ywn	yò	Nan
ywr	awọn	Nan
z	z	Nan
zambia	zambani	Nan
zamenhof	zamenhof	Nan
ystyria	ronu	Nan
zedong	zedong	Nan
ystyr	itumo	None
ystwyll	abori	Nan
ysgrifennodd	o kọ	Nan
ysgrifennu	kikọ	Nan
ysgrifennur	kikọ	Nan
ysgrifennwyd	kọ	Nan
ysgrifennydd	akọwe	Nan
ysgrifenwyd	ti kọ	Nan
ysgubol	gbigba	Nan
ysgwydd	ejika	Nan
ysgyfaint	ẹdọforo	Nan
ystadegaeth	eeka	Nan
ystadegau	eeka	Nan
ystafell	yara	Nan
ystlum	adan	Nan
ystod	ibiti	None
ystorfa	ibi ipamọ	Nan
ystwyth	agin	Nan
zeno	zeno	Nan
zenobia	zenobia	Nan
zeppelin	zeppelin	Nan
ên	eegun	Nan
île	islay	Nan
ïonau	ion	Nan
ôl	sẹhin	Nan
ôlfywyd	lẹhin igbesi aye	Nan
ühtenzoittud	ühtenzoittud	Nan
ütsang	ütsang	Nan
ŵy	ẹyin	Nan
ŵyl	ajọdun	Nan
ŵyr	ọmọ-ọmọ	Nan
ŷd	agbado	None
ɪ	ɪ	Nan
˚c	˚c	Nan
و	ati	Nan
€	€	Nan
éire	orile-ede ireland	Nan
é	rẹ	None
âu	wọn	None
âr	arable	Nan
zetajones	awọn agbegbe ita	Nan
zimbabwe	zimbabwe	Nan
zubizarreta	zubizarreta	Nan
zur	zur	Nan
zygotic	zygotic	Nan
km²	km²	Nan
m	m	Nan
ysgrifennir	o ti kọ	Nan
  	  	Nan
°c	° c	Nan
×	×	Nan
×km	km	Nan
átha	ṣeéṣe	Nan
â	pẹlu	Nan
âi	yoo	None
ânt	yoo	None
°c	° c	Nan
ysgrifenedig	kọ	Nan
ysgrifen	kikọ	Nan
ysgrifau	awọn iwe	Nan
ynganiad	ìpolongo	None
ynganu	ìpolongo	None
yngenir	oyè	Nan
ynghanol	ni aarin	Nan
ynghau	sunmọ	Nan
ynghlwm	somọ	Nan
ynghyd	papọ	Nan
ynghylch	nipa	Nan
ynghynt	sẹyìn	Nan
ynghŷd	papọ	Nan
ynglyn	nipa	Nan
ynglŷn	nipa	Nan
ynni	agbara	None
ynnir	eeru	Nan
yno	ní	None
yng	ninu	Nan
ynddynt	wọn	None
ynddo	ninu e	Nan
ynddi	ninu e	Nan
ymunodd	darapo	None
ymweld	ṣàbẹwò	Nan
ymweliad	ṣàbẹwò	Nan
ymwelodd	o ṣàbẹwò	Nan
ymwelwyr	àlejò	Nan
ymwneud	lowo	Nan
ymwybodol	mimọ	Nan
yntau	oun	None
ymwybyddiaeth	imo	Nan
ymylon	igun	Nan
ymyriad	ilowosi	Nan
ymyrraeth	kikọlu	Nan
ymysg	laarin	None
yn	ninu	Nan
yna	lẹhinna	Nan
ynan	ní	None
ymyl	eti	Nan
ymsefydlwyr	atipo	Nan
ynydiad	fesi	Nan
ynydu	lẹhinna	Nan
ysbrydoli	iwuri	Nan
ysbrydolodd	o atilẹyin	Nan
ysbytai	iwosan	None
ysbyty	ile-iwosan	Nan
ysgafn	ina	Nan
ysgafnach	fẹẹrẹ	Nan
ysgarodd	o kọsilẹ	Nan
ysgarthu	ayẹyẹ	Nan
ysgerbwd	egungun	Nan
ysgol	ile-iwe	Nan
ysgolhaig	omowe	Nan
ysgolheictod	sikolashipu	Nan
ysgolheigion	awọn ọjọgbọn	Nan
ysgolion	awọn ile-iwe	Nan
ysgrif	aroko	Nan
ysbrydol	nípa tẹ̀mí	Nan
ysbrydion	iwin	Nan
ysbryd	ẹmi	Nan
ysblander	ologo	Nan
ynys	erekusu	Nan
ynysfor	ile ikawe	Nan
ynysig	ti ya sọtọ	Nan
ynysoedd	erekusu	Nan
ynysu	ìyàraẹniṣọtọ	Nan
yoko	yoko	Nan
york	york	None
ynydiadau	awọn iyọrisi	Nan
you	iwo	Nan
your	rẹ	None
yours	tirẹ	Nan
ypres	ypres	Nan
yr	awọn	Nan
yrfa	iṣẹ	Nan
yrru	wakọ	Nan
ysbeidiol	laipẹ	Nan
young	odo	Nan
urdd	paṣẹ	Nan
wyllt	egan	Nan
wylio	wiwo	Nan
walter	walter	Nan
wan	ailera	Nan
wanna	fẹ	Nan
want	fẹ	Nan
war	ogun	None
warbler	jagunjagun	Nan
warchae	dotì	Nan
warchod	ni idaabobo	Nan
wareiddiad	ọlaju	Nan
warner	onilọ	Nan
warranty	atilẹyin ọja	Nan
warren	warren	Nan
wars	ogun	None
warsaw	warsaw	Nan
warszawa	warszawa	Nan
walt	walt	Nan
was	wà	Nan
walonia	walonia	Nan
wallace	wallace	Nan
waethaf	buru	Nan
wag	ofo	Nan
wagtail	wagtail	Nan
wahan	yatọ	Nan
wahaniaeth	iyato	None
wahaniaethau	awọn iyatọ	Nan
wahaniaethu	iyasoto	Nan
wahanol	yatọ	Nan
wahardd	leewọ	Nan
wahân	yàtò	None
wain	obo	Nan
waldo	waldo	Nan
wales	oyo	Nan
walk	rìn	None
wall	aṣiṣe	Nan
wallgof	irikuri	Nan
wasanaeth	iṣẹ	Nan
wasanaethau	awọn iṣẹ	Nan
wasg	tẹ	Nan
weddol	iṣẹtọ	Nan
wedi	ní	None
wedii	lẹhin	Nan
wedir	sọ	None
wediu	lẹhin	Nan
wediw	lẹhin	Nan
wedyn	lẹhinna	Nan
wefan	aaye ayelujara	Nan
weimar	weimar	Nan
weinidog	òjíṣẹ́	Nan
weinidogion	minisita	Nan
weinyddol	isakoso	Nan
weir	okun waya	Nan
weithgar	lọwọ	Nan
weithgaredd	ìṣe	Nan
weddill	isimi na	Nan
web	wẹẹbu	Nan
we	wẹẹbu	Nan
wcráin	yukirenia	Nan
wasgar	tuka	Nan
wasgedd	titẹ	Nan
washington	aṣọ iwẹ	Nan
wastad	nigbagbogbo	Nan
wastadedd	ipalọlọ	Nan
wastadeddau	ipele	None
water	omi	None
waelod	isalẹ	Nan
waters	omi	None
watkins	iṣọṣọ	Nan
watson	watson	Nan
watt	watt	Nan
waugh	waugh	Nan
waun	moorland	Nan
wawr	owurọ	Nan
way	ọna	Nan
watkin	watkin	Nan
wael	aisan	Nan
waed	ẹ̀jẹ̀	Nan
w	w	Nan
valdkundad	valdkundad	Nan
valens	valens	Nan
valerian	valerian	Nan
valiente	valiente	Nan
valletta	valletta	Nan
van	ayokele	Nan
vanellus	fanila	Nan
vanuatu	vanuatu	Nan
vas	vas	Nan
vaughan	vaughan	Nan
veda	veda	Nan
vegas	vegas	Nan
veneris	veneris	Nan
venezuela	venezuela	None
vepamerikan	vepamerikan	Nan
val	ẹru	Nan
vaduz	vaduz	Nan
v	v	Nan
uíbh	ẹyin	Nan
urien	urien	Nan
url	url	Nan
uruguay	urur	Nan
us	àwa	Nan
us$	us $	Nan
use	lo	Nan
used	ti lo	Nan
verde	verde	Nan
usher	usher	Nan
utcutc	utcutc	Nan
utrecht	utrecht	Nan
uwch	ga	Nan
uwchben	loke	Nan
uwchdestun	agba	None
uwchradd	atẹle	Nan
uzbekistan	uzbekistan	Nan
utc	utc	None
weithgareddau	akitiyan	Nan
verdun	verdun	Nan
versailles	wapọ	Nan
visayas	visayas	Nan
vishnu	vishnu	Nan
vita	vita	Nan
vitellius	vitellius	Nan
vitiligo	vitiligo	Nan
vivian	ará vivian	Nan
vlaams	vlaams	Nan
vlaamse	vlaamse	Nan
voice	ohun	Nan
von	von	Nan
vous	alagbara	Nan
voyager	ajo	None
vulgaris	vulgaris	Nan
vulpes	awọn irubọ	Nan
vun	vun	Nan
virginia	wundia	Nan
virgin	wundia	Nan
vireo	vireo	Nan
viola	viola	Nan
version	ẹya	Nan
versions	awọn ẹya	Nan
very	pupọ	Nan
vi	vi	Nan
vicksburg	vicksburg	Nan
victor	segun	Nan
victoria	iṣẹgun	Nan
verrocchio	verrocchio	Nan
victory	isegun	Nan
vientiane	vientiane	Nan
vii	vii	Nan
viii	viii	Nan
villa	villa	None
vincent	vincent	Nan
vinci	vinci	Nan
vinnie	vinnie	Nan
video	fidio	Nan
wylit	daradara	Nan
weithiau	nigbami	Nan
weithio	iṣẹ	Nan
wneud	ṣe	Nan
wo	wo	Nan
wobr	joju	Nan
wobrau	onipokinni	Nan
wolf	ikooko	Nan
wolfgang	wolfgang	Nan
wonder	iyalẹnu	Nan
wood	igi	Nan
woolf	ajé	Nan
word	ọrọ	Nan
work	iṣẹ	Nan
works	ṣiṣẹ	Nan
world	agbaye	None
would	yoo	None
wrach	ajẹ	Nan
wneir	ṣe	Nan
wrachod	awọn ajẹ	Nan
wnaeth	o ṣe	Nan
wlster	oluṣeto	Nan
with	pẹlu	Nan
without	laisi	Nan
wives	aya	None
wiwer	squirrel	Nan
wj	wj	Nan
wlad	orilẹ-ede	Nan
wladfa	ileto	Nan
wladgarol	olufẹ orilẹ-ede	Nan
wladwriaeth	ipinle	Nan
wladwriaethau	awọn ipinlẹ	Nan
wladychwyd	yípo	Nan
wledig	igberiko	None
wledydd	awọn orilẹ-ede	Nan
wleidyddiaeth	oselu	Nan
wleidyddol	oselu	Nan
wnaed	ṣe	Nan
wragedd	obinrin	Nan
wraidd	gbongbo	None
wraig	iyawo	None
wybod	mọ	Nan
wybodaeth	alaye	Nan
wyddbwyll	chess	Nan
wyddeleg	irish	Nan
wyddelig	irish	Nan
wyddfa	egbon snowdon	Nan
wyddgrug	molo	Nan
wyddom	a mọ	Nan
wyddoniaeth	imọ-jinlẹ	Nan
wyddonol	sayensi	Nan
wyddonwyr	sayensi	Nan
wyddor	abidi	None
wyddys	ni a mo	Nan
wydr	gilasi	Nan
wyliau	awọn isinmi	Nan
wyau	ẹyin	Nan
ww	ww	Nan
wrthwynebu	nnkan	Nan
wrthwynebiad	àtakò	Nan
wral	éù	Nan
wrando	nfeti	Nan
wranws	uranu	Nan
wrdw	urdu	Nan
wrecsam	wrexham	Nan
wreiddiol	ni akọkọ	Nan
wres	igbona	Nan
witches	awọn ajẹ	Nan
wrethra	ile ito	Nan
wrthdaro	rogbodiyan	None
wrthi	rẹ	None
wrtho	fún un	Nan
wrthrych	nnkan	Nan
wrthryfel	iṣọtẹ	Nan
wrthryfeloedd	ọlọ̀tẹ̀	Nan
wrthsefyll	tako	Nan
wrth	nigbawo	Nan
witchcraft	ajẹ	Nan
witch	ajẹ	Nan
wisg	aṣọ	Nan
wenwynig	majele	Nan
werdd	ewe	None
were	wà	Nan
werin	eniyan	Nan
weriniaeth	olominira	Nan
weriniaethol	olominira	Nan
weriniaethwyr	olominira	Nan
wersi	awọn ẹkọ	Nan
werth	tọ	Nan
werthodd	o ta	Nan
werthu	ta	Nan
wessex	wessex	Nan
west	iwọ oorun	Nan
westeion	awon alejo	Nan
western	iwọ oorun	Nan
wen	funfun	Nan
wely	ibusun	Nan
welwyd	ti ri	Nan
welwch	ṣe o ri	Nan
weithior	iṣẹ	Nan
weithred	iṣe	Nan
weithrediad	isẹ	Nan
weithredoedd	awọn iṣẹ	Nan
weithredol	actively	Nan
weithredu	ìṣe	Nan
weithwyr	oṣiṣẹ	Nan
whale	ẹja	Nan
weladwy	han	Nan
welir	ti ri	Nan
well	dara julọ	Nan
wella	imudarasi	Nan
wellington	alafia	Nan
wells	kanga	Nan
welodd	o ri	Nan
welsh	àwæn	Nan
weld	wo	Nan
weithiaun	ṣiṣẹ	Nan
what	kini	Nan
wheeler	wheeler	Nan
wikimedia	wikimedia	Nan
wikipedia	wikipedia	Nan
wil	wil	Nan
wilhelm	wilhelm	Nan
willem	willem	Nan
william	william	Nan
williams	williams	Nan
williamson	williamson	Nan
wilsons	wilsons	Nan
win	waini	Nan
wind	afẹfẹ	Nan
windows	windows	Nan
winfrey	winfrey	Nan
winston	winston	Nan
wir	nitootọ	Nan
wien	wi	Nan
wicitestun	wiki	Nan
wicipedwyr	awọn ara ilu wikipedians	Nan
wicipedia	wikipedia	Nan
when	nigbawo	Nan
which	ewo	Nan
white	funfun	Nan
who	àjọ who	Nan
whole	gbogbo	Nan
wib	lẹsẹkẹsẹ	Nan
wica	wica	Nan
wheatear	wheatear	Nan
wicaid	wickets	Nan
wicca	wicca	Nan
wiced	wicket	Nan
wici	wiki	Nan
wiciadur	wiktionary	Nan
wiciaid	awọn afọju	Nan
wicifryngau	wifi	Nan
wicilyfrau	awọn iwe ipamọ	Nan
wicaidd	eniyan buburu	Nan
sylfaenydd	oludasile	Nan
sylfaenol	ipilẹ	Nan
sylfaen	ipile	Nan
raglen	eto	Nan
raglenni	awọn eto	Nan
ragor	diẹ sii	Nan
ragweld	ifojusona	Nan
rai	diẹ ninu	Nan
raid	gbọdọ	Nan
railway	reluwe	Nan
ralph	ralph	Nan
ralphie	ralphie	Nan
rama	rama	Nan
ramsay	ramsay	Nan
ran	apakan	Nan
ranbarth	ẹkùn	Nan
ranbarthau	awọn ẹkun ni	Nan
ranbarthol	agbegbe	Nan
ragfyr	oṣu kejila	Nan
randstad	ogun	None
rafah	raafá	Nan
radiws	ologbo	Nan
qomolangma	qomolangma	Nan
quarrying	ariyanjiyan	Nan
queen	ayaba	Nan
queens	awọn ayaba	Nan
quincy	quincy	Nan
quinnell	quinnell	Nan
quran	quran	None
r	r	Nan
rachel	aṣọ awọleke	Nan
racial	ẹlẹyamẹya	Nan
radd	ìyí	Nan
raddau	iwọn	Nan
raddfa	ìwọn	Nan
raddol	di .di.	Nan
radio	redio	Nan
rafael	ẹyẹ	Nan
randy	olufẹ	Nan
raniadau	ipin	None
rannau	awọn ẹya	Nan
recordiodd	o gbasilẹ	Nan
records	awọn igbasilẹ	Nan
rectwm	onigun	Nan
red	pupa	None
redbreasted	atunkọ	Nan
redeg	nṣiṣẹ	Nan
rednecked	ti tunṣe	Nan
redpoll	pupa	None
redstart	atunto	Nan
redthroated	tunṣe	Nan
reed	di	Nan
reference	itọkasi	Nan
refferendwm	idapada	Nan
región	ilana	None
regulus	regulus	Nan
recordio	gbigbasilẹ	Nan
recordiau	awọn igbasilẹ	Nan
recordiad	gbigbasilẹ	Nan
record	igbasilẹ	Nan
rannu	pin	Nan
rannur	pipin	Nan
ransh	sáré	Nan
ras	ije	None
rasio	ije	None
rattigan	rattigan	Nan
ravel	rave	Nan
qatar	qatar	Nan
rawson	rawson	Nan
raymond	pupa	None
rb	rb	Nan
read	ka	Nan
reading	kika	Nan
reagan	reagan	Nan
real	gidi	Nan
really	lootọ	Nan
ray	eegun	Nan
q	q	Nan
pŵer	agbara	None
pêldroedwr	ẹlẹsẹ ẹlẹsẹ	Nan
pwerus	alagbara	Nan
pwll	adagun-odo	Nan
pwllheli	pwllheli	Nan
pwmp	fifa soke	Nan
pwmpior	elegede	Nan
pwnc	koko	Nan
pwnig	pọn	Nan
pwrpas	idi	Nan
pws	ọfun	Nan
pwy	àjọ who	Nan
pwyl	pólándì	Nan
pwyleg	pólándì	Nan
pwyliaid	awọn ọpá	Nan
pwyll	pele	None
pwyllgor	igbimo	Nan
pwerau	agbara	None
pusilla	ìromi	Nan
purt	omi	None
purple	elese	Nan
prysur	nṣiṣe lọwọ	Nan
príncipe	itẹwe	Nan
ptolemi	ptolemi	Nan
public	gbangba	Nan
publish	jade	Nan
published	atejade	Nan
publisher	akede	Nan
pwynt	ojuami	Nan
publishers	awọn olutẹjade	Nan
puffinus	puffinus	Nan
pum	marun	Nan
pumed	karun	None
pumlumon	pumlumoni	Nan
pump	marun	Nan
punt	ọkan iwon	Nan
pur	mimọ	Nan
puerto	puerto	Nan
regum	atunto	Nan
pwyntiau	awọn aaye	Nan
pwysicaf	pataki julọ	Nan
px|de|bawd|telor	px | de | bawd | igbona	Nan
px|de|gwledydd	px | de | awọn orilẹ-ede	Nan
px|ewin	px | eekanna	Nan
px|gwyddoniaeth	px | imọ	Nan
pyllau	awọn adagun-omi	Nan
pynciau	wonyen	Nan
pyreneau	pyrenees	Nan
pysgod	ẹja	Nan
pysgodyn	ẹja	Nan
pysgota	ipeja	Nan
pâl	puffin	Nan
pâr	meji	Nan
pêl	bọọlu	Nan
pêldroed	bọọlu	Nan
pêldroediwr	ẹlẹsẹ ẹlẹsẹ	Nan
px|de|bawd|bras	px | de | bawd | bras	Nan
px|dde|ewin	px | ọtun | eekanna	Nan
px|bawd|y	px | bawd | y	Nan
px|bawd|rhan	px | atan | | apakan	Nan
pwysig	pataki	Nan
pwysigrwydd	pataki	Nan
pwyslais	tcnu	Nan
pwysleisio	tẹnumọ	Nan
pwyso	ṣe iwọn	Nan
px	px	Nan
px|	px |	Nan
pwysau	titẹ	Nan
px|baner	px | asia	Nan
px|bawd|castell	px | atanpako | kasulu	Nan
px|bawd|de|y	px | bawd | de | y	Nan
px|bawd|hen	px | atan | | gboo	Nan
px|bawd|lleoliad	ipo	None
px|bawd|llun	px | atanpako | aworan	Nan
px|bawd|logo	px | bawd | àmi	Nan
px|bawd|map	maapu	None
px|bawd|baner	px | atanpako | asia	Nan
prynu	ra	None
reilffordd	reluwe	Nan
released	tu silẹ	Nan
rhodri	rìn	None
rhoi	fifun	Nan
rhoir	fifun	Nan
rholyddion	rollers	Nan
rhonabwy	rhonabwy	Nan
rhondda	fifun	Nan
rhosgadfan	iyipo	Nan
rhosneigr	rhosneigr	Nan
rhostio	rosoti	Nan
rhosyn	dide	Nan
rhosynnau	roses	Nan
rhowch	fifun	Nan
rhuban	tẹẹrẹ	Nan
rhuddlan	ẹwẹ-kekere	Nan
rhufain	lomu	Nan
rhoddwyd	fifun	Nan
rhufeiniad	romanization	Nan
rhoddodd	fun	None
rhoda	fifun	Nan
rhestru	kikojọ	Nan
rheswm	idi	Nan
rhesymau	awọn idi	Nan
rhew	yìnyín	Nan
rhewlifoedd	glaciers	Nan
rhewogydd	firisa	Nan
rhiannon	rhiannon	Nan
rhieni	awọn obi	Nan
rhif	rárá	Nan
rhifau	awọn nọmba	Nan
rhinoplasti	rhinoplasty	Nan
rhinwedd	rere	None
rhisiart	epo igi	Nan
rhith	iruju	Nan
rhod	rìn	None
rhoddir	fifun	Nan
rhufeiniaid	róòmù	Nan
rhufeinig	roman	Nan
rhufeinwyr	roman	Nan
rhyddion	ọfẹ	Nan
rhydwen	okùn didẹ	Nan
rhydychen	oxford	Nan
rhyfedd	ajeji	Nan
rhyfeddod	iyalẹnu	Nan
rhyfeddol	iyalẹnu	Nan
rhyfel	ogun	None
rhyfela	ogun	None
rhyfelgyrch	ipolongo	Nan
rhyfeloedd	ogun	None
rhyfelwr	jagunjagun	Nan
rhyl	agba	None
rhyngddi	oun	None
rhyngddisgyblaethol	ajọṣepọ	Nan
rhyngddynt	laarin	None
rhyddid	ominira	Nan
rhyddiaith	prose	Nan
rhyddhawyd	tu silẹ	Nan
rhyddhau	itusilẹ	Nan
rhuthun	ruthin	Nan
rhwng	laarin	None
rhwydwaith	nẹtiwọọki	Nan
rhwydweithiau	awọn nẹtiwọki	Nan
rhwydweithio	nẹtiwọki	Nan
rhwystr	idiwọ	Nan
rhwystro	ṣe idiwọ	Nan
rhestri	awọn akojọ	Nan
rhy	paapaa	None
rhybuddio	ikilọ	Nan
rhybuddiodd	o kilo	Nan
rhyd	ṣeéṣe	Nan
rhydd	larọwọto	Nan
rhydderch	ọrọ ọfẹ	Nan
rhyddfrydol	olutayo	Nan
rhyddhaodd	o tu	Nan
rhybudd	ikilọ	Nan
rhestr	atokọ	Nan
rhesi	ori	None
rhes	kana	Nan
resymau	awọn idi	Nan
reykjavík	reykjavík	Nan
reynolds	reynolds	Nan
rh	rh	Nan
rhad	olowo poku	Nan
rhag	boya	Nan
rhagenwau	awọn iṣapẹẹrẹ	Nan
rhagflaenydd	royi	Nan
rhagfyr	oṣu kejila	Nan
rhaglen	eto	Nan
rhaglenni	awọn eto	Nan
rhaglennu	siseto	Nan
rhagor	diẹ sii	Nan
rhagweld	ifojusona	Nan
rhai	diẹ ninu	Nan
reswm	idi	Nan
restrir	ṣe akojọ	Nan
restr	atokọ	Nan
responsible	lodidi	Nan
remus	atunṣe	Nan
rennir	pin	Nan
reolaeth	iṣakoso	Nan
reolai	ilana	None
reolau	ofin	None
reoli	iṣakoso	Nan
reolir	ti ṣakoso	Nan
rhaid	o gbọdọ	Nan
reolwyr	iṣakoso	Nan
república	olominira	Nan
required	beere	Nan
requirement	ibeere	Nan
requires	nilo	Nan
res	res	Nan
resbiradaeth	atẹgun	Nan
resbiradu	atẹgun	Nan
republic	olominira	Nan
reis	iresi	Nan
rhain	iwọnyi	Nan
rhamantus	ti alefi ife han	Nan
rheilffordd	reluwe	Nan
rheilffyrdd	ọkọ oju-irin	Nan
rhein	iwọnyi	Nan
rheini	awon na	Nan
rhengoedd	ipo	None
rheniwm	rhenium	Nan
rhennir	o pin	Nan
rheol	ṣàkóso	Nan
rheolaeth	iṣakoso	Nan
rheolaidd	nigbagbogbo	Nan
rheolau	ofin	None
rheoli	iṣakoso	Nan
rheolir	dari	Nan
rheolwr	oluṣakoso	Nan
rheolwyr	awọn alakoso	Nan
rheidol	rheidol	Nan
rhegennod	ede	None
rhegen	rhegen	Nan
rhedwyr	asare	Nan
rhan	apakan	Nan
rhanbarth	ẹkùn	Nan
rhanbarthau	awọn ẹkun ni	Nan
rhanbarthol	agbegbe	Nan
rhaniad	pin	Nan
rhannau	awọn ẹya	Nan
rhannodd	o pin	Nan
rhamant	fifehan	Nan
rhannol	ni apakan	Nan
rhannun	pin	Nan
rhannur	pinpin	Nan
rhannwyd	ti pin	Nan
rhatach	din	None
rhed	sáré	Nan
rhedeg	nṣiṣẹ	Nan
rhediad	sáré	Nan
rhannu	pin	Nan
rhynglywodraethol	ajọṣepọ ajọṣepọ	Nan
prynhawn	ọsán	Nan
pryf	kan	None
phoblogaeth	olugbe	Nan
phoblogrwydd	gbaye-gbale	Nan
phocaena	ẹṣẹ	Nan
phoebe	phoebe	Nan
phoenicurus	irora	Nan
pholisïau	imulo	Nan
phont	afara	Nan
phosibl	ṣeeṣe	Nan
php	php	Nan
phrif	akọkọ	Nan
phrifddinas	olú ìlú	Nan
phrifysgol	yunifasiti	Nan
phriodas	igbeyawo	None
phriodi	iyawo	None
phriodweddau	awọn ohun-ini	Nan
phobl	eniyan	Nan
phryd	nigbawo	Nan
phob	gbogbo	Nan
phleidlais	dibo	Nan
pheasant	epa	None
phedwar	mẹrin	Nan
pheiriannau	ero	Nan
phen	ori	None
phensaernïaeth	faaji	Nan
phentrefi	abule	Nan
pherfformio	sise	None
pheriw	ara ilu peruvian	Nan
pherthynas	ibatan	Nan
phil	phil	Nan
philadelphia	foladelphia	Nan
philip	philli	Nan
phillips	phillips	Nan
phlanhigion	eweko	Nan
phlant	ọmọ	None
phlentyn	ọmọ	None
phrydain	gẹẹsi	Nan
phum	pupa	None
phwy	àjọ who	Nan
pkm	pkm	Nan
pla	aarun	Nan
plaid	ẹgbẹ	Nan
plancton	plankton	Nan
planed	ile aye	Nan
planedau	aye orun	Nan
planhigion	eweko	Nan
planhigyn	ohun ọgbin	Nan
plant	ọmọ	None
plas	pẹtẹlẹ	Nan
plasma	pilasima	Nan
plat	plat	Nan
plata	awo	None
platiau	sii farahan	Nan
platinwm	pilatnomu	Nan
piws	elese	Nan
piwbis	awọn puppy	Nan
pistyll	ikunku	Nan
pipit	opo gigun ti epo	Nan
phwynt	ojuami	Nan
phwyslais	tcnu	Nan
phylloscopus	phylloscopus	Nan
physik	physik	Nan
pi	pi	Nan
piano	duru	Nan
pibydd	piper	Nan
phatrymau	awọn apẹẹrẹ	Nan
pidyn	kòfẹ	Nan
pier	afara	Nan
pierre	gun	None
pig	beak	Nan
pilen	awo	None
pileri	àwọn ọwọ̀n	Nan
pilipinas	awọn agekuru	Nan
pinc	pupa	None
pied	lu	Nan
pharhaodd	o tesiwaju	Nan
pharc	gbesile	Nan
phapurau	awọn iwe	Nan
penrhyn	ile larubawa	Nan
pensaer	ayaworan	Nan
pensaerniaeth	faaji	Nan
pensaernïaeth	faaji	Nan
pensaernïol	ayaworan	Nan
penseiri	awọn ayaworan ile	Nan
pentraeth	olú ìlú	Nan
pentref	abule	Nan
pentrefi	abule	Nan
penybont	bridgend	Nan
penypass	peni irekọja	Nan
people	eniyan	Nan
peoples	awọn eniyan	Nan
peppers	ata	Nan
pepsin	pepsin	Nan
penodwyd	yan	None
penodol	pàtó	Nan
penododd	yan	None
penodi	ipinnu lati pade	Nan
penderfynodd	o pinnu	Nan
penderfynu	pinnu	Nan
penderfynwyd	o ti pinnu	Nan
pendil	pendulum	Nan
penfro	pembrokeshire	Nan
penglog	timole	Nan
penmon	ẹja pẹtẹlẹ	Nan
perchen	tirẹ	Nan
penmynydd	penmynydd	Nan
pennaf	o kun	Nan
pennant	onibaje	Nan
pennar	pennar	Nan
pennau	awọn olori	Nan
pennill	ẹsẹ	None
pennod	orí	Nan
pennsylvania	pennsilin	Nan
pennaeth	olori olukọ	Nan
platon	platoon	Nan
percoladur	olukopa	Nan
perdix	perdix	Nan
perthynas	ibatan	Nan
perthynol	ti o ni ibatan	Nan
perygl	ijamba	Nan
peryglus	lewu	Nan
pete	pete	Nan
peter	peter	Nan
peth	ohun	Nan
pethau	ohun	Nan
pethaun	ohun	Nan
petrel	ọpẹ	Nan
petrol	epo	Nan
petroliwm	epo	Nan
ph	ara	Nan
phalaropus	eegun iwaju	Nan
phan	pan	Nan
perthyn	ohun ini	Nan
perthnasol	ibaramu	Nan
perswadiwyd	yiro	Nan
personol	ti ara ẹni	Nan
pererindod	ajo	None
perfformiad	imuṣere	Nan
perfformiadau	awọn iṣe	Nan
perfformio	ṣe	Nan
perfformiodd	o ṣe	Nan
perfformir	ošišẹ	Nan
peri	ọga	Nan
percy	percy	Nan
pericles	patikulu	Nan
perk	perki	Nan
perl	parili	Nan
permission	igbanilaaye	Nan
perry	ariyanjiyan	Nan
persia	persia	Nan
persiaid	irisi	None
person	eniyan	Nan
periw	perú	Nan
pryfed	kokoro	Nan
please	jowo	Nan
pleidleisio	idibo	Nan
prin	igboro	Nan
prince	ọmọ	None
princes	awọn ọmọ-alade	Nan
principal	olukọ	Nan
prinder	aito	Nan
printed	tejede	Nan
priod	iyawo	None
priodas	igbeyawo	None
priodi	igbeyawo	None
priododd	iyawo	None
priodoleddau	awọn eroja	Nan
priodolwyd	ikawe	Nan
priodweddau	awọn ohun-ini	Nan
priodweddaur	abuda	Nan
pris	owo	Nan
prifysgolion	egbelegbe	Nan
prisiau	awọn idiyele	Nan
prifysgol	yunifasiti	Nan
prifddinas	olú ìlú	Nan
pren	igi	Nan
pres	pres	Nan
presennol	lọwọlọwọ	Nan
presenol	lọwọlọwọ	Nan
presenoldeb	niwaju	None
present	lọwọlọwọ	Nan
presley	presley	Nan
press	tẹ	Nan
preswylio	ibugbe	Nan
previous	ti tẹlẹ	Nan
price	owo	Nan
prichard	onigbagbo	Nan
pridd	ile	Nan
prif	akọkọ	Nan
prifardd	ewi olori	Nan
prifddinasoedd	olu ilu	Nan
problem	iṣoro	Nan
problemau	awọn iṣoro	Nan
procellariiformes	procellariiformes	Nan
protestiadau	awọn ehonu	Nan
protestio	ifihan	Nan
protestwyr	awọn alainitelorun	Nan
protocol	ilana	None
protonau	awọn protons	Nan
provided	pese	Nan
province	igberiko	None
prwsia	prussia	Nan
pryce	pryce	Nan
pryd	nigbawo	Nan
prydain	gẹẹsi	Nan
prydeinig	ara ilu gẹẹsi	Nan
prydeinwyr	awọn kikun	Nan
pryder	aibalẹ	Nan
pryderi	fiyesi	Nan
protestannaidd	alainitelorun	Nan
protestaniaeth	onitẹnumọ	Nan
protest	ifihan	Nan
proteinau	awọn ọlọjẹ	Nan
professor	alamọdaju	Nan
proffesiynol	ọjọgbọn	Nan
proffil	profaili	Nan
proffwyd	woli	Nan
proffwydi	awọn woli	Nan
profi	idanwo	Nan
profiad	iriri	Nan
preifatrwydd	asiri	Nan
profion	awọn idanwo	Nan
prokofiev	prokofiev	Nan
promenad	isọtẹlẹ	Nan
prop	ti ikede	Nan
proses	ilana	None
prosesau	ilana	None
prosiect	ise agbese	Nan
protein	amuaradagba	Nan
project	ise agbese	Nan
preifat	ikọkọ	Nan
prego	prego	Nan
pregethu	waasu	Nan
poblogaeth	olugbe	Nan
poblogaethau	olugbe	Nan
poblogaidd	gbajumọ	Nan
poblogrwydd	gbaye-gbale	Nan
pobol	eniyan	Nan
podiceps	podiceps	Nan
poen	irora	Nan
poeni	dààmú	Nan
poeth	gbona	Nan
poetry	oríkì	None
police	ọlọpa	Nan
polisi	eto imulo	Nan
polisïau	imulo	Nan
politicaidd	oselu	Nan
poly	ọpọ	Nan
poblog	gbe	None
pobloedd	awọn eniyan	Nan
pobl	eniyan	Nan
pob	eniyan	Nan
plentyn	ọmọ	None
plentyndod	ewe	None
pleser	idunnu	Nan
plinius	plinius	Nan
plisgyn	ikarahun	Nan
plith	laarin	None
plover	plover	Nan
polyn	òpó	Nan
pluvialis	pluvialis	Nan
plwton	pluto	Nan
plygain	plygain	Nan
plygiant	isọdọtun	Nan
plygu	atunse	None
plât	awo	None
pnawn	ni ọsan	Nan
po	po	None
plwm	darí	Nan
pleidiau	awọn ẹgbẹ	Nan
polynesia	ẹla	Nan
pompeius	oloyinmọmọ	Nan
porwr	aṣàwákiri	Nan
porzana	iloro	Nan
posib	ṣeeṣe	Nan
posibilrwydd	seese	Nan
posibl	ṣeeṣe	Nan
positif	rere	None
post	ifiweranṣẹ	Nan
pot	ikoko	Nan
potensial	agbara	None
powell	powell	Nan
powys	powys	Nan
ppp	pppp.	Nan
pratchett	pratchett	Nan
pratincole	pratincole	Nan
preachers	awọn oniwaasu	Nan
portreadu	àpèjúwe	Nan
portreadir	ti ṣafihan	Nan
portreadau	awọn aworan	Nan
portread	aworan	Nan
pont	afara	Nan
pontydd	afara	Nan
pop	agbejade	Nan
popeth	ohun gbogbo	Nan
population	olugbe	Nan
porbandar	faranda	Nan
pori	jeun	Nan
polypeptid	polypeptide	Nan
port	ibudo	Nan
porthaethwy	amudani	Nan
porthladd	ibudo	Nan
porthladdoedd	omi	None
porthmadog	portmadog	Nan
porthmyn	apanirun	Nan
portiwgal	ilu pọtugali	Nan
portiwgaleg	ilu pọtugali	Nan
porth	ọna abawọle	Nan
rhyngrwyd	intanẹẹti	Nan
rhyngweithiad	ibaraenisepo	Nan
rhyngweithiadau	awọn ibaraenisọrọ	Nan
sinc	sinkii	Nan
since	sinkii	Nan
sinema	sinima	Nan
singapore	ẹrin	Nan
singer	akorin	Nan
single	ẹyọkan	Nan
sinn	àwa	Nan
siocled	ologbo	Nan
sioe	ṣafihan	Nan
siomedig	ti yẹ adehun	Nan
sionc	briskly	Nan
siop	ṣọọbu	Nan
siopa	ṣọọbu	Nan
siopau	awọn ile itaja	Nan
sir	county	Nan
sinai	sinai	None
siroedd	awọn kaunti	Nan
sin	iyẹn	Nan
simon	simoni	Nan
sieloau	cello	Nan
sierra	sierra	Nan
sifil	ara ilu	Nan
sifiliaid	alagbada	Nan
siglen	fifi	Nan
signalau	agbara	None
sil	idogo	Nan
silicon	ohun alumọni	Nan
sillaf	ọṣẹ-ohun	Nan
sillafiad	akọtọ	Nan
sillafu	sipeli	Nan
sillwyddor	siliki	Nan
simbabwe	orilẹ-ede zimbabwe	Nan
simeon	simeon	Nan
simneiau	owole	Nan
simple	o rọrun	Nan
sirol	county	Nan
sisili	chileli	Nan
siwan	lẹhinna	Nan
sn	sn	Nan
sneddon	sneddon	Nan
snipe	apanirun	Nan
snow	yinyin	Nan
snowdon	yinyin	Nan
snowdonia	yinyin	Nan
so	eyi	Nan
socrates	socrates	Nan
sofia	oorun oorun	Nan
sofietaidd	rosia	Nan
sofraniaeth	ọba aláṣẹ	Nan
software	sọfitiwia	Nan
sol	sol	Nan
solar	oorun	Nan
solid	líle	Nan
smotiau	yẹriyẹri	Nan
smith	smith	Nan
slovenia	slovenia	Nan
slofenia	slovenia	Nan
siwgr	ṣuga	Nan
six	mefa	Nan
sizwe	sizwe	Nan
siân	siân	Nan
siâp	apẹrẹ	Nan
siôn	iró	Nan
siôr	daju	Nan
sielo	cello	Nan
skopje	skopje	Nan
sl	sl	Nan
slafaidd	panṣaga	Nan
slafeg	slavic	Nan
slate	ọpá	Nan
slater	apaniyan	Nan
slofacia	slovakia	Nan
slofeneg	ede	None
skua	skua	Nan
siegfried	siegfried	Nan
sieffre	aso	Nan
side	ẹgbẹ	Nan
shane	shane	Nan
shanklin	shanklin	Nan
shannon	shannon	Nan
shaw	ẹyẹ	Nan
she	obinrin na	Nan
shearwater	rirẹ-omi	Nan
sheen	sheen	Nan
shetty	shetty	Nan
shia	mefa	Nan
shilpa	shilpa	Nan
shiva	shiva	Nan
shivaeth	shivaeth	Nan
shorttoed	kukuru	Nan
shostakovich	onigbọnrin	Nan
should	yẹ	Nan
shan	shan	Nan
shakti	shakti	Nan
shakespeare	shakespeare	Nan
sh	sh	Nan
severus	okun	Nan
seychelles	seychelles	Nan
seán	seán	Nan
sgerbwd	egungun	Nan
sgil	olorijori	Nan
sgiliau	ogbon	Nan
sgiwen	sẹsẹ	Nan
showa	showa	Nan
sgoteg	awọn scots	Nan
sgrôl	yi lọ	Nan
sgwrs	iwiregbe	Nan
sgwâr	square	Nan
sgìl	olorijori	Nan
sgîl	nitorina na	Nan
sgïo	sikiini	Nan
sgôr	wole	None
sgript	iwe afọwọkọ	Nan
solomon	adashe	Nan
shrew	gbọn	Nan
si	si	Nan
siarter	iwe adehun	Nan
siasbar	syikamore	Nan
siawns	aye	Nan
siberia	siberian	Nan
siberian	siberian	Nan
sibh	iwo	Nan
sichuan	sichuan	Nan
siciaeth	oroinuokan	Nan
sicilia	siciliisi	Nan
sicr	esan	Nan
sicrhau	rii daju	Nan
sicrwydd	idaniloju	Nan
siculus	siculus	Nan
sidan	siliki	Nan
sidanes	siliki	Nan
siart	àwòrán	Nan
siarlymaen	oriyin	Nan
siarl	sẹhin	Nan
siaredir	sọ	None
siachmat	hexadecimal	Nan
siambr	iyẹwu	Nan
sian	ohunkohun ti	Nan
sianel	ikanni	Nan
sianeli	awọn ikanni	Nan
siap	apẹrẹ	Nan
siapan	ọṣẹ	Nan
shrike	gbọn	Nan
siapaneg	japanese	Nan
siarad	sọrọ	Nan
siaradir	sọ	None
siaradodd	o sọrọ	Nan
siaradwr	agbọrọsọ	Nan
siaradwyd	sọ	None
siaradwyr	awọn agbohunsoke	Nan
siaredid	sọ	None
siapau	awọn apẹrẹ	Nan
setophaga	setophaga	Nan
somalia	somalia	Nan
somme	somme	Nan
suez	suez	None
suful	suful	Nan
suharto	suharto	Nan
suitable	o dara	Nan
suite	agesin	Nan
sul	ṣaaju	Nan
sulawesi	oorun	Nan
suleiman	suleiman	Nan
sulgwyn	sulgwyn	Nan
sulla	sulla	Nan
sullivan	sullivan	Nan
sumatra	sumatra	Nan
sunni	sunni	Nan
super	dara julọ	Nan
supergroup	olorijori	Nan
sudetenland	sudetenland	Nan
sur	sur	Nan
suddo	sin ninu	Nan
such	iru	Nan
streptopelia	streptopelia	Nan
stribed	rinhoho	Nan
strigiformes	awọn iṣiro afọwọya	Nan
strindberg	strindberg	Nan
strwythr	be	Nan
strwythur	be	Nan
strwythurau	awọn ẹya	Nan
strwythuriaethol	eleto	Nan
stryd	opopona	Nan
strydoedd	ita	Nan
stumog	ikun	Nan
style	ara	Nan
stêm	nya si	Nan
subject	koko	Nan
subprefecture	atunkọ	Nan
sudan	sudan	Nan
suriname	abẹ	Nan
sus	sus	Nan
susan	susan	Nan
swyddfa	ọfiisi	Nan
swyddfeydd	awọn ọfiisi	Nan
swyddi	awọn iṣẹ	Nan
swyddog	oṣiṣẹ	Nan
swyddogaeth	iṣẹ	Nan
swyddogaethau	awọn iṣẹ	Nan
swyddogion	awọn olori	Nan
swyddogol	ifowosi	Nan
swynion	iwuri	Nan
sy	sy	Nan
sych	gbẹ	Nan
sychach	gbigbẹ	Nan
sycharth	ogbele	Nan
sydd	ewo	Nan
sydyn	lojiji	Nan
swydd	iṣẹ	Nan
swnion	ariwo	Nan
swn	ariwo	Nan
swm	iye	Nan
sut	bawo	Nan
sutton	sutton	Nan
swahili	ibi	Nan
swallow	gbe	None
swan	siwani	Nan
swbstrad	sobusitireti	Nan
swcwbws	iṣupọ	Nan
streic	kọlu	Nan
swdan	sudan	Nan
sweden	sweden	Nan
sweet	adun	Nan
swift	yiyara	Nan
swisdir	yipada	None
swistir	switzerland	Nan
swlffwrig	eefin	Nan
swltan	sulusi	Nan
swedeg	ara ilu sweden	Nan
street	opopona	Nan
strategol	ilana	None
strategaeth	nwon.mirza	Nan
spoken	sọ	None
spongiosum	spongiosum	Nan
spotted	iranran	Nan
spring	omi	None
squirrel	squirrel	Nan
sri	sri	Nan
ss	s	Nan
st	st.	Nan
stad	duro	Nan
stadiwm	papa-iṣere	Nan
staff	oṣiṣẹ	Nan
stalin	sitárá	Nan
stalingrad	stalingrad	Nan
stallman	ọmọlọtọ	Nan
stamp	ontẹ	Nan
special	pataki	Nan
sparta	sparta	Nan
sparrow	onirẹlẹ	Nan
spam	àwúrúju	Nan
son	olubori	Nan
sonata	sonata	Nan
soned	ọmọkùnrin	Nan
song	orin	Nan
songs	awọn orin	Nan
soniodd	o mẹnuba	Nan
soniwyd	mẹnuba	Nan
stanley	ìlù	Nan
sony	ọmọkùnrin	Nan
sosialaidd	alaifeiruedaomoenikeji	Nan
sou	sou	Nan
soul	ọkàn	Nan
soweto	shukaeto	Nan
sownd	di	Nan
space	aaye	Nan
spaen	spain	Nan
sophia	arabinrin	Nan
some	diẹ ninu	Nan
star	irawo	Nan
stated	ṣalaye	Nan
stiwdio	ile isise	Nan
stiwdios	awọn ile-iṣere	Nan
stoc	ọja	Nan
stone	okuta	Nan
stones	okuta	Nan
stori	itan	Nan
storio	ibi ipamọ	Nan
storm	ìjì	Nan
stormpetrel	efuufu lile	Nan
stormydd	ìjì	Nan
story	itan	Nan
storïau	awọn itan	Nan
strabo	okun	Nan
straen	aapọn	Nan
straeon	awọn itan	Nan
stint	itara	Nan
stigma	abuku	Nan
stewarthannah	stewarthannah	Nan
stewart	stewart	Nan
staten	ipinle	Nan
states	awọn ipinlẹ	Nan
station	ibudo	Nan
statws	ipo	None
steffan	steffan	Nan
steil	ara	Nan
stephen	alairi	Nan
state	ipinle	Nan
stephens	arabinrin stefeni	Nan
stercorarius	stercorarius	Nan
sterna	sterna	Nan
steve	steve	Nan
steven	steven	Nan
stevens	stevens	Nan
stevenson	stevenson	Nan
stevie	stevie	Nan
stephenson	igbidanwo	Nan
set	ṣeto	Nan
sesiwn	igba	Nan
seryddwr	awòràwọ	Nan
rwmania	romania	Nan
rwseg	ara ilu rọsia	Nan
rwsia	rísia	Nan
rwsiaid	ara ilu russia	Nan
rwsiaidd	ara ilu rọsia	Nan
rwsieg	ara ilu rọsia	Nan
rwydwaith	nẹtiwọọki	Nan
rwyn	emi ni	Nan
rwystro	ṣe idiwọ	Nan
rwystror	idiwọ	Nan
ryan	ryan	None
rybuddio	itaniji	Nan
rydd	larọwọto	Nan
ryddfrydol	olutayo	Nan
ryddhau	itusilẹ	Nan
rwmaneg	ara ilu romania	Nan
ryddhawyd	tu silẹ	Nan
rwdlan	parun	Nan
ruthun	ruthin	Nan
rowling	titọ	Nan
rownd	yika	Nan
rowndiau	iyipo	Nan
roy	roy	Nan
royal	ọba	Nan
rss	lp	Nan
rufain	ruffs	Nan
rufeinig	roman	Nan
ruficollis	ruficollis	Nan
rugby	rugby	Nan
run	sáré	Nan
rush	adie	Nan
russell	rùn	Nan
rustica	rustica	Nan
ruth	ruth	Nan
rwanda	rwanda	Nan
ryddiaith	prose	Nan
ryddid	ominira	Nan
rydw	emi ni	Nan
régions	awọn régions	Nan
rêp	rapese	Nan
río	ọba	Nan
rôl	ipa	Nan
s	s	Nan
sa	sa	Nan
sabbats	sabbats	Nan
sabha	sabha	Nan
sacrwm	sacrum	Nan
sacsoffon	saxophone	Nan
sacsoniaid	saxons	Nan
saddam	saddam	Nan
sadwrn	s&#39;oru	Nan
saer	gbenagbena	Nan
saesneg	gẹẹsi	Nan
réard	réard	Nan
rywun	enikan	Nan
rywogaethau	eya	None
rywogaeth	eya	None
rydych	ti o ba wa	Nan
rydym	a wa	Nan
ryfel	ogun	None
ryfeloedd	ogun	None
ryfelwyr	jagunjagun	Nan
rygbi	rugby	Nan
rygbir	rugby	Nan
rowlands	awọn erekusu	Nan
rym	ipa	Nan
ryngwladol	kariaye	Nan
rythm	ilu	Nan
ryw	ibalopọ	Nan
rywbeth	nkan	None
rywbryd	nigbakan	None
rywiol	ibalopọ	Nan
rywle	ibikan	Nan
rymoedd	awọn ipa	Nan
rowland	kana	Nan
routledge	igbese	Nan
ross	rosa	Nan
rieni	awọn obi	Nan
rif	nọmba	Nan
rights	awọn ẹtọ	Nan
ring	òrùka	Nan
rio	rio	Nan
river	odo	Nan
rivonia	rivonia	Nan
rix	rix	Nan
rms	rms	Nan
road	opopona	Nan
rob	jale	Nan
robert	robert	Nan
roberts	aṣọ alarabara	Nan
robin	robin	Nan
robot	robot	Nan
rico	rico	Nan
richards	richards	Nan
richard	richard	None
rice	iresi	Nan
rhyngweithio	ibaraenisepo	Nan
rhyngweithiol	ibanisọrọ	Nan
rhyngwladol	kariaye	Nan
rhys	rhys	Nan
rhythm	ilu	Nan
rhythmau	awọn sakediani	Nan
rhyw	ibalopọ	Nan
robusta	adigunjale	Nan
rhywbeth	nkan	None
rhywfaint	diẹ ninu	Nan
rhywiol	ibalopọ	Nan
rhywioldeb	ibalopọ	Nan
rhywogaeth	eya	None
rhywogaethau	eya	None
rhywun	ẹnikan	Nan
rica	rica	Nan
rhywbryd	nigbakan	None
saesnegcymraeg	gẹẹsi	Nan
robyn	robin	Nan
roced	rọkẹti	Nan
roman	róòmù	Nan
romana	romana	Nan
romania	romania	Nan
romanos	romanos	Nan
romanus	romanus	Nan
romaunsch	romaunsch	Nan
romeo	romeo	Nan
romulus	romulus	Nan
romáwns	fifehan	Nan
românia	românia	Nan
ron	ṣaaju	Nan
ronald	ronald	None
ronynnau	patikulu	Nan
roosevelt	roosevelt	Nan
ros	ros	Nan
roma	oti romu	Nan
rolling	yiyi	Nan
roll	yipo	Nan
rolihlahla	rolihlahla	Nan
rocedi	awọn apata	Nan
rock	apata	Nan
rocket	rọkẹti	Nan
roddir	fifun	Nan
roddodd	fun	None
roddwyd	fifun	Nan
roedd	oun	None
roc	apata	Nan
roedden	o jẹ	Nan
roeddynt	wọn	None
roeg	fifun	Nan
roegaidd	griki	Nan
roger	roger	Nan
roi	fifun	Nan
roir	ọkọ oju-irin	Nan
rol	ipa	Nan
roeddent	wọn	None
saeson	arakunrin gẹẹsi	Nan
saethau	ọfa	Nan
saethodd	o gbon	Nan
sefydlwyd	ti dasilẹ	Nan
sefydlwyr	awọn oludasilẹ	Nan
sefyll	dúró	None
sefyllfa	ipo	None
sefyllfan	duro	Nan
segontium	segontium	Nan
seicoleg	oroinuokan	Nan
seicolegol	oroinuokan	Nan
seiliau	awọn ipilẹ	Nan
seiliedig	orisun	None
seilio	mimọ	Nan
seilir	cellar	Nan
seiliwyd	orisun	None
seine	seine	Nan
seineg	orisun	None
sefydlur	oludasile	Nan
sefydlu	ṣeto	Nan
sefydlogrwydd	iduroṣinṣin	Nan
sefydlogi	iduroṣinṣin	Nan
sean	atijọ	Nan
sebastan	ẹja pẹtẹlẹ	Nan
sebastian	sebastian	Nan
sebon	ọṣẹ	Nan
seciwlar	alailesin	Nan
secondary	atẹle	Nan
section	apakan	Nan
seinegol	amọfa	Nan
sector	eka	None
seddau	ibijoko	Nan
sef	eyun	Nan
sefydliad	agbari	Nan
sefydliadau	ajo	None
sefydliadaur	awọn ile-iṣẹ	Nan
sefydlodd	o mulẹ	Nan
sefydlog	ti o wa titi	Nan
sedd	ijoko	Nan
sea	bẹẹni	Nan
seiniau	awọn ohun	Nan
seiont	bẹẹni	Nan
serbian	ara serbia	Nan
serch	botilẹjẹpe	Nan
seremoni	ayẹyẹ	Nan
seremoniau	awọn ayẹyẹ	Nan
seremonïau	awọn ayẹyẹ	Nan
seremonïol	ayẹyẹ	Nan
seren	irawo	Nan
serennodd	o starred	Nan
serennu	irawo	Nan
sergei	sergei	Nan
sergio	sergio	Nan
serth	gaan	Nan
service	iṣẹ	Nan
seryddiaeth	aworawo	Nan
seryddol	aworawo	Nan
serbiaid	awọn iṣẹ	Nan
serbia	serbia	Nan
serbeg	serbian	Nan
sensitif	kókó	Nan
seiriol	sherry	Nan
seismoleg	seismology	Nan
seisnig	englishdè gẹẹsi	Nan
seithfed	keje	Nan
seland	ilu niu silandii	Nan
selim	lẹnu	Nan
selyf	selyf	Nan
seintiau	awon eniyan mimo	Nan
semen	àwo	Nan
semitaidd	semitiki	Nan
senedd	ile igbimọ aṣofin	Nan
seneddol	ile igbimọ aṣofin	Nan
seneddwyr	awon asofin	Nan
senegal	senior	Nan
sengl	ẹyọkan	Nan
senglau	awọn ẹlẹgbẹ	Nan
semenaidd	ẹkọ ile-ẹkọ giga	Nan
penderfyniad	kan	None
scrofa	kọ	Nan
scott	scott	Nan
sais	sash	Nan
saitama	saitama	Nan
saith	meje	Nan
salsa	salsa	Nan
salvador	salvador	Nan
salve	yọyọ	Nan
salwch	àìsàn	Nan
sam	sam	Nan
same	kanna	Nan
samoa	samoa	Nan
sampl	apẹẹrẹ	Nan
samplau	awọn ayẹwo	Nan
sampson	iṣapẹẹrẹ	Nan
samuel	samueli	Nan
san	san	Nan
saint	awon eniyan mimo	Nan
sain	ìró	None
sail	ipilẹ	Nan
saif	o duro	Nan
saethu	gbon	Nan
saethwyd	ni yinbọn	Nan
saethwyr	tafàtafà	Nan
safbwynt	bi o se ri si	Nan
safbwyntiau	awọn iwo	Nan
safle	aaye	Nan
safleodd	ipo	None
sancsiynau	awọn ijẹniniya	Nan
safleoedd	awọn aaye	Nan
safon	boṣewa	Nan
safonau	awọn ajohunše	Nan
safoni	idiwon	Nan
safonol	boṣewa	Nan
sagrada	sagrada	Nan
sahara	sahara	Nan
sahel	sahel	Nan
safler	fipamọ	Nan
scream	pariwo	Nan
sanctaidd	mimọ	Nan
sand	iyanrin	Nan
sbaen	ilu sibeeni	Nan
sbaenaidd	hisipaniki	Nan
sbaeneg	ede	None
sbectrwm	igbohunsafẹfẹ	Nan
sberm	sugbọn	Nan
sbwriel	idalẹnu	Nan
sc	sc	Nan
scala	iwọn	Nan
scarlets	pupa	None
school	ile-iwe	Nan
schwimmer	schwimmer	Nan
science	sayensi	Nan
scops	awotẹlẹ	Nan
scoter	ẹlẹyọ	Nan
scots	scots	Nan
say	sọ	None
saxicola	saxicola	Nan
sawl	lọpọlọpọ	Nan
sawdi	sage	Nan
sanders	sanders	Nan
sandpiper	aṣọ iyanrin	Nan
sanscrit	sanskrit	Nan
sansgrit	sanskrit	Nan
sant	mimọ	Nan
santa	santa	None
santiago	santiago	Nan
sancti	mimọ	Nan
sapiens	sapiens	Nan
sarhaus	ibinu	Nan
sassoon	sassoon	Nan
sataniaeth	satanism	Nan
saturninus	saturninus	Nan
saudi	saudi	Nan
saunders	awọn oludasilẹ	Nan
save	fipamọ	Nan
sardinia	sardinia	Nan
→	→	Nan
gwersi	awọn ẹkọ	Nan
gwerinwyr	epa	None
categoritywysogion	awọn ẹka ti awọn ọmọ-alade	Nan
categoriundduwiaeth	ẹya monotheism	Nan
categoriunedau	awọn ẹka	Nan
categoriwicipedia	wikipedia	Nan
categoriy	awọn ẹka	Nan
categoriymddygiad	ẹka ti aiṣedeede	Nan
categoriymlusgiaid	ẹya ti awọn abuku	Nan
categoriynysoedd	awọn ẹka	Nan
categoriyr	awọn ẹka	Nan
cath	ogun	None
catharus	oju mimu	Nan
catherine	catherine	None
cathod	ologbo	Nan
catholig	ẹlẹsin ẹlẹsin	Nan
catref	ile	Nan
categoritywysogaethau	ipin	None
catrin	catrin	Nan
categoritywydd	categorism	Nan
categoriteledu	isori	Nan
categoriplanedau	categoriplanets	Nan
categoriplanhigion	eweko ẹka	Nan
categoripobl	eniyan ẹka	Nan
categoriprifddinasoedd	olu ilu	Nan
categorirhaglenni	awọn akojọ aṣayan ẹka	Nan
categorirhanbarthau	ipin	None
categorirhestrau	ipin	None
categorirhyngrwyd	ẹya ayelujara	Nan
categorirhyw	tito lẹšẹšẹ	Nan
categorisafleoedd	ẹka ojula	Nan
categorisefydliadau	awọn isori	Nan
categorisiroedd	awọn ẹka	Nan
categorisystem	categorisystem	Nan
categoritanwyddau	awọn ẹka	Nan
categoritechnoleg	categortechnology	Nan
categoritermau	awọn ẹka fifọ	Nan
cau	sunmọ	Nan
caur	caur	Nan
cawcasws	caucasus	Nan
cefnogir	o ti ni atilẹyin	Nan
cefnogwyr	egeb onijakidijagan	Nan
cefnwr	ni kikun pada	Nan
ceg	ẹnu	Nan
ceid	wa	Nan
ceidwadol	konsafetifu	Nan
ceiliog	akukọ	Nan
ceilliau	testicles	Nan
ceir	oko	None
ceirios	awọn ṣẹẹri	Nan
ceiriosen	ṣẹẹri	Nan
ceisiadau	awọn ohun elo	Nan
ceisio	gbidanwo	Nan
ceisiodd	o gbiyanju	Nan
celebrity	olókìkí	Nan
cefnogi	atilẹyin	Nan
cefnogaeth	atilẹyin	Nan
cefnforol	òkun	Nan
cefnfor	okun	Nan
cawl	bimo	Nan
cawn	bẹẹni	Nan
cawr	omiran	Nan
caws	warankasi	Nan
cawsant	wọn	None
cc	cc	Nan
ccc	plc	Nan
categoriofferynnau	awọn irinṣẹ categoryof	Nan
cd	cd	Nan
cebl	okun	Nan
cedor	kedari	Nan
cedwir	o ti wa ni ifipamọ	Nan
ceffyl	kan	None
ceffylau	ẹṣin	Nan
cefn	sẹhin	Nan
cefndir	lẹhin	Nan
cdrom	cdrom	Nan
categorinofelwyr	awọn oluṣapẹrẹ	Nan
categorimytholeg	categorimythology	Nan
categorimoeseg	awọn aṣapẹrẹ	Nan
categoricerddoriaeth	ẹka orin	Nan
categoricewri	categoricewri	Nan
categoricredoau	awọn ẹka	Nan
categoricrefydd	ẹka ti ẹsin	Nan
categoricristnogaeth	ẹya ti kristiẹniti	Nan
categoricwmnïau	awọn ẹka	Nan
categoricyfandiroedd	awọn ẹka ti awọn ile aye	Nan
categoricyfathrebu	isọdi ti ibaraẹnisọrọ	Nan
categoricyfraith	ofin	None
categoricyfrifiadureg	iṣiro isori	Nan
categoricyfrifiaduro	iṣiro isori	Nan
categoricyfryngau	media ẹka	Nan
categoricymdeithas	ẹka ti awujọ	Nan
categoricyrff	awọn ẹka	Nan
categoridaeareg	categorology	Nan
categoricerbydau	awọn ọkọ ti ẹka	Nan
categoricemeg	tito lẹtọ	Nan
categoricantorion	awọn aṣapẹrẹ	Nan
categoricanrifoedd	awọn ẹka	Nan
categoriamgylchedd	agbegbe ẹka	Nan
categorianatomeg	categoriatomi	Nan
categorianifeiliaid	awọn ẹka eranko	Nan
categorianthropoleg	categorientropology	Nan
categoriarian	oniṣiro	Nan
categoriarlunwyr	awọn apẹẹrẹ ẹka	Nan
categoriarlywyddion	awọn alakoso ẹka	Nan
categoridaearyddiaeth	ẹka ẹkọ	Nan
categoriasiantaethau	awọn ile ibẹwẹ ẹka	Nan
categoriau	awọn ẹka	Nan
categoriawdurdodau	awọn alaṣẹ ẹka	Nan
categoribeirdd	oniṣiro	Nan
categoribioleg	categoribiology	Nan
categoribrenhinoedd	awọn ọba awọn ọba	Nan
categoribywyd	tito lẹšẹšẹ	Nan
categoricalendr	ẹka ẹka	Nan
categoriasidau	awọn ẹka	Nan
celf	aworan	Nan
categoridefnyddiau	ẹka lilo	Nan
categoridinasoedd	awọn ẹka	Nan
categorigwyddoniaeth	sayensi categorical	Nan
categorigwyddorau	awọn ẹka	Nan
categorigwyliau	awọn ẹka	Nan
categorihamdden	igbadun ẹka	Nan
categorihanes	ẹka ti itan	Nan
categorihindŵaeth	ẹka	Nan
categorihylifau	ẹka ti awọn olomi	Nan
categoriieithoedd	ede	None
categorillenyddiaeth	litireso kikọ	Nan
categorillywodraeth	ijoba ẹka	Nan
categorimamaliaid	categorimamals	Nan
categorimarwolaethau	iku	None
categorimeddalwedd	awọn ẹka sọfitiwia	Nan
categorimetelau	awọn ẹka	Nan
categorimisoedd	awọn ẹka	Nan
categorigwybodaeth	alaye ẹka	Nan
categorigwrthdaro	rogbodiyan	None
categorigwleidyddion	oloselu ẹka	Nan
categorigwleidyddiaeth	iselu categorical	Nan
categoridiodydd	awọn ẹka	Nan
categoridiwydiannau	awọn ile-iṣẹ ẹka	Nan
categoridiwydiant	tito lẹšẹšẹ	Nan
categoridiwylliant	isori	Nan
categorieconomeg	categorieconomics	Nan
categorieg	ẹka	Nan
categorielfennau	awọn ẹka	Nan
categoridifyrweithiau	awọn aṣapẹrẹ	Nan
categorifed	tito lẹkọ	Nan
categoriffisegwyr	categorologists	Nan
categorigenedigaethau	isori ti awọn ibi	Nan
categorigrwpiau	awọn ẹgbẹ tito lẹtọ	Nan
categorigwefannau	awọn ẹka aaye ayelujara	Nan
categorigweithredwyr	ajafitafita ẹka	Nan
categorigweriniaethau	awọn isori ti awọn oogun	Nan
categorigwledydd	awọn ẹka ti awọn orilẹ-ede	Nan
categoriffiseg	isori	Nan
categoriafiechydon	arun	None
celfyddyd	aworan	Nan
celfyddydol	ona ona	Nan
chiang	chiang	Nan
chiba	baba	Nan
chicago	chicago	Nan
chiefs	awọn olori	Nan
children	ọmọ	None
chile	omiiran	Nan
chilton	chileti	Nan
chin	agbọn	Nan
china	ṣaina	Nan
chipio	mú	Nan
chipiodd	o mu	Nan
chlorus	klarisu	Nan
chodi	gbe	None
chofadeiladau	awọn arabara	Nan
choice	yiyan	Nan
chi	iwo	Nan
cholli	ipadanu	Nan
cherrig	okuta	Nan
cherddi	awọn ewi	Nan
charadrius	charadrius	Nan
chariad	ni ife	Nan
charlie	ṣaja	Nan
charlotte	charlotte	Nan
chastell	ile odi	Nan
chawsant	wọn	None
chefnfor	okun	Nan
chefnogaeth	atilẹyin	Nan
cheir	oko	None
chekhov	chekhov	Nan
chelf	aworan	Nan
chelloedd	ẹyin	Nan
cheltaidd	sẹẹli	Nan
chenedl	orílẹ-èdè	Nan
cherdded	ririn	Nan
cherddoriaeth	orin	Nan
chrefydd	ẹsin	Nan
chreigiau	awọn apata	Nan
chreu	ẹda	Nan
chwaraer	mu ṣiṣẹ	Nan
chwaraewr	player	Nan
chwaraewyd	dun	None
chwaraewyr	awọn oṣere	Nan
chwarel	ariyanjiyan	Nan
chwareli	awọn ibeere	Nan
chwarelwr	aáyán	Nan
chwarelwyr	aáyán	Nan
chwarennau	kee keekeekee	Nan
chwarren	ẹṣẹ	Nan
chwarrennau	kee keekeekee	Nan
chwarter	mẹẹdogun	Nan
chwe	mefa	Nan
chwech	mefa	Nan
chweched	kẹfa	Nan
chwaraeon	eré ìdárayá	Nan
chwaraeodd	o ṣere	Nan
chwaraeir	dun	None
chwarae	mu ṣiṣẹ	Nan
chris	kilasi	Nan
christian	kristiẹni	Nan
christie	kristiẹni	Nan
christoph	kristiẹni	Nan
christopher	christi	Nan
chroesi	rekọja	Nan
chroicocephalus	chroicocephalus	Nan
charadriiformes	charadriiformes	Nan
chubut	chubut	Nan
chulfor	awọn ọna	Nan
church	ijo	Nan
churchill	churchill	Nan
chwaer	arabinrin	Nan
chwaith	boya	Nan
chwalu	ko	None
chwant	ifẹkufẹ	Nan
chuck	chuck	Nan
chaplin	tẹmpili	Nan
chao	chao	Nan
chanu	kọrin	Nan
cenhinen	irugbin ẹfọ	Nan
cenia	kenya	Nan
central	aringbungbun	Nan
cerbyd	ọkọ	Nan
cerbydau	awọn ọkọ	Nan
cerdd	ewi	Nan
cerdded	ririn	Nan
cerddi	awọn ewi	Nan
cerddir	rìn	None
cerddor	olorin	Nan
cerddorfa	olutoju	Nan
cerddoriaeth	orin	Nan
cerddorion	awọn akọrin	Nan
cerddorol	gaju ni	Nan
cerddorwyr	awọn akọrin	Nan
cenhedlu	oyun	Nan
cenhedloedd	iran	Nan
cenhadon	míṣọ́nnárì	Nan
cenedlaetholwyr	nationalists	Nan
cell	sẹẹli	Nan
cellbilen	awo	None
celloedd	ẹyin	Nan
celt	celt	Nan
celtaidd	sẹẹli	Nan
celteg	sẹẹli	Nan
celtiaid	awọn sẹẹli	Nan
cerddwyr	alarinkiri	Nan
celtic	sẹẹli	Nan
celts	awọn sẹẹli	Nan
celyn	ṣofo	Nan
cemeg	kemistri	Nan
cemegol	kẹmika	Nan
cenedl	orílẹ-èdè	Nan
cenedlaethol	orilẹ-ede	Nan
cenedlaetholdeb	t’orilẹ-ede	Nan
celtica	sẹẹli	Nan
celfyddydau	ona ona	Nan
ceredigion	igbasilẹ	Nan
cerflun	ere	Nan
chael	ni	Nan
chafodd	o ni	Nan
chafwyd	ni a ri	Nan
chaiff	yoo	None
challenge	ipenija	Nan
chamberlain	iyẹwu	Nan
chan	kii ṣe	Nan
chandler	chandler	Nan
chaneuon	awọn orin	Nan
chaniateir	gba	None
channel	ikanni	Nan
chanol	àárín	None
chanolbarth	aarin wales	Nan
chanolfan	aarin	Nan
chanran	ogorun	Nan
chadwyd	tọju	Nan
chadwraethau	itoju	Nan
chadwodd	o tọju	Nan
chadw	tọju	Nan
ceri	keri	Nan
cernyw	ogiri	Nan
cernyweg	kọndi	Nan
cerrig	okuta	Nan
cerrynt	lọwọlọwọ	Nan
certi	awọn kẹkẹ	Nan
cervus	sẹẹli	Nan
cerfiedig	gbẹ	Nan
cesar	késárì	Nan
cestyll	awọn kasulu	Nan
ceton	ketone	Nan
ceunant	alayeye	Nan
cewch	yoo	None
cewri	awọn omiran	Nan
cf	cf	Nan
ch	ch	Nan
cesiwm	cesium	Nan
chwedl	arosọ	Nan
categoriadloniant	idanilaraya ẹka	Nan
categori	ẹka	Nan
byr	kukuru	Nan
byrddau	tabili	None
byrion	owo kukuru	Nan
byrne	mì	Nan
bysantaidd	byzantine	Nan
bysantiaid	ayalegbe	Nan
bysedd	awọn ika ọwọ	Nan
bysiau	awọn ọkọ akero	Nan
byth	lailai	Nan
byw	ngbe	Nan
bywgraffiad	isedale	Nan
bywiog	iwunlere	Nan
bywyd	igbesi aye	Nan
bywydau	laaye	Nan
byzantium	byzantium	Nan
bynnag	sibẹsibẹ	Nan
bêl	bọọlu	Nan
bynciau	wonyen	Nan
bymtheg	mẹẹdogun	Nan
bydd	yoo	None
byddai	bẹẹni	Nan
byddain	yoo	None
byddair	etí	Nan
byddent	yoo	None
byddin	ogun	None
byddinoedd	ogun	None
byddwch	jẹ	Nan
bydeang	kariaye	Nan
bydenwog	agbaye	None
bydysawd	agbaye	None
byfflo	ẹtu	Nan
bygwth	idẹruba	Nan
bygythiad	irokeke	Nan
byllau	awọn adagun	Nan
bymthegfed	mẹẹdogun	Nan
bêldroedwyr	ẹlẹsẹ ẹlẹsẹ	Nan
bó	maalu	Nan
bŵer	agbara	None
caeau	awọn aaye	Nan
caeedig	ni pipade	Nan
cael	ni	Nan
caeodd	o ni pipade	Nan
caer	odi	Nan
caerdydd	cardiff	Nan
caeredin	edinburgh	Nan
caerfyrddin	carmarthen	Nan
caergaint	odi	Nan
caergrawnt	ilu amọdaju	Nan
caergybi	mimo olodumare	Nan
caergystennin	fortinystenin	Nan
caernarfon	caernarfon	Nan
caerwyn	odi	Nan
caesar	ẹṣẹ	Nan
cae	pápá	Nan
cadwynau	ẹwọn	Nan
cadwyn	pq	Nan
cadwraeth	itoju	Nan
c	c	Nan
cabinet	minisita	Nan
cadair	alaga	Nan
cadarn	ìró	None
cadarnhaodd	o timo	Nan
cadarnhau	jẹrisi	Nan
cadarnhawyd	timo	Nan
byd	agbaye	None
cadeirydd	alaga	Nan
cadfridog	gbogboogbo	Nan
cadfridogion	gbogbogbo	None
cadoediad	alaafia	None
cadw	tọju	Nan
cadwedig	ni ifipamọ	Nan
cadwodd	o tọju	Nan
cadwr	olutọju	Nan
cadfan	cadfan	Nan
bychan	kekere	None
bychain	kekere	None
by	nipasẹ	Nan
bunting	igbidanwo	Nan
bur	bur	Nan
burke	buruku	Nan
burkina	burkina	Nan
burn	jona	Nan
burns	jó	Nan
burton	ajekii	Nan
burum	iwukara	Nan
burundi	burundi	Nan
bus	bosi	Nan
bush	igbo	Nan
busnes	iṣowo	Nan
busnesau	iṣowo	Nan
but	ṣugbọn	Nan
butcher	alagbata	Nan
bun	isalẹ	Nan
bump	gbamu	Nan
bumed	karun	None
bum	marun	Nan
brønstedlowry	brønstedlowry	Nan
bt	bt	Nan
bu	bu	None
buanedd	iyara	Nan
buasai	yoo	None
bucephala	bucephala	Nan
buchedd	igbesi aye	Nan
buteo	buteo	Nan
buckland	ilẹ	None
budd	anfani	Nan
buddsoddi	idokowo	Nan
buddugoliaeth	isegun	Nan
buenos	buenos	Nan
buffalo	ẹtu	Nan
buffay	ajekii	Nan
bugail	oluṣọ-agutan	Nan
budapest	budapest	Nan
caeth	muna	Nan
butler	alagbẹdẹ	Nan
buwch	maalu	Nan
bws	bosi	Nan
bwthyn	kekere	None
bwy	àjọ who	Nan
bwyd	oúnjẹ	None
bwydo	ono	Nan
bwyllgor	igbimo	Nan
bwynt	ojuami	Nan
bwyntiau	awọn aaye	Nan
bwys	pataki	Nan
bwysau	titẹ	Nan
bwysaur	pataki	Nan
bwysicaf	pataki julọ	Nan
bwysig	pataki	Nan
bwysigrwydd	pataki	Nan
bwyta	jẹ	Nan
bwrw	simẹnti	Nan
bwrpas	idi	Nan
bwriedir	o ti pinnu	Nan
bwriadu	ti a pinnu	Nan
buzzard	ariwo	Nan
bwa	tẹriba	Nan
bwdhaeth	buddhism	Nan
bwdhaidd	ẹlẹsin buddhist	Nan
bwdiaeth	buddhism	Nan
bwer	agbara	None
bwerau	agbara	None
butterflies	labalaba	None
bwlch	alafo	Nan
bwlgaria	bulgaria	Nan
bwlgariaid	bulgarians	Nan
bwnc	koko	Nan
bwrdd	tabili	None
bwrdeisdref	adugbo	Nan
bwrdeistref	adugbo	Nan
bwriad	idi	Nan
bwlgareg	ede	None
categoriactorion	awọn ẹka	Nan
caethion	awọn igbekun	Nan
caethwasiaeth	oko	None
carcharorion	awọn ẹlẹwọn	Nan
carcharwyd	ẹwọn	Nan
cardell	kaadi	Nan
cardinal	kadinal	Nan
carduelis	kadimisiti	Nan
carfan	ẹgbẹ	Nan
carfil	ogun	None
cariad	ni ife	Nan
caribi	caribi	Nan
caribî	kariaye	Nan
cario	gbe	None
carior	alagba	Nan
carl	carl	Nan
carlo	ọkọ ayọkẹlẹ	Nan
carlos	carlos	Nan
carchar	ẹwọn	Nan
carn	opoplopo	Nan
carbonifferaidd	carboniferous	Nan
carbocsylig	kekere	None
canrifoedd	sehin	Nan
cant	agbara	None
cantores	akorin	Nan
cantorion	awọn akọrin	Nan
cantref	cantref	Nan
canu	orin	Nan
canwr	akorin	Nan
cap	fila	Nan
cape	iho	Nan
capel	ijosin	None
capeli	awọn ile isin oriṣa	Nan
capten	balogun	Nan
car	ọkọ ayọkẹlẹ	Nan
caracalla	ẹgbẹ ẹṣin	Nan
caradoc	carradoc	Nan
carbon	erogba	Nan
carnedd	cairn	Nan
carneddau	awọn cairns	Nan
carol	carol	Nan
cassini	kasẹti	Nan
cassius	cassius	Nan
cast	simẹnti	Nan
castell	ile odi	Nan
castellnedd	ọrun	Nan
castor	castor	Nan
castro	fẹẹrẹ	Nan
cat	o nran	Nan
catalan	gbọdọ	Nan
catalaneg	ede	None
cataleiddio	catalysis	Nan
catalog	iwe ipolowo ọja	Nan
catalonia	catalonia	Nan
catalytig	ayase	Nan
català	iwe ipolowo ọja	Nan
caspian	amọja	Nan
caspia	caspia	Nan
casnewydd	newport	Nan
casglu	kó	Nan
carpathia	carpathia	Nan
carr	ọkọ ayọkẹlẹ	Nan
carreg	okuta	Nan
carter	ataja	Nan
carthago	ererege	Nan
cartilagaidd	kerekere	Nan
cartref	ile	Nan
canrifau	sehin	Nan
cartrefi	awọn ile	Nan
carwyn	carwyn	Nan
caryl	caryl	Nan
casa	esè	Nan
casachstan	ikọaláìdúró	Nan
casgliad	gbigba	Nan
casgliadau	awọn ikojọpọ	Nan
casglodd	o pejọ	Nan
caru	ni ife	Nan
canrif	kan	None
canrannau	ipin	None
canran	ogorun	Nan
calendr	kalẹnda	Nan
calidris	calidris	Nan
califfornia	california	Nan
called	lile	Nan
callestr	aladun	Nan
calon	obi	Nan
cam	igbesẹ	Nan
camau	awọn igbesẹ	Nan
cambig	cambig	Nan
cambodia	cambodia	Nan
cambria	cambria	Nan
cambriae	cambriae	Nan
cambriaidd	akérúbù	Nan
cambridge	kaadi	Nan
camel	ràkúnmí	Nan
caledwedd	ohun elo	Nan
caledonia	lile	Nan
caledi	lile	Nan
caled	lile	Nan
caethweision	ẹrú	Nan
caewyd	ni pipade	Nan
caffein	kanilara	Nan
caffi	kafe	Nan
caffè	kafe	Nan
cafodd	o ni	Nan
cafwyd	wa	Nan
camera	kamẹra	Nan
café	kafe	Nan
caiff	yoo	None
cain	yangan	Nan
cainc	ẹyẹ	Nan
cais	ohun elo	Nan
calan	agbọnrin	Nan
calandra	tilandi	Nan
calchfaen	okuta-ilẹ	Nan
cai	cai	Nan
caethwas	ẹrú	Nan
camgymeriad	aṣiṣe	Nan
camlesi	awọn ọna odo	Nan
canlynol	atẹle	Nan
canmlwyddiant	ọgọ́rùn-ún	Nan
canmol	iyin	Nan
cannoedd	ọgọọgọrun	Nan
canodd	o kọrin	Nan
canol	aarin	Nan
canolbarth	aarin wales	Nan
canolbwynt	ibudo	Nan
canolbwyntio	koju	Nan
canoldir	mẹditarenia	Nan
canolfan	aarin	Nan
canolfannau	awọn ile-iṣẹ	Nan
canoloesol	igba atijọ	Nan
canolog	aringbungbun	Nan
canolwr	kọsọ	Nan
canlyniadau	awọn esi	Nan
canlyniad	esi	Nan
canlyn	tẹle	Nan
canllawiau	awọn itọsona	Nan
camwy	camwy	Nan
can	sọ	None
cana	sọ	None
canada	canada	Nan
canadensis	alakan ara	Nan
cancr	alakan	Nan
caneuon	awọn orin	Nan
camlas	odo odo	Nan
canfod	ri	Nan
canhwyllau	abẹla	Nan
caniatau	gba	None
caniateir	gba	None
caniatáu	gba	None
caniatâd	igbanilaaye	Nan
canis	ibori	None
canllaw	itọsọna	Nan
cangen	ẹka	Nan
brønsted	brønsted	Nan
chwedlau	arosọ	Nan
chwedlonol	arosọ	Nan
cwsg	sun	None
cwta	kan	None
cwtiad	ikun	Nan
cwtiadwennol	arogbogbo	Nan
cwymp	ṣubu	Nan
cwympo	subu	Nan
cwympodd	o ṣubu	Nan
cychod	kekere	None
cychwyn	bẹrẹ	Nan
cychwyna	bẹrẹ	Nan
cychwynnodd	o bẹrẹ	Nan
cychwynodd	o bẹrẹ	Nan
cyd	co	Nan
cyddestun	o tọ	Nan
cydffactorau	àjọ-ifosiwewe	Nan
cwrw	oti sekengberi	Nan
cydnabod	itewogba	Nan
cwrs	dajudaju	Nan
cwrdd	pàdé	Nan
cwch	omi	None
cwellyn	ọmọ	None
cweryl	aáwọ̀	Nan
cwestiynau	awọn ibeere	Nan
cwlt	egbeokunkun	Nan
cwm	afonifoji	Nan
cwmni	ile-iṣẹ	Nan
cwmniau	awọn ile-iṣẹ	Nan
cwmnïau	awọn ile-iṣẹ	Nan
cwmpas	dopin	Nan
cwmpasu	ideri	Nan
cwmwl	awọsanma	Nan
cwningod	ehoro	Nan
cwpan	kan	None
cwpled	tọkọtaya	Nan
cwrdeg	kuridi	Nan
cydnabyddir	gba	None
cydweithio	ifowosowopo	Nan
cydweithredol	ifọwọsowọpọ	Nan
cyfansoddwyr	oluṣeto	Nan
cyfanswm	lapapọ	Nan
cyfarfod	ipade	Nan
cyfarfu	ó	None
cyfarfur	ohun elo	Nan
cyfartaledd	aropin	Nan
cyfartalog	aropin	Nan
cyfarthrebu	ibasọrọ	Nan
cyfarwydd	faramọ	Nan
cyfarwyddo	taara	Nan
cyfateb	tuntun	None
cyfatebol	deede	Nan
cyfathrach	ajọṣepọ	Nan
cyfathrebu	ibasọrọ	Nan
cyfeilio	ba ẹgbẹ	Nan
cyfansoddwr	olupilẹṣẹ	Nan
cyfansoddodd	o kq	Nan
cyfansoddion	awọn iṣiro	Nan
cyfansoddiad	t’olofin	Nan
cydweithredu	ifowosowopo	Nan
cydymerawdwr	olú ọba	Nan
cyf	sọ	None
cyfaddefodd	eleyi	None
cyfagos	nitosi	None
cyfaint	iwọn didun	Nan
cyfalaf	olu	Nan
cwbl	gbogbo	Nan
cyfalafol	kapitalisimu	Nan
cyfan	gbogbo	Nan
cyfandir	kọntinia	Nan
cyfandiroedd	awọn aye	Nan
cyfandirol	continental	Nan
cyfanrwydd	odindi	Nan
cyfansawdd	yellow	Nan
cyfansoddi	ikowe	Nan
cyfamod	majẹmu	Nan
cwantwm	kuatomu	Nan
cusanu	fenukonu	Nan
cusan	ifẹnukonu	Nan
crochenwaith	amọ	Nan
croen	awọ	Nan
croenddu	dudu	Nan
croenwyn	funfun	Nan
croes	rekọja	Nan
croesbig	ọkọ oju-omi	Nan
croesgadau	ogun	None
croesgadwyr	awọn onija	Nan
croesi	líla	Nan
croesir	o ti rekoja	Nan
croeso	kaabọ	Nan
croew	robi	Nan
cromosomau	awọn ajakalẹmu	Nan
cronfa	inawo	Nan
cronfeydd	owo	Nan
croatiaid	awọn ara ilu kroati	Nan
croatia	kroatia	Nan
criwiau	awọn ẹgbẹ	Nan
criw	atuko	Nan
creta	jinjin	Nan
creu	ẹda	Nan
creur	ẹda	Nan
crewyd	ṣẹda	Nan
criafolen	rowan	Nan
crib	ogun	None
criced	ere kiriketi	Nan
crossbill	ohun iyipo	Nan
cricieth	criccieth	Nan
cristatus	kirisita	Nan
cristionogaeth	kristiẹniti	Nan
cristionogion	awọn kristiani	Nan
cristionogol	kristiẹni	Nan
cristnogaeth	kristiẹni	Nan
cristnogion	kristiẹni	Nan
cristnogol	kristiẹni	Nan
crist	kristi	Nan
cyfeillgarwch	ore	Nan
croth	ọmọ	None
croyw	alabapade	Nan
crëyr	awon oloorun	Nan
cu	cu	Nan
cuba	kuba	Nan
cuckoo	cuckoo	Nan
cudd	farapamọ	Nan
cuddio	fipamọ	Nan
cudyll	ẹrin	Nan
cul	dín	Nan
culdir	culdir	Nan
culfor	okun	Nan
culhwch	arosọ	Nan
cunningham	cunningham	Nan
curiad	lu	Nan
curie	curie	Nan
curlew	iṣupọ	Nan
crëwyd	ṣẹda	Nan
crysau	seeti	Nan
crynswth	gbogbogbo	None
crynodiad	fojusi	Nan
crud	jojolo	Nan
cruz	cruz	Nan
crwbanod	ijapa	Nan
crwm	te	Nan
crwn	yika	Nan
cry	kigbe	Nan
crybwyll	mẹnuba	Nan
crowley	igbọnrin	Nan
crybwyllwyd	mẹnuba	Nan
cryfach	okun sii	Nan
cryfaf	lágbára	Nan
cryfder	okun	Nan
cryfhau	okun	Nan
cryfhaur	ni okun	Nan
cryn	akude	Nan
cryno	ṣoki	Nan
cryf	lagbara	Nan
crested	fẹẹrẹ	Nan
cyfeiria	tọka	Nan
cyfeiriadau	awọn adirẹsi	Nan
cyhydedd	olumeta	Nan
cyhydeddol	dọgbadọgba	Nan
cyhydnos	equinox	Nan
cyhyr	iṣan	Nan
cyhyrau	iṣan	Nan
cylch	circle	Nan
cylchdro	iyipo	Nan
cylchdroi	iyipo	Nan
cylchfa	agbegbe aago	Nan
cylchgrawn	iwe irohin	Nan
cylchgronau	awọn iwe irohin	Nan
cylchoedd	awọn iyika	Nan
cylchol	kẹkẹ oniye	Nan
cylchred	ọmọ	None
cylchrediad	san	Nan
cyhuddwyd	onimo	Nan
cyllidol	owo	Nan
cyhuddo	kan	None
cyhuddiad	ẹsùn	Nan
cyfweliad	ifọrọwanilẹnuwo	Nan
cyfyng	rọ	Nan
cyfyngedig	lopin	Nan
cyfyngiadau	awọn ihamọ	Nan
cyfyngu	ihamọ	Nan
cyfystyr	amuṣiṣẹpọ	Nan
cygnus	cygnus	Nan
cyhoedd	gbangba	Nan
cyhoeddi	te	Nan
cyhoeddiad	ikede	Nan
cyhoeddiadau	jẹ ti	Nan
cyhoeddir	yoo	None
cyhoeddodd	o kede	Nan
cyhoeddus	gbangba	Nan
cyhoeddwyd	ti kede	Nan
cyhuddiadau	ẹsùn	Nan
cymaint	pupọ gaan	Nan
cymalau	awọn gbolohun ọrọ	Nan
cymalwst	gbolohun ọrọ	Nan
cymraeg	àwæn	Nan
cymreig	welsh	Nan
cymro	olóṣèré	Nan
cymru	oyo	Nan
cymrun	elegbe	Nan
cymrur	olóṣèré	Nan
cymry	awọn eniyan wels	Nan
cymryd	mu	Nan
cymuned	agbegbe	Nan
cymunedau	awọn agbegbe	Nan
cymylau	awọsanma	Nan
cymysg	dapọ	Nan
cymysgedd	adalu	Nan
cymysgu	dapọ	Nan
cyn	ṣaaju	Nan
cymorth	egba	None
cymoedd	awọn afonifoji	Nan
cymhwysiad	ohun elo	Nan
cymhlethdod	complexity	Nan
cymanwlad	l’owo	Nan
cymar	mate	Nan
cymdeithas	awujọ	Nan
cymdeithaseg	sociology	Nan
cymdeithasol	lawujọ	Nan
cymedrig	tumọ	Nan
cymedrol	iwọntunwọnsi	Nan
cyfunrywioldeb	ilopọ	Nan
cymeriad	ohun kikọ	Nan
cymerwyd	mu	Nan
cymeryd	mu	Nan
cymhariaeth	lafiwe	Nan
cymharol	ibatan	Nan
cymharu	afiwe	Nan
cymhedrol	iwọntunwọnsi	Nan
cymhleth	eka	None
cymeriadau	ohun kikọ	Nan
cyfuniad	apapo	Nan
cyfundrefnau	awọn akoko ijọba	Nan
cyfundrefn	eto	Nan
cyflawn	pari	Nan
cyflawni	ṣaṣeyọri	Nan
cyflawnwyd	ti waye	Nan
cyfle	aye	Nan
cyflenwad	ipese	Nan
cyflenwadau	agbari	Nan
cyflenwol	ibaramu	Nan
cyfleu	fihan	None
cyflogi	gba	None
cyflwr	majemu	Nan
cyflwyniad	igbejade	Nan
cyflwyno	tẹriba	Nan
cyflwynodd	o ṣafihan	Nan
cyflwynor	olutayo	Nan
cyflwynwyd	gbekalẹ	Nan
cyfieithwyd	itumọ	Nan
cyfieithu	translation	Nan
cyfieithiadau	ogbufọ	Nan
cyfieithiad	translation	Nan
cyfeiriadur	iwe itọsọna	Nan
cyfeiriar	itọkasi	Nan
cyfeirio	itọkasi	Nan
cyfeiriodd	o tọka	Nan
cyfeirir	tọka	Nan
cyfeiriwyd	tọka	Nan
cyferbyniaeth	itansan	Nan
cyflwynwyr	awọn olutayo	Nan
cyffelyb	jọra	Nan
cyffredin	wọpọ	Nan
cyffredinol	gbogboogbo	Nan
cyffuriau	awọn oogun	Nan
cyffwrdd	fọwọkan	Nan
cyfiawn	olododo	Nan
cyfiawnder	ododo	None
cyfieithad	translation	Nan
cyffiniau	agbegbe	Nan
cyfeiriad	adirẹsi	Nan
cyflwynydd	olutayo	Nan
cyflymaf	yiyara	Nan
cyfreithiau	ofin	None
cyfreithiol	t’olofin	Nan
cyfreithiwr	agbejoro	Nan
cyfres	jara	Nan
cyfrif	akọọlẹ	Nan
cyfrifiad	ìkànìyàn	Nan
cyfrifiadur	kọmputa	Nan
cyfrifiadureg	komputa	None
cyfrifiadurol	kọmputa	Nan
cyfrifiaduron	awọn kọmputa	Nan
cyfrol	iwọn didun	Nan
cyfrolau	ipele	None
cyfrwng	alabọde	Nan
cyfryngau	media	Nan
cyfryw	iru	Nan
cyfredol	lọwọlọwọ	Nan
cyfrannu	idasi	Nan
cyfraniad	ilowosi	Nan
cyfranc	pin	Nan
cyflymder	iyara	Nan
cyflymu	isare	None
cyfnewid	paṣipaarọ	Nan
cyfnewidfa	paṣipaarọ	Nan
cyfnod	asiko	Nan
cyfnodau	awọn akoko	Nan
cyfnodol	igbakọọkan	Nan
cyflym	yara	Nan
cyfoes	imusin	None
cyfoethocaf	richest	Nan
cyfoethog	ọlọrọ	Nan
cyfog	inu rirun	Nan
cyfradd	oṣuwọn	Nan
cyfraddau	awọn oṣuwọn	Nan
cyfraith	ofin	None
cyfran	pin	Nan
cyfoeth	ọrọ	Nan
chwedloniaeth	itan aye atijọ	Nan
creol	apaadi	Nan
creigiau	awọn apata	Nan
clement	clement	Nan
cleopatra	cleopatra	Nan
cliath	akoj	Nan
cliff	àpáta	Nan
clifford	clifford	Nan
clinton	clinton	Nan
clitoris	iṣọn-alọ	Nan
clive	itẹlera	Nan
clo	tiipa	Nan
cloddfeydd	maini	Nan
cloddio	ìgbín	Nan
cloddir	mined	Nan
clogwyn	àpáta	Nan
clogwyni	cliffs	Nan
clorin	kiloraidi	Nan
clefydau	arun	None
club	ọgọ	Nan
clefyd	aisan	Nan
clawdd	banki	Nan
cipiwyd	gba	None
circus	circle	Nan
cisalpina	cisalpina	Nan
city	ilu	Nan
ciwb	kuubu	Nan
ciwba	kuba	Nan
cl	cl	Nan
claddu	isinku	Nan
claddwyd	sin	Nan
clan	idile	Nan
clapton	clapton	Nan
clara	clara	Nan
clarke	clarke	Nan
clasurol	ayebaye	Nan
claude	robi	Nan
clawr	ideri	Nan
cludiant	irinna	Nan
cludir	gbigbe	Nan
cludo	irinna	Nan
cod	koodu	Nan
codau	awọn koodu	Nan
codedig	dide	Nan
codi	ere	Nan
codiad	dide	Nan
codir	agbara	None
cododd	o dide	Nan
codwyd	ni a ji dide	Nan
coed	igi	Nan
coeden	kan	None
coedwig	igbo	Nan
coedwigoedd	igbo	Nan
coegylfinir	dãmu	Nan
coesau	esè	Nan
cof	iranti	Nan
cocteau	cocteau	Nan
cocos	awọn akukọ	Nan
coco	koko	Nan
cochrane	cochrane	Nan
clwb	ọgọ	Nan
clwyd	ilekun nla	Nan
clwyf	egbo	None
clybiau	ọgọ	Nan
clymu	tai	Nan
clywed	gbọ	Nan
cm	cm	Nan
cipiodd	o mu	Nan
cmc	cmc	Nan
cnau	eso	Nan
cnewyllyn	ekuro	Nan
cnydau	awọn irugbin	Nan
co	co	Nan
cobach	kekere	None
coblyn	cobble	Nan
coch	pupa	None
cmcpen	cmcpen	Nan
cipio	mú	Nan
cinetig	ibatan	Nan
cinerea	cinerea	Nan
chyfandir	kọntinia	Nan
chyfathrach	ajọṣepọ	Nan
chyfeiriad	itọsọna	Nan
chyfeirir	tọka	Nan
chyffuriau	awọn oogun	Nan
chyfiawnder	ododo	None
chyflawni	láti ṣàṣeyọrí	Nan
chyflwyno	tẹriba	Nan
chyfnod	asiko	Nan
chyfoethog	ọlọrọ	Nan
chyfres	jara	Nan
chyfrif	ka	Nan
chyhoeddodd	o kede	Nan
chyhoeddwyd	ti kede	Nan
chylchdro	iyipo	Nan
chydnabod	itewogba	Nan
chyda	pẹlu	Nan
chychod	kekere	None
chwysu	lagun	Nan
chwefror	oṣu kínní	Nan
chwerw	kikoro	Nan
chwilen	beetle	Nan
chwiliedydd	wadi	Nan
chwiliedyddion	wadi	Nan
chwilio	wa	Nan
chwiorydd	arabinrin	Nan
chymdeithas	awujọ	Nan
chwith	osi	Nan
chwm	afonifoji	Nan
chwmpas	dopin	Nan
chwyddo	wiwu	Nan
chwyldro	iyika	Nan
chwyldroadol	rogbodiyan	None
chwymp	subu	Nan
chwys	lagun	Nan
chwithdde	osi	Nan
cofalent	covalent	Nan
chymdeithasau	awọn awujọ	Nan
chymerodd	o mu	Nan
chysylltu	kan	None
chytunodd	gba	None
chânt	le	None
ci	aja	Nan
cia	bawo	Nan
cib	cib	Nan
ciconia	ekini	Nan
ciconiaid	awọn aami	Nan
ciconiiformes	ciconiiformes	Nan
cig	eran	Nan
cigydd	alagbata	Nan
cilgwyn	cilgwyn	Nan
cill	sẹẹli	Nan
cilmeri	ibuso	None
cilogram	kilo	Nan
chysylltiadau	awọn olubasọrọ	Nan
chyrraedd	de	Nan
chyrhaeddodd	o de	Nan
chyrff	awọn ara	Nan
chymerwyd	mu	Nan
chymharu	afiwe	Nan
chymorth	egba	None
chymru	oyo	Nan
chymuned	agbegbe	Nan
chymunedau	awọn agbegbe	Nan
chyn	ṣaaju	Nan
chymdeithasol	lawujọ	Nan
chyngheiriaid	awọn ibatan	Nan
chynhyrchiad	gbóògì	Nan
chynhyrchu	gbóògì	Nan
chynnal	muduro	Nan
chynnwys	akoonu	Nan
chynrychioli	aṣoju	Nan
chynrychiolwyr	awọn aṣoju	Nan
chyrchoedd	igbogun	Nan
chynhaliwyd	waye	Nan
creigiog	apata	Nan
coffee	kọfi	Nan
coffin	òkú	None
corn	agbado	None
cornchwiglen	wiwakọ	Nan
cornel	igun	Nan
cornelia	cornerelia	Nan
corniog	ibanilẹru	Nan
coron	ade	Nan
coropleth	choropleth	Nan
corporation	ile-iṣẹ	Nan
corpus	okùn	Nan
corris	corris	Nan
corryn	spider	Nan
cors	mars	None
corsica	corsica	Nan
corswennol	boggy	Nan
corvus	corvus	Nan
corhwyaden	tẹẹrẹ	Nan
corwen	corwen	Nan
corhedydd	opo gigun ti epo	Nan
corff	ara	Nan
copi	ẹda	Nan
copies	awọn ẹda	Nan
copland	copland	Nan
copog	rọ	Nan
copr	bàbà	Nan
copy	ẹda	Nan
copying	didakọ	Nan
copyleft	ẹda adakọ	Nan
copyright	aṣẹkikọ	Nan
copïau	awọn ẹda	Nan
coraciiformes	awọn coraciiformes	Nan
coran	ohun kohun	Nan
cordiau	okùn	Nan
cordog	okùn	Nan
corea	corea	Nan
corfforol	ti ara	Nan
costa	etikun	Nan
cotwm	owu	Nan
counties	awọn kaunti	Nan
credai	o gbagbọ	Nan
credant	wọn	None
credid	o ti gbà	Nan
credinwyr	onigbagbọ	Nan
credir	o ti gbagbọ	Nan
credoau	awọn igbagbọ	Nan
credodd	o gbagbọ	Nan
credu	gbagbọ	Nan
credwyd	ro	None
credyd	kirẹditi	Nan
crefft	iṣẹ ọwọ	Nan
crefydd	ẹsin	Nan
crefyddau	awọn ẹsin	Nan
crefyddol	ẹlẹsin	Nan
crehyrod	awon oloorun	Nan
cred	igbagbọ	Nan
creawdwr	eleda	Nan
creadigol	ẹda	Nan
cread	ẹda	Nan
country	orilẹ-ede	Nan
court	kootu	Nan
courteney	iteriba	Nan
cover	ideri	Nan
covers	awọn ibora	Nan
cowper	konbo	Nan
cox	cox	Nan
copar	bàbà	Nan
cpd	cpd	Nan
craidd	mojuto	Nan
craig	apata	Nan
craigglais	craigglais	Nan
cramen	erunrun	Nan
crane	kireni	Nan
cras	inira	Nan
crazy	irikuri	Nan
crai	aise	Nan
copaon	ga ju	Nan
copa	akopọ	Nan
cooper	konbo	Nan
collasant	wọn	None
colledion	adanu	Nan
college	kọlẹji	Nan
colli	sọnu	Nan
collins	collins	Nan
collodd	o padanu	Nan
collwyd	sọnu	Nan
colofn	ẹka	Nan
colofnau	awọn ọwọn	Nan
colombia	agba	None
colomen	àdàbà	Nan
colomennod	ẹyẹle	Nan
colony	ileto	Nan
coluddyn	iṣan	Nan
columba	kolumba	Nan
collared	akojọpọ	Nan
colin	choline	Nan
coligny	ẹlẹṣẹ	Nan
coli	coli	Nan
cofiadwy	iranti	Nan
cofiant	isedale	Nan
cofio	ranti	Nan
cofnod	igbasilẹ	Nan
cofnodi	gbigbasilẹ	Nan
cofnodion	awọn igbasilẹ	Nan
cofnodir	o gbasilẹ	Nan
columbia	ẹyẹ	Nan
cofnododd	o gbasilẹ	Nan
cog	cog	Nan
cogau	cogs	Nan
coginio	sise	None
cola	cola	Nan
cold	tutu	Nan
coleg	kọlẹji	Nan
colera	arun	None
cofrestru	iforukọsilẹ	Nan
coffi	kọfi	Nan
columbus	akọmọ	Nan
combin	apapọ	Nan
condemnio	da	None
condemniodd	o lẹbi	Nan
conditions	ipo	None
conffederasiwn	confederation	Nan
confoederatio	confoederatio	Nan
cong	apejọ	Nan
congo	congo	Nan
conrad	papọ	Nan
considered	ṣakiyesi	Nan
constantius	constantius	Nan
conswl	aṣoju ijọba	Nan
contains	ni	Nan
control	iṣakoso	Nan
conwy	iṣiro	Nan
cook	alase	Nan
concwest	iṣẹgun	Nan
concrwyd	nja	Nan
con	con	Nan
comunidad	communidad	Nan
come	wá	Nan
comedi	awada	Nan
comin	wọpọ	Nan
comisiwn	igbimọ	Nan
comiwnyddiaeth	communism	Nan
comiwnyddion	awọn alagbọrọ	Nan
comiwnyddol	ọmọ	None
colwyn	colwyn	Nan
commentarii	asọye	Nan
commodus	ẹṣẹ	Nan
common	wọpọ	Nan
commonly	wọpọ	Nan
comoros	comoros	Nan
compact	iwapọ	Nan
company	ile-iṣẹ	Nan
compilation	ikojọpọ	Nan
commitment	ifaramo	Nan
brïeg	afarawe	Nan
brân	pọ	Nan
brythoniaid	oloogun	Nan
angeles	awọn angeles	Nan
angeleslos	angeleslos	Nan
angelus	angẹli	Nan
angen	nilo	Nan
angenrheidiol	pataki	Nan
angerddol	olufẹ	Nan
angharad	irunu	Nan
anghenion	aini	Nan
angheuol	apani	Nan
anghydffurfiol	ti kii-conformist	Nan
anghydfod	àríyànjiyàn	Nan
anghyfarwydd	aimọ	Nan
anghyffredin	ko	None
anghyfreithlon	arufin	Nan
anghytundeb	àríyànjiyàn	Nan
angel	angẹli	Nan
anghytuno	gba	None
angau	iku	None
anfon	firanṣẹ	Nan
aneddiadau	awọn ibugbe	Nan
aneglur	koyewa	Nan
aneirin	aneirin	Nan
anelid	ifọkansi	Nan
anelwyd	ifọkansi	Nan
aneu	tún	Nan
anferth	tobi	Nan
anfetel	ti kii-irin	Nan
anfetelau	ti kii-irin	Nan
anffodus	laanu	Nan
anffurfiol	informal	Nan
anffyddwyr	alaigbagbọ	Nan
anfiolegol	ti kii-oniye	Nan
anfodlon	ainitẹlọrun	Nan
anfodlonrwydd	ainitẹlọrun	Nan
anfonodd	o ranṣẹ	Nan
anghywir	ko	None
anglesey	igun	Nan
anglicanaidd	angẹli	Nan
annibynnol	olominira	Nan
annibynol	olominira	Nan
annibynwyr	awọn ominira	Nan
annog	gba	None
annwyd	òtútù	Nan
annwyl	ololufe	Nan
anodd	nira	Nan
anoddaf	nira julọ	Nan
anorganig	ailorukọ	Nan
another	omiiran	Nan
anrhegion	awọn ẹbun	Nan
anrheithio	ikogun	Nan
anrhydedd	ọlá	Nan
anrhydeddus	ẹni-ọlá	Nan
anrhywiol	asepọ	Nan
annibyniaeth	ominira	Nan
annhebyg	ko	None
annerbyniol	itẹwẹgba	Nan
anne	arene	Nan
angola	angola	Nan
angry	binu	Nan
anhebyg	ko	None
anhrefn	rudurudu	Nan
anhwylder	rudurudu	Nan
anhysbys	aimọ	Nan
anial	aṣálẹ	Nan
andy	andy	Nan
anialwch	aṣálẹ	Nan
anifeiliaid	ẹranko	Nan
animalia	ẹranko	Nan
animeiddiedig	ti ere idaraya	Nan
aniston	aganran	Nan
ankara	ankara	Nan
ann	ní	None
annalen	iparun	Nan
anifail	ẹranko	Nan
andwyol	alailanfani	Nan
andronikos	andronikos	Nan
andrew	andrew	Nan
amlach	julọ igba	Nan
amlaf	julọ igba	Nan
amldduwiaeth	polytheism	Nan
amldduwiol	ọpọlọpọ awọn	Nan
amlder	igbohunsafẹfẹ	Nan
amlgellog	multicellular	Nan
amlwch	igbohunsafẹfẹ	Nan
amlwg	o han ni	Nan
amlycaf	olokiki julọ	Nan
amlygrwydd	olokiki	Nan
amlygu	saami	Nan
amod	majemu	Nan
amodau	ipo	None
among	laarin	None
amonia	amonia	Nan
aml	nigbagbogbo	Nan
amis	amis	Nan
amino	amino	Nan
amhosibl	soro	Nan
americanaidd	ara ilu amẹrika	Nan
americanwyr	ara ilu amẹrika	Nan
amerig	america	Nan
amgueddfa	musiọmu	Nan
amgylch	yika	Nan
amgylchedd	ayika	Nan
amgylcheddol	ayika	Nan
amryw	oniruru	Nan
amgylchiadau	awọn ayidayida	Nan
amgylchynu	yika	Nan
amgylchynur	yika	Nan
amharu	idalọwọduro	Nan
amhendant	aimọkan	Nan
amheuaeth	aniani	Nan
amhoblogaidd	aibikita	Nan
amhosib	soro	Nan
amgylchynir	yika	Nan
ansawdd	didara	Nan
amrywia	yatọ	Nan
amrywiadau	awọn iyatọ	Nan
anarferol	dani	None
anas	anus	Nan
anathraidd	aidibajẹ	Nan
anatolia	anatolia	Nan
anatomeg	anatomi	Nan
anatomi	anatomi	Nan
anatomy	anatomi	Nan
anawsterau	awọn ìṣoro	Nan
anc	anc	None
ancient	atijọ	Nan
and	ati	Nan
andaman	ati hamani	Nan
andes	andes	Nan
andorra	andorra	Nan
andrea	andrea	Nan
anaml	ṣọwọn	Nan
analog	afọwọkọ	Nan
analeiddio	ifasimu	Nan
anafu	ipalara	Nan
amrywiaeth	orisirisi	None
amrywiaethau	awọn iyatọ	Nan
amrywio	yatọ	Nan
amrywiol	oniruru	Nan
amrywion	awọn iyatọ	Nan
amser	aago	Nan
amstel	amẹ́ẹ́rẹ́	Nan
amrywiad	iyatọ	Nan
amsterdam	amsterdam	Nan
amwythig	shrewsbury	Nan
an	awọn	Nan
ana	ana	Nan
anad	ìmí	Nan
anadlu	mimi	Nan
anaerobig	anaerobic	Nan
anafiadau	nosi	Nan
amsugno	gbigba	Nan
americana	americana	Nan
ansefydlog	riru	Nan
anser	esi	Nan
argae	idido	Nan
argentina	argentina	Nan
argloddiau	embankments	Nan
arglwydd	oluwa	Nan
arglwyddes	arabinrin	Nan
arglwyddiaeth	oluwa	Nan
argraff	iwunilori	Nan
argraffiad	àtúnse	Nan
argraffiadau	awọn itọsọna	Nan
argrafflenni	awọn atẹwe	Nan
argraffu	titẹ sita	Nan
argraffwyd	tejede	Nan
argyfwng	rogbodiyan	None
argymhellion	awọn iṣeduro	Nan
arhosodd	o duro	Nan
arfordirol	etikun	Nan
arian	owo	Nan
arfordiroedd	àgbegbe	Nan
arfon	arfon	Nan
ardudwy	ardudwy	Nan
are	jẹ	Nan
areola	areola	Nan
arestio	mú	Nan
arfau	awọn ohun ija	Nan
arfbais	orileede	None
arfer	adaṣe	Nan
arferai	o lo lati wa ni	Nan
arferiad	aṣa	Nan
arferiadau	awọn kọsitọmu	Nan
arferid	lo lati wa ni	Nan
arferion	awọn kọsitọmu	Nan
arferir	nigbagbogbo lo	Nan
arferol	deede	Nan
arfog	ni ihamọra	Nan
arfordir	etikun	Nan
ariannin	ilu amẹrika	Nan
ariannol	owo	Nan
aries	awọn aries	Nan
arnofio	omi	None
arnold	arnold	Nan
arnynt	wọn	None
arolwg	iwadi	None
aromatig	oorun didun	Nan
aros	duro de	Nan
arrhenius	agberaga	Nan
arsylwadau	awọn akiyesi	Nan
art	aworan	Nan
arth	jẹri	Nan
arthur	akite	Nan
arthuraidd	arthritic	Nan
artiffisial	atọwọda	Nan
artist	olorin	Nan
artistiaid	awọn oṣere	Nan
arno	lórí i rẹ	Nan
arni	lórí i rẹ	Nan
arnhem	arnhem	Nan
armeniaid	armenia	Nan
aristoteles	awọn aristotles	Nan
aristotle	aristotle	Nan
aristotlys	aristotle	Nan
arizona	arizona	Nan
arlein	lori ayelujara	Nan
arllwys	tú	None
arloeswyr	aṣáájú-ọ̀nà	Nan
ardea	ga	Nan
arlunio	iyaworan	Nan
arlunydd	olorin	Nan
arlywydd	adari	Nan
arlywyddiaeth	ààrẹ	Nan
arlywyddion	awọn alaṣẹ	Nan
arlywyddol	ajé	Nan
armellog	oorun didun	Nan
armenia	armenia	Nan
arlunwyr	awọn oṣere	Nan
arddull	ara	Nan
arddu	ogba	Nan
arddodiadau	ilana	None
anturiaethau	seresere	Nan
anwedd	oru	Nan
anwes	ohun ọsin	Nan
anws	anus	Nan
anwybyddu	foju	Nan
any	eyikeyi	Nan
anything	ohunkohun ti	Nan
ap	ap	Nan
apartheid	eleyameya	Nan
apelio	afilọ	Nan
apocryffaidd	apofo	Nan
apple	apu	Nan
applies	kan	None
apus	apus	Nan
apwyntiwyd	yan	None
antonius	antonius	Nan
antonio	antonio	Nan
anton	anton	Nan
antioch	ori	None
ansicr	aidaniloju	Nan
ansicrwydd	aidaniloju	Nan
ansoddair	ajẹtífù	Nan
ansoddeiriau	awọn afẹsodi	Nan
answyddogol	laigba aṣẹ	Nan
ant	kokoro	Nan
antarctica	antarctica	Nan
aq	aq	Nan
antarctig	antarctic	Nan
anthem	orin oloyin	Nan
anthemau	awọn aṣebiakọ	Nan
anthony	oloye	None
anthropoleg	anthropology	Nan
anthropolegwyr	alamọdaju eniyan	Nan
anthus	anthus	Nan
antigua	antigua	Nan
anterth	tente oke	Nan
ansefydlogrwydd	ailagbara	Nan
ar	loju	Nan
arabeg	.rúbù	Nan
archeolegol	igba atijọ	Nan
archesgob	archbishop	Nan
archoffeiriad	àlùfáà àgbà	Nan
archoffeiriades	àlùfáà àgbà	Nan
archwilio	se ayewo	Nan
archwiliwyd	ayewo	Nan
arctic	akitiki	Nan
arctig	akitiki	Nan
arctigalpaidd	arctic arctic	Nan
ardal	agbegbe	Nan
ardaloedd	awọn agbegbe	Nan
ardd	ọgba	Nan
arddangos	ifihan	Nan
arddangosir	han	Nan
ardderchog	o tayọ	Nan
archaeolegol	igba atijọ	Nan
archaeoleg	igba atijọ	Nan
arch	ọririn	Nan
arcadius	arcadius	Nan
arabia	arabia	Nan
arabiaid	arab	Nan
arabica	arabica	Nan
araf	lọra	Nan
arafu	fa fifalẹ	Nan
aragon	wiwoon	Nan
araith	ọrọ	Nan
arabaidd	.rúbù	Nan
arall	omiiran	Nan
aran	burẹdi	Nan
arbed	fipamọ	Nan
arbenigo	alagbara	Nan
arbenigwyr	awọn amoye	Nan
arbennig	pataki	Nan
arbrofion	awọn adanwo	Nan
arc	aaki	Nan
arallfyd	miiran aye	Nan
artistig	iṣẹ ọna	Nan
american	ara ilu amẹrika	Nan
amedr	amita	Nan
adfer	imupada	Nan
adferiad	gbigba	Nan
adferwyd	gba	None
adfywiad	isoji	Nan
adler	adarí	Nan
adlewyrchu	tan ojiji	Nan
adlewyrchur	tan ojiji	Nan
adloniant	idanilaraya	Nan
adlonni	ṣe ere idaraya	Nan
adnabod	idanimọ	Nan
adnabyddir	mọ	Nan
adnabyddus	daradara mọ	Nan
adnewyddu	isọdọtun	Nan
adnod	ẹsẹ	None
adnodd	awọn olu .ewadi	Nan
adfeilion	dabaru	Nan
adnoddau	orisun	None
aderyndrycin	aderyndrycin	Nan
adenydd	iyẹ	Nan
addurno	ọṣọ	Nan
addysg	eko	None
addysgol	eto ẹkọ	Nan
addysgu	nkọ́ni	Nan
adeg	aago	Nan
adegau	míràn	None
adeilad	ile	Nan
adeiladau	awọn ile	Nan
adeiladodd	o kọ	Nan
adeiladu	ikole	Nan
adeiladur	be	Nan
adeiladwaith	ikole	Nan
adeiladwyd	itumọ	Nan
adeiledd	be	Nan
adennill	bọsipọ	Nan
aderyn	ẹyẹ	Nan
adolf	adágún	Nan
adran	apakan	Nan
adrannau	awọn apa	Nan
aelwyd	ìdílé	Nan
aer	ategun	Nan
aerodynameg	aerodynamics	Nan
aeth	o lọ	Nan
aethant	wọn	None
aethpwyd	ti lọ	Nan
af	st.	Nan
afael	di mu	Nan
afal	apu	Nan
afalau	awọn apple	Nan
affrica	ile afirika	Nan
affrican	afirika	Nan
affricanaidd	afirika	Nan
affricanwyr	awọn afirika	Nan
affrig	afirika	Nan
aelodwladwriaethau	egbe	None
aelodaur	ọmọ	None
aelodau	ọmọ	None
aelodaeth	ẹgbẹ	Nan
adref	ile	Nan
adria	adria	Nan
adrianople	adrian eniyan	Nan
adrodd	ijabọ	Nan
adroddiad	ijabọ	Nan
adroddiadau	awọn ijabọ	Nan
adwaenir	mọ	Nan
addrefnu	pese	Nan
adwaith	ifura	Nan
adweithiau	awọn aati	Nan
adweithio	fesi	Nan
aeddfed	ogbo	Nan
aedui	aedui	Nan
aegeaidd	aegese	Nan
aeleg	ẹkọ akẹkọ	Nan
aelod	ọmọ	None
adweithia	fesi	Nan
addolir	o ti wa ni jọsin	Nan
addoliad	jọsin	Nan
addoli	jọsin	Nan
aberthu	rúbọ	Nan
aberystwyth	aberystwyth	Nan
about	nipa	Nan
above	loke	Nan
abraham	rabúráhámù	Nan
abrahamig	abrahamiki	Nan
abse	abse	Nan
absenoldeb	isansa	Nan
ac	ati	Nan
academaidd	omowe	Nan
academi	omowe	Nan
academic	omowe	Nan
academy	omowe	Nan
acen	isọrọsi	Nan
achau	pedigrees	Nan
aberteifi	swansea	Nan
abertawe	swansea	Nan
aberpennar	estuary	Nan
aberhonddu	brecon	Nan
+	+	Nan
+x	+ x	Nan
<i>	<i>	Nan
=	=	Nan
>	&gt;	Nan
a	a	Nan
aaron	aaron	Nan
achlysur	ayeye	Nan
ab	ab	Nan
abaty	tẹriba	Nan
aber	estuary	Nan
aberaeron	aberaeron	Nan
aberconwy	estuary	Nan
aberffraw	abuku	Nan
abergwaun	ẹja ẹja	Nan
abergwyngregyn	abergwyngregyn	Nan
abad	abbot	Nan
afghanistan	afiganisitani	Nan
achlysurol	lẹẹkọọkan	Nan
achosi	fa	Nan
acwstig	ẹyẹ	Nan
ad	ipolowo	Nan
adael	lọ	Nan
adain	iyẹ	Nan
adam	adam	Nan
adams	adams	Nan
adar	àwọn ẹyẹ	Nan
adawyd	osi	Nan
add	ṣafikun	Nan
adda	ṣèlérí	Nan
addas	o dara	Nan
addaswyd	fara	Nan
addewid	ṣèlérí	Nan
addition	afikun	Nan
addo	ṣèlérí	Nan
acw	ní	None
actorion	olukopa	Nan
actores	oṣere	Nan
actor	oṣere	Nan
achosion	awọn okunfa	Nan
achosir	ṣẹlẹ	Nan
achosodd	o ṣẹlẹ	Nan
achoswyd	ṣẹlẹ	Nan
achub	fipamọ	Nan
acid	acid	Nan
acknowledgements	awọn idanimọ	Nan
achos	fa	Nan
aconcagua	aconcagua	Nan
acronym	adape	Nan
acropolis	acropolis	Nan
act	iṣe	Nan
actif	lọwọ	Nan
actifadu	ibere ise	Nan
actifedd	ijajagbara	Nan
actio	anesitetiki	Nan
acrocephalus	acrocephalus	Nan
america	america	Nan
afiach	lailera	Nan
afiechydon	arun	None
allheulol	extraterrestrial	Nan
allmusic	gbogbogbo	None
allobroges	allobroges	Nan
allodd	le	None
allor	pẹpẹ	Nan
allt	gbogbo ibi	Nan
alltud	igbekun	Nan
alltudiaeth	igbekun	Nan
alltudio	ilọkuro	Nan
alltudiwyd	fipilẹ	Nan
allu	agbara	None
alluogi	mu ṣiṣẹ	Nan
allweddell	keyboard	Nan
allweddol	bọtini	Nan
allyrru	itusilẹ	Nan
allfudo	ijira	Nan
almaen	jẹmánì	Nan
allforion	okeere	None
allforid	okeere	None
alexius	alexius	Nan
alfred	sẹsẹ	Nan
algae	ewe	None
algeria	algeria	Nan
algâu	ewe	None
ali	ali	Nan
alison	alison	Nan
all	le	None
allah	olorun	Nan
allai	le	None
allan	jade	Nan
allanol	ita	Nan
alldafliad	ejection	Nan
allen	pẹlẹ	Nan
alley	ale	Nan
allforio	okeere	None
almaenaidd	almondi	Nan
almaeneg	jẹmánì	Nan
almaenig	alumọni	Nan
amcan	eredi	Nan
amcangyfrif	ti siro	Nan
amcangyfrifir	o ti ni ifoju	Nan
amcangyfrifol	isunmọ	Nan
amcangyfrifon	awọn iṣiro	Nan
amcanion	awọn afojusun	Nan
amdano	rẹ	None
amdanynt	wọn	None
amddifad	alainibaba	Nan
amddiffyn	aabo	Nan
amddiffynfa	olugbeja	Nan
amddiffynfeydd	awọn aabo	Nan
amddiffyniad	aabo	Nan
amddiffynnol	aabo	Nan
amddiffynwr	olugbeja	Nan
ambrose	ikọmu	Nan
ambell	kan	None
amazonas	amazonas	None
amazon	amazon	Nan
almaenwyr	awọn aṣọ atẹrin	Nan
alpau	alps	Nan
alshifa	alshifa	Nan
also	tun	Nan
alun	alun	Nan
alw	pe	Nan
alwad	pe	Nan
alexios	awọn irọwọ	Nan
alwminiwm	alumọni	Nan
alwyd	ti a pe	Nan
am	aago	Nan
amaeth	ogbin	Nan
amaethwyr	agbe	Nan
amaethyddiaeth	ogbin	Nan
amaethyddol	ogbin	Nan
amau	fura fura	Nan
alwn	a pe e	Nan
alexandra	alexandra	None
alexander	alaapọn	Nan
alex	alex	Nan
agosach	sunmọ	Nan
agosaf	nitosi	None
agwedd	iwa	Nan
agweddau	awọn iwa	Nan
ahmed	ahmed	Nan
ai	ai	Nan
aids	arannilọwọ	Nan
aiff	yoo	None
aifft	íjíbítì	Nan
aiguille	atuille	Nan
ail	tun	Nan
ailadeiladwyd	tun-kọ	Nan
ailagorodd	o tun tan	Nan
ailddechreuodd	o bẹrẹ	Nan
ailfwyaf	jinde	Nan
agos	sunmọ	Nan
agorwyd	ṣí	Nan
agorodd	o ṣi	Nan
agoriad	ṣiṣi	Nan
aflonyddwch	rudurudu	Nan
aflwyddiannus	aṣeyọri	Nan
afon	odo	Nan
afonydd	odo	Nan
africa	afirika	Nan
afrikaans	ọmọ	None
afu	ẹdọ	Nan
ailgipio	atunkọ	Nan
ag	ni	Nan
against	lodi si	Nan
agan	oun	None
agatha	agatha	Nan
ager	nya si	Nan
aggregate	apapọ	Nan
agor	ṣii	Nan
agored	ṣii	Nan
again	lẹẹkansi	Nan
afiechyd	aisan	Nan
ailgreu	ere idaraya	Nan
ailsefydlodd	o tunto	Nan
albert	ominira	Nan
albwm	awo-orin	Nan
albwmau	awọn awo-orin	Nan
albymau	awọn awo-orin	Nan
alcalïaidd	ipilẹ	Nan
alcanau	awọn ọna	Nan
alcenau	alkenes	Nan
alcohol	oti	Nan
alcoholaidd	ọmuti	Nan
alcoholiaeth	ọti amupara	Nan
alecsander	alefoonu	Nan
alecsandraidd	alamọde	Nan
aled	ṣaisan	Nan
alesia	alesia	Nan
alessandro	alessandro	Nan
albedo	albedo	Nan
albatrosiaid	albatrosses	Nan
albaniaid	albanians	Nan
albania	albania	Nan
ailsefydlu	atunto	Nan
ailymgnawdoli	atunkọ	Nan
aimee	aimee	Nan
ain	éù	Nan
aipac	aipac	Nan
air	lórí i rẹ	Nan
aires	akiyesi	Nan
ailgydiodd	o bẹrẹ	Nan
akiruno	akiruno	Nan
alan	alan	Nan
alaqsa	alaqsa	Nan
alaska	alaska	Nan
alaw	orin aladun	Nan
alba	awo-orin	Nan
alban	ilu scotland	Nan
albaneg	albania	Nan
al	al	Nan
aruthrol	ọpọlọpọ	Nan
arwain	darí	Nan
arweiniad	itọsọna	Nan
blant	ọmọ	None
blas	itọwo	Nan
blat	awo	None
ble	nibo	Nan
bledren	àpòòtọ	Nan
bleidiau	awọn ẹgbẹ	Nan
bleidleisiau	ibo	Nan
blentyn	ọmọ	None
blentyndod	ewe	None
blew	irun	Nan
blith	laarin	None
bloc	dina	Nan
blociau	awọn bulọọki	Nan
blodau	ododo	None
blodeuodd	o ti bilona	Nan
blanhigion	eweko	Nan
blodeuwedd	òdòdó	Nan
blaned	ile aye	Nan
blanc	òfo	Nan
björk	björk	Nan
black	dudu	Nan
blackheaded	ṣú irun orí	Nan
blaen	iwaju	Nan
blaenasgellwr	flanker	Nan
blaenau	awọn imọran	Nan
blaengroen	foreskin	Nan
blaenllaw	yori	None
blaenoriaeth	pataki	Nan
blaenorol	ti tẹlẹ	Nan
blaenwr	frontman	Nan
blaenwyr	siwaju	Nan
blaid	ẹgbẹ	Nan
blaidd	ikooko	Nan
blair	blir	Nan
blanche	ibora	Nan
blodyn	òdòdó	Nan
blog	bulọọgi	Nan
blogio	kekeke	Nan
boced	apo	Nan
bod	iyẹn	Nan
boda	kòfẹ	Nan
bodau	eeyan	Nan
boddi	riran	Nan
bodedern	bodedern	Nan
bodloni	itelorun	Nan
bodolaeth	iwalaaye	Nan
bodoli	wa	Nan
bodorgan	bodorgan	Nan
boed	jẹ o	Nan
boeriaid	boars	Nan
boeth	gbona	Nan
boicotio	ikokunrin	Nan
bolifia	eegun	Nan
bobol	eniyan	Nan
boblogrwydd	gbaye-gbale	Nan
boblogaidd	gbajumọ	Nan
boblogaeth	olugbe	Nan
blonde	irunrin	Nan
blue	bulu	Nan
blues	awọn blues	Nan
blwch	àpótí	Nan
blwyddyn	ọdun	Nan
blwyf	parish	Nan
blynedd	ọdun	Nan
biwmares	beaumaris	Nan
blynyddoedd	ọdun	Nan
blŵs	awọn blues	Nan
bo	bo	Nan
bob	bob	Nan
bobby	ariwo	Nan
bobi	beki	Nan
bobl	eniyan	Nan
bobloedd	awọn eniyan	Nan
blynyddol	lododun	Nan
bittern	ida	Nan
biolegol	ẹkọ oniye	Nan
bioleg	isedale	Nan
berberiaid	berberians	Nan
berchen	ohun ini	Nan
bererindod	ajo	None
berfau	ìse	Nan
berfformiad	imuṣere	Nan
berfformiadau	awọn iṣe	Nan
berfformio	ṣe	Nan
berfformion	awọn iṣe	Nan
berfol	lọrọ ẹnu	Nan
beri	duro	Nan
bering	bering	Nan
berlin	berlin	None
bernard	bernard	Nan
bernstein	bernstein	None
berry	berry	Nan
berber	ata	Nan
benywod	obinrin	Nan
benywaidd	obinrin	Nan
benyw	obinrin	Nan
bengoch	pupa	None
benin	benin	None
benito	benito	Nan
benjamin	benjamin	Nan
benllech	lẹwa	Nan
bennaeth	balogun	Nan
bennaf	o kun	Nan
bersaidd	parsimonious	Nan
bennett	bennett	Nan
benodol	pataki	Nan
benrhyn	ile larubawa	Nan
benthyciad	awin	Nan
benthyciadau	awọn awin	Nan
benthyg	yawo	Nan
bentref	abule	Nan
bentrefi	abule	Nan
bennill	ẹsẹ	None
bolisi	eto imulo	Nan
berseg	parsley	Nan
bersonol	tikalararẹ	Nan
bi	jẹ	Nan
bibracte	ṣẹṣẹ	Nan
bicini	bikini	Nan
biden	biden	Nan
bidgood	bidgood	Nan
bidyn	kòfẹ	Nan
big	nla	Nan
biliwn	bilionu	Nan
bill	owo	Nan
billboard	iwe-iwọle	Nan
billie	ìdíyelé	Nan
billy	oniruru	Nan
bioamrywiaeth	ipinsiyeleyele	Nan
biocemeg	ẹkọ biokemika	Nan
biodaearyddiaeth	biogeography	Nan
bhutan	orunkun	Nan
bhagavad	bhagavad	Nan
betws	tẹtẹ	Nan
bethesda	bethesda	Nan
berswadio	yiroro	Nan
berthnasol	ibaramu	Nan
berthynas	ibatan	Nan
bertolt	bertolt	Nan
bertrand	bertrand	Nan
berwbwynt	farabale ipari	Nan
berwbwyntiau	farabale ojuami	Nan
berson	eniyan	Nan
berwi	sise	None
beryglus	lewu	Nan
bessie	bessie	Nan
best	dara julọ	Nan
beth	kini	Nan
bethan	betani	Nan
bethania	bétánì	Nan
bethau	ohun	Nan
berwyn	berwyn	Nan
bengal	bengal	None
bolisïau	imulo	Nan
bollywood	boluti	Nan
britanniae	britanniae	Nan
britannica	britannica	Nan
brith	didin	Nan
british	oloogun	Nan
bro	bro	Nan
broadcasting	igbohunsafefe	Nan
broadway	gbooro	Nan
broblem	iṣoro	Nan
broblemau	awọn iṣoro	Nan
broch	pẹlẹbẹ	Nan
brodorion	abinibi	Nan
brodorol	abinibi	Nan
brofi	idanwo	Nan
brofion	awọn idanwo	Nan
bron	fẹẹrẹ	Nan
britannia	britannia	Nan
bronfraith	thrush	Nan
britain	britain	None
bris	owo	Nan
bri	ọlá	Nan
brid	ajọbi	Nan
bridd	ile	Nan
brif	akọkọ	Nan
brifddinas	olú ìlú	Nan
briflythyren	leta nla	Nan
brifysgol	yunifasiti	Nan
brifysgolion	egbelegbe	Nan
brig	oke	Nan
brin	ṣọwọn	Nan
briod	iyawo	None
briodas	igbeyawo	None
briodi	igbeyawo	None
briodolir	jogun	None
briodweddau	awọn ohun-ini	Nan
brisiau	awọn idiyele	Nan
brongoch	brongoch	Nan
bronnau	ọyan	Nan
bronnaun	a ṣetọrẹ	Nan
brwydrau	ogun	None
brwydro	ogun	None
brwynog	adie	Nan
brych	iranran	Nan
brycheiniog	brecknock	Nan
bryd	nigbawo	Nan
brydain	gẹẹsi	Nan
brydeinig	ara ilu gẹẹsi	Nan
bryderon	awọn ifiyesi	Nan
bryn	òkè	Nan
bryngwran	kekere	None
bryniau	awọn oke-nla	Nan
brynu	ra	None
brysur	nṣiṣe lọwọ	Nan
brythoneg	brythonic	Nan
brwydr	ogun	None
brwselprifddinas	olú ìlú brussels	Nan
brwsel	gbọnnu	Nan
bruxelles	awọn ẹya ara ibọn	Nan
bronx	idẹ	Nan
bros	bros	Nan
broses	ilana	None
brosesau	ilana	None
brosesu	sisẹ	Nan
brosiect	ise agbese	Nan
brosiectau	awọn iṣẹ	Nan
brezhoneg	ajọdun	Nan
brostad	to	None
brothers	awọn arakunrin	Nan
brotonau	awọn protons	Nan
broughton	mú	Nan
brown	brown	Nan
bruce	bruce	Nan
brunei	brunei	Nan
brussel	gbọnnu	Nan
brother	arakunrin	Nan
brewys	aisan	Nan
breuddwydion	ala	None
breuddwyd	kan	None
borthladd	ibudo	Nan
borthladdoedd	omi	None
bos	ọga	Nan
bosib	ṣeeṣe	Nan
bosibl	ṣeeṣe	Nan
bosnahercegovina	bosnahercegovina	Nan
bosnia	oorun ara ilu	Nan
bosphorus	irawọ owurọ	Nan
bost	meeli	Nan
boston	meeli	Nan
bosworth	bosworth	Nan
botaneg	botany	Nan
botswana	botswana	Nan
botwm	bọtini	Nan
bowen	tẹriba	Nan
borth	ọna abawọle	Nan
borneo	borneo	Nan
bore	owurọ	Nan
border|px|dinas	ààlà | px | ìlú	Nan
bomiau	awọn ado-iku	Nan
bomio	ajonirun	Nan
bomis	awọn ado-iku	Nan
bonan	awọn imoriri	Nan
bonaparte	bonaparte	Nan
bond	mnu	Nan
bondiau	ìde	Nan
bowys	awọn ohun mimu	Nan
bondio	imora	Nan
bont	afara	Nan
bontydd	afara	Nan
book	iwe	Nan
bop	agbejade	Nan
bopeth	ohun gbogbo	Nan
bor	rù	Nan
bordeaux	bordeaux	Nan
bonnie	bonnie	Nan
bolivia	bolivia	Nan
boy	ọmọkunrin	Nan
bradley	bradley	Nan
breichiau	awọn ọwọ	Nan
breifat	ikọkọ	Nan
breiniol	faranse	None
breision	diẹ sii	Nan
breizh	breizh	Nan
bren	igi	Nan
brenhines	ayaba	Nan
brenhiniaeth	ọba	Nan
brenhinllin	ọba	Nan
brenhinoedd	awọn ọba	Nan
brenhinol	ọba	Nan
brenin	ọba	Nan
breninesau	awọn ayaba	Nan
bresennol	lọwọlọwọ	Nan
breton	bretoni	Nan
bregus	ẹlẹgẹ	Nan
brecht	rata	Nan
break	fọ	Nan
braşov	braşov	Nan
braf	wuyi	Nan
brahma	brahma	Nan
braich	apa	Nan
braidd	bikita	Nan
brandenburg	brandenburg	Nan
brando	brando	Nan
branning	iyasọtọ	Nan
brad	ẹlẹtan	Nan
branta	silẹ	Nan
bras	isokuso	Nan
brasil	ilu brazil	Nan
braster	ọra	Nan
brawd	arakunrin	Nan
brawddeg	gbolohun ọrọ	Nan
brawddegau	awọn gbolohun ọrọ	Nan
brawf	idanwo	Nan
branwen	branwen	Nan
benfro	pembroke	Nan
bened	tẹ	Nan
bendigeidfran	bendigeidfran	Nan
autónoma	adari	Nan
aux	oluranlọwọ	Nan
available	wa	Nan
avatars	avatars	Nan
awdl	awdl	Nan
awdur	onkọwe	Nan
awdurdod	aṣẹ	Nan
awdurdodau	awọn alaṣẹ	Nan
awdures	onkọwe	Nan
awduron	awọn onkọwe	Nan
awen	eeru	Nan
awgryma	o ni imọran	Nan
awgrymodd	o daba	Nan
awgrymu	daba	Nan
awgrymwyd	o daba	Nan
authors	awọn onkọwe	Nan
awr	wakati	Nan
australopithecus	australopithecus	Nan
austin	austin	Nan
atomfa	agbara	None
atomig	atomu	Nan
atriwm	atrium	Nan
attlee	attlee	Nan
atyn	sí	Nan
atyniad	ifamọra	Nan
atyniadau	awọn ifalọkan	Nan
atynt	wọn	None
au	au	Nan
audio	ohun	Nan
august	ogo	Nan
augustus	augustus	Nan
aur	wúrà	Nan
aurelian	igbeyawo	None
aurelius	aurelius	Nan
australia	ilu oyinbo	Nan
awst	ogo	Nan
awstralaidd	autistic	Nan
awstralasia	adọkita	Nan
bachwr	hooker	Nan
back	sẹhin	Nan
bacsiog	ẹkun	Nan
bacteria	arun	None
bad	buburu	Nan
bae	bay	Nan
baganaidd	keferi	Nan
baghdad	baghdad	Nan
bahamas	bahamas	Nan
bahasa	bahasa	Nan
bahrain	bahrain	None
bai	jẹbi	Nan
baikal	baikal	Nan
baines	igbeyawo	None
bakr	alagbẹdẹ	Nan
bachgen	ọmọkunrin	Nan
bach	kekere	None
babilon	bábílónì	Nan
babanod	ọmọ-ọwọ	Nan
awstralia	ilu oyinbo	Nan
awstria	austria	Nan
awstriahwngari	ara ilu austrian	Nan
awtistiaeth	autism	Nan
awyddus	ni itara	Nan
awyr	ategun	Nan
awyren	ọkọ ofurufu	Nan
atomau	awọn ọta	Nan
awyrennau	ọkọ ofurufu	Nan
ayb	abbl.	Nan
aythya	aythya	Nan
ayutthaya	ayutthaya	Nan
ayyb	abbl.	Nan
b	b?	Nan
ba	ba	Nan
baban	ọmọ	None
awyrgylch	bugbamu	Nan
atom	ọgbọn	Nan
ato	fún un	Nan
atmosffêr	bugbamu	Nan
arysgrifau	awọn akọle	Nan
as	pipa	Nan
asennau	awọn ẹgbẹ	Nan
aserbaijan	azerbaijan	Nan
asesu	iṣiro	Nan
asetig	jiini	Nan
asgell	iyẹ	Nan
asgellwr	afọwọkọ	Nan
asgwrn	eegun	Nan
asgwrncefn	ọpa ẹhin	Nan
asia	asia	Nan
asiaidd	ara ilu asia	Nan
asiantaeth	ibẹwẹ	Nan
asiantaethau	awọn ile ibẹwẹ	Nan
asid	acid	Nan
arwynebeddkm²	agbegbe km²	Nan
arwynebedd	agbegbe	Nan
arwyneb	dada	Nan
arwyddwyd	fowo si	Nan
arweiniai	o si dari	Nan
arweiniodd	o si dari	Nan
arweiniol	darí	Nan
arweinwyr	awọn adari	Nan
arweinydd	oludari	Nan
arweinyddiaeth	oludari	Nan
arwel	arwel	Nan
asidau	awọn acids	Nan
arwr	akọni	Nan
arwyddair	gbolohun ọrọ	Nan
arwyddion	awọn ami	Nan
arwyddlun	apẹẹrẹ	Nan
arwyddo	ami	Nan
arwyddocaol	pataki	Nan
arwyddocâd	pataki	Nan
arwyddodd	o fowo si	Nan
arwydd	kan	None
bala	bala	Nan
asidig	ekikan	Nan
association	ẹgbẹ	Nan
athen	hensténì	Nan
athletau	elere idaraya	Nan
athraidd	permeable	Nan
athrawes	olukọ	Nan
athrawon	olukọ	Nan
athro	olukọ	Nan
athroniaeth	imoye	Nan
athronwyr	onimoye	Nan
athronydd	onimoye	Nan
athronyddol	ori	None
athrylith	oloye-pupọ	Nan
ati	abbl.	Nan
atlas	atlas	Nan
atmosffer	bugbamu	Nan
atmosfferig	ti oyi oju aye	Nan
atgofion	ìrántí	Nan
atgenhedlun	atunse	None
atgenhedlu	atunse	None
atebol	iṣiro	Nan
astudiaeth	iwadi	None
astudiaethau	awọn ijinlẹ	Nan
astudio	iwadi	None
astudiodd	o kẹkọ	Nan
astudior	iwadi	None
astudir	iwadi	None
asturias	asturias	Nan
asio	asio	Nan
at	ni	Nan
ataliad	idaduro	Nan
ataliodd	da	None
atalydd	adena	Nan
atalyddion	inhibitors	Nan
atatürk	atatürk	Nan
ateb	idahun	Nan
atebodd	o si dahun pe	Nan
atal	ṣe idiwọ	Nan
balcanau	balikoni	Nan
baldwin	ọdẹdẹ	Nan
bale	baluu	Nan
beddgelert	iboji gelert	Nan
bedr	arara	Nan
bedwar	mẹrin	Nan
bedwaredd	kẹrin	None
bedwerydd	kẹrin	None
bedwyr	bedrock	Nan
bedydd	ìrìbọmi	Nan
bedyddwyr	baptisti	Nan
bee	oyin	Nan
been	ti	Nan
beethoven	beethoven	Nan
beetle	beetle	Nan
before	ṣaaju	Nan
beibl	bibeli	None
beic	keke	Nan
beddargraff	ibojì	None
bedd	sàréè	Nan
bedair	mẹrin	Nan
beckett	bekett	Nan
bawd|px|baner	àtẹ | px | àsíá	Nan
bawd|px|delwedd	atanpako | px | aworan	Nan
bawd|px|logo	atanpako | px | aami	Nan
bawd|px|map	maapu	None
bawd|px|y	àtẹ | px | y	Nan
bawd|px|yr	àtẹ | px | yr	Nan
bawd|y	àá | |	Nan
beichiogrwydd	oyun	Nan
bay	bay	Nan
be	jẹ	Nan
beale	beale	Nan
beat	lu	Nan
beatles	awọn iṣẹgun	Nan
beauty	ẹwa	Nan
bebb	beb	Nan
bechgyn	omokunrin	Nan
bb	bb	Nan
bawd|px	àtẹ | px	Nan
beiciau	awọn kẹkẹ	Nan
beidio	kii ṣe	Nan
belisarius	belisarius	Nan
belize	beli	Nan
bell	jinna	Nan
bellach	bayi	None
belled	jinna	Nan
bello	bello	Nan
bellter	jinna	Nan
below	ni isalẹ	Nan
ben	ben	Nan
bencadlys	olú	Nan
bencampwriaeth	aṣaju	Nan
benddu	didaku	Nan
benderfyniad	ipinnu	Nan
benderfynol	pinnu	Nan
benderfynu	pinnu	Nan
believe	gbagbọ	Nan
beli	awon boolu	Nan
belgae	belgae	Nan
belg	belun	Nan
beijing	ilu oyinbo	Nan
beili	bailiff	Nan
being	jije	None
beirdd	awọn ewi	Nan
beiriannau	ero	Nan
beiriant	ẹrọ	Nan
beirniadodd	o ti ṣofintoto	Nan
beicio	gigun kẹkẹ	Nan
beirniadol	lominu	Nan
beirniadwyd	ti ṣofintoto	Nan
beirniaid	awọn onidajọ	Nan
beit	baiti	Nan
bel	bel	Nan
belarus	belarus	None
belarws	belarus	None
belffast	belfast	Nan
beirniadu	adajo	Nan
cynan	laipẹ	Nan
bawd|map	maapu	None
bawd|lleoliad	ipo	None
bantu	pipa	Nan
bantw	pantan	Nan
bapur	iwe	Nan
bapurau	awọn iwe	Nan
bar	pẹpẹ	Nan
bara	burẹdi	Nan
barack	baraki	Nan
baratoi	igbaradi	Nan
barau	orisii	Nan
barbados	barbados	Nan
barbara	àpáta	Nan
barbuda	barbuda	Nan
barc	gbesile	Nan
barcelona	agolo	Nan
barcud	kapa	Nan
bangor	asegun	Nan
bangladesh	onigbọwọ	Nan
bangkok	bọki	Nan
banerir	asia	Nan
balearig	balletiki	Nan
balesteiniaid	palestinians	Nan
bali	bali	Nan
balkan	balkan	Nan
ball	ọmọ	None
ballet	baluu	Nan
baltaidd	baliki	Nan
bardd	ewi	Nan
baltig	ẹlẹdẹ	Nan
banc	banki	Nan
bancio	ile-ifowopamọ	Nan
band	ẹgbẹ	Nan
bandemig	àrùn	None
bandiau	igbohunsafefe	Nan
baner	asia	Nan
baneri	awọn asia	Nan
ban	obinrin	Nan
bawd|logo	atanpako | aami	Nan
barddol	ewi	Nan
barfog	irungbọn	Nan
basileios	basileios	Nan
basilica	basilica	Nan
basio	rekoja	Nan
basiwyd	koja	Nan
basque	iwulo	None
bat	adan	Nan
batagones	batagones	Nan
batagonia	patagonia	Nan
bath	iwẹ	Nan
bathwyd	ti parun	Nan
batri	batiri	Nan
bawb	gbogbo eniyan	Nan
bawd|chwith|px|arfbais	atanpako | osi | px | aṣọ ti awọn apa	Nan
bawd|chwith|y	atampako | osi | y	Nan
bawd|dde|px|y	atanpako | ọtun | px | y	Nan
basgeg	basiki	Nan
basg	apeere	Nan
basau	awọn ipilẹ	Nan
basalt	basil	Nan
barhaodd	o tesiwaju	Nan
barhaol	titilai	Nan
barhau	tẹsiwaju	Nan
barhaus	loorekoore	Nan
baris	paris	Nan
barn	awọn ero	Nan
barod	ṣetan	Nan
barddoniaeth	oríkì	None
barodd	o tesiwaju	Nan
barri	oke	Nan
barry	abọ	Nan
barti	ayẹyẹ	Nan
bartneriaeth	ajọṣepọ	Nan
barwn	baron	Nan
barwniaid	àwọn ènìyàn	Nan
bas	baasi	Nan
baron	baron	Nan
gwerni	pin	Nan
cynefinoedd	ibugbe	Nan
cynffonhir	iru	Nan
fleming	fleming	Nan
flew	irun	Nan
flogiau	awọn bulọọgi	Nan
florida	florida	Nan
flwyddyn	ọdun	Nan
fly	fò	Nan
flycatcher	flycatcher	Nan
flynedd	ọdun	Nan
flynyddoedd	ọdun	Nan
flynyddol	lododun	Nan
fm	fm	Nan
fnla	fnla	Nan
fo	fo	Nan
fod	jẹ	Nan
fodau	eeyan	Nan
flaenorol	tẹlẹ	Nan
fodd	sibẹsibẹ	Nan
flaenllaw	yori	None
fl	fl	Nan
finch	itanran	Nan
fiola	viola	Nan
fiolan	violets	Nan
fioleg	isedale	Nan
fiolegol	ẹkọ oniye	Nan
fiolegwyr	onimọ-jinlẹ	Nan
firaol	gbogun ti	Nan
firefox	firefox	Nan
first	akoko	Nan
firws	àrùn	None
firysau	awọn ọlọjẹ	Nan
fis	kan	None
fisher	apẹja	Nan
fisigothiaid	fisiksi	Nan
fit	ibaamu	Nan
flaen	iwaju	Nan
foddi	riran	Nan
fodern	igbalode	Nan
fodolaeth	iwalaaye	Nan
forster	alakọsilẹ	Nan
fort	odi	Nan
fotaneg	botany	Nan
foundation	ipile	Nan
four	mẹrin	Nan
fox	kọlọkọ	Nan
frad	ẹlẹtan	Nan
fraich	apa	Nan
fraith	kiri	Nan
france	itanran	Nan
frances	ododo	None
francis	francis	None
francisco	francisco	Nan
franco	franco	Nan
frank	otitọ	Nan
formats	awọn ọna kika	Nan
format	ọna kika	Nan
fore	owurọ	Nan
fordaith	irin-ajo	Nan
fodoli	wa	Nan
fodrwyau	oruka	Nan
foel	si igboro	Nan
folcanig	onina aruwo	Nan
foleciwlaidd	molikula	Nan
foleciwlau	molikula	Nan
follett	follett	Nan
finalé	ipari	Nan
following	atẹle	Nan
fom	bombu	Nan
foment	akoko	Nan
fomiau	awọn ado-iku	Nan
fomio	ajonirun	Nan
fon	fon	Nan
for	fun	None
ford	ṣeéṣe	Nan
foltedd	folti	Nan
fin	pari	Nan
filwyr	jagunjagun	Nan
filwrol	ologun	Nan
ffrwydrodd	o bubu	Nan
ffrwyth	eso	Nan
ffrwythau	eso	Nan
ffrwythlon	irọyin	Nan
ffrwythlondeb	irọyin	Nan
ffrynt	iwaju	Nan
ffugenw	inagije	Nan
ffuglen	itan-akọọlẹ	Nan
ffurf	fọọmu	Nan
ffurfdroad	iṣipapada	Nan
ffurfiant	ibiyi	Nan
ffurfiau	awọn fọọmu	Nan
ffurfio	ibiyi	Nan
ffurfiodd	o ṣẹda	Nan
ffurfiol	lodo	None
ffrwydro	bu	None
ffrwydriadau	awọn bugbamu	Nan
ffrwd	ṣiṣan	Nan
ffrithiant	ikọlu	Nan
ffosydd	ẹgbin	Nan
ffotograffiaeth	fọtoyiya	Nan
ffoton	photon	Nan
ffotosynthesis	photosynthesis	Nan
ffowc	fokii	Nan
ffrae	aáwọ̀	Nan
ffrainc	faranse	None
ffurfior	akoso	Nan
fframwaith	ilana	None
ffrancod	franc	Nan
ffrancwyr	faranse	None
ffrangeg	faranse	None
ffrengig	faranse	None
ffrigad	ogun	None
ffrind	ọ̀rẹ́	Nan
ffrindiau	ọrẹ	Nan
ffranciaid	franc	Nan
franklin	franklin	Nan
ffurfir	akoso	Nan
ffurflen	fọọmu	Nan
fideo	fidio	Nan
fideos	awọn fidio	Nan
field	pápá	Nan
fienna	vienna	Nan
fiet	viet	Nan
fietnam	vietnam	Nan
fifa	fifa	Nan
fiji	fiji	Nan
fil	àlẹmọ	Nan
fileindonesia	poetindonesia	Nan
fileniwm	ẹgbẹrun ọdun	Nan
filiwn	a million	Nan
filiynau	miliọnu	Nan
filoedd	ẹgbẹẹgbẹrun	Nan
filwr	jagunjagun	Nan
fidel	iṣootọ	Nan
fictorianaidd	fikitoria	Nan
ficedula	ficedula	Nan
fi	emi	Nan
ffwrdd	kuro	Nan
ffydd	igbagbọ	Nan
ffyddlon	adúróṣinṣin	Nan
ffylwm	agbedemeji	Nan
ffync	funk	Nan
ffyngau	elu	Nan
ffynhonnau	omi	None
ffurfiwyd	akoso	Nan
ffynhonnell	orisun	None
ffynnon	orisun	None
ffynnu	fẹẹrẹ	Nan
ffynonellau	orisun	None
ffyrdd	opopona	Nan
ffyrnig	onirun	Nan
ffîn	ààlà	Nan
ffôn	tẹlifoonu	Nan
ffyniant	aisiki	Nan
ffosiliau	awọn fosaili	Nan
franz	franz	Nan
fras	ni aijọju	Nan
fywyd	igbesi aye	Nan
fywydau	laaye	Nan
fàs	lati dagba	Nan
fân	kekere	None
fôn	foonu	Nan
fôr	okun	Nan
g	g	Nan
ga	ga	Nan
gabe	gabé	Nan
gabon	gabon	Nan
gabriel	gabriel	Nan
gad	tirẹ	Nan
gadael	lọ	Nan
gadair	alaga	Nan
gadarn	ìró	None
fywiog	aladun	Nan
gadarnhau	jẹrisi	Nan
fyw	wa laaye	Nan
fyth	rara	Nan
fygythiad	irokeke	Nan
fylfa	alafo	Nan
fymryn	fẹẹrẹ	Nan
fynachlog	monastery	Nan
fynd	lọ	Nan
fynedfa	ẹnu ọna	Nan
fynegi	han	Nan
fynnu	ku	None
fynwy	monmouth	Nan
fyny	sókè	Nan
fynydd	òkè	Nan
fynyddig	olórí òkè	Nan
fynyddoedd	awọn oke-nla	Nan
fynyr	eniyan	Nan
fysantaidd	byzantine	Nan
fytholeg	itan aye atijọ	Nan
gadawodd	otilo	Nan
gadeiriol	katidira	Nan
gadoediad	alaafia	None
gaiff	yoo	None
gaiman	gaiman	Nan
gainc	ẹka	Nan
gair	ọrọ	Nan
gais	ohun elo	Nan
gaius	gìrì	Nan
gal	agbọn	Nan
galan	kan	None
galapagos	galapagos	Nan
galatiaid	àwọn ará galati	Nan
galaţi	galaţi	Nan
galba	galba	Nan
galed	lile	Nan
galeg	àgbọn	Nan
galendr	kalẹnda	Nan
gafwyd	gba	None
gafr	ewurẹ	Nan
gafodd	o ni	Nan
gaffein	kanilara	Nan
gadw	tọju	Nan
gadwr	alaga	Nan
gadwyn	pq	Nan
gae	nec	Nan
gaeaf	otutu	None
gaeilge	irish	Nan
gael	wa	Nan
fyfyrwyr	omo ile	Nan
gaeleg	gaelic	Nan
gaerdydd	cardiff	Nan
gaerfyrddin	carmarthen	Nan
gaergystennin	fortgystennin	Nan
gaernarfon	caernarfon	Nan
gaethiwed	afẹsodi	Nan
gaethweision	ẹrú	Nan
gafael	dimu	Nan
gaer	fort	Nan
fydeang	agbaye	None
fyddyn	bẹẹni	Nan
fyddinoedd	ogun	None
from	lati	Nan
fron	igbaya	Nan
frontcover	iwaju	Nan
frown	brown	Nan
frwd	onítara	Nan
frwydr	ogun	None
frwydrau	ogun	None
frwydro	ja	Nan
fryn	òkè	Nan
fryniau	awọn oke-nla	Nan
frythoneg	orisun	None
frân	pọ	Nan
fu	fu	Nan
fuan	laipẹ	Nan
fuddugol	bori	Nan
frodyr	awọn arakunrin	Nan
frodorol	abinibi	Nan
fro	àgbọn	Nan
fritz	fritz	Nan
frawd	arakunrin	Nan
frawddeg	gbolohun ọrọ	Nan
frech	sisu	Nan
frederick	frederick	Nan
free	ọfẹ	Nan
freedom	ominira	Nan
frenhines	ayaba	Nan
fuddugoliaeth	isegun	Nan
frenhiniaeth	olú ọba	Nan
frenhinol	ọba	Nan
frenin	ọba	Nan
frest	àyà	Nan
fri	ọlá	Nan
friedrich	didin	Nan
friends	ọrẹ	Nan
frig	oke	Nan
frenhinoedd	awọn ọba	Nan
français	faranse	None
fuddugoliaethau	awọn iṣẹgun	Nan
fudiadau	ajo	None
fwyd	oúnjẹ	None
fwydo	oúnjẹ	None
fwyfwy	pọ si	Nan
fwynau	ohun alumọni	Nan
fwynhau	gbadun	Nan
fwyta	jẹ	Nan
fwythblu	didopo dudu	Nan
fy	temi	Nan
fychan	kekere	None
fyd	agbaye	None
fydd	yoo	None
fyddai	yoo	None
fyddain	ogun	None
fyddair	etí	Nan
fyddin	ogun	None
fwyar	berries	Nan
fwyaf	julọ	Nan
fwy	diẹ sii	Nan
fwslim	muslim	Nan
fuego	fuego	Nan
full	kun	Nan
fun	igbadun	Nan
funk	funk	Nan
funud	iṣẹju	Nan
fuodd	bẹẹni	Nan
fur	àwáàrí	Nan
fudiad	agbari	Nan
furiau	odi	Nan
future	ojo	None
fwdhaeth	buddhism	Nan
fwlch	alafo	Nan
fwrdd	tabili	None
fwriad	idi	Nan
fwriadol	mọọmọ	Nan
fwslemiaid	muslim	Nan
fusnesau	iṣowo	Nan
galerius	galerius	Nan
ffosilau	awọn fosaili	Nan
ffosfforws	irawọ owurọ	Nan
ewropeaidd	oyinbo	Nan
ewropiwm	eurium	Nan
ewros	yuroopu	Nan
ewyllys	yoo	None
ewythr	aburo	Nan
ez	éù	Nan
f	f	Nan
fab	ọmọ	None
facebook	facebook	Nan
fach	kekere	None
fachgen	ọmọkunrin	Nan
factbook	iwe otitọ	Nan
facto	facto	Nan
fae	bay	Nan
faes	pápá	Nan
ewropeaid	oyinbo	Nan
fagina	obo	Nan
ewropead	yuroopu	Nan
ewrop	yuroopu	Nan
eurovision	eurovision	Nan
euryn	ọla-goolu	Nan
eurynnod	idì wúrà	Nan
euskara	euskara	Nan
eva	eva	Nan
evan	evan	Nan
evans	awọn ikede	Nan
eve	éù	Nan
everest	igba atijọ	Nan
every	gbogbo	Nan
ewch	lọ	Nan
ewffrates	odo	Nan
ewin	clove	Nan
ewrasia	eurasia	Nan
ewro	euro	None
ewropa	yuroopu	Nan
faginaidd	obo	Nan
fagu	ajọbi	Nan
fai	ẹbi	Nan
fangor	bangor	Nan
fannod	gbogbo bit	Nan
fantais	anfani	Nan
fanwl	ni apejuwe	Nan
fanylion	awọn alaye	Nan
fap	maapu	None
farchnad	ọjà	Nan
fardd	ewi	Nan
farddoniaeth	oríkì	None
fari	ila oorun	Nan
farn	ero	Nan
farrar	farrar	Nan
farw	kú	Nan
farwol	ku	None
farwolaeth	iku	None
faner	asia	Nan
fandiau	igbohunsafefe	Nan
fandaliaid	vandali	Nan
fandaliaeth	jagidi	Nan
faint	elo ni	Nan
fair	ẹwà	Nan
fairbanks	itẹbanks	Nan
faith	igbagbọ	Nan
falch	agberaga	Nan
falco	falco	Nan
falcon	iwin	Nan
european	oyinbo	Nan
falconiformes	falconiformes	Nan
fali	fali	Nan
fall	ṣubu	Nan
fam	iya	Nan
familiaris	familiaris	Nan
fampir	fanpaya	Nan
fan	duro de	Nan
fanaweg	èdè àìpẹ	Nan
falens	kan	None
europe	yuroopu	Nan
europaeus	europaeus	Nan
europaea	europaea	Nan
esblygiad	itankalẹ	Nan
esblygodd	o wa lati	Nan
esblygol	itankalẹ	Nan
esblygu	da	None
esbonio	ṣàlàyé	Nan
esboniodd	o salaye	Nan
esgidiau	awọn bata	Nan
esgob	bishop	Nan
esgobaeth	diocese	Nan
esgus	ikewo	Nan
esgyn	goke	Nan
esgyrn	egungun	Nan
esgyrnog	egungun	Nan
esiampl	apẹẹrẹ	Nan
esiamplau	awọn apẹẹrẹ	Nan
es	es	Nan
erys	o si wa	Nan
eryrod	idì	Nan
eryri	idì	Nan
er	botilẹjẹpe	Nan
era	akoko	Nan
eraill	awọn miiran	Nan
erbyn	nipasẹ	Nan
erchyll	oburewa	Nan
eric	eric	Nan
erich	erich	Nan
español	español	Nan
erioed	lailai	Nan
erlid	inunibini	Nan
erotica	erotica	Nan
erotig	itara	Nan
ers	niwon	Nan
erthygl	nkan	None
erthyglau	nkan	None
eryr	idì	Nan
eritrea	eritrea	Nan
farwolaethau	iku	None
esperanto	esperanto	Nan
est	gbooro	Nan
etholir	dibo	Nan
etholwyd	dibo	Nan
etholwyr	awọn agbegbe	Nan
etifedd	ajogun	Nan
etifeddiaeth	julọ	Nan
etifeddodd	jogun	None
etifeddol	ajogun	Nan
etifeddu	ogún	Nan
eto	lẹẹkansi	Nan
eu	wọn	None
eugene	eugene	Nan
euog	jẹbi	Nan
euraidd	wẹwẹ	Nan
eurben	ọla-goolu	Nan
europa	europa	Nan
etholiadol	idibo	Nan
etholiadau	awọn idibo	Nan
etholiad	idibo	Nan
etholedig	dibo	Nan
esther	esther	Nan
estheteg	adani	Nan
estonia	estonia	Nan
estrogen	ẹla ẹla	Nan
estyn	itẹsiwaju	Nan
estynedig	gbooro	Nan
estyniad	itẹsiwaju	Nan
espresso	espresso	Nan
et	àti	Nan
ethel	ethel	Nan
ethiopia	ethiopia	Nan
ethnig	ẹya	Nan
ethnogrefyddol	ẹda abinibi	Nan
ethol	yan	None
etholaeth	agbegbe	Nan
etholaethau	awọn agbegbe	Nan
ethan	etan	Nan
ffosil	fosaili	Nan
fas	baasi	Nan
fasgeg	fascism	Nan
ffenomenau	iyalẹnu	Nan
fferi	ferry	Nan
fferm	oko	None
ffermio	ogbin	Nan
ffermwr	agbẹ	Nan
ffermwyr	agbe	Nan
ffermydd	oko	None
ffesant	eye aparo	Nan
ffestiniog	ffestiniog	Nan
ffidil	violin	Nan
ffigurau	isiro	Nan
ffigwr	eeya	Nan
ffigyrau	isiro	Nan
ffiji	fiji	Nan
ffilm	fiimu	Nan
ffeniciaid	fanimọra	Nan
ffilmiau	fiimu	Nan
ffenestr	ferese	Nan
ffeiliau	awọn faili	Nan
ffactorau	awọn okunfa	Nan
ffafrio	ojurere	Nan
ffafriol	ọjo	Nan
ffagan	fagan	Nan
ffair	ẹwà	Nan
ffaith	o daju	Nan
ffalopaidd	fallopian	Nan
ffanffer	ijafafa	Nan
ffantasi	irokuro	Nan
ffaryncs	apọju	Nan
ffasiwn	njagun	Nan
ffatrïoedd	ile-iṣelọpọ	Nan
ffederal	federal	Nan
ffederasiwn	federation	Nan
ffeil	faili	Nan
ffeithlyfr	iwe otitọ	Nan
ffilmio	o nya aworan	Nan
ffin	ààlà	Nan
ffindir	finland	Nan
ffoaduriaid	asasala	Nan
ffocysu	idojukọ	Nan
ffoi	sá	Nan
ffonau	awọn foonu	Nan
ffonoleg	ìyọnú	Nan
ffordd	ọna	Nan
fforest	igbo	Nan
fforestydd	igbo	Nan
fforio	ṣawari	Nan
fforiwr	aṣawakiri	Nan
fformat	ọna kika	Nan
fformiwla	agbekalẹ	Nan
fforwm	apejọ	Nan
ffos	trench	Nan
ffosffad	fosifeti	Nan
fflworin	eleyi	None
fflorens	florence	Nan
ffliwt	ferese	Nan
ffliwr	yíyọ	Nan
ffiniau	aala	None
ffiniaur	ààlà	Nan
ffinio	ààlà	Nan
ffiseg	fisiksi	Nan
ffisegol	ti ara	Nan
ffisegwyr	fisiksi	Nan
ffisegydd	oníṣègùn	Nan
ffactor	ifosiwewe	Nan
ffitio	ibaamu	Nan
fflamadwy	oniná	Nan
fflandrys	ilẹ	None
fflat	iyẹwu	Nan
fflatiau	irini	Nan
fflemeg	agbedemeji	Nan
fflint	ferese	Nan
ffliw	aisan	Nan
ffiwdal	feudal	Nan
ffa	awọn ewa	Nan
ff	emi	Nan
feysydd	awọn aaye	Nan
feddalwedd	sọfitiwia	Nan
feddiannu	ohun-ini	Nan
feddiant	ohun-ini	Nan
feddianwyd	ti tẹdo	Nan
feddwl	lerongba	Nan
fedi	oṣu kẹsan	Nan
fedru	ni anfani lati	Nan
fedyddio	baptisi	Nan
fehefin	karun	None
fei	fẹran	Nan
feibion	ọmọ	None
feichiog	loyun	Nan
feiciau	awọn kẹkẹ	Nan
feicio	gigun kẹkẹ	Nan
feini	okuta	Nan
fedd	sàréè	Nan
fedal	medal	Nan
fed	th	Nan
fecsico	meksiko	None
fasnach	isowo	Nan
fasnachol	ti iṣowo	Nan
fasnachu	isowo	Nan
faso	faso	Nan
fater	ọrọ	Nan
faterion	awọn ọran	Nan
fath	iru	Nan
feinwe	àsopọ	Nan
fathau	awọn oriṣi	Nan
fatican	vatican	Nan
fawr	nla	Nan
fawrth	kẹta	None
fc	fc	Nan
fe	rẹ	None
fear	ọkunrin	Nan
fechan	kekere	None
fathwyd	ti a itemole	Nan
fasged	apeere	Nan
feirdd	awọn ewi	Nan
feirws	àrùn	None
fersiwn	ẹya	Nan
fersiynau	awọn ẹya	Nan
fertebrat	vertebrate	Nan
fertebratau	awọn ọna atẹgun	Nan
fertibra	vertibra	Nan
fertigol	inaro	Nan
fesul	fun	None
fesur	ìwọn	Nan
fetel	irin	Nan
fetelau	awọn irin	Nan
fethan	gaasi	Nan
fetropolitanaidd	ilu	Nan
feu	feu	Nan
fewn	laarin	None
fewnfudwyr	aṣikiri	Nan
ferf	ìse	Nan
ferdinand	ferdinand	Nan
ferched	obinrin	Nan
ferch	ọmọbinrin	Nan
feistr	ọga	Nan
feithrin	ntọjú	Nan
fel	bi	Nan
felan	odo	Nan
felis	felis	Nan
felly	nitorinaa	Nan
fellyn	ọlọ	Nan
feirionnydd	meirionnydd	Nan
felyn	odo	Nan
feneswela	angling	Nan
fenis	fenis	Nan
fenni	abergavenny	Nan
fenthyg	yawo	Nan
fentrigl	ventricle	Nan
fenywaidd	abo	None
fer	kukuru	Nan
fenai	fenai	Nan
eplesu	bakteria	Nan
gales	awọn idi	Nan
galicia	galikia	Nan
graig	apata	Nan
gramadeg	èdè grámà	Nan
gramadegau	awon omo ile iwe	Nan
grammar	èdè grámà	Nan
grammy	arẹmọ	Nan
gran	gran	Nan
granada	granada	Nan
grand	agba	None
grant	yọọda	Nan
grawn	ọkà	Nan
grawnfwyd	agbado	None
gray	grẹy	Nan
grazie	grazie	Nan
greadigol	ẹda	Nan
great	nla	Nan
graham	graham	Nan
greater	tobi	Nan
graffit	ayaworan	Nan
graff	eeya	Nan
gosod	fifi sori	Nan
gosodir	o ti ṣeto	Nan
gosododd	o ṣeto	Nan
gosodwyd	ṣeto	Nan
gostwng	dinku	Nan
gostyngiad	idinku	Nan
gostyngodd	o dinku	Nan
gotama	niama	Nan
gothiaid	goths	Nan
gothig	onibaje	Nan
gpt	plc	Nan
grace	oore-ofe	Nan
gradd	ìyí	Nan
graddau	iwọn	Nan
graddfa	ìwọn	Nan
graffeg	eya	None
gred	igbagbọ	Nan
gredu	gbagbọ	Nan
green	ewe	None
grisons	grisons	Nan
grist	ọrun-ọwọ	Nan
gristion	kristiẹni	Nan
gristionogaeth	kristiẹniti	Nan
gristionogol	kristiẹni	Nan
gristnogaeth	kristiẹni	Nan
gristnogion	kristiẹni	Nan
gristnogol	kristiẹni	Nan
groeg	griki	Nan
groegaidd	griki	Nan
groegiaid	awọn hellene	Nan
groegwyr	awọn hellene	Nan
groen	awọ	Nan
groes	ilodi si	Nan
groesgad	ogun	None
griffiths	gita	Nan
griffith	ologbo	Nan
grid	akoj	Nan
grib	àgbọn	Nan
greenwich	ewe	None
gref	lagbara	Nan
grefft	iṣẹ ọwọ	Nan
grefydd	ẹsin	Nan
grefyddau	awọn ẹsin	Nan
grefyddol	ẹlẹsin	Nan
gregor	gregor	Nan
gorynys	ile larubawa	Nan
gregoraidd	gregarious	Nan
greigiau	awọn apata	Nan
grenada	alumọni	Nan
grenadines	alumọni	Nan
greodd	o ṣẹda	Nan
greu	ṣẹda	Nan
grewyd	ṣẹda	Nan
grey	grẹy	Nan
gregory	gregory	Nan
gorymdeithiodd	o rin	Nan
gorwedd	parọ	Nan
goruwchnaturiol	elekewa	Nan
gomiwnyddol	ọmọ	None
goncwest	iṣẹgun	Nan
gone	lọ	Nan
gonfensiynol	mora	Nan
good	o dara	Nan
goody	o dara	Nan
google	google	Nan
goose	gusi	Nan
gopa	gopa	Nan
gopaon	ga ju	Nan
gopar	gopar	Nan
gopr	bàbà	Nan
goptaidd	adakọ	Nan
gorau	dara julọ	Nan
gorchfygodd	o ṣẹgun	Nan
gomiwnyddion	awọn alagbọrọ	Nan
gomiwnyddiaeth	communism	Nan
gomer	ohun elo iwamu	Nan
gomedi	awada	Nan
golfanod	ologoṣẹ	Nan
golff	gọọfu	Nan
goll	sọnu	Nan
golledion	adanu	Nan
golli	padanu	Nan
gollwng	silẹ	Nan
gollwyd	sọnu	Nan
gorchfygur	ṣẹgun	Nan
gollyngodd	o lọ silẹ	Nan
golofn	ẹka	Nan
golwg	iriran	Nan
golygfa	iwo	Nan
golygfeydd	awọn iwo	Nan
golygu	ṣiṣatunkọ	Nan
golygur	olootu	Nan
golygydd	olootu	Nan
gollyngwyd	ti lọ silẹ	Nan
groeshoelio	agbelebu	Nan
gorchfygwyd	ṣẹgun	Nan
gorchuddior	ideri	Nan
gorllewinol	iwọ oorun	Nan
gormod	pupo ju	Nan
gormodiaith	àṣejù	Nan
goroesi	iwalaaye	Nan
goron	ade	Nan
goroni	ade	Nan
goronwy	ade	Nan
gororau	àgbegbe	Nan
gorrach	apanirun	Nan
gors	mars	None
gorsaf	ibudo	Nan
gorsafoedd	awọn ibudo	Nan
gorsedd	itẹ	Nan
goruchaf	adajọ	Nan
goruchel	t’olofin	Nan
gorllewin	iwọ oorun	Nan
gorkys	gorkys	Nan
gorgyffwrdd	agbekọja	Nan
gorfodwyd	agbara	None
gorchuddir	o ti bò	Nan
gorchuddiwyd	ti bo	Nan
gorchymyn	paṣẹ	Nan
gordderch	apọju	Nan
goresgyn	bori	Nan
goresgyniad	ikogun	Nan
gorff	ara	Nan
gorchuddio	ideri	Nan
gorffen	pari	Nan
gorffennodd	o pari	Nan
gorffennol	ti o ti kọja	Nan
gorfforaeth	ile-iṣẹ	Nan
gorfforol	nipa ti ara	Nan
gorfod	nini lati	Nan
gorfodi	agbofinro	Nan
gorfodir	agbara	None
gorffennaf	yoo	None
golfan	hazel	Nan
groesi	rekọja	Nan
groglith	oore	Nan
gweddill	isimi na	Nan
gweddillion	ku	None
gweddw	opó	Nan
gwefan	aaye ayelujara	Nan
gwefannau	awọn oju opo wẹẹbu	Nan
gwefr	ayo	Nan
gwefusau	ète	None
gwehillion	a million	Nan
gweilch	ẹyẹ	Nan
gweill	ni ilọsiwaju	Nan
gweinidog	òjíṣẹ́	Nan
gweinidogion	minisita	Nan
gweinyddiaeth	iṣakoso	Nan
gweithgaredd	ìṣe	Nan
gweithgareddau	akitiyan	Nan
gweddi	àdúrà	Nan
gweithiau	ṣiṣẹ	Nan
gwe	wẹẹbu	Nan
gwbl	egba	None
gwared	sọnu	Nan
gwareiddiad	ọlaju	Nan
gwareiddiadau	ọlaju	Nan
gwartheg	ẹran	Nan
gwasanaeth	iṣẹ	Nan
gwasanaethau	awọn iṣẹ	Nan
gwasanaethu	sìn	Nan
gwasanaethydd	oluduro	Nan
gwasg	tẹ	Nan
gwasgaredig	tuka	Nan
gwasgedd	titẹ	Nan
gwastadedd	ipalọlọ	Nan
gwastadeddau	pẹtẹlẹ	Nan
gwastraff	egbin	Nan
gwaun	ilera	Nan
gwddf	ọrùn	Nan
gweithio	ṣiṣẹ	Nan
gweithiodd	o ṣiṣẹ	Nan
gweithred	ìṣe	Nan
gwenith	alikama	Nan
gwenithfaen	giranaiti	Nan
gwenllian	sunkún	Nan
gwenlyn	majele	Nan
gwennol	agbẹru	Nan
gwenoliaid	mì	Nan
gwent	gwent	Nan
gwenwyn	majele	Nan
gwenyn	oyin	Nan
gwerddon	ajesara	Nan
gwerddonau	ọya	Nan
gwerin	eniyan	Nan
gweriniaeth	olominira	Nan
gweriniaethau	awọn olominira	Nan
gweriniaethwyr	olominira	Nan
gwener	ọjọru	Nan
gwenallt	irun	Nan
gwelwyd	šakiyesi	Nan
gwelwch	wo	Nan
gweithrediad	isẹ	Nan
gweithredoedd	awọn iṣẹ	Nan
gweithredol	ṣiṣiṣẹ	Nan
gweithredu	ìṣe	Nan
gweithwyr	oṣiṣẹ	Nan
gweld	wo	Nan
gweledigaeth	ìran	Nan
gwarchodfa	ifipamọ	Nan
gweledol	wiwo	Nan
gwelir	o ti ri	Nan
gwell	dara julọ	Nan
gwella	imudarasi	Nan
gwellan	imudarasi	Nan
gwelliant	ilọsiwaju	Nan
gwellodd	o dara si	Nan
gwelodd	o ri	Nan
gweler	wo	Nan
gwarchod	aabo	Nan
gwarchae	dotì	Nan
gwanwyn	omi	None
grymoedd	awọn ipa	Nan
gryn	pataki	Nan
gryno	ṣoki	Nan
grëwyd	ṣẹda	Nan
grønland	grønland	Nan
grŵp	ẹgbẹ	Nan
guadeloupehidalgo	guadeloupehidalgo	Nan
guangdong	guangdong	Nan
guatemala	guatemala	Nan
guba	guba	Nan
guest	àlejò	Nan
guide	itọsọna	Nan
guildhall	guildhall	Nan
guinea	guinea	None
guitar	gita	Nan
grym	agbara	None
gryfach	okun sii	Nan
gryf	lagbara	Nan
grwpiau	awọn ẹgbẹ	Nan
gron	yika	Nan
gronfa	inawo	Nan
gronfeydd	owo	Nan
gronyn	patiku	Nan
gronynnau	patikulu	Nan
groth	ile-ọmọ	Nan
group	ẹgbẹ	Nan
gul	dín	Nan
grud	jojolo	Nan
gruffydd	gruff	Nan
grug	heather	Nan
grugiar	grouse	Nan
gruiformes	gruiformes	Nan
grus	gusi	Nan
grwn	yika	Nan
grwp	ẹgbẹ	Nan
gruffudd	gruffudd	Nan
grog	adiye	Nan
gull	gull	Nan
gustave	gustave	Nan
gwahaniaethau	awọn iyatọ	Nan
gwahaniaethu	iyasoto	Nan
gwahanir	ti wa ni niya	Nan
gwahanol	yatọ	Nan
gwahanu	ipinya	Nan
gwahardd	leewọ	Nan
gwaharddiad	idinamọ	Nan
gwaharddwyd	leewọ	Nan
gwain	obo	Nan
gwair	koriko	Nan
gwaith	iṣẹ	Nan
gwalch	ẹyẹ	Nan
gwallt	irun	Nan
gwan	ailera	Nan
gwanhau	irẹwẹsi	Nan
gwahaniaeth	iyato	None
gwahaniad	ipinya	Nan
gwagolyn	òfo	Nan
gwag	ofo	Nan
guto	guto	Nan
guyana	guyana	Nan
guyane	guyane	Nan
gv	gv	None
gw	wo	Nan
gwactod	òfo	Nan
gwaddod	erofo	None
gustav	gustav	Nan
gwaddodion	gedegede	Nan
gwaed	ẹ̀jẹ̀	Nan
gwaedlyd	ẹlẹjẹ	Nan
gwael	talaka	None
gwaelod	isalẹ	Nan
gwaelodol	labẹ	Nan
gwaethaf	buru	Nan
gwaethygodd	o ti buru	Nan
gwadodd	o sẹ	Nan
galiaid	àwòrán	Nan
goleuni	ina	Nan
goleg	kọlẹji	Nan
gatholigion	katoliki	Nan
gau	sunmọ	Nan
gavia	gavia	Nan
gavin	gavin	Nan
gawr	omiran	Nan
gay	onibaje	Nan
gaza	gaza	Nan
gbp	gbp	Nan
gd	gd	Nan
gdp	gdp	Nan
ge	ge	Nan
gee	kekere	None
gefeilldrefi	ibeji	None
geffyl	ẹṣin	Nan
gefn	sẹhin	Nan
gatholig	ẹlẹsin ẹlẹsin	Nan
gefnddu	dudu	Nan
gate	ilekun nla	Nan
gastell	ile odi	Nan
garfan	ẹgbẹ	Nan
gariad	ọrẹbinrin	Nan
gario	gbe	None
garn	iwo	Nan
garnedd	cairn	Nan
garreg	okuta	Nan
gartref	ni ile	Nan
garu	ni ife	Nan
garw	ti o ni inira	Nan
gary	iwin	Nan
gas	gaasi	Nan
gasgliad	ipari	Nan
gasgliadau	awọn ipinnu	Nan
gasglu	kó	Nan
gast	simẹnti	Nan
gatalaneg	ede	None
gefndir	lẹhin	Nan
gefnfor	okun	Nan
gefnogaeth	atilẹyin	Nan
gell	sẹẹli	Nan
geller	cellar	Nan
gellid	bẹẹni	Nan
gellir	bẹẹni	Nan
gelloedd	ẹyin	Nan
geltaidd	seliketi	Nan
gelteg	sẹẹli	Nan
geltiaid	awọn sẹẹli	Nan
gelwid	o ti a npe	Nan
gelwir	o pe	Nan
gelyn	ọtá	Nan
gelynion	awon ota	Nan
gemau	awọn ere	Nan
gemegol	kẹmika	Nan
genau	ẹnu	Nan
gelfyddyd	aworan	Nan
gelf	aworan	Nan
geisiodd	o gbiyanju	Nan
geisio	gbidanwo	Nan
gefnogi	atilẹyin	Nan
gefnogir	atilẹyin	Nan
gefnogol	atilẹyin	Nan
gefnogwyd	atilẹyin	Nan
gefnogwyr	egeb onijakidijagan	Nan
geg	ẹnu	Nan
geidwadol	konsafetifu	Nan
gareth	gareth	Nan
geifr	ewurẹ	Nan
geirdarddiad	ẹkọ ẹkọ ẹkọ	Nan
geirfa	iwe afọwọkọ	Nan
geirfar	sọ	None
geiriadur	iwe itumọ	Nan
geiriaduron	itumo	None
geiriau	awọn ọrọ	Nan
geisiadau	awọn ohun elo	Nan
geir	oko	None
gardneraidd	kadinal	Nan
gardner	ogba	Nan
garden	ọgba	Nan
galwadau	awọn ipe	Nan
galwn	le	None
galwodd	o pe	Nan
galwr	olupe	Nan
galwyd	o ti a npe	Nan
galés	agbès	Nan
gam	igbesẹ	Nan
gamau	awọn igbesẹ	Nan
gambia	gambáà	Nan
gamblo	tẹtẹ	Nan
gambriaidd	akérúbù	Nan
gamdrin	ilokulo	Nan
gamlas	odo odo	Nan
gamp	ft?	Nan
gan	laisi	Nan
galw	beere	Nan
galon	obi	Nan
gallwn	le	None
gallwch	le	None
galilea	galilee	Nan
galileo	galileo	Nan
gall	le	None
gallai	le	None
gallair	le	None
gallent	le	None
galles	le	None
gancr	alakan	Nan
gallia	gallia	Nan
gallinago	gallinago	Nan
gallodd	o ni anfani lati	Nan
gallois	àgbọn	Nan
gallu	agbara	None
galluog	lagbara	Nan
galluogi	mu ṣiṣẹ	Nan
galluogir	sise	None
gallico	gallico	Nan
genedigaeth	ibi	Nan
ganddi	rẹ	None
ganddynt	wọn	None
gant	ọgọrun	Nan
gantores	akorin	Nan
ganu	orin	Nan
ganur	ganur	Nan
ganwr	akorin	Nan
ganwyd	a bi	Nan
ganwyr	awọn akọrin	Nan
ganymede	ganymede	Nan
gapten	balogun	Nan
garamantes	garamantes	Nan
garbon	erogba	Nan
garcharor	ẹlẹwọn	Nan
garcharorion	awọn ẹlẹwọn	Nan
gardd	ọgba	Nan
garddio	ogba	Nan
ganrifoedd	sehin	Nan
ganrif	orundun	Nan
ganran	ogorun	Nan
ganolog	aringbungbun	Nan
gandhi	gandhi	Nan
ganed	a bi	Nan
ganeuon	awọn orin	Nan
ganfod	nitori	Nan
gangen	ẹka	Nan
ganiatau	gba	None
ganiatáu	gba	None
ganddo	rẹ	None
ganiatâd	igbanilaaye	Nan
ganlyniad	esi	Nan
ganlynol	atẹle	Nan
ganol	aarin	Nan
ganolbarth	aarin wales	Nan
ganolbwynt	ifojusi ojuami	Nan
ganolfan	aarin	Nan
ganolfannau	awọn ile-iṣẹ	Nan
ganlyn	atẹle	Nan
goleudy	ile ina	Nan
genedigaethau	bíbí	Nan
genedlaethol	orilẹ-ede	Nan
glyderau	awọn idasilẹ	Nan
glyn	afonifoji	Nan
glyndwr	glyndwr	Nan
glyndyfrdwy	adití	Nan
glyndŵr	glyndŵr	Nan
glynne	grinne	Nan
glân	mọ	Nan
gnau	eso	Nan
gnu	gnu	Nan
go	iyẹn	Nan
gobaith	ireti	Nan
gobeithio	nireti	Nan
goch	pupa	None
god	koodu	Nan
goddrych	koko	Nan
glyder	glyder	Nan
godi	dide	Nan
glwb	ọgọ	Nan
gludo	glued	Nan
glasoed	ọdọ	Nan
glasurol	ayebaye	Nan
glaw	ojo	None
glawdd	hejii	Nan
glawr	ideri	Nan
glefyd	aisan	Nan
gleifion	alaisan	Nan
gleision	bàbá	None
glenn	glenn	Nan
glicio	tẹ	Nan
glir	ko	None
glo	eedu	Nan
gloddio	ma wà	Nan
glogwyn	àpáta	Nan
glowyr	ohun alumọni	Nan
gludor	agbẹru	Nan
godidog	ologo	Nan
godir	agbara	None
gododdin	oriṣa	Nan
gogleddddwyreiniol	àríwá	Nan
gogleddol	ariwa	Nan
gogleddorllewin	ariwa iwọ-oorun	Nan
gogwydd	iṣalaye	Nan
gogwyddion	eeyan	Nan
gohirio	fiwe si	Nan
goideleg	alakọkọ	Nan
going	lọ	Nan
gol	ed	Nan
golan	gbogbo	Nan
golau	ina	Nan
golaur	golaur	Nan
golchi	fifọ	Nan
golden	ti goolu	Nan
goleddu	ṣìpẹ	Nan
gogleddddwyrain	àríwá	Nan
gogledd	ariwa	Nan
gofynwch	béèrè	Nan
gofyn	béèrè	Nan
godro	milgi	Nan
godwit	olorun	Nan
godwyd	ni a ji dide	Nan
goed	igi	Nan
goeden	kan	None
goedwig	igbo	Nan
goelcerth	ìgbín	Nan
glaslyn	bulu	Nan
goes	ẹsẹ	None
gofalu	itọju	Nan
goffa	iranti aseye	Nan
goffi	kọfi	Nan
gofio	ranti	Nan
gofnodi	igbasilẹ	Nan
gofnodion	iṣẹju	Nan
gofod	aaye	Nan
goesgoch	ẹlẹgbẹ	Nan
glasgow	glasgow	Nan
glas	ewe	None
glareola	glareola	Nan
geraint	ọya	Nan
gerald	gerald	Nan
gerallt	gerald	Nan
gerbron	ṣaaju	Nan
gerbydau	awọn ọkọ	Nan
gerdd	ewi	Nan
gerdded	ririn	Nan
gerddi	awọn ọgba	Nan
gerddorfa	olutoju	Nan
gerddoriaeth	orin	Nan
gerddorol	gaju ni	Nan
geredigion	igbasilẹ	Nan
gerila	ilẹ	None
gerllaw	nitosi	None
gerllawr	carousel	Nan
ger	nitosi	None
georgia	georgia	None
georges	georges	Nan
george	george	Nan
genefa	idile	Nan
general	gbogboogbo	Nan
genesis	jiini	Nan
geneteg	jiini	Nan
genetig	jiini	Nan
genhedlaeth	iran	Nan
genhedloedd	awọn orilẹ-ede	Nan
germanaidd	jẹmánì	Nan
geni	ibi	Nan
genoa	genoa	Nan
genom	oniye	Nan
genres	awọn ẹya	Nan
gente	gente	Nan
genws	iwin	Nan
geometreg	geometry	Nan
georg	georg	Nan
genir	a bi	Nan
genedl	orílẹ-èdè	Nan
germania	jẹmánì	Nan
germaniwm	germanium	Nan
gipior	ọpọlọ ara	Nan
gita	gita	Nan
gitar	gita	Nan
gitâr	gita	Nan
giuseppe	giuseppe	Nan
give	fifun	Nan
given	fifun	Nan
gladdu	isinku	Nan
gladstone	ayo	Nan
glan	mọ	Nan
glanio	ibalẹ	Nan
glaniodd	dé	None
glanmor	mọ	Nan
glannau	bèbe	Nan
glans	glans	Nan
gipio	mú	Nan
giovanni	giovanni	Nan
gini	guinea	None
ging	gingin	Nan
gernyw	kọndi	Nan
gernyweg	kọndi	Nan
gestyll	awọn kasulu	Nan
gethin	gbahin	Nan
gets	gba	None
gewch	yoo	None
gewynnau	nafu	Nan
germanig	jẹmánì	Nan
gh	gh	Nan
ghazni	ghazni	Nan
giacomo	giakomo	Nan
gibraltar	gibraltar	Nan
gig	oju agbo	Nan
gilbert	gilbert	Nan
gillian	ọmọ	None
gilydd	papọ	Nan
ghana	ghana	None
eplesiad	bakteria	Nan
epil	ọmọ	None
epaod	epaod	Nan
ddu	dudu	Nan
ddull	ọna	Nan
ddulliau	awọn ọna	Nan
dduon	alawodudu	Nan
ddur	irin	Nan
dduw	ọlọrun	Nan
dduwdod	oriṣa	Nan
dduwiau	oriṣa	Nan
dduwies	oriṣa	Nan
ddweud	sọ	None
ddwy	meji	Nan
ddwyieithog	ede	None
ddwyn	jale	Nan
ddwyrain	ila-oorun	Nan
ddwyreiniol	ila-oorun	Nan
ddrysau	awọn ilẹkun	Nan
ddwyreinol	ila-oorun	Nan
ddrwg	binu	Nan
ddringwyr	oluta oke	Nan
ddiwylliannau	awọn asa	Nan
ddiwylliannol	aṣa	Nan
ddiwylliant	aṣa	Nan
ddod	wá	Nan
ddogfen	iwe	Nan
ddogfennau	awọn iwe aṣẹ	Nan
ddoleri	dọla	Nan
ddosbarth	kilasi	Nan
ddosbarthiad	pinpin	Nan
ddosbarthiadau	awọn kilasi	Nan
ddosbarthu	pinpin	Nan
ddraig	dragoni	Nan
ddrama	eré	Nan
ddringo	gígun	Nan
ddringor	oluta-nla	Nan
ddrud	gbowolori	Nan
ddwywaith	lemeji	Nan
ddychwelyd	padà	Nan
ddydd	ọjọ	Nan
ddynodir	sọtọ	Nan
ddynol	ènìyàn	Nan
ddynoliaeth	ọmọ	None
ddysgeidiaeth	nkọ́ni	Nan
ddysgir	kọ ẹkọ	Nan
ddysgodd	o kọ	Nan
ddysgu	kikọ ẹkọ	Nan
ddysgur	kọ ẹkọ	Nan
ddysgwyr	akẹẹkọ	Nan
ddywedodd	sọ	None
ddŵr	omi	None
de	ti	Nan
dead	kú	Nan
deall	oye	Nan
dealltwriaeth	oye	Nan
ddynodi	yiyan	Nan
ddynion	okunrin	None
ddynes	obinrin	Nan
ddyn	ọkunrin	Nan
ddyddiad	ọjọ	Nan
ddyddiau	àwọn ọjọ́	Nan
ddyddiol	ojoojumo	Nan
ddyfais	ẹrọ	Nan
ddyfeisio	pilẹ	Nan
ddyffryn	afonifoji	Nan
ddyfnach	wole	None
ddiwygiad	atunse	None
ddyfrhau	irigeson	Nan
ddylanwad	ipa	Nan
ddylanwadau	awọn ipa	Nan
ddylanwadol	gbajugbaja	Nan
ddyled	gbese	None
ddylid	yẹ	Nan
ddylunio	apẹrẹ	Nan
ddymchwel	iwolulẹ	Nan
ddylai	yẹ	Nan
ddiwydiant	ile ise	Nan
ddiwydiannol	ile ise	Nan
ddiwydiannau	awọn ile-iṣẹ	Nan
ddiddorol	awon	Nan
ddidduw	o ṣeun	Nan
ddienyddio	ipaniyan	Nan
ddiffiniadau	awọn asọye	Nan
ddiffinio	asọye	Nan
ddiffyg	aipe	Nan
ddiflannu	farasin	Nan
ddifrifol	to	None
ddifrodi	bajẹ	Nan
ddigidol	oni-nọmba	Nan
ddigon	to	None
ddigonol	deedee	Nan
ddigwydd	ṣẹlẹ	Nan
ddigwyddiadau	iṣẹlẹ	Nan
ddigwyddodd	ṣẹlẹ	Nan
ddiddordeb	nife	Nan
ddibynnu	gbarale	Nan
ddibynnol	igbẹkẹle	Nan
ddianc	sa asala	Nan
ddelio	ibaṣowo	Nan
ddelwedd	aworan	Nan
ddemocrataidd	tiwantiwa	Nan
ddenu	ifamọra	Nan
dderbyn	gba	None
dderbyniodd	gba	None
dderbyniol	itewogba	Nan
ddileu	paarẹ	Nan
ddethlir	ṣe ayẹyẹ	Nan
ddetholiad	yiyan	Nan
ddeuddeg	mejila	None
ddeunaw	mejidilogun	Nan
ddeunawfed	kejidilogun	Nan
ddeurywiol	iselàgbedemeji	Nan
ddewiniaeth	oriṣa	Nan
ddewis	yiyan	Nan
ddethol	yan	None
deallusol	ọgbọn	Nan
ddillad	aṣọ	Nan
ddilynodd	o tẹle	Nan
ddisgrifir	ṣàpèjúwe	Nan
ddisgyblaeth	ibawi	Nan
ddisgyn	ṣubu	Nan
ddisgynnydd	ọmọ-ọmọ	Nan
ddisgynyddion	iru-ọmọ	Nan
ddisodli	rọpo	Nan
ddiwedd	ipari	Nan
ddiweddar	laipẹ	Nan
ddiweddarach	nigbamii	Nan
ddiweddaraf	tuntun	None
ddiweddarch	nigbamii	Nan
ddiweddarun	laipẹ	Nan
ddiweddu	ipari	Nan
ddiwethaf	kẹhin	Nan
ddiwrnod	ọjọ	Nan
ddisgrifior	ṣàpèjúwe	Nan
ddisgrifiodd	o ṣe apejuwe	Nan
ddisgrifio	ṣàpèjúwe	Nan
ddisgen	jiroro	Nan
ddilynol	atẹle	Nan
ddilynwyr	ọmọlẹyìn	Nan
ddim	kii ṣe	Nan
ddinas	ilu	Nan
ddinasoedd	awọn ilu	Nan
ddinasyddion	ara ilu	Nan
ddinbych	denbigh	Nan
ddilyn	tẹle	Nan
ddinesig	t’ọlaju	Nan
ddiod	mu	Nan
ddioddef	ijiya	Nan
ddiogel	lailewu	Nan
ddiogelu	ṣe aabo	Nan
ddirgel	aramada	Nan
ddirywiad	kọ	Nan
ddisg	disiki	Nan
ddinistrio	iparun	Nan
ddeheuol	guusu	None
dean	diini	Nan
debygol	seese	Nan
deunyddiau	awọn ohun elo	Nan
deuocsid	itọsi	Nan
deuoliaeth	meji	Nan
deuoliaethol	olutayo meji	Nan
deurywioldeb	iselàgbedemeji	Nan
deutsch	deutsch	Nan
dewi	wá	Nan
dewin	oluṣeto	Nan
dewiniaeth	ajẹ	Nan
dewis	yiyan	Nan
dewisir	yan	None
dewisodd	yan	None
dewiswyd	yan	None
deyrnas	ijọba	Nan
deyrnasiad	jọba	Nan
deunydd	ohun elo	Nan
deyrnasoedd	awọn ijọba	Nan
deunaw	mejidilogun	Nan
deuluoedd	idile	Nan
dermau	ofin	None
derwyddon	druids	Nan
des	des	None
desc	sokale	Nan
designed	ti a ṣe	Nan
destament	majemu	Nan
destiny	kadara	None
destun	koko	Nan
destunau	awọn akọle	Nan
dethlir	o ti ye	Nan
detholiad	yiyan	Nan
detroit	ipanu	Nan
deuatomig	iṣeego	Nan
deuddeg	mejila	None
deulu	idile	Nan
deulur	deul	Nan
deyrngarwch	iṣootọ	Nan
deyrnged	oriyin	Nan
de|ewin	ti | ewin	Nan
die	kú	Nan
diego	kú	Nan
diemwnt	okuta iyebiye	Nan
dienyddiwyd	pa	Nan
difa	ku	None
diffeithwch	aṣálẹ	Nan
differu	iyatọ	Nan
diffiniad	itumo	None
diffiniadau	awọn asọye	Nan
diffinio	setumo	Nan
diffinir	ti asọye	Nan
diffiniwyd	asọye	Nan
diffwys	ipon	Nan
diffyg	ko	None
diflanedig	parun	Nan
didnt	didnt	Nan
diddymwyd	ti parẹ	Nan
diddymu	iparun	Nan
diddorol	awon	Nan
di	rẹ	None
diagram	aworan	Nan
diamedr	opin	Nan
diana	alakikanju	Nan
dianc	sa asala	Nan
dibyn	igbẹkẹle	Nan
dibyniaeth	gbárale	Nan
derm	kan	None
dibynnol	igbẹkẹle	Nan
dibynnun	igbẹkẹle	Nan
dic	fi	None
dickens	dickens	Nan
dictator	apanirun	Nan
dictionary	iwe itumọ	Nan
diddanwyr	entertainers	Nan
diddordeb	iwulo	None
dibynnu	gbarale	Nan
derfynol	ipari	Nan
derbyniwyd	gba	None
derbyniodd	gba	None
defnydd	lo	Nan
defnyddiau	awọn ohun elo	Nan
defnyddid	ti lo	Nan
defnyddio	lo	Nan
defnyddiodd	o lo	Nan
defnyddiol	wulo	Nan
defnyddion	nlo	Nan
defnyddior	lo	Nan
defnyddir	o ti lo	Nan
defnyddiwr	olumulo	Nan
defnyddiwyd	ni won lo	Nan
defnyddwyr	awọn onibara	Nan
defod	irubo	Nan
defodau	awọn irubo	Nan
defodol	irubo	Nan
deferens	ṣẹgun	Nan
defend	gbeja	Nan
default	aiyipada	Nan
defaid	agutan	Nan
decaffeineiddio	decaffeinating	Nan
dechnoleg	imọ-ẹrọ	Nan
dechrau	bẹrẹ	Nan
dechraur	initraur	Nan
dechreuad	awọn ibẹrẹ	Nan
dechreuadau	awọn ibẹrẹ	Nan
dechreuasant	wọn	None
deg	mẹwa	Nan
dechreuodd	o bẹrẹ	Nan
deddf	ofin	None
deddfau	ofin	None
deddfwriaeth	ofin	None
deddwyrain	guusu	None
dedfrydwyd	ẹjọ	Nan
dedications	awọn iyasọtọ	Nan
deer	agbọnrin	Nan
dechreuwyd	bẹrẹ	Nan
debyg	jọra	Nan
degau	mewa	Nan
degawdau	ewadun	Nan
dem	dem	Nan
deml	tẹmpili	Nan
democrataidd	tiwantiwa	Nan
democratiaeth	tiwantiwa	Nan
demograffeg	awọn ẹkọ nipa ẹkọ eniyan	Nan
den	den	Nan
denau	tinrin	Nan
deng	mẹwa	Nan
dengys	fihan	None
denmarc	fi	None
denodd	ni ifojusi	Nan
denu	ifamọra	Nan
deorllewin	guusu	None
der	der	Nan
derbyn	gba	None
delyn	harp	Nan
delweddau	awọn aworan	Nan
delwedd	aworan	Nan
delta	delta	Nan
degfed	kẹwa	Nan
deheubarth	guusu	None
dehonglir	itumọ	Nan
deich	mẹwa	Nan
deillio	itọsẹ	Nan
deiniol	alakomeji	Nan
deinosor	dainoso	Nan
degawd	mewa	Nan
deinosoriaid	dinosaurs	Nan
deithio	irin-ajo	Nan
del	del	Nan
deledu	tẹlifisiọnu	Nan
delerau	ofin	None
delhi	delhi	None
delio	ibaṣowo	Nan
della	della	Nan
deithiau	ajo	None
diflannodd	o parẹ	Nan
ddegfed	kẹwa	Nan
ddeg	mẹwa	Nan
cân	orin	Nan
cânt	le	None
córdoba	káàdì	Nan
côd	koodu	Nan
côn	konu	Nan
côr	akọrin	Nan
côte	aṣọ	Nan
cúig	marun	Nan
cŵn	ajá	Nan
d	o	Nan
da	o dara	Nan
dacia	dacia	Nan
dad	baba	Nan
dadansoddi	onínọmbà	Nan
dadeni	atunṣe	Nan
cywydd	a cywydd	Nan
dadl	ariyanjiyan	Nan
cywir	tọ	Nan
cytunwyd	gba	None
cyswllt	kan	None
cysylltiad	ìbáṣepọ	Nan
cysylltiadau	awọn olubasọrọ	Nan
cysylltiedig	ti o ni ibatan	Nan
cysylltir	ti sopọ	Nan
cysylltu	kan	None
cysylltur	asopo	Nan
cysyniad	erongba	Nan
cysyniadau	awọn erongba	Nan
cytgan	ègbè	Nan
cytundeb	àdéhùn	Nan
cytundebau	awọn adehun	Nan
cytunir	gba	None
cytuno	gba	None
cytunodd	gba	None
cywair	forukọsilẹ	Nan
dadlau	jiyan	Nan
dadleoledig	nipo	Nan
dadleuodd	o jiyan	Nan
dafodieithoedd	awọn iledìí	Nan
dafydd	dafydd	Nan
dagrau	omije	Nan
dai	awọn ile	Nan
dail	ewé	None
daily	ojoojumo	Nan
dair	mẹta	Nan
daith	irin-ajo	Nan
dal	yẹ	Nan
dalaith	igberiko	None
daleithiau	agbegbe	Nan
daleithiaur	awọn agbegbe ilu	Nan
dalglish	dalglish	Nan
daliodd	o tesiwaju	Nan
dall	afoju	Nan
dafodiaith	iledìí	Nan
daflu	jabọ	Nan
dafis	dafis	Nan
dafadennog	ogun	None
dadleuol	ariyanjiyan	Nan
daduno	atunso	Nan
daear	ilẹ	None
daeareg	ilẹ	None
daearegol	ilẹ	None
daearegwyr	awọn onimọ-jinlẹ	Nan
daeargryn	ìṣẹlẹ	Nan
cystennin	cystennin	Nan
daeargrynfeydd	awọn iwariri-ilẹ	Nan
daearyddiaeth	ilẹ	None
daearyddol	àgbègbè	Nan
daearyddwyr	ilẹ	None
daeth	o wa	Nan
daethant	wọn	None
daethpwyd	wa	Nan
dafad	agutan	Nan
daearol	ilẹ-ilẹ	Nan
cystadlu	dije	Nan
cystadleuwyr	awọn oludije	Nan
cystadleuol	ifigagbaga	Nan
cynhesu	dara ya	Nan
cynhwysedd	agbara	None
cynhwysir	to	None
cynhyrchiad	gbóògì	Nan
cynhyrchiol	iṣelọpọ	Nan
cynhyrchion	awọn ọja	Nan
cynhyrchir	ni iṣelọpọ	Nan
cynhyrchodd	produced	None
cynhyrchu	gbóògì	Nan
cynhyrchur	olupilẹṣẹ	Nan
cynhyrchwyd	produced	None
cynigiodd	o dabaa	Nan
cynllun	gbero	Nan
cynlluniau	awọn ero	Nan
cynllunio	gbimọ	Nan
cynhesaf	gbona ju	Nan
cynhenid	onile	Nan
cynhelir	yoo	None
cynharaf	alakoko	Nan
cyngerdd	ere orin	Nan
cyngheiriaid	awọn oludaniloju	Nan
cyngherddau	awọn ere orin	Nan
cynghorwyr	ọmọ	None
cynghrair	ajumọṣe	Nan
cynghreiriaid	awọn ọrẹ	Nan
cyngor	imọran	Nan
cynlluniwyd	ngbero	None
cyngres	apejọ alapejọ	Nan
cynhaeaf	ìkórè	Nan
cynhaliodd	o muduro	Nan
cynhaliwr	olutọju	Nan
cynhaliwyd	o ti waye	Nan
cynhanes	prehistory	Nan
cynhanesyddol	prehistoric	Nan
cynharach	sẹyìn	Nan
cynhadledd	apejọ	Nan
dalu	sanwo	Nan
cynnal	fowosowopo	Nan
cynnes	loworo	Nan
cyprus	kírúsì	Nan
cyrch	igbogun ti	Nan
cyrchoedd	igbogun	Nan
cyrff	awọn ara	Nan
cyrhaeddodd	o de	Nan
cyrn	iwo	Nan
cyrraedd	de	Nan
cyrs	ọpá	Nan
cyrus	ekoro	Nan
cysawd	eto	Nan
cysgodion	awọn ojiji	Nan
cysgu	sùn	Nan
cyson	loorekoore	Nan
cystadlaethau	awọn idije	Nan
cystadleuaeth	idije	Nan
cynyddu	pọ si	Nan
cynyddol	npo si	Nan
cynyddodd	o pọ si	Nan
cynydd	pọ si	Nan
cynnig	išipopada	Nan
cynnwys	akoonu	Nan
cynnydd	ilọsiwaju	Nan
cynnyrch	ọja	Nan
cynorthwyo	ran	Nan
cynradd	kekere	None
cynrychiolaeth	oniduro	Nan
cynnar	kutukutu	Nan
cynrychioli	aṣoju	Nan
cynrychiolwyr	awọn aṣoju	Nan
cyntaf	akoko	Nan
cyntefig	alakọbẹrẹ	Nan
cynulleidfa	jepe	Nan
cynulleidfaoedd	olugbo	Nan
cynulliad	apejọ	Nan
cynweriniaeth	olominira	Nan
cynrychiolir	aṣoju	Nan
ddegawd	mewa	Nan
damascus	damascus	Nan
damwain	ijamba	Nan
ddafydd	david	Nan
ddal	dimu	Nan
ddamcaniaeth	yii	Nan
ddamwain	ijamba	Nan
ddanfon	firanṣẹ	Nan
ddangos	ṣafihan	Nan
ddarganfod	ṣewadi	Nan
ddarganfuwyd	ri	Nan
ddarganfyddiadau	awari	None
ddarganfyddodd	awari	None
ddarlledu	igbohunsafefe	Nan
ddarn	nkan	None
ddarparu	pese	Nan
ddata	data	Nan
ddatblygiad	idagbasoke	None
ddafad	agutan	Nan
ddatblygiadau	idagbasoke	None
ddaeth	wa	Nan
ddaearyddol	àgbègbè	Nan
dawr	owurọ	Nan
day	ọjọ	Nan
days	àwọn ọjọ́	Nan
dağı	dağı	Nan
dc	dc	Nan
dd	f	Nan
dda	daradara	Nan
ddadl	ijiroro	Nan
ddadlau	jiyan	Nan
ddadleuol	ariyanjiyan	Nan
ddaear	ile aye	Nan
ddaearegol	ilẹ	None
ddaeargryn	ìṣẹlẹ	Nan
ddaeargrynfeydd	awọn iwariri-ilẹ	Nan
ddaearyddiaeth	ilẹ	None
ddaearyddwyr	ilẹ	None
ddatblygodd	dagbasoke	None
ddatblygu	idagbasoke	None
ddatblygwyd	idagbasoke	None
ddeddwyrain	ila-oorun	Nan
ddefaid	agutan	Nan
ddefnydd	lo	Nan
ddefnyddiai	o lo	Nan
ddefnyddiau	awọn ohun elo	Nan
ddefnyddid	ti lo	Nan
ddefnyddio	lo	Nan
ddefnyddiodd	o lo	Nan
ddefnyddiol	wulo	Nan
ddefnyddior	ti lo	Nan
ddefnyddir	ti lo	Nan
ddefnyddiwyd	ti lo	Nan
ddefnyddwyr	awọn olumulo	Nan
ddefod	irubo	Nan
ddefodau	awọn irubo	Nan
ddeddfwriaeth	ofin	None
ddeddfau	ofin	None
ddeddf	ofin	None
ddechreuwyd	bẹrẹ	Nan
ddatgan	ipinle	Nan
ddatganiad	alaye	Nan
ddathlu	ayeye	Nan
ddathlur	ṣe ayẹyẹ	Nan
ddatrys	yanjú	None
ddau	meji	Nan
ddaw	yoo	None
dawnsio	jijo	Nan
ddawns	jó	Nan
ddawr	owurọ	Nan
dde	ni ọtun	Nan
ddeall	loye	Nan
ddealltwriaeth	oye	Nan
ddechrau	bẹrẹ	Nan
ddechraur	bẹrẹ	Nan
ddechreuodd	bẹrẹ	Nan
ddawnsio	jijo	Nan
dawns	jó	Nan
dawn	ogbon	Nan
dawes	tunu	Nan
darfu	idalọwọduro	Nan
darganfod	iwari	Nan
darganfu	o ri	Nan
darganfur	o ri	Nan
darganfuwyd	awari	None
darganfyddiad	awari	None
darganfyddiadau	awari	None
dargludiad	ipa ọna	Nan
dargludo	ihuwasi	Nan
darllediadau	awọn igbohunsafefe	Nan
darlledu	igbohunsafefe	Nan
darlledur	olugbohunsafefe	Nan
darlledwr	olugbohunsafefe	Nan
darlledwyd	igbohunsafefe	Nan
darllen	kika	Nan
darfod	pari	Nan
darddiad	oti	Nan
danwydd	epo	Nan
dant	ehin	Nan
damweiniau	awọn ijamba	Nan
dan	danu	Nan
dance	jó	Nan
dances	ijó	Nan
danciau	awọn tanki	Nan
danddaearol	ipamo	Nan
daneg	mejila	None
darllenwch	ka	Nan
dangerous	lewu	Nan
dangosir	ti han	Nan
dangosodd	fihan	None
dangoswyd	ti han	Nan
daniaid	danieni	Nan
daniel	daniel	Nan
dannedd	eyin	None
dannie	dannie	Nan
dangos	ṣafihan	Nan
damcaniaeth	yii	Nan
darlun	aworan	Nan
darn	nkan	None
datganiadau	awọn alaye	Nan
datganodd	o kede	Nan
datgelodd	fi	None
datgelu	ifihan	Nan
datguddiad	ifihan	Nan
dathliadau	ayẹyẹ	Nan
dathlu	ayeye	Nan
datrys	yanju	Nan
dau	meji	Nan
dave	dave	Nan
david	david	Nan
davies	davies	Nan
davis	davis	Nan
daw	yoo	None
dawel	dakẹrọrọ	Nan
datganiad	alaye	Nan
datgan	ipinle	Nan
datblygwyd	idagbasoke	None
datblygun	idagbasoke	None
darnau	awọn ege	Nan
daro	lu	Nan
darogan	awọn asọtẹlẹ	Nan
darparu	pese	Nan
darparwyd	pese	Nan
dartford	dartford	Nan
darwin	darwin	Nan
darlunio	iyaworan	Nan
das	das	Nan
datblygedig	ti ni ilọsiwaju	Nan
datblygiad	idagbasoke	None
datblygiadau	idagbasoke	None
datblygiedig	idagbasoke	None
datblygodd	dagbasoke	None
datblygol	sese	Nan
datblygu	idagbasoke	None
data	data	Nan
diflannu	farasin	Nan
diflannun	farasin	Nan
difrifol	to	None
ec	àsọ	Nan
echdoriadau	irukerudo	Nan
echel	àá	Nan
echreiddiad	ogbara	Nan
eclectig	awokose	Nan
ecoleg	ẹkọ nipa ayika	Nan
economaidd	aje	None
economeg	ọrọ-aje	Nan
economi	aje	None
economir	aje	None
economïau	awọn ọrọ-aje	Nan
ecosystemau	ilolupo eda	Nan
ecuador	ecuador	Nan
ecwador	ecuador	Nan
ecwilibriwm	iwọntunwọnsi	Nan
ebyst	imeeli	Nan
ed	ed	Nan
ebwy	ebbw	Nan
ebost	imeeli	Nan
dŵf	wá	Nan
dŵr	omi	None
dŷ	ilé	None
e	é	Nan
e-bost	imeeli	Nan
each	ẹṣin	Nan
eagle	idì	Nan
eames	awọn orukọ	Nan
eang	gbooro	Nan
eangdiroedd	ilẹ	None
east	ila-oorun	Nan
eastenders	ila-oorun	Nan
eastern	ila-oorun	Nan
eb	eb	Nan
ebill	kẹrin	None
ebrill	kẹrin	None
edd	edd	Nan
eddie	eddie	Nan
eden	eden	Nan
effeithiol	munadoko	Nan
effeithiolrwydd	ndin	Nan
effeithior	kan	None
effeithiwyd	fowo	Nan
effeithlon	munadoko	Nan
effeithlonrwydd	ṣiṣe	Nan
efo	pẹlu	Nan
efor	efor	Nan
efrog	york	None
efydd	idẹ	Nan
eg	eg	Nan
eglur	ko	None
egluro	ṣàlàyé	Nan
eglwys	ijo	Nan
eglwysi	awọn ile ijọsin	Nan
effeithiodd	o fowo	Nan
effeithio	kan	None
effeithiau	awọn ipa	Nan
effaith	ipa	Nan
edgar	edgar	Nan
edison	edison	Nan
edmund	edmund	Nan
edmunds	awọn itọsọna	Nan
edmwnd	edmwnd	Nan
edrych	wo	Nan
edward	edward	Nan
dún	odi	Nan
edwards	awọn itọsọna	Nan
edwino	ibajẹ	Nan
ee	eg	Nan
ef	rẹ	None
efaill	ibeji	None
efallai	boya	Nan
efengyl	ihinrere	None
efengylau	ihinrere	None
edwin	edwin	Nan
dôn	ohun orin	Nan
dîm	egbe	None
départements	départements	Nan
dylanwad	ipa	Nan
dylanwadau	awọn ipa	Nan
dylanwadol	gbajugbaja	Nan
dylanwadu	ipa	Nan
dylanwadun	influencer	Nan
dyled	gbese	None
dyli	ko	None
dylid	bẹẹni	Nan
dylunio	apẹrẹ	Nan
dyma	niyi	None
dymar	ibinu	Nan
dymheredd	otutu	None
dymhereddau	ibinu	Nan
dymhorol	ti igba	Nan
dymor	akoko	Nan
dylan	ipa	Nan
dylair	yẹ	Nan
dylai	o ye	Nan
dyfyniadau	avvon	Nan
dyfeisio	pilẹ	Nan
dyfeisiwr	olupilẹṣẹ	Nan
dyfeisiwyd	ti a se	Nan
dyfeisydd	olupilẹṣẹ	Nan
dyffryn	afonifoji	Nan
dyffrynoedd	afonifoji	Nan
dyfnaf	jinjin	Nan
dymuniad	ifẹ	Nan
dyfnaint	devon	Nan
dyfod	wá	Nan
dyfodd	o dagba	Nan
dyfodiad	dide	Nan
dyfodol	ojo	None
dyfrhau	irigeson	Nan
dyfrllyd	olomi	Nan
dyfu	dagba	Nan
dyfnder	ijinle	Nan
eglwysig	ti alufaa	Nan
dymuno	fẹ	Nan
dyna	o n niyen	Nan
dyw	ọlọrun	Nan
dywed	o sọpe	Nan
dywediadau	awọn ọrọ	Nan
dywedir	sọ	None
dywedodd	sọ	None
dywedwyd	sọ	None
dywodfaen	okuta didan	Nan
dywydd	ojo	None
dywyll	dudu	Nan
dywysog	ọmọ	None
dywysogaeth	ijoye	Nan
dywysoges	ọmọ-alade	Nan
dywysogion	awọn ọmọ-alade	Nan
dân	ina	Nan
département	dédé	Nan
dystiolaeth	ẹri	Nan
dysprosiwm	dysprosium	Nan
dysgwyr	akẹẹkọ	Nan
dysgwn	a kọ	Nan
dynar	onírẹlẹ	Nan
dynes	obinrin	Nan
dyngarol	omoniyan	Nan
dyngedfennol	lominu	Nan
dynion	okunrin	None
dynnu	fa	Nan
dynodi	yiyan	Nan
dyn	ọkunrin	Nan
dynodir	itọkasi	Nan
dynolryw	ọmọ	None
dysg	kọ ẹkọ	Nan
dysgeidiaeth	awọn ẹkọ	Nan
dysgir	o jẹ ẹkọ	Nan
dysgodd	o kọ	Nan
dysgu	kikọ ẹkọ	Nan
dysgur	kọ ẹkọ	Nan
dynol	ènìyàn	Nan
dyfed	dagba	Nan
egni	agbara	None
egret	egret	Nan
encyclopædia	encyclopedia	Nan
end	ipari	Nan
endid	nkankan	Nan
endif	opin	Nan
endocrin	endocrine	Nan
endorsements	awọn ìfaradà	Nan
enedigaeth	ibi	Nan
enedigol	ibi	Nan
enfawr	tobi	Nan
enfys	oṣumare	Nan
enghraifft	apẹẹrẹ	Nan
enghreifftiau	awọn apẹẹrẹ	Nan
engineer	ẹnjinia	Nan
england	gẹẹsi	Nan
english	gẹẹsi	Nan
encyclopedia	encyclopedia	Nan
englyn	englyn	Nan
encyclopaedia	igbasilẹ	Nan
encilio	padasehin	Nan
elyn	ọtá	Nan
elyrch	swans	Nan
embargo	ofin	None
emberiza	emberiza	Nan
emily	emily	Nan
emiradau	olú ọba	Nan
emlyn	emlyn	Nan
emosiynol	ẹdun	Nan
empire	olú ọba	Nan
employment	oojọ	Nan
emrys	awọn em em	Nan
emyr	emyr	Nan
en	yo	Nan
enaid	ọkàn	Nan
enbyd	desperate	Nan
enciliodd	o pada sẹhin	Nan
englynion	itumo	None
engraifft	apẹẹrẹ	Nan
eni	ibi	Nan
enwebiad	yiyan	Nan
enwebwyd	yan	None
enwedig	ni pataki	Nan
enwi	lorukọ	Nan
enwir	ti a npè ni	Nan
enwocaf	olokiki julọ	Nan
enwodd	o lorukọ	Nan
enwog	olokiki	Nan
enwogion	gbajumo osere	Nan
enwol	ipin	None
enwr	omiran	Nan
enwyd	ti a npè ni	Nan
enydaidd	lẹsẹkẹsẹ	Nan
eo	éo	Nan
eos	éos	Nan
enwaur	enwaur	Nan
enwau	awọn orukọ	Nan
enwadau	denomination	Nan
enwad	denomination	Nan
enillasant	won bori	Nan
enillion	awọn dukia	Nan
enillodd	o bori	Nan
enillwr	olubori	Nan
enillwyd	bori	Nan
enillwyr	bori	Nan
ennill	ṣẹgun	Nan
elwir	ti a pe	Nan
ennyn	mu binu	Nan
ensemble	ṣajọpọ	Nan
ensure	rii daju	Nan
ensym	enzymu	Nan
ensymatig	ensaemusi	Nan
ensymau	ensaemusi	Nan
entitled	ẹtọ ni	Nan
enw	orukọ	Nan
enrico	okun	Nan
elwid	o ti a npe	Nan
elwa	anfani	Nan
elw	èrè	Nan
eifion	eifion	Nan
eiliad	ikeji	Nan
ein	tiwa	Nan
einglsacsonaidd	anglo-saxon	Nan
einglsacsoniaid	anglo-saxons	Nan
einstein	einstein	Nan
eira	yinyin	Nan
eirian	plums	Nan
eiriau	awọn ọrọ	Nan
eironig	ironically	Nan
eisiau	fẹ	Nan
eisioes	tẹlẹ	Nan
eisoes	tẹlẹ	Nan
eistedd	joko	Nan
eisteddfod	eisteddfod	Nan
eifftaidd	ara egipti	Nan
eider	eider	Nan
eiddo	ohun-ini	Nan
eidaleg	ilu italia	Nan
egwyddor	opo	Nan
egwyddorion	awọn ipilẹṣẹ	Nan
egyptian	egyptian	Nan
ehangach	fẹẹrẹ	Nan
ehangaf	fẹẹrẹ	Nan
ehangdir	ilẹ	None
ehangiad	imugboroosi	Nan
eisteddfodau	eisteddfodau	Nan
ehangodd	o gbooro	Nan
ehangur	imugboroosi	Nan
ehangwyd	ti fẹ	Nan
ehedydd	eefin	Nan
ei	tirẹ	Nan
eich	rẹ	None
eidal	ilu italia	Nan
eidalaidd	italics	Nan
ehangu	imugboroosi	Nan
egnir	funnilokun	Nan
eitemau	awọn ohun	Nan
eithafol	awọn iwọn	Nan
elgar	àgbọn	Nan
eliffant	erin	Nan
eliot	iwoye	Nan
elis	elis	Nan
elisabeth	elizabeth	Nan
elizabeth	elizabeth	Nan
ell	gbogbogbo	None
ellen	ellen	Nan
ellir	rárá	Nan
ellis	ellis	Nan
eluned	gbọn	Nan
elusen	aanu	None
elusennau	alanu	Nan
elusennol	alaanu	Nan
elvis	igbonwo	Nan
elfennol	alakọbẹrẹ	Nan
elfennau	awọn eroja	Nan
elfen	ano	Nan
elen	lẹẹkansi	Nan
either	boya	Nan
eithin	gorse	Nan
eithr	ṣugbọn	Nan
eithriad	ayafi	Nan
eithriadau	imukuro	Nan
eithriadol	yatọ	Nan
eithrio	ayafi	Nan
eithaf	lẹwa	Nan
eithrior	ayafi	Nan
ela	emi	Nan
eleanor	eleanor	Nan
electromagnetedd	itanna	Nan
electromagnetig	itanna	Nan
electronau	elekitironi	Nan
electroneg	ẹrọ itanna	Nan
electronig	itanna	Nan
el	el	Nan
dydyr	odi	Nan
dydy	kii ṣe	Nan
dydi	kii ṣe	Nan
diweithdra	alainiṣẹ	Nan
diwethaf	kẹhin	Nan
diwinyddiaeth	eko	None
diwinyddol	imq ẹkọ	Nan
diwrnod	ọjọ	Nan
diwydiannau	awọn ile-iṣẹ	Nan
diwydiannol	ile ise	Nan
diwydiant	ile ise	Nan
diwygiad	atunwo	Nan
diwygiadau	awọn atunṣe	Nan
diwylliannau	awọn asa	Nan
diwylliannol	aṣa	Nan
diwyllianol	aṣa	Nan
diwylliant	aṣa	Nan
djibouti	djibouti	Nan
diweddu	ipari	Nan
dm	dm	Nan
diweddodd	o pari	Nan
diweddarach	nigbamii	Nan
disgyn	ṣubu	Nan
disgynodd	o ṣubu	Nan
disgynyddion	iru-ọmọ	Nan
disgyrchiant	walẹ	Nan
disodlwyd	rọpo	Nan
distribute	kaakiri	Nan
distribution	pinpin	Nan
district	agbegbe	Nan
divali	divus	Nan
diver	omuwe	Nan
divoire	devoire	Nan
diwali	diwali	Nan
diwan	bayi	None
diwedd	ipari	Nan
diweddar	laipẹ	Nan
diweddaraf	tuntun	None
dmitri	dmitri	Nan
dna	dna	Nan
do	fun	None
doler	dola	Nan
dolur	imolara	Nan
dolwyddelan	ayeraye	Nan
dom	emi	Nan
domen	okiti	Nan
domesticus	homeus	Nan
dominica	dominica	Nan
dominyddir	jẹ gaba lori	Nan
dominyddur	gomina	None
don	don	Nan
dona	buburu	Nan
donald	donald	Nan
donaw	donaw	Nan
donn	brown	Nan
dont	maṣe	Nan
dolenni	awọn ọna asopọ	Nan
dolennau	awọn ọna asopọ	Nan
dolen	lupu	Nan
dolbadarn	dolmen	Nan
doc	doc	Nan
dociau	docks	Nan
doctor	dokita	Nan
document	iwe	Nan
documentation	iwe	Nan
documents	awọn iwe aṣẹ	Nan
dod	wá	Nan
disgyblaethau	ilana	None
dodd	dodd	Nan
doeau	awọn orule	Nan
doedd	ko	None
does	ko	None
doeth	ologbon	Nan
dof	sọ	None
dogfen	iwe	Nan
dogfennau	awọn iwe aṣẹ	Nan
dodiad	ifihan	Nan
disgyblaeth	ibawi	Nan
disgybl	ọmọ	None
disgwylir	o ti ṣe yẹ	Nan
dim	rárá	Nan
dime	éù	Nan
dimensiwn	apa	Nan
dinas	ilu	Nan
dinasoedd	awọn ilu	Nan
dinasyddion	ara ilu	Nan
dinbych	jowo	Nan
dineilltuol	aimọkan	Nan
dinesig	t’ọlaju	Nan
dinesydd	ara ilu	Nan
dinistr	iparun	Nan
dinistrio	iparun	Nan
dinistriwyd	o ti parun	Nan
dinorwig	aini	Nan
diocletian	diocletian	Nan
dilynwyr	ọmọlẹyìn	Nan
dilynwyd	tẹle	Nan
dilynodd	o tẹle	Nan
dilyniant	ọkọọkan	Nan
difrodi	bajẹ	Nan
difyrrwch	iṣere	Nan
difyrweithiau	ọgba iṣere	Nan
digidol	oni-nọmba	Nan
digital	oni-nọmba	Nan
digon	to	None
digwydd	ṣẹlẹ	Nan
diod	mu	Nan
digwyddiad	ìṣẹlẹ	Nan
digwyddodd	o ṣẹlẹ	Nan
digymraeg	welsh	Nan
dihangfa	sa asala	Nan
dileu	paarẹ	Nan
dillad	aṣọ	Nan
dilledyn	aṣọ	Nan
dilyn	tẹle	Nan
digwyddiadau	iṣẹlẹ	Nan
dorchog	sun	None
dioddef	ijiya	Nan
diodorus	mimu	Nan
dirywiad	kọ	Nan
dirywio	kọ	Nan
dirywiodd	o kọ	Nan
disclaimers	àsọjáde	Nan
disel	diesel	Nan
disg	disiki	Nan
disgrifiad	ijuwe	Nan
disgrifiadau	awọn apejuwe	Nan
disgrifio	ṣàpèjúwe	Nan
disgrifiodd	o ṣe apejuwe	Nan
disgrifior	ṣàpèjúwe	Nan
disgrifir	ṣàpèjúwe	Nan
disgwyl	reti	Nan
disgwyliad	ireti	Nan
disgwylid	o ti ṣe yẹ	Nan
dirwyn	yikaka	Nan
dirwedd	ala-ilẹ	Nan
dirwasgiad	ipadasẹhin	Nan
dirty	dọti	Nan
diodydd	ohun mimu	Nan
diogel	lailewu	Nan
diogelu	aabo	Nan
diogelwch	aabo	Nan
diolch	o ṣeun	Nan
diorseddwyd	iparun	Nan
diplomyddol	oselu ara ilu	Nan
dioddefodd	o jiya	Nan
dipyn	kan	None
directly	taara	Nan
dirgryniadau	awọn ariwo	Nan
diriogaeth	agbegbe	Nan
diriogaethau	awọn agbegbe	Nan
diriogaethaur	awọn agbegbe	Nan
dirk	dirk	Nan
diroedd	ilẹ	None
dir	ilẹ	None
doreen	doreen	Nan
dorf	ogunlọgọ	Nan
dorlan	ọdẹdẹ	Nan
dudalen	oju iwe	Nan
dudley	dudley	Nan
duedd	aṣa	Nan
dueddol	tọkantọkan	Nan
duffy	eeyan	Nan
dug	gbe	None
dugiaeth	adodo	Nan
dull	ọna	Nan
dulliau	awọn ọna	Nan
dulyn	dublin	Nan
duon	alawodudu	Nan
dur	irin	Nan
during	lakoko	Nan
durrës	durrës	Nan
duw	ọlọrun	Nan
duck	pepeye	Nan
dubh	dudu	Nan
dua	lile	Nan
du	dudu	Nan
drwydded	iwe-aṣẹ	Nan
drwyr	nipasẹ	Nan
drych	digi	Nan
drychinebus	ìparun	Nan
drycin	oko	None
drydan	ina	Nan
drydanol	itanna	Nan
duwdod	oriṣa	Nan
drydedd	kẹta	None
drymau	wuwo	Nan
drymiau	awọn ilu	Nan
drysau	awọn ilẹkun	Nan
dryw	wren	Nan
drywod	aran	Nan
drên	ọkọ oju-irin	Nan
dteach	ilé	None
drydydd	kẹta	None
drwy	nipasẹ	Nan
duwiau	oriṣa	Nan
duwiesau	oriṣa	Nan
dwythwch	jowo	Nan
dwywaith	lemeji	Nan
dy	rẹ	None
dyblu	ilọpo meji	Nan
dych	jẹ	Nan
dychwelodd	o pada	Nan
dychwelyd	padà	Nan
dydd	ọjọ	Nan
dyddewi	st davids	Nan
dyddiad	ọjọ	Nan
dyddiau	ọjọbọ	Nan
dyddiaur	ojoojumo	Nan
dyddio	ibaṣepọ	Nan
dyddiol	ojoojumo	Nan
dyddion	àwọn ọjọ́	Nan
dwythell	meji	Nan
dwysedd	kikankikan	Nan
dwysder	kikankikan	Nan
dwys	lekoko	Nan
dvd	dvd	Nan
dwbl	ilọpo meji	Nan
dweud	sọ	None
dwf	idagba	Nan
dwfn	jinjin	Nan
dwi	emi ni	Nan
dwr	omi	None
duwies	oriṣa	Nan
dwrci	tọki	Nan
dwy	meji	Nan
dwyfol	ibawi	Nan
dwyieithog	ede	None
dwylo	ọwọ	Nan
dwyn	jiji	Nan
dwyrain	ila-oorun	Nan
dwyreiniol	ila-oorun	Nan
dwristiaid	ajo	None
cynffon	iru	Nan
drwsio	tunṣe	Nan
drwm	wuwo	Nan
draddodiadau	aṣa	Nan
draddodiadol	aṣa	Nan
draed	ẹsẹ	None
draenog	hedgehog	Nan
draeth	eti okun	Nan
drafferth	wahala	Nan
drafnidiaeth	irinna	Nan
drafod	jiroro	Nan
drafodaeth	ijiroro	Nan
drafodaethau	awọn ijiroro	Nan
draig	dragoni	Nan
drais	iwa-ipa	Nan
drama	eré	Nan
dramodydd	agba	None
dramor	odi	Nan
draddodiad	atọwọdọwọ	Nan
dr	dr	Nan
doyle	doyle	Nan
down	silẹ	Nan
dorothy	igbagbe	Nan
dorri	fọ	Nan
dorrir	ti baje	Nan
dorsal	ibusọ	Nan
dos	iwọn lilo	Nan
dosbarth	kilasi	Nan
dosbarthiad	pinpin	Nan
dramâu	ìtàgé	Nan
dosbarthiadau	awọn kilasi	Nan
dosbarthur	awọn kilasika	Nan
dosbarthwyd	pin	Nan
dosberthir	pin	Nan
dot	aami	Nan
douglas	douglas	Nan
doukas	doukas	Nan
dove	àdàbà	Nan
dosbarthu	pinpin	Nan
drws	ilekun	Nan
dras	dofun	Nan
draws	trans	Nan
dringwyr	oluta oke	Nan
driniaeth	itọju	Nan
driphlyg	meteta	Nan
dro	yiyi	Nan
droed	ẹsẹ	None
drofannol	tropical	Nan
droi	yiyi	Nan
droin	silẹ	Nan
dros	lori	Nan
drosedd	ilufin	Nan
droseddau	ilufin	Nan
droseddol	ọdaran	Nan
drosglwyddo	gbigbe	Nan
drosodd	lori	Nan
drwg	buburu	Nan
dringwr	oluta-nla	Nan
dringor	oluta-nla	Nan
dringodd	gun	None
dringo	gígun	Nan
dre	ti	Nan
dref	ilu	Nan
drefedigaeth	ileto	Nan
drefi	awọn ilu	Nan
drefn	paṣẹ	Nan
drefniadaeth	agbari	Nan
drefnu	seto	Nan
draw	lori	Nan
dreigiau	awọn dragoni	Nan
dreisgar	iwa-ipa	Nan
dreulio	walẹ	Nan
dri	mẹta	Nan
drigai	olugbe	Nan
drigolion	olugbe	Nan
drin	tọju	Nan
drindod	metalokan	Nan
dreiglad	iyipada	Nan
毛澤東	毛澤東	Nan
