paragraph sign	<i>	None
spouses	подружжя	None
events	події	None
divide	поділ	None
divisibility	подільність	None
podolsky	подільська	None
event	подією	None
poetry	поетика	None
poet	поетом	None
poetess	поетеса	None
poets	поетів	None
poetic	поетичні	None
destituted	позбавлений	None
deprivation	позбавлення	None
trip	рейси	None
positively	позитивно	None
position	становище	None
designates	позначається	None
marking	розмітки	None
show	шоу	None
indicator	індикатор	None
indexes	індекси	None
punishment	покарання	None
while	поки	None
adoration	поклоніння	None
generation	покоління	None
generations	поколінь	None
covering	покрив	None
buyers	покупців	None
positions	посади	None
overcome	подолання	None
feats	подвиги	None
presents	присутня	None
returns	повертається	None
surface	поверхні	None
guilty	повинні	None
full	полон	None
complete	повної	None
entirely	повністю	None
rising	повстання	None
insurgents	повстанців	None
revolts	повстань	None
bounded	повязано	None
bound	повязують	None
bounds	повязує	None
notifications	повідомлення	None
messages	повідомлень	None
informes	повідомляє	None
slowly	повільно	None
district	району	None
air	повітрі	None
aerial	повітряних	None
bad	погано	None
deepening	поглиблення	None
absorption	поглинання	None
coordinated	погодився	None
worsening	погіршення	None
under	під	None
presentation	подання	None
presented	представлені	None
taxes	податків	None
tax	податок	None
sex	статі	None
field	полі	None
regiment	полку	None
regiments	полків	None
port	порту	None
portal	портал	None
portrait	портрет	None
portraits	портрети	None
portugal	португалії	None
breaking	порушення	None
rescue	порятунку	None
comparison	порівняння	None
comparable	порівнянні	None
comparatively	порівняно	None
differently	порізному	None
post	пошти	None
settlements	селища	None
sending	посилання	None
weakening	послаблення	None
sent	послав	None
services	служби	None
ambassadors	послів	None
followers	послідовників	None
one after another	послідовно	None
sequence	послідовність	None
embassy	посольство	None
pospolita	посполитої	None
became	стало	None
decision	рішенням	None
resolution	постановою	None
provision	постачання	None
concedes	поступається	None
gradually	поступово	None
breed	породи	None
returned	повернувшись	None
defeat	поразки	None
popularity	популярністю	None
colonel	полковника	None
half	половині	None
captives	полонених	None
poltava	полтаві	None
poltavka	полтавка	None
polish	польські	None
poland	польщі	None
hunting	полювання	None
fields	полях	None
poles	поляків	None
polysaccharides	полісахариди	None
pole	тичини	None
flight	політ	None
policy	політиці	None
political	політичній	None
police	поліції	None
orange	помаранчевої	None
errors	помилок	None
among	серед	None
moderate	помірного	None
noticeable	помітні	None
noticeably	помітно	None
enslavement	поневолення	None
monday	понеділок	None
ideas	ідеї	None
precursor	попередник	None
precursors	попередників	None
at first	спершу	None
popular	популярні	None
time	часі	None
return	повернутися	None
behaviours	поведінки	None
behaviour	поведінку	None
pentameter	пентаметр	None
pentastomata	пентастоми	None
staying	перебування	None
reconstruction	реконструкції	None
advantages	переваги	None
victory	перемогу	None
predominate	переважали	None
predominance	переважанням	None
prevail	переважають	None
predominates	переважає	None
predominant	переважна	None
transportation	транспортування	None
exceeds	перевищує	None
revolution	революції	None
verification	перевірки	None
viewing	перегляду	None
negotiations	переговорів	None
before	перед	None
transfer	перенесення	None
transferred	передається	None
transmission	передачі	None
transfers	перекази	None
foresight	передбачення	None
preface	передмова	None
front	фронті	None
conditions	умови	None
translated	переклав	None
translation	трансляції	None
translator	перекладачі	None
pelicans	пелікани	None
translations	перекладів	None
peleus	пелей	None
pedagogy	педагогіки	None
memory	памяті	None
pan	пан	None
gentlemen	пана	None
panas	панас	None
punk rock	панкрока	None
panteleimon	пантелеймон	None
rules	правилами	None
pope	папою	None
paper	папір	None
fallow	пар	None
pair	пара	None
parallelogram	паралелограм	None
parallel	паралелі	None
parameters	параметрів	None
paris	паризької	None
park	парку	None
parks	парків	None
parliament	парламенті	None
partner	партнера	None
partners	партнерів	None
party	партії	None
passengers	пасажирів	None
patent	патенту	None
patriarchy	патріархату	None
sure	певні	None
definitely	певне	None
positive	позитивні	None
confident	певній	None
teacher	педагог	None
pedagogical	педагогічних	None
constant	постійні	None
list	список	None
conqueror	переможець	None
easter egg	писанки	None
write	пишуть	None
writer	письменниця	None
writers	письменниці	None
questions	питаннями	None
writes	пише	None
writed	пишеться	None
ppp	пкс	None
swimming	плавання	None
reptiles	плазунів	None
planets	планети	None
planet	планеті	None
plans	планів	None
planning	планування	None
planned	планується	None
bedded	пластових	None
payment	плата	None
plato	платон	None
platon	платона	None
platform	платформи	None
tribes	племенами	None
tribe	племя	None
metatarsus	плесно	None
plus	плюс	None
north	північному	None
coast	узбережжі	None
mode of life	побут	None
everyday	побутові	None
overthrow	повалення	None
philip	пилипа	None
truce	перемиря	None
stove	печі	None
petrovich	петрович	None
movement	руху	None
inventory	перепису	None
female quail	перепілка	None
repartition	перерозподілу	None
settlers	переселенців	None
pursuit	переслідування	None
transformation	перетворення	None
transformations	перетворень	None
turn into	перетворюються	None
remaked	перетворюється	None
hymenoptera	перетинчастокрилі	None
passes	проходить	None
transition	перехід	None
transitional	перехідний	None
moved	переїхали	None
character	характеру	None
personages	персонажів	None
personalities	персоналії	None
perspective	перспективи	None
pen	перу	None
period	періоді	None
periods	періодів	None
periodic	періодичні	None
periodically	періодично	None
saint petersburg	спб	None
petliura	петлюра	None
petlyura	петлюри	None
petr	петра	None
petro	петро	None
petroglyphs	петрогліфи	None
constantly	постійно	None
dishes	страви	None
manual	підручник	None
proposal	пропозицією	None
offers	пропонує	None
enlightenment	просвітництва	None
avenue	проспект	None
observed	спостерігається	None
simple	прості	None
spaces	простори	None
extends	простягається	None
protectorate	протекторат	None
protest	протесту	None
protestantism	протестантизму	None
against	проти	None
counterweight	противагу	None
adversary	противника	None
opposed	протилежних	None
contradiction	протиріччя	None
cannals	протоки	None
strait	протокою	None
proton	протон	None
protons	протонів	None
professor	професора	None
professional	професійні	None
request	прохання	None
procedure	процедури	None
process	процесі	None
processes	процесів	None
processor	процесора	None
manifestations	проявів	None
straight	прямої	None
offer	пропозиція	None
nickname	прізвисько	None
sermons	проповіді	None
penetration	проникнення	None
problems	проблеми	None
problem	проблему	None
leading	провідні	None
passing	проходження	None
implement	проводить	None
take place	проводяться	None
guide	провідника	None
declared	проголосили	None
proclamation	проголошення	None
programmes	програм	None
program	програмі	None
programme	програмного	None
programming	програмування	None
progress	просування	None
selling	продаж	None
continuation	продовженням	None
continued	продовжували	None
continue	продовжують	None
continues	триває	None
product	продукція	None
productive	продуктивних	None
productivity	продуктивність	None
project	проекту	None
projects	проектів	None
designing	проектування	None
residence	резиденції	None
proseman	прозаїк	None
proletariat	пролетаріату	None
industrial	промислові	None
propaganda	пропаганди	None
near black sea	причорноморї	None
priority	пріоритет	None
psychology	психології	None
subsystem	підсистема	None
grounds	підставі	None
results	результатів	None
confirm	підтверджують	None
supported	підтримували	None
support	підтримці	None
supports	підтримує	None
approaches	підходів	None
approach	підхід	None
late	пізній	None
later	пізніші	None
picasso	пікассо	None
pyramid	піраміди	None
songs	пісні	None
sand	піски	None
after	після	None
song	пісня	None
pythagoras	піфагора	None
gerbillinae	піщанкові	None
slaves	рабів	None
councils	рад	None
council	раді	None
radical	радикальних	None
soviet	радянській	None
radiometer	радіометр	None
times	часів	None
together	спільно	None
paradise	рай	None
ryegrass	райграси	None
manuals	підручники	None
psichological	психологічних	None
account	підрахунками	None
enterprise	підприємство	None
psyche	психіки	None
birds	птахів	None
publicist	публіцист	None
item	пункт	None
points	точок	None
desert	пустелі	None
pushkin	пушкіна	None
wheat	пшениці	None
five	пять	None
southern	південній	None
southwestern	південнозахідній	None
south-western	південносхідної	None
south	півдні 	Nan
hemisphere	півкулі	None
northern	північній	None
northwest	північнозахідній	None
northeastern	північносхідній	None
peony	півонія	None
peninsula	півострів	None
semifinal	півфінал	None
underwater	підводних	None
preparation	підготовці	None
striked	піддається	None
are subordinated	підлягають	None
subordinates	підлягає	None
palate	піднебіння	None
signature	підписання	None
signed	підписали	None
subordinate	підпорядкування	None
enterprises	підприємствах	None
monument	памятника	None
reasons	причини	None
come	приходить	None
combination	сполучення	None
combines	поєднує	None
trips	поїздки	None
right	праві	None
rights	правах	None
truth	істини	None
true	щоправда	None
rule	правління	None
correct	правильний	None
governors	правителів	None
governor	правителі	None
governing	правлячої	None
right bank	правобережжі	None
legal	юридичні	None
orthography	правопису	None
orthodox	православя	None
aspiration	прагнення	None
aimed	прагнули	None
strived	прагнула	None
seek	прагнуть	None
aiming	прагнучи	None
prose	прозі	None
practice	практиці	None
practical	практичної	None
practically	практично	None
flag	прапором	None
work	твору	None
worked	працювали	None
working	робочої	None
explains	пояснює	None
labor	трудової	None
explain	пояснюють	None
explanation	пояснення	None
potential	потенціалу	None
potlatch	потлач	None
flow	потік	None
need	треба	None
inclination	потяг	None
buried	похований	None
burial	поховання	None
origin	походженням	None
hiking	походів	None
derivative	похідної	None
marching	похідних	None
began	розпочалася	None
rudimentary	початковий	None
primary	початкової	None
beginning	починаючи	None
honourable	почесний	None
begin	починаються	None
begins	починається	None
heard	почуттів	None
spreaded	поширилися	None
extension	поширенню	None
expansion	розширення	None
expansions	поширенням	None
extended	поширився	None
extened	поширилася	None
spreading	поширюються	None
spreads	поширюється	None
impulse	поштовх	None
search	шукати	None
explained	пояснюється	None
arrival	приходу	None
works	функціонує	None
ancestors	предків	None
reception	прийом	None
came	прийшов	None
examples	прикладів	None
advective	прикметник	None
advectives	прикметників	None
devices	пристроїв	None
lodging	приміщенні	None
at least	щонайменше	None
belonging	приналежність	None
principle	принципі	None
substantially	істотно	None
nestle	припадає	None
suspension	припинення	None
assume	припускають	None
supposition	припущення	None
nature	характер	None
natural	природні	None
dedicated	присвячені	None
acceleration	прискорення	None
adverb	прислівник	None
adverbs	прислівники	None
adoptation	пристосування	None
attachment	пристрій	None
presence	присутності	None
characteristic	характерні	None
tributaries	притоки	None
adherent	прихильниками	None
adherents	прихильників	None
sympathy	співчуття	None
acceptance	прийняттям	None
employees	службовців	None
adoption	прийняття	None
accepts	приймає	None
subject	тематика	None
representation	представництво	None
represent	являють	None
representative	представником	None
representatives	представників	None
president	президентом	None
presidium	президії	None
beautiful	прекрасне	None
premier	премєра	None
prime minister	премєрміністром	None
premier minister	премєрміністра	None
award	премії	None
press	пресі	None
blessed	пресвятої	None
throne	трон	None
coastal	прибережних	None
private	приватні	None
bring	приносить	None
reason	причиною	None
privilege	привілеї	None
consonant	приголосні	None
dowry	придане	None
acquirement	придбання	None
prydneprovsk	придніпровської	None
repression	репресії	None
gived	приділяв	None
appointed	призначається	None
assigned	призначено	None
appointment	призначенням	None
accepted	прийняті	None
limits	рамки	None
monuments	памятників	None
fuel	палива	None
areas	сферах	None
locality	місцевість	None
spots	місць	None
urban	міській	None
month	місяць	None
months	місяців	None
mission	місії	None
mitchell	мітчелл	None
myth	міф	None
myths	міфів	None
mythology	міфології	None
mikhnovsky	міхновського	None
ad	н е	None
mysticism	містицизм	None
bc	н е 	Nan
approaching	наближення	None
acquired	набуло	None
obtain	набувають	None
obtains	набуває	None
load	навантаження	None
in spring	навесні	None
surrounding	навколишнього	None
educational	освітніх	None
taught	навчається	None
even	навіть	None
remind	нагадують	None
reminds	нагадує	None
reward	нагороди	None
collects	набирає	None
contained	містяться	None
contains	містить	None
contain	містять	None
musical	музичні	None
musical-dramatic	музичнодраматичний	None
municipalities	общини	None
wall	сцені	None
obliged	повинно	None
muslims	мусульмани	None
munich	мюнхен	None
muscles	мязів	None
soft	мякою	None
meat	мясо	None
ball	шаром	None
migration	переселення	None
copper	міді	None
international	міжнародній	None
misanthropy	мізантропія	None
michelangelo	мікеланджело	None
microorganism	мікроорганізмів	None
milan	мілан	None
millions	мільйонів	None
mineral	мінеральні	None
minimum	мінімуму	None
ministry	служіння	None
minister	міністра	None
ministers	міністрів	None
measure	міру	None
consideration	розгляду	None
places	місцях	None
place	місці	None
twin cities	містапобратими	None
plateau	плоскогіря	None
provided	передбачав	None
assignment	надання	None
extraordinary	надзвичайних	None
nancy	нансі	None
nasu	нану	None
attack	наступу	None
the day before	напередодні	None
inscription	напис	None
wrote	писали	None
written	пишуться	None
writing	письмо	None
inscriptions	написи	None
napoleon	наполеона	None
drink	напої	None
for example	напр	None
example	прикладом	None
at the end	наприкінці	None
direction	спрямування	None
directions	напрямів	None
numbered	нараховується	None
essay	очерк	None
nations	націй	None
birth rate	народжуваність	None
folk	народній	None
national	національній	None
naruto	наруто	None
level	рівнем	None
first of all	передусім	None
violence	насильства	None
as far as	наскільки	None
consequences	наслідків	None
result	результатом	None
national academy of sciences	нан	None
musicians	музикантів	None
intention	намір	None
attempts	спроби	None
bowels	надрах	None
hope	надії	None
for ever	назавжди	None
back	назад	None
names	іменами	None
name	імям	None
titles	названий	None
named	названі	None
the largest	найбільші	None
the most important	найважливіші	None
most important	найвизначніших	None
highest	найвищі	None
best known	найвідоміший	None
the oldest	найстаріших	None
best	найкращий	None
the lowest	найнижча	None
protists	найпростіші	None
most frequent	найчастіше	None
ordered	наказав	None
accumulation	накопичення	None
belonged	належало	None
belongs	належить	None
counts	нараховує	None
counted	налічується	None
us	нас	None
attempted	намагалися	None
attempt	спробу	None
endeavour	намагаються	None
attempting	намагаючись	None
draw	намалював	None
music	музиці	None
museums	музеїв	None
museum	музею	None
mercury	меркурій	None
dead	померлих	None
mesopotamia	месопотамії	None
metabolites	метаболіти	None
metal	металу	None
metals	металів	None
metallurgy	металургії	None
goals	цілей	None
method	методу	None
methods	прийомів	None
underground	підпілля	None
aim	прагне	None
mechanism	механізму	None
mechanisms	механізмів	None
mechanics	механіки	None
mikita	микита	None
nicholas	миколи	None
mikolayovich	миколайович	None
mikolaev	миколаєва	None
mykolaiv	миколаїв	None
mikolaevsk	миколаївської	None
the past	минуле	None
pass	проходять	None
passed	проходили	None
peaceful	мирного	None
cape	мис	None
thinking	мислення	None
thinker	мислителі	None
arts	мистецтв	None
network	мережі	None
art	творчість	None
smaller	менші	None
less	менший	None
material	матеріальні	None
materials	матеріалів	None
matter	матерії	None
have	маємо	None
matrix	матриці	None
match	матч	None
matches	матчі	None
mafia	мафія	None
machines	машин	None
machine	машина	None
machinery construction	машинобудування	None
machine-building	машинобудівна	None
having	маючи	None
estate	маєтку	None
imf	мвф	None
honey	мед	None
medals	медалі	None
medicine	медицині	None
medical	медичні	None
limit	межа	None
outside	поза	None
boundaries	рубежі	None
between rivers	межиріччя	None
mexico	мексики	None
miller	мельник	None
membranes	мембрани	None
membrane	мембрана	None
memorial	меморіальні	None
me	мені	None
minority	меншин	None
nassau	нассау	None
artistic	художніх	None
metropolis	митрополії	None
moments	моменти	None
monarch	монарха	None
monarchy	монархії	None
cloister	монастиря	None
cloisters	монастирів	None
coins	монети	None
coin	монета	None
monograph	монографія	None
monomach	мономаха	None
monstera	монстера	None
montesquieu	монтескє	None
monitoring	моніторингу	None
morality	моралі	None
moral	моральні	None
sea	морі	None
by sea	морем	None
marine	морської	None
seas	морів	None
wizard muscovite	москальчарівник	None
moscow	московської	None
bridges	мости	None
motive	мотив	None
motives	мотивів	None
mozzarella	моцарела	None
my	мій	None
mp	мп	None
rna	рнк	None
wise	мудрого	None
wisdom	мудрість	None
moment	моменту	None
metropolitan	митрополита	None
molybdenum	молібден	None
young	молоді	None
artists	художників	None
michael	михайлом	None
mihailo	михайло	None
mihailovich	михайлович	None
plural	множини	None
language	язык	None
languages	мови 	Nan
speech	мовленні	None
grave	могилі	None
powerful	потужні	None
modality	модальність	None
models	моделі	None
model	модель	None
modeling	моделювання	None
modern	сучасній	None
modification	модифікації	None
maybe	можливо	None
possible	можна	None
opportunities	нагоди	None
possibility	можливість	None
opportunity	можливістю	None
may	травні	None
mosaics	мозаїки	None
brain	мозок	None
moldavians	молдавани	None
moldova	молдови	None
molecules	молекули	None
molecular	молекулярна	None
prayer	молитви	None
moliere	мольєра	None
temper	настрої	None
following	наступному	None
successor	наступник	None
alexey	олексій	None
deer	олень	None
olesya	олеся	None
olga	ольги	None
olympic	олімпійські	None
mistletoe	омела	None
washed	омивається	None
online	інтернеті	None
united nations	оон	None
precipitation	опадів	None
opera	оперний	None
stopped	опинилася	None
description	опису	None
descriptions	описи	None
describe	описують	None
describes	описує	None
questioning	опитування	None
story	розповідь	None
stories	історії	None
taxation	оподаткування	None
opposition	протистояння	None
resistance	опір	None
published	опублікував	None
orgasm	оргазму	None
bodies	тіл	None
body	тілом	None
organizations	організації	None
organization	організацією	None
organism	організму	None
alexandrovich	олександрович	None
organisms	організмів	None
oleg	олега	None
oxana	оксана	None
grounding	обґрунтування	None
sheeps	овець	None
review	огляду	None
advertisement	оголошення	None
ode	ода	None
received	отримували	None
receive	отримують	None
odesa	одесі	None
one	однієї	None
unit	підрозділ	None
units	підрозділів	None
equally	однаково	None
identical	однакові	None
alone	саму	None
singular	однини	None
clothes	одягу	None
odyssey	одіссея	None
armament	озброєнь	None
lakes	озера	None
lake	озеро	None
meant	означало	None
oach	ой	None
ocean	океані	None
eye	око	None
neighbourhood	околицях	None
surroundings	середовищі	None
separate	окремі	None
individual	індивідів	None
regions	регіонів	None
oxides	оксидів	None
circulation	обігу	None
organized	організував	None
horde	орди	None
official	офіційні	None
officially	офіційно	None
envelops	охоплює	None
guard	охорону	None
readily	охоче	None
evaluate	оцінити	None
rating	рейтингу	None
evaluations	оцінками	None
evaluation	оцінювання	None
estimated	оцінюється	None
evidently	очевидно	None
essays	очерки	None
cleaning	очищення	None
headed	очолював	None
eyes	очі	None
nd	ої	None
p.	п	None
p. kotlearevskiy	п котляревского	None
p. kotlearevskii	п котляревський	None
p. kotliarevsky	п котляревського	None
pablo	пабло	None
paul	павло	None
pavlichko	павличко	None
pavlovich	павлович	None
sprout	росток	None
chamber	палати	None
palace	палаці	None
paleolith	палеоліту	None
palaestra	палестра	None
design	оформлення	None
organic	органічних	None
oun	оун	None
get	отримувати	None
eagle	орлика	None
original	оригінальних	None
orchestra	оркестру	None
ornaments	прикраси	None
orientation	спрямованість	None
os	ос	None
development	розробці	None
lightning	освітлення	None
autumn	осінь	None
center	центрі	None
because	оскільки	None
ottoman	османської	None
fundamental	фундаментальні	None
person	особі	None
persons	осіб	None
personal	особисті	None
personally	особисто	None
personality	особистість	None
special	спеціальні	None
features	рисами	None
particularity	особливість	None
peculiarity	особливістю	None
last	останніх	None
ostap	остап	None
islands	островів	None
island	острів	None
here	тут	None
axis	осі	None
otaman	отамана	None
receives	отримує	None
memo	памяток	None
objective	обєктивної	None
object	обєктом	None
unknown	невідомі	None
integral	невідємною	None
immediately	сходу	None
negative	негативні	None
defects	недоліки	None
insufficiently	недостатньо	None
soon	скоро	None
independent	самостійні	None
independently	самостійно	None
independence	самостійності	None
in spite of	незважаючи	None
insignificant	незначні	None
no	ніякої	None
nonmetal	неметали	None
inevitably	неминуче	None
impossibly	неможливо	None
necessary	потрібні	None
necessity	потреб	None
repeatedly	неодноразово	None
neolithic age	неоліту	None
not far from	неподалік	None
nep	непу	None
nervous	нервової	None
irregularly	нерівномірно	None
often	часто	None
carries	несе	None
bear	носять	None
let	хай	None
recently	нещодавно	None
slavery	неволі	None
her	її	None
little	трохи	None
shortly	невдовзі	None
so	тому	None
natalka	наталка	None
natalya	наталія	None
nato	нато	None
crowd	натовп	None
in place	натомість	None
science	науці	None
sciences	наукове	None
scientific	науковій	None
oil	нафту	None
oil products	нафтопродуктів	None
nazis	нацистів	None
national-liberation	національновизвольної	None
nationalities	національностей	None
nationality	національність	None
nationalism	націоналізму	None
nationalists	націоналістів	None
nation	нації	None
as if	нібито	None
like	походять	None
our	наші	None
progeny	нащадки	None
succession	нащадків	None
availability	наявністю	None
nbu	нбу	None
sky	небо	None
not much	небагато	None
heavenly	небесних	None
failure	невдачі	None
dissatisfaction	невдоволення	None
objects	предметів	None
lower	нижчих	None
lowland	низовина	None
region	регіоні	None
equipment	устаткування	None
area	районі	None
face	обличчя	None
bonds	облігації	None
limited	обмежені	None
limitation	обмеження	None
limitations	обмежень	None
duties	обовязків	None
obligatory	обовязковим	None
necessarily	обовязково	None
duty	чергування	None
envelope	оболонка	None
cover	покриву	None
defensive	оборонних	None
descriptive	образотворчому	None
processing	переробки	None
ritual	обряд	None
rituals	обрядів	None
rite	обряду	None
service	службі	None
circumstances	обставини	None
amount	суму	None
volumes	томах	None
calculation	розрахунку	None
united	сполучені	None
bring together	обєднати	None
unite	обєднуються	None
unificates	обєднує	None
both	обох	None
low	низькі	None
turn	чергу	None
obama	обама	None
lowlands	низовини	None
nkvd	нквд	None
nobel	нобелівська	None
new	новій	None
novel	роману	None
news	новини	None
face value	номіналом	None
norway	норвегії	None
norms	норми	None
norm	норма	None
normative	нормативного	None
wore	носили	None
bearers	носіїв	None
bearer	носієм	None
nights	ночі	None
new york	ньюйорку	None
netherlands	нідерландів	None
never	ніколи	None
nobody	нікому	None
nile	нілу	None
germany	німеччині	None
germans	німців	None
niobe	ніоба	None
no one	ніхто	None
nietzsche	ніцше	None
night	ніч	None
nothing	ніщо	None
at	при	None
about	про	None
rotation	обертання	None
early	рано	None
earlier	раніше	None
races	раси	None
federal	федерального	None
federation	федерації	None
fedorovich	федорович	None
fedir	федір	None
feminism	фемінізму	None
phenol	фенол	None
phenomenon	явищем	None
feudal	феодальної	None
feudal lords	феодалів	None
feodosiya	феодосія	None
ferments	ферментів	None
farmer	фермер	None
festival	фестивалі	None
fauna	фауна	None
fc	фк	None
fletcher	флетчер	None
flora	флори	None
florence	флоренції	None
fleet	флоту	None
fauvism	фовізм	None
folklore	фольклору	None
fund	фонду	None
fondue	фондю	None
phonetic	фонетичні	None
forsythia	форзиція	None
formally	формально	None
formal	формальної	None
format	форматі	None
fleming	флемінг	None
paint	фарби	None
pharaoh	фараона	None
faculty	факультету	None
awarness	усвідомлення	None
uspenskiy	успенський	None
success	успіхів	None
successes	успіхи	None
successfully	успішно	None
removing	усунення	None
formations	формувань	None
forming	утворюється	None
allowance	утримання	None
ucc	уцр	None
member	членом	None
participants	учасників	None
participant	учасником	None
participation	участі	None
student	учень	None
schools	шкіл	None
school	шкільна	None
pupils	учні	None
idea	ідеєю	None
representations	уявлень	None
uefa	уєфа	None
phase	фаза	None
pheasant	фазанові	None
file	файл	None
files	файлів	None
fact	факт	None
facts	фактів	None
factor	чинник	None
factors	чинників	None
formula	формулою	None
formulating	формулювання	None
piano	фортепіано	None
fortress	фортеці	None
film	фільму	None
films	фільмів	None
finances	фінанси	None
financial	фінансові	None
financing	фінансування	None
finance	фінансів	None
finland	фінляндії	None
firms	фірми	None
havasu	хавасу	None
hyderabad	хайдарабад	None
khamsin	хамсин	None
khan	хана	None
characterize	характеризують	None
characterized	характеризується	None
characterizes	характеризує	None
characteristics	характеристики	None
characteristically	характерно	None
kharkiv	харківської	None
food	їжі	None
minute	хвилина	None
wave	хвиля	None
minutes	хвилі	None
sick	хворих	None
hentai	хентай	None
kherson	херсонський	None
chersonese	херсонес	None
bread	хліб	None
khmelnytsky	хмельниччини	None
khmelnitski	хмельницький	None
philosophy	філософії	None
government	урядів	None
philosophical	філософські	None
philosopher	філософа	None
forum	форум	None
photograph	фото	None
photos	фотографії	None
photosynthesis	фотосинтезу	None
fractions	фракцій	None
fraction	частка	None
thrace	фракія	None
frank	франка	None
franko	франко	None
francois	франсуа	None
french	франческо	None
frenchmen	французи	None
in french	французькою	None
france	франції	None
freya	фрейя	None
fresco	фрески	None
frg	фрн	None
frederick	фрідріх	None
foucault	фуко	None
functions	функції	None
functioning	функціонування	None
function	функцією	None
football	футбольні	None
footballer	футболіст	None
physics	фізиці	None
physical	фізичні	None
physically	фізично	None
physiology	фізіології	None
philharmonic society	філармонія	None
philosophers	філософів	None
fragments	фрагменти	None
ukrainian soviet encyclopedia (use)	уре	None
taking into consideration	урахуванням	None
temporary	тимчасового	None
type	типу	None
types	типів	None
typical	типові	None
pressure	тиску	None
thousands	тисячі	None
millennium	тисячоліття	None
millenary	тисячоліть	None
titanic	титаніка	None
title	титул	None
slow-walker	тихоходи	None
tichina	тичина	None
interpretation	інтерпретації	None
interpretative	тлумачний	None
background	фоні	None
that is	тобто	None
llc	тов	None
thickness	товщі	None
of that time	тогочасних	None
tokyo	токіо	None
thomas	томас	None
tone	тон	None
tons	тонн	None
trade	торгівлі	None
trading	торгові	None
toronto	торонто	None
point	точці	None
exact	точні	None
accuracy	точність	None
timoshenko	тимошенко	None
precise	точніше	None
weeks	тижнів	None
tigers	тигрів	None
tendency	тенденції	None
theogony	теогонія	None
theodicy	теодіцея	None
theorem	теореми	None
theoretical	теоретичні	None
theoretically	теоретично	None
theories	теорій	None
theory	теорії	None
warm	теплим	None
territorial	територіальні	None
territories	територіях	None
territory	території	None
thermidor	термідор	None
terms	термінів	None
terminology	термінології	None
ternopil	тернопільської	None
terror	терору	None
tesla	тесла	None
testing	тестування	None
man-caused	техногенного	None
technologies	технологій	None
technological	технологічною	None
technology	технології	None
technics	техніку	None
technical college	технікум	None
technical	технічні	None
currents	течії	None
so called	тзв	None
tiger	тигра	None
week	тижня	None
hockey	хокей	None
etc.	ін	None
traditions	традиції	None
those	ті	None
tightly	тісно	None
attention	увагу	None
imprisonment	увязнення	None
ugkc	угкц	None
bargains	угод	None
bargain	угоди	None
hungarian	угорського	None
hungarians	угорці	None
hungary	угорщині	None
stroke	удару	None
ujgorod	ужгород	None
generalization	узагальнення	None
decree	указ	None
arranged	уклав	None
ukraine	україні	None
ukrainian	українській	None
ukrainka	українки	None
study of ukraine	українознавства	None
ukrainians	українців	None
ukrainization	українізації	None
snail	улітку	None
uman	умані	None
conditionally	умовно	None
avoid	уникнути	None
universal	універсальний	None
universities	університетів	None
unique	унікальні	None
wound	ураження	None
t. shevcenko	тшевченка	None
tragedy	трагедії	None
arborvitae	туя	None
tourists	туристів	None
traditional	традиційні	None
tradition	традицією	None
treatise	трактат	None
tram	трамвай	None
transcription	транскрипції	None
transport	транспорту	None
coach	тренер	None
a third	третини	None
third	третім	None
three	трьох	None
lasted	тривало	None
duration	тривалість	None
trident	тризуба	None
triangle	трикутника	None
triangles	трикутників	None
trypillian	трипільської	None
thrice	тричі	None
trk	трк	None
trogonidae	трогонові	None
tropical	тропічні	None
difficulties	труднощі	None
corpses	трупи	None
trinity	трійці	None
tuberculosis	туберкульозу	None
tour	тур	None
turkish	туреччиною	None
turkey	туреччина	None
tourism	туризму	None
tourist	туристичних	None
turks	турків	None
cold	холодної	None
hone	хон	None
chondroma	хондрома	None
barley	ячмінь	None
the gospels	євангеліє	None
eugene	євгена	None
eurasia	євразії	None
jewish	єврейської	None
jews	євреїв	None
euro	євро	None
europe	європі	None
european	європейській	None
europeans	європейців	None
egypt	єгипті	None
egyptians	єгиптян	None
jehovah	єгови	None
unitary	єдину	None
the only	єдине	None
unity	єдність	None
jesuit	єзуїтів	None
eparchy	єпархії	None
bishop	єпископ	None
bishops	єпископів	None
eu	єс	None
so on	і т д	None
ivanovych	іванович	None
ivano-frankivsk	іванофранківській	None
ivasyuk	івасюка	None
igor	ігоря	None
ideals	ідеалів	None
indentification	ідентифікації	None
ideological	ідеологічних	None
bright	яскраво	None
ideology	ідеології	None
yaroslav	ярослава	None
japan	японія	None
of	щодо	None
annually	щорічно	None
densely	щільно	None
y.	ю	None
yugoslavia	югославії	None
yulia	юлії	None
youth	юність	None
unesco	юнеско	None
jupiter	юпітера	None
yura	юра	None
juridical	юридично	None
jurisdiction	юрисдикції	None
yuri	юрія	None
yushchenko	ющенко	None
i	я	None
phenomenons	явищ	None
kernels	ядер	None
kernel	ядра	None
core	ядром	None
egg	яйце	None
eggs	яєць	None
yakovich	якович	None
quality	якістю	None
qualitative	якісно	None
iambus	ямб	None
yan	ян	None
yana	яна	None
yanukovich	януковича	None
japanese	японії	None
gully	яр	None
daily	щодня	None
israel	ізраїлю	None
icons	ікони	None
interface	інтерфейс	None
intonation	інтонація	None
inflation	інфляції	None
informatics	інформатики	None
informational	інформаційні	None
communicatory	інформаційний	None
infrastructure	інфраструктури	None
initiative	ініціативою	None
initiator	ініціатором	None
irina	ірина	None
ireland	ірландії	None
islam	ісламу	None
existed	існувало	None
existence	існування	None
exist	існує	None
existing	існуючі	None
spanish	іспанської	None
spain	іспанії	None
historian	історика	None
historians	істориків	None
historical and cultural	історикокультурний	None
historical	історичній	None
historiograpy	історіографії	None
jesus	ісуса	None
italian	італійські	None
italy	італії	None
hierarchy	ієрархії	None
ride	їздка	None
their	їхніх	None
internet	інтернету	None
icon	ікона	None
interview	інтервю	None
intensively	інтенсивно	None
ilya	ілля	None
iliad	іліади	None
noun	іменника	None
nouns	іменників	None
immigrants	іммігрантів	None
emperor	імператором	None
emperors	імператорів	None
empires	імперій	None
empire	імперією	None
import	імпорту	None
immunity	імунітет	None
investment	інвестування	None
investments	інвестиції	None
index	індекс	None
indonesia	індонезії	None
induction	індукції	None
industrialization	індустріалізації	None
hinduism	індуїзмі	None
indian	індійського	None
india	індії	None
engineer	інженер	None
inquisition	інквізиція	None
foreigners	іноземців	None
institute	інт	None
institutes	інститути	None
integration	інтеграції	None
intellect	інтелекту	None
intellectual	інтелектуальної	None
intellectuals	інтелігенції	None
intensity	інтенсивність	None
temperature	температурі	None
dairy	щоденник	None
happiness	щастя	None
ceremonies	церемонії	None
churches	церков	None
old church	церковнословянської	None
civilizations	цивілізацій	None
civilization	цивілізації	None
gipsy	цигани	None
cycle	циклу	None
these	ці	None
zircon	циркон	None
central committee	цк	None
sugar	цукру	None
interesting	цікаві	None
totally	цілком	None
integrity	цілісності	None
prices	ціни	None
price	ціну	None
valuable	цінні	None
chernobyl	чаес	None
tchaikovsky	чайковського	None
parts	частини	None
part	частку	None
particles	часток	None
frequency	частотою	None
frequence	частоти	None
frequent	часті	None
more frequently	частіше	None
champion	чемпіон	None
championship	чемпіонаті	None
champions	чемпіонів	None
centers	центрів	None
june	червні	None
central	центральній	None
this	цієї	None
croatia	хорватії	None
hortitsya	хортиця	None
wanted	хотіли	None
just	щойно	None
wants	хоче	None
want	хочу	None
temple	храму	None
temples	храмів	None
spine	хребта	None
vertebral	хребетних	None
ridge	хребтів	None
cross	хрестом	None
christians	християни	None
christianity	християнстві	None
christian	християнські	None
christ	христос	None
chromosome	хромосом	None
khrushchev	хрущов	None
who	хто	None
someone	хтось	None
cattle	худобу	None
chemical	хімічні	None
chemistry	хімії	None
chiron	хірон	None
tsar	царів	None
reign	царювання	None
tsars	царі	None
charnels	цвинтарі	None
caesar	цезаря	None
cent	цент	None
shield	щиті	None
red	червоні	None
cherkasy	черкаської	None
churay	чурай	None
salvia	шавлія	None
layer	шар	None
chess	шахи	None
shakhtar	шахтар	None
switzerland	швейцарії	None
sweden	швеції	None
fast	швидкого	None
quickly	швидко	None
speed	швидкістю	None
shevchenko	шевченку	None
masterpiece	шедевр	None
shakespeare	шекспіра	None
sheptytsky	шептицького	None
six	шість	None
width	ширина	None
wide	широкі	None
latitude	широти	None
crossbill	шишкар	None
damage	шкоди	None
harmful	шкідливих	None
stomach	шлунок	None
sluice	шлюз	None
gentry	шляхти	None
helmet	шолом	None
scotland	шотландії	None
artificial	штучного	None
artificially	штучно	None
shukhevych	шухевича	None
plague	чуми	None
belly	черевце	None
sucker	чукучан	None
four	чотирьох	None
chernivtsi	чернівців	None
chernihiv	чернігівської	None
honour	честь	None
fourth	четвертого	None
czechoslovakia	чехословаччині	None
czechia	чехії	None
chile	чилі	None
numbers	числами	None
numerous	численних	None
calculus	числення	None
ammount	число	None
clear	ясно	None
Сepphus	чистик	None
cleanly	чисто	None
read	читати	None
reading	читання	None
reader	читача	None
whose	якого	None
members	членів	None
membership	членство	None
what	що	None
men	чоловіків	None
masucline	чоловіча	None
masculine	чоловічий	None
black	чорні	None
bilberry	чорниця	None
chornovil	чорновіл	None
black earth	чорноземи	None
black sea	чорноморського	None
miracles	чудес	None
temperatures	температур	None
temperament	темпераменту	None
tempo	темпи	None
sarmatians	сарматів	None
satire	сатира	None
st.	св	None
freedoms	свобод	None
freedom	свободу	None
it's	свій	None
peculiar	своєрідні	None
proper	своєї	None
holy	святої	None
sacred	священної	None
celebration	святкування	None
saint	святого	None
svyatoslav	святослава	None
priests	священиків	None
witnesses	свідчить	None
consciously	свідомо	None
witness	свідчать	None
svitlana	світлана	None
conception of the world	світогляд	None
conception	світогляду	None
secular	світські	None
sevastopol	севастополя	None
season	сезоні	None
seym	сейм	None
saeima	сейму	None
secretary	секретаря	None
secretariat	секретаріату	None
sexual	статеві	None
sector	сектор	None
sarcophagus	саркофаг	None
villages	сіл	None
itselves	самі	None
consciousness	свідомість	None
equality	рівність	None
equal	рівня	None
equation	рівняння	None
levels	рівнів	None
seldom	рідко	None
rare	рідше	None
christmas	різдва	None
different	інакше	None
variety	різноманітність	None
multiform	різноманітні	None
various	різноманітний	None
diversity	різноманіття	None
rivers	річок	None
ricotta	рікотта	None
rilke	рільке	None
richard	річард	None
river	річці	None
annual	річного	None
sabini	сабіни	None
quiver	сагайдачного	None
garden	саду	None
site	сайті	None
sites	сайтів	None
himself	себе	None
itself	собі	None
samara	самара	None
exactly	точно	None
the very	самих	None
self-government	самоврядування	None
stag	самців	None
equilibrium	рівноваги	None
selenium	селен	None
peasantry	селянства	None
simonenko	симоненко	None
symphony	симфонія	None
son	сином	None
sons	синів	None
syntagma	синтагма	None
syntax	синтаксис	None
synthesis	синтезу	None
dark blue	синій	None
raw materials	сировини	None
systems	системи	None
situation	ситуації	None
scandium	скандій	None
anulled	скасовано	None
cancellation	скасування	None
skeleton	скелет	None
formed	формується	None
consisted	складалися	None
was formed	складалося	None
putting together	складання	None
form	формі	None
forms	формує	None
consists	складається	None
put together	складений	None
well-knit	складна	None
well-knilt	складним	None
well-built	складну	None
complexity	складність	None
component	складовою	None
syllable	складом	None
symon	симон	None
peasants	селяни	None
symbolize	символізує	None
symbols	символів	None
rural	сільському	None
seven	сім	None
seminary	семінарії	None
senate	сенату	None
saintpaulia	сенполія	None
sense	чуття	None
middle	середині	None
serbia	сербії	None
server	сервер	None
sergiy	сергія	None
mediterranean	середземноморя	None
medieval	середньовічної	None
middle ages	середньовіччі	None
average	середній	None
average annual	середньорічна	None
medium	середніх	None
seriously	серйозно	None
serious	серйозні	None
heart	серця	None
series	серії	None
sister	сестра	None
session	сесії	None
siberia	сибіру	None
white fish	сиг	None
forces	сили	None
force	силу	None
strong	сильні	None
strongly	сильно	None
symbol	символу	None
symbolism	символіка	None
somplement	складі	None
plain	рівнини	None
repin	рєпін	None
reform	реформу	None
reformation	реформування	None
speeches	речей	None
sentence	реченні	None
substances	речовини	None
substance	речовина	None
remainder	решта	None
the rest	решту	None
fish	риби	None
ribosome	рибосоми	None
rives	рив	None
rylsky	рильський	None
rome	римі	None
romans	римляни	None
roman	римській	None
markets	ринків	None
market	ринок	None
rice	рисою	None
lynx	рись	None
rhetoric	риторики	None
robert	роберт	None
makes	робить	None
workers	робітників	None
horn	ріг	None
genuses	роди	None
families	сімей	None
family	сімї	None
relatives	рідних	None
ancestral	родового	None
reforms	реформи	None
deposit	родовище	None
rethymnon	ретимно	None
republics	республіках	None
town	ратуші	None
round	туру	None
reactor	реактора	None
reactions	реакції	None
reaction	реакція	None
real	справжніх	None
realism	реалізму	None
revolutionary	революційні	None
rugby	регбі	None
regulation	регулювання	None
regulate	регулюють	None
regulates	регулює	None
regularly	регулярно	None
editor	редактор	None
regime	устрою	None
modes	режимів	None
resedaceae	резедові	None
resonance	резонанс	None
advertising	рекламу	None
recommendations	рекомендації	None
recommended	рекомендується	None
relief	рельєфу	None
religions	релігій	None
religious	релігійні	None
crafts	ремесла	None
renovation	реновація	None
x-ray	рентген	None
rheology	реологія	None
republic	республіці	None
resources	ресурсів	None
rivne	рівненська	None
genealogy	родовід	None
developed	розроблені	None
rock-and-roll	рокнролу	None
rococo	рококо	None
roxolana	роксолани	None
rockefeller	рокфеллер	None
role	ролі	None
novels	романів	None
romanticism	романтизму	None
russian	руські	None
dew	роса	None
vegetal	рослинний	None
vegetation	рослинність	None
grow	ростуть	None
russian-ukrainian	російськоукраїнський	None
russia	росії	None
russians	росіяни	None
rotor	ротор	None
rotunda	ротунда	None
ore	руди	None
romania	румунії	None
russification	русифікації	None
rus	русь	None
ruthenium	рутеній	None
movements	рухів	None
ruins	руїни	None
rf	рф	None
rshuhevych	ршухевич	None
r. shuhevicya	ршухевича	None
rows	ряди	None
row	ряді	None
rock music	рокмузика	None
origined	родом	None
rock	скелі	None
disperse	розходяться	None
develop	розвиватися	None
developing	розвивається	None
develops	розвиває	None
prospecting	розвідки	None
examines	розглядає	None
deployment	розгортання	None
divisions	розділів	None
bloom	розквіту	None
split	розкол	None
excavations	розкопок	None
divorce	розлучення	None
differentiation	розмежування	None
duplication	розмноження	None
colloquial	розмовної	None
placing	розміщення	None
located	розташовані	None
roseau	розо	None
tells	розповідає	None
distribution	розподілу	None
rupture	розрив	None
elaborated	розроблений	None
distinguish	розрізняють	None
resettlement	розселення	None
investigation	розслідування	None
placed	ставилися	None
disposition	розташуванням	None
mind	увазі	None
understood	розуміється	None
understanding	розуміючи	None
solutions	рішень	None
mother	має	None
valut	склепіння	None
griddle	сковорода	None
stus	стуса	None
table	таблиці	None
so much	стільки	None
walls	стінки	None
subculture	субкультури	None
subjects	теми	None
sovereignty	суверенітету	None
judges	суддів	None
judge	судити	None
shipbuilding	суднобудування	None
judicial	судові	None
courts	судів	None
totality	сукупність	None
suleiman	сулеймана	None
sultan	султана	None
sum	сума	None
sumatra	суматра	None
sumy	сумський	None
doubt	сумніву	None
adjacent	суміжних	None
mixture	суміші	None
contradict	суперечить	None
argument	суперечки	None
contradictions	суперечності	None
arguments	суперечок	None
accompanied	супроводжується	None
satellits	супутників	None
surjik	суржик	None
social and political	суспільнополітичні	None
degree	ступінь	None
society	товариства	None
studio	студії	None
gunners	стрільців	None
stentor	стентор	None
steppe	степу	None
stepan	степан	None
steppes	степів	None
stefan	стефан	None
stefanik	стефаника	None
meeting-point	стику	None
style	стилі	None
styles	стилів	None
stylistics	стилістика	None
hundred	христа	None
century	сторіччя	None
page	сторінка	None
pages	сторінок	None
conformably	стосовно	None
stood	стояли	None
stand	стоять	None
stands	стоїть	None
suffering	страждання	None
strategical	стратегічних	None
strategy	стратегії	None
fear	страх	None
insurance	страхування	None
streptococcus	стрептокок	None
uncle	стрию	None
strictly	суворо	None
term	терміну	None
structural	структурні	None
current	струму	None
students	учнів	None
creates	створює	None
neighboring	сусідніх	None
appreciably	суттєво	None
thallium	талій	None
there	туди	None
templars	тамплієрів	None
dance	танцю	None
dances	танці	None
taras	тарас	None
taras (first name)	тараса	None
tatars	татари	None
animal	тваринного	None
affirmation	твердження	None
hardness	твердість	None
creator	творця	None
writings	твори	None
creative	творчі	None
and so far	тд	None
that	тієї	None
theater	театрі	None
theatrical	театральні	None
theaters	театрів	None
taylor	тейлор	None
text	тексті	None
texts	текстів	None
textile	тканин	None
telephone	тел	None
telamon	теламон	None
television	телебаченні	None
tv and radio company	телерадіокомпанія	None
themes	тем	None
topic	тему	None
talent	талант	None
essence	суті	None
taxi	таксі	None
taiwan	тайвань	None
contemporaries	сучасників	None
modernity	сучасність	None
sphere	сфері	None
formulated	сформулював	None
schemes	схеми	None
scheme	схема	None
slopes	схили	None
east	східний	None
similarity	схожість	None
eastern	східній	None
east slavic	східнословянські	None
scenes	сцени	None
scene	сцена	None
usa	сша 	Nan
today	сьогоднішній	None
ci	сі	None
agricultural	сільськогосподарські	None
simferopol	сімферополь	None
singapore	сінгапуру	None
sulphur	сірки	None
sulphor	сірко	None
siringa	сірінга	None
sych	січ	None
january	січня	None
sich	січі	None
t.	т	None
t. g. shevcenko	т г шевченка	None
camps	табори	None
camp	табір	None
such	такій	None
convocation	скликання	None
create	створюють	None
affirms	стверджує	None
sombrero	сомбреро	None
sommelier	сомельє	None
dream	сон	None
sun	сонця	None
sunny	сонячна	None
solar	сонячної	None
sorbo	сорбе	None
sorts	сорти	None
hundreds	сотні	None
sofia	софії	None
sofiivka	софіївка	None
social democratic	соціалдемократична	None
social	суспільний	None
social economic	соціальноекономічного	None
socialism	соціалізму	None
socialist	соціалістичні	None
sociology	соціології	None
composed	сочинений	None
union	унії	None
allies	союзників	None
allied	союзних	None
salvation	спасіння	None
spectrum	спектр	None
specially	спеціально	None
specialization	спеціалізації	None
specialized	спеціалізовані	None
specialists	фахівців	None
leaning	спираючись	None
relies	спирається	None
salt	сіль	None
lists	списки	None
salts	солей	None
conscience	совісті	None
skovordy	сковороди	None
skoropadsky	скоропадського	None
rather	швидше	None
cattle breeding	тваринництво	None
sculptor	скульптора	None
sculptures	скульптури	None
sculpture	скульптурі	None
how much	скільки	None
scythians	скіфів	None
scythian	скіфських	None
poorly	слабо	None
glory	славу	None
suburban	слобідської	None
dictionary	словників	None
slovakian	словацької	None
slovakia	словаччини	None
dictionary directory	словникдовідник	None
slavic	словянські	None
slavics	словяни	None
serve	служить	None
served	служили	None
footsteps	сліди	None
taste	смаку	None
mortality	смертність	None
currant	смородина	None
strip	смуги	None
smith	сміт	None
cis	снд	None
aids	снід	None
socrates	сократа	None
created	створюється	None
profess	сповідують	None
consumption	споживання	None
becomes	стає	None
rates	ставки	None
becoming	становлення	None
stadium	стадіону	None
steel	сталі	None
stalin	сталіна	None
standard	стандарту	None
standards	стандартів	None
opinions	становища	None
formation	формуванні	None
condition	умовою	None
stanislav	станіслава	None
old	старі	None
old man	старицький	None
senior	старшого	None
master sergeant	старшина	None
oldest	старших	None
articles	статті	None
become	стають	None
statistics	статистики	None
statistical	статистичні	None
article	стаття	None
status	статусу	None
regulations	статут	None
statute	статуту	None
statue	статуя	None
statues	статуї	None
affirmed	стверджував	None
affirm	стверджують	None
stability	стабільність	None
remembrance	спогади	None
mammals	ссавців	None
silver	срібні	None
consumer	споживача	None
consumers	споживачів	None
calmness	спокою	None
quiet	тихого	None
compounds	сполуки	None
contests	спори	None
sport	спорт	None
sports	спорту	None
ways	шляхів	None
way	шляху	None
observation	спостережень	None
observe	спостерігати	None
businesses	справах	None
in fact	справді	None
justice	юстиції	None
produced	справила	None
perceives	сприймається	None
perception	сприйняття	None
assisted	сприяло	None
favourable	сприятливі	None
assists	сприяє	None
directed	спрямовані	None
singings	спів	None
singer	співачка	None
correlation	співвідношення	None
cooperation	співробітництво	None
joint	спільний	None
spiral	спіралі	None
ussr	усрр	None
s.s.	сс	None
mathematical	математичні	None
mathematics	математики	None
mathematician	математик	None
wars	війнах	None
flows	тече	None
forward	вперед	None
first	уперше	None
influence	впливом	None
influences	впливів	None
influential	впливових	None
influenced	вплинули	None
affected	позначався	None
application	застосуванням	None
during	ході	None
sensation	враження	None
in the end	врешті	None
province	провінція	None
finally	остаточно	None
vsevolod	всеволод	None
inside	усередині	None
universe	всесвіту	None
global	всесвітньо	None
world	світі	None
though	хоч	None
all-ukrainian	всеукраїнського	None
established	встановлено	None
sets	призначає	None
establishment	заснування	None
set up	встановлені	None
constitutes	встановлюється	None
enters	входить	None
save	зберігають	None
soldiers	солдати	None
resurrection	воскресіння	None
in autumn	восени	None
hydrogen	водню	None
simultaneously	одночасно	None
water supply	водопостачання	None
water plants	водорості	None
reservoir	водосховища	None
leader	лідером	None
reunification	воззєднання	None
station	станції	None
volyn	волині	None
wallace	воллес	None
humidity	вологість	None
volodar	володар	None
volodimyr	володимир	None
volodimir	володимиром	None
volodimirovich	володимирович	None
owned	володів	None
dominion	володінь	None
possess	володіють	None
owns	володіє	None
hair	волосся	None
voltaire	вольтера	None
will	заповіт	None
she	вона	None
they	вони	None
it	це 	Nan
enemy	ворогом	None
enemies	ворогами	None
goal	метою	None
gate	воріт	None
introductory	вступна	None
entry	входження	None
contrary to	попри	None
total	усього	None
departments	кафедри	None
viennese	віденського	None
vienna	відні	None
video	відео	None
note	відзначити	None
distinguished	відзначаються	None
marked	позначені	None
deposits	родовища	None
opened	відкрито	None
open	відкриті	None
opens	відкривається	None
discoveries	відкриттів	None
refusal	відмову	None
refused	відмовилися	None
refuse	відмовитися	None
differences	різниці	None
difference	різниця	None
carry	носить	None
restored	відновлено	None
renew	відновити	None
renewal	оновлення	None
relations	відносинах	None
applies	стосується	None
relative	відносна	None
relatively	відносно	None
relativity	відносності	None
treated	відносяться	None
relation	відношення	None
attitude	ставлення	None
department	кафедра	None
water	воді	None
give	передають	None
visit	відвідують	None
everywhere	всюди	None
whole	цілі	None
invasion	навали	None
losses	втрати	None
waste	відходів	None
lost	загиблих	None
loses	втрачає	None
intervention	втручання	None
embodiment	втілення	None
however	однак	None
hydrocarbons	вуглеводнів	None
carbon	вуглецю	None
coal	вугілля	None
knots	вузлів	None
knot	вузол	None
street	вулиця	None
streets	вулиці	None
scientist	учений	None
scientists	учених	None
doctrine	доктрина	None
honouring	вшанування	None
prisons	вязниці	None
vyaceslav	вячеслав	None
altar	вівтар	None
from	із	None
took place	проводилися	None
happened	сталося	None
occures	відбувається	None
visited	відвідав	None
gave	подав	None
fire	пожежі	None
vovchok	вовчок	None
internal	внутрішніх	None
occurrence	виникнення	None
risings	виникненням	None
vinnicenka	винниченка	None
vinnichenko	винниченко	None
footnotes	виноски	None
exception	винятком	None
fall	потрапляють	None
cases	випадків	None
accidentally	випадково	None
case	справі	None
payments	плати	None
sails out	випливає	None
test	тест	None
radiation	радіації	None
release	звільнення	None
express	виражають	None
expresses	виражає	None
expressed	висловив	None
expression	вислів	None
clearly	явно	None
expressions	вислови	None
wares	вироби	None
manufacturing	вироблення	None
manufacture	виробляють	None
manufactures	виробляє	None
producer	виробник	None
manufacturers	виробників	None
products	продукції	None
rearing	вирощування	None
originated	виникло	None
cultivate	вирощують	None
arises	виникає	None
arised	виникали	None
married	одружився	None
appeared	появи	None
described	описується	None
teaching	навчання	None
teachers	вчителів	None
called	називається	None
caused	принесли	None
cause	викликають	None
provokes	викликає	None
exclusively	суто	None
performed	виступили	None
executors	виконавців	None
executive	виконавчу	None
execution	виконання	None
performance	виступ	None
execute	виконати	None
executed	виконується	None
do	роблять	None
executes	виконує	None
using	використовуючи	None
uses	використовує	None
demanded	вимагали	None
require	потребують	None
demands	вимоги	None
pronounced	вимовляється	None
demand	попиту	None
measuring	вимірювання	None
wine	вино	None
invention	винахід	None
originate	виникають	None
reflect	відображають	None
solution	розчин	None
decided	вирішили	None
indicates	зазначити	None
instructions	вказівки	None
included	входять	None
include	відносять	None
including	включно	None
includes	включає	None
inclusion	включення	None
extremely	надзвичайно	None
covered	криті	None
power	сила	None
authorities	органи	None
vladislav	владислав	None
own	своє	None
actually	фактично	None
owner	власника	None
owners	власників	None
property	майно	None
inherent	притаманні	None
properties	властивості	None
in summer	влітку	None
died	померли	None
skill	майстерність	None
contents	вміст	None
content	змісту	None
as a result	унаслідок	None
bringing in	внесення	None
contribution	сприяння	None
university	університеті	None
in the night	вночі	None
indicate	вказують	None
held	вирішено	None
manifests	проявляється	None
discovery	відкриття	None
decide	вирішити	None
decides	вирішує	None
dictum	висловлювання	None
conclusions	висновків	None
conclusion	укладення	None
high	високі	None
height	висоті	None
heights	височини	None
performances	виступів	None
exposition	виставки	None
spoke	говорив	None
speak	розмовляють	None
advance	виступають	None
pulled out	висунув	None
sources	джерелах	None
costs	страти	None
education	утворенням	None
went out	виходили	None
coming out	виходячи	None
appear	зявляються	None
entrance	вхід	None
embroidery	вишивки	None
vishnevetsky	вишневецького	None
cherry	вишня	None
higher	вищі	None
discovered	виявлені	None
manifested	виявлено	None
showed	показано	None
discover	виявити	None
shows	показує	None
represents	являє	None
image	образу	None
separation	розділення	None
pot	горщик	None
master	старшини	None
economy	економіку	None
management	управлінні	None
guests	гості	None
sharply	різко	None
hotel	готель	None
hotels	готелі	None
goths	готи	None
gothic	готики	None
finished	закінчив	None
ready	готові	None
hoffman	гофман	None
game	гру	None
players	гравців	None
engraving	гравюри	None
grammar	граматики	None
grammatical	граматичні	None
granite	граніт	None
graphic	графік	None
graphics	графіки	None
graffiti	графіті	None
greeks	греків	None
greek-catholic	грекокатолицька	None
greco-catholic	грекокатолицької	None
greek	грецькій	None
greece	греції	None
games	ігри	None
mushrooms	грибів	None
horace	горацій	None
uah	грн	None
mountains	гір	None
gonchar	гончара	None
deep	глибокі	None
deeper	глибше	None
loam	глини	None
glossary	глосарій	None
gluon	глюон	None
spectators	глядачів	None
oppression	гноблення	None
him	собою	None
talks	переговори	None
said	сказано	None
say	сказати	None
talking	говориться	None
saying	кажучи	None
garrot	гоголь	None
gogol	гоголя	None
hours	часи	None
heads	очолює	None
chiefly	головне	None
main	основної	None
principal	головного	None
famine	голодомору	None
hunger	голоду	None
holocaust	голокосту	None
voice	голосу	None
vowel	голосних	None
voting	голосуванням	None
voices	голосів	None
holothurian	голотурії	None
homer	гомера	None
mountain	гірські	None
depth	глибині	None
hryvnia	гривні	None
grigory	григорія	None
e	д	None
da	да	None
david	девід	None
long	тривалої	None
ancient greek	давньогрецької	None
old russian	давньоруської	None
far	далеко	None
faraway	далекого	None
remote	далекому	None
further	подальші	None
given	наведено	None
present	теперішній	None
danila	данила	None
danilo	данило	None
tribute	данину	None
dante	данте	None
denmark	данії	None
tao	дао	None
taoism	даосизм	None
dated	датується	None
dacite	дацит	None
gives	дає	None
two	дві	None
nobility	знаті	None
yard	дворі	None
court	суді	None
where	куди	None
nine	девять	None
motto	девіз	None
hitler	гітлера	None
grigorovich	григорович	None
mining	гірнича	None
hyperion	гіперіон	None
tomb	гробниці	None
community	спільноти	None
public	суспільні	None
comunity	громадськості	None
citizens	громадяни	None
citizen	громадянина	None
citizenship	громадянство	None
civil	цивільного	None
money	пари	None
monetary	грошової	None
december	грудні	None
georgians	грузини	None
georgia	грузії	None
group	угруповання	None
grushevskii	грушевського	None
thunder	грім	None
grinchenko	грінченка	None
lips	губ	None
provinces	провінції	None
humanism	гуманізму	None
humanitarian	гуманітарних	None
circle	крутами	None
density	щільність	None
dignity	сан	None
hymn	гімн	None
high school	гімназії	None
anthem	гімну	None
hindenburh	гінденбурґ	None
ginzburg	гінзбург	None
hypothesis	гіпотези	None
go out	виходити	None
head	начальник	None
hetmanschina	гетьманщини	None
alienation	відчуження	None
feeling	почуття	None
sensations	відчуттів	None
played	грали	None
won	переміг	None
play	грають	None
plays	пєси	None
moved away	відійшли	None
byzantine	візантійські	None
byzantium	візантії	None
war	війні	None
armies	військами	None
age	доби	None
windows	вікна	None
victor	віктора	None
victoria	вікторія	None
wiki	вікі	None
centuries	сторіч	None
wikipedia	вікіпедії	None
wikipedias	вікіпедіях	None
ox	віл	None
free	вільні	None
william	вільям	None
wimbledon	вімблдон	None
he	он	None
vinnytsia	вінниці	None
vinci	вінчі	None
faith	віру	None
armenian	вірмени	None
felt	відчувається	None
armenia	вірменії	None
moves away	відходить	None
creation	творчістю	None
known	відомі	None
famous	славиться	None
information	інформації	None
data	датою	None
answered	відповідала	None
responsible	відповідальний	None
responsibility	відповідальність	None
reply	відповідь	None
suit	відповідають	None
meets	зустрічається	None
appropriate	відповідні	None
suitable	відповідних	None
accordingly	відповідно	None
accordance	відповідності	None
correspondance	відповідність	None
answering	відповіді	None
relaxation	відпочинку	None
recreation	відпочинок	None
at once	одразу	None
renaissance	ренесансу	None
differs	відрізняється	None
differ	відрізняє	None
interests	інтересів	None
interest	інтересу	None
retirement	відставку	None
distance	відстані	None
absence	відсутністю	None
absent	відсутні	None
then	тоді	None
thence	відтоді	None
mouth	гирлі	None
fidelity	вірність	None
belief	переконання	None
harmony	гармонії	None
garrison	гарнізон	None
garry	гаррі	None
harrison	гаррісон	None
hegel	гегеля	None
gates	порти	None
hector	гектор	None
gena	гена	None
genesis	генезис	None
general	полководець	None
genetic	генетичної	None
genes	генів	None
henry	генріх	None
geographical	географічні	None
geography	географії	None
geology	геологія	None
geometry	геометрії	None
geomorphology	геоморфологія	None
george	джордж	None
hercules	геракла	None
heraclitus	геракліт	None
arms	руки	None
coat of arms	гербі	None
german	німеччиною	None
herodotus	геродот	None
hero	героя	None
heroes	героїв	None
ghetto	гетто	None
hetman	гетьману	None
hamilton	гамільтон	None
religion	релігії	None
galvanoplasty	гальванопластика	None
industry	індустрії	None
beliefs	вірувань	None
virus	вірус	None
viruses	вірусів	None
believers	віруючих	None
verse	вірш	None
poem	пєса	None
lyrics	лірики	None
poems	пєс	None
viscometer	віскозиметр	None
herald	вісник	None
eight	вісім	None
vitaliy	віталій	None
wind	вітру	None
winds	вітрів	None
domestic	вітчизняної	None
eternal	вічного	None
hectares	га	None
gas	газу	None
newspapers	газети	None
newspaper	газеті	None
gases	газів	None
gay	гай	None
haydamaks	гайдамаки	None
gallery	галереї	None
galician	галичини	None
galician-volyn	галицьковолинського	None
galich	галич	None
galicia	галичині	None
branches	гілки	None
branch	філія	None
admits	визнає	None
clarify	визначити	None
determining	визначенні	None
entente	антанти	None
antarctica	антарктиди	None
anticyclone	антициклон	None
ancient	стародавніх	None
antiquity	старина	None
anton	антон	None
antonich	антонич	None
anthony	антонія	None
anubis	анубіс	None
not	не	None
than	чим	None
anime	аніме	None
aorta	аорта	None
apparatus	апарату	None
apatite	апатит	None
apostle	апостола	None
arab	арабської	None
argentina	аргентині	None
arrest	арешту	None
aristocracy	пізнати	None
aristotle	арістотель	None
army	військом	None
arno	арно	None
arteriole	артеріола	None
artist	художника	None
archeologists	археологи	None
archaeological	археологічні	None
archaeology	археології	None
archives	архівів	None
ensembles	ансамблі	None
archimedes	архімед	None
ensemble	ансамбль	None
anna	ганна	None
but	проте	None
alexander	олександра	None
alcohol	алкоголю	None
albert	альберта	None
album	альбому	None
albums	альбоми	None
aldehydes	альдегіди	None
alps	альп	None
altair	альтаїр	None
america	америці	None
american	американські	None
amos	амос	None
amur	амур	None
ammonia	аміаку	None
amino acids	амінокислот	None
similar	схожі	None
analysis	аналізу	None
anapaest	анапест	None
anatoliy	анатолій	None
anatomy	анатомії	None
english	англійській	None
anglo-saxon	англосакси	None
england	англії	None
anderson	андерсон	None
andorra	андорри	None
andromeda	андромеда	None
andriy	андрія	None
andreevich	андрійович	None
ankara	анкара	None
anoa	аноа	None
algorithms	алгоритмів	None
archipelago	архіпелаг	None
architects	архітектори	None
base	засад	None
bases	основи	None
basic	основні	None
based	ґрунтується	None
baikove	байковому	None
bacteria	бактерії	None
ballad	балади	None
ballet	балету	None
baltic	балтійського	None
bandera	бандера	None
band	бандери	None
bank	банківської	None
banks	банків	None
banknotes	банкноти	None
baptism	хрещення	None
bark	кори	None
baroque	бароко	None
barometer	барометр	None
basin	басейні	None
pools	басейни	None
pool	басейну	None
basnya	басня	None
bastion	бастіон	None
bataan	батаан	None
batourin	батурин	None
baturins	батурині	None
father	батьком	None
fathers	батьків	None
home	дому	None
wishes	бажанням	None
architect	архітектора	None
wish	бажання	None
many	численні	None
architecture	архітектурі	None
architectural	архітектурні	None
arsh	арш	None
aristophanes	арістофан	None
assembly	збірку	None
association	обєднань	None
aspect	аспект	None
aspects	аспектів	None
asthenia	астенія	None
astronaut	астронавт	None
astronomy	астрономії	None
attacks	нападів	None
atlantic	атлантичного	None
atmosphere	атмосфері	None
atoll	атол	None
atom	атома	None
atoms	атомів	None
nuclear	ядерної	None
auditoriums	аудиторії	None
audiolibrary	аудіобібліотеці	None
afghanistan	афганістану	None
africa	африці	None
aftershocks	афтершоки	None
affix	афікс	None
athens	афіни	None
achaeans	ахейці	None
achilles	ахіллес	None
ajax	аякс	None
rich	річ	None
wealth	багатством	None
inheritance	спадщину	None
algorithm	алгоритму	None
joint-stock	акціонерні	None
shipuuden	shippuuden	None
village	смт	None
state	штату	None
and	і	None
v	v	None
you	тобі	None
vii	vii	None
viii	viii	None
x	х 	Nan
xi	хі	None
xii	хіі	None
xiii	хііі	None
xiv	xiv	None
xix	хіх	None
xix-xx	xixxx	None
xml	xml	None
xv	xv	None
xvi	xvi	None
xvii	xvii	None
xviii	xviii	None
xviii-xix	xviiixix	None
xvii-xviii	xviixviii	None
xvi-xvii	xvixvii	None
xvi-xviii	xvixviii	None
xx	хх	None
xxi	ххі	None
u	y	None
the word to translate is blank	  	Nan
km	км	None
rss	rss	None
meters	 м	Nan
radio	радіо	None
year	рік	None
a	a	None
c.	c	None
company	товариство	None
d	г	None
economic	економічній	None
edition	редакції	None
entertainment	entertainment	None
f	f	None
google	google	None
h.	h	None
ii	іі	None
iii	ііі	None
iran	ірані	None
isbn	isbn	None
iv	iv	None
ix	ix	None
others	інші 	Nan
j.	j	None
k	к	None
l	л	None
left	пішов	None
m.	m	None
marketing	маркетингу	None
we	ми	None
n.	n	None
on	по	None
o	o	None
over	понад	None
p	 р 	Nan
pixels	пкс|	None
action	дією	None
mln	 млн	Nan
years	річчя	None
after all	таки	None
adynamia	адинамія	None
administrative	адміністративні	None
administrative-territorial	адміністративнотериторіального	None
administration	адміністрації	None
address	адресу	None
aerogram	аерограма	None
airport	аеропорт	None
nuclear power station	аес	None
till	аж	None
azerbaijan	азербайджану	None
azerbaijans	азербайджанці	None
azides	азиди	None
azov	азовського	None
nitrogen	азоту	None
asia	азії	None
iceberg	айсберг	None
academician	академік	None
academical	академічний	None
academy	академії	None
accreditation	акредитації	None
act	діяти	None
acts	діє	None
active	активні	None
activity	діяльністю	None
actor	актор	None
actors	акторів	None
accent	акцент	None
shares	частки	None
adam	адам	None
billion	 млрд	Nan
aggression	агресії	None
agrarian	аграрний	None
thousand	тисячу	None
celsius	°с	None
to	щоби	None
alphabet	алфавітом	None
only	єдиний	None
or	чи	None
absolutism	абсолютизму	None
absolute	абсолютну	None
habakkuk	авакум	None
accidents	аварії	None
august	серпні	None
avon	авон	None
australia	австралії	None
austria-hungary	австроугорщини	None
austrian	австрійської	None
austria	австрії	None
buses	автобуси	None
highway	автомагістраль	None
automatically	автоматично	None
automotive	автомобільний	None
cars	машини	None
autonomous	автономні	None
autonomy	автономії	None
author	авторського	None
authors	авторів	None
authority	повноважень	None
author's	авторські	None
agency	агентство	None
agglomeration	агломерації	None
aggregate	сукупності	None
deoxyribose	дезоксирибоза	None
bach	баха	None
saw	побачив	None
gdp	ввп	None
above	вище	None
succeed	вдалося	None
succeeds	вдається	None
twice	двічі	None
improvement	поліпшення	None
website	вебсайт	None
vega	вега	None
vedas	вед	None
leads	призводить	None
performing	ведення	None
conducted	проводили	None
lead	проводу	None
tower	вежі	None
weather	погода	None
bill	вексель	None
bills	векселя	None
led	чолі	None
great	великій	None
easter	великдень	None
big	великий	None
great britain	великобританії	None
huge	величезні	None
size	розмірі	None
dimensions	розмірів	None
very	самий	None
september	вересні	None
vernadsky	вернадський	None
verona	верона	None
introduce	ввести	None
groups	угруповань	None
introduced	запровадив	None
introduction	запровадження	None
heavy	важкі	None
hard	тверді	None
important	важливі	None
valence	валанс	None
valencia	валенсія	None
valentin	валентин	None
valeriy	валерій	None
gross	валовий	None
currencies	валюти	None
freights	вантажів	None
worthless	варто	None
cost	вартістю	None
warsaw	варшаві	None
version	редакція	None
variants	варіантів	None
vasily	василь	None
vasilovich	васильович	None
vasilya	василя	None
open joint stock company	ват	None
vatican	ватикану	None
murder	вбивство	None
believed	вірили	None
recognized	визнається	None
considered	розглядається	None
were	становили	None
consider	розглядати	None
think	вважають	None
are considered	розглядаються	None
believes	верств	None
entered	увійшов	None
pregnancy	вагітності	None
versions	версій	None
top	найпопулярніших	None
publishing house	видавництво	None
publishing	видавничий	None
species	порід	None
publications	публікації	None
issue	випуск	None
outstanding	визначні	None
deal	видаються	None
issues	питань	None
is issued	видається	None
visible	видно	None
extraction	виділення	None
view	погляд	None
devided	виділити	None
extracted	виділяють	None
stood out	виділяються	None
separates	виділяє	None
stands out	виділяється	None
survival	виживання	None
liberation	визвольної	None
emancipated	визвольного	None
found	знаходили	None
recognition	визнання	None
recognize	визнати	None
determine	визначають	None
fixed	фіксується	None
determines	визначає	None
determined	визначив	None
defined	визначено	None
determination	визначень	None
issued	виходить	None
upper	верхній	None
production	виробничі	None
kind	роду	None
supreme	найвищим	None
tops	вершин	None
spring	весни	None
all	усієї	None
wedding	весілля	None
veto	вето	None
already	уже	None
used	користуються	None
use	користується	None
usage	вжитку	None
generally	загалом	None
relationships	стосунків	None
relationship	стосунки	None
interact	взаємодіють	None
interaction	взаємодії	None
along	уздовж	None
in winter	зимою	None
footwear	взуття	None
taken	взято	None
elections	виборів	None
election	обрання	None
choice	вибір	None
elected	проголосив	None
withdrawal	вилучення	None
studied	навчалися	None
study	навчального	None
learns	вивчає	None
appearance	появу	None
looks	поглядів	None
vyhovsky	виговського	None
vision	бачення	None
weight	вагу	None
in	у	None
bogdan	богдана	None
gods	божеств	None
goddes	богиня	None
the virgin	богородиці	None
liturgy	богослужіння	None
deity	божества	None
god's	божої	None
fighting	бойової	None
military	військовій	None
side	стороні	None
sides	сторін	None
bulgars	болгари	None
bulgaria	болгарії	None
boris	бориса	None
born	народилися	None
fighted	воювали	None
struggle	боротьбу	None
fight	бій	None
boyars	бояр	None
was	становило	None
brazil	бразилії	None
marriage	шлюбу	None
took	зайняла	None
brassy	брассі	None
brother	брата	None
brotherhood	братство	None
brothers	братів	None
browser	браузер	None
briquette	брикет	None
god	богу	None
british	британської	None
for	щоб	None
block	кварталі	None
see	побачити	None
without	без	None
safety	безпеки	None
undoubtedly	безумовно	None
directly	напряму	None
direct	прямі	None
immediate	безпосереднім	None
unemployment	безробіття	None
belgium	бельгії	None
beneficiary	бенефіція	None
berdichev	бердичів	None
takes	бере	None
shore	березі	None
shores	берегів	None
march	похідні	None
birch	березкові	None
berlin	берліні	None
take	приймають	None
if	якщо	None
ivory	бивні	None
battle	бою	None
battles	боїв	None
more	ще	None
goods	товарів	None
good	добрі	None
close	тісні	None
closer	ближче	None
near	поряд	None
closeness	близькість	None
blitz	бліц	None
baal	ваал	None
britain	британії	None
bronze	бронзи	None
library	бібліотеці	None
bible	біблії	None
poor	бідних	None
poverty	бідності	None
business	справи	None
white	білі	None
biletskiy	білецький	None
squirrel	білка	None
proteins	білків	None
bilokur	білокур	None
belorussia	білорусії	None
belorussian	білорусі	None
pain	біль	None
largest	найбільший	None
greater	більшої	None
more or less	більшменш	None
bolshevik	більшовики	None
bolsheviks	більшовиків	None
most	самої	None
large	великі	None
major	більшій	None
majority	більшістю	None
biogeography	біогеографія	None
biography	біографії	None
biological	біологічні	None
biology	біології	None
biotechnology	біотехнологія	None
biotite	біотит	None
exchange	обміну	None
libraries	бібліотеки	None
battleship	броненосці	None
biblical	біблійне	None
budget	бюджету	None
happen	трапляються	None
is	є	None
bug	бугу	None
buddhism	буддизму	None
will be	будуть	None
houses	хати	None
at home	будинку	None
house	хаус	None
structure	структурі	None
buildings	споруди	None
built	споруджено	None
overturned	будувалися	None
construct	побудувати	None
being	істоти	None
built on	будується	None
be	вважатися	None
any	ніяк	None
thistle	будяк	None
constructioning	будівельний	None
construction	побудову	None
building	спорудження	None
word for word	буквально	None
bukovina	буковині	None
bulbar	бульб	None
bulba	бульби	None
wild grass	бур'ян	None
bourgeoisie	буржуазії	None
warbler	бурмотушки	None
storms	бурі	None
bureau	бюро	None
soil	ґрунті	None
misinformation	дезінформування	None
sometimes	іноді	None
leaders	лідерів	None
leadership	проводом	None
cashew	кеш'ю	None
kiev	київщині	None
cypress	кипарисовик	None
cyril	кирило	None
oxygen	кисню	None
acidity	кислот	None
acidities	кислоти	None
china	кнр	None
chinese	китайської	None
kiyv-mohyla	києвомогилянської	None
kyyevopecherskoi	києвопечерської	None
governs	керує	None
kyiv	київській	None
classes	класів	None
classification	класифікації	None
classicism	класицизму	None
classical	класичної	None
classic	класичні	None
club	клубу	None
clubs	клубів	None
climate	клімату	None
climatic	кліматичні	None
climatology	кліматологія	None
clytemnestra	клітемнестра	None
cells	осередків	None
cellular	клітинні	None
cemetery	кладовищі	None
governed	керував	None
kernite	керніт	None
flower	квітка	None
category languages	категоріямови	None
category places	категоріяміста	None
category popular	категоріянадпопулярні	None
category born	категоріянародились	None
category population	категоріянаселені	None
category: district	категоріяобласні	None
category regions	категоріярайонні	None
category persons	категоріяперсоналії	None
category died	категоріяпомерли	None
category buried	категоріяпоховані	None
category republics	категоріяреспубліки	None
category rivers	категоріярічки	None
category articles	категоріястатті	None
category ukrainian	категоріяукраїнські	None
category native	категоріяуродженці	None
category historical	категоріяісторичні	None
category history	категоріяісторія	None
cutter	катер	None
katerina	катерини	None
katerinoslav	катеринослав	None
catholicism	католицизму	None
catholic	католицькі	None
cafe	кафе	None
cathedral	соборів	None
square	площа 	Nan
qualification	кваліфікації	None
quarter	чверті	None
april	квітні	None
flowers	квітів	None
clitoris	клітора	None
square km	км²	None
books	книжок	None
book	книзі	None
colors	кольорів	None
coloured	кольорова	None
colour	колір	None
commands	команди	None
commander	командира	None
headquarters	штаб	None
insects	комах	None
industrial complex	комбінат	None
comedy	комедії	None
comment	комент	None
commentary	коментарі	None
commercial	торгових	None
commerce	комерції	None
companies	компанії	None
complex	складні	None
complexes	комплексів	None
composer	композитора	None
composers	композиторів	None
composition	твір	None
components	складові	None
computer	компютерні	None
computers	компютерів	None
communal	комунальне	None
communism	комунізму	None
communist	комуністичної	None
komi	комі	None
commission	комісії	None
committee	комітету	None
horses	коні	None
colonies	колоній	None
category liberal	категоріяліберальні	None
colonization	колонізації	None
kolomyia	коломиї	None
princess	княгині	None
prince	князя	None
princes	князів	None
principalities	князівств	None
principality	князівстві	None
coalition	коаліції	None
cobsar	кобзар	None
kobsar	кобзаря	None
kobilyanskoya	кобилянської	None
kovalenko	коваленко	None
koval	коваль	None
whom	кому	None
code	коду	None
coefficient	коефіцієнт	None
each	кожній	None
every	кожним	None
skin	шкіри	None
cossack	козацькі	None
spheres	сфери	None
college	коледж	None
collective	колектив	None
teams	тими	None
when	коли	None
vibration	коливання	None
vibrations	коливань	None
oscillates	коливається	None
once	колись	None
former	колишніх	None
previous	попередніх	None
column	колони	None
category laureates	категоріялауреати	None
category states	категоріякраїни	None
category geography	категоріягеографія	None
liability	зобовязання	None
obligations	зобовязань	None
depicted	зображений	None
images	образів	None
represented	представляли	None
external	зовнішніх	None
at all	зовсім	None
especially	особливо	None
gold	золоті	None
gold-topped	золотоверхий	None
zones	зони	None
zone	поясу	None
star	зірка	None
stars	зірок	None
concentrated	зосереджені	None
between	між	None
from under	зпід	None
samples	зразків	None
sample	зразок	None
understand	розуміють	None
increased	зріс	None
grew	зростала	None
growth	ріст	None
grows	зростає	None
teeth	зуби	None
specified	зумовлені	None
specifies	зумовлює	None
was able	зумів	None
effort	зусиллям	None
made	чинили	None
efforts	зусиль	None
again	знову	None
destroyed	знищені	None
dragon	змій	None
changes	змінюється	None
change	зміні	None
changed	змінили	None
strengthening	утвердження	None
serpents	змії	None
knew	знали	None
find	знаходять	None
sign	слід	None
signs	ознаки	None
knowledge	пізнання	None
instrument	інструмент	None
tools	інструментів	None
know	знати	None
finding	знахідки	None
situated	розташований	None
are	перебувають	None
value	цінність	None
meaning	означення	None
values	цінності	None
considerable	чимало	None
significant	значній	None
much	набагато	None
knows	знає	None
decrease	зниження	None
lowers	знижується	None
evanesces	зникає	None
disappearance	зникнення	None
destruction	руйнування	None
destroy	знищити	None
specific	специфічні	None
met	познайомився	None
collected	зібрані	None
candelo	кандела	None
candidate	кандидата	None
candidates	кандидатів	None
canon	канон	None
choir	хор	None
capital	столиці	None
capitalism	капіталізму	None
caravanserai	караван-сарай	None
carbonates	карбонати	None
stamping	карбування	None
carbides	карбіди	None
charles	карл	None
karl	карла	None
carpathians	карпати	None
carpathian	карпатської	None
map	мапа	None
cartagena	картахена	None
maps	карти	None
pictures	картин	None
picture	малюнок	None
potatoes	картоплі	None
career	карєру	None
caspian	каспійського	None
cassandra	кассандра	None
catastrophe	катастрофи	None
categories	категорії	None
class	класу	None
category graduates	категоріявипускники	None
category wars	категоріявійни	None
canals	каналів	None
appears	постає	None
channel	руслі	None
kamenets podolsky	камянецьподільський	None
contiguity	зіткнення	None
congress	конгресу	None
ivan	івану	None
th	ий	None
history	історією	None
them	їм	None
goes	іде	None
go	ходи	None
probably	ймовірно	None
joseph	йосип	None
went	пішли	None
cabinet	кабінету	None
caucasia	кавказі	None
cadmium	кадмій	None
staff	персоналу	None
says	каже	None
kazakhstan	казахстані	None
kazimir	казимир	None
tale	казка	None
tales	казок	None
as	як	None
calendar	календаря	None
calorie	калорія	None
calcination	кальцинація	None
flounder	камбалові	None
stone	камінь	None
cell	осередком	None
campaign	похід	None
campaigns	кампанії	None
canada	канаді	None
competitors	конкурентів	None
conservatism	консерватизм	None
constantinople	константинополі	None
lithuania	литві	None
literature	літературі	None
lithuanian	литовської	None
knight	лицар	None
knights	лицарів	None
logic	логіки	None
lodge	ложі	None
local	місцеві	None
loculi	локулі	None
london	лондоні	None
lorak	лорак	None
luhansk	луганська	None
meadows	луки	None
lutsk	луцьку	None
louis	луї	None
lviv	львівської	None
loved	любив	None
lublin	люблінської	None
people	чол	None
man	чоловік	None
ludmila	людмила	None
humanity	людство	None
human	чоловічого	None
luther	лютера	None
february	лютому	None
liberal	ліберальна	None
liberalism	лібералізму	None
left bank	лівобережної	None
league	лізі	None
letters	письмі	None
clinic	лікарня	None
leaf	листя	None
november	листопаді	None
chain	мережа	None
latin	латинської	None
latvia	латвії	None
laureate	лауреат	None
le	ле	None
lev	лева	None
levitsky	левицький	None
legend	легендою	None
lungs	легені	None
easy	легкої	None
light	світлі	None
hardly	ледве	None
lie	лежать	None
lies	лежить	None
leucine	лейцин	None
vocabulary	словник	None
lectures	лекції	None
lenin	леніна	None
leonardo	леонардо	None
leonid	леоніда	None
forest	лісу	None
lesya	леся	None
summer	літом	None
july	липні	None
lime	липові	None
lisenko	лисенка	None
lysenko	лисенко	None
letter	літерою	None
leaves	листи	None
correspondence	листування	None
landscape	ландшафт	None
hospitals	лікарні	None
liquidation	ліквідації	None
macedonia	македонії	None
mccartney	маккартні	None
broker	маклер	None
max	макс	None
maxim	максим	None
maximal	максимально	None
malaniuk	маланюк	None
malles venosta	маллес-веноста	None
lesser russian	малороссийский	None
drawings	малюнків	None
mandrill	мандрил	None
rubiaceae	маренові	None
mark	марка	None
marks	приводу	None
marko	марко	None
marx	маркса	None
marxism	марксизму	None
mars	марсі	None
kingfisher	мартин	None
martis	мартіс	None
marusya	маруся	None
routes	маршрути	None
mariupol	маріуполя	None
mary	марії	None
mass	масу	None
massif	масиву	None
freemasonry	масонство	None
freemasons	масонів	None
masturbation	мастурбації	None
macedonian	македонського	None
doctors	лікарів	None
makalu	макалу	None
masters	майстрів	None
liquidated	ліквідовано	None
liqueur	лікер	None
treatment	трактування	None
lina	ліна	None
linguistics	мовознавство	None
lines	рядки	None
line	строком	None
lyric	ліричних	None
forests	лісів	None
forest and steppe regions	лісостепу	None
planes	літаки	None
literatures	літературах	None
literary	літературній	None
literary-critical	літературнокритичні	None
literar-memorial	літературномеморіальний	None
summery	літніх	None
chronicle	хроніка	None
chronicles	хроніки	None
lyceum	ліцей	None
city	місті	None
perhaps	мабуть	None
magdeburg	магдебурзьке	None
magnetic	магнітного	None
mazepa	мазепі	None
future	наступні	None
almost	майже	None
manana	майнана	None
skills	уміння	None
masterly	майстерні	None
maya	майя	None
media	носії	None
lactation	лактація	None
system	устрій	None
user	користувача	None
users	користувачів	None
profit	прибуток	None
king	цар	None
kingdom	царство	None
royal	царської	None
crown	корони	None
short	короткі	None
corps	корпус	None
native	рідної	None
cosmogony	космогонія	None
space	простір	None
roman catholic church	костел	None
church	церковні	None
kostenko	костенко	None
costomarov	костомаров	None
kostimarov	костомарова	None
constantin	костянтин	None
kotlyarevsky	котляревського	None
which	якій	None
love	любові	None
kotsyubinsky	коцюбинський	None
kotsyubinskii	коцюбинського	None
koshoviy	кошовий	None
cpsu	кпрс	None
cpu	кпу	None
extreme	крайній	None
regional	регіональні	None
krakow	кракові	None
useful	корисні	None
beauty	красу	None
korea	кореї	None
root	корінь	None
constitutional	конституційного	None
constitution	конституції	None
structures	структури	None
contact	контакт	None
contacts	контактів	None
context	контексті	None
continental	континентального	None
continent	материка	None
control	контролювати	None
controls	контролює	None
conference	конференції	None
conflict	конфлікту	None
conflicts	конфліктів	None
confucianism	конфуціанство	None
concentration	концентрації	None
concepts	поняттях	None
concept	поняттям	None
concert	концерт	None
concerts	концерти	None
coordinates	координати	None
minerals	руд	None
copy	копія	None
copies	примірників	None
ship	корабель	None
ships	судна	None
koran	коран	None
the koran	корану	None
border	межу	None
borders	межі	None
roots	коріння	None
mode	режимі	None
the best	найкращі	None
countries	країни 	Nan
thick soup	куліш	None
kulish (last name)	куліша	None
calamagrostis	куничник	None
health resort	курорт	None
course	хід	None
courses	курси	None
angle	кута	None
corners	кути	None
angles	кутів	None
kitchen	кухні	None
couches	куш	None
curium	кюрій	None
stake	ставка	None
kilometres	кілометрів	None
quantity	кількістю	None
numerical	кількісні	None
number	числі	None
rings	кільця	None
cinema	кінотеатр	None
kinetics	кінетика	None
cinemas	кінотеатри	None
final	остаточного	None
endings	кінцівок	None
kirovograd	кіровограді	None
bones	кісток	None
kihot	кіхот	None
laboratory	лабораторії	None
lavrasia	лавразія	None
laurels	лаври	None
globe	кулі	None
lore	краєзнавчий	None
cultural	культурні	None
cultures	культур	None
country	країні	None
kremenchuk	кременчуці	None
kremenchug	кременчуцький	None
creon	креонт	None
curve	кривої	None
kriviy	кривий	None
krivoy rog	криворізький	None
crisis	кризу	None
crises	кризи	None
wing	крила	None
crimea	криму	None
crimean	кримського	None
crete	крит	None
criterias	критерії	None
critic	критик	None
criticism	критиці	None
critics	критиків	None
cretan	критський	None
blood	крові	None
step	кроком	None
steps	кроки	None
cro-magnons	кроманьйонці	None
through	через	None
except	окрім	None
cuba	куби	None
kuban	кубані	None
cup	кубок	None
smithy	кузня	None
cult	культу	None
culture	культурі	None
forced	змушені	None
will be able	зможе	None
could	міг	None
spiritual	духовні	None
shower	душ	None
soul	душі	None
woodpeckers	дятлові	None
di	ді	None
diagnostics	діагностики	None
dialect	наріччя	None
dialects	діалектів	None
dialectics	діалектики	None
dialogue	діалог	None
dialogues	діалоги	None
diameter	діаметром	None
diapason	діапазон	None
diaspora	діаспори	None
girls	дівчат	None
girl	дівчина	None
grandfather	дід	None
diderot	дідро	None
really	реально	None
reality	реальність	None
divided	розділені	None
plots	сюжетів	None
plot	сюжету	None
got	потрапили	None
operating	операційної	None
acted	діяло	None
actions	дії	None
figure	фігура	None
figures	фігури	None
clergy	духовенство	None
verbs	дієслів	None
spirit	духу	None
thoughts	думок	None
till now	дотепер	None
till that time	доти	None
observance	дотримання	None
keep	тримати	None
income	надходження	None
board	колегії	None
rains	дощів	None
soe	дп	None
dragomanov	драгоманов	None
drama	драми	None
dramatic	драматичні	None
dramatist	драматург	None
drogobych	дрогобич	None
friend	другом	None
other	іншій	None
second	подруге	None
friendship	дружба	None
armed force	дружину	None
companion	дружини	None
friends	друзів	None
printing	друку	None
printed	надруковано	None
print	друкувати	None
small	невеликі	None
genista	дрік	None
oak	дуб	None
thought	думку	None
word	словом	None
words	слів	None
danube	дунаю	None
achievements	досягнень	None
verb	дієслово	None
his	своїх	None
aesthetics	естетики	None
aesthetic	естетичні	None
estonia	естонії	None
stage	фази	None
stages	етапів	None
ethics	етики	None
etymology	етимологія	None
ethical	етичні	None
ethnos	етносу	None
ethnic	етнічні	None
eukaryotes	еукаріотів	None
effect	ефекту	None
effective	ефективного	None
efficiency	чинності	None
also	тож	None
sorrow	жаль	None
jean	жан	None
genre	жанрі	None
genres	жанрів	None
same	же	None
victims	жертви	None
victim	жертву	None
alive	живі	None
lives	проживає	None
live	проживають	None
nourishment	живлення	None
painting	живописі	None
to live	живуть	None
life	побуту	None
epitaph	епітафія	None
evolution	еволюції	None
epidemic	епідемії	None
epos	епосу	None
aegis	егідою	None
einstein	ейнштейній	None
equator	екватора	None
ecological	екологічної	None
ecology	екології	None
economically	економічно	None
ecosystems	екосистеми	None
experiment	експерименту	None
experts	експертів	None
operation	операції	None
export	експорту	None
elasticity	еластичність	None
electric	електричного	None
electricity	електроенергії	None
electrons	електронів	None
electronic	електронні	None
electric power	електростанції	None
electrochemistry	електрохімія	None
element	елементу	None
elements	початки	None
elementary	початкова	None
elite	еліти	None
emancipation	емансипація	None
emigration	еміграції	None
engels	енгельс	None
energy	енергії	None
aeneid	энеида	None
encyclopedia	энциклопедия	None
sponge	епонж	None
epoch	ери	None
lived	проживали	None
achievement	досягненням	None
reaches	сягає	None
john	джон	None
mirror	дзеркало	None
dziuba	дзюба	None
look	погляду	None
strangely	дивно	None
division	розділу	None
dixieland	диксиленд	None
dictatorship	диктатури	None
dynamo	динамо	None
dynamics	динаміку	None
dynasty	династії	None
diplomatic	дипломатичні	None
director	режисер	None
directory	довідник	None
discussion	обговорення	None
dysplasia	дисплазія	None
dysphoria	дисфорія	None
disciplines	дисциплін	None
discipline	дисципліни	None
child	дитина	None
children	дітьми	None
childhood	дитинстві	None
childish	дитячі	None
dithyramb	дифірамб	None
breathing	дихання	None
dmitry	дмитра	None
dmytro	дмитро	None
bottom	дна	None
deoxyribonucleic acid	днк	None
bumblebee	джміль	None
days	добу	None
fountain	фонтан	None
james	джеймс	None
few	небагатьох	None
several	кількох	None
delta	дельта	None
demography	демографія	None
democratic	демократичні	None
democracy	демократії	None
demostration	демонстрації	None
denudation	денудація	None
day	доба	None
depot	депо	None
deputy	заступник	None
deputies	депутатів	None
trees	дерева	None
tree	дерево	None
wooden	деревяні	None
states	штатів	None
statehood	державність	None
states members	державчленів	None
derjlitvidav	держлітвидав	None
somewhere	подекуди	None
ten	десять	None
decades	десятиліть	None
tens	десятків	None
details	деталі	None
detailed	докладніше	None
some	якогось	None
something	щось	None
dj	дж	None
jazz	джаз	None
jamestown	джеймстаун	None
achieved	досягається	None
dnepr	дніпра	None
dnipr	дніпром	None
share	поділяють	None
fate	долі	None
domain	домен	None
domination	панування	None
dominate	домінують	None
don	дону	None
donbas	донбасі	None
donetsk	донецькій	None
up to this time	донині	None
daughter	дочки	None
helps	допомагає	None
help	сприяють	None
road	дорозі	None
roads	доріг	None
adults	дорослих	None
doroshenko	дорошенко	None
is equal	дорівнює	None
experience	досвіду	None
ideal	ідеального	None
research	досліджень	None
investigates	досліджує	None
experiments	експерименти	None
investigator	дослідник	None
investigators	дослідників	None
dostoevsky	достоєвський	None
access	доступу	None
accessible	доступні	None
reached	потрапив	None
reach	сягають	None
valleys	долини	None
dnipro	дніпрі	None
valley	долині	None
documents	документів	None
dnipropetrovsk	дніпропетровський	None
dnepropetrovsk	дніпропетровської	None
dniester	дністра	None
well	добре	None
fertilizer	добрива	None
prosperity	добробут	None
voluntarily	добровільно	None
proof	доведення	None
had	мав	None
dovzhenko	довженко	None
length	протяжність	None
around	навколо	None
environment	середовище	None
have to	доводилося	None
enough	достатньо	None
conventions	договорів	None
contract	контракт	None
agreement	угоду	None
addition	приєднання	None
add	додати	None
additional	додаткові	None
allowed	дозволило	None
permission	дозвіл	None
allow	дозволяють	None
allows	дозволяє	None
allowing	дозвілля	None
evidence	свідченням	None
doctor	лікаря	None
document	документу	None
dollars	доларів	None
declaration	декларації	None
population	популяції	None
housing	корпусу	None
enrichment	збагачення	None
preserved	зберігся	None
preservation	збереження	None
saved	зберіг	None
storing	зберігання	None
kept	зберігається	None
keeps	тримає	None
gathered	збиралися	None
collection	колекція	None
gather	збираються	None
rapprochement	зближення	None
armed	збройні	None
weapon	зброї	None
excitation	збудження	None
sales	продажу	None
run together	збігаються	None
runs together	збігається	None
increase	підвищення	None
increases	збільшується	None
team	тим	None
combined	обєднані	None
paying attention	зважаючи	None
rank	звання	None
welding	зварюванні	None
report	протоколу	None
appeal	звернення	None
turned	перетворилося	None
turns	обертається	None
on the top	зверху	None
volume	том	None
accusation	звинувачення	None
announced	проголошено	None
west ukrainian	західноукраїнських	None
assimilation	засвоєння	None
populated	населяли	None
settlement	селищі	None
exile	заслання	None
merits	заслуги	None
merited	заслужений	None
founded	заснували	None
founder	засновником	None
founders	засновників	None
means	означає	None
funds	фондів	None
apply	стосуються	None
are applied	застосовуються	None
applied	застосував	None
meetings	зустрічі	None
meeting	сходи	None
closed joint-stock company	зат	None
approved	затвердив	None
confirmation	підтвердження	None
bay	затоки	None
remark	зауважити	None
western	західній	None
disease	хвороба	None
diseases	хвороби	None
defend	захищати	None
measures	міри	None
west	західний	None
captured	захопили	None
rapture	захоплення	None
west european	західноєвропейських	None
basis	підставою	None
custom	звичаї	None
usual	звичайний	None
implemented	реалізується	None
make	проводять	None
set	ставлять	None
realize	реалізувати	None
realizes	здійснює	None
zeus	зевса	None
green	зелені	None
lands	теренах	None
land	суші	None
agriculture	землеробство	None
earthquakes	землетрусів	None
ground	майданчик	None
terrestrial	земного	None
amphibious	земноводних	None
amphibia	земноводні	None
earthly	земної	None
grain	зерно	None
winter	зимові	None
kingfishers	зимородкові	None
shoot	зйомка	None
evil	зло	None
pour together	зливаються	None
confluence	злиття	None
crimes	злочини	None
reunion	злуки	None
competition	конкурс	None
competitions	змагань	None
reduction	скорочення	None
diminishes	зменшується	None
realized	здійснила	None
ordinary	звичайні	None
realization	реалізації	None
health	здоровя	None
commonly	звичайно	None
customs	звичаїв	None
sound	звучить	None
sounds	звуків	None
sounding	звучання	None
related	споріднені	None
ties	звязки	None
communication	спілкування	None
communications	звязків	None
connection	зєднання	None
from here	звідси	None
from there	звідти	None
remember	згадує	None
recollection	згадка	None
mentions	згадки	None
remembered	згадується	None
consent	згодою	None
in time	згодом	None
after some time	згодом 	Nan
according to	згідно	None
seemed	здавалося	None
long since	здавна	None
capable	здатні	None
ability	здатністю	None
it seems	здається	None
mainly	переважно	None
gained	здобули	None
gain	придбати	None
obtaining	одержання	None
capabilities	здібностей	None
inhabitants	мешканців	None
principles	принципів	None
birth	народження	None
plants	рослини	None
factory	фабрика	None
factories	фабрики	None
conquest	завоювання	None
conquests	завоювань	None
common	спільні	None
invaders	загарбників	None
death	смерті	None
detachments	загонів	None
sharpening	загострення	None
threat	загрозу	None
danger	небезпеку	None
detachment	загін	None
long before	задовго	None
satisfaction	задоволення	None
plan	плані	None
usually	зазвичай	None
in advance	заздалегідь	None
suffered	зазнало	None
expereinced	зазнали	None
notes	примітки	None
indicated	зазначено	None
occupied	зайняли	None
busy	зайняті	None
occupy	посідають	None
are busy	займаються	None
occupies	посідає	None
pronoun	займенник	None
pronouns	займенники	None
plant	рослинного	None
transcarpathian	закарпатської	None
always	завжди	None
completion	завершення	None
dwelling	житло	None
zhytomyr	житомирської	None
vital	життєві	None
vital activity	життєдіяльності	None
october	жовтні	None
yellow	жовтий	None
none	жодної	None
cruelly	жорстоко	None
grues	журавлеподібні	None
magazine	часопис	None
magazines	журналів	None
journalist	журналіст	None
woman	жінку	None
women	жіночі	None
female	жіночої	None
with	со	None
coloration	забарвлення	None
ensuring	забезпечення	None
ensure	забезпечити	None
provide	надають	None
provides	передбачає	None
ensures	забезпечується	None
prohibition	заборона	None
forbidden	заборонено	None
defence	оборону	None
pollution	забруднення	None
task	завданням	None
tasks	задачі	None
thanks to	завдяки	None
ends	закінчується	None
charge	заряду	None
transcarpathia	закарпатті	None
institution	установи	None
too	надто	None
decay	розпаду	None
decadance	занепаду	None
occupation	окупації	None
occupate	занять	None
stocks	запасів	None
objection	заперечення	None
raises	заперечує	None
recording	запис	None
recordings	записи	None
registration	реєстрації	None
question	питанням	None
fertilization	запліднення	None
prevention	запобігання	None
prevent	запобігти	None
reserve	заповідника	None
testament	заповіту	None
loan	позики	None
borrowed	запозичені	None
cossacks	козацтво	None
zaporozhye	запорізької	None
zaporozhian	запорозької	None
zaporizhia	запоріжжя	None
started	розпочато	None
offered	запропонував	None
invitation	запрошення	None
now	тепер	None
registered	зареєстровано	None
earnings	прибутків	None
instead of	замість	None
put	ставить	None
replace	замінити	None
suede	замша	None
institutions	інституцій	None
call	називає	None
law	закону	None
laws	законів	None
legislation	законодавством	None
legislative	законодавчої	None
patterns	закономірності	None
foreign	іноземні	None
closing	закриття	None
end	припинити	None
ended	закінчилася	None
hall	зали	None
depend	залежать	None
depends	залежить	None
depending	залежно	None
dependence	залежність	None
dependent	залежні	None
remained	залишилися	None
remain	залишаються	None
remains	рештки	None
iron	залізо	None
gland	залози	None
attraction	залучення	None
lie down	залягають	None
railroads	залізниць	None
railway	залізничні	None
castles	замки	None
castle	замок	None
order	упоряд	None
replacement	заміни	None
soils	ґрунтів	None
