+	+	Nan	+
ห้วยขวาง	huai khwang	Nan	huai khwang
ห้วยทับทัน	huai thap than	Nan	huai thap than
ห้องน้ำ	bathroom	Nan	toilet
ห้องสมุด	library	Nan	library
ห้าง	mall	Nan	store
ห้างฉัตร	hang chat	Nan	hang chat
ห้างหุ้นส่วนจำกัด	limited partnership	Nan	limited partnership
ฬาพานิช	fapanit - surname of an actor	Nan	commercial
อก	breast	Nan	breast
อคิลลีส	achilles	Nan	achilles
องคชาต	penis	Nan	genitals
องคต	angada	Nan	organization
องค์กรปกครองส่วนท้องถิ่น	local administration	Nan	local government organization
องค์การนิสิต	student organization	Nan	student organization
องค์การมหาชน	public organization	Nan	public organization
องค์การสหประชาชาติ	united nations	Nan	united nations
องค์บาก	ong-bak	Nan	ong bak
อนึ่ง	once	Nan	incidentally
อนาลโย	analayo	Nan	analoy
อนันตรัย	anuntrai	Nan	anantai
อนันตยะ	anantaya	Nan	anantaya
อธิบายว่า	explain	Nan	explain that
อธิการบดีมหาวิทยาลัยธรรมศาสตร์	former chanceller of thamasat university	Nan	president of thammasat university
ห่วงใย	care	Nan	caring
อธิการบดี	dean of the college	Nan	chancellor
อดีตรองนายกรัฐมนตรี	former deputy prime minister	Nan	former deputy prime minister
อดีตผู้บัญชาการทหารบก	ex-commander in chief of the royal thai army	Nan	former military commander
อดีต	the past	Nan	former
อดิศักดิ์	adisak	Nan	adisak
องอาจ	ongart	Nan	valiant
องค์ประกันหงสา	prakunhongsa - a famous person from the ancient time	Nan	hongsa insurance
อดีตรองหัวหน้าหน่วยที่	former lieutenant	Nan	former deputy head of the unit
อนุทิน	diary	Nan	diary
หเตุการณ์	situation	Nan	situation
หุ่น	puppet	Nan	puppet
หลักสูตรวิทยาศาสตรมหาบัณฑิต	degree requirements for a bachelor degree in science	Nan	master of science program
หลังจาก	after	Nan	after
หลังสงคราม	after the war	Nan	after the war
หลังสงครามโลกครั้งที่	after world war	Nan	after world war
หลังสงครามโลกครั้งที่สอง	after world war ii	Nan	after the second world war
หลังเหตุการณ์	after the event	Nan	after the event
หลาย	many, vastly	Nan	many
หลีกภัย	escape	Nan	escape
หลุมดำจิ๋ว	small black hole	Nan	tiny black hole
หล่มสัก	lohmsak	Nan	lom sak
หวาย	bamboo	Nan	rattan
หอก	spear	Nan	spear
หอประชุมพ่อขุนรามคำแหงมหาราช	pho khun ram khamhaeng convention center	Nan	king ramkhamhaeng the great auditorium
หอมรดกไทย	national ancient museum of thailand	Nan	thai heritage hall
หอย	shells, clams	Nan	shellfish
หอไอเฟล	eiffel tower	Nan	eiffel tower
หัก	broken	Nan	deduct
หุตะสิงห์	hutasingha	Nan	huta sing
หี	vagina (impolite word)	Nan	pussy
หินไซอัล	sial	Nan	shale stone
หินแกรนิต	granite	Nan	granite
หินเชิร์ต	chert	Nan	stone shirt
หินอ่อน	marble	Nan	marble
หุ่นยนต์	robot	Nan	robot
หินปูน	limestone	Nan	limestone
หาดทรายแก้ว	glass beach	Nan	sai kaew beach
หาง	tail	Nan	tail
หัวใจ	heart	Nan	heart
หัวโขน	khon mask	Nan	mask
หัวหิน	hua hin	Nan	hua hin
หัว	head	Nan	head
หาบเร่	street vending	Nan	hawker
หลักสูตรภาษาไทย	thai language curriculum	Nan	thai language course
อนุสรณ์สถาน	monument	Nan	memorial
อปักธงชัย	pak thongchai district	Nan	pak thong chai
ออกมาในอะนิเมะเท่านั้น	only in anime	Nan	coming out in the anime only
ออกอากาศ	on the air	Nan	broadcast
ออกอากาศครั้งที่	aired on	Nan	aired on
ออกอากาศทางช่อง	aired on channel	Nan	broadcast on
ออกัสตัส	augustus	Nan	augustus
ออกเป็น	into	Nan	into
ออกแบบตัวละคร	character design	Nan	character design
ออนไลน์	online	Nan	online
ออฟ	off	Nan	off
ออลแบนี	albany	Nan	allies
ออสเตรเลีย	australia	Nan	australia
ออโตทรอพ	autotroph	Nan	autobot
อะ	a	Nan	what
อะซูไรต์	azurite	Nan	azurite
อะตอม	atom	Nan	atom
อะนิเมะ	anime	Nan	anime
อะบุราเมะ	aburame	Nan	aburame
อัธฮา	athha	Nan	athha
อัตราการว่างงาน	unemployment rate	Nan	unemployment rate
อัฒภาค	semicolon	Nan	semicolon
อัญมณี	gem	Nan	gem
อังการา	ankara	Nan	ankara
อังกฤษสมัยแองโกล-นอร์มัน	england anglo-norman era	Nan	anglo-norman english
ออกฉายครั้งแรกเมื่อวันที่	first screening	Nan	first screened on
อักษรเกาหลี	korean alphabets	Nan	korean alphabet
อักษร	letter	Nan	letter
อะโลน	alone	Nan	alone
อะโกนิสต์	agonist	Nan	agonist
อะลูมิเนียม	aluminum	Nan	aluminum
อะมาเดอุส	amadeus	Nan	amadeus
อะพาไทต์	apatite	Nan	apatite
อักษรย่อ	abbreviation	Nan	abbreviations
อนุสรา	anusara	Nan	anusara
ออ	or	Nan	or
อสมท	acronym for thai communication companies	Nan	mcot
อพอลโล่	apollo	Nan	apollo
อพิมาย	phimai district	Nan	aphimai
อภัยนุราช	aphainurat	Nan	forgiveness
อภินันท์	ahpinun - a male's name	Nan	aphinan
อภิปรัชญา	metaphysics	Nan	metaphysics
อภิรักษ์	apirak	Nan	aphirak
อมฤต	ummarit - a male's name	Nan	dead
อมาตยกุล	amattayakun	Nan	amatayakun
อยู่	is	Nan	are
อยู่วิทยา	yoovidhya	Nan	science
อยู่ห่างออกไปจากชายฝั่ง	away offshore	Nan	far away from the coast
อยู่แล้ว	already	Nan	already
อยู่ในเขตอำเภอกุฉินารายณ์	in the kuchinarai district	Nan	located in kuchinarai district
อย่างต่อเนื่อง	continuously	Nan	continuously
อย่างแพร่หลาย	many, various	Nan	widely
อย่างไรก็ตาม	however	Nan	however
อร	orn (thai name)	Nan	orn
อศรีประจันต์	master sri prajan - a priest's name	Nan	asri prachan
อวัยวะเพศ	sex organ	Nan	genitals
อวัยวะสืบพันธุ์หญิง	female reproductive system	Nan	female genital organs
อวัยวะสืบพันธุ์สตรีด้านนอก	femal reproductive system	Nan	female genital organs on the outside
อวอร์ดส	award	Nan	awards
อลิซ	alice	Nan	alice
อสามชุก	sam chuk district	Nan	sam chuk
อลาสก้า	alaska	Nan	alaska
อรุณี	arunee	Nan	arunee
อริยสัจ	teaching of buddha	Nan	noble truth
อรัญประเทศ	arranyapratet - a location in thailand	Nan	aranyaprathet
อรรถพร	uttapon - a female's name	Nan	athaphon
อรรถกถา	atthakatha	Nan	commentary
อรทัย	orathai - surname of a thai country singer	Nan	young girl
อลังการ	alungan - the name of a movie theater in thailand	Nan	ornamentation
อันดับ	order	Nan	rating
หลักสูตรภาษาอังกฤษ	english curriculum	Nan	english language course
หลักสูตรนานาชาติ	international course	Nan	international course
หน้าอก	chest	Nan	chest
หมวด	group	Nan	group
หมวดหมู่	category	Nan	category
หมวดหมู่กลุ่มดนตรีที่ก่อตั้งในปี	category: music band established in the year	Nan	music group category founded in
หมวดหมู่กลุ่มดนตรีสัญชาติเกาหลี	korean musical group	Nan	korean music group category
หมวดหมู่กวีชาวไทย	thai poem category	Nan	thai poet category
หมวดหมู่การฉลองปีใหม่	the group in charge of new year celebration	Nan	new year celebration category
หมวดหมู่การประท้วงในประเทศไทย	category:protests in thailand	Nan	category protest in thailand
หมวดหมู่การ์ตูนญี่ปุ่นแนวโชเน็น	the cartoons of japan	Nan	category: japanese cartoon, shonen style
หมวดหมู่จุลชีววิทยา	category:microbiology	Nan	microbiology category
หมวดหมู่ชาวไทยที่นับถือศาสนาพุทธ	category:thai buddhists	Nan	category thai buddhists
หมวดหมู่ชาวไทยที่เกิดในต่างประเทศ	thais that were born outside thailand	Nan	category thai people born overseas
หมวดหมู่ดาวเคราะห์ชั้นใน	group of stars inside	Nan	inner planet category
หมวดหมู่ดาวเคราะห์หิน	category:terrestrial planets	Nan	planet stone category
หมวดหมู่ทหารอากาศชาวไทย	category:royal thai air force personnel	Nan	thai air force category
หมวดหมู่ทหารเรือชาวไทย	group of thai navy officers	Nan	thai navy category
หมวดหมู่นักการเมืองไทย	politician	Nan	category of thai politicians
หมวดหมู่ประวัติศาสตร์ไทย	category:history of thailand	Nan	thai history category
หมวดหมู่บุคคลที่เกี่ยวข้องกับเหตุการณ์	catagory: individuals invovled	Nan	category of people related to the event
หมวดหมู่บุคคลจากโรงเรียนมงฟอร์ตวิทยาลัย	category: people from mongford college	Nan	category of individuals from montfort college
หมวดหมู่บุคคลจากโรงเรียนนายร้อยพระจุลจอมเกล้า	catagory: people from prchomklhaw academy	Nan	categories from chulachomklao royal military academy
หมวดหมู่บุคคลจากสถาบันบัณฑิตพัฒนศิลป์	group of staff from art schools	Nan	category of people from bunditpatanasilpa institute
หมวดหมู่บุคคลจากมหาวิทยาลัยอ๊อกซฟอร์ด	the staff of oxford university, england	Nan	individual category from oxford university
หน่วยพันธุกรรม	gene	Nan	genetic unit
หมวดหมู่บุคคลจากมหาวิทยาลัยสุโขทัยธรรมาธิราช	group: person from sukhothai thammathirach university	Nan	categories from sukhothai thammathirat open university
หมวดหมู่บุคคลจากจุฬาลงกรณ์มหาวิทยาลัย	category:chulalongkorn university alumni	Nan	categories from chulalongkorn university
หมวดหมู่บอยแบนด์	a group of boys band	Nan	boy band category
หมวดหมู่บริษัทที่ก่อตั้งในปี	category:companies established in	Nan	category company founded in
หมวดหมู่บริษัทของไทย	group of thai's companies	Nan	thai company category
หมวดหมู่นายกรัฐมนตรีไทย	category:prime ministers of thailand	Nan	category thai prime minister
หมวดหมู่นักร้องไทย	singer category	Nan	thai singer category
หมวดหมู่บุคคลจากมหาวิทยาลัยธรรมศาสตร์	group of staff from thammasat university	Nan	category from thammasat university
หมวดหมู่ประเภทของภาพยนตร์	types of film	Nan	movie category category
หน่วยประมวลผลกลาง	central processing unit	Nan	central processing unit
หน่วยที่	order of 1, 2, 3...	Nan	unit
ส่วนหัว	top part	Nan	header
ส่วนในฤดูฝนน้ำจะท่วมทุกปี	flooding in the rainy season	Nan	in the rainy season, the water will flood every year.
ส่วนใหญ่	mostly	Nan	most
ส่วนใหญ่เป็นโรงสีข้าว	most of them are rice refinery	Nan	most of them are rice mills.
ส่องแสง	shining light	Nan	shine
ส้ม	orange	Nan	orange
ส้มเช้ง	acidless orange	Nan	orange orange
ส้มโอ	grapefruit	Nan	grapefruit
หงษ์ทอง	hongthong	Nan	hong thong
หงษ์มานพ	hongmanop	Nan	hong manop
หงสกุล	hongsakul (a famous surname in thailand), as in harin hongsakul	Nan	hong sakul
หญ้าทะเล	seagrass	Nan	sea grass
หญ้าฝรั่น	saffron	Nan	saffron
หนองคาย	nong khai	Nan	nong khai
หนองม่วง	nong muang	Nan	nong muang
หนองหาน	nong-haan	Nan	nong han
หนองฮี	nong hi - a location in thailand	Nan	nong hee
หน่วยทหารในค่าย	units in camp	Nan	military unit in the camp
หน่วยคำเติม	affix	Nan	morpheme
หน่วยความจำ	memory	Nan	memory
หนุ่ม	young	Nan	young
หนุมาน	hanuman	Nan	hanuman
หนึ่งธิดา	nuengthida	Nan	one daughter
หน่วยบัญชาการนาวิกโยธิน	royal thai marine corps	Nan	marine headquarters
หนึ่ง	one	Nan	one
หนังสือลามก	pornographic magazines	Nan	pornographic books
หนังสือการ์ตูน	comic book	Nan	comic book
หนังสือ	book	Nan	book
หนัก	heavy	Nan	heavy
หนอน	worm	Nan	worm
หนองแซง	nong sang - area in thailand	Nan	zang
หนังใหญ่	nang yai	Nan	big movie
หลักสูตรปกติ	normal program	Nan	normal course
หมวดหมู่ปรัชญา	category:philosophy	Nan	philosophy category
หมวดหมู่พระราชปทินัดดาในรัชกาลที่	the king's army	Nan	category royal reign during the reign
หมอชิต	mochit bus station	Nan	morchit
หมากรุกสากล	chess	Nan	international chess
หมายความว่า	means	Nan	means
หมู่	district, group	Nan	swine
หมู่ที่	village	Nan	village
หมู่เกาะเคย์แมน	cayman island	Nan	cayman islands
หมู่เกาะแบลีแอริก	balearic island in spain	Nan	balearic islands
หมู่เกาะโซโลมอน	solomon islands	Nan	solomon islands
หม่อมราชวงศ์ปรีดิยาธร	mom rajawongse pridiyathorn devakula	Nan	r. pridiyathorn
หม่อมหลวงปิ่น	mom luang pin	Nan	mom pin
หม่อมเจ้าจุฑาวัชร	his serene highness prince juthawat	Nan	prince jutawatchai
หม่อมเจ้าวัชรวีร์	mom chao vatcharee - a member of the royal family	Nan	prince watcharawee
หม่อมเจ้าวัชรเรศร	watcharaje - a member of royal family	Nan	mom watcharachorn
หม้อข้าวหม้อแกงลิง	nepenthes - a type of tropical plant	Nan	nepenthes
หยุ่น	yun - nickname of a thai newscaster	Nan	flexible
หรั่ง	rang	Nan	lang
หรือ	or	Nan	or
หลักสูตรที่เปิดสอน	curriculum	Nan	course
หลักสูตรการจัดการดุษฏีบัณฑิต	doctor of management program	Nan	doctor of philosophy program in management
หลักสี่	luk sri - a location in bangkok	Nan	laksi
หลักทรัพย์	property	Nan	securities
หลักจริยธรรม	ethics	Nan	ethics
หลอดเลือดแดงใหญ่เอออร์ตา	aorta	Nan	aorta
หมวดหมู่โรงเรียนบุรุษในประเทศไทย	category:boys' schools in thailand	Nan	men&#39;s school category in thailand
หลอดอาหาร	esophagus	Nan	esophagus
หลวง	loung - a thai title for people who services the king	Nan	royal
หรือเรียกว่า	called	Nan	or called
หรือที่เรียกกันว่า	also known as	Nan	also known as
หรือที่รู้จักกันในชื่อ	also known as	Nan	or known as
หรือชื่อทางการคือ	official name is	Nan	or official name is
หรือการแสดงธงชาติ	national flag display	Nan	or showing the national flag
หลอก	fake, fooling someone	Nan	pseudo
หมวดหมู่พระราชนัดดาในรัชกาลที่	catagory: royal heirs during the "blank" reign	Nan	category royal grandson of the reign
หมวดหมู่โรงเรียนที่มีอัตราการแข่งขันสูง	categories high competition school	Nan	category of schools with high competition rates
หมวดหมู่แนวพระราชดำริ	the king's words (instruction)	Nan	initiative category
หมวดหมู่พระราชปนัดดาในรัชกาลที่	belonging to the king # ________	Nan	category king panadda in the reign
หมวดหมู่พิธีกรไทย	host for thai shows	Nan	category thai presenters
หมวดหมู่ฟุตบอลในประเทศไทย	category; football in thailand	Nan	football category in thailand
หมวดหมู่ภัยธรรมชาติ	catagory: natural disasters	Nan	natural disaster category
หมวดหมู่ภัยพิบัติทางการแพทย์	category: medical disaster	Nan	medical disaster category
หมวดหมู่มหาวิทยาลัยธรรมศาสตร์	thamasat university	Nan	thammasat university category
หมวดหมู่รัชกาลที่	reign 9 category	Nan	category reign
หมวดหมู่รัฐคอมมิวนิสต์	communist countries	Nan	communist state category
หมวดหมู่รัฐมนตรีว่าการกระทรวงการต่างประเทศไทย	category:foreign ministers of thailand	Nan	category: thai foreign minister
หมวดหมู่รัฐวิสาหกิจไทย	category:government-owned companies of thailand	Nan	category thai enterprises
หมวดหมู่รัฐสิ้นสภาพในทวีปเอเชีย	asian counties in controlled	Nan	category state of the state ceased in asia
หมวดหมู่รัฐและดินแดนที่ก่อตั้งในปี	categories state and territory established in	Nan	category state and territory founded in
หมวดหมู่รายการโทรทัศน์ไทย	the group of thai television channels	Nan	thai television program category
หมวดหมู่ละครโทรทัศน์ไทย	thai drama category	Nan	category thai television drama
หมวดหมู่วัฒนธรรมไทย	category:thai culture	Nan	thai culture category
หมวดหมู่วันสำคัญทางศาสนาที่นับโดยปฏิทินจันทรคติ	group of religious holidays	Nan	categories of important religious days counted by the lunar calendar
หมวดหมู่ศิลปินสังกัดจีเอ็มเอ็ม	mgm artists	Nan	artist category under gmm
หมวดหมู่เพศศึกษา	sex education category	Nan	sex education category
หมวดหมู่เครื่องเทศ	herbs	Nan	spice category
หมวดหมู่อวัยวะเพศ	category:sex organs	Nan	genital category
หมวดหมู่อวัยวะ	group of organs	Nan	organ category
หมวดหมู่อดีตอาณานิคมของอังกฤษ	the group of countries that were under british control	Nan	british former colonial category
หมวดหมู่อดีตอาณานิคมของสเปน	category:former spanish colonies	Nan	spanish former colonial category
หมวดหมู่โรค	group of disease	Nan	disease category
หมวดหมู่อดีตอาณานิคมของฝรั่งเศส	category:former french colonies	Nan	french former colonial category
หมวดหมู่สิ้นสุดในคริสต์ศตวรรษที่	category: ended in xth century	Nan	category ended in the 19th century.
หมวดหมู่สิ่งก่อสร้างในพุทธศตวรรษที่	development in the century # ____	Nan	category of buildings in the 21st century
หมวดหมู่สัตว์เลื้อยคลาน	reptilians	Nan	reptile category
หมวดหมู่สัตว์มีแกนสันหลัง	category:chordates	Nan	category vertebral axis
หมวดหมู่สมุนไพร	herbal, herbs	Nan	herb category
หมวดหมู่สถาบันอุดมศึกษาในกรุงเทพมหานคร	category:universities in bangkok	Nan	categories of higher education institutions in bangkok
หมวดหมู่สโมสรในพรีเมียร์ลีก	group of premier club	Nan	club category in the premier league
อันประกอบด้วย	consists of	Nan	consisting of
อันโตนิโอ	antonio	Nan	antonio
อันโตนีโอ	antonio	Nan	antonio
อุณหเคมี	thermochemistry	Nan	thermochemistry
อุดม	udom	Nan	fertile
อุดรธานี	udon thani	Nan	udon thani
อุตตมะโยธิน	uttamayothin	Nan	upparat
อุตรดิตถ์	uttaradit	Nan	uttaradit
อุทยาน	park	Nan	park
อุทยานประวัติศาสตร์พนมรุ้ง	phanom rung historical park	Nan	phanom rung historical park
อุทยานประวัติศาสตร์พิมาย	phimai historical park	Nan	phimai historical park
อุทยานแห่งชาติคลองตรอน	khlong tron national park	Nan	khlong tron national park
อุทยานแห่งชาติดอยภูคา	doi phu kha national park	Nan	doi phu kha national park
อุทยานแห่งชาติดอยอินทนนท์	national park doi inthanon in northern thailand	Nan	doi inthanon national park
อุทยานแห่งชาติทุ่งแสลงหลวง	thung salaeng luang national park	Nan	thung salaeng luang national park
อุทยานแห่งชาติธารโบกขรณี	tarabokorani national preserve area	Nan	than bok khorani national park
อุทยานแห่งชาติน้ำตกสี่ขีด	namtoksekeed national park	Nan	si khit waterfall national park
อุทยานแห่งชาติน้ำพอง	nam phong national park	Nan	nam phong national park
อุทยานแห่งชาติภูผาเหล็ก	phupalek national park	Nan	iron mountain national park
อุทยานแห่งชาติภูพาน	phu phan national park	Nan	phu phan national park
อุภัยราศี	ambivert zodiac	Nan	forgive the zodiac
อุปนิสัย	character	Nan	character
อุปกรณ์คอมพิวเตอร์	computer hardware	Nan	computer accessories
อุปกรณ์	instrument	Nan	equipment
อุบล	ubol - a place in thailand	Nan	ubon
อุทุมพรพิสัย	utompisai - an area in thai province	Nan	uthumphon phisai
อุณหภูมิ	temperature	Nan	temperature
อุทยานแห่งชาติไทรทอง	sai thong national preserve area	Nan	sai thong national park
อุทยานแห่งชาติหาดนพรัตน์ธาราหมู่เกาะพีพี	hat nopparatthara-mu ko phi phi national park	Nan	noppharat thara beach national park, phi phi islands
อุทยานแห่งชาติภูแลนคา	phu laenkha national park	Nan	phulanca national park
อุทยานแห่งชาติภูเวียง	phu wiang national park	Nan	phu wiang national park
อุทยานแห่งชาติภูเรือ	phu ruea national park	Nan	phu ruea national park
อุทยานแห่งชาติภูสอยดาว	phu soi dao national park	Nan	phu soi dao national park
อุทยานแห่งชาติภูสวนทราย	pusuansai national preserve	Nan	phu suan sai national park
อุทยานแห่งชาติเขาหลวง	khao luang national park	Nan	khao luang national park
อุรุกวัย	uruguay	Nan	uruguay
อุซึมากิ	uzumaki	Nan	uzumaki
อื่น	other	Nan	another
อำเภอแม่แจ่ม	mae jam province	Nan	mae chaem district
อำเภอแม่แตง	mae taeng district	Nan	mae taeng district
อำเภอโนนดินแดง	non din daeng district	Nan	non din daeng district
อำเภอโนนสุวรรณ	none su wan province	Nan	non suwan district
อิงค์	inc.	Nan	inc.
อิงลิช	english	Nan	english
อิทธิพล	power	Nan	influence
อิน	in	Nan	in
อินทิรา	indira	Nan	indira
อินฟราเรด	infared	Nan	infrared
อินฮิบิเตอร์	inhibitors	Nan	inhibitor
อินุยาฉะ	inuyacha - a japanese cartoon	Nan	inuyasha
อินเซคทิวอรา	insectivora	Nan	inseqtura
อินเดียน	indian	Nan	indian
อินเด็กซ์	index	Nan	index
อินโดนีเซีย	indonesia	Nan	indonesia
อิม	im	Nan	imm
อือ	uu - a thai vowel	Nan	yeah!
อึ๊งภากรณ์	ungpakorn - a famous surname	Nan	ungphakorn
อึ	poop	Nan	shit
อีกด้วย	too	Nan	too
อีกครั้ง	again	Nan	once again
อีก	more	Nan	more
อุ	ou	Nan	o
อิโนะ	ino	Nan	ino
อิหร่าน	iran	Nan	iran
อิสตันบูล	istanbul	Nan	istanbul
อิริโทรมัยซิน	erythromycin	Nan	electrolysis
อิรัก	iraq	Nan	iraq
อิมแพ็ค	impact	Nan	impact
อิมาจิน	imagine	Nan	imajin
อิเควทอเรียลกินี	equitorial	Nan	equatorial guinea
อำเภอแม่ทะ	mahta district	Nan	mae tha district
อุเทน	utain - a male's name	Nan	uthen
อู๋	auu (first name)	Nan	wu
ฮิโซกะ	hisoka	Nan	hisoka
ฮิโรชิ	hiroshi	Nan	hiroshi
ฮีชอล	heechul	Nan	heechul
ฮุก	hook	Nan	hook
ฮโยยอน	hyoon - a dancer from japan	Nan	hyoyeon
ฯพณฯ	two thai alphabets.  abbreviation that means many things	Nan	his excellency
เกตส์	gates	Nan	gates
เกตุทัต	kettut - a surname	Nan	ketthat
เกมที่	game number _________	Nan	the game
เกมบุค	game book	Nan	game
เกรย์	gray	Nan	gray
เกษตรกรรม	agriculture	Nan	agriculture
เกษตรวิสัย	kasetvisai (name of thai district)	Nan	kaset wisai
เกษมศรี	kasemsri surname	Nan	kasemsri
เกอริง	the name 'gerring'	Nan	gering
เกอไทต์	goethite mineral	Nan	goethe
เกาหลีใต้	south korea	Nan	south korea
เกียรติศักดิ์	reputation.  kietisak can be a male's name	Nan	glory
เกียรติประวัติ	honor	Nan	honor
เกียรติ	honor	Nan	honor
เกิดนิมิตร	caused a vision/realization	Nan	create a vision
เกิดจากเชื้อไวรัส	caused by virus	Nan	caused by virus
เกิดจากการรวมตัวของ	combination of	Nan	caused by the incorporation of
ฮิวงะ	hewnga - a japanese name from a story	Nan	hyuga
เกิดจากการรวมชิ้นส่วนที่	put together to form something	Nan	caused by combining parts that
เกิดขึ้นหลังจากมหาวิทยาลัยศรีนครินทรวิโรฒวิทยาเขตต่างๆ	happened after srinakarinviroj university started	Nan	occurred after srinakharinwirot university
เกิด	born	Nan	was born
เกาะสุมาตรา	sumatra	Nan	sumatra
เกาะลูซอน	luzon island	Nan	luzon island
เกาะคา	ko kha	Nan	kauai
เกาะ	island	Nan	island
เกิดขึ้นเมื่อวันที่	birthdate	Nan	occurred on
อู	ou	Nan	ou
ฮิราโกะ	hirako	Nan	hirako
ฮินาตะ	hinada - a japanese story	Nan	hinata
อเมริกัน	american	Nan	american
อเมริกา	america	Nan	america
อเมริกาเหนือ	north america	Nan	north america
อเล็กซานเดอร์	alexander	Nan	alexander
อเล็กซ์	alex	Nan	alex
อโลหะ	nonmetal	Nan	non-metal
อ่อนเพลีย	fatigue	Nan	tired
อ่าน	read	Nan	read
อ่าวลึก	ao luek	Nan	ao luek
อ้างว่า	claim that	Nan	claim that
อ้างว้าง	loneliness	Nan	desolate
ฮอกกี้	hockey	Nan	hockey
ฮอท	hot	Nan	hot
ฮอฟมัน	hoofman - a name	Nan	hoffman
ฮอยเกนส์	huygens	Nan	hogens
ฮอร์โมน	hormone	Nan	hormone
ฮอลแลนด์	holland	Nan	holland
ฮิตเลอร์	hitler	Nan	hitler
ฮิซานะ	hisana	Nan	hisana
ฮิซาชิ	hitachi	Nan	hisashi
ฮาวาย	hawaii	Nan	hawaii
ฮารุกะ	haruka - a japanese name	Nan	haruka
ฮายาโตะ	hayada - a japanese surname	Nan	hayato
ฮิมาวาริ	himawari - a japanese surname	Nan	himawari
ฮานอย	hanoi	Nan	hanoi
ฮาจิ	haji	Nan	hachi
ฮัมบูร์ก	hamburg	Nan	hamburg
ฮันกึล	hangeul	Nan	hangul
ฮักบี้	goodbye	Nan	goodbye
ฮอว์ค	hawk	Nan	seahawks
ฮอลโลว์	hollow	Nan	hollow
ฮาตาเกะ	hatake	Nan	hatake
อำเภอแจ้ห่ม	chae hom district	Nan	chae hom district
อำเภอเสริมงาม	soem ngam district	Nan	soem ngam district
อำเภอเวียงแก่น	wiang kaen district	Nan	wiang kaen district
อานโตนิโอ	antonio	Nan	antonio
อาบาราอิ	abarai	Nan	abarai
อายุ	age	Nan	age
อารยา	araya	Nan	araya
อาร์	r.	Nan	r
อาร์กอน	argon	Nan	argon
อาร์คิมิดีส	archimedes	Nan	archimedes
อาร์ม	arm	Nan	arm
อาร์มาดิลโล	armadillo	Nan	armadillo
อาร์เคด	arcade	Nan	arcade
อาร์เมเนีย	armenia	Nan	armenia
อาร์เอ็นเอ	rna	Nan	rna
อาร์โนลด์	arnold	Nan	arnold
อาวุธคือ	type of weapons	Nan	weapon is
อาวุธประจำกาย	personal weapon	Nan	personal weapon
อาหาร	food	Nan	food
อาเจียน	vomit	Nan	vomit
อำเภอดอยสะเก็ด	doi saket district	Nan	doi saket district
อำเภอจอมทอง	jom thong district	Nan	chom thong district
อำเภอคูเมือง	khu mueang district	Nan	khu mueang district
อำเภอครบุรี	amphur kornburi	Nan	khon buri district
อำเภอขุนหาญ	amphur kunhan	Nan	khun han district
อำเภอขุขันธ์	khukhan district	Nan	khukhan district
อานุภาพ	power	Nan	power
อำเภอกันทรลักษ์	kantharalak district	Nan	kantharalak district
อำเภอกมลาไสย	kamalasai district	Nan	kamalasai district
อำเภอ	district	Nan	district
อำนาจอธิปไตย	sovereignty	Nan	sovereignty
อำนาจ	power	Nan	power
อาเนีย	anya	Nan	ana
อาเธอร์	arthur	Nan	arthur
อำเภอกระสัง	krasang district	Nan	krasang district
อำเภอด่านขุนทด	dan koontod district	Nan	dan khun thot district
อานันทมหิดล	ahnanmahidol - someone with the king's surname	Nan	ananda mahidol
อาทิตย์	sunday	Nan	week
อันได้แก่	which are	Nan	including
อัฟกานิสถาน	afghanistan	Nan	afghanistan
อัมพร	umpon - a female's name	Nan	amporn
อัมพาต	paralysis	Nan	paralysis
อัลบัส	albus in harry potter stories	Nan	albus
อัลบั้ม	album	Nan	album
อัลเดบารัน	arudebaran	Nan	aldebaran
อัลเฟรด	alfred	Nan	alfred
อัสนี	thunderbolt	Nan	bolt
อาการหวาดระแวง	paranoia	Nan	paranoia
อากาศ	air, weather	Nan	air
อากาศอำนวย	akat amnuai	Nan	weather
อากาเป	agape	Nan	agape
อาคามัตสึ	akamatsi	Nan	akamatsu
อาคารส่วนที่	part (insert number) of the the building	Nan	building section
อาคารอุบลรัตนราชกัญญา	buildings outside ubon ratana graz contract.	Nan	ubonratana ratchakanya building
อาคารเฉลิมพระเกียรติ	chalermphrakiat building	Nan	chaloem phrakiat building
อาทิ	such as	Nan	such as
อาดัม	adam	Nan	adam
อาณาเขตติดต่อ	adjoining parcel	Nan	contact area
อาณาจักรแพกเจ	pakja territory	Nan	pakae kingdom
อาณาจักรอยุธยาเริ่มเสื่อมอำนาจลงราวพุทธศตวรรษที่	ayutthaya kingdom had started to downfall around 24 b.e.	Nan	the ayutthaya kingdom began to decline in power around the buddhist century.
อาณาจักรอยุธยาปกครองเขมรเป็นเวลาเกือบปี	ayutthaya dynasty had colonized khmer for almort 400 years	Nan	the ayutthaya kingdom ruled cambodia for almost a year.
อานนท์	anon	Nan	anon
อาณาจักรสุโขทัย	sukhothai kingdom	Nan	sukhothai kingdom
อาณาจักร	kingdom	Nan	kingdom
อาณัตพล	arnattapon	Nan	anataphon
อาซึกะ	asuka	Nan	asuka
อาจารย์ใหญ่	headmaster	Nan	headmaster
อาจารย์	professor	Nan	professor
อาจหมายถึง	may also mean	Nan	may mean
อาณาจักรธนบุรี	thonburi empire	Nan	thonburi kingdom
อำเภอตะพานหิน	taphan hin district	Nan	taphan hin district
อำเภอทับคล้อ	amphoe tap khlo	Nan	thap khlo district
อำเภอทุ่งช้าง	thung chang district	Nan	thung chang district
อำเภอศรีเมืองใหม่	sri meung mai district	Nan	si mueang mai district
อำเภอสระโบสถ์	sa bot district	Nan	sra church district
อำเภอสหัสขันธ์	sahuskhan district	Nan	sahatsakhan district
อำเภอสองแคว	song khwae district	Nan	song khwae
อำเภอสังขะ	sangkha district	Nan	sangkha district
อำเภอสันป่าตอง	san pa tong district	Nan	san pa tong district
อำเภอสามพราน	sam pran area	Nan	sam phran district
อำเภอสารภี	sarape district	Nan	saraphi district
อำเภอสิชล	sichon district	Nan	sichon district
อำเภอสุไหงโกลก	amphoe su-ngai kolok	Nan	sungai kolok district
อำเภอหนองกี่	nong kee district	Nan	nong ki district
อำเภอห้วยราช	huai rat district	Nan	huai rat district
อำเภออมก๋อย	om koi district in chiang mai, thailand	Nan	omkoi district
อำเภอเกาะคา	amphoe ko kha	Nan	ko kha district
อำเภอเขวาสินรินทร์	khwao sinarin district	Nan	khwao sinarin district
อำเภอเฉลิมพระเกียรติ	amphur chalermprakiet	Nan	chaloem phrakiat district
อำเภอเชียงของ	chiang khong district	Nan	chiang khong district
อำเภอเวียงชัย	wiang chai district	Nan	wiang chai district
อำเภอเมืองเพชรบุรี	pechaburi province	Nan	mueang phetchaburi district
อำเภอเมืองเชียงใหม่	mung chiang mai district	Nan	mueang chiang mai district
อำเภอเมืองอุตรดิตถ์	mueang uttaradit district	Nan	mueang uttaradit district
อำเภอเมืองสุรินทร์	surin province	Nan	mueang surin district
อำเภอเมืองลพบุรี	lopburi province	Nan	mueang lop buri district
อำเภอศรีณรงค์	si narong district	Nan	si narong district
อำเภอเมืองพิษณุโลก	ampore maung pisanulok	Nan	mueang phitsanulok
อำเภอเมืองบุรีรัมย์	burerum province	Nan	mueang buri ram district
อำเภอเมืองนนทบุรี	nontaburi district	Nan	mueang nonthaburi district
อำเภอเมืองนครราชสีมา	mueang nakhon ratchasima district	Nan	mueang nakhon ratchasima district
อำเภอเมืองกาฬสินธุ์	mueang kalasin provincial district	Nan	mueang kalasin
อำเภอเชียรใหญ่	chien yai district in thailand	Nan	chian yai district
อำเภอเชียงคาน	chiang khan district	Nan	chiang khan district
อำเภอเมืองพิจิตร	mueang phichit district	Nan	mueang phichit district
อำเภอลำปลายมาศ	lam plai mat district	Nan	lam plai mat district
อำเภอลาดหลุมแก้ว	lat lum kaeo district	Nan	lat lum kaeo district
อำเภอร่อนพิบูลย์	ron phibun district	Nan	ron phibun district
อำเภอบ้านลาด	ban lat district	Nan	ban lat district
อำเภอบางเสาธง	bang sao thong district	Nan	bang sao thong district
อำเภอบางละมุง	bang lamung district	Nan	bang lamung district
อำเภอบางพลี	bang plee district	Nan	bang phli district
อำเภอบางบ่อ	bang bo district	Nan	bang bo district
อำเภอบางบัวทอง	bang bua thong district	Nan	bang bua thong district
อำเภอบ้านหมี่	ban mi district	Nan	ban mi district
อำเภอบัวใหญ่	amphoe buayai (buayai district)	Nan	bua yai district
อำเภอน้ำเกลี้ยง	amphur namleang	Nan	nam kliang district
อำเภอนาบอน	nabon district	Nan	na bon district
อำเภอนครชัยศรี	nakhon chai si district	Nan	nakhon chai si district
อำเภอท่าวุ้ง	tha wung district	Nan	tha wung district
อำเภอท่าวังผา	tha wang pha district	Nan	tha wang pha district
อำเภอท่าตูม	ta toom district	Nan	tha tum district
อำเภอบัวเชด	buachet district	Nan	buachet district
ส่วนส่งกำลังบำรุง	supply center	Nan	logistics section
อำเภอปราสาท	prasat district	Nan	prasat district
อำเภอปากพนัง	pak phanang district	Nan	pak phanang district
อำเภอราษีไศล	rasi salai district	Nan	rasi salai district
อำเภอรัตนบุรี	rhatanaburi district	Nan	rattanaburi district
อำเภอรหัสไปรษณีย์หมายเหตุ	district, post code, note	Nan	district, postcode, note
อำเภอยางชุมน้อย	choom noi province	Nan	yang chum noi district
อำเภอภูสิงห์	aumphor phu sing (name of district)	Nan	phu sing district
อำเภอพุทธมณฑล	ampore phuthamontol	Nan	phutthamonthon district
อำเภอปากช่อง	pak chong district	Nan	pak chong district
อำเภอพิปูน	phipun district	Nan	phipun district
อำเภอพลับพลาชัย	plubplachai province in thailand	Nan	phlapphla chai district
อำเภอพระสมุทรเจดีย์	samutjadee district	Nan	phra samut chedi district
อำเภอพระพรหม	pra phrom province	Nan	phra phrom district
อำเภอพระประแดง	pra-pradaeng district	Nan	phra pradaeng district
อำเภอฝาง	fang district	Nan	fang district
อำเภอปาย	pai district	Nan	pai district
อำเภอพัฒนานิคม	amphur pattananikhom	Nan	phatthana nikhom district
เกียวโตะ	kyoto	Nan	kyoto
ส่วนสูง	height	Nan	height
ส่วนของผู้ถือหุ้น	shareholder fund	Nan	shareholders&#39; equity
วิลเลียม	william	Nan	william
วิลเลี่ยม	william	Nan	william
วิวัฒนาการ	evolution	Nan	evolution
วิวัฒน์	produce, making up, invent	Nan	evolve
วิวัฒน์เกียรติ	wiwatkiat	Nan	wiwat kiat
วิศว	engineering	Nan	engineering
วิศวกร	engineer	Nan	engineer
วิศวกรรมวัสดุ	material engineering	Nan	material engineering
วิศวกรรมสิ่งแวดล้อม	environmental engineering	Nan	environmental engineering
วิศวกรรมเครื่องกล	engineering	Nan	mechanical engineering
วิศวกรรมไฟฟ้า	electrical engineering	Nan	electrical engineering
วิสา	wisa	Nan	wisisa
วิสูตร	wisut	Nan	diagnostic
วิหาร	vihara	Nan	sanctuary
วิเศษ	magic	Nan	magic
วิเศษแก้ว	visetkeaw - surname of a singer	Nan	magic glass
วิโนทัย	winothai	Nan	vinothai
ศรีนครินทร์	srinakarin	Nan	srinakarin
ศรายุทธ	sarayut - a male's name	Nan	sarayuth
ศรชัย	sornchai - a male's name	Nan	sornchai
ศร	arrow	Nan	arrow
ศ	a thai alphabet	Nan	prof
ว้าวุ่น	wawun	Nan	distracted
วิลเลจ	village	Nan	village
วุฒิเมธี	wuttimethi - a surname	Nan	wuttimethi
วีออส	vios	Nan	vios
วีระยุทธ	werayut - a male's name	Nan	wirayut
วีระ	veera	Nan	veera
วีรบุรุษ	hero	Nan	hero
วีดีโอเกม	video game	Nan	video game
วีดีโอ	video	Nan	video
วุฒิสภา	senate	Nan	senate
ศรีนวล	sinuan	Nan	srinual
วิลลี่	willy	Nan	willy
วิบูลย์	goodbye	Nan	goodbye
วิตามินอี	vitamin e	Nan	vitamin e
วิทยาการคอมพิวเตอร์	computer science	Nan	computer science
วิทยาการระบาด	epidemiology	Nan	epidemiology
วิทยาลัยการจัดการเพื่อการพัฒนา	management for development college	Nan	college of management for development
วิทยาลัยการบริหารรัฐกิจ	management college	Nan	college of public administration
วิทยาลัยครูสวนสุนันทา	soun sunanta teachers college	Nan	suan sunandha teachers college
วิทยาลัยดุริยางคศิลป์	college of music	Nan	college of music
วิทยาลัยนวัตกรรมและการจัดการ	the college specialized in arts	Nan	college of innovation and management
วิทยาลัยพยาบาลกองทัพเรือ	royal thai navy college of nursing	Nan	naval nursing college
วิทยาลัยพยาบาลบรมราชชนนี	nursing university of barom raj chonnani	Nan	boromarajonani college of nursing
วิทยาลัยพาณิชยศาสตร์	panitsat university	Nan	college of commerce
วิทยาลัยวิชาการศึกษา	college of education	Nan	college of education
วิทยาลัยเทคนิคธนบุรี	king mongkut's university of technology thonburi	Nan	thonburi technical college
วิทยาลัยแพทยศาสตร์พระมงกุฎเกล้า	phramongkutklao college of medicine	Nan	phramongkutklao college of medicine
วิทยาศาสตรมหาบัณฑิต	master of science	Nan	master of science
วิทยาศาสตร์สุขภาพ	health science	Nan	health science
วิทยาศาสตร์และเทคโนโลยี	science and technology	Nan	science and technology
วินเนอร์	winner	Nan	winner
วินัย	manners	Nan	discipline
วินชี	vinci	Nan	vinci
วิธีการหาความสัมพันธ์	formula for the correlation coefficient	Nan	how to find relationships
วิทยุ	radio	Nan	radio
วิทยาเขตเฉลิมพระเกียรติ	vittaya kat chalerm pra kiet - a location at kasetsat university in thailand	Nan	chaloem phrakiat campus
วิมเบิลดัน	wimbledon	Nan	wimbledon
วิทยาเขตหนองคาย	nong khai campus	Nan	nong khai campus
วิทยาเขตสุพรรณบุรี	suphanburi campus	Nan	suphanburi campus
วิทยาเขตสารสนเทศเพชรบุรี	information technology college of petchaburi	Nan	phetchaburi information technology campus
วิทยาเขตพิษณุโลก	pissanulok college	Nan	phitsanulok campus
วิทยาเขตนครศรีธรรมราช	nakhon si thammarat campus	Nan	nakhon si thammarat campus
วิทยาเขตกาญจนบุรี	kanchanaburi college	Nan	kanchanaburi campus
วิทยาเขต	campus	Nan	campus
วิทยาเขตสุรินทร์	surin campus	Nan	surin campus
วิดีโอเกม	video game	Nan	video game
ศรีบุญเรือง	si bun rueang	Nan	sri bunrueang
ศรีปาน	sri pan - a surname	Nan	sri pan
ศึกษาศาสตร์	field of education	Nan	education
ศุกลวัฒน์	sukolawat (a person's name)	Nan	sukonwat
ศุภกิจ	supphakit	Nan	supakit
ศุภณัฐ	supanat (first name)	Nan	suphanat
ศูนย์	center	Nan	center
ศูนย์การค้า	shopping center	Nan	shopping center
ศูนย์การบินทหารบก	marine forces	Nan	army aviation center
ศูนย์การศึกษาแม่ฮ่องสอน	maehongsorn learning center	Nan	mae hong son education center
ศูนย์คอมพิวเตอร์	computer center	Nan	computer center
ศูนย์ค้าส่ง	wholesale center	Nan	wholesale center
ศูนย์บริการวิชาการ	academic service center	Nan	academic service center
ศูนย์ภาษา	language center	Nan	language center
ศูนย์รังสิต	rangsit university center	Nan	rangsit center
ศูนย์ลำปาง	lampang center	Nan	lampang center
ศูนย์แพทยศาสตรศึกษาชั้นคลินิก	medical education center	Nan	clinical education center
สก	abbreviation of two letters	Nan	screw
สกว	trf	Nan	trf
สง่าพล	sangapol - a thai surname	Nan	elegant
สงครามเย็น	cold war	Nan	cold war
สงครามเกาหลี	korean war	Nan	korean war
สงครามอวกาศ	space war	Nan	space war
สงครามมหาเอเชียบูรพา	world war two	Nan	the great east asia war
สงครามครูเสด	crusades war	Nan	crusade
ศึกนันทบุเรง	suknuntabureng -  a war in thailand	Nan	nanthabureng battle
สงคราม	war	Nan	war
สกุลเพชรหึง	grammatophyllum	Nan	petcheng
สกุลหยาดน้ำค้าง	d. etrythrorhiza - a type of plant	Nan	sundew
สกุล	family	Nan	family
สกาย	sky	Nan	sky
สกอตแลนด์	scotland	Nan	scotland
สกอ	scotland	Nan	scotland
สควอโล่	squalo	Nan	squalo
ศรีประจวบ	siprachuap	Nan	si prachuap
ศีรษะ	head	Nan	head
ศิษย์เก่าคณะรัฐศาสตร์	faculty of political science alumni	Nan	faculty of political science alumni
ศรีมะฆะ	sirimaka - a thai name	Nan	sri makha
ศรียาภัย	siyaphai	Nan	sriyapai
ศรีสวัสดิ์	srisawat	Nan	srisawat
ศรีสำโรง	si samrong	Nan	si samrong
ศรีเมือง	srimuang	Nan	sri mueang
ศรีไพร	sri prai - a name	Nan	sri phrai
ศรเพชร	sonpet	Nan	diamond arrow
ศศิธร	sasitorn - a females name	Nan	sasithorn
ศักดิ์ศรี	dignity	Nan	prestige
ศักย์ไฟฟ้า	electric potential	Nan	electric potential
ศัพท์	terminology	Nan	terminology
ศาลชั้นต้น	curcuit court	Nan	civil court
ศาลหลักเมือง	city pillar shrine	Nan	city pillar shrine
ศาลเจ้าพ่อหลักเมือง	city pillar shrine	Nan	city pillar shrine
ศาสตราจารย์	professor	Nan	professor
ศาสนา	religion	Nan	religion
ศาสนาพราหมณ์ฮินดู	hinduism	Nan	hinduism
ศิษย์เก่าคณะมนุษยศาสตร์	former humanity student	Nan	faculty of humanities alumni
ศิลป์	silpa	Nan	art
ศิลปินแห่งชาติ	national artist	Nan	national artist
ศิลปะเชียงแสน	chaingsan art	Nan	chiang saen art
ศิลปะเครื่องปั้นดินเผา	pottery art	Nan	pottery art
ศิลปะเขมร	cambodian arts	Nan	khmer art
ศิษย์เก่าคณะเศรษฐศาสตร์	economics alumni	Nan	faculty of economics alumni
ศิลปะศรีวิชัย	arts from sri vi chai province	Nan	srivijaya art
ศิลปะการแสดง	performing arts	Nan	performance art
ศิลปะ	arts	Nan	art
ศิลปอาชา	silpa-archa	Nan	art archa
ศิริวรรณ	siriwan - a female's name	Nan	siriwan
ศาสนาโซโรอัสเตอร์	zoroastrianism	Nan	zoroastrianism
ศาสนาฮินดู	hinduism	Nan	hinduism
ศิลปะลพบุรี	lopburi art	Nan	art lopburi
สด	fresh	Nan	fresh
วิฑูรย์	witoon	Nan	lapis lazuli
วิชิต	wichit - a male's name	Nan	wichit
วง	band	Nan	loop
วงจรไฟฟ้า	electric circuit	Nan	electric circuit
วงดนตรี	band	Nan	band
วงศ์กำแหง	family	Nan	family
วงศ์ถั่ว	fabaceae	Nan	nut family
วงศ์ปลากดทะเล	ariidae	Nan	fish family
วงศ์ปลากะรัง	serranidae family	Nan	grouper
วงศ์ปลายอดม่วง	tonguefish	Nan	wong pla yot muang
วงศ์ปลาหลังเขียว	clupeidae - a type of fish	Nan	green fish
วงศ์ปลาเนื้ออ่อน	siluridae	Nan	cichlid
วงศ์ปลาเสือตอ	datnioididae	Nan	tiger fish family
วงศ์พัวพันธ์	wongpourpan	Nan	wongpua phan
วงศ์วิริยะ	vongsiriya - a surname	Nan	wiriya
วงศ์เทวัญ	family	Nan	family
วงศ์แคหางค่าง	plants in kae-hang-kang family	Nan	wong khae hang kong
วงษ์คำเหลา	wongkamlao	Nan	wong kham lao
วงเงิน	budget	Nan	limit
วองโกเล่แฟมิลี	vongola family	Nan	vongola family
วอก	monkey	Nan	monkey
วว	office of ____________	Nan	dd
วรัทยา	varattaya (first name)	Nan	warutya
วรรธนพิสิฐกุล	wanthanaphisitkun	Nan	watthon phisitkun
วรรณสุทธิ์	wannasut - surname of an actress	Nan	wansut
ล้อแม็กซ์อัลลอยขนาด	alloy wheel	Nan	alloy wheels, size
วรรณกรรม	literature	Nan	literature
วนิดา	wanida - the name of a drama	Nan	wanida
วนอุทยานถ้ำจัน	tham chan forest park	Nan	tham chan forest park
วทบ	bachelor of science	Nan	dd
วชิรบรรจง	wachirabunjong	Nan	wachirabunjong
วงแหวน	ring	Nan	ring
วงเวียน	circle	Nan	roundabout
วร	won	Nan	wor
วอชิงตัน	washington	Nan	washington
ล้อม	lom	Nan	around
ล่าทา	lata	Nan	hunting
ลานจาตุรงคสันนิบาต	lan jaturonsunnibat - an ancient place in india	Nan	quadrangle
ลามิวูดีน	lamivudine	Nan	lamiwooden
ลายน้ำ	watetmark	Nan	watermark
ลาว	laos	Nan	laos
ลาออก	resign	Nan	resign
ลำดับ	order	Nan	order
ลำดับพระปฐมวงศ์ในพระบรมราชวงศ์จักรี	order of the kings	Nan	order of the genesis in the chakri dynasty
ลำดับพระมหากษัตริย์ไทย	the order of the kings of thailand	Nan	order of the thai king
ลำตัว	body	Nan	trunk
ลำลูกกา	lumlookka - a location in thailand	Nan	lam luk ka
ลำลูกกาคลอง	lum luk kak klong	Nan	lam luk ka canal
ลำไส้เล็ก	small intestine	Nan	small intestine
ลิง	monkey	Nan	monkey
ลิซท์	(franz) liszt	Nan	liszt
ลิปปี	rippi - a surname	Nan	lip year
ลิพิด	lipid	Nan	lipid
ลิฟวิ่งมอลล์	living mall	Nan	living mall
ลูน่า	luna	Nan	luna
ลูซิเฟอร์	lucifer	Nan	lucifer
ลูกอัณฑะ	testicle	Nan	testicles
ลูกอม	candy	Nan	candy
ลูกสาว	daughter	Nan	daughter
ลูกปัด	beads	Nan	bead
ล่ำซำ	lumsum	Nan	lump
ลุงบุญมีระลึกชาติ	uncle boonmee who can recall his past lives	Nan	uncle boonmee recalling nation
ลี้	li	Nan	li
ลีเมอร์	lemur	Nan	lemur
ลีซอ	lisu	Nan	lisu
ลีกคัพ	league cup	Nan	league cup
ลิเทียม	lithium	Nan	lithium
ลิเก	like	Nan	musical folk drama
ลี้สุวรรณ	lisuwan	Nan	li suwan
วิญญาณ	soul	Nan	spirit
วอลท์	walt	Nan	walt
วะสี	wasee	Nan	wasi
วันพฤหัสบดี	thursday	Nan	thursday
วันพุธ	wednesday	Nan	wednesday
วันมหาสงกรานต์	songkran day	Nan	maha songkran day
วันละ	per day	Nan	a day
วันศุกร์	friday	Nan	friday
วันสงกรานต์	songkran day	Nan	songkran day
วันสำคัญ	important day	Nan	important day
วันสำคัญทางพุทธศาสนา	buddhist holidays	Nan	important buddhist day
วันหยุดราชการ	national holiday	Nan	public holiday
วันอังคาร	tuesday	Nan	tuesday
วันอาทิตย์	sunday	Nan	sunday
วันอาสาฬหบูชา	asalha puja	Nan	asanha bucha day
วันเกิด	birthday	Nan	birthday
วันเสาร์	saturday	Nan	saturday
วันแรม	day	Nan	day
วัย	age	Nan	aged
วัลลิโภดม	wanliphodom	Nan	walliphodom
วิชาการคอม	vcharkarn.com	Nan	academic computer
วิชาการ	academic	Nan	academic
วิจิตรศิลป์	fine art	Nan	fine arts
วิจัย	research	Nan	research
วิคตอเรีย	victoria	Nan	victoria
วิกตอร์	victor	Nan	victor
วันนี้ที่รอคอย	the day that one has been waiting for	Nan	waiting today
วาไรตี้	variety	Nan	variety
วาเรีย	varia	Nan	varia
วาลีน	valine - a type of protein	Nan	valine
วาลคิรี	valkyrie	Nan	valkyrie
วารินชำราบ	warinchamrap	Nan	warinchamrap
วานูอาตู	vanuatu, australia	Nan	vanuatu
วัสดุฟิสไซล์	fissile material	Nan	fissile material
วาเลนไทน์	valentine	Nan	valentine&#39;s
วอล์ค	walk	Nan	walk
วันที่เข้าฉาย	release date	Nan	release date
วันที่ขึ้นเครื่องหมาย	excluding dividend day	Nan	sign date
วัง	palace	Nan	palace
วังจันทร์	wang-chan	Nan	wang chan
วังสระปทุม	srapathum palace	Nan	sra pathum palace
วังสะพุง	wang saphung	Nan	wang saphung
วังหลัง	palace	Nan	palace
วังหิน	rock castle	Nan	stone palace
วัชรพล	watcharapol supermarket	Nan	watcharapol
วัฒนชัย	wattanachai - a surname	Nan	watthanachai
วัฒนธรรม	culture	Nan	culture
วัฒนวิทูกูร	watthanawithukun	Nan	wattanawitkun
วัฒนา	wattana	Nan	wattana
วัดกลาง	wat klang	Nan	medium temple
วัดป่าเลไลยก์วรวิหาร	wat palaylay	Nan	wat pa lelai worawihan
วัดพระธาตุดอยสุเทพราชวรวิหาร	wat pratatdoisuthep rachavoravihan - the temple erected on top of doi suthep in northern thailand	Nan	wat phra that doi suthep, ratchaworawihan
วัดพระฝางสวางคบุรีมุนีนาถ	prhafangsawangkaburimuninat temple	Nan	wat phra fang sangkhaburi muninat
วัดพระมหาธาตุวรมหาวิหาร	wat phramahathat woramahawihan	Nan	wat phra mahathat woramahaviharn
วัดพระยืนพุทธบาทยุคล	the standing buddha temple of puttabatyukol	Nan	wat phra yuen phutthayakhon
วันชัย	wanchai - a male's name	Nan	wanchai
วัน	day	Nan	day
วัตสัน	watson	Nan	watson
วัตต์	watt	Nan	watt
วัดโพธิ์	wat po - a thai temple	Nan	wat pho
วัดเจดีย์หลวง	wat pagoda	Nan	chedi luang temple
วันที่ออกอากาศชื่อตอนแขกรับเชิญ	when the invitation comes out	Nan	broadcast date, episode name, guest appearance
วัดหน้าพระธาตุ	wat na pra tat - a buddhist temple	Nan	na phra that temple
วัดสุทัศนเทพวรารามราชวรมหาวิหาร	wat sutatthepvararamrajavorimahavihan - a temple in thailand	Nan	suthasan thep wararam temple
วัดสองพี่น้อง	two siblings temple	Nan	song phi nong temple
วัดระฆังโฆสิตาราม	wat rakang kositaram (name of temple)	Nan	rakhangkosaram temple
วัดพระเชตุพนวิมลมังคลารามราชวรมหาวิหาร	wat pra chetpnvimolmungklaramrajavoramahavihan	Nan	phra chetuphon vimolmangklararam temple
วัดพระศรีรัตนมหาธาตุ	wat phra si rattana mahathat	Nan	wat phra si rattana mahathat
วัดพระลอย	wat phra loi	Nan	phra loi temple
วัดหนองเพียร	wat nong pien - a temple in thailand	Nan	nong phian temple
สตรอเบอรี่	strawberry	Nan	strawberry
สตรีวิทยา	satriwithaya	Nan	radiology
สติปัญญา	intelligence	Nan	intelligence
สารานุกรมไทยฉบับราชบัณฑิตยสถาน	thai's publication	Nan	thai encyclopedia royal institute edition
สารีวงษ์	sariwong	Nan	sareewong
สาวิตรี	sawitri	Nan	savitri
สาเหตุ	reasons	Nan	cause
สำนวนเก่า	old aphorism	Nan	old idiom
สำนักงานขนส่งกรุงเทพมหานครพื้นที่	thai general transport	Nan	bangkok area transport office
สำนักงานคณะกรรมการวัฒนธรรมแห่งชาติ	office of arts and culture preservation of thailand	Nan	office of the national culture commission
สำนักงานโครงการพัฒนาแห่งสหประชาชาติ	united nations development prograท	Nan	united nations development program office
สำนักระบาดวิทยา	bureau of epidemiology	Nan	bureau of epidemiology
สำนักราชเลขาธิการ	operation department of the king's palace	Nan	secretariat
สำนักวิทยบริการ	office of academic services	Nan	office of academic resources
สำนักหอสมุด	library	Nan	library
สำนักหอสมุดกลาง	the central library	Nan	central library
สำรวจ	investigate	Nan	survey
สำราญ	happily	Nan	gleefully
สำหรับ	for	Nan	for
สำหรับประเทศไทย	for thailand	Nan	for thailand
สินิทธา	sinitra - first name of an actor	Nan	zithitha
สินสมุทร	sihnsmut	Nan	sin samut
สินค้าอุปโภคบริโภค	consumer goods	Nan	consumer goods
สินค้าคงเหลือ	inventory	Nan	inventories
สิน	sin	Nan	sin
สิทธิมนุษยชน	human rights	Nan	human rights
สารานุกรมไทย	saranukromthai	Nan	thai encyclopedia
สิทธิ	rights	Nan	rights
สิงหไตรภพ	sing tri pop - a thai drama	Nan	singha tripop
สิงหาคม	august	Nan	august
สำโรง	sumrong - a location in thailand	Nan	samrong
สำเนียง	accent	Nan	accent
สำหรับในปี	for the year	Nan	for in the year
สำหรับใช้เป็นตราหัวหนังสือราชการไทย	emblem thailand garuda	Nan	for use as a seal for the thai government official letter
สิงโต	lion	Nan	lion
สิปปภาค	sippapak	Nan	zippy region
สารละลาย	solution	Nan	solution
สารพฤกษเคมี	phytochemical	Nan	phytochemistry
สาขาวิชาเคมี	department of chemistry	Nan	department of chemistry
สาขาวิชาเทคโนโลยีชีวภาพ	department of biotechnology	Nan	biotechnology program
สาขาวิชาเศรษฐศาสตร์	finance department	Nan	economics
สาขาศิลปะสถาปัตยกรรม	art and architecture branch	Nan	art architecture
สาขาสมุย	smui branch	Nan	samui branch
สาขาหัวหิน	hoa hin branch	Nan	hua hin branch
สาครสินธุ์	sakornsin - a surname	Nan	sakorn sin
สาทร	sathon	Nan	sathorn
สาธารณรัฐประชาชนจีน	people's republic of china	Nan	people&#39;s republic of china
สาธารณรัฐออสเตรีย	republic of austria	Nan	republic of austria
สาธารณรัฐอินโดนีเซีย	republic of indonesia	Nan	republic of indonesia
สาธารณรัฐเช็ก	czech republic	Nan	czech republic
สาธารณรัฐโดมินิกัน	dominican republic	Nan	dominican republic
สานติวัตร	santiwat	Nan	santiwat
สามก๊ก	three kingdom 'sam kok' - a thai legend	Nan	three kingdoms
สามชัย	samchai - a location in thailand	Nan	sam chai
สามชุก	sam chuk district	Nan	sam chuk
สารต้านอนุมูลอิสระ	antioxidants	Nan	antioxidants
สายเมืองทอง	muang thong line	Nan	mueang thong line
สายเดียว	single helix	Nan	single line
สายหมอก	fog	Nan	fog
สายสีม่วง	purple line	Nan	purple line
สายสีน้ำเงิน	blue line	Nan	blue line
สารภี	saraphi	Nan	saraphi
สายสีชมพู	pink line	Nan	pink line
สายรุ้ง	rainbow	Nan	rainbow
สายรัชกาลที่	family tree of king rama ...	Nan	late reign
สายการบิน	airlines	Nan	airlines
สามัญ	common	Nan	ordinary
สามอัศวินในจินตนาการ	sam assavin in jintanakan - the name of a japanese story	Nan	three fantasy knights
สามพราน	sampran	Nan	sampran
สายสนั่น	siasanan	Nan	thunder line
สาขาวิชาศิลปอุตสาหกรรม	arts department	Nan	art department
สิเรียม	syriam (name of city in myanmar)	Nan	sirium
สิ่งมีชีวิต	living things	Nan	living things
สุปรีย์	supri - a name	Nan	supri
สุพจน์	supot	Nan	suphot
สุพล	surapol	Nan	supon
สุมณทิพย์	sumonthip	Nan	sumonthip
สุรชาติ	surachart - a male's name	Nan	surachat
สุรพล	suraphol	Nan	surapon
สุรพันธ์	surapan - a male's name	Nan	suraphan
สุรวุฒิ	surawut	Nan	surawut
สุรศักดิ์	surasak	Nan	surasak
สุรัสวดี	suratsawadee - a thai surname	Nan	surasawadee
สุราษฎร์ธานี	surat thani	Nan	surat thani
สุรินทร์	surin - a place in thailand	Nan	surin
สุริยัน	suriyan - a male actor	Nan	suriyan
สุริโยไท	movie called "suriyothai"	Nan	suriyo thai
สุลต่าน	sultan	Nan	sultan
สุวนันท์	suwanan	Nan	suwanan
สุวรรณรัฐ	suwannarath	Nan	suwannarat
ส่งเสริม	promote	Nan	promote
สไตล์การเล่น	style	Nan	play style
สไตรค์	strike	Nan	strike
สเปน	spain	Nan	spain
สเตเดี้ยม	stadium	Nan	stadium
สเตอรอล	sterol	Nan	sterol
สุนัขจิ้งจอก	baby fox	Nan	the fox
สเตราส์	strauss.	Nan	strauss
สูงจากระดับน้ำทะเลปานกลาง	above average sea level	Nan	high above sea level
สูง	high	Nan	high
สุ่น	sun	Nan	sun
สุโขทัย	sukothai - ancient thailand	Nan	sukhothai
สุเทพ	suthep - first name of a famous singer	Nan	suthep
สุวรรณานนท์	suwannanon - a surname	Nan	suwannanon
สู่	to	Nan	to
สิ่ง	thing	Nan	thing
สุนทรเวช	surname "sundaravej"	Nan	sunthornwet
สุนทร	sunthon	Nan	sunthorn
สิ่งเสพติด	drug	Nan	drug
สิ้นพระชนม์ในรัชกาลที่	died in	Nan	died in the reign of
สี	color	Nan	color
สีขาว	white	Nan	white color
สีดำ	black color	Nan	black
สีน้ำตาล	brown color	Nan	brown color
สีน้ำเงิน	blue	Nan	blue
สีฟ้า	blue	Nan	blue
สีม่วง	purple	Nan	purple
สีลม	silom	Nan	windmill
สึนะ	tsuna	Nan	tsuna
สึนะโยชิ	tsunayoshi	Nan	tsunayoshi
สืบต่อมา	live on	Nan	inherit
สื่อสารมวลชน	mass communication	Nan	mass communication
สื่อสิ่งพิมพ์	printing media	Nan	print media
สุกิจ	sukit	Nan	sukit
สุขภาพ	health	Nan	health
สุธี	sutee - a male's name	Nan	scholar
สุทัศน์	sutas	Nan	suthat
สุทัศนะจินดา	sututnajinda - surname of a tv host	Nan	sutasachinda
สุทธิชัย	suttichai - a male's first name	Nan	sutthichai
สุดารัตน์	sudarat	Nan	sudarat
สุดสาคร	sootsakorn - a character in a thai legend	Nan	sudsakorn
สุนทรภู่	soontornpoo - a character from a legend	Nan	sunthorn phu
สุดท้ายตายด้วยฝีมือ	eventually dies at the hand of	Nan	finally, die by skill.
สุจาริณี	sujarinee	Nan	sucharinee
สุจริตกุล	sucharitkul	Nan	sucharitkun
สุครีพ	sugriva	Nan	sukree
สุขุมวิท	sukhumvit	Nan	sukhumvit
สุขาภิบาล	sukhapibal (name of district)	Nan	sanitary
สุขสวัสดิ์	suksawat	Nan	suksawat
สุชิน	suchin	Nan	suchin
สาขาวิชาวิศวกรรมอิเล็กทรอนิกส์	major electronic engineering	Nan	electronic engineering program
สาขาวิชาวิศวกรรมอาหาร	food engineering	Nan	food engineering
สาขาวิชาวิศวกรรมคอมพิวเตอร์	computer engineering	Nan	computer engineering program
สนิม	rust	Nan	rust
สนเกรวิลเลีย	grevilea - family of 250 types of plants	Nan	pine grapes
สปริงฟิลด์	springfield	Nan	springfield
สปรินเตอร์	sprinter	Nan	sprinter
สปาร์ค	spark	Nan	spark
สพ	oc	Nan	spec
สภานิติบัญญัติแห่งชาติ	national diet	Nan	national legislative assembly
สภาผู้แทนนิสิต	college student representatives	Nan	student representative council
สภาพอากาศ	weather conditions	Nan	the weather
สมจิตต์	somjit - a female's name	Nan	somchit
สมจิตร	somjit	Nan	somchit
สมชัย	somchai	Nan	somchai
สมชาย	somchai	Nan	somchai
สมภพ	sompob	Nan	birth
สมศรี	somsi	Nan	somsri
สมศักดิ์	somsak	Nan	somsak
สมัคร	samak	Nan	apply
สมเด็จพระนางเจ้าสิริกิติ์	queen sirikit	Nan	queen sirikit
สมเด็จพระนางเจ้ารำไพพรรณี	queen rambhai barni	Nan	queen rambhai barni
สมเด็จ	your highness	Nan	her majesty
สมุทวณิช	samudavanija	Nan	samutavanich
สมาชิกฤดูกาลที่	member of the parliament	Nan	season members
สมาชิกรับเชิญตอนพิเศษ	special guests	Nan	invited members to special episodes
สนิทวงศ์	there are families.	Nan	sanit wong
สมาคมประชาชาติแห่งเอเชียตะวันออกเฉียงใต้	association of south east asian nations (asean)	Nan	association of southeast asian nations
สมัยสุโขทัย	sukothai era	Nan	sukhothai period
สมัยรัชกาลที่	in the reign of	Nan	reign
สมัยที่	term	Nan	when
สมัยก่อนประวัติศาสตร์	prehistory	Nan	prehistoric times
สมัยกรุงธนบุรี	thonburi era	Nan	thonburi period
สมัย	period	Nan	period
สมัยอาณานิคมฝรั่งเศส	modern france	Nan	french colonial period
สมเด็จพระนางเจ้าฯ	the queen of thailand	Nan	her majesty
สนามไฟฟ้า	electric field	Nan	electric field
สนามฟุตบอล	football field	Nan	football field
สตึก	satuek	Nan	satuek
สตูดิโอ	studio	Nan	the studio
สถานที่ท่องเที่ยวทางธรรมชาติ	natural attraction	Nan	natural attractions
สถานะ	status	Nan	status
สถานีคาราวาน	caravan station	Nan	caravan station
สถานีวิทยุโทรทัศน์ไทยทีวีสีช่อง	thai television station number _____	Nan	thai television stations with color tv channels
สถานีโทรทัศน์ไทยพีบีเอส	thai public broadcasting service	Nan	thai pbs television station
สถาบัน	office, department	Nan	institution
สถาบันการศึกษา	educational institution	Nan	educational institution
สถาบันบัณฑิตพัฒนบริหารศาสตร์	satabunbunthitpakanabarihansart - a university in thailand, as known as nida	Nan	national institute of development administration
สถาบันพระบรมราชชนก	red cross department	Nan	royal institute
สถาบันวิจัยจุฬาภรณ์	julapon academy	Nan	chulabhorn research institute
สถาบันวิจัยและพัฒนา	reseach and development institution	Nan	research and development institute
สถาบันศูนย์และหน่วยงานในมหาวิทยาลัย	current faculties/college/school/institutes	Nan	institutions, centers, and departments in universities
สถาบันสมทบ	affiliated institute	Nan	associate institution
สถาบันอาชีวศึกษา	ahchevasuksa academy	Nan	vocational institute
สถาบันอุดมศึกษา	higher education institute	Nan	higher education institution
สนามชัยเขต	sanamchaikate - a location in thailand	Nan	sanam chai khet
สนามกีฬากลาง	main athletic field	Nan	central stadium
สนธิไชย	sontichai	Nan	sonthichai
สนธิ	sonti - a male's name	Nan	junction
สนธยา	twilight	Nan	twilight
สธ	two letters from thai alphabets	Nan	sth
สนามแม่เหล็ก	magnetic field	Nan	magnetic field
สถิติศาสตร์	statistic	Nan	statistics
สถาปนิก	architect	Nan	architect
สถาบันโภชนาการ	institute of nutrition	Nan	institute of nutrition
สถาบันเทคโนโลยีราชมงคล	rajamangala university of technology	Nan	rajamangala institute of technology
สถาบันเทคโนโลยีพระจอมเกล้าเจ้าคุณทหารลาดกระบัง	king mongkut's institute of technology ladkrabang	Nan	king mongkut&#39;s institute of technology ladkrabang
สถาบันเทคโนโลยีพระจอมเกล้า	king mongkut's institute of technology	Nan	king mongkut&#39;s institute of technology
สถาบันเทคโนโลยีนานาชาติสิรินธร	sirindhorn international institute of technology	Nan	sirindhorn international institute of technology
สถาปัตยกรรมไทย	architecture of thailand	Nan	thai architecture
สมเด็จพระบรมราชาที่	king	Nan	the king
สมเด็จพระบรมโอรสาธิราช	his highness, royal crowned prince	Nan	crown prince
สมเด็จพระบรมโอรสาธิราชฯ	the crown prince of thailand	Nan	crown prince
สะเดา	neem, a type of plant	Nan	neem
สัจธรรม	truth	Nan	truth
สัญญา	sanya	Nan	contract
สัญลักษณ์ประจำมหาวิทยาลัย	logo of the university	Nan	university logo
สัดส่วน	ratio	Nan	proportion
สัตว์	animal	Nan	animal
สัตว์มีกระดูกสันหลัง	vertebrates	Nan	vertebrates
สัตว์มีแกนสันหลัง	chordata	Nan	spine
สัตว์เลี้ยงลูกด้วยน้ำนม	mammal	Nan	mammals
สัตว์เลื้อยคลาน	reptile	Nan	reptile
สัตว์เลื้อยคลานในอันดับนี้	reptile in this order	Nan	reptiles in this rank
สัทศาสตร์	phonetics	Nan	phonetics
สันติ	peace	Nan	peace
สันติสุข	peace	Nan	peace
สัมผัสนอก	outside touch	Nan	external rhyme
สัมพันธ์	relationship	Nan	relationships
สัมมา	summa - the buddhist prayer often starts with this	Nan	right
สาขาวิชาวิทยาการคอมพิวเตอร์	school of computer science	Nan	computer science program
สาขาวิชารัฐประศาสนศาสตร์	local government	Nan	department of public administration
สาขาวิชาบริหารธุรกิจ	business administration program	Nan	business administration program
สาขาวิชานิติศาสตร์	law department	Nan	faculty of law
สาขาลำปาง	lumpang location	Nan	lampang branch
สาขาย่อย	offices	Nan	sub branch
สะล้อ	salao	Nan	brake
สาขามนุษยศาสตร์	humanities	Nan	humanities
สาขาปราจีนบุรี	pracheenburi branch	Nan	prachinburi branch
สาขาประจวบคีรีขันธ์	prachuap khiri khan branch	Nan	prachuap khiri khan branch
สาขานิเทศศาสตร์	faculty of communication arts	Nan	communication arts
สาขานครสวรรค์	nakhon sawan branch	Nan	nakhon sawan branch
สาขานครราชสีมา	nakhon ratchasima branch	Nan	nakhon ratchasima branch
สาขา	office location	Nan	branch
สาขาพิษณุโลก	pisanulok location	Nan	phitsanulok branch
สะตอ	sator	Nan	sato
สะดวก	convenient	Nan	easy
สอยดาว	soidao	Nan	uppercut
สร้าง	build	Nan	create
สราวุธ	sarawut	Nan	sarawut
สรรพสินค้า	department store	Nan	department store
สร	abbreviation for the royalties' accessories	Nan	create
สยามพารากอน	siam paragon	Nan	siam paragon
สยามบรมราชกุมารี	the current king's eldest daughter, the eldest princess	Nan	siam
สลักใจ	salakchai	Nan	impress
สยามดารา	siam stars	Nan	siam dara
สมเด็จพระเจ้าภคินีเธอ	the king's sister, som dej pra jao pakini ther	Nan	her royal highness
สมเด็จพระเจ้ากรุงธนบุรี	the king of the thonburi kingdom	Nan	krung thon buri
สมเด็จพระอนุชาธิราช	som dej pra ah nu cha thi raj - a famous royalty in thailand a long time ago	Nan	somdej anuchatthirat
สมเด็จพระศรีนครินทราบรมราชชนนี	queen sirikit	Nan	hrh princess maha chakri sirindhorn
สมเด็จพระรามาธิบดีที่	som dej pra rama tippadee #_____ , number of the king	Nan	king ramathibodi
สมเด็จพระมหิตลาธิเบศร	somdet phra mahitra thibet	Nan	somdet phra mahidol latibes
สมเด็จพระเจ้าลูกเธอ	the king's daughter, the princess	Nan	her royal highness
ส่วนต่อขยายบางซื่อท่าพระ	bang sue – tha phra expansion	Nan	extension bang sue tha phra
สวนดุสิตโพล	suan dusit poll	Nan	suan dusit poll
สวนสมเด็จพระศรีนครินทร์	pra sri nakarin - a king of thailand	Nan	somdet phra srinagarindra park
สองสาย	double-stranded	Nan	two wires
สหวงษ์	sawong - a male's name	Nan	sahawong
สหราชอาณาจักร	united kingdom	Nan	united kingdom
สหรัฐอเมริกา	america, usa	Nan	u.s.
สหรัฐอาหรับเอมิเรตส์	arab emirate	Nan	united arab emirates
สหพันธ์สาธารณรัฐเยอรมนี	germany	Nan	federal republic of germany
สวนผึ้ง	bee garden	Nan	suan phueng
สส	representatives	Nan	secret
สวิตเซอร์แลนด์	switzerland	Nan	switzerland
สวัสดีปีใหม่	happy new year	Nan	happy new year
สวัสดิ์	sawat	Nan	sawat
สวรรคโลก	sawankhalok	Nan	sawankhalok
สวรรคตหรือ	die or ___________	Nan	passed away
สวรรคต	die	Nan	pass away
สวี	sawi	Nan	suites
ลา	goodbye	Nan	la
เก็กโค	gecko	Nan	checco
เขตจอมทอง	jomthong area	Nan	chom thong district
โชอิจิ	shoichi	Nan	shoichi
โชแปง	chopin	Nan	chopin
โซน	zone	Nan	zone
โซนยอชิแด	senyosede - a japanese name	Nan	girls&#39; generation
โซนี่	sony company	Nan	sony
โซล	seoul	Nan	seoul
โซลดิ๊ก	sol-dig	Nan	soldick
โซลโซไซตี้	soul society	Nan	soul society
โซเดียม	sodium	Nan	sodium
โซเฟีย	sofia	Nan	sofia
โดจินชิ	dōjinshi	Nan	do jinchi
โดย	by	Nan	by
โดยคำว่า	by the word	Nan	by the word
โดยตรง	directly	Nan	directly
โดยทรงพระกรุณาโปรดเกล้าฯ	the king's order	Nan	graciously granted by his majesty
โดยที่	by	Nan	where
โดยบ่งบอกถึงปริมาณและคุณภาพของสิ่งตีพิมพ์อิเล็กทรอนิกส์ของสถาบัน	stating the limitation and quality of a product	Nan	by indicating the quantity and quality of the electronic publications of the institute
โดเมกิ	domagi - a japanese word.	Nan	domome
โดราเอมอนฉบับภาพยนตร์	doraemon movie edition	Nan	doraemon movie edition
โดยในวันที่	on the date of ___	Nan	by on
โดยใช้ทางหลวงแผ่นดินหมายเลข	using freeway #________	Nan	by national highway
โดยใช้ชื่อว่า	using name	Nan	by name
โดยเจ้าฟ้าธรรมธิเบศรไชยเชษฐสุริยวงศ์	the name of a king	Nan	by prince thamathibet sornchai chetchasuriyawong
โชว์	show	Nan	show
โดยสรุป	in summary.	Nan	in summary
โดยมีพระภิกษุสงฆ์นำเวียนเทียน	buddhist monks performing ceremony for vientien buddhist religious holiday	Nan	with a monk leading a candle lit procession
โดยมีตัวอย่างบทพากย์ฉบัง	background movie in music video	Nan	with examples of poems
โดยมี	with	Nan	with
โดยปกติแล้ว	normally	Nan	normally
โดยปกติตามวัดต่าง	normally, at the various temples...	Nan	usually according to different temples
โดยปกติ	normally	Nan	normally
โดยราชบัณฑิตยสถาน	by royal institute	Nan	by the royal institute
โดเมน	domain	Nan	domain
โชคดี	lucky	Nan	good luck
โจโจ้	jojo	Nan	jojo
แฮปปี้และชาร์ล	happy and charles	Nan	happy and charles
แฮ็ค	hack	Nan	hacking
โกบอล	cobalt	Nan	global
โกร	guro	Nan	grow
โกรกพระ	krok-phra	Nan	crevice
โกลด์	gold	Nan	gold
โกวิท	kowit	Nan	kowit
โกโก้	cocoa	Nan	cocoa
โขน	khon	Nan	pantomime
โคกสำโรง	khok samrong	Nan	khok samrong
โคนัน	conan	Nan	conan
โคฟี	kofe annan	Nan	kofi
โครงการ	project	Nan	project
โครงการก่อสร้าง	construction project	Nan	construction project
โครงการนานาชาติ	international program	Nan	international project
โครงการศิลปินแห่งชาติ	national artist project	Nan	national artist project
โครงการเรียนภาษาอังกฤษแบบเข้ม	intensive english program	Nan	intensive english learning program
โจเซฟ	joseph	Nan	joseph
โจจิ	choji	Nan	joji
โฆษิตพิพัฒน์	the surname kopitpipat	Nan	kosit phiphat
โฆษะ	kosa	Nan	vocalization
โคโทเน่ที่	kotone	Nan	kotone at
โคแทนเจนต์	cotangent	Nan	cotangent
โช	sho	Nan	cho
โคเบะ	kobe	Nan	kobe
โคล้ด	code	Nan	code
โคลอมเบีย	colombia	Nan	colombia
โคล	cold	Nan	cole
โครโมโซม	chromosome	Nan	chromosome
โคราช	khorat or nakorn rajjasrima state	Nan	korat
โครงสร้างภายใน	internal structure	Nan	internal structure
โคเคน	cocain	Nan	cocaine
แฮปปี้	happy	Nan	happy
โต	big	Nan	grown up
โทน	tone	Nan	tone
โฟโตสเฟียร์	photosphere	Nan	photo spheres
โมซาร์ท	mozart	Nan	mozart
โมบิลสูทกันดั้ม	mobile suit gundam	Nan	mobile suit gundam
โมรา	agate	Nan	chalcedony
โมร็อกโก	morocco	Nan	moroccan
โมลิบดีนัม	molybdenum	Nan	molybdenum
โมฮัมหมัด	mohamad	Nan	mohammad
โมเดิร์น	modern	Nan	modern
โมเต็ต	motet (sound)	Nan	motate
โมเลกุล	molecule	Nan	molecules
โมโคนะ	mokona - a japanese word	Nan	mokona
โมโนไซต์	mono site.	Nan	mono site
โยชิโนะ	yoshino	Nan	yoshino
โยฮันน์	johann	Nan	johann
โยเซฟ	joseph	Nan	joseph
โรค	disease	Nan	disease
โรคประจำตัว	personal illness	Nan	congenital disease
โรงเรียนนนทรีวิทยา	nontrivittaya school	Nan	nonsi witthaya school
โรงเรียนดาราวิทยาลัย	dara academy	Nan	dara college
โรงเรียนการบิน	flight school	Nan	flight school
โรงละคร	theater	Nan	the theater
โรงพยาบาลอุตรดิตถ์	uttaradit hospital	Nan	uttaradit hospital
โรงพยาบาลอานันทมหิดล	ananthamahidol hospital	Nan	anandamahidol hospital
โฟลเอ็ม	phloem	Nan	flo m
โรงพยาบาลรามาธิบดี	ramathibodi hospital	Nan	ramathibodi hospital
โรงพยาบาลกรุงเทพ	krung thep hospital	Nan	bangkok hospital
โรคไต	kidney disease	Nan	kidney disease
โรคเกาต์	gout	Nan	gout
โรคุโด	rokudo	Nan	rokudo
โรคออทิซึม	autism	Nan	autism
โรคปอดบวม	pneumonia	Nan	pneumonia
โรงพยาบาลจุฬาลงกรณ์	king chulalongkorn memorial hospital	Nan	king chulalongkorn memorial hospital
โตชิบา	toshiba	Nan	toshiba
โฟลต	float	Nan	float
โพรทิสต์	protist	Nan	protist
โทนะหงษา	tonahongsa - a surname	Nan	tonahahasa
โทนี่	tony	Nan	tony
โทบรามัยซิน	tobramycin	Nan	tobramamcin
โทมัส	thomas	Nan	thomas
โทรจัน	trojan	Nan	trojan
โทรลล์	troll	Nan	troll
โทริคาบูโตะ	torikabuto - a japanese word	Nan	torikabuto
โทรโข่ง	a megaphone, portable sound directing equipment.	Nan	megaphone
โน	no	Nan	no
โนบิตะ	nobita	Nan	nobita
โนบิตะและอัศวินแดนวิหค	nobita and the winged braves	Nan	nobita and the knight
โนรา	nora	Nan	nora
โนะ	noh - a japanese word	Nan	dino
โนเบล	nobel	Nan	nobel
โบตั๋นกลีบสุดท้าย	botun kleep suttai - a novel	Nan	the last peony
โบราณสถาน	the ancient place	Nan	archaeological site
โบอิง	boeing company	Nan	boeing
โพนพิสัย	phonphisai	Nan	phon phisai
โพธิ์ศรี	phosi	Nan	phosri
โป๊	nude	Nan	nude
โปเกมอน	pokemon	Nan	pokemon
โปรโมชั่น	promotion	Nan	promotion
โปรแกรมคอมพิวเตอร์	computer program	Nan	computer program
โพแทสเซียม	potassium	Nan	potassium
โปรเจกต์พิเศษ	special project	Nan	special project
โปรตีน	protein	Nan	protein
โปรตอน	proton	Nan	proton
โปรดเกล้า	the king's order	Nan	please
โปงลางสะออน	pong langsaoun	Nan	ponglang sa-on
โบแดง	bodin	Nan	admirable
โบฮีเมีย	bohemia	Nan	bohemia
โปรเจกต์	project	Nan	project
โรงเรียนนายเรือ	royal thai naval academy	Nan	naval academy
แฮช	hash	Nan	hash
แอสซิสต์	assist	Nan	assist
แฟรี่	fairy	Nan	fairy
แฟรี่เทล	fairy tale	Nan	fairy tale
แมกนีเซียม	magnesium	Nan	magnesium
แมคอินทอช	mcintosh	Nan	macintosh
แมนดาริน	mandarin	Nan	mandarin
แมนเชสเตอร์	manchester	Nan	manchester
แมว	cat	Nan	cat
แมวป่า	jungle cat	Nan	wildcat
แมวลายหินอ่อน	pardofelis marmorata	Nan	marble tabby
แมวไทย	thai cat	Nan	thai cat
แม็คโคร	macro	Nan	makro
แม่	mother	Nan	mother
แม่จริม	mae charim	Nan	mother jim
แม่ชี	nun	Nan	nuns
แม่นาคพระโขนง	mae nak phra khanong	Nan	mae nak phra khanong
แม่น้ำ	river	Nan	river
แม่น้ำชี	chi river	Nan	chi river
แลมบ์ดา	lambda	Nan	lambda
แลกเปลี่ยนโดยถือ	exchange, conversion	Nan	exchange by holding
แร็ปเปอร์	rapper	Nan	rapper
แรงโน้มถ่วง	gravity	Nan	gravity
แย้มบุญเรือง	yaembunrueang	Nan	opting for merit
แย้มนาม	yamnam - a surname	Nan	name
แฟรงค์	frank	Nan	frank
แยกจากคลองบางกอกใหญ่ฝั่งซ้าย	forked from khlong bangkok yai	Nan	junction from the bangkok yai canal on the left
แยกจากคลองบางกอกน้อยฝั่งซ้าย	forks from the left branch of khlong bangkok noi	Nan	from the bangkok noi canal on the left
แยกจากคลองชักพระฝั่งซ้าย	forks from khlong chak phra	Nan	separate from chak phra canal on the left
แม่ริม	amphoe mae rim	Nan	mae rim
แม่น้ำโขง	mekong river	Nan	mekong river
แม่น้ำปิง	ping rover	Nan	ping river
แม่น้ำทะเลสาบสำคัญ	important rivers and lakes	Nan	important lake river
แยกจากคลองบางกอกใหญ่ฝั่งขวา	split from the bankok yai canal to the right	Nan	junction from the bangkok yai canal on the right
และ	and	Nan	and
แฟมิลีที่ไปพักผ่อนที่เกาะมาเฟีย	family that went to mafia island for vacation	Nan	family go to rest on the mafia island
แฟชั่น	fashion	Nan	fashion
แถบ	bar	Nan	bar
แทซิทัส	tacitus	Nan	tasitus
แทน	instead	Nan	represent
แทนเจนต์	tangent	Nan	tangent
แทยอน	taeyeon	Nan	taeyeon
แทลเลียม	thallium	Nan	thallium
แท็กซี่	taxi	Nan	taxi
แท็บเล็ต	tablet	Nan	tablet
แนท	nat	Nan	nat
แนวความคิดที่	idea number...	Nan	concept
แนวพระราชดำริ	royal initiative	Nan	royal initiative
แนสแด็ก	nasdaq	Nan	nasdaq
แบคทีเรีย	bacteria	Nan	bacteria
แบงค์	bank	Nan	bank
แบทเทิลบรอลเลอร์	battle brawlers	Nan	battle tanker
แบรนด์แอมบาสเดอร์	brand ambassador	Nan	brand ambassador
แบ่งประเทศไทยออกเป็น	dividing thailand into 6 areas	Nan	divide thailand into
แพ้	to lose	Nan	lose
แพะ	goat	Nan	goat
แพลทฟอร์ม	platform	Nan	platform
แพร่	the state of praa	Nan	spread
แพน	pan	Nan	pan
แพทย์	physician	Nan	physician
แฟนเก่า	ex boyfriend/girlfriend	Nan	ex girlfriend
แผลไหม้	burn	Nan	burns
แผนไพรีพินาศ	pan pirepinat - a plan to destroy the mobs	Nan	consortium plan
แผนที่	map	Nan	map
แป้ง	pang	Nan	flour
แบ่งได้เป็น	divided into	Nan	can be divided into
แบ่งออกได้เป็น	divided into	Nan	divided into
แบ่งออกเป็น	divided into	Nan	divided into
แผลศักดิ์สิทธิ์	stigmata	Nan	holy wound
แอสปาร์แตม	aspartame	Nan	aspartame
และกลายเป็นอู่ข้าวอู่น้ำที่มีชื่อเสียงของไทย	and becoming the futile land	Nan	and became a famous breadbasket in thailand
และครอบครัว	and family	Nan	and family
แสงสิงแก้ว	sangsingkaew	Nan	sang singkaew
แสงเทียน	saengthian	Nan	candlelight
แสตมป์	stamp	Nan	stamp
แสนรัก	love	Nan	love
แสนโภศิก	sankosuk - a surname	Nan	saen phosik
แหลมสิงห์	lam sing - a famous country singer in thailand	Nan	laem sing
แหล่งท่องเที่ยว	tourist attraction	Nan	tourist attraction
แหล่งโบราณคดีบ้านเชียง	ban chiang archaeological site	Nan	ban chiang archaeological site
แหวน	ring	Nan	ring
แหวนธรรมดา	ordinary ring	Nan	plain ring
แหวนมาเล่ริง	ring (faux jewelry)	Nan	malele ring
แห่งบันนัม	of bannam	Nan	of ban nam
แห่งสหประชาชาติ	united nations	Nan	united nations
แองกวิลลา	anguilla	Nan	anguilla
แองเจิ้ล	angel	Nan	angel
แอซิด	acid	Nan	acid
แอด	add	Nan	add
แอสกี	ascii	Nan	asci
แอลจีเรีย	algeria	Nan	algeria
แอล	l	Nan	l
แอร์ไลน์	airlines	Nan	airlines
แอมเวย์	amway	Nan	amway
แอมะซอน	amazon	Nan	amazon
แสงทอง	golden sun ray	Nan	sangthong
แอฟริกาใต้	south africa	Nan	south africa
แอนโทนี	anthony	Nan	anthony
แอนเนลิดา	annelida	Nan	annelida
แอนิเมชัน	animation	Nan	animation
แอนด์	and	Nan	and
แอนดี้	andy	Nan	andy
แอนดรอยด์	android	Nan	android
แอฟริกา	africa	Nan	africa
และกัมพูชา	and cambodia	Nan	and cambodia
แสงชูโต	sangchuto - a surname	Nan	chuto
แวน	wan	Nan	van
และคำว่า	and the word "......."	Nan	and the word
และจังหวัดใกล้เคียง	and nearby state	Nan	and nearby provinces
และดุษฎีบัณฑิต	honorary degree	Nan	and doctor of philosophy
และตามสภาพเศรษฐกิจและสังคม	and following the economy and social conditions	Nan	and according to the economic and social conditions
และตำแหน่ง	and position	Nan	and position
และที่สำคัญคือ	and important thing is...	Nan	and the important thing is
และธงของต่างประเทศ	and other countries' flags	Nan	and foreign flags
และปัจจุบัน	now	Nan	and present
และพรรคฟุนซินเปค	funcinpec	Nan	and the funchinpec party
และรถไฟ	and railways	Nan	and train
และรัสเซีย	and russia	Nan	and russia
และสหรัฐอเมริกา	in america	Nan	and the united states
และสังคม	and society	Nan	and society
และสังคมศาสตร์	and social science	Nan	and social sciences
และสัตว์	and animal	Nan	and animals
และสโรชา	and sarocha	Nan	and sarocha
และหลังจากสงครามภายใน	after inside war	Nan	and after the internal war
แล้วเดินเวียนรอบปูชนียสถาน	walk with lighted candles in hand around a temple	Nan	then walked around the sanctuary
และได้ปรากฏตัวตอนภาค	appeared	Nan	and appeared in the episode
และในปี	and in the year	Nan	and in the year
และโลก	and earth	Nan	and the world
และเรียกว่า	and call	Nan	and called
และเมื่อวันที่	when date	Nan	and on
แสงจันทร์	saengchan	Nan	moonlight
และเมืองเก่า	old city	Nan	and the old town
และเป็น	and is	Nan	and is
และเปียโน	and piano	Nan	and the piano
และอเมริกาเหนือ	and north america	Nan	and north america
และอื่น	etc.	Nan	and others
และอำเภอกันทรารมย์	and kanthararom district	Nan	and kanthararom district
และออกซิเจน	and oxygen	Nan	and oxygen
และเป็นสมาชิกราชวงศ์	in monarchs family	Nan	and is a member of the royal family
โรงเรียนนายเรืออากาศ	royal thai air force academy	Nan	royal thai air force academy
โรงเรียนบดินทรเดชา	bodindecha school	Nan	bodindecha school
โรงเรียนประชานิเวศน์	prachanivet school	Nan	prachaniwet school
ไปจนถึง	to	Nan	to
ไปบรรจบแม่น้ำเจ้าพระยา	runs to chao phraya river	Nan	meet the chao phraya river
ไปรษณีย์กาฬสินธุ์	kalasin post office	Nan	kalasin post office
ไปรษณีย์ฉะเชิงเทรา	chachoengsao post office	Nan	chachoengsao post office
ไปรษณีย์นครศรีธรรมราช	nakornsritamarat postal station	Nan	nakhon si thammarat post office
ไปรษณีย์ภูเวียง	pu weang postal office	Nan	phu wiang post office
ไปรษณีย์ยานนาวา	yan nawa post office	Nan	yannawa post office
ไปรษณีย์ร้อยเอ็ด	roi et post office	Nan	roi et post office
ไปรษณีย์สามเสนใน	samsen nai post office	Nan	samsen nai postal office
ไปรษณีย์หนองหาน	nong han postal office	Nan	nong han post office
ไปรษณีย์อำนาจเจริญ	amnat charoen post office	Nan	amnat charoen post office
ไปรษณีย์อุทุมพรพิสัย	utumporn pisai post office	Nan	uthumphon phisai post office
ไปรษณีย์อุบลราชธานี	ubon ratchathani post office	Nan	ubon ratchathani post office
ไปรษณีย์เดชอุดม	det udom post office	Nan	det post office
ไปรษณีย์โพนพิสัย	phon phisai post office	Nan	phon phisai post office
ไผ่แดง	red bamboo	Nan	red bamboo
ไพฑูรย์	phaithun	Nan	chrysoberyl
ไม่มีบันทึกว่าใครเป็นคนสร้าง	don't note who make id	Nan	there is no record of who created it.
ไม่ผ่านเข้ารอบ	did not make it to the next round, got eliminated in the initial round	Nan	not qualified
ไม่บังคับ	not enforced	Nan	optional
ไม่ทราบข้อมูล	no background information	Nan	unknown information
ไม่ต่ำกว่า	not lower than	Nan	not less than
ไมโครซอฟท์	microsoft	Nan	microsoft
ไนโตรเจน	nitrogen	Nan	nitrogen
ไมอามี่	miami	Nan	miami
ไฟร์วอลล์	firewall	Nan	firewall
ไฟนอลแฟนตาซี	final fantasy	Nan	final fantasy
ไฟ	fire	Nan	fire
ไพศาล	phaisan	Nan	expansive
ไพรวัลย์	phraiwan	Nan	praiwan
ไพรบึง	forest	Nan	forest
ไมค์	mike	Nan	mike
ไม่มีแขน	armless	Nan	no arms
ไนลอน	nylon	Nan	nylon
ไทโรซีน	thyrosine	Nan	tyrosine
ไชโย	chaiyo	Nan	bravo!
ไซน์	sine	Nan	sine
ไซโทสเกเลตอน	cytoskeleton	Nan	zeitos gateela
ไซโปรเฮปตาดีน	cyproheptadine	Nan	sipro heptadine
ไดคลอกซาซิลลิน	dicloxacillin - a drug	Nan	daiklok sillin
ไดดาโนซีน	didanosine - medication	Nan	dinocene
ไดอาน่า	diana	Nan	diana
ไดโนเสาร์ของโนบิตะ	nobita's dinosaur	Nan	nobita&#39;s dinosaur
ได้	have	Nan	have
ได้กล่าวว่า	said	Nan	said
ได้ดังนี้	these	Nan	as follows
ได้ทูลเกล้าฯ	report to the king	Nan	presented
ได้มีโอกาสสร้างความสัมพันธ์อันดีต่อกัน	good relationship	Nan	have the opportunity to build good relationships with each other
ได้รับ	received	Nan	get
ได้รับฉายาว่า	recived the alias	Nan	received the nickname
ได้รับรางวัล	awarded	Nan	get an award
ได้ร่วมกันในภารกิจในด้านต่าง	participated in activities	Nan	together in the mission in various fields.
ไทลื้อ	group of laotians that lives on flatlands	Nan	thai lue
ไทรโลจี	trilogy	Nan	trilogy
ไทยานนท์	taiyanon - a thai surname	Nan	thaiyanon
ไทยรามา	thairama	Nan	thai rama
ไทยพรีเมียร์ลีก	thai premiere	Nan	thai premier league
ไทยทีวีสีช่อง	thai tv	Nan	thai color tv channel
ไนท์	night	Nan	night
ไทย	thai	Nan	thai
ไต้หวัน	taiwan	Nan	taiwan
ไต	kidney	Nan	kidney
ได้เป็น	is	Nan	get to be
ได้เคลื่อนไหวตรวจสอบการทำงานของรัฐบาลกัมพูชาอย่างแข็งขัน	underground investigation	Nan	has actively moved to inspect the work of the cambodian government
ได้สู้กับ	competing against	Nan	fought with
ได้สำเร็จ	successfully	Nan	successfully
ไท	tai	Nan	independent
ไชยา	chaiya	Nan	chaiya
ไม่ว่าจะ	such as	Nan	whether
ไม่แตกกิ่ง	no chain	Nan	not branched
ไอโมบาย	i-mobile	Nan	i-mobile
ไอโอ	io	Nan	io
ไฮยาซินธ์	hyacinth	Nan	hyacinth
ไฮเดรนเยีย	hydrangea	Nan	hydrangea
ไฮเปอร์มาร์เก็ต	tesco lotus hypermarket chain	Nan	hypermarket
ไฮแจ็ค	hijack	Nan	hijack
ไฮโดรเจน	hydrogen	Nan	hydrogen
๑๔	14	Nan	14
๑๕	15	Nan	15
๑๖	16	Nan	16
๑๘	18	Nan	18
๒๑	21	Nan	21
๒๒	22	Nan	22
๒๔๕๐	2450	Nan	1907
๒๕๐๒	2502	Nan	1962
๒๕๐๓	2503	Nan	1963
๒๕๒๓	1980	Nan	1980
๙	nine	Nan	9
๖๐	60	Nan	60
๕	5	Nan	5
๔๘	48	Nan	48
๓	3	Nan	3
๒๘	28	Nan	28
ไอเอ	ia	Nan	ia
๒๗	27	Nan	27
๒๕๕๐	2550	Nan	2007
๒๕๔๘	2548	Nan	2005
๒๕๔๗	2004	Nan	2004
๒๕๓๖	2536	Nan	2536
๒๕๓๕	2535	Nan	1992
๒๕๓๔	2534	Nan	1991
๒๕๕๔	2554	Nan	2011
ไม่สามารถทำการเกษตรได้	unable to practice agriculture	Nan	unable to do farming
ไอร์แลนด์เหนือ	northern ireland	Nan	northern ireland
ไอพอด	ipod	Nan	ipod
ไม่ใช่	no	Nan	no
ไม้	mai	Nan	the wood
ไม้กวาด	broom	Nan	broom
ไม้หนีบผ้า	clip	Nan	clothes peg
ไม้ไม่ผลัดใบ	plants that have leaves all year round	Nan	evergreen
ไรงะ	reiya - a character from a japanese story	Nan	riga
ไรโบโซม	ribosome	Nan	ribosomes
ไร่	field, parcel	Nan	farm
ไลท์	light	Nan	light
ไลบร้า	libra	Nan	libra
ไลฟ์สไตน์	life style	Nan	lifstein
ไลเบรชัน	library	Nan	library
ไวชาน่า	baishana - weapon in a japanese story	Nan	waichana
ไวทยางกูร	wathaiyangkun	Nan	vittayangkun
ไวทยานนท์	waithayanon	Nan	waithayanon
ไวท์สเปล	white spell	Nan	whitespell
ไวน์	wine	Nan	wine
ไอน์สไตเนียม	einsteinium	Nan	einsteinium
ไอน์สไตน์	einstein	Nan	einstein
ไอทีวี	itv	Nan	itv
ไหลจากลาวเข้าสู่ภาคเหนือของกัมพูชาแล้วไหลผ่านเข้าเขตเวียดนาม	flows from laos into northern cambodia	Nan	flows from laos into northern cambodia and flows into vietnam
ไหมกัน	maigun - a surname	Nan	together
ไหซอง	haisong	Nan	flirt
ไอริส	iris	Nan	iris
ไว้ว่า	as	Nan	say
ไวเวิร์น	wyvern	Nan	wvern
ไวเปอร์	viper	Nan	viper
ไวเซิร์ด	vizard	Nan	weiss
ไวรัสตับอักเสบ	hepatitis	Nan	hepatitis
ไวรัส	virus	Nan	virus
ไวยากรณ์	waiyakorn	Nan	grammar
ไวโอเลต	violet	Nan	violet
ไชยวัฒน์	chaiwat	Nan	chaiwat
ไชยยงค์	chaiyayong	Nan	chaiyong
ไชยกิตติ	chaikitti	Nan	chai kitti
โอภาส	oh pas - a thai name	Nan	brilliance
โอร์มาน	oman - country	Nan	oman
โอวีเอ	ova	Nan	ova
โอสถสภา	osotspa	Nan	osotspa
โอสถานุเคราะห์	social service	Nan	osathanugrah
โออิชิ	oochi - a name of food business in thailand	Nan	oishi
โอะกินะวะ	okinawa	Nan	okinawa
โอเค	ok	Nan	ok
โอเอกซ์	tic-tac-toe	Nan	tic-tac-toe
โฮม	home	Nan	home
โฮลดิ้ง	holdings	Nan	holding
ใจดี	kind	Nan	kind
ใช่	yes	Nan	yes!
ใช้ขยายความเฉพาะบุคคล	to describe	Nan	use to personalize
ใช้ชื่อว่า	named	Nan	named
ใช้เวลา	it takes time	Nan	take time
ใต้	south	Nan	under
ในช่วงหลัง	later	Nan	later
ในช่วงสงครามโลกครั้งที่สอง	during world war ii	Nan	during the second world war
ในช่วงสงครามโลกครั้งที่	in time of world war	Nan	during the world war
ในช่วงสงครามเย็น	during the cold war	Nan	during the cold war
ในช่วงปี	in the year of ________	Nan	during the year
ในชิงร้อยชิงล้าน	game show to compete for 1 million baht	Nan	in the ching ching million
โอบามา	obama	Nan	obama
ในคศ	in the year	Nan	in the year
ในขณะที่	while	Nan	while
ในกาลต่อมา	later	Nan	in the future
ในการเลือกตั้ง	election	Nan	in the election
ในการประเมินผลงานวิจัยของสถาบัน	in research evaluating of institute	Nan	in evaluating the research results of the institute
ในกลุ่ม	in group	Nan	in group
ในกรณีนี้	in this case	Nan	in this case
ในคริสต์ศตวรรษที่	in the #___ century	Nan	in the 19th century
ในช่วงแรก	in the first part, primarily	Nan	in the beginning
โอกาส	opportunities	Nan	chance
โหมด	mode	Nan	mode
โรงเรียนปรินส์รอยแยลส์วิทยาลัย	the prince royal's college	Nan	prince royal&#39;s college
โรงเรียนพระตำหนักสวนกุหลาบ	the school in the king's compound.  it is reserved for the princess and the royal family	Nan	suan kularb tamnak school
โรงเรียนมัธยมสาธิตวัดพระศรีมหาธาตุ	wat phrasri mahadhat secondary demonstration school	Nan	secondary school demonstration of wat phra si mahathat
โรงเรียนมารีวิทย์	maryvit school	Nan	mary wit school
โรงเรียนยุพราชวิทยาลัย	yupparaj wittayalai school	Nan	yupparat wittayalai school
โรงเรียนราชินีบน	rachinibon school in thailand	Nan	upper queen school
โรงเรียนวัฒโนทัยพายัพ	vattanotaipayup school	Nan	watthanothai payap school
โรงเรียนศึกษานารี	suksanari school	Nan	naree school of education
โรงเรียนสาธิต	demonstration school	Nan	demonstration school
โรงเรียนสาธิตแห่งมหาวิทยาลัยเกษตรศาสตร์	kasetsart university laboratory school	Nan	kasetsart university demonstration school
โรงเรียนห้องสอนศึกษา	class room in school	Nan	school teaching room
โรงเรียนเขมะสิริอนุสสรณ์	kamasirianussorn school	Nan	khemasiri anusorn school
โรงเรียนเจ้าพระยาวิทยาคม	chao praya vitanakom school	Nan	chao phraya witthayakhom school
โรงเรียนเฉลิมพระเกียรติสมเด็จพระศรีนครินทร์	srinagarindra the princress mother school	Nan	chaloem phrakiat somdet phra srinagarindra school
โรงเรียนเทศบาล	public schools	Nan	public school
โรงเรียนไตรมิตรวิทยาลัย	trimittavitayalai school	Nan	traimit wittayalai school
โรงแรม	hotel	Nan	hotel
โสภณ	sophon	Nan	lovely
โสน	sesbania	Nan	sesbania
โสณกุล	sonakul	Nan	sonakul
โลโซ	lasso	Nan	loso
โลงหิน	sarcophagus	Nan	sarcophagus
โลกแอมะซอน	world of amazon	Nan	amazon world
โหม่ง	mong - a thai musical instrument	Nan	tackles
โลก	world	Nan	world
โรส	rose	Nan	rose
โรลเลอร์เบลด	rollerblade	Nan	roller blade
โรมัน	roman	Nan	roman
โรม	rome	Nan	rome
โรตารี	rotary	Nan	rotary
โรจูโร่	rojuro - a japanese character	Nan	rojero
โรเจอร์	name "roger"	Nan	roger
ในดาร์ฟูร์	inside dafur	Nan	in darfur
ในต่างประเทศ	in foreign countries	Nan	in foreign countries
ในทางกลับกัน	opposite	Nan	on the other hand
ในอัลบั้ม	in the album	Nan	in the album
ในเกมเดอะซิมส์	sims game	Nan	in the sims game
ในเครือ	in the area of	Nan	affiliated
ในเดือน	in the month of ...	Nan	in month
ในเดือนมิถุนายน	in june	Nan	in june
ในเดือนมีนาคม	in march	Nan	in march
ในเบื้องต้น	primarily	Nan	initially
ในเรื่อง	in story	Nan	in regard to
ในเหตุการณ์	in the event	Nan	in the event
ในเอเชียตะวันออกเฉียงใต้	in southeast asia.	Nan	in southeast asia
ในแฮร์รี่	in harry	Nan	harry
ในโอกาสครบรอบ	anniversary	Nan	on the occasion of the anniversary
ใบเสมา	boundary marker of a temple	Nan	battlements
ใหญ่	big	Nan	big
ให้พลเอกเปรม	general prem - a former military figure	Nan	for general prem
ให้สมเด็จพระเทพรัตนราชสุดาฯ	given to the thai's eldest princess	Nan	for hrh princess maha chakri sirindhorn
ให้เสียงพากย์	dubbed	Nan	voice acting
ไคเอ็น	kaien	Nan	kaien
ไข้หวัดใหญ่สเปน	spanish flu	Nan	spanish flu
ไข้หวัดใหญ่สายพันธุ์ใหม่	new flu strain	Nan	new strain of influenza
ไข้สูง	high fever	Nan	high fever
ไข้รากสาดใหญ่	typhus	Nan	typhus
ไข่	egg	Nan	egg
ในอดีตทุ่งกุลาร้องไห้ในฤดูแล้ง	thung kula rong hai in dry season in the past	Nan	in the past, thung kula weeped in the dry season.
ไขสันหลัง	spinal cord	Nan	pith
ไก่	chicken	Nan	chicken
ไกลกังวล	klai kangwon	Nan	worry
ไกรลาศ	krailard	Nan	krailat
ไกรทอง	krei thong - a surname	Nan	krai thong
ให้ใช้หลัก	large size	Nan	use the principle
ให้แก่ประชาชน	for the people	Nan	to the people
ไขมัน	fat	Nan	fat
ในอดีต	in the past	Nan	in the past
ในหนังสือ	in book	Nan	in the book
ในสหรัฐอเมริกา	in united states of america	Nan	in the united states
ในพระบาทสมเด็จพระพุทธเลิศหล้านภาลัย	under one of the king of siam	Nan	in his majesty the king, phra buddha lertlah, napalai
ในพระบาทสมเด็จพระพุทธยอดฟ้าจุฬาโลก	under the reign of one of the thailand's past king	Nan	in the reign of king buddha yodfa chula lok
ในปีเดียวกันนั้น	in that year	Nan	in that same year
ในปีเดียวกัน	in the same year	Nan	in the same year
ในปีพุทธศักราช	in b.e.	Nan	in the year.
ในปีพศ	in the year	Nan	in the year
ในภายหลัง	later	Nan	later
ในปีนี้	this year	Nan	this year
ในปี	in the year	Nan	in the year
ในปลายปี	at teh end of the year	Nan	at the end of the year
ในประเทศญี่ปุ่น	japan	Nan	in japan
ในบางฉบับ	in a certain issue (of a magazine)	Nan	in some editions
ในทางตรงกันข้าม	on the contrary	Nan	on the contrary
ในทางดาราศาสตร์	astrology	Nan	in astronomy
ในปีที่	in the year	Nan	in the year
แต่ไม่สำเร็จ	no success	Nan	but unsuccessful
ในภาษาสันสกฤต	in sanskrit language	Nan	in sanskrit
ในภาษาอิตาลี่	in italian	Nan	in italian
ในสมัยรัชกาลที่	in period	Nan	during the reign of
ในสมัยพุทธกาล	in buddha era	Nan	in the modern era
ในสมัยก่อน	in the past	Nan	in the olden days
ในสมัยกรุงศรีอยุธยา	in  ayutthaya kingdom era	Nan	in the ayutthaya period
ในฤดูกาล	in season	Nan	in season
ในรัฐบาล	in the government	Nan	in government
ในภาษาอังกฤษ	in english	Nan	in english
ในรัชสมัยพระบาทสมเด็จพระจอมเกล้าเจ้าอยู่หัว	in the reign of thailand's 4th king	Nan	during the reign of king mongkut
ในระหว่างปี	between the years	Nan	during the year
ในระยะหลัง	later	Nan	later
ในระบบสุริยะ	in the solar system	Nan	in the solar system
ในยุคแรก	in early age	Nan	in the beginning
ในยุคกลาง	in the middle ages	Nan	in the middle ages
ในภาษาไทย	in the thai language	Nan	in thai
ในระหว่างวันที่	during the dates	Nan	during the day
เขตคลองสาน	klongsan district	Nan	khlong san district
แต่ไม่ประสบความสำเร็จ	failed	Nan	but without success
แต่ใน	but in	Nan	but in
เทริโอ	terio - surname of a singer	Nan	therio
เทวดา	angel	Nan	angel
เทวรูป	graven image	Nan	idol
เทศบาล	municipality	Nan	the municipality
เทศบาลนครขอนแก่น	khon khan public works	Nan	khon kaen municipality
เทศบาลนครนครราชสีมา	nakhon ratchasima	Nan	nakhon ratchasima
เทศบาลนครนครศรีธรรมราช	nakorn sri thamarat city public works	Nan	nakhon si thammarat
เทศบาลนครเชียงราย	chiang rai	Nan	chiang rai
เทศบาลนครเชียงใหม่	chiang mai municipality	Nan	chiang mai municipality
เทศบาลเมืองชัยภูมิ	mueang chaiyaphum	Nan	chaiyaphum municipality
เทศบาลเมืองบุรีรัมย์	bureerum public works	Nan	buriram
เทศบาลเมืองมหาสารคาม	thesaban mueang maha sarakham	Nan	maha sarakham municipality
เทศบาลเมืองมุกดาหาร	mookdahan public works	Nan	mukdahan municipality
เทศบาลเมืองสกลนคร	municipality of sakonnakon	Nan	sakon nakhon municipality
เทศบาลเมืองหนองคาย	nong khai municipality	Nan	nong khai municipality
เทศบาลเมืองหนองบัวลำภู	nong bua lam phu town municipality	Nan	nong bua lamphu town municipality
เทศวิศาล	tasavisakal - a surname	Nan	expansive
เธอจะอยู่กับฉันตลอดไป	you will be with me forever	Nan	you will stay with me forever
เธอกับฉัน	you and i	Nan	you and me
เธรซ	thrace	Nan	thrace
เธคุนุ	dhekunu	Nan	support
เท่านั้น	only	Nan	only
เท่ง	teng (first name)	Nan	teng
เทพีเธมิส	themis	Nan	goddess
เท็นเท็น	tin-tin	Nan	ten ten
เทโรศาสน	terosat football club	Nan	tero sasana
เทเบิลเทนนิส	table tennis	Nan	table tennis
เทียนโพธิ์สุวรรณ	tianphosuwan (thai last name)	Nan	thian pho suwan
เทียนเงิน	tienngern	Nan	silver candle
เทียนทอง	tientong - a male's name	Nan	gold candles
เทิดศักดิ์	honor	Nan	honor
เท็ดดี้	teddy	Nan	teddy
เธอยัง	tur yung	Nan	you still
เทพอาเตน	aten	Nan	athen
เทพหัสดิน	tephussadin (a surname)	Nan	god of heaven
เดนโอเบลท์	den-o belt	Nan	den obelt
เดย์	day	Nan	day
เดอะซิมส์	the sims	Nan	the sims
เดอะฮาเดส	the hades	Nan	the hades
เดอะฮาเดสแชปเตอร์	the hades chapter	Nan	the hades chapter
เดิม	at first	Nan	old
เดิมชื่อ	former name	Nan	formerly
เดิมที	at first	Nan	originally
เดิมเรียกว่า	formerly known as	Nan	formerly known as
เดียวกัน	same	Nan	same
เดือดทะลุจุดศูนย์	zero point breakthrough	Nan	boiling through the zero point
เดือนกุมภาพันธ์	february	Nan	february
เดือนตุลาคม	october	Nan	october
เดือนตุลาคมมีฝนตกชุกที่สุด	highest amount of rainfall in october	Nan	october is the rainiest.
เดือนธันวาคม	december	Nan	december
เดือนมกราคม	january	Nan	january
เดือนมิถุนายน	june	Nan	june
เทพมรณะ	bleach	Nan	death god
เทพพิทักษ์	theppitak	Nan	theppitak
เทนโจอิน	tenjoin - a character in a japanese story	Nan	tenjo-in
เทนนิส	tennis	Nan	tennis
เทคโนโลยีสารสนเทศ	san son tej techonology	Nan	information technology
เทคโนโลยี	technology	Nan	the technology
เทพอานูบิส	anubis	Nan	anubis
เทควันโด้	taekwondo	Nan	taekwondo
เถรวาท	buddha's teaching	Nan	doctrine
เต๋อ	to	Nan	to
เต่า	tao (first name)	Nan	turtle
เด็กและเยาวชน	children and youth	Nan	children and youth
เด็กหญิงอายุ	the girl's age	Nan	old girl
เดือนอ้าย	first lunar month	Nan	lunar month
เทคนิคอิลลูชั่น	technique illusion	Nan	illusion technique
เดนโอ	den-o	Nan	den o
เธอเป็นเพื่อนอาบาราอิ	she is a friend of arbarae	Nan	she is a friend of abarai.
เนย	butter	Nan	butter
เปิดสอนระดับปริญญาตรี	offer bachelor degree curriculum	Nan	open for undergraduate study
เปียงยาง	pyongyang	Nan	pyongyang
เปียโตร	pietro	Nan	pietro
เปียโน	piano	Nan	piano
เปโซ	peso	Nan	peso
เป็ด	duck	Nan	duck
เป็น	is	Nan	are
เป็นขนมของชาวไทยมุสลิม	is a thai-muslim dessert	Nan	is a dessert of thai muslims
เป็นครั้งแรก	first	Nan	the first time
เป็นงานเขียนในชุด	in the edition of...	Nan	is a set of writing
เป็นต่อ	pen to	Nan	against
เป็นต้น	etc.	Nan	etc.
เป็นต้นมา	onward	Nan	since
เป็นต้นไม้ประจำมหาวิทยาลัย	tree of university	Nan	is a tree of the university
เป็นบัวในสกุล	is a lotus in the family	Nan	is a lotus in the genus
เป็นประธาน	principal of	Nan	become president
เป็นปลาตู้สวยงาม	is an ornamental fish	Nan	is a beautiful aquarium fish
เป๊ปซี่	pepsi	Nan	pepsi
เป็นโฮโมโลกัสกับ	homologous	Nan	is a homologus with
เป็นเวลา	for	Nan	for
เป็นเมืองหลวง	capital	Nan	is the capital
เป็นเจ้าเมืองปกครอง	governor	Nan	governor
เป็นเครื่องหมายแสดงว่า	indicates that	Nan	is a sign that
เปอร์โตริโก้	puerto rico	Nan	puerto rico
เป็นอาวุธ	as a weapon	Nan	as a weapon
เป็นหัวหน้าพรรค	party leader	Nan	party leader
เป็นหนึ่งใน	is one of	Nan	is one of
เป็นสีประจำ	official color	Nan	regular color
เป็นวิญญาณเทียมเพศชาย	the spirit who is a male	Nan	is a male artificial spirit
เป็นพ่อของ	is the father of	Nan	is the father of
เป็นพระราชโอรสพระองค์เดียวในพระบาทสมเด็จพระปรมินทรมหาภูมิพลอดุลยเดช	is the only son of	Nan	is the only son of king bhumibol adulyadej
เป็นอดีตหัวหน้าหน่วยที่	is the former leader of the unit	Nan	is a former head of the unit
เนกิ	negi	Nan	negi
เปอร์เซีย	persia	Nan	persia
เปลื้อง	nude	Nan	divest
เนรมิต	casting a spell	Nan	invent
เนะ	ney	Nan	right
เนื่องจาก	because	Nan	since
เนื่องจากประเทศเหล่านั้นอยู่ในตำแหน่งบนโลกที่ต่างไปจากประเทศไทย	because those countries are in the group of...	Nan	because they are in a position on earth that is different from thailand
เนื้อที่	area	Nan	area
เนื้อที่ประมาณ	approximate area	Nan	approximate area
เนื้อร้อง	lyrics	Nan	lyrics
เนื้อเรื่องย่อ	summary	Nan	summary
เนเธอร์แลนด์	netherlands	Nan	the netherlands
เนโกะ	neko	Nan	neko
เน็น	nen	Nan	nen
เบจิต้า	vegeta	Nan	bechita
เบธเลเฮม	bethlehem	Nan	bethlehem
เบนจามิน	benjamin	Nan	benjamin
เบรกมา	bregma	Nan	break
เบริธ	berith	Nan	berith
เบลเฟกอล	belphegor- a demon in a legend	Nan	bellegal
เปลี่ยนชื่อเป็น	changed the name to	Nan	renamed to
เปลวไฟ	flame	Nan	flame
เปรู	peru	Nan	peru
เปรี้ยว	sour	Nan	sour
เปรม	pream	Nan	satisfied
เบ็นเท็น	ben 10	Nan	ben 10
เปล่งพานิช	plengpanich	Nan	plengpanich
เบโทเฟิน	beethoven	Nan	beethoven
เบื่ออาหาร	not appetite, eating disorder.	Nan	bored
เบาหวาน	diabetes	Nan	diabetes
เบาท์	(dieric) bouts	Nan	baut
เบา	light	Nan	light
เบอร์ลิน	berlin	Nan	berlin
เบส	bass	Nan	bass
เบื้องหลัง	background	Nan	background
เพกาซัส	pegasus	Nan	pegasus
เดนกัชเชอร์	den gusher - a weapon in japanese movies	Nan	denkucher
เดชา	decha	Nan	dacha
เคนยา	kenya	Nan	kenya
เคมีไฟฟ้า	electrochemistry	Nan	electrochemistry
เคยสู้กับโกคุเทระ	fought with gokudera	Nan	used to fight with gokudera
เครือข่าย	network	Nan	the network
เครื่องขัตติยราชอิสริยาภรณ์อันมีเกียรติคุณรุ่งเรืองยิ่งมหาจักรีบรมราชวงศ์	something used in a thai ceremony - too obscure	Nan	commemorating the great honor of the chakri dynasty
เครื่องดีด	thai string musical instruments	Nan	strum
เครื่องตี	musical intrument	Nan	beat machine
เครื่องบิน	airplane	Nan	aircraft
เครื่องปั้นดินเผาและเซรามิค	pottery and ceramic	Nan	pottery and ceramics
เครื่องยนต์	engine	Nan	engine
เครื่องราชอิสริยาภรณ์	the king's accessories for ceremonies	Nan	insignia
เครื่องราชอิสริยาภรณ์อันเป็นที่เชิดชูยิ่งช้างเผือก	order of the white elephant	Nan	the insignia that is glorified by the white elephant
เครื่องราชอิสริยาภรณ์อันเป็นสิริยิ่งรามกีรติ	king's accessories	Nan	the insignia of the great glory of kirati
เครื่องราชอิสริยาภรณ์อันเป็นโบราณมงคลนพรัตนราชวราภรณ์	the ancient and auspicious order of the nine gems	Nan	ancient insignia with auspiciousness
เครื่องสาย	string instrument	Nan	stringed instruments
เครื่องแต่งกาย	clothes	Nan	costume
เคลลี่	kelly	Nan	kelly
เจเน็ต	janet	Nan	janet
เจี๊ยบ	jeab (thai name)	Nan	chick
เจียะแจ	nine emperor gods festival	Nan	jae jae
เจสเปอร์	jasper	Nan	jesper
เจริญ	charoen	Nan	grow
เจมินี่	gemini	Nan	gemini
เคน	ken	Nan	ken
เจนี่	jenny	Nan	janie
เงี้ยว	shan tribe in northern part of thailand	Nan	tortuous
เงินในบัญชีธนาคาร	balance	Nan	money in bank account
เงินทุน	fund	Nan	funding
เงิน	money	Nan	money
เค้ก	cake	Nan	cake
เคอาร์วาย	k.r.y	Nan	kryy
เจ	j	Nan	j
เจ็ดเทพโจรสลัด	seven warlords of the sea	Nan	shichibukai
เข้าเฝ้า	visit (word for the king)	Nan	have an audience
เข้าชิงไนน์เอ็นเตอร์เทนอวอร์ดส	compete in entertaining world	Nan	nominated for nine entertainment awards.
เขตดุสิต	dusit	Nan	dusit
เขตที่	district	Nan	district
เขตบางกอกใหญ่	bangkok yai district in thailand	Nan	bangkok yai district
เขตบางซื่อ	bang sue district	Nan	bang sue district
เขตบางแค	bang khae district	Nan	bang khae
เขตปทุมวัน	pathum wan district	Nan	pathumwan
เขตภาษีเจริญ	phasi charoen district	Nan	phasi charoen district
เขตมีนบุรี	min buri district	Nan	min buri district
เขตรักษาพันธุ์สัตว์ป่า	national wildlife preserve	Nan	wildlife sanctuary
เขตรักษาพันธุ์สัตว์ป่าภูหลวง	wildlife preserve	Nan	phu luang wildlife sanctuary
เขตลาดกระบัง	lad krabang district	Nan	lat krabang
เขตวังทองหลาง	wang thonglang district	Nan	wang thonglang district
เขตวัฒนา	watana district	Nan	wattana district
เขตสวนหลวง	suan luang district	Nan	suan luang district
เขตสาทร	sathon	Nan	sathon
เขตห้วยขวาง	huai khwang	Nan	huai khwang
เขตเลือกตั้งที่	election area number	Nan	borough
เข้าฉาย	show	Nan	show
เข่า	knee	Nan	knee
เข็มอัปสร	kem uppasorn - a thai drama	Nan	needle
เข็มศิลปวิทยา	khem sinlapawitthaya	Nan	needle arts
เขื่อนแม่งัดสมบูรณ์ชล	mae ngud som bul chol dam in chiangmai	Nan	mae ngad somboon chon dam
เขื่อนลำปาว	lum pao dam	Nan	lampao dam
เข้ารอบ	made it to the next round, selected from the initial round	Nan	finalist
เขื่อนป่าสักชลสิทธิ์	parsakchonlasit dam	Nan	pasak chonlasit dam
เขี้ยวพิษ	vemon fangs	Nan	toxic fangs
เขียนโดย	written by	Nan	written by
เขียนว่า	wrote	Nan	wrote that
เขาทราย	sand dunes	Nan	khao sai
เขากล่าวว่า	he said	Nan	he said
เขมนิจ	khemanit	Nan	imperious
เขื่อนกิ่วลม	kio lom dam	Nan	kio wind dam
เดธโน้ต	death note - a mysterious japanese cartoon	Nan	death note
เจ็บ	pain	Nan	sore
เจ้าจอม	king's concubine	Nan	master
เชียงใหม่	chiang mai	Nan	chiang mai
เชี่ยววงศ์กุล	chiaowongkul	Nan	chiewwongkun
เชื่อมต่อกับรถไฟฟ้ามหานคร	connect with skytrain	Nan	connected to the mrt
เชื่อมแม่น้ำท่าจีน	confluence to the ta jean river	Nan	connect the tha chin river.
เชื้อชาติ	helping the country	Nan	race
เชื้อรา	fungus	Nan	the fungus
เช็ค	check	Nan	check
เช่นกัน	as well	Nan	as well
เช่นเดียวกัน	similar to	Nan	likewise
เช้ามืดวันที่	in dawn of	Nan	dawn of the day
เช้าวันรุ่งขึ้น	next morning	Nan	the next morning
เซกิ	seki	Nan	seki
เซน	saint	Nan	zen
เซนทอร์	centaur	Nan	centaur
เซบาสเตียน	sebastian	Nan	sebastian
เซฟ	save	Nan	save
เซลล์	cell	Nan	cell
เดคลิเนชัน	declination	Nan	decloration
เณร	samanera	Nan	neophyte
เซ็นเซอร์	sensor	Nan	the sensor
เซ็นทารา	centara	Nan	centara
เซ็นทรัล	central - department stores in thailand	Nan	central
เซ็กส์	sex	Nan	sex
เชียงราย	chiang rai	Nan	chiang rai
เซโรไลเนอร์	seroliner	Nan	seroliner
เซโรกัชเชอร์	sero gusher - a type of weapon	Nan	sero kutcher
เซอวิวาสแตติน	cerivastatin - drug	Nan	cervivastin
เซอร์เบีย	serbia	Nan	serbia
เซอร์วิส	service	Nan	service
เซอร์	sir	Nan	sir
เซสติโม	settimo	Nan	seto
เซโรนอส	zeronos	Nan	seronos
เจ้าของจุกนม	the owner of the baby's bottle	Nan	nipple owner
เชียงยืน	chiang yuen	Nan	chiang yuen
เชียงดาว	chiang dao	Nan	chiang dao
เจ้าฟ้ากรมพระยานริศรานุวัดติวงศ์	refer to a title of a royal family member - jao fa krom pra ya rissanuwattiwong	Nan	prince krom phraya narisaranu, tiwong temple
เจ้าฟ้ากรมพระยานริศรานุวัติวงศ์	prince narisara nuvativongse	Nan	prince krom phraya narisara nuwatwong
เจ้าฟ้าจิตรเจริญ	prince chitcharoen	Nan	prince jitcharoen
เจ้าฟ้าภาณุรังษีสว่างวงศ์	prince panuragui bright chestnut.	Nan	prince phanurangseesawangwong
เจ้าฟ้ามหาวชิราลงกรณ	thailand's crown prince	Nan	prince maha vajiralongkorn
เจ้าฟ้ามหาวชิรุณหิศ	crown prince maha vajirunhis	Nan	prince mahawajirunhit
เจ้าฟ้ามหิดลอดุลยเดช	prince mahidol adulyadej	Nan	prince mahidol adulyadej
เจ้าฟ้ามหิดลอดุลเดช	prince mahidol adulyadej	Nan	prince mahidol adulyadej
เจ้าฟ้าหญิง	princess	Nan	princess
เจ้าฟ้าอุบลรัตนราชกัญญา	princess ubon ratana graz's' contract.	Nan	chaofa ubonratana rajaganya
เจ้าหนี้การค้า	trade account payable	Nan	accounts payable
เจ้าเมือง	governor	Nan	governor
เจ้าเมืองขุขันธ์	a name of the head of the state	Nan	governor of khukhan
เจ้าโลก	world conqueror	Nan	hegemony
เฉพาะด้านตะวันออกเฉียงใต้เท่านั้นที่เป็นที่ราบลุ่มแม่น้ำโขง	only south-east area that is in mekhong plateau	Nan	only the southeast side is the mekong river basin.
เฉลิม	chalerm - a male's name	Nan	chalerm
เฉลิมชัย	chalermchai	Nan	chalermchai
เชียงของ	chiang khong	Nan	chiangkhong
เชียงกลาง	chiang klang	Nan	chiang klang
เชิดชัย	name "churd-chai"	Nan	conquer
เชิญยิ้ม	smile	Nan	smile
เชาวราษฎร์	chowarat - the surname of a famous actress	Nan	chaowarat
เชาวน์	intelligence	Nan	intelligence
เชียงปุม	chiang poom - area in thailand	Nan	chiang pum
เชา	chow -  a chinese name	Nan	chow
เชส	chase	Nan	chase
เฉลียว	chaleuw - a male's name	Nan	perceptive
เฉลิมแสน	chaloemsaen	Nan	chalermsaen
เฉลิมพล	shalermpol - a surname	Nan	chalermpol
เฉลิมพระเกียรติ	honor	Nan	honor
เฉลิมชัยเจริญกิจ	chalermchaichareonkij	Nan	chalermchai charoenkit
เชอร์รี่	cherry	Nan	cherry
เพชร	diamond	Nan	diamond
เพชรบุรี	petchaburi province	Nan	phetchaburi
เพชรบูรณ์	prechabun	Nan	phetchabun
เหล่านี้	these	Nan	these
เหล่าสุนทร	soontorn group	Nan	laosonthorn
เห็นภาพลวงตา	seeing hallucination	Nan	see the illusion
เอก	first	Nan	first
เอกชน	private	Nan	private
เอกซ์	x	Nan	x
เอกราช	independence	Nan	independence
เอกวาดอร์	edwardor	Nan	ecuador
เอกสิทธิ์	privilege	Nan	privilege
เอจิเซ็น	echizen	Nan	echizen
เอชไอวี	hiv	Nan	hiv
เอซ	letter h	Nan	aces
เอตาสีติ	sesasiti	Nan	atacati
เอนจิเนียริ่ง	engineering	Nan	engineering
เอนไซม์	enzyme	Nan	enzyme
เอบีซี	abc	Nan	abc
เอม	aim - could be a nickname	Nan	aim
เอเชียแปซิฟิก	asia-pacific	Nan	asia pacific
เอเชียเหนือ	north asia	Nan	north asia
เอเชียตะวันตกเฉียงใต้	southwest asia	Nan	southwest asia
เอเชีย	asia	Nan	asia
เอื้อย	eay - a thai nickname	Nan	uri
เอี่ยมสุข	iamsuk	Nan	iam happy
เหล็ก	iron	Nan	steel
เอี่ยมยิ่ง	super, awesome	Nan	iam
เอสโตเนีย	astonia - a country	Nan	estonia
เอสเอ็ม	sm	Nan	sm
เอสปาด้าตกชั้น	aspata	Nan	espada relegated
เอสปาด้า	eapada	Nan	espada
เอล	el	Nan	el
เอริค	eric	Nan	eric
เออร์โกสเฟียร์	ergosphere	Nan	ergosphere
เอเชียใต้	south asia	Nan	south asia
เหลือสมาชิก	members left	Nan	remaining members
เหรียญรัตนาภรณ์	a special thai medallion	Nan	rattanaporn coin
เว้นวรรค	space	Nan	space
เศรษฐกิจพอเพียง	sufficiency economy	Nan	sufficiency economy
เศรษฐบุตร	settabut - the family that started bus system in thailand	Nan	sethaputra
เศรษฐศาสตร์จุลภาค	microeconomics	Nan	microeconomics
เศรษฐศาสตร์มหภาค	macroeconomics	Nan	macroeconomics
เสงี่ยม	sa-ngiam	Nan	mannerly
เสชนะ	sechana	Nan	win
เสด็จพระราชสมภพ	royal birth	Nan	royal birth
เสนอชื่อเข้าชิงและรับรางวัล	nominate and win	Nan	nominate and receive awards.
เสนา	sena	Nan	sena
เสนาเมือง	senamuang	Nan	sena city
เสนีวงศ์	seniwong	Nan	seni wong
เสน่ห์	sanea	Nan	charm
เสมอ	always	Nan	always
เสรี	seri	Nan	free
เสรีภาพ	freedom	Nan	freedom
เสียง	sound	Nan	sound
เหรียญทอง	gold medal	Nan	gold medal
เหรียญกษาปณ์	mint	Nan	mint
เหรียญ	coin	Nan	medal
เหตุการณ์สำคัญ	important event	Nan	important event
เหตุการณ์	event	Nan	event
เหงื่อ	sweat	Nan	sweat
เหลือง	yellow	Nan	yellow
เส้นใย	fiber	Nan	fiber
เส้นพุ่ง	yarn that is used for weaving	Nan	line
เส้นทแยงมุม	diagonal	Nan	diagonal
เสื้อครุย	gown	Nan	robe
เสือจากัวร์	jaguar	Nan	jaguar
เสียงเสียดแทรก	noise	Nan	fricative sound
เสียงเปิด	approximant, semi-vowel	Nan	open sound
เส้นโค้ง	curve	Nan	curve
เว็บไซต์ซีไอเอ	cia website	Nan	cia website
เอเธนส์	athens	Nan	athens
เอเอฟซีแชมเปียนส์ลีก	afc championship	Nan	afc champions league
แขวงหลวงพระบาง	luang pra bang province	Nan	luang prabang subdistrict
แคดเมียม	cadmium	Nan	cadmium
แคทแพท	kat - pat kamikaze - the thai famous stars	Nan	cat pat
แคน	kan - a type of thai music	Nan	caen
แคนดี้	candy	Nan	candy
แคนเซอร์	cancer	Nan	canzer
แคม	cam	Nan	webcams
แคมป์เบลล์	campbell	Nan	campbell
แคมเปญ	campagne	Nan	the campaign
แคมเล็ก	vagina fold	Nan	small cam
แคมใหญ่	labia	Nan	big cam
แคร็กเกอร์	crackers	Nan	nutcracker
แคลคูลัสเชิงปริพันธ์	integral calculas	Nan	integral calculus
แคลคูลัสเชิงอนุพันธ์	differential calculus	Nan	differential calculus
แคลอรี	calories	Nan	calories
แคลิฟอร์เนีย	california	Nan	california
แคลิฟอร์เนียม	california	Nan	california
แต่งโดย	composed by	Nan	composed by
แต่งตั้ง	giving a new title to	Nan	appoint
แต่งงาน	wedding, marriage	Nan	marry
แตน	hornet	Nan	hornet
แดเนียล	daniel	Nan	daniel
แดนสุพรรณ	dansuphan	Nan	suphan
แขวงจำปาสัก	champasak province	Nan	champasak province
แดงทั้งแผ่นดิน	red (political party all over the country	Nan	whole earth red
แจ๊ส	jazz	Nan	jazz
แจ๊ค	jack	Nan	jack
แจ็ค	jack	Nan	jack
แจ็กสัน	jackson	Nan	jackson
แจ	live purely and clean both in body and mind - from chinese belief	Nan	jam
แคว้น	region	Nan	region
แด	dae	Nan	dae
เอเอฟซี	afc	Nan	afc
แขน	arm	Nan	arm
แก๊สธรรมชาติ	natural gas	Nan	natural gas
เอ็กซ์โป	expo	Nan	expo
เอ็กโทเดิร์ม	ectoderm, top level of skin layer.	Nan	ecterm
เอ็กโปรพลาซ่า	expo plaza in thailand	Nan	expo plaza
เอ็ดดูเทนเมนท์	edutainment	Nan	edutainment
เอ็ดเวิร์ด	edward	Nan	edward
เอ็น	n	Nan	ligament
เอ็นบีเอ	nba - national basketball association	Nan	nba
เอ็นเตอร์เทนเม้นท์	entertainment	Nan	entertainment
เอ็นเทอร์เทนเมนท์	entertainment	Nan	entertainment
เอ็มม่า	emma	Nan	emma
เอ๋	ah - a nick name	Nan	eh
เฮติ	haiti	Nan	haiti
เฮลมุต	helmut	Nan	helmut
เฮสเตีย	hestia	Nan	hestia
เฮอร์เชล	herschel	Nan	herschel
เฮาส์	house	Nan	house
เฮียวงะ	heonga	Nan	hyuga
แก้วบัวสาย	kaeobuasai	Nan	lotus glass
แก้วทอง	golden cup	Nan	gold glass
แก้ว	glass	Nan	glass
แก่	to	Nan	to
แกแล็คซี่	galaxy	Nan	galaxy
แกะ	sheep	Nan	sheep
แขก	indian	Nan	guest
แกสโทรโพดา	gastropoda	Nan	gastropoda
แกลง	glang	Nan	klaeng
แกริซั่น	garrison - an english name	Nan	garrison
แกรมมี่	grammy	Nan	grammy
แกรนซ์	grantz	Nan	grant
แกมเบีย	cambia	Nan	gambia
แกง	curry	Nan	curry
แกลเลอรี	gallery	Nan	gallery
เว็บไซต์ของเกมส์	gaming website	Nan	game website
เว็บเบราว์เซอร์	web browser	Nan	web browser
เว็บสเตอร์	webster	Nan	webster
เภสัชกร	pharmacist	Nan	pharmacist
เภสัชจลนศาสตร์	pharmacokinetics	Nan	pharmacokinetics
เม	may	Nan	may
เมกา	mega	Nan	mega
เมฆ	cloud	Nan	cloud
เมฆออร์ต	ash cloud in the space	Nan	oort cloud
เมจิ	maji - a nickname	Nan	meiji
เมตร	metre	Nan	m.
เมทริกซ์	matrix	Nan	matrix
เมทะนี	metanee - the surname of a famous actor	Nan	metani
เมอร์คิวรี	mercury	Nan	mercury
เมือง	city	Nan	city
เมืองทองฯ	muangthong	Nan	muang thong
เมืองนครราชสีมา	nakhon ratchasima	Nan	nakhon ratchasima
เมืองปทุมธานี	pathum thani	Nan	pathum thani
เมืองปราจีนบุรี	prachinburi	Nan	prachinburi
เมืองพิจิตร	phichit	Nan	phichit
เมื่อประมาณ	estimate	Nan	when
เมืองใหญ่ในเขตนี้	capital presently	Nan	major cities in this district
เมืองใหญ่	big city	Nan	big city
เมืองโคราช	muang korat	Nan	korat
เมืองเอก	mueang-ake	Nan	ake city
เมืองเคมบริดจ์	city of cambridge	Nan	cambridge city
เฟื่องอารมย์	fueangarom	Nan	foudarom
เมืองหลวงของอาณาจักรเขมร	capital of cambudia	Nan	capital of the khmer empire
เมืองสุรินทร์	surin city	Nan	surin
เมืองสิงห์	muangsing	Nan	singha
เมืองสกลนคร	sakon nakhon	Nan	sakon nakhon
เมืองลำพูน	lumpoon province	Nan	lamphun
เมืองยอง	mueng-yor	Nan	stag city
เมืองพิษณุโลก	phitsanulok	Nan	phitsanulok
เมืองหลวง	capital	Nan	capital
เมื่อปีพศ	in buddhist era	Nan	last year
เฟอร์นิเจอร์	furniture	Nan	furniture
เฟรดริก	fredrick	Nan	frederick
เพชรพระอุมา	ancient diamond	Nan	diamond phra uma
เพชรา	petchara - name of a famous actress	Nan	old man
เพชรเกษม	petchakasem area in bangkok	Nan	petchkasem
เพดานอ่อน	gill	Nan	soft ceiling
เพทาย	zircon	Nan	zircon
เพพซิน	pepsin	Nan	pepsin
เพราะ	because	Nan	because
เพราะว่า	because	Nan	because
เพรียะ	preah - cambodia	Nan	piriya
เพลงประกอบภาพยนตร์	soundtrack	Nan	movie soundtrack
เพลงประจำจังหวัด	province anthem	Nan	provincial song
เพลงประจำมหาวิทยาลัย	university song	Nan	university song
เพลงปิดเรื่อง	pid reung song	Nan	cover song
เพลงพระราชนิพนธ์	the king's song	Nan	royal music
เพลงลูกทุ่ง	folk song	Nan	country music
เพลงลูกทุ่งขับร้อง	luk thung song	Nan	country music
เพลงอีแซว	a type of thai country music	Nan	music tease
เฟย์	fay	Nan	fay
เฟนิรามีน	pheniramine	Nan	pheniramine
เพ็ชรทาย	petchtai	Nan	phettha
เพื่อใช้ร่วมกับตัวชี้วัดอื่น	to be used with other indicators	Nan	to be used with other indicators
เพื่อเป็นการเผยแผ่พระพุทธศาสนาและประชาสัมพันธ์กิจกรรมทางพระพุทธศาสนาต่าง	passing knowledge about buddhism	Nan	in order to propagate buddhism and promote religious activities
เพื่อ	for	Nan	for
เฟส	phase	Nan	phase
เพียงพอ	enough	Nan	enough
เพศชาย	male	Nan	male gender
เพศ	sex	Nan	sex
เพลโต	plato	Nan	plato
เพลย์สเตชัน	playstation	Nan	playstation
เพลงเปิดเรื่อง	opening song	Nan	opening song
เพลงเปิด	opening song	Nan	opening song
เพิ่มมา	more	Nan	more
เมื่อปีพุทธศักราช	in b.e.	Nan	in the year buddhist era
เมื่อวันจันทร์	on monday	Nan	on monday
เมื่อเดือนกันยายน	in september	Nan	last september
เรื่อง	story	Nan	subject
เรื่องย่อ	summary	Nan	summary
เรื่องสั้น	short story	Nan	short story
เร้กเก้	reggae	Nan	reggae
เลข	number	Nan	number
เลขที่	number	Nan	number
เลขาธิการสหประชาชาติ	united nations secretary-general	Nan	secretary-general of the united nations
เลนส์	lens	Nan	the lens
เลออน	lyon	Nan	leon
เลิฟ	love	Nan	love
เลือดออกตามไรฟัน	scurvy	Nan	scurvy
เลโอ	alo	Nan	leo
เลโอนาร์โด	leonardo	Nan	leonardo
เล็ก	small	Nan	small
เล่ม	book	Nan	book
เล่มที่	volume	Nan	book number
เวทีทอง	golden podium	Nan	gold stage
เว็บ	web	Nan	the web
เวโรนา	verona	Nan	verona
เวียนเทียนรอบอุโบสถหรือสถูปเจดีย์พุทธสถานต่าง	a thai religious ceremony	Nan	circling around the chapel or pagoda
เวียงสา	wiang sa	Nan	wiang sa
เวียงสระ	wiang sa	Nan	wiang sa
เวิลด์	world	Nan	the world
เรือใบ	sailboat	Nan	sailboat
เวิร์ม	worm	Nan	worms
เวิร์คพอยท์	workpoint company	Nan	workpoint
เวอร์โก้	virgo	Nan	vergo
เวอร์ชัน	version	Nan	version
เวสต์	west	Nan	west
เวลาประมาณ	approximate time	Nan	estimated time
เวล	vail	Nan	vail
เวิร์คพอยท์สตูดิโอ	workpoint studio	Nan	workpoint studio
เรือเร็วโจมตี	fast attack craft	Nan	speed boat attack
เรือสำรวจ	survey vessel	Nan	survey ship
เรือยกพลขึ้นบก	boat for advance the army	Nan	landboat
เรดวัน	redone	Nan	red day
เรด	red	Nan	red
เรซูเม	resume	Nan	resume
เยื่อหุ้มสมอง	meninges	Nan	cortex
เยาวราช	yaowaraj	Nan	chinatown
เยาวชนอายุ	youth age of ...	Nan	youth age
เรย์	ray	Nan	ray
เยาวชน	youth	Nan	youth
เยอรมนี	germany	Nan	germany
เยลโล่	yellow	Nan	yellow
เย	yay - a sound	Nan	ye
เม่น	porcupine	Nan	porcupine
เม็ดขนุน	metkhanun	Nan	jackfruit
เมื่อเดือนมีนาคม	in march	Nan	in march
เยอรมัน	german	Nan	german
แต่ในปัจจุบัน	in the present	Nan	but now
เรวดี	rawadee	Nan	good news
เริ่มการผลิตนำเข้า	importing	Nan	start import production
เรือนนาค	nak castle	Nan	naga house
เรือตรี	ensign	Nan	boat
เรืองศรี	rueng sri - a surname	Nan	rueangsri
เรืองรุ่ง	rueangrung	Nan	glowing
เรียะชอาณาจักร	kingdom	Nan	kingdom
เรียวเฮ	reohay - a japanese character	Nan	rye hye
เราเตอร์	router	Nan	router
เรียวทาโร่	totoro - a japanese cartoon	Nan	ryotaro
เรียล	real	Nan	real
เรียกว่า	called	Nan	called
เรียกกันว่า	called	Nan	called
เริ่มตั้งแต่อาณาจักรอยุธยาได้โจมตีอาณาจักรเขมร	ever since the ayudhya (military) assault...	Nan	beginning with the ayutthaya kingdom attacking the khmer kingdom.
เริ่มจากเดือนพฤศจิกายนเมษายน	begins from november to april	Nan	starting from november to april
เริ่มก่อสร้าง	began constuction	Nan	start construction
เรียว	ryo	Nan	slender
ព្រះរាជាណាចក្រកម្ពុជា	cambodia	Nan	ព្រះរាជាណាចក្រ កម្ពុជា
ลัคนา	ascendant	Nan	ascendant
ลักษณะสำคัญ	main characteristics	Nan	important characteristics
ซากดึกดำบรรพ์	fossil	Nan	fossil
ซาคุโร่	zakuro - a japanese character	Nan	sakuro
ซาซางาวะ	sasangngawa - a japanese name	Nan	sasagawa
ซานกัลโล	sangallo family	Nan	san gallo
ซาบุซะ	zabuza	Nan	sabuza
ซาลาดิน	saladin	Nan	saladin
ซาอิ	chai - a japanese name	Nan	sayi
ซาโลมอน	salomon	Nan	salomon
ซิกนัส	signus	Nan	cignus
ซิงเกอร์	singer	Nan	singer
ซิงเกิ้ล	single	Nan	singles
ซิทคอม	sitcom	Nan	sitcom
ซินเดอเรลล่า	cinderella	Nan	cinderella
ซิมไฟลา	class symphyl	Nan	simphila
ซิโนไทย	sino-thai	Nan	sino thai
ซี	see	Nan	c
ซีซี	cc	Nan	cc
ซึ่งมี	with	Nan	which has
ซึ่งประกอบด้วย	consists of	Nan	consisting of
ซึ่ง	because	Nan	which
ซึม	absorb	Nan	seep
ซึง	feeling touched (by the music or movie)	Nan	which
ซีโร่	zero	Nan	zero
ซัลเฟต	sulphate	Nan	sulfate
ซีแคนต์	secant	Nan	secant
ซีเซียม	cesium	Nan	cesium
ซีเจ	cj	Nan	cj
ซีเกมส์	southeast asian game	Nan	sea games
ซีสต์	cyst	Nan	cysts
ซีลีเนียม	selenium (chemical element)	Nan	selenium
ซีรีเบลลัม	cerebellum	Nan	serabellum
ซีเนม่า	cinema	Nan	cinema
ซึ่งมีความหมายว่า	meaning	Nan	which means
ซัลฟาไดอะซีน	sulfadiazine	Nan	sulfadiazine
ซันไชน์	sunshine	Nan	sunshine
ชื่อนามสกุล	name-lastname	Nan	first name surname
ชื่อภาษาญี่ปุ่น	japanese name	Nan	japanese name
ชื่อภาษาอังกฤษ	english name	Nan	english name
ชื่อยศภาษาไทย	thai title	Nan	thai rank
ชื่ออัลบั้ม	album name	Nan	album name
ชื่ออื่น	other names	Nan	other names
ชื่อเก่าในวงการ	old stage name	Nan	old name in the industry
ชื่อเดิม	former name	Nan	former name
ชื่อเมือง	city's name	Nan	city name
ชื่อเรื่อง	the name of the story	Nan	the title
ชื่อเล่น	nickname	Nan	nickname
ชุดแพนเค้ก	pancake	Nan	pancake set
ชุติมา	chutima	Nan	chutima
ชุมชนออนไลน์ชาวจังหวัดสกลนคร	sakon nakhon people online community	Nan	sakon nakhon online community
ชุมพลบุรี	chumphon buri	Nan	chumphon buri
ชุมแพ	choompa - location in thailand	Nan	chum phae
ชุมแสง	choomsang - a male's name	Nan	chum saeng
ซออู้	a woodwind thai instrument	Nan	zo o
ซอมบี้	zombie	Nan	zombies
ซบที่อกฉัน	cry in my arms	Nan	nestle in my chest
ซน	crashing into	Nan	naughty
ซ	the eleventh letter of the thai alphabets	Nan	c
ช้อน	spoon	Nan	spoon
ซัลฟานิลาไมด์	sulfanilamide	Nan	sulfanilamide
ช่องเชิงเทิน	machicolation	Nan	battlements
ช่วงปี	the year	Nan	the year
ช็อกโกแลต	chocolate	Nan	chocolate
ชไนเดอร์	schneider	Nan	schneider
ชโย	cheer; hurray	Nan	bravo
ชูศักดิ์	chusak	Nan	chusak
ชูมันน์	schumann	Nan	schumann
ช่อง	channel	Nan	channel
ชื่อดัง	famous	Nan	famous
ซึ่งมีทั้งหมด	in total of	Nan	which has all
ซึ่งเกิดจากปัจจัยภายนอก	which is caused by external factors	Nan	caused by external factors
ดอกอ้อ	dok aou	Nan	reed flower
ดอกไม้	flower	Nan	flower
ดอกไม้ประจำจังหวัด	provincial flower	Nan	provincial flower
ดอตคอม	dotcom	Nan	dot com
ดอนเมือง	don mueang	Nan	don mueang
ดอยอินทนนท์	doi inthanon	Nan	doi inthanon
ดอร์	door	Nan	door
ดอลลาร์สหรัฐ	united states dollar	Nan	us dollar
ดอว์ขิ่นจี	dorkingi	Nan	dawin ji
ดังนั้น	for that reason	Nan	so
ดังเช่น	like	Nan	like
ดัชนีการพัฒนามนุษย์	human development index	Nan	human development index
ดัตช์	dutch	Nan	dutch
ดันแฮม	dunham, the mother of barrack obama	Nan	dunham
ดับเบิลยู	letter w	Nan	w.
ดา	da - a thai nickname	Nan	da
ดาบ	sword	Nan	sword
ดาวอาร์คตุรุส	arcturus	Nan	arcturus
ดาวศุกร์	venus	Nan	venus
ดาวยูเรนัส	uranus	Nan	uranus
ดาวพุธ	mercury	Nan	mercury
ดาวพฤหัสบดี	jupiter	Nan	jupiter
ดาวคาโนปุส	canopus star	Nan	canapas
ดอก	flower	Nan	flower
ดาวกระจาย	star disperse	Nan	starburst
ดาราศาสตร์รังสีเอ็กซ์	x-ray astronomy	Nan	x-ray astronomy
ดาราจักร	galaxy	Nan	galaxy
ดาราคู่แรกของไทย	first movie stars in thailand	Nan	the first star in thailand
ดารากร	actor	Nan	actor
ดารา	star	Nan	star
ดาบเขี้ยวฟ้าฟื้น	sky fang sword of revival	Nan	the sword of revenge
ดาราหญิงไทยยอดนิยม	famous actress	Nan	popular thai female celebrities
ซึ่งรู้จักกันว่า	called	Nan	which is known as
ดวงอาทิตย์	sun	Nan	the sun
ดราก้อนเควสต์	dragon quest	Nan	dragon quest
ซึ่งเรียกว่า	called	Nan	which is called
ซึ่งแท้จริงแล้ว	real name	Nan	in truth
ซึ่งได้แก่	which are	Nan	which are
ซุง	sung	Nan	log
ซุน	sun	Nan	sun
ซุปเปอร์มาร์เก็ต	supermarket	Nan	supermarket
ซุปเปอร์เซ็นเตอร์	super center	Nan	super center
ซู	holding up high	Nan	sue
ซูจี	fuji	Nan	suzy
ซูซูกิ	suzuki	Nan	suzuki
ซูรินาเม	suriname	Nan	suriname
ซูเปอร์เซ็นเตอร์	super center	Nan	super center
ซ่อมแซม	repair	Nan	repair
ซ่าหริ่ม	a type of thai dessert	Nan	be happy
ซ้าย	left	Nan	left
ฌอง	jean - french name	Nan	jean
ญ	a thai alphabet with a y sound	Nan	the
ดราก้อน	dragon	Nan	dragon
ดรสุชาติ	dr. suchart	Nan	dr suchart
ดรสาโรช	dr. sarot	Nan	dr saroj
ดรนิพนธ์	doctor nipon	Nan	dr nipon
ดรทรงศักดิ์	doctor songsuk - a famous person	Nan	dr songsak
ดม	smell	Nan	smell
ดวงพร	dwongpol	Nan	fortune
ดง	area, location	Nan	thrush
ณัฐวุฒิ	nattawut	Nan	nattawut
ณัฏฐธิดา	nattathida - a thai female actress	Nan	natthida
ณรงค์	campaign	Nan	campaign
ณภัทร	napat	Nan	naphat
ฐานทัพ	armforce	Nan	cantonment
ฐานข้อมูล	database	Nan	the database
ด	a letter from thai alphabet	Nan	m
ดาวเคราะห์	planet	Nan	planet
ชีวสถิติ	biostatistics	Nan	biostatistics
ชีวประวัติ	biography	Nan	biography
จำนวน	number	Nan	number
จำนวนประชากร	population	Nan	population
จำปาเทศ	a specific type of magnolia tree; similar michelia champaca	Nan	champa
จำเริญ	jamroen	Nan	prosper
จิกะไบต์	gigabyte	Nan	jigtes
จิตรกร	painter	Nan	painter
จิตรกรรม	painting	Nan	painting
จิตวิทยา	psychology	Nan	psychology
จิตใจ	mind	Nan	mind
จินตหรา	jinnara - a female's name who is a singer	Nan	jintara
จิบูตี	ji bu dee event on june 27	Nan	djibouti
จิบเบอเรลลิน	gibberellin	Nan	gibberellin
จิม	jim	Nan	jim
จิโอวานนี	giovanni	Nan	giovanni
จี	g	Nan	g
จีนตัวย่อ	simplified chinese characters	Nan	simplified chinese
จียอน	๋jiyeon (korean name)	Nan	jiyeon
จเพชรบูรณ์	province pechaboon	Nan	phetchabun
จเพชรบุรี	pedchaburee province	Nan	phetchaburi
จเชียงใหม่	chiang mai	Nan	chiang mai
จูเนียร์	junior	Nan	junior
จูเซปเป	giuseppe	Nan	giuseppe
จูล	joule	Nan	joule
จำกัดมหาชน	limited	Nan	limited
จุฬาลงกรณินทรวรางกูร	new title for the princess	Nan	chulalongkorn nintharangrangkun
จุดจอมฟ้า	zenith	Nan	blue point
จุดกึ่งกลาง	midpoint	Nan	midpoint
จุกนมสีขุ่น	corrupted pacifier	Nan	opaque teat
จึงใช้ธาตุหมอกและเมฆาได้	using magic with cloud and spells	Nan	therefore can use the element of mist and cloud
จึงเปิดโอกาสให้	open up opportunities	Nan	therefore gave the opportunity
จึงทรงพระกรุณาโปรดเกล้า	be kind enough to	Nan	therefore graciously ordered
จุลจอมเกล้าเจ้าอยู่หัว	phra chunla chom klao chao yu hua	Nan	vajiralongkorn
จ๊กมก	jokmok - a surname of a comedian	Nan	jumkum
จำกัด	limited	Nan	ltd.
จารุเสถียร	charusathien	Nan	jaru sathien
จังหวัดเพชรบูรณ์	petchabun province	Nan	phetchabun
จังหวัดเลย	loei (name of thai province)	Nan	loei province
จังหวัดแพร่	phrae	Nan	phrae
จังหาร	changhan	Nan	junghan
จัดขึ้นเมื่อ	held on	Nan	held on
จัดตั้งขึ้นโดย	established by	Nan	established by
จัดอยู่ในภูมิภาค	in region	Nan	organized in the region
จัดเมื่อวันที่	held on	Nan	held on
จัดโดย	arrange by	Nan	arranged by
จัน	chan	Nan	chan
จันทบุรี	juntaburi state	Nan	chanthaburi
จันทร	moon	Nan	moon
จันทรุปราคา	lunar eclipse	Nan	lunar eclipse
จันทร์	chan	Nan	monday
จันทร์ภักดี	juntapukdee - surname of a famous actor	Nan	chan phakdi
จันทร์เกษ	juntagaset - a surname	Nan	chan ket
จาก	from	Nan	from
จารีตประเพณี	tradition	Nan	tradition
จามจุรี	jamjuri flower	Nan	jamjuree
จาติกวณิช	chatikavanij	Nan	chatikavanij
จากโซล	from soeul	Nan	from seoul
จากเว็บไซต์กระทรวงต่างประเทศ	from the foreign government affairs website	Nan	from the website of the ministry of foreign affairs
จากเว็บไซต์กระทรวงการต่างประเทศ	from the website of foreign department	Nan	from the website of the ministry of foreign affairs
จาวตาลเชื่อม	sweetened palm - a type of thai dessert	Nan	jao tan weld
จากเว็บ	from the web	Nan	from the web
จากอัลบั้ม	from the album	Nan	from the album
จากสารานุกรมบริทานิกา	from printed information	Nan	from the encyclopaedia britannica
จากละครเรื่อง	from the soap opera	Nan	from the drama
จากละคร	from drama	Nan	from the drama
จากภาษากรีก	greek language	Nan	from greek
จากการพิสูจน์อายุโดยคาร์บอน	from the forensic carbon dating	Nan	from the proof of age by carbon
จากเรื่อง	from the story of ...	Nan	from the story
ชีวมวล	alternative (natural) power	Nan	biomass
ฉ	ninth thai alphabet	Nan	f
ฉบับวณิพก	begger version	Nan	numerals
ชั้นมหาวชิรมงกุฎ	order of the king's jewels	Nan	crown maha vajiraj
ชั้นยศ	rank	Nan	rank
ชั้นสูงสุด	special class	Nan	highest level
ชา	tea	Nan	tea
ชากะ	shaka	Nan	shaka
ชาคริต	charkrit	Nan	alert
ชาญชัย	chanchai	Nan	chanchai
ชาตะ	born	Nan	be born
ชาติ	nation	Nan	nation
ชาย	male	Nan	male
ชาร์ป	sharp	Nan	sharp
ชาร์ล	charles	Nan	charles
ชาร์ลส	charles	Nan	charles
ชาลส์	charles	Nan	charles
ชาลี	charlie	Nan	charlie
ชาวนา	farmer	Nan	farmer
ชาวไทย	thai	Nan	thai people
ชีวนิชพันธ์	chiwanitphan	Nan	biological
ชีพด็อก	chief dog	Nan	sheepdog
ชิโนะ	shino	Nan	chino
ชิลี	chile	Nan	chile
ชิริว	cherew - a japanese character	Nan	chiryu
ชินวัตร	shinawatra	Nan	shinawatra
ชั้นประทวน	non-commissioned officer	Nan	floor
ชิน	get used to	Nan	accustomed
ชิซุกะ	shizuka	Nan	shizuka
ชิงร้อยล้าน	ching roi lan	Nan	compete for a hundred million
ชิงร้อย	ching roi	Nan	compete
ชิคิกามิ	shikigami	Nan	shikikami
ชำนิ	chumni - a location in thailand	Nan	chamni
ชาวไทยภูเขา	thai hill tribe	Nan	hill tribe
ชิดจันทร์	chidjun (a person's last name)	Nan	chidchan
ฉบับชั่วคราว	special (temporary) edition	Nan	temporary version
ชั้นที่	order	Nan	floor
ชัยยุทธ	chaiyuth (first name)	Nan	chaiyut
ฉลอง	celebrate	Nan	celebrate
ฉลองพระชนมายุ	celebrated birth anniversary of	Nan	celebrate the 80th year
ฉันรักคุณ	i love you	Nan	i love you
ฉาบ	cymbal	Nan	plaster
ฉายเมื่อ	aired	Nan	show on
ฉิ่ง	cymbal	Nan	cymbal
ฉี่	qi	Nan	pee
ชนะ	winning	Nan	win
ชนิด	type	Nan	type
ชนิดของเมฆ	types of clound	Nan	cloud type
ชม	chom	Nan	watch
ชมชื่น	chomchuen	Nan	compliment
ชมพู	rose apple	Nan	pink
ชมพูทวีป	south asia	Nan	india
ชมพู่	rose apple	Nan	rose apple
ชล	chol (first name)	Nan	lakes
ชลธารวิทยา	limnology	Nan	chaloem wittaya
ชัยมงคล	chaimongkol - a male's name	Nan	chaimongkol
ชัยบัญชา	chaibancha	Nan	chai bancha
ชัยนาม	chainam	Nan	chai nam
ชัยชนะ	chaichana	Nan	victory
ชัย	chai	Nan	victory
ชัชพล	chatchapol - a male's name	Nan	chatchapon
ชั้น	class	Nan	class
ชะอำ	cha-am (name of thai district)	Nan	cha-am
ชะมด	anteater	Nan	musk
ชะนี	gibbon	Nan	gibbon
ชอบ	like	Nan	like
ชวนชื่น	choun cheen - a surname	Nan	inviting
ชลิต	chalit	Nan	chalit
ชลบุรี	chon buri	Nan	chon buri
ชะอวด	chaoud - location in thailand	Nan	show off
ดาวเคราะห์แคระ	dwarf planet	Nan	dwarf planet
ดาวเสาร์	saturn	Nan	saturn
ดำรงค์	dumrong - a male's name	Nan	wimax
ทองใหญ่	tong yai - a name	Nan	big gold
ทอม	tom	Nan	tom
ทอมสัน	thomson	Nan	thomson
ทอมัส	thomas	Nan	thomas
ทะเล	sea	Nan	sea
ทะเลทราย	dessert	Nan	desert
ทะเลสาบ	lake	Nan	lagoon
ทักษะ	skill	Nan	the skills
ทัช	touch	Nan	touch
ทับ	thon-rammana	Nan	slash
ทัพเรือภาคที่	naval area command	Nan	naval department
ทัวร์คอนเสิร์ต	concert tour	Nan	concert tour
ทั่วไป	general	Nan	general
ทั้ง	all	Nan	both
ทั้งหมด	all	Nan	all
ทางทิศตะวันออก	east	Nan	east
ทางทิศตะวันออกติดกับเวียดนาม	borders vietnam to the east	Nan	the east borders vietnam.
ทำให้	made	Nan	make
ทำหน้าที่	task, function	Nan	do the duty
ทำบุญตักบาตรฯ	put food offerings into a buddhist monk's bowl	Nan	making merit and offering food to monks
ทำนอง	melody	Nan	tune
ทำงาน	working	Nan	work
ทาวเวอร์	tower	Nan	the tower
ทองแดง	copper	Nan	copper
ทาร์ดิกราดา	tardigrada	Nan	tardikrada
ทางไอทีวี	via itv ( a television station in thailand)	Nan	on itv
ทางอากาศ	by air	Nan	by air
ทางหลวงพิเศษ	motorway	Nan	special highway
ทางรถไฟ	rail	Nan	the train
ทางน้ำ	by water	Nan	water way
ทางทิศเหนือติดกับประเทศไทยและลาว	borders thailand and laos to the north	Nan	the north borders thailand and laos.
ทานากะ	tanage - a japanese name	Nan	tanaka
ทิฆัมพรธีรวงศ์	timkamporntiravong (thai last name)	Nan	tikamporn thirawong
ทองเจือ	tong jea - a surname	Nan	gold laced
ทองหยอด	a type of thai dessert	Nan	gold leaf
ทรงคล้ายทรงกลม	spheroid	Nan	spherical
ทรงถือหุ้นจำนวน	stock ownership	Nan	his highness holds shares in
ทรงผนวช	ordain	Nan	his highness
ทรงพระกรุณาโปรดเกล้าโปรดกระหม่อมให้	gift (word for the king)	Nan	graciously consecrate me
ทรงยี่สิบหน้า	icosahedron	Nan	twenty face
ทรงลูกบาศก์	cube	Nan	cube
ทรงสี่เหลี่ยมขนมเปียกปูน	rhombohedron shaped	Nan	rhombus
ทรงสี่เหลี่ยมมุมฉาก	triangular prism	Nan	rectangle
ทรงห้าหน้า	polyhedron	Nan	five face
ทรงได้รับการทูลเกล้าฯ	the king of thailand gives out ____ to people	Nan	received his majesty the king
ทรัพยากร	resources	Nan	resource
ทรัพยากรน้ำ	water resources	Nan	water resources
ทรัพย์วิจิตร	wealth	Nan	wealth
ทรัพย์เพิ่ม	subpherm	Nan	additional assets
ทรัมเป็ต	trumpet	Nan	trumpet
ทรีทูวัน	three to one	Nan	three to one
ทวารหนัก	anus	Nan	anus
ทองผาภูมิ	thong pha phum	Nan	thong pha phum
ทองประสม	gold	Nan	gold
ทองขาว	white gold	Nan	white gold
ทอง	gold	Nan	gold
ทหารอากาศ	air force	Nan	air force
ทหารหน่วยอาเฟลันดราที่	afelandra army	Nan	the aphelandra military unit
ทองหล่อ	gold	Nan	thonglor
ทหาร	soldier	Nan	soldier
ทศกัณฐ์	ravana	Nan	tosakan
ทว่า	however	Nan	but
ทวีวัฒน์	taweewan	Nan	thawiwat
ทวีปเอเชีย	asia	Nan	asia
ทวีปอเมริกา	america	Nan	america
ทวีป	continent	Nan	continent
ทศพล	thotsaphon	Nan	tosapon
ทนายความ	lawyer	Nan	lawyer
ทิพย์	thip	Nan	thip
ทิม	tim	Nan	tim
ท่าน้ำนนท์	nam non pier	Nan	waterfront
ท่ายาง	tha yang	Nan	rubber stamp
ท่าศาลา	sala pier	Nan	tha sala
ท่าอากาศยานเลย	loei airport	Nan	loei airport
ท่าเรือ	pier	Nan	port
ท่าไม้ตาย	deadly move	Nan	settler
ท้องสนามหลวง	sanamloung - a landmark in thailand	Nan	sanam luang
ธกรุงไทย	krung thai bank	Nan	krung thai bank
ธกส	bank for agriculture and agriculture	Nan	baac
ธกสิกรไทย	kasikornbank	Nan	kasikorn bank
ธง	flag	Nan	flag
ธงชัย	thongchai	Nan	thongchai
ธงชาติ	national flag	Nan	national flag
ธงธง	flag	Nan	flag
ธนบุรี	thonburi	Nan	thonburi
ธนพร	thanaporn	Nan	thanaporn
ธนะรัชต์	tanarat -a surname	Nan	thanarat
ธรรมนูญ	law	Nan	charter
ธรณีสัณฐานวิทยา	geomorphology	Nan	soil morphology
ธรณินทราธิราช	having to do with the king	Nan	tharawintharathirat
ธปท	bot	Nan	bot
ธนิต	thanit	Nan	thanit
ธนาคารไทยพาณิชย์	siam commercial bank	Nan	siam commercial bank
ท่านอ้วน	than uan	Nan	fat man
ธนาคารเพื่อการพัฒนาแห่งเอเชีย	patana asia bank	Nan	asian development bank
ธนาคารอิสลามแห่งประเทศไทย	islamic bank of thailand	Nan	islamic bank of thailand
ธนาคารทิสโก้	tisco bank	Nan	tisco bank
ธนาคารทหารไทย	tahanthai bank	Nan	thai military bank
ธนาคารกรุงไทย	krung thai bank	Nan	krung thai bank
ธนาคารกรุงศรีอยุธยา	bank of ayudhya	Nan	bank of ayudhya
ธนาคาร	bank	Nan	bank
ธนาคารเกษตร	farmer's bank	Nan	agricultural bank
ทิฟฟานี่	tiffany - female's name	Nan	tiffany
ท่านอ่อง	tan ong - a member of the royal family	Nan	ong
ท่าชนะ	thachana	Nan	posture
ทิวานนท์	thiwanon	Nan	tiwanon
ทิศตะวันตก	west	Nan	west
ที	t	Nan	t
ทีบีเอส	tbs	Nan	tbs
ทีมชาติไทย	thai national team	Nan	thailand national team
ทีมใดที่จำนวนข้อที่ถูกน้อยกว่า	the team with the least correct answers	Nan	which team has the lower number than
ทีวีอินไซด์	tv inside	Nan	tv inside
ทีโอที	tot	Nan	tot
ที่จ่ายร้อยละ	costing	Nan	that pays a percentage
ที่นี้	here	Nan	here
ที่ประชาชนชอบมากที่สุด	people's most favorite	Nan	which people like the most
ที่มา	source	Nan	source
ที่มี	possess	Nan	that has
ที่มีชื่อว่า	named	Nan	named
ที่สำคัญ	important	Nan	the key
ที่หมายถึง	explanation	Nan	that means
ที่อยู่อาศัย	residence	Nan	residence
ท่องอาณาจักรโฮ่งเหมียว	traveling the kingdom of woof-meow	Nan	recite the kingdom of hong miao
ทไย	thayai	Nan	why
ทโกมลบุตร	komolbut - a surname	Nan	thakomolabut
ทเวนตี้	twenty	Nan	twenty
ทูล	thun	Nan	tool
ทู	too	Nan	too
ท่านอิน	than in	Nan	thanin
ทุ่งใหญ่	tungyai	Nan	thung yai
ทุ่งตะโก	thung tako district	Nan	thung tako
ทุติยจุลจอมเกล้าวิเศษ	tuthit julajomklawwiset - the title of those you received jewelry from the king	Nan	vessels
ทุกครั้ง	every time	Nan	every time
ทุก	every	Nan	each
ที่โดดเด่นคือ	notable	Nan	the outstanding is
ที่เกิดขึ้น	appear	Nan	that happened
ทุ่งสง	tong song or nakon sri thamarat state	Nan	thung song
ทนาย	lawyer	Nan	lawyer
ทนงศักดิ์	thanongsak	Nan	thanongsak
ทดลอง	experiment	Nan	trial
ด้านหน้า	front	Nan	front
ด้านหลัง	backside	Nan	the back
ด้านอ่าวไทย	gulf of thailand side	Nan	gulf of thailand
ต	a letter from thai alphabet with th sound	Nan	o
ตกรอบที่	did not make the cut	Nan	eliminated
ตรงกับวันขึ้น	on the date of	Nan	match up
ตรงกับวันที่	on the date of _______________	Nan	match date
ตระกูล	clan	Nan	clan
ตระกูลนารา	nara family	Nan	nara family
ตระกูลปาร์ค	park family (korean last name)	Nan	clan park
ตระกูลยามานากะ	yamanaka clan	Nan	yamanaka family
ตระกูลอินุซึกะ	inu-tsuka family	Nan	inuzuka family
ตระกูลเซนจู	chen ju dynasty	Nan	senju family
ตรัง	trang	Nan	trang
ตรางู	snake	Nan	snake
ตราด	trad state	Nan	trat
ตรานี้	this seal	Nan	this seal
ตันติเวชกุล	tantivejkul	Nan	tantivejkul
ตะวันออกเฉียงเหนือ	east	Nan	north east
ตะวันออก	east	Nan	east
ตะวันทอแสง	tawanthosaeng	Nan	sun rise
ตะลุยอวกาศ	space trek	Nan	space dabble
ตะละภัฏ	talaput - a surname	Nan	talapat
ด้านดนตรี	in music	Nan	music
ตะกั่ว	copper	Nan	lead
ตอน	at	Nan	at
ตลาดโลตัส	lotus market	Nan	lotus market
ตลาด	market	Nan	market
ตรุษจีน	chinese new year	Nan	chinese new year
ตรึงใจ	truengjai	Nan	fascinate
ตราสัญลักษณ์	symbol	Nan	emblem
ตะกร้อ	takraw	Nan	muzzle
ตัว	body	Nan	body
ด้านการเกษตร	agriculture	Nan	agricultural
ด้านการกีฬา	sports	Nan	sports
ดำรงตำแหน่ง	hold the title of	Nan	hold a position
ดำรงอ่องตระกูล	dumrongongtrakul	Nan	damrong ong family
ดำเนินสะดวก	damnoen saduak	Nan	damnoen saduak
ดิกชันนารี	dictionary	Nan	dictionary
ดิค	dick - the name	Nan	dick
ดิจิตอล	digital	Nan	digital
ดิน	soil	Nan	soil
ดินเซนฮอฟเฟอร์	dientzenhofer - as in christoph or leonhard or johannes	Nan	zenhoffer
ดินแดน	territory	Nan	territory
ดิว	dew	Nan	dew
ดิวิชั่น	division	Nan	division
ดิศ	dis (thai first name)	Nan	disc
ดิศกุล	disakul (last name)	Nan	diskun
ดิสนีย์	disney	Nan	disney
ดิสโพรเซียม	dysprosium	Nan	dysprosium
ดี	good	Nan	good
ดีคอนสตรักทิวิสม์	deconstructivism	Nan	dconrak tavist
ด้วยเหตุนี้	for this reason	Nan	for this reason
ด้วย	with	Nan	with
ด็อก	dog	Nan	dog
ดูแล	care	Nan	care
ดูเร็กซ์	durex	Nan	durex
ดูเพิ่มเติมที่	see also	Nan	see also
ด้านการต่างประเทศ	foreign affairs	Nan	foreign affairs
ดูเพิ่มเติม	see also	Nan	see more
ดุสิต	dusit	Nan	dusit
ดีเอ็นเอ	dna	Nan	dna
ดีเวลลอปเม้นท์	development	Nan	development
ดีเวลลอปเมนท์	development	Nan	development
ดีบุก	tin	Nan	tin
ดีน	religion (islamic term)	Nan	dean
ดูที่	see	Nan	look at
ตัวพระ	main character	Nan	protagonist
ตัวยักษ์	giant	Nan	giant
ตัวละคร	character	Nan	the character
ติณสูลานนท์	thinasulanon	Nan	tinsulanon
ติอามัต	tiarmut	Nan	tiamat
ตี๋ใหญ่	ti yai	Nan	big tee
ตึก	building	Nan	building
ตุรกี	turkey	Nan	turkey
ตุลาคม	october	Nan	october
ตุ๊กแก	gecko	Nan	gecko
ตูน	toon	Nan	cartoon
ต่อกันด้วยพันธะ	linked by bond	Nan	continue with bonds
ต่อจาก	resulting from	Nan	continue from
ต่อมา	later	Nan	later
ต่อมาวันที่	later on the date	Nan	next date
ต่อมาในปี	later in the year	Nan	later in the year
ต่อมาในรัชกาลที่	afterwards, in the reign of	Nan	later in the reign
ต่อมาในสมัยกรุงธนบุรีและกรุงรัตนโกสินทร์เขมรตกอยู่ภายใต้การควบคุมของจักรวรรดิสยามอย่างเข้มงวด	later in thonburi period and rattanakosin period	Nan	later, in the thonburi and rattanakosin periods, the khmer was under strict control of the siamese empire.
ต่าง	different, various	Nan	different
ต่างๆ	various, different	Nan	various
ถ้อยคำ	accent	Nan	words
ถ้วย	cup	Nan	cup
ถึงเดือนกรกฎาคม	starting july	Nan	to july
ถึงกระนั้น	until	Nan	nonetheless
ถวาย	offer	Nan	offer
ถมิตรภาพ	mittraphap road	Nan	friendship
ตำบลไพรขลา	phrai khla subdistrict	Nan	phrai khala subdistrict
ถนนสุขุมวิท	sukhumvit road	Nan	sukhumvit road
ถนนประชาธิปก	prachatiphok road	Nan	democracy road
ถนนคนเดิน	kon dern road	Nan	walking street
ถนน	road	Nan	road
ต้นสกุล	clan	Nan	genus
ต้นตอจักรวาลวิทยา	cosmogony	Nan	cosmology origin
ต้น	medication for multi-symptoms	Nan	beginning
ถนนมิตรภาพ	thanon mittraphap	Nan	friendship road
ตำบลโพนครก	tambon poncrok	Nan	phon nakorn
ตำบลเมืองบัว	muangbua district	Nan	bua subdistrict
ตำบลสังขะ	thambol sangka	Nan	sangkha
ตั้งอยู่ที่	located	Nan	located at
ตั้งงี่สุ่น	tang ngee soon	Nan	tang ngeon
ตัวแปร	variable	Nan	variable
ตัวเลขอย่างเป็นทางการ	official number	Nan	official numbers
ตัวอย่างเช่น	for example	Nan	for example
ตัวอย่างภาพยนตร์	movie trailer	Nan	movie trailer
ตั้งอยู่เลขที่	at house number	Nan	located at
ตัวอย่างต้นแบบแรก	holotype	Nan	first prototype example
ตัวอย่างคำบาลี	bali example words	Nan	pali example
ตัวอย่าง	example	Nan	example
ตัวหาร	divisor	Nan	divisor
ตัวสะกด	final consonant	Nan	spelling
ตัวลิง	monkey	Nan	monkey
ตัวละครจากเรื่อง	soap opera based on a written story	Nan	the characters from the story
ตัวอย่างคำประพันธ์	sample writing	Nan	sample rhyme
จังหวัดเพชรบุรี	petcharaburi state	Nan	phetchaburi province
ตั๊กแตน	grasshopper	Nan	grasshopper
ตาคลี	ta-klee	Nan	takhli
ตำบลระแงง	ra-ngang district	Nan	rahang district
ตำบลยะวึก	tambon yawuek	Nan	yuwak district
ตำบลบ้านกง	tambon bankong (name of the district)	Nan	ban kong subdistrict
ตำบลนาดี	na dee district	Nan	nadi subdistrict
ตำบลนางแล	nang lae province	Nan	nanglae subdistrict
ตำบลตาเมียง	tambon tameung	Nan	ta myung district
ตา	ta (a person's name)	Nan	eye
ตำบลกังแอน	ung gan district	Nan	gang ann district
ตำนานแฝงคำสอน	tales	Nan	legendary teachings
ตำนานวายุสลาตัน	shippuden	Nan	the legend of a storm
ตาราง	table	Nan	table
ตาระวา	tarawa	Nan	tarawa
ตามตำราพรหมชาติฉบับหลวง	by royal botanic manual/handbook	Nan	according to the royal textbook of the brahma
ตามตัวสวมเครื่องประดับต่าง	accessories	Nan	as he wore different ornaments
ตำบลกระเทียม	garlic district	Nan	garlic subdistrict
ธรรมศักดิ์	tamasak - surname of an elected prime minister	Nan	thammasak
จังหวัดเชียงใหม่	chiang mai province	Nan	chiang mai province
จังหวัดเชลลา	chella city	Nan	shella
การท่องเที่ยว	tourism	Nan	the tourism
การท่าเรือ	port authority	Nan	port authority
การบริการ	service	Nan	service
การบริหารการพัฒนา	development	Nan	development management
การบริหารการศึกษา	educational administration	Nan	educational administration
การบริหารจัดการ	management	Nan	management
การบริหารราชการแผ่นดิน	administration	Nan	government administration
การบินไทย	thai airways	Nan	thai airways
การปกครองท้องถิ่น	local government	Nan	local government
การปกครองส่วนท้องถิ่น	local government	Nan	local government
การปกครองแบ่งออกเป็น	administration	Nan	the rule is divided into
การปฏิรูประบบจัดเก็บภาษีเงินได้	taxation reform	Nan	reform of the income tax collection system
การปฏิรูปศาสนา	religious reformation	Nan	reformation
การปฏิวัติฝรั่งเศส	french revolution	Nan	french revolution
การปฏิวัติอุตสาหกรรม	industrial revolution	Nan	industrial revolution
การปฏิสนธิ	fertilization	Nan	fertilization
การประมง	fishery	Nan	fisheries
การสั่นพ้อง	resonance	Nan	resonance
การสังคายนาครั้งที่	the event of convention of monks	Nan	the last order
การศึกษา	study of, education	Nan	the education
การวิเคราะห์	analysis	Nan	the analysis
การวิจัย	research	Nan	research
การละเล่นพื้นบ้าน	local game	Nan	folk games
การทำป่าไม้	forestry	Nan	forestry
การลดรูป	reduction	Nan	deforming
การรักษาพยาบาล	nursing care	Nan	medical treatment
การระบาดของไข้หวัดใหญ่สายพันธุ์ใหม่	flu pandemic	Nan	the new strain of influenza
การยึดครองมะละกาของโปรตุเกสในปี	portugal took over malaga	Nan	portuguese occupation of melaka in the year
การพูด	speaking	Nan	speaking
การพัฒนาประชาธิปไตย	democratic development	Nan	democratic development
การพัฒนา	development	Nan	the development
การร่วมเพศทางทวารหนัก	sodomy	Nan	anal fucking
การสำเร็จความใคร่ด้วยตนเอง	masturbation	Nan	masturbation
การทำงานของ	function	Nan	the work of
การตั้งถิ่นฐาน	start a project	Nan	settlement
กัมพูชาประชาธิปไตย	democratic kampuchea	Nan	democratic cambodia
กัมพูชาเป็นประเทศที่มีป่าไม้อุดมสมบูรณ์มากที่สุดหากเปรียบเทียบกับประเทศเพื่อนบ้าน	cambodia is the country with nice, healthy forests	Nan	cambodia is the country with the most abundant forests when comparing with neighboring countries.
กัมพูชาเป็นอดีตประเทศอาณานิคมของฝรั่งเศสในภูมิภาคเอเชียตะวันออกเฉียงใต้เพียงแค่ประเทศเดียวเท่านั้นที่มีการปกครองด้วยระบอบราชาธิปไตยภายใต้รัฐธรรมนูญ	cambodia was a former french colony	Nan	cambodia is the only former french colonial country in southeast asia that has monarchy under the constitution.
กัมพูชาเป็นอาณานิคมของฝรั่งเศสมาตั้งแต่พศ	cambodia was a france colony from year	Nan	cambodia has been a french colony since.
กัวเตมาลา	guatemala	Nan	guatemala
กานซู	honshu in china	Nan	gansu
กานต์	kan	Nan	kan
กานา	ghana	Nan	ghana
กานามัยซิน	kanamycin	Nan	kanamycin
กาบอง	baton	Nan	gabon
กาพย์ฉบัง	poem	Nan	epic poem
กาพย์สุรางคนางค์	poem	Nan	poem
กาม	lust	Nan	wanton
กาย	body	Nan	body
การ	project	Nan	the
การกีฬา	sports	Nan	sports
การขัดเกลาทางสังคม	socialization	Nan	socialization
การตอบรับ	welcoming	Nan	feedback
การดำเนินการ	progression	Nan	an operation
การชัก	the act of pulling the flag wiht string up the pole	Nan	seizure
การจูบ	kissing	Nan	a kiss
การจัดให้มี	putting together something	Nan	provision
การจัดอันดับ	ranking	Nan	ranking
การต่างประเทศ	foreign affairs	Nan	foreign affairs
การจัดการคุณภาพ	quality control	Nan	quality management
การค้า	marketing	Nan	the trade
การค้นพบ	discover	Nan	the discovery
การคลัง	public finance	Nan	finance
การคมนาคม	transportation department	Nan	transportation
การขับไล่	discharge	Nan	eviction
การขับถ่าย	excretion	Nan	excretion
การจัดการ	project	Nan	the management
กัมพูชา	cambodia	Nan	cambodia
การสืบพันธุ์	reproduction	Nan	reproduction
การาจ	garage	Nan	garage
กุหลาบ	rose	Nan	rose
กุ้ง	shrimp	Nan	shrimp
กุ้งต้ม	boiled shrimp	Nan	boiled shrimp
กูเกิล	google	Nan	google
ก็คือ	is	Nan	is
ก็ใช้เป็น	utilize	Nan	used as
ก่อตั้ง	founded	Nan	founded
ก่อตั้งโดย	make by	Nan	founded by
ก่อนที่	before	Nan	before
ก่อนที่จะตกเป็นของฝรั่งเศสในเวลาต่อมา	belonging to france, under the control of france	Nan	before becoming france later
ก่อนหน้านั้น	before	Nan	before that
ก้อย	koi	Nan	pinky
ก้าน	thorn	Nan	stalk
ก้านกล้วย	kankluai	Nan	banana stalk
ก๊าซธรรมชาติ	natural gas	Nan	natural gas
ก๎ล	magic	Nan	gift
ขขขขขขขขขข	repeated letter from thai alphabet	Nan	b b b b b b b
ขบวนการอ๊บอ๊บป่วนโลก	original name is keroro gunso	Nan	the movement of the earth
ขนาดใหญ่	large size	Nan	large size
ขนาดหน้าตัก	lap size	Nan	lap size
ขนอม	kanom - location in thailand	Nan	khanom
ขนสัตว์	fur, animal hair	Nan	wool
ขนมไทย	thai dessert	Nan	thai dessert
กุลละวณิชย์	kullawanich	Nan	kulalawanit
ขนมเปียกปูน	a type of thai dessert with flour and sugar	Nan	rhombus
ขนมปัง	bread	Nan	bread
ขนมครก	kind of thai sweetmeat	Nan	knmcrk
ขนมกล้วย	banana dessert	Nan	banana
ขนม	candy	Nan	candy
ขณะที่	while	Nan	while
ขณะทรงพระเยาว์	having to do with the young prince or princess	Nan	while he was young
ขนมปังขิง	gingerbread	Nan	gingerbread
การสื่อสาร	communications	Nan	communication
กุลดิลก	kuldilok	Nan	kuldilok
กีฬาแหลมทอง	seap games	Nan	laem thong sport
การุณ	karoon	Nan	karun
การเต้นรำ	dance	Nan	the dance
การเพิ่มสิทธิประโยชน์แก่นักลงทุนต่างประเทศ	increase benefits for foreign investors	Nan	increasing privileges for foreign investors
การเล่น	play	Nan	to play
การแข่งขัน	competition	Nan	the competition
การแบ่งพื้นที่	land division	Nan	partitioning
การใช้คำ	terminology	Nan	word usage
การไฟฟ้าส่วนภูมิภาค	distribution electric transformer	Nan	provincial electricity authority
การไหว้	thai greeting	Nan	respect
การ์ด	card	Nan	card
กาฬสินธุ์	kalasin	Nan	kalasin
กาเวน	gawain	Nan	gawain
กาเหว่าที่บางเพลง	the cuckoo's song.	Nan	the raven of some songs
กำกับการแสดงโดย	produced by (movie)	Nan	directed by
กำกับโดยอภิชาติพงศ์	produced by apichartpong - a famous thai movie producer	Nan	directed by aphichat pong
กำมะถัน	sulfur	Nan	brimstone
กำลังจะปรับเปลี่ยนเป็น	is changing to	Nan	going to change to
กีฬาทางน้ำ	water sports	Nan	water sports
กีฬา	sport	Nan	sport
กีฏวิทยา	entomology	Nan	entomology
กิ๊ก	gig	Nan	kik
กิ้งกือ	millipede	Nan	millipede
กิ่งแก้ว	kingkaew	Nan	kingkaew
กุดจับ	mold	Nan	mold
กิโลไบต์	kilobyte	Nan	kb
กิมป์	gimp - gnu image manipulation program	Nan	gimb
กิจผลิต	production	Nan	production
กำแพงแสน	kampangsaen (name of district)	Nan	kamphaengsaen
กำแพงเมืองจีน	the great wall of china	Nan	the great wall
กำแพงเพชร	kamphaeng phet	Nan	kamphaeng phet
กำหนดตามสภาพภูมิศาสตร์	geography estimation	Nan	determined by geography
กิโลกรัม	kilogram	Nan	kg
ขบวนรถสินค้า	caravan of trucks	Nan	train
กัมปูเชีย	kampuchea	Nan	kampuchia
กันเอง	casual	Nan	amicably
กระดูกต้นแขน	humerus	Nan	humerus
กระดูกฝ่ามือ	metacapus	Nan	palms
กระดูกสะบัก	scapula	Nan	scapula
กระดูกสะบ้า	patella	Nan	patella
กระทรวงกลาโหม	defense ministry	Nan	ministry of defense
กระทรวงการคลัง	ministry of finance	Nan	ministry of finance
กระทรวงการต่างประเทศ	ministry of foreign affairs	Nan	ministry of foreign affairs
กระทรวงวัฒนธรรม	ministry of culture	Nan	ministry of culture
กระทรวงศึกษาธิการ	ministry of education	Nan	ministry of education
กระทรวงสาธารณสุข	ministry of public health	Nan	ministry of public health
กระทรวงอุตสาหกรรม	ministry of industry	Nan	ministry of industry
กระทรวงเกษตรและสหกรณ์	ministry of agriculture and cooperatives	Nan	ministry of agriculture and cooperatives
กระทรวงเศรษฐการ	ministry of commerce	Nan	ministry of economic affairs
กระทุ่มแบน	krathum baen district, samut songkram province	Nan	small basket
กระนวน	granuan - location in knon kan province	Nan	pitch
กระนั้น	however	Nan	nonetheless
กระบวนการสร้าง	anabolism	Nan	building process
กรัยวิเชียร	krivician - a surname	Nan	kraiwichian
กรัม	gram	Nan	gram
กรับเสภา	wooden rhythm clappers	Nan	krapao
กรับพวง	krap phuang	Nan	pick a bunch
กรับ	wooden rhythm clappers	Nan	pick up
กระแต	wasp	Nan	chipmunk
กระดูกค้อน	malleus, hammer bone	Nan	hammer bone
กระเพาะอาหาร	stomach	Nan	stomach
กระวนกระวาย	nervous	Nan	anxious
กระรอก	squirrel	Nan	squirrel
กระบี่กระบอง	krabi krabong (swordplay)	Nan	contest with swords
กระบะทราย	sand box	Nan	sand box
กระบอง	club	Nan	blackjack
กระบวนการสร้างและสลาย	metabolism	Nan	process of creating and disintegrating
กระหม่อม	head	Nan	head
กรานาดา	granada	Nan	granada
กรอง	screen	Nan	filter
กรมอุตุนิยมวิทยา	meteorological department	Nan	meteorological department
=	=	Nan	=
 °ซ  °ฟ 	เซลเซียส ฟาเรนไฮต์	Nan	° c ° f
 ซม	cm.	Nan	cm
 −°ซ  °ฟ	thai letters	Nan	- ° c ° f
×	×	Nan	×
γ	γ	Nan	γ
π	π	Nan	π
กกกก	a thai letter repeated 4 times	Nan	kg
กกกข	4 thai alphabets - jibberish	Nan	khor khor
กขขข	4 of thai letters	Nan	abc b
กขขขขขขข	abbbbbbb	Nan	a b a b b b a
กฎ	rule	Nan	rule
กฎของโคไซน์	law of cosines	Nan	cosine law
กฎแห่งกรรม	bad karma	Nan	karma
กติกา	rule	Nan	rules
กทม	bangkok	Nan	bangkok
กนู	gnu - computer related acronym	Nan	knight
กรมหลวงสงขลานครินทร์	prince of songkla	Nan	kromluang songkhla nakarin
กรมหลวงนราธิวาสราชนครินทร์	krom ma loung naratifatrachanakarin - the name of a royal family member	Nan	krom luang narathiwatratchanakharin
กรมศิลปากร	fine arts department	Nan	fine arts department
กรมรบพิเศษที่	special force group	Nan	the special combat department
กรมทหารราบที่	infantry regiment	Nan	infantry regiment
กรมควบคุมโรค	department of disease control	Nan	department of disease control
กรรชัย	kanchai	Nan	kanchai
กรมข่าวทหารอากาศ	communication department of the thai air force	Nan	department of the air force news
กรมขุนอิศเรศรังสรรค์	the convention of angels	Nan	krom khun isaresrangsan
กรณีที่	case	Nan	the case
กมลรัตน์	kamonrat	Nan	kamonrat
กมล	kamon	Nan	lily
กบฏทหารนอกราชการ	coup de lat	Nan	military insurrection
กบ	frog	Nan	frog
กรมขุนเพ็ชรบูรณ์อินทราชัย	department of....	Nan	kromkhunpetchaboon-indachai
กับนางสุจาริณี	with mrs. sujarinee	Nan	with mrs. sucharinee
กริม	grim	Nan	grimm
กรุง	capital	Nan	capital
กองการบินทหารเรือ	the flying section of the navy	Nan	naval aviation division
กองการศึกษา	education group	Nan	education division
กองการเจ้าหน้าที่	division of personnel	Nan	division of personnel
กองกำลังกึ่งทหาร	armforces	Nan	semi-military forces
กองคลัง	division of finance	Nan	finance division
กองทัพ	arm forces	Nan	the army
กองทัพบกไทย	thai army	Nan	thai army
กองทัพภาคที่	army area	Nan	army of the region
กองทัพเรือ	navy	Nan	navy
กองทัพเรือไทย	thai navy	Nan	thai navy
กองทัพแห่งความชอบธรรม	army of the righteous	Nan	army of righteousness
กองทัพไทย	thai army	Nan	thai army
กองบิน	air force	Nan	air force
กองบินปีกหมุนที่	flight corp number __________	Nan	wing spinning wing
กองพลทหารม้าที่	cavalry division	Nan	the cavalry brigade
กองพันทหารช่างที่	troop unit number ___________`	Nan	the engineer brigade
กอด	hug	Nan	hug
กันอริ	gan-ari	Nan	canary
กันฟอร์ม	gun form	Nan	form
กันทรลักษ์	kuntaraluk - an area in thailand	Nan	kantharalak
กันตัง	kuntun in trung state	Nan	kantang
กันดั้ม	gundam - a cartoon	Nan	gundam
กังหันชัยพัฒนา	chaipattana's windmill	Nan	chaipattana turbine
กองกลาง	headquarter	Nan	midfielder
กะโหลกศีรษะ	skull	Nan	skull
กะเหรี่ยง	karen	Nan	karen
กอล์ฟไมค์	golf-mike	Nan	golf mic
กอล์ฟ	golf	Nan	golf
กอลมเบต์	glombet - a catholic priest	Nan	goreme
กอร์ดอน	gordon	Nan	gordon
กอนซาเลซ	gonzales - a name	Nan	gonzalez
กะโหลก	skull	Nan	skull
กรี	karee	Nan	grey
กว่า	than	Nan	than
กวิน	kawin	Nan	kawin
กรุงธนบุรี	thonburi city	Nan	thon buri
กรุงลอนดอน	london	Nan	london
กรุงศรีอยุธยา	sri ayuttaya city - former capital of thailand	Nan	ayutthaya
กรุงเทพ	bangkok	Nan	bangkok
กรุงเทพเชียงใหม่กรุงเทพ	bangkok changmai bangkok	Nan	bangkok, chiang mai, bangkok
กรุงเทพโพลล์	bangkok poll	Nan	bangkok poll
กรุ๊ป	group	Nan	group
กลอง	drum	Nan	drum
กลองมโหระทึก	big drum	Nan	big drum
กลองยาว	drum	Nan	drum
กลองสองหน้า	glong songna	Nan	two-faced drum
กลอน	poem	Nan	verse
กลอบูลิน	globulin	Nan	glossy
กลาง	in the middle	Nan	middle
กลิ่น	smell	Nan	smell
กลุ่มดาวกล้องจุลทรรศน์	microscopium	Nan	constellations of microscopes
กลุ่มดาวนกทูแคน	tucana	Nan	toucan
กวาง	deer	Nan	deer
กวม	obscure	Nan	guam
กล้ามเนื้อ	muscle	Nan	muscle
กล้องถ่ายภาพ	camera	Nan	camera
กล้วยไม้ดาว	type of orchid that have slim petal like star	Nan	star orchid
กล่าวคือ	that is	Nan	that is to say
กวี	poet	Nan	poet
กลูคากอน	glucagon	Nan	glucon
กลุ่มที่	group	Nan	the group
กลุ่มดาวแมลงวัน	musca	Nan	flies
กลุ่มดาวแมงป่อง	scorpion constellation	Nan	scorpion
กลุ่มดาวเตาหลอม	fornax	Nan	blast furnace
กลุ่มดาวเข็มทิศ	pyxis constellation	Nan	constellation compass
กลุ่มดาวสิ่ว	siu star	Nan	chisel
กลุ่มแสงอุษา	light at dawn	Nan	usa light group
ขม	bitter taste	Nan	bitter
ขรรค์ชัย	kanchai - a male's name	Nan	khan chai
ขลุ่ยหลิบ	khlui lib	Nan	flute
คิด	thinking	Nan	think
คินนิคุแมน	kinnikuman	Nan	kinnikuman
คิมิฮิโระ	kimihiro	Nan	kimihiro
คิระ	kira	Nan	kira
คิเคียว	kikyo	Nan	kikyo
คีตกวี	composer	Nan	composer
คือประมาณ	estimated to be	Nan	is about
คือเพลง	is the song	Nan	is a song
คุณ	you	Nan	you
คุณครูจอมเวท	magister	Nan	the magician teacher
คุณปลื้ม	kunpleam	Nan	khun pluem
คุณหญิงโม	suranaree	Nan	empress mo
คุณากร	you	Nan	you
คุราปิก้า	kurapika	Nan	kurapika
คุโรซึจิ	kurochiji - a japanese word	Nan	kurotsuji
คุ้มค่า	worth the money spent on	Nan	good value
คูกิมิยะ	kugimiya	Nan	kukimiya
งาน	work, job	Nan	work
งดส่งเข้าประกวด	enroll in the contest	Nan	no entry
ฆ้องวงใหญ่	a group of thai drum music	Nan	big gong
ฆ้อง	gong	Nan	gong
ฆ	a letter from thai alphabet	Nan	juan
ค้างคาว	bat	Nan	bat
คิชิเนีย	kishinia	Nan	kishinya
ค่ำแล้ว	getting dark, at dusk	Nan	dusk
ค่าจีดีพี	gdp - an economics term	Nan	gdp
ค่าความต้านทานตัวที่	resistance value of the	Nan	the resistance value that
คู่กรรม	soul mate	Nan	partner
คูเวต	kuwait	Nan	kuwait
คูเรียม	chemical element "curium"	Nan	curium
คูคาคุ	kukaku (japanese last name)	Nan	kuku
ค่าใช้จ่าย	expense	Nan	the cost
งานอดิเรก	hobby	Nan	hobbies
คิงไลเนอร์	kingliner	Nan	kingliner
คิงส์	kings	Nan	kings
คาคาชิ	cacashi	Nan	kakashi
คางาริ	kagari	Nan	kagari
คาซัคสถาน	kazakhstan	Nan	kazakhstan
คาถาอัญเชิญ	a magic spell	Nan	incantation
คาบ	period	Nan	period
คาบัคโรเน่	kyabarrone	Nan	kabakhroone
คาบูโตะ	kabuto	Nan	kabuto
คาปูชิโน่	cappuccino	Nan	cappuccino
คามิว	camus	Nan	kamui
คาราคุระ	karakura	Nan	karakura
คาร์ล	karl	Nan	carl
คาวทอง	lizard tail	Nan	fishyong
คาเมนไรเดอร์	kamen rider	Nan	kamen rider
คาโรลัส	carolus linnaeus	Nan	carolas
คำขวัญวันเด็ก	quote for kids day	Nan	children&#39;s day slogan
คำถามข้อที่	the question number_________	Nan	question number
คำนวณ	calculate	Nan	calculate
คิง	king	Nan	king
คำแปล	translation	Nan	translation
คำเมือง	kum meuong - a location in chiang mai	Nan	city word
คำอธิบาย	explanation	Nan	the description
คำสุภาพ	formal	Nan	polite word
คำสุดท้ายของวรรคที่	the last word (in a poem)	Nan	the last word of the paragraph
คิงส์คัพ	king's cup	Nan	king&#39;s cup
คำสร้อย	word	Nan	word
คำศัพท์	vocabulary	Nan	vocabulary
คำวิลัยศักดิ์	important words, magic words	Nan	kamwilai sak
คำม่วง	kham muang	Nan	kham muang
คำมั่นสัญญา	agreement	Nan	promise
คำพ้องรูป	hemonym	Nan	synonyms
คำนาม	noun	Nan	noun
คำสรรพนาม	pronoun	Nan	pronoun
คั่ว	roast	Nan	roast
งานเขียน	writing, composition work	Nan	writings
งานโมเสก	mosaic	Nan	mosaic
จักรพันธุ์	chakrabhand	Nan	chakphan
จักรวาลวิทยา	cosmology	Nan	cosmology
จังหวัด	province	Nan	province
จังหวัดกระบี่	krabee state	Nan	krabi province
จังหวัดกาญจนบุรี	kanchanaburi	Nan	kanchanaburi
จังหวัดกาฬสินธุ์	kalasin	Nan	kalasin
จังหวัดขอนแก่น	khon kaen province	Nan	khon kaen province
จังหวัดคยองกี	the state of kyong gee	Nan	gyeonggi province
จังหวัดคยองซาง	kyongchang province	Nan	gyeongsang province
จังหวัดฉะเชิงเทรา	chachoengsao province	Nan	chachoengsao
จังหวัดชุมพร	chumphon province	Nan	chumphon
จังหวัดตราด	trat province	Nan	trat province
จังหวัดตาก	tak province	Nan	tak province
จังหวัดนครปฐม	nakhon pathom province	Nan	nakhon pathom province
จังหวัดนครพนม	nakhon phanom province	Nan	nakhon phanom province
จังหวัดนครสวรรค์	nakorn sawan province in thailand	Nan	nakhon sawan province
จังหวัดน่าน	nan state in the north east of thailand	Nan	nan province
จังหวัดอุดรธานี	udon thani state	Nan	udon thani province
จังหวัดหนองบัวลำภู	nong bua lamphu province	Nan	nong bua lamphu province
จังหวัดสิงห์บุรี	sing buri province	Nan	sing buri province
จังหวัดสมุทรสงคราม	samut songkhram province	Nan	samut songkhram province
จังหวัดสงขลา	songkla province	Nan	songkhla
จังหวัดลำพูน	lamphun province	Nan	lamphun
จักรพรรดิไททัส	emperor titus	Nan	emperor titus
จังหวัดราชบุรี	ratchaburi province	Nan	ratchaburi
จังหวัดยโสธร	yasothorn province (name of thai province)	Nan	yasothon
จังหวัดมหาสารคาม	maha sarakham province	Nan	maha sarakham province
จังหวัดพิษณุโลก	pisanulok state	Nan	phitsanulok province
จังหวัดพังงา	phang nga province	Nan	phang nga province
จังหวัดพระนครศรีอยุธยา	nakon sri ahyutthaya province	Nan	phra nakhon si ayutthaya
จังหวัดปัตตานี	pattani state	Nan	pattani province
จังหวัดระยอง	rayong province	Nan	rayong
งานเทางามสัมพันธ์	public party	Nan	tao ngam relationship
จักรพรรดิเนอร์วา	emperor nerva	Nan	emperor nirvana
จะได้	results in	Nan	will get
งามวงศ์วาน	ngamwongwan	Nan	ngamwongwan
งู	snake	Nan	snake
งูอนาคอนดา	anaconda	Nan	anaconda
จดหมายอากาศ	aerogram	Nan	air mail
จตรัง	trang	Nan	trang
จตุรงค์	jaturong - a surname of a comedian	Nan	chatuchak
จนกระทั่ง	until	Nan	until
จนกระทั่งปี	until the year	Nan	until the year
จนกระทั่งเมื่อปี	until the year	Nan	until last year
จนครปฐม	nakhon pathom	Nan	nakhon pathom
จนมีคำกล่าวว่า	said	Nan	until it was said that
จน่าน	nan state	Nan	mon
จบุรีรัมย์	burerum state	Nan	buriram
จมูก	nose	Nan	nose
จระเข้และแอลลิเกเตอร์	crocodile and alligator	Nan	crocodile and alligator
จรัญญา	jarunya - a surname	Nan	charanya
จริยธรรม	ethics	Nan	ethics
จะเข้	jakhe	Nan	zither
จะเขียนว่า	written as	Nan	will say
จะต้องหาตัวแทนลงจากเวที	find a teammate to leave the stage, a unique game	Nan	must find a representative to get off the stage
จอร์เจีย	georgia	Nan	georgia
จอมเทียน	jomtien	Nan	jomtien
จอมพลเรือ	the general of the navy	Nan	ship marshal
จักจั่น	chakkachan	Nan	cicada
จอมพลสฤษดิ์	field marshal sarit	Nan	field marshal sarit
จอมบึง	chom bueng	Nan	swollen
จสุราษฎร์ธานี	surat thani	Nan	surat thani
จสตูล	stoul state	Nan	satun
จลำพูน	jalumpoon - a place in thailand	Nan	lamphun
จริยา	lady	Nan	lady
จริยศาสตร์	ethics	Nan	ethics
จอมพลถนอม	field marshal thanom	Nan	chom phon thanom
คัมภีร์	bible	Nan	scripture
คัพ	cup	Nan	cup
คันธวงศ์	kunntavong - a surname	Nan	kanthavong
ข้อมูลโดย	information from	Nan	data by
ข้อวิพากษ์วิจารณ์	critique reports	Nan	criticism
ข้ามฉาก	sin(a)	Nan	across the scene
ข้าวสาลี	wheat	Nan	wheat
ข้าวหลาม	bamboo rice	Nan	khao lam
ข้าวเกรียบปากหม้อ	a thai snack	Nan	rice crackers
ข้าวเจ้า	white rice	Nan	paddy
ข้าวโพด	corn	Nan	corn
ข้าหลวงกำกับราชการเมืองขุขันธ์คนที่	government worker for ku khan city	Nan	governor, governor of khukhan city
ฃ	ฃ	Nan	ฃ
คงยิ่ง	kongying	Nan	very likely
คงเจริญ	khongcharoen	Nan	probably prosper
คณะครุศาสตร์	faculty of education	Nan	faculty of education
คณะครุศาสตร์อุตสาหกรรม	faculty of industrial education	Nan	faculty of industrial education
คณะที่	the current administration	Nan	faculty at
คณะบัญชี	accounting department (major)	Nan	faculty of accountancy
คณะปฏิรูปการปกครองแผ่นดิน	national administrative reform council	Nan	revolutionary committee
คณารศ	kanaros - a surname	Nan	kanara
คณะแพทยศาสตร์โรงพยาบาลรามาธิบดี	the staff of ramatippadee hospital	Nan	faculty of medicine, ramathibodi hospital
คณะแพทยศาสตร์ศิริราชพยาบาล	faculty of medicine siriraj hospital	Nan	faculty of medicine siriraj hospital
คณะเกษตร	faculty of agriculture	Nan	faculty of agriculture
คณะสาธารณสุขศาสตร์	faculty of public health	Nan	faculty of public health
คณะสหเวชศาสตร์	อังกฤษ   faculty of allied health science	Nan	faculty of allied health sciences
ข้อมูลอื่นๆ	other information	Nan	other information
คณะสถาปัตยกรรมศาสตร์	faculty of architecture	Nan	faculty of architecture
คณะวิศวกรรมศาสตร์	engineering department	Nan	faculty of engineering
คณะวิทยาการจัดการ	management department	Nan	faculty of management science
คณะรัฐมนตรีคณะที่	cabinet	Nan	cabinet
คณะมนุษย์ศาสตร์และสังคมศาสตร์	humanity department	Nan	faculty of humanities and social sciences
คณะพยาบาลศาสตร์	nursing department	Nan	faculty of nursing
คณะประมง	fishery division of the college of farming and agriculture	Nan	faculty of fisheries
คณะศิลปกรรมศาสตร์	faculty of fine arts	Nan	faculty of fine arts
คนที่	person number __________________________	Nan	the person who
ข้อมูลปี	information from the year ________	Nan	year data
ข้อมูลประเทศเดนมาร์ก	information on denmark	Nan	denmark information
ขวด	bottle	Nan	bottle
ขวัญ	morale	Nan	morale
ขวัญใจช่างภาพ	miss photogenic	Nan	beloved photographer
ขสมก	an acronym consists of four thai letters	Nan	mass
ของ	of	Nan	of
ของทุกปี	every year	Nan	every year
ของประเทศจีน	of china	Nan	of china
ของมหาวิทยาลัย	of university	Nan	of the university
ของมัน	their	Nan	its
ของร่างกาย	of the body	Nan	of body
ของสมเด็จฮุน	houssaine of cambodia	Nan	of somdej hun
ของสิ่งมีชีวิต	living things	Nan	of living things
ของสุนทรภู่	belong to soon thong pu (a thai legend)	Nan	of sunthorn phu
ของเหลว	liquid	Nan	liquid
ของโลก	of the world	Nan	of the world
ขอนแก่น	khon kaen	Nan	khon kaen
ขอบคุณที่รักกัน	thank you for loving each other	Nan	thank you for loving me
ข้อมูลทั่วไป	general information	Nan	general information
ขุนหาญ	koonhan - a location in thailand	Nan	han
ขุขันธิน	kukuntin	Nan	khan tin
ขึ้นไป	next one up	Nan	up
ขึ้นเป็น	to	Nan	up to
ขี้ผึ้ง	wax	Nan	wax
ข้อมูลปรากฏการณ์โลกร้อน	global climate change	Nan	global warming phenomenon
ขีดเส้นใต้	underline	Nan	underline
ขิง	ginger	Nan	ginger
ขาย	sell	Nan	sell
ขา	leg	Nan	leg
ขั้นที่	level	Nan	step
ขอให้เด็กสมัยปฏิวัติของข้าพเจ้า	i hope that the children in my lifetime will ____________	Nan	may my revolutionary children
ขอเช็ดน้ำตา	wipe the tears	Nan	let&#39;s wipe away the tears
ขิม	kim - a thai musical instrument	Nan	dulcimer
คนที่ไปช่วยรุ่นที่	volunteer group number __________	Nan	the people who helped the generation
คนแคระ	dwarf	Nan	dwarf
คนแรก	first	Nan	first person
ความยาวช่วงคลื่น	wave length	Nan	wave length
ความยาวเพลง	song length	Nan	song length
ความรัก	love	Nan	love
ความรู้	knowledge	Nan	the knowledge
ความสว่าง	illumination	Nan	brightness
ความสัมพันธ์กับประเทศไทย	relationship with thailand	Nan	relations with thailand
ความสัมพันธ์ระหว่างจีนกับอเมริกา	relationship with china and the usa	Nan	relations between china and america
ความสูง	height	Nan	the height
ความส่องสว่าง	luminance	Nan	brightness
ความหนาแน่นของประชากร	population density	Nan	population density
ความหมาย	meaning	Nan	the meaning
ความหมายโดยพยัญชนะ	definition that derived from translation from another language	Nan	consonant meaning
ความเข้มของการส่องสว่าง	luminous intensity	Nan	luminous intensity
ความเข้าใจ	understanding	Nan	understanding
ความเร่ง	acceleration	Nan	acceleration
ความโกรธ	anger	Nan	anger
ความโน้มถ่วง	gravity	Nan	gravitation
คัทลียา	kathaleeya (thai first name)	Nan	cattleya
คัญทัพ	main army.	Nan	important army
คัชชินสกี	kaczyński	Nan	kutchinski
คัง	kan	Nan	kang
คอสตาริกา	costa rica	Nan	costa rica
คอลลิงวูด	collingwood	Nan	callingwood
ความยาวคลื่น	wavelength	Nan	wavelength
คอร์ด	chord	Nan	chord
คอนเสิร์ตประสานเสียงสามสถาบัน	chulalongkorn kasetsart thammasat choral concert	Nan	three institutes choir concert
คอนเวนชัน	convention	Nan	conventions
คอนสตรัคชั่น	construction	Nan	construction
คอ	neck	Nan	neck
ควีนซี่	queen	Nan	queen
ควินโต	quinto	Nan	quinto
คอมพิวเตอร์ยุคที่	_-generation computer (as in frist generation, second generation etc)	Nan	computer era
ความยาว	length	Nan	the length
ความยากจน	poverty	Nan	poverty
ความพอประมาณ	estimate	Nan	modesty
คลอง	canal	Nan	canal
ครูพิเศษจอมป่วน	kru pisat jom poun  - name of a story	Nan	troll teacher
ครู	teacher	Nan	teacher
ครุฑ	garuda	Nan	garuda
คริสต์ศาสนา	christainity	Nan	christianity
คริสตี	christie	Nan	christi
คลองสาน	klongsan	Nan	khlong san
คริส	christ	Nan	chris
คราประยูร	karaprayoon - a thai surname	Nan	prayun
ครั้งหนึ่ง	once upon a time	Nan	one time
ครอบครัว	family	Nan	family
ครอคโคไดล์	crocodile	Nan	crocodile
คม	sharp	Nan	sharp
คปค	3 thai letters	Nan	year
คราม	indigo	Nan	indigo
จังหวัดเชียงราย	chiang rai	Nan	chiang rai
คลองเตย	klongtoei	Nan	khlong toei
คลาวิคอร์ด	class	Nan	class
ความฝันอันสูงสุด	the impossible dream	Nan	the ultimate dream
ความบริสุทธิ์	purity	Nan	purity
ความนิยม	popular	Nan	popularity
ความถี่	frequency	Nan	frequency
ความต่างศักย์	potential difference	Nan	potential difference
ความจำ	memory	Nan	the memory
คลับ	club	Nan	club
ความงาม	beauty	Nan	the beauty
ควอร์เตอร์	quarter	Nan	quarter
ควอน	kwon - a surname of a korean singer	Nan	kwon
คลื่นสึนามิ	tsunami wave	Nan	tsunami
คลิป	clip	Nan	clip
คลินิก	clinic	Nan	clinic
คลิก	click	Nan	click
ความกว้าง	width	Nan	width
ลักเซมเบิร์ก	luxembourg	Nan	luxembourg
ธรรมศาสตร์	thammasat university	Nan	thammasat university
ธานินทร์	tanin	Nan	thanin
มณฑลหูหนาน	hunan in china	Nan	hunan
มณีวรรณ	maniwan	Nan	maniwan
มด	ant	Nan	ant
มดลูก	uterus	Nan	uterus
มต้น	primary level of secondary school	Nan	begin
มธ	tu	Nan	tu
มธรรมศาสตร์	thammasat university	Nan	thammasat university
มน	round	Nan	round
มนุษย์	man	Nan	man
มนุษย์กลายพันธุ์	mutant	Nan	mutant
มนเรศวร	naresuan university	Nan	naresuan
มปท	acronyms	Nan	nps
มม	mm	Nan	mm
มมหิดล	mahidol university	Nan	mahidol university
มยุรา	mayura - a female's name	Nan	peacock
มลายู	malay	Nan	malay
มวยปล้ำ	wrestling	Nan	wrestling
มหาวิทยาลัยปทุมธานี	pathumthani university	Nan	pathum thani university
มหาวิทยาลัยบูรพา	burapha university	Nan	burapha university
มหาวิทยาลัยนเรศวร	naresuan university	Nan	naresuan university
มหาวิทยาลัยทักษิณ	thaksin university	Nan	thaksin university
มหาวิทยาลัยขอนแก่น	khon kaen university	Nan	khon kaen university
มหาวิทยาลัย	university	Nan	university
มจก	the most illustrious order of the royal house of chakri	Nan	m
มหาวรรค	mahavak - a buddhist priest	Nan	mahawan
มหาปรมาภรณ์ช้างเผือก	highest class of the order of white elephant	Nan	maha paramaporn chang phueak
มหาบัณฑิต	graduates from college	Nan	master
มหาชัย	mahachai - male's name	Nan	mahachai
มหาชน	public	Nan	public
มหัพภาค	a symbol used in thai writing	Nan	overall
มสงขลานครินทร์	prince of songkla	Nan	prince of songkla
มหาวชิรมงกุฎ	the biggest crown of the king	Nan	mahavajira crown
มหาวิทยาลัยพะเยา	prayao university	Nan	phayao university
มกราคม	january	Nan	january
ภู่สว่าง	poosawang - a surname	Nan	phoo sawang
ภาพยนตร์ลามก	porn movie	Nan	nasty movie
ภาพรวม	group of pictures	Nan	overview
ภายหลัง	after	Nan	after
ภายหลังสงคราม	after the war	Nan	after the war
ภายใต้ความช่วยเหลือจากกองทุนการเงินระหว่างประเทศ	with the financial help, sponsored by	Nan	under the help of the international monetary fund
ภายในวงขอบเหรียญเบื้องบนมีข้อความว่า	etching in the medal that ______________	Nan	within the top of the coin is a statement that
ภารกิจ	business	Nan	mission
ภาวะเศรษฐกิจของกัมพูชาหลังจากมีการเปลี่ยนแปลงการปกครองจากระบอบสังคมนิยมเป็นระบอบประชาธิปไตย	cambodia economy after political change	Nan	economic conditions of cambodia after the transition from democratic socialism to democracy.
ภาษาญี่ปุ่น	japanese language	Nan	japanese
ภาษาบาลี	balese language	Nan	pali
ภาษาสเปน	spanish language	Nan	spanish language
ภาษาอังกฤษ	english language	Nan	english language
ภาษาอีสาน	eastern thai language	Nan	northeast language
ภาษาเกชัว	quechua language	Nan	quechua
ภาษาเฉพาะอาชีพ	jargon	Nan	jargon
ภาษาเบสิก	basic programming lauguage	Nan	basic
ภาษาเยอรมัน	german	Nan	german
ภูเขาน้ำแข็ง	iceberg	Nan	iceberg
ภูเขา	mountain	Nan	mountain
ภูหลวง	phu luang	Nan	phu luang
ภูมิรัตน์	poomirath	Nan	bhumirat
ภูมิภาค	region	Nan	region
ภูมิประเทศและภูมิอากาศ	geography and climate	Nan	topography and climate
ม	a thai alphabet with an 'm' sound	Nan	m
ภูพาน	phu phan	Nan	phu phan
ภูกามยาว	phu kamyao district	Nan	phu kam yao
ภูกระดึง	phu kradueng	Nan	phukradueng
ภิรมย์ภักดี	pirompakdee	Nan	phirom phakdi
ภิรมย์	philom	Nan	satisfied
ภิญโญ	pinyo - a female's name	Nan	increasingly
ภาษาโคบอล	cobol programming language	Nan	cobol
ภูธเนศ	putanet - a male's name	Nan	bhutanet
ภาพยนตร์ตอน	version of the movie	Nan	episode
มหาวิทยาลัยภูมินทร์พนมเปญ	university of phnom penh	Nan	phumin university, phnom penh
มหาวิทยาลัยมหาสารคาม	mahasarakham university	Nan	maha sarakham university
มังกี้	monkey	Nan	monkey
มังคุด	mangosteen	Nan	mangosteen
มัจฉานุ	majjanu - the son of the giant in a thai legend.  majanu is half monkey and half fish.	Nan	matcha
มัชฌิมาปฏิปทา	the middle way	Nan	middle path
มัทนะพาธา	matthanaphatha	Nan	muthana phatha
มัธยฐาน	median	Nan	median
มัธยมศึกษา	junior high school	Nan	secondary education
มัธยมศึกษาปีที่	secondary school year	Nan	grade
มันติคอร์	manticore	Nan	manticore
มัลเจร่า	wonderweiss margera - a cartoon character	Nan	malera
มากกว่า	more than	Nan	over
มากที่สุด	most abundant	Nan	the most
มากิ	maki	Nan	maki
มาครอส	macross	Nan	macross
มาจยาร์	magyar	Nan	mayar
มาจากภาษาละติน	from latin	Nan	from latin
มาซากิ	masaki	Nan	masaki
มาลี	flower	Nan	mali
มาลากุล	malakul	Nan	malakul
มาลัยพร	malaiphon	Nan	malai porn
มาร์แชล	marshall	Nan	marshall
มาร์ตินีก	martinique	Nan	martinique
มาร์ติน	martin	Nan	martin
มะเร็ง	cancer	Nan	cancer
มาร์ช	march	Nan	marsh
มาริสา	marissa	Nan	marisa
มายน์ส	mine	Nan	mines
มานี	mani	Nan	mani
มาตรา	article	Nan	section
มาตรฐาน	standard	Nan	standard
มาดริด	madrid	Nan	madrid
มาริเบล	maribel	Nan	maribel
มหาวิทยาลัยมหาจุฬาลงกรณราชวิทยาลัย	chulalongkorn university	Nan	mahachulalongkornrajavidyalaya university
มะริด	myeik	Nan	myeik
มะขาม	tamarind	Nan	tamarind
มหาวิทยาลัยมหิดล	mahidol university	Nan	mahidol university
มหาวิทยาลัยรังสิต	rangsit university	Nan	rangsit university
มหาวิทยาลัยราชภัฏบ้านสมเด็จเจ้าพระยา	bansomdejchaopraya rajabhat university	Nan	bansomdejchaopraya rajabhat university
มหาวิทยาลัยราชภัฏสงขลา	songkhla rajabhat university	Nan	songkhla rajabhat university
มหาวิทยาลัยราชภัฏสวนสุนันทา	suan sunandha rajabhat university	Nan	suan sunandha rajabhat university
มหาวิทยาลัยราชภัฏอุตรดิตถ์	uttaradit rajabhat university	Nan	uttaradit rajabhat university
มหาวิทยาลัยราชภัฏเทพสตรี	thepsatri rajabhat university	Nan	thepsatri rajabhat university
มหาวิทยาลัยราชภัฏเลย	loei rajabhat university	Nan	loei rajabhat university
มหาวิทยาลัยวงษ์ชวลิตกุล	vongchavalitkul university	Nan	wongchawalitkun university
มหาวิทยาลัยศรีนครินทรวิโรฒ	srinakarinvirot university	Nan	srinakharinwirot university
มหาวิทยาลัยศรีปทุม	sripatum university	Nan	sripatum university
มหาวิทยาลัยศิลปากร	silpakorn university	Nan	silpakorn university
มหาวิทยาลัยสุโขทัยธรรมาธิราช	sukhothai thammathirat open university	Nan	sukhothai thammathirat open university
มหาวิทยาลัยอีสาน	issan univbersity	Nan	northeast university
มหาวิทยาลัยอุบลราชธานี	ubon ratchathani university	Nan	ubon ratchathani university
มหาวิทยาลัยอ๊อกซฟอร์ด	university of oxford	Nan	university of oxford
มหาวิทยาลัยเกษตรศาสตร์	kasetsart university	Nan	kasetsart university
มอหาดใหญ่	had yai city in southern thailand	Nan	mor hat yai
มอสส์	moss	Nan	moss
มอส	moss	Nan	moss
มอร์ริส	morris	Nan	morris
มองโกเลียใน	mongolia	Nan	inner mongolia
มหาวิทยาลัยแห่งแรกของประเทศไทย	first university of thailand	Nan	the first university in thailand
มะม่วงหิมพานต์	mango (anacardium occidentale)	Nan	cashew nut
มหาวิทยาลัยแม่โจ้	maejo university	Nan	maejo university
มหาวิทยาลัยเทคโนโลยีราชมงคลอีสาน	rajamangala university of technology isan	Nan	rajamangala university of technology isan
มหาวิทยาลัยเทคโนโลยีราชมงคลสุวรรณภูมิ	techonology university at rajamongkolsuwannapoom	Nan	rajamangala university of technology suvarnabhumi
มหาวิทยาลัยเทคโนโลยีราชมงคลธัญบุรี	rajamangala university of technology thanyaburi	Nan	rajamangala university of technology thanyaburi
มหาวิทยาลัยเทคโนโลยีราชมงคลตะวันออก	the eastern university of teachnology	Nan	rajamangala university of technology tawan-ok
มหาวิทยาลัยเทคโนโลยีราชมงคลกรุงเทพ	rajamangala university of technology krungthep	Nan	rajamangala university of technology krungthep
มหาวิทยาลัยเทคโนโลยีพระจอมเกล้าพระนครเหนือ	king mongkut's university of technology.	Nan	king mongkut&#39;s university of technology north bangkok
มหาวิทยาลัยเปิด	open university	Nan	open university
มาสคาร่า	mascara	Nan	mascara
ภาพยนตร์ชุดนี้	this series	Nan	this movie set
ภาพยนตร์	movie	Nan	movies
พาร์ค	park	Nan	park
พาวเวอร์บาย	power buy	Nan	power buy
พาเมล่า	pamela	Nan	pamela
พิชัย	pichai	Nan	phichai
พิชิต	phichit	Nan	conquer
พิณ	harp	Nan	mandolin
พิธีกรรายการ	host	Nan	host
พิบูลมังสาหาร	pi bul mung sa har (province name)	Nan	phibun mangsahan
พิพิธภัณฑสถานแห่งชาติ	thailand meseum	Nan	national museum
พิพิธภัณฑ์	museum	Nan	museum
พิม	type	Nan	pim
พิมประภา	phimprapha	Nan	phimprapa
พิมพ์เล็ก	small photo frame 1.4 cm x 2.1 cm x 0.5 cm thick	Nan	small print
พิมลวรรณ	pimonvun - the name of a female anchor person	Nan	phimonwan
พิรุณ	rain water	Nan	rain
พิสุทธิ์	pisut - a male's name	Nan	brilliant
พิออจชา	piodcha	Nan	phion tea
พุฒตาล	puttan	Nan	putthan
พื้นที่มหาวิทยาลัย	university area	Nan	university area
พื้นฐานทางเศรษฐกิจ	base economics	Nan	economic basis
พืชไม่มีท่อลำเลียง	plants without tubelike structures	Nan	plants without pipelines
พืชที่สำคัญคือ	important plants are ...	Nan	important plants are
พืช	plant	Nan	plant
พารามีเซียม	paramecium	Nan	parametric
พึ่งสุนทร	puangsunthorn	Nan	rely on sunthorn
พี่น้อง	siblings	Nan	brethren
พีอีเอ	pea	Nan	pia
พีระศรี	balcony	Nan	phirasri
พีระมิด	pyramid	Nan	pyramid
พีท	pete	Nan	pete
พิเศษนครกิจ	pisetnakornkit - a surname	Nan	nakornkit special
พี่สาวของ	the sister of ____________	Nan	sister
พุทธคยา	bodh gaya	Nan	bodh gaya
พารา	para	Nan	para
พากย์เป็น	subtitle	Nan	dubbed as
พลอากาศเอกหญิง	air chief marshal	Nan	female acm
พลฯ	general	Nan	general
พลังงานคลื่น	wave power	Nan	wave power
พลังงานนิวเคลียร์	nuclear power	Nan	nuclear power
พลังงานลม	wind power	Nan	wind power
พลังงานไฟฟ้า	electrical energy	Nan	electric power
พลัส	plus	Nan	plus
พลาซา	plaza	Nan	plaza
พลาสติก	plastic	Nan	plastic
พลาสมา	plasma	Nan	plasma
พลเรือเอก	admiral	Nan	admiral
พลเอกสนธิ	general sonthi	Nan	general sonthi
พวกสัตว์ลำตัวกลม	animals with no backbones	Nan	round body animals
พศ	b.e.	Nan	fri
พอ	enough	Nan	enough
พอตเตอร์	potter	Nan	potter
พอตเตอร์กับเจ้าชายเลือดผสม	potter and the half-blood prince	Nan	potter and the half-blood prince
พัลซาร์	pulsar	Nan	pulsar
พับลิชชิ่ง	publishing	Nan	publishing
พันธเสน	panthasen (thai last name)	Nan	bond
พันธุ์สุนัข	dogs	Nan	dog breed
พันธุ์พืช	seed	Nan	plant species
พันธุศาสตร์	genetic	Nan	genetics
พายุ	storm	Nan	storm
พันธมิตร	alliance	Nan	alliance
พัทยาใต้	south pattaya - in thailand	Nan	south pattaya
พัทยาเหนือ	north pattaya	Nan	north pattaya
พัฒน์ชัย	pattachai - a male's name, famous singer	Nan	phatchai
พัชรี	pacharee - a female's name	Nan	phachari
พอล	paul	Nan	paul
พอยท์	point	Nan	point
พัน	pan	Nan	thousand
ภาพยนตร์การ์ตูนไทย	thai cartoon	Nan	thai cartoon movie
พุทธนิกายเถรวาท	theravada buddhism	Nan	theravada buddhism
พุทธศักราช	buddhist era	Nan	buddhist era
ฟุตบอล	football	Nan	football
ฟุตบอลอาเซียนเยาวชน	asian youth soccer	Nan	asean youth football
ฟุตบอลเอเชียเยาวชน	asian football club youth championship	Nan	asian youth football
ฟู	rise up	Nan	full
ฟูจิ	fuji	Nan	fuji
ฟูลส์	fools	Nan	full
ฟ้อน	dance	Nan	dance
ฟ้า	blue	Nan	blue
ฟ้าร้อง	thunder	Nan	thunder
ฟ้าหลัว	haze	Nan	sunrise
ภมรมนตรี	pamornmontri	Nan	bamamon montri
ภักดี	pakdi	Nan	loyal
ภัณฑิลา	paktila - first name of a female actress	Nan	panthila
ภาคกลาง	central thailand	Nan	central region
ภาคคนแสดง	show	Nan	show
ภาคตะวันตก	western region	Nan	western region
ภาคตะวันออกเฉียงเหนือ	northeast region	Nan	northeast region
ภาพพิมพ์	lithography	Nan	print image
ภาพพาโนรามา	panoramic image	Nan	panorama
ภาพถ่าย	photograph	Nan	photo
ภาพตรา	coat of arms	Nan	seal image
ภาคใต้ตอนล่าง	southern thailand	Nan	lower southern region
ภาคเหนือ	northern region	Nan	north
ฟุตซอล	futsal	Nan	futsal
ภาควิชาเทคโนโลยีอาหาร	faculty of food technology	Nan	department of food technology
ภาควิชาวิศวกรรมไฟฟ้า	engineering department	Nan	department of electrical engineering
ภาควิชาวิศวกรรมเครื่องกล	department of mechanical engineering	Nan	department of mechanical engineering
ภาควิชาฟิสิกส์	physics	Nan	department of physics
ภาควิชาพยาธิวิทยา	department of pathology	Nan	department of pathology
ภาควิชาคณิตศาสตร์	department of mathematics	Nan	department of mathematics
ภาคพิเศษ	special program	Nan	special
ภาควิชาสูติศาสตร์และนรีเวชวิทยา	gynecology	Nan	department of obstetrics and gynecology
พุทธศตวรรษที่	buddhist era	Nan	century buddhist
ฟีฟ่าคลับเวิลด์คัพ	fifa club world cup	Nan	fifa club world cup
ฟิสิกส์อนุภาค	particle physics	Nan	particle physics
พุ่มพวง	poompoang - surname of a famous actor	Nan	woman
พู่กัน	pugun	Nan	paintbrush
พ่อขุนรามคำแหง	the leader of sukothai empire	Nan	king ramkhamhaeng
พ่อขุนศรีอินทราทิตย์	po kun intarathip - the fist king of thailand	Nan	king intharathit
พ่อมด	wizard	Nan	wizard
พ่ายแพ้ให้กับ	lose to	Nan	lost to
พ๎ร	wish	Nan	welcome
ฟง	fong - a chinese name	Nan	fong
ฟรานซ์	franz	Nan	franz
ฟรีดริช	friedrich	Nan	friedrich
ฟรีด้อม	freedom	Nan	free sneaking
ฟรีแวร์	freeware	Nan	freeware
ฟลายเวท	flyweight	Nan	flyweight
ฟลูวาสแตติน	fluvastatin - a drug	Nan	fluvastin
ฟอน	von - in german name	Nan	von
ฟอร์ด	ford	Nan	ford
ฟอสฟอรัส	phosphorus	Nan	phosphorus
ฟิสิกส์ดาราศาสตร์	astrophysics	Nan	astrophysics
ฟิวชัน	fusion	Nan	fusion
ฟิลิปีโน	filipino	Nan	philippino
ฟิลิปปินส์	philippines	Nan	philippines
ฟิลิป	philip	Nan	philip
ฟินแลนด์	finland	Nan	finland
ฟีนิลคีโตนูเรีย	phenylketonuria	Nan	phenylketuria
ฟิชเชอร์	fisher	Nan	fisher
ฟาง	fhang	Nan	straw
ฟัน	tooth	Nan	teeth
ฟังไจ	fungi	Nan	listen to jaime
ฟังเพลง	listen to music	Nan	listen to music
ฟังพระธรรมเทศนา	listen to the gospel	Nan	listen to sermons
ฟอสเฟต	phosphate	Nan	phosphate
ฟาน	van - as in the surname	Nan	van
มาเก๊า	macau	Nan	macau
มาเฟีย	mafia	Nan	mafia
มาเรีย	maria	Nan	maria
รัฐธรรมนูญแห่งราชอาณาจักรไทย	constitution of the kingdom of thailand	Nan	constitution of the kingdom of thailand
รัฐบาลไทย	thai government	Nan	thai government
รัฐบุรุษ	statesman	Nan	statesman
รัฐประหาร	coup d'état	Nan	coup
รัฐประหารในประเทศไทย	thailand's coup d'état	Nan	coup in thailand
รัฐมนตรีว่าการกระทรวงคมนาคม	transportation secretary of thailand	Nan	minister of transport
รัฐวิสาหกิจ	financial situation of the country	Nan	state enterprise
รัฐวิสาหกิจไทย	thai state enterprise	Nan	thai state enterprises
รัฐสภา	parliament	Nan	parliament
รัฐสีมาคุณากรปิยชาติ	ratthasimakhunakonpiyachat	Nan	ratthasima kunakornpiyachat
รัฐอิลลินอยส์	illinois	Nan	illinois
รัฐเทกซัส	texas	Nan	texas
รัตนบุรี	rattanaburi	Nan	rattanaburi
รัตนาธิเบศร์	ratana thibet	Nan	rattanathibet
รับบทโดย	played by	Nan	played by
รับพระราชทาน	accept	Nan	accept
รัศมี	radius	Nan	radius
ราชวงศ์ทิพย์จักราธิวงศ์	thipjaklatiwong dynasty	Nan	the royal family, chakrathiwong
ราชวงศ์ถัง	tang dynasty	Nan	tang dynasty
ราชวงศ์ชิง	ching dynasty	Nan	qing dynasty
ราชวงศ์จิ้นตะวันออก	east jin dynasty	Nan	eastern jin dynasty
ราชมังคลากีฬาสถาน	rajamangala national stadium	Nan	rajamangala stadium
ราชนาวี	navy	Nan	navy
รัชดาภิเษก	rajada pisek - a location in thailand	Nan	ratchadaphisek
ราชตระกูล	royal family	Nan	royal family
รางวัลโนเบล	nobel prize	Nan	nobel prize
รางวัลนาฏราช	naktarath prize	Nan	royal dancer awards
รางวัลนักร้องไทยสากลชายยอดนิยม	best thai male singer award	Nan	popular male thai international singer award
รางวัลนักร้องยอดเยี่ยม	best singer award	Nan	best singer award
รากแก่น	rakkan	Nan	core root
รัสเซล	russell	Nan	russell
รางวัลไนน์เอ็นเตอร์เทน	nine entertain awards	Nan	nine entertainment award
ราชวงศ์บ้านพลูหลวง	ban phlu luang dynasty	Nan	royal house of plu luang
รัชกาลสมเด็จพระจุลจอมเกล้าเจ้าอยู่หัว	king chula chomklao's reign	Nan	reign of king chulalongkorn
รังสีแกมมา	gamma ray	Nan	gamma ray
ระดับการกระโดดสูง	high jump	Nan	high jump
ระดับปริญญาเอก	doctorate degree level	Nan	phd level
ระดับปริญญาโท	master's degree	Nan	master degree
ระดับมัธยมศึกษา	middle school level	Nan	secondary
ระดับอาชีวศึกษา	vocational education	Nan	vocational level
ระนอง	ranong	Nan	ranong
ระนาด	ranad - a thai musical instrument	Nan	xylophone
ระนาดทุ้ม	a type of thai musical instrument	Nan	alto xylophone
ระนาดเอก	ranad eg -  a thai musical instrument	Nan	alto
ระบบ	system	Nan	system
ระบบกษัตริย์ของกัมพูชา	cambodian monarchy	Nan	cambodian monarchy
ระบบรัฐสภา	rajya sabha system of governing	Nan	parliamentary system
ระบบสืบพันธุ์	reproductive system	Nan	reproductive system
ระบบสุริยะ	solar system	Nan	solar system
ระบบโครงกระดูก	skeletal system	Nan	skeleton system
ระบบใช้อำนาจเด็ดขาด	despotism	Nan	absolute power system
ระยะ	term	Nan	term
รังสีเอกซ์	xray	Nan	x-ray
รังสี	ray	Nan	ray
รังสิตคลอง	rangsit canal	Nan	rangsit khlong
รักแห่งสยาม	love thailand	Nan	love of siam
รักษาสิ่งแวดล้อม	protect the environment	Nan	protect the environment
รักษาศีล	observe the precepts	Nan	observe the precepts
รัชกาลที่	rama	Nan	reign
ระโนด	ranode (name of district in thailand)	Nan	dead
ระเบียง	balcony	Nan	balcony
ระหว่างสงครามโลกครั้งที่	during wold war	Nan	during the world war
ระหว่างปี	between the year	Nan	during the year
ระวิ	rawi	Nan	between
ระยะเวลาการดำรงตำแหน่ง	the term in the office	Nan	term of service
ระยะเวลา	period	Nan	duration
ระเบียบ	order	Nan	order
ระดับกระโดดสูง	high jump	Nan	high jump
ราชวงศ์พระร่วง	pra roung dynasty	Nan	phra ruang dynasty
ราชวงศ์อู่ทอง	utong empire in ancient thailand	Nan	u-thong dynasty
รูปวรรณยุกต์	tones	Nan	tonal form
รูปสามเหลี่ยมมุมป้าน	obtuse	Nan	obtuse triangle
รูปสี่เหลี่ยมด้านขนาน	parallelogram	Nan	parallelogram
รูสเวลต์	roosevelt	Nan	roosevelt
ร็อดฟอร์ม	rock form	Nan	rod form
ร่วมแสดงกับ	costarring	Nan	perform with
ร้องคู่กับ	sing a duet with	Nan	sing along with
ร้องร่วมกับ	sing with	Nan	sing with
ร้องโดย	sung by	Nan	sung by
ร้อยตรี	second lieutenant	Nan	second lieutenant
ร้านอาหาร	restaurants	Nan	a restaurant
ฤดูกาล	season	Nan	the season
ฤดูฝน	rainy season	Nan	rainy season
ฤดูร้อน	summer	Nan	hot season
ล	a thai alphabet with an l sound	Nan	the
ลงวันที่	on this date	Nan	dated
ลพบุรี	lopburi	Nan	lop buri
ลักษณะภูมิอากาศ	climate	Nan	climate
ลักษณะทางกายภาพ	physical characteristics	Nan	physical characteristics
ลักษณะทั่วไป	common characteristic	Nan	general characteristics
ลักษณะ	characteristic	Nan	look
ละติจูด	latitude	Nan	latitude
ละครโทรทัศน์	television drama	Nan	soap opera
รูปร่าง	body	Nan	shape
ละครเพลง	stage musical theatre	Nan	musical
ละครวิทยุ	soap opera broadcasted on the radio	Nan	radio drama
ละครชาตรี	lakorn-chatri	Nan	chatri drama
ละคร	play	Nan	drama
ลอร์ด	lord	Nan	the lord
ลอยกระทง	loy kratong festival	Nan	loy kratong festival
ลอนดอน	london	Nan	london
ละครสั้น	short drama	Nan	short drama
ราชวงศ์หยวน	yuan dynasty	Nan	yuan dynasty
รูปภาพ	picture	Nan	image
รูดอล์ฟ	rudolf	Nan	rudolph
ราชสกุล	royal family members	Nan	tokens
ราชสีมา	ratchasima	Nan	ratchasima
ราชินิกุล	relatives of the queen	Nan	relatives of the queen
ราบเป็นหน้ากลอง	flattened like a drum (meaning to be defeated)	Nan	be plain
รามอินทรา	ram inthra	Nan	ramintra
รายการ	show	Nan	list
รายการวันสำคัญทางพุทธศาสนา	important days in buddhism	Nan	list of important buddhist dates
รายชื่อ	list of the names	Nan	list
รายชื่อคำในภาษาไทยที่มักเขียนผิด	common misspelled thai words	Nan	list of thai words that are often written incorrectly
รายชื่อภาพยนตร์ไทย	a list of thai movies	Nan	list of thai movies
รายชื่อหุ่นยนต์ใน	list of robots in	Nan	list of robots in
รายชื่ออธิการบดี	list of presidents	Nan	list of chancellors
รายชื่อเพลง	songs list	Nan	list of songs
รายนามรองอธิการประจำวิทยาเขต	llist of deputy directors of the college	Nan	name list of vice-chancellors on campus
รายนามอธิการบดี	chancellor list	Nan	list of the president
รายพระนามพระมหากษัตริย์ไทย	list of thai monarchs	Nan	list of thai kings
รายะนาค	rayanak	Nan	raya nak
รุ่งเพชร	roongpetch - a female's name	Nan	rung petch
รุ่งสว่าง	dawn	Nan	dawn
รุ่ง	dawn	Nan	dawn
รุจิพรรณ	pan - a name	Nan	rujipan
รีเนียม	rhenium	Nan	rhenium
รีสอร์ท	resort	Nan	a resort
รูทีเนียม	ruthenium	Nan	ruthenium
ริเอะ	rie tanaga - a japanese singer	Nan	rie
ริมแม่น้ำเจ้าพระยา	near chao praya river	Nan	riverside chao phraya river
ริน	rin	Nan	pour
รำพันพิลาป	poem called rum pan pi lab	Nan	scream
ราศีธนู	sagittarius	Nan	sagittarius
ราวพุทธศตวรรษที่	about buddhist era	Nan	around the century
รายได้อื่น	other wages, incomes	Nan	other income
ริวซากิ	ryuzaki	Nan	ryuzaki
รอบเมือง	around town	Nan	around town
รอบที่	round	Nan	round
รอบชิงชนะเลิศระดับประเทศ	national final round	Nan	national finals
มีน	min	Nan	min
มีนบุรี	minburi province	Nan	min buri
มีนวิทยา	ichthyology	Nan	minology
มีนายกรัฐมนตรี	have a prime minister	Nan	have a prime minister
มีประวัติศาสตร์ยาวนาน	having a long history	Nan	has a long history
มีพรมแดนทางทิศใต้จรดกับอ่าวไทย	having boundaries adjacent to the gulf of thailand	Nan	bordered on the south by the gulf of thailand
มีภูเขาล้อมรอบอยู่	surrounded by mountains	Nan	surrounded by mountains
มีลักษณะดังนี้	has following characteristics	Nan	has the following characteristics
มีลักษณะภูมิประเทศคล้ายชามหรืออ่าง	have topography like bowl or basin	Nan	has features like a bowl or basin
มีลาภ	milap	Nan	have a fortune
มีล่า	mila	Nan	have a hunt
มีสูตรการคำนวณหาจำนวนฟัน	dental formula	Nan	there is a formula to calculate the number of teeth.
มีอยู่	possess, present	Nan	exist
มีอุณหภูมิเฉลี่ย	average temperature	Nan	average temperature
มีอุทยานแห่งชาติสำคัญหลายแห่ง	has many important national parks	Nan	there are many important national parks.
มีเดีย	media	Nan	media
มีโคลซีน	meclozine	Nan	with cole scene
ยอดนักสืบจิ๋วโคนัน	conan the detective	Nan	detective conan
ยอด	super, great	Nan	elite
ยศ	rank	Nan	rank
ยกเว้น	except	Nan	except
ย	a thai alphabet with the y sound	Nan	the
ม้าม	spleen	Nan	spleen
มีทิวเขาล้อมรอบทางเหนือ	surrounded by the mountains in the north	Nan	with mountain ranges in the north
ม้า	horse	Nan	horse
มเชียงใหม่	chiang mai	Nan	chiang mai
มูลสาร	munsan	Nan	fundamentals
มูลนิธิอานันทมหิดล	the king's charities	Nan	anandamahidol foundation
มูลนิธิชัยพัฒนา	chaipattana foundation	Nan	chaipattana foundation
มู	mu	Nan	smooth
มือ	hand	Nan	hand
มโนราห์	thai dance art	Nan	manohra
ยอดเขาสูงที่สุดของกัมพูชาคือ	highest mountain in cambodia	Nan	the highest peak of cambodia is
มีทั้งสิ้น	all	Nan	all
มีด	knife	Nan	a knife
มาเลเซีย	malaysia	Nan	malaysia
มาเลเซียตะวันตก	west malaysia	Nan	west malaysia
มิจิรุ	mijiru	Nan	michiru
มิตร	mitr	Nan	friendly
มิตรชัย	mitchai	Nan	mitchai
มิตรเพชรา	mit pechara - two of famous actors in the old time	Nan	friendly
มิถุนายน	june	Nan	june
มินต์	mint	Nan	mint
มิลจิ	mulji	Nan	milji
มิลตัน	milton	Nan	milton
มิลฟีโอเล่	millefiore	Nan	milfi ole
มิลลิเมตร	millimeter	Nan	mm.
มิลินทจินดา	milinjinda - a surname of a singer	Nan	milinthinda
มิล่า	mila	Nan	mila
มิว	mew	Nan	mew
มิวฟิลโอเล่	millefiore	Nan	mule phil ole
มิวสิกวีดีโอ	music video	Nan	music video
มีชื่อเล่นว่า	nick name	Nan	nicknamed
มีชื่อว่า	named	Nan	named
มีฉายาว่า	famous for...	Nan	with the nickname
มีจำนวน	have the amount of	Nan	have a number
มีความหมายว่า	meaning	Nan	meaning that
มีความยาว	has length of	Nan	have a length
มีดาบฟันวิญญาณ	have a sword to fight the ghost	Nan	with the spirit sword
มีข้อความว่า	inscription reads	Nan	labeled
มิโร	miro	Nan	miro
มิเตอร์	meter	Nan	meter
มิเชล	michelle	Nan	michelle
มิเกล	miguel	Nan	miguel
มิฮอว์ค	mihawk - surname of a character in a japanese movie	Nan	mihawk
มิสทีน	mistine	Nan	mistine
มีขนาดใหญ่	large	Nan	large
ยอพระกลิ่น	yorpaglin - name of a story	Nan	yor phra klin
ยัง	to	Nan	to
ยาขับปัสสาวะ	diuretic	Nan	diuretic
ยูโรเพียม	europium	Nan	europium
ยูไนเต็ด	united	Nan	united
ย่านตาขาว	yan ta khao	Nan	yan khao
รณชัย	ronnachai	Nan	ronnachai
รณภพ	world	Nan	world
รณฤทธิ์	ranariddh	Nan	battle
รถด่วนสายทางช้างเผือก	galactic express	Nan	the milky way express bus
รถประจำทางสาย	bus number	Nan	bus line
รถยนต์อเนกประสงค์	automobile	Nan	multipurpose car
รถลาก	rickshaw	Nan	rickshaw
รถโดยสารประจำทาง	bus	Nan	bus
รถโดยสารประจำทางสาย	bus	Nan	bus line
รถไฟฟ้าชานเมืองสายสีแดงอ่อน	rapid transit light red line	Nan	red light suburb
รถไฟฟ้ามหานคร	metropolitan rapid transit	Nan	mrt
รฟม	public transit	Nan	r.o.
รวดเร็ว	rapid	Nan	fast
รวม	total	Nan	to include
รอบคอบ	careful	Nan	carefully
รอบ	surrounding	Nan	around
รอญับ	seventh month of the hijra calendar	Nan	wait
รองเท้า	shoes	Nan	shoes
รองประธานสภาคนที่สอง	second vice chairman	Nan	second vice president of the council
รองประธานรัฐสภาคนที่หนึ่ง	an assistant head of a thai governmental committee	Nan	first vice president of parliament
ยูโด	judo	Nan	judo
รอก	roack	Nan	reel
รศ	ratanakosin era	Nan	associate
รวมระยะทางทั้งสิ้น	total distance	Nan	total distance
รวมทั้งสิ้น	result	Nan	grand total
รวมทั้งประเทศที่ให้ความช่วยเหลืออื่นๆ	the countries that provided helps	Nan	including countries that provide other assistance
รวมทั้ง	include	Nan	including
รวมกับ	add to	Nan	combined with
รหัส	code	Nan	code
ยูริ	yuri -  a japanese name	Nan	yuri
ยูฟ่า	uefa	Nan	uefa
ยูกิโอ	yu-gi-oh	Nan	yukio
ยีน	gene	Nan	gene
ยิ้มสู้	smile	Nan	smile
ยิ่งลักษณ์	yingluck	Nan	yingluck
ยิ่งยง	yingyong - a first name	Nan	yingyong
ยามเย็น	sundown, evening time	Nan	evening
ยามาโมโตะ	yamamoto	Nan	yamamoto
ยืนยง	(inthira) yeenyong - lead singer of budogun band	Nan	endure
ยามาโตะ	yamato - a japanese name	Nan	yamato
ยาบ้า	ya ba	Nan	amphetamine
ยานอวกาศ	rocket ship	Nan	space ship
ยานอนหลับ	sleeping pills	Nan	sleeping pills
ยางามิ	yangami	Nan	yagami
ยางธรรมชาติ	natural rubber	Nan	natural rubber
ยาง	rubber, tire	Nan	rubber
ยาปฏิชีวนะ	antibiotic	Nan	antibiotics
พลอสนธิ	sonthi - a famous thai army officer	Nan	polson junction
ยุคกลาง	middle age	Nan	middle ages
ยุคที่	era	Nan	era
ยู	u	Nan	u
ยุ้ย	yui	Nan	exaggerated
ยุวธิดา	yuwatidah	Nan	young daughter
ยุทธนาวี	naval battle	Nan	battle of the navy
ยุคใหม่	new age	Nan	new age
ยุคโลหะ	metal age	Nan	metal age
ยุคก่อนประวัติศาสตร์	prehistory	Nan	prehistoric era
ยุคโบราณ	ancient history	Nan	ancient times
ยุคเรเนสซองส์	renaissance	Nan	renaissance era
ยุคอาณาจักรเหนือใต้	north-south dynasty	Nan	northern and southern kingdom era
ยุคอะซึกะ	asuka period	Nan	asuka era
ยุคสามก๊ก	three kingdoms - the legend	Nan	three kingdoms era
ยุคศตวรรษที่	century	Nan	century era
ยุคปัจจุบัน	modern time	Nan	modern times
ยุคเฮอัง	heian period of japan	Nan	heian era
ธรรมเมกขสถูป	dhamek stupa	Nan	dharma makk stupa
พลอย	ploy	Nan	gemstone
พลทหาร	soldier	Nan	soldier
บริเวณรอบทะเลสาบเขมร	area around the lake in cambodia	Nan	around khmer lake
บริเวณเขตภูเขาทางภาคเหนือ	mountain in north of thailand	Nan	mountainous region in the north
บรูไน	brunei	Nan	brunei
บลีช	bleach	Nan	bleach
บลู	blue	Nan	blue
บลูคอสมอส	blue cosmos	Nan	blue cosmos
บลูเบอร์รี่	blueberry	Nan	blueberry
บวก	positive	Nan	positive
บวม	swelling	Nan	swelling
บวร	bawon	Nan	divine
บอมบ์	bomb	Nan	bomb
บอย	boy	Nan	boy
บอยซ์	boys	Nan	boyz
บอล	ball	Nan	the ball
บอลด์วิน	baldwin	Nan	baldwin
บอส	boss	Nan	the boss
บังคลาเทศ	bangladesh	Nan	bangladesh
บาคุกันลูกน้องของนากา	bakugan, minion of naga	Nan	bakugan, a supporter of naga
บาคุกันธาตุไฟ	dragonoid	Nan	bakugan fire element
บาคคัส	bacchus	Nan	bacchus
บัวใหญ่	big lotus	Nan	bua yai
บัวเชด	cedric dubois.	Nan	lotus flower
บัวลอย	kind of thai sweetmeat	Nan	bualoy
บริหารธุรกิจ	business administration	Nan	business administration
บัว	lotus	Nan	lotus
บันทึกความทรงจำ	diary	Nan	memo
บันทึกการสร้างโลก	genesis diary	Nan	world record creation
บันทึก	record	Nan	record
บัณฑิตวิทยาลัยร่วมด้านพลังงานและสิ่งแวดล้อม	joint graduate school of energy and environment	Nan	joint graduate school of energy and environment
บัณฑิต	bandit	Nan	graduate
บังไค	bankai	Nan	bangkai
บันเทิง	entertainment	Nan	entertainment
บางกอกกล๊าส	bangkok glass	Nan	bangkok glass
บริสุทธิ์	pure	Nan	pure
บริพัตร	food	Nan	food
นี่คือ	this is	Nan	this is
นุช	nucth	Nan	joy
นเรศ	naret - a male's name	Nan	nares
นโยบายทางการทูตของจีน	china;s foreign policies	Nan	diplomatic policy of china
น็อกซ์	left.	Nan	knox
น้องครีม	nong kreme - a nickname of someone in thai entertainment	Nan	nong cream
น้องชาย	brother	Nan	younger brother
น้อยมาก	noimak	Nan	very few
น้ำ	water	Nan	water
น้ำค้าง	dew	Nan	dew
น้ำดื่ม	beverages	Nan	drinking water
น้ำท่วม	flooding	Nan	flood
น้ำฝน	rainwater	Nan	rainwater
น้ำพอง	nam pong in kon kan province	Nan	inflatable
น้ำมะนาว	lemonade	Nan	lemon juice
น้ำมัน	oil	Nan	oil
น้ำมันสน	turpentine	Nan	turpentine
บริบาล	care	Nan	care
บราเธอร์ส	brothers	Nan	brothers
บราซิเลีย	brazilian	Nan	brasilia
บรรพชีวินวิทยา	paleontology	Nan	paleontology
บรรณาธิการ	editor	Nan	editor
บรมนาถบพิตร	borommanatbophit	Nan	boromnat bophit
บริวเวอรี่	brewery	Nan	brewery
บรมนาถชาติอาชาวศรัย	something has to do with the king - too obscure	Nan	borommanachat achan sai
บทสวดสรภัญญะที่ขึ้นต้นด้วยธรรมมะคือ	a buddhist prayer	Nan	sorapanya chants that begin with dharma are
บทสวดบาลีที่ขึ้นต้นด้วยอรหัง	pali mantra started with "arhat"	Nan	pali chanting that begins with the arhat
บทบาททางการเมือง	politic	Nan	political role
บทนมัสการนอบน้อมบูชาพระพุทธเจ้า	a prayer to the lord buddha	Nan	chapters of humble worship of the lord buddha
น้ำหนัก	weight	Nan	weight
น้ำยืน	numyeen - location in ubolthani state	Nan	standing water
บนบก	on land	Nan	on land
นีโอ	neo	Nan	neo
บางกอกน้อย	bangkok noi	Nan	bangkok noi
บางซื่อ	bang see - a location in thailand	Nan	bang sue
บ้านฉาง	bahn shang -a  location in thailand	Nan	ban chang
บ้านปราสาท	castle house	Nan	castle house
บ้านผือ	ban phue	Nan	ban phue
บ้านฝันดอตคอม	bahnfun.com	Nan	baan fan com
บ้านลาด	home	Nan	home
บ้านเขว้า	house	Nan	house
บ้านแพ้ว	house	Nan	house
บ้านโพธิ์	bahn po - a location in thailand	Nan	ban pho
ปจ	two letters acronym	Nan	year
ปช	beach	Nan	beach
ปฏิทินช่อง	calendar	Nan	channel calendar
ปฏิภาณ	male's name patipan	Nan	esprit
ปตท	three letters from thai alphabets	Nan	ptt
ปทานุกรม	encyclopedia	Nan	lexicon
ปทุมธานี	pathum thani	Nan	pathum thani
ปภ	the order of the direkgunabhorn	Nan	security
ปภัสรา	papatsara	Nan	papassara
ประติมากรรม	production of a play	Nan	sculpture
ประดิษฐาน	placed	Nan	place
ประชากรศาสตร์	literature subject	Nan	demography
ประชากรประมาณ	population about	Nan	estimated population
ประจำปี	annual	Nan	annual
ประจักษ์	mr. prajak	Nan	manifest
บ่อทอง	bothong	Nan	pond gold
ประจวบคีรีขันธ์	prajoubkirikan state	Nan	prachuap khiri khan
ประกาศเป็นป่าสงวน	preserve area, the protected forest	Nan	declared as a forest reserve
ประกาศิต	command	Nan	decree
ประการที่	number	Nan	number
ประกอบไปด้วย	consists of	Nan	consists of
ประกอบด้วย	include	Nan	include
ปม	knot	Nan	the knot
ประจวบ	prachuap	Nan	collide
บางครั้ง	sometimes	Nan	sometimes
บูมเมอแรง	boomerang	Nan	boomerang
บุตร	son	Nan	child
บางปะกอก	bang prakok - an area in bangkok	Nan	bang pakok
บางปะหัน	a district in ayutthaya province	Nan	bang pahan
บางพลัด	bangplad	Nan	bangplad
บางส่วน	some	Nan	some
บางเขน	bang khen	Nan	bangkhen
บางแสน	bang saen	Nan	bangsaen
บางใหญ่	bang yai - a location in thailand	Nan	bang yai
บานไม่รู้โรย	gomphrena	Nan	amaranth
บารอมิเตอร์	barometer	Nan	barometer
บารัก	barack	Nan	barack
บาร์	bar	Nan	bar
บาลี	vatthu	Nan	pali
บาอัล	baal	Nan	baal
บิน	bin	Nan	fly
บิล	bill	Nan	bill
บิ๊กซี	big c	Nan	big c
บิ๊กซ้งซุปเปอร์สโตร์	big song superstore	Nan	big song superstore
บุณยเกตุ	boonyaket	Nan	bunyaket
บุญนาค	boon nak - a famous surname	Nan	merit
บุญนะโชติ	bunachot - a surname	Nan	bunnachot
บุญค้ำ	bunkham	Nan	merit
บุช	(george) bush	Nan	bush
บุคลิกภาพ	personality	Nan	personality
บุษบา	flower	Nan	flower
บุคคลสำคัญ	important person	Nan	important person
บี้สุกฤษฎิ์	be- sukasit wisetkeaw - name of a singer	Nan	bie sukrit
บี้	flatten	Nan	crumbling
บีฟเค้ก	beef cake	Nan	beef cake
บีบี	bb	Nan	bb
บีช	beach	Nan	the beach
บี	b	Nan	b.
บุคคล	person	Nan	person
ประติมากรรมไทย	thai sculpture	Nan	thai sculpture
นิ่มสกุล	nimsakun	Nan	nim sakul
นิเทศศาสตรบัณฑิต	communication major graduates	Nan	bachelor of arts
นอกจากนี้แล้ว	besides	Nan	besides
นอกเหนือจากนี้	moreover	Nan	apart from this
นอนไม่หลับ	insomnia	Nan	can&#39;t sleep
นอร์ส	norse	Nan	norse
นะงะซะกิ	nagasaki	Nan	nagasaki
นะโม	namo	Nan	namo
นักดนตรี	musician	Nan	musician
นักบินของออร์บ	orb pilot	Nan	orb&#39;s pilot
นักบินอวกาศ	astronaut	Nan	astronaut
นักปรัชญา	philosophist	Nan	philosopher
นักพากย์	voice actor	Nan	voice actor
นักมวย	boxer	Nan	boxer
นักร้อง	singer	Nan	the singer
นักร้องชายไทย	thai male vocalist	Nan	thai male singers
นักร้องนักดนตรี	singer, musician	Nan	singer musician
นักร้องเพลงไทยสากลชาย	male thai pop singer	Nan	international male thai singer
นักร้องเสียงหลัก	lead singer	Nan	main vocalist
นันทนาการ	recreation	Nan	recreation
นัดกับนัด	nut kab nut - a thai sitcom	Nan	date with
นักแสดงรับเชิญ	guest star	Nan	invited actor
นักแสดงพิธีกร	actor	Nan	actor
นักแสดง	actor/actress	Nan	the actors
นักแต่งเพลง	composer	Nan	composer
นอกจากนี้	furthermore	Nan	in addition
นักเศรษฐศาสตร์	economist	Nan	economist
นักเขียนการ์ตูน	cartoonist	Nan	cartoonist
นักเขียน	writer	Nan	the writer
นักสู้อันดับ	fighter rank	Nan	ranked fighter
นักศึกษาวิชาทหาร	army reserve force students	Nan	military student
นักวิทยาศาสตร์	scientist	Nan	the scientist
นักวิชาการ	academic	Nan	academic
นักเต้นนำ	dancers	Nan	lead dancer
นันทนาคร	nantanakorn	Nan	nanthanakorn
นอกจาก	besides	Nan	besides
นวรัตน์	navaratna	Nan	nawarat
ธารทิพย์	tarnthip (first name)	Nan	than thip
ธำมงรค์	ring	Nan	thamrong
ธิติกานต์	thitikan	Nan	thitikan
ธีม	theme	Nan	the theme
ธีระ	teera	Nan	thira
ธีรเดช	theeradej	Nan	thiradej
ธุรกิจ	business	Nan	a business
ธุรกิจการบิน	airline business	Nan	aviation business
นก	bird	Nan	bird
นกกระจอก	sparrow	Nan	sparrow
นกกระทา	quail	Nan	quail
นกกระทุง	pelican	Nan	pelican
นกกระเต็น	kingfisher	Nan	kingfisher
นกขมิ้น	oriole	Nan	canary
นกน้อย	noknoi	Nan	little bird
นกแก้ว	parot	Nan	parrot
นกแอร์	airline	Nan	nok air
นวนิยาย	novel	Nan	novel
นราธิวาส	narativat state	Nan	narathiwat
นราธิป	naratip - a male's name of a singer	Nan	narathip
นร	the ancient and auspicious order of the nine gems	Nan	student
นพดล	noppadol - a male's name	Nan	nopadon
นพจินดา	noppajinda - a surname	Nan	noppachinda
นวล	noul -  a name	Nan	ivory
นปช	udd	Nan	udd
นครหลวงเวียงจันทน์	vientiane	Nan	vientiane capital
นครสวรรค์	nakhon sawan	Nan	nakhon sawan
นครราชสีมา	nakhon ratchasima	Nan	nakhon ratchasima
นครพนม	nakhon phanom	Nan	nakhon phanom
นครปฐม	nakhon pathom	Nan	nakhon pathom
นครนิวยอร์ก	new york city	Nan	new york city
นที	natee - a male's name	Nan	tributary
นิ่ม	soft	Nan	soft
นันทเสน	nanthasen	Nan	nanthasen
นับตั้งแต่เริ่มก่อตั้งจนถึงปัจจุบัน	from the foundation up to the present	Nan	since inception until present
นายสวัสดิ์	sawat	Nan	mr. sawat
นายสุชาติ	mr. suchat	Nan	mr suchart
นายสุนทร	mr. soontorn - a male's name	Nan	mr. sunthorn
นายแพทย์	male doctor	Nan	doctor
นารูโตะ	naruto - a japanese cartoon	Nan	naruto
นาวาอากาศเอกหญิง	woman airforce captain	Nan	squadron leader
นาฬิกา	clock	Nan	clock
นาโนเทคโนโลยี	nanotechnology	Nan	nanotechnology
นำกลับมาสร้างใหม่อีกครั้ง	remake (of an old movie)	Nan	brought back to create again
นำแสดงโดย	performed by	Nan	starring
นำโดย	led by	Nan	lead by
นิกาย	sect	Nan	sect
นิกเกิล	nickel	Nan	nickel
นิคมพัฒนา	nikhom phatthana	Nan	nikom phatthana
นิตยสารชีวจิต	cheewajit magazine	Nan	homeopathic magazine
นิตยสารเอเชียวีก	asia week magazine	Nan	asia week magazine
นิตโย	nittayo	Nan	nittayo
นิฮง	nippon or nikon, a japanese reading language	Nan	nihong
นิวเคลียส	nucleus	Nan	nucleus
นิวเคลียร์	nuclear	Nan	nuclear
นิวัฒน์	niwat	Nan	newwat
นิวยอร์ก	new york	Nan	new york
นิวคลีโอไทด์	nucleotide	Nan	nucleotide
นายสมัคร	mr. samak - a thai name	Nan	applicant
นิลภิรมย์	nipinpirom - a surname	Nan	nilphirom
นิรันดร์กุล	nirankun	Nan	nirunkun
นิรมิต	niramit	Nan	dream
นิยาม	symbols	Nan	define
นิยมจัดขึ้นในเดือน	usually held in the month of	Nan	popular held in the month
นิยม	popular	Nan	popular
นิทาน	tales	Nan	tale
นิรุกติศาสตร์	philology	Nan	etymology
นันทไกร	nandhakrai	Nan	nantakrai
นายสมชัย	mr. somchai	Nan	mr. somchai
นายยงยุทธ	mr. yongyut - a male's name	Nan	mr yongyut
นัยนา	naiyana	Nan	eye
นั่นคือ	that is	Nan	that is
นั่นเอง	that is	Nan	there
นั้น	that	Nan	that
นา	na	Nan	field
นากา	naga	Nan	naga
นากิ	nagi	Nan	nagi
นาคหิรัญกนก	nakhirunkanok	Nan	nak hirankanok
นางงามจักรวาล	miss universe	Nan	miss universe
นางสาวสุวรรณ	miss suwan	Nan	miss suwan
นางสุพรรณมัจฉา	mrs. supanmatja - a character in a thai legend	Nan	mrs. suphan matcha
นางาโตะ	nagato	Nan	nagato
นาดี	nadi	Nan	nadi
นาดูน	nadune (name of district)	Nan	nadun
นาทวี	natavee district	Nan	nathawi
นาทาล	exactly: "natal;"  proper name: natarle	Nan	natal
นาที	minute	Nan	minute
นายปรีดี	pridi - a male's name	Nan	mr. pridi
นายปรีชา	mr.preecha	Nan	mr. preecha
นายประกอบ	mr. prakob - a male's name	Nan	mr assembly
นายทวี	mr.tawee	Nan	mr thawee
นายดำรง	mr dumrong - a male's name	Nan	mr damrong
นายณรงค์	mr. narong - a male's name	Nan	mr. narong
นายศักดา	sakda	Nan	sakda
นายชาญชัย	chanchai	Nan	mr. chanchai
นายชลอ	chalo	Nan	mr chalo
นายกำพล	kamphon	Nan	mr. kampon
นายกรัฐมนตรีไทย	thai prime minister	Nan	thai prime minister
นายกรัฐมนตรีของประเทศไทย	prime minister of thailand	Nan	prime minister of thailand
นามิ	nami	Nan	nami
นานา	nana	Nan	numerous
นายชวน	mr. chuan	Nan	mr chuan
ประตู	door	Nan	door
ประตูน้ำ	pratunam	Nan	dam
ประตูเสีย	broken door	Nan	broken door
พงศ์ศิลป์พิพัฒน์	pongsinpipat	Nan	pongsilp phiphat
พงศ์เรืองรอง	surname "pong reuang-rong"	Nan	pongrueangrong
พงษ์พานิช	phongphanit	Nan	pongpanich
พงษ์เพชร	phong phet	Nan	phong phet
พงษ์ไพบูลย์	pongphatboon	Nan	phongpaibun
พจนานุกรมออนไลน์	online dictionary	Nan	online dictionary
พญา	phaya	Nan	serpent
พญามังราย	mangrai the great	Nan	phaya mangrai
พตท	area	Nan	area
พธม	people's alliance for democracy	Nan	th
พนมไพร	phanom phrai	Nan	phanom phrai
พบหลักฐานของมนุษย์ซึ่งมีอายุเก่าแก่ที่สุดถึงห้าแสนปี	found an evidence of the the oldest human that lived in that area	Nan	found evidence of humans, the oldest up to five hundred thousand years
พยัญชนะ	consonant	Nan	consonant
พยัญชนะสะกดควบกล้ำ	diphthong's consonant	Nan	consonants
พยางค์	syllable	Nan	syllable
พยาธิกำเนิด	pathogenesis	Nan	pathogenesis
พยาธิวิทยา	pathology	Nan	pathology
พรอุดมศักดิ์	pornudomsak (last name)	Nan	phonudomsak
พรรคเพื่อแผ่นดิน	puea pandin party	Nan	pheu thai party
พรรคสังคมประชาธิปไตย	social democratic party	Nan	social democratic party
พรรคสม	som rangsi political party	Nan	equation party
พรรคภูมิใจไทย	bhumjaithai party	Nan	phuea thai party
พรรคประชาธรรม	prachatam political party	Nan	prachatham party
พ	t	Nan	t
พรรคธรรมาธิปัตย์	tamatipat political party	Nan	thammathipat party
พรรคการเมืองใหม่	kan mai meung political party	Nan	new political party
พรบ	act	Nan	act
พรนารายณ์	phonnarai	Nan	narai
พร	wishes	Nan	porn
พยายามชี้ให้สาธารณชนและนานาชาติ	encourage to promote the people and international policies	Nan	trying to point out to the public and international
พยาบาล	nurse	Nan	nurse
พรรคชาติไทย	thai nation party	Nan	chart thai party
พระคาถาชินบัญชร	chinbanchon	Nan	incantation chinnabanchon
ฝ้าย	fai	Nan	cotton
ฝ่าเท้า	sole of foot	Nan	sole of the foot
ผิวสี	skin color	Nan	skin color
ผี	ghost	Nan	ghost
ผีน่ารัก	cute ghost	Nan	cute ghost
ผู้กำกับ	producer	Nan	director
ผู้จัดการ	manager	Nan	manager
ผู้จัดการทีม	manager	Nan	team manager
ผู้ชนะ	winner	Nan	the winner
ผู้ชาย	man	Nan	man
ผู้ช่วยศาสตราจารย์	assistant professor	Nan	assistant professor
ผู้ดำเนินรายการ	moderator	Nan	moderator
ผู้บริหาร	manager	Nan	executive
ผู้ผลิต	producer	Nan	the manufacturer
ผู้ฝึกสอน	trainer	Nan	trainer
ผู้พิทักษ์แห่งพิรุณ	rain defender	Nan	guardian of trouble
ผู้พิทักษ์แห่งอรุณ	guardian of the dawn.	Nan	guardian of the dawn
ผู้ว่าการธนาคารแห่งประเทศไทย	governor of the bank of thailand	Nan	governor of the bank of thailand
ผู้ว่าราชการจังหวัด	governor	Nan	governor
ฝ่ายบริหาร	management	Nan	management
ฝ่ามือ	palm	Nan	palm
ฝูงชนวุ่นวาย	mob	Nan	chaotic crowd
ฝิ่น	opium	Nan	opium
ฝอยทอง	foythong - a thai dessert	Nan	fuzz
ฝ	a letter with ph sound	Nan	the
ฝ่าแดนเขาวงกต	in the boundaries of kao wonkut	Nan	through the maze
ผ้าอนามัยโซฟี	sofi sanitary napkin	Nan	sophie sanitary napkins
ผ่องศรี	pongsri	Nan	phongsri
ผู้ใหญ่	adult	Nan	adult
ผู้เล่นชุด	team	Nan	set player
ผู้เล่น	player	Nan	the players
ผู้อำนวยการ	superintendent	Nan	the director
ผู้สนับสนุน	supporter	Nan	supporter
ผ้าขาวม้า	a special thai cloth that men used to tie around their waists	Nan	loincloth
ผิวขาว	white	Nan	white skin
พระจันทร์	moon	Nan	moon
พระชนม์	the father of the king	Nan	life
พระยาวิเศษภักดี	praya wiset pakdi -a  name of a head of state in the ancient time	Nan	phraya wisetphakdi
พระยาสุนทรสงคราม	phraya sonthornsongkram (thai name)	Nan	phraya sunthornsongkram
พระยาไกรภักดีศรีนครลำดวน	phraya kraiphakdi sinakhon lamduan	Nan	phraya kraiphakdi srinakhon lamduan
พระราชกรณียกิจ	royal duties	Nan	royal duties
พระราชลัญจกรประจำพระองค์	the king's body guard	Nan	royal seal
พระราชวงศ์	royal family	Nan	royal family
พระราชวรวงศ์เธอ	royal family	Nan	royal family
พระราชวังดุสิต	dusit palace	Nan	dusit palace
พระราชวังเดิม	phra racha wang derm	Nan	original palace
พระลอ	phra lo	Nan	phra lor
พระสมเด็จจิตรลดา	pra jitlada - something that was built by the king	Nan	phra somdej chitralada
พระสัมมาสัมพุทธเจ้า	buddha	Nan	lord buddha
พระองค์เจ้าสิริวัณณวรีนารีรัตน์	the name of one of the king's granddaughter	Nan	hrh princess siriwannawari wareerat
พระอังสาเบื้องซ้ายประดับเหรียญรัตนาภรณ์	diagonal sash for the princess	Nan	auspicious buddha amulet on the left, decorated with a rattanakhon medal
พระอัษฎามหาเจดีย์	(royal name/language)	Nan	phra asada maha chedi
พระอิศวร	shiva	Nan	shiva
พระอิสริยยศ	given rank or honor by the monarchy	Nan	royal title
พลตำรวจเอก	police general	Nan	police general
พลตรีหญิง	a female officer	Nan	female air force
พลตรี	air force	Nan	air force
พฤกษศาสตร์	botany	Nan	botany
พริกไทย	thai pepper	Nan	pepper
พริกหวาน	sweet pepper	Nan	bell pepper
พระยาราม	phraya ram	Nan	phraya ram
พริกหยวก	a type of thai pepper	Nan	bell pepper
พรานกระต่าย	prankatai - an area in thai province	Nan	hunter
พระโคตมพุทธเจ้า	pra kotomputtachao - another name of buddha	Nan	buddha amulet
พระเจ้าหลานเธอ	hmh princess	Nan	god your niece
พระเจ้าลูกยาเธอ	the royal princess	Nan	god child
พระเกียรติยศ	honor	Nan	honor
พระอุโบสถ	the temple	Nan	buddhist temple
พราหมณ์	brahman	Nan	brahmin
พระจันทร์สีรุ้ง	phrachan sirung	Nan	rainbow moon
พระยาชัยสุนทร	praya chaisoontorn - first mayor of thailand	Nan	phraya chai soonthorn
พระมเหสี	the wife of a king	Nan	consort
พระตำหนัก	palace	Nan	palace
พระที่นั่งจักรพรรดิพิมาน	chakraput piman hall	Nan	the emperor phiman palace
พระที่นั่งดุสิตมหาปราสาท	phra thinang dusit maha prasat	Nan	dusit maha prasat throne hall
พระที่นั่งบรมพิมาน	the king's seat	Nan	boromphiman mansion
พระธรรมปิฎก	phra thampidok	Nan	dhammapitaka
พระธิดา	daughter	Nan	daughter
พระนคร	capital	Nan	capital
พระนาม	name of the king	Nan	name
พระนามต้นราชสกุล	the first person in the dynasty	Nan	first name
พระนารายณ์	narayana	Nan	vishnu
พระบรมธาตุไชยา	buddha's relics chaiya	Nan	buddha&#39;s relics
พระบรมราชชนก	the king's sister	Nan	royal patronage
พระบรมราชินี	queen	Nan	queen
พระบรมวงศานุวงศ์	members of the royal family	Nan	royalty
พระบาทสมเด็จพระนั่งเกล้าเจ้าอยู่หัว	jessadabodindra	Nan	king nang klao
พระบาทสมเด็จพระปกเกล้าเจ้าอยู่หัว	phrabat somdet phra poramintharamaha - 7th king of thailand	Nan	king prajadhipok
พระบาทสมเด็จพระปรเมนทรมหาอานันทมหิดล	phra bat somdet phra poramentharamaha ananda mahidol	Nan	his majesty king bhumibol adulyadej maha anandamahidol
พระมงกุฏเกล้าเจ้าอยู่หัว	phra mongkut klao chao yu hua	Nan	king rama iv
พระพุทธศาสนา	buddhism	Nan	buddhism
พระพุทธบาท	phra phutthabat	Nan	buddha&#39;s footprint
พระพุทธชินราช	phra buddha chinnarat	Nan	phra buddha chinnarat
พระพันวัสสาอัยยิกาเจ้า	pra paunvatsaeyyigajao - name of a monk	Nan	phra phanwassa aiya
พระพันปีหลวง	queen mother	Nan	millennium luang
พระยศขณะนั้น	the current title	Nan	at that time
พระพรหมคุณาภรณ์	pra prhom kunaporn - a person in thailand	Nan	phra prom khunaporn
พระประแดง	phra pradaeng	Nan	phra pradaeng
พระปกเกล้าเจ้าอยู่หัว	king rama vii	Nan	king prajadhipok
พระบาทสมเด็จพระเจ้าอยู่หัวเสด็จฯ	the current king	Nan	his majesty the king
พระบาทสมเด็จพระเจ้าอยู่หัวอานันทมหิดล	king ananda mahidol	Nan	king ananda mahidol
พระบาทสมเด็จพระเจ้าอยู่หัวภูมิพลอดุลยเดชทรงพระกรุณาโปรดเกล้าฯ	the current king of thailand	Nan	his majesty king bhumibol adulyadej graciously pleased
พระบาทสมเด็จพระพุทธยอดฟ้าจุฬาโลก	king rama 1 of chakri monarchy (bangkok)	Nan	phra buddha phra yot fa, chulalongkorn
พระปรางค์สามยอด	prapang samyod	Nan	prang sam yot
ผลสำรวจ	survey results	Nan	survey results
ผลรวม	summation	Nan	sum
ผลผลิตพลอยได้	result, effects	Nan	by-products
ประเทศเปรู	peru	Nan	peru
ประเทศเม็กซิโก	mexico	Nan	mexico
ประเทศเวียดนาม	vietnam	Nan	vietnam
ประเทศแคนาดา	canada	Nan	canada
ประเทศและดินแดน	natoin and territory	Nan	countries and territories
ประเทศไทย	thailand	Nan	thailand
ประเพณีชักพระ	chak phra festival	Nan	chak phra tradition
ประเภท	category	Nan	category
ประเภทของ	type of	Nan	type of
ประเภทรายการแข่งขันชิงรางวัลดีเด่น	award show for	Nan	award category outstanding competition
ประโยค	sentence	Nan	sentence
ปรัชญา	philosophy	Nan	philosophy
ปรัชญาตะวันตก	western philosophy	Nan	western philosophy
ปรากฏการณ์โลกร้อน	global warming	Nan	global warming
ปรากฏตัวตอนแรกในตอน	first appear in	Nan	first appeared in an episode
ปรากฏตัวในตอน	showing their presence	Nan	appeared in
ปราจีนบุรี	prachin-buri	Nan	prachin buri
ปลาปอมปาดัวร์	pompadour	Nan	pompadour
ปลาบู่ทอง	golden goby	Nan	golden goby
ปลา	fish	Nan	fish
ปรีดี	pridi	Nan	pri
ปรีดา	prida - a male's name	Nan	delight
ปริ๊นซ์	prince	Nan	prince
ประเทศเนปาล	nepal	Nan	nepal
ปริศนา	puzzle	Nan	puzzle
ปริภูมิ	space	Nan	space
ปริญญา	degree	Nan	degree
ปริญ	parin	Nan	prin
ปราโมทย์	pramot	Nan	pramot
ปราสาทเขาพระวิหาร	kao pravihan ancient ruins	Nan	preah vihear temple
ปราบดาภิเษก	prapdapisek	Nan	crowned
ปริมาณการผลิต	capacity	Nan	production volume
ปลาย	at the end	Nan	end
ประเทศเกาหลีใต้	south korea	Nan	south korea
ประเทศอียิปต์	egypt	Nan	egypt
ประทีป	continent	Nan	lamp
ประธาน	president	Nan	president
ประธานกรรมการ	chairman	Nan	chairman
ประธานศาลฎีกา	president of the supreme court	Nan	president of the supreme court
ประธานสภารัฐสภา	speaker of parliament	Nan	speaker of the parliament
ประธานาธิบดี	president	Nan	president
ประมาณ	about, estimated to be	Nan	about
ประมาณคศ	christ year	Nan	about
ประมาณปี	approximately in the year	Nan	about a year
ประยงค์	prayong	Nan	prayong
ประวัติศาสตร์	history	Nan	history
ประวัติศาสตร์สเปน	history of spain	Nan	spanish history
ประวัติศาสตร์ไทย	thai history	Nan	thai history
ประสาท	castle	Nan	nerve
ประสิทธิภาพ	efficiency	Nan	efficiency
ประหยัด	save	Nan	save
ประเด็นที่	point number	Nan	the issue
ประเทศสเปน	spain	Nan	spain
ประเทศสวีเดน	sweden	Nan	sweden
ประเทศลาว	laos	Nan	laos
ประเทศราช	vassal state	Nan	royal country
ประเทศมาเลเซีย	malaysia	Nan	malaysia
ประเทศภูฏาน	bhutan	Nan	bhutan
ประเทศเกาหลี	korea	Nan	korea
ประเทศฟินแลนด์	finland	Nan	finland
ประเทศฝรั่งเศส	france	Nan	france
ประเทศนอร์เวย์	norway	Nan	norway
ประเทศทำการค้าขายกับต่างประเทศมากยิ่งขึ้น	country that trades with other countries	Nan	countries doing more trading with foreign countries
ประเทศซูดาน	sudan	Nan	sudan
ประเทศกัมพูชา	cambodia	Nan	cambodia
ประเทศ	country	Nan	country
ประเทศพม่า	burma	Nan	myanmar
ปลายคริสต์ศตวรรษที่	late century	Nan	late 19th century
ปลาในสกุลนี้เรียกว่า	the fish in this family is called _________	Nan	the fish in this genus is called
ปลิงทะเล	sea cucumber	Nan	sea cucumber
ปีที่	the year	Nan	year
ปีที่วางจำหน่าย	the year that the product was on the market	Nan	release year
ปีพุทธศักราช	buddhism year	Nan	buddhist year
ปีย์	pe - a thai music artist	Nan	year
ปีย์ชนิตว์	peechanit	Nan	piyachit
ปีเตอร์	peter	Nan	peter
ปี่กลาง	a thai woodwind instrument	Nan	middle bag
ปืนพก	handgun	Nan	pistol
ปืนพกกึ่งอัตโนมัติ	semi-automatic pistol	Nan	semi-automatic pistol
ปืนใหญ่	cannon	Nan	cannon
ปืนใหญ่กลางกระสุนวิถีโค้ง	cannon	Nan	cannon medium trajectory curves
ปืนไร้แรงสะท้อนถอยหลัง	recoilless rifle	Nan	the recoil gun
ปุณณกันต์	bhunnagun	Nan	punnakan
ปุตราจายา	putrajaya	Nan	putrajaya
ปุ๋ย	pui	Nan	fertilizer
ปู	crab	Nan	crab
ป่าชายหาด	beach forest	Nan	beach forest
ผลประเสริฐ	polpasert - last name of the 2nd wife of the thai prince	Nan	excellent results
ผลงานโฆษณา	marketing project	Nan	advertising
ผลงานเพลง	song production	Nan	music
ผลงานหนังสือ	publication	Nan	book portfolio
ผลการแข่งขัน	result of competition	Nan	competition results
ผล	result	Nan	results
ปีจอโทศก	year of the dog	Nan	year of the pig
ผดุง	phadung	Nan	support
ป๊อปปี้	poppy	Nan	poppy
ป๊อป	pop	Nan	pop
ป่าโกงกาง	mangrove forest	Nan	mangrove forest
ป่าเบญจพรรณ	mixed forest	Nan	mixed forest
ป่าดิบแล้ง	dry evergreen forest	Nan	dry evergreen forest
ป่าชายเลน	mangrove forest	Nan	mangrove forest
ผจญภัยเกาะมหาสมบัติ	nobita's south sea adventure	Nan	treasure island adventure
ปีคศ	christain era	Nan	year
ปิ่นเกล้า	pin glow - an area in thailand	Nan	pinklao
ปิยะพงษ์	piyapong	Nan	piyapong
ปัน	pan	Nan	share
ปัญโญภาส	panyopat - a surname	Nan	panopas
ปัญจาบ	panjab	Nan	punjabi
ปัจจุบันเลิกเขียนแล้ว	presently retired from writing	Nan	currently no longer writing
ปัจจุบันมีที่นั่งอยู่ในสภาผู้แทนราษฎร	presently have elected representatives	Nan	currently have a seat in the house of representatives
ปัจจุบันประเทศไทยมีภาพยนตร์ที่มุ่งสู่ตลาดโลก	currently thailand has international movies	Nan	nowadays, thailand has movies aimed at the world market.
ปั้น	mold	Nan	mold
ปัจจุบันนี้	presently	Nan	nowadays
ปักธงชัย	pakthongchai	Nan	pak thong chai
ปักกิ่ง	beijing	Nan	peking
ปวีณา	paweena	Nan	paweena
ปวันรัตน์	pavunnarat - a surname	Nan	pawanrat
ปวดข้อ	joint pain	Nan	joint pain
ปล่อย	release	Nan	release
ปัจจุบัน	at present	Nan	present
พลศักดิ์	polsak	Nan	polsak
ปั๊บ	pup	Nan	at once
ปากดี	be talkative	Nan	good mouth
ปิปเปอราซิลลิน	piperacillin	Nan	piper acillin
ปาเลสไตน์	palestine	Nan	palestine
ปาสกาล	pascal	Nan	pascal
ปาร์ค	park	Nan	park
ปารีส	paris	Nan	paris
ปาริชาต	tiger’s claw	Nan	parichat
ปาก	mouth	Nan	mouth
ปาย	pai	Nan	pai
ปานามา	panama	Nan	panama
ปาน	pan - a thai name	Nan	stigma
ปากแม่น้ำสิงคโปร์	singapore river delta	Nan	singapore mouth
ปากเกร็ด	pak kret	Nan	pak kret
ปากีสถาน	country of pakistan	Nan	pakistan
ปากน้ำ	samutpragan province in thailand	Nan	estuary
ปานแร่	panrae	Nan	birthmarks
疾風伝	not in thai - cannot translate	Nan	疾風 伝
