$	$	None
micro	மைக்ரோ	None
technique	நுட்பத்தை	None
electro	நுட்ப	None
consumer	நுகர்வோர்	None
three dimensional	நீளுருண்டை	None
length	நீளம்	None
longest	நீளமான	None
nilgiris	நீலகிரி	None
plasma	நீர்மம்	None
irrigation	நீர்ப்பாசனம்	None
water current	நீரோட்டம்	None
kidney failure	நீரிழிவு	None
steam	நீராவி	None
by water	நீரால்	None
judges	நீதிபதிகள்	None
intelectual	நுண்ணறிவு	None
it is a tiny thing like bactria,virus, amoeba	நுண்ணுயிரி	None
micropes	நுண்ணுயிர்	None
microscope	நுண்நோக்கி	None
hearted	நெஞ்சம்	None
in the books	நூல்களிலும்	None
according to books	நூல்களின்	None
books	புத்தகங்கள்	None
treatise	நூல்களான	None
library	நூலகம்	None
hundreds of	நூற்றுக்கணக்கான	None
judge	நீதிபதி	None
century to	நூற்றாண்டுகளுக்கு	None
the century	நூற்றாண்டுகளாக	None
from the century	நூற்றாண்டிலிருந்து	None
hundred	நூறு	None
century	நூற்றாண்டைச்	None
gateway	நுழைவாயில்	None
tip	நுனியில்	None
bacteria	பாக்டீரியாக்கள்	None
centuries	நூற்றாண்டுகள்	None
justice	நீதித்துறை	None
long time	நீண்டகால	None
long	நெடிய	None
earthquake	நிலநடுக்கம்	None
underground	நிலத்தடி	None
lands	நிலத்தின்	None
lands in	நிலங்களில்	None
feudalism	நிலக்கிழாரியம்	None
coal	நிலக்கரி	None
land	நிலம்	None
in lands	நிலப்பகுதிகளில்	None
execute	நிறைவேற்ற	None
installation	நிறுவிய	None
founded	நிறுவினர்	None
establishment	நிறுவப்பட்ட	None
company	நிறுவனம்	None
institutions	நிறுவனங்களை	None
companies	நிறுவனங்கள்	None
install	நிறுவும்	None
adequacy	நிறைவு	None
long long ago	நெடுங்காலமாக	None
in land	நிலப்பகுதியில்	None
of the land	நிலப்பரப்பின்	None
lasted	நீடித்தது	None
for long time	நீடித்த	None
continiue	நீடிக்கும்	None
swimming	நீச்சல்	None
shadow	நிழல்	None
stable	நிலையானது	None
station	நிலையம்	None
map	வரைபடம்	None
stations	நிலையங்கள்	None
status	நிலையைப்	None
strong	வலுவான	None
position	பணியில்	None
at different levels	நிலைகளையும்	None
in the moon	நிலவில்	None
geography	புவியியல்	None
land areas	நிலப்பரப்பு	None
airport	விமானநிலையம்	None
to stop	நிறுத்தி	None
highway	நெடுஞ்சாலை	None
leap	லீப்	None
from areas	பகுதிகளிலிருந்து	None
areas	பகுதிகள்	None
parts	பாகங்கள்	None
share	வழங்க	None
ragging	பகிடிவதை	None
bhagwat	பகவத்	None
in daylight	பகலில்	None
bahadur	பகதூர்	None
pa a letter in tamil	ப	None
aetiology	நோய்க்காரணி	None
diseases	நோய்கள்	None
antibiotic	நோயெதிர்ப்பு	None
patient's	நோயாளியின்	None
for patients	நோயாளிகளுக்கு	None
patients	நோயாளிகள்	None
regions	மண்டலங்கள்	None
portion	பகுதியின்	None
a part of	பகுதியான	None
section	பிரிவு	None
seperation of tamil	பகுப்புதமிழக	None
seperate designs	பகுப்புகோலங்கள்	None
a computer	பகுப்புகணினி	None
unorganised	பகுப்புகட்டற்ற	None
division: europe	பகுப்புஐரோப்பிய	None
seperate eelam	பகுப்புஇலங்கை	None
divided physics	பகுப்புஇயற்பியல்	None
nobel	நோபெல்	None
pakuppuintuk	பகுப்புஇந்துக்	None
divided india's	பகுப்புஇந்தியத்	None
seperated together	பகுப்புஇணைய	None
theologists	பகுப்புஆன்மிகவாதிகள்	None
category	வகையைச்	None
analysis	பகுப்பாய்வு	None
rational	பகுத்தறிவு	None
in the area	பரப்பில்	None
a sect of indian	பகுப்புஇந்தியப்	None
fasting	விரதம்	None
vision	நோக்கு	None
in order to	நோக்கில்	None
nepal	நேபாளம்	None
nato	நேட்டோ	None
paddy	நெல்	None
the protocol	நெறிமுறையானது	None
protocol	வழிமுறை	None
ethics	நெறிகள்	None
principle	பண்புகளை	None
timings	நேரங்கள்	None
close	மூடி	None
a land called neithal	நெய்தல்	None
lever	நெம்புகோல்	None
napoleon	நெப்போலியன்	None
neptune	நெப்டியூன்	None
netherland	நெதர்லாந்து	None
netscape	நெட்ஸ்கேப்	None
network	வலையமைப்புகள்	None
crisis	நெருக்கடி	None
nedunchezhian a name given in tamil	நெடுஞ்செழியன்	None
live	வாழ்கின்றனர்	None
direct	நேரடியான	None
aiming at	நோக்கிச்	None
purpose	நோக்கம்	None
aims	நோக்கமாகக்	None
principles	நோக்கங்கள்	None
aim	நோக்குடன்	None
noyyal	நொய்யல்	None
enzyme	நொதி	None
directly	நேரடியாக	None
nile	நைல்	None
proton	நேர்மின்னி	None
positive	நேர்மறை	None
nehru, name of a person	நேருவின்	None
nehru	நேரு	None
in person	நேரில்	None
timelime	நேரவரிசை	None
no time	நேரமில்லை	None
nitrogen	நைதரசன்	None
stoppage	நிறுத்தம்	None
punctuations	நிறுத்தக்குறிகள்	None
spectroscopy	நிறமாலையியல்	None
civilization	நாகரிகம்	None
naveen	நவீன்	None
modern	நவீன	None
november	நவம்பர்	None
nallur	நல்லூர்	None
nattrinai	நற்றிணை	None
good news	நற்செய்தி	None
neurological	நரம்பியல்	None
neuroscience	நரம்பணுவியல்	None
narasimha	நரசிம்ம	None
believe	நம்பினர்	None
beliefs	நம்பிக்கைகள்	None
hope	நம்புகின்றனர்	None
believing	நம்புவது	None
believed	நம்பினார்	None
actor nagesh in tamil films	நாகேஷ்	None
we	நாம்	None
nazareth	நாசரேத்து	None
nasa	நாசாவின்	None
days	நாட்கள்	None
moving to different places	நாடோடி	None
with countries	நாடுகளுடன்	None
in the countries	நாடுகளில்	None
from countries	நாடுகளிலிருந்து	None
nations	நாடுகளின்	None
countries	நாடுகள்	None
namibia	நமீபியா	None
sought	முயன்று	None
lock saba	நாடாளுமன்றத்தில்	None
parliment's	நாடாளுமன்றத்தின்	None
parliament	மக்களவை	None
nadar	நாடார்	None
in drama	நாடகங்களில்	None
drama	நாடகத்தில்	None
nacho	நாச்சோ	None
pulse	நாடி	None
prophet	நபிகள்	None
person	நபர்	None
excellent	நன்று	None
going on	நடைபெறுகிறது	None
is held	நடைபெறுகின்றது	None
centre	மையக்	None
the federal	நடுவண்	None
center part	நடுப்பகுதியில்	None
middle	மத்திய	None
neutral	நடுநிலை	None
held	வகித்தார்	None
played	நடித்தார்	None
actress	நடிகைக்கான	None
actors	நடிகர்கள்	None
actor	நடிகர்	None
dancing	நாட்டியம்	None
behavior	நடத்தைகள்	None
was conducted	நடத்தினர்	None
conducted	மேற்கொண்டனர்	None
acting	நடித்து	None
calender	நாட்காட்டி	None
have done that	நடைபெற்றன	None
practical	நடைமுறைப்	None
benefit	பலன்	None
freshwater	நன்னீர்	None
well known	நன்கு	None
nandhi a hindu god	நந்தி	None
nandha a kingdom	நந்தா	None
malacology	நத்தையினவியல்	None
friends	நண்பர்கள்	None
to happen	நடைபெற்று	None
with friends	நண்பர்களுடன்	None
friendship	நட்புறவு	None
friendly	நேச	None
star	ஸ்டார்	None
ways	வழிகள்	None
practice	நடைமுறையில்	None
effect	விளைவை	None
procedures	நடைமுறைகள்	None
crab	நண்டு	None
keen	நாட்டம்	None
natal	நாட்டல்	None
music of nattar	நாட்டார்	None
new zealand	நியூசிலாந்து	None
new	புது	None
niamey	நியாமி	None
neon	நியான்	None
minute	நிமிடத்திற்கு	None
geographist	நிபுணர்கள்	None
standing	நிற்கும்	None
new wonders	நியூஒன்டர்ஸ்	None
in memory of	நினைவுச்	None
in remembrance	நினைவில்	None
to remember	நினைவிடம்	None
in memory	நினைவாக	None
memory	நினைவகம்	None
thinking	நினைத்து	None
nithya sundarar	நித்திய	None
finance	நிதியை	None
memorial	நினைவு	None
lympotic system	நிணநீர்	None
newton of	நியூட்டனின்	None
new york	நியூயார்க்	None
color	வண்ணம்	None
naked	நிர்வாணம்	None
administrators	நிர்வாகிகள்	None
administrator	நிர்வாகி	None
in administration	நிர்வாகத்தில்	None
management	மேலாண்மை	None
administration	நிர்வாகம்	None
newton	நியூட்டன்	None
finalised	நிர்ணயிக்கப்படுகிறது	None
prove	நிரூபிக்க	None
programs	மென்பொருட்களை	None
software items	நிரல்களை	None
a sect	நிரலில்	None
programming	நிரலாக்கம்	None
filled with	நிரப்பி	None
permanent	நிரந்தரமான	None
fix	பொருந்தி	None
culture of tamilan	பகுப்புதமிழர்	None
not having defnite	நிச்சயமற்ற	None
nickel	நிக்கல்	None
nayakars  a ruler in tamil nadu	நாயக்கர்கள்	None
naicker	நாயக்கர்	None
general	யாழ்	None
namakkal	நாமக்கல்	None
four	நான்கும்	None
quarters	நான்கில்	None
fourth	நான்காவது	None
nayanmarkal	நாயன்மார்கள்	None
nano	நானோ	None
four hundred	நானூறு	None
i	நான்	None
coins	நாணயங்கள்	None
coin	நாணயம்	None
in the country	நாட்டிலுள்ள	None
from country	நாட்டிலிருந்து	None
country peoples	நாட்டினர்	None
myself	நானே	None
nicobar	நிக்கோபார்	None
naidu	நாயுடு	None
dogs	நாய்கள்	None
events	நிகழ்வுகள்	None
occurende	நிகழ்வில்	None
happening	நிகழும்	None
net	நெட்	None
nasdaq	நாஸ்டாக்	None
novel	நாவல்	None
novelor	நாவலர்	None
dog	நாய்	None
tomorrow	நாளைக்கு	None
newspaper	பத்திரிகை	None
afterwards	நாளடைவில்	None
naladiar	நாலடியார்	None
forty	நாற்பது	None
cyclic quadrilateral	நாற்கரம்	None
norway	நோர்வேயின்	None
narayanan	நாராயணன்	None
dailies	நாளிதழ்கள்	None
to conduct	நடத்த	None
tamil analysis	பகுப்புதமிழ்	None
division	பிரிவினையை	None
pazhani	பழனி	None
ancient tamil	பழந்தமிழ்	None
tribes	பழங்குடியினர்	None
old tribal	பழங்குடி	None
in old period	பழங்காலத்தில்	None
fruits	பழங்கள்	None
customs	பழக்க	None
fruit	பழம்	None
schools	பாடசாலைகள்	None
in schools	பள்ளிகளில்	None
school	பாடசாலை	None
deep pits	பள்ளம்	None
valley	பள்ளத்தாக்கு	None
multiculturalism	பல்லினப்பண்பாடு	None
several thousands	பல்லாயிரம்	None
old	வயதான	None
proverb	பழமொழி	None
proverbs	பழமொழிகள்	None
pavan	பவன்	None
laborer	பாட்டாளி	None
singing	பாடும்	None
sung	பாடியுள்ளார்	None
sang	பாடினார்	None
songs	பாடல்கள்	None
lyrics	பாடல்	None
lesson	பாடம்	None
in thousands	பல்லாயிரக்கணக்கான	None
facism	பாசிச	None
fire fox	பாக்ஸ்	None
to see	பார்வைக்கு	None
pakistan	பாக்கிஸ்தான்	None
pakistani	பாகிஸ்தானின்	None
paul	பவுல்	None
bavani	பவானி	None
platinum	பிளாட்டினம்	None
affection	பாசம்	None
pallavas	பல்லவர்கள்	None
pallava	பல்லவ	None
universities	பல்கலைக்கழகங்கள்	None
season	பருவம்	None
a compund	பருமூலக்கூறு	None
vidth	பருமன்	None
matter	விடயமாக	None
macroeconomics	பருப்பொருளியல்	None
dhall	பருப்பு	None
cotton	பருத்தி	None
airy time	பருவக்காற்று	None
exchange	பரிவர்த்தனை	None
recommendations	பரிந்துரைகள்	None
recomandation	பரிந்துரை	None
to close	பரிதி	None
dimension	பரிமாண	None
test	பரிசோதிக்க	None
testing	பரிசோதனை	None
prizes	பரிசுகள்	None
recommend flimfare	பரிந்துரைப்புபிலிம்ஃபேர்	None
song	பாட்டு	None
burma	பர்மா	None
fly	பறக்கும்	None
university	பல்கலைக்கழகத்தில்	None
tooth	பல்	None
beluga	பலூகா	None
various	பல்வேறு	None
palavaru	பலவாறு	None
different	வேறுபட்டு	None
strength	வலு	None
parva	பர்வம்	None
several times	பலமுறை	None
in different	பலதரப்பட்ட	None
board	பலகை	None
palakali	பலகாலி	None
about	பற்றியோ	None
deficient	பற்றாக்குறை	None
birds	பறவைகள்	None
bird	பறவை	None
without benefits	பலனின்றி	None
gift	பரிசை	None
job	பாணியில்	None
pandian king	பாண்டிய	None
bridge	பாலம்	None
sex cell	பாலணு	None
bridges	பாலங்கள்	None
bala	பால	None
rocks	பாறைகள்	None
rock	ராக்	None
to be shown	பார்வையில்	None
views	பார்வைகள்	None
forward	முன்னோக்கி	None
parvathi	பார்வதி	None
take care, look at	பார்த்துக்	None
partisan	பார்ட்டிசான்	None
seeing	பார்த்தால்	None
park	பூங்காவில்	None
look	பார்	None
gender	பாலின	None
sex	பாலுறவு	None
bollywood	பாலிவுட்	None
sexual	பால்வினை	None
later part	பிந்தைய	None
bit	பிட்	None
liked	பிடித்தது	None
p.t.	பிடி	None
biji	பிஜி	None
b y	பிஒய்	None
php	பிஎச்பி	None
paris war	பாரிய	None
brn	பிஆர்என்	None
sin	பாவம்	None
pali	பாளி	None
sexual work	பால்வினைத்	None
desert	பாலைவனம்	None
lactational	பாலூட்டும்	None
mammals	பாலூட்டிகள்	None
mamals	பாலூட்டி	None
pascal	பாஸ்கல்	None
paris	பாரிஸ்	None
parliment	பாராளுமன்றத்தின்	None
not seeing	பாராமல்	None
path	பாதையை	None
security	பாதுகாப்புப்	None
secure	பாதுகாப்பான	None
unsafe	பாதுகாப்பற்ற	None
to protect	பாதுகாத்தல்	None
safe	பாதுகாக்கிறது	None
protection	பாதுகாப்பை	None
paths	பாதைகள்	None
infect	பாதிப்பை	None
affected	பாதிப்படைந்த	None
affecting	பாதிக்கப்படும்	None
to be affected by	பாதிக்கப்படுகின்றன	None
foot	பாதம்	None
pandiyas an ancient kingdom	பாண்டியர்கள்	None
pandias is a king in olden days	பாண்டியர்களின்	None
pandian	பாண்டியர்	None
affects	பாதிக்கிறது	None
pondicherry	பாண்டிச்சேரி	None
in the path	பாதையில்	None
papanasam	பாபநாசம்	None
appreciate	பாராட்டி	None
tradition	வழக்கமாகும்	None
heritage	புராதன	None
traditional	மரபைச்	None
bharthiyar (name)	பாரதியாரின்	None
bharathidhasan	பாரதிதாசன்	None
bharathi	பாரதியார்	None
vessels	பாத்திரங்கள்	None
bharat	பாரத்	None
persia	பாரசீகம்	None
flows	பாய்கிறது	None
snakes	பாம்புகள்	None
snake	பாம்பு	None
pop	போப்	None
babu	பாபு	None
baba	பாபா	None
persian	பாரசீகத்தின்	None
maintenance	பராமரிப்பு	None
a title in tamil chola kingdom paranthaga	பராந்தக	None
parasakthi	பராசக்தி	None
minimum level	பட்சம்	None
in the case of	விஷயத்தில்	None
minimum	பட்ச	None
invasion	படையெடுப்புக்கு	None
to wage a war	படையெடுத்து	None
in the army	படையில்	None
force	படையின்	None
soldiers	வீரர்கள்	None
creations	படைப்புகள்	None
one of his	படைப்புகளில்	None
forces	படைகள்	None
troops	படைகளை	None
will do	படுத்தும்	None
to succumb to	படுத்தப்பட்ட	None
bed	படுக்கை	None
degrees	பட்டங்களும்	None
diplomas	பட்டயங்கள்	None
list	பட்டியல்	None
lists	பட்டியல்கள்	None
behaviour	பண்பு	None
cultures	பண்பாடும்	None
in cultures	பண்பாடுகளில்	None
farms	பண்ணைகள்	None
farm	பண்ணை	None
antiquity	பண்டை	None
pandit	பண்டிட்	None
massacre	படுகொலைகள்	None
task	பணியை	None
inflation	பணவீக்கம்	None
by money	பணத்தின்	None
rich people	பணக்கார	None
money	பணம்	None
bar	பட்டை	None
pattukottai, a place in tamilnadu	பட்டுக்கோட்டை	None
silk	பட்டு	None
work	பணிகளில்	None
evolutionary	பரிணாம	None
forms	வடிவங்களை	None
algorithms	படிமுறை	None
representation	பங்களிப்பை	None
contribution	பங்களிப்பு	None
devotees	பக்தர்கள்	None
holy	பரிசுத்த	None
page	பக்கம்	None
bias	பக்கசார்பு	None
pages	பக்கங்கள்	None
march	மார்ச்	None
sides	பக்கங்களிலும்	None
puck chasers	பக்	None
enemy	பகைவர்	None
opponent thought	பகைமை	None
analysischemistry	பகுப்புவேதியியல்	None
partial freedom	பகுப்புவிடுதலைப்	None
south eastern	பகுப்புதென்கிழக்கு	None
pakupputtamil	பகுப்புதமிழ்ப்	None
side	புறம்	None
in office	பதவியில்	None
hungry	பசி	None
five	பஞ்ச	None
study	படிப்பை	None
step by step	படிப்படியான	None
gradually	படிப்படியாக	None
a layer of deposited matter	படிந்து	None
studied	பயின்றார்	None
reading	வாசிப்பு	None
read	படித்து	None
pacific	பசிபிக்கில்	None
slide	படவில்லை	None
camera	படம்பிடிகருவி	None
pictures	படங்களை	None
in pictures	படங்களில்	None
boat	படகு	None
punjab	பஞ்சாப்	None
punjabi	பஞ்சாபி	None
scare	பஞ்சம்	None
ozone	படலம்	None
topic	பதி	None
register	பதித்த	None
fourteen	பதினான்கு	None
mode	பயன்முறை	None
utilisation	பயன்பாட்டை	None
in utilisation	பயன்பாட்டில்	None
application	மனு	None
to use	பயன்படுத்துவது	None
useless	பயன்படுத்தாமல்	None
using	பயன்படுத்துதல்	None
cropping	பயிரிடப்படுகிறது	None
used	பயன்பட்டது	None
effective	பயன்	None
users	பயனர்கள்	None
user's	பயனரின்	None
feared	பயந்து	None
travels	பயணித்து	None
traveling	பயணிக்கும்	None
passenger	பயணிகள்	None
uses	பயன்படுத்தும்	None
tour	பயணத்தில்	None
crops	பயிர்கள்	None
practicals	பயிற்சிகள்	None
outspread	பரவிய	None
proliferation	பரவலை	None
widely	பரவலாகப்	None
orgasm	புணர்ச்சிப்	None
dissemination	பரம்பல்	None
genitic	பரம்பரை	None
area wise	பரப்பை	None
training	பயிற்சி	None
spreading	பரப்புதல்	None
area	பரப்பளவு	None
in area	பரப்பளவில்	None
spread	விரிந்து	None
wide	பரவலான	None
bharathan	பரதன்	None
bharatnatyam	பரத	None
algol	பரணி	None
surface	பரப்பின்	None
division of tamilnadu	பகுப்புதமிழ்நாடு	None
travelling	பயணங்கள்	None
terrific	பயங்கர	None
ten	பத்து	None
tenth	பத்தாம்	None
in 10 years	பத்தாண்டுகளில்	None
records, posts	பதிவுகள்	None
registers	பதிவகம்	None
answer	விடை	None
instead of	பதிலாக	None
pattupattu	பத்துப்பாட்டு	None
an ancient book name	பதிற்றுப்பத்து	None
publications	வெளியீடுகள்	None
edition	பதிப்பு	None
eleventh	பதினொரு	None
eighteen	பதினெண்	None
eighteenth	பதினெட்டாம்	None
sixteen	பதினாறு	None
sixteenth	பதினாறாம்	None
copyright	பதிப்புரிமை	None
terrorists	பயங்கரவாத	None
nineteenth	பத்தொன்பதாம்	None
ball	பால்	None
bombay	பாம்பே	None
pappuva	பப்புவா	None
papaya	பப்பாளி	None
swine flu	பன்றிக்	None
pig	பன்றி	None
diversity	பன்முகத்தன்மை	None
plural	பல்வகை	None
padnamba a tamil leader in ltte	பத்மநாதன்	None
twelve	பன்னிரெண்டு	None
snow waterfall	பனியருவி	None
snowman	பனிமனிதன்	None
cold war	பனிப்போர்	None
cold	பனிப்	None
ice bergs	பனிக்கட்டி	None
mist	பனி	None
banama canal	பனாமா	None
palm	பனை	None
background	பின்னணியில்	None
happens	நடக்கும்	None
toxic	நச்சு	None
layers of the earth	தட்டுகள்	None
plate	தட்டு	None
billboard	தட்டிகள்	None
dragonfly	தட்டாரப்பூச்சி	None
typing	தட்டச்சு	None
dakshinamurthy	தட்சிணாமூர்த்தி	None
hurdle	தடையாக	None
break	தடை	None
vaccination	தடுப்பூசி	None
prevention	தடுப்பு	None
stopped	தடுத்து	None
prevent	தடுக்கும்	None
thanjavur	தஞ்சையில்	None
muscle	தசை	None
dasavatharam	தசாவதாரம்	None
flate	தட்டையான	None
weather	வானிலை	None
stem	தண்டு	None
water	வாட்டர்	None
seperate	பிரிப்பு	None
individual	தனிநபர்	None
per person	தனிநபருக்கான	None
individually	தனித்துவமான	None
custom	வழக்கமும்	None
speciality	தனித்தன்மை	None
separately	தனித்தனியே	None
dhasarathan	தசரதன்	None
unique	தனித்த	None
separate	தனியான	None
father	தந்தையை	None
telegram	தந்தி	None
ivory	தந்தம்	None
philosophers	தத்துவவாதிகள்	None
philosophy	மெய்யியல்	None
ravi	ரவி	None
distinction	வேறுபாட்டை	None
themselves	தாமாகவே	None
of gold	தங்கத்தின்	None
sister	தங்கச்சி	None
denmark	டென்மார்க்	None
tennis	டென்னிஸ்	None
techtonic	டெக்டோனிக்	None
texas is a state in usa	டெக்சாஸ்	None
dvd	டிவிடி	None
delhi	தில்லி	None
dgps	டிஜிபிஎஸ்	None
taylor	டெய்லர்	None
digital	டிஜிட்டல்	None
dna	டிஎன்ஏ	None
de	தே	None
toss	வென்ற	None
dollar	டாலர்	None
darwin	டார்வின்	None
don television	டான்	None
tata	டாடா	None
dysprosium	டிசிப்ரோசியம்	None
private	தனியார்	None
terbium	டெர்பியம்	None
federation an english movie or film	டெஸ்பெரேஸன்	None
gold	பொன்	None
eligible	தகுதியை	None
communication	தொடர்பாடல்	None
thagadur a war place	தகடூர்	None
twitter	ட்விட்டர்	None
tokyo in japan	டோக்கியோ	None
times	வேளைகளில்	None
del	டெல்	None
tiber	டைபர்	None
nucleous	டைசர்	None
tigris river	டைகிரிஸ்	None
tiger	புலியை	None
davis	டேவிஸ்	None
daniel	டேனியல்	None
dachau	டேச்சு	None
day	நாள்	None
titanium	டைட்டேனியம்	None
doctor	மருத்துவர்	None
alone	தனியாக	None
natural quality	தன்மை	None
chief	தலைமைத்	None
generation	பழந்தமிழர்	None
topics	தலைப்புகள்	None
caption	தலைப்பு	None
capital city	தலைநகரம்	None
capital	தலைநகர்	None
capitals	தலைநகரங்கள்	None
famous	புகழ்பெற்றது	None
head	தலைமை	None
existing	தற்போதுள்ள	None
present	தற்போதும்	None
currently	தற்போது	None
suicide	தற்கொலை	None
temporarily	தற்காலிகமாக	None
temporary	தற்காலிக	None
leadership	தலைமையின்	None
headquaters	தலைமையகம்	None
head quaters	தலைமையிடமாக	None
under the leadership	தலைமையிலான	None
wrong	தவறான	None
meditation	தவம்	None
discount	தள்ளுபடி	None
floor	தளம்	None
sites	தளங்கள்	None
site	தளத்தில்	None
woman	பெண்ணை	None
dharmapuri	தர்மபுரி	None
leaders	தலைவர்கள்	None
leader	தலைவர்	None
interference	தலையீட்டை	None
interfere	தலையிட	None
primary	முதன்மையான	None
editoral	தலையங்கம்	None
led	தலைமையேற்று	None
under the leadership of	தலைமையில்	None
president and	தலைவராகவும்	None
dharma	தர்மம்	None
wordy quarrel	தர்க்க	None
ground	மைதானம்	None
tamil eelam	தமிழீழத்தில்	None
in tamil	தமிழில்	None
of tamil	தமிழின்	None
tamilpoem	தமிழிசை	None
tamil	தமிழ்ப்	None
tamils	தமிழா	None
tamilians	தமிழரின்	None
tamil ealam	தமிழீழம்	None
hold	பிடித்துக்	None
tamil nadu	தமிழ்நாட்டின்	None
in tamilnadu	தமிழகத்தில்	None
tamilnadu	தமிழக	None
artery	தமனி	None
to escape	தப்பி	None
post	போஸ்ட்	None
character	பாத்திரம்	None
tamizhan	தமிழன்	None
self sufficient	தன்நிறைவு	None
tamil language	தமிழை	None
tamilnet	தமிழ்நெட்	None
not having a gap	தரைபாவுமை	None
gives	தருவது	None
data	தரவை	None
not given	தரவில்லை	None
download	பதிவிறக்கம்	None
standard	நியம	None
in standard	தரத்தில்	None
in the tamil nadu	தமிழ்நாட்டில்	None
quality	தரம்	None
ready by	தயார்	None
manufacture	தயாரிப்புகள்	None
prepared	தயாரித்து	None
produced	வெளிவரும்	None
manufactured	தயாரிக்கப்பட்ட	None
productions	போன்றவற்றைக்	None
to be ready for harvest	தயாராக	None
yogurt	தயிர்	None
dhaka	டாக்கா	None
dock	டாக்	None
da	டா	None
in the mars planet	செவ்வாயில்	None
in the mars	செவ்வாயின்	None
influence	செல்வாக்கை	None
wealth	செல்வம்	None
selvan a title given	செல்வன்	None
going	போகும்	None
for going	செல்வதற்கு	None
while going	செல்லும்போது	None
pet	செல்லப்	None
seldic	செல்டிக்	None
leads	வழிவகுக்கிறது	None
visit	விஜயம்	None
payments	முறைகளை	None
exerted	செலுத்திய	None
injected	செலுத்தினர்	None
classicalogy	செவ்வியல்	None
se	சே	None
collect	தொகுத்து	None
collected	தொகுத்தார்	None
charity	தொண்டு	None
cheralathan	சேரலாதன்	None
the cheras	சேரர்களின்	None
cheras	சேரர்கள்	None
seramaan	சேரமான்	None
cheran	சேரன்	None
join	திரட்டி	None
selenium	செலீனியம்	None
savings	சேமிப்பு	None
saved	சேமிக்கப்படும்	None
channel	சேனல்	None
sedhu	சேது	None
damage	சேதம்	None
shakespeare	சேக்சுபியர்	None
sakespeare	சேக்சுபியரின்	None
collection	தொகுப்புகள்	None
saver	சேவர்	None
expenses	செலவுகள்	None
cost	செலவு	None
expense	செலவில்	None
they did	செய்தனர்	None
done by	செய்தன	None
profile	பயன்வகை	None
done	பட்டுள்ளன	None
makes	செய்கிறது	None
make	மேற்கொள்ள	None
st.	செயின்ட்	None
making	செய்வதை	None
fucntional	செயல்பாட்டு	None
operates	செயல்பட்டு	None
worked	பணியாற்றினார்	None
operation	செயல்படும்	None
implementation	செயல்படுத்தப்படுகிறது	None
performance	செயல்திறன்	None
actions	நடவடிக்கைகளை	None
process	நிகழ்முறை	None
functions	பயன்பாடுகள்	None
to add	சேர்	None
did	செய்தார்கள்	None
messages	செய்திகளை	None
sherpa	செர்ப்பா	None
in germany	ஜெர்மனியில்	None
germany	ஜேர்மனி	None
serranidae a fish family name	செரானைடீ	None
ceratopciti	செராடொப்சிடீ	None
in doing	செய்வதில்	None
do not	வேண்டாம்	None
if done	செய்தால்	None
to do	செய்வது	None
have been	செய்யப்பட்டுள்ளன	None
to be done	செய்யவேண்டும்	None
can do	செய்யக்கூடிய	None
do	செய்யக்	None
doers	செய்பவர்கள்	None
doing	படுத்தி	None
in news paper	செய்தித்தாளில்	None
not done	செய்யவில்லை	None
combination	சேர்க்கையை	None
adding	சேர்த்து	None
belong	சேர்ந்தவை	None
zimbabe	ஜிம்பாப்வே	None
gmail	ஜிமெயில்	None
in gmail	ஜிமெயிலில்	None
ips	ஜிபிஎஸ்ஸின்	None
gps	ஜிபிஎஸ்	None
gmo	ஜிஎம்ஓ	None
javascript	ஜாவாஸ்கிரிப்ட்	None
jean	ஜீன்	None
java	ஜாவா	None
jar	ஜார்	None
johnson	ஜான்சன்	None
john	யோவான்	None
jackson	ஜாக்சன்	None
jawaharlal	ஜவஹர்லால்	None
jammu	ஜம்மு	None
in japan	ஜப்பானில்	None
george	ஜார்ஜ்	None
japanese	ஜப்பானியர்கள்	None
jeevan	ஜீவன்	None
jurich	ஜூரிச்	None
touch	டச்	None
sages	ஞானிகள்	None
saint	ஞானி	None
wisdom	ஞானம்	None
torch	தீபம்	None
paired	ஜோடியாக	None
joseph	யோசேப்பு	None
junior	ஜூனியர்	None
germany's	ஜேர்மனியின்	None
jack	ஜேக்	None
j	ஜே	None
german	ஜேர்மன்	None
chief minister of tamil nadu	ஜெயலலிதா	None
geneva	ஜெனீவா	None
joule	ஜூல்	None
julius	ஜூலியஸ்	None
james	யாக்கோபு	None
fault	தவறு	None
the president	ஜனாதிபதியின்	None
jahan	ஜகான்	None
that says	சொல்கிறது	None
semantic	சொற்பொருளியல்	None
words	வார்த்தைகள்	None
heaven	சொர்க்கம்	None
if they say beautifully	சொன்னால்	None
own	தனித்து	None
property	சொத்து	None
tells	சொல்கிறார்	None
vegetarian	சைவம்	None
in the service	சேவையில்	None
services	பணிகளை	None
service	சேவை	None
saree	சேலை	None
salem	சேலம்	None
muddy	சேற்று	None
serbia	சேர்பியா	None
siberian	சைபீரியன்	None
democratic	மக்களாட்சிக்	None
it is informed	சொல்லப்படுகிறது	None
word	வேர்ட்	None
shoshone a north american tribe	சோஷோன்	None
soviet	சோவியத்	None
cholas	சோழர்கள்	None
cholapuram	சோழபுரம்	None
first cholan	சோழன்முதலாம்	None
cjola have ganga	சோழன்கங்கைகொண்ட	None
for the cholas	சோழனுக்கு	None
the term	சொல்லானது	None
cholan	சோழனின்	None
chola nadu or chola ruling place	சோழநாடு	None
chola	சோழர்களின்	None
corn	சோளம்	None
trial	சோதனை	None
sodium	சோடியம்	None
soso people	சோசா	None
socialism	சோசலிச	None
chola kingdom in the country	சோழநாட்டின்	None
walk	நடந்து	None
allow phonetic typing by mistake	தவறுதலாக	None
to avoid	தவிர்க்க	None
election	தேர்தலில்	None
honey	தேன்	None
theni	தேனி	None
tea	தேயிலை	None
date	தேதி	None
looking	தேடும்	None
searching	தேடி	None
search	தேடுதல்	None
national	பாரதிய	None
desigar	தேசிகர்	None
the nation's	தேசத்தின்	None
nation	தேசம்	None
clear	தெளிவு	None
in telugu	தெலுங்கில்	None
telugu	தெலுங்கு	None
elections	தேர்தல்கள்	None
expertised	தேர்ந்த	None
select	தேர்ந்தெடுக்க	None
elected	மகிந்த	None
volume of	தொகுதியின்	None
consituencies	தொகுதிகள்	None
compiled	தொகுக்கப்பட்ட	None
stitching	தையல்	None
month of thai	தை	None
no need of	தேவையில்லை	None
necessary	தேவையான	None
south asian	தெற்காசிய	None
not necessary	தேவையற்ற	None
wants	தேவைகள்	None
need	வேண்டியது	None
wanted	விரும்பினார்	None
devi	தேவி	None
deva	தேவர்	None
devar	தேவரின்	None
selected	தேர்ந்தெடுக்கப்பட்ட	None
needed	தேவைப்பட்டது	None
southern	தெற்கு	None
mother theresa	தெரேசா	None
in the street	வீதியில்	None
distance	தொலைவு	None
keeps away	தூர	None
purity	தூய்மை	None
pure	தூய	None
tuticorin	தூத்துக்குடி	None
messenger	தூதர்	None
stimulates	தூண்டும்	None
thulium	தூலியம்	None
response	தூண்டற்பேறு	None
pillar	தூண்	None
start	தொடங்கும்	None
holes	துளைகள்	None
drop	துளி	None
basil	துளசி	None
accurate	துல்லியமான	None
departmental	துறையை	None
pillars	தூண்கள்	None
in a set of	தொகுப்பில்	None
south	தெற்கே	None
southeast	தென்கிழக்கு	None
street	வீதிகள்	None
call for	தெரிவித்துள்ளனர்	None
inform	தெரிவித்து	None
informing	தெரிவிக்கும்	None
informating	தெரிவிக்கின்றன	None
looks	தெரிகிறது	None
godly	தெய்வீக	None
south-east asia's	தென்கிழக்காசியாவின்	None
breeze	தென்றல்	None
coconut	தென்னை	None
in south india	தென்னிந்தியாவில்	None
southindia	தென்னிந்தியாவின்	None
south india	தென்னிந்தியா	None
south africa	தென்னாப்பிரிக்காவில்	None
north africa	தென்னாப்பிரிக்க	None
south china	தென்சீனப்	None
southwest	தென்மேற்கு	None
industry	தொழில்துறை	None
compilation	தொகுப்பு	None
hang	தொங்கு	None
professional	வல்லுநர்	None
technologies	தொழில்நுட்பங்கள்	None
technology	நுட்பம்	None
jobs	வேலைகள்	None
works	தொழில்களை	None
business	வியாபார	None
of workers	தொழிலாளர்களின்	None
labourers	தொழிலாளர்	None
industrial	தொழிற்புரட்சி	None
industries	தொழிற்சாலைகள்	None
in factories	தொழிற்சாலைகளில்	None
factory	தொழிற்சாலை	None
occupational	தொழிற்	None
paleontology	தொல்லுயிரியல்	None
archaeological	தொல்லியல்	None
dosa	தோசை	None
garden	தோட்டம்	None
appear	தோன்றும்	None
origin	தோன்றியது	None
ornament	நகை	None
mobile phone	நகர்பேசி	None
nakarkaruvi	நகர்கருவி	None
moving	நகர்ந்து	None
municipalities	நகராட்சிகள்	None
municipal	முனிசிப்பல்	None
cities	மாநகரங்கள்	None
early man reserch	தொல்பொருள்	None
defeat	தோல்வியை	None
founder	தோற்றுவித்த	None
fail	தோல்வியுற்ற	None
appearance	தோற்றத்தை	None
faces	தோற்றங்கள்	None
beaten	தோற்ற	None
drum	தோற்கருவி	None
it appears with	தோன்றுகிறது	None
skin	தோல்	None
archeological	புதைபடிவ	None
tholkappiar	தொல்காப்பியர்	None
tholkappiyam	தொல்காப்பியம்	None
rail	தொடர்வண்டிப்	None
connection, association, contacts	தொடர்பையும்	None
associated	தொடர்புடையதாக	None
contacts	தொடர்புகள்	None
in relation to	தொடர்பில்	None
togeather	தொடர்பாக	None
following	பின்வருவனவற்றையும்	None
sequence	தொடர்வரிசை	None
continued	தொடர்ந்த	None
continuous	தொடர்ச்சியான	None
continues	தொடர்கிறது	None
continue	தொடர்ந்தும்	None
series	தொடர்	None
begins	தொடங்குகிறது	None
launched	தொடங்கப்பட்டது	None
initial stage	தொடக்ககால	None
continuously	தொடர்ச்சியாக	None
packages	தொகுப்புகளை	None
femur	தொடையெலும்பு	None
traditionally	தொன்று	None
olden	பழமையான	None
in remote	தொலைவில்	None
telephones	தொலைபேசிகள்	None
telephone	தொலைபேசி	None
telecom	தொலைத்	None
telescope	மேல்நோக்கி	None
contagious	தொற்றும்	None
cradle	தொட்டில்	None
leprosy	தொற்றுநோய்	None
very olden	தொன்மையான	None
ancient	பழங்கால	None
thonmaas	தொன்மாக்கள்	None
dinosaur	தொன்மா	None
mythology	தொன்மவியல்	None
thondaimaan	தொண்டைமான்	None
throat	தொண்டை	None
infection	நோய்த்தொற்று	None
port	போர்ட்	None
harbour	துறைமுகத்தில்	None
ports	துறைமுகம்	None
whale	திமிங்கிலம்	None
whales	திமிங்கிலங்கள்	None
a title given to king	திப்பு	None
of tibet	திபெத்தின்	None
tibet	திபெத்	None
daily malar	தினமலர்	None
dinamani	தினமணி	None
belt	திணைமண்டலம்	None
mass	வெகுஜன	None
planned	திட்டமிட்ட	None
planning	திட்டமிடல்	None
program	திட்டம்	None
scheme	திட்டத்தின்	None
plans	திட்டங்கள்	None
plannings	திட்டங்களின்	None
dmk a political party	திமுக	None
dmk, a political party	திமுகவின்	None
swarms	திரள்கள்	None
liquid	நீர்ம	None
amendments	திருத்தங்களை	None
trichirapalli	திருச்சிராப்பள்ளி	None
thiruchi	திருச்சி	None
chruch	திருச்சபையின்	None
churches	திருச்சபைகள்	None
church	தேவாலயம்	None
in casualty	திருக்கோணமலையில்	None
project	திட்டத்தில்	None
thirukona malai	திருக்கோணமலை	None
thirugonamalai	திருகோணமலை	None
mr.	மிஸ்டர்	None
dravidians	திராவிடர்கள்	None
pradesh to	திராவிடம்	None
dravidian	திராவிடர்களை	None
dravida	திராவிடர்	None
fluid	திரவம்	None
thirukkural	திருக்குறள்	None
sudden	திடீர்	None
solid	திண்ம	None
router	திசைவி	None
donating	தானம்	None
mineral	தாது	None
even after that	தாண்டிய	None
the taj mahal	தாஜ்மகாலின்	None
taj	தாஜ்	None
bearing	தாங்கிய	None
to bear	தாங்க	None
automatically	தானாகவே	None
thaco a mixture	தாக்கோ	None
attacked	தாக்கி	None
affect	பாதிக்கும்	None
impacts	தாக்கங்கள்	None
impact	விளைந்த	None
attack	தாக்கும்	None
tagore	தாகூர்	None
except	தவிர்த்து	None
attacks	தாக்குதல்களை	None
correction	திருத்தம்	None
automatic	தானியங்கி	None
their own	தானே	None
directions	திசைகளிலும்	None
tissue	திசு	None
monday	திங்கள்	None
bearing a good name	திகழும்	None
botany	தாவரவியல்	None
in plants	தாவரங்களில்	None
lower land	தாழ்வான	None
motor	மோட்டார்	None
backward class	தாழ்த்தப்பட்ட	None
rocker	தாலாட்டு	None
taiwan	தாய்வான்	None
thailand	தாய்லாந்து	None
from the mother	தாயின்	None
thamiraparani is a river in tamil nadu	தாமிரபரணி	None
thomas	தாமஸ்	None
just	வெறும்	None
taliban	தாலிபான்	None
corrected	திருத்தப்பட்ட	None
good day	திருநாள்	None
thirunavukkarasu a tamil name	திருநாவுக்கரசு	None
particles	துகள்கள்	None
particle	துகள்	None
in islands	தீவுகளில்	None
in island	தீவில்	None
terrorism	பயங்கரவாதம்	None
seriously	தீவிரமான	None
heavily	தீவிர	None
mourning	துக்கம்	None
islands	தீவுகள்	None
solution	தீர்வு	None
judgement	நீதியின்	None
to find a solution	தீர்க்கும்	None
solve	தீர்க்க	None
bad	மோசமான	None
deepawali	தீபாவளி	None
teen	தீன்	None
islander	தீவினர்	None
harm	தீங்கு	None
bat	மட்டை	None
sub	துணைக்	None
departments	துறைகள்	None
depatment	துறைகளிலும்	None
ports or departments	துறைகளின்	None
to be left	துறந்து	None
turkey	துருக்கி	None
rapidly	துரிதமாக	None
fast	வேகமாக	None
partner	துணை	None
dubai	துபை	None
sorrow	துன்பம்	None
zinc	துத்தநாகம்	None
segments	பிரிவுகளில்	None
pieces	துண்டுகளாக	None
pit	துண்டு	None
to be helpful	துணையாக	None
sub continent	துணைக்கண்டத்தின்	None
tragedies	துன்பியல்	None
apart	தவிர	None
safety match	தீக்குச்சி	None
dhil	தில்	None
thiruvaroor	திருவாரூர்	None
astrology word	திருவாதிரை	None
thiruvalluvar	திருவள்ளுவர்	None
thiruvannamalai	திருவண்ணாமலை	None
returned	திரும்பினார்	None
for tirumul	திருமுழுக்கு	None
tirumuraikal	திருமுறைகள்	None
thiruvalangkadu is a place in tamilnadu	திருவாலங்காட்டுச்	None
deuterocanonical	திருமுறை	None
tirumala	திருமலை	None
marriage	மண	None
lakshmi	லட்சுமி	None
tirupur a district in tamil nadu	திருப்பூர்	None
return	திரும்பிய	None
thirupathi a holy temple in andhra pradesh	திருப்பதி	None
thirunelvelli	திருநெல்வேலி	None
thirumal a vainava god	திருமால்	None
fire	பயர்	None
thiruvidaimaruthoor	திருவிடைமருதூர்	None
screen	திரை	None
a title given to actors in tamil	திலகம்	None
key	விசையின்	None
indeligent	திறம்பட	None
talent	திறமை	None
skills	திறன்களை	None
efficiency	திறனை	None
talented	திறனுள்ள	None
thiruvilayadal, the work of lord siva	திருவிளையாடல்	None
open	திறந்து	None
cinema deportment	திரைப்படத்துறையில்	None
film industry	திரைப்படத்துறை	None
film	படமான	None
movies for	திரைப்படங்களுக்கு	None
in movies	திரைப்படங்களில்	None
movies	படங்களின்	None
movie	திரைப்பட	None
picture	பட	None
activator	செயலிகள்	None
after	பிறகே	None
followed	பின்பற்றப்படுகிறது	None
bengali	வங்காளி	None
west bengal	வங்காளம்	None
bengal	வங்காள	None
having that way	வகையிலான	None
variety of	வகையான	None
of kind	வகையாக	None
is planned	வகைப்படுத்துவது	None
classification	வகைப்பாட்டு	None
veriety	வகைத்	None
type	வகைக்	None
variety	வகைகளின்	None
types	வகைப்பட்ட	None
class	வர்க்கம்	None
in class	வகுப்பில்	None
existed	வகித்தது	None
bank	வங்கியின்	None
banks	வங்கிகள்	None
facility	வசதி	None
facilities	வசதிகளை	None
circle	வட்டம்	None
design	வடிவமைப்பு	None
designed to	வடிவமைக்கப்பட்ட	None
form	வடிவமான	None
shaped	வடிவிலான	None
sanitary	வடிகால்	None
north indian language	வடமொழியில்	None
plays	விளையாடப்படும்	None
northwest	வடமேற்கு	None
from north	வடக்கிலிருந்து	None
northeast	வடகிழக்குப்	None
north	வடக்கே	None
residing	வசிக்கும்	None
into the hands of	வசம்	None
spring	வசந்தம்	None
comfortable	வசதியான	None
in the north	வடக்கில்	None
va	வ	None
labotidae a name given to family of fish	லோபோட்டைடீ	None
lemur	லெமூர்	None
rome	ரோம்	None
romeo	ரோமியோ	None
romanian	ரோமர்	None
rohini	ரோகிணி	None
ribosome	ரைபோசோம்	None
rite	ரைட்	None
radio	வானொலிக்	None
routing	ரௌட்டிங்	None
retro	ரெட்ரோ	None
rupees	ரூபாய்	None
ruthenium	ருத்தேனியம்	None
in terms of	ரீதியில்	None
industrialised way	ரீதியிலான	None
reliance	ரிலையன்ஸ்	None
richard	ரிச்சர்டு	None
reserve	ரிசர்வ்	None
reggae	ரெகே	None
in circle	வட்டத்தில்	None
la	லா	None
lanthanide	லாந்த்தனைடு	None
lenin	லெனின்	None
leninism	லெனினிசம்	None
lues	லூயிஸ்	None
louisiana	லூசியானா	None
luke	லூக்கா	None
lutjanidae a fish family name	லுத்யானைடீ	None
in liyarnado	லியொனார்டோவின்	None
lushkar-a-thoiyba	லஷ்கர்-ஏ-தொய்பா	None
leonardo	லியொனார்டோ	None
lin	லின்	None
linex	லினக்ஸ்	None
litho	லித்தோ	None
lincoln	லிங்கன்	None
las	லாஸ்	None
lal	லால்	None
lorry	லாரி	None
lipid	லிப்பிட்	None
rig	ரிக்	None
orbit	வட்டப்பாதையில்	None
disk	வட்டு	None
valvil	வல்வில்	None
a talented	வல்லவன்	None
computer networking	வலையமைப்பு	None
blogs	வலைப்பதிவுகள்	None
blog	வலைப்பூ	None
webpage	வலைப்பக்கம்	None
insist	வலியுறுத்தும்	None
enforce	வலியுறுத்தினார்	None
emphasizing	வலியுறுத்தி	None
pain	வலி	None
in poor	வறுமையில்	None
poverty	வறுமை	None
drought	வறட்சி	None
varma	வர்ம	None
on of the principle of something about	வரைவு	None
resources	வளம்	None
fertile	வளமான	None
grow	வளர்ச்சியடைந்து	None
nourish	வளர்	None
a tamil epic	வளையாபதி	None
bangle	வளையல்	None
rings	வளையம்	None
than katch	வளைகுடா	None
curve	வளைவு	None
carbonic anhydride	வளிமம்	None
earth's surface	வளிமண்டலத்தில்	None
draw	வரையும்	None
atmosphere of	வளிமண்டலத்தின்	None
gases	வாயுக்கள்	None
atomosphere	வளிமங்களின்	None
development of	வளர்ச்சியின்	None
growth	வளர்ச்சியையும்	None
metabolism	வளர்சிதைமாற்றம்	None
grown	வளர்ந்து	None
develop	வளர்க்க	None
atmosphere	விண்	None
till	வரையிலும்	None
definitions	வரைவிலக்கணங்கள்	None
definition	வரைவிலக்கணம்	None
hadron	வன்மி	None
vannier	வன்னியர்	None
vanni tree	வன்னி	None
come	வா	None
if	வந்தால்	None
has come	வந்தாச்சு	None
came	வந்தார்	None
violence	வன்முறை	None
coming	வருவது	None
2nd	வது	None
annihilated	வதம்	None
sediment	வண்டல்	None
businessman	வணிகர்	None
and worshiping	வணங்கி	None
wishing	வணக்கம்	None
worship	வழிபாடு	None
vatican	வத்திக்கான்	None
interest	வட்டி	None
dynasty	வம்சம்	None
violin	வயலின்	None
determining	வரையறுக்கிறது	None
defined	வரையறுக்கப்படுகிறது	None
on the map	வரைபடத்தில்	None
drawn	வரையப்பட்ட	None
in revenue	வருவாயில்	None
coming from	வருவதால்	None
when it comes	வரும்போது	None
at the age of	வயதில்	None
income	வருவாய்	None
row	வரிசையில்	None
not affect	வராமல்	None
economic status	வரவு	None
didnt come	வரவில்லை	None
welcome	வருக	None
boon	வரம்	None
stomach	வயிற்றில்	None
in year	வருடத்தில்	None
rico	ரிகோ	None
rao	ராவ்	None
roy	ராய்	None
highschool	மேனிலைப்பள்ளி	None
genius	மேதை	None
websites	மேடை	None
major	மேஜர்	None
cloud	மேகம்	None
wax	மெழுகு	None
mollusc	மெல்லுடலி	None
thin	மெல்லிய	None
melanesia	மெலனீசியா	None
marina	மெரினா	None
true reputation	மெய்க்கீர்த்தி	None
true	மெய்	None
mail	மெயில்	None
soft	மென்மையான	None
softwares	மென்பொருள்கள்	None
manhattan	மேன்காட்டன்	None
highness	மேன்மைமிகு	None
improve	மேம்படுத்த	None
improved	மேம்படுத்தப்பட்ட	None
above all	மேலிருக்கும்	None
on the surface	மேற்பரப்பில்	None
celebrity	மேற்கொள்ளப்பட்டன	None
carried out	மேற்கொள்ளப்படும்	None
to be followed	மேற்கொள்ளப்படுகிறது	None
undertook	மேற்கொண்டது	None
aforementioned	மேற்கூறிய	None
soft things	மென்பொருளின்	None
west	மேலை	None
above mentioned	மேற்கண்ட	None
grazing	மேய்ச்சல்	None
mayor	மேயர்	None
improvement	மேம்பாடு	None
better	வாய்ந்த	None
to improve	மேம்படுத்தும்	None
improvisation	மேம்படுத்தல்	None
western	மேற்குத்	None
software	மென்பொருள்	None
slowly	மெல்ல	None
metro	மெட்ரோ	None
all over	முழுவதும்	None
full	முழுமையாகக்	None
mulllaitivu	முல்லைத்தீவு	None
mullai	முல்லை	None
mullidae , a family name for fish	முலைடீ	None
totally	மொத்தத்தில்	None
in those days	முற்பகுதியில்	None
the whole	முழுவதிலும்	None
ancient days	முற்காலத்தில்	None
in olden days	முற்கால	None
by the rule of law	முறையே	None
way	முறையையும்	None
a method of rule	முறையானது	None
systems	முறைமைகள்	None
methods	வழிமுறைகளையும்	None
method	முறையைப்	None
past period	முற்காலச்	None
from above	மேலிருந்து	None
whole	முழுவதுமாக	None
nose	மூக்கு	None
metastasis	மெடாச்டாசிஸ்	None
mexico	மெக்சிகோ	None
big	மெகா	None
all the three	மூவரும்	None
diagonal	மூலைவிட்டம்	None
herbal	மூலிகை	None
sources	மூலங்கள்	None
muslims	முஸ்லிம்கள்	None
molecules	மூலக்கூறுகள்	None
idol	மூர்த்தி	None
three	மூவர்	None
third	மூன்றாவது	None
senior	மூத்த	None
superstition	மூடநம்பிக்கை	None
breath	மூச்சு	None
bamboo	மூங்கில்	None
molecular	மூலக்கூற்று	None
further more	மேலும்	None
western salukya king	மேலைச்	None
crust	மேலோடு	None
yordan	யோர்தான்	None
york	யோர்க்	None
vaginal	யோனி	None
name of a person	யோசேஃபசு	None
yoga	யோகம்	None
yellowstone	யெல்லோஸ்டோன்	None
europium	யூரோப்பியம்	None
rugby	ரக்பி	None
euro	யூரோ	None
euclid	யூக்ளிட்	None
u	யூ	None
uranium	யுரேனியம்	None
uranus	யுரேனஸ்	None
unesco	யுனெஸ்கோ	None
utc	யுடிசி	None
by all	யாவற்றினும்	None
jewish	யூதர்கள்	None
yalpanam	யாழ்ப்பாணப்	None
fans	ரசிகர்கள்	None
ratna	ரத்னா	None
royal	ராயல்	None
ram	ராம்	None
raman	ராமன்	None
ramasamy	ராமசாமி	None
robert	ராபர்ட்	None
radha krishnan	ராதாகிருஷ்ணன்	None
area or ruling or governing places	ராஜ்ஜியம்	None
rajinikanth	ரசினிகாந்து	None
rajiv gandhi	ராஜீவ்	None
war stragedy	ராஜதந்திர	None
raja	ராஜ	None
rocky mountain	ராக்கி	None
tunes	ராகங்கள்	None
in russia	ரஷ்யாவில்	None
railways	ரயில்வே	None
rubber	ரப்பர்	None
rajan	ராஜன்	None
vallalar	வள்ளலார்	None
in jaffna	யாழ்ப்பாணத்தில்	None
ilangai	யாழ்ப்பாண	None
language and	மொழியாகவும்	None
for language	மொழிக்கு	None
languages as well	மொழிகளையும்	None
within languages	மொழிகளுள்	None
languages	மொழிகள்	None
language	மொழியை	None
mauritius	மொரிசியசு	None
translation	மொழிபெயர்ப்பு	None
total	மொத்தம்	None
as a head or in central	மையமாகவும்	None
center region	மையப்பகுதியில்	None
centers	மையங்கள்	None
adult	மைனர்	None
mysore	மைசூர்	None
microsoft	மைக்ரோசாப்ட்	None
micheal	மைக்கேல்	None
mile	மைல்	None
yalpaanam	யாழ்ப்பாணக்	None
language of	மொழியாகக்	None
language's	மொழியின்	None
no one	யாருக்கும்	None
yappu	யாப்பு	None
elephants	யானைகள்	None
elephant's	யானைகளின்	None
elephant	யானையின்	None
pilgrimage	யாத்திரை	None
of that	யாதெனில்	None
the language	மொழியே	None
yahoo	யாஹூ	None
yamuna	யமுனை	None
not speek	மௌன	None
battle	யுத்தம்	None
mohan	மோகன்	None
in the language	மொழியில்	None
linguistics	மொழியிலும்	None
lingustics	மொழியியலின்	None
penance	யாகம்	None
murugan	முருகன்	None
a generous person	வள்ளல்	None
valluvar	வள்ளுவர்	None
eruption of volcano	வெடிப்புக்	None
explode	வெடித்து	None
exploded	வெடித்துச்	None
onion leaves	வெங்காயத்தாள்	None
greatly	வெகுவாக	None
v is the initial before tamil leader periyar	வெ	None
has lost	வீழ்ந்தது	None
player	வீரர்களின்	None
veeramamunivar	வீரமாமுனிவர்	None
veerapandiya	வீரபாண்டிய	None
warrior	வீரன்	None
venus	வீனஸ்	None
musical instrument	வீணை	None
pertains to home	வீட்டு	None
homes	வீடுகளிலும்	None
cut	வெட்டு	None
white	வெள்ளைப்	None
venpa	வெண்பா	None
heating	வெப்பமடைதல்	None
transparent	வெளிப்படையான	None
openly	வெளிப்படையாக	None
exposed	வெளிப்படும்	None
abroad	வெளிநாட்டில்	None
wells	வெல்ஸ்	None
success	வெற்றியை	None
successes	வெற்றிகள்	None
video	வீடியோ	None
successful	வெற்றிகரமான	None
versailles	வெர்சாய்	None
thermochemistry	வெப்பவேதியியல்	None
weather conditions	வெப்பமண்டல	None
warm place	வெப்பப்பகுதி	None
heat	வெப்பம்	None
temperatures	வெப்பநிலைகள்	None
temperature	வெப்பநிலையில்	None
successfully	வெற்றிகரமாக	None
range	வீச்சு	None
radiative	வீச்சில்	None
swept	வீசும்	None
games	விளையாட்டுக்களும்	None
in the game	விளையாட்டில்	None
sports	விளையாட்டுப்	None
playing	விளையாடும்	None
play	விளையாடு	None
vladimir	விளாடிமிர்	None
ad	விளம்பரத்தை	None
game	விளையாட்டை	None
advertisers	விளம்பரதாரர்கள்	None
advertisements'	விளம்பரங்களின்	None
advertisement	விளம்பரம்	None
past tense of be (was)	விளங்கினார்	None
to be understood	விளக்கும்	None
explains	விளக்குகிறது	None
make it clear	விளக்குகின்றன	None
explaining	விளக்கி	None
addvertisement	விளம்பரங்களுக்கு	None
elaborate	வெளிப்பாடு	None
effects	விளைவுகள்	None
falls	விழுந்து	None
bulged	வீக்கம்	None
a letter or a flower in tamil	வீ	None
vista	விஸ்டா	None
vishnu	விஷ்ணு	None
vivekananda	விவேகானந்தர்	None
bible	விவிலியத்தில்	None
describing	விவரிப்பது	None
will yield	விளைவிக்கும்	None
to be explained	விவரிக்கும்	None
details	விவரம்	None
farmers	விவசாயிகள்	None
farmer	விவசாயி	None
agriculture	வேளாண்மை	None
agricultural	விவசாயத்தின்	None
affairs	விவகாரங்கள்	None
fall	வீழ்ச்சிக்குப்	None
describe	விவரிக்க	None
explanation	விளக்கம்	None
disclosures	வெளிப்பாடுகள்	None
published	வெளியிட்டுள்ளது	None
shajkhan a moghul king	ஷா	None
diamond	வைரம்	None
vairamuthu	வைரமுத்து	None
viruses	வைரசுகள்	None
virus	வைரஸ்	None
placing	வைப்பது	None
take off	வைத்திருந்த	None
possessed	வைத்திருக்கும்	None
retention	வைத்தல்	None
vaishnava	வைணவ	None
vaikam is a place in kerala	வைக்கம்	None
kept	வைக்கப்பட்டுள்ளன	None
placed	வைத்தார்	None
vaigai	வைகை	None
vaikundar	வைகுண்டர்	None
script	ஸ்கிரிப்ட்	None
stalin	ஸ்டாலின்	None
statten	ஸ்டேட்டன்	None
styracosaurus	ஸ்டைராக்கோசோரஸ்	None
hestia	ஹெஸ்டியா	None
hepatitis	ஹெபடைடிஸ்	None
henry	ஹென்றி	None
helium	ஹீலியம்	None
hill	ஹில்	None
hollywood	ஹாலிவுட்	None
harvard	ஹார்வர்ட்	None
vikunda's	வைகுண்டரின்	None
hockey	ஹாக்கி	None
harappa	ஹரப்பா	None
hudson	ஹட்சன்	None
haj pilgrimage	ஹஜ்	None
hungary a country	ஹங்கேரி	None
ha - a letter	ஹ	None
sreerangam(place)	ஸ்ரீரங்கம்	None
smith	ஸ்மித்	None
hawai	ஹவாய்	None
wi-fi	வைஃபை	None
keep	வைத்துக்	None
vellalar	வேளாளர்	None
fastly	வேகமான	None
at speeds	வேகத்தில்	None
west minister	வெஸ்ட்மின்ஸ்டர்	None
whites	வெள்ளையின	None
tin	வெள்ளீயம்	None
friday	வெள்ளிக்கிழமை	None
silver	வெள்ளி	None
hunting	வேட்டையாடும்	None
floods	வெள்ளங்கள்	None
pale	வெளிர்	None
expulsion	வெளியேற்றம்	None
to be released	வெளியேற்றப்படும்	None
exit	வெளியேறும்	None
out of home	வெளியில்	None
outside	வெளியிலிருந்து	None
releases	வெளியிடுகிறது	None
flood	வெள்ளம்	None
outdoor	வெளிப்புற	None
candidate	வேட்பாளர்	None
want	வேண்டுமென்றே	None
wales	வேல்ஸ்	None
oppurtunity	வேலைவாய்ப்பு	None
unemployed	வேலைவாய்ப்பின்மை	None
assignment	வேலையை	None
to work	வேலைக்கு	None
requried	வேலைகளில்	None
vellore	வேலூர்	None
candidates	வேட்பாளர்கள்	None
its a name of a person	வேலுப்பிள்ளை	None
another one	வேறெந்த	None
differentiated	வேறுபடுத்தி	None
differ	வேறுபடுகிறது	None
margo	வேம்பு	None
chemistry	வேதியியல்	None
vedas	வேதங்கள்	None
vedic	வேதாந்த	None
fence	வேலி	None
explained	விளங்கினர்	None
diagram	விளக்கப்படம்	None
explanations	விளக்கங்கள்	None
comets	வால்மீன்கள்	None
poet valmiki	வால்மீகி	None
walt	வால்ட்	None
tail	வால்	None
wise	வாரியாக	None
heirs	வாரிசாக	None
week	வாரம்	None
weekly	வார	None
verbal	வாய்மொழி	None
chance's are there	வாய்ப்புள்ளது	None
chances	வாய்ப்பை	None
opportunities	வாய்ப்புகள்	None
opportunity	வாய்ப்பும்	None
mouth	வாய்	None
vampire	வாம்பைர்	None
sword	வாள்	None
to live	வாழ	None
habitat	வாழ்	None
banana	வாழைப்பழம்	None
wikipedia	விக்கிப்பீடியாவை	None
wikis	விக்கிகள்	None
wiki	விக்கி	None
stoichiometry	விகிதவியல்	None
rate	வீதம்	None
ratio	விகிதத்தில்	None
vikatan	விகடன்	None
vanpulikal	வான்புலிகள்	None
v	வி	None
washington	வாஷிங்டன்	None
in life	வாழ்வில்	None
lived	வாழ்ந்து	None
lifetime	வாழ்நாள்	None
greeting	வாழ்த்து	None
in their life	வாழ்க்கையில்	None
live long	வாழ்க	None
vastu	வாஸ்து	None
aerial tigers	வான்புலிகளின்	None
aircraft	வானூர்திகள்	None
aeroplane	வானூர்தி	None
votes	வாக்குரிமை	None
vote	வாக்கு	None
sentence	வாக்கியம்	None
voting	வாக்களிப்பில்	None
vehicles	வாகனங்கள்	None
vehicle	வாகனம்	None
on the way	வழியில்	None
census	வாக்கெடுப்பு	None
instructions	வழிமுறைகள்	None
guide	வழிகாட்டி	None
presented	வழங்கினார்	None
granted	வழங்கப்பட்டது	None
will be given	வழங்கப்படும்	None
cases	வழக்குகள்	None
practically	வழக்கத்தில்	None
usually	வழக்கம்	None
prayerful	வழிபடும்	None
wikimedia	விக்கிமீடியா	None
buy	வாங்குதல்	None
purchased	வாங்கிய	None
in the sky	வானில்	None
astrophysics	வானியற்பியல்	None
vaniyar	வானியற்	None
a person of kingly nature	வானவன்	None
sky	ஸ்கை	None
space	வெளியின்	None
vomit	வாந்தி	None
bought	வாங்கி	None
argue	விவாதம்	None
arguments	வாதங்கள்	None
watt	வாட்	None
enterance , a gateway	வாசல்	None
smell	வாசம்	None
readers	வாசகர்கள்	None
reader	வாசகர்	None
to purchase or to get	வாங்கும்	None
arguement	வாதம்	None
vikrama	விக்கிரம	None
victoria	விக்டோரியா	None
vikram	விக்ரம்	None
virudhunagar	விருதுநகர்	None
awards	விருதுகள்	None
award	விருதை	None
diastolic	விரிவியக்க	None
detailed	விளக்கமான	None
expand	விரிவாக்கம்	None
in detail	விரிவாக்க	None
not liking	விரும்பவில்லை	None
detail	விரிவாக	None
enlarged	விரிந்த	None
finger	விரல்	None
jupiter	வியாழன்	None
sweat	வியர்வை	None
viatnam	வியட்நாம்	None
pilot	விமானி	None
criticism	விமர்சனங்கள்	None
expanded	விரிவடைந்து	None
accident	விபத்து	None
likely	விரும்பி	None
quik	விரைந்து	None
explain	விளக்க	None
capsule	வில்லை	None
william	வில்லியம்	None
bow	வில்	None
prices	விலைகள்	None
price	விலைவாசி	None
animals	விலங்குகள்	None
loving	விரும்புகின்றனர்	None
zoology	விலங்கியல்	None
leave from	விலகி	None
deviates	விலகல்	None
sales	விற்பனை	None
selling	விற்கும்	None
speed	வேகம்	None
soon	விரைவில்	None
quickly	விரைவான	None
refractory	விலக்கு	None
valli	வள்ளி	None
sexual business	விபச்சாரம்	None
verb	வினைச்சொல்	None
realesing	விடுதல்	None
to release	விடுதலைக்கு	None
release	வெளிவருகிறது	None
riddles	விடுகதை	None
letting	விடாமல்	None
leave	விட்டுச்	None
vidayam	விடயம்	None
released	வெளிவந்தது	None
matters	விடயங்களில்	None
vijayanagara	விஜயநகர	None
forcing	விசையால்	None
keyboard	விசைப்பலகை	None
speeds	விசைகள்	None
faith	விசுவாச	None
enquiry	விசாரணை	None
visakam	விசாகம்	None
vijay	விஜய்	None
vinci	வின்சி	None
have laid down	விடுத்தனர்	None
holiday	விடுமுறை	None
reaction	வினை	None
distribution	விநியோகம்	None
gymnosperm	வித்துமூடியிலி	None
difference	வேற்றுமை	None
shows the way	வித்திட்டது	None
seeds	விதைகள்	None
seed	விதை	None
escape	விடுபடு	None
exceptional	விதிவிலக்காக	None
asteroids	விண்மீன்கள்	None
astronaut	விண்ணோடி	None
in sky	விண்ணில்	None
windows	வின்டோஸ்	None
meteorite	விண்கல்	None
diameter	விட்டம்	None
will go	விடும்	None
as per the principles	விதிகளின்	None
behind	மறுபக்கம்	None
contrasts	முரண்பாடுகள்	None
rogue	முரட்டு	None
receive	பெறும்	None
value	மதிப்பை	None
getting	பெறுவது	None
not getting	பெறாத	None
do not get	பெறவில்லை	None
can get	பெறமுடியும்	None
received	பெற்றுள்ள	None
get	பெற்று	None
perl	பெர்ள்	None
berlin	பெர்லின்	None
permuda	பெர்முடா	None
big temple in thanjavur	பெருவுடையார்	None
majority	பெருவாரியான	None
many places	பெரும்பகுதியை	None
most parts of	பெரும்பகுதி	None
to get	மேற்கொண்டு	None
won	வென்று	None
the recipient	பெற்றவர்	None
people who got	பெற்றவர்கள்	None
great kingdoms	பேரரசுகள்	None
ghost	மோகினி	None
louse	பேன்	None
discussions	விவாதங்கள்	None
conference/meeting	பேச்சுவார்த்தை	None
talks	பேச்சுக்கள்	None
speech	பேச்சு	None
proudness	பெருமையை	None
speaking	பேசுவோர்	None
spoken	பேசப்பட்டு	None
begum , islam name	பேகம்	None
belgium	பெல்ஜியம்	None
bell	பெல்	None
parents	பெற்றோர்	None
earned	பெற்றுத்	None
obtained	பெற்றுள்ளனர்	None
dont talk	பேசாதே	None
glory	பெருமை	None
brain	மூளை	None
perumal	பெருமாள்	None
namely	பெயர்க்	None
pempheridae a fish family	பெம்ஃபெரைடீ	None
benzyl	பென்சைல்	None
ben	பென்	None
feminism	பெண்ணியம்	None
female	பெண்ணின்	None
for women	பெண்களுக்கு	None
in the name of	பெயரால்	None
women	மகளிர்	None
girl	பொண்ணு	None
petroleum	பெட்ரோலியம்	None
in the box	பெட்டியில்	None
federal	பெடரல்	None
it is a name of bangalore city	பெங்களூரில்	None
bangalore	பெங்களூரு	None
native	பூர்வீக	None
ladies	பெண்களின்	None
imperialism	பேரரசுவாதம்	None
name	பெயர்	None
grammer	வெண்டளை	None
maximum	பெருமளவில்	None
greatwall	பெருஞ்சுவர்	None
large intestine	பெருங்குடல்	None
oceans	பெருங்கடல்களின்	None
of ocean	பெருங்கடலின்	None
big one	பெருங்	None
growing	வளர்ந்தார்	None
in the name	பெயரில்	None
peru	பெரு	None
a tamil freedom fighter or reformer periyar	பெரியாரின்	None
biggest	பெரியது	None
large	பெருமளவு	None
periyakulama ,place in madurai district	பெரியகுளம்	None
bigger	பெரிதாக	None
heavier	பெய்யும்	None
names	பெயர்கள்	None
periyar	பெரியார்	None
with rights	பூர்வமாக	None
disaster	பேரழிவு	None
conference	மாநாட்டில்	None
put	போட்டுக்	None
contest	போட்டியில்	None
participating	போட்டியிட்ட	None
competitions	போட்டிகள்	None
competition	போட்டியை	None
course	போக்கை	None
transport	போக்குவரத்துக்	None
transports	போக்குவரத்து	None
a way	போக்கு	None
poker	போகர்	None
to go	போக	None
polynesia	பொலினீசியா	None
poraiyan	பொறையன்	None
responsibility	பொறுப்பை	None
depending on the	பொறுத்து	None
preacher	போதகர்	None
slogan	போதனை	None
bodhisattva	போதிசத்துவர்	None
enough	போதும்	None
poland	போலந்து	None
pollack	போலக்	None
pray	போற்றி	None
port-au-prince	போர்ட்-ஓ-பிரின்ஸ்	None
portukese	போர்ச்சுகீசிய	None
in wars	போர்களில்	None
war	யுத்தத்தை	None
for the	பொறுத்தவரை	None
for war	போருக்கான	None
wars	போர்கள்	None
by war	போரினால்	None
fighters	போராளிகள்	None
war man	போராளி	None
struggle	போராட்டம்	None
gone up	போனது	None
porttukiciyar	போத்துக்கீசர்	None
in the war	யுத்தத்தில்	None
engineer	பொறியாளர்	None
mechanics	பொறிமுறை	None
fried	பொறித்த	None
civilians	பொதுமக்களும்	None
comon	பொதுப்	None
packet	பொதி	None
wife	மனைவியும்	None
pongal celebration in tamil nadu	பொங்கல்	None
bairam	பைராம்	None
guy	பையன்	None
the general publics	பொதுமக்கள்	None
paise of indian currency	பைசா	None
baseball	பேஸ்பால்	None
face	முகம்	None
buses	பேருந்துகள்	None
bus	பேருந்து	None
barium	பேரியம்	None
genus	பேரினம்	None
professor	பேராசிரியர்	None
bag	பை	None
disasters	பேரழிவுகள்	None
generally	பொதுவாகக்	None
communism	பொதுவுடைமை	None
engines	பொறிகள்	None
engine	பொறி	None
economists	பொருளியலாளர்கள்	None
economy	பொருளாதாரத்தை	None
economics	பொருளியல்	None
of the economy	பொருளாதாரத்தின்	None
economic	பொருளாதாரப்	None
commonly	பொதுவாகப்	None
object	பொருளின்	None
masses	பொருண்மைகள்	None
in order	பொருட்டு	None
objects	பொருள்களை	None
toy	பொம்மை	None
ponniyin	பொன்னியின்	None
bonsai	பொன்சாய்	None
button	பொத்தான்	None
fit	பொருந்தும்	None
charge	பூர்வ	None
to complete	பூர்த்தி	None
burdo	பூர்டோ	None
priam	பிரையம்	None
brazil	பிரேசில்	None
french	பிரெஞ்சுப்	None
priacanthidae	பிரியாகந்தைடீ	None
pretoria	பிரிட்டோரியா	None
britian	பிரித்தானியாவின்	None
britain	பிரித்தானியாவும்	None
divide	பிரித்து	None
seperates	பிரிக்கிறது	None
separated	பிரிந்து	None
divided	வகுத்தது	None
to seperate	பிரிக்க	None
broids	பிராய்டின்	None
a kind of fish	பிராமைடீ	None
brahmi	பிராமி	None
birth	பிறப்பு	None
born	பிறந்து	None
births	பிறப்புக்கள்	None
for others	பிறருக்கு	None
praise	புகழ்ந்து	None
beetroot	பீட்ரூட்	None
beta	பீட்டா	None
bihar	பீகார்	None
feces	மலம்	None
errors	பிழையை	None
pillaiyar	பிள்ளையார்	None
brahmins	பிராமணர்	None
pillai	பிள்ளை	None
rift	பிளவு	None
flimfare	பிலிம்பேர்	None
philip	பிலிப்	None
pilate	பிலாத்து	None
late	மறைந்த	None
the crescent	பிறை	None
misrespentation	பிறள்பகர்வு	None
flight	விமானம்	None
brahmin	பிராமண	None
francisco	பிரான்சிஸ்கோ	None
francis	பிரான்சிஸ்	None
copy	பிரதி	None
main	முதன்மைக்	None
prime ministerial	பிரதமரின்	None
as a prime minister	பிரதமராக	None
prime	பிரதமர்கள்	None
issue	பிரச்சினை	None
campaign	பிரச்சாரம்	None
representatives	பிரதிநிதிகள்	None
popular	புகழ்பெற்ற	None
february	பெப்ரவரி	None
bbc	பிபிசி	None
follows	பின்வருமாறு	None
binland	பின்லாந்து	None
followers	பின்பற்றுவோர்	None
follow	பின்பற்றும்	None
follower	பின்பற்றி	None
prasad	பிரசாத்	None
smoke	புகை	None
represent	பிரதிநிதித்துவம்	None
province	மாநிலமும்	None
france	பிரான்ஸ்	None
name of a city	பிரான்க்சு	None
regional	வட்டார	None
frank	பிராங்க்	None
tremendous	பிரம்மாண்டமான	None
brahma	பிரம்மா	None
pyramid	பிரமிட்டு	None
reflections	பிரதிபலிக்கும்	None
prabhu	பிரபு	None
prabakaran's	பிரபாகரனின்	None
exclusively	பிரத்தியேகமாக	None
exclusive	பிரத்தியேக	None
pradesh or regional	பிரதேசம்	None
area of the	பிரதேசத்தின்	None
territories	பிரதேசங்களும்	None
in areas	பிரதேசங்களில்	None
prabakaran	பிரபாகரன்	None
photography	புகைப்படம்	None
photographs	புகைப்படங்கள்	None
tobaco	புகையிலை	None
of geography	புவியியலின்	None
geographic	புவியியற்	None
earth's	புவியின்	None
world status	புவியமைப்பு	None
worms	புழுக்கள்	None
public	பொதுமக்களுக்கு	None
figures	புள்ளிவிவரங்கள்	None
in the earth	புவியில்	None
point	புள்ளி	None
pluto	புளூட்டோ	None
bluetooth	புளுடூத்	None
lawn	புல்வெளி	None
grass	புல்	None
to migrate	புலம்பெயர்ந்த	None
proficiency	புலமை	None
visible	புலப்படும்	None
florida	புளோரிடா	None
sense	புலன்	None
bush	புஷ்	None
relating to geography	பூகோள	None
centipede	பூரான்	None
a naksatra in tamil horoscope	பூரட்டாதி	None
from the earth	பூமியிலிருந்து	None
down to earth	பூமிக்கு	None
puppeytiya	பூப்பெய்திய	None
cat	பூனை	None
bhutan	பூட்டான்	None
flower	மலர்களின்	None
fungi	பூஞ்சை	None
pucciyunni	பூச்சியுண்ணி	None
pesticide	பூச்சிக்கொல்லிகள்	None
insects	பூச்சிகள்	None
pooja	பூசை	None
parks	பூங்காக்கள்	None
flowering	பூக்கும்	None
flowers	மலர்கள்	None
ritual	பூஜை	None
than/compare	போலும்	None
malignant	வீரிய	None
like dna	புற்றணுக்கள்	None
storm	புயல்	None
smile	புன்னகை	None
sacred	புனிதமான	None
renovated pucam	புனர்பூசம்	None
revitalization	புத்துயிர்	None
buthar	புத்தர்	None
buddhism	பௌத்தம்	None
cyclones	புயல்கள்	None
in the book	புத்தகத்தில்	None
underground mud	புதைசேற்று	None
puducherry	புதுச்சேரி	None
pudukkottai	புதுக்கோட்டை	None
discussion	புதினம்	None
newly	புதிதாக	None
mercury	புதன்	None
torous	புடைப்புச்	None
buddhist	பௌத்த	None
for cancer	புற்றுநோய்க்கான	None
revolutionary	புரட்சிகரமான	None
use net	புரவன்	None
proxy	புறொக்ஸி	None
pigeon	புறா	None
outer activities	புறப்பொருள்	None
leaving	விலகிச்	None
purananuru	புறநானூறு	None
bye pass	புறநகர்	None
cortex	புறணி	None
protein	புரதம்	None
ultra violet	புறஊதா	None
promethium	புரோமித்தியம்	None
propylene	புரோப்பிலீன்	None
to understand	விளங்கிக்	None
understand	புரிந்து	None
having done	புரிந்தார்	None
myth	புராணம்	None
mythical	புராண	None
outer	வெளி	None
controversion	முரண்பாடான	None
bose	போஸ்	None
blues	ப்ளூஸ்	None
electromagnetic	மின்காந்த	None
temperate	வெப்பமான	None
floating	மிதக்கும்	None
mexican	மிச்சிகன்	None
ming	மிங்	None
in excess	மிகையான	None
in excess of	மிகையாக	None
extra	மிகை	None
abundance	மிகுதியான	None
excess	மிகுதி	None
very big	மிகப்பெரிய	None
oldest	மிகப்பழைய	None
mostly	மிகத்	None
smallest	மிகச்சிறிய	None
stagae	மிகக்குறைந்த	None
electromagnetism	மின்காந்தவியல்	None
electric	மின்சார	None
electricity	மின்சாரம்	None
email	மின்னஞ்சல்	None
ichthyology	மீனியல்	None
meenakshi amman a hindu goddess	மீனாட்சியம்மன்	None
meenatchi	மீனாட்சி	None
remaining	மீதம்	None
the remaining	மீதமுள்ள	None
meters	மீட்டர்கள்	None
recover	மீண்டு	None
brave	வீர	None
i am	மீ	None
mission	மிஷன்	None
electrochemistry	மின்வேதியியல்	None
charged particles	மின்மம்	None
electrostatic	மின்னியல்	None
voltage	மின்னழுத்தம்	None
electronic	மின்னணு	None
emails	மின்னஞ்சல்கள்	None
missionaries for charities	மிஷினரீஸ்	None
cellulose	மாவியம்	None
in district	மாவட்டத்திலுள்ள	None
districts	மாவட்டங்கள்	None
mars	மார்ஸ்	None
chest	மார்பு	None
bust	மார்பளவு	None
breast	மார்பகப்	None
martin	மார்ட்டின்	None
marks	மார்க்ஸ்	None
marxist	மார்க்சிய	None
without changes	மாறாத	None
marx	மார்க்சு	None
temparatures	மாரி	None
maya	மாயா	None
writing, mathematics, astronomy	மாயன்	None
mamba	மாம்பா	None
mango	மாம்பழம்	None
uncle	மாமா	None
mamallapuram	மாமல்லபுரம்	None
it's a one of the name of female god in india	மாரியம்மன்	None
fishes	மீன்கள்	None
varied	மாறான	None
change	மாற்று	None
county	மாவட்ட	None
mall	மால்	None
in evening	மாலையில்	None
maldives	மாலைதீவுகளின்	None
molybdenum	மாலிப்டினம்	None
convert	மாற்றும்	None
replaced	மாற்றப்பட்டு	None
variable	மாறி	None
change over	மாற்றத்தை	None
variation	மாறுபாடு	None
vary	வேறுபடும்	None
varies	மாறுபடுகிறது	None
changes	மாற்றத்தின்	None
changing	மாற்றுவது	None
constant	மாறிலி	None
changed	மாற்றினார்	None
differences	வேறுபாடுகள்	None
groom	மாப்பிள்ளை	None
hypertext	மீயுரை	None
violation	மீறிய	None
corners	முனைகளில்	None
corner	விளிம்பில்	None
muni	முனி	None
cashew	முந்திரி	None
previous	முன்பிருந்த	None
muthukamalam	முத்துக்கமலம்	None
muthu	முத்து	None
emblem	முத்திரை	None
vertebrates	முதுகெலும்பிகள்	None
chordate	முதுகுநாணி	None
grown up	முதிர்ந்த	None
investment	முதலீடு	None
first place	முதலிடத்தில்	None
bosses	முதலாளிகள்	None
chief ministers	முதலமைச்சர்கள்	None
dr	முனைவர்	None
before	முன்பு	None
front	முன்னும்	None
earlier	முற்பட்ட	None
rubadub	முரசொலி	None
in an attempt to	முயற்சியாக	None
efforts	முயற்சியில்	None
try	முயற்சி	None
mummudi chola , a tamil king	மும்முடிச்	None
mumbai	மும்பையின்	None
thirty	முப்பது	None
chief minister	முதல்வர்	None
pioneer	முன்னோடியாக	None
progressive	முற்போக்குக்	None
progress	முன்னேற்றம்	None
to develop	வளர்க்கும்	None
in front	முன்னே	None
priority	முன்னுரிமை	None
infront of others	முன்னிலையில்	None
before that	முன்னரே	None
improvements	முன்னேற்றங்கள்	None
the poeter's those who are get together among themselves on 1st century. they introduce ours new poets	முதற்சங்கம்	None
primarily	முதன்மையாக	None
first time	முதலாக	None
importantly	முக்கியமாக	None
importance	முக்கியத்துவம்	None
significance	முக்கியத்துவத்தை	None
clouds	முகில்	None
addresses	முகவரிகள்	None
addreses	முகவரிகளின்	None
address	முகவரியின்	None
three comunity	முக்குலத்தோர்	None
mughal	மொகலாய	None
mohammad	முஹம்மது	None
home page	முகப்பு	None
facial	முக	None
m is the initial	மு	None
come out	மீள்	None
cycling process	மீளுருவாக்கம்	None
restore	மீள	None
having a way	முகமாக	None
meera	மீரா	None
triangular	முக்கோண	None
liberation	விடுதலைப்	None
first	முதல்	None
acceleration	முடுக்கம்	None
decision	முடிவை	None
ended	முடிவுற்றது	None
to end	முடிவுக்கு	None
results	முடிவுகள்	None
result	விளை	None
triangle	முக்கோணம்	None
at the end	முடிவில்	None
finally	முடிவான	None
unable	முடியாமல்	None
complete	முழுமையான	None
finished	முடித்து	None
finishing	முடித்த	None
knot	முடிச்சு	None
completed	முடிவடைந்து	None
conclusion	முடிவிற்கு	None
deer	மான்	None
subsidies	மானியங்கள்	None
anthropology	மானிடவியல்	None
in madurai	மதுரையில்	None
madurai	மதுரையை	None
liquor	மது	None
autism	மதியிறுக்கம்	None
lunch	மதிய	None
values	மதிப்புகள்	None
respect	மரியாதை	None
valuation	மதிப்பீட்டு	None
rating	மதிப்பீடுகள்	None
estimation	மதிப்பீடு	None
in the religion	மதத்தில்	None
secular	மதச்சார்பற்ற	None
pedology	மண்ணியல்	None
skull	மண்டை	None
mandela bridge	மண்டேலா	None
mediterranean	மத்தியதரைக்	None
centrally	மத்தியப்	None
among	மத்தியில்	None
mathew	மத்தேயு	None
psychological	மனோதத்துவ	None
wife's	மனைவியின்	None
wives	மனைவிகள்	None
men	மென்	None
human beings	மனிதர்களுக்கும்	None
among the humans	மனிதர்களில்	None
humans	மனிதர்களும்	None
zone	வலயம்	None
by the human	மனிதர்களால்	None
in human	மனிதரில்	None
of human	மனிதனின்	None
humanly	மானிட	None
human	மானிடப்	None
mind	மனோ	None
in mind	மனதில்	None
magic	மாய	None
for the humans	மனிதருக்கு	None
regional wise	மண்டலங்களுக்கு	None
soil	மண்ணை	None
manimekalai a tamil girl name	மணிமேகலை	None
density of population	மக்களடர்த்தி	None
mahindan	மகிந்தன்	None
mahavamsam	மகாவம்சம்	None
mahal	மஹால்	None
mahalakshmi	மகாலட்சுமி	None
maharastra	மகாராட்டிரம்	None
mahabharat	மகாபாரதம்	None
lok sabha election	மக்களவைத்	None
magabaratham	மகாபாரதத்தின்	None
mahadevan	மகாதேவன்	None
daughter	மகள்	None
makarantakkavi	மகரந்தக்காவி	None
pollen	மகரந்தம்	None
magam	மகம்	None
sons	மகன்கள்	None
son	மகன்	None
mahatma gandhi	மகாத்மா	None
by the king	மன்னனாக	None
democracy	மக்களாட்சி	None
for the people	மனிதர்களுக்கு	None
minits	மணித்துளி	None
sand	மணல்	None
sandstone	மணற்கல்	None
lavender	மணம்	None
not only	மட்டுமில்லாமல்	None
at the level of	மட்டத்தில்	None
above	மட்டத்திலிருந்து	None
in people	மக்களில்	None
mattakillappu a town in sri lanka	மட்டக்களப்பு	None
machu	மச்சு	None
sanitory	மங்கல	None
makalu	மக்காலு	None
maize	மக்காச்சோளம்	None
population control	மக்கள்தொகையின்	None
people's	மக்களுடைய	None
with people	மக்களுடன்	None
turmeric	மஞ்சள்	None
monarch	மன்னராட்சி	None
manna	மன்னா	None
mannar bay	மன்னார்	None
mavori	மவோரி	None
mount	மவுண்ட்	None
by rain	மழையால்	None
rain	மழை	None
malayalam film industry	மலையாள	None
malayaman a king	மலையமான்	None
in the mountain	மலைகளில்	None
a sections of people	மா	None
mountains	மலைப்	None
malaria	மலேரியா	None
malaysia	மலேசியா	None
malay	மலாய்	None
malacca	மலாக்கா	None
malabar	மலபார்	None
excavating	மறைவு	None
suspence keep	மறையீட்டியல்	None
mountain	மலையில்	None
indirect	மறைமுகமாக	None
mafia	மாஃப்பியா	None
student	மாணவர்கள்	None
in the state	மாநிலத்தில்	None
metropolitan	மாநகரப்	None
tablets	மாத்திரைகள்	None
model	மாதிரியானது	None
samples	மாதிரியை	None
mensus	மாதவிலக்கு	None
madhavi a tamil girl name	மாதவியின்	None
pollution	மாசு	None
menopause	மாதவிடாய்	None
in the month	மாதத்தில்	None
of the month	மாதத்தின்	None
months	மாதங்கள்	None
monthly	மாதப்	None
mandarin	மாண்டரின்	None
gem	மாணிக்கம்	None
in students	மாணவர்களின்	None
month	மாதம்	None
full moon	பௌர்ணமி	None
hidden	மறைந்து	None
objection	மறுப்பு	None
referred to king	மரமது	None
genealogy	மரபுவழி	None
traditions	மரபுகள்	None
sectarians	மரபில்	None
genetics	மரபியல்	None
ancestral line	மரபின்	None
genes	மரபணுக்கள்	None
marati	மராத்தி	None
gene	மரபணு	None
tree	மரத்தின்	None
trees	மரங்கள்	None
vegetable	மரக்கறிகள்	None
wood	மரம்	None
peacock	மயில்	None
forum	மன்றத்தில்	None
manmohan	மன்மோகன்	None
genome	மரபகராதி	None
conceal	மறை	None
marantaciye	மராந்தாசியே	None
marudhan	மருதம்	None
again	மீண்டும்	None
refused	மறுத்து	None
denied	மறுத்தார்	None
renaissance	மறுமலர்ச்சி	None
rejected	மறுக்கப்பட்ட	None
rework	மறு	None
maravar	மறவர்	None
maria	மரியா	None
marulumattai	மருளூமத்தை	None
medicines	மருந்துகள்	None
doctors	மருத்துவர்கள்	None
hospitals	மருத்துவமனைகள்	None
hospital	மருத்துவமனையில்	None
medicine	மருந்து	None
medical	வைத்திய	None
maruthur a place	மருதூர்	None
daughter in law	மருமகள்	None
hong kong	ஹொங்கொங்	None
processor	செயலி	None
activities	செயல்பாடுகள்	None
train	ரயில்	None
blood	குருதி	None
chariot	இரதம்	None
chariots	இரதங்கள்	None
both	இவ்விரு	None
second	பயன்படுத்தப்பட்ட	None
secondly	இரண்டாவதாக	None
two thousand	இரண்டாயிரம்	None
two	இரண்டு	None
in two	இரண்டாக	None
dual	இரட்டை	None
russia	ரஷ்யா	None
varieties	வகைகளிலும்	None
jesus	இயேசுவை	None
nature	தன்மையைக்	None
to night	இரவில்	None
night	இரவு	None
r , a title	இரா	None
rhythm	இராகங்கள்	None
ramanujan	இராமானுஜன்	None
ramanathapuram	இராமநாதபுரம்	None
ramachandran	இராமச்சந்திரன்	None
rama	இராமர்	None
radha	ராதாவின்	None
army	ராணுவத்தின்	None
military	ராணுவம்	None
characteristics	சிறப்பியல்புகள்	None
rajendiran a chola king	இராஜேந்திரனின்	None
in iratciyat	இராச்சியத்தில்	None
kingdom	இராச்சியம்	None
rajendra	ராஜேந்திர	None
zodiac	இராசிச்	None
rajaraja	இராஜராஜன்	None
iraq	ஈராக்	None
raaga or music	ராகம்	None
raja kesari	இராஜகேசரி	None
properties	பண்புகள்	None
normal	சாதாரண	None
can	விடலாம்	None
operating	இயங்கு	None
functioning	இயங்கி	None
run	இயங்க	None
directing	இயக்கும்	None
director	இயக்குனர்	None
to direct	இயக்கு	None
directed	இயக்கிய	None
operate	இயங்குகின்றன	None
driver	இயக்கி	None
operated	இயக்கப்படும்	None
operations	நடவடிக்கைகள்	None
direction	திசையில்	None
motion	இயக்கத்தை	None
organisations	இயக்கங்கள்	None
in the way	இம்முறையில்	None
in this type of	இம்முறையின்	None
animation	இயக்கமூட்டல்	None
ramayanam	இராமாயணம்	None
running	விளங்கி	None
platform	பீடம்	None
wikidpedia section	இயலில்	None
can not	முடியாது	None
impossible	இயலாத	None
writer	எழுத்தாளர்	None
written	எழுதப்பட்டது	None
actual name	இயற்பெயர்	None
physics	இயற்பியல்	None
source code	இயங்குதளங்களில்	None
in nature	தன்மையில்	None
naturally	இயல்பாக	None
natural	இயல்பான	None
algebra	இயற்கணிதம்	None
statistics	புள்ளிவிவரம்	None
machine	இயந்திரம்	None
machines	கருவிகள்	None
machinery	இயந்திர	None
natures	தன்மையும்	None
in this period	இம்முறை	None
ravanan	இராவணன்	None
stay	தங்கி	None
literatures	இலக்கியங்கள்	None
in literature	இலக்கியங்களில்	None
literature	புதினங்கள்	None
easily	ஏதுவாக	None
grammar	இலக்கணம்	None
easy	எளிதான	None
because of god	இறைவனால்	None
theology	விவிலியம்	None
one of the name	இறையனார்	None
athiesm	இறைமறுப்பு	None
against the religious	இறைமறுப்பாளர்கள்	None
meat	இறைச்சி	None
end	மண்முனை	None
final	இறுதித்	None
last	கடைசியில்	None
a target	இலக்கு	None
goals	இலக்குகள்	None
lanka	இலங்கை	None
sri lanka	இலங்கையை	None
no	இல்லை	None
absence	இல்லாததால்	None
wish	இல்லாத	None
home	ஹோம்	None
autumn	இலையுதிர்	None
leaves	இலைகள்	None
leaf	இலை	None
tight	இறுக்கமான	None
illinois state in usa	இலினொய்	None
latin	லத்தீன்	None
electronics	மின்னணுவியல்	None
london	லண்டன்	None
in london	லண்டனில்	None
million	லட்சம்	None
sirlanka	இலங்கையில்	None
sri lankan	இலங்கைத்	None
free	தளையறு	None
deaths	இறப்புக்கள்	None
death	மறைவுக்குப்	None
died	இறந்தான்	None
may have had	இருந்திருக்கலாம்	None
have	விட்டார்கள்	None
chance	சந்தர்ப்பங்களில்	None
were	பட்டனர்	None
and even	இருந்தபோதும்	None
despite the	இருந்தபோதிலும்	None
there were	வந்தன	None
has been	வந்திருக்கிறது	None
since the	என்பதால்	None
presence	இருப்பை	None
having	விட்ட	None
not having	இருக்காது	None
should	வேண்டும்	None
may	வைகாசி	None
will be	இருக்கும்	None
possible	சாத்தியமுள்ள	None
available at	இருந்ததற்கான	None
iridium	இரிடியம்	None
twentieth	இருபதாம்	None
bisexual	இருபால்	None
dead	இறந்து	None
import	இறக்குமதி	None
die	டை	None
prey	இரையை	None
bait	தூண்டி	None
irular	இருளர்	None
irumporai	இரும்பொறை	None
twenty	இருபத்தி	None
iron	இரும்பு	None
cough	இருமல்	None
stock	பங்கை	None
if the	கொண்டால்	None
incase	இருப்பினும்	None
available	கிடைக்கும்	None
being	வைக்கும்	None
both sides	இருபுறமும்	None
twice	இருமுறை	None
district	மாவட்டம்	None
this king	இம்மன்னன்	None
himalayas	இமயம்	None
in between gaps	இடைவெளியில்	None
in between gap	இடைவெளி	None
disturb	இடையூறு	None
in between	இடையிடையே	None
cowherd	இடையர்	None
medium	நடுத்தர	None
center	மையம்	None
median	இடைநிலையளவு	None
secondary	இடைநிலை	None
interim	இடைக்கால	None
inter	இடையேயான	None
between	இடையே	None
itayccu	இடாய்ச்சு	None
risk	இடர்	None
found place	இடம்பெற்றது	None
lead	வகித்து	None
hitler	இட்லர்	None
idly	இட்லி	None
comply	இணங்கி	None
web	வலையின்	None
website	வெப்	None
links	இணைப்புகள்	None
connections	இணைப்புத்	None
link	இணைப்பை	None
merge	இணைந்தது	None
combined	கூட்டு	None
featuring	இடம்பெறும்	None
annex	இணைத்துக்	None
that connects	இணைக்கும்	None
combine	இணைக்கின்றன	None
connected	இணைக்கப்பட்டது	None
joined	சேர்ந்தார்	None
connect	இணைக்க	None
parallelogram	இணைகரம்	None
joint	கூட்டுப்	None
in conjunction	இணைத்து	None
in the place	இடமும்	None
from	விலிருந்து	None
as	கொண்டதாக	None
here also	இங்கும்	None
england	இங்கிலாந்து	None
in england	இங்கிலாந்தில்	None
from here	இங்கிருந்து	None
igloo	இக்லூ	None
this temple	இக்கோயில்	None
this flag	இக்கொடி	None
here	இங்கேயே	None
now a days	இக்காலப்பகுதியில்	None
in this era	இக்காலகட்டத்தில்	None
sculpture	சிற்பம்	None
this sea	இக்கடலின்	None
e	ம்	None
in australia	ஆஸ்திரேலியாவில்	None
of australia	ஆஸ்திரேலியாவின்	None
australian	ஆஸ்திரேலிய	None
nowadays	தற்காலத்தில்	None
internet	வலையில்	None
sparidae a fish family name	இசுப்பாரைடீ	None
muslim	முஸ்லிம்	None
transformation	உருமாற்றம்	None
place	வைக்க	None
from that place	காலத்திலிருந்து	None
left	இடதுசாரி	None
to places	இடங்களுக்கு	None
locations	இடங்களும்	None
everywhere	எங்கும்	None
israel	இஸ்ரேல்	None
places	தலங்கள்	None
the word	வார்த்தையானது	None
lust	காமம்	None
this service	இச்சேவை	None
music director	இசையமைப்பாளர்	None
composed	உருவாக்குகின்றது	None
music	ரமண	None
islam	இஸ்லாம்	None
locations and	இடங்களாகவும்	None
in internet	இணையத்தளத்தில்	None
on the internet	இணையத்தில்	None
same	இணையான	None
inter war	இனப்பிரச்சினை	None
race	வருக்கம்	None
community	சமூகம்	None
species	வகைகளை	None
a community	இனக்	None
caste	ஜாதி	None
disease	நோய்த்	None
reproduction	இனப்பெருக்கம்	None
book	வேதம்	None
this situation	இந்நிலையில்	None
this company	இந்நிறுவனம்	None
fund	இந்நிதி	None
event	நிகழ்வை	None
this country	இந்நாட்டில்	None
city	மூலமான	None
in the city	நகரில்	None
in this book	இந்நூலில்	None
this city	இம்மாவட்டத்தின்	None
insulin	இன்சுலின்	None
still	இன்னும்	None
in this war	சண்டையில்	None
current	மின்னோட்டம்	None
now	தற்பொழுது	None
named	பெயரிட்டார்	None
this region	இப்பிரதேசம்	None
these	இவையும்	None
like this	இப்படிப்பட்ட	None
etc.	முதலியவை	None
this movie	இப்படம்	None
in the region	பிராந்தியத்தில்	None
till today	இன்றுவரை	None
now also	இன்றும்	None
today	இன்றைய	None
without	செய்யாமல்	None
till date	இன்றளவும்	None
another	மற்றோர்	None
this part	இப்பகுதியை	None
youth	இளைஞர்கள்	None
the city	இந்நகரம்	None
indo european	இந்தோஐரோப்பிய	None
apart from	இதைத்தவிர	None
upto now	இதுவரை	None
from this	இதிலிருந்து	None
serials	இதழ்கள்	None
magazine	இதழ்	None
journals	பத்திரிகைகள்	None
in-between	இதற்கிடையில்	None
and this	இதையும்	None
for this	இதற்காக	None
in heart	இதயத்தில்	None
heart	மனதை	None
as per	ரீதியாக	None
this	இதைப்	None
join with	இதனுடன்	None
indium	இண்டியம்	None
joining	இணையும்	None
other	வேறுபல	None
indonesia	இந்தோனேசியா	None
italy	இத்தாலியும்	None
this plan	இத்திட்டம்	None
hindustani	இந்துஸ்தானி	None
hindus	ஹிந்துக்கள்	None
hindu	ஹிந்து	None
indra	இந்திரன்	None
indira	இந்திரா	None
in hindi	இந்தியில்	None
in india	இந்தியாவில்	None
italian	இத்தாலியன்	None
from india	இந்தியாவிலிருந்து	None
india	இந்தியாவை	None
indians	இந்தியர்கள்	None
indian	இந்தியர்	None
hindi	இந்தி	None
internet protocol	ஐபி	None
department	துறையில்	None
with this	இத்துடன்	None
india's	இந்தியாவின்	None
austria	ஆஸ்திரியா	None
young age	இளமைக்காலம்	None
prince	இளவரசன்	None
action	நடவடிக்கையும்	None
working	வேலை	None
adductor	உள்வாங்கி	None
local	உள்ளூர்	None
input	உள்ளீடு	None
configuration	கட்டமைப்பு	None
what	எவை	None
be	உள்ளதாக	None
index	சுட்டு	None
content	உள்ளடக்கம்	None
homeland	தாயகம்	None
domestic	உள்நாட்டுக்	None
interpution	உள்கட்டமைப்பு	None
internal	உள்ளார்ந்த	None
psychology	உளவியல்	None
f	ஊ	None
encourage	ஊக்கம்	None
stimulants	ஊக்கிகள்	None
injection	ஊசி	None
eg. (example)	எகா	None
workers	தொழிலாளர்கள்	None
corruption	ஊழல்	None
fountain	நீர்த்தாரைகள்	None
reptiles	ஊர்வன	None
towns	நகரங்கள்	None
in towns	ஊர்களின்	None
physcology	உளவியலில்	None
town	ஊருக்கு	None
blue	நீலான்	None
interfer	ஊடுருவல்	None
through	வாயிலாக	None
journalism	ஊடகவியல்	None
in media	ஊடகத்தில்	None
a way of	ஊடகத்தின்	None
media	மீடியா	None
a place or village	ஊரு	None
psychiatry	மனநல	None
psychologist	உளவியலாளர்கள்	None
exist	உளர்	None
confimred	உறுதியாக	None
conform	நிர்ணயம்	None
confirmation	உறுதி	None
relation	உறவுகள்	None
relations	சார்பியல்	None
relationship	தொடர்பை	None
roman	ரோமானிய	None
member	பிரதிநிதியாக	None
conversations	உரையாடல்கள்	None
prose	நடை	None
text	உரை	None
becomes	உருவெடுத்து	None
driven	உருவெடுத்தது	None
came into existence	உருவாயின	None
production	விளைச்சல்	None
forming	உருவாக்கும்	None
conversation	உரையாடல்	None
egypt	எகிப்து	None
members	நபர்கள்	None
organs	உறுப்புக்கள்	None
metallurgical	உலோகவியல்	None
metals	உலோகங்கள்	None
metal	உலோக	None
internets	உலாவியானது	None
sevagar	உலாவிகள்	None
dry	உலர்	None
in this world	உலகில்	None
elements	தனிமங்கள்	None
worldwide	தழுவிய	None
worldwar	உலகப்போரின்	None
prepare	உற்பத்தித்	None
manufacturing	தயாரிப்பு	None
festival	விழாக்கள்	None
uriyoor	உறையூர்	None
freezing	உறைபனி	None
case	வழக்கும்	None
globalization	உலகமயமாதல்	None
creator	படைத்த	None
egyptian	எகிப்திய	None
windows xp	எக்ஸ்பி	None
my	மை	None
me	என்னை	None
any	ஏதேனும்	None
ethane	எத்தேன்	None
how many	எத்தனை	None
anything	எதையும்	None
electron	எதிர்மின்னி	None
opposite	முரணாக	None
anti	எதிர்ப்புப்	None
resistance	எதிர்ப்பாற்றல்	None
heterosexuality	எதிர்பால்சேர்க்கை	None
unexpected	எதிர்பாராத	None
opposed	எதிர்ப்புத்	None
opposing	எதிர்க்கும்	None
to oppose	எதிர்க்க	None
in my	எனில்	None
they said	என்கின்றனர்	None
saying	கூறுகிறார்	None
according to that	படி	None
how	விதம்	None
f is a letter fiwf	எப்	None
hebrew	எபிரேய	None
ephemeris	எபிமெரிஸ்	None
macros	என்றவாறு	None
said	தெரிவித்துள்ளார்	None
such as	என்போர்	None
futurology	எதிர்காலவியல்	None
call so	என்பார்	None
whether	என்றெல்லாம்	None
in the	வரையில்	None
means	வகையிலும்	None
is believed	என்பதாக	None
at	மணிக்கு	None
engineering	பொறியியல்	None
encyclopedia	கலைக்களஞ்சியங்கள்	None
respectful	என்பவரின்	None
in future	எதிர்காலத்தில்	None
future	வருங்கால	None
enemies	எதிரிகள்	None
will take	எடுக்கும்	None
taken from	எடுக்கப்படும்	None
edit	எடிட்	None
edison	எடிசன்	None
expected	எதிர்பார்க்கப்படுகிறது	None
warning	எச்சரிக்கை	None
leavings	எச்சம்	None
taking	வளர்த்தனர்	None
hiv	எச்ஐவி	None
spain	ஸ்பெயின்	None
spanish	ஸ்பானிய	None
ester	எசுத்தர்	None
our	நம்ம	None
where	எங்கே	None
explolar	எக்ஸ்புளோளர்	None
express	வெளிப்படுத்தும்	None
html	எச்டிஎம்எல்	None
x	எக்ஸ்	None
weight	எடை	None
eight	எட்டு	None
against	எதிர்த்துப்	None
oil	எண்ணெய்	None
count	எண்ணிக்கையை	None
to count	எண்ணி	None
many	பலவும்	None
thought	நினைத்த	None
with the intention	எண்ணத்தில்	None
eighth	எட்டாவது	None
thoughts	சிந்தனைகள்	None
in numbers	எண்களில்	None
numbers	எண்கள்	None
arithmetic	எண்கணிதம்	None
arithmetical	எண்கணித	None
number	எண்ணை	None
edward	எட்வர்டு	None
ettuthokai	எட்டுத்தொகை	None
nt	எண்டி	None
developed	வளர்ந்த	None
created	உருவாக்கியது	None
creating	உருவாக்குவது	None
broken	வெடிப்பு	None
style	பாணி	None
stars	நட்சத்திரங்கள்	None
intercourse	புணர்ச்சி	None
for body	உடலுக்கு	None
body	உடல்	None
utarriran	உடற்றிறன்	None
exercise	உடற்பயிற்சி	None
physical	பௌதீக	None
in body	உடலின்	None
agreement	ஒப்புதல்	None
immediately	உடனே	None
instant	உடனடி	None
peek	பீக்	None
pronounce	உச்சரிப்பு	None
once property	உடையதாகும்	None
all rights reserved	உடையது	None
people	வந்தவர்கள்	None
udayar a community	உடையார்	None
food	வடை	None
feed	ஊட்டி	None
restaurants	உணவகங்கள்	None
impressionism	உணர்வுப்பதிவுவாதம்	None
feelings	உணர்வுகள்	None
feeling	உணர்வை	None
understood	விளங்கிய	None
peak	உச்ச	None
felt	உணர்ந்தார்	None
sensation	உணர்ச்சி	None
aware	உணரும்	None
realised	உணரப்பட்டது	None
feel	உணர	None
subdivisions	உட்பிரிவுகள்	None
injector	உட்செலுத்தி	None
intake	உட்கொள்ளும்	None
show	நிகழ்ச்சியின்	None
references	மேற்கோள்கள்	None
your	உம்	None
reasanable	உகந்ததாக	None
all this	இவையனைத்தும்	None
these things	இவைகளை	None
for these	இவைகளுக்கு	None
because of this	இவற்றால்	None
in these	இவைகளில்	None
for them	இவருக்கு	None
by this	இவன்	None
this way	இவ்வகையில்	None
this person	இவரே	None
to destruct	இழிவு	None
very badly	இழிவான	None
loss	இழப்பு	None
losing	இழந்து	None
lost	தொலைந்து	None
ilaiyaraajaa	இளையராஜா	None
younger	இளைய	None
bunchy	இழை	None
in the food	உணவில்	None
the order	இவ்வமைப்பு	None
called as	இவ்வாறாக	None
right	வலம்	None
h	எச்	None
oppary poet	ஈழத்தில்	None
eelam	த‌மிழீழ‌	None
attraction but here gravity	ஈர்ப்பு	None
attraction	கவர்ச்சி	None
erode	ஈரோடு	None
so much	இவ்வளவு	None
iran	ஈரான்	None
emulate	ஈமுலைடீ	None
involvement	ஈடுபாடு	None
involved	ஈடுபட்டார்	None
an	ஈடுபட்டது	None
engaged	ஈடுபட்டு	None
compensate	ஈடு	None
islamic	இஸ்லாமிய	None
humdity	ஈரப்பதம்	None
foods	உணவுகள்	None
eating	பழக்கம்	None
to make	உண்டாக்கி	None
lives	வசித்து	None
spirits'	உயிர்களின்	None
vowels	உயிர்மெய்	None
alive	உயிருடன்	None
life is	உயிருக்கு	None
deth	உயிரிழந்தனர்	None
biology	உயிரியல்	None
vitamin	ஊட்டச்சத்து	None
lifeless	உயிரியற்	None
of the organism	உயிரினத்தின்	None
spices	உயிரினங்கள்	None
livingthings	உயிரினங்களில்	None
live sperms	உயிரணுவில்	None
cells	திசுக்கள்	None
sperms	உயிரணுக்களின்	None
cell	திசுள்	None
living being	உயிரினம்	None
raise	உயர்வு	None
biogeography	உயிர்ப்புவியியல்	None
a sect of tamil language	உரிச்சொல்	None
generated	உருவாக்கிய	None
creation	படைப்பு	None
established	நிறுவியது	None
figure	உருவம்	None
shape	வடிவில்	None
shapes	வடிவங்கள்	None
image	படிமம்	None
living	வாழ்வினச்	None
cylinderical	உருளை	None
sphere	கோளத்தின்	None
russian	ரஷ்யாவின்	None
in melted	உருகிய	None
having the capacity	உரிய	None
rights	உரிமைகள்	None
license	உரிமம்	None
lisence	உரிம	None
urdu	உருது	None
young	இளம்	None
on top	மேற்	None
rising	உயர்ந்து	None
kicking	உதைத்தல்	None
bleeding	உதிரப்போக்கு	None
example	தண்டனை	None
for example	எடுத்துக்காட்டுக்கு	None
examples	மேற்கோள்	None
helps	உதவுகிறது	None
with help of	உதவியுடன்	None
a tile to chola king	உத்தம	None
helped	உதவியது	None
real	உண்மையான	None
promise	உண்மையிலேயே	None
truths	உண்மைகளை	None
truth	சத்தியம்	None
is eaten	உண்ணப்படுகிறது	None
eat	உண்ண	None
occurred	நிகழ்ந்தன	None
in fact	உண்மையில்	None
high	உயர்நிலைப்	None
guarantee	உத்தரவாதம்	None
tactics	உத்திகள்	None
tallest	உயரமான	None
height	உயரம்	None
of height	உயர	None
emissions	உமிழ்வுகள்	None
emitted	உமிழப்படும்	None
salt	உப்பு	None
user	பயனர்	None
strategy	வியூகம்	None
usage	உபயோகிக்கும்	None
upanidathams	உபநிடதங்கள்	None
equipments	சாதனங்களின்	None
you	நீயே	None
ununpiyam	உனுன்பியம்	None
for you	உனக்காக	None
momentum	வேகத்தை	None
measures	நடவடிக்கைகளையும்	None
use	பயன்படுத்துவர்	None
when	போது	None
australasia	ஆஸ்திரலேசியா	None
include	போன்றனவும்	None
akapporul	அப்பொருள்	None
region	பகுதியிலேயே	None
abdul	அப்துல்	None
rarely	அரிது	None
unbelive	அபூர்வ	None
abul	அபுல்	None
abin	அபின்	None
danger	ஆபத்து	None
risky	அபாயகரமான	None
rather	மாற்றாக	None
daily	நாளிதழ்	None
regards	அன்புடன்	None
love	லவ்	None
dear	கண்ணம்மா	None
mother	மதர்	None
a family of fish	அப்போகொனைடீ	None
amaravathy a name in tamil	அமராவதி	None
seated	அமர்ந்து	None
invisible	அமானுட	None
up	வரையிலான	None
having that	வைத்துக்கொண்டு	None
is organised	அமைக்கப்பட்டிருக்கும்	None
formed	உருவானது	None
set	திகழ்ந்தார்	None
is	விளங்குகிறது	None
are	விளங்குகின்றன	None
to everyone	அனைவருக்கும்	None
is coming	அமைகின்றது	None
united states	அமெரிக்காவுக்கு	None
americans	அமெரிக்கர்கள்	None
american	அமெரிக்கர்	None
us	யுஎஸ்	None
emirates	கூட்டாட்சி	None
acid	அமிலம்	None
amino	அமினோ	None
with america	அமெரிக்காவுடன்	None
almost	கிட்டத்தட்ட	None
hanuman	அனுமன்	None
allows	அனுமதிக்கிறது	None
similarly	அவ்வாறே	None
at the same time	அதேசமயம்	None
the same	இதே	None
that	என்றே	None
yet	அதுவரை	None
most	மிக்க	None
in that	அவையில்	None
likewise	போலன்றி	None
frequency	பண்பலை	None
owner	அதிபர்	None
hyperbola	அதிபரவளைவு	None
viral	வைரல்	None
wonder	அதிசயங்கள்	None
surprise	அதிசய	None
officials	அதிகாரிகள்	None
officer	அதிகாரியான	None
shock	அதிர்ச்சி	None
sets	அமைக்கும்	None
while	வேளையில்	None
such a	இத்தகையதொரு	None
allowed	அனுமதித்தது	None
allow	அனுமதிக்கும்	None
sends	அனுப்பும்	None
sent	அனுப்பிய	None
to send	அனுப்பி	None
experience	அனுபவம்	None
experiences	அனுபவங்கள்	None
moreover	அத்தோடு	None
country	வேங்கி	None
worm	அந்து	None
evening	மாலை	None
a grammatical rule	அந்தாதி	None
andhman island	அந்தமான்	None
respective	அந்தந்த	None
priest	அந்தணர்	None
essential	இன்றியமையாதது	None
anthuvancheral	அந்துவஞ்சேரல்	None
order	வரிசைப்படி	None
ministry	அமைச்சரவை	None
ministers	அமைச்சர்கள்	None
political structure	அரசியலமைப்பு	None
in the constitution	அரசியலமைப்பில்	None
constitution	அரசியலமைப்புச்	None
political	அரசியற்	None
queen	ராணி	None
reign	ஆட்சிக்காலம்	None
the goverment	அரசாங்கமும்	None
government	அரசும்	None
for government	அரசாங்கத்தால்	None
governments	அரசுகள்	None
king's	அரசரின்	None
article	விதி	None
for the king	அரசனுக்கு	None
kings	மன்னர்கள்	None
to become a king	அரசனாக	None
politics	அரசியல்சட்ட	None
politicians	அரசியல்வாதிகள்	None
in government	அரசில்	None
states	மாநிலத்தின்	None
aristophanes	அரிஸ்டாஃபனீஸ்	None
haryana	அரியானா	None
throne of	அரியணையில்	None
throne	அரியணை	None
itching	அரிப்பு	None
rare	அரிய	None
rice	சோறு	None
goverment	அரச	None
arabian	அரேபிய	None
arabic	அரபி	None
palace	அரண்மனை	None
wall	வே	None
state	ஸ்டேட்	None
government rights	அரசுரிமை	None
with government	அரசுடன்	None
govenment to	அரசுக்கும்	None
arab	அரபு	None
theater	நாடகம்	None
auditorium	அரங்கம்	None
aragonite	அரகோனைட்	None
formation	உருவாவதற்கு	None
settings	அமைப்புகள்	None
from the system	அமைப்பிலிருந்து	None
an organization	அமைப்பானது	None
structure	கட்டமைப்பை	None
organization	அறக்கட்டளை	None
amine	அமைன்	None
to form	வடிவமாக	None
was	விளங்கியது	None
situated	அமைந்திருக்கும்	None
is located	அமைந்திருக்கிறது	None
within	அமைந்தன	None
setting up	அமைத்தல்	None
create	தோன்றின	None
peace keeping	அமைதிகாக்கும்	None
peace	சாந்தி	None
located	அமைந்துள்ளன	None
minister	அமைச்சர்	None
may be	அமையும்	None
location	விரும்பும்	None
ayya's path	அய்யாவழியில்	None
the way of the grand father	அய்யாவழியின்	None
ayyavazhi	அய்யாவழி	None
sir	அய்யா	None
aiyothi	அயோத்தி	None
foreign	வெளியுறவு	None
ireland	அயர்லாந்து	None
to organise	அமைவது	None
ionospheric	அயனாதிக்க	None
amman	அம்மன்	None
hindu godess	அம்மனுக்கு	None
ambedkar	அம்பேத்கர்	None
arrow	அம்பு	None
feature	வசதியை	None
features	அம்சங்களையும்	None
ammonia	அமோனியா	None
lady	அம்மையார்	None
officially	அதிகாரப்பூர்வமாக	None
official	உத்தியோகபூர்வ	None
in power	அதிகாரத்தில்	None
from there	அங்கிருந்து	None
the	வைத்த	None
ankara	அங்காரா	None
element	அங்கம்	None
part	பாகம்	None
akbar	அக்பர்	None
king	ராஜா	None
october	ஒக்டோபர்	None
acupuncture	அக்குபிரசர்	None
during those days	அக்காலத்து	None
at the time	சமயத்தில்	None
during that time	அக்காலகட்டத்தில்	None
time	முறையும்	None
care	கவனிப்பு	None
that party	அக்கட்சியின்	None
authorized	அங்கீகரிக்கப்பட்ட	None
recognition	அறிதல்	None
there	வந்துள்ளன	None
angur	அங்கூர்	None
density	அடர்த்தி	None
including	உள்ளிட்ட	None
included	ஆகியனவும்	None
includes	உள்ளடக்குகிறது	None
contained	கொண்டிருந்தது	None
containing	பெற்றிருக்கும்	None
contains	திகழ்கிறது	None
a measurement	அகிலத்திரட்டு	None
buried	அடக்கம்	None
press	பிரஸ்	None
ashoka	அசோகர்	None
print	அச்சுப்	None
asin	அசினின்	None
assam	அசாம்	None
extraordinary	அசாதாரண	None
original	அசல்	None
ajith	அஜித்	None
international	பன்னாட்டுக்	None
all	யாவும்	None
ahimsa, and non violence	அகிம்சை	None
mesherment	φ	None
a mathematical symbol	λ	None
a	வழங்கி	None
degree	பட்டம்	None
multiplication	பெருக்கல்	None
percent	~	None
|	|	None
firefox	பயர்பாக்ஸ்	None
power symbol in maths	^	None
headings	==	None
equal	சம	None
straight	நேர்	None
hirsels	<நிரை>	None
mend	<சீர்>	None
lesser than	<	None
plus	+	None
greater than	>	None
thick	அடர்த்தியான	None
facebook	ஃபேஸ்புக்	None
faq	அ.கே.கே	None
augustus	அகஸ்ட்டஸ்	None
akalpori	அகழ்பொறி	None
latitude	அட்ச	None
width	அகலம்	None
remove	நீக்க	None
dictionary	அருஞ்சொற்பொருள்	None
alphabet	எழுத்துக்களை	None
a chemaical name	ஃவீனால்	None
agaram, a dictionary	அகரம்	None
alphabetically	அகர	None
inside	உள்ளே	None
akananuru	அகநானூறு	None
sage	முனிவர்	None
refugees	அகதிகள்	None
infrared	அகச்சிவப்பு	None
aiadmk	அதிமுக	None
alphabets	எழுத்துக்களும்	None
feet	அடி	None
hits	அடிகள்	None
often	பெரும்பாலும்	None
with that	அத்துடன்	None
so	எனவே	None
that is why	அதனாலேயே	None
recent	சமீப	None
recently	சமீபத்தில்	None
latest	சமீபத்திய	None
annamalai a title	அண்ணாமலை	None
its	ஆகியவற்றைத்	None
annadurai	அண்ணாதுரை	None
a thousand year old	அண்ணளவாக	None
a great man	அண்ணல்	None
brother	தம்பி	None
and	மற்றும்	None
neighbour	அண்டை	None
cosmology	அண்டவியல்	None
universe	அண்டம்	None
former chief minister of tamilnadu	அண்ணா	None
the universe	அண்டமானது	None
itself	தன்னுள்	None
that also	உடையவை	None
power	வல்லமை	None
powers	சக்திகள்	None
authority	அதிகார	None
in abundance	அதிகளவில்	None
increasing	அதிகரிப்பதால்	None
increase	பெருக்கும்	None
over	முடிந்து	None
it	வவுனியா	None
increased	அதிகரிப்பால்	None
hence	அதவாது	None
then	பிறகு	None
more	வெகு	None
appropriate	பொருத்தமானது	None
for that	அதற்காக	None
after that	அதன்பிறகு	None
in that way	அதன்படி	None
like that	விரும்பிய	None
aristotlian	அரிஸ்டாட்டிலின்	None
world	வேர்ல்டு	None
dam	அணை	None
next	அடுத்து	None
outer layers	அடுக்குகள்	None
layer	அடுக்குகளில்	None
under	உள்ளானது	None
slaves	அடிமைகள்	None
slavery	அடிமைகளாக	None
slave	அடிமை	None
next to next	அடுத்தடுத்த	None
basically	அடிப்படையில்	None
based	மருவி	None
is the fundamental	அடிப்படையாகும்	None
on	மீது	None
fundamentally	அடிப்படையிலேயே	None
basics	அடிப்படைகள்	None
basic	அடிப்படைப்	None
footnotes	அடிக்குறிப்புகளும்	None
fundamentals	அடிப்படையிலும்	None
near	அருகே	None
reach	சேரும்	None
identities	அடையாளங்களை	None
atom	அணுவின்	None
atoms	அணுக்கள்	None
approaches	அணுகுமுறைகள்	None
approach	அணுகுமுறை	None
senate	மேலவை	None
access	அணுகு	None
nuclear	அணுக்கரு	None
reached	அடைந்து	None
group	குழுவை	None
team	அணியை	None
atlantic	அட்லாண்டிக்	None
card	அட்டை	None
identified	அடையாளம்	None
symbolic	அடையாளமாக	None
identity	அடையாளத்தை	None
signs	அடையாளங்கள்	None
wearing	அணியும்	None
vapor	ஆவி	None
aristatil	அரிஸ்டாட்டில்	None
nearest	அருகில்	None
leading	வழிவகுத்தது	None
indian national congress strongly opposed the british colonial rule to bring independence. despite this event it showed the british sea dominance. arctic cold winds diminishes the atlantic sea power.	ஆதிக்கத்தை	None
domination	ஆதிக்க	None
beginning	துவங்கி	None
evidence	சான்று	None
source	மூல	None
proof	ஆதாரங்கள்	None
resource	ஆதார	None
adam	ஆதாம்	None
since	ஆதலால்	None
with support	ஆதரவுடன்	None
support	சார்பில்	None
help	உதவும்	None
masculine	ஆண்பால்	None
yearly	வருடாந்திர	None
aaditya	ஆதித்த	None
athithan	ஆதித்தன்	None
soul	பக்தி	None
andira	ஆந்திர	None
in africa	ஆப்பிரிக்காவில்	None
africa's	ஆப்பிரிக்காவின்	None
afghanistan	ஆப்கானிஸ்தான்	None
africa	ஆப்பிரிக்கா	None
african	ஆப்பிரிக்க	None
abraham	ஆபிரகாம்	None
dangerous	பயங்கரமான	None
years	வருடங்களுக்கு	None
on line	ஆன்லைன்	None
ann	ஆன்	None
though	ஆனாலும்	None
became	ஆனார்	None
anand	ஆனந்த்	None
happy	ஆனந்த	None
andhra pradesh state in india	ஆந்திரா	None
andhra	ஆந்திரப்	None
spiritual	ஆன்மீக	None
in the years	வருடங்களில்	None
for many years	ஆண்டுகளாக	None
in	இல்	None
regime	ஆட்சியை	None
dresses	ஆடைகள்	None
cloth	துணி	None
tamil month aadi	ஆடி	None
dances	ஆடல்	None
luxurious	ஆடம்பரமான	None
dance	நடன	None
ruling	ஆளும்	None
desire	விருப்பம்	None
teacher	வாத்தியார்	None
as a teacher	ஆசிரியராக	None
in asia	ஆசியாவில்	None
asia	ஆசியாவின்	None
asath	ஆசாத்	None
seat	தொகுதியில்	None
british	பிரித்தானியர்	None
teachers	ஆசிரியர்கள்	None
apple	ஆப்பிள்	None
ruling period	ஆட்சிக்காலத்தில்	None
rulers	ஆட்சியாளர்கள்	None
year	வருஷம்	None
god	தேவன்	None
lord	இறைவன்	None
ruler	ஆண்ட	None
male penis	ஆண்குறியின்	None
gents	ஆண்கள்	None
for men	ஆண்களுக்கு	None
rulling	ஆட்சிப்	None
males	ஆண்களின்	None
condom	காண்டம்	None
man	மனிதர்	None
male	புருஷ	None
atracain	ஆட்ராசைன்	None
shaking	நடுக்கம்	None
governance	ஆட்சியில்	None
rule	ஆட்சியின்	None
commission	ஆணையம்	None
in english	ஆங்கிலத்தில்	None
apples	ஆப்பிள்கள்	None
amsterdam	ஆம்ஸ்டர்டாம்	None
temple	திருக்கோயில்	None
in the river	ஆற்றில்	None
river	நதியின்	None
energy	சக்தி	None
efficient	திறனும்	None
aarumuga	ஆறுமுக	None
to attributed	ஆறுதல்	None
rivers	நதிகள்	None
in the rivers	ஆறுகளின்	None
six	ஆறு	None
sixth	ஆறாவது	None
eager	ஆர்வம்	None
irterest	ஆர்வத்தை	None
arthur	ஆர்தர்	None
arctic	ஆர்க்டிக்	None
plant	தாவர	None
advisory	ஆலோசனை	None
halloween	ஆலோவீன்	None
alkene	ஆல்க்கீன்	None
at least	குறைந்தபட்சம்	None
avani , a tamil month	ஆவணி	None
document	சாசனம்	None
documents	ஆவணங்கள்	None
alvars	ஆழ்வார்களின்	None
alwars	ஆழ்வார்	None
deep	ஆழ்ந்த	None
orkut	ஆர்க்குட்	None
high seas	ஆழ்கடல்	None
depth	ஆழம்	None
in depth	ஆழமாக	None
personality	தனிமனித	None
governor	ஆளுனர்	None
alps	ஆல்ப்ஸ்	None
albert	ஆல்பர்ட்	None
alkaline	ஆல்க்கைன்	None
tsunami	சுனாமியை	None
archimedes	ஆர்க்கிமிடீஸ்	None
organic	கரிம	None
r	ஆர்	None
from the research	ஆய்வுகளின்	None
review	விமர்சனம்	None
under research	ஆய்வில்	None
experiment	ஆய்வுகள்	None
research scholars	ஆய்வாளர்கள்	None
scientist	ஆய்வாளர்	None
life	வாழ்வு	None
researches	ஆராய்ச்சிகள்	None
weapons	ஆயுதங்கள்	None
equipment	சாதனம்	None
happened	நடந்தது	None
thousand	ஆயிரம்	None
thousands of	ஆயிரக்கணக்கான	None
although	வந்தாலும்	None
bishop	ஆயர்	None
core	ஆய	None
weapon	ஆயுதம்	None
yes	ஆம்	None
experiments	பரிசோதனைகள்	None
orange	ஆரஞ்சு	None
health	நல	None
healthy	ஆரோக்கியமான	None
radian	ஆரையம்	None
aryans	ஆரியர்	None
one of the community of india	ஆரிய	None
researched	ஆராய்ந்த	None
research of	ஆராய்ச்சியின்	None
reserch	ஆய்வுகளை	None
researchers	ஆராய்ச்சியாளர்கள்	None
research	ஆராய்ச்சியில்	None
to examine	ஆராய	None
started	தொடங்கியது	None
began	மேற்கொண்டார்	None
initiated	வருதலும்	None
in the beginning	தொடக்கத்தில்	None
starting	தொடங்கி	None
researcher	ஆராய்ச்சியாளர்	None
english	ஆங்கிலப்	None
there and there	ஆங்காங்கே	None
oxide	ஆக்சைடு	None
al	அல்	None
wavelength	அலைநீளம்	None
waves	பேரலைகள்	None
wave	அலைகளை	None
of alexander	அலெக்ஸாண்டரின்	None
alexander	அலெக்ஸாண்டர்	None
office	பதவிக்கு	None
ali	அலி	None
alaska	அலாஸ்காவின்	None
units	அலகுகள்	None
unit	யூனிட்	None
apex	உச்சி	None
not	பிடிக்க	None
room	அறை	None
harvest	அறுவடை	None
alkuran	அல்குர்ஆன்	None
alkyl	அல்கைல்	None
almanac	பஞ்சாங்கம்	None
not that	அல்ல	None
quantity	அளவில்	None
level	மட்ட	None
metric	மெட்ரிக்	None
of	பொருளில்	None
measured	அளவிடப்படுகிறது	None
amount	அளவானது	None
sized	அளவான	None
diagnosis	ஆய்வுக்கு	None
limited	வரையறுக்கப்பட்ட	None
measuring	அளவிடும்	None
scale	அளவுகோல்	None
ally flower	அல்லி	None
allah	அல்லாஹ்	None
besides	கூடவே	None
non	அல்லாத	None
or	பணியாளர்	None
measure	அளவிட	None
suggested	அறிவுறுத்தினார்	None
knowledge	உணர்வும்	None
sciences	அறிவியல்கள்	None
information	தகவல்கள்	None
report	புகார்	None
symptoms	அறிகுறிகள்	None
good things	அறம்	None
trust	நம்பிக்கையை	None
meaning	பொருள்படும்	None
argentina	அர்ஜென்டினா	None
scholar	பண்டிதர்	None
half	அரை	None
arabia	அரேபியா	None
waterfalls	அருவி	None
sri	ஸ்ரீ	None
god's wishes	அருள்	None
arun mozhi a tamil name	அருண்மொழி	None
arjunan	அருச்சுனன்	None
museum	கூடம்	None
in the arabian country	அரேபியாவின்	None
measurement	அளவைக்	None
scholars	சான்றோர்	None
know	தெரியும்	None
in science	அறிவியலில்	None
scientists	விஞ்ஞானிகள்	None
science	விஞ்ஞானம்	None
announcement	அறிவிப்பை	None
intellectually	அறிவின்	None
he announced	அறிவித்தார்	None
announced	அறிவித்துள்ளது	None
knowing	தெரியாமல்	None
intelligence	அறிவாற்றல்	None
known	தெரிந்த	None
unknown	தெரியாத	None
introduction	முன்னுரை	None
introduced	அறிமுகப்படுத்தியது	None
intraduce	அறிமுகப்படுத்தி	None
introduce	அறிமுகப்	None
learn	கற்று	None
to make known	அறியலாம்	None
measurements	அளவீடுகள்	None
size	அளவு	None
levels of	அளவுகளில்	None
house	வீட்டை	None
these include	இவற்றுட்	None
channels	அவைகளாவன	None
australia	ஆஸ்திரேலியா	None
outlook	நோக்கும்	None
her	அவளை	None
which	அவற்றுள்	None
regularly	தவறாமல்	None
them (between them)	அவற்றுக்கு	None
them	என்பவற்றுக்கு	None
with them	இவற்றோடு	None
they	தாம்	None
in their	உள	None
to them	அவர்களிடம்	None
him	அவரைச்	None
that person	அவரை	None
among them	அவற்றிலிருந்து	None
himself	தாமே	None
cow	மாடு	None
august	ஆகஸ்ட்	None
oxygen	ஆக்ஸிஜன்	None
occupy	நிறைந்த	None
invasive	தோலினுள்	None
development	விருத்தி	None
made	உள்ளாகி	None
to create	இயற்றி	None
so that	ஆகையால்	None
become	வருதல்	None
those	ஆகியோர்	None
and also	ஆகியவையும்	None
including all	ஆகியவைகள்	None
causes	காரணங்கள்	None
with	வைத்தே	None
to	வேண்டுமென்று	None
including that	கொண்டிருக்கும்	None
all those	ஆகியனவாகும்	None
also	என்பனவும்	None
near by	அருகிலுள்ள	None
with him	தன்னுடன்	None
their	தத்தம்	None
destroyed	அழித்து	None
inflammation	அழற்சி	None
beautificates	அழகூட்டல்	None
beauty	அழகு	None
beautiful	அழகிய	None
destroy	மருவிய	None
providing	வழங்குதல்	None
to destroy	அழிக்கும்	None
giving	வழங்கும்	None
given	தரப்பட்டுள்ள	None
by	வாரியாகவோ	None
offered	அளிக்கப்படும்	None
provided	வழங்குவது	None
give	பயக்கும்	None
limit	அளவை	None
levels	நிலைகளில்	None
provide	வழங்குகின்றன	None
for him	இவரை	None
destruction	அழிவு	None
to be destroyed	அழியும்	None
she	வந்தாள்	None
every one	அவரவர்	None
he	இவரைப்	None
who	யாருக்கு	None
to him	அவரிடம்	None
his	ஹிஸ்	None
avadhar	அவதாரம்	None
does not disappear	அழியாத	None
avatar	அவதார	None
important	முக்கியம்	None
take	எடுத்துச்	None
calling	அழைத்தனர்	None
called	என்றழைக்கப்பட்ட	None
invited	அழைத்தார்	None
call	அழைப்பு	None
pressure	அழுத்தம்	None
notice	கவனிக்க	None
secretary	செயலாளர்	None
always	எப்போதும்	None
m	மீட்டர்	None
consume	நுகர்வு	None
policies	கொள்கைகள்	None
policy	கொள்கையை	None
to have	கொள்க	None
kolli	கொல்லிமலை	None
lethals but here its a name	கொல்லி	None
to kill	கொல்ல	None
kolkata	கொல்கத்தா	None
murder	கொலை	None
colorado	கொலராடோ	None
coloumbia	கொலம்பியா	None
columbus	கொலம்பஸ்	None
colombus	கொலம்பசு	None
columbus'	கொலம்பசின்	None
korea	கொரியா	None
will	படும்	None
capacity	திறன்	None
could not	கொள்ளவில்லை	None
must	கொள்ளவேண்டும்	None
towers	கோபுரங்கள்	None
anger	கோபம்	None
wheat	கோதுமை	None
godhavari	கோதாவரி	None
angles	கோணங்களில்	None
theme	கோட்பாட்டை	None
theories	கோட்பாடுகள்	None
killed	கொல்லப்பட்டார்	None
palase	கோட்டை	None
summer	வெயில்	None
lines	கோடுகள்	None
millions	கோடிக்கணக்கான	None
crore	கோடியில்	None
colombo	கொழும்பு	None
cholesterol	கொழுப்பு	None
siviar	கொள்ளை	None
in a line	கோட்டில்	None
killing	கொல்லப்பட்டனர்	None
boiling	கொதிக்கும்	None
had	வேண்டியிருந்தது	None
deadly	கொடிய	None
flag	கொடியை	None
little	கொஞ்சம்	None
kochi	கொச்சி	None
left out or abondon	கைவிடப்பட்ட	None
handling	கையாளும்	None
handle	கையாள	None
as a flag	கொடியாக	None
by hand	கையால்	None
caught	பிடித்து	None
seized	கைப்பற்றினர்	None
take over	கைப்பற்றிக்	None
captured	கைப்பற்றினான்	None
capture	கைப்பற்றிய	None
volleyball	கைப்பந்து	None
mobile	மொபைல்	None
handover	கைமாற்றம்	None
tower	கோபுரம்	None
in the flag	கொடியில்	None
is giving	கொடுக்கிறது	None
has	விட்டார்	None
not having that	கொண்டிருக்கவில்லை	None
celebrations	கொண்டாட்டங்கள்	None
celebrating	கொண்டாடும்	None
celebrate	கொண்டாடுகின்றனர்	None
celebrated	கொண்டாடப்படும்	None
took	கொண்டார்கள்	None
pay	செலுத்துகின்றனர்	None
into	கொண்டன	None
contain	கொண்டிருக்கின்றன	None
kotland	கொட்லாந்து	None
generosity	கொடை	None
cruelty	கொடுமை	None
gave	கொடுத்தார்	None
to provide	கொடுத்தது	None
will give	கொடுக்கும்	None
having included	கொண்டதாகும்	None
arrest	கைது	None
kobe	கோபே	None
files	கோப்புகளை	None
illegally	புறம்பாக	None
law	சட்டம்	None
legislature	சட்டமன்றம்	None
assembly	சட்டமன்றத்	None
by law	சட்டப்பூர்வமான	None
legally	சட்டப்படி	None
in the law	சட்டத்தில்	None
bill	மசோதா	None
act	செயல்பட	None
acts	செயல்படுகிறது	None
laws	சட்டங்களை	None
legal	சட்ட	None
mutation	பிறழ்வு	None
formalities	சடங்குகள்	None
sachin	சச்சின்	None
chandigar	சண்டிகர்	None
fight	போரிட்டு	None
fights	சண்டைகள்	None
percentage	விழுக்காடு	None
moons	சந்திரன்கள்	None
chandrasekar	சந்திரசேகர்	None
moon	நிலா	None
appointment	நியமனம்	None
meet	சந்தித்து	None
suffered	சந்தித்தது	None
met	சந்தித்தனர்	None
sankarar	சங்கரர்	None
to meet	நேரிடும்	None
sathyagraha	சத்தியாகிரக	None
muscles	சதைப்புற்று	None
chathurthi	சதுர்த்தி	None
chess	செஸ்	None
square	சதுர	None
marshy	சதுப்பு	None
coup attempt or a betrayal	சதி	None
sathyam	சத்ய	None
society	சங்கம்	None
association	மன்றம்	None
in ancient days	சங்ககாலத்தில்	None
spheres	கோளங்கள்	None
spherical	கோள	None
golf	கோல்ப்	None
satellite	விண்கலம்	None
pattern	கோலம்	None
one of the art in india specific in tamil nadu	கோலங்கள்	None
court	நீதிமன்றம்	None
disorder	கோளாறு	None
demanded	கோரியது	None
request	வேண்டுகோளுக்கு	None
requested	கோரி	None
temples	கோவில்கள்	None
in the temples	கோயில்களில்	None
in temple	கோயிலில்	None
coimbatore	கோவையில்	None
trophy	கோப்பை	None
appeals	கோரிக்கைகளை	None
file	கோப்பு	None
hen	கோழி	None
covalan	கோவலனின்	None
sangam	சங்க	None
powerful	சக்திவாய்ந்த	None
emperor	பேரரசர்	None
wheel	சக்கரம்	None
brothers	சகோதரர்கள்	None
period or era	சகாப்தம்	None
all of	சகல	None
chickens	கோழிகள்	None
co	சக	None
na	நா	None
gouri	கௌரி	None
dignity	கௌரவம்	None
coimbatore district in tamilnadu	கோவையின்	None
kovai	கோவை	None
goa	கோவா	None
kovalan	கோவலன்	None
challenge	சவால்	None
hands	கைக்	None
hand	கையில்	None
questions	கேள்விகள்	None
short sound letters	குறில்	None
symbols	குறியீடுகள்	None
points	புள்ளிகள்	None
code	கோட்	None
symbol	சின்னமாக	None
encryption	குறியாக்கம்	None
in the mentions	குறிப்பில்	None
noted	குறிப்பிட்டார்	None
specific	குறிப்பிட்ட	None
notes	ஸ்வரங்கள்	None
indicate	குறிப்பிடுகின்றன	None
specified	குறிப்பிடப்பட்ட	None
mentioned	குறிப்பிட்டுள்ளார்	None
to mention	குறிப்பிடப்	None
notable	குறிப்பிடத்தக்கவை	None
cross	வெட்டும்	None
across	குறுக்கே	None
small scale	குறுநில	None
suggesstion	குறைகள்	None
cooled	குளிர்ந்து	None
cool	குளிர்ந்த	None
winter	குளிர்காலம்	None
pond	குளம்	None
kulothungan a king name	குலோத்துங்கன்	None
kulothungan	குலோத்துங்க	None
sect	குலம்	None
mentionable	குறிப்பிடத்	None
crime	குற்றவியல்	None
deficiency	குறைபாடு	None
lowering	குறைந்து	None
lowered	குறைத்து	None
reduction	குறைதல்	None
decrease	குறைவு	None
lower	தாழ்ந்த	None
decreases	குறையும்	None
mistakes	பிறழ்வுகள்	None
in particular	குறிப்பாக	None
mention	குறிப்பிட	None
particular	குறிபிட்ட	None
failure	தோல்வியில்	None
gnu	குனூ	None
gnome	குநோம்	None
stab	குத்து	None
horses	குதிரைகள்	None
horse	குதிரை	None
bombs	குண்டுகள்	None
kumaran	குமரன்	None
bomb	குண்டு	None
characters	குணம்	None
kuttuvan	குட்டுவன்	None
kutty , a name in tamil parlance	குட்டி	None
in the family	குடும்பத்தில்	None
family	குடும்பம்	None
relating to emigration	குடியேற்றவாத	None
imigration	குடியேற்றம்	None
gundalakesy	குண்டலகேசி	None
glucagon	குளூக்கொகான்	None
kumari	குமரி	None
in kumbakonam	கும்பகோணத்தில்	None
pointed	குறித்தது	None
conditions	நிலையையும்	None
marking	குறிக்கும்	None
categorised	குறிக்கப்	None
mark	மாற்கு	None
kural	குறள்	None
quran	திருக்குர்ஆன்	None
kumar	குமார்	None
kuro maugunan	குரோ-மாகுநன்	None
in blood	குருதியில்	None
through blood	குருதியின்	None
monk	குரு	None
voice	குரல்	None
monkey	குரங்கு	None
quebare	குயிபேர்	None
kumbakanam - name of a place	கும்பகோணம்	None
corundum	குருந்தம்	None
dwarf	குள்ள	None
baby	பாப்பா	None
children's	குழந்தைகளின்	None
pelican	கூழைக்கடா	None
coulomb a unit	கூலும்	None
maid	கூலி	None
as per the said	கூற்றுப்படி	None
concepte	கூற்று	None
is told by	கூறுவர்	None
to say	சொல்லில்	None
comedy actor	கெம்பெ	None
telling	சொல்வது	None
claims	கூறும்	None
divisons	கூறுகளைக்	None
divisions	பிரிவுகளாகப்	None
sayings	கூறுகளும்	None
tell	சொல்லலாம்	None
informed by them	கூறுகையில்	None
revealed	தெரியவருகிறது	None
reveal	கூறுகின்றன	None
not said by them	கூறவில்லை	None
keynesian	கெயின்சியன்	None
k	கே	None
question	கேள்வி	None
entertainment	பொழுதுபோக்கு	None
gaelic	கேலிக்	None
in kerala	கேரளாவில்	None
kerala	கேரளா	None
cambridge	கேம்ப்ரிட்ஜ்	None
captain	கேப்டன்	None
gerreidae	கெரீடீ	None
cape an island	கேப்	None
kendela	கேண்டெலா	None
colonel	கேணல்	None
gates	வாயில்கள்	None
asked	கேட்டார்	None
hearing	கேட்டு	None
ask	கோர	None
detriment	கேடு	None
cable	கேபிள்	None
market	சந்தையை	None
proposed	முன்மொழிந்தார்	None
was said by	கூறப்படும்	None
minaret	குவிமாடம்	None
quam	குவாம்	None
quantum	குவாண்டம்	None
in groups	குழுக்களில்	None
pipes	குழாய்கள்	None
tube	குழாய்	None
sambhar	குழம்பு	None
kuvera sect	குவேரா	None
confusion	குழப்பம்	None
childish	குழந்தையாக	None
childhood	குழந்தைப்	None
child	குழந்தைத்	None
children	பிள்ளைகள்	None
for children	குழந்தைகளுக்கு	None
childist	குழந்தைகளுக்கான	None
in children	குழந்தைகளில்	None
the child's	குழந்தையின்	None
was explained	கூறப்பட்டது	None
google	கூகுள்	None
hall	மண்டபம்	None
there are	கூறப்படுகின்றன	None
to look into	கூர்ந்து	None
roof	கூரை	None
cones	கூம்புகள்	None
cone	கூம்பு	None
addition	கூட்டல்	None
meeting	கூட்டம்	None
even	கூட	None
federation	கூட்டமைப்பு	None
joint alliance	கூட்டணி	None
basketball	கூடைப்பந்து	None
nest	கூடு	None
to join	சேர்க்க	None
in addition to	கூடுதல்	None
cooperate	கூடி	None
interact	கூடல்	None
annual conference	கூட்டத்தில்	None
settlement	தீர்வை	None
population	மக்கள்தொகையில்	None
saturn	சனியின்	None
subash a freedom fighter	சுபாஷ்	None
sunni	சுன்னி	None
sundar	சுந்தர்	None
sundareshwarar	சுந்தரேசுவரர்	None
sundaram	சுந்தரம்	None
sundaramurthy	சுந்தரமூர்த்தி	None
liberal	தாராளவாத	None
refinery	சுத்திகரிப்பு	None
clean	துப்பரவான	None
freely	சுதந்திரமாக	None
freedom	சுதந்திரம்	None
independence	சுதந்திரப்	None
lime	சுண்ணாம்பு	None
pointing	சுட்டும்	None
shoot	சுட்டுக்	None
bharathi he is a poet	சுப்பிரமணிய	None
subramanian	சுப்பிரமணியன்	None
supreme	சுப்ரீம்	None
carrying	தாங்கும்	None
round	வட்ட	None
surroundings	சுற்றிலும்	None
around	சுற்றிவரும்	None
perimeter	சுற்றளவு	None
roll	சுருள்	None
shrinking	சுருங்குதல்	None
shrinks	சுருக்கியக்கம்	None
out	வெளியே	None
summary	சுருக்கம்	None
in brief	சுருக்கமாக	None
tunnel	சுரங்கம்	None
stimulation	சுரக்கும்	None
autonomy	தன்னாட்சி	None
biographies	சுயசரிதை	None
self	தன்னிலை	None
sumatra	சுமாத்திரா	None
brief	சுருக்கமான	None
a links	சுட்டிகள்	None
mouse	சுட்டி	None
sujatha	சுஜாதா	None
temple of lord shiva	சிவத்தலங்கள்	None
sivakasi	சிவகாசி	None
siva	சிவ	None
retail	சில்லறை	None
statues	சிலைகள்	None
statue	சிலை	None
cross in christianity	சிலுவையில்	None
red	ரெட்	None
silicon	சிலிக்கான்	None
having few	சிலவற்றில்	None
few people	சிலரால்	None
silapathikaram a poetry	சிலப்பதிகாரம்	None
spider	சிலந்தி	None
some times	நேரங்களில்	None
sometimes	சிலசமயங்களில்	None
some	சிலவும்	None
chile	சிலி	None
synodic period	சுற்றுக்காலம்	None
shiva	சிவபெருமான்	None
system	முறையைக்	None
sukilam a timing in tamil	சுக்கில	None
an initial in tamil	சு	None
civakan	சீவகன்	None
seevaga	சீவக	None
reformations	சீர்திருத்த	None
critical	சீரிய	None
in series	சீராக	None
sivaji	சிவாஜி	None
random	சீரற்ற	None
in china	சீனாவில்	None
china	சீனாவை	None
chinese	சீனர்	None
sita	சீதையை	None
assistant	துணைப்	None
cesium	சீசியம்	None
sikhs	சீக்கியர்	None
srinivasa	சீனிவாச	None
sculptures	சிற்பங்கள்	None
compound	சுற்றுச்	None
cuff	சுற்றுப்பட்டை	None
senator	செனட்டர்	None
pure tamil	செந்தமிழ்	None
chettiar	செட்டியார்	None
plants	தாவரம்	None
sengundar	செங்குந்தர்	None
vertical	செங்குத்து	None
vertically	செங்குத்தாக	None
senguttuvan chera king	செங்குட்டுவன்	None
chezh republics	செக்	None
situations	சூழ்நிலையில்	None
surround	சூழ்	None
in situations	சூழ்நிலைகளில்	None
in the context of	சூழலில்	None
ecology	சூழலியல்	None
situation	நிலையும்	None
sen	சென்	None
central	மையத்தில்	None
sun fishes	சென்ட்ரார்கைடீ	None
chennai	சென்னையிலும்	None
activity	நடவடிக்கையை	None
artificially	செயற்கையான	None
ortificial	செயற்கைக்	None
satilites	செயற்கைகோள்கள்	None
satlight	செயற்கைகோளின்	None
artificial	செயற்கைத்	None
classical language	செம்மொழி	None
surrounded	சூழ்ந்து	None
cembadai	செம்படை	None
september	செப்டெம்பர்	None
go	போ	None
has gone	சென்றார்	None
visited	வந்தது	None
gone	சென்றான்	None
in chennai	சென்னையில்	None
madras	மெட்ராஸ்	None
it's an ancient evidance	செப்பேடுகள்	None
july	ஜூலை	None
island	தீவுக்	None
hurricane	சூறாவளி	None
schweizerland	சுவிட்சர்லாந்தின்	None
swamithoppu	சுவாமிதோப்பு	None
swami	சுவாமிகள்	None
swathi	சுவாதி	None
respiratory	சுவாச	None
walls	சுவர்கள்	None
rotate shape	சுழல்வடிவ	None
in switzerland	சுவிட்சர்லாந்தில்	None
velocity	திசைவேகம்	None
cycle	சுழற்சியின்	None
rotation	சுழற்சிக்	None
sultan	சுல்தான்	None
tourism	சுற்றுலாத்துறை	None
tourist	சுற்றுலாப்	None
travel	பயண	None
rotating	சுற்றும்	None
swirls	சுழற்சியை	None
environment	சூழல்	None
switzerland	சுவிட்சர்லாந்து	None
sweden	சுவீடன்	None
heliocentric	சூரியமையக்	None
the sun	சூரியனைச்	None
from the sun	சூரியனிலிருந்து	None
of the sun	சூரியனின்	None
solar	சூரியக்	None
good	நல்லவன்	None
june	ஜூன்	None
swiss	சுவிஸ்	None
zuni	சூனி	None
casino	சூதாட்டரங்கம்	None
sudo	சூடோ	None
soodamani	சூடாமணி	None
sudan	சூடான்	None
hot	சூடான	None
interesting	சுவையான	None
taste	சுவை	None
formula	சூத்திரம்	None
in jail	சிறையில்	None
prison	சிறை	None
boy	சிறுவன்	None
slight	சிறிது	None
server	சர்வர்	None
news	செய்தியை	None
controversy	சர்ச்சை	None
sugar	சீனி	None
carkoma	சர்கோமா	None
slanding	சரிவு	None
properly	சரிவர	None
correct	சரியான	None
correctly	சரியாக	None
in history	சரித்திரத்தில்	None
history	வரலாற்றையும்	None
exact	சரி	None
on an average	சராசரியாக	None
average	சுமார்	None
sulfur	சல்பர்	None
saudi	சவூதி	None
sophocles	சாஃபக்கிளீசு	None
sappho	சாஃபோ	None
san antonia	சான்	None
possibility	சாத்தியம்	None
satan	சாத்தான்	None
simply	வெறுமனே	None
achievement	சாதனை	None
with the device	சாதனத்துடன்	None
items	விடயங்கள்	None
sanctuary	சரணாலயம்	None
appratus	சாதனங்களுக்கு	None
device	சாதனத்தின்	None
favourite	சாதகமான	None
advantage	பயன்படுத்திக்	None
witness	சாட்சி	None
soccer	சாக்கர்	None
cultivate	சாகுபடி	None
sagar	சாகர்	None
things	விஷயங்கள்	None
saraswathi, a god of education	சரசுவதி	None
item	சரக்கு	None
scianenidae a family fish name	சயீனைடீ	None
plain	சமவெளி	None
religions	மதங்கள்	None
occassions	சமயங்களில்	None
religious	மதக்	None
religion	மதம்	None
equalised	சமமான	None
equally	சமமாக	None
plains	சமவெளிகள்	None
equations	சமன்பாடுகள்	None
jains	சமணம்	None
jain	ஜெ	None
same level	சமச்சீர்	None
sanskrit	வடமொழி	None
same period	சமகால	None
japan	ஜப்பான்	None
sabash	சபாஷ்	None
equation	சமன்பாடு	None
in witness	சான்றாக	None
tomb	சமாதி	None
samarium	சமாரியம்	None
samhithai	சம்ஹிதை	None
incidents	சம்பவங்கள்	None
salary	சம்பளம்	None
connection	தொடர்பும்	None
related	தொடர்புள்ள	None
sampath	சம்பத்	None
samove	சமோவா	None
a tomp	சமாதிக்	None
cooking	சமையல்	None
kitchen	சமையலறை	None
social sciences	சமூகவியல்	None
communities: user communities and research communities	சமூகங்கள்	None
in the sea	சமுத்திரத்தில்	None
ocean	பெருங்கடல்	None
in society	சமூகங்களில்	None
to manage	தழுவி	None
in cooking	சமையலில்	None
chaplin	சாப்ளின்	None
sai	சாயி	None
slope	சாய்வு°	None
pregnant	சினை	None
cinema	சினிமா	None
indus valley	சிந்துவெளி	None
(sindhu) name of the river	சிந்து	None
think	சிந்தித்து	None
chinthamani	சிந்தாமணி	None
in the first tamil month	சித்திரை	None
logo	சின்னம்	None
drawings	வரைபடங்கள்	None
ideology	சித்தாந்தம்	None
siddantha	சித்தாந்த	None
sidha's	சித்தர்களின்	None
siddha	சித்தர்கள்	None
siddhars	சித்த	None
scattering	சிதறும்	None
chidambaram	சிதம்பரம்	None
aunt	சித்தி	None
singh a community	சிங்க்	None
cement	சிமெந்து	None
difficulties	சிரமம்	None
minorities	சிறுபான்மையினர்	None
shedual	சிறுபான்மை	None
urine	சிறுநீர்	None
kidney	சிறுநீரகம்	None
short story	சிறுகதை	None
small	சிறுசிறு	None
slightly more	சிறிதளவே	None
ali adopter	சியா	None
in smaller	சிறிதளவு	None
special	சிறப்புப்	None
best of	சிறப்பான	None
excelled	சிறந்து	None
best	மிகச்சிறந்த	None
wings	சிறகுகள்	None
veins	சிரை	None
syria	சிரியா	None
greatest	சிறப்புற்று	None
january	ஜனவரி	None
sinhalese	சிங்களவர்	None
lion	சிங்கம்	None
roads	சாலைகள்	None
road	வீதி	None
juice	சாறு	None
charles	சார்ல்ஸ்	None
function	விழாவில்	None
carpilat	சார்பிலாத்	None
towards	நோக்கிய	None
in the road	சாலையில்	None
independent	சுயேச்சை	None
depends	பொறுத்தது	None
commercial	சார்ந்த	None
sarcoma a cancer	சார்கோமா	None
wing	சாரி	None
non-	சாராத	None
out of	சாரா	None
extract	பெறுவதற்கு	None
dependent	சார்ந்தவை	None
sinhala	சிங்களம்	None
chalukyas	சாளுக்கியர்	None
astronomy	வானியல்	None
singapore	சிங்கப்பூர்	None
singapore's	சிங்கப்பூரின்	None
bagath singh	சிங்	None
small efects	சிக்குறும்	None
concentration	செறிவு	None
sikkim	சிக்கிம்	None
issues	விடயங்களை	None
chawla	சாவ்லா	None
complex	வளாகம்	None
honourable	சிகாமணி	None
chicago	சிக்காகோ	None
top	சிகரம்	None
fair	சிகப்பு	None
cia central intelligence agency	சிஐஏ	None
c++	சி++	None
c	சி	None
treatment	சிகிச்சைக்கு	None
some time	எப்போதாவது	None
domacaracy	குடியேற்ற	None
citizenship	குடியுரிமை	None
near to sea	கடலோரப்	None
sea shore	கடலோரத்தில்	None
groundnut	கடலை	None
cuddalore	கடலூர்	None
tigers	விடுதலைப்புலிகள்	None
sea birds	கடற்பறவை	None
navy	கடற்படையின்	None
seashore	கடற்கரையை	None
beach	கடற்கரையில்	None
sea	சீ	None
duties	கடமைகள்	None
right things	கடமைகளை	None
duty	கடமை	None
credit	கடன்	None
beyond	தாண்டிச்	None
overseas	கடல்கடந்த	None
gods	தேவர்கள்	None
kadaram	கடாரம்	None
bite	கடி	None
phase	படிநிலை	None
low	தாழ்	None
building	கட்டும்	None
buildings	கட்டிடங்கள்	None
architectural	கட்டடக்கலை	None
stages	நிலைகளை	None
in buildings	கட்டிடங்களில்	None
kidnap	கடத்தி	None
parties	கட்சிகள்	None
gadolinium	கடோலினியம்	None
lastly	கடைசிப்	None
severe	கடும்	None
difficult	பிரகடனம்	None
hard	கடின	None
watches	கடிகாரங்கள்	None
clock	கடிகாரம்	None
party	தரப்பு	None
passing through	கடத்தல்	None
paper	தாள்கள்	None
ghajini	கஜினி	None
runs	ஓட்டங்கள்	None
tile	ஓடு	None
hummingbird	ஓசனிச்சிட்டு	None
o,s	ஓஎஸ்	None
o	ஓ	None
each and every	ஒவ்வோர்	None
in desent	ஒழுங்கற்ற	None
flow	வருவதாலும்	None
discipline	துறையாகும்	None
optics	ஒளியியல்	None
broadcast	ஒளிபரப்பு	None
light	வெளிச்சம்	None
dutch	டச்சுக்	None
acoustics	ஒலியியல்	None
olympic	ஒலிம்பிக்	None
phonetics	ஒலிப்பியல்	None
abolish	ஒழிப்பு	None
kattabomman , a king in tamilnadu	கட்டபொம்மன்	None
ottoman	ஓட்டோமான்	None
oman	ஓமான்	None
crude	கச்சா	None
ganga	கங்கை	None
ka	க	None
avvaiyar	ஔவையார்	None
painting	ஓவியம்	None
painter	ஓவியர்	None
olmiyam	ஓல்மியம்	None
omar	ஓமர்	None
only one	மட்டில்	None
in a single place	ஓரிடத்தில்	None
isotope	ஓரிடத்தான்	None
horace	ஓராசு	None
to some extent	ஓரளவுக்கு	None
somewhat	ஓரளவு	None
rest	ஓய்வு	None
om	ஓம்	None
homosex	ஓரினச்சேர்க்கை	None
broadcasting	ஒலிபரப்புக்	None
built	கட்டிய	None
of the structure	கட்டமைப்பின்	None
found	பொருத்தமான	None
condemned	கண்டனம்	None
in the continet	கண்டத்தில்	None
continent	கண்டம்	None
continents	கண்டங்கள்	None
saw	சா	None
supervision	கண்காணிப்பு	None
monitoring	கண்காணித்தல்	None
to supervise	கண்காணிக்கும்	None
exhibition	கண்காட்சியாக	None
eyes	கண்கள்	None
eye	கண்ணுக்குப்	None
pancreas	கணையம்	None
a sect of animals	கணுக்காலி	None
calculation	கணிப்பு	None
goitre	கண்டமாகும்	None
invention	கண்டுபிடிப்புகள்	None
identify	கண்டறிந்து	None
detectors	கண்டறிந்துள்ளனர்	None
radiation	கதிர்வீச்சு	None
sun	சூரியன்	None
door	கதவு	None
tears	கண்ணீர்	None
s	களின்	None
glass	கிளாஸ்	None
kanna	கண்ணா	None
computer	கணிப்பொறி	None
kannan	கண்ணன்	None
kannagi	கண்ணகியை	None
to discover	கண்டுபிடித்து	None
discover	கண்டுபிடிக்கப்பட்டது	None
view	பார்வை	None
strictly	கண்டிப்பாக	None
kandy	கண்டி	None
find	காணவும்	None
kannadasan	கண்ணதாசன்	None
computers	கணினிகள்	None
maths	கணிதத்தில்	None
mathamates	கணிதத்தின்	None
bounded	கட்டுப்பட்டு	None
controlling	கட்டுப்படுத்தும்	None
controls	கட்டுப்படுத்துகிறது	None
controller	கட்டுப்படுத்தி	None
restrict	தடுப்பது	None
control	கட்டுப்பாட்டை	None
under control	கட்டுப்பாட்டு	None
rules	விதிமுறைகள்	None
constructed by	கட்டினார்	None
architecture	கட்டுமானம்	None
tumors	கட்டிகள்	None
tumor	கட்டி	None
mandatory	வசிக்கிறார்கள்	None
compulsory	கட்டாய	None
box	பெட்டி	None
structures	கட்டமைப்புகள்	None
architect	கட்டிடக்கலைஞர்கள்	None
constructed	கட்டப்பட்டு	None
in control	கட்டுப்பாட்டில்	None
feuilleton	கட்டுரைகளில்	None
mathematics	கணிதம்	None
sizeable	கணிசமான	None
to measure	கணிக்கும்	None
anterstant	கணிக்கப்படுகிறது	None
calculare	கணிக்க	None
pass	பாஸ்	None
husband	புருஷன்	None
construction	கட்டுமான	None
lord ganesha	விநாயகர்	None
counts	கணக்கில்	None
accounting	கணக்கெடுப்பு	None
calculated	கணிக்கப்பட்ட	None
calculate	கணக்கிட	None
countable	கணக்கான	None
essays	கட்டுரைகள்	None
compositions	கட்டுரைகளை	None
as per the census	கணக்கெடுப்பின்படி	None
sound testing	ஒலிச்சோதனை	None
sound	சத்தம்	None
single	தனியாள்	None
numerous	ஏராளமான	None
lavish	ஏராளமாக	None
sections	பிரிவுகள்	None
astronomical unit	ஏயூ	None
april	மாசி	None
api	ஏபிஐ	None
why	ஏன்	None
others	மற்றவர்கள்	None
because	காரணத்தினால்	None
athens	ஏதென்ஸ்	None
something	வித	None
dictatorial	ஏகாதிபத்திய	None
in world's information book(a)	ஏ	None
ss	எஸ்எஸ்	None
si unit	எஸ்எ	None
lake	ஏரியின்	None
lakes	லேக்ஸ்	None
a king of hebrew	ஏரோது	None
airtel	ஏர்டெல்	None
suitable	ஏற்றது	None
load	சுமை	None
to accept	ஏற்பு	None
arrangements	ஏற்பாடுகள்	None
organized	ஏற்பாடு	None
arise	ஏற்படுவது	None
cause	சமயத்தின்	None
s is the initial	எஸ்	None
caused	ஏற்படுவதால்	None
aftermath	பின்னரும்	None
occur	நிகழ்கின்றன	None
already	முன்பே	None
accept	நம்பப்பட்டது	None
assume	ஏறிய	None
to climb	ஏறி	None
approximately	தோராயமாக	None
occurs	ஏற்படுகின்றது	None
nobody	யாரும்	None
seventy	எழுபது	None
araised	எழுந்தன	None
elizabeth	எலிசபெத்	None
ant	எறும்பு	None
thrown	எறிந்த	None
erbium	எர்பியம்	None
earth	பூமியைச்	None
gas	வளி	None
volcano	எரிமலைச்	None
skeleton	எலும்புக்கூடு	None
volcano lava	எரிமலைக்குழம்பு	None
valcano	எரிமலையின்	None
fuel	எரிபொருள்	None
burning	எரியும்	None
aids	எய்ட்ஸ்	None
empire	பேரரசை	None
m.g.r	எம்ஜிஆர்	None
m.g.r's	எம்ஜிஆரின்	None
volcanoes	எரிமலைகள்	None
appropriately	துல்லியமாக	None
l	எல்	None
ellies	எல்லிஸ்	None
raised	வளர்த்த	None
writings	எழுத்துக்களில்	None
letters	எழுத்துக்களின்	None
letter	மடல்	None
writers	எழுத்தாளர்கள்	None
wrote	எழுதியுள்ளார்	None
writing	எழுதுவது	None
everything	எல்லாவற்றையும்	None
write	எழுதப்	None
simple	சுருக்கி	None
for all	எல்லோருக்கும்	None
within border	எல்லைக்குள்	None
borderline	எல்லைக்கு	None
boundaries	எல்லைகள்	None
borders	எல்லைகளாக	None
border	எல்லையை	None
rise	எழும்	None
accepted	ஏற்றுக்	None
to be accepted	ஏற்றுக்கொள்ளும்	None
export	ஏற்றுமதி	None
in comparison	ஒப்பிடுகையில்	None
uncomparable	ஒப்பற்ற	None
deeds	ஒப்பந்தங்கள்	None
contract	ஒப்பந்த	None
obaamaavin	ஒபாமாவின்	None
each one	ஒன்றையொன்று	None
nothing	பூச்சிய	None
compare	சார்புக்	None
with one	ஒன்றுடன்	None
in one	ஒன்றில்	None
from one	ஒன்றிலிருந்து	None
union	யூனியன்	None
one of the	ஒருவருடைய	None
one	ஒரேயொரு	None
together	சேர்ந்து	None
nine	ஒன்பது	None
one to one	ஒன்றுக்கொன்று	None
ninth	ஒன்பதாவது	None
compared to	ஒப்பிடும்போது	None
relatively	ஒப்பீட்டளவில்	None
unity	ஒற்றுமை	None
dot	புள்ளிக்	None
only	மாத்திரம்	None
in case of	ஒருவேளை	None
someone	ஒருவரை	None
each	ஒவ்வொருவரும்	None
one type	ஒருவகை	None
comparison	ஒப்பீட்டு	None
singular	ஒருமை	None
one day	ஒருநாள்	None
few	சற்றே	None
unicode	ஒருங்குறி	None
orunkiyam	ஒருங்கியம்	None
integrated	சங்கமம்	None
orissa	ஒரிசா	None
relative	ஒப்புமை	None
never	ஒருபோதும்	None
ray	கதிர்	None
agree	ஒத்து	None
similar	ஒத்தது	None
astrology	சோதிடம்	None
five thinai	ஐந்திணை	None
fifth	ஐந்தில்	None
five year	ஐந்தாண்டுத்	None
united nations	ஐநா	None
hyderabad	ஐதராபாத்	None
hydrogen	ஹைட்ரஜன்	None
for	ஐந்து	None
five small hundred	ஐங்குறுநூறு	None
i.e	ஐஇ	None
missiles	ஏவுகணைகள்	None
poor poeple	ஏழைகள்	None
poor	ஏழ்மை	None
seven	ஏழு	None
seventh	ஏழாவது	None
exports	ஏற்றுமதியில்	None
united	யுனைடெட்	None
like	விரும்பினால்	None
albert ienstin	ஐன்ஸ்டீனின்	None
ipod	ஐப்பாடு	None
common	பொதுவான	None
allotment	ஒதுக்கீடு	None
seperately	தனித்துவம்	None
allocated	ஒதுக்கப்பட்டது	None
the overall	ஒட்டுமொத்த	None
fully	முழுமையாக	None
having eagerness	ஒட்டிய	None
einstein	ஐன்ஸ்டைன்	None
oo! pronensiat	ஒ	None
european	ஐரோப்பியர்	None
in europe	ஐரோப்பாவில்	None
europe	ஐரோப்பாவிலும்	None
irish	ஐரிஷ்	None
iyer	ஐயர்	None
doubt	சந்தேகம்	None
fifty	ஐம்பது	None
ice	ஐஸ்	None
migrated	குடியேறினர்	None
rays	துருவ	None
story	கதையில்	None
during that period	காலப்பகுதியில்	None
stage	காலகட்டத்தில்	None
different periods	காலகட்டங்களில்	None
period	காலமாகும்	None
term	சொல்லே	None
air	விமானப்	None
in air	காற்றில்	None
wind	செல்கின்றன	None
carl	கார்ல்	None
karthick	கார்த்திக்	None
tamil month	கார்த்திகை	None
carcinoma	கார்சினோமா	None
karaikal	காரைக்கால்	None
factors	காரணிகள்	None
factor	காரணியாக	None
line	வரி	None
periods	காலங்கள்	None
old age	மரபினர்	None
climate	பருவநிலை	None
gaurds	காவலர்கள்	None
police	போலீஸ்	None
mushroom	காளான்	None
canal	கால்வாய்	None
football	கால்பந்து	None
veterinary	கால்நடை	None
legs	கால்கள்	None
is the reason	காரணமாகிறது	None
quarter	கால்	None
morning	பகல்	None
a time gap	காலவெளி	None
duration	காலம்	None
period and the	காலமும்	None
age	வயதுக்கு	None
in due course of time	காலப்போக்கில்	None
colony	காலனி	None
in the morning	காலையில்	None
reason	காரணமாகவே	None
for reasons	காரணங்களுக்காக	None
reasons	காரணங்களால்	None
lookup	காண்போம்	None
displayed	வைக்கப்பட்டுள்ள	None
seen	பாருங்கள்	None
see	பார்த்து	None
viewing	பார்ப்பது	None
missing	விடப்பட்ட	None
not seen	காணப்படவில்லை	None
lover	காதலி	None
observable	காணக்கூடிய	None
showing	தெரிவிக்கிறது	None
shows	நிகழ்ச்சிகளை	None
in the forest	காட்டில்	None
than	விடப்	None
indicator	காட்டி	None
shown	காட்டப்பட்டுள்ளது	None
television	தொலைக்காட்சி	None
cadmium	காட்மியம்	None
custody	காவல்	None
ear	காதை	None
kanthalur	காந்தளூர்ச்	None
fever	காய்ச்சல்	None
kai	காய்	None
injury	பாதித்த	None
comic	காமிக்	None
kamarasu	காமராசு	None
kamaraj	காமராசர்	None
commonwealth	பொதுநலவாய	None
magnetic	காந்தப்	None
patent right	காப்புரிமை	None
insurance	காப்பீடு	None
epic	காவிய	None
cancer	புற்றுநோய்க்கு	None
kan	கான்	None
gandhian	காந்தியின்	None
gandhi's	காந்தியடிகளின்	None
gandhi	காந்தியும்	None
backup	காப்பு	None
got	காட்	None
saffron	காவி	None
in the river cauvery	காவிரியின்	None
in bottom side	கீழேயே	None
down	கீழே	None
below	கீழ்வருமாறு	None
osteoarthritis	கீல்வாதம்	None
spinach	கீரை	None
holy book of hindu	கீதை	None
anthem	கீதம்	None
it is the family of fish	கீட்டோடொன்டைடீ	None
kilar	கிழார்	None
pottato	கிழங்கு	None
east	கிழக்கே	None
branches	கிளைகள்	None
branch	கிளை	None
kilinochi	கிளிநொச்சி	None
parrot	கிளி	None
upon	கீழைச்	None
the following	பின்வருவன	None
it is an ancient poet of tamil nadu	கீழ்க்கணக்கு	None
lower grade	கீழ்நிலை	None
houses	வீடுகள்	None
residence	குடியிருப்புகள்	None
immigrants	குடியேற்றவாசிகள்	None
president	குடியரசுத்	None
republic	குடியரசுக்	None
citizens	வம்சாவழித்	None
citison	குடிமக்களின்	None
revolution	புரட்சியை	None
drinking water	குடிநீர்	None
circles	குடிகள்	None
bay	விரிகுடா	None
goorg	குடகு	None
gujarati	குஜராத்தி	None
gujarat	குஜராத்	None
kungumam	குங்குமம்	None
cave	குகை	None
civilian	சிவிலியன்	None
club	கிளப்	None
kilo gram	கிலோ	None
christmas	கிறிஸ்துமஸ்	None
planets	கோள்கள்	None
planet	செவ்வாய்	None
cuba	கியூபா	None
kimp	கிம்ப்	None
b.c	கிமுல்	None
bc	கிமு	None
km	கிமீ	None
granth	கிரந்த	None
khmer	கெமர்	None
guinea-bissau	கினி-பிசாவு	None
guinea	கினி	None
scarcity	கிடைப்பருமை	None
kisa	கிசாவின்	None
christ	கிறிஸ்து	None
kashmir	காஷ்மீர்	None
with cauvery	காவிரியுடன்	None
b.c (before christ)	கிபி	None
cauvery	காவிரி	None
granada	கிரனாதா	None
village	கிராமம்	None
christopher	கிறிஸ்டோபர்	None
christians	கிறிஸ்தவர்கள்	None
christianity	கிறிஸ்தவம்	None
great	மிகுந்து	None
greeks	கிரேக்கர்கள்	None
greek	கிரேக்கம்	None
krishnamurthy	கிருஷ்ணமூர்த்தி	None
grand	கிராண்ட்	None
krishnan,	கிருஷ்ணன்	None
germ	கிருமி	None
krypton	கிருப்டான்	None
christian	கிறிஸ்துவ	None
greece	கிரேக்கத்	None
green	பச்சை	None
cricket	கிரிக்கெட்	None
villages	கிராமங்கள்	None
krishna	கிருஷ்ணா	None
forestry	காடுகள்	None
forests	காடுகளை	None
forest	வன	None
opinion	கருத்துப்படி	None
pregnancy	கருத்தரிப்பு	None
to think about	கருதுவது	None
to have that	கருதும்	None
hypothesis	கருதுகோள்	None
consider	கருதுகின்றனர்	None
considering	கருத்தில்	None
say	கூறுகிறார்கள்	None
think of	கருதப்பட்ட	None
considered	கருதிய	None
mercy	கருணை	None
karunanidhi	கருணாநிதி	None
abortion	கருத்தடை	None
sperm	விந்துப்	None
caribbean	கரீபியன்	None
theoretical	கோட்பாட்டு	None
comment	கருத்து	None
comments	கருத்துக்களையும்	None
opinions	கருத்தும்	None
coastal	கரையோரப்	None
shore	கரையை	None
karur	கரூர்	None
egg	முட்டை	None
tools	கருவிகளை	None
instrument	கருவிகளில்	None
specific part	கருவறை	None
carbon	கார்பன்	None
black tigers	கரும்புலிகள்	None
uterus	கருப்பை	None
black	பிளாக்	None
karnataka	கர்நாடகம்	None
intellectual things	கருத்தோட்டம்	None
idea	கருத்தை	None
conceptions	கருத்துருக்கள்	None
concept	கருத்துரு	None
sugarcane	கரும்பு	None
karikalan	கரிகாலன்	None
carangidae a fish family	கராங்கைடீ	None
karamchand	கரம்சந்த்	None
calf	கன்று	None
kanyakumari	கன்னியாகுமரி	None
virgin	கன்னி	None
kannada	கன்னடம்	None
kanimozhi a name	கனிமொழி	None
chemical	வேதியியற்	None
dreams	கனவுகள்	None
kabilar	கபிலர்	None
dream	கனவு	None
canadian	கனடிய	None
canada	கனடாவின்	None
heavy	கனரக	None
magnet	கந்தகம்	None
catholic	கத்தோலிக்கத்	None
stories	கதைகள்	None
in stories	கதைகளில்	None
volume	தொகுதி	None
carolina	கரோலினா	None
tribute	திறை	None
in the ship	கப்பலின்	None
bears	கரடிகள்	None
gayana	கயானா	None
communist	பொதுவுடமைக்	None
combodia	கம்போடியாவின்	None
cambodia	கம்போடியா	None
kampodia	கம்போடிய	None
wireless	கம்பியில்லா	None
naval force	கப்பற்படை	None
wire	கம்பி	None
kamban	கம்பன்	None
committee	குழுக்களாக	None
kamal hassan	கமல்ஹாசன்	None
pulley	கப்பி	None
ships	கப்பல்கள்	None
ships'	கப்பல்களின்	None
ship	கப்பல்	None
kambar	கம்பர்	None
in karnataka	கர்நாடகத்தில்	None
karma	கர்ம	None
gems	கற்கள்	None
caring	பற்று	None
focus	மையமாகக்	None
carefully	கவனமாக	None
attention	கவனத்தை	None
note	குறிப்பு	None
protective structure	கவச	None
collar	கழுத்துப்பட்டை	None
catching	பிடித்தல்	None
neck	கழுத்து	None
ditch water	கழிவுநீர்	None
waste	கழிவுகள்	None
later	பிற்காலப்	None
subtraction	கழித்தல்	None
corporation	மாநகரின்	None
league	லீக்	None
kallar a community in tamilnadu	கள்ளர்	None
eagle	கழுகு	None
weed	களை	None
attracted	கவர்ந்து	None
poet	மகாகவி	None
kancheepuram	காஞ்சிபுரம்	None
kangipuram	காஞ்சி	None
coin bar	காசுக்கட்டி	None
kasi a religious place in northern india	காசி	None
tuberculosis	காசநோய்	None
congo	கொங்கு	None
congress	நாடாளுமன்றம்	None
anxiety	கவலை	None
protect	பேணி	None
kaa	கா	None
musk	கஸ்தூரி	None
gounder	கவுண்டர்	None
poems	பாடல்களின்	None
poetry	செய்யுள்	None
poem	பரிபாடல்	None
poets	நாயனார்	None
save	சேமித்து	None
solstice	கதிர்த்திருப்பம்	None
field	புலம்	None
a type of caste	களப்பிரர்	None
california	கலிபோர்னியா	None
a period of destruction	கலி	None
in culture	பண்பாட்டில்	None
for culture	கலாச்சாரத்தின்	None
cultural	கலாச்சார	None
culture	வளர்ப்பு	None
composition	கலவை	None
arts	மரபுக்	None
mix	கலந்து	None
lighthouse	கலங்கரை	None
mixed	கலப்புப்	None
learner	கற்றார்	None
learning	பயிலும்	None
imaginary	கற்பனைக்	None
imagine	கற்பனை	None
to learn	கற்கும்	None
kalasam	கலசம்	None
in field	நின்றது	None
cultural terms	கலைச்சொற்கள்	None
art	கலையின்	None
repository	களஞ்சியம்	None
domains	களங்கள்	None
inscriptions	கல்வெட்டுக்கள்	None
inscription	கல்வெட்டுக்களில்	None
in the education also	கல்வியிலும்	None
education	கல்வியை	None
in college	கல்லூரியில்	None
artist	கலைஞர்கள்	None
colleges	கல்லூரிகள்	None
liver	நுரையீரல்	None
death place	கல்லறை	None
married	மணந்து	None
marriage or wedding	திருமண	None
janarlisum	கல்கி	None
calcutta	கல்கத்தாவின்	None
stone	கல்	None
college	வித்தியாலயம்	None
right direction	→	None
