dollar	dollár	None
not a stand alone word (nevezi ki=nominate)	nevezi	None
education	oktatási	None
names	nevek	None
names of sy/sg	nevei	None
neumann	neumann	None
internationally	nemzetközileg	None
nationalities	nemzetiségek	None
nationality	nemzetiségű	None
national assembly	nemzetgyűlés	None
nations	nemzetek	None
nation	nemzet	None
non-metals	nemfémek	None
nobility	nemesség	None
nobles	nemesek	None
not only	nemcsak	None
no	sincs	None
nelson	nelson	None
for him/her	neki	None
difficulties	nehézségek	None
name (verb)	nevezni	None
lest	nehogy	None
neville	neville	None
from the name of sy	nevéből	None
nomad	nomád	None
nobel prize winner	nobeldíjas	None
nobel prize	nobeldíjat	None
nob	nob	None
nixon	nixon	None
nirvana	nirvana	None
niro	niro	None
are no	nincsenek	None
have not	nincsen	None
nikola	nikola	None
night	éjszaka	None
nietzsche	nietzsche	None
nicholas	nicolas	None
nick	nick	None
newton	newton	None
their names	nevüket	None
with its/his/her name	nevével	None
known as	nevén	None
to the name	nevéhez	None
in the name of sy/sg	nevében	None
forty	negyven	None
fourth	negyedik	None
in the quarter-finals	negyeddöntőben	None
days	napok	None
daily	naponta	None
solstice	napforduló	None
sunspots	napfoltok	None
solar eclipse	napfogyatkozás	None
day	naptól	None
cities	városokban	None
oradea	nagyváradon	None
nagyvárad	nagyvárad	None
numerous	sorát	None
magnificent	nagyszerű	None
highly	nagyra	None
bigger	nagyobb	None
greatly	nagymértékben	None
big sized	nagyméretű	None
big audience	nagyközönség	None
roughly	nagyjából	None
great power	nagyhatalom	None
great powers	nagyhatalmak	None
daily newspaper	napilap	None
sun god	napisten	None
diary	naplója	None
in days	napokban	None
quarterfinal	negyeddöntő	None
quarter	negyed	None
negative	negatív	None
wet	vizes	None
east germany	ndk	None
abbravieation of "national championship"	nb	None
(italian word) nazionale	nazionale	None
nato	nato	None
national	országos	None
norman	norman	None
nasa	nasa	None
orange	narancs	None
napoleonic	napóleoni	None
napoleon	napóleon	None
calendar	naptár	None
solar wind	napszél	None
solar system	naprendszerben	None
living room	nappali	None
sunny	napos	None
on a day	napon	None
naruto	naruto	None
intense	nagyfokú	None
normal	rendes	None
norway	norvégia	None
german roman	németrómai	None
in germany	németországban	None
germany	németországnak	None
nemeth	németh	None
germans	németeket	None
without	nélküli	None
somewhere	valahol	None
four times	négyszer	None
four	négyes	None
neapolitan	nápolyi	None
nandor	nándor	None
with him	vele	None
palatine	választófejedelem	None
nazis	nácik	None
nazi	náci	None
goes back	nyúlik	None
rabbit	nyúl	None
openly	nyíltan	None
summer	nyáron	None
in german	németül	None
sedative	nyugtató	None
slightly	valamivel	None
ethnic group	népcsoport	None
view	véve	None
look	tekint	None
nameless	névtelen	None
pronoun	névmás	None
folk music	népzene	None
barbarian migration	népvándorlás	None
population density	népsűrűség	None
census	népszámlálási	None
popularity	népszerűségét	None
popular	populáris	None
referendum	népszavazás	None
ethnographic	néprajzi	None
ethnography	néprajz	None
people's party	néppárt	None
people's republic	népköztársaság	None
folksy	népies	None
folk	népi	None
population growth	népességnövekedés	None
commons	népek	None
aunt	néni	None
rests	nyugszik	None
calm	nyugodt	None
western	nyugati	None
win	nyerni	None
in the language of	nyelvén	None
with language	nyelvvel	None
dialects	nyelvjárások	None
dialect	nyelvjárás	None
lingual	nyelvi	None
languages	nyelveket	None
language family	nyelvcsalád	None
language	nyelvre	None
neck	nyak	None
new york	ny	None
zero	nulla	None
nuclear	nukleáris	None
nr.	nr	None
in november	novemberben	None
november	november	None
short story	novella	None
nova	nova	None
nostradamus	nostradamus	None
wins	nyeri	None
raw	nyers	None
raw materials	nyersanyagok	None
statement	nyilatkozata	None
west european	nyugateurópai	None
west europe	nyugateurópa	None
west	west	None
pressure	nyomására	None
in print	nyomtatásban	None
printing	nyomtatás	None
printed	nyomtatott	None
detective	nyomozó	None
investigation	vizsgálatot	None
norwegian	norvég	None
press	sajtó	None
trace	nyoma	None
eighties	nyolcvanas	None
eighth	nyolcadik	None
pre-quarter final	nyolcaddöntő	None
eight	viii	None
open	open	None
declared	vallott	None
obvious	nyilvánvaló	None
publicly	nyilvánosan	None
traces of	nyomait	None
grand prix / prize	nagydíjat	None
grand prix	nagydíjon	None
great britain	nagybritanniában	None
motion picture	mozifilm	None
cinema	mozi	None
moving	mozgó	None
motion	mozgását	None
move	mozog	None
movement	mozgalom	None
movements	mozgások	None
locomotives	mozdonyok	None
mozart	mozart	None
mount	mount	None
motor	motoros	None
engines	motorok	None
motorcycling	motorkerékpározás	None
engine	motor	None
moscow	moszkvában	None
washes	mos	None
moravian	morvai	None
morse	morse	None
morrison	morrison	None
in cinemas	mozikban	None
morgan	morgan	None
mozilla	mozilla	None
mrs	mrs	None
music	zenét	None
museum	múzeumban	None
museo	museo	None
job	állást	None
his work	művét	None
labour party	munkáspárt	None
worker	munkás	None
task, work	munkáját	None
works of	műveit	None
works	műveket	None
munkácsy	munkácsy	None
staff	állomány	None
holiday	ünnep	None
unemployment	munkanélküliség	None
labor	munkaerő	None
multinational	multinacionális	None
mtv	mtv	None
mta	mta	None
mszp	mszp	None
mr	mr	None
moore	moore	None
monumental	nagyszabású	None
monty	monty	None
mode	mód	None
marshy	mocsaras	None
after which	miután	None
mythological	mitológiai	None
mythology	mitológiában	None
mystic	misztikus	None
miskolc	miskolcon	None
mass	mise	None
be qualified as	minősül	None
quality	színvonalú	None
qualitative	minőségi	None
quality of	minősége	None
model	modellt	None
rather than	minthogy	None
as if	mintha	None
ministry	minisztérium	None
prime minister	miniszterelnöki	None
ministers	miniszterek	None
minister	miniszter	None
models	modellek	None
mohammed	mohamed	None
mohacs	mohácsi	None
moldova	moldovai	None
montgomery	montgomery	None
montenegro	montenegró	None
monte	monte	None
monk	szerzetes	None
monica	monica	None
mongols	mongolok	None
mongolian	mongol	None
saying	szóló	None
they said	mondták	None
musical	zenés	None
says	vallja	None
to say	mondani	None
monarchy	monarchia	None
monaco	monacói	None
mona	mona	None
my	mon	None
molybdenum	molibdén	None
molecular	molekuláris	None
molecules	molekulák	None
moldavian	moldvai	None
sentence	mondat	None
mussolini	mussolini	None
muslim	muzulmán	None
muslims	muszlimok	None
genre	műfaja	None
monuments	műemlékei	None
plant	növény	None
plastic	műanyag	None
munich	müncheni	None
müller	müller	None
museums	múzeumok	None
behind	mögötti	None
moses	mózes	None
moricz	móricz	None
móra	móra	None
mór	mór	None
methods	módszert	None
method	módszere	None
modified	módosított	None
mézga	mézga	None
meter	méter	None
butcher	mészáros	None
massacre	mészárlás	None
workshop	műhely	None
operate	működnek	None
functional	működési	None
technical	technikai	None
considerably	nagyban	None
large-scale	nagyarányú	None
grandfather	nagyapja	None
grandmotherly	nagyanyai	None
large	nagy	None
nationalism	nacionalizmus	None
nationalist	nacionalista	None
nacional	nacional	None
n	n	None
limestone	mészkő	None
arts education	művészetoktatási	None
art of	művészete	None
artists	művészek	None
artist	művész	None
literary work	művet	None
educated	művelt	None
(oh his) works	műveinek	None
from his works	műveiből	None
in sy's works	műveiben	None
work of	műve	None
artistic	művészi	None
views	nézetek	None
measurements	mérések	None
moderate	mérsékelt	None
another	másik	None
elsewhere	máshol	None
one and a half	másfél	None
márta	márta	None
márquez	márquez	None
in march	márciusban	None
márai	márai	None
for today	mára	None
manic	mániás	None
maltese	máltai	None
malta	málta	None
in may	májusban	None
liver	máj	None
magnetic	mágneses	None
magical	mágikus	None
mutation	mutáció	None
indicator	mutató	None
to show	mutatni	None
there is	mutatkozik	None
at other times	máskor	None
the next day	másnap	None
second	másodperc	None
secondary	szekunder	None
engineer	mérnök	None
matches	mérkőzések	None
toxic	mérgező	None
elapidae	mérgessiklófélék	None
sized	méretű	None
size of	méretét	None
size	mérete	None
deeper	mélyebb	None
worthy	méltó	None
extent	mértékben	None
not	ne	None
still	mégis	None
even	páros	None
media	médiában	None
mav	máv	None
mate	máté	None
matthias	mátyás	None
matrix	mátrix	None
on the other hand	másrészt	None
secondly	másodszor	None
namely	ugyanis	None
facing	néző	None
viewers	nézők	None
nile	nílus	None
barren	puszta	None
puskás	puskás	None
punk	punk	None
puerto	puerto	None
psychotic	pszichotikus	None
psychological	pszichológiai	None
psychedelic	pszichedelikus	None
prose	prózai	None
prophet	próféta	None
try	próbálják	None
prague	prágában	None
protists	protiszták	None
protestant	protestáns	None
prost	prost	None
propylene	propilén	None
propaganda	propaganda	None
project	projekt	None
progressive	progresszív	None
programming	programozási	None
merely	pusztán	None
programs	programokat	None
devastating	pusztító	None
station	állomása	None
spider	pók	None
financial	pénzügyi	None
money	pénzt	None
for example	például	None
examples	példák	None
example	példája	None
pecs	pécsi	None
pécs	pécs	None
parties	pártok	None
party of sy/sg	pártja	None
parisian	párizsi	None
parallel	párhuzamosan	None
unmatched	páratlan	None
papal	pápai	None
pope	pápát	None
panic	pánik	None
armored	páncélos	None
path	útnak	None
career of	pályáját	None
brandy	pálinka	None
programmes	programok	None
program	programot	None
professor	tanára	None
ponte	ponte	None
point	pontján	None
pompeius	pompeius	None
politicians	politikusok	None
politician	politikus	None
politically	politikailag	None
political	politikai	None
policy	rendje	None
polysaccharide	poliszacharid	None
citizens	polgárok	None
mayor	polgármester	None
civil war	polgárháború	None
citizen	állampolgár	None
pole	pole	None
hell	pokol	None
pagan	pogány	None
poe	poe	None
plus	plusz	None
plato	platón	None
points	utal	None
on a point	ponton	None
exactly	pontosan	None
pop	pop	None
producers	produceri	None
producer	producere	None
with problems	problémákkal	None
problems	problémákat	None
problem	problémát	None
pro	pro	None
premiere	premier	None
in bratislava	pozsonyban	None
pozsony	pozsony	None
spiders	pókok	None
positive	pozitív	None
posthumous	posztumusz	None
bumble bee	poszméh	None
portal	portál	None
portugal	portugália	None
portuguese	portugál	None
porto	porto	None
porta	porta	None
prussian	porosz	None
dust	por	None
potlatch	potlach	None
bishop	püspök	None
episcopal	püspöki	None
q	q	None
regime	rendszerváltás	None
regularly	rendszeresen	None
systematic	rendszeres	None
systems	rendszerek	None
system	rendszerű	None
extraordinary	rendkívüli	None
excessively	rendkívül	None
irregular	rendhagyó	None
ranks	rendfokozatok	None
sort of	rendezésében	None
settlement	települést	None
organized	szerveztek	None
orderly	rendezett	None
usually	általában	None
incosnsistent examples (rendek=city name - rendek=orders	rendek	None
order	sorrend	None
renault	renault	None
hope	remény	None
remix	remix	None
policeman	rendőr	None
police	rendőrök	None
renaissance	reneszánsz	None
a lot of	rengeteg	None
more infrequently	ritkábban	None
rare	ritkák	None
rita	rita	None
rio	rio	None
rihanna	rihanna	None
right|thumb|px|a	right|thumb|px|a	None
richter magnitude scale	richterskála	None
richards	richards	None
richard	richárd	None
exquisite	remek	None
ricardo	ricardo	None
rex	rex	None
return	visszatérése	None
airport	repülőtér	None
airports	repülőterek	None
aircraft	repülőgép	None
flying	repülő	None
flight	repülés	None
rheology	reológia	None
rené	rené	None
resonance	rezonancia	None
ex.	pl	None
rembrandt	rembrandt	None
theory of relativity	relativitáselmélet	None
rammstein	rammstein	None
missile	rakéta	None
sketch	rajza	None
at the strat	rajtnál	None
fans	szurkolók	None
fan	rajongói	None
rhine	rajna	None
raid	raid	None
clung	ragaszkodott	None
carnivores	ragadozók	None
rafael	rafael	None
radnóti	radnóti	None
radioactive	radioaktív	None
radio	rádióban	None
radical	radikális	None
rational	racionális	None
rachel	rachel	None
slaves	rabszolgák	None
r	r	None
randy	randy	None
rank	rangra	None
ranking	rangú	None
ray	ray	None
mysterious	titokzatos	None
mystery	rejtély	None
hidden	rejtett	None
reise	reise	None
novels	regények	None
novel	újszerű	None
registered	regisztrált	None
regional	területi	None
regina	regina	None
relative	viszonylagos	None
reggae	reggae	None
reformation	reformáció	None
reforms	reformokat	None
reform era	reformkor	None
reform	reform	None
realism	realizmus	None
realist	realista	None
reactor	reaktor	None
reaction	reakció	None
raúl	raúl	None
reformed	református	None
minimum	minimális	None
pius	piusz	None
dirty	piszkos	None
countries	országokból	None
ursula	orsolya	None
nose bleeding	orrvérzés	None
russia	oroszországi	None
russians	oroszok	None
lions	oroszlánok	None
lion	oroszlán	None
russian	orosz	None
orlando	orlando	None
orbán	orbán	None
oratory	oratórium	None
opus	opus	None
optical	optikai	None
operas of sy/sg	operái	None
operational	operációs	None
opera house	operaház	None
opera	operát	None
on the australian open	openen	None
from there	onnan	None
parliament	parlamentben	None
oneil	oneil	None
parliamentary	parlamentáris	None
throughout	országszerte	None
abandon	otthagyta	None
austrians	osztrákok	None
austro-hungarian	osztrákmagyar	None
austrian	osztrák	None
shares	osztja	None
divide	osztható	None
ottoman	oszmán	None
pillar	oszlop	None
the siege	ostroma	None
siege	ostrom	None
osiris	osiris	None
oscar awards	oscardíjat	None
oscar award	oscardíj	None
oscar	oszkár	None
ancestor	őse	None
oral	orális	None
doctors	orvosok	None
medical	orvosi	None
orthodox	ortodox	None
country house	országház	None
so much so that	olyannyira	None
so	úgyhogy	None
readers	olvasók	None
odysseus	odüsszeusz	None
out there	odaát	None
oceanic	óceáni	None
objects	égitestek	None
object	tárgya	None
obama	obama	None
sy's sister	nővére	None
grew	nőtte	None
grow	nőnek	None
female	nőstény	None
gynecological	nőgyógyászati	None
vegetation	vegetáció	None
vegetable	zöldség	None
plants	növények	None
improving	növelése	None
increase	növelik	None
growing	növekvő	None
growth	növekedési	None
nóra	nóra	None
reason	oka	None
causes	okozza	None
reasons	okokból	None
caused	okoztak	None
reader	olvasó	None
read	olvasta	None
readable	olvasható	None
melted	olvadt	None
vaccination	oltás	None
oliver	oliver	None
olympics	olimpiát	None
olympic	olimpiai	None
olympia	olimpia	None
at home	otthon	None
olga	olga	None
on the pages of sg	oldalain	None
side	side	None
cheap	olcsó	None
in italian	olaszul	None
italians	olaszok	None
oil	olaj	None
in october	októberben	None
october	október	None
causing	okozó	None
from the side	oldalról	None
otto	ottó	None
overdose	overdose	None
oxford	oxford	None
peruvian	perui	None
peru	peru	None
of course	persze	None
perry	perry	None
periodic	periódusos	None
periphery	periféria	None
minute	perc	None
lawsuit	per	None
beijing	pekingi	None
in turn	pedig	None
pearl	pearl	None
pc	pc	None
pawnees	paunik	None
paulo	paulo	None
pauline	paulina	None
paula	paula	None
paul	pál	None
patrick	patrick	None
pataky	pataky	None
persian	perzsa	None
persians	perzsák	None
pest	pesti	None
plague	pestis	None
red	vörös	None
piramids	piramisok	None
english word	select	None
pink	rózsaszín	None
pilots	pilóták	None
pilot	pilóta	None
in the moment of	pillanatában	None
in a moment	pillanatban	None
pietro	pietro	None
creek	patak	None
picchu	picchu	None
piazza	piazza	None
pi	pi	None
phoebe	phoebe	None
philip	philipposz	None
phil	phil	None
phi	phi	None
petöfi	petőfi	None
peter	péter	None
pete	pete	None
picasso	picasso	None
python	python	None
hoof	pata	None
pascal	pascal	None
pannonius	pannonius	None
pannon	pannon	None
palaces	paloták	None
palace	palotája	None
pallas	pallas	None
palin	palin	None
palestine	palesztina	None
palestinian	palesztin	None
paleo-indians	paleoindiánok	None
palazzo	palazzo	None
palaestra	palaisztra	None
pakistan	pakisztán	None
ruff	pajzsoscankó	None
shield	pajzs	None
paice	paice	None
pacino	pacino	None
pablo	pablo	None
p	p	None
oxygen	oxigén	None
panthera	panthera	None
paolo	paolo	None
priest	pap	None
priestly	papi	None
on the bank	partra	None
on the shore	parton	None
partners	partnerek	None
partner	társa	None
on its shore	partján	None
coast	tengerpart	None
coastal	tengerparti	None
parks	parkok	None
parker	parker	None
passive	passzív	None
park	parkot	None
italian word	pietà	None
peasantry	parasztság	None
peasants	parasztok	None
commander	parancsnoki	None
command	parancsára	None
parallelogram	paralelogramma	None
tomato	paradicsom	None
papp	papp	None
clericals	papok	None
paris	párizsban	None
all the time	mindvégig	None
until now	mindmáig	None
both	mindkét	None
at least	legalábbis	None
lowest	legalacsonyabb	None
lee	lee	None
league	ligájában	None
cf.	vö	None
loose	laza	None
lawrence	lőrinc	None
latinovits	latinovits	None
latin	latinul	None
slow	lassú	None
slowly	lassan	None
las	las	None
larry	larry	None
paper	papírra	None
flat	sík	None
pages	oldalak	None
page	oldalon	None
lane	lane	None
land	szárazföldön	None
easiest	legegyszerűbb	None
lamdacism	lambdacizmus	None
most widespread	legelterjedtebb	None
legend of sy/sg	legendája	None
least	legkisebb	None
most	többsége	None
best-known	legismertebb	None
eldest	legidősebb	None
longest	leghosszabb	None
fastest	leggyorsabban	None
most often	leggyakrabban	None
most common	leggyakoribb	None
richest	leggazdagabb	None
chief	legfőbb	None
most important	legjelentősebbek	None
youngest	legfiatalabb	None
supreme	legfelsőbb	None
at most	legfeljebb	None
most advanced	legfejlettebb	None
strongest	legerősebb	None
most succesful	legeredményesebb	None
legendary	legendás	None
legends	legendák	None
legend	legenda	None
housing estate	lakótelep	None
living	lakó	None
apartment	lakást	None
secretary of state	külügyminiszter	None
particularly	különösen	None
separate	különálló	None
special	speciális	None
various	különféle	None
separately	külön	None
outwardly	külsőleg	None
external	külső	None
foreign policy	külpolitikai	None
foreign trade	külkereskedelmi	None
abroad	külföldön	None
mission	küldetés	None
cone	kúp	None
among them	közülük	None
of	szerinti	None
public (road)	közúti	None
communal	közösségi	None
communities	közösségek	None
audience	közönség	None
sarraceniaceae	kürtvirágfélék	None
struggle	küzdelem	None
stone	stone	None
petroleum	kőolaj	None
lived	éltek	None
inhabited	lakta	None
population	populáció	None
residents	lakói	None
inhabitant	lakos	None
lake	tó	None
uninhabited	lakatlan	None
louis	louis	None
lorisidae	lajhármakifélék	None
the most excellent	legkiválóbb	None
lagoon	lagúna	None
football team	labdarúgóválogatott	None
football association	labdarúgószövetség	None
football cup	labdarúgókupa	None
footballers	labdarúgói	None
footballer	labdarúgó	None
la	la	None
l	l	None
rocks	kőzetekből	None
kőrösi	kőrösi	None
lago	lago	None
earliest	legkorábbi	None
nearest	legközelebbi	None
the highest	legmagasabb	None
lexicon	lexikona	None
lewis	lewis	None
archives	levéltár	None
in a letter	levélben	None
(in her/his) letter	levelében	None
write	írni	None
letters of	levelei	None
airborne	levegőben	None
latvia	lettország	None
became	lettek	None
arrested	letartóztatták	None
being	élőlény	None
descendant of sy	leszármazottja	None
descendants	leszármazottai	None
landing	partraszállás	None
will be	válnak	None
les	les	None
leopold	lipót	None
leonardo	leonardo	None
closing	záró	None
daughter	lányát	None
written	íródott	None
description	leírása	None
list	listát	None
lisa	lisa	None
leipzig	lipcsében	None
linux	linux	None
linkin	linkin	None
link collection	linkgyűjtemény	None
links	linkek	None
linear	lineáris	None
line	vonalán	None
leonard	leonard	None
lindemann	lindemann	None
lincoln	lincoln	None
lily	lily	None
purple	purple	None
liqueur	likőr	None
life	életét	None
liechtenstein	liechtensteini	None
liberal	liberális	None
liberalism	liberalizmus	None
descriptive	leíró	None
linda	linda	None
told	közölte	None
leo	leó	None
lennon	lennon	None
northernmost	legészakibb	None
most valuable	legértékesebb	None
crew	stáb	None
defeated	vesztes	None
beat	út	None
be	tehető	None
last	utolsó	None
latest	legutolsó	None
the most	legtöbbet	None
most of them	többségük	None
most densely	legsűrűbben	None
the most beutiful	legszebb	None
successful	sikerű	None
oldest	legrégibb	None
worst	legsúlyosabb	None
the most populous	legnépszerűbb	None
most populous	legnépesebb	None
biggest	legnagyobbak	None
the deepest	legmélyebb	None
newest	legújabb	None
most ancient	legősibb	None
can be	mondható	None
may	május	None
would be	volna	None
lenin	lenin	None
poland	lengyelországban	None
poles	lengyelek	None
polish	lengyel	None
resignation	lemondását	None
resigned	lemondott	None
resign	lemond	None
disc	lemezt	None
would	szeretne	None
disk	lemezen	None
enthusiastic	lelkes	None
souls	lelkek	None
soul	lélek	None
findings	álláspontja	None
find	találunk	None
possibilities	lehetőségek	None
possibility	lehetőség	None
possible	lehető	None
impossible	lehetetlenné	None
spiritual	lelki	None
lists	listák	None
to the center	középre|px	None
medieval	középkori	None
later	utóbb	None
preparing	készülő	None
prepare	készül	None
making	tétele	None
produced	termelt	None
make	végez	None
incline	késztette	None
ready	készen	None
late	későn	None
on the request of	kérésére	None
asked	érdeklődött	None
kéri	kéri	None
crust	kéreg	None
questions	kérdéseket	None
question of sg	kérdése	None
in question	kérdéses	None
question	kérdést	None
ask	kér	None
visual arts	képzőművészetek	None
there are two	kétféle	None
arts	művészetek	None
bicameral	kétkamarás	None
twice the	kétszeres	None
than	mintsem	None
outside	kívül	None
required	szükséges	None
wish	kívánja	None
accompanied	kísérte	None
experimental	kísérleti	None
experiments	kísérletek	None
attempt	kísérlete	None
experiment	kísérletet	None
accompanied by	kíséretében	None
chinese	kínaiak	None
china	kínában	None
echium	kígyószisz	None
snake	kígyó	None
with hand	kézzel	None
handball	kézilabda	None
undoubtedly	kétségtelenül	None
doubt	kétségbe	None
two hundred	kétszáz	None
twice	kétszer	None
representatives	képviselők	None
chamber of deputies	képviselőház	None
representative	ábrázoló	None
chapel	kápolna	None
khan	kán	None
kama sutra	kámaszútra	None
calvin	kálvin	None
kálmán	kálmán	None
kadar	kádár	None
kyle	kyle	None
dogs	kutyák	None
researcher	kutatók	None
research	kutatások	None
kuruc	kurucok	None
kurt	kurt	None
kuroszaki	kuroszaki	None
kun	kun	None
cultures	kultúrák	None
culture	kultúrát	None
cult	kultusza	None
cultural	művelődési	None
ticks	kullancsok	None
károlyi	károlyi	None
harmful	káros	None
carpatian	kárpáti	None
carpathian basin	kárpátmedencében	None
picture gallery	képtár	None
unable	képtelen	None
graphical	képi	None
represented	viselte	None
compared	viszonyítva	None
capacity	képességű	None
capabilities	képességeit	None
ability	képessége	None
on the picture	képen	None
from outside	kívülről	None
pictures	pictures	None
were forced to	kénytelen	None
forced to	kénytelenek	None
forced	kényszerítették	None
chemical	vegyi	None
chemistry	kémia	None
blue	kék	None
coffee	kávé	None
card	kártya	None
carpathians	kárpátok	None
picture	képét	None
code	kód	None
hospital	kórházba	None
in hospital	kórházban	None
from its middle	közepétől	None
in the middle	középen	None
to the middle	közepére	None
medium	közepes	None
near	közelében	None
middle east	közelkeleti	None
forthcoming	közelgő	None
closer	közelebb	None
close	szorosan	None
to do	tenni	None
during	közepette	None
public	public	None
followers	követői	None
follower	követő	None
following	nyomán	None
followed	követték	None
as a consequence of	következményeként	None
consequences of sg	következményei	None
effect of	következménye	None
general assembly	közgyűlés	None
public administration	közigazgatás	None
administratively	közigazgatásilag	None
well-known	közismert	None
middle ages	középkor	None
median temperature	középhőmérséklet	None
central europe	középeurópai	None
middle	középső	None
public opinion	közvélemény	None
directly	közvetlenül	None
indirect	közvetett	None
republican	republikánus	None
republic	köztársaságot	None
came after	következett	None
in common knowledge	köztudatban	None
community	közössége	None
with the cooperation/assistance of	közreműködésével	None
centralized	központosított	None
hub	központjává	None
headquarters	székhelye	None
central	központi	None
communicate	közli	None
traffic of	közlekedése	None
transport	közlekedés	None
between	között	None
at the centre of	középpontjában	None
follows	következőképpen	None
demanded	követelte	None
in a library	könyvtárban	None
libraries	könyvtárak	None
library	library	None
pop music	könnyűzenei	None
easy	könnyű	None
with ease	könnyedén	None
poets	költők	None
poetic	költői	None
poet	költőt	None
poetry	verseket	None
budget	költségvetési	None
costs	költségek	None
poems	versek	None
poem	versét	None
spend	töltött	None
mutual	kölcsönös	None
rental	kölcsönző	None
interaction	kölcsönhatás	None
kolcsey	kölcsey	None
coat	köpeny	None
around	táján	None
circle	köre	None
environment	környezetvédelmi	None
follow	nyomon	None
stones	stones	None
concluded	következtetni	None
tied	kötötte	None
volume	kötetet	None
bound	kötődő	None
bind	köt	None
owing to	köszönhetően	None
thanks	köszönhető	None
followed by	nyomában	None
due to the	köszönheti	None
boulevard	körút	None
circles	körökben	None
among	közé	None
area	területű	None
neighborhood	szomszédságában	None
surrounding	körülvevő	None
surroundings	környékét	None
environmental protection	környezetvédelem	None
environmental	környezeti	None
comprehensive	összefoglaló	None
rarely	ritkán	None
flour	liszt	None
lithuania	litvánia	None
ceases	megszűnik	None
cessation of	megszüntetése	None
abolished	megszüntették	None
was born	megszületett	None
occupied by	megszállták	None
acquiring	megszerzése	None
earned	megszerezte	None
interrupted	megszakadt	None
destroyed	megsemmisült	None
deteriorated	megromlott	None
held	tartották	None
tried to	megpróbálták	None
tried	próbálták	None
try to	megpróbálja	None
shared	megosztotta	None
divided	tagolt	None
distribution	megoszlása	None
solving	megoldása	None
solution	oldat	None
ended	zárult	None
to solve	megoldani	None
termination	megszűnése	None
injured	sérült	None
sy's/sg's estimation	megítélése	None
wrote	írták	None
arrived	érkeztek	None
county seat	megyeszékhely	None
county	vármegye	None
protect	védelmében	None
changed	változtatta	None
change	változást	None
elected	választották	None
has	rendelkezik	None
to realize	megvalósítani	None
attacked	támadták	None
find out	rájön	None
forbade	megtiltotta	None
creation of	megteremtése	None
retained	megtartották	None
to find	találni	None
found	találták	None
refused	visszautasította	None
violation of	megsértése	None
grown	növekedett	None
opened	megnyílt	None
denomination	megnevezés	None
observer	megfigyelő	None
observations	megfigyelések	None
observation of	megfigyelése	None
equivalent of sy/sg	megfelelője	None
compliance	megfelel	None
allowed	megengedett	None
preceding	megelőző	None
ahead	megelőzve	None
the same	ugyanezt	None
are identical	megegyeznek	None
correspond with	megegyezik	None
on the behalf of	megbízásából	None
commissioned	megbízást	None
reliable	megbízható	None
failed	megbukott	None
ill	megbetegedett	None
hinder	megakadályozni	None
tardigrade	medveállatkák	None
bear	szül	None
weakened	meggyengült	None
drive	vezetni	None
surpasses	meghaladja	None
exceeded	meghaladta	None
showed	mutatta	None
visiting	meglátogatta	None
surprising	meglepő	None
distinguish	megkülönböztetünk	None
approach	megközelítés	None
tryed	megkísérelte	None
he asked	megkérte	None
appearing	megjelenő	None
appearance	megjelenését	None
kills	megöli	None
remark	megjegyzés	None
becoming acquainted with	megismerése	None
acquaintance	megismerés	None
got acquinted  (with sy)	megismerkedett	None
determining	meghatározó	None
allocation of	meghatározása	None
define	meghatározza	None
specified	meghatározott	None
to determine	meghatározni	None
definable	meghatározható	None
to remark	megjegyezni	None
mek	mek	None
meclizine	meklizin	None
warm	meleg	None
miller	molnár	None
millennium	millenniumi	None
milan	milánóban	None
mikszáth	mikszáth	None
miksa	miksa	None
miguel	miguel	None
microsoft	microsoft	None
mick	mick	None
michelle	michelle	None
michelangelo	michelangelo	None
michel	michel	None
michael	miklós	None
miami	miami	None
while	míg	None
we	mi	None
mh	mh	None
outfield	mezőny	None
agricultural	mezőgazdasági	None
agriculture	mezőgazdaság	None
million	millió	None
what kind	milyen	None
milanese	milánói	None
all	összes	None
moreover	sőt	None
always	mindig	None
all three	mindhárom	None
all these	mindezek	None
all of this	mindez	None
everything	mindent	None
everyday	mindennapi	None
definitely	mindenképpen	None
all-time	mindenkori	None
field	mező	None
everyone	mindenkit	None
everybody	mindenki	None
everywhere	mindenütt	None
all sorts of	mindenféle	None
in any case	mindenesetre	None
first of all	mindenekelőtt	None
all of them	mindegyikük	None
each	mindegyike	None
nevertheless	mindazonáltal	None
as long	mindaddig	None
for everyone	mindenkinek	None
median	medián	None
naked	meztelen	None
meyer	meyer	None
quantity	mennyiség	None
how much	mennyi	None
thunder	mennydörgés	None
to go	menni	None
refugees	menekültek	None
refugee	menekülő	None
escape	menekülni	None
haven	menedéket	None
manager	menedzsere	None
that are	melyeknek	None
deep	mélyen	None
adjective	melléknévi	None
adjectives	melléknevek	None
bust	mellszobra	None
next	tovább	None
beside	mellette	None
next to	mellé	None
melinda	melinda	None
warmer	melegebb	None
amount	összege	None
menstrual	menstruációs	None
rescue	mentes	None
saved	menti	None
mexican	mexikói	None
mexico	mexikóban	None
chives	metélőhagyma	None
subway	metró	None
methionine	metionin	None
metallica	metallica	None
metaphysics	metafizika	None
recounts	meséli	None
tales	mondák	None
mesopotamia	mezopotámia	None
artificially	mesterségesen	None
masters	mesterek	None
messi	messi	None
messenger	messenger	None
assassination	merénylet	None
hard disc	merevlemez	None
rigid	merev	None
mercury	merkúr	None
mercedes	mercedes	None
mental	mentális	None
artificial	mesterséges	None
lithuanian	litván	None
mediterranean	mediterrán	None
mechanical	mechanikus	None
essence	lényege	None
atmospheric	légköri	None
into the atmosphere	légkörbe	None
atmosphere	légköre	None
air force	légierő	None
lázár	lázár	None
rebel	lázadó	None
rebellion	lázadás	None
fever	láz	None
lava	láva	None
spectacular	látványos	None
seeing	látás	None
saw	láttak	None
apparent	látszólagos	None
apparently	látszólag	None
was seen	látszott	None
seen	látták	None
visitors	látogatók	None
visitor	látogató	None
essential	nélkülözhetetlen	None
visit	látogatása	None
significantly	lényegesen	None
creatures	élőlények	None
anserinae	lúdformák	None
lóránt	lóránt	None
lyrical	lírai	None
lira	líra	None
lyceum	líceum	None
existence of sy/sg	létét	None
number	számú	None
number of	létszáma	None
to create	létrehozni	None
sy's existence	létezését	None
existence	létezés	None
there are	léteznek	None
exists	létezik	None
existed	létezett	None
steps	lépéseket	None
stepped	léptek	None
step	lépése	None
can occur	léphet	None
occurs in	lép	None
essentially	lényegében	None
sights	látnivalók	None
panorama	panoráma	None
we see	látjuk	None
see	see	None
love	szeretet	None
horse	ló	None
lovas	lovas	None
horses	lovak	None
knights	lovagok	None
knight	vitéz	None
lotus	lotus	None
los	los	None
lorenzo	lorenzo	None
lorelai	lorelai	None
lord	ura	None
london	londoni	None
loki	loki	None
logistics	logisztika	None
logic	logikai	None
logan	logan	None
liverpool	liverpool	None
litany	litánia	None
luca	luca	None
lucas	lucas	None
lucifer	lucifer	None
ludwig	ludwig	None
hosts	látja	None
visible	láthatóak	None
invisible	láthatatlan	None
flag	zászlót	None
chain bridge	lánchíd	None
soft	lágy	None
laden	láden	None
leg	lábát	None
footnote	lábjegyzet	None
locse	lőcsei	None
feet	lába	None
hole	lyuk	None
luxembourg	luxemburgi	None
luther	luther	None
lupus	lupus	None
lunar	lunar	None
luna	luna	None
luke	lukács	None
luis	luis	None
luigi	luigi	None
foot	lábánál	None
m	m	None
today	napjainkra	None
mac	mac	None
marketing	marketing	None
mario	mario	None
marie	marie	None
maria	maría	None
mari	mari	None
margaret	margit	None
marcus	marcus	None
marco	marco	None
marcell	marcell	None
the rest	maradék	None
remains	maradványait	None
remained	maradtak	None
irreversible	maradandó	None
manuel	manuel	None
manson	manson	None
mansell	mansell	None
mann	mann	None
manga	manga	None
manchester	manchester	None
marley	marley	None
morocco	marokkó	None
tirgu	maros	None
marosvásárhely	marosvásárhely	None
abbreviation of hungarian workers' party	mdp	None
mclaren	mclaren	None
mccartney	mccartney	None
maximum	maximális	None
matt	matt	None
mathematician	matematikus	None
mathematical	matematikai	None
mathematics	matematika	None
master	mestere	None
nowadays	napjainkban	None
massa	massa	None
mary	mária	None
marxist	marxista	None
marx	marx	None
martin	márton	None
marsh	marsh	None
marshal	marsall	None
mars	mars	None
tirgu mures	marosvásárhelyi	None
at marosvásárhely	marosvásárhelyen	None
mason	mason	None
medici	medici	None
malaria	malária	None
malthusianism	malthusianizmus	None
themselves	magukra	None
magma	magma	None
magdolna	magdolna	None
magda	magda	None
height	magassága	None
higher	magasabb	None
myself	magam	None
itself	önmagában	None
core	magja	None
mafia	maffia	None
bird	madár	None
madách	madách	None
madrid	madrid	None
madonna	madonna	None
birds	madarak	None
cats	macskák	None
cat	macska	None
machu	machu	None
macedonia	macedónia	None
with them	velük	None
magvető (a hungarian publishing company)	magvető	None
hungarian	magyarországi	None
hungarians	magyarság	None
malfoy	malfoy	None
malcolm	malcolm	None
macedonians	makedónok	None
macedonian	makedón	None
maya	maja	None
along	mentén	None
inconsistent examples (magától értetődő=evident - távol tartani magától=keep it away from himself)	magától	None
private life	magánélete	None
lonely	magányos	None
malaysian	maláj	None
vowels	magánhangzók	None
himself	önmaga	None
inconsistent examples, not a stand alone word (foglalja magában=includes - magában hordozza=carries within itself)	magában	None
fetus	magzat	None
explainable	magyarázható	None
explanation	magyarázatot	None
in hungarian	magyarul	None
from hungary	magyarországról	None
to hungary	magyarországra	None
in hungary	magyarországon	None
private	privát	None
maize	kukorica	None
ritual	rituális	None
rice	rizs	None
in the world war	világháborúban	None
world war	világháborút	None
world championship	világbajnokságot	None
world champion	világbajnok	None
world atlas	világatlasz	None
world	világát	None
william	william	None
tram	villamos	None
villa	villa	None
storm	vihar	None
vietnamese	vietnami	None
vietnam	vietnam	None
rural	vidéki	None
in the countryside	vidékén	None
menyanthaceae	vidrafűfélék	None
videos	videók	None
video	videó	None
victoria	victoria	None
victor	viktor	None
world war i	világháborús	None
via	via	None
world famous	világhírű	None
on the world	világon	None
carrying	viselő	None
behavior	viselkedését	None
behaves	viselkedik	None
bears	viseli	None
wear	viselt	None
blooming	virágzó	None
flourished	virágzott	None
virág (forename)	virág	None
virtuoso	virtuóz	None
virginia	virginia	None
vinci	vinci	None
vincent	vincent	None
vince	vince	None
world heritage	világörökségi	None
in the world of	világában	None
to the world	világába	None
world organization	világszervezet	None
worldwide	világszerte	None
clearer	világosabb	None
worldly	világi	None
chief of staff	vezérkari	None
leaders	vezetők	None
leaders of	vezetői	None
competitors	versenyzők	None
driver	versenyzője	None
competitor	versenyző	None
competed	versenyzett	None
competition	versenyt	None
gerbil	versenyegérformák	None
defeat	vereséget	None
verdi	verdi	None
vera	vera	None
venera	venyera	None
venus	vénusz	None
buy	vesz	None
venezuela	venezuela	None
guests	vendégek	None
vencel	vencel	None
venetian	velencei	None
venice	venezia	None
compounds	vegyületek	None
chemical industry	vegyipari	None
verse-	verses	None
version	változatában	None
the sparrows	verébalkatúak	None
kidney	vese	None
leadership	vezetésével	None
cable	vezeték	None
headed	élén	None
traceable	vezethető	None
led	vezetett	None
customer	vevő	None
projection	vetítés	None
vettel	vettel	None
they took	vették	None
vishnu	visnu	None
employed	vetették	None
vet = sow (véget vet = end)	vet	None
endangered	veszélyeztetett	None
dangerous	veszélyes	None
danger	veszélyt	None
losses	veszteségeket	None
veszprém	veszprémi	None
veszprem	veszprém	None
takes	viszi	None
rabies	veszettség	None
suggested	vetette	None
vatican	vatikáni	None
relapsed	visszaesett	None
returning	visszatérve	None
migrate	vándoroltak	None
vampires	vámpírok	None
vampire	vámpír	None
divorce	váló	None
variable	változó	None
changes	változásokat	None
variations	változatok	None
version of	változatát	None
alternate	váltakozó	None
separated	váltak	None
crisis	válság	None
in the national team	válogatottban	None
in sg's blue, selected	válogatott	None
to become	válni	None
enterprise	vállalkozás	None
take on	vállal	None
become	válik	None
as an answer	válaszul	None
elections	választásokon	None
unexpected	váratlan	None
election	választáson	None
unexpectedly	váratlanul	None
várkonyi	várkonyi	None
végvári (surname)	végvári	None
infinite	végtelen	None
executing	végrehajtó	None
implementation	végrehajtás	None
eventually	véglegesen	None
final	végső	None
finally	végül	None
done	végzi	None
perform	végeznek	None
end result	végeredmény	None
protector	védő	None
protected	védte	None
defensive	védelmi	None
protection	védelmét	None
defending	védekező	None
bought	vásárolt	None
neighborhoods	városrészek	None
town hall	városháza	None
to wait	várni	None
waiting	várja	None
choice	választás	None
chosen	választott	None
choose	választása	None
visual	vizuális	None
examined	vizsgálta	None
surveys	vizsgálatok	None
examination	vizsgálata	None
water	vízzel	None
diuretic	vizelethajtó	None
waters	waters	None
vivaldi	vivaldi	None
discussions	vitákat	None
debates	viták	None
were taken	vitték	None
carried	vitt	None
vitiligo	vitiligo	None
contested	vitatott	None
debate	vitát	None
abuse	visszaélés	None
retired	vonult	None
revoked	visszavonta	None
recurrent	visszatérő	None
vladimir	vlagyimir	None
vocal	vokális	None
voldemort	voldemort	None
volga	volga	None
answered	válaszolt	None
desire	vágya	None
cut	vágott	None
accused	vádolták	None
accusation	vád	None
váci (a famous street of budapest)	váci	None
volcanoes	vulkánok	None
vulcanic	vulkáni	None
volcano	vulkán	None
to return	visszatérni	None
volcanic	vulkanikus	None
voyager	voyager	None
marched	vonultak	None
grouped	vonták	None
entailed	vonta	None
involved	vonják	None
trains	vonatok	None
concern	vonatkozik	None
von	von	None
(they) were	voltak	None
vs.	vs	None
train station	vasútállomás	None
railway lines	vasútvonalak	None
railroad	vasútvonal	None
dwarf	törpe	None
efforts	törekvések	None
aspiration	törekvés	None
public transport	tömegközlekedési	None
numerously	tömegesen	None
mass-	tömeges	None
masses	tömegek	None
weight	tömegű	None
crowd	tömeg	None
block	tömb	None
they spent	töltötték	None
spends	tölti	None
charge	tölt	None
perfect	tökéletes	None
more or less	többékevésbé	None
most of	zöme	None
majority	többségi	None
several	többféle	None
multiple	többszörös	None
historical	történeti	None
tóth	tóth	None
story	történetét	None
storytellers	történetíró	None
survivors	túlélők	None
survived	túlélte	None
excessive	túlzott	None
predominantly	túlnyomórészt	None
overwhelming	túlnyomó	None
too	túlságosan	None
cancelled	törölték	None
turkish	törökök	None
turkey	törökországban	None
throat	török	None
tribal	törzsi	None
tribes	törzsek	None
tribe	törzs	None
legislator	törvényhozó	None
legislation	törvényhozás	None
laws	törvényeket	None
historians	történészek	None
historian	történész	None
happen	zajlik	None
stories	történeteket	None
ten	tízes	None
type	típusú	None
typhoid	tífusz	None
distance	távolság	None
remote	távoli	None
farther	távolabb	None
associated	társult	None
subject	tárgyát	None
accusative	tárgyeset	None
negotiations	tárgyalásokat	None
discussed	tárgyalt	None
food	étel	None
dance	tánc	None
supporting	támogató	None
aid	támogatás	None
supported	támogatták	None
support	támogatásával	None
attackers	támadók	None
attacking	támadó	None
attacks	támadások	None
attack	támadást	None
landscapes	tájak	None
long-distance	távolsági	None
term	távú	None
(his) departure	távozása	None
cuboid	téglatest	None
wrongly	tévesen	None
putting	téve	None
item	tétel	None
maps	térképek	None
map	térképe	None
spacial	téri	None
in square	téren	None
in reality	valóságban	None
actual	tényleges	None
reflects	tükrözi	None
indeed	tényleg	None
factor	tényező	None
facts	tények	None
fact	tény	None
topics	témákat	None
themes	témák	None
themed	témájú	None
theme	témát	None
in topic	témában	None
topic	téma	None
factors	tényezők	None
mirror	tükör	None
symptoms	tüneteket	None
demonstrators	tüntetők	None
someone	valaki	None
typhlopidae	vakkígyófélék	None
blind	vak	None
whether	vajon	None
vajda	vajda	None
we are	vagyunk	None
i am	vagyok	None
that is	vagyis	None
hunting	vadászat	None
hunter	vadász	None
wild	vadon	None
dinner	vacsora	None
afterwards	utólag	None
posterity	utókor	None
descendants of sy	utódai	None
successor	utódja	None
the latter	utóbbit	None
latter	utóbbi	None
at last	utoljára	None
something	valamit	None
sometime	valamikor	None
as well as	valamint	None
valencia	valencia	None
railway	vasúti	None
iron ore	vasérc	None
sunday	vasárnapi	None
thick	vastag	None
iron	vas	None
wizards	varázslók	None
wizard	varázsló	None
warsaw	varsói	None
sewing	varrás	None
streets	utcák	None
common last name	varga	None
reality	valóság	None
likely	valószínűséggel	None
implemented	végrehajtott	None
religions	vallások	None
religious	vallásos	None
religion	vallású	None
confessed	vallotta	None
walloon	vallon	None
valkyrie	valkűr	None
is there	vane	None
doom	végzet	None
in the street	utcán	None
travelled	utazott	None
alatt	under	None
und	und	None
ulászló	ulászló	None
ulrich	ulrich	None
ukrainian	ukrán	None
ukraine	ukrajna	None
as well	éppúgy	None
same time	ugyanekkor	None
though	ugyan	None
ugric	ugor	None
uefa cup	uefakupa	None
uefa	uefa	None
in sy's court	udvarában	None
seemingly	tűnő	None
seems	tűnik	None
from it	tőle	None
artillery	tüzérségi	None
tuskes	tüskés	None
turkic	türk	None
unesco	unesco	None
unitarian	unitárius	None
universe	világegyetem	None
union	uniós	None
travel	úti	None
road	utat	None
instructions	utasítást	None
instructed	utasította	None
pointed	utalt	None
roads	utak	None
uss	uss	None
usb	usb	None
usa	usaban	None
traveller	utazó	None
uranus	uránusz	None
dominated	uralta	None
ruler	uralkodók	None
regal	uralkodói	None
monarch	uralkodó	None
reign	uralma	None
reigned	uralkodott	None
urahara	urahara	None
grandson	unokája	None
nephew	unokaöccse	None
uranium	urán	None
not a stand alone word (munkát végző=working)	végző	None
ends	végét	None
end of	végén	None
northeast	északkeleti	None
northerners	északiak	None
northern	északi	None
north-south	északdéli	None
in north america	északamerikában	None
north america	északamerikai	None
north	északról	None
wit	ész	None
sensual	érzéki	None
sensitive	érzékeny	None
felt	érzett	None
emotional	érzelmi	None
emotions	érzelmeket	None
feelings	érzelmek	None
prevail	érvényesül	None
valid	érvényes	None
in effect	érvényben	None
value of	értékét	None
valuable	értékes	None
north korea	északkorea	None
values	értékeket	None
north-west	északnyugati	None
to his senses	észre	None
ireland	írország	None
writes	írja	None
irish	ír	None
promised	ígért	None
promise	ígéretet	None
decades	évtizeden	None
decade	évtizedben	None
a century	évszázados	None
centuries	évszázadok	None
at the age of	évesen	None
annual	éves	None
yearly	évi	None
from 1990/from the 1990's/from the years of 1990	évektől	None
years	évvel	None
eve	éva	None
restaurant	étterem	None
foods	ételek	None
estonia	észtország	None
estonian	észt	None
north vietnamese	északvietnami	None
understandable	érthető	None
understood	értett	None
was informed	értesült	None
were built	épültek	None
are being built	épülnek	None
buildings	épületek	None
architectural	építészeti	None
architecture	építészet	None
architects	építészek	None
architect	építész	None
building	épületében	None
construction	építését	None
built	épült	None
build	épül	None
singers	énekesek	None
sang	énekelt	None
sing	énekel	None
enek	ének	None
wildlife	élővilág	None
on the elysion	élüszion	None
lively	élénk	None
enjoyed	örvendett	None
inconsistent examples, not a stand alone word (ér el=reaches - ér véget=ends)	ér	None
interests	érdekeit	None
interested	érdekelte	None
interesting	érdekes	None
explanatory	értelmező	None
interpretation	értelmezése	None
sense	értelemben	None
dissertation	értekezés	None
value	értékű	None
understands	ért	None
archbishop	érseki	None
arrival	érkezése	None
coming	érkező	None
writing	írásában	None
touch	érinti	None
worth	éri	None
feeling	érzés	None
graduated from highschool	érettségizett	None
ripe	érett	None
merit	érdemrend	None
substantial	érdemi	None
interest	érdeklődését	None
curiosities	érdekességek	None
curiosity	érdekessége	None
ripen	érik	None
in writing	írásban	None
character	írásjegy	None
writings	írások	None
on the way	úton	None
swimmer	úszó	None
mr.	úr	None
new year	újév	None
new zealand	újzéland	None
journalists	újságírók	None
journalist	újságíró	None
newspapers	újságok	None
newly	újonnan	None
romanic	újlatin	None
new age	újkor	None
reborn	újjá	None
recently	újabban	None
newer	újabb	None
new	újat	None
so-called	úgynevezett	None
business	üzleti	None
widow	özvegy	None
fifth	ötödik	None
route	útvonal	None
routes	útvonalak	None
in case	ügyben	None
affairs	ügyek	None
astronaut	űrhajós	None
spacecraft	űrszonda	None
autumn	őszi	None
in autumn	ősszel	None
native	őshonos	None
ancestors	ősei	None
crazy	őrült	None
preserves	őrzi	None
guard	őrség	None
five-year	ötéves	None
message	üzenetet	None
greenhouse	üvegházhatású	None
collision	ütközés	None
empty	üres	None
ceremonial	ünnepélyes	None
celebrated	ünneplik	None
holidays	ünnepek	None
celebration of	ünnepe	None
sat	ült	None
lawyer	ügyvéd	None
fuel	üzemanyag	None
to live	élni	None
fifty	ötven	None
in line with	összhangban	None
council	önkormányzat	None
suicidal	öngyilkos	None
ecological	ökológiai	None
Ödön	ödön	None
younger brother of	öccse	None
old town	óvárosa	None
kindergarten	óvoda	None
since	óta	None
hours	órával	None
giant	óriási	None
hour	órás	None
ancient	ősi	None
antiquity	ókorban	None
ocean	óceán	None
he	ő	None
sentenced	ítélték	None
judgement	ítéletet	None
writers	írók	None
writer	írója	None
local government	önkormányzati	None
voluntarily	önként	None
voluntary	önkéntes	None
self-	önmagát	None
compiled	összeállított	None
composition	összetétele	None
in total	összességében	None
altogether	összesen	None
collapse	összeomlása	None
collapsed	összeomlott	None
compare	összehasonlítása	None
sum	összeget	None
connected	összefüggő	None
stimulated	ösztönözte	None
context	összefüggésben	None
gladly	örömmel	None
estate	örökösödési	None
inherited	örökölte	None
heritage	öröksége	None
forever	örökre	None
eternal	örök	None
armenian	örmény	None
devil	ördög	None
autobiographic	önéletrajzi	None
conspiracy	összeesküvés	None
landscape	táj	None
our lives	életünk	None
lives	életére	None
disorders	zavarok	None
riots	zavargások	None
confusion	zavar	None
zalaegerszeg	zalaegerszegi	None
zala	zala	None
took place	zajlottak	None
z	z	None
youtube	youtube	None
york	yorki	None
y	y	None
xviii	xviii	None
roman number	xv	None
xp	xp	None
roman date	xix	None
xi.	xiv	None
xii	xii	None
wolfner	wolfner	None
wolfgang	wolfgang	None
winston	winston	None
musically	zeneileg	None
windows	windows	None
orchestra	zenekart	None
zeneműkiadó	zeneműkiadó	None
zsófia (forename)	zsófia	None
zsuzsanna	zsuzsanna	None
zsuzsa	zsuzsa	None
zsolt	zsolt	None
synagogue	zsinagóga	None
sigismund	zsigmond	None
jews	zsidókat	None
jewish	zsidó	None
genious	zseniális	None
zrínyi	zrínyi	None
company ltd.	zrt	None
piano	zongorára	None
zoltán	zoltán	None
zeus	zeusz	None
musicians	zenészek	None
musician	zenész	None
his music	zenéje	None
composers	zeneszerzők	None
composer	zeneszerzőt	None
orchestral	zenekari	None
wilson	wilson	None
willis	willis	None
williams	williams	None
valley	völgyében	None
horizontal	vízszintes	None
hydrography	vízrajz	None
epiphany	vízkereszt	None
aquatic	vízi	None
watercollector	vízgyűjtő	None
viruses	vírusok	None
virus	vírus	None
martyrs	vértanúk	None
blood pressure	vérnyomás	None
bloody	véres	None
blood glucose	vércukorszint	None
blood	vért	None
perceived	vélt	None
by accident	véletlenül	None
random	véletlen	None
opinions	vélemények	None
opinion	véleménye	None
thin	vékony	None
vörösmarty	vörösmarty	None
wagner	wagner	None
wales	wales	None
wallace	wallace	None
wilhelm	wilhelm	None
wilde	wilde	None
wikipedia	wikipédia	None
wifi	wifi	None
weöres	weöres	None
wesselényi	wesselényi	None
werner	werner	None
weimar	weimari	None
weber	weber	None
(german word)	zu	None
web	webes	None
wayne	wayne	None
watson	watson	None
wass	wass	None
in washington	washingtonban	None
washington	washingtoni	None
warhol	warhol	None
warcraft	warcraft	None
walter	walter	None
walt	walt	None
waesley	weasley	None
closed	zárva	None
in parentheses	zárójelben	None
zászlós	zászlós	None
average temperature	átlaghőmérséklet	None
average	átlagos	None
revised	átdolgozta	None
transformation	átalakulás	None
transformed	átalakult	None
mineral	ásványi	None
digs	ás	None
flood	árvíz	None
goods	áruk	None
arpad	árpádsávos	None
house of arpad	árpádházi	None
Árpád	árpád	None
price	áron	None
april	áprilisi	None
Ányos	ányos	None
in general	általánosságban	None
generally	általánosan	None
dream	álom	None
pseudonym	álnéven	None
on average	átlagosan	None
diameter	átmérője	None
conversion	átszámítás	None
breakthrough	áttörést	None
lifetime	élettartama	None
to life	életre	None
biographical	életrajzi	None
biography	életrajza	None
lifestyle	életmódot	None
way of living	életmód	None
my life	életem	None
his life	életének	None
alive	élve	None
sleepy	álmos	None
sharply	élesen	None
nightly	éjszakai	None
luminary	égitest	None
heaven	égi	None
climatological	éghajlati	None
climate	éghajlata	None
sky	ég	None
sweet	édes	None
asian	ázsiai	None
asia	ázsiában	None
sharp	éles	None
their lives	életüket	None
alleged	állítólagos	None
positioning of	állítása	None
branches	ágazatok	None
branch	ágon	None
alphabet	ábécé	None
representation	ábrázolása	None
depicted	ábrázolták	None
illustrated	ábrázolt	None
depict	ábrázolják	None
shows	ábrázolja	None
x, times	×	None
centigrade	 °c	Nan
mm, millimetre	 mm	Nan
mg	 mg	Nan
square kilometer	 km²	Nan
500 km far	 kmre	Nan
kg	 kg	Nan
cm	 cm	Nan
nothing here	 	Nan
green	zöld	None
zone	övezet	None
Ágnes	ágnes	None
Ágost	ágost	None
Ágoston	ágoston	None
inconsistent examples (sacrifice or victim)	áldozat	None
claimed	állították	None
claim	állítják	None
standing	álló	None
point of view	álláspont	None
stood	álltak	None
stationing	állomásozó	None
desist from	álljon	None
can stand	állhat	None
fauna	állatvilága	None
allegedly	állítólag	None
livestock	állattenyésztés	None
zoo	állatkert	None
animal	állatot	None
status	állapotát	None
state organization	államszervezet	None
head of state	államfő	None
form of government	államformája	None
stand	állni	None
victim	áldozatot	None
victims	áldozatok	None
animals	állatokat	None
broader	tágabb	None
generals	vezérkar	None
typotex	typotex	None
deer	szarvas	None
sarcophagus	szarkofág	None
szapolyai	szapolyai	None
sanskrit	szanszkrit	None
szalai	szalai	None
experts	szakértők	None
secondary school	szakközépiskola	None
saccade	szakkád	None
technical school	szakiskola	None
professionals	szakemberek	None
sections	szakaszok	None
broken	törtek	None
tailor	szabó	None
regulation	szabályozás	None
rules	uralkodik	None
rule	uralom	None
szabolcs	szabolcs	None
outdoor	szabadtéri	None
freedom fight	szabadságharc	None
words of sy	szavai	None
freedom	szabadságát	None
words	szavakkal	None
vote	szavazás	None
from a point of view	szempontból	None
eyes	szemében	None
review	véleményét	None
szemere	szemere	None
face	szembe	None
eye	szeme	None
selenium	szélén	None
intellectual	értelmi	None
selection	válogatás	None
winds	szelek	None
sector	szektor	None
seiyū	szeijú	None
poverty	szegénység	None
poor	szegények	None
carnation	szegfű	None
of szeged	szegedi	None
szeged	szeged	None
secession	szecessziós	None
scientology	szcientológia	None
votes	szavazatok	None
free masonry	szabadkőművesség	None
freemason	szabadkőműves	None
szabadka	szabadka	None
statistical	statisztikai	None
stanley	stanley	None
standard	szabvány	None
stan	stan	None
stallone	stallone	None
stadium	stadionban	None
stable	stabil	None
ss	ss	None
sql	sql	None
spartan	spártai	None
sportsmen	sportolók	None
sports	sportág	None
spontaneous	spontán	None
spencer	spencer	None
spd	spd	None
in spanish	spanyolul	None
spain	spanyolországban	None
spanish	spanyolok	None
space	tér	None
statistics	statisztikák	None
etc.	stb	None
steve	steve	None
steven	steven	None
leisure	szabadidő	None
sweden	svédország	None
swedish	svéd	None
swiss	svájci	None
switzerland	svájcban	None
susan	susan	None
surányi	surányi	None
sun	sun	None
sulinet	sulinet	None
from the point of view of	szempontjából	None
emission	sugárzás	None
styles	stílusok	None
style	stílusú	None
stuttgart	stuttgart	None
studio	stúdióban	None
stuart	stuart	None
stress	stressz	None
street	utcai	None
stonehenge	stonehenge	None
stewart	stewart	None
sugár	sugár	None
person	személyét	None
persons	személyek	None
personal	személyi	None
voiced by	szinkronhangja	None
symphonic	szimfónia	None
symbolic	szimbolikus	None
szilárd (feorename)	szilárd	None
szilágyi	szilágyi	None
sylvester	szilveszter	None
rigorously	szigorúan	None
strict	szigorú	None
islands	szigetek	None
sicilian	szicíliai	None
siberian	szibériai	None
sexual	szexuális	None
sexuality	szexualitás	None
sex	szex	None
setter	szetter	None
modest	szerény	None
seraph	szeráf	None
authors	szerzők	None
authors of sg	szerzői	None
synchronized	szinkronizálva	None
level	színt	None
on the level of	szintjén	None
scandium	szkandium	None
software	szoftverek	None
social	társasági	None
social democrat	szociáldemokrata	None
sociological	szociológiai	None
sociology	szociológia	None
socialism	szocializmus	None
socialist	szocialista	None
sculpture	szobrászat	None
sculptor	szobrászművész	None
contract	szerződést	None
statues	szobrok	None
statue	szobrát	None
slavs	szlávok	None
slavic	szláv	None
slovenia	szlovénia	None
slovenian	szlovén	None
slovaks	szlovákok	None
in slovakia	szlovákiában	None
slovakia	szlovákiai	None
slovak	szlovák	None
(its) statue	szobra	None
its destiny	sorsát	None
author	szerzője	None
organized by	szervezésében	None
fortunately	szerencsére	None
amorous	szerelmi	None
beloved of sy	szerelme	None
serbia	szerbiában	None
serbs	szerbek	None
serbian	szerbül	None
agent	ügynök	None
in september	szeptemberben	None
september	szeptember	None
senate	szenátus	None
suffering	szenvedő	None
suffer	szenved	None
szent-györgyi	szentgyörgyi	None
devoted	szentelt	None
saints	szentek	None
holy	szent	None
in the person of	személyében	None
personality	személyisége	None
personally	személyesen	None
lucky	szerencsés	None
role	szerepük	None
role of sy/sg	szerepe	None
actors	színészek	None
organizational	szervezeti	None
organizations	szervezetet	None
organization	szervezete	None
organize	szervez	None
organic	szerves	None
bodies	testek	None
serve	szolgálnak	None
tool	szerszám	None
structural	szerkezeti	None
monks	szerzetesek	None
editors	szerkesztők	None
editor	szerkesztője	None
edited	szerkesztette	None
according to	értelmében	None
obtained	szereztek	None
loved	szerették	None
want	szeretné	None
loves	szereti	None
role of	szerepére	None
actor	színész	None
editorial	szerkesztői	None
unusual	szokatlan	None
fate of	sorsa	None
in order	sorrendben	None
part of	része	None
part	shore	None
section	szakaszát	None
archaic	régészeti	None
regions	régiók	None
region	vidéke	None
long ago	régóta	None
older	régebbi	None
formerly	régebben	None
raikkonen	räikkönen	None
shakes	rázza	None
rate	ütemben	None
on us	ránk	None
rákóczi	rákóczi	None
rakosi	rákosi	None
crayfish	rák	None
realized	rájött	None
raba	rába	None
ruthenium	ruténium	None
particles	részecskék	None
russell	russell	None
as part of	részeként	None
detail	részlet	None
abbreviation of	rövidítése	None
shorter	rövidebb	None
shortly	röviddel	None
short	röviden	None
fixed	rögzített	None
rose	rózsa	None
romans	rómaiak	None
about them	róluk	None
copper	réz	None
through	át	None
layers	rétegek	None
layer	réteg	None
part of them	részük	None
participation	részvételével	None
participants	résztvevők	None
participant	résztvevője	None
in detail	részletesen	None
detailed	részletes	None
details	részletek	None
partial	részleges	None
rukia	rukia	None
rudolf	rudolf	None
rtl	rtl	None
romeo	rómeó	None
romantic	romantikus	None
romantics	romantika	None
rome	rómát	None
ruin	rom	None
rolling	rolling	None
roll	tekercs	None
roland	roland	None
relatives	rokonai	None
apace	rohamosan	None
roger	roger	None
rod	rod	None
rocky	rocky	None
robin	robin	None
roberto	roberto	None
robert	róbert	None
explosion	robbanás	None
exploded	robbant	None
rob	rob	None
ruins of sg	romjai	None
decline	romlott	None
rommel	rommel	None
roma	romák	None
corporation	rt	None
rss	rss	None
rowling	rowling	None
old hungarian alphabet	rovásírás	None
notch	rovás	None
rousseau	rousseau	None
rourke	rourke	None
badly	rosszul	None
bad intentioned	rosszindulatú	None
s	s	None
bad	rossz	None
rosberg	rosberg	None
rory	rory	None
roosevelt	roosevelt	None
ronaldo	ronaldo	None
ron	ron	None
in romanian	románul	None
romanians	románok	None
romania	romániában	None
romanian	román	None
ross	ross	None
saint	st	None
unfortunately	sajnos	None
own	önállóan	None
sinus	szinusz	None
simon	simon	None
right whales	simabálnák	None
smooth	sima	None
succeeded	sikerült	None
succeed	sikerül	None
unsuccessfully	sikertelenül	None
unsuccessful	sikertelen	None
successfully	sikeresen	None
successes	sikerek	None
success	sikerét	None
sherlock	sherlock	None
shakespeare	shakespeare	None
service	szolgáltatás	None
swine flu	sertésinfluenza	None
stimulating	serkentő	None
army of	seregét	None
corp	sereg	None
senna	senna	None
singer	énekesnő	None
sir	sir	None
scandinavian	skandináv	None
schizophrenia	skizofrénia	None
constantly	állandóan	None
series	sorozatát	None
serial	sorozatos	None
on the row	soron	None
classified	sorolják	None
classified (as)	sorolható	None
lines	vonalak	None
in sequence	sorban	None
in a row	sorba	None
nobody	senki	None
sopron	soproni	None
multicolored	sokszínű	None
versatile	sokoldalú	None
varied	változatos	None
many	számos	None
never	sosem	None
society	társadalomban	None
smith	smith	None
scottish	skót	None
scotland	skócia	None
somogyi	somogyi	None
fate	sors	None
nothing	semmit	None
neutral	semleges	None
sata	sata	None
eagle	sas	None
sarolta	sarolta	None
polar	sarki	None
sarah	sarah	None
santiago	santiago	None
santa	santa	None
sant	sant	None
san	san	None
samuel	sámuel	None
samu	samu	None
sam	sam	None
salzburg	salzburgi	None
salvador	salvador	None
solomon	salamon	None
chess mat	sakk-matt	None
chess	sakk	None
trait	sajátossága	None
particular	sajátos	None
saturn	szaturnusz	None
savaria	savaria	None
schengen	schengeni	None
schiller	schiller	None
qualifying	selejtező	None
cell	sejtek	None
nowhere	sehol	None
helper	segítő	None
help	segítségével	None
helped	segítette	None
to help	segíteni	None
sebestyén	sebestyén	None
speed	sebességét	None
semmelweis	semmelweis	None
sebastian	sebastian	None
neither	sem	None
scott	scott	None
scorsese	scorsese	None
scooter	scooter	None
sci-fi	scifi	None
science	tudományok	None
schwartz	schwartz	None
schumacher	schumacher	None
schneider	schneider	None
sean	sean	None
rival	rivális	None
use to	szokták	None
habits	szokások	None
theology	teológia	None
theodicy	teodicea	None
tenke	tenke	None
tennis	tennis	None
sea level	tengerszint	None
on the coast	tengerparton	None
high sea	tengeri	None
overseas	tengerentúli	None
on sea	tengeren	None
submarines	tengeralattjárók	None
submarine	tengeralattjáró	None
sea	tengerbe	None
axis	tengely	None
temple	temploma	None
cemetery	temetőben	None
cemetary	temető	None
buried	temették	None
timisoara	temesvári	None
performance	teljesítmény	None
theological	teológiai	None
completely	teljesen	None
sqaure	tere	None
pregnancy	terhesség	None
teresa	terézia	None
teréz (forename)	teréz	None
square	terén	None
therapy	terápia	None
planned	tervezte	None
plans	terveket	None
plan	tervét	None
terry	terry	None
terrier	terrier	None
conservation	természetvédelmi	None
protection of the environment	természetvédelem	None
supernatural	természetfeletti	None
naturally	természetesen	None
natural	természeti	None
natore of sy/sg	természete	None
in the nature	természetben	None
fertile	termékeny	None
product	termék	None
produce	termelnek	None
pregnant	terhes	None
complete	teljes	None
winter	téli	None
television	televíziós	None
teatro	teatro	None
tea	teáját	None
taylor	taylor	None
spring	tavaszi	None
lakes	tavak	None
tatars	tatárok	None
mongol invasion	tatárjárás	None
tartar	tatár	None
stayed	tartózkodott	None
durable	tartós	None
lasting	tartó	None
keeping	tartása	None
belonged	tartoztak	None
belong	tartoznak	None
belongs to	tartozik	None
provinces	tartományok	None
provincial	tartományi	None
province	tartományt	None
considered	tekintik	None
technique	technikát	None
techniques	technikák	None
technology	technológia	None
technological	technológiai	None
settlements	településeken	None
installed	telepített	None
settlers	telepesek	None
settled	települt	None
teleki	teleki	None
plot	telek	None
phone	telefon	None
full	telt	None
prestigious	tekintélyes	None
area of	területe	None
regarding	tekintve	None
could be regarded as	tekinthetők	None
can be considered	tekinthető	None
in the relation of	tekintetében	None
respect	tisztelték	None
milk	tej	None
talent	tehetségét	None
talented	tehetséges	None
do	teszi	None
ted	ted	None
consider	vélik	None
areas	vidékeken	None
territory	területét	None
tesla	tesla	None
troyan	trójai	None
troy	trója	None
trianon	trianoni	None
trek	trek	None
transistor	tranzisztor	None
transformator	transzformátor	None
tragedy	tragédiája	None
tragic	tragikus	None
furthermore	továbbá	None
further	távolabbi	None
torres	torres	None
tower	torony	None
tournament	versenyen	None
gymnastics	torna	None
topography	topográf	None
tony	tony	None
tolkien	tolkien	None
toldi	toldi	None
tag	toldalék	None
throne	trónra	None
heir	örököse	None
tropical	trópusi	None
dozen	tucat	None
tv	tv	None
tutankhamun	tutanhamon	None
tour	turnéja	None
turner	turner	None
tourists	turisták	None
tupac	tupac	None
in possession of	tulajdonában	None
properties	tulajdonságok	None
property	tulajdonsága	None
a hungarian brand of wine	tokaji	None
virtual	virtuális	None
scientists	tudósok	None
scientist	tudós	None
scientific	tudományos	None
to know	tudni	None
learn	tudjon	None
knowable	tudható	None
awareness	tudomást	None
consciously	tudatosan	None
consciousness	tudat	None
actually	tulajdonképpen	None
holds	tartja	None
todd	todd	None
fourteen	tizennégy	None
forbidden	tilos	None
ban	tilalom	None
tiger	tigris	None
tibor	tibor	None
tibetian	tibeti	None
thököly	thököly	None
not a hungarian word "thumb" and "right" means "hüvelykujj" and "jobb", while "az" means "the"	thumb|right|px|az	None
textile industry	textilipar	None
texas	texasi	None
activities	tevékenységek	None
teutons	teutonok	None
doing	tették	None
did	tette	None
sy liked sg	tetszett	None
tetracaine	tetrakain	None
on top	tetején	None
test	vizsgálat	None
sister cities	testvérvárosai	None
his body	testét	None
protested	tiltakozott	None
prohibited	tiltott	None
tim	tim	None
timeaxis	timeaxis	None
twelve	tizenkét	None
seventeen	xvii	None
thirteen	xiii	None
eleven	tizenegy	None
tenth	tizedik	None
common first name	tivadar	None
titan	titán	None
in secret	titokban	None
tito	tito	None
fifteen	tizenöt	None
secret of	titkára	None
titanic	titanic	None
made clear	tisztázott	None
aware of the	tisztában	None
honouring	tiszteletére	None
honorary	tiszteletbeli	None
officers	tisztek	None
clean	tiszta	None
officer	tiszti	None
tisza	tisza	None
secret	titkos	None
habit	szokás	None
keep	tartani	None
contained	tartalmazta	None
székelys	székelység	None
transylvanian hungarian	székelymagyar	None
in transylvania	székelyföldön	None
transylvanian	székelyföldi	None
székely land	székelyföld	None
szekely	székelyek	None
széchenyi	széchenyi	None
hundred thousand	százezer	None
turn of the century	századforduló	None
century	évszázad	None
hundred	száz	None
saxon	szász	None
originary	származó	None
ancestry	származású	None
came from	származott	None
originate	származnak	None
dry	száraz	None
szántó=last name - szántó=ploughland	szántó	None
intended	szánták	None
cathedral	székesegyházban	None
destined	szánt	None
székesfehérvár	székesfehérvár	None
wind	szél	None
actress	színésznő	None
to the stage	színpadra	None
on the stage	színpadon	None
theatrical	színészi	None
theaters	színházak	None
theater	színházban	None
the scene	színhelye	None
colorful	színes	None
colors	színeket	None
apart	szét	None
beauty	szépség	None
fine art	szépművészeti	None
carbon dioxide	széndioxid	None
coal	szén	None
extreme	szélsőséges	None
latitude	szélességi	None
width of sg	szélessége	None
wider	szélesebb	None
wide	széles	None
seat	székhely	None
deliberately	szándékosan	None
intentional	szándékos	None
intention	szándéka	None
stalin	sztálin	None
in the soviet union	szovjetunióban	None
soviet union	szovjetunió	None
soviets	szovjetek	None
soviet	szovjet	None
needs	szorul	None
tight	szorult	None
times	szor	None
probe	szonda	None
neighbor	szomszéd	None
sad	szomorú	None
szombathely	szombathelyi	None
szolnok	szolnokon	None
provider	szolgáltató	None
services	szolgáltatások	None
served	szolgáltak	None
serving	szolgáló	None
service of	szolgálatában	None
usual	szokásos	None
subjective	szubjektív	None
sultan	szultán	None
sumatra	szumátra	None
supporters	támogatói	None
computers	számítógépek	None
computer	számítógépes	None
counting	számítva	None
expected	várta	None
calculated	számító	None
count	számítani	None
counts	számít	None
accounting	számvitel	None
their numbers	számuk	None
colour	színű	None
countless	számtalan	None
keep on recod	számon	None
numbers	számok	None
supplier	szállító	None
transported	szállították	None
supplied	szállított	None
landed	szálltak	None
flies	száll	None
szálasi	szálasi	None
palate	szájpad	None
considerable	számottevő	None
heart	szíve	None
with pleasure	szívesen	None
word	szót	None
thomas	thomas	None
maybe	talán	None
we can meet	találkozhatunk	None
finds	találja	None
thallium	tallium	None
soil	talaj	None
takacs	takács	None
tactical	taktikai	None
taiwan	tajvan	None
member states	tagállamok	None
members	tagok	None
members of	tagjainak	None
member	tagjává	None
density	sűrűsége	None
densely	sűrűn	None
dense	sűrű	None
roast	sült	None
heavily	súlyosan	None
weight of	súlya	None
doctrines	tanait	None
tuition fee	tandíj	None
tanager	tangarafélék	None
textbook publishers	tankönyvkiadó	None
contain	tartalmazzák	None
contents	tartalma	None
hold	tart	None
tarantino	tarantino	None
experienced	tapasztalt	None
experiences	tapasztalatok	None
certified	tanúsított	None
witnesses	tanúi	None
his student	tanítványa	None
hit	sújtotta	None
taught	tanította	None
teacher	tanár	None
soviet republic	tanácsköztársaság	None
consultant	tanácsadó	None
council of	tanácsa	None
advice	tanácsok	None
to study	tanulni	None
studied	tanult	None
studies	tanulmányok	None
study	tanulmányozása	None
teaching	tanítása	None
content	tartalom	None
darkness	sötétség	None
beers	sörök	None
born	születésű	None
parents	szülők	None
necessary	szükségessé	None
gnatcatcher	szúnyogkapófélék	None
federal	szövetségi	None
allies	szövetségesek	None
ally	szövetséges	None
alliance	szövetséget	None
text books	szövegkönyvet	None
text	szövegét	None
horrible	szörnyű	None
angle	szög	None
dictionaries	szótárak	None
dictionary	szótár	None
entertaining	szórakoztató	None
commented	szólt	None
glossary	szójegyzék	None
orally	szóban	None
inconsistent examples (szóba áll=talk to - szóba kerül=came up)	szóba	None
birth	szülés	None
birthday	születésnapja	None
birthplace	szülőháza	None
break	tör	None
beer	sör	None
sorrel	sóska	None
salty	sós	None
hawk	sólyom	None
epitaph	sírfelirat	None
tomb	sírja	None
sita (religious group)	síita	None
injuries	sérüléseket	None
injury of	sérülése	None
darker	sötétebb	None
chef	séf	None
satan	sátán	None
yellow	sárga	None
sándort (forename)	sándort	None
with sándor	sándorral	None
virgin	szűz	None
redwing	szőlőrigó	None
grape	szőlő	None
blond	szőke	None
dusk	szürkület	None
sao	são	None
setback	kudarc	None
morchellaceae	kucsmagombafélék	None
kubo	kubo	None
also	ugyancsak	None
equally	egyaránt	None
one	valamelyik	None
eger	egri	None
mice	egerek	None
mouse	egér	None
coach	edző	None
training	szakképző	None
edward	edward	None
edition	számában	None
edit	szerk	None
edison	edison	None
edgar	edgar	None
ede (forename)	ede	None
so far	odáig	None
eddie	eddie	None
edda	edda	None
from this	ebből	None
in this	ebben	None
others	többiek	None
eastwood	eastwood	None
egyed (forename)	egyed	None
unique	egyedülálló	None
at the university	egyetemen	None
universities	egyetemek	None
university	university	None
united	united	None
association	egyesület	None
conjugate	egyesített	None
some	valamiféle	None
individual	egyéni	None
equality	egyenlőség	None
equal	egyenlő	None
equatorial	egyenlítői	None
equator	egyenlítő	None
regular	szabályos	None
equation	egyenlet	None
one by one	egyenként	None
straight	egyenesen	None
a pre-	egyelőre	None
a	valamely	None
alone	egyedül	None
individuals	egyének	None
east	keletről	None
slanted	dőlt	None
finalist	döntős	None
south african	délafrikai	None
gran-grand father	dédapjan	None
great-grandmother	dédanyjan	None
products	termékek	None
date	dátum	None
denmark	dánia	None
on dvd	dvdn	None
dvd	dvd	None
rough	durva	None
double	dupla	None
danube	dunán	None
dumbledore	dumbledore	None
du	du	None
dramatic	drámai	None
drama	színmű	None
expensive	költséges	None
drum	drum	None
dragon	sárkány	None
dr.	dr	None
south america	délamerikai	None
morning	reggeli	None
southerners	déliek	None
southeastern	délkeleti	None
decisively	döntően	None
finals	döntőt	None
decided	elhatározta	None
decision	döntést	None
draw	készítenek	None
dózsa	dózsa	None
dome	dóm	None
decorated	díszített	None
honorary citizens	díszpolgárai	None
universal	egyetemes	None
ornate	díszes	None
awards of	díjai	None
prize	díj	None
día	día	None
dénes	dénes	None
south vietnam	délvietnami	None
afternoon	délután	None
southern slav	délszláv	None
southwest	délnyugaton	None
south korea	délkorea	None
awrds	díjak	None
down	lefelé	None
agreement	szerződésben	None
convention	egyezményt	None
elek	elek	None
beginning	kezdettől	None
top	legfelső	None
at the beginning	kezdetén	None
early	korán	None
at first	eleinte	None
elegant	elegáns	None
meet	találkozik	None
sufficient	elegendő	None
short stories	novellák	None
narrative	elbeszélő	None
selling	eladási	None
sold	eladta	None
away	el	None
meanwhile	mindeközben	None
since then	ekkortól	None
in this time	ekkortájt	None
by this time	ekkorra	None
this time	ilyenkor	None
electrochemistry	elektrokémia	None
pronounce	ejtsd	None
electronic	elektronikus	None
electrons	elektronok	None
sy's/sg's position	elhelyezkedése	None
situated	elterülő	None
heard	elhangzott	None
lost	vesztette	None
leave	távozik	None
occupation	megszállása	None
occupied	megszállta	None
busy	foglalt	None
occupy	foglalják	None
accepted	vállalt	None
to accept	elfogadni	None
accept	fogadja	None
acceptable	elfogadható	None
already	már	None
killed	megölték	None
elements of	elemeit	None
elements	elemek	None
items	elemekkel	None
element	elemet	None
electromagnetic	elektromágneses	None
einstein	einstein	None
one (german)	ein	None
word does not make sense on its won "11-ei" means on the 11th day of (month)	ei	None
single	kislemeze	None
once	egyszer	None
on the one hand	egyrészt	None
ever	örökké	None
from each other	egymástól	None
with each other	egymással	None
on one another	egymásra	None
to each other	egymásnak	None
each other	egymást	None
one million	egymillió	None
one ot two	egykét	None
pristine	egykori	None
egyptian	egyiptomi	None
egypt	egyiptomban	None
one of them	egyikük	None
at the same time	egyúttal	None
churches	templomok	None
church	templomot	None
of a certain kind	egyfajta	None
simple	egyszerű	None
easier	könnyebben	None
simply	egyszerűen	None
simplified	egyszerűsített	None
akhenaten	ehnaton	None
this	this	None
instead of	helyett	None
(its) whole	egészét	None
healthy	egészséges	None
quite	igen	None
whole	egészében	None
cooperation	együttműködés	None
bands	együttesek	None
match	mérkőzést	None
ensemble	együttesnek	None
obviously	nyilvánvalóan	None
otherwise	másként	None
other	többi	None
at all	egyáltalán	None
uniformly	egységesen	None
unified	egységes	None
units	egységeket	None
unity	egységre	None
unit	unit	None
together	össze	None
douglas	douglas	None
decide	dönt	None
donald	donald	None
target	célul	None
companies	vállalatok	None
company	vállalat	None
tsar	cár	None
cup	kupát	None
diabetes	diabétesz	None
sugar	cukor	None
peak of	csúcspontja	None
peak	csúcsán	None
decreasing	csökkenő	None
decrease in	csökkentése	None
reduce	csökkentik	None
decreases	csökkenti	None
reduced	csökkentette	None
decrease	csökkenése	None
csíkszereda	csíkszereda	None
stripe	csík	None
emperor	császárt	None
groups	csoportra	None
end	végére	None
(incorrect compound word)	kategóriakezdőlapon	None
their goal	céljuk	None
purpose of sy	célját	None
dalí	dalí	None
dalmatia	dalmácia	None
dallas	dallas	None
songs	dalokat	None
songs of	dalai	None
song	szám	None
despite	ellenére	None
da	da	None
d	d	None
address	címét	None
coat of arms	címere	None
crest	címer	None
its title	címe	None
title	címek	None
purpose	célú	None
goal	gólját	None
practical	gyakorlati	None
for	végett	None
relationship	viszonyát	None
in order to	céljából	None
group	group	None
skeleton	csontváz	None
csontváry	csontváry	None
channels	csatornák	None
attached	csatolták	None
jack	jack	None
joined	csatlakoztak	None
joins	csatlakozik	None
battle	ütközetben	None
hall	csarnok	None
blow	csapást	None
disaster	katasztrófa	None
to the team of	csapatának	None
teammate	csapattársa	None
troops	seregek	None
teams	csapatai	None
team of sy/sg	csapata	None
team	csapatát	None
rainfall	csapadékmennyiség	None
rain	eső	None
familys	családok	None
his family	családjával	None
czech	csehek	None
czech republic	csehország	None
czecho-slovakian	csehszlovák	None
czechoslovakia	csehszlovákia	None
junction	csomópont	None
csoma	csoma	None
csokonai	csokonai	None
wonderful	csodálatos	None
miracle	csoda	None
made	készültek	None
astronomers	csillagászok	None
astronomical	csillagászati	None
astronomy	csillagászat	None
danish	dán	None
astronomer	csillagász	None
stars	csillagok	None
star	star	None
in return	cserébe	None
exchange	csere	None
pacific	csendesóceáni	None
pacific ocean	csendesóceán	None
silent	csendes	None
activity	tevékenységét	None
little	kicsit	None
our star	csillagunk	None
daniel	dániel	None
dante	dante	None
piece	darabja	None
diana	diána	None
students	tanítványai	None
student	tanuló	None
dysarthria	dizartria	None
fashionable	divatos	None
fashion	divat	None
discography	diszkográfia	None
disney	disney	None
diploma	diplomát	None
diplomatic	diplomáciai	None
dinosaurs	dinoszauruszok	None
dinosaur	dinoszaurusz	None
dynasty	dinasztia	None
dynamic	dinamikus	None
dilleniales	dilléniafélék	None
dictatorship	diktatúra	None
digital	digitális	None
diego	diego	None
die	meghal	None
dns	dns	None
drummer	dobos	None
dog	kutya	None
tobacco	dohány	None
don	don	None
domonkos	domonkos	None
domokos	domokos	None
dominant	domináns	None
domenico	domenico	None
terrain	domborzati	None
relief	domborzat	None
thing	dolog	None
workers	munkások	None
dick	dick	None
working	dolgozó	None
worked	tevékenykedett	None
to work	dolgozni	None
they work	dolgoznak	None
work	működik	None
things	tárgyak	None
documents	iratok	None
documentary	dokumentumfilm	None
document	dokumentum	None
doctor	orvos	None
worked over	dolgozta	None
deceased	elhunyt	None
dicaprio	dicaprio	None
diagnosis	diagnózis	None
dei	dei	None
definition	definíció	None
in december	decemberben	None
december	december	None
debut	debütáló	None
in debrecen	debrecenben	None
debrecen	debreceni	None
dean	dean	None
dead	holtan	None
but	ám	None
dc	dc	None
davis	davis	None
david	dávid	None
dave	dave	None
darwin	darwin	None
gruiformes	darualakúak	None
dark	sötét	None
darius	dareiosz	None
pieces	darabot	None
south	south	None
dolphin	delfin	None
delle	delle	None
demographic	demográfiai	None
di	di	None
dharma	dharma	None
deak	deák	None
dezső	dezső	None
deoxyribose	dezoxiribóz	None
dexter	dexter	None
deutsche	deutsche	None
descartes	descartes	None
des	des	None
diamond	gyémánt	None
clear	világossá	None
rectangular	derékszögű	None
depression	világválság	None
depeche	depeche	None
denudation	denudáció	None
dennis	dennis	None
democracy	demokrácia	None
democrats	demokraták	None
democratic	demokratikus	None
democrat	demokrata	None
revealed	feltárt	None
started	megkezdődött	None
admits	elismeri	None
respected	tisztelt	None
europe	európát	None
eur	eur	None
eu	eu	None
etruscan	etruszk	None
ethnic	etnikai	None
objective case-ending	et	None
rainy	esős	None
chances	lehetőségeket	None
chance	esélye	None
aesthetic	esztétikai	None
esztergom	esztergomi	None
esther	eszter	None
year	évében	None
ideas	ötletet	None
conception	eszme	None
tools	eszközöket	None
means	jelenti	None
instrument	hangszer	None
accordingly	megfelelően	None
european	európai	None
esterhazy	esterházy	None
euro	euró	None
to europe	európába	None
thousand	ezer	None
henceforth	ezentúl	None
apart from that he	ezenkívül	None
on this	ezen	None
ago	ezelőtt	None
of these	ezekre	None
in these	ezekben	None
express	express	None
export products	exporttermékek	None
export	export	None
explorer	explorer	None
experience	tapasztalat	None
expedition	expedíció	None
ewing	ewing	None
evolutionary	evolúciós	None
everest	everest	None
evans	evans	None
evangelical	evangélikus	None
in europe	európában	None
europeans	európaiak	None
evenings	estek	None
evening	esti	None
esp	esp	None
force	erő	None
ervin	ervin	None
erotic	erotikus	None
ernst	ernst	None
ernest	ernő	None
ethical	etikai	None
erkel	erkel	None
erika	erika	None
eric	eric	None
decree	rendelet	None
resultant	eredő	None
result of	eredményét	None
resulted	eredményezte	None
resulted in	eredményezett	None
as a result of	eredményeként	None
result	eredményez	None
results	eredményt	None
surname	eredetű	None
origin of	eredetét	None
strong	erősen	None
stronger	erősebb	None
strength	erőt	None
violence	erőszak	None
wedding	esküvő	None
in case of	esetén	None
fell	esett	None
accidental	esetleges	None
possibly	lehetőleg	None
sometimes	olykor	None
cases	esetekben	None
case	ügyében	None
events	rendezvények	None
centaury	ezerjófű	None
event	versenyén	None
with power	erővel	None
strongly	erőteljesen	None
forceful	erőteljes	None
rising	erősödő	None
enhance	erősíti	None
confirmed	megerősítették	None
strengthened	megerősített	None
violent	erőszakos	None
by force	erőszakkal	None
and	ës	None
colonel	ezredes	None
after this	ezután	None
with this	ezzel	None
break-up	felbomlása	None
offered	személye	None
gave up	feladta	None
tasks	feladatokat	None
task of	feladata	None
task	feladatot	None
up	up	None
lying	feküdt	None
location	fekvése	None
lies	terül	None
blacks	feketék	None
black sea	feketetenger	None
black	fekete	None
fejér	fejér	None
in the head of sy	fejében	None
explained	magyarázzák	None
developing	fejlődő	None
improved	javult	None
more developed	fejlettebb	None
processing	feldolgozása	None
processor	processzor	None
half of	felét	None
answer	válasz	None
records	rekordok	None
caption	felirat	None
users	felhasználók	None
user	használó	None
using	használva	None
use of	felhasználása	None
accelerated	felgyorsult	None
perception	felfogás	None
discoveries	felfedezések	None
developmental	fejlődési	None
discovery of	felfedezése	None
over	vége	None
above	fölött	None
married	házasságot	None
wives	feleségek	None
his wife	feleségével	None
wife	feleség	None
unnecessary	felesleges	None
responsible for	felelőssé	None
responsible	felelős	None
to explore	felfedezni	None
originally	eredetileg	None
developments	fejlesztések	None
advanced	haladó	None
fantastic	fantasztikus	None
fantasy	fantasy	None
villages	falvak	None
villager	falusi	None
village	falu	None
wall	wall	None
originating	fakadó	None
comes from	fakad	None
kind of	fajtája	None
types	típust	None
racial	faji	None
species	fajok	None
facto	facto	None
facebook	facebook	None
wood	wood	None
eötvös	eötvös	None
silver medalist	ezüstérmes	None
silver	ezüst	None
thereby	ezáltal	None
carved	faragott	None
wolf	farkas	None
fascist	fasiszta	None
fauvism	fauvizmus	None
expressed	fejezte	None
is	értéke	None
chapter	fejezet	None
princely	hercegi	None
princes	fejedelmek	None
prince	prince	None
head	élére	None
proteins	fehérjék	None
whites	fehérek	None
development	fejlődést	None
white	white	None
weapons	fegyverek	None
weapon	fegyvert	None
on board of	fedélzetén	None
discovered	felfedezték	None
federer	federer	None
in february	februárban	None
february	február	None
football club	fc	None
potter	fazekas	None
armed	fegyveres	None
(his) family tree	családfája	None
original	eredeti	None
arise	ered	None
after	utána	None
passed	eltelt	None
aside from	eltekintve	None
a hungarian university	elte	None
primarily	elsősorban	None
primary	primer	None
first	legelső	None
sank	elsüllyedt	None
suffered	szenvedtek	None
not a hungarian word. "else" means "más" in hungarian.	else	None
ordered	rendelte	None
perished	elpusztult	None
presidential election	elnökválasztás	None
presidency	elnöksége	None
presidential	elnöki	None
president	elnököt	None
won	szerezte	None
naming	elnevezése	None
name	névvel	None
spread	terjesztette	None
named	névre	None
removed	eltávolították	None
difference	különbséget	None
access	igénybe	None
to reach	elérni	None
available	érhető	None
reach	eléri	None
enough	eléggé	None
edge	peremén	None
divorced	elváltak	None
undertook	vállalta	None
elvis	elvis	None
lost its	elvesztette	None
principle of	elve	None
principle	elvét	None
rejected	elutasították	None
disappeared	szűnt	None
disappear	eltűnik	None
spent	töltötte	None
differently	eltérően	None
different	másmás	None
differences	különbségek	None
differ	különbözik	None
past	múlt	None
in theory	elvileg	None
theoretical	elméleti	None
sent	küldött	None
subsequent	elkövetkező	None
committed	elkövetett	None
completed	lezajlott	None
prepared	készítik	None
conceptions	elképzelések	None
idea	ötlete	None
imagination	elképzelés	None
imaginable	elképzelhető	None
begun	elkezdett	None
avoidance	elkerülése	None
processes	folyamatok	None
process	folyamatot	None
reached	jutottak	None
elizabeth	erzsébetet	None
elite	elit	None
recognition	elismerést	None
appreciations	elismerések	None
recognized	ismerték	None
against	szembeni	None
opposed	ellenezte	None
opponent	ellenfél	None
contraindicated	ellenjavallat	None
theories	elméletek	None
theory	theory	None
account of	elmondása	None
said	nevezett	None
tell	mond	None
went	mentek	None
fled	elmenekült	None
loss	elvesztése	None
check	ellenőrzése	None
convicted	elítélt	None
control	irányítása	None
resistance	ellenállást	None
opposition	ellenzéki	None
opposite	szemközti	None
opposites	ellentétek	None
unlike	ellentétben	None
contradicting	ellentmondásos	None
hostile	ellenséges	None
adversary	ellenség	None
contrary	ellentét	None
against them	ellenük	None
front	fronton	None
live	élő	None
lecture	előadásában	None
emo	emo	None
emma	emma	None
mammals	emlősök	None
mention	említést	None
mentions	említi	None
in memory of	emlékére	None
plaque	emléktáblája	None
monument of sy/sg	emlékműve	None
monument	emlékmű	None
reminder	emlékeztető	None
reminds	emlékeztet	None
remembered	emlékezett	None
memorable	emlékezetes	None
memories	emlékek	None
memory	memória	None
mentioned	említésre	None
emily	emily	None
emil	emil	None
emigrant	emigráns	None
digestion	emésztést	None
i	én	None
encyclopedia	enciklopédia	None
energy	energiája	None
wooded	erdős	None
forests	erdők	None
in the forest	erdőben	None
forest	erdő	None
transylvania	erdélyt	None
episodes	epizódok	None
episode	epizódot	None
ep	ep	None
mildly	enyhén	None
emigration	emigráció	None
milder	enyhébb	None
un	un	None
me	nekem	None
permit	engedélyt	None
authorized	engedélyezték	None
permitted	engedélyezte	None
licensed	engedélyezett	None
permission	engedély	None
allow	lehetővé	None
power	teljesítményt	None
mild	enyhe	None
origin	származása	None
because of this	emiatt	None
lifted	emelte	None
forward	előre	None
advantageous	előnyös	None
advantage of	előnye	None
priority	kiemelt	None
preparatory	előkészítő	None
have been found	előkerült	None
noble	nemesi	None
occuring	előforduló	None
occurrence	előfordulása	None
happened	zajlott	None
occur	fordulnak	None
in the semi finals	elődöntőben	None
semifinal	elődöntő	None
predecessor	elődje	None
former	korábbi	None
presenters	előadók	None
performer	fellépő	None
lectures	előadásokat	None
presentations	előadások	None
progresses	előrehaladtával	None
contributed	közreműködött	None
helps	segíti	None
helping	elősegítő	None
raised	nevelte	None
rise	emelkedő	None
high	magasra	None
increases	növekszik	None
these	ezeknek	None
humanity	emberiség	None
for the people	embereknek	None
people	élők	None
man	férfit	None
erected	felállították	None
human	emberi	None
e-mail	email	None
regulations	előírások	None
production	termelési	None
beforehand	előzőleg	None
preceded	előzte	None
history	történetének	None
preliminary	előzetes	None
to the foreground	előtérbe	None
with formidable pleasure	előszeretettel	None
emancipation	emancipáció	None
family	családot	None
in the same way	ugyanígy	None
almost	szinte	None
mothers	anyák	None
mother	édesanyja	None
speaking	nyelvű	None
materials	anyagokat	None
material	anyagát	None
maternal	anyai	None
antonio	antonio	None
anton	anton	None
anthology	antológia	None
antique	antik	None
antigone	antigoné	None
anticyclone	anticiklon	None
anthony	anthony	None
entente	antant	None
antal	antal	None
more	többet	None
that	miszerint	None
so much	ekkora	None
anne	anne	None
father	édesapja	None
anna	anna	None
paternal	apai	None
project apollo	apolloprogram	None
aristotle	arisztotelész	None
aristocracy	arisztokrácia	None
argentina	argentína	None
argentine	argentin	None
arena	küzdő	None
face of sy/sg	arcát	None
portrait	portré	None
face of	arca	None
scored	arattak	None
victory	győzelmével	None
gold team	aranycsapat	None
golden bull	aranybulla	None
gold	gold	None
of aragon	aragóniai	None
arad	aradi	None
arabs	arabok	None
arabic	arab	None
small	kis	None
apostle	apostol	None
apollo	apollo	None
ann	ann	None
anita	anita	None
animated	animációs	None
anyway	amúgy	None
until	mígnem	None
amy	amy	None
why	miért	None
about	találhatóak	None
you	ön	None
amino acids	aminosavak	None
when	mikor	None
what	mit	None
in which	amiben	None
to america	amerikába	None
americans	amerikaiak	None
american	amerikai	None
america	amerikában	None
in so far as	amennyiben	None
as much as	amennyi	None
which	melyre	None
with which	amellyel	None
besides	mindemellett	None
an	an	None
anapest	anapesztus	None
anatomical	anatómiai	None
anderson	anderson	None
anime	animében	None
anikó	anikó	None
angels	angyalok	None
angel	angyal	None
in english	angolul	None
anglo-saxons	angolszászok	None
anglo-saxon	angolszász	None
english	nyelven	None
in england	angliában	None
arnold	arnold	None
anglican	anglikán	None
angelina	angelina	None
angeles	angelesi	None
andy	andy	None
andré	andré	None
andrássy	andrássy	None
andrew	endre	None
andrea	andrea	None
andor	andor	None
andes	andok	None
england	angolok	None
arsenal	arsenal	None
art	művészetének	None
arthur	artúr	None
bajnai	bajnai	None
wrong	hibás	None
bach	bach	None
babits	babits	None
ever since	azóta	None
therefore	ezért	None
it	róla	None
identified	meghatározta	None
same	ugyanolyan	None
immediate	azonnali	None
immediately	rögtön	None
however	viszont	None
with	tartalmazó	None
in	vesznek	None
those	azokra	None
that day	aznap	None
before	mielőtt	None
say	azaz	None
ayrton	ayrton	None
champion	bajnok	None
championship	bajnokságot	None
champions	bajnokok	None
bavarian	bajor	None
banks	bankok	None
bills	bankjegyek	None
bank	bánk	None
band	zenekar	None
balazs	balázs	None
baltic	balti	None
from the left	balról	None
to the left	balra	None
left	távozott	None
awards	awards	None
balogh	balogh	None
ballet	balett	None
accident	balesetet	None
lake balaton	balaton	None
balassi	balassi	None
balassa	balassa	None
ball	labdát	None
bacteria	baktériumokat	None
bacterial	bakteriális	None
baksheesh	baksis	None
balkan	balkáni	None
ambrus	ambrus	None
award	díját	None
avars	avarok	None
atom	atom	None
atlético	atlético	None
atlantic ocean	atlantióceán	None
atlantis	atlantisz	None
from athens	athéni	None
athens	athén	None
athenaeum	athenaeum	None
at	nál	None
table	táblázatban	None
women	nőket	None
woman	nőt	None
assisi	assisi	None
with asperger syndrome	aspergerszindrómás	None
asimov	asimov	None
ratio of sgs	arányuk	None
nice	kedves	None
relatively	viszonylag	None
ratio	arányban	None
ration of	aránya	None
atomic bomb	atombomba	None
atoms	atomok	None
atp	atp	None
attila	attila	None
avar	avar	None
or	vagy	None
highways	autópályák	None
motorway	autópálya	None
cars	autók	None
bus	busz	None
car	kocsi	None
autonomy	autonómiát	None
autonomic	autonóm	None
inaugurated	avatták	None
automatically	automatikusan	None
autoimmunity	autoimmun	None
autism	autizmus	None
australia	ausztráliában	None
australian	ausztrál	None
austria	ausztriát	None
auschwitz	auschwitz	None
aus - german word	aus	None
in august	augusztusban	None
august	augusztus	None
automatic	automatikus	None
baptism	baptizmus	None
amateur	amatőr	None
from	útra	None
wanted	akarták	None
they want	akarnak	None
to	érdekében	None
will	jelenik	None
academic	akadémiai	None
academy	akadémián	None
prevented	megakadályozta	None
there were	akadtak	None
had	támadt	None
there	ottani	None
recommended	javasolta	None
offer	nyújtanak	None
airsoft	airsoft	None
aires	aires	None
air	légi	None
aids	aids	None
this word does not make sense on its own	ai	None
from where	ahonnan	None
where	hol	None
action	akció	None
as	néven	None
achilles	akhilleusz	None
with whom	akivel	None
shape	formát	None
form	képeznek	None
alajos (forename)	alajos	None
tunnel	alagút	None
aladar	aladár	None
lower	alsóbb	None
low	alacsony	None
al	al	None
just	éppen	None
acacia	akác	None
acoustic	akusztikus	None
actively	aktívan	None
active	aktív	None
current	áram	None
back then	akkoriban	None
the size	akkora	None
then	majd	None
whom	kit	None
to whom	akinek	None
who	who	None
to it	ahhoz	None
brain	agy	None
agatha	agatha	None
give	adni	None
steel	acél	None
act	felvonás	None
agate	achát	None
acdc	acdc	None
ac	ac	None
abu	abu	None
absolute	abszolút	None
absinthe	abszintot	None
abraham	abraham	None
abc	abc	None
from that	abból	None
therein	benne	None
into it	abba	None
aba	aba	None
ab	ab	None
the	á	None
>	>	None
=	=	None
adam	ádám	None
adams	adams	None
data	adatot	None
information	információt	None
african	afrikai	None
africa	afrikában	None
afghan	afgán	None
afghanistan	afganisztáni	None
taxes	adót	None
due	miatti	None
tax	adó	None
ady	ady	None
released	megjelent	None
figures	számokat	None
gave	átadja	None
given	megadott	None
adolf	adolf	None
they	általuk	None
admiral	admirális	None
administrative	közigazgatási	None
enter	adja	None
by then	addigra	None
previous	előző	None
until then	addig	None
adrian	adrian	None
in the form of	alakjában	None
develops	alakul	None
formation	megalakult	None
create	alkot	None
alcohol	alkoholt	None
parts	részre	None
time	ízben	None
occasion	alkalom	None
the occasion	alkalmával	None
on the occasion of	alkalmából	None
occasional	alkalmi	None
applications	alkalmazások	None
application	alkalmazásával	None
applied	alkalmazta	None
employee	munkatársa	None
apply	vonatkoznak	None
used	szokott	None
applicable	alkalmazható	None
opportunity	lehetőségét	None
suitable	alkalmasak	None
occasionally	alkalmanként	None
at the bottom of	alján	None
constitute	alkotják	None
constitution	alkotmányt	None
constitutional court	alkotmánybíróság	None
constitutional	alkotmányos	None
signature of	aláírása	None
signed	jelöltek	None
the following	alábbiak	None
hereinafter	alább	None
aluminum	alumínium	None
bottom	alul	None
alternative	alternatív	None
alps	alpok	None
alpine	vasi	None
barely	alig	None
alonso	alonso	None
allele	allél	None
allen	allen	None
allan	allan	None
constituent	alkotórésze	None
creators	készítők	None
creator	alkotója	None
creative	alkotói	None
creations	alkotások	None
creation	létrehozása	None
apple	álma	None
am	am	None
ali	ali	None
lowland	alföld	None
thoroughly	alaposan	None
based on	épülő	None
foundations	alapjait	None
foundation	megalakulása	None
elementary	elemi	None
basis	alapon	None
nominative (case)	alanyeset	None
alan	alan	None
forming	képező	None
designed	tervezték	None
created	teremtett	None
shaped	alakú	None
formed	kialakított	None
forms	formák	None
evolution	fejlődését	None
developed	kifejlesztett	None
founded	megalapították	None
evolve	fejlődik	None
forces	haderő	None
on	án	None
basic	alapvető	None
basically	alapvetően	None
founder	alapítója	None
alfred	alfréd	None
alfonso	alfonz	None
alpha	alpha	None
alexandra	alexandra	None
alexander	sándor	None
alex	alex	None
alessandro	alessandro	None
vice president	alelnök	None
aldehyde	aldehid	None
plain	síkság	None
albanians	albánok	None
albanian	albán	None
albums	lemezek	None
album	lemez	None
alberto	alberto	None
albert	albert	None
below	alábbi	None
under	alatta	None
alaska	alaszka	None
based	alapú	None
albania	albánia	None
humerus	felkarcsont	None
bar	bár	None
peach	barack	None
viennese	bécsi	None
in vienna	bécsben	None
vienna	wien	None
base	bázis	None
brother	testvére	None
brave	bátor	None
bathory	báthory	None
bastion	bástya	None
baron	báró	None
sheep	juh	None
anytime	bármikor	None
whichever	bármelyik	None
any	valamilyen	None
anyone	bárki	None
mining	bányászat	None
complaints	bántalmak	None
bothers	bánt	None
valentine	bálint	None
bács-kiskun	bácskiskun	None
potamogetonaceae	békaszőlőfélék	None
uncle	nagybátyja	None
peace	nyugalomra	None
békés	békés	None
trust	bízott	None
courts	bíróságok	None
court	udvarán	None
judicial	bírósági	None
criticized	kritizálták	None
have	rendelkeznek	None
cardinal	bíboros	None
rented	bérelt	None
thumbnail i pixels i right i a	bélyegkép|px|jobb|a	None
stamppicture	bélyegkép|px|balra|a	None
stamp picture	bélyegkép|px|a	None
thumbnail i right i pixels i a	bélyegkép|jobb|px|a	None
thumbnail i right i pixels i the	bélyegkép|jobbra|px|az	None
thumbnail i right i pixels	bélyegkép|jobbra|px|	None
a 120 ph thumbnail on the left	bélyegkép|balra|px|a	None
thumbnail	bélyegkép|a	None
enteritis	bélhurut	None
béla	béla	None
békéscsaba	békéscsabán	None
peace treaty	békeszerződést	None
by	útján	None
vitamin b	bvitamin	None
rubiaceae	buzérfélék	None
bronze	bronz	None
britney	britney	None
brits	britek	None
britain	britannia	None
british	british	None
bridge	hídon	None
brian	brian	None
bregma	bregma	None
brazil	brazíliában	None
brazilian	brazil	None
bratislava	pozsonyi	None
brasov	brassói	None
abbreviation of "budapest"	bpest	None
budapest	pesten	None
bozsik	bozsik	None
boy	fiút	None
box	box	None
botticelli	botticelli	None
scandal	botrányt	None
bros	bros	None
brothers	testvérek	None
bruce	bruce	None
gross	bruttó	None
buses	buszok	None
bush	bush	None
burton	burton	None
bulgaria	bulgária	None
fall	esnek	None
fallen	bukott	None
bucharest	bukarest	None
buenos	buenos	None
at buda	budán	None
entrusted	bízták	None
buddhism	buddhizmus	None
buddha	buddha	None
to budapest	pestre	None
of budapest	budapesti	None
in budapest	budapesten	None
buda	budavári	None
bud	bud	None
abbreviation of "deposit company)	bt	None
in brussels	brüsszelben	None
brussels	brüsszel	None
buddhist	buddhista	None
wise	bölcsek	None
browser	böngésző	None
prison	börtönben	None
class	osztályban	None
clark	clark	None
civilization	civilizáció	None
civil	polgári	None
city	városát	None
zircon	cirkon	None
cirill	cirill	None
cyprus	ciprusi	None
cycads	cikászfélék	None
cyclamen	ciklámen	None
cycle	ciklus	None
articles	szócikkek	None
article	szócikk	None
gypsies	cigányság	None
gypsy	cigány	None
cia	cia	None
churchill	churchill	None
chuck	chuck	None
christopher	kristóf	None
claude	claude	None
cleese	cleese	None
cleveland	cleveland	None
cliff	cliff	None
only	egyedüli	None
shortly after	csakhamar	None
csaba	csaba	None
cruz	szegeden	None
cross	kereszt	None
costa	costa	None
corvina	corvina	None
corvin	corvin	None
corona	corona	None
christie	christie	None
concerto	concerto	None
comedy	vígjáték	None
columbia	kolumbia	None
color	színre	None
college	kollégium	None
cobra	cobra	None
cobain	cobain	None
co	co	None
club	klub	None
clint	clint	None
comics	comics	None
bosnia and herzegovina	boszniahercegovina	None
christian	kereszténydemokrata	None
chopin	chopin	None
carl	carl	None
capone	capone	None
canis	canis	None
can	tudom	None
campo	campo	None
camp	tábort	None
cameron	cameron	None
caesar	császárnak	None
c++	c++	None
criminal	bűnügyi	None
sinful	bűnös	None
crimes	bűnök	None
crime	bűnözés	None
sin	bűn	None
easily	bőven	None
proud	büszke	None
penalty	büntetést	None
wheat	búza	None
farewell	búcsú	None
carlo	carlo	None
carlos	carlos	None
carter	kocsis	None
cartman	cartman	None
chile	chile	None
chicago	chicago	None
chelsea	chelsea	None
che	che	None
chase	chase	None
charlie	charlie	None
charles	károly	None
chapman	chapman	None
chaplin	chaplin	None
chris	chris	None
channel	csatornán	None
cf	cf	None
censorship	cenzúra	None
center	középpontja	None
cd	cd	None
not a hungarian word	till	None
catherine	katalin	None
castro	castro	None
casa	casa	None
cartographia	cartographia	None
chandler	chandler	None
barabás	barabás	None
bosnia	boszniai	None
bosnian	bosnyák	None
bem	bem	None
from them	tőlük	None
entered	lépett	None
downtown	belvárosi	None
internal	belső	None
inside	belül	None
interior	belseje	None
bella	bella	None
bell	bell	None
belgrade	nándorfehérvári	None
belgium	belgium	None
belgian	belga	None
domestic	hazai	None
including	többek	None
agreed	megegyezett	None
into	bele	None
bel	bel	None
included	tartalmazza	None
§	§	None
presents	mutatja	None
entrance	bejárata	None
present	mostani	None
presentation	bemutatása	None
spoken	beszélt	None
speak	szólnak	None
we can	beszélhetünk	None
talk	beszélgetés	None
speeches	beszédek	None
speech	beszédében	None
best	legjobban	None
berzsenyi	berzsenyi	None
bertalan	bertalan	None
bernard	bernard	None
in berlin	berlinben	None
berlin	berlini	None
facilities	berendezések	None
post	utáni	None
benefice	benefícium	None
benedict	benedek	None
benedictine	bencés	None
premier od sg	bemutatója	None
exhibition	kiállítás	None
presented	bemutatták	None
qualified	képzett	None
announces	bejelenti	None
announced	bejelentette	None
batthyány	batthyány	None
batman	batman	None
bass	bass	None
friendship	barátságot	None
girlfriend	barátnője	None
friendly	barátságos	None
friends	barátok	None
friend	barátjával	None
bartók	bartók	None
barry	barry	None
barrett	barrett	None
barometer	barométer	None
baroque	barokk	None
barney	barney	None
brown	brown	None
challah	barhesz	None
barcelona	barcelonában	None
barbara	barbara	None
baranya	baranya	None
bay	öböl	None
bayern	bayern	None
basilica	bazilika	None
peony	bazsarózsa	None
enroll	beiratkozott	None
influential	befolyásos	None
affected	érintette	None
affect	érintő	None
influence of	befolyása	None
influence	befolyással	None
the end	végétől	None
finished	végzett	None
unfinished	befejezetlen	None
we are talk	beszélünk	None
beethoven	beethoven	None
estimates	becslések	None
estimation	becslés	None
beckham	beckham	None
beck	beck	None
sy's nickname	beceneve	None
intervention	beavatkozás	None
beatles	beatles	None
beagle	vizsla	None
bbc, british broadcasting corporation	bbc	None
honest	becsületes	None
patient	páciens	None
patients	betegek	None
disease	kör	None
bocskai	bocskai	None
bobby	bobby	None
bob	bob	None
bmw	bmw	None
blocks	gátolja	None
blogs	blogok	None
blog	blog	None
blackmore	blackmore	None
short for a type of football championship	bl	None
byzantine	bizánci	None
operfixi	biztosító	None
assuring of	biztosítása	None
assuring	biztosítva	None
provided	átadott	None
assured	biztosított	None
ensure	biztosítják	None
provide	biztosítani	None
grant	grant	None
surely	biztosan	None
bushy	bokros	None
happy	vidám	None
bulgarian	bolgár	None
bulgarians	bolgárok	None
cover	fedi	None
covered	fedett	None
wine region	borvidék	None
borsodaújzemplén	borsodabaújzemplén	None
wines	borok	None
borderline	borderline	None
skin	bőr	None
books	könyveket	None
book	könyvét	None
sure	biztos	None
complex	összetett	None
person's name	roxfort	None
bon	bon	None
bomb	bomba	None
bolivian	bolíviai	None
bolivia	bolívia	None
planets	bolygók	None
planet	bolygót	None
bolyai	bolyai	None
bolshevik	bolsevik	None
bond	kötés	None
revenge	bosszút	None
safe	biztonságos	None
committee	bizottságának	None
bible	bibliát	None
built-in	beépített	None
of revenue	bevételi	None
taking	figyelembe	None
immigrants	bevándorlók	None
immigration	bevándorlás	None
good	jót	None
introduction of	bevezetését	None
introduction	bevezető	None
introduced	vezették	None
established	állítottak	None
admission	bevallása	None
letters	levelek	None
letter	levél	None
broke into	betört	None
loaded	betöltött	None
banned	betiltották	None
bethlen	bethlen	None
diseases	betegségek	None
biblical	bibliai	None
bibliography	bibliográfia	None
bihari	bihari	None
bill	törvényt	None
evidence	bizonyítékot	None
proved	bizonyított	None
show	utalnak	None
prove	bizonyítja	None
proved to be	bizonyultak	None
uncertain	bizonytalan	None
certain	határozott	None
certainly	bizonnyal	None
bizarre	bizarr	None
safety	biztonsági	None
in posession of	birtokában	None
domain	domén	None
imperial	imperial	None
empire	fejedelemség	None
bipolar	bipoláris	None
biological	biológiai	None
biogeography	biogeográfia	None
bin	bin	None
billy	billy	None
keyboard	billentyűzet	None
owner	tulajdonosa	None
revolt	felkelés	None
insurgents	felkelők	None
visited	látogatott	None
ouch	jaj	None
jagger	jagger	None
jacques	jacques	None
jackson	jackson	None
israeli	izraeli	None
israel	izrael	None
icelandic	izlandi	None
iceland	izland	None
isabel	izabella	None
ix.	ix	None
iván	iván	None
ivan	ivan	None
five	őt	None
italian	olasz	None
italy	olaszországi	None
drinks	italok	None
drink	ital	None
istanbul	isztambul	None
islam	iszlám	None
james	james	None
mudfish	iszaphal	None
jacamar	jakamárfélék	None
iambus	jambus	None
jehovah	jehova	None
spirit	szelleme	None
notes	megjegyzések	None
noted	neves	None
tickets	jegyek	None
icy	jeges	None
jedlik	jedlik	None
jean	johanna	None
jazz	jazz	None
jay	jay	None
proposal	javaslatára	None
benefit	javára	None
jason	jason	None
in japan	japánban	None
japanese	japánok	None
in january	januárban	None
janus	janus	None
jane	jane	None
january	január	None
jamaica	jamaica	None
istván	istvánnak	None
stephen	stephen	None
goddess	istennője	None
manage of sg	irányítását	None
directed	rendezte	None
direct	közvetlen	None
in the direction of	irányába	None
trends	irányzatok	None
trend	irányzat	None
directions	irányból	None
direction	irányt	None
towards	iránt	None
iranian	iráni	None
iran	perzsia	None
literature	szépirodalom	None
literary	irodalmi	None
iraqi	iraki	None
ipod	ipod	None
iphone	iphone	None
of arts and crafts	iparművészeti	None
industrial	ipari	None
industry	iparban	None
leader	élen	None
way	way	None
isaac	isaac	None
isbn	isbn	None
divine	isteni	None
gods	istenek	None
god	istent	None
iso	iso	None
repeating	ismétlődő	None
repeatedly	többször	None
again	újra	None
we know	tudunk	None
knew	ismerte	None
mark	márk	None
met	ütközött	None
unknown	ismeretlen	None
known	tudott	None
knowledge	tudás	None
know	tudják	None
abbreviation of the word "ismétlődés"=repetition	ism	None
island	szigetét	None
schools	iskolák	None
to school	iskolába	None
school	school	None
informative	ismeretterjesztő	None
sign	jele	None
signs	jelek	None
scene	jelenetet	None
jones	jones	None
jonathan	jonathan	None
jon	jon	None
jolán	jolán	None
jolie	jolie	None
johnson	johnson	None
johnny	johnny	None
johannes	johannes	None
johann	johann	None
legal	törvényes	None
rights	jogokat	None
yoga	joga	None
law	törvénye	None
joey	joey	None
joe	joe	None
to the right	jobbra|px|bélyegkép|a	None
right i thumbnail i pixels i a	jobbra|bélyegkép|px|a	None
rightwing	jobboldali	None
better	jobbik	None
jordan	jordan	None
josep	josep	None
joseph	józsef	None
josé	josé	None
vehicles	járművek	None
vehicle	jármű	None
járai	járai	None
go	mennek	None
juventus	juventus	None
per	jutó	None
come	érkezik	None
jupiter	jupiter	None
jump	jump	None
joan	joan	None
july	július	None
shepherd	pásztor	None
yugoslavia	jugoszlávia	None
yugoslav	jugoszláv	None
judit	judit	None
judaism	zsidóság	None
juan	juan	None
jr	jr	None
short for japan	jpn	None
journal	journal	None
sheep dog	juhászkutya	None
io	io	None
jimmy	jimmy	None
jim	jim	None
importance	jelentőségű	None
significant	jelentős	None
meaning	értelme	None
report	jelentést	None
insignificant	jelentéktelen	None
candidate	jelölt	None
could mean	jelenthet	None
reported	számolt	None
meant	jelentett	None
are	állnak	None
published	publikálta	None
mean	értjük	None
phenomenon	jelenséget	None
presence of	jelenlétét	None
in the presence	jelenlétében	None
presence odf sy/sg	jelenléte	None
currently	jelenleg	None
contemporary	kortárs	None
scenes	jeleneteket	None
importance of	jelentőségét	None
indicated	jelezte	None
symbol	szimbóluma	None
represents	képviseli	None
jesuit	jezsuita	None
jerusalem	jeruzsálemi	None
jerry	jerry	None
eugene	jenő	None
jennifer	jennifer	None
nominations	jelölések	None
nomination	jelölés	None
appointed	kinevezett	None
assigned	jelöli	None
jimi	jimi	None
indicate	jelölik	None
indicates	jelzi	None
feature	jellemzője	None
typically	jellemzően	None
specific	jellemző	None
features	tulajdonságait	None
characterized by	jellemzik	None
characteristics	jellegzetessége	None
typical	tipikus	None
nature	volta	None
attributive	jelző	None
traveled	utaztak	None
insulin	inzulin	None
institution	intézmény	None
string holder	húrtartó	None
strings	húrok	None
string	húr	None
sister	húga	None
lady	lady	None
months	hónapra	None
conqueror	hódító	None
castoridae	hódfélék	None
believer	hívő	None
called	ún	None
call	neveznek	None
believers	hívők	None
devotee	híve	None
fame	hírnevet	None
reputation	hírnevét	None
newspaper	újság	None
notorious	hírhedt	None
famous	nevezetes	None
news	hírére	None
meat	hús	None
male	hím	None
easter	húsvéti	None
inch	hüvelyk	None
tourism	turizmus	None
tourist	turisztikai	None
foreign	külföldi	None
here	nálunk	None
ida (forename)	ida	None
senior	id	None
icsigo	icsigo	None
german word	mein	None
ibolya	ibolya	None
ibn	ibn	None
ibm	ibm	None
ian	ian	None
cool	hűvös	None
faithful	hűséges	None
loyal	hű	None
heroes	hősök	None
heroic	hősi	None
hero	hőse	None
temperature	hőmérsékleti	None
twenty	húsz	None
weeks	héttel	None
for a week	hétig	None
seven	hét	None
hybrid	hybrid	None
hussar	huszár	None
twentieth	huszadik	None
hunyadi	hunyadi	None
huns	hunok	None
hun	hun	None
humorous	humoros	None
humor	humor	None
humanist	humanista	None
waves	hullámok	None
wave	hullám	None
hugo	hugo	None
hughes	hughes	None
hugh	hugh	None
html	html	None
approximately	megközelítőleg	None
contribute	hozzájárul	None
to them	hozzájuk	None
they have brought	hozták	None
antiwar	háborúellenes	None
wars	háborúk	None
of war	háborús	None
network	network	None
helium	hélium	None
hebrew	héber	None
händel	händel	None
häkkinen	häkkinen	None
marriage	házasság	None
married couple	házaspár	None
houses	házak	None
on the back of	hátán	None
from behind	hátulról	None
temporary	átmeneti	None
background	térben	None
disadvantage of sg	hátránya	None
back	vissza	None
hymenoptera	hártyásszárnyúak	None
triangle	háromszög	None
three times	háromszor	None
three	három	None
threesome	hármas	None
how many	hány	None
networks	hálózatok	None
rear	hátsó	None
temporarily	átmenetileg	None
for the time of	idejére	None
ideology	ideológia	None
launched	indították	None
(they) start from	indulnak	None
starts	kezdi	None
indonesia	indonézia	None
indonesian	indonéz	None
indo-european	indoeurópai	None
indians	indiánok	None
indian	indián	None
india	indiában	None
index.hu, hungarian infoportal	indexhu	None
index	index	None
increment	increment	None
imre	imre	None
imported products	importtermékek	None
now	now	None
immune system	immunrendszer	None
im	im	None
such	ilyen	None
ilona	ilona	None
march	március	None
infinitive	infinitiv	None
flu	influenza	None
inflation	infláció	None
provisions	írásai	None
online	internetes	None
on the internet	interneten	None
internet	internet	None
internazionale	internazionale	None
international	nemzetközi	None
interview	interjúban	None
interactive	interaktív	None
intensive	intenzív	None
illusion	illúzió	None
intelligent	intelligens	None
beckon	int	None
institute	intézet	None
from here	innentől	None
hence	innen	None
rather	meglehetősen	None
inca	inka	None
free	szabadon	None
infrastructure	infrastruktúra	None
informations	információk	None
intel	intel	None
institutions	intézmények	None
elijah	illés	None
respectively	rendre	None
director	rendezője	None
true	igaz	None
his youth	ifjúkora	None
junior	ifjabb	None
jr.	ifj	None
b.c.	ie	None
with time	idővel	None
stay	tartózkodása	None
the period	időszakra	None
period	period	None
elder	idősebb	None
old	öreg	None
time trial	időmérő	None
weather	időjárási	None
in time	időben	None
quotes	idézi	None
citation	idézet	None
season	évszak	None
ideal	ideális	None
real	valóságos	None
proven	igazolt	None
truth	igazságot	None
justice	igazságügyi	None
relative to	illetően	None
respective	illető	None
concerning	vonatkozó	None
illegal	törvénytelen	None
ildikó	ildikó	None
ikarus	ikarus	None
iii.	iii	None
abbreviation of "second"	ii	None
inspired	ihlette	None
illyes	illyés	None
requiring	igénylő	None
need	szüksége	None
verbs	igék	None
trying to	igyekszik	None
sought	törekedett	None
ignác	ignác	None
very	nagyon	None
verb	igenév	None
really	valóban	None
truly	igazából	None
demand	igényt	None
brought	hoztak	None
epidemic	járvány	None
play	játszik	None
kiss	kiss	None
small stadium	kispályás	None
singles	kislemez	None
kisimoto	kisimoto	None
kisfaludy	kisfaludy	None
minorities	kisebbségi	None
minority	kisebbség	None
smaller/bigger (as a descriptor of a class, like smaller/bigger rocks)	kisebbnagyobb	None
smaller	kisebbik	None
kingdom	királyságot	None
kings	királyok	None
queen	királynő	None
royal	royal	None
tyranni	királygébics-alkatúak	None
kirk	kirk	None
king	királyt	None
treasury	kincstár	None
shown	mutatott	None
detected	kimutatható	None
somewhat	kissé	None
enunciated	kimondta	None
small region	kistérség	None
invented	kitalált	None
exclusively	kizárólag	None
except	leszámítva	None
exceptional	kivételes	None
exceptions	kivételek	None
exception	kivételt	None
execution	kivégzés	None
perfectly	tökéletesen	None
privilege	kiváltság	None
selected	kiválasztott	None
set	állított	None
excellent	kiváló	None
eruptions	kitörések	None
outbreak	kitörése	None
broke	szakított	None
extended	kiterjesztette	None
extending	kiterjedő	None
-range	kiterjedésű	None
(its) volume	kiterjedése	None
extensive	kiterjedt	None
small town	kisváros	None
kimi	kimi	None
left out	kimaradt	None
kim	kim	None
emitted	kibocsátott	None
chiasmus	kiazmus	None
development of	kialakításában	None
design	terve	None
evolving	kialakuló	None
publisher	könyvkiadó	None
charges	vádjával	None
publications	kiadványok	None
publication	kiadvány	None
unpublished	kiadatlan	None
issue	kiad	None
limited liability company	kft	None
hand	átadta	None
treatment of	kezelése	None
treatment	kezelésére	None
treated	kezelte	None
treat	kezelik	None
handles	kezeli	None
hands	kézre	None
turns out	kiderül	None
turned out	kiderült	None
compromise	kiegyezés	None
additional	kiegészítő	None
came out	kilépett	None
kilometer	 kmes	Nan
ninety	kilencvenes	None
ninth	kilencedik	None
nine	kilenc	None
ports	kikötők	None
port of	kikötője	None
port	port	None
proclaimed	kikiáltották	None
classicist	klasszicista	None
states	állítja	None
starting from	kiindulva	None
exploiting	kihasználva	None
extinction	kihalási	None
extinct	kihalt	None
expressions	kifejezések	None
expression	kifejezést	None
was out	kiesett	None
outstanding	kimagasló	None
satisfying	kielégítő	None
stated	állította	None
classicism	klasszicizmus	None
classic	klasszikus	None
klaus	klaus	None
kosztolanyi	kosztolányi	None
kosztka	kosztka	None
kosovo	koszovói	None
wreath	koszorú	None
cosine	koszinusz	None
kossuth	kossuth	None
age	korát	None
far	távol	None
of the age of	korának	None
until age	koráig	None
contemporaries	kortársak	None
modern	újkori	None
era	korában	None
corruption	korrupció	None
coronation	koronázási	None
puck	korong	None
crown	koronát	None
kornel	kornél	None
governor	kormányzó	None
basketball	kosárlabda	None
covalent	kovalens	None
blacksmith	kovács	None
sourdough	kovász	None
cuban	kubai	None
cuba	kuba	None
krúdy	krúdy	None
chronicle of	krónikája	None
chronic	krónikus	None
chronicle	krónika	None
crimean	krími	None
chalk	kréta	None
crater	kráter	None
govermental	kormányzati	None
reviews	kritikákat	None
critics	kritikusok	None
critic	kritikus	None
critical	kritikai	None
criticism	kritikát	None
christ	krisztus	None
krisztina	krisztina	None
crystalline	kristályos	None
abbreviation of "christ"	kr	None
cosmic	kozmikus	None
critique	kritikája	None
starting	kezdődően	None
governments	önkormányzatok	None
government	kormányának	None
more serious	komolyabb	None
serious	súlyosabb	None
communism	kommunizmus	None
communists	kommunisták	None
communist	kommunista	None
communication	kommunikációs	None
comic	képregény	None
columbus	kolumbusz	None
cluj	kolozsvári	None
cluj-napoca	kolozsvár	None
monastery	kolostor	None
collective	kollektív	None
kodály	kodály	None
coalition	koalíciós	None
km	  km	Nan
klára	klára	None
clubs	klubok	None
clinical	klinikai	None
climatology	klimatológia	None
seriously	komolyan	None
composed	komponálta	None
komárom	komárom	None
concentration	koncentrációs	None
limited	korlátozták	None
unlimited	korlátlan	None
korean	koreai	None
ages	kort	None
hound	kopó	None
conservative	konzervatív	None
kitchen	konyha	None
continental	kontinentális	None
continent	kontinensen	None
prime	miniszterelnököt	None
konstantin	konstantin	None
concrete	konkrét	None
congo	kongói	None
congress	kongresszus	None
confederate	konföderációs	None
confederation	konföderáció	None
conflicts	konfliktusok	None
conflict	összetűzésbe	None
conference	konferencián	None
concerts	koncerteket	None
konrad	konrád	None
plays	játssza	None
beginner	kezdő	None
beginning of the	kezdetét	None
characters	írásjegyek	None
damage	károkat	None
goalkeeper	kapus	None
we get	kapunk	None
gate	kapu	None
received	átvett	None
got	szert	None
to get	megszerezni	None
receive	kapnak	None
captain	kapitánya	None
capitalism	kapitalizmus	None
connecting	összekötő	None
they attach	kapcsolódnak	None
connects	kapcsolódik	None
related	összefüggésbe	None
relationships	kapcsolatokat	None
connection	kapcsán	None
contact	érintkezés	None
relations	kapcsolatai	None
carbide	karbid	None
gets	szerez	None
sword	kard	None
karl	karl	None
category: jewish	kategóriazsidó	None
category: german	kategórianémet	None
category name	kategórianevet	None
category: mta members	kategóriamtatagok	None
2 words incorrectly joined together	kategóriamagyar	None
incorrect compound word	kategóriahalálozások	None
(incorrect compound)	kategóriagországok	None
category: budapest	kategóriabudapest	None
incorrect compound	kategóriaországgyűlési	None
this entry is not formatted correctly. what it intends to mean is : "category: american".	kategóriaamerikai	None
category	kategóriában	None
disastrous	katasztrofális	None
catalan	katalán	None
kata	kata	None
abbreviation of "catholic"	kat	None
castle	várnegyed	None
kassa	kassai	None
christmas	karácsonyi	None
career	pályafutását	None
karinthy	karinthy	None
canton	kanton	None
kant	kant	None
kane	kane	None
cattle	szarvasmarha	None
largely	nagyrészt	None
well	jól	None
jókai	jókai	None
jesus	jézust	None
jena	jéna	None
kingfisher	jégmadárfélék	None
ice age	jégkorszak	None
hockey	jégkorong	None
berg	jéghegy	None
ice	jég	None
referee	játékvezető	None
players	játékosok	None
games	játékokon	None
game	meccsen	None
taking place	zajló	None
player	játékosnak	None
played	játszották	None
to play	játszani	None
charitable	jótékonysági	None
much	sokkal	None
came	jött	None
they came	jöttek	None
candela	kandela	None
chancellor	kancellár	None
canadian	kanadai	None
canada	kanadában	None
cambrian	kambrium	None
calorie	kalória	None
kalocsa	kalocsai	None
californian	kaliforniai	None
california	kalifornia	None
kath	kath	None
conductor	vezető	None
rooster	kakas	None
gar	kajmánhalfélék	None
kafka	kafka	None
in june	júniusban	None
june	június	None
in july	júliusban	None
juliet	júlia	None
in the future	továbbiakban	None
future	leendő	None
adventures	kalandjai	None
catholic	katolikus	None
catholics	katolikusok	None
soldier	katona	None
sg's perimeter	kerülete	None
district	kerületében	None
cost	árán	None
gardener	kertész	None
garden	kertjében	None
kernel	kernel	None
waltz	keringő	None
orbiting	keringési	None
orbit	keringenek	None
within the confines	keretében	None
frames	keretek	None
framework	keretén	None
inconsistent examples (translations in order: earning, seekeing)	kereső	None
across	keresztül	None
christianity	kereszténységet	None
christians	keresztények	None
crusaders	keresztesek	None
keresztes	keresztes	None
christening	keresztelő	None
districts	kerületek	None
could be	lehetne	None
to get into	kerülni	None
ended up at	kerültek	None
initial	kiinduló	None
beginnings	kezdetek	None
in the beginning	kezdetben	None
begin	kezdődik	None
initiative	kezdeményezésére	None
initiated	kezdeményezett	None
start	start	None
few	pár	None
less	kisebb	None
godfather	keresztapa	None
mix	keveréke	None
dual	kettős	None
two	két	None
two of them	ketten	None
them	őket	None
cashew	kesu	None
narrow	szűkebb	None
bitter	keserű	None
to be	lenni	None
avoiding	kerülése	None
mixed	vegyes	None
they started	megkezdték	None
seek	keresni	None
merchant	kereskedő	None
was created	keletkezett	None
east european	keleteurópai	None
kelemen	kelemen	None
short for origin	kel	None
keith	keith	None
cruel	kegyetlen	None
for the sake of	kedvéért	None
disadvantageous	kedvezőtlen	None
favorable	kedvező	None
favourite	kedvenc	None
liked	kedvelte	None
kecskemét	kecskeméti	None
goat	kecske	None
approx	kb	None
kazinczy	kazinczy	None
kazakhstan	kazahsztán	None
kazakh	kazah	None
caucasus	kaukázus	None
soldiers	katonákat	None
arose	merült	None
formation of	keletkezésének	None
resulting	keletkező	None
to the east	keletre	None
trade	kereskedelmi	None
commerce	kereskedelem	None
visits / looks for / visits	keresi	None
look for	keres	None
kerepesi	kerepesi	None
kenny	kenny	None
kennedy	kennedy	None
ken	ken	None
hardness	keménység	None
traders	kereskedők	None
harder	nehezebb	None
celts	kelták	None
celtic	kelta	None
cause	okát	None
kelly	kelly	None
needed	kellő	None
should	kellene	None
unpleasant	kellemetlen	None
pleasant	kellemes	None
must	kell	None
hard	nehéz	None
astronauts	űrhajósok	None
bring	hozzák	None
howard	howard	None
metalic	fémes	None
metals	fémek	None
metal	metal	None
half breed	félvér	None
hemisphere	féltekén	None
peninsula	félsziget	None
half	félig	None
halftime	félidőben	None
fear	félelem	None
party	részes	None
phase	szakaszában	None
pharaoh	fáraó	None
trees	fák	None
files	fájlok	None
file:character	fájlcharacter	None
(meaningless compound)	fájlbudapest	None
file	fájl	None
pain	fájdalom	None
pheasant	fácánfélék	None
light	light	None
running	húzódó	None
bright	fényes	None
men	férfiak	None
depends	függ	None
fusion	fúziós	None
inconsistent examples (német föld=german land - földön fekvő=líing on the ground)	földön	None
(sg of) geological history	földtörténeti	None
earthquakes	földrengések	None
earthquake	földrengés	None
geographical	földrajzi	None
geography	földrajza	None
feldspars	földpátok	None
of agriculture	földművelés	None
mediterranean sea	földközitenger	None
ground	talajon	None
natural gas	földgáz	None
underground	underground	None
earth	földet	None
federation	szövetsége	None
her husband	férje	None
husband	férjét	None
man's name	férfinév	None
pentastomida	féregatkák	None
ran	húzódott	None
race	verseny	None
run	fut	None
france	franciaországi	None
fox	róka	None
photos	képei	None
fossil	fosszilis	None
forum	fórum	None
hot	forró	None
sources	forrásokból	None
source	forrásból	None
revolutionary	forradalmi	None
revolution	forradalomban	None
in the form	formájában	None
in formula 1	formulaben	None
formula	formulaes	None
formal	formális	None
forint	forint	None
rotating	forgó	None
rotation	forgási	None
colon is required here (forgatókönyv=script)	forgatókönyvcs	None
scenario	forgatókönyv	None
francesco	francesco	None
french	franciák	None
to france	franciaországba	None
in france	franciaországban	None
strange	különös	None
functions	függvények	None
function	függvény	None
drowned	fulladt	None
fulham	fulham	None
abbreviation of various words	ft	None
fresh	frissen	None
friedrich	frigyes	None
freud	freud	None
independent	önálló	None
frequency	frekvencia	None
fred	fred	None
françois	françois	None
franz	franz	None
franklin	franklin	None
frankfurt	frankfurt	None
frank	frank	None
franco	franco	None
in french	franciául	None
francisco	francisco	None
freddie	freddie	None
independence	függetlenségét	None
independently	függetlenül	None
dependent	függő	None
gera	gera	None
georges	georges	None
george	györgy	None
georg	georg	None
geomorphology	geomorfológia	None
geometric	geometriai	None
geometry	geometria	None
geological	geológiai	None
from geneva	genfi	None
geneva	genfben	None
genetic	genetikai	None
generation	nemzedék	None
general	általános	None
gellért	gellért	None
gedeon	gedeon	None
gdp	gdp	None
gbr	gbr	None
economically	gazdaságilag	None
economic	közgazdasági	None
john	jánost	None
german	német	None
get	szerezni	None
gillan	gillan	None
gnu	gnu	None
gmail	gmail	None
glover	glover	None
global	globális	None
globe prize	globedíj	None
globe	globe	None
globalization	globalizáció	None
glaciers	gleccserek	None
gizella	gizella	None
economy	gazdaságot	None
giuseppe	giuseppe	None
guitars	gitárok	None
guitar	gitár	None
girls	lányok	None
girl	lányt	None
giovanni	giovanni	None
giorgio	giorgio	None
high school	középiskolák	None
gilmour	gilmour	None
gilliam	gilliam	None
guitarist	gitáros	None
filming	forgatása	None
rich	gazdag	None
gastronomy	gasztronómia	None
boss	főnöke	None
noun	főnévi	None
phoenix	phoenix	None
nouns	főnevek	None
especially	kifejezetten	None
mostly	többnyire	None
mainly	főként	None
protagonist	főszereplő	None
archduchess	főhercegnő	None
archduke	főherceg	None
major	őrnagy	None
main	fő	None
grassy	füves	None
bath	fürdő	None
für	für	None
philippines	fülöpszigetek	None
earwigs	fülbemászók	None
vertical	függőleges	None
depending	függően	None
commander in chief	főparancsnoka	None
main role	főszerepet	None
starring	főszereplője	None
leading characters	főszereplők	None
gary	gary	None
garcía	garcía	None
gandhi	gandhi	None
gallery	galéria	None
galleria	galleria	None
gaul	gall	None
galileo	galileo	None
galilei	galilei	None
galaxy	galaxis	None
farmer	gazda	None
gaga	gaga	None
gabriela	gabriela	None
gabriel	gabriel	None
ga	ga	None
bringing	hozó	None
ties in to/with	fűződik	None
highway	főút	None
metropolitan	fővárosi	None
capital	tőke	None
lords	főurak	None
gabriella	gabriella	None
goethe	goethe	None
filmed	forgatták	None
traffic	közlekedési	None
infection	fertőzés	None
ferrari	ferrari	None
fernando	fernando	None
ferenczy	ferenczy	None
ferencz	ferencz	None
francis	francis	None
ferenc	ferenccel	None
franciscan	ferences	None
ferdinand	ferdinánd	None
threatened	fenyegette	None
phenol	fenol	None
existing	létező	None
to maintain	fenntartani	None
remaining	fennmaradó	None
preserved	őrzik	None
authority of sy/sg	fennhatósága	None
jurisdiction of	fennhatóság	None
supervisor	felügyelő	None
supervision	felügyelete	None
infections	fertőzések	None
restauration of	felújítása	None
infected	fertőzött	None
painted	festett	None
(follow) with attention	figyelemmel	None
fifa	fifa	None
fidesz	fidesz	None
fidel	fidel	None
fiction	szépirodalmi	None
youth	ifjúsági	None
younger	fiatalabb	None
young	young	None
sons	fiai	None
son	son	None
feudal	feudális	None
tensions	feszültségek	None
tension	feszültséget	None
painters	festők	None
painter	festőművész	None
paintings	festményei	None
painting	festészet	None
festival	fesztiválon	None
painted by	festette	None
contageous	fertőző	None
renovation	felújítás	None
was established	felépült	None
structure	szerkezetű	None
superlative	felsőfokú	None
upper	fenti	None
urged	felszólította	None
on the surface of	felszínén	None
on the surface	felszínen	None
surface	felületet	None
equipped	felszerelt	None
listed	felsorolt	None
partition	felosztás	None
adults	felnőttek	None
adult	felnőtt	None
arisen	felmerült	None
warming up	felmelegedés	None
actions	fellépése	None
acted	felléptek	None
performed	teljesített	None
can be found	megtalálható	None
invited	meghívta	None
added	felkerült	None
higher education	felsőoktatási	None
probably	vélhetően	None
presumably	feltehetőleg	None
condition	állapot	None
set up	felállított	None
shooting	forgatás	None
recordings	felvételeket	None
record	életű	None
alternately	felváltva	None
enlightenment	felvilágosodás	None
admitted	felvették	None
acquired	szerzett	None
recorded	rögzítették	None
observed	megfigyelhető	None
pick up	felvenni	None
appeared	tűnt	None
appear	tűnnek	None
unconditionally	feltétlenül	None
assumptions	feltételezések	None
assumption	feltételezés	None
presumeably	feltételezhető	None
assumed	feltételezett	None
conditions	viszonyok	None
requirement	feltétele	None
conspicuous	feltűnő	None
consideration	szempont	None
attention	figyelmét	None
movie	movie	None
continues to	folytatja	None
conducted	végzik	None
was	volte	None
flow	ömlik	None
continuously	folyamatosan	None
continuous	folyamatos	None
in progress	folyamatban	None
spots	foltok	None
increased	növelte	None
gradually	fokozatosan	None
gradual	fokozatos	None
degree	°	None
consumption	fogyasztása	None
consuming	fogyasztják	None
took	átvették	None
captivity	fogságba	None
prisoner	fogoly	None
conquered	meghódította	None
profession	foglalkozás	None
continue	továbbra	None
continued	folytatódott	None
constant	állandó	None
due to	következtében	None
translator	fordító	None
translations	fordítások	None
translation	fordítása	None
the other way around	fordítva	None
translated	fordította	None
round	menet	None
turned	megfordult	None
turn	forduló	None
ford	ford	None
dealt	foglalkoztak	None
forbes	forbes	None
leptotyphlopidae	fonálkígyófélék	None
fontsize	fontsizes	None
more important	fontosabb	None
important	fontosnak	None
pound	font	None
magazine	magazin	None
rivers	folyók	None
river	folyón	None
liquid	folyékony	None
football	labdarúgók	None
market	piacra	None
engaged	foglalkozott	None
reserves	foglal	None
florence	firenzében	None
firefox	firefox	None
fire	tűz	None
fine	finom	None
finno-ugric	finnugor	None
finland	finnország	None
finnish	finn	None
finger	finger	None
philosophers	filozófusok	None
philosopher	filozófus	None
philosophical	filozófiai	None
philosophy	filozófiája	None
filmography	filmográfia	None
cimetaic art	filmművészet	None
movie critics	filmkritikusok	None
films	filmjei	None
film festival	filmfesztivál	None
movies	filmeket	None
film	filmre	None
florentine	firenzei	None
foreskin	fityma	None
fiume	fiume	None
paid	fizetett	None
concept	koncepció	None
formulated	megfogalmazott	None
concepts	fogalmak	None
teeth	fogak	None
adopted	fogadott	None
tooth	fog	None
fodor	fodor	None
fm	fm	None
floyd	floyd	None
deal	kezelni	None
fleet	flotta	None
fk	fk	None
boys	fiúk	None
physicists	fizikusok	None
physicist	fizikus	None
phisically	fizikailag	None
physical	testi	None
physics	fizika	None
payment	fizetési	None
to pay	fizetni	None
flemish	flamand	None
take	vinni	None
gogh	gogh	None
button	gomb	None
our country	hazánkban	None
hungary	magyarországért	None
country	vidék	None
returned	visszatértek	None
patriotic	hazafias	None
on the way home	hazafelé	None
home	otthonában	None
haydn	haydnt	None
havaii	hawaii	None
monthly	havonta	None
authorities	hatóságok	None
acting	működő	None
effective	hatékony	None
effects	hatások	None
effect	életbe	None
adverb	határozószó	None
determined	határozzák	None
firmly	határozottan	None
adjacent	szomszédos	None
violin	hegedű	None
delimited	határolja	None
hegedus	hegedűs	None
mountain	hegység	None
sites	helyszínek	None
local	helyi	None
located	állott	None
puts	helyezi	None
placed	helyezték	None
instead	helyette	None
correctly	helyesen	None
right	ügye	None
in some places	helyenként	None
locations	helyeken	None
places	helyek	None
in the place	helyben	None
place	végbe	None
heliocentric	heliocentrikus	None
helikon	helikon	None
heinrich (a person's name)	heinrich	None
highland	hegyvidéki	None
highlands	hegyvidék	None
mountains	hegyek	None
welding	hegesztés	None
borders	határok	None
border of	határában	None
border	határát	None
hungarian mountain	hargita	None
warriors	harcosok	None
warrior	harcos	None
fighting	harcoló	None
fought	vívott	None
in battles	harcokban	None
fights	harcok	None
martial	harcművészeti	None
fight	meccset	None
hans	hans	None
hannah	hannah	None
hanks	hanks	None
worded	hangú	None
sounding	hangzású	None
sounded	hangzott	None
antbird	hangyászmadárfélék	None
intonation	hangvételű	None
concert	koncertet	None
mood	hangulat	None
woodpeckers	harkályfélék	None
third	harmadik	None
thirty	harminc	None
30's	harmincas	None
sixties	hatvanas	None
could	tudták	None
sixth	vi	None
huge	hatalmas	None
powers	hatalmak	None
six	hat	None
usable	használható	None
in use	használatban	None
use	használni	None
site	helyszínen	None
useful	használatos	None
like	tetszik	None
similar	hasonló	None
diarrhea	hasmenés	None
laxative	hashajtó	None
ripper	hasfelmetsző	None
harvard	harvard	None
harry	harryt	None
harrison	harrison	None
harold	harold	None
similarly	hasonlóképpen	None
incorrect	helytelen	None
state	állapotot	None
position	pozíciót	None
in the netherlands	hollandiában	None
holland	hollandia	None
dutch	holland	None
lunar module	holdkomp	None
moons	holdak	None
moon	moon	None
how	miként	None
month	hő	None
germ	hn	None
lacking	híján	None
missing	hiányzó	None
lacked	hiányzott	None
miss	miss	None
lack of	hiánya	None
in vain	hiába	None
professional	szakmai	None
intended to	hivatott	None
reference	utalás	None
referring to	utalva	None
hollywood	hollywoodi	None
raven	holló	None
holmes	holmes	None
tomorrow	holnap	None
house	házában	None
hotel	szálló	None
long	sokáig	None
longer	hosszabb	None
length	hosszúságú	None
croatia	horvátország	None
croat	horvátok	None
horváth	horváth	None
croatian	horvát	None
referred	hivatkozott	None
horthy	horthy	None
website	weboldala	None
hong kong	hongkongi	None
hongkong	hongkong	None
conquest	hódítás	None
honda	honda	None
homosexual	homoszexuális	None
homo	homo	None
body	testület	None
holocaust	holokauszt	None
defense	honvédelmi	None
accent	hangsúlyt	None
refer to	hivatkoznak	None
official	hivatalos	None
hetfield	hetfield	None
week	héten	None
weekly	heti	None
seventh	vii	None
begone	hess	None
hermione	hermione	None
hermann	hermann	None
princedom	hercegség	None
princess	hercegnő	None
prince (of sg)	hercege	None
herbert	herbert	None
hepatitis	hepatitis	None
henry	henry	None
henri	henri	None
hendrix	hendrix	None
hemingway	hemingway	None
replaced	váltották	None
situation	rendezni	None
in situation	helyzetben	None
seventies	hetvenes	None
vehement	heves	None
mistake	hiba	None
mistakes	hibák	None
office	tisztséget	None
believed	hitt	None
hitler	hitler	None
authentic	hiteles	None
credit	hitel	None
one's religion	hite	None
faith	hitre	None
because	okán	None
suddenly	hirtelen	None
officially	hivatalosan	None
announced, advertised	hirdette	None
hinduism	hinduizmus	None
hindu	hindu	None
anthem	himnusza	None
hill	hill	None
unbelievable	hihetetlen	None
cold war	hidegháború	None
cold	hideg	None
bridges	hidak	None
error	hibát	None
promoted	hirdetett	None
golden	golden	None
articular	ízületi	None
instrumental	hangszeres	None
inflammation	gyulladás	None
gyula	gyulai	None
gyula (forename)	gyula	None
expressway	gyorsforgalmi	None
faster	gyorsabban	None
fast	gyorsan	None
stomach	gyomor	None
weed	gyom	None
murders	gyilkosságok	None
murder	gyilkosság	None
killer	gyilkos	None
as child	gyermekeként	None
childhood	gyermekkorában	None
children	gyermekük	None
kids	gyerekek	None
child	gyermek	None
weaker	gyengébb	None
weak	gyenge	None
gyarmati	gyarmati	None
gyurcsány	gyurcsány	None
colony	gyarmat	None
factory	gyár	None
manufacturer	gyártó	None
rings	gyűrűk	None
ring	ring	None
meeting	találkozó	None
collected	gyűjtött	None
collection	gyűjteménye	None
győző	győző	None
winner	győztes	None
to win	megnyerni	None
of győr	győri	None
győr (hungarian city)	győr	None
fruit	gyümölcs	None
beautiful	szép	None
nacre	gyöngyház	None
roots	gyökerei	None
medicines	gyógyszerek	None
medicine	medicina	None
sg's curative effect	gyógyhatása	None
spa	gyógyfürdő	None
diamonds	gyémántok	None
manufacturing	gyártási	None
on foot	gyalog	None
more often	gyakrabban	None
often	sokszor	None
graham	graham	None
graphite	grafit	None
graphic	grafikus	None
gottfried	gottfried	None
gothic	gótikus	None
gordon	gordon	None
google	google	None
evil	gonosz	None
gong	gong	None
trouble	gondot	None
carefully	gondosan	None
thinkers	gondolkodók	None
thinking	gondolkodó	None
think	szerintük	None
thoughts	gondolatok	None
thought	vélték	None
troubles	gondok	None
mushrooms	gombák	None
mushroom	gomba	None
gran	gran	None
grand	grand	None
grande	grande	None
gravity	gravitációs	None
impacted	gyakoroltak	None
practicing	gyakorló	None
virtually	gyakorlatilag	None
practically	gyakorlatban	None
exercise	gyakorlat	None
more common	gyakoribb	None
common	közös	None
frequent	gyakori	None
guy	guy	None
gábor	gábor	None
gustave	gusztáv	None
guide	útikalauz	None
guevara	guevara	None
georgian	grúz	None
countship	grófság	None
earl	grófja	None
granite	gránit	None
groom	groom	None
griffin	griffin	None
gray	szürke	None
tuber	gumó	None
guards	gárda	None
gárdonyi	gárdonyi	None
gáspár	gáspár	None
listened	hallgatott	None
to hear	hallani	None
going	járás	None
moved	megindult	None
proceed	halad	None
fish	halak	None
sailors	hajós	None
on a ship	hajón	None
ships	hajók	None
ship	hajót	None
executed	kivégezték	None
out	kifelé	None
drove	hajtott	None
early morning	hajnali	None
dawn	hajnalban	None
willing	hajlandó	None
prestine	hajdani	None
leaving	hagyva	None
let	hagyták	None
audible	hallható	None
mortuary	halotti	None
died	meghalt	None
branchiura	haltetvek	None
musical instruments	hangszerek	None
sounds	hangok	None
sound	szólal	None
voice	hangját	None
ashes	hamvait	None
hamlet	hamlet	None
false	téves	None
hamilton	hamilton	None
hamburg	hamburg	None
traditionally	hagyományosan	None
earlier	korábban	None
fishing	halászat	None
to his death	haláláig	None
lethal	halálos	None
death gods	halálistenek	None
death penalty	halálbüntetést	None
capital punishment	halálbüntetés	None
at sy's death	halálakor	None
(his) death	halála	None
death	halálával	None
soon	rövidesen	None
emphasis	hangsúly	None
traditional	tradicionális	None
tradition	hagyomány	None
greek	görögül	None
görgey	görgey	None
görgei	görgei	None
curved	görbe	None
sphere	gömb	None
pelecanidae	gödényfélék	None
lead	vezér	None
shot	vetett	None
goals	gólok	None
gyros	gírosz	None
géza (common fist name)	géza	None
machinery production	gépgyártás	None
machines	gépek	None
machine	gép	None
genes	gének	None
gene	gén	None
shrike	gébicsfélék	None
gases	gázok	None
gas	gáz	None
greece	görögországban	None
greeks	görögök	None
if	ha	None
habsburg	habsburg	None
legacy of	hagyatéka	None
strategic	stratégiai	None
military leadership	hadvezetés	None
corps	hadtest	None
army group	hadseregcsoport	None
army	seregével	None
division	hadosztály	None
lieutenant	hadnagy	None
operation	művelet	None
traditions	hagyományok	None
campaigns	hadjáratok	None
navy	haditengerészet	None
war	üzent	None
gabble	hadarás	None
armies	hadak	None
hadean	hadaikum	None
military	katonái	None
although	noha	None
habsburgs	habsburgok	None
house of habsburg	habsburgház	None
campaign	hadjáratot	None
-	−	None
