$	$	None
मालिश	மசாஜ்	Nan
मालिनी	மாலினி	Nan
मालिकों	உரிமையாளர்கள்	Nan
मालिकाना	தனியுரிம	Nan
मालिक	உரிமையாளர்	Nan
माला	கார்லண்ட்	Nan
मालदीवज	மாலத்தீவுகள்	Nan
मालदीव	மாலத்தீவு	Nan
माल	பொருட்கள்	None
मार्शल	மார்ஷல்	Nan
मार्मिक	தொடுதல்	Nan
मार्टिन	மார்ட்டின்	None
मार्चअप्रैल	மார்ச் ஏப்ரல்	Nan
मार्च	மார்ச்	None
मार्गों	வழிகள்	None
मार्गशीर्ष	சாலை தலை	Nan
मार्गरेट	மார்கரெட்	Nan
मार	கொல்லுங்கள்	Nan
मारना	கொலை	None
मारने	கொல்ல	Nan
मारवाड़	மார்வார்	Nan
मारा	வெற்றி	Nan
मारी	மாரி	None
मालूम	தெரிந்தவை	Nan
मारीच	மாரிச்	Nan
मार्क	குறி	None
मार्क्स	மார்க்ஸ்	None
मार्क्सवाद	மார்க்சியம்	Nan
मार्क्सवादी	மார்க்சிஸ்ட்	Nan
मार्ग	வழி	Nan
मार्गदर्शन	வழிகாட்டல்	Nan
मारे	கொல்லப்பட்டார்	None
माले	ஆண்	None
मासिक	மாதாந்திர	Nan
मास्टर	குரு	None
मिथ्या	பொய்	Nan
मिनट	நிமிடம்	Nan
मिनर्वा	மினெர்வா	Nan
मिनी	மினி	Nan
मिर्च	மிளகாய்	Nan
मिर्ज़ा	மிர்சா	Nan
मिथुन	ஜெமினி	Nan
मिर्जा	மிர்சா	Nan
मिलकर	ஒன்றாக	None
मिलती	பெறு	Nan
मिलते	சந்திக்கிறேன்	Nan
मिलन	மிலன்	Nan
मिलना	பெறு	Nan
मिलने	சந்திக்க	Nan
मिल	பெறு	Nan
माया	மாயா	None
मिथिला	மிதிலா	Nan
मित्रों	நண்பர்கள்	None
माह	மாதம்	None
माहवारी	மாதவிடாய்	None
माहौल	காற்றுமண்டலம்	Nan
मिंग	மிங்	None
मिट	அழிக்கப்பட்டது	Nan
मिटटी	மண்	None
मिथक	கட்டுக்கதை	Nan
मिटा	அழிக்க	None
मिट्टी	மண்	None
मिठाई	இனிப்பு	Nan
मिडिया	மீடியா	None
मित्तल	மிட்டல்	Nan
मित्र	நண்பர்	Nan
मित्रता	நட்பு	None
मिटाने	அழிக்க	None
मिला	சந்தித்தார்	Nan
मायनों	அவ்வப்போது	Nan
मामूली	மைனர்	None
माध्यमिक	இரண்டாம் நிலை	Nan
माधुर्य	மெல்லிசை	Nan
माधुरी	மாதுரி	Nan
माधव	மாதவ்	Nan
मादा	பெண்	None
मादक	போதை	Nan
माथे	நெற்றியில்	Nan
माथुर	சுருக்கமாக கூறினார்	Nan
मात्रा	அளவு	None
मात्र	மட்டும்	None
मातृभाषा	அம்மா தொடுதல்	Nan
मातृ	அம்மா	None
मातापिता	தாய் தந்தை	Nan
माता	அம்மா	None
मातरम्	மாதரம்	Nan
मात	சிறப்பாக செயல்படுங்கள்	Nan
माचिस	தீப்பெட்டி	Nan
मांगी	தேடியது	Nan
मांगे	மாங்கே	Nan
मांस	இறைச்சி	None
मांसपेशियों	தசைகள்	Nan
मांसाहारी	அசைவம்	Nan
माइक्रो	மைக்ரோ	None
माध्यमों	நடுத்தரங்கள்	Nan
माइक्रोप्रोसेसर	நுண்செயலி	Nan
माई	மாய்	Nan
माउंट	மவுண்ட்	None
माउण्ट	மவுண்ட்	None
माउन्टबेटन	மவுண்ட்பேட்டன்	Nan
माउस	சுட்டி	None
माघ	மாக்	Nan
माइक्रोसॉफ्ट	மைக்ரோசாப்ட்	None
मान	மதிப்புகள்	None
मानकीकरण	தரப்படுத்தல்	Nan
मानकीकृत	தரப்படுத்தப்பட்டது	Nan
मानी	ஏற்றுக்கொள்ளப்பட்டது	Nan
माने	மானே	Nan
मानो	என்பது போல	Nan
मान्य	செல்லுபடியாகும்	Nan
मान्यता	அங்கீகாரம்	None
मान्यताओं	நம்பிக்கைகள்	None
माना	ஒப்புக்கொண்டது	Nan
माप	அளவீட்டு	None
मापने	அளவிடுதல்	Nan
मापा	அளவிடப்படுகிறது	None
मामला	விஷயம்	Nan
मामले	வழக்குகள்	None
मामलों	விவகாரங்கள்	None
मामा	தாய்வழி மாமா	Nan
मापन	அளவீட்டு	None
मायने	பொருள்	None
मानसून	பருவமழை	Nan
मानसिंह	மன் சிங்	Nan
मानकों	தரநிலைகள்	Nan
मानचित्र	வரைபடம்	None
मानचित्रावली	வரைபடம்	None
मानचित्रों	வரைபடங்கள்	None
मानता	ஒப்புக்கொள்கிறார்	Nan
मानती	ஒப்புக்கொள்கிறேன்	Nan
मानसिक	மன	None
मानते	கவனியுங்கள்	Nan
मानना	ஏற்றுக்கொள்	Nan
मानव	மனிதன்	None
मानवता	மனிதநேயம்	Nan
मानवीय	மனிதன்	None
मानस	மனம்	None
मानसरोवर	மன்ஸ்ரோவர்	Nan
मानद	க .ரவ	Nan
मिलाकर	உட்பட	None
मिलान	பொருத்துக	Nan
मिलाने	குலுக்கல்	Nan
मूल्यों	மதிப்புகள்	None
मूल्यांकन	மதிப்பீடு	None
मूल्यवान	மதிப்பிடப்பட்டது	Nan
मूल्य	மதிப்பு	None
मूलभूत	அடிப்படை	None
मूलतः	அடிப்படையில்	None
मूलत	முதலில்	None
मूल	அசல்	None
मूर्धन्य	ஹோலி	Nan
मूर्तियों	சிலைகள்	None
मूर्तियां	சிற்பங்கள்	None
मूर्तियाँ	சிலைகள்	None
मूर्तिकला	சிற்பம்	None
मूर्त	உறுதியான	Nan
मूर	மூர்	Nan
मूत्रमार्ग	யுரேத்ரா	Nan
मूत्र	சிறுநீர்	None
मुरादाबाद	மொராதாபாத்	Nan
मुलाकात	சந்தித்தல்	Nan
मुलायम	மென்மையான	None
मुश्किल	கடினம்	None
मुसलमान	முஸ்லிம்	None
मुसलमानों	முஸ்லிம்கள்	None
मूसा	மோசே	Nan
मुहब्बत	காதல்	None
मुहाने	வாய்	None
मुहावरा	இடியம்	Nan
मुहावरे	idioms	Nan
मुहावरों	இடியம்ஸ்	Nan
मुहूर्त	சுப ஆரம்பம்	Nan
मूक	அமைதியாக	Nan
मुहम्मद	முஹம்மது	None
मृग	மான்	None
मृगी	மான்	None
मृत	இறந்தவர்கள்	Nan
मेन	முதன்மை	None
मेनन	மேனன்	Nan
मेमोरियल	நினைவகம்	None
मेमोरी	நினைவு	None
मेयर	மேயர்	None
मेरा	என்	None
मेट्रो	மெட்ரோ	None
मेरूशीर्ष	புதன்	None
मेल	ஒற்றுமை	None
मेला	நியாயமான	Nan
मेले	நியாயமான	Nan
मेवाड	மேவாட்	Nan
मेसोपोटामिया	மெசொப்பொத்தேமியா	Nan
मेहता	மேத்தா	Nan
मेरे	என்	None
मुम्बई	மும்பை	None
मेटास्टेसिस	மெட்டாஸ்டாஸிஸ்	Nan
मेजर	மேஜர்	None
मृतक	இறந்தவர்கள்	Nan
मृतोत्थान	உயிர்த்தெழுதல்	Nan
मृत्यु	மரணம்	None
मृदा	மண்	None
मे	நான்	None
मेँ	நான்	None
मेटाबोलिज्म	வளர்சிதை மாற்றம்	Nan
में	இல்	None
मेगस्थनीज	மெகாஸ்டீனஸ்	Nan
मेघ	மேகம்	None
मेघदूत	மேக்தூட்	Nan
मेच	பொருத்துக	Nan
मेजबान	புரவலன்	Nan
मेजबानी	ஹோஸ்டிங்	Nan
मेक्सिको	மெக்சிகோ	None
मुमताज	மும்தாஜ்	Nan
मुफ्त	இலவசமாக	Nan
मुनियों	துறவிகள்	Nan
मीथेन	மீத்தேன்	Nan
मीन	மீனம்	Nan
मीना	மீனா	Nan
मीनाक्षी	மீனாட்சி	None
मीनार	கோபுரம்	Nan
मीराबाई	மீரா பாய்	Nan
मीडिया	மீடியா	None
मील	மி	Nan
मुंडा	மொட்டையடித்தது	Nan
मुंबई	மும்பை	None
मुंशी	கணக்காளர்	Nan
मुंह	வாய்	None
मुकदमा	நீதிமன்ற வழக்கு	Nan
मुकदमे	வழக்கு	None
मुँह	வாய்	None
मुकाबला	போட்டி	None
मीठे	இனிப்பு	Nan
मीट	இறைச்சி	None
मिलाया	கலப்பு	None
मिली	கிடைத்தது	None
मिलेंगे	சந்திக்கலாம்	Nan
मिलेगा	கிடைக்கும்	None
मिलेनियर	மில்லியனர்	Nan
मिशन	மிஷன்	None
मीटर	மீட்டர்	None
मिशनरी	மிஷனரி	Nan
मिश्रित	கலப்பு	None
मिसाल	முன்னோடி	None
मिस्र	எகிப்து	None
मिस्रवासियों	எகிப்தியர்கள்	Nan
मिस्रवासी	எகிப்தியர்கள்	Nan
मी	எம்	None
मिश्रण	கலவை	None
मांगने	கேட்க	Nan
मुकाबले	ஒப்பிடும்போது	None
मुकेश	முகேஷ்	Nan
मुग़ल	முகலாய	None
मुझको	என்னை	None
मुझसे	என்னுடன்	Nan
मुझे	என்னை	None
मुठभेड़	என்கவுண்டர்	Nan
मुताबिक	படி	None
मुगलों	முகலாயர்கள்	Nan
मुद्दा	பிரச்சனை	Nan
मुद्दों	சிக்கல்கள்	None
मुद्रा	நாணய	None
मुद्राओं	நாணயங்கள்	None
मुद्रित	அச்சிடப்பட்டது	Nan
मुनाफ़िक़	லாபம்	Nan
मुनि	முனி	None
मुद्दे	பிரச்சனைகள்	None
मुकुट	மகுடம்	Nan
मुगल	முகலாய	None
मुख्यालय	தலைமையகம்	None
मुक्त	இலவசம்	Nan
मुक्ति	சுதந்திரம்	None
मुख	வாய்	None
मुखपृष्ठ	முன் பக்கம்	Nan
मुखर	வெளிப்படையாக	None
मुखर्जी	முகர்ஜி	Nan
मुख्‍य	முதன்மை	None
मुखिया	தலைவர்	None
मुख्यत	முக்கியமாக	None
मुख्यतः	முக்கியமாக	None
मुख्यतया	முக்கியமாக	None
मुख्यधारा	பிரதான நீரோடை	Nan
मुख्यमंत्री	முதல் அமைச்சர்	Nan
मुख्यमन्त्री	முதல் அமைச்சர்	Nan
मुख्य	முதன்மை	None
मांग	தேவை	None
मां	அம்மா	None
माँगी	தேவை	None
मज़बूत	வலுவான	None
मजबूर	உதவியற்ற	Nan
मजबूत	வலுவான	None
मजनूँ	மஜ்னு	Nan
मजदूरी	ஊதியம்	Nan
मजदूर	தொழிலாளி	Nan
मछली	மீன்	Nan
मछलियों	மீன்கள்	None
मच्छरों	கொசுக்கள்	Nan
मच्छर	கொசு	Nan
मगहर	மகர்	Nan
मगर	ஆனாலும்	None
मगध	மகத்	Nan
मक्खन	வெண்ணெய்	Nan
मक्का	சோளம்	None
मकार	மகர	Nan
मकानों	வீடுகள்	None
मंत्री	அமைச்சர்	None
मंत्रों	மந்திரங்கள்	Nan
मंथन	மூளை புயல்	Nan
मंदिर	கோயில்	None
मंदिरों	கோயில்கள்	None
मंदी	மந்தநிலை	Nan
मज्जा	மஜ்ஜை	Nan
मई	மே	None
मकड़ी	சிலந்தி	None
मकतौम	மக்தூம்	Nan
मकबरा	கல்லறை	None
मकबरे	கல்லறை	None
मकर	மகர	Nan
मकान	வீடு	None
मकई	சோளம்	None
मठ	மடாலயம்	Nan
मठों	மடங்கள்	Nan
मणि	மணி	None
मदिरा	ஒயின்கள்	Nan
मदिरालय	உணவகம்	Nan
मदीना	மதீனா	Nan
मदुरई	மதுரை	None
मद्रास	மெட்ராஸ்	None
मधुमक्खी	தேனீ	Nan
मदर	அம்மா	None
मधुमती	மதுமதி	Nan
मधुर	இனிப்பு	Nan
मधुशाला	மதுக்கூடம்	Nan
मध्य	நடுவில்	None
मध्यकाल	இடைக்காலம்	Nan
मध्यकालीन	இடைக்காலம்	Nan
मध्यपूर्व	மத்திய கிழக்கு	Nan
मधुमेह	நீரிழிவு நோய்	Nan
मंत्रियों	அமைச்சர்கள்	None
मदनलाल	மதன்லால்	Nan
मददगार	உதவியாக இருக்கும்	Nan
मणिकर्णिका	மணிகர்னிகா	Nan
मण्डप	பெவிலியன்	Nan
मण्डल	வாரியம்	Nan
मत	வாக்களியுங்கள்	Nan
मतगणना	வாக்குகளின் எண்ணிக்கை	Nan
मतदाताओं	வாக்காளர்கள்	Nan
मदन	மதன்	Nan
मतदान	வாக்களியுங்கள்	Nan
मतानुसार	கருத்துப்படி	None
मतों	வாக்குகள்	None
मत्स्य	மீன்	Nan
मथुरा	மதுரா	Nan
मद	பொருள்	None
मदद	உதவி	None
मतभेद	வித்தியாசம்	None
मंत्रिमंडल	அமைச்சரவை	None
मंत्रिपरिषद	அமைச்சர்கள் சபை	Nan
मंत्रि	அமைச்சர்	None
भूषण	கருணை	None
भूस्खलन	நிலச்சரிவு	Nan
भृगु	பிரிகு	Nan
भेंट	பிரசாதம்	Nan
भेज	அனுப்புக	Nan
भेजना	அனுப்புகிறது	Nan
भूवैज्ञानिक	புவியியலாளர்	Nan
भेजने	அனுப்புகிறது	Nan
भेजे	அனுப்புக	Nan
भेड़	செம்மறி	Nan
भेद	வேறுபாடு	None
भेदभाव	பாகுபாடு	Nan
भेष	மாறுவேடம்	Nan
भैंस	எருமை	Nan
भेजी	அனுப்பப்பட்டது	Nan
भैरव	பைரவ்	Nan
भूल	மறந்துவிட்டேன்	Nan
भूमिगत	நிலத்தடி	None
भूकंपी	பூகம்பம்	Nan
भूकम्पों	பூகம்பங்கள்	Nan
भूख	பசி	None
भूखंड	சூழ்ச்சி	Nan
भूगोल	நிலவியல்	None
भूटान	பூட்டான்	None
भूरे	பிரவுன்	Nan
भूत	பேய்	None
भूभाग	நிலப்பரப்பு	None
भूमध्य	மத்திய தரைக்கடல்	Nan
भूमध्यसागरीय	மத்திய தரைக்கடல்	Nan
भूमि	பூமி	None
भूमिका	பங்கு	None
भूमिकाओं	பாத்திரங்கள்	None
भूतपूर्व	முன்னாள்	None
मध्यप्रदेश	மத்தியப் பிரதேசம்	Nan
भैरवनाथ	பைரவ்நாத்	Nan
भोग	இன்பம்	Nan
मंगोलिया	மங்கோலியா	Nan
मंगोलों	மங்கோலியர்கள்	Nan
मंचू	மஞ்சு	Nan
मंजिल	தரை	Nan
मंजूर	ஒப்புதல்	None
मंजूरी	அனுமதி	None
मंगोल	மங்கோலியர்	Nan
मंडप	பெவிலியன்	Nan
मंडलों	வட்டங்கள்	Nan
मंडी	சந்தை	None
मंडेला	மண்டேலா	None
मंत्र	மந்திரம்	Nan
मंत्रालय	அமைச்சகம்	Nan
मंत्रालयों	அமைச்சுக்கள்	Nan
मंडल	குழு	None
भोंसले	போன்ஸ்லே	Nan
मंगेशकर	மங்கேஷ்கர்	Nan
मंगल	செவ்வாய்	None
भोज	விருந்து	None
भोजन	உணவு	None
भोजपुरी	போஜ்புரி	Nan
भोपाल	போபால்	Nan
भोसले	போஸ்லே	Nan
भौगोलिक	புவியியல்	None
मंगलवार	செவ்வாய்	None
भौतिक	உடல்	None
भ्रम	ஒரு கட்டுக்கதை	Nan
भ्रमण	டூர்	Nan
भ्रमित	குழப்பமான	Nan
भ्रष्ट	சிதைந்த கோப்பு	Nan
भ्रष्टाचार	ஊழல்	None
भ्रूण	கரு	None
भौतिकी	இயற்பியல்	None
मेहनत	கடின உழைப்பு	Nan
मध्ययुग	இடைக்காலம்	Nan
मध्यवर्ती	இடைநிலை	None
महानगरों	மெட்ரோக்கள்	Nan
महानगरीय	பெருநகர	Nan
महानगर	பெருநகர	Nan
महान	நன்று	None
महाद्वीपों	கண்டங்கள்	None
महाद्वीपीय	கான்டினென்டல்	Nan
महाद्वीप	கண்டம்	None
महादेवी	மகாதேவி	Nan
महादेव	சிவன்	None
महात्मा	மகாத்மா	None
महाकाव्यों	காவியங்கள்	Nan
महाकाव्य	காவியம்	None
महाकालेश्वर	மகாகலேஷ்வர்	Nan
महाकाल	மகாகலா	Nan
महाकवि	சிறந்த கவிஞர்	Nan
महा	அருமை	Nan
महसूस	உணருங்கள்	Nan
महंगी	விலை உயர்ந்தது	Nan
महज	வெறுமனே	None
महत्ता	முக்கியத்துவம்	None
महत्त्व	முக்கியத்துவம்	None
महत्त्वपूर्ण	முக்கியமான	None
महत्व	முக்கியத்துவம்	None
महानता	பெருமை	None
महत्वपूर्ण	முக்கியமான	None
महत्वाकांक्षी	லட்சியம்	Nan
महत्‍वपूर्ण	முக்கியமான	None
महमूद	மெஹ்மூத்	Nan
महर्षि	மகரிஷி	Nan
महल	அரண்மனை	None
महलों	அரண்மனைகள்	Nan
महत्वाकांक्षा	லட்சியம்	Nan
महानदी	மகாநதி	Nan
महान्	பெரிய	None
महापुरुषों	பெரிய மனிதர்கள்	Nan
महिलाएं	பெண்கள்	None
महिलाओं	பெண்கள்	None
महिषासुर	மகிஷாசுரா	Nan
महीना	மாதம்	None
महीने	மாதம்	None
महेंद्र	மகேந்திரா	Nan
महिलाएँ	பெண்கள்	None
महेन्द्र	மகேந்திரா	Nan
महोत्सव	திருவிழா	None
मा	அம்மா	None
माँ	அம்மா	None
माँग	தேவை	None
माँगने	கேட்க	Nan
माँगा	மங்கா	Nan
महेश	மகேஷ்	Nan
महंगा	விலை உயர்ந்தது	Nan
महिमा	மகிமை	Nan
महासागरीय	பெருங்கடல்	None
महाबलि	மகாபலி	Nan
महाभारत	மகாபாரதம்	None
महामंदी	பெரும் மந்தநிலை	Nan
महामारी	பெருவாரியாக பரவும் தொற்று நோய்	Nan
महायान	மகாயானா	Nan
महायुद्ध	உலக போர்	Nan
महासागरों	பெருங்கடல்கள்	Nan
महाराज	ராஜா	None
महाराणा	மகாராணி	Nan
महारानी	ராணி	None
महाराष्ट्र	மகாராஷ்டிரா	Nan
महाशक्ति	சூப்பர் வலிமை	Nan
महाशिवरात्रि	மகாசிவராத்திரி	Nan
महासागर	பெருங்கடல்	None
महाराजा	ராஜா	None
मस्ती	வேடிக்கை	Nan
मस्तिष्क	மூளை	None
मस्तिषक	மூளை	None
मनोरंजन	பொழுதுபோக்கு	Nan
मनोरम	கவரும்	None
मनोविक्षिप्ति	மனநோய்	Nan
मनोविज्ञान	உளவியல்	None
मनोविज्ञानी	உளவியலாளர்	Nan
मनोवैज्ञानिक	உளவியலாளர்	Nan
मनोनीत	பரிந்துரைக்கப்பட்டார்	Nan
मनोवैज्ञानिकों	உளவியலாளர்கள்	None
मन्त्र	மந்திரம்	Nan
मन्त्री	அமைச்சர்	None
मन्त्रों	மந்திரங்கள்	Nan
मन्दिर	கோயில்	None
मन्दिरों	கோயில்கள்	None
ममता	ஒரு தாயின் காதல்	Nan
मनोहर	வசீகரம்	Nan
ममी	மம்மி	Nan
मनुस्मृति	மனுஸ்மிருதி	Nan
मनु	மனு	None
मध्यस्थ	மத்தியஸ்தர்	Nan
मध्यस्थता	மத்தியஸ்தம்	Nan
मध्याह्न	மெரிடியன்	Nan
मन	மனம்	None
मनन	சிந்தனை	None
मनमोहन	மன்மோகன்	None
मनुष्यों	மனிதர்கள்	None
मना	மறுக்க	Nan
मनाए	கொண்டாடுங்கள்	Nan
मनाते	கொண்டாடுகிறது	Nan
मनाने	நம்புங்கள்	Nan
मनाया	கொண்டாடப்பட்டது	Nan
मनाये	கொண்டாடுங்கள்	Nan
मनी	பணம்	None
मनाई	கொண்டாடப்பட்டது	Nan
मध्ययुगीन	இடைக்காலம்	Nan
मय	மே	None
मरते	இறக்க	None
मल्होत्रा	மல்ஹோத்ரா	Nan
मशहूर	பிரபலமானது	None
मशीन	இயந்திரம்	None
मशीनरी	இயந்திரங்கள்	None
मशीनी	இயந்திரம்	None
मशीनों	இயந்திரங்கள்	None
मल्टीमीडिया	மல்டிமீடியா	Nan
मसनवी	மஸ்னவி	Nan
मसालों	மசாலா	Nan
मसीह	கிறிஸ்து	None
मसूरी	முசோரி	Nan
मस्जिद	பள்ளிவாசல்	Nan
मस्जिदों	மசூதிகள்	Nan
मस्तक	தலை	None
मसलन	உதாரணமாக	None
मर	இறக்க	None
मलेशिया	மலேசியா	None
मलिक	மாலிக்	Nan
मरने	இறக்க	None
मरम्मत	பழுதுபார்க்கவும் அல்லது மீண்டும் நிறுவவும்	Nan
मराठा	மராத்தா	Nan
मराठी	கொடி	None
मराठों	மராட்டியர்கள்	Nan
मरियम	மேரி	Nan
मलेरिया	மலேரியா	None
मरीज	நோயாளி	Nan
मरीना	மெரினா	None
मरुस्थल	பாலைவனம்	None
मर्यादा	அடக்கம்	None
मल	மலம்	None
मलय	மலாய்	None
मलयालम	மலையாளம்	Nan
मरीजों	நோயாளிகள்	None
मेहरगढ़	மெஹர்கர்	Nan
मेहराब	பரம	Nan
मै	நான்	None
रुझान	போக்கு	None
रुचि	ஆர்வம்	None
रुख	நிற்க	Nan
रुक्मिणी	ருக்மிணி	Nan
रुका	நிறுத்தப்பட்டது	Nan
रुकने	நிறுத்து	Nan
रुक	உறைய	Nan
रीति	மன்னர்	None
रीढ़	முதுகெலும்பு	Nan
रीडर	வாசகர்	None
रिहा	வெளியிடப்பட்டது	None
रिसाव	கசிவு	Nan
रिसर्च	ஆராய்ச்சி	None
रिश्तेदारों	உறவினர்கள்	Nan
रिश्तेदार	உறவினர்	Nan
रिश्ते	உறவுகள்	None
रिश्ता	உறவு	None
रिकॉर्ड	சாதனை	None
रिकॉर्डिंग	பதிவு	Nan
रिक्शा	ரிக்‌ஷா	Nan
रिचर्ड	ரிச்சர்ட்	Nan
रिजर्व	இருப்பு	None
रिपब्लिकन	குடியரசுக் கட்சி	Nan
रुड़की	ரூர்க்கி	Nan
रिपोर्ट	அறிக்கை	None
रियासत	சுதேச அரசு	Nan
रियो	ரியோ	Nan
रिलायंस	நம்பகத்தன்மை	Nan
रिलीज	வெளியீடு	None
रिलीज़	வெளியீடு	None
रिवाजों	பழக்க வழக்கங்கள்	Nan
रियल	உண்மையானது	Nan
रुद्र	ருத்ரா	Nan
रुप	வடிவம்	None
रुपए	பணம்	None
रेखा	வரி	None
रेखाएँ	கோடுகள்	None
रेखाओं	கோடுகள்	None
रेखाचित्र	ஸ்கெட்ச்	Nan
रेगिस्तान	பாலைவனம்	None
रेगिस्तानी	பாலைவனம்	None
रेंज	சரகம்	Nan
रेजिमेंट	ரெஜிமென்ட்	Nan
रेडियो	வானொலி	None
रेडियोधर्मी	கதிரியக்க	None
रेड्डी	ரெட்டி	Nan
रेणु	ரேணு	Nan
रेणुका	ரேணுகா	Nan
रेत	மணல்	None
रेड	சிவப்பு	None
रिकार्ड	சாதனை	None
रे	ரே	Nan
रूस	ரஷ்யா	None
रुपये	ரூபாய்	None
रूचि	ஆர்வம்	None
रूढ़ियों	மாநாடுகள்	Nan
रूढ़िवादी	கன்சர்வேடிவ்	Nan
रूप	வடிவம்	None
रूपक	உருவகம்	Nan
रूसी	ரஷ்யன்	Nan
रूपरेखा	அவுட்லைன்	Nan
रूपांतरण	மாற்றம்	None
रूपांतरित	மாற்றப்பட்டது	None
रूपान्तर	மாற்றம்	None
रूपान्तरण	மாற்றம்	None
रूपी	பார்	None
रूपों	படிவங்கள்	None
रूपांतर	தழுவல்	Nan
राहुल	ராகுல்	Nan
राहु	ராகு	Nan
राही	பயணி	Nan
राधा	ராதா	None
राधाकृष्ण	ராதாகிருஷ்ணா	Nan
राधाकृष्णन	ராதாகிருஷ்ணன்	None
रानी	ராணி	None
राम	ரேம்	Nan
रामकृष्ण	ராமகிருஷ்ணா	Nan
रात्रि	இரவு	None
रामचंद्र	ராம்சந்திரா	Nan
रामचरितमानस	ராம்சரித்மனாஸ்	Nan
रामजी	ராம்ஜி	Nan
रामदास	ராம்தாஸ்	Nan
रामदेव	ராம்தேவ்	Nan
रामधारी	ராம்தாரி	Nan
रामनगर	ராம்நகர்	Nan
रामचन्द्र	ராம் சந்திரா	Nan
रामनवमी	ராம் நவமி	Nan
रात	இரவு	None
राज्‍य	நிலை	None
राजस्थानी	ராஜஸ்தானி	Nan
राजस्व	வருவாய்	None
राजा	ராஜா	None
राजाओं	அரசர்கள்	None
राजी	ஒப்புக்கொள்கிறேன்	Nan
राजीव	ராஜீவ்	None
राणा	ராணா	Nan
राजे	ராஜே	Nan
राजेन्द्र	ராஜேந்திரா	Nan
राजेश	ராஜேஷ்	Nan
राज्यपाल	கவர்னர்	Nan
राज्यसभा	மாநிலங்களவை	Nan
राज्याभिषेक	முடிசூட்டு விழா	Nan
राज्यॉ	மாநிலங்களில்	None
राजेंद्र	ராஜேந்திரா	Nan
रेतीले	சாண்டி	Nan
रामनाथ	ராம்நாத்	Nan
राममोहन	ராம் மோகன்	Nan
राष्ट्रमंडल	காமன்வெல்த்	None
राष्ट्रवाद	தேசியவாதம்	Nan
राष्ट्रवादी	தேசியவாதி	Nan
राष्ट्रीय	தேசிய	None
राष्ट्रों	தேசங்கள்	Nan
राष्‍ट्रीय	தேசிய	None
राष्ट्रभाषा	தேசிய மொழி	Nan
रास	ராஸ்	Nan
रासायनिक	வேதியியல்	None
रासो	ரசோ	Nan
रास्ता	வழி	Nan
रास्ते	வழி	Nan
राह	வழி	Nan
राहत	துயர் நீக்கம்	Nan
रासलीला	ரஸ்லீலா	Nan
रामपुर	ராம்பூர்	Nan
राष्ट्रपति	ஜனாதிபதி	None
राष्ट्र	தேசம்	None
रामलीला	ராம் லீலா	Nan
रामानंद	ராமானந்த்	Nan
रामानन्द	ராமானந்த்	Nan
रामानुजन	ராமானுஜன்	Nan
रामायण	ராமாயணம்	Nan
रामेश्वरम	ராமேஸ்வரம்	Nan
राष्ट्रगान	தேசீய கீதம்	Nan
राय	கருத்து	None
रायपुर	ராய்ப்பூர்	Nan
रायबरेली	ரே பரேலி	Nan
राव	ராவ்	None
रावण	இராவணன்	None
राशि	தொகை	None
राशियों	இராசி அறிகுறிகள்	Nan
रायता	ரைதா	Nan
राजस्थान	ராஜஸ்தான்	Nan
रेफरी	நடுவர்	Nan
रेलगाड़ी	ரயில்	None
लहरें	அலைகள்	None
लहर	அலை	None
लसिका	நிணநீர்	None
लश्कर-ए-तैयबा	லஷ்கர்-இ-தைபா	Nan
लव	காதல்	None
लय	ரிதம்	Nan
लम्बे	உயரமான	None
लम्बी	நீண்டது	Nan
लम्बाई	நீளம்	None
लम्बा	நீண்டது	Nan
लन्दन	லண்டன்	None
लता	க்ரீப்பர்	Nan
लड्डू	லட்டு	Nan
लडाई	போர்	None
लड़ाई	சண்டை	None
लड़ाइयाँ	போர்கள்	None
लड़ा	போராடியது	Nan
लगाव	இணைப்பு	None
लगी	நிச்சயதார்த்தம் செய்யப்பட்டது	Nan
लगे	நிச்சயதார்த்தம் செய்யுங்கள்	Nan
लगेगा	எடுக்கும்	None
लघु	சிறிய	None
लटका	தொங்கு	None
लहरों	அலைகள்	None
लड़	சண்டை	None
लड़कियों	பெண்கள்	None
लड़की	பெண்	None
लड़के	சிறுவர்கள்	None
लड़कों	சிறுவர்கள்	None
लड़ते	சண்டை	None
लड़ने	சண்டை	None
लड़का	பையன்	None
ला	லா	None
लाइट	ஒளி	None
लाइन	வரிசை	None
लाभ	நன்மை	None
लाभकारी	நன்மை பயக்கும்	Nan
लाभदायक	இலாபகரமான	Nan
लाभप्रद	நன்மை பயக்கும்	Nan
लाभों	நன்மைகள்	Nan
लामा	லாமா	Nan
लापता	காணவில்லை	Nan
लायक	மதிப்பு	None
लायी	கொண்டு வரப்பட்டது	Nan
लाये	கொண்டு வாருங்கள்	Nan
लार्ड	ஆண்டவரே	Nan
लाल	சிவப்பு	None
लालटेन	விளக்கு	None
लालबहादुर	லல்பஹதூர்	Nan
लाया	கொண்டு வரப்பட்டது	Nan
लगाये	போடு	Nan
लाने	கொண்டு வாருங்கள்	Nan
लादेन	லாடன்	Nan
लाइनों	கோடுகள்	None
लाइफ	வாழ்க்கை	None
लाइव	வாழ்க	None
लाइसेंस	உரிமம்	None
लाए	கொண்டு வரப்பட்டது	Nan
लाकर	கொண்டு வருவதன் மூலம்	Nan
लाना	கொண்டு வாருங்கள்	Nan
लाख	லட்சம்	None
लागत	செலவு	None
लागू	பொருந்தும்	None
लाजपत	லஜ்பத்	Nan
लाता	கொண்டு வருகிறது	Nan
लाती	கொண்டு வாருங்கள்	Nan
लाते	கொண்டு வாருங்கள்	Nan
लाखों	மில்லியன் கணக்கானவர்கள்	Nan
लगायी	பயன்படுத்தப்பட்டது	None
लगाया	நடப்பட்டது	Nan
लगाने	வைக்க	None
रोचक	சுவாரஸ்யமானது	Nan
रोजगार	வேலைவாய்ப்பு	None
रोड	சாலை	None
रोम	ரோம்	None
रोमन	ரோமன்	None
रोमांस	காதல்	None
रोगों	நோய்கள்	None
रोमानी	காதல்	None
रोलिंग	உருட்டுதல்	Nan
रोशन	ஒளிரும்	Nan
रोशनी	ஒளி	None
रोहिणी	ரோகினி	Nan
ल	லே	Nan
लंकाकाण्ड	லங்கா	Nan
रोल	ரோல்	Nan
लंगड़ा	நொண்டி	Nan
रोगी	நோயாளி	Nan
रोग	நோய்	None
रेलमार्ग	இரயில் பாதை	Nan
रेलवे	ரயில்வே	None
रेशम	பட்டு	None
रेशमी	சில்கி	Nan
रैदास	ரைடாஸ்	Nan
रॉक	பாறை	None
रोगियों	நோயாளிகள்	None
रॉबर्ट	ராபர்ட்	None
रोक	நிறுத்து	Nan
रोकता	நிறுத்துகிறது	Nan
रोकथाम	தடுப்பு	None
रोकना	நிறுத்து	Nan
रोकने	தடுக்க	None
रोका	நிறுத்தப்பட்டது	Nan
रॉयल	ராயல்	None
रेल	ரயில்	None
लंगर	நங்கூரம்	Nan
लंबा	நீண்டது	Nan
लगते	தெரிகிறது	None
लगना	உணருங்கள்	Nan
लगने	தெரிகிறது	None
लगभग	பற்றி	None
लगा	உணர்ந்தேன்	Nan
लगाई	போடு	Nan
लगती	தெரிகிறது	None
लगाए	நடப்பட்டது	Nan
लगाता	பொருந்தும்	None
लगातार	தொடர்ந்து	None
लगाती	விண்ணப்பிக்கவும்	Nan
लगाते	விண்ணப்பிக்கிறது	Nan
लगान	வரி	None
लगाना	அமைப்பதற்கு	Nan
लगाकर	விண்ணப்பிப்பதன் மூலம்	Nan
लंदन	லண்டன்	None
लगता	தெரிகிறது	None
लखनऊ	லக்னோ	Nan
लंबाई	நீளம்	None
लंबी	நீண்ட	None
लंबे	நீண்ட	None
लकड़ी	மரம்	None
लक्षण	அறிகுறிகள்	None
लक्षणा	பண்புகள்	None
लखनवी	லக்னோவி	Nan
लक्षणों	அறிகுறிகள்	None
लक्ष्मण	லக்ஷ்மன்	Nan
लक्ष्मी	லட்சுமி	None
लक्ष्मीबाई	லக்ஷ்மி பாய்	Nan
लक्ष्य	நோக்கம்	Nan
लक्ष्यों	இலக்குகள்	None
लक्स	லக்ஸ்	Nan
लक्षित	இலக்கு	None
भूकंप	பூகம்பம்	Nan
राजसी	இளவரசர்	Nan
राजवंशों	வம்சங்கள்	Nan
यीशु	கிறிஸ்தவ சமயத்தை தோற்றுவித்தவர்	Nan
याहू	யாகூ	None
यार्क	யார்க்	Nan
यानी	அதாவது	None
यानि	அதாவது	None
यान	வாகனம்	None
यादव	யாதவ்	Nan
यादगार	மறக்கமுடியாதது	Nan
यात्री	பயணி	Nan
यात्रियों	பயணிகள்	None
यात्रा	பயணம்	Nan
यातायात	போக்குவரத்து	None
याज्ञवल्क्य	யஜ்னாவல்க்யா	Nan
याचिका	மனு	None
याचना	வேண்டுகோள்	Nan
यांत्रिक	மெக்கானிக்கல்	Nan
या	அல்லது	None
यथासंभव	முடிந்தவரை	Nan
यदि	என்றால்	None
यद्यपि	என்றாலும்	None
यम	யமா	Nan
यमुना	யமுனா	Nan
यश	புகழ்	None
यु	ஒய்	Nan
यह	இது	None
यहाँ	இங்கே	None
यहां	இங்கே	None
यही	இது மட்டுமே	Nan
यहीं	இங்கே மட்டும்	Nan
यहूदियों	யூதர்கள்	None
यहूदी	யூத	None
यहा	இங்கே	None
युक्त	கொண்டிருக்கும்	None
युक्ति	உதவிக்குறிப்பு	Nan
युक्तियों	உதவிக்குறிப்புகள்	Nan
यूट्यूब	வலைஒளி	Nan
यूनवर्स	பிரபஞ்சம்	Nan
यूनाइटेड	யுனைடெட்	None
यूनान	கிரீஸ்	None
यूनानी	கிரேக்கம்	None
यूनिकोड	யூனிகோட்	Nan
यूजर	பயனர்	None
यूनिक्स	யூனிக்ஸ்	Nan
यूनियन	யூனியன்	None
यूनेस्को	யுனெஸ்கோ	None
यूपीए	யுபிஏ	Nan
यूरोप	ஐரோப்பா	None
यूरोपिय	ஐரோப்பிய	Nan
यूरोपियन	ஐரோப்பிய	Nan
यूनिट	அலகு	None
यथार्थवादी	யதார்த்தமானது	Nan
यूक्लिड	யூக்லிட்	Nan
यूँ	இது போன்ற	Nan
युग	சகாப்தம்	None
युगल	ஜோடி	Nan
युगों	காலங்கள்	None
युग्म	ஜோடி	Nan
युद्घ	போர்	Nan
युद्धों	போர்கள்	None
यूं	இது போன்ற	Nan
युधिष्ठिर	யுதிஷ்டிரா	Nan
युरोप	ஐரோப்பா	None
युवक	சிறுவன்	None
युवराज	இளவரசன்	None
युवा	இளம்	None
युवाओं	இளைஞர்கள்	None
युवावस्था	இளைஞர்கள்	None
युनेस्को	யுனெஸ்கோ	None
यथार्थवाद	யதார்த்தவாதம்	Nan
यथार्थ	உண்மை	None
यथा	என	Nan
मॉनसून	பருவமழை	Nan
मॉरीशस	மொரீஷியஸ்	Nan
मॉल	மால்	None
मोक्ष	இரட்சிப்பு	Nan
मोटर	மோட்டார்	None
मोटर्स	மோட்டார்ஸ்	Nan
मॉड्यूल	தொகுதி	None
मोटा	கொழுப்பு	None
मोटी	கொழுப்பு	None
मोटे	கொழுப்பு	None
मोडल	மோடல்	Nan
मोड़	திரும்பவும்	None
मोती	முத்து	None
मोतीलाल	மோதிலால்	Nan
मोटाई	தடிமன்	Nan
मोदी	மோடி	Nan
मॉडलिंग	மாடலிங்	Nan
मैसूर	மைசூர்	None
मैं	நான்	None
मैंने	நான்	None
मैक	மேக்	Nan
मैक्स	அதிகபட்சம்	Nan
मैच	போட்டி	Nan
मैचों	போட்டிகளில்	Nan
मॉडल	மாதிரி	Nan
मैत्री	நட்பு	None
मैथुन	கணக்கீடு	Nan
मैदान	புலம்	None
मैदानी	வெற்று	Nan
मैदानों	சமவெளி	None
मैन	ஆண்	None
मैने	நான்	None
मैथिलीशरण	மைதிலிஷரன்	Nan
यूरोपीय	ஐரோப்பிய	Nan
मोनोऑक्साइड	மோனாக்சைடு	Nan
मोमबत्ती	மெழுகுவர்த்தி	Nan
मौसम	வானிலை	None
मौसमी	பருவகால	Nan
म्यूकर	முக்கர்	Nan
म्यूजिक	இசை	None
म्यूजियम	அருங்காட்சியகம்	None
य	இது	None
मौलिक	அசல்	None
यंत्र	சாதனம்	None
यकृत	கல்லீரல்	None
यक्ष	யக்ஷ	Nan
यजुर्वेद	யஜுர்வேத்	Nan
यज्ञ	யஜ்னா	Nan
यज्ञों	யாகியர்கள்	Nan
यत्न	விடாமுயற்சியுடன்	Nan
यंत्रों	வாத்தியங்கள்	Nan
मोम	மெழுகு	None
मौलाना	ம ula லானா	Nan
मौर्य	ம ur ரியா	Nan
मोर्चा	முன்	None
मोहन	மோகன்	None
मोहनदास	மோகன்தாஸ்	Nan
मोहम्मद	முகமது	None
मोहित	ஈர்க்கப்பட்ட	Nan
मौका	வாய்ப்பு	None
मौर्यों	ம ury ரியர்கள்	Nan
मौके	வாய்ப்பு	None
मौजूदा	இருக்கும்	None
मौत	மரணம்	None
मौतें	இறப்புகள்	None
मौतों	இறப்புகள்	None
मौद्रिक	பண	None
मौन	ம ile னம்	Nan
मौजूद	தற்போது	None
राजशाही	முடியாட்சி	Nan
ये	இவை	None
योग	யோகா	Nan
राक्षस	பேய்	None
राकेश	ராகேஷ்	Nan
राउटर	திசைவி	None
राइबोसोम	ரைபோசோம்	None
राँची	ராஞ்சி	Nan
रहो	இருங்கள்	Nan
रहेगी	இருக்கும்	None
रहेगा	இருக்கும்	None
रहेंगे	இருக்கும்	None
रहें	இருங்கள்	Nan
रहे	உள்ளன	None
रहीम	ரஹீம்	Nan
रहीं	தங்கியிருந்தார்	Nan
रही	செய்து	None
रहित	இலவசமாக	Nan
रहा	தங்கியிருந்தார்	Nan
रहस्यों	மர்மங்கள்	Nan
रवीन्द्रनाथ	ரவீந்திரநாத்	Nan
रस	சாறு	None
रसायन	கெமிக்கல்ஸ்	Nan
रसूल	ரசூல்	Nan
रसोई	சமையலறை	None
रस्सी	கயிறு	Nan
राक्षसी	பேய்	None
रह	இருங்கள்	Nan
रहता	நீடிக்கும்	None
रहते	வாழ்க	None
रहना	வாழ	None
रहने	வாழும்	None
रहमान	ரஹ்மான்	Nan
रहस्य	மர்மம்	Nan
रहकर	தங்குவதன் மூலம்	Nan
राक्षसों	பேய்கள்	Nan
राख	சாம்பல்	Nan
राखी	ராக்கி	None
राजनीती	அரசியல்	Nan
राजनेता	அரசியல்வாதி	Nan
राजनैतिक	அரசியல்	Nan
राजन्	ராஜன்	None
राजपथ	நெடுஞ்சாலை	None
राजपूत	ராஜ்புத்	Nan
राजनीतिज्ञ	அரசியல்வாதி	Nan
राजपूताना	ராஜ்புதன	Nan
राजभाषा	உத்தியோகபூர்வ மொழி	Nan
राजमहल	அரண்மனை	None
राजमार्ग	நெடுஞ்சாலை	None
राजमार्गों	நெடுஞ்சாலைகள்	Nan
राजवंश	ஆள்குடி	Nan
राजवंशीय	வம்சம்	None
राजपूतों	ராஜபுத்திரர்கள்	Nan
रवि	சூரியன்	None
राजनीतिक	அரசியல்	Nan
राजनितिक	அரசியல்	Nan
राग	மெல்லிசை	Nan
राघव	ராகவ்	Nan
राज	ஆட்சி	None
राजकीय	நிலை	None
राजकुमार	இளவரசன்	None
राजकुमारी	இளவரசி	Nan
राजनीति	அரசியல்	Nan
राजगद्दी	சிம்மாசனம்	Nan
राजतंत्र	முடியாட்சி	Nan
राजतन्त्र	முடியாட்சி	Nan
राजदूत	தூதர்	None
राजधानियों	தலைநகரங்கள்	None
राजधानी	மூலதனம்	Nan
राजनयिक	இராஜதந்திரி	Nan
राजगुरु	ராஜ்குரு	Nan
रमेश	ரமேஷ்	Nan
रमण	ராமன்	None
रफ्तार	வேகம்	None
रंगे	சாயம் பூசப்பட்டது	Nan
रंगों	நிறங்கள்	Nan
रंगोली	ரங்கோலி	Nan
रंजन	ரஞ்சன்	Nan
रक्त	இரத்தம்	None
रक्तचाप	இரத்த அழுத்தம்	Nan
रंगीन	வண்ணமயமான	Nan
रक्तस्त्राव	இரத்தப்போக்கு	Nan
रक्षाबंधन	ரக்ஷா பந்தன்	Nan
रख	வை	None
रखकर	வைப்பதன் மூலம்	Nan
रखता	வைத்திருக்கிறது	Nan
रखती	வைத்திருக்கிறது	Nan
रखना	வைத்திருக்க	None
रक्षा	பாதுகாப்பு	None
रखने	வை	None
रंगमंच	நிலை	None
रंगबिरंगे	வண்ணமயமான	Nan
योगदान	பங்களிப்பு	None
योगी	யோகி	Nan
योग्य	பொருத்தமானது	None
योग्यता	தகுதி	Nan
योजन	திட்டம்	None
योजना	திட்டம்	None
रंगभेद	நிறவெறி	Nan
योजनाओं	திட்டங்கள்	None
योनि	யோனி	None
यौगिक	கலவை	None
यौगिकों	கலவைகள்	Nan
यौन	பாலியல்	Nan
र	சு	None
रंग	நிறம்	None
योद्धा	போர்வீரன்	Nan
यों	இது போன்ற	Nan
रखरखाव	பராமரிப்பு	None
रखी	லேட்	Nan
रजिस्टर	பதிவு	Nan
रज्जब	ராஜாஜ்	Nan
रणनीति	உத்தி	None
रणनीतिक	மூலோபாய	Nan
रणनीतियां	உத்திகள்	None
रणनीतियों	உத்திகள்	None
रजत	வெள்ளி	None
रतन	நகை	None
रत्न	ரத்தினம்	Nan
रत्नाकर	ரத்னக்கர்	Nan
रथ	தேர்	Nan
रद्द	ரத்து செய்யப்பட்டது	Nan
रन	ஓடு	None
रफ़ी	ரஃபி	Nan
रतिक्रीड़ा	இரத்த விளையாட்டு	Nan
रखा	வைத்திருந்தார்	Nan
रज	ராஜ்	Nan
रची	குஞ்சு பொரித்தது	Nan
रखे	வை	None
रखें	வை	None
रग्बी	ரக்பி	None
रचना	உருவாக்கம்	None
रचनाएँ	கலவைகள்	Nan
रचनाएं	கலவைகள்	Nan
रचे	உருவாக்கப்பட்டது	None
रचनाओं	கலவைகள்	Nan
रचनाकाल	உருவாக்கும் நேரம்	Nan
रचनात्मक	கிரியேட்டிவ்	Nan
रचनायें	கலவைகள்	Nan
रचयिता	நூலாசிரியர்	Nan
रचा	புனையவும்	Nan
रचित	அமைதியாக	Nan
रचनाकार	உருவாக்கியவர்	Nan
भूआकृति	இயற்கை	Nan
भू	நில	None
भुवनेश्वर	புவனேஸ்வர்	Nan
प्रशासित	நிர்வகிக்கப்படுகிறது	Nan
प्रशासनिक	நிர்வாக	None
प्रशासकीय	நிர்வாக	None
प्रशासक	நிர்வாகி	None
प्रशान्त	பசிபிக்	None
प्रशांत	பசிபிக்	None
प्रशस्ति	பாராட்டு	Nan
प्रशस्त	விரிவானது	Nan
प्रशंसा	பாராட்டு	Nan
प्रशंसक	மின்விசிறி	Nan
प्रवेशद्वार	நுழைவு வாயில்	Nan
प्रवेश	உள்ளிடவும்	Nan
प्रवृत्तियों	போக்குகள்	Nan
प्रवृत्ति	போக்கு	None
प्रवृत्त	நடைமுறையில் உள்ளது	Nan
प्रवृति	இயற்கை	Nan
प्रवीण	திறமையானவர்	Nan
प्रयोजनों	நோக்கங்களுக்காக	Nan
प्रर्दशित	ஆர்ப்பாட்டம்	Nan
प्रलय	ஹோலோகாஸ்ட்	Nan
प्रलेख	ஆவணம்	None
प्रलेखों	ஆவணங்கள்	None
प्रवचन	சொற்பொழிவு	Nan
प्रशिक्षण	பயிற்சி	None
प्रवर्तक	விளம்பரதாரர்	Nan
प्रवास	தங்க	None
प्रवासियों	குடியேறியவர்கள்	Nan
प्रवासी	குடியேறியவர்	Nan
प्रवाह	ஓட்டம்	None
प्रवाहित	பாய்ந்தது	Nan
प्रविष्ट	உள்ளிட்ட	None
प्रवर्धक	பெருக்கி	Nan
प्रशिक्षित	பயிற்சி	None
प्रश्न	கேள்விகள்	None
प्रश्नों	கேள்விகள்	None
प्रस्तुतीकरण	சமர்ப்பிப்பு	Nan
प्रस्थान	புறப்படுதல்	Nan
प्रहार	தம்ப்	Nan
प्रह्लाद	பிரஹலாத்	Nan
प्रांगण	முற்றத்தில்	Nan
प्रांत	மாகாணம்	None
प्रस्तुतिकरण	விளக்கக்காட்சி	Nan
प्रांतस्था	புறணி	None
प्रांतों	மாகாணங்கள்	None
प्राकृत	பிரகிருத்	Nan
प्राकृतिक	இயற்கை	Nan
प्रागैतिहासिक	வரலாற்றுக்கு முந்தைய	Nan
प्राचीन	பண்டைய	None
प्राचीनकाल	பண்டைய காலம்	Nan
प्रांतीय	மாகாணம்	None
प्रयोजन	அதன் காரணம்	Nan
प्रस्तुति	விளக்கக்காட்சி	Nan
प्रस्तावित	முன்மொழியப்பட்டபடி	Nan
प्रसंग	சூழல்	None
प्रसन्न	மகிழ்ச்சி	Nan
प्रसन्नता	மகிழ்ச்சி	Nan
प्रसव	டெலிவரி	Nan
प्रसाद	பரிசுத்த பிரசாதம்	Nan
प्रसाधन	கழிப்பறை	Nan
प्रस्तुत	வழங்கப்பட்டது	None
प्रसारण	ஒளிபரப்பு	None
प्रसिद्द	பிரபலமானது	None
प्रसिद्ध	பிரபலமானது	None
प्रसिद्धि	புகழ்	None
प्रसिध्द	பிரபலமானது	None
प्रस्ताव	முன்மொழிவு	Nan
प्रस्तावना	முன்னுரை	None
प्रसारित	ஒளிபரப்பப்பட்டது	Nan
प्रयोगों	சோதனைகள்	Nan
प्रयोगात्मक	சோதனை	None
प्रयोगशालाओं	ஆய்வகங்கள்	Nan
प्रदाताओं	வழங்குநர்கள்	Nan
प्रदान	வழங்குங்கள்	Nan
प्रदूषक	மாசுபடுத்தும்	Nan
प्रदूषकों	மாசுபடுத்திகள்	Nan
प्रदूषण	மாசு	None
प्रदूषित	மாசுபட்டது	Nan
प्रदर्शित	காட்டப்பட்டது	Nan
प्रदेश	பிராந்தியம்	Nan
प्रधान	பிரதம	None
प्रधानता	முன்னுரிமை	None
प्रधानमंत्री	பிரதமர்	None
प्रधानमन्त्री	பிரதமர்	None
प्रपत्र	படிவம்	Nan
प्रबंध	மேலாண்மை	None
प्रदेशों	பிரதேசங்கள்	None
प्रबंधक	மேலாளர்	Nan
प्रदर्शनों	ஆர்ப்பாட்டங்கள்	Nan
प्रदत्त	கட்டணம்	None
प्रतिस्पर्धी	போட்டி	Nan
प्रतीक	சின்னம்	None
प्रतीकात्मक	குறியீட்டு	None
प्रतीकों	சின்னங்கள்	None
प्रतीक्षा	காத்திரு	Nan
प्रतीत	தெரிகிறது	None
प्रदर्शन	காட்சி	Nan
प्रत्यंग	இணைப்பு	None
प्रत्यय	பின்னொட்டு	Nan
प्रत्याशा	எதிர்பார்ப்பு	Nan
प्रत्येक	எல்லோரும்	None
प्रथम	முதலில்	None
प्रथा	தனிப்பயன்	Nan
प्रथाओं	நடைமுறைகள்	None
प्रत्यक्ष	ஆதாரம்	None
प्राचीनतम	பழமையான	None
प्रबंधकों	மேலாளர்கள்	Nan
प्रबन्ध	மேலாண்மை	None
प्रमस्तिष्क	பெருமூளை	Nan
प्रमाण	ஆதாரம்	None
प्रमाणित	சான்றளிக்கப்பட்ட	Nan
प्रमाणों	அதற்கான சான்றுகள்	Nan
प्रमुख	முதல்வர்	None
प्रमुखता	முக்கியத்துவம்	None
प्रभुत्व	ஆதிக்கம்	None
प्रयत्न	முயற்சி	None
प्रयास	முயற்சி	None
प्रयासों	முயற்சிகள்	None
प्रयोक्ता	பயனீட்டாளர்	Nan
प्रयोग	பரிசோதனை	None
प्रयोगकर्ता	பயனீட்டாளர்	Nan
प्रयोगशाला	ஆய்வகம்	Nan
प्रयत्नों	முயற்சிகள்	None
प्रबंधन	மேலாண்மை	None
प्रभुता	இறையாண்மை	Nan
प्रभास	பிரகாசம்	Nan
प्रबन्धन	மேலாண்மை	None
प्रबलता	ஆதிக்கம்	None
प्रबुद्ध	அறிவொளி	Nan
प्रभा	பிரபா	Nan
प्रभाकर	பிரபாகர்	Nan
प्रभाग	பிரிவு	None
प्रभु	ஆண்டவரே	Nan
प्रभात	காலை	None
प्रभाव	விளைவு	Nan
प्रभावकारी	பயனுள்ள	Nan
प्रभावित	செல்வாக்கு செலுத்தியது	Nan
प्रभाविता	செயல்திறன்	None
प्रभावी	பயனுள்ள	Nan
प्रभावों	விளைவுகள்	None
प्रभार	கட்டணம்	None
प्रतिष्ठित	புகழ்பெற்ற	None
प्राण	வாழ்க்கை	None
प्राणियों	உயிரினங்கள்	None
फ़िर	மீண்டும்	None
फ़िजी	பிஜி	None
फ़ारसी	பாரசீக	None
फ़ारस	பாரசீக	None
फ़ायदा	லாபம்	Nan
फ़सल	பயிர்	None
फ़ल	தவறு	None
फ़रवरी	பிப்ரவரி	None
फ़	எஃப்	Nan
फहराया	ஏற்றப்பட்டது	Nan
फहराना	ஏற்றுவதற்கு	Nan
फसलों	பயிர்கள்	None
फसलें	பயிர்கள்	None
फसल	பயிர்	None
फलों	பழங்கள்	None
फली	நெற்று	Nan
फलस्वरूप	அதன் விளைவாக	Nan
प्लेटो	பிளேட்டோ	Nan
प्लेटों	தகடுகள்	Nan
प्लेयर	ஆட்டக்காரர்	Nan
फंड	நிதி	None
फकीर	செயிண்ட்	None
फतेहपुर	ஃபதேபூர்	Nan
फ़िल्म	திரைப்படம்	None
फरवरी	பிப்ரவரி	None
फर्म	நிறுவனம்	None
फर्मियान	ஃபெர்மியன்	Nan
फर्श	மாடிகள்	Nan
फल	பழம்	None
फलत	அதன் விளைவாக	Nan
फलस्वरुप	அதன் விளைவாக	Nan
फर्क	வேறுபாடு	None
फ़िल्मफेयर	பிலிம்பேர்	None
फ़िल्मी	படம்	None
फ़िल्में	திரைப்படம்	None
फार्म	வடிவம்	None
फाल्गुन	பால்குன்	Nan
फिजी	பிஜி	None
फिट	பொருத்து	None
फिनलैंड	பின்லாந்து	None
फिर	மீண்டும்	None
फारसी	பாரசீக	None
फिलहाल	தற்போதைக்கு	Nan
फिलोसोफी	தத்துவம்	None
फिल्म	படம்	None
फिल्मफेयर	பிலிம்பேர்	None
फिल्मी	ஃபிலிமி	Nan
फिल्में	திரைப்படம்	None
फिल्मों	திரைப்படம்	None
फिलिस्तीन	பாலஸ்தீனம்	Nan
प्लेटफार्म	நடைமேடை	Nan
फायरफॉक्स	பயர்பாக்ஸ்	None
फायदा	லாபம்	Nan
फ़ेस	முகம்	None
फ़ैल	வீழ்ச்சி	None
फ़ॉन्ट	எழுத்துரு	Nan
फ़ोन	தொலைபேசி	None
फ़ोर्तूना	பார்ச்சூனா	Nan
फ़्रांस	பிரான்ஸ்	None
फायदे	நன்மை	None
फ़्रांसिसी	பிரஞ்சு	Nan
फाँसी	தொங்குகிறது	Nan
फाइनल	இறுதி	None
फाइनेंस	நிதி	None
फाइल	கோப்பு	Nan
फाइलों	கோப்புகள்	Nan
फाउंडेशन	அஸ்திவாரம்	Nan
फ़्रांसीसी	பிரஞ்சு	Nan
प्लास्मोडियम	பிளாஸ்மோடியம்	Nan
प्लास्टिक	நெகிழி	Nan
प्लान	திட்டம்	None
प्रारंभ	தொடங்கு	Nan
प्रारंभिक	ஆரம்ப	None
प्रारम्भ	தொடங்கு	Nan
प्रारम्भिक	ஆரம்ப	None
प्रारूप	வடிவம்	None
प्रारूपिक	வழக்கமான	None
प्रायोगिक	சோதனை	None
प्रार्थना	ஜெபம்	Nan
प्रासंगिक	தொடர்புடையது	None
प्रासंगिकता	சம்பந்தம்	None
प्रासाद	அரண்மனை	None
प्रिय	அன்பே	None
प्रियव्रत	அன்பே	None
प्रिया	பிரியா	Nan
प्रावधान	ஏற்பாடு	None
प्रेक्षकों	பார்வையாளர்கள்	Nan
प्रायद्वीप	தீபகற்பம்	Nan
प्राय	பொதுவாக	None
प्राणी	உயிரினம்	None
प्राणों	வாழ்க்கை	None
प्रात	காலை	None
प्रातकाल	காலை	None
प्राथमिकता	முன்னுரிமை	None
प्रादुर्भाव	பரிணாமம்	None
प्रायः	பொதுவாக	None
प्रादेशिक	பிராந்திய	None
प्रान्त	மாகாணம்	None
प्रान्तों	மாகாணங்கள்	None
प्राप्त	பெறு	Nan
प्राप्ति	அடைதல்	Nan
प्रामाणिक	உண்மையானது	Nan
प्रामाणिकता	நம்பகத்தன்மை	Nan
प्राधिकरण	அதிகாரம்	None
प्राणायाम	பிராணயாமா	Nan
प्रेक्षण	கவனிப்பு	None
प्रेमचंद	பிரேம்சந்த்	Nan
प्रोटॉन	புரோட்டான்	Nan
प्रोटोकॉल	நெறிமுறை	None
प्रोटोज़ोआ	புரோட்டோசோவா	Nan
प्रोत्साहन	ஊக்கம்	None
प्रोत्साहित	ஊக்குவிக்கப்பட்டது	Nan
प्रोफ़ेसर	பேராசிரியர்	None
प्रोटेस्टेंट	புராட்டஸ்டன்ட்	Nan
प्रोफेसर	பேராசிரியர்	None
प्रोस्टेट	புரோஸ்டேட்	Nan
प्रौद्योगिकियों	தொழில்நுட்பங்கள்	None
प्रौद्योगिकी	தொழில்நுட்பம்	None
प्लस	பிளஸ்	Nan
प्लांट	ஆலை	None
प्लाज्मा	பிளாஸ்மா	Nan
प्रोसेसर	செயலி	None
प्रेम	காதல்	None
प्रोटीन	புரத	None
प्रोग्रामों	நிகழ்ச்சிகள்	Nan
प्रेमिका	காதலன்	Nan
प्रेमियों	காதலர்கள்	Nan
प्रेमी	காதலன்	Nan
प्रेरक	உந்துதல்	Nan
प्रेरणा	உத்வேகம்	Nan
प्रेरित	உத்வேகம்	Nan
प्रोटान	புரோட்டான்	Nan
प्रेषित	அனுப்பப்பட்டது	Nan
प्रेसिडेंसी	ஜனாதிபதி பதவி	Nan
प्रेसीडेंसी	ஜனாதிபதி பதவி	Nan
प्रो	புரோ	Nan
प्रोग्राम	நிகழ்ச்சி	None
प्रोग्रामन	புரோகிராமிங்	Nan
प्रोग्रामिंग	புரோகிராமிங்	Nan
प्रेस	பத்திரிகை	None
फीका	மங்கல்	Nan
प्रतिष्ठा	க ti ரவம்	Nan
प्रतिवर्ष	வருடத்திற்கு	None
पूरे	முழு	None
पूरी	முழுமை	Nan
पूरा	முழு	None
पूरब	கிழக்கு	None
पूरक	பூர்த்தி	None
पूना	பூனா	Nan
पूज्य	வணக்கத்திற்குரியது	Nan
पूजा	பிரார்த்தனை	Nan
पूजन	வழிபாடு	None
पूछे	கேளுங்கள்	Nan
पूछा	என்று கேட்டார்	Nan
पूंजीवादी	முதலாளித்துவவாதி	Nan
पूँजीवादी	முதலாளித்துவவாதி	Nan
पूँजीवाद	முதலாளித்துவம்	Nan
पूँजी	மூலதனம்	Nan
पू	பூ	None
पुस्तकों	புத்தகங்கள்	None
पुर्तगाल	போர்ச்சுகல்	Nan
पुर्तगालियों	போர்த்துகீசியம்	Nan
पुर्तगाली	போர்த்துகீசியம்	Nan
पुल	பாலம்	None
पुलिस	காவல்	None
पुष्टि	உறுதிப்படுத்தல்	Nan
पूर्ण	முழுமை	Nan
पुष्प	பூ	None
पुष्य	புஷ்யா	Nan
पुष्यमित्र	புஷ்யமித்ரா	Nan
पुस्तक	நூல்	None
पुस्तकालय	நூலகம்	None
पुस्तकालयों	நூலகங்கள்	Nan
पुस्तकें	புத்தகங்கள்	None
पुष्पण	பூக்கும்	None
पूर्णत	முழுமையாக	None
पूर्णतः	முழுமையாக	None
पूर्णतया	முழுமையாக	None
पृथ्वीराज	பிருத்விராஜ்	Nan
पृष्ट	பக்கம்	None
पृष्ठ	பக்கம்	None
पृष्ठों	பக்கங்கள்	None
पे	ஆன்	None
पेंशन	ஓய்வூதியம்	Nan
पृथ्वी	பூமி	None
पेज	பக்கம்	None
पेटेंट	காப்புரிமை	None
पेट्रोलियम	பெட்ரோலியம்	None
पेठ	பெத்	Nan
पेड	மரம்	None
पेड़पौधे	மரங்கள் &amp; தாவரங்கள்	Nan
पेड़ों	மரங்கள்	None
पेट	வயிறு	None
पुरे	முழு	None
पृथक्करण	பிரிப்பு	None
पूसा	பூசா	Nan
पूर्णिमा	முழு நிலவு	Nan
पूर्ति	விநியோகி	Nan
पूर्व	கிழக்கு	None
पूर्वक	முன்னுரிமை	None
पूर्वज	மூதாதையர்	Nan
पूर्वजों	முன்னோர்கள்	Nan
पृथक्	தனி	None
पूर्वराजवंशीय	முன்னோடி	None
पूर्वविधान	பழைய ஏற்பாடு	Nan
पूर्वानुमान	முன்னறிவிப்பு	Nan
पूर्वार्ध	முதல் பாதி	Nan
पूर्वी	கிழக்கு	None
पूर्वोक्त	மேற்கூறியவை	Nan
पूर्वोत्तर	வடகிழக்கு	None
पूर्ववर्ती	முந்தையது	Nan
पुरूष	ஆண்கள்	None
पुरुषोत्तम	புருஷோத்தம்	Nan
पुरुषवाचक	ஆண்பால்	None
पीढ़ी	தலைமுறை	None
पीढी	ஒரு தலைமுறை	Nan
पीते	பானம்	Nan
पीना	குடிக்க	Nan
पीने	குடிப்பது	Nan
पीनेवाला	குடிப்பவர்	Nan
पीढ़ियों	தலைமுறைகள்	Nan
पीनेवाले	குடிப்பவர்கள்	Nan
पीपी	பிபி	Nan
पीरियड	காலம்	None
पीला	மஞ்சள்	None
पीली	மஞ்சள்	None
पीले	மஞ்சள்	None
पीस	சமாதானம்	Nan
पीपल	ficus religiosa	Nan
पीसकर	அரைக்கவும்	Nan
पीड़ित	பாதிக்கப்பட்டவர்	Nan
पीटर	பீட்டர்	Nan
पिच	சுருதி	Nan
पिछड़े	பின்தங்கிய	Nan
पिछली	கடந்த	None
पितामह	தாத்தா	Nan
पित्त	பித்தம்	Nan
पिनकृमि	பின் புழு	Nan
पीठ	பின்புறம்	Nan
पिमलिको	பிம்லிகோ	Nan
पिलाने	உணவளித்தல்	Nan
पी	பி	Nan
पीक	உச்சம்	Nan
पीकर	குடிப்பதன் மூலம்	Nan
पीछा	துரத்தல்	Nan
पीछे	பின்னால்	None
पिरामिड	பிரமிட்	None
पेनाल्टी	தண்டம்	Nan
पीसी	பிசி	Nan
पुख्ता	வலுவான	None
पुरस्कृत	வெகுமதி	Nan
पुरा	முழு	None
पुराणों	புராணம்	None
पुरातत्त्व	தொல்லியல்	None
पुरातत्व	தொல்லியல்	None
पुरातत्वविदों	தொல்பொருள் ஆராய்ச்சியாளர்கள்	Nan
पुरस्कार	விருது	None
पुरातन	பண்டைய	None
पुराना	பழையது	Nan
पुरानी	பழையது	Nan
पुराने	பழையது	Nan
पुरापाषाण	பாலியோலிதிக்	Nan
पुरी	பூரி	Nan
पुरुष	ஆண்	None
पुरातात्विक	தொல்பொருள்	None
पुकारा	அழைத்தனர்	None
पुर	புர்	Nan
पुनर्जीवित	புத்துயிர் பெற்றது	Nan
पुजारियों	பூசாரிகள்	Nan
पुजारी	பூசாரி	Nan
पुट	போடு	Nan
पुणे	புனே	Nan
पुण्य	புனிதர்	Nan
पुत्री	மகள்	None
पुनर्निर्माण	புனரமைப்பு	Nan
पुत्रों	மகன்கள்	None
पुनः	மீண்டும்	None
पुनरीक्षण	திருத்தம்	None
पुनरुत्थान	மீண்டும் எழுச்சி	Nan
पुनर्गठन	மறுசீரமைப்பு	None
पुनर्जन्म	மறுபிறப்பு	Nan
पुनर्जागरण	மறுமலர்ச்சி	None
पुन	மீண்டும்	None
प्रतिशत	சதவீதம்	None
पेय	அந்த பானம்	Nan
पेरू	பெரு	None
प्रताप	மாட்சிமை	Nan
प्रणेता	முன்னோடி	None
प्रणीत	பிரணித்	Nan
प्रणाली	அமைப்பு	None
प्रणालियों	அமைப்புகள்	None
प्रणालियां	அமைப்புகள்	None
प्रणालियाँ	அமைப்புகள்	None
प्रणाम	வாழ்த்துக்கள்	Nan
प्रणव	பிரணவ்	Nan
प्रणयन	காதல்	None
प्रणय	காதல்	None
प्रज्ञा	ஞானம்	None
प्रजापति	உருவாக்கியவர்	Nan
प्रजातियों	இனங்கள்	None
प्रजातियां	இனங்கள்	None
प्रजातियाँ	இனங்கள்	None
प्रजाति	இனங்கள்	None
प्रख्यात	குறிப்பிடப்பட்டுள்ளது	None
प्रगति	முன்னேற்றம்	None
प्रगतिशील	முற்போக்கானது	Nan
प्रचलन	போக்கு	None
प्रचलित	பிரபலமானது	None
प्रचार	விளம்பரம்	None
प्रतापी	கம்பீரமான	Nan
प्रचारक	விளம்பரதாரர்	Nan
प्रचारिणी	விளம்பரதாரர்	Nan
प्रचारित	பதவி உயர்வு	Nan
प्रचालन	செயல்பாடு	None
प्रचुर	ஏராளமான	None
प्रजनन	இனப்பெருக்கம்	None
प्रजा	மக்கள்	None
प्रचारप्रसार	பிரச்சாரம்	None
प्रति	ஒன்றுக்கு	None
प्रतिकूल	சாதகமற்றது	Nan
प्रतिकृति	முகம்	None
प्रतिमा	சிலை	None
प्रतिमाओं	சிலைகள்	None
प्रतिमान	மாதிரி	Nan
प्रतियोगिताओं	போட்டிகள்	None
प्रतियोगियों	போட்டியாளர்கள்	Nan
प्रतियोगी	போட்டியாளர்	Nan
प्रतिभा	திறமை	None
प्रतिरक्षा	நோய் எதிர்ப்பு சக்தி	Nan
प्रतिरूप	மாதிரி	Nan
प्रतिरोध	எதிர்ப்பு	None
प्रतिरोधक	எதிர்ப்பு	None
प्रतिरोधी	எதிர்ப்பு	None
प्रतिलिपि	நகலெடுக்கவும்	Nan
प्रतिलेखन	படியெடுத்தல்	Nan
प्रतिरक्षी	பாதுகாப்பு	None
प्रखर	கூர்மையானது	Nan
प्रतिबिम्ब	படம்	None
प्रतिबन्ध	கட்டுப்பாடு	None
प्रतिक्रिया	எதிர்வினை	Nan
प्रतिक्रियाओं	எதிர்வினைகள்	Nan
प्रतिज्ञा	உறுதிமொழி	Nan
प्रतिदिन	தினமும்	None
प्रतिद्वंद्वी	போட்டி	None
प्रतिनिधि	பிரதிநிதி	Nan
प्रतिबिंबित	பிரதிபலிக்கவும்	Nan
प्रतिनिधित्व	பிரதிநிதித்துவம்	None
प्रतिपदा	போட்டி	None
प्रतिपादन	ரெண்டரிங்	Nan
प्रतिपादित	முன்மொழியப்பட்டது	Nan
प्रतिपुरुष	கதாநாயகன்	Nan
प्रतिबंधित	தடைசெய்யப்பட்டுள்ளது	Nan
प्रतिबंधों	கட்டுப்பாடுகள்	None
प्रतिनिधियों	பிரதிநிதிகள்	None
प्रक्षेपास्त्र	ஏவுகணை	Nan
प्रक्षेप	இடைக்கணிப்பு	Nan
प्रक्रियाओं	நடைமுறைகள்	None
पैरामिसियम	பாரமீசியம்	Nan
पैरिस	பாரிஸ்	None
पैरों	கால்கள்	None
पैलेस	அரண்மனை	None
पैसा	பணம்	None
पैसों	பணம்	None
पैराग्वे	பராகுவே	Nan
पॉटर	குயவன்	Nan
पॉडकास्टिंग	பாட்காஸ்டிங்	Nan
पॉप	பாப்	None
पॉल	பால்	None
पॉलीन्या	பவுலினா	Nan
पोजीशन	நிலை	None
पोप	போப்	None
पॉडकास्ट	வலையொளி	Nan
पोर्ट	துறைமுகம்	None
पैर	கால்	None
पैनल	குழு	None
पेश	தற்போது	None
पेशकश	சலுகை	Nan
पेशवा	பேஷ்வா	Nan
पेशाब	சிறுநீர்	None
पेशियों	தசைகள்	Nan
पेशे	தொழிலை	Nan
पैमाने	அளவு	None
पेशेवर	தொழில்முறை	None
पैगम्बर	நபி	None
पैग़म्बर	நபி	None
पैतृक	தந்தைவழி	Nan
पैदल	கால்நடையாக	Nan
पैदा	பிறந்தவர்	Nan
पैदावार	மகசூல்	None
पैकेजिंग	பேக்கேஜிங்	Nan
पेरिस	பாரிஸ்	None
पोर्ट-ऑ-प्रिंस	போர்ட்-ஓ-இளவரசன்	Nan
पोलिश	போலிஷ்	Nan
प्रकार	வகை	None
प्रकारों	வகைகள்	None
प्रकाश	ஒளி	None
प्रकाशन	வெளியீடு	None
प्रकाशनों	வெளியீடுகள்	None
प्रकाशसंश्लेषण	ஒளிச்சேர்க்கை	Nan
प्रकल्प	திட்டம்	None
प्रकाशिकी	ஒளியியல்	None
प्रकाशीय	ஆப்டிகல்	Nan
प्रकीर्णन	சிதறல்	Nan
प्रकृति	இயற்கை	Nan
प्रकोप	பரவல்	None
प्रक्रिया	செயல்முறை	None
प्रक्रियाएं	செயல்முறைகள்	None
प्रकाशित	வெளியிடப்பட்டது	None
पोर्टल	இணைய முகப்பு	Nan
प्रकरण	வழக்கு	None
प्यास	தாகம்	Nan
पोलैंड	போலந்து	Nan
पोशाक	ஆடை	None
पोषक	சத்தான	Nan
पोषित	நேசத்துக்குரியது	Nan
पोस्ट	அஞ்சல்	Nan
पौड़ी	ப ri ரி	Nan
प्यूपा	பூபா	Nan
पौत्र	பேரன்	Nan
पौधे	தாவரங்கள்	None
पौधों	தாவரங்கள்	None
पौराणिक	பழம்பெரும்	Nan
प्यार	காதல்	None
प्याला	கிண்ணம்	Nan
प्याले	கோப்பைகள்	Nan
पौधा	ஆலை	None
लाहौर	லாகூர்	Nan
फीड	ஊட்டம்	Nan
फील्ड	புலம்	None
बैटरी	பேட்டரி	Nan
बैट	பேட்	Nan
बैंड	இசைக்குழு	Nan
बैंगनी	ஊதா	None
बैंकों	வங்கிகள்	None
बैंकिंग	வங்கி	None
बैंकर	வங்கியாளர்	Nan
बैंक	வங்கி	None
बेहद	மிகவும்	None
बेहतरीन	சிறந்த	None
बेहतर	சிறந்தது	None
बेसिन	பேசின்	Nan
बेसिक	அடிப்படை	None
बेस	அடித்தளம்	Nan
बेल्जियम	பெல்ஜியம்	None
बेल	பெல்	None
बेरोजगारी	வேலையின்மை	Nan
बुश	புஷ்	None
बूट	துவக்க	Nan
बृहस्पति	வியாழன்	None
बेंच	பெஞ்ச்	Nan
बेक	பெக்	Nan
बेगम	ராணி	None
बैठ	உட்கார	Nan
बेग़म	பேகம்	None
बेटद्वारका	பெட்வர்கா	Nan
बेटा	மகன்	None
बेटी	மகள்	None
बेटे	மகன்	None
बेदी	பேடி	Nan
बेन	பென்	None
बेचने	விற்க	Nan
बैठक	சந்திப்பு	None
बैठकों	கூட்டங்கள்	Nan
बैठता	அமர்ந்திருக்கிறது	Nan
बोलता	பேசுகிறார்	Nan
बोलते	பேசு	Nan
बोलना	பேச	Nan
बोलने	பேசும்	None
बोला	பேசினார்	Nan
बोलियाँ	ஏலம்	Nan
बोलचाल	பேசினார்	Nan
बोलियों	ஏலம்	Nan
बोली	மொழி	Nan
बोले	பேசு	Nan
बोस	முதலாளி	Nan
बौद्ध	ப .த்த	Nan
बौद्धिक	அறிவுசார்	Nan
बौद्धों	ப ists த்தர்கள்	Nan
बोलिविया	பொலிவியா	Nan
बुलाया	என்று அழைக்கப்படுகிறது	Nan
बोल	பாடல் வரிகள்	Nan
बोनापार्ट	போனபார்டே	Nan
बैठते	உட்கார	Nan
बैठने	உட்கார	Nan
बैठा	சனி	None
बैठें	உட்கார	Nan
बैर	வெறுப்பு	Nan
बैरम	பைராம்	None
बोर्ड	வாரியம்	Nan
बैल	காளை	Nan
बॉम्बे	பம்பாய்	None
बॉल	பந்து	None
बोझ	சுமை	None
बोध	உணர்வு	None
बोधक	விளக்கம்	None
बोनसाई	போன்சாய்	Nan
बॉक्स	பெட்டி	None
बुर्ज	சிறு கோபுரம்	Nan
बुरे	கெட்டது	Nan
बुरी	கெட்டது	Nan
बिंदुओं	புள்ளிகள்	None
बिक्री	விற்பனை	None
बिखरे	சிதறடிக்கப்பட்டது	Nan
बिजनेस	வணிக	None
बिजली	மின்னல்	Nan
बिड़ला	பிர்லா	Nan
बिंदु	புள்ளி	None
बिताया	செலவு	None
बिन्दु	புள்ளி	None
बिन्दुसार	பிந்துசாரா	Nan
बियर	பீர்	Nan
बिल	ர சி து	Nan
बिलियन	பில்லியன்	Nan
बिल्कुल	முற்றிலும்	None
बिन	பின் இல்லாமல்	Nan
बिल्ली	பூனை	None
बाह्यसूत्र	மேல்தோல்	Nan
बाहरी कड़ियाँ	வெளி இணைப்புகள்	Nan
बारीक	நல்லது	None
बारे	பற்றி	None
बाल	குழந்தை	None
बालक	சிறுவன்	None
बालकाण्ड	மழலையர் பள்ளி	Nan
बालकृष्ण	பாலகிருஷ்ணா	Nan
बाह्य	வெளிப்புறம்	Nan
बालाजी	பாலாஜி	Nan
बालिका	பெண்	None
बाली	பாலி	Nan
बालों	முடி	None
बाल्टिक	பால்டிக்	Nan
बाल्यकाल	குழந்தைப் பருவம்	Nan
बावजूद	இருந்தாலும்	None
बालि	பாலி	Nan
ब्याज	ஆர்வம்	None
बिस्तर	படுக்கை	None
बिहारी	பிஹாரி	Nan
बीसवीं	இருபதாம்	None
बुंदेलखंड	புண்டேல்கண்ட்	Nan
बुक्स	புத்தகங்கள்	None
बुखार	காய்ச்சல்	None
बुगरा	புக்ரா	Nan
बुद्ध	புத்தர்	None
बीसवी	இருபதாம்	None
बुद्धि	ஞானம்	None
बुध	திருமணம் செய்	Nan
बुधवार	புதன்கிழமை	Nan
बुनियादी	அடிப்படை	None
बुरा	கெட்டது	Nan
बुराइयों	தீமைகள்	Nan
बुराई	தீமை	Nan
बुद्धिमान	புத்திசாலி	Nan
बिहार	பீகார்	None
बीमारी	நோய்	None
बीमार	நோய்வாய்ப்பட்டது	Nan
बी	பி	Nan
बीएसई	பி.எஸ்.இ.	Nan
बीकानेर	பிகானேர்	Nan
बीच	இடையில்	None
बीज	விதை	None
बीजिंग	பெய்ஜிங்	Nan
बीमारियों	நோய்கள்	None
बीजों	விதைகள்	None
बीटी	பிடி	None
बीत	கழிந்தது	Nan
बीता	கடந்த காலம்	Nan
बीबीसी	பிபிசி	None
बीम	உத்திரம்	None
बीमा	காப்பீடு	None
बीटा	பீட்டா	None
बारी	திருப்பம்	Nan
ब्यूरो	பணியகம்	Nan
ब्रजभाषा	பிரஜ் பாஷா	Nan
भारी	கனமான	Nan
भारद्वाज	பரத்வாஜ்	Nan
भारतेन्दु	பாரதெண்டு	Nan
भारतीयों	இந்தியர்கள்	None
भारतीय	இந்தியன்	None
भारती	இந்தியன்	None
भारतवर्ष	இந்தியா	None
भारत	இந்தியா	None
भार	சுமை	None
भाभी	மைத்துனர்	Nan
भाप	நீராவி	None
भाड़े	ஹேக்ஸ்	Nan
भाटिया	பாட்டியா	Nan
भाट	மினிஸ்ட்ரல்	Nan
भाजपा	பி ஜே பி	Nan
भाग्य	அதிர்ஷ்டம்	Nan
भागो	ஓடு	None
भस्म	நுகர்வு	None
भाँति	பிடிக்கும்	Nan
भांग	கஞ்சா	Nan
भाइयों	சகோதரர்கள்	None
भाई	சகோதரன்	Nan
भाईचारे	சகோதரத்துவம்	Nan
भालू	தாங்க	None
भाग	ஓடு	None
भागफल	அளவு	None
भागलपुर	பாகல்பூர்	Nan
भागवत	பகவத்	None
भागीदार	பங்குதாரர்	Nan
भागीदारी	பங்கேற்பு	Nan
भागीरथी	பாகீரதி	Nan
भागने	எஸ்கேப்	Nan
भावना	உணர்வு	None
भावनाओं	உணர்வுகள்	None
भावनात्मक	உணர்ச்சி	None
भिन्नभिन्न	வெவ்வேறு	None
भी	மிகவும்	None
भीड	கூட்டம்	None
भीड़	கூட்டம்	None
भीतर	உள்ளே	None
भीतरी	உள்	None
भिन्नता	வேறுபாடு	None
भीमगोडा	பீம்கோடா	Nan
भीषण	கொடூரமான	Nan
भुगतान	கட்டணம்	None
भुजा	கை	None
भुजाओं	ஆயுதங்கள்	None
भुला	மறந்துவிட்டேன்	Nan
भुवन	புவன்	Nan
भीमराव	பீம்ராவ்	Nan
भव्यता	ஆடம்பரம்	Nan
भित्ति	சுவர்	None
भास्कर	பாஸ்கர்	Nan
भावी	எதிர்காலம்	None
भावे	பாவே	Nan
भावों	வெளிப்பாடுகள்	None
भाषण	பேச்சு	None
भाषा	மொழி	Nan
भाषाई	மொழியியல்	None
भि	மிகவும்	None
भाषाएँ	மொழிகள்	None
भाषाओं	மொழிகள்	None
भाषापरिवार	மொழி குடும்பம்	Nan
भाषायें	மொழிகள்	None
भाषाविज्ञान	மொழி அறிவியல்	Nan
भाषी	பேசும்	None
भाष्य	வர்ணனை	Nan
भाषाएं	மொழிகள்	None
भव्य	மாபெரும்	None
भविष्यवाणी	கணிப்பு	None
भविष्य	எதிர்காலம்	None
ब्रिटेन	பிரிட்டன்	None
ब्रितानी	பிரிட்டிஷ்	Nan
ब्रॉडबैंड	பிராட்பேண்ட்	Nan
ब्लाग	வலைப்பதிவு	None
ब्लू	நீலம்	None
ब्लेयर	பிளேர்	Nan
ब्रिटिशों	ஆங்கிலேயர்	None
ब्लैक	கருப்பு	None
ब्लॉग	வலைப்பதிவு	None
भ	பி	Nan
भंग	மீறல்	Nan
भंडार	கடை	Nan
भंडारण	சேமிப்பு	None
भक्त	பக்தர்	Nan
ब्लॉक	தடை	None
भक्ति	பக்தி	None
ब्रिटिश	ஆங்கிலேயர்	None
ब्राहमण	பிராமணர்	None
ब्रह्म	பிரம்மா	None
ब्रह्मचर्य	பிரம்மச்சாரிய	Nan
ब्रह्मांड	அண்டம்	None
ब्रह्माजी	பிரம்மா	None
ब्रह्माण्ड	அண்டம்	None
ब्रह्मास्त्र	பிரம்மஸ்திரம்	Nan
ब्रिज	பாலம்	None
ब्रांड	பிராண்ட்	Nan
ब्राउज़र	உலாவி	Nan
ब्राउज़रों	உலாவிகள்	None
ब्राउसर	உலாவி	Nan
ब्राज़ील	பிரேசில்	None
ब्राजील	பிரேசில்	None
ब्रायलर	பிராய்லர்	Nan
ब्राउजर	உலாவி	Nan
ब्रज	பிரஜ்	Nan
भक्तों	பக்தர்கள்	None
भगत	பின்தொடர்பவர்	Nan
भरती	கட்டாயப்படுத்துதல்	Nan
भरते	நிரப்புதல்	Nan
भरने	நிரப்புதல்	Nan
भरपूर	ஏராளமான	None
भरा	முழு	None
भरी	முழு	None
भरतपुर	பரத்பூர்	Nan
भरे	பூர்த்தி	None
भला	சரி	None
भलाई	நன்மை	None
भली	சரி	None
भले	நல்ல	None
भवन	கட்டிடம்	None
भवनों	கட்டிடங்கள்	None
भर्ती	ஆட்சேர்ப்பு	Nan
भक्‍ति	பக்தி	None
भरत	பாரத்	None
भर	பூர்த்தி	None
भगवती	பகவதி	Nan
भगवद्गीता	பகவத் கீதை	Nan
भगवा	ஓச்சர்	Nan
भगवान	இறைவன்	None
भगवान्	இறைவன்	None
भगवान्‌	இறைவன்	None
भरकर	அடைத்த	Nan
भगिनी	சகோதரி	Nan
भटक	அலைந்து திரிகிறது	Nan
भत्ते	கொடுப்பனவுகள்	Nan
भय	பயம்	Nan
भयंकर	பயமுறுத்தும்	Nan
भयभीत	பயந்துபோனது	Nan
भयानक	பயமாக இருக்கிறது	Nan
भजन	ஸ்தோத்திரம்	Nan
फीफा	ஃபிஃபா	Nan
बारिश	மழை	None
बारात	ஊர்வலம்	Nan
बढ़ते	பெருகிவரும்	Nan
बढ़ती	உயரும்	None
बढ़कर	விட	None
बढ़	அதிகரித்தது	None
बढती	அதிகரித்து வருகிறது	Nan
बढता	அதிகரிக்கிறது	None
बढ	அதிகரித்தது	None
बडे	பெரியது	None
बडी	பெரியது	None
बडा	பெரியது	None
बड़ेबड़े	பெரியவை	Nan
बड़े	பெரியது	None
बड़ी	பெரியது	None
बड़ा	பெரியது	None
बटन	சொடுக்கி	Nan
बजे	நேரம்	None
बजाय	மாறாக	None
बचत	சேமிப்பு	None
बचना	தவிர்க்க	None
बचने	எஸ்கேப்	Nan
बचपन	குழந்தை பருவம்	Nan
बचा	இடது	None
बचाने	சேமி	Nan
बढ़ना	தலைக்கு	Nan
बचाव	மீட்பு	Nan
बच्चा	குழந்தை	None
बच्चे	குழந்தைகள்	None
बच्चों	குழந்தைகள்	None
बजट	பட்ஜெட்	Nan
बजाए	மாறாக	None
बजाते	டிக்கிங்	Nan
बच्चन	பச்சன்	Nan
बढ़ने	வளருங்கள்	Nan
बढ़ाता	மேம்படுத்துகிறது	Nan
बढ़ाते	அதிகரிக்க	None
बताने	சொல்லுங்கள்	Nan
बताया	கூறினார்	None
बदनाम	பத்னம்	Nan
बदल	மாற்றம்	None
बदलकर	மாற்றுவதன் மூலம்	Nan
बदलता	மாறுபடும்	None
बताना	சொல்ல	None
बदलती	மாறுபடும்	None
बदलना	மாற்ற	None
बदलने	மாற்ற	None
बदला	பழிவாங்குதல்	Nan
बदलाव	மாற்றம்	None
बदले	மாற்றம்	None
बनकर	செய்யப்படும்	None
बदलते	மாற்றுதல்	None
बच	எஸ்கேப்	Nan
बताते	சொல்கிறது	None
बताता	சொல்கிறது	None
बढ़ाना	எழுப்பு	Nan
बढ़ाया	மேம்படுத்தப்பட்டது	Nan
बढ़ावा	ஊக்கம்	None
बढ़ी	மேம்படுத்தப்பட்டது	Nan
बढा	அதிகரித்தது	None
बढाता	அதிகரித்து வருகிறது	Nan
बताती	சொல்கிறது	None
बढाने	அதிகரிக்க	None
बढावा	பதவி உயர்வு	Nan
बढे	வளருங்கள்	Nan
बतलाया	கூறினார்	None
बता	சொல்லுங்கள்	Nan
बताई	கூறினார்	None
बताए	சொல்லுங்கள்	Nan
बढाया	அதிகரித்தது	None
बगैर	இல்லாமல்	None
बगीचों	தோட்டங்கள்	Nan
बगावत	எழுச்சி	None
फैरोओं	பார்வோன்	Nan
फैल	பரவுதல்	None
फैलता	பரவுகிறது	Nan
फैलने	தீவிர நோய் பரவல்	Nan
फैला	பரவுதல்	None
फैलाने	கலை	None
फैरो	ஃபாரோ	Nan
फैलाया	சிதறடிக்கப்பட்டது	Nan
फैली	நீட்டிக்கிறது	Nan
फैशन	ஃபேஷன்	Nan
फैसला	முடிவு	None
फैसले	தீர்ப்பு	None
फॉण्ट	எழுத்துரு	Nan
फॉर	க்கு	Nan
फैलाव	பரவுதல்	None
फोटो	புகைப்படம்	None
फैबेसी	கற்பனையானது	Nan
फेसबुक	முகநூல்	Nan
फीस	கட்டணம்	None
फुट	அடி	None
फूट	பிளவு	None
फूल	பூ	None
फूलन	பூலன்	Nan
फूलपौधों	மலர் தாவரங்கள்	Nan
फैजाबाद	பைசாபாத்	Nan
फूलों	பூக்கள்	None
फेंग	ஃபாங்	Nan
फेज	கட்டம்	None
फेडरेशन	கூட்டமைப்பு	None
फेफड़ों	நுரையீரல்	None
फेयर	நியாயமான	Nan
फेर	திரும்பவும்	None
फेंक	வீசு	Nan
बनता	செய்யப்பட வேண்டும்	Nan
फोटोग्राफी	புகைப்படம் எடுத்தல்	Nan
फोर्ट	கோட்டை	None
बंगलौर	பெங்களூர்	Nan
बंगाल	வங்கம்	Nan
बंगाली	பெங்காலி	Nan
बंद	நெருக்கமான	None
बंदरगाह	துறைமுகம்	None
बंदरगाहों	துறைமுகங்கள்	Nan
बंगलोर	பெங்களூர்	Nan
बंदी	சிறைப்பிடிக்கப்பட்டவர்	Nan
बंध	பேண்ட்	Nan
बंधन	பிணைப்பு	Nan
बंधे	கட்டப்பட்டது	None
बंबई	பம்பாய்	None
बकरी	வெள்ளாடு	Nan
बगल	பக்க	None
बंदूक	துப்பாக்கி	Nan
फोन	தொலைபேசி	None
बंगलूरू	பெங்களூர்	Nan
बंगलादेश	பங்களாதேஷ்	Nan
फोर्स	படை	None
फौज	இராணுவம்	None
फ्रांस	பிரான்ஸ்	None
फ्रांसिस	பிரான்சிஸ்	None
फ्रांसिस्को	பிரான்சிஸ்கோ	None
फ्रांसीसी	பிரஞ்சு	Nan
बंगलुरु	பெங்களூர்	Nan
फ्रेंच	பிரஞ்சு	Nan
फ्लाइट	விமானம்	None
फ्लू	காய்ச்சல்	None
फ्लैश	ஃப்ளாஷ்	Nan
फ्लोएम	புளோம்	Nan
फ्लोरिडा	புளோரிடா	None
बंगला	மாளிகை	None
फ्रेम	சட்டகம்	Nan
बाराबंकी	பராபங்கி	Nan
बनती	செய்யப்பட்டது	None
बनवाया	கட்டப்பட்டது	None
बागवानी	தோட்டம்	Nan
बाग	தோட்டம்	None
बाकी	மீதமுள்ளவை	Nan
बाएं	இடது	None
बाएँ	இடது	None
बाईं	இடது	None
बाई	பணிப்பெண்	Nan
बाइबिल	திருவிவிலியம்	Nan
बाइबल	பைபிள்	Nan
बाइनरी	பைனரி	Nan
बांह	கை	None
बांधने	கட்ட	Nan
बांध	அணை	None
बांटा	விநியோகிக்கப்பட்டது	Nan
बांट	விநியோகிக்கவும்	Nan
बांग्लादेश	பங்களாதேஷ்	Nan
बांग्ला	பங்களா	Nan
बहिष्कार	வெளியேற்றம்	None
बहु	பல	None
बहुत	மிகவும்	None
बहुतायत	ஏராளமான	None
बहुधा	அடிக்கடி	None
बहुमत	பெரும்பான்மை	None
बाग़	தோட்டம்	Nan
बहुमुखी	பல்துறை	Nan
बहुवचन	பன்மை	None
बहुसंख्यक	பன்முகத்தன்மை	None
बाँग्ला	பெங்காலி	Nan
बाँट	விநியோகம்	None
बाँटा	விநியோகிக்கப்பட்டது	Nan
बाँध	கட்டுதல்	Nan
बहुल	பல	None
बागान	தோட்டம்	None
बागों	தோட்டங்கள்	Nan
बाघ	புலி	None
बाध्यकारी	கட்டாய	None
बाप	அப்பா	Nan
बापू	பாபு	None
बाबर	பாபர்	Nan
बाबा	செயிண்ட்	None
बाबू	பாபு	None
बाध्य	கட்டுண்டது	Nan
बायाँ	இடது	None
बायें	இடது	None
बार	முறை	None
बारबार	மீண்டும் மீண்டும்	Nan
बारह	பன்னிரண்டு	None
बारहमासी	வற்றாத	Nan
बारहवीं	பன்னிரண்டாவது	Nan
बायीं	இடது	None
बहाव	ஓட்டம்	None
बाधित	குறுக்கிட்டது	Nan
बादशाह	ராஜா	None
बाजपेयी	பாஜ்பாய்	Nan
बाज़ार	சந்தை	None
बाजार	சந்தை	None
बाजीराव	பாஜிராவ்	Nan
बाड़ी	வேலி	None
बाढ	வெள்ளம்	None
बादशाहत	ராஜா	None
बाढ़	வெள்ளம்	None
बातचीत	அரட்டை	Nan
बातें	அந்த பொருட்கள்	Nan
बातों	விஷயங்கள்	None
बाद	பிறகு	None
बादल	மேகம்	None
बादलों	மேகங்கள்	Nan
बाण	அம்பு	None
बहाल	மீண்டும் தொடங்கியது	Nan
बहार	வசந்த	None
बहाने	சாக்கு	Nan
बन्द	மூடப்பட்டது	Nan
बन्दरगाह	துறைமுகம்	None
बन्दी	கைதி	Nan
बन्ध	கட்டுண்டது	Nan
बम	குண்டு	None
बम्बई	பம்பாய்	None
बनेगा	உருவாகும்	None
बयान	அறிக்கை	None
बरसात	மழை	None
बराक	பராக்	Nan
बराबरी	இணையாக	None
बरेली	பரேலி	Nan
बर्तन	கப்பல்	None
बर्फ	பனி	None
बरमूडा	பெர்முடா	None
बर्बर	காட்டுமிராண்டித்தனம்	Nan
बनें	ஆக	None
बनीं	ஆனது	None
बनाई	செய்யப்பட்டது	None
बनाकर	தயாரிப்பதன் மூலம்	Nan
बनाता	செய்கிறது	None
बनाती	செய்கிறது	None
बनाते	செய்ய	Nan
बनाना	தயாரிக்க, தயாரிப்பு	Nan
बने	செய்யப்பட வேண்டும்	Nan
बनाने	செய்ய	Nan
बनाया	செய்ய	Nan
बनायी	செய்யப்பட்டது	None
बनाये	செய்ய	Nan
बनारस	பனாரஸ்	Nan
बनावट	அமைப்பு	None
बनी	செய்யப்பட்டது	None
बनाम	vs	Nan
बनते	செய்யப்படுகின்றன	None
बर्बरता	காழ்ப்புணர்ச்சி	Nan
बर्लिन	பெர்லின்	None
बसी	செட்டில்	Nan
बसु	பாசு	Nan
बसे	செட்டில்	Nan
बसें	பேருந்துகள்	None
बस्तियों	குடியேற்றங்கள்	None
बस्ती	காலனி	None
बसाया	செட்டில்	Nan
बह	ஓட்டம்	None
बहने	பாயும்	None
बहरहाल	எனினும்	None
बहस	விவாதம்	None
बहा	உதிர்தல்	Nan
बहादुर	தைரியமான	Nan
बहाना	சாக்குப்போக்கு	Nan
बहन	சகோதரி	Nan
बर्मा	பர்மா	None
बसने	செட்டில்	Nan
बल्लेबाजी	பேட்டிங்	Nan
बल	சக்தி	None
बलदेव	பல்தேவ்	Nan
बलपूर्वक	கட்டாயப்படுத்தி	Nan
बलबन	பால்பன்	Nan
बलराम	பலராம்	Nan
बलि	தியாகம்	Nan
बल्लेबाजों	பேட்ஸ்மேன்கள்	Nan
बलिदान	தியாகம்	Nan
बलुआ	மணல்	None
बलों	படைகள்	None
बल्कि	மாறாக	None
बल्लभ	பல்லப்	Nan
बल्ले	மட்டை	None
बल्लेबाज	பேட்ஸ்மேன்	Nan
बलिया	பாலியா	Nan
लिंक	இணைப்பு	None
लिंकन	லிங்கன்	None
लिंक्स	இணைப்புகள்	None
सुचना	அறிவிப்பு	None
सुगम	வசதி	None
सुगंध	மணம்	None
सुखों	இன்பங்கள்	Nan
सुखी	சந்தோஷமாக	Nan
सुखा	உலர்	None
सुखसागर	சுக்சாகர்	Nan
सुख	மகிழ்ச்சி	Nan
सुक्ष्म	நல்லது	None
सुकरात	சாக்ரடீஸ்	Nan
सुई	ஊசி	None
सुअर	பன்றி	None
सुंदरवन	சுந்தர்பன்ஸ்	Nan
सुंदरता	அழகு	None
सुंदर	அழகு	None
सीसा	வழி நடத்து	Nan
सील	முத்திரை	None
सीधी	நேராக	Nan
सीधे	நேரடியாக	None
सीने	மார்பு	None
सीनेट	செனட்	None
सीनेटर	செனட்டர்	None
सीमा	அளவு	None
सुचारु	மென்மையான	None
सीमाएँ	எல்லைகள்	None
सीमाओं	எல்லைகள்	None
सीमायें	எல்லைகள்	None
सीमित	வரையறுக்கப்பட்டவை	Nan
सीमेंट	சிமென்ட்	Nan
सीरिया	சிரியா	None
सीरीज	தொடர்கள்	Nan
सीमाएं	வரம்புகள்	Nan
सुचारू	மென்மையான	None
सुदर्शन	சுதர்சன்	Nan
सुदूर	தொலைநிலை	Nan
सुन्दरी	அழகு	None
सुन्नी	சுன்னி	None
सुपर	அருமை	Nan
सुप्रसिद्ध	நன்கு அறியப்பட்ட	Nan
सुबह	காலை	None
सुभद्रा	சுபத்ரா	Nan
सुन्दरता	அழகு	None
सुभाष	சுபாஷ்	None
सुभाषित	நன்கு வரையறுக்கப்பட்ட	Nan
सुमन	சுமன்	Nan
सुमात्रा	சுமத்ரா	Nan
सुमित्रा	சுமித்ரா	Nan
सुमित्रानंदन	சுமித்ரானந்தன்	Nan
सुर	டோன்	Nan
सुभाषबाबू	சுபாஷ் பாபு	Nan
सीधा	நேராக	Nan
सुन्दर	அழகு	None
सुनीता	சுனிதா	Nan
सुदृढ़	வலுவான	None
सुधा	சுதா	Nan
सुधारक	சீர்திருத்தவாதி	Nan
सुधारने	மேம்படுத்தவும்	Nan
सुधारों	சீர்திருத்தங்கள்	Nan
सुन	கேளுங்கள்	Nan
सुनील	சுனில்	Nan
सुनकर	கேட்பது	Nan
सुनने	கேளுங்கள்	Nan
सुना	கேள்விப்பட்டேன்	Nan
सुनाई	கேள்விப்பட்டேன்	Nan
सुनाया	விவரிக்கப்பட்டது	Nan
सुनिश्चित	உறுதி செய்யுங்கள்	Nan
सुनी	கேட்டார்	None
सुनते	கேளுங்கள்	Nan
सीताजी	சீதாஜி	Nan
सीता	சீதா	None
सीढ़ी	ஏணி	Nan
सिख	சீக்கியர்கள்	Nan
सिखाने	கற்பிக்க	Nan
सिखाया	கற்றுக் கொடுத்தார்	Nan
सिखों	சீக்கியர்கள்	Nan
सिगरेट	சிகரெட்	Nan
सिटी	நகரம்	Nan
सिक्खों	சீக்கியர்கள்	Nan
सिडनी	சிட்னி	Nan
सितम्बर	செப்டம்பர்	None
सितारा	நட்சத்திரம்	None
सितारे	நட்சத்திரங்கள்	None
सितारों	நட்சத்திரங்கள்	None
सिद्ध	நிரூபிக்கப்பட்டுள்ளது	Nan
सिद्धांत	கோட்பாடு	None
सितंबर	செப்டம்பர்	None
सिद्धांतों	கொள்கைகள்	None
सिक्के	நாணயங்கள்	None
सिक्का	நாணயம்	None
साहेब	சாஹேப்	Nan
सिंगापुर	சிங்கப்பூர்	None
सिंड्रोम	நோய்க்குறி	Nan
सिंध	சிந்து	None
सिंधिया	சிந்தியா	Nan
सिंधी	சிந்தி	Nan
सिक्किम	சிக்கிம்	None
सिंधु	சிந்து	None
सिंहली	சிங்களம்	None
सिंहस्थ	சிம்ஹஸ்தா	Nan
सिंहासन	சிம்மாசனம்	Nan
सिकंदर	அலெக்சாண்டர்	None
सिकंदराबाद	செகந்திராபாத்	Nan
सिकन्दर	அலெக்சாண்டர்	None
सिंह	சிங்கம்	None
सुरंग	சுரங்கம்	None
सिद्धान्त	கொள்கை	None
सिद्धार्थ	சித்தார்த்	Nan
सिवाय	தவிர	None
सिविल	சிவில்	Nan
सिस्टम	அமைப்பு	None
सी++	சி ++	Nan
सीकरी	சிக்ரி	Nan
सीक्रेट	ரகசியம்	Nan
सिल्क	பட்டு	None
सीख	கற்றல்	None
सीखा	கற்று	None
सीखें	அறிய	None
सीट	இருக்கை	Nan
सीटें	இருக்கைகள்	Nan
सीटों	இருக்கைகள்	Nan
सीडी	குறுவட்டு	Nan
सीखने	கற்றல்	None
सिद्धान्तों	கோட்பாடுகள்	None
सिलाई	தைத்து	Nan
सिर्फ़	மட்டும்	None
सिद्धि	சாதனை	None
सिनेमा	சினிமா	None
सिन्ध	சிந்து	None
सिन्धी	சிந்தி	Nan
सिन्धु	சிந்து	None
सिन्हा	சின்ஹா	Nan
सिलसिला	தொடர்ச்சி	None
सिपाहियों	சிப்பாய்கள்	Nan
सिफर्स	மறைக்குறியீடுகள்	Nan
सिफारिश	பரிந்துரை	None
सिम	சிம்	Nan
सियोल	சியோல்	Nan
सिर	தலை	None
सिर्फ	மட்டும்	None
सिपाही	சிப்பாய்	Nan
साहित्‍य	இலக்கியம்	None
सुरक्षा	பாதுகாப்பு	None
सुरा	சூரா	Nan
सोडियम	சோடியம்	None
सोचा	சிந்தியுங்கள்	Nan
सोचने	சிந்திக்க	Nan
सोचते	சிந்தியுங்கள்	Nan
सो	அதனால்	None
सॉफ्टवेर	மென்பொருள்	None
सॉफ्टवेयर	மென்பொருள்	None
सैलानी	சுற்றுலா	None
सैलानियों	சுற்றுலா பயணிகள்	Nan
सैर	நடை	None
सैयद	சையத்	Nan
सैन्य	இராணுவம்	None
सैद्धांतिक	கோட்பாட்டு	None
सैकड़ों	நூற்றுக்கணக்கான	None
सेवायें	சேவைகள்	None
सेवाओं	சேவைகள்	None
सेवाएं	சேவைகள்	None
सेतु	பாலம்	None
सेन	சென்	None
सेना	இராணுவம்	None
सेनाओं	படைகள்	None
सेनानी	போராளி	None
सेनापति	தளபதி	Nan
सोते	தூங்குகிறது	Nan
सेन्ट्रोसोम	சென்ட்ரோசோம்	Nan
सेल	செல்	None
सेलुलर	செல்லுலார்	Nan
सेल्यूकस	செலுகஸ்	Nan
सेल्सियस	செல்சியஸ்	Nan
सेवक	வேலைக்காரன்	Nan
सेवाएँ	சேவைகள்	None
सेब	ஆப்பிள்	None
सोन	மகன்	None
सोना	தங்கம்	None
सोनिया	சோனியா	Nan
सौन्दर्य	அழகு	None
सौभाग्य	நல்ல அதிர்ஷ்டம்	Nan
सौम्य	லேசான	Nan
सौर	சூரிய	None
सौरमंडल	சூரிய குடும்பம்	Nan
सौरमास	ச ur ர்மஸ்	Nan
सौदा	ஒப்பந்தம்	None
सौराष्ट्र	சவுராஷ்டிரா	Nan
स्कन्ध	சாரி	None
स्काई	வானம்	None
स्कूल	பள்ளி	None
स्कूली	பள்ளி	None
स्कूलों	பள்ளிகள்	None
स्केल	அளவுகோல்	None
स्कन्द	ஸ்கந்த்	Nan
सेठ	சேத்	Nan
सौजन्य	உபயம்	Nan
सौंप	ஒப்டைத்தல்	Nan
सोने	தங்கம்	None
सोपान	படி	None
सोम	சோம்	Nan
सोमनाथ	சோம்நாத்	Nan
सोमवार	திங்கட்கிழமை	Nan
सोर्स	மூல	None
सौंपा	ஒதுக்கப்படும்	Nan
सोलह	பதினாறு	None
सोविएत	சோவியத்	None
सोवियत	சோவியத்	None
सोसाइटी	சமூகம்	None
सोसायटी	சமூகம்	None
सौ	நூறு	None
सौंदर्य	அழகு	None
सोलहवीं	பதினாறாவது	Nan
सेट	தொகுப்பு	Nan
सेगोविआ	செகோவியா	Nan
सेक्स	செக்ஸ்	Nan
सूअरों	பன்றிகள்	Nan
सूक्ष्म	நுட்பமான	None
सूक्ष्मजीव	நுண்ணுயிரிகள்	Nan
सूक्ष्मजीवों	நுண்ணுயிரிகள்	Nan
सूक्ष्मजैविक	நுண்ணுயிரியல்	Nan
सूक्ष्मजैविकी	நுண்ணுயிரியல்	Nan
सूअर	பன்றிகள்	Nan
सूक्ष्मदर्शी	நுண்ணோக்கிகள்	Nan
सूखा	உலர்	None
सूखापन	வறட்சி	None
सूखी	உலர்	None
सूखे	உலர்ந்த	Nan
सूचक	காட்டி	None
सूचकांक	குறியீட்டு	None
सूख	உலர்ந்த	Nan
सूचना	தகவல்	None
सुस्पष्ट	பகட்டான	Nan
सुषमा	சுஷ்மா	Nan
सुरेन्द्र	சுரேந்திரா	Nan
सुरेश	சுரேஷ்	Nan
सुलझाने	தீர்க்கும்	None
सुलभ	அணுகக்கூடியது	Nan
सुल्तान	சுல்தான்	None
सुल्तानों	சுல்தான்கள்	Nan
सुसज्जित	அலங்கரிக்கப்பட்ட	Nan
सुवर्ण	தங்கம்	None
सुविधाएँ	அம்சங்கள்	Nan
सुविधाएं	வசதிகள்	None
सुविधाजनक	வசதியானது	Nan
सुव्यवस्थित	நன்கு ஒழுங்கமைக்கப்பட்ட	Nan
सुशील	சுஷீல்	Nan
सुशोभित	அருளாளர்	Nan
सुविधा	வசதி	None
सुरक्षित	பாதுகாப்பானது	Nan
सूचनाएं	அறிவிப்புகள்	Nan
सूचि	பட்டியல்	None
सूर्यकांत	சூர்யகாந்த்	Nan
सूर्यदेव	சூரிய கடவுள்	Nan
सूर्योदय	சூரிய உதயம்	Nan
सृजन	உருவாக்கம்	None
सृजनगाथा	படைப்புக் கதை	Nan
सृजनात्मक	கிரியேட்டிவ்	Nan
सूर्य	சூரியன்	None
सृजित	உருவாக்கப்பட்டது	None
से	இருந்து	None
सेंटर	மையம்	None
सेंट्रल	மத்திய	None
सेंसेक्स	சென்செக்ஸ்	Nan
सेकंड	இரண்டாவது	None
सेक्टर	துறை	None
सृष्टि	உருவாக்கம்	None
सूचनाओं	அறிவிப்புகள்	Nan
सूरी	சூரி	Nan
सूरत	முகம்	None
सूचित	தெரிவிக்கவும்	Nan
सूची	பட்டியல்	None
सूजन	வீக்கம்	None
सूडान	சூடான்	None
सूत्र	நூல்	None
सूत्रधार	கதை	None
सूरदास	சுர்தாஸ்	Nan
सूत्रपात	ஹெரால்ட்	Nan
सूनामी	சுனாமி	None
सूफ़ी	சூஃபி	Nan
सूफी	சூஃபி	Nan
सूबेदार	சுபேதர்	Nan
सूर	சுர்	Nan
सूरज	சூரியன்	None
सूत्रों	ஆதாரங்கள்	None
स्कैंडिनेवियाई	ஸ்காண்டிநேவிய	Nan
साहित्यिक	இலக்கியவாதி	Nan
साहित्य	இலக்கியம்	None
सरस	சரஸ்	Nan
सरलता	எளிமை	Nan
सरल	சுலபம்	Nan
सरन	சரண்	Nan
सरदार	முதல்வர்	None
सरकारों	அரசாங்கங்கள்	None
सरकारें	அரசாங்கங்கள்	None
सरकारी	அதிகாரி	None
सरकार	அரசு	None
सर	தலை	None
सयुंक्त	யுனைடெட்	None
सम्राट्	சக்கரவர்த்தி	None
सम्राटों	பேரரசர்கள்	Nan
सम्राट	பேரரசர்	None
सम्यक	சரி	None
सम्मेलन	கருத்தரங்கு	Nan
सम्मुख	எதிர்	None
सम्बंधित	தொடர்புடையது	None
सम्बंधी	தொடர்புடையது	None
सम्बद्ध	கூட்டணி	None
सम्बन्धित	தொடர்புடையது	None
सम्बन्धी	தொடர்புடையது	None
सम्बोधित	உரையாற்றினார்	Nan
सरसों	கடுகு	Nan
सम्भवतः	ஒருவேளை	None
सम्भोग	உடலுறவு	None
सम्मलेन	மாநாடு	None
सम्मान	மரியாதை	None
सम्मानित	மரியாதை	None
सम्मिलित	இல் சேர்க்கப்பட்டுள்ளது	Nan
सम्मिश्रण	கலத்தல்	Nan
सम्भावना	சாத்தியம்	None
सराहना	பாராட்டு	Nan
सराहा	பாராட்டப்பட்டது	Nan
सरीसृप	ஊர்வன	None
सर्वाधिक	பெரும்பாலானவை	None
सर्विस	சேவை	None
सर्वे	சர்வே	Nan
सर्वेक्षण	சர்வே	Nan
सर्वोत्तम	சிறந்த	None
सर्वोपरि	மிக முக்கியம்	Nan
सर्वांगीण	அனைத்து சுற்று	Nan
सलमान	சல்மான்	Nan
सलाहकार	ஆலோசகர்	Nan
सलीम	சலீம்	Nan
सल्तनत	சுல்தானேட்	Nan
सल्फर	கந்தகம்	None
सल्ल	விற்பனை	None
सवाई	சவாய்	Nan
सलाह	ஆலோசனை	None
सम्बंध	உறவு	None
सर्वश्रेष्ठ	சிறந்த	None
सर्वव्यापी	எங்கும்	None
सरोवर	ஏரி	None
सर्च	தேடல்	None
सर्दियों	குளிர்காலம்	None
सर्दी	குளிர்	Nan
सर्प	பாம்பு	None
सर्पिल	சுழல்	None
सर्वशक्तिमान	சர்வ வல்லமையுள்ளவர்	Nan
सर्वज्ञ	எல்லாம் அறிந்தவர்	Nan
सर्वदा	என்றென்றும்	Nan
सर्वनाम	பிரதிபெயர்களை	Nan
सर्वपल्ली	சர்வபள்ளி	Nan
सर्वप्रथम	முதல்	None
सर्वमान्य	உலகளவில் ஏற்றுக்கொள்ளப்பட்டது	Nan
सर्वर	சேவையகம்	Nan
सर्वथा	ஒட்டுமொத்தமாக	Nan
सम्प्रदायों	சமூகங்கள்	None
सम्प्रदाय	சமூக	Nan
सम्पूर्ण	மொத்தம்	Nan
समाज	சமூகம்	None
समाजवाद	சோசலிசம்	Nan
समाजवादी	சோசலிஸ்ட்	Nan
समाजशास्त्र	சமூகவியல்	None
समाजों	சங்கங்கள்	Nan
समाधान	தீர்வு	None
समाचारपत्रों	செய்தித்தாள்கள்	Nan
समाधि	கல்லறை	None
समानता	சமத்துவம்	Nan
समानताएं	ஒற்றுமைகள்	Nan
समानांतर	இணை	None
समानान्तर	இணை	None
समाप्त	முடிவு	None
समाप्ति	முற்றும்	Nan
समान	அதே	None
समारोह	விழா	None
समाचारपत्र	செய்தித்தாள்	Nan
समांतर	இணை	None
समर्थक	ஆதரவாளர்	Nan
समर्थकों	ஆதரவாளர்கள்	Nan
समर्थन	ஆதரவு	None
समर्पण	அர்ப்பணிப்பு	Nan
समर्पयामि	அர்ப்பணிப்பு	Nan
समर्पित	அர்ப்பணிக்கப்பட்டது	Nan
समाचार	செய்தி	None
समशीतोष्ण	மிதமான	Nan
समस्त	அனைத்தும்	Nan
समस्या	பிரச்சனை	Nan
समस्याएँ	பிரச்சினைகள்	None
समस्याएं	சிக்கல்கள்	None
समस्याओं	பிரச்சினைகள்	None
समा	சுற்றுச்சூழல்	None
समसामयिक	தற்கால	Nan
सवार	சவாரி	Nan
समारोहों	கொண்டாட்டங்கள்	None
समाविष्ट	சேர்க்கப்பட்டுள்ளது	Nan
समूचे	முழு	None
समूह	குழு	None
समूहों	குழுக்கள்	Nan
समृद्ध	வளமான	None
समृद्धि	செழிப்பு	Nan
समेटे	பெருமை பேசுகிறது	Nan
समुद्रों	கடல்கள்	Nan
समेत	உட்பட	None
सम्पत्ति	உடைமை	Nan
सम्पदा	தோட்டங்கள்	Nan
सम्पन्न	முடிந்தது	None
सम्पर्क	தொடர்பு கொள்ளுங்கள்	Nan
सम्पादन	திருத்துதல்	Nan
सम्पादित	திருத்தப்பட்டது	Nan
समोच्च	விளிம்பு	Nan
समालोचना	திறனாய்வு	Nan
समुद्री	மரைன்	Nan
समुद्रतट	கடல் கரை	Nan
समावेश	சேர்த்தல்	Nan
समाहित	உள்ளடக்கியது	None
समिति	கமிட்டி	None
समितियों	குழுக்கள்	Nan
समीकरण	சமன்பாடு	None
समीकरणों	சமன்பாடுகள்	None
समुद्रतल	கடல் மட்டத்தில்	Nan
समीक्षा	விமர்சனம்	None
समुचित	முறையானது	None
समुच्चय	தொகுப்பு	None
समुदाय	சமூக	Nan
समुदायों	சமூகங்கள்	None
समुद्र	கடல்	None
समुद्रगुप्त	சமுத்திரகுப்தர்	Nan
समीप	அருகில்	None
साहित्यकार	லிட்டரேட்டூர்	Nan
सवारी	சவாரி	Nan
सविता	சவிதா	Nan
सामना	முகம்	None
सामग्री	பொருள்	None
सामंजस्य	நல்லிணக்கம்	Nan
साम	பொருள்	None
साबुन	வழலை	Nan
साबित	நிரூபித்தது	Nan
साफ्टवेयर	மென்பொருள்	None
साफ	சுத்தமான	None
साप्ताहिक	வாராந்திர	Nan
सापेक्षता	சார்பியல்	None
सापेक्ष	உறவினர்	Nan
सान्निध्य	தொடர்ச்சியான	None
सानिया	சானியா	Nan
साध्य	நடைமுறை	None
साधु	ஹெர்மிட்	Nan
साधारणतया	பொதுவாக	Nan
साधारणतः	பொதுவாக	Nan
सातवाँ	ஏழாவது	None
सातवीं	ஏழாவது	None
सात्विक	ஒழுக்கம்	None
साथ	உடன்	None
साथसाथ	ஒன்றாக	None
साथियों	சக	None
सामने	முன்	None
साथी	கூட்டாளர்	Nan
साध	உதவி	None
साधक	கோருவோர்	Nan
साधन	வளங்கள்	None
साधना	தியானம்	Nan
साधनों	பொருள்	None
साधारण	எளிமையானது	Nan
सादगी	எளிமை	Nan
सामरिक	மூலோபாய	Nan
सामान	சாமான்கள்	Nan
सामान्य	இயல்பானது	Nan
सार्थक	அர்த்தமுள்ள	Nan
सार्वजनिक	பொது	None
सार्वजानिक	பொது	None
सार्वभौमिक	யுனிவர்சல்	Nan
साल	ஆண்டு	None
सालाना	ஆண்டு	None
सारे	அனைத்தும்	Nan
सालों	ஆண்டுகள்	None
सावन	பருவமழை	Nan
सावरकर	சாவர்க்கர்	Nan
सावित्री	சாவித்ரி	Nan
साहब	ஐயா	Nan
साहसिक	சாகசம்	Nan
साहसी	தைரியமான	Nan
सावधान	கவனமாக	None
सात	ஏழு	None
सारी	அனைத்தும்	Nan
सारा	அனைத்தும்	Nan
सामान्यत	பொதுவாக	Nan
सामान्यतः	பொதுவாக	Nan
सामान्यतया	பொதுவாக	Nan
सामी	சாமி	None
सामुदायिक	சமூகம்	None
सामूहिक	கூட்டு	None
सारांश	சுருக்கம்	None
साम्राज्य	பேரரசு	None
साम्राज्यों	பேரரசுகள்	None
सायंकाल	சாயங்காலம்	Nan
सार	சுருக்கம்	None
सारणी	அட்டவணை	Nan
सारथी	தேர்	Nan
सारनाथ	சாரநாத்	Nan
साम्राज्यवाद	ஏகாதிபத்தியம்	Nan
साढेसाती	சதேசதி	Nan
साड़ी	சேலை	None
साठ	அறுபது	Nan
सहस्र	சஹஸ்ரா	Nan
सहस्राब्दी	மில்லினியம்	Nan
सहस्रों	மில்லினியம்	Nan
सहानुभूति	அனுதாபம்	Nan
सहाय	உதவி	None
सहायक	உதவியாளர்	Nan
सहस्त्रपाद	மில்லே	Nan
सहायता	உதவி	None
सहारा	உதவி	None
सहारे	ஆதரவு	None
सहित	உட்பட	None
सहिष्णुता	சகிப்புத்தன்மை	Nan
सही	சரி	None
सा	சா	None
सहारनपुर	சஹரன்பூர்	Nan
साँची	சாஞ்சி	Nan
सहलक्षण	சின்னம்	None
सहयोग	உதவி	None
सविन्धान	அரசியலமைப்பு	None
सशक्त	வலுவான	None
सशस्त्र	ஆயுதம்	None
सस्ता	மலிவானது	Nan
सस्ते	மலிவானது	Nan
सह	கோ	Nan
सहयोगी	கூட்டாளர்	Nan
सहकारी	கூட்டுறவு	Nan
सहज	தன்னிச்சையானது	Nan
सहजता	இயல்பான தன்மை	Nan
सहन	பொறுத்துக்கொள்ளுங்கள்	Nan
सहनशीलता	சகிப்புத்தன்மை	Nan
सहमत	ஒப்புக்கொள்கிறேன்	Nan
सहमति	ஒப்பந்தம்	None
सहगल	சேகல்	Nan
सवालों	கேள்விகள்	None
साँप	பாம்பு	None
सांकेतिक	டோக்கன்	Nan
साओ	சாவோ	Nan
साकार	உணர்ந்துகொள்வது	Nan
साकी	சாகி	Nan
साकीबाला	சாகிபாலா	Nan
साकेत	சாகேத்	Nan
साक्षरता	கல்வியறிவு	Nan
साईट	தளத்தில்	None
साक्षात्	நபர்	None
साक्षी	சாட்சி	None
साक्ष्य	ஆதாரம்	None
साखी	நண்பர்	Nan
सागर	கடல்	None
साझा	பகிரப்பட்டது	Nan
साझेदारी	கூட்டாண்மை	Nan
साक्षात्कार	நேர்காணல்	Nan
साँस	சுவாசம்	Nan
साई	சாய்	Nan
साइड	பக்கம்	None
सांख्य	எண்	None
सांख्यिकी	புள்ளிவிவரம்	None
सांख्यिकीय	புள்ளிவிவரம்	None
सांची	சாஞ்சி	Nan
सांप्रदायिक	வகுப்புவாத	Nan
सांभर	சாம்பார்	Nan
साइडर	சைடர்	Nan
सांस	சுவாசம்	Nan
सांसारिक	பூமிக்குரியது	Nan
सांस्कृतिक	கலாச்சார	None
साइंस	விஞ்ஞானம்	None
साइकिल	மிதிவண்டி	Nan
साइट	தளத்தில்	None
साइटों	தளங்கள்	None
सांसद	பாராளுமன்ற உறுப்பினர்	Nan
समर्थ	திறன் கொண்டது	Nan
स्कैन	ஊடுகதிர்	Nan
स्कॉटलैंड	ஸ்காட்லாந்து	Nan
१००	100	Nan
१०	10	Nan
१	1	Nan
०	0	Nan
ह्रास	சீரழிவு	Nan
ह्रदय	இதயம்	None
होश	உணர்வுகள்	None
होली	ஹோலி	Nan
होलिका	நெருப்பு	None
होम्योपैथी	ஹோமியோபதி	Nan
होमियोपैथी	ஹோமியோபதி	Nan
होमर	ஹோமர்	Nan
होम	வீடு	None
होनेवाले	இருக்க வேண்டும்	Nan
होनेवाली	இருக்க வேண்டும்	Nan
होनी	இருக்க வேண்டும்	Nan
होना	நடக்கும்	None
हॉल	ஹால்	Nan
हॉलीवुड	ஹாலிவுட்	None
हो	ஹோ	Nan
हों	இரு	None
होंगी	இருக்கும்	None
होंगे	இருக்கும்	None
१०००	1000	Nan
होकर	மூலம்	None
होगी	இருக்கும்	None
होटल	ஹோட்டல்	Nan
होड़	போட்டி	None
होता	நடக்கும்	None
होती	வேண்டும்	None
होते	நிகழ்கிறது	Nan
होगा	நடக்கும்	None
१००००	10000	Nan
१०५	105	Nan
१०८	108	Nan
१८वीं	17 வது	Nan
१८१५	1815	Nan
१८४०	170	Nan
१८५०	1850	Nan
१८५७	1856	Nan
१८८०	170	Nan
१८	14	Nan
१९	19	Nan
१९००	1900	Nan
१९०१	1901	Nan
१९०२	1902	Nan
१९०३	1903	Nan
१९०४	1906	Nan
१९०६	1906	Nan
१९वीं	19	Nan
हॉकी	ஹாக்கி	None
१७००	1800	Nan
१६७४	14	Nan
१०९	10 9	Nan
११	11	Nan
१२	12	Nan
१२वीं	12 வது	Nan
१२०	120	Nan
१३	13	Nan
१७	14	Nan
१४	14	Nan
१५	15	Nan
१५वीं	15 வது	Nan
१५०	150	Nan
१५००	1500	Nan
१६	14	Nan
१६वीं	17 வது	Nan
१४००	1800	Nan
हैहालांकि	எனினும்	None
हैसूर्य	ஹெசுரி	Nan
हैसियत	நிலை	None
हुमायूं	ஹுமாயூன்	Nan
हुयी	நடந்தது	None
हुये	நடந்தது	None
हुसैन	உசேன்	Nan
हूँ	நான்	None
हूं	நான்	None
हुमायूँ	ஹுமாயூன்	Nan
हूनान	ஹுனன்	Nan
हे	ஏய்	Nan
हेक्टेयर	ஹெக்டேர்	Nan
हेतु	க்கு	Nan
हेमंत	ஹேமந்த்	Nan
हेमा	ஹேமா	Nan
हेरात	ஹெராத்	Nan
हॅ	இருக்கிறது	Nan
हेलोवीन	ஹாலோவீன்	Nan
हुगली	ஹூக்லி	Nan
हुए	வேண்டும்	None
हिस्सा	பகுதி	Nan
हिस्से	பாகங்கள்	None
हिस्सों	பாகங்கள்	None
ही	மட்டும்	None
हींग	அசாஃபோடிடா	Nan
हीन	தாழ்ந்த	None
हुक्म	ஆர்டர்	Nan
हीनयान	ஹினாயனா	Nan
हीरे	வைரங்கள்	Nan
हीरो	ஹீரோ	Nan
हीलियम	கதிர்வளி	Nan
हुआ	நடந்தது	None
हुआ|	நடந்தது	None
हुईं	ஏற்பட்டது	None
हीरा	வைர	Nan
१९०७	1906	Nan
हेल्थ	ஆரோக்கியம்	None
है	இருக்கிறது	Nan
हैजब	எப்பொழுது	Nan
हैजो	யார் யார்	Nan
हैतो	பிறகு	None
हैदर	ஹைதர்	Nan
हैदराबाद	ஹைதராபாத்	Nan
हैदराबादी	ஹைதராபாத்	Nan
हैकुछ	கொஞ்சம் எடுத்துக்கொள்	Nan
हैयह	இதுவா	Nan
हैरी	ஹாரி	Nan
हैलेकिन	ஆனாலும்	None
हैलोवीन	ஹாலோவீன்	Nan
हैवह	அவன் ஒரு	Nan
हैवे	வேண்டும்	None
हैव्यक्ति	நபர்	None
हैया	ஹையா	Nan
हेस्टिया	ஹெஸ்டியா	None
हैकि	அந்த	None
हैउसे	அவனிடம் உள்ளது	Nan
है|	இருக்கிறது	Nan
हैँ	ஆம்	None
हैं	ஹு	Nan
हैं|	உள்ளன	None
हैंइसके	அதன்	None
हैंउनके	அவர்கள்	None
हैएक	அங்கே ஒன்று உள்ளது	Nan
हैंयह	இது	None
हैंशनि	ஹன்ஷி	Nan
हैअगर	என்றால்	None
हैइसका	அதன்	None
हैउदाहरण	உதாரணமாக	None
हैउसका	அவனிடம் உள்ளது	Nan
हैउसके	அவனிடம் உள்ளது	Nan
हैंवे	ஹன்வே	Nan
हिस्ट्री	வரலாறு	None
१९०९	1909	Nan
१९११	1911	Nan
३९	39	Nan
३८	37	Nan
३७	37	Nan
३६	37	Nan
३५०	350	Nan
३५	35	Nan
३४	37	Nan
३३	33	Nan
३२२	322	Nan
३२०	320	Nan
३२	32	Nan
३१	31	Nan
३०००	3000	Nan
३००	300	Nan
३०	30	Nan
३	3	Nan
२९	29	Nan
२००७	2008	Nan
२००८	2008	Nan
२००९	2009	Nan
२०११	2011	Nan
२०१२	2012	Nan
२१	21	Nan
४	4	Nan
२२	22	Nan
२५	25	Nan
२५०	250	Nan
२६	24	Nan
२७	24	Nan
२७३	243	Nan
२८	24	Nan
२३	23	Nan
४०	40	Nan
४००	400	Nan
४२	42	Nan
६४	4	Nan
६५	45	Nan
७	4	Nan
७०	40	Nan
७५	45	Nan
८	4	Nan
६०००	8000	Nan
८०	40	Nan
८४	4	Nan
८५	45	Nan
९	4	Nan
९०	90	Nan
९५	95	Nan
९८	9 8	Nan
८००	400	Nan
२००६	2008	Nan
६००	400	Nan
६	4	Nan
४३	43	Nan
४५	45	Nan
४६	4	Nan
४७	4	Nan
४८	4	Nan
५	5	Nan
६०	40	Nan
५०	50	Nan
५०००	5000	Nan
५१	51	Nan
५२	52	Nan
५३	53	Nan
५५	55	Nan
५६	58	Nan
५००	500	Nan
२००५	2005	Nan
२००४	2008	Nan
२००३	2003	Nan
१९४५	1945	Nan
१९४७	1949	Nan
१९४८	1949	Nan
१९४९	1949	Nan
१९५०	1950	Nan
१९५२	1952	Nan
१९४३	1963	Nan
१९५३	1953	Nan
१९५५	1955	Nan
१९५६	1956	Nan
१९५७	1956	Nan
१९५९	1959	Nan
१९६०	1960	Nan
१९६१	1961	Nan
१९५४	1956	Nan
१९६२	1962	Nan
१९४२	1962	Nan
१९३७	1937	Nan
१९१७	1914	Nan
१९१८	1914	Nan
१९१९	1919	Nan
१९२१	1921	Nan
१९२२	1922	Nan
१९२४	1926	Nan
१९३९	1939	Nan
१९२५	1925	Nan
१९२९	1929	Nan
१९३०	1930	Nan
१९३१	1931	Nan
१९३२	1932	Nan
१९३४	1937	Nan
१९३६	1937	Nan
१९२८	1926	Nan
१९१०	1910	Nan
१९६४	1949	Nan
१९६८	1949	Nan
१९८९	1949	Nan
१९९०	190	Nan
१९९१	191	Nan
१९९२	192	Nan
१९९४	1949	Nan
१९९६	1949	Nan
१९८८	1949	Nan
१९९७	1949	Nan
१९९९	19	Nan
२	2	Nan
२०	20	Nan
२००	200	Nan
२०००	2000	Nan
२००१	2001	Nan
१९९८	1949	Nan
१९६५	1945	Nan
१९८७	1949	Nan
१९८५	1945	Nan
१९६९	1949	Nan
१९७०	1960	Nan
१९७१	1961	Nan
१९७३	1963	Nan
१९७४	1949	Nan
१९७६	1949	Nan
१९८६	1949	Nan
१९७७	1949	Nan
१९७९	1949	Nan
१९८०	1960	Nan
१९८१	1961	Nan
१९८२	1962	Nan
१९८३	1963	Nan
१९८४	1949	Nan
१९७८	1949	Nan
स्कैनिंग	ஸ்கேன் செய்கிறது	Nan
हिसाब	கணக்கீடு	Nan
हिम्मत	தைரியம்	Nan
स्वयंभू	சுய அறிவிப்பு	Nan
स्वयं	சுய	None
स्वप्न	கனவு	None
स्वपोषी	ஆட்டோட்ரோபிக்	Nan
स्वदेशी	என் நாடு	Nan
स्वदेश	தாய் நாடு	Nan
स्वतन्त्रता	சுதந்திரம்	None
स्वतन्त्र	இலவசம்	Nan
स्वतः	ஆட்டோ	Nan
स्वतंत्रता	சுதந்திரம்	None
स्वतंत्र	இலவசம்	Nan
स्वच्छमण्डल	சுத்தமான அறை	Nan
स्वच्छता	தூய்மை	None
स्वच्छंद	வேவர்ட்	Nan
स्वच्छ	சுத்தமான	None
स्वंय	தானே	None
स्व	சுய	None
स्पेन	ஸ்பெயின்	None
स्पेनी	ஸ்பானிஷ்	Nan
स्पेशल	சிறப்பு	None
स्पेस	இடம்	None
स्पैनिश	ஸ்பானிஷ்	Nan
स्प्रे	தெளிப்பு	Nan
स्वयंवर	சுயம்வர்	Nan
स्मरण	நினைவு	None
स्मारकों	நினைவுச்சின்னங்கள்	Nan
स्मिथ	ஸ்மித்	None
स्मृति	நினைவு	None
स्राव	வெளியேற்றம்	None
स्रोत	மூலம்	None
स्रोतों	ஆதாரங்கள்	None
स्मारक	நினைவகம்	None
स्वयंसेवक	தொண்டர்	Nan
स्वर	உயிர்	Nan
स्वराज	ஸ்வராஜ்	Nan
स्वामी	உரிமையாளர்	Nan
स्वामीजी	சுவாமிஜி	Nan
स्वायत्त	தன்னாட்சி	None
स्वास्थ्य	ஆரோக்கியம்	None
स्विट्जरलैंड	சுவிட்சர்லாந்து	None
स्विस	சுவிஸ்	None
स्वामित्व	உரிமையாளர்	Nan
स्वीकार	ஏற்றுக்கொள்	Nan
स्वीकृति	ஏற்றுக்கொள்வது	Nan
स्वीडन	சுவீடன்	None
स्वीडिश	ஸ்வீடிஷ்	Nan
स्‍त्री	பெண்	None
स्‍थान	இடம்	None
हंस	ஸ்வான்	Nan
स्वीकृत	அங்கீகரிக்கப்பட்டது	Nan
स्पेक्ट्रम	ஸ்பெக்ட்ரம்	Nan
स्वाभिमानी	சுயமரியாதை	Nan
स्वाभाविक	இயற்கை	Nan
स्वरुप	படிவம்	Nan
स्वरूप	வடிவம்	None
स्वरों	உயிரெழுத்துகள்	Nan
स्वर्ग	சொர்க்கம்	Nan
स्वर्गीय	பரலோக	Nan
स्वर्ण	தங்கம்	None
स्वाभिमान	சுய மரியாதை	Nan
स्वशासन	சுய அரசு	Nan
स्वाइन	பன்றி	None
स्वागत	வரவேற்பு	None
स्वाद	சுவை	None
स्वादिष्ट	சுவையானது	Nan
स्वाधीनता	சுதந்திரம்	None
स्वानिकी	ஒலிப்பு	Nan
स्वस्थ	ஆரோக்கியமான	None
स्पीकर	சபாநாயகர்	Nan
स्पिन	சுழல்	None
स्पष्टीकरण	விளக்கம்	None
स्ट्रीम	ஸ்ட்ரீம்	Nan
स्तंभ	நெடுவரிசை	Nan
स्तंभन	விறைப்பு	Nan
स्तंभों	நெடுவரிசைகள்	Nan
स्तन	மார்பக	None
स्तनधारी	பாலூட்டிகள்	None
स्ट्रीट	தெரு	None
स्तम्भ	நெடுவரிசை	Nan
स्तरीय	நிலை	None
स्तुति	புகழ்	None
स्तूप	ஸ்தூபம்	Nan
स्तोत्र	துதி	Nan
स्त्रियाँ	பெண்கள்	None
स्त्रियां	பெண்கள்	None
स्तर	நிலை	None
स्त्रियों	பெண்கள்	None
स्ट्राइकर	ஸ்ட்ரைக்கர்	Nan
स्टैण्डर्ड	தரநிலை	None
स्कॉटिश	ஸ்காட்டிஷ்	Nan
स्कोर	ஸ்கோர்	Nan
स्क्रबर	ஸ்க்ரப்பர்	Nan
स्क्रीन	திரை	None
स्क्रीनिंग	திரையிடல்	None
स्खलन	விந்துதள்ளல்	Nan
स्टॉक	பங்கு	None
स्टाफ	பணியாளர்கள்	Nan
स्टील	எஃகு	Nan
स्टेट	நிலை	None
स्टेडियम	மைதானம்	None
स्टेम	தண்டு	None
स्टेशन	நிலையம்	None
स्टेशनों	நிலையங்கள்	None
स्टार	நட்சத்திரம்	None
हक़	சரி	None
स्त्रीकेसर	பிஸ்டில்	Nan
स्त्रोत	மூல	None
स्थितियों	நிபந்தனைகள்	Nan
स्थिती	நிலை	None
स्थिर	சரி செய்யப்பட்டது	Nan
स्थिरता	ஸ்திரத்தன்மை	Nan
स्थूल	மேக்ரோ	Nan
स्थैतिक	நிலையான	None
स्थिति	நிகழ்வு	None
स्नातक	பட்டதாரி	Nan
स्नान	குளியல்	Nan
स्नायु	தசை	None
स्नेह	காதல்	None
स्पर्श	தொடவும்	Nan
स्पष्ट	தெளிவானது	Nan
स्पष्टता	தெளிவு	None
स्नातकोत्तर	முதுகலை	Nan
स्त्रीपुरूष	பெண்பால்	Nan
स्थित	அமைந்துள்ளது	None
स्थापित	நிறுவப்பட்டது	None
स्त्रोतों	ஆதாரங்கள்	None
स्थगित	ஒத்திவைக்கப்பட்டது	Nan
स्थल	தளத்தில்	None
स्थलाकृति	இடவியல்	Nan
स्थान	இடம்	None
स्थानांतरण	இடமாற்றம்	Nan
स्थायी	நிரந்தர	None
स्थानांतरित	நகர்த்தப்பட்டது	Nan
स्थानीय	உள்ளூர்	None
स्थानों	இடங்கள்	None
स्थापत्य	கட்டிடக்கலை	Nan
स्थापत्यकला	கட்டிடக்கலை	Nan
स्थापन	நிறுவல்	None
स्थापना	ஸ்தாபனம்	Nan
स्थानिक	உள்ளூர்	None
हिल	மலை	None
हज	ஹஜ்	None
हज़रत	ஹஸ்ரத்	Nan
हाला	மது	None
हालत	நிலை	None
हाल	நிலை	None
हार्वर्ड	ஹார்வர்ட்	None
हार्मोन	ஹார்மோன்கள்	Nan
हार्डी	ஹார்டி	Nan
हार्डवेयर	வன்பொருள்	Nan
हार	தோல்வி	None
हानिकारक	தீங்கு விளைவிக்கும்	Nan
हानि	இழப்பு	None
हान	ஹான்	Nan
हाथों	கைகள்	None
हाथी	யானை	None
हाथियों	யானைகள்	None
हाथ	கை	None
हाजी	ஹாஜி	Nan
हाउसबोट	ஹவுஸ் படகு	Nan
हस्तशिल्प	கைவினைப்பொருட்கள்	Nan
हस्ताक्षर	கையொப்பம்	Nan
हस्तिनापुर	ஹஸ்தினாபூர்	Nan
हस्तियों	பிரபலங்கள்	Nan
हाँ	ஆம்	None
हां	ஆம்	None
हालाँकि	எனினும்	None
हांग	ஹாங்	Nan
हाइड्रिल्ला	ஹைட்ரில்லா	Nan
हाइड्रोकार्बन	ஹைட்ரோகார்பன்கள்	Nan
हाइड्रोजन	ஹைட்ரஜன்	None
हाइपर	ஹைப்பர்	Nan
हाई	வணக்கம்	None
हाउस	வீடு	None
हांगकांग	ஹாங்காங்	Nan
हालात	சூழ்நிலைகள்	None
हावी	ஆதிக்கம்	None
हासिल	பெறுங்கள்	Nan
हिन्दयूरोपीय	இந்தோ-ஐரோப்பிய	Nan
हिन्दी	இந்தி	None
हिन्दीउर्दू	இந்தி உருது	Nan
हिन्दीकुंज	இந்திகுஞ்ச்	Nan
हिन्दु	இந்து	None
हिन्दुओं	இந்துக்கள்	Nan
हिन्द	ஹிந்த்	Nan
हिन्दुस्तान	இந்துஸ்தான்	Nan
हिन्दुस्थान	இந்துஸ்தான்	Nan
हिन्दू	இந்து	None
हिब्रू	ஹீப்ரு	Nan
हिमनद	பனிப்பாறைகள்	Nan
हिमाचल	இமாச்சல்	Nan
हिमालयी	இமயமலை	None
हिन्दुस्तानी	இந்துஸ்தானி	None
हस्तलिखित	கையால் எழுதப்பட்டது	Nan
हितों	ஆர்வங்கள்	Nan
हिटलर	ஹிட்லர்	Nan
हास्य	நகைச்சுவை	Nan
हि	அவர்	None
हिंद	ஹிந்த்	Nan
हिंदी	இந்தி	None
हिंदीकुंज	இந்திகுஞ்ச்	Nan
हिंदु	இந்து	None
हित	ஆர்வம்	None
हिंदुओं	இந்துக்கள்	Nan
हिंदू	இந்து	None
हिंसक	வன்முறை	None
हिंसा	வன்முறை	None
हिक्सोस	ஹிக்சோஸ்	Nan
हिज्री	ஹிஜ்ரி	Nan
हिट	அடி	None
हिंदुस्तान	இந்தியா	None
हस्तमैथुन	சுயஇன்பம்	Nan
हस्तक्षेप	குறுக்கீடு	Nan
हवेली	மாளிகை	None
हथेली	பனை	None
हद	எல்லை வரை	Nan
हनन	துஷ்பிரயோகம்	Nan
हनुमान	அனுமன்	None
हनुमानजी	அனுமன் ஜி	Nan
हम	நாங்கள்	None
हथियारों	ஆயுதங்கள்	None
हमको	நாங்கள்	None
हमला	தாக்குதல்	None
हमले	தாக்குதல்கள்	Nan
हमलों	தாக்குதல்கள்	Nan
हमसे	எங்களிடம் இருந்து	Nan
हमारा	நமது	None
हमारी	நமது	None
हमने	நாங்கள்	None
हमारे	நமது	None
हथियार	ஆயுதங்கள்	None
हड्डी	எலும்பு	Nan
हज़ार	ஆயிரம்	None
हज़ारों	ஆயிரம்	None
हजार	ஆயிரம்	None
हजारी	ஹசாரி	Nan
हजारे	ஹசாரே	Nan
हजारों	ஆயிரம்	None
हत्या	கொலை	Nan
हट	குடிசை	Nan
हटा	அகற்று	Nan
हटाकर	அகற்றுவதன் மூலம்	Nan
हटाया	அகற்றப்பட்டது	Nan
हड़ताल	வேலைநிறுத்தம்	Nan
हड़प्पा	ஹரப்பா	None
हड़प्पाई	ஹரப்பன்	Nan
हटकर	ஆஃப்	None
हजरत	ஹஸ்ரத்	Nan
हमीरपुर	ஹமீர்பூர்	Nan
हमें	எங்களுக்கு	Nan
हरेक	ஒவ்வொன்றும்	None
हर्षवर्धन	மகிழ்ச்சியை அதிகரிக்கும் ஒருவர்	Nan
हल	தீர்வு	None
हलचल	அசை	Nan
हल्का	ஒளி	None
हल्की	ஒளி	None
हरे	பச்சை	None
हल्के	இலகுரக	Nan
हवन	நெருப்பின் முன் கடவுளிடம் ஜெபம் செய்வது	Nan
हवा	காற்று	None
हवाई	காற்றோட்டமான	Nan
हवाएं	தென்றல்கள்	Nan
हवाओं	காற்று	None
हवाले	ஒப்படை, பொறுப்பை ஒப்படை	Nan
हल्दी	மஞ்சள்	None
हमे	எங்களுக்கு	Nan
हरी	பச்சை	None
हरिशंकर	ஹரிஷங்கர்	Nan
हमेशा	எப்போதும்	None
हर	ஒவ்வொன்றும்	None
हरण	ஹரன்	Nan
हरदोई	ஹார்டோய்	Nan
हरमंदिर	ஹர்மந்திர்	Nan
हरि	ஹரி	Nan
हरिश्चन्द्र	ஹரிஷ் சந்திரா	Nan
हरिकृष्ण	ஹரிகிருஷ்ணா	Nan
हरित	பச்சை	None
हरिता	ஹரிதா	Nan
हरिदास	ஹரிதாஸ்	Nan
हरिद्वार	ஹரித்வார்	Nan
हरियाणा	ஹரியானா	Nan
हरिवंश	ஹரிவன்ஷ்	Nan
हरिजन	ஹரிஜன்	Nan
पिग्मी	பிக்மி	Nan
समरकंद	சமர்கண்ட்	Nan
समयसमय	அவ்வப்போது	Nan
विवेकानंद	விவேகானந்தர்	None
विवेकाधीन	விருப்பப்படி	Nan
विवेक	விவேகம்	Nan
विविधता	பன்முகத்தன்மை	None
विविध	பன்முகத்தன்மை	None
विवाहित	திருமணமானவர்	Nan
विवाह	திருமணம்	None
विवादों	சர்ச்சைகள்	None
विवादित	சர்ச்சைக்குரியது	Nan
विवादास्पद	சர்ச்சைக்குரிய	Nan
विवादस्पद	சர்ச்சைக்குரிய	Nan
विवाद	சர்ச்சை	None
विवश	கட்டுப்படுத்தப்பட்டது	Nan
विवर्तन	வேறுபாடு	None
विवरण	விளக்கம்	None
विलुप्त	அழிந்துவிட்டது	Nan
विलीन	இணைக்கப்பட்டது	None
विराम	இடைவெளி	None
विरासत	மரபுரிமை	Nan
विरुद्ध	எதிராக	None
विरूद्ध	எதிராக	None
विरोध	எதிராக	None
विरोधियों	எதிரிகள்	None
विवेकानन्द	விவேகானந்தர்	None
विरोधी	எதிர்ப்பு	None
विलय	இணைவு	Nan
विलयन	இணைப்பு	None
विलाप	மோன்	Nan
विलायक	கரைப்பான்	Nan
विलासिता	சொகுசு	Nan
विलियम	வில்லியம்	None
विलक्षण	ஒருமை	None
विवेचन	விவாதம்	None
विशद	தெளிவான	None
विशाखापट्नम	விசாகப்பட்டினம்	Nan
विश्लेषण	பகுப்பாய்வு	None
विश्लेषणात्मक	பகுப்பாய்வு	None
विश्व	உலகம்	None
विश्वकर्मा	விஸ்வகர்மா	Nan
विश्वकोश	கலைக்களஞ்சியம்	Nan
विश्वकोष	கலைக்களஞ்சியம்	Nan
विश्राम	ஓய்வு	None
विश्वप्रसिद्ध	உலக புகழ்பெற்ற	Nan
विश्वविख्यात	உலக புகழ்பெற்ற	Nan
विश्वविद्यालयों	பல்கலைக்கழகங்கள்	None
विश्वव्यापी	உலகளவில்	None
विश्वसनीय	நம்பகமான	Nan
विश्वामित्र	விஸ்வாமித்ரா	Nan
विश्वास	நம்புங்கள்	Nan
विश्वयुद्ध	உலக போர்	Nan
विराट	விராட்	Nan
विशेषताओं	பண்புகள்	None
विशेषताएँ	அம்சங்கள்	Nan
विशाल	பரந்த	None
विशालकाय	ராட்சத	Nan
विशालता	பரந்த தன்மை	Nan
विशिष्ट	குறிப்பிட்ட	None
विशिष्टता	சிறப்பு	None
विशुद्ध	தூய	None
विशेषताएं	அம்சங்கள்	Nan
विशेष	சிறப்பு	None
विशेषज्ञ	நிபுணர்	Nan
विशेषज्ञों	நிபுணர்கள்	None
विशेषण	உரிச்சொற்கள்	Nan
विशेषत	குறிப்பாக	None
विशेषतः	குறிப்பாக	None
विशेषता	சிறப்பு	None
विशेषकर	குறிப்பாக	None
विराजमान	அமர்ந்திருக்கும்	Nan
विरह	இல்லாதது	Nan
वियोग	துண்டித்தல்	Nan
विधवा	விதவை	Nan
विधा	வகை	None
विधाओं	வகைகள்	None
विधान	சட்டம்	None
विधानसभा	சட்டசபை	Nan
विधायिका	சட்டமன்றம்	None
विद्वान्	அறிஞர்	None
विधायी	சட்டமன்றம்	None
विधियाँ	முறைகள்	None
विधियां	முறைகள்	None
विधेयक	ர சி து	Nan
विनती	கோரிக்கை	None
विनम्र	கண்ணியமாக	Nan
विनय	அடக்கம்	None
विधि	முறை	None
विनायकाय	விநாயகர்	None
विद्वानों	அறிஞர்கள்	None
विद्रोही	கிளர்ச்சியாளர்கள்	Nan
विदेशी	வெளிநாட்டவர்	Nan
विद्यमान	இருக்கும்	None
विद्या	அறிவு	None
विद्याओं	கல்வியாளர்கள்	Nan
विद्यापति	அறிஞர்	None
विद्यार्थियों	மாணவர்கள்	None
विद्वान	அறிஞர்	None
विद्यार्थी	மாணவர்	None
विद्यालयों	பள்ளிகள்	None
विद्युत	மின்சாரம்	None
विद्युत्‌	மின்சாரம்	None
विद्युदणु	எதிர் மின்னணு	Nan
विद्योत्तमा	வித்யுத்மா	Nan
विद्रोह	கிளர்ச்சி	None
विद्यालय	பள்ளி	None
विश्वासघात	துரோகம்	Nan
विनाश	அழிவு	None
विनिमय	பரிமாற்றம்	None
विभाजन	பிரிவு	None
विभाजित	பிளவு	None
विभाषा	பகிர்வு	Nan
विभिन्न	வெவ்வேறு	None
विभिन्नता	மாறுபாடு	None
विभिन्‍न	வெவ்வேறு	None
विभागों	துறைகள்	None
विभीषण	நிர்மூலமாக்கல்	Nan
विमर्श	கலந்துரையாடல்	Nan
विमल	விமல்	Nan
विमान	விமானம்	None
विमानक्षेत्र	விமான நிலையம்	Nan
विमानों	விமானங்கள்	Nan
वियतनाम	வியட்நாம்	None
विभेदन	வேறுபாடு	None
विनाशकारी	அழிவுகரமான	Nan
विभाग	துறை	None
विफलता	தோல்வி	None
विनियमन	ஒழுங்குமுறை	Nan
विनियमित	ஒழுங்குபடுத்தப்பட்டுள்ளது	Nan
विनिर्देश	விவரக்குறிப்பு	Nan
विनिर्माण	உற்பத்தி	None
विनोद	நகைச்சுவை	Nan
विनोबा	வினோபா	Nan
विभक्त	வகுப்பி	Nan
विन्डोज़	விண்டோஸ்	None
विन्यास	கட்டமைப்பு	None
विपक्ष	எதிர்ப்பு	None
विपक्षी	எதிர்ப்பு	None
विपणन	சந்தைப்படுத்தல்	Nan
विपरीत	பாதகமான	Nan
विफल	தோல்வி	Nan
विन्या	வின்யா	Nan
विदेशियों	வெளிநாட்டினர்	Nan
विश्वासों	நம்பிக்கைகள்	None
विश्‍वविद्यालय	பல்கலைக்கழகம்	Nan
व्यंजना	சொற்பொழிவு	Nan
व्यंजन	உணவுகள்	None
व्यंग्यरचना	கிண்டல்	Nan
व्यंग्य	கிண்டல்	Nan
वोल्टायिक	வோல்டாயிக்	Nan
वोर्ल	வோர்ல்	Nan
वोट	வாக்கு	None
वो	அவர்கள்	None
वॉट	வாட்	None
वैसे	மூலம்	None
वैसी	அது போல	Nan
वैसा	அது போல	Nan
वैष्णो	வைஷ்ணோ	Nan
वैष्णव	வைஷ்ணவ்	Nan
वैश्वीकरण	உலகமயமாக்கல்	Nan
वैश्विक	உலகளாவிய	None
वैश्य	வைஷ்ய	Nan
वैज्ञानिकों	விஞ்ஞானிகள்	None
वैदिक	வேத	None
वैद्य	டாக்டர்	None
वैद्युत	மின்	None
वैध	செல்லுபடியாகும்	Nan
वैधता	செல்லுபடியாகும்	Nan
व्यंजनों	சமையல்	None
वैधानिक	சட்டரீதியான	Nan
वैराग्य	அமைதி	None
वैली	பள்ளத்தாக்கு	None
वैवाहिक	திருமணமானவர்	Nan
वैशाख	பைஷாக்	Nan
वैशाली	வைஷாலி	Nan
वैशेषिक	சிறப்பு	None
वैभव	ஆடம்பரம்	Nan
व्यक्त	வெளிப்படுத்தியது	Nan
व्यक्ति	நபர்	None
व्यक्तिगत	தனிப்பட்ட	None
व्याख्याता	விரிவுரையாளர்	Nan
व्याख्यान	சொற்பொழிவு	Nan
व्यापक	விரிவான	None
व्यापार	வணிக	None
व्यापारियों	வணிகர்கள்	Nan
व्यापारी	வணிகர்	None
व्याख्याओं	விளக்கங்கள்	None
व्यापी	பரந்த	None
व्यायाम	ஒர்க் அவுட்	Nan
व्यावसायिक	தொழில்முறை	None
व्यावहारिक	நடைமுறை	None
व्यावहारिकता	நடைமுறை	None
व्यास	விட்டம்	None
व्युत्पत्ति	வழித்தோன்றல்	Nan
व्याप्त	ரைஃப்	Nan
वैज्ञानिकता	விஞ்ஞானம்	None
व्याख्या	விளக்கம்	None
व्याकरण	கிராமர்	Nan
व्यक्तित्व	ஆளுமை	None
व्यक्तियों	தனிநபர்கள்	Nan
व्यतीत	கடந்த காலம்	Nan
व्यय	செலவு	None
व्यर्थ	வீண்	Nan
व्यवसाय	வணிகம்	None
व्याकुल	கலக்கம்	Nan
व्यवसायिक	தொழில்முறை	None
व्यवस्था	ஏற்பாடு	None
व्यवस्थित	ஏற்பாடு செய்யப்பட்டது	Nan
व्यवहार	நடத்தை	None
व्यवहारिक	நடைமுறை	None
व्यस्क	பெரியவர்	Nan
व्यस्त	பரபரப்பு	Nan
व्यवसायों	வணிகங்கள்	Nan
वैज्ञानिक	விஞ்ஞானி	Nan
वैचारिक	கருத்தியல்	None
वैकल्पिक	மாற்று	None
विहीन	விலகிவிட்டது	Nan
वीं	வது	None
वीडियॊ	காணொளி	Nan
वीडियो	காணொளி	Nan
वीणा	வீணா	Nan
वीर	தைரியமான	Nan
विस्फोट	வெடிப்பு	None
वीरता	வீரம்	Nan
वीरों	துணிச்சலான	Nan
वीर्य	விந்து	None
वृंदावन	பிருந்தாவன்	Nan
वृक्ष	மரம்	None
वृक्षों	மரங்கள்	None
वृत्तांत	கணக்கு	None
वीरेन्द्र	வீரேந்திரா	Nan
वृत्ति	அணுகுமுறை	None
विस्थापित	இடம்பெயர்ந்தார்	Nan
विस्तारपूर्वक	சூழ்நிலை	None
विष	விஷம்	Nan
विषम	ஒற்றைப்படை	Nan
विषय	பொருள்	None
विषयक	கருப்பொருள்	Nan
विषयवस्तु	பொருள்	None
विषयों	தலைப்புகள்	None
विस्तृत	விரிவானது	Nan
विषाणु	வைரஸ்	None
विषैले	நச்சு	None
विष्णु	விஷ்ணு	None
विष्णुगुप्त	விஷ்ணுகுப்தா	Nan
विसर्जन	மூழ்கியது	Nan
विसर्जित	மூழ்கிவிடு	Nan
विस्तार	விரிவானது	Nan
विषाणुओं	வைரஸ்கள்	Nan
विश्‍व	உலகம்	None
वृद्ध	பழையது	Nan
वृद्धि	வளர்ச்சி	Nan
वेनेज़ुएला	வெனிசுலா	Nan
वेब	வலை	None
वेबदुनिया	வெப்டூனியா	Nan
वेबसाइट	இணையதளம்	None
वेल्डिंग	வெல்டிங்	Nan
वेल्श	வெல்ஷ்	Nan
वेधशाला	ஆய்வகம்	Nan
वेल्स	கிணறுகள்	Nan
वेश्या	விபச்சாரி	Nan
वेश्याओं	விபச்சாரிகள்	Nan
वेश्यावृत्ति	விபச்சாரம்	None
वेस्ट	மேற்கு	None
वेस्टमिंस्टर	வெஸ்ட்மின்ஸ்டர்	None
वेह	அவர்கள்	None
वेश	உடை	None
वृद्धावस्था	முதுமை	Nan
वेदों	வேதங்கள்	None
वेदान्त	வேதாந்தா	Nan
वृन्दावन	பிருந்தாவன்	Nan
वृहत	பரந்த	None
वृहद	பெரியது	None
वृहद्	பெரியது	None
वे	அவர்கள்	None
वें	வது	None
वेदी	பலிபீடம்	Nan
वेंकटेश्वर	வெங்கடேஸ்வர	Nan
वेतन	ஊதியங்கள்	Nan
वेद	வேதம்	None
वेदना	கோபம்	None
वेदव्यास	வேத்விகள்	Nan
वेदांग	வேதங்	Nan
वेदांत	வேதாந்தா	Nan
वेग	வேகம்	None
व्युत्पन्न	பெறப்பட்டது	None
विदेश	வெளிநாட்டு	Nan
वित्त	நிதி	None
वक्त	நேரம்	None
वकील	வழக்கறிஞர்	Nan
वकालत	வக்கீல்	Nan
वंशावली	பரம்பரை	None
वंशानुगत	பரம்பரை	None
वंशज	வம்சாவளி	Nan
वंश	ஆள்குடி	Nan
वंदना	பிரார்த்தனை	Nan
ळ	4	Nan
लौह	இரும்பு	None
लौटा	திரும்பினார்	None
लौटने	திரும்பவும்	None
लौट	திரும்பவும்	None
लौकिक	காஸ்மிக்	Nan
लोहे	இரும்பு	None
लोहा	இரும்பு	None
लोशन	லோஷன்	Nan
लोकतान्त्रिक	ஜனநாயக	None
लोकप्रियता	புகழ்	None
लोकमान्य	பிரபலமானது	None
लोकसभा	மக்களவை	None
लोकों	மக்கள்	None
लोग	மக்கள்	None
वक्तव्य	அறிக்கை	None
लोगो	மக்கள்	None
लोड	ஏற்றவும்	Nan
लोदी	லோடி	Nan
लोधी	லோதி	Nan
लोप	வெளியேற்றம்	None
लोभ	அவாரிஸ்	Nan
लोयस	இழக்கிறது	Nan
लोगों	மக்கள்	None
वक्ता	பேச்சாளர்	Nan
वक्र	வளைவு	None
वक्ष	மார்பகம்	Nan
वरन्	மற்றவை	None
वरिष्ठ	மூத்தவர்	Nan
वरुण	வருண்	Nan
वरुणा	வருணா	Nan
वर्ग	வகை	None
वर्गीकरण	வகைப்பாடு	None
वरन	வரம்	None
वर्गीकृत	வகைப்படுத்தப்பட்டுள்ளது	Nan
वर्चस्व	மேலாதிக்கம்	Nan
वर्जित	தடைசெய்யப்பட்டுள்ளது	Nan
वर्ड	சொல்	Nan
वर्ण	எழுத்துக்கள்	Nan
वर्णक्रम	ஸ்பெக்ட்ரம்	Nan
वर्णक्रमीय	ஸ்பெக்ட்ரல்	Nan
वर्गों	சதுரங்கள்	Nan
लोकतांत्रिक	ஜனநாயக	None
वरदान	பரிசு	None
वयस्क	பெரியவர்	Nan
वचन	வாக்குறுதி	Nan
वचनों	சொற்கள்	Nan
वजन	எடை	None
वजह	காரணம்	Nan
वज़न	எடை	None
वत्स	குழந்தை	None
वयस्कों	பெரியவர்கள்	Nan
वध	கொல்லுங்கள்	Nan
वनडे	ஒருநாள்	None
वनवास	நாடுகடத்தல்	Nan
वनस्पतियों	தாவரங்கள்	None
वनों	காடுகள்	None
वन्दे	வந்தே	Nan
वन्य	காட்டு	None
वन	காடு	None
लोककथा	நாட்டுப்புறவியல்	Nan
लोक	பிராந்தியம்	Nan
लो	எடுத்துக்கொள்ளுங்கள்	Nan
लिपियों	ஸ்கிரிப்ட்கள்	Nan
लिप्यन्तरण	ஒலிபெயர்ப்பு	Nan
लिया	எடுத்தது	Nan
लिया|	எடுத்தது	Nan
लिये	க்கு	Nan
लिये|	க்கு	Nan
लिपियाँ	ஸ்கிரிப்ட்கள்	Nan
लिली	லில்லி	Nan
लीग	லீக்	None
लीटर	லிட்டர்	Nan
लीबनीज	லீப்னிஸ்	Nan
लीबिया	லிபியா	Nan
लीला	லீலா	Nan
लीलाओं	பொழுது போக்குகள்	Nan
ली	லீ	Nan
लुईस	லூயிஸ்	None
लिपिक	குமாஸ்தா	Nan
लिनक्स	லினக்ஸ்	None
लिंग	பாலினம்	Nan
लिंगानुपात	பாலின விகிதம்	Nan
लिए	க்கு	Nan
लिख	எழுதுங்கள்	Nan
लिखकर	எழுதுவதன் மூலம்	Nan
लिखते	எழுதுகிறார்	Nan
लिपि	கையால் எழுதப்பட்ட தாள்	Nan
लिखना	எழுத	None
लिखा	எழுதினார்	None
लिखित	எழுதப்பட்ட பதிவு	Nan
लिखी	எழுதப்பட்டது	None
लिखीं	எழுதினார்	None
लिखे	எழுதுங்கள்	Nan
लिच्छवि	லிச்சாவி	Nan
लिखने	எழுதுங்கள்	Nan
वर्णन	விளக்கம்	None
लुप्त	காணவில்லை	Nan
लूटपाट	கொள்ளை	None
लेनदेन	பரிவர்த்தனை	None
लेना	எடுக்க	None
लेनी	லென்னி	Nan
लेने	எடுத்துக்கொள்வது	Nan
लेप	பூச்சு	Nan
लेबल	லேபிள்	Nan
लेते	எடுத்துக்கொள்ளுங்கள்	Nan
लैंगिक	பாலியல்	Nan
लैंड	நில	None
लैटिन	லத்தீன்	None
लैला	லைலா	Nan
लॉ	சட்டம்	None
लॉर्ड	ஆண்டவரே	Nan
लॉस	இழப்பு	None
लैंग्वेज	மொழி	Nan
लू	லு	Nan
लेती	எடுக்கிறது	Nan
लेट	தாமதமாக	Nan
लूट्यन्स	லுடியன்ஸ்	Nan
ले	எடுத்துக்கொள்ளுங்கள்	Nan
लें	எடுத்துக்கொள்ளுங்கள்	Nan
लेक	ஏரி	None
लेकर	உடன்	None
लेख	கட்டுரை	None
लेता	எடுக்கிறது	Nan
लेखक	நூலாசிரியர்	Nan
लेखन	எழுதுதல்	None
लेखा	கணக்குகள்	Nan
लेखांकन	கணக்கியல்	None
लेखों	கட்டுரைகள்	None
लेग	கால்	None
लेगा	எடுக்கும்	None
लेखकों	ஆசிரியர்கள்	None
वित्तीय	நிதி	None
वर्णनात्मक	விளக்கமான	None
वर्णों	கதாபாத்திரங்கள்	Nan
विकास	வளர்ச்சி	Nan
विकारों	கோளாறுகள்	Nan
विकार	கோளாறு	None
विकसित	உருவாக்கப்பட்டது	None
विकल्प	விருப்பம்	None
विंग	சாரி	None
वि	வி	None
वाह्य	வெளிப்புறம்	Nan
वाहिनी	குழாய்	None
वाहिनियों	குழாய்கள்	None
वाहनों	வாகனங்கள்	None
वाहन	வாகனம்	None
वास्तुशिल्प	கட்டிடக்கலை	Nan
वास्तुकार	கட்டட வடிவமைப்பாளர்	Nan
वास्तुकला	கட்டிடக்கலை	Nan
वास्तु	கட்டடக்கலை	None
वास्तविकता	உண்மை	None
वार्मिंग	வெப்பமயமாதல்	Nan
वार्षिक	ஆண்டு	None
वाला	ஒன்று	None
वालो	நண்பர்கள்	None
वालों	தான்	None
वाल्मीकि	வால்மீகி	None
विकासवादी	பரிணாம வளர்ச்சி	Nan
वाशिंगटन	வாஷிங்டன்	None
वास	வாழ்விடம்	Nan
वासना	ஆசை	None
वासाच	வசாச்	Nan
वासुदेव	வாசுதேவ்	Nan
वास्तव	யதார்த்தம்	Nan
वास्तविक	உண்மையானது	Nan
वाष्प	நீராவி	None
विकि	விக்கி	None
विकिपीडिया	விக்கிபீடியா	None
विकिमीडिया	விக்கிமீடியா	None
विजय	வெற்றி	Nan
विजयनगर	விஜயநகர்	Nan
विजयी	வெற்றி	Nan
विजेता	வெற்றியாளர்	Nan
विज्ञान	விஞ்ஞானம்	None
विज्ञानियों	விஞ்ஞானிகள்	None
विचित्र	வினோதமானது	Nan
विज्ञानी	விஞ்ஞானி	Nan
विज्ञापन	விளம்பரம்	None
विज्ञापनों	விளம்பரங்கள்	None
विटामिन	வைட்டமின்	Nan
विडियो	காணொளி	Nan
विण्डोज़	விண்டோஸ்	None
वितरण	டெலிவரி	Nan
विज्ञानों	அறிவியல்	None
वार्तालाप	உரையாடல்கள்	None
विचारों	யோசனைகள்	Nan
विचारक	சிந்தனையாளர்	Nan
विकिरण	கதிர்வீச்சு	None
विकिस्रोत	விக்கிசோர்ஸ்	Nan
विकेट	விக்கெட்	Nan
विकेटकीपर	விக்கெட் கீப்பர்	Nan
विक्टोरिया	விக்டோரியா	None
विक्रम	விக்ரம்	None
विचारकों	சிந்தனையாளர்கள்	Nan
विक्रमादित्य	விக்ரமாதித்யா	Nan
विक्रेता	விற்பனையாளர்	Nan
विख्यात	குறிப்பிடப்பட்டுள்ளது	None
विगत	கடந்த காலம்	Nan
विघ्न	இடையூறு	None
विचरण	மாறுபாடு	None
विचार	யோசனை	Nan
विक्रय	விற்பனை	None
वार्ता	பேச்சு	None
वाराणसी	வாரணாசி	Nan
वार	போர்	None
वस्तुएं	அந்த பொருட்கள்	Nan
वस्तुओं	பொருட்கள்	None
वस्तुत	உண்மையில்	None
वस्तुतः	உண்மையாக	None
वस्त्र	ஆடைகள்	None
वस्त्रों	ஆடை	None
वस्तुएँ	அந்த பொருட்கள்	Nan
वह	அவள்	None
वहाँ	அங்கே	None
वहां	அங்கே	None
वही	அதே	None
वहीं	அங்கேயே	Nan
वा	வா	None
वां	வது	None
वहन	மலிவு	Nan
वांछित	ஆசை	None
वस्तु	விஷயம்	Nan
वसा	கொழுப்பு	None
वर्तनी	எழுத்துப்பிழை	Nan
वर्तमान	தற்போது	None
वर्मा	வர்மா	Nan
वर्ल्ड	உலகம்	None
वर्ष	ஆண்டு	None
वर्षीय	ஒரு வயது	Nan
वसूली	மீட்பு	Nan
वर्षो	ஆண்டுகள்	None
वल्लभ	வல்லப்	Nan
वल्लभाचार्य	வல்லபச்சார்யா	Nan
वश	டேம்	Nan
वशिष्ठ	வசிஷ்டா	Nan
वसंत	வசந்த	None
वसन्त	வசந்த	None
वर्षों	ஆண்டுகள்	None
वर्णित	விவரிக்கப்பட்டது	Nan
वाइड	பரந்த	None
वाक	பேச்சு	None
वान	வேன்	Nan
वानर	குரங்கு	None
वानरों	குரங்குகள்	Nan
वापस	மீண்டும்	None
वापसी	திரும்ப	None
वापिस	மீண்டும்	None
वाद्य	கருவி	Nan
वायरस	வைரஸ்	None
वायुगतिकी	ஏரோடைனமிக்ஸ்	Nan
वायुदाब	காற்றழுத்தம்	Nan
वायुमंडल	வளிமண்டலம்	None
वायुमंडलीय	வளிமண்டலம்	None
वायुयान	விமானம்	None
वायुसेना	விமானப்படை	Nan
वायु	காற்று	None
वाई	ஏன்	None
वादी	வாதி	Nan
वादक	ஆட்டக்காரர்	Nan
वाकाटक	வகாடகா	Nan
वाक्य	வாக்கியம்	None
वाक्यों	வாக்கியங்கள்	Nan
वाचक	வாசகர்	None
वाजपेयी	வாஜ்பாய்	Nan
वाट	வாட்	None
वादन	விளையாடுகிறது	Nan
वाणिज्य	வணிகரீதியானது	Nan
वाणी	குரல்	None
वात	காற்று	None
वातावरण	வளிமண்டலம்	None
वात्सल्य	வத்சல்யா	Nan
वात्स्यायन	வத்ஸ்யாயன்	Nan
वाद	சூட்	Nan
वाणिज्यिक	வணிகரீதியானது	Nan
समर	போர்	None
व्यू	பார்வை	None
व्रत	வேகமாக	None
संयुक्त	கூட்டு	None
संयम	மிதமான	Nan
संयंत्र	ஆலை	None
संभोग	உடலுறவு	None
संभावित	ஆற்றல்	None
संभावनाओं	சாத்தியங்கள்	Nan
संभावना	வாய்ப்பு	None
संभाला	கையாளப்படுகிறது	Nan
संभालने	அனுமானித்தல்	Nan
संभाल	கவனித்துக் கொள்ளுங்கள்	Nan
संभवतया	ஒருவேளை	None
संभवतः	ஒருவேளை	None
संभवत	அநேகமாக	Nan
संभव	சாத்தியம்	None
संबोधित	உரையாற்றினார்	Nan
संबन्धी	தொடர்புடையது	None
संबंधों	உறவுகள்	None
संपत्ति	சொத்து	None
संपदा	எஸ்டேட்	Nan
संपन्न	முடிந்தது	None
संपर्क	தொடர்பு	None
संपादक	ஆசிரியர்	None
संपादन	எடிட்டிங்	Nan
संयोग	ஒரு தற்செயல்	Nan
संपादित	திருத்தப்பட்டது	Nan
संप्रदाय	பிரிவு	None
संप्रदायों	வகுப்புகள்	Nan
संप्रभु	இறையாண்மை	Nan
संबंध	உறவு	None
संबंधित	தொடர்புடையது	None
संबंधी	உறவினர்	Nan
संपूर्ण	முழுமை	Nan
संयोगिता	தற்செயல்	Nan
संयोजक	கன்வீனர்	Nan
संयोजन	சேர்க்கை	None
संशोधन	ஒரு திருத்தம்	Nan
संशोधित	திருத்தப்பட்ட	None
संश्लेषण	தொகுப்பு	None
संसद	பாராளுமன்றம்	None
संसदीय	நாடாளுமன்றம்	None
संसाधन	வளங்கள்	None
संवेदी	உணர்ச்சி	None
संसाधनों	வளங்கள்	None
संस्करण	பதிப்பு	None
संस्करणों	தொகுதிகள்	None
संस्कार	சடங்குகள்	None
संस्कारों	சடங்குகள்	None
संस्कृत	சமஸ்கிருதம்	Nan
संस्कृतम्	சமஸ்கிருதம்	Nan
संसार	உலகம்	None
संन्यासी	புனிதர்கள்	Nan
संवेदना	இரங்கல்	Nan
संवेदनशील	உணர்திறன்	Nan
संरक्षण	பாதுகாப்பு	None
संरक्षित	பாதுகாக்கப்படுகிறது	Nan
संरचना	கட்டமைப்பு	None
संरचनाओं	கட்டமைப்புகள்	None
संरेखण	சீரமைப்பு	Nan
संलग्न	இணைக்கவும்	Nan
संवेदनशीलता	உணர்திறன்	Nan
संलयन	இணைவு	Nan
संवत्	சகாப்தம்	None
संवाद	உரையாடல்	None
संवादों	உரையாடல்கள்	None
संविधान	அரசியலமைப்பு	None
संविभ्रम	சித்தப்பிரமை	Nan
संवेग	உந்தம்	None
संवत	சகாப்தம்	None
संध्या	சாயங்காலம்	Nan
संधि	ஒப்பந்தம்	None
संदेह	சந்தேகம்	None
संगणक	கணினி	Nan
संगणना	கணக்கீடு	Nan
संगत	நிறுவனம்	None
संगम	சங்கமம்	None
संगमरमर	பளிங்கு	Nan
संगमर्मर	பளிங்கு	Nan
संगठनात्मक	நிறுவன	Nan
संगीतकार	இசைக்கலைஞர்	Nan
संग्रह	சேகரிப்பு	None
संग्रहण	சேமிப்பு	None
संग्रहालय	அருங்காட்சியகம்	None
संग्रहित	சேமிக்கப்பட்டது	Nan
संग्राम	போராட்டம்	None
संग्राहलय	அருங்காட்சியகம்	None
संगृहीत	சேமிக்கப்பட்டது	Nan
संघ	ஒன்றுக்கூடல்	Nan
संगठन	அமைப்பு	None
संख्याओं	எண்கள்	None
संकुचित	சுருங்க	Nan
संकेत	சமிக்ஞை	Nan
संकेतक	குறிகாட்டிகள்	Nan
संकेतन	குறியீடு	None
संकेतों	சிக்னல்கள்	Nan
संकोच	தயக்கம்	Nan
संग	உடன்	None
संक्रमण	தொற்று	None
संक्रांति	சங்கிராந்தி	Nan
संक्रामक	தொற்றும் தன்மை கொண்டது	Nan
संक्षिप्त	சுருக்கமான	None
संक्षेप	சுருக்கமான	None
संख्या	எண்	None
संख्याएँ	எண்கள்	None
संक्रमित	நோய்த்தொற்றுக்கு உள்ளானவர்	Nan
संस्कृति	கலாச்சாரம்	None
संघटन	கலவை	None
संघीय	கூட்டாட்சி	None
संतरा	ஆரஞ்சு	None
संतान	குழந்தைகள்	None
संतुलन	இருப்பு	None
संतुलित	சமச்சீர்	None
संतुष्ट	திருப்தி	Nan
संतुष्टि	திருப்தி	Nan
संत	செயிண்ட்	None
संतों	புனிதர்கள்	Nan
संदमक	தடுப்பான்	Nan
संदर्भ	குறிப்பு	None
संदर्भित	குறிப்பிடப்பட்டுள்ளது	None
संदर्भों	குறிப்புகள்	None
संदिग्ध	சந்தேகம்	None
संदेशों	செய்திகள்	None
संतोष	திருப்தி	Nan
संघर्षों	மோதல்கள்	Nan
संज्ञानात्मक	அறிவாற்றல்	None
संज्ञा	பெயர்ச்சொல்	Nan
संघों	சங்கங்கள்	Nan
संचय	குவிப்பு	Nan
संचरण	பரவும் முறை	Nan
संचार	தகவல்தொடர்புகள்	Nan
संचारित	பரப்பப்பட்டது	Nan
संचालक	இயக்குனர்	None
संज्ञाओं	பெயர்ச்சொற்கள்	Nan
संचालन	செயல்பாடுகள்	None
संचिका	கோப்பு	Nan
संचिकाएँ	கோப்புகள்	Nan
संचिकाओं	கோப்புகள்	Nan
संचित	திரட்டப்பட்டது	Nan
संजय	சஞ்சய்	Nan
संजोए	சேமி	Nan
संचालित	இயக்கப்படுகிறது	Nan
संकुचन	சுருக்கம்	None
संस्कृतियों	கலாச்சாரங்கள்	Nan
संस्थाएँ	நிறுவனங்கள்	None
सबकी	அனைவருக்கும்	None
सबका	எல்லோரும்	None
सब	அனைத்தும்	Nan
सफेद	வெள்ளை	None
सफारी	சஃபாரி	Nan
सफाई	சுத்தமான	None
सफ़लता	வெற்றி	Nan
सफ़ल	வெற்றி பெற்றது	Nan
सफ़र	பயணம்	Nan
सफलतापूर्वक	வெற்றிகரமாக	None
सफलता	வெற்றி	Nan
सफल	வெற்றி	Nan
सफर	பயணம்	Nan
सप्ताह	வாரம்	None
सप्तम	ஏழாவது	None
सपने	கனவுகள்	None
सन्‌	ஆண்டு	None
सदाबहार	பசுமையானது	Nan
सदियों	நூற்றாண்டுகள்	None
सदी	நூற்றாண்டு	None
सदृश	பிடிக்கும்	Nan
सदैव	எப்போதும்	None
सद्भावना	நல்லெண்ணம்	Nan
सबके	அனைவருக்கும்	None
सद्स्य	உறுப்பினர்	None
सनातन	நித்தியம்	Nan
सन्त	செயிண்ட்	None
सन्तान	குழந்தைகள்	None
सन्तों	புனிதர்கள்	Nan
सन्दर्भ	குறிப்புகள்	None
सन्देश	செய்தி	None
सन	சூரியன்	None
सबको	அனைத்து	None
सबमें	ஆகமொத்தம்	Nan
सबसे	எல்லாவற்றிலிருந்தும்	Nan
समझना	புரிதல்	Nan
समझने	புரிந்துகொள்வதற்கு	Nan
समझा	புரிந்தது	Nan
समझाने	விளக்க	None
समझाया	விளக்கினார்	None
समझी	புரிந்தது	Nan
समझते	புரிந்து	None
समझौता	ஒரு தீர்வு	Nan
समता	பரிதி	None
समन्वय	ஒருங்கிணைப்பு	None
समन्वित	ஒருங்கிணைந்த	None
समभाव	சமநிலை	Nan
समय	நேரம்	None
समयरेखा	காலவரிசை	Nan
समझौते	ஒப்பந்தம்	None
सदाचार	நல்லொழுக்கம்	Nan
समझता	புரிந்துகொள்கிறது	Nan
समग्र	ஒட்டுமொத்த	Nan
सबूत	ஆதாரம்	None
सब्जी	காய்கறி	Nan
सब्सिडी	மானியம்	Nan
सभा	சட்டசபை	Nan
सभाओं	கூட்டங்கள்	Nan
सभापति	தலைவர்	None
समझ	புரிந்து	None
सभी	அனைத்தும்	Nan
सभ्यता	கலாச்சாரம்	None
सभ्यताओं	நாகரிகங்கள்	None
सम	கூட	None
समकालीन	தற்கால	Nan
समकोण	வலது கோணம்	Nan
समक्ष	முன்	None
सभ्य	கண்ணியமான	Nan
सदा	எப்போதும்	None
सदस्यों	உறுப்பினர்கள்	None
सदस्यता	உறுப்பினர்	None
सकें	முடியும்	None
सकेगा	முடியும்	None
सक्रिय	செயலில்	Nan
सक्रियता	செயல்பாடு	None
सक्षम	திறன்	None
सख्त	கண்டிப்பான	Nan
सके	முடிந்தது	None
सख्ती	கண்டிப்பு	Nan
सघन	அடர்த்தியான	None
सच	உண்மை	None
सचमुच	உண்மையில்	None
सचिन	சச்சின்	None
सचिव	செயலாளர்	None
सचिवालय	செயலகம்	Nan
सगुण	நல்லொழுக்கம்	Nan
सच्चा	உண்மை	None
सकी	முடிந்தது	None
सका	முடிந்தது	None
संस्थाएं	நிறுவனங்கள்	None
संस्थाओं	நிறுவனங்கள்	None
संस्थागत	நிறுவன	Nan
संस्थान	நிறுவனம்	None
संस्थानों	நிறுவனங்கள்	None
संस्थापक	நிறுவப்பட்டது	None
सकारात्मक	உறுதியான	Nan
संस्थापित	நிறுவப்பட்ட	None
संहार	அழிக்கவும்	Nan
संहिता	குறியீடு	None
सकता	முடியும்	None
सकती	முடியும்	None
सकते	முடியும்	None
सकल	மொத்த	None
संस्मरण	நினைவுகள்	Nan
संस्था	அமைப்பு	None
सच्चाई	உண்மை	None
सजा	தண்டனை	None
सत्तर	எழுபது	None
सत्ता	சக்தி	None
सत्तारूढ़	தீர்ப்பு	None
सत्यं	உண்மை	None
सत्यजीत	சத்யஜித்	Nan
सत्यता	உண்மை	None
सत्कार	வரவேற்பு	None
सत्यवती	சத்தியாவதி	Nan
सत्र	அமர்வு	Nan
सत्रह	பதினேழு	Nan
सत्रहवीं	பதினேழாம்	Nan
सदन	வீடு	None
सदनॉ	வீடுகள்	None
सदस्य	உறுப்பினர்	None
सत्याग्रह	சத்தியாக்கிரகம்	Nan
सच्चे	உண்மை	None
सत्कर्म	உண்மை	None
सती	சதி	None
सजाने	அலங்கரிக்கவும்	Nan
सजाया	அலங்கரிக்கப்பட்டுள்ளது	Nan
सजावट	அலங்காரம்	Nan
सजावटी	அலங்கார	Nan
सजीव	வாழ்க	None
सजीवों	உயிரினங்கள்	None
सतीश	சதீஷ்	Nan
सज्जन	நற்பண்புகள் கொண்டவர்	Nan
सडक	சாலை	None
सड़क	சாலை	None
सड़कों	சாலைகள்	None
सतत	தொடர்ச்சியான	Nan
सतरूपा	எழுபது	None
सतह	மேற்பரப்பு	Nan
सटीक	சரியான	None
व्रण	அல்சர்	Nan
संकीर्ण	குறுகிய	Nan
संकल्प	சத்தியம்	None
शिक्षकों	ஆசிரியர்கள்	None
शिक्षक	ஆசிரியர்	None
शिकारी	ஹண்டர்	Nan
शिकार	இரையை	None
शिकायतें	புகார்கள்	Nan
शिकायत	புகார்	None
शिकागो	சிகாகோ	None
शाही	ராயல்	None
शाहिद	ஷாஹித்	Nan
शाहजी	ஷாஹாஜி	Nan
शाहजहां	ஷாஜகான்	Nan
शाहजहाँ	ஷாஜகான்	Nan
शाह	ஷா	None
शास्त्रों	வேதங்கள்	None
शास्त्रीय	பாரம்பரிய	None
शास्त्री	சாஸ்திரி	Nan
शास्त्रार्थ	விவாதம்	None
शाम	சாயங்காலம்	Nan
शामिल	சேர்க்கிறது	Nan
शायर	கவிஞர்	None
शायरी	கவிதை	None
शारदा	ஷர்தா	Nan
शारीरिक	உடல்	None
शिक्षण	கற்பித்தல்	Nan
शाश्वत	நிரந்தர	None
शासकीय	அதிகாரப்பூர்வ	None
शासकों	ஆட்சியாளர்கள்	None
शासन	ஆளுகை	Nan
शासनकाल	ஆட்சி	None
शासित	ஆட்சி செய்தது	Nan
शास्त्र	நெறிமுறை	None
शासक	ஆட்சியாளர்	Nan
शिक्षाओं	போதனைகள்	Nan
शिक्षित	படித்தவர்	Nan
शिखर	உச்சம்	Nan
शीत	குளிர்	Nan
शीतकाल	குளிர்காலம்	None
शीतोष्ण	மிதமான	Nan
शीर्ष	மேலே	None
शीर्षक	தலைப்பு	None
शील	அடக்கம்	None
शीघ्र	விரைவில்	None
शुंग	சுங்கா	Nan
शुक्रवार	வெள்ளி	None
शुक्राणु	விந்து	None
शुक्लयजुर्वेदीय	ஜோதிடம்	Nan
शुद्ध	தூய	None
शुद्धता	துல்லியம்	Nan
शुद्धि	சுத்திகரிப்பு	None
शुक्र	வெள்ளி	None
शाब्दिक	உண்மையாகவே	Nan
शिष्य	மாணவர்	None
शिशुओं	குழந்தைகள்	None
शिथिल	நிதானமாக	Nan
शिमला	சிம்லா	Nan
शिया	ஷியா	Nan
शिराओं	நரம்புகள்	Nan
शिला	பாறை	None
शिलालेख	கல்வெட்டு	None
शिष्टाचार	நடத்தை	None
शिव	சிவ்	Nan
शिवरात्रि	சிவராத்திரி	Nan
शिवलिंग	சிவலிங்	Nan
शिवाजी	சிவாஜி	None
शिवालिक	சிவாலிக்	Nan
शिविर	முகாம்	Nan
शिशु	குழந்தை	None
शिवजी	சிவன்	None
शाप	சாபம்	Nan
शान्ति	சமாதானம்	Nan
शान्तनु	சாந்தனு	Nan
शताब्दी	நூற்றாண்டு	None
शती	நூற்றாண்டு	None
शत्रु	எதிரி	Nan
शत्रुओं	எதிரிகள்	None
शनि	சனி	None
शनिदेव	சனி தேவ்	Nan
शताब्दियों	நூற்றாண்டுகள்	None
शनिवार	சனிக்கிழமை	Nan
शब्दकोष	அகராதி	None
शब्दार्थ	சொற்பொருள்	Nan
शब्दावली	சொற்களஞ்சியம்	Nan
शब्दों	வார்த்தைகள்	None
शमन	குறைத்தல்	Nan
शरण	புகலிடம்	Nan
शपथ	சத்தியம்	None
शरणार्थी	அகதிகள்	None
शतरंज	செஸ்	None
शटल	விண்கலம்	None
व्हाइट	வெள்ளை	None
श	எஸ்	None
शंकराचार्य	சங்கராச்சாரியார்	Nan
शंकुधारी	ஊசியிலை	Nan
शंख	ஷெல்	Nan
शंघाई	ஷாங்காய்	Nan
शतक	நூற்றாண்டு	None
शक	சந்தேகம்	None
शकुन्तला	சகுந்தலா	Nan
शकों	மகன்கள்	None
शक्तियाँ	அதிகாரங்கள்	None
शक्तियां	அதிகாரங்கள்	None
शक्तियों	அதிகாரங்கள்	None
शक्तिशाली	சக்திவாய்ந்தவர்	Nan
शकुंतला	சகுந்தலா	Nan
शुभ	நல்ல	None
शरद	இலையுதிர் காலம்	Nan
शरीफ	ஜென்ட்ரி	Nan
शहीदों	தியாகிகள்	Nan
शांत	அமைதியான	None
शांति	சமாதானம்	Nan
शाकाहारी	சைவம்	None
शाक्त	சக்தி	None
शाखा	கிளை	None
शहीद	தியாகி	Nan
शाखाएँ	கிளைகள்	None
शाखाओं	கிளைகள்	None
शाखायें	கிளைகள்	None
शादी	திருமண	None
शान	பெருமை	None
शानदार	அற்புதமான	Nan
शान्त	அமைதியானது	Nan
शाखाएं	கிளைகள்	None
शराब	ஆல்கஹால்	Nan
शहादत	தியாகம்	Nan
शहरो	நகரங்கள்	None
शरीर	உடல்	None
शर्करा	சர்க்கரை	None
शर्त	பந்தயம்	None
शर्तें	நிபந்தனைகள்	Nan
शर्तों	நிபந்தனைகள்	Nan
शर्मा	சர்மா	Nan
शहरों	நகரங்கள்	None
शल्य	அறுவை சிகிச்சை	Nan
शशि	சஷி	Nan
शस्त्र	ஆயுதங்கள்	None
शहद	தேன்	None
शहर	நகரம்	Nan
शहरी	நகர்ப்புற	None
शहरीकरण	நகரமயமாக்கல்	Nan
शव	பிணம்	Nan
संकल्पना	கருத்து	None
शुभारंभ	வெளியீடு	None
शुरुआत	ஆரம்பம்	None
श्रेणीयूरोप	வகை ஐரோப்பா	Nan
श्रेणीमुग़ल	வகை மொகல்	Nan
श्रेणीमहाभारत	இந்தியா	None
श्रेणीमध्य	வகை	None
श्रेणीभौतिकी	தர இயற்பியல்	Nan
श्रेणीभूगोल	நிலவியல்	None
श्रेणीभारतीय	வகைஇந்தியன்	Nan
श्रेणीबॉलीवुड	வகை பாலிவுட்	Nan
श्रेणीबिहार	மதிப்பீடு	None
श्रेणीपौराणिक	வகை	None
श्रेणीपश्चिम	தரம் மேற்கு	Nan
श्रेणीनोबेल	கிரெனோபல்	Nan
श्रेणीधार्मिक	வர்க்க மத	Nan
श्रेणीधर्मग्रन्थ	படிநிலை	None
श्रेणीधर्म	படிநிலை	None
श्रेणीदेश	தர நாடு	Nan
श्रेणीदेवीदेवता	வகை கடவுள்	Nan
श्रेणीइस्लाम	வகை இஸ்லாம்	Nan
श्रेणीउत्तम	சிறந்த வகுப்பு	Nan
श्रेणीउत्तर	வகை பதில்	Nan
श्रेणीउत्तराखण्ड	வகை உத்தரகண்ட்	Nan
श्रेणीएशिया	வகை ஆசியா	Nan
श्रेणीगुगल	வகை	None
श्रेणीराजनीति	வகை கொள்கை	Nan
श्रेणीग्रह	படிநிலை	None
श्रेणीजीव	பேரழிவு	None
श्रेणीजीवनी	வகை நேரடி	Nan
श्रेणीज्योतिष	சாய்வு	None
श्रेणीतकनीकी	தொழில்நுட்பம்	None
श्रेणीदर्शन	மதிப்பீடு	None
श्रेणीदिल्ली	டெல்லி	None
श्रेणीचीन	வகைகள்	None
श्रेणीराजस्थान	வகை ராஜஸ்தான்	Nan
श्रेणीरामायण	தரம்	None
श्रेणीवर्ष	தரம் ஆண்டு	Nan
श्रेष्ठतम	சிறந்த	None
श्रेष्ठता	மேன்மை	Nan
श्रोताओं	கேட்போர்	Nan
श्लोक	வசனம்	Nan
श्लोकों	ஸ்லோகாஸ்	Nan
श्वसन	சுவாசம்	Nan
श्रेष्ठ	சிறந்தது	None
श्वास	சுவாசம்	Nan
स	எஸ்	None
सं	இல்லை.	Nan
संकट	பிரச்சனை	Nan
संकर	கலப்பின	None
संकलक	தொகுப்பி	Nan
संकलित	தொகுக்கப்பட்டது	Nan
श्वेत	வெள்ளை	None
श्रेणीइतिहास	வரலாறு வரலாறு	Nan
श्रेय	கடன்	None
श्रेणीस्वतंत्रता	வர்க்க சுதந்திரம்	Nan
श्रेणीविज्ञान	படிநிலை	None
श्रेणीव्यक्तिगत	தனிப்பயனாக்கப்பட்டது	Nan
श्रेणीशहर	வகை நகரம்	Nan
श्रेणीसंगणक	வகைப்படுத்தி	Nan
श्रेणीसंयुक्त	வகை இணை	Nan
श्रेणीसंस्कृत	தரம் வளர்ப்பு	Nan
श्रेणीहिन्दू	தர புள்ளி	Nan
श्रेणीसंस्कृति	வர்க்க கலாச்சாரம்	Nan
श्रेणीसमाज	வர்க்க சமூகம்	Nan
श्रेणीसमाजशास्त्र	படிநிலை	None
श्रेणीसाहित्य	வகை இலக்கியம்	Nan
श्रेणीसूचना	மதிப்பீடு	None
श्रेणीसॉफ्टवेयर	வகை மென்பொருள்	Nan
श्रेणीसौर	வகை	None
श्रेणीसभ्यता	தரம்	None
श्रेणीआगरा	வகை	None
श्रेणीअर्थशास्त्र	தர பொருளாதாரம்	Nan
श्रेणी	வகை	None
शेष	மீதமுள்ள	None
शैक्षणिक	கல்வி	None
शैतान	பிசாசு	Nan
शैलियाँ	பாங்குகள்	Nan
शैलियां	பாணிகள்	Nan
शैलियों	பாணிகள்	Nan
शेर्पा	ஷெர்பா	Nan
शैली	நடை	None
शॉट	ஷாட்	Nan
शॉपिंग	கடையில் பொருட்கள் வாங்குதல்	Nan
शो	காட்டு	None
शोक	துக்கம்	None
शोध	ஆராய்ச்சி	None
शोधकर्ता	ஆராய்ச்சியாளர்	None
शैव	ஷைவா	Nan
शोधकर्ताओं	ஆராய்ச்சியாளர்கள்	None
शेरशाह	ஷெர் ஷா	Nan
शेयरों	பங்குகள்	Nan
शुरुआती	ஆரம்ப	None
शुरुवात	ஆரம்பம்	None
शुरू	தொடங்கு	Nan
शुरूआत	ஆரம்பம்	None
शुरूआती	ஆரம்ப	None
शुल्क	கட்டணம்	None
शेर	சிங்கம்	None
शुष्क	உலர்	None
शूटिंग	படப்பிடிப்பு	Nan
शून्य	பூஜ்யம்	Nan
शृंखला	தொடர்கள்	Nan
शेख	ஷேக்	Nan
शेखर	சேகர்	Nan
शेयर	பகிர்	Nan
शूकर	சர்க்கரை	None
शुरु	தொடங்கு	Nan
शोधन	திருத்தம்	None
शोभा	கருணை	None
श्रीमद्	ஸ்ரீமத்	Nan
श्रीमद्भगवद्गीता	ஸ்ரீமத் பகவத் கீதை	Nan
श्रीमद्भागवत	ஸ்ரீமத் பகவத்	Nan
श्रीराम	ஸ்ரீராம்	Nan
श्रीरामजी	ஸ்ரீ ராம் ஜி	Nan
श्रीलंका	இலங்கை	None
श्रीनिवास	சீனிவாஸ்	Nan
श्रीवास्तव	ஸ்ரீவஸ்தவா	Nan
श्रुति	ஸ்ருதி	Nan
श्रृंखला	சங்கிலி	Nan
श्रृंखलाओं	சங்கிலிகள்	Nan
श्रृंगार	ஒப்பனை	Nan
श्रेणियाँ	வகைகள்	None
श्रेणियों	வகைகள்	None
श्रीशैल	ஸ்ரீசெயில்	Nan
शोधपत्र	ஆய்வு கட்டுரை	Nan
श्रीधर	ஸ்ரீதர்	Nan
श्री	திரு	None
शोर	சத்தம்	None
शोषण	சுரண்டல்	Nan
शोषित	சுரண்டப்பட்டது	Nan
शौर्य	துணிச்சல்	Nan
श्याम	ஷியாம்	Nan
श्यामा	ஷியாமா	Nan
श्रीकृष्ण	ஸ்ரீ கிருஷ்ணா	Nan
श्रद्धा	பயபக்தி	Nan
श्रद्धालुओं	பக்தர்கள்	None
श्रम	தொழிலாளர்	Nan
श्रमिक	தொழிலாளர்	Nan
श्राद्ध	ஷ்ரத்	Nan
श्राप	சாபம்	Nan
श्रावण	ஷ்ரவன்	Nan
श्रद्धालु	விசுவாசமானவர்	Nan
पिंडों	பொருள்கள்	None
पिंड	உடல்	None
पास्काविषयक	கடந்து செல்லக்கூடியது	Nan
कर्मी	ஊழியர்கள்	None
कर्मियों	பணியாளர்	None
कर्मचारी	பணியாளர்கள்	Nan
कर्मचारियों	ஊழியர்கள்	None
कर्मकाण्ड	சடங்கு	Nan
कर्फ्यू	ஊரடங்கு உத்தரவு	Nan
कर्नाटक	கர்நாடகா	Nan
कर्तव्य	கடமை	None
कर्ण	கர்ணன்	Nan
कर्ज	கடன்	None
कर्क	புற்றுநோய்	Nan
करोड़ों	மில்லியன் கணக்கானவர்கள்	Nan
करोड़	கோடி	None
करोड	கோடி	None
करोगे	செய்வேன்	Nan
करों	வரி	None
करो	செய்	Nan
कराना	செய்ய	Nan
कराने	தயாரிக்க, தயாரிப்பு	Nan
करार	ஒப்பந்தம்	None
करी	கறி	Nan
करीना	கரீனா	Nan
करीब	அருகில்	None
कर्मों	செயல்கள்	None
करुणा	இரக்கம்	Nan
करूंगा	செய்வேன்	Nan
करे	செய்	Nan
करें	செய்யுங்கள்	Nan
करेंगे	செய்வேன்	Nan
करेगा	செய்வேன்	Nan
करेगी	செய்வேன்	Nan
करूँगा	செய்வேன்	Nan
कल	நாளை	None
कलंक	தெளிவின்மை	Nan
कलकत्ता	கல்கத்தா	None
कवच	கவசம்	Nan
कवयित्री	கவிஞர்	None
कवर	அட்டைப்படம்	Nan
कवरेज	பாதுகாப்பு	None
कवि	கவிஞர்	None
कविता	கவிதை	None
कल्याणकारी	நலன்	Nan
कविताएँ	கவிதைகள்	None
कवियों	கவிஞர்கள்	None
कश्मीर	காஷ்மீர்	None
कश्मीरी	காஷ்மீர்	None
कश्यप	காஷ்யப்	Nan
कष्ट	துன்பம்	None
कसौटी	சோதனை	None
कविताओं	கவிதைகள்	None
कराते	கராத்தே	Nan
कल्याण	நலன்	Nan
कल्पना	கற்பனை	None
कलम	பேனா	Nan
कलश	கலாஷ்	Nan
कला	கலை	None
कलाई	மணிக்கட்டு	Nan
कलाओं	கலைகள்	None
कलाकार	கலைஞர்	None
कल्पित	கற்பனையானது	Nan
कलाकारों	கலைஞர்கள்	None
कलात्मक	கலை	None
कलाम	கலாம்	Nan
कलियुग	காளுகம்	Nan
कली	மொட்டு	Nan
कल्कि	கல்கி	None
कल्चर	கலாச்சாரம்	None
कलाकृतियों	கலைப்பொருட்கள்	Nan
कराती	காரதி	Nan
कराता	வழங்குகிறது	None
कराची	கராச்சி	Nan
कबीर	கபீர்	Nan
कबीरदास	கபிர்தாஸ்	Nan
कबीले	குலம்	None
कब्ज़ा	பிடிப்பு	Nan
कब्जा	பிடிப்பு	Nan
कब्र	கல்லறை	None
कबड्डी	கபடி	Nan
कब्रों	கல்லறைகள்	Nan
कभीकभी	சில நேரங்களில்	Nan
कमजोर	பலவீனமான	Nan
कमजोरी	பலவீனம்	Nan
कमप्यूटर	கணினி	Nan
कमर	இடுப்பு	Nan
कमरे	அறைகள்	Nan
कभी	சில நேரங்களில்	Nan
कमल	தாமரை	Nan
कब	எப்பொழுது	Nan
कप्तान	கேப்டன்	None
कनाडा	கனடா	None
कनिष्ठ	ஜூனியர்	None
कनेक्शन	அந்த இணைப்பு	Nan
कन्नड़	கன்னடம்	None
कन्नौज	கண்ண au ஜ்	Nan
कन्या	கன்னி	None
कफ	கபம்	Nan
कन्याकुमारी	கன்யகுமாரி	Nan
कप	கோப்பை	Nan
कपड़ा	துணி	None
कपड़ों	ஆடை	None
कपास	பருத்தி	None
कपिल	கபில்	Nan
कपूर	கபூர்	Nan
कन्हैयालाल	கன்ஹையலால்	Nan
कस्टम	தனிப்பயன்	Nan
कमला	கம்லா	Nan
कमांडो	கமாண்டோ	Nan
करती	செய்யும்	None
करतीं	செய்வேன்	Nan
करते	செய்	Nan
करना	செய்	Nan
करनी	செய்ய	Nan
करने	செய்ய	Nan
करता	செய்யும்	None
करनेवाला	ஒருங்கிணைப்பாளர்	Nan
करवा	அதைச் செய்யுங்கள்	Nan
करवाई	முடிந்தது	None
करवाने	அதைச் செய்யுங்கள்	Nan
करवाया	முடிந்தது	None
करा	காரா	Nan
कराई	வழித்தடமாக	Nan
करनेवाले	செய்பவர்	Nan
कमांडर	தளபதி	Nan
करण	கரண்	Nan
कर	வரி	None
कमाई	வருவாய்	None
कमान	கட்டளை	None
कमाने	சம்பாதிக்க	Nan
कमाल	ஆச்சரியமாக இருக்கிறது	Nan
कमी	பற்றாக்குறை	None
कमीशन	கமிஷன்	Nan
करके	செய்வதன் மூலம்	Nan
कमेटी	குழு	None
कम्पनियां	நிறுவனங்கள்	None
कम्पनियों	நிறுவனங்கள்	None
कम्पनी	நிறுவனம்	None
कम्प्यूटर	கணினி	Nan
कम्प्यूटरों	கணினிகள்	None
कम्प्यूटिंग	கம்ப்யூட்டிங்	Nan
कम्पनियाँ	நிறுவனங்கள்	None
कद्दू	பூசணி	Nan
कस्बे	நகரங்கள்	None
कह	சொல்	Nan
कार्यवाही	செயல்	None
कार्यरत	வேலை	None
कार्यभार	பணிகள்	None
कार्यपालिका	நிர்வாகி	None
कार्यपालक	நிர்வாகி	None
कार्यक्षेत्र	வேலையின் நோக்கம்	Nan
कार्यक्षमता	வேலை திறன்	Nan
कार्यक्रमों	நிகழ்ச்சிகள்	Nan
कार्यक्रम	நிரல்	None
कार्यकारी	நிர்வாகி	None
कार्यकर्ताओं	தொழிலாளர்கள்	Nan
कार्यकर्ता	தொழிலாளி	Nan
कार्य	வேலை	None
कार्बोहाइड्रेट्स	கார்போஹைட்ரேட்டுகள்	Nan
कार्बोहाइड्रेट	கார்போஹைட்ரேட்	Nan
कार्बनिक	கரிம	None
कार्बनडाइऑक्साइड	கார்பன் டை ஆக்சைடு	Nan
कारगिल	கார்கில்	Nan
कारण	காரணம்	Nan
कारणों	காரணங்கள்	None
कारागृह	சிறை	None
कारावास	சிறைவாசம்	Nan
कारीगर	கைவினைஞர்	Nan
कार्यात्मक	செயல்பாட்டு	None
कारीगरों	கைவினைஞர்கள்	Nan
कारोबार	வணிக	None
कार्ड	அட்டை	None
कार्तिक	கார்த்திக்	None
कार्तिकेय	கார்த்திகேயா	Nan
कार्पोरेशन	கார்ப்.	Nan
कार्बन	கார்பன்	None
कारों	கார்கள்	Nan
कार्यान्वयन	செயல்படுத்துதல்	Nan
कार्यालय	அலுவலகம்	None
कार्यालयों	அலுவலகங்கள்	None
काल्पनिक	கனவு	None
काव्य	கவிதை	None
काशी	காஷி	Nan
काष्ठ	மரம்	None
कि	அந்த	None
किंग	ராஜா	None
कालों	கறுப்பர்கள்	Nan
किंगडम	இராச்சியம்	None
किक	உதை	Nan
किण्वन	நொதித்தல்	Nan
कितना	எவ்வளவு	None
कितनी	எத்தனை	None
कितने	எத்தனை	None
किताब	நூல்	None
किए	முடிந்தது	None
कारगर	பயனுள்ள	Nan
कालेज	கல்லூரி	None
कालीबंगां	காளிபங்கன்	Nan
कार्यो	படைப்புகள்	None
कार्यों	செயல்பாடுகள்	None
कार्रवाई	நடவடிக்கை	None
कार्ल	கார்ல்	None
कार्सिनोजन	புற்றுநோய்	None
कार्सिनोमा	கார்சினோமா	None
काले	கருப்பு	None
काल	காலம்	None
काला	கருப்பு	None
कालांतर	அதிக நேரம்	Nan
कालान्तर	நேரம் குறைந்தது	Nan
कालिदास	காளிதாஸ்	Nan
कालिया	கலியா	Nan
कालीन	கம்பளம்	Nan
कालक्रम	காலவரிசை	Nan
कारखाने	தொழிற்சாலை	Nan
कारखाना	தொழிற்சாலை	Nan
कारकों	காரணிகள்	None
कहीं	எங்கோ	Nan
कहे	என்று	None
कहें	சொல்	Nan
क़यामत	தீர்ப்பு	None
क़ानून	சட்டம்	None
क़ुरआन	குர்ஆன்	None
कहावत	பழமொழி	None
क़ुरान	குர்ஆன்	None
कांगो	காங்கோ	None
कांग्रेस	காங்கிரஸ்	None
कांच	கண்ணாடி	None
कांचीपुरम	காஞ்சிபுரம்	None
कांड	ஊழல்	None
कांतिमान	கதிரியக்க	None
काँग्रेस	காங்கிரஸ்	None
कांस्य	ஒரு வெண்கலம்	Nan
कहानी	கதை	None
कहानियां	கதைகள்	None
कहकर	என்று சொல்வதன் மூலம்	Nan
कहता	என்கிறார்	None
कहती	என்கிறார்	None
कहते	சொல்	Nan
कहना	சொல்லுங்கள்	Nan
कहने	சொல்ல	Nan
कहानियों	கதைகள்	None
कहलाता	என்று அழைக்கப்படுகிறது	Nan
कहलाते	அழைக்கப்படுகின்றன	None
कहलाने	அழைக்கப்பட வேண்டும்	Nan
कहलाया	என்று அழைக்கப்படுகிறது	Nan
कहा	கூறினார்	None
कहां	எங்கே	None
कहानियाँ	கதைகள்	None
कहलाती	என்று அழைக்கப்படுகிறது	Nan
कस्बों	நகரங்கள்	None
काउंटी	கவுண்டி	Nan
काकोरी	ககோரி	Nan
काबुल	காபூல்	Nan
काम	வேலை	None
कामकाज	வேலை	None
कामना	விரும்பும்	None
कामयाब	வெற்றி பெற்றது	Nan
कामशास्त्र	உளவியல்	None
काफी	போதும்	Nan
कामसूत्र	காமசூத்ரா	Nan
कामा	காமா	Nan
कामुक	உணர்ச்சி	None
कामों	படைப்புகள்	None
कायम	நீடிக்க	Nan
कार	கார்	Nan
कारक	காரணி	None
कामसूत्रकार	காமசூத்ராகர்	Nan
काउंसिल	சபை	None
काफिर	காஃபிர்	Nan
कानूनों	சட்டங்கள்	None
कागज	காகிதம்	Nan
कागज़	காகிதம்	Nan
काजू	முந்திரி	None
काट	வெட்டுதல்	Nan
काटकर	வெட்டுவதன் மூலம்	Nan
काटती	கடி	None
काफ़ी	போதும்	Nan
काटा	வெட்டு	None
काठियावाड़	கத்தியாவார்	Nan
काढ़ा	கஷாயம்	Nan
काण्ड	ஊழல்	None
कान	காது	None
कानपुर	கான்பூர்	Nan
कानून	சட்டம்	None
काठमांडु	காத்மாண்டு	Nan
किन	கின்	Nan
कदापि	ஒருபோதும்	None
कद	உயரம்	None
एजेंट	முகவர்	Nan
एचटीएमएल	html	Nan
एचआईवी	எச்.ஐ.வி.	Nan
एच	எச்	None
एग्रीगेटर	திரட்டுபவர்	Nan
एग	முட்டை	None
एक्सप्लोरर	ஆய்வுப்பணி	Nan
एक्सप्रेस	எக்ஸ்பிரஸ்	None
एक्सटेंशन	நீட்டிப்பு	Nan
एक्स	எக்ஸ்	None
एक्शन	செயல்	None
एकीकृत	ஒருங்கிணைந்த	None
एकीकरण	ஒருங்கிணைப்பு	None
एकान्त	தனிமை	Nan
एकाधिकार	ஏகபோகம்	Nan
एकाधिक	பல	None
एकादशी	ஏகாதசி	Nan
एअर	காற்று	None
एक	ஒன்று	None
एकक	ஒன்று	None
एकजुट	யுனைடெட்	None
एकता	ஒற்றுமை	None
एकत्र	சேகரிக்கப்பட்டது	Nan
एजेंसियों	முகவர்	Nan
एकत्रित	சேகரிக்கப்பட்டது	Nan
एकदूसरे	இரண்டாவது ஒன்று	Nan
एकमत	ஒருமனதாக	Nan
एकमात्र	மட்டும்	None
एकरूपता	சீரான தன்மை	Nan
एकल	சோலோ	Nan
एकाग्रता	செறிவு	None
एकदम	ஒரே நேரத்தில்	Nan
एजेंसी	நிறுவனம்	None
एट	மற்றும்	None
एटा	எட்டா	Nan
एम०	எம்.	Nan
एयर	காற்று	None
एयरपोर्ट	விமான நிலையம்	Nan
एरिया	பரப்பளவு	None
एल	எல்	None
एलन	ஆலன்	Nan
एम्	எம்	None
एलबम	ஆல்பம்	Nan
एलिमेंट	உறுப்பு	None
एल्काइन	அல்கைன்	Nan
एल्गोरिथम	அல்காரிதம்	Nan
एल्डिहाइड	ஆல்டிஹைட்	Nan
एव	மற்றும்	None
एवं	மற்றும்	None
एलिजाबेथ	எலிசபெத்	None
एंव	மற்றும்	None
एम	எம்	None
एफ	எஃப்	Nan
एटीपी	ஏடிபி	Nan
एट्रीब्यूट	பண்பு	None
एट्रीब्यूट्	பண்பு	None
एडम	ஆடம்	Nan
एडवर्ड	எட்வர்ட்	Nan
एडीज	ஏடிஸ்	Nan
एबं	மற்றும்	None
एड्स	எய்ட்ஸ்	None
एण्डीज	ஆண்டிஸ்	Nan
एथेंस	ஏதென்ஸ்	None
एनक्रिप्शन	குறியாக்கம்	None
एनोफ़िलीज़	அனோபிலிஸ்	Nan
एपीजे	apj	Nan
एप्पल	ஆப்பிள்	None
एण्ड	மற்றும்	None
एंड	மற்றும்	None
ए	a	Nan
ऋषियों	முனிவர்கள்	Nan
उलेमा	உலேமா	Nan
उल्टा	தலைகீழ்	Nan
उल्टी	வாந்தி	None
उल्लंघन	மீறல்	Nan
उल्लास	மகிழ்ச்சி	Nan
उल्लिखित	கோடிட்டுக் காட்டப்பட்டுள்ளது	Nan
उलट	எதிர்	None
उल्लेख	குறிப்பிடவும்	Nan
उषा	உஷா	Nan
उष्णकटिबंधीय	வெப்பமண்டல	None
उष्मागतिकी	வெப்ப இயக்கவியல்	Nan
उष्मारसायन	வெப்ப வேதியியல்	Nan
उस	அந்த	None
उसका	அவனது	None
उल्लेखनीय	குறிப்பிடத்தக்கது	None
उसकी	அவள்	None
उलझन	குழப்பம்	None
उर्वरता	கருவுறுதல்	Nan
उभर	வளர்ந்து வருகிறது	Nan
उभरते	வளர்ந்து வருகிறது	Nan
उभरा	வெளிப்பட்டது	Nan
उभरी	வெளிப்பட்டது	Nan
उभरे	வெளிப்பட்டது	Nan
उमर	வயது	None
उर्वशी	ஊர்வசி	Nan
उम्मीद	எதிர்பார்ப்பு	Nan
उम्र	காலங்கள்	None
उर	உர்	Nan
उरुग्वे	உருகுவே	Nan
उर्जा	ஆற்றல்	None
उर्मिला	உர்மிலா	Nan
उर्वरक	உரம்	Nan
उम्मीदवार	வேட்பாளர்	None
एवम	மற்றும்	None
उसके	அவரது	Nan
उसने	அவர்	None
ऊन	கம்பளி	Nan
ऊपरी	மேல்	None
ऊर्जा	ஆற்றல்	None
ऊष्मा	வெப்பம்	None
ऋग्	ரிக்	None
ऋग्वेद	ரிக்வேதம்	Nan
ऊतकों	திசுக்கள்	None
ऋग्वेदीय	ரிக்வேத	Nan
ऋतु	பருவம்	None
ऋषभ	ரிஷாப்	Nan
ऋषभदेव	ரிஷப்தேவ்	Nan
ऋषि	முனிவர்	None
ऋषिकेश	ரிஷிகேஷ்	Nan
ऋषिमुनियों	முனிவர் பறவைகள்	Nan
ऋण	கடன்	None
उसको	அவருக்கு	None
ऊतक	திசு	None
ऊंची	உயர்	None
उसपर	அந்த மீது	Nan
उसमे	அதில் உள்ளது	Nan
उसमें	அதில்	None
उससे	அவனிடமிருந்து	Nan
उसी	அதே	None
उसे	அவரை	None
ऊंचे	உயர்ந்தது	Nan
उस्ताद	குரு	None
ऊँचाई	உயரம்	None
ऊँची	உயர்	None
ऊँचे	உயர்	None
ऊँट	ஒட்டகம்	Nan
ऊंचा	உயர்	None
ऊंचाई	உயரம்	None
ऊँचा	உயர்	None
कदम	படி	None
एवम्	மற்றும்	None
एशियन	ஆசிய	None
कच्ची	மூல	None
कच्चा	பச்சையாக	Nan
कचरे	குப்பை	Nan
कगार	கயிறு	Nan
कक्षीय	சுற்றுப்பாதை	Nan
कक्षाओं	வகுப்புகள்	Nan
कक्षा	வர்க்கம்	None
कक्ष	அறை	None
कई	நிறைய	None
कंस	கன்சா	Nan
कंबोडिया	கம்போடியா	None
कंबोज	கம்போஜ்	Nan
कंप्यूटर	கணினி	Nan
कंपनी	நிறுவனம்	None
कंपनियों	நிறுவனங்கள்	None
कंपनियां	நிறுவனங்கள்	None
कंधे	தோள்பட்டை	Nan
औरतों	பெண்கள்	None
औरों	மற்றவைகள்	Nan
औलिया	ஆலியா	Nan
औषध	மருந்துகள்	None
औषधि	மருந்து	None
औषधियाँ	மருந்துகள்	None
कच्चे	மூல	None
औषधियों	மருந்துகள்	None
औसत	சராசரி	None
औसतन	சராசரி	None
क	கே	None
कंट्रोल	கட்டுப்பாடு	None
कंठ	தொண்டை	Nan
कंडोम	ஆணுறைகள்	Nan
औषधीय	மருத்துவ	None
कट	வெட்டு	None
कटरा	பரப்பளவு	None
कटा	நறுக்கப்பட்ட	Nan
कडी	இணைப்பு	None
कण	துகள்	None
कणों	துகள்கள்	None
कण्ठ	ஜார்ஜ்	None
कण्ठ्य	ஜார்ஜ்	None
कतिपय	சில	None
कडियाँ	இணைப்புகள்	None
कथन	அறிக்கை	None
कथाएँ	கதைகள்	None
कथाओं	கதைகள்	None
कथानक	சதி	None
कथावस्तु	சதி	None
कथित	கூறினார்	None
कथ्य	கதை	None
कथा	கதை	None
औरगंजेब	அவுரங்கசீப்	Nan
कड़े	கடுமையான	None
कड़ियों	இணைப்புகள்	None
कटाई	அறுவடை	None
कटौती	கழித்தல்	None
कट्टर	ஹார்ட்கோர்	Nan
कट्टरपंथी	அடிப்படைவாதி	Nan
कठ	படி	None
कठपुतली	பொம்மை	None
कड़ी	இணைப்பு	None
कठफोड़वा	மரங்கொத்தி	Nan
कठिनाइयों	சிரமங்கள்	Nan
कठिनाई	சிரமம்	None
कठोर	கடுமையான	None
कठोरता	கடினத்தன்மை	Nan
कड़ा	கடினமானது	Nan
कड़ियां	இணைப்புகள்	None
कठिन	கடினமானது	Nan
औरंगजेब	அவுரங்கசீப்	Nan
औरंगज़ेब	அவுரங்கசீப்	Nan
और	மற்றும்	None
ऑक्सीजन	ஆக்ஸிஜன்	None
ऑक्सीय	ஆக்ஸி	Nan
ऑटिज़्म	மன இறுக்கம்	Nan
ऑटो	ஆட்டோ	Nan
ऑटोमोबाइल	ஆட்டோமொபைல்	Nan
ऑटोरिक्शा	ஆட்டோ ரிக்‌ஷா	Nan
ऑक्सीकरण	ஆக்ஸிஜனேற்றம்	Nan
ऑडियो	ஆடியோ	Nan
ऑनलाइन	நிகழ்நிலை	Nan
ऑपरेटिंग	இயங்குகிறது	None
ऑपरेशन	செயல்பாடு	None
ऑफ	முடக்கு	Nan
ऑफ़	முடக்கு	Nan
ऑफिस	அலுவலகம்	None
ऑन	ஆன்	None
ऑबजेक्ट	பொருள்	None
ऑक्साइड	ஆக்சைடு	None
ऐसी	அத்தகைய	None
एशिया	ஆசியா	None
एशियाई	ஆசிய	None
एस	கள்	Nan
एसएमएस	எஸ்.எம்.எஸ்	Nan
एसबीआई	எஸ்.பி. நான்	Nan
एससीओ	எஸ்சிஓ	Nan
ऐसे	அத்தகைய	None
एसिड	அமிலம்	None
ए०	ஏ.	Nan
ऐतरेय	ஆத்ரேயா	Nan
ऐतिहासिक	வரலாற்று	None
ऐश्वर्य	செழிப்பு	Nan
ऐश्वर्या	ஐஸ்வர்யா	Nan
ऐसा	இது போன்ற	Nan
एसोसिएशन	சங்கம்	None
एवरेस्ट	எவரெஸ்ட்	Nan
ऑयल	எண்ணெய்	None
ऑल	அனைத்தும்	Nan
ओम	ஓம்	None
ओर	மற்றும்	None
ओलंपिक	ஒலிம்பிக்	None
ओलम्पिक	ஒலிம்பிக்	None
ओवर	ஓவர்	Nan
ओशो	ஓஷோ	Nan
ओबामा	ஒபாமா	Nan
ओसामा	ஒசாமா	Nan
औचित्य	நியாயப்படுத்துதல்	Nan
औजार	கருவிகள்	None
औद्योगिक	தொழில்துறை	None
औद्योगिकीकरण	தொழில்மயமாக்கல்	Nan
औपचारिक	முறையான	Nan
औपनिवेशिक	காலனித்துவ	Nan
औ	மற்றும்	None
ऑर्कुट	ஆர்குட்	Nan
ओपेन	திற	Nan
ओन	சொந்தமானது	Nan
ऑव	ow	Nan
ऑस्कर	ஆஸ்கார்	Nan
ऑस्ट्रिया	ஆஸ்திரியா	None
ऑस्ट्रेलियन	ஆஸ்திரேலிய	None
ऑस्ट्रेलिया	ஆஸ்திரேலியா	None
ऑस्ट्रेलियाई	ஆஸ்திரேலிய	None
ओपन	திறந்த	None
ओ	ஓ	None
ओएस	ஓ.எஸ்	Nan
ओक	ஓக்	Nan
ओजस्वी	சக்திவாய்ந்த	None
ओज़ोन	ஓசோன்	Nan
ओड़िशा	ஒடிசா	Nan
ओड्र	odr	Nan
ओंकार	ஓம்கர்	Nan
उपेक्षा	புறக்கணிக்கவும்	Nan
किनारे	விளிம்பு	Nan
किन्तु	ஆனாலும்	None
गंगायमुना	கங்கயமுனா	Nan
गंगाधर	கங்காதர்	Nan
गंगाजल	கங்கை நீர்	Nan
गंगा	கங்கை	None
गंग	கும்பல்	Nan
ग	சி	None
ख्वाजा	குவாஜா	Nan
ख्याति	புகழ்	None
खोला	திறக்கப்பட்டது	Nan
खोलने	திறக்கிறது	Nan
खोल	ஷெல்	Nan
खोपड़ी	மண்டை ஓடு	Nan
खोने	இழக்கிறது	Nan
खोजों	கண்டுபிடிப்புகள்	None
खोजे	கண்டுபிடி	Nan
खोजा	தேடியது	Nan
खोजने	தேடல்	None
खूब	ஏராளமான	None
खूबसूरत	அழகு	None
खूबसूरती	அழகு	None
खेत	பண்ணை	None
खेती	விவசாயம்	None
खेतों	துறைகள்	None
गंगोत्री	கங்கோத்ரி	Nan
खेल	விளையாட்டு	None
खेलने	விளையாட	None
खेला	உடன்	None
खेले	விளையாடு	None
खेलों	விளையாட்டுகள்	None
खो	இழந்தது	None
खोज	தேடல்	None
खेलकूद	விளையாட்டு	None
गंडक	கந்தக்	Nan
गंतव्य	இலக்கு	None
गंध	வாசனை	Nan
गणना	கணக்கீடு	Nan
गणपति	கணபதி	None
गणराज्यों	குடியரசுகள்	Nan
गणित	கணிதம்	None
गणितज्ञ	கணிதவியலாளர்	Nan
गणितज्ञों	கணிதவியலாளர்கள்	Nan
गणतन्त्र	குடியரசு	None
गणितीय	கணிதம்	None
गणेशजी	கணேஷ் ஜி	Nan
गणों	கணோ	Nan
गत	கடந்த காலம்	Nan
गति	வேகம்	None
गतिज	இயக்கவியல்	Nan
गतिविधि	செயற்பாடு	None
गणेश	விநாயகர்	None
खून	இரத்தம்	None
गणतंत्र	குடியரசு	None
गढ़वाल	கர்வால்	Nan
गंधर्व	காந்தர்வா	Nan
गंभीर	தீவிரமானது	Nan
गंभीरता	தீவிரம்	Nan
गई	போய்விட்டது	Nan
गईं	சென்றது	Nan
गए	சென்றது	Nan
गण	எண்ணிக்கை	None
गज	யார்டுகள்	Nan
गज़ल	கசல்	Nan
गठन	கட்ட	Nan
गठबन्धन	கூட்டணி	None
गठित	அமைக்கப்பட்டது	None
गड्ढे	குழி	Nan
गढ़	கோட்டை	None
गजल	கசல்	Nan
खुसरो	குஸ்ரோ	Nan
खुशी	மகிழ்ச்சி	Nan
खुश	சந்தோஷமாக	Nan
ख़राब	மோசமான	None
ख़लीफ़ा	கலீஃப்	Nan
ख़ान	கான்	None
ख़ास	சிறப்பு	None
ख़िलाफ़	எதிராக	None
ख़ुद	தன்னை	None
ख़बर	செய்தி	None
ख़ुदा	இறைவன்	None
खाँसी	இருமல்	None
खां	கான்	None
खाड़ी	வளைகுடா	None
खाता	கணக்கு	None
खाते	கணக்குகள்	Nan
खातों	கணக்குகள்	Nan
ख़ुशी	மகிழ்ச்சி	Nan
खाद	உரம்	Nan
ख़त्म	முடிந்தது	None
खलीफा	கலீஃபா	Nan
खपत	நுகரப்படும்	Nan
खबर	செய்தி	None
खबरें	செய்தி	None
खमीर	ஈஸ்ட்	Nan
खरगोश	முயல்	Nan
खराब	மோசமான	None
ख़तरा	ஆபத்து	None
खराबी	குறைபாடு	None
खरीदते	வாங்க	None
खरीददारी	கடையில் பொருட்கள் வாங்குதல்	Nan
खरीदने	வாங்க	None
खरीदारी	கடையில் பொருட்கள் வாங்குதல்	Nan
खरीदी	வாங்கப்பட்டது	Nan
खर्च	செலவு	None
खरीद	கொள்முதல்	None
गतिविधियाँ	நடவடிக்கைகள்	None
खादी	காதி	Nan
खान	கான்	None
खीर	இனிப்பு	Nan
खुजली	அரிப்பு	None
खुद	நானே	None
खुदरा	சில்லறை	None
खुदा	இறைவன்	None
खुफिया	உளவுத்துறை	Nan
खींचा	ட்ரூ	Nan
खुल	திற	Nan
खुलता	திறக்கிறது	Nan
खुलने	திறக்கிறது	Nan
खुला	திற	Nan
खुलासा	வெளிப்படுத்தல்	Nan
खुली	திறந்த	None
खुले	திற	Nan
खुलकर	வெளிப்படையாக	None
खाद्य	உணவு	None
खींच	இழுக்கவும்	Nan
खिलाफ	எதிராக	None
खानदान	குடும்பம்	None
खानपान	உணவு மற்றும் பானம்	Nan
खाने	சாப்பிடுங்கள்	Nan
खानों	சுரங்கங்கள்	Nan
खाया	சாப்பிட்டேன்	Nan
खालसा	கல்சா	Nan
खिलाफ़	எதிராக	None
खाली	காலியாக	Nan
खासकर	குறிப்பாக	None
खासी	இருமல்	None
खिलजी	கில்ஜி	Nan
खिलाड़ियों	விளையாட்டாளர்கள்	Nan
खिलाड़ी	ஆட்டக்காரர்	Nan
खिलाडी	வீரர்கள்	None
खास	சிறப்பு	None
खन्ना	உணவு	None
गतिविधियां	நடவடிக்கைகள்	None
गतिशील	மாறும்	None
गिरी	வீழ்ச்சி	None
गिरिजाघर	சர்ச்	Nan
गिरावट	வீழ்ச்சி	None
गिराया	கைவிடப்பட்டது	Nan
गिरा	கைவிடப்பட்டது	Nan
गिरफ्तार	கைது	None
गिरने	வீழ்ச்சி	None
गिरती	வீழ்ச்சி	None
गिर	வீழ்ச்சி	None
गिने	எண்	None
गिनीज	கின்னஸ்	Nan
गिनी	கினியா	Nan
गिना	எண்ணப்பட்டது	Nan
गिनती	எண்ணிக்கை	None
गाल	கன்னம்	Nan
गार्डन	தோட்டம்	Nan
गार्ड	காவலர்	Nan
गाथा	சகா	Nan
गान	கீதம்	None
गाना	பாடல்	None
गाने	பாடல்கள்	None
गानों	பாடல்கள்	None
गान्धी	காந்தி	None
गिरीश	கிரிஷ்	Nan
गाय	கால்நடைகள்	Nan
गायकों	பாடகர்கள்	Nan
गायत्री	காயத்ரி	Nan
गायन	பாடுகிறார்	Nan
गाया	பாடினார்	None
गायिका	பாடகர்	Nan
गारंटी	உத்தரவாதம்	None
गायक	பாடகர்	Nan
गिर्द	சுற்றி	Nan
गिल्ड	கில்ட்	Nan
गीज़ा	கிசா	Nan
गुना	மடி	Nan
गुप्तचर	துப்பறியும்	Nan
गुप्ता	குப்தா	Nan
गुफा	குகை	None
गुफाएं	குகைகள்	Nan
गुफाओं	குகைகள்	Nan
गुन	துப்பாக்கி	Nan
गुम्बद	குவிமாடம்	None
गुरु	குரு	None
गुरुओं	குருக்கள்	Nan
गुरुकुल	குருகுல்	Nan
गुरुत्व	ஈர்ப்பு	None
गुरुत्वाकर्षण	ஈர்ப்பு	None
गुरुदेव	குருதேவ்	Nan
गुयाना	கயானா	None
गाते	பாட	Nan
गुदा	ஆசனவாய்	Nan
गुणा	பெருக்கல்	None
गीत	பாடல்	None
गीता	கீதா	Nan
गीताप्रेस	கீதாபிரஸ்	Nan
गीतों	பாடல்கள்	None
गीली	ஈரமான	Nan
गुजरता	சீட்டுகள்	Nan
गुणों	குணங்கள்	None
गुजरती	பாஸ்	None
गुजरात	குஜராத்	None
गुजराती	குஜராத்தி	None
गुट	பிரிவு	None
गुड	வெல்லம்	Nan
गुण	ஒரு தரம்	Nan
गुणवत्ता	தரம்	None
गुजरने	கடந்து செல்கிறது	Nan
गाढ़ा	அடர்த்தியானது	Nan
गाड़ी	கார்	Nan
गाए	பாட	Nan
गर्ग	கார்க்	Nan
गर्दन	கழுத்து	None
गर्भ	கர்ப்பம்	Nan
गर्भकाल	கர்ப்பம்	Nan
गर्भगृह	கருவறை	None
गर्भधारण	கருத்து	None
गरुड़	கழுகு	None
गर्भपात	கருக்கலைப்பு	None
गर्भाधान	கருத்து	None
गर्भायोजित	பொருத்தப்பட்டது	Nan
गर्भावस्था	கர்ப்பம்	Nan
गर्भाशय	கருப்பை	None
गर्म	சூடாக	Nan
गर्मियों	கோடை	None
गर्भवती	கர்ப்பிணி	Nan
गर्मी	வெப்பம்	None
गरीबों	ஏழை	None
गरिमा	கண்ணியம்	Nan
गतिशीलता	இயக்கம்	None
गद्दी	திணிப்பு	Nan
गद्य	உரை நடை	Nan
गद्यकार	உரை நடை	Nan
गन्धक	கந்தகம்	None
गन्ना	கரும்பு	None
गरीब	ஏழை	None
गमेलन	விளையாட்டு	None
गया|	சென்றது	Nan
गयी	சென்றது	Nan
गयीं	சென்றது	Nan
गयूम	கயூம்	Nan
गये	சென்றது	Nan
गरम	சூடான	None
गया	சென்றது	Nan
गतिविधियों	செயல்பாடுகள்	None
गलत	தவறு	None
गला	தொண்டை	Nan
ग़ुलाम	அடிமை	None
गा	கா	None
गाँठ	முடிச்சு	None
गाँधी	காந்தி	None
गाँधीजी	காந்தி	None
गाँवों	கிராமங்கள்	None
ग़ालिब	காலிப்	Nan
गांगुली	கங்குலி	Nan
गांठों	கட்டிகள்	None
गांधी	காந்தி	None
गांधीजी	காந்திஜி	Nan
गांव	கிராமம்	None
गांवों	கிராமங்கள்	None
गाइड	வழிகாட்டி	None
गांठ	முடிச்சு	None
गलती	தவறு	None
ग़लत	தவறானது	Nan
ग़ज़ा	காசா	Nan
गलियों	தெருக்களில்	Nan
गली	சந்து	Nan
गले	தொண்டை	Nan
गल्फ	வளைகுடா	None
गवाह	சாட்சி	None
गवाही	சாட்சியம்	Nan
ग़म	துக்கம்	None
गहन	தீவிர	None
गहरा	ஆழமான	Nan
गहराई	ஆழம்	None
गहरी	ஆழமான	Nan
गहरे	ஆழமான	Nan
ग़ज़ल	கசல்	Nan
ग़ज़लों	கஜல்கள்	Nan
गहने	நகைகள்	Nan
किनारों	விளிம்புகள்	Nan
खनिज	தாதுக்கள்	Nan
खत्म	ஓவர்	Nan
केन्द्रक	நியூக்ளியஸ்	Nan
केन्द्र	மையம்	None
केन	கென்	Nan
केदारनाथ	கேதார்நாத்	Nan
केदार	கேதார்	Nan
केतु	கேது	Nan
केजीबी	கே.ஜி.பி.	Nan
केंद्रों	மையங்கள்	None
केंद्रीय	மத்திய	None
केंद्रीकृत	மையப்படுத்தப்பட்ட	Nan
केंद्र	மையம்	None
के	இல்	None
कृष्‍ण	கிருஷ்ணா	None
कृष्णा	கிருஷ்ணா	None
कृष्णयजुर्वेदीय	கிருஷ்ணாயுஜுர்வேதி	Nan
कृष्णभक्ति	கிருஷ்ணபக்தி	Nan
कृष्णपक्ष	கிருஷ்ணபக்ஷ	Nan
कूद	ஜம்ப்	Nan
कूल्हों	இடுப்பு	Nan
कृत	தேவை	None
कृति	வேலை	None
कृतियाँ	படைப்புகள்	None
कृतियों	படைப்புகள்	None
केन्द्रशासित	மையமாக	None
कृत्य	நாடகம்	None
कृत्रिम	செயற்கை	None
कृपया	தயவு செய்து	Nan
कृपा	தயவு செய்து	Nan
कृषक	பயிரிடுபவர்	Nan
कृषि	வேளாண்மை	None
कृष्ण	கிருஷ்ணா	None
कृत्यों	செயல்கள்	None
केन्द्रीय	மத்திய	None
केन्द्रों	மையங்கள்	None
केरल	கேரளா	None
कैलिफोर्निया	கலிபோர்னியா	None
कैलेंडर	நாள்காட்டி	Nan
कैलोरी	கலோரி	Nan
कैल्शियम	கால்சியம்	Nan
कैसा	எப்படி	None
कैसे	எப்படி	None
कैलाश	கைலாஷ்	Nan
कैस्पियन	காஸ்பியன்	Nan
कॉफी	கொட்டைவடி நீர்	Nan
कॉम	com	Nan
कॉम्प्लेक्स	சிக்கலான	None
कॉरोना	கொரோனா	Nan
कॉर्पोरेट	பெருநிறுவன	Nan
कॉर्पोरेशन	கார்ப்பரேஷன்	Nan
कॉपीराइट	பதிப்புரிமை	None
कूड़ा	குப்பை	Nan
कैरोल	கரோல்	Nan
कैरेक्टर	எழுத்து	None
केल्टिक	செல்டிக்	None
केवल	கல்லூரியில்	None
केशव	கேசவ்	Nan
केसर	குங்குமப்பூ	Nan
कैंडी	மிட்டாய்	Nan
कैंब्रिज	கேம்பிரிட்ஜ்	None
कैरेट	கேரட்	Nan
कैंसर	புற்றுநோய்	Nan
कैण्डेला	கேண்டெலா	None
कैद	சிறைவாசம்	Nan
कैपिटल	மூலதனம்	Nan
कैमरा	கேமரா	Nan
कैम्ब्रिज	கேம்பிரிட்ஜ்	None
कैरियर	கேரியர்	Nan
कैकेयी	கைகேயி	Nan
कूट	குறியீடு	None
कूच	பயணம்	Nan
कुषाण	குஷன்	Nan
किसे	who	Nan
किस्म	வெரைட்டி	Nan
किस्मत	விதி	None
किस्में	வகைகள்	None
किस्मों	வகைகள்	None
की	இல்	None
किसी	ஏதேனும்	None
कीं	அந்த	None
कीटनाशक	பூச்சிக்கொல்லி	Nan
कीटनाशकों	பூச்சிக்கொல்லிகள்	None
कीटाणु	கிருமி	None
कीटों	பூச்சிகள்	None
कीटोन	கெட்டோன்	Nan
कीड़े	புழுக்கள்	None
कीट	பூச்சி	Nan
कीपर	கீப்பர்	Nan
किसानों	விவசாயிகள்	None
किस	முத்தம்	Nan
किमी	கி.மீ.	Nan
किया	செய்தது	None
किया|	முடிந்தது	None
किये	செய்தது	None
किरण	உத்திரம்	None
किरणों	கதிர்கள்	None
किसान	உழவர்	Nan
किरदार	பாத்திரம்	None
किले	கோட்டை	None
किलो	கி.கி.	Nan
किलोग्राम	கிலோகிராம்	Nan
किलोमीटर	கிலோமீட்டர்	Nan
किशोर	டீன்	Nan
किष्किन्धाकाण्ड	கிஷ்கிந்தகாண்ட்	Nan
किला	கோட்டை	None
कॉलेज	கல்லூரி	None
कीपिंग	வைத்திருத்தல்	Nan
कीमत	செலவு	None
कुमारगुप्त	குமர்குப்தா	Nan
कुमारपाल	குமார்பால்	Nan
कुमारी	கன்னி	None
कुरान	குர்ஆன்	None
कुरीतियों	தீமைகள்	Nan
कुरु	குரு	None
कुमार	குமார்	None
कुरुक्षेत्र	குருக்ஷேத்ரா	Nan
कुर्सी	நாற்காலி	Nan
कुल	மொத்தம்	Nan
कुलीन	உன்னத	Nan
कुश	குஷ்	Nan
कुशल	திறமையானவர்	Nan
कुशलता	செயல்திறன்	None
कुर्ता	சட்டை	Nan
कीबोर्ड	விசைப்பலகை	None
कुमाऊँ	குமாவோன்	Nan
कुन्डली	ஜாதகம்	Nan
कीमती	விலைமதிப்பற்றது	Nan
कीमतों	விலைகள்	None
कीर्तिमान	பதிவு	Nan
कुंड	ஃபர்ரோ	Nan
कुंभ	கும்பம்	Nan
कुटिया	குடிசை	Nan
कुबेर	குபேரா	Nan
कुटीर	குடிசை	Nan
कुण्डल	சுருள்	None
कुतुब	குதுப்	Nan
कुतुबुद्दीन	குதுபுதீன்	Nan
कुत्ता	நாய்	None
कुत्ते	நாய்கள்	None
कुनैन	குயினின்	Nan
कुण्ड	பூல்	Nan
खनन	சுரங்க	Nan
कॉलेजों	கல்லூரிகள்	None
कों	எந்த	None
क्षय	சிதைவு	Nan
क्षमा	மன்னிக்கவும்	Nan
क्षमताओं	திறன்கள்	Nan
क्षमता	திறன்	None
क्षत्रिय	க்ஷத்ரிய	Nan
क्षतिपूर्ति	இழப்பீடு	Nan
क्षतिग्रस्त	சேதமடைந்தது	Nan
क्षति	சேதம்	None
क्षणिक	தருணம்	Nan
क्षण	கணம்	Nan
क्वाथ	காபி தண்ணீர்	Nan
क्वांटम	குவாண்டம்	None
क्लोरोफिल	பச்சையம்	Nan
क्लोराइड	குளோரைடு	Nan
क्लोनिंग	குளோனிங்	Nan
क्लिक	கிளிக் செய்க	Nan
क्लिंटन	கிளின்டன்	Nan
क्रीज	மடிப்பு	Nan
क्रीड़ा	விளையாட்டு	None
क्रुद्ध	கோபம்	None
क्रूज	குரூஸ்	Nan
क्रूर	இரக்கமற்ற	Nan
क्रेडिट	கடன்	None
क्षरण	அரிப்பு	None
क्रोध	கோபம்	None
क्रोमोसोम	குரோமோசோம்	Nan
क्रोमोसोमों	குரோமோசோம்கள்	Nan
क्रोस	சிலுவை	Nan
क्लब	கிளப்	None
क्लाइस्ट्रॉन	கிளைஸ்ட்ரான்	Nan
क्लासिकल	பாரம்பரிய	None
क्रोधित	கோபம்	None
क्षिप्रा	கிஷிப்ரா	Nan
क्षीण	பலவீனமான	Nan
क्षुद्र	குட்டி	None
खजुराहो	கஜுராஹோ	Nan
खजूर	தேதிகள்	Nan
खड़ा	நிற்க	Nan
खड़ी	நின்று	None
खड़ीबोली	இந்தி மொழியின் பண்டைய வடிவம்	Nan
खड़े	நின்று	None
खजाने	பொக்கிஷங்கள்	Nan
खडा	நிற்க	Nan
खण्ड	தொகுதி	None
खतना	விருத்தசேதனம்	Nan
खतरनाक	ஆபத்தானது	Nan
खतरा	ஆபத்து	None
खतरे	ஆபத்து	None
खतरों	ஆபத்துகள்	Nan
खडी	நின்று	None
क्रिस्टल	படிக	Nan
खजाना	புதையல்	Nan
खगोल	ஆஸ்ட்ரோ	Nan
क्षुब्ध	கோபம்	None
क्षेत्र	பரப்பளவு	None
क्षेत्रफल	பரப்பளவு	None
क्षेत्रमापी	புலம் பாதை	Nan
क्षेत्ररक्षण	பீல்டிங்	Nan
क्षेत्राधिकार	அதிகார வரம்பு	Nan
खगोलीय	வான	None
क्षेत्रीय	பிராந்திய	None
क्षैतिज	கிடைமட்ட	Nan
ख	பி	Nan
खंड	பிரிவு	None
खंडन	மறுப்பு	None
खंडित	துண்டு துண்டாக	Nan
खंडों	பிரிவுகள்	None
क्षेत्रों	பிராந்தியங்கள்	Nan
क्रिसमस	கிறிஸ்துமஸ்	None
क्रियान्वयन	மரணதண்டனை	Nan
क्रियात्मक	செயல்பாட்டு	None
कोरिया	கொரியா	None
कोरियाई	கொரிய	Nan
कोर्ट	நீதிமன்றம்	None
कोर्स	பாடநெறி	Nan
कोलंबिया	கொலம்பியா	None
कोलकाता	கொல்கத்தா	None
कोर	மூலை	Nan
कोलोंबिया	கொலோபியா	Nan
कोशिका	செல்	None
कोशिकाएं	செல்கள்	None
कोशिकाओं	செல்கள்	None
कोशिकीय	செல்லுலார்	Nan
कोशिश	முயற்சி	None
कोशों	தேசரஸ்	Nan
कोशल	கோசலா	Nan
कोष	கருவூலம்	Nan
कोयले	நிலக்கரி	None
कोमलता	மிருதுவான	Nan
कोंकण	கொங்கன்	Nan
कोइ	ஏதேனும்	None
कोई	யாரோ	Nan
कोख	கருவில்	Nan
कोच	பயிற்சியாளர்	Nan
कोट	கோட்	None
कोयला	நிலக்கரி	None
कोड	குறியீடு	None
कोणार्क	கோனர்க்	Nan
कोणीय	கோண	Nan
कोणों	கோணங்கள்	Nan
कोने	மூலையில்	None
कोबे	கோபி	Nan
कोमल	மென்மையான	None
कोण	கோணம்	None
को	க்கு	Nan
कोसल	கோசல்	Nan
कोहरा	மூடுபனி	Nan
क्रमशः	முறையே	None
क्रमांक	வரிசை எண்	Nan
क्रय	கொள்முதல்	None
क्रांतिकारी	புரட்சிகர	None
क्रान्त	புரட்சி	None
क्रान्ति	புரட்சி	None
क्रमश	முறையே	None
क्रान्तिकारी	புரட்சிகர	None
क्रिकेटर	கிரிக்கெட் வீரர்	Nan
क्रिप्ट	க்ரிப்ட்	Nan
क्रिप्टो	கிரிப்டோ	Nan
क्रिप्टोग्राफ़ी	குறியாக்கவியல்	Nan
क्रियाओं	வினைச்சொற்கள்	Nan
क्रियाकलाप	செயல்பாடு	None
क्रिकेट	மட்டைப்பந்து	Nan
कोसी	கோசி	Nan
क्रमबद्ध	வகைபடுத்து	Nan
क्योटो	கியோட்டோ	Nan
कोहिनूर	கோஹினூர்	Nan
कौटिल्य	க auti டில்யா	Nan
कौन	who	Nan
कौरव	க aura ரவ	Nan
कौशल	திறன்	None
कौशाम्बी	க aus சாம்பி	Nan
क्रम	ஆர்டர்	Nan
कौशिक	க aus சிக்	Nan
क्यूंकि	ஏனெனில்	None
क्यूबा	கியூபா	None
क्यूलेक्स	குலெக்ஸ்	Nan
क्यों	ஏன்	None
क्योंकि	ஏனெனில்	None
क्योकि	ஏனெனில்	None
क्या	என்ன	None
गुरुद्वारा	குருத்வாரா	Nan
उपिनषद्	உபினாஷாத்	Nan
उपासक	வழிபடுபவர்	Nan
अर्जी	விண்ணப்பம்	Nan
अर्जित	சம்பாதித்தார்	Nan
अर्ज़ी	விண்ணப்பம்	Nan
अर्चना	அர்ச்சனா	Nan
अर्क	பிரித்தெடுத்தல்	Nan
अरे	ஏய்	Nan
अरुणाचल	அருணாச்சல்	Nan
अरुण	அருண்	Nan
अरावली	ஆரவலி	Nan
अराजकता	அராஜகம்	Nan
अरस्तू	அரிஸ்டாட்டில்	None
अरस्तु	அரிஸ்டாட்டில்	None
अरविन्द	அரவிந்த்	Nan
अरबों	பில்லியன்கள்	Nan
अरबी	அரபு	None
अरब	அரபு	None
अरण्यकाण्ड	பேக்வுட்ஸ்	Nan
अमृतसर	அமிர்தசரஸ்	Nan
अमेरिकन	அமெரிக்கன்	None
अमेरिका	அமெரிக்கா	None
अमोनिया	அம்மோனியா	Nan
अमौसी	அம aus சி	Nan
अम्बा	அம்பா	Nan
अर्जुन	அர்ஜுன்	Nan
अम्बालिका	அம்பலைகா	Nan
अम्बेडकर	அம்பேத்கர்	None
अम्ल	அமிலம்	None
अम्लीय	அமில	None
अम्हारिक	அம்ஹாரிக்	Nan
अयोध्या	அயோத்தி	None
अयोध्याकाण्ड	அயோத்தி	None
अम्बिका	அம்பிகா	Nan
अर्जेंटीना	அர்ஜென்டினா	None
अर्थ	பொருள்	None
अर्थविज्ञान	பொருளாதாரம்	Nan
अलगअलग	வெவ்வேறு	None
अलगाव	தனிமைப்படுத்துதல்	Nan
अलाउद्दीन	அலாவுதீன்	Nan
अलावा	தவிர	None
अलिखित	எழுதப்படாதது	Nan
अली	அலி	None
अलग	தவிர	None
अलौकिक	அமானுஷ்யம்	Nan
अल्पना	அல்பனா	Nan
अल्पायु	குறுகிய வயது	Nan
अल्फा	ஆல்பா	Nan
अल्फ्रेड	ஆல்பிரட்	Nan
अल्मोड़ा	அல்மோரா	Nan
अल्लाह	இறைவன்	None
अल्प	சில	None
अमूल्य	விலைமதிப்பற்றது	Nan
अलकनन्दा	அலக்நந்தா	Nan
अलंकार	அலங்கார	Nan
अर्थव्यवस्था	பொருளாதாரம்	Nan
अर्थव्यवस्थाओं	பொருளாதாரங்கள்	Nan
अर्थशास्त्र	பொருளாதாரம்	Nan
अर्थशास्त्रियों	பொருளாதார வல்லுநர்கள்	Nan
अर्थशास्त्री	பொருளாதார நிபுணர்	Nan
अर्थात	பொருள்	None
अलंकृत	அலங்கரிக்கப்பட்ட	Nan
अर्थात्	அதாவது	None
अर्थों	பொருள்	None
अर्द्ध	அரை	None
अर्न्तगत	கீழ்	None
अर्पित	அர்ப்பணிப்பு	Nan
अल	அல்	None
अलंकरण	அலங்கார	Nan
अर्थात्‌	அதாவது	None
अमूर्त	சுருக்கம்	None
अमीरात	எமிரேட்	Nan
अमीर	பணக்கார	None
अब	இப்போது	None
अबतक	அது இப்போது வரை	Nan
अबु	அபு	Nan
अबुल	அபுல்	None
अब्द	அப்து	Nan
अब्दुल	அப்துல்	None
अफ्रीकी	ஆப்பிரிக்க	None
अब्दुल्ला	அப்துல்லா	Nan
अब्राहम	ஆபிரகாம்	None
अभाव	பற்றாக்குறை	None
अभिकलन	கணக்கீடு	Nan
अभिकलित्र	கணினி	Nan
अभिकल्पना	வடிவமைப்பு	None
अभिक्रिया	எதிர்வினை	Nan
अब्बास	அப்பாஸ்	Nan
अभिनय	நடிப்பு	Nan
अफ्रीका	ஆப்பிரிக்கா	None
अफ़्रीकी	ஆப்பிரிக்க	None
अपील	முறையீடு	Nan
अपूर्णता	அபூரணம்	Nan
अपूर्व	அரிது	None
अपेक्षा	எதிர்பார்க்கலாம்	Nan
अपेक्षाकृत	ஒப்பீட்டளவில்	None
अपेक्षित	எதிர்பார்க்கப்படுகிறது	None
अफ्फनपिन्स्चर	செயலிழப்பு	Nan
अप्रत्यक्ष	மறைமுக	None
अप्सरा	எல்ஃப்	Nan
अफगान	ஆப்கான்	Nan
अफगानिस्तान	ஆப்கானிஸ்தான்	None
अफसर	அதிகாரி	None
अफ़ग़ानिस्तान	ஆப்கானிஸ்தான்	None
अफ़्रीका	ஆப்பிரிக்கா	None
अप्रैलजून	ஏப்ரல்ஜூன்	Nan
अवकाश	விடுமுறை	None
अभिनेता	நடிகர்	None
अभिनेत्रियों	நடிகைகள்	None
अभिहित	நியமிக்கப்பட்டது	Nan
अभ्यारण्य	சரணாலயம்	None
अभ्यास	பயிற்சி	None
अमर	அழியாத	None
अमरनाथ	அமர்நாத்	Nan
अमरावती	அமராவதி	None
अभिषेक	அபிஷேக்	Nan
अमरीकन	அமெரிக்கன்	None
अमरीकी	அமெரிக்கன்	None
अमल	மரணதண்டனை	Nan
अमावस्या	அமாவாசை	Nan
अमिट	அழியாத	None
अमिताभ	அமிதாப்	Nan
अमीटर	அம்மீட்டர்	Nan
अमरीका	அமெரிக்கா	None
अभिनेताओं	நடிகர்கள்	None
अभिव्यक्ति	பாவனை	Nan
अभिलेखों	பதிவுகள்	None
अभिनेत्री	நடிகை	None
अभिन्न	ஒருங்கிணைந்த	None
अभिप्राय	நோக்கம்	None
अभिभाषण	முகவரி	None
अभिमन्यु	அபிமன்யு	Nan
अभिमान	பெருமை	None
अभिव्यक्त	வெளிப்படுத்தியது	Nan
अभियन्ता	பொறியாளர்	None
अभियान	பிரச்சாரம்	None
अभियानों	பிரச்சாரங்கள்	Nan
अभियान्त्रिकी	பொறியியல்	None
अभिरुचि	ஆர்வம்	None
अभिलाषा	ஆசை	None
अभिलेख	பதிவு	Nan
अभियांत्रिकी	பொறியியல்	None
अपितु	ஆனாலும்	None
अवतरण	தரையிறக்கம்	Nan
अवतार	அவதார்	Nan
आइ	நான்	None
आंशिक	பகுதி	Nan
आंबेडकर	அம்பேத்கர்	None
आंध्रप्रदेश	ஆந்திரா	None
आंध्र	ஆந்திரா	None
आंधी	புயல்	None
आंदोलनों	இயக்கங்கள்	None
आंतरिक	உள்	None
आंत	குடல்	Nan
आंखों	கண்கள்	None
आंख	கண்	None
आंकडों	புள்ளிவிவரங்கள்	None
आंकडे	புள்ளிவிவரங்கள்	None
आंकडा	தகவல்கள்	None
आंकड़ों	தகவல்	None
आंकड़े	புள்ளிவிவரங்கள்	None
आँसू	கண்ணீர்	None
अस्वीकृत	நிராகரிக்கப்பட்டது	Nan
अस्वीकृति	மறுப்பு	None
अस्सी	எண்பது	Nan
अहंकार	ஈகோ	Nan
अहम	உயிர்	Nan
अहमद	அகமது	Nan
आइंस्टीन	ஐன்ஸ்டீன்	None
अहमदाबाद	அகமதாபாத்	Nan
अहिंसा	அஹிம்சா	Nan
आ	வாருங்கள்	Nan
आँकड़ों	புள்ளிவிவரங்கள்	None
आँख	கண்	None
आँखें	கண்கள்	None
आँखों	கண்கள்	None
अहसास	உணர்தல்	Nan
आइसलैंड	ஐஸ்லாந்து	Nan
आइसोटोप	ஐசோடோப்பு	Nan
आई	நான் வந்தேன்	Nan
आकार	வடிவம்	None
आकाश	வானம்	None
आकाशगंगा	கேலக்ஸி	Nan
आकाशीय	வான	None
आकिल	ஐகல்	Nan
आकिलखान	மதிப்பீடு	None
आकांक्षाओं	அபிலாஷைகள்	Nan
आकृतियों	வடிவங்கள்	None
आक्रमणकारियों	படையெடுப்பாளர்கள்	Nan
आक्रमणों	படையெடுப்புகள்	Nan
आक्रामक	முரட்டுத்தனமான	Nan
आक्सफोर्ड	ஆக்ஸ்போர்டு	Nan
आक्साइड	ஆக்சைடு	None
आक्सीकरण	ஆக்ஸிஜனேற்றம்	Nan
आक्रमण	தாக்குதல்	None
अस्वीकार	நிராகரி	Nan
आकांक्षा	ஆசை	None
आकर्षित	ஈர்த்தது	Nan
आईं	அவள் வந்துவிட்டாள்	Nan
आईएमई	ime	Nan
आईटी	ஐ.டி.	Nan
आईपॉड	ஐபாட்	Nan
आईबीएम	ஐ.பி.எம்	Nan
आईसीसी	ஐ.சி.சி.	Nan
आकस्मिक	தற்செயலானது	Nan
आउट	அவுட்	Nan
आए	திரும்பும்	Nan
आएगा	வரும்	None
आओ	வாருங்கள்	Nan
आकर	வந்த பிறகு	Nan
आकर्षक	கவர்ச்சிகரமான	Nan
आकर्षण	வசீகரம்	Nan
आउटपुट	வெளியீடு	None
अस्पृश्यता	தீண்டாமை	Nan
अस्पृश्य	தீண்டத்தகாத	Nan
अस्पष्ट	தெளிவாக இல்லை	Nan
अवसर	வாய்ப்பு	None
अवस्था	நிலை	None
अवस्थाओं	மாநிலங்களில்	None
अवार्ड	விருது	None
अविश्वास	அவநம்பிக்கை	Nan
अवैध	சட்டவிரோதமானது	Nan
अवश्य	நிச்சயமாக	Nan
अशांति	இடையூறு	None
अशोक	அசோக்	Nan
अश्वत्थामा	அஸ்வத்தாமா	Nan
अश्वमेध	அஸ்வமேத்	Nan
अश्विनी	அஸ்வினி	Nan
अष्टमी	எட்டாவது	None
असंख्य	ஏராளமான	None
अशुभ	தீங்கு விளைவிக்கும்	Nan
असंतुलन	ஏற்றத்தாழ்வு	Nan
अवशोषित	உறிஞ்சப்படுகிறது	Nan
अवशोषक	உறிஞ்சி	Nan
अवतारों	அவதாரங்கள்	Nan
अवतीर्ण	அவதரித்தார்	Nan
अवधारणा	அங்கீகாரம்	None
अवधारणाओं	கருத்துக்கள்	None
अवधि	காலம்	None
अवधी	அவதி	Nan
अवशोषण	உறிஞ்சுதல்	Nan
अवमानना	அவமதிப்பு	Nan
अवयवों	பொருட்கள்	None
अवरोध	தடை	None
अवलोकन	கண்ணோட்டம்	Nan
अवशिष्ट	எஞ்சியவை	Nan
अवशेष	எஞ்சியுள்ளவை	Nan
अवशेषों	எச்சம்	None
अवयव	கூறுகள்	None
अवतरित	இறங்கியது	Nan
असंतोष	அதிருப்தி	Nan
असफल	தோல்வி	Nan
असेम्बली	சட்டசபை	Nan
असोसिएशन	சங்கம்	None
अस्त	தொகுப்பு	Nan
अस्तित्व	இருப்பு	None
अस्तु	உண்மையில்	None
अस्त्र	ஆயுதம்	None
असुरों	அசுரர்கள்	Nan
अस्त्रों	ஆயுதங்கள்	None
अस्थायी	தற்காலிகமானது	Nan
अस्थि	எலும்பு	Nan
अस्थिर	நிலையற்றது	Nan
अस्थिरता	உறுதியற்ற தன்மை	Nan
अस्पताल	மருத்துவமனை	None
अस्पतालों	மருத்துவமனைகள்	None
अस्थाई	தற்காலிகமானது	Nan
असंभव	சாத்தியமற்றது	Nan
असुरक्षित	பாதுகாப்பற்றது	Nan
असीमित	வரம்பற்றது	Nan
असफलता	தோல்வி	None
असम	அசாம்	None
असमर्थ	முடியவில்லை	None
असमानता	சமத்துவமின்மை	Nan
असमिका	அசாமி	Nan
असमिया	அசாமி	Nan
असुर	அசுர	Nan
असर	பாதிப்பு	None
असली	உண்மையானது	Nan
असहयोग	ஒத்துழையாமை	Nan
असहाय	உதவியற்றவர்	Nan
असाधारण	அசாதாரணமானது	Nan
असामान्य	அசாதாரணமானது	Nan
असीम	எல்லையற்ற	Nan
असल	அசல்	None
आक्सीजन	ஆக்ஸிஜன்	None
अपार	விவரிக்க முடியாதது	Nan
अपशिष्ट	கழிவு	None
अड्डा	டென்	Nan
अठारहवीं	பதினெட்டாம்	None
अठारह	பதினெட்டு	None
अटूट	உடைக்க முடியாதது	Nan
अटलांटिक	அட்லாண்டிக்	None
अज्ञेय	தெரியவில்லை	None
अज्ञान	அறியாமை	Nan
अज्ञात	தெரியவில்லை	None
अजीब	விசித்திரமானது	Nan
अजातशत्रु	அஜாதசாத்ரு	Nan
अज़ीज़	அஜீஸ்	Nan
अजय	அஜய்	Nan
अजमेर	அஜ்மீர்	Nan
अजनाभवर्ष	அஜ்னா பவர்	Nan
अजंता	அஜந்தா	Nan
अच्छे	நல்லது	None
अच्छी	நல்ல	None
अखिल	அகில்	Nan
अख्तर	அக்தர்	Nan
अगर	என்றால்	None
अगली	அடுத்தது	Nan
अगले	அடுத்து	None
अगस्त	ஆகஸ்ட்	None
अड्डे	அடிப்படை	None
अग्नि	அக்னி	Nan
अग्रणी	முன்னணி	None
अग्रसर	முன்னோக்கி	None
अग्रिम	முன்கூட்டியே	Nan
अचल	அசையாத	Nan
अचानक	திடீரென்று	Nan
अच्छा	நல்ல	None
अग्निमित्र	அக்னிமித்ரா	Nan
अणु	மூலக்கூறுகள்	None
अणुओं	மூலக்கூறுகள்	None
अण्डमान	அந்தமான்	None
अत्रि	ஆத்ரி	Nan
अथ	ஆத்	Nan
अथर्व	அதர்வா	Nan
अथर्ववेद	அதர்வவேதம்	Nan
अथवा	அல்லது	None
अदभुत	ஆச்சரியம்	Nan
अत्याधिक	மேலும்	None
अदा	அடா	Nan
अदृश्य	கண்ணுக்கு தெரியாத	Nan
अदृष्ट	காணப்படாத	Nan
अद्भुत	அற்புதம்	Nan
अद्यतन	புதுப்பிப்புகள்	Nan
अद्वितीय	தனித்துவமான	None
अद्वैत	அத்வைதம்	Nan
अदालत	நீதிமன்றம்	None
अखबारों	செய்தித்தாள்கள்	Nan
अत्याचारी	துன்புறுத்துபவர்	Nan
अत्यन्त	மிகவும்	None
अण्डे	முட்டை	None
अण्डों	முட்டை	None
अत	எனவே	None
अतः	எனவே	None
अतएव	எனவே	None
अति	தீவிர	None
अत्याचार	சித்திரவதை	Nan
अतिक्रमण	அத்துமீறல்	Nan
अतिरिक्त	தவிர	None
अतिवादी	தீவிரவாதி	Nan
अतीत	கடந்த காலம்	Nan
अतेन	ஏடன்	Nan
अत्यंत	மிகவும்	None
अत्यधिक	அதிகப்படியான	None
अतिथि	விருந்தினர்	Nan
अखबार	செய்தித்தாள்	Nan
अखंडता	நேர்மை	Nan
अखंड	உடைக்கப்படாதது	Nan
अंग्रेज़ी	ஆங்கிலம்	Nan
अंग्रेजी	ஆங்கிலம்	Nan
अंग्रेजो	பிரிட்டிஷ்	Nan
अंग्रेजों	ஆங்கிலேயர்	None
अंचल	மண்டலம்	None
अंजाम	முடிவு	None
अंग्रेज	ஆங்கிலம்	Nan
अंजीर	படம்	None
अंडाशय	கருப்பை	None
अंडे	முட்டை	None
अंत	முடிவு	None
अंतत	இறுதியாக	Nan
अंततः	இறுதியாக	Nan
अंतर	வித்தியாசம்	None
अंडमान	அந்தமான்	None
अंतरजाल	இணையதளம்	None
अंगों	கைகால்கள்	Nan
अंगूर	திராட்சை	Nan
<	&lt;	Nan
=	=	None
==	==	None
^	^	None
|	|	None
~	~	None
अंगो	கைகால்கள்	Nan
°	°	None
अंकगणित	எண்கணிதம்	None
अंकारा	அங்காரா	None
अंकित	அங்கித்	Nan
अंकीय	டிஜிட்டல்	None
अंकों	இலக்கங்கள்	Nan
अंग	பகுதி	Nan
अ	a	Nan
अधरों	பாதி	Nan
अंतरण	இடமாற்றம்	Nan
अंतराल	இடைவெளி	None
अकार	காரணம்	Nan
अकाल	பஞ்சம்	None
अकेला	தனியாக	None
अकेले	தனியாக	None
अक्टूबर	அக்டோபர்	None
अक्तूबर	அக்டோபர்	None
अकादमी	அகாடமி	Nan
अक्तूबरदिसंबर	அக்டோபர் டிசம்பர்	Nan
अक्षय	புதுப்பிக்கத்தக்க	Nan
अक्षर	கடிதம்	None
अक्षरधाम	அக்ஷர்தம்	Nan
अक्षांश	அட்சரேகை	Nan
अक्षुण्ण	அப்படியே	None
अक्सर	பெரும்பாலும்	None
अक्षम	முடக்கப்பட்டது	Nan
अंतरराष्ट्रीय	சர்வதேச	None
अकबर	அக்பர்	None
अंश	பகுதி	Nan
अंतराष्ट्रीय	சர்வதேச	None
अंतरिक्ष	இடம்	None
अंतरिम	இடைக்கால	None
अंतर्गत	கீழ்	None
अंतर्दृष्टि	நுண்ணறிவு	None
अंतर्राष्ट्रीय	சர்வதேச	None
अंशों	டிகிரி	Nan
अंतिम	கடைசி	None
अंदाज	உடை	None
अंध	குருட்டு	Nan
अंधकार	இருள்	Nan
अंधेरी	இருள்	Nan
अंपायर	நடுவர்	Nan
अंबानी	அம்பானி	Nan
अंदर	உள்ளே	None
अपहरण	கடத்தப்பட்டது	Nan
अधर्म	தவறு	None
अधिक	மேலும்	None
अन्तरिक्ष	இடம்	None
अन्तरराष्ट्रीय	சர்வதேச	None
अन्तरजाल	இணையதளம்	None
अन्तर	வித்தியாசம்	None
अन्ततः	இறுதியில்	None
अन्त	முற்றும்	Nan
अनोखी	தனித்துவமான	None
अनोखा	தனித்துவமான	None
अनैतिक	ஒழுக்கக்கேடானது	Nan
अनेकों	நிறைய	None
अनेक	பல	None
अनूबिस	அனுபிஸ்	Nan
अनूदित	மொழிபெயர்க்கப்பட்டுள்ளது	Nan
अनुसूची	அட்டவணை	Nan
अनुसूचित	திட்டமிடப்பட்ட	Nan
अनुसार	அதன்படி	None
अनुसरण	பின்தொடர்தல்	Nan
अनुमानों	கணிப்புகள்	Nan
अनुयायियों	பின்தொடர்பவர்கள்	Nan
अनुयायी	பின்தொடர்பவர்கள்	Nan
अनुराग	பாசம்	None
अनुरूप	படி	None
अनुरोध	கோரிக்கை	None
अन्तर्गत	கீழ்	None
अनुवाद	மொழிபெயர்ப்பு	None
अनुशासन	டிசிப்லைன்	Nan
अनुशीलन	பின்தொடர்கிறது	Nan
अनुष्ठान	சடங்கு	Nan
अनुष्ठानों	சடங்குகள்	None
अनुसंधान	ஆராய்ச்சி	None
अनुसन्धान	ஆராய்ச்சி	None
अनुवादक	மொழிபெயர்ப்பாளர்	Nan
अन्तर्राष्ट्रीय	சர்வதேச	None
अन्तस्थ	பொதிந்துள்ளது	Nan
अन्तिम	கடைசி	None
अपनी	என்னுடையது	Nan
अपनीअपनी	உங்கள்	None
अपने	நம்முடையது	Nan
अपनेअपने	உங்கள்	None
अपभ्रंश	இணைப்பு	None
अपमान	அவமதிப்பு	Nan
अपनाया	தத்தெடுக்கப்பட்டது	Nan
अपमानित	அவமானப்படுத்தப்பட்டது	Nan
अपराधियों	குற்றவாளிகள்	Nan
अपराधी	குற்றவாளி	Nan
अपराधों	குற்றங்கள்	None
अपलोड	பதிவேற்றவும்	Nan
अपवाद	விதிவிலக்கு	Nan
अपवाह	ஓட்டம்	None
अपराध	குற்றம்	None
अनुमानित	மதிப்பிடப்பட்டுள்ளது	Nan
अपनाने	தத்தெடுக்க	Nan
अपना	நம்முடையது	Nan
अन्दर	இல்	None
अन्दाज	யூகிக்கவும்	Nan
अन्ध	குருட்டு	Nan
अन्धकार	இருள்	Nan
अन्धेरा	இருள்	Nan
अन्न	தானிய	Nan
अपनाई	தொடர்ந்தது	Nan
अन्ना	அண்ணா	None
अन्यत्र	மற்ற இடங்களில்	Nan
अन्यथा	இல்லையெனில்	Nan
अन्याय	அநீதி	Nan
अन्वेषण	ஆய்வு	None
अन्‍य	மற்றவை	None
अप	மேலே	None
अन्य	மற்றவை	None
अनुमान	ஒரு மதிப்பீடு	Nan
अनुमस्तिष्क	செரிபெலம்	Nan
अनुमति	அனுமதி	None
अधीन	உட்பட்டது	Nan
अधीनता	அடிபணிதல்	Nan
अधूरा	முழுமையற்றது	Nan
अध्यक्ष	இயக்குனர்	None
अध्यक्षता	தலைமை வகித்தார்	Nan
अध्ययन	படிப்பு	None
अधिवेशन	அமர்வு	Nan
अध्ययनों	ஆய்வுகள்	None
अध्यादेश	கட்டளை	None
अध्याय	அத்தியாயம்	Nan
अध्यायों	அத்தியாயங்கள்	Nan
अनंत	முடிவற்றது	Nan
अनघ	அனாக்	Nan
अनदेखी	காணப்படாத	Nan
अध्यात्म	ஆன்மீகம்	Nan
अनन्त	நித்தியம்	Nan
अधिपति	சுசரைன்	Nan
अधिग्रहण	கையகப்படுத்தல்	Nan
अधिकतम	அதிகபட்சம்	Nan
अधिकतर	பெரும்பாலானவை	None
अधिकता	அதிகப்படியான	None
अधिकरण	தீர்ப்பாயம்	Nan
अधिकाँश	பெரும்பாலானவை	None
अधिकांश	பெரும்பான்மை	None
अधिनियम	நாடகம்	None
अधिकांशत	பெரும்பாலும்	None
अधिकाधिक	மேலும் மேலும்	Nan
अधिकार	உரிமைகள்	None
अधिकारिक	அதிகாரப்பூர்வ	None
अधिकारियों	அதிகாரிகள்	None
अधिकारी	அதிகாரி	None
अधिकृत	அங்கீகாரம் பெற்றது	Nan
अधिकांशतः	பெரும்பாலும்	None
अधातु	nonmetal	Nan
अनन्य	தனித்துவமான	None
अनमोल	விலைமதிப்பற்றது	Nan
अनुचित	பொருத்தமற்றது	Nan
अनुच्छेद	கட்டுரை	None
अनुदान	மானியம்	Nan
अनुनाद	அதிர்வு	Nan
अनुपम	அனுபம்	Nan
अनुपस्थिति	இல்லாமை	Nan
अनुग्रह	கருணை	None
अनुपात	விகிதம்	None
अनुप्रयोगों	பயன்பாடுகள்	None
अनुबंध	ஒப்பந்தம்	None
अनुभव	அனுபவம்	None
अनुभवी	அனுபவம் வாய்ந்தவர்கள்	Nan
अनुभाग	பிரிவு	None
अनुभूति	உணர்வு	None
अनुपालन	இணக்கம்	Nan
अनपढ़	படிப்பறிவில்லாத	Nan
अनुक्रम	வரிசை	None
अनुकूल	சாதகமானது	Nan
अनवर	அன்வர்	Nan
अनवरत	இடைவிடாமல்	Nan
अनशन	வேகமாக	None
अनाज	தானிய	Nan
अनाथ	அனாதை	Nan
अनार	மாதுளை	Nan
अनुकूलन	தனிப்பயனாக்கம்	Nan
अनावश्यक	தேவையற்றது	Nan
अनियमित	ஒழுங்கற்ற	None
अनिल	அனில்	Nan
अनिवार्य	கட்டாயமாகும்	Nan
अनिश्चित	நிச்சயமற்றது	Nan
अनु	அனு	Nan
अनुकरण	உருவகப்படுத்துதல்	Nan
अनियंत्रित	கட்டுப்பாடற்றது	Nan
उपासना	வழிபாடு	None
आखरी	கடைசி	None
आखिरी	கடைசி	None
उठते	உயரும்	None
उठती	உயரும்	None
उठता	எழுந்திரு	Nan
उठ	எழுந்திரு	Nan
उज्जैन	உஜ்ஜைன்	Nan
उज्जयिनी	உஜ்ஜயினி	Nan
उजागर	அம்பலப்படுத்து	Nan
उच्‍च	உயர்	None
उच्चतर	உயர்ந்தது	Nan
उच्चतम	அதிகபட்சம்	Nan
उचित	பொருத்தமானது	None
उग्र	உமிழும்	Nan
उगाया	வளர்ந்த	None
उगाई	வளர்ந்த	None
उखाड़	பிடுங்க	Nan
उक्त	கூறினார்	None
उंगलियों	விரல்கள்	Nan
ईरान	ஈரான்	None
ईरानी	ஈரானிய	Nan
ईश	இஷ்	Nan
ईश्वर	இறைவன்	None
ईश्वरीय	தெய்வபக்தி	Nan
ईसवी	கி.பி.	Nan
उठने	உயர்த்த	Nan
ईसाइयत	கிறிஸ்தவம்	None
ईसाई	கிறிஸ்துவர்	Nan
ईसाईयों	கிறிஸ்தவர்கள்	None
ईसापूर्व	பி.சி.	Nan
ईस्ट	கிழக்கு	None
ईस्टर	ஈஸ்டர்	Nan
ईस्वी	கி.பி.	Nan
ईसाइयों	கிறிஸ்தவர்கள்	None
उठा	எடுப்பது	Nan
उठाकर	எடுப்பது	Nan
उठाते	எடுப்பது	Nan
उतारने	இறக்குதல்	Nan
उतारा	குறைக்கப்பட்டது	Nan
उत्कर्ष	செழிப்பானது	Nan
उत्कीर्ण	பொறிக்கப்பட்டுள்ளது	Nan
उत्कृष्ट	அருமை	Nan
उत्खनन	அகழ்வாராய்ச்சி	Nan
उतार	யு பி எஸ்	Nan
उत्तम	சிறந்தது	None
उत्तरकाण्ड	உத்தரகண்ட்	Nan
उत्तरकाशी	உத்தர்காஷி	Nan
उत्तरदायित्व	பொறுப்பு	Nan
उत्तरदायी	பொறுப்பு	Nan
उत्तरपश्चिम	வடமேற்கு	None
उत्तरपूर्व	வடகிழக்கு	None
उत्तर	பதில்	None
ईरप्शन	வெடிப்பு	None
उतरने	தரையிறக்கம்	Nan
उतर	இறங்க	Nan
उठाना	எடு	None
उठाने	தூக்குதல்	Nan
उठाया	எழுப்பப்பட்ட	Nan
उठाये	எடு	None
उठी	கிடைத்தது	None
उठे	கிடைத்தது	None
उतरते	இறங்கு	Nan
उड़	ஈ	None
उड़िया	ஒரியா	Nan
उड़ीसा	ஒரிசா	None
उतक	திசு	None
उतना	அவ்வளவுதான்	Nan
उतनी	அவ்வளவுதான்	Nan
उतने	அவ்வளவு அதிகம்	Nan
उड़ने	பறக்க	Nan
ईमेल	மின்னஞ்சல்	None
ईमानदारी	நேர்மை	Nan
ईमानदार	நேர்மையான	Nan
इमाम	பாதிரியார்	Nan
इमारत	கட்டிடம்	None
इमारतों	கட்டிடங்கள்	None
इराक	ஈராக்	None
इराक़	ஈராக்	None
इरादा	நோக்கம்	None
इब्राहिम	இப்ராஹிம்	Nan
इलाका	பகுதியில்	None
इलाज	சிகிச்சை	None
इलाहाबाद	அலகாபாத்	Nan
इलेक्ट्रान	எதிர் மின்னணு	Nan
इलेक्ट्रॉन	எதிர் மின்னணு	Nan
इलेक्ट्रॉनिक	மின்னணு	None
इलेक्ट्रॉनिकी	எலெக்ட்ரானிக்ஸ்	Nan
इलाकों	வட்டாரங்கள்	Nan
इलेक्ट्रॉनिक्स	எலெக்ட்ரானிக்ஸ்	Nan
इबादत	வழிபாடு	None
इन्होंने	அவர்கள்	None
इनको	அவர்களுக்கு	None
इनपुट	உள்ளீடு	None
इनमे	இவற்றில்	None
इनमें	இவற்றில்	None
इनाम	பரிசு	None
इन्टरनेट	இணையதளம்	None
इन्होने	அவர்கள்	None
इन्दिरा	இந்திரா	None
इन्दौर	இந்தூர்	Nan
इन्द्रप्रस्थ	இந்திரப்பிரஸ்தா	Nan
इन्फ्लूएंजा	குளிர் காய்ச்சல்	Nan
इन्ही	இவை	None
इन्हे	அவர்களுக்கு	None
इन्हें	இவை	None
इन्दु	இந்தூ	Nan
उत्तरप्रदेश	உத்தரபிரதேசம்	Nan
इलेक्ट्रॉनों	எலக்ட்ரான்கள்	Nan
इष्ट	பிடித்தது	None
इस्लाम	இஸ்லாம்	None
इस्लामिक	இஸ்லாமிய	None
इस्लामी	இஸ்லாமிய	None
इस्वी	கி.பி.	Nan
ई	இ	None
ईंट	செங்கல்	Nan
इस्माईल	இஸ்மாயில்	Nan
ईंटों	செங்கற்கள்	Nan
ईक्वाडोर	ஈக்வடார்	Nan
ईटानगर	இட்டாநகர்	Nan
ईडन	ஈடன்	Nan
ईद	ஈத்	Nan
ईपू	பிபி	Nan
ईमान	நம்பிக்கை	None
ईंधन	எரிபொருள்	None
इशारा	அறிகுறி	Nan
इस्तेमाल	பயன்படுத்தப்பட்டது	None
इसीलिये	அதனால்தான்	Nan
इस	இது	None
इसका	அதன்	None
इसकी	அவரது	Nan
इसके	அதன்	None
इसको	இது	None
इसपर	இந்த	None
इसे	அவரை	None
इसमे	இதில்	None
इसरो	இஸ்ரோ	Nan
इसलिए	அதனால்	None
इसलिये	அதனால்தான்	Nan
इसवी	இஸ்வி	Nan
इससे	இதன் மூலம்	Nan
इसी	அதே	None
इसमें	இதில்	None
इनकी	அவர்களது	Nan
उत्तरांचल	உத்தராஞ்சல்	Nan
उत्तराखण्ड	உத்தரகண்ட்	Nan
उपभोक्ता	நுகர்வோர்	Nan
उपन्यासों	நாவல்கள்	Nan
उपन्यासकार	நாவலாசிரியர்	Nan
उपन्यास	புதினம்	None
उपनिषद्	உபநிடதங்கள்	None
उपनिषदों	உபநிடதங்கள்	None
उपनिषद	உபநிடதங்கள்	None
उपनिवेशों	காலனிகள்	Nan
उपनिवेशवाद	காலனித்துவவாதம்	Nan
उपनाम	குடும்ப பெயர்	Nan
उपनगरों	புறநகர்ப் பகுதிகள்	Nan
उपनगरीय	புறநகர்	None
उपनगर	புறநகர்	None
उपधातु	பைமெட்டாலிக்	Nan
उपदेशों	போதனைகள்	Nan
उपदेश	உபதேசம்	Nan
उपजाऊ	வளமான	None
उन्हे	அவர்களுக்கு	None
उन्हें	அவர்களுக்கு	None
उन्होंने	அவர்கள்	None
उन्होने	அவர்கள்	None
उन्होनें	அவர்கள்	None
उपकरण	உபகரணங்கள்	None
उपभोक्ताओं	நுகர்வோர்	None
उपकरणों	சாதனங்கள்	Nan
उपक्रम	நிறுவன	Nan
उपक्षेत्र	சப்ஃபீல்ட்	Nan
उपग्रह	செயற்கைக்கோள்	None
उपग्रहों	செயற்கைக்கோள்கள்	Nan
उपचार	சிகிச்சை	None
उपचारों	சிகிச்சைகள்	Nan
उपकार	உதவி	None
उपभोग	நுகர்வு	None
उपमहाद्वीप	துணைக் கண்டம்	Nan
उपमा	ஒத்த	None
उपविभाग	துணைத் துறை	Nan
उपशाखा	துணை தலைப்பு	Nan
उपसर्ग	முன்னொட்டு	Nan
उपसहारा	வளர்ப்பவர்	Nan
उपस्थित	தற்போது	None
उपस्थिति	இருப்பு	None
उपवास	விரதம்	None
उपहार	பரிசுகள்	None
उपाधियाँ	தலைப்புகள்	None
उपाध्याय	உபாத்யாய்	Nan
उपाय	தீர்வு	None
उपायुक्त	துணை ஆணையர்	Nan
उपायों	நடவடிக்கைகள்	None
उपार्जित	வாங்கியது	Nan
उपाधि	பட்டம்	None
उन्हीं	அதே	None
उपलब्धियों	சாதனைகள்	Nan
उपलब्धि	கிடைக்கும்	None
उपयुक्त	பொருத்தமானது	None
उपयोग	பயன்படுத்தவும்	Nan
उपयोगकर्ता	பயனீட்டாளர்	Nan
उपयोगकर्ताओं	பயனர்கள்	None
उपयोगिता	பயன்பாடு	None
उपयोगी	பயனுள்ள	Nan
उपलब्धियाँ	சாதனைகள்	Nan
उपर	மேலே	None
उपरान्त	பிறகு	None
उपराष्ट्रपति	துணைத் தலைவர்	Nan
उपरोक्त	மேலே குறிப்பிட்டுள்ள	Nan
उपर्युक्त	மேலே குறிப்பிட்டுள்ள	Nan
उपलब्ध	கிடைக்கிறது	None
उपलब्धता	கிடைக்கும்	None
उपरांत	பிறகு	None
उन्ही	அதே	None
उन्मूलन	நீக்குதல்	Nan
उन्मुख	சார்ந்த	None
उत्पादित	தயாரிக்கப்பட்டது	Nan
उत्पादों	தயாரிப்புகள்	None
उत्प्रेरक	வினையூக்கி	Nan
उत्सर्जन	உமிழ்வு	None
उत्सर्जित	உமிழப்படுகிறது	Nan
उत्सव	திருவிழா	None
उत्पादन	உற்பத்தி	None
उत्सवों	விழாக்கள்	None
उत्साहित	உற்சாகமாக	Nan
उदय	பிரகாசிக்கவும்	Nan
उदयपुर	உதய்பூர்	Nan
उदर	வயிறு	None
उदहारण	உதாரணமாக	None
उदार	தாராள	Nan
उत्साह	உற்சாகம்	Nan
उदारता	கருணை	None
उत्पादकता	உற்பத்தித்திறன்	Nan
उत्पाद	பொருள்	Nan
उत्तराधिकार	அடுத்தடுத்து	Nan
उत्तराधिकारियों	வாரிசுகள்	Nan
उत्तरार्ध	பிந்தையது	Nan
उत्तरी	வடக்கு	None
उत्तरोत्तर	படிப்படியாக	None
उत्तानपाद	தயாரிப்பு	None
उत्पादक	உற்பத்தியாளர்	Nan
उत्तेजना	உற்சாகம்	Nan
उत्तोलक	நெம்புகோல்	None
उत्थान	மீளுருவாக்கம்	None
उत्पत्ति	தோற்றம்	Nan
उत्पन्न	உருவாக்கப்பட்டது	None
उत्परिवर्तन	பிறழ்வு	None
उत्परिवर्तित	பிறழ்ந்த	Nan
उत्तेजित	உற்சாகமாக	Nan
उत्तराखंड	உத்தரகண்ட்	Nan
उदारवादी	மிதமான	Nan
उदासीन	ஆர்வமற்றவர்	Nan
उधर	பின்னர்	None
उधार	கடன்	None
उन	அந்த	None
उनका	அவர்களது	Nan
उनकी	அவர்களது	Nan
उनके	அவர்களது	Nan
उद्योग	தொழில்	None
उनको	அவர்களுக்கு	None
उनसे	அவர்களிடமிருந்து	Nan
उन्नत	மேம்படுத்தபட்ட	Nan
उन्नति	முன்னேற்றம்	None
उन्नयन	மேம்படுத்தல்	None
उन्नीस	பத்தொன்பது	Nan
उन्नीसवीं	பத்தொன்பது	Nan
उनमें	அவற்றுள்	None
उदारीकरण	தாராளமயமாக்கல்	Nan
उद्यानों	தோட்டங்கள்	Nan
उद्यान	தோட்டம்	None
उदाहरण	எடுத்துக்காட்டுகள்	None
उदाहरणस्वरूप	உதாரணத்திற்கு	None
उदाहरणार्थ	உதாரணத்திற்கு	None
उदाहरणों	எடுத்துக்காட்டுகள்	None
उदित	எழுப்பப்பட்ட	Nan
उद्गम	தோற்றம்	Nan
उद्यानिकी	தோட்டக்கலை	Nan
उद्घाटन	பதவியேற்பு	Nan
उद्धरण	மேற்கோள்கள்	None
उद्धार	விடுதலை	None
उद्धृत	மேற்கோள் காட்டப்பட்டது	Nan
उद्भव	பரிணாமம்	None
उद्यम	நிறுவன	Nan
उद्यमी	தொழில்முனைவோர்	Nan
उद्देश्यों	நோக்கங்கள்	None
आखिर	அனைத்து பிறகு	Nan
इनकार	மறு	None
इथोपिया	எத்தியோப்பியா	Nan
आफ	முடக்கு	Nan
आपूर्ति	வழங்கல்	Nan
आपातकाल	அவசரம்	Nan
आपसे	உன்னிடமிருந்து	Nan
आपसी	பரஸ்பர	Nan
आपस	ஒருவருக்கொருவர்	Nan
आपरेशन	செயல்பாடு	None
आपरेटिंग	இயங்குகிறது	None
आपराधिक	குற்றவாளி	Nan
आपने	நீங்கள்	None
आपदाओं	பேரழிவுகள்	None
आपदा	பேரழிவு	None
आपत्ति	ஆட்சேபனை	Nan
आपको	நீங்கள்	None
आपके	உங்கள்	None
आपकी	உங்கள்	None
आपका	உங்கள்	None
आध्यात्मिक	ஆன்மீகம்	Nan
आन	aan	Nan
आनंद	மகிழ்ச்சி	Nan
आनंददायी	இன்பம் தரக்கூடியது	Nan
आनन्द	மகிழ்ச்சி	Nan
आनलाइन	நிகழ்நிலை	Nan
आफ़	முடக்கு	Nan
आना	வாருங்கள்	Nan
आने	வருகிறது	None
आनेवाली	வருகை	None
आन्तरिक	உள்	None
आन्दोलन	அசைவு	Nan
आन्ध्र	ஆந்திரா	None
आप	நீங்கள்	None
आनुवंशिक	மரபணு	None
आबाद	மனிதன்	None
आबू	அபு	Nan
आभास	இன்க்லிங்	Nan
आयाम	பரிமாணங்கள்	Nan
आयामी	பரிமாண	None
आयी	வந்தது	None
आयीं	வந்தது	None
आयुर्विज्ञान	மருத்துவ அறிவியல்	Nan
आयुर्वेद	ஆயுர்வேதம்	Nan
आयात	இறக்குமதி	None
आयुर्वेदिक	ஆயுர்வேத	Nan
आयेगा	வரும்	None
आयोग	கமிஷன்	Nan
आयोजक	அமைப்பாளர்	Nan
आयोजन	திட்டமிடல்	None
आयोजित	கட்டுப்பாட்டில்	None
आर	ஆர்	None
आये	வந்து சேர்ந்தது	Nan
आधे	பாதி	Nan
आया	அவர் வந்து	Nan
आयरलैंड	அயர்லாந்து	None
आभासी	மெய்நிகர்	Nan
आभूषण	நகைகள்	Nan
आम	மாங்கனி	Nan
आमंत्रण	அழைப்பிதழ்	Nan
आमंत्रित	அழைக்கப்பட்டார்	None
आमतौर	பொதுவாக	None
आयरिश	ஐரிஷ்	None
आमाशय	வயிறு	None
आमेर	அமர்	Nan
आय	வருமானம்	None
आयतन	தொகுதி	None
आयताकार	செவ்வக	Nan
आयतों	செவ்வகங்கள்	Nan
आयनीकृत	அயனியாக்கம்	Nan
आमिर	அமீர்	Nan
आधुनिकीकरण	நவீனமயமாக்கல்	Nan
आधुनिकतम	அதிநவீன	Nan
आधुनिक	நவீன	None
आज़ादी	சுதந்திரம்	None
आजादी	சுதந்திரம்	None
आजीवन	வாழ்நாள் முழுவதும்	Nan
आजीविका	வாழ்வாதாரம்	Nan
आटा	மாவு	Nan
आठ	எட்டு	None
आज़ाद	இலவசம்	Nan
आठवीं	எட்டாவது	None
आडवाणी	அத்வானி	Nan
आडियो	ஆடியோ	Nan
आणविक	மூலக்கூறு	None
आण्विक	மூலக்கூறு	None
आतंक	பயங்கரவாதம்	None
आतंकवाद	பயங்கரவாதம்	None
आठवें	எட்டாவது	None
आतंकवादी	பயங்கரவாதி	Nan
आजकल	இப்போதெல்லாம்	Nan
आच्छादित	மூடப்பட்ட	Nan
आखेट	விளையாட்டு	None
आख्यान	கதை	None
आग	நெருப்பு	None
आगंतुक	பார்வையாளர்	Nan
आगम	பெருக்குதல்	Nan
आगमन	வருகை	None
आज	இன்று	None
आगरा	ஆக்ரா	Nan
आगे	முன்னால்	None
आग्रह	கோரிக்கை	None
आघात	பக்கவாதம்	Nan
आचार	நெறிமுறைகள்	Nan
आचार्य	ஆசிரியர்	None
आचार्यों	ஆச்சார்யர்கள்	Nan
आगामी	வரவிருக்கும்	Nan
आरंभ	தொடங்கு	Nan
आता	வாருங்கள்	Nan
आते	வாருங்கள்	Nan
आदिकालीन	முதன்மையானது	Nan
आदित्य	ஆதித்யா	Nan
आदिनाथ	ஆதினாத்	Nan
आदिवासियों	பழங்குடியினர்	None
आदिवासी	பழங்குடி	None
आदेश	ஆர்டர்	Nan
आदिकाल	நேரம்	None
आदेशों	ஆர்டர்கள்	Nan
आधार	அடித்தளம்	Nan
आधारशिला	கார்னர்ஸ்டோன்	Nan
आधारित	அடிப்படையில்	None
आधिकारिक	அதிகாரப்பூர்வ	None
आधिपत्य	சுசெரண்டி	Nan
आधी	பாதி	Nan
आधा	பாதி	Nan
आती	வாருங்கள்	Nan
आदि	e.t.c.	Nan
आदान	உள்ளீடு	None
आत्म	சுய	None
आत्मकथा	சுயசரிதை	None
आत्मकल्याण	மன இறுக்கம்	Nan
आत्मसमर्पण	சரணடையுங்கள்	Nan
आत्मसात	ஒருங்கிணைத்தல்	Nan
आत्मा	ஆன்மா	None
आदानप्रदान	கொடுங்கள், எடுத்துக் கொள்ளுங்கள்	Nan
आत्माओं	ஆவிகள்	Nan
आदत	பழக்கம்	None
आदम	ஆடம்	Nan
आदमी	ஆண்	None
आदर	மரியாதை	None
आदर्श	ஏற்றதாக	Nan
आदर्शों	இலட்சியங்கள்	Nan
आत्‍मा	ஆத்மா	None
इन	இல்	None
आरंभिक	ஆரம்ப	None
आरक्षण	முன்பதிவு	Nan
इंसानों	மனிதர்கள்	None
इंसान	மனிதன்	None
इंद्रियों	உணர்வுகள்	None
इंद्रिय	உணர்வு	None
इंद्र	இந்திரன்	None
इंदौर	இந்தூர்	Nan
इंदर	இந்தர்	Nan
इंतजार	காத்திருக்கிறது	Nan
इंडोनेशिया	இந்தோனேசியா	None
इंडीज	இண்டீஸ்	Nan
इंडिया	இந்தியா	None
इंडियन	இந்தியன்	None
इंटेल	இன்டெல்	Nan
इंटरफेस	இடைமுகம்	None
इंटरनेशनल	சர்வதேச	None
इंटरनेट	இணையதளம்	None
इंटर	இன்டர்	Nan
आस्ट्रेलिया	ஆஸ்திரேலியா	None
आहार	டயட்	Nan
आह्वान	அழைப்பு	None
इंक	இன்க்.	Nan
इंकार	மறுப்பு	None
इंगित	சுட்டிக்காட்டப்பட்டது	Nan
इंसुलिन	இன்சுலின்	None
इंग्लिश	ஆங்கிலம்	Nan
इंग्लैण्ड	இங்கிலாந்து	None
इंच	அங்குலம்	Nan
इंजन	இயந்திரம்	None
इंजीनियर	பொறியாளர்	None
इंजीनियरिंग	பொறியியல்	None
इंजीनियरी	பொறியியல்	None
इंग्लैंड	இங்கிலாந்து	None
इंस्टाल	நிறுவு	Nan
इंस्टीट्यूट	நிறுவனம்	None
इंस्पेक्टर	இன்ஸ்பெக்டர்	Nan
इण्टरफेस	இடைமுகம்	None
इण्डिक	இந்திக்	Nan
इण्डिया	இந்தியா	None
इतना	இந்த அதிக	Nan
इतनी	மிகவும்	None
इतालवी	இத்தாலிய	None
इण्टर	இன்டர்	Nan
इति	இதி	Nan
इतिहासकार	வரலாற்றாசிரியர்	Nan
इतिहासकारों	வரலாற்றாசிரியர்கள்	Nan
इत्यादि	மற்றும் பல	Nan
इत्र	வாசனை	Nan
इथियोपिया	எத்தியோப்பியா	Nan
इथेन	ஈத்தேன்	Nan
इतिहास	வரலாறு	None
आसुमल	அஸ்முல்	Nan
इटावा	எட்டாவா	Nan
इटली	இத்தாலி	None
इकट्ठा	சேகரிக்கவும்	Nan
इकठ्ठा	கூடியது	None
इकाइयाँ	அலகுகள்	None
इकाइयों	அலகுகள்	None
इकाई	அலகு	None
इक्कीस	இருபத்து ஒன்று	Nan
इटालियन	இத்தாலிய	None
इक्कीसवीं	இருபது முதல்	Nan
इच्छा	ஆசை	None
इच्छाओं	வாழ்த்துக்கள்	Nan
इच्छित	ஆசை	None
इच्छुक	ஆசை	None
इजराइल	இஸ்ரேல்	None
इजरायल	இஸ்ரேல்	None
इक्ष्वाकु	இக்ஷ்வாகு	Nan
आसाम	அசாம்	None
आसानी	எளிதாக்கு	Nan
आसान	சுலபம்	Nan
आर्थर	ஆர்தர்	None
आर्थिक	பொருளாதாரம்	Nan
आर्द्र	ஈரப்பதம்	None
आर्द्रता	ஈரப்பதம்	None
आर्मी	இராணுவம்	None
आर्य	ஆர்யா	Nan
आर्डर	ஆர்டர்	Nan
आर्यावर्त	ஆரியவர்த்தா	Nan
आलम	ஆலம்	Nan
आलावा	தவிர	None
आलिकखान	ஆலிகன்	Nan
आलू	உருளைக்கிழங்கு	Nan
आलेख	கட்டுரை	None
आलोक	அலோக்	Nan
आर्यों	ஆரியர்கள்	Nan
आलोचक	விமர்சகர்	Nan
आर्ट्स	கலை	None
आर्कियोप्टेरिक्स	ஆர்க்கியோபடெரிக்ஸ்	Nan
आरक्षित	ஒதுக்கப்பட்டுள்ளது	Nan
आरटीआई	ஆர்டிஐ	Nan
आरती	ஆர்த்தி	Nan
आरम्भ	தொடங்கு	Nan
आरम्भिक	ஆரம்ப	None
आराधना	வழிபாடு	None
आर्ट	கலை	None
आराध्य	அபிமான	Nan
आरामदायक	வசதியானது	Nan
आरेख	வரைபடம்	None
आरोग्य	ஆரோக்கியம்	None
आरोप	பழி	Nan
आरोपों	குற்றச்சாட்டுகள்	Nan
आर्किमिडिज़	ஆர்க்கிமிடிஸ்	Nan
आराम	ஓய்வு	None
आरएसएस	ஆர்.எஸ்.எஸ்	Nan
आलोचकों	விமர்சகர்கள்	Nan
आलोचनाएँ	விமர்சனங்கள்	None
आशय	நோக்கம்	None
आशा	நம்பிக்கை	None
आशीर्वाद	ஆசீர்வாதம்	Nan
आशुतोष	அசுதோஷ்	Nan
आश्चर्यचकित	ஆச்சரியமாக இருக்கிறது	Nan
आश्चर्यजनक	அற்புதம்	Nan
आशंका	புரிதல்	Nan
आश्रम	ஹெர்மிடேஜ்	Nan
आश्वासन	உத்தரவாதம்	None
आश्विन	அஸ்வின்	Nan
आषाढ़	ஆஷாத்	Nan
आसन	தோரணை	Nan
आसपास	அருகில்	None
आसमान	வானம்	None
आश्रित	சார்ந்தது	None
आलोचना	திறனாய்வு	Nan
आवेदन	விண்ணப்பம்	Nan
आविष्कारक	கண்டுபிடிப்பாளர்	Nan
आलोचनात्मक	விமர்சன	Nan
आल्प्स	ஆல்ப்ஸ்	None
आवरण	கவர்	Nan
आवर्त	காலம்	None
आवश्यक	தேவை	None
आवश्यकता	தேவை	None
आवृत्ति	அதிர்வெண்	None
आवश्यकताओं	தேவைகள்	None
आवागमन	போக்குவரத்து	None
आवाज	குரல்	None
आवास	விடுதி	Nan
आवासीय	குடியிருப்பு	Nan
आविर्भाव	வெளிப்பாடு	None
आविष्कार	கண்டுபிடிப்பு	None
आवश्यक्ता	தேவை	None
‎में	இல்	None
गुरुद्वारे	குருத்வாரா	Nan
गुरू	குரு	None
धान	தானிய	Nan
धातुकर्म	உலோகம்	Nan
धातुओं	உலோகம்	Nan
धातु	உலோகம்	Nan
धागे	நூல்	None
धवन	தவான்	Nan
धर्मेन्द्र	தர்மேந்திரா	Nan
धर्मशास्त्र	இறையியல்	None
धर्मनिरपेक्ष	மதச்சார்பற்றது	Nan
धर्मग्रन्थ	வேதம்	None
धर्मग्रंथ	வேதம்	None
धर्मगुरु	மதத் தலைவர்	Nan
धर्म	மதம்	None
धरोहर	பாரம்பரியம்	None
धरातल	மேற்பரப்பு	Nan
धरा	தோல்விகள்	Nan
धरती	பூமி	None
द्वीपों	தீவுகள்	None
द्वेष	காழ்ப்புணர்ச்சி	Nan
द्वैत	இருமை	Nan
धक्के	பேங்	Nan
धड़	உடல்	None
धन	பணம்	None
धाम	தாம்	None
धनवान	பணக்கார	None
धनुष	வில்	None
धनुषटंकार	வில் டை	Nan
धन्यवाद	நன்றி	Nan
धब्बे	புள்ளிகள்	None
धमनियों	தமனிகள்	Nan
धम्म	தம்மம்	Nan
धनी	பணக்காரர்	Nan
धार	குஷ்	Nan
धारण	பிடி	None
धारणाएँ	அனுமானங்கள்	Nan
धोखे	மோசடி	Nan
धोना	கழுவ	Nan
धोनी	தோனி	Nan
धोने	கழுவும்	Nan
धौली	த ul லி	Nan
ध्यान	பராமரிப்பு	None
धोखा	மோசடி	Nan
ध्रुव	கம்பம்	Nan
ध्वज	கொடி	None
ध्वनि	ஒலி	None
ध्वनियाँ	ஒலிகள்	None
ध्वनियों	ஒலிக்கிறது	Nan
ध्वस्त	அழிக்கப்பட்டது	Nan
न	இல்லை	None
ध्रुवीय	துருவ	None
द्वीपसमूह	தீவுக்கூட்டம்	Nan
धैर्य	பொறுமை	Nan
धूल	தூசி	Nan
धारणाओं	அனுமானங்கள்	Nan
धारा	பிரிவு	None
धाराओं	நீரோடைகள்	Nan
धारावाहिक	சீரியல்	Nan
धीमी	மெதுவாக	None
धीरुभाई	திருப்பாய்	Nan
धृतराष्ट्र	த்ரிதராஷ்டிரா	Nan
धीरे	மெதுவாக	None
धुम्रपान	புகைத்தல்	Nan
धुरी	அச்சு	None
धुल	கழுவப்பட்டது	Nan
धूम	பாறை	None
धूमधाम	ஃபேன்ஃபேர்	Nan
धूम्रपान	புகைத்தல்	Nan
धुंध	மூடுபனி	Nan
द्वीप	தீவு	None
द्विवेदी	திவேதி	Nan
द्वितीयक	இரண்டாம் நிலை	Nan
देसाई	தேசாய்	Nan
देसी	தேசி	Nan
देह	உடல்	None
देहरादून	டெஹ்ராடூன்	Nan
देहली	சன்னல்	Nan
देहांत	இறப்பு	None
देशों	நாடுகள்	None
देहान्त	இறந்தவர்	Nan
दैत्यों	பேய்கள்	Nan
दैनन्दिनी	டைரி	Nan
दैनिक	தினசரி	None
दैवीय	தெய்வீக	None
दैहिक	சோமாடிக்	Nan
दो	இரண்டு	None
दैत्य	விகாரமானவன்	Nan
दोनो	இருவரும்	None
देशो	நாடுகள்	None
देशान्तर	தீர்க்கரேகை	Nan
देवकी	தேவகி	Nan
देवता	இறைவன்	None
देवताओं	கடவுள்கள்	None
देवनागरी	தேவநாகரி	Nan
देवराज	தேவ்ராஜ்	Nan
देवि	தேவி	None
देशी	பூர்வீகம்	Nan
देवी	தெய்வம்	None
देश	நாடு	None
देशभक्त	தேசபக்தர்	Nan
देशभक्ति	தேசபக்தி	Nan
देशभर	நாடு முழுவதும்	Nan
देशविदेश	வெளிநாடு	Nan
देशांतर	தீர்க்கரேகை	Nan
देवीदेवताओं	தேவர்களும் தெய்வங்களும்	Nan
नंद	நந்தா	None
दोनों	இருவரும்	None
दोबारा	மீண்டும்	None
द्रव्यमात्रा	நிறை	Nan
द्रव्यों	திரவங்கள்	Nan
द्रुत	விரைவு	None
द्रोण	துரோணர்	Nan
द्रोणाचार्य	துரோணாச்சார்யா	Nan
द्रोणी	பேசின்	Nan
द्रव	திரவ	None
द्रौपदी	திர ra பதி	Nan
द्वापर	த்வாபர்	Nan
द्वार	வாயில்	None
द्वारका	துவாரகா	Nan
द्वारिका	துவாரகா	Nan
द्विआधारी	பைனரி	Nan
द्वितीय	இரண்டாவது	None
द्वादश	த்வாதாஷ்	Nan
दोपहर	பிற்பகல்	Nan
द्योतक	சின்னம்	None
दौरे	சுற்றுலா	None
दोष	தவறு	None
दोषी	குற்ற உணர்வு	Nan
दोषों	குறைபாடுகள்	None
दोस्त	நண்பர்	Nan
दोस्ती	நட்பு	None
दोस्तों	நண்பர்கள்	None
दौलत	செல்வம்	None
दोहन	சுரண்டல்	Nan
दोहरे	இரட்டை	None
दोहा	தோஹா	Nan
दौड़	இனம்	None
दौर	சுற்று	None
दौरा	சுற்றுலா	None
दौरान	போது	None
दोहरी	இரட்டை	None
देव	இறைவன்	None
नंदन	நந்தன்	Nan
नंबर	எண்	None
नाम	பெயர்	None
नाभिकीय	அணு	None
नाभि	தொப்புள்	Nan
नापा	அளவிடப்படுகிறது	None
नाप	அளவீட்டு	None
नाना	தாய்வழி தாத்தா	Nan
नानक	நானக்	Nan
नाद	நாட்	Nan
नाथूराम	நாதுராம்	Nan
नाते	இருப்பது	None
नाडु	நாடு	None
नाट्यशास्त्र	நாடகவியல்	Nan
नाट्य	நாடக	None
नाटो	நேட்டோ	None
नाटकों	நாடகங்கள்	None
नाटककारों	நாடக ஆசிரியர்கள்	Nan
नाटककार	நாடக ஆசிரியர்	Nan
ना	இல்லை	None
नांसी	நான்சி	Nan
नाइजीरिया	நைஜீரியா	Nan
नाइट्रोजन	நைட்ரஜன்	None
नाक	மூக்கு	None
नाग	பாம்பு	None
नामक	என்று அழைக்கப்படுகிறது	Nan
नागपुर	நாக்பூர்	Nan
नागरिक	குடிமகன்	Nan
नागरिकता	குடியுரிமை	None
नागरिकों	குடிமக்கள்	None
नागरी	நகரி	Nan
नागार्जुन	நாகார்ஜுனா	Nan
नाटक	நாடகம்	None
नागर	சிவில்	Nan
नामकरण	பெயரிடுதல்	Nan
नाममात्र	பெயரளவு	None
नामांकन	பதிவு	Nan
नाव	படகு	None
नाविक	மாலுமி	Nan
नाश	அழிவு	None
नासा	நாசா	None
नासिक	நாசிக்	Nan
नासिर	நசீர்	Nan
नालन्दा	நாலந்தா	Nan
नास्तिक	நாத்திகர்	Nan
नि	இலவசம்	Nan
निःशुल्क	இலவசம்	Nan
निकट	நெருக்கமான	None
निकटतम	மிக நெருக்கமான	Nan
निकटता	அருகாமை	Nan
निकटवर्ती	அருகில்	None
नास्तिकता	நாத்திகம்	Nan
नहीं	இல்லை	None
नालंदा	நாலந்தா	Nan
नारीवाद	பெண்ணியம்	None
नामांकित	நியமனம்	None
नामित	நியமிக்கப்பட்டது	Nan
नामी	பிரபலமானது	None
नामों	பெயர்கள்	None
नामोत्पत्ति	நியமனம்	None
नायक	ஹீரோ	Nan
नार्वे	நோர்வே	Nan
नायडू	நாயுடு	None
नारंगी	ஆரஞ்சு	None
नारद	நாரத	Nan
नारा	கோஷம்	Nan
नाराज	கோபம்	None
नारायण	நாராயண்	Nan
नारी	பெண்	None
नायर	நாயர்	Nan
नही	இல்லை	None
नहर	கால்வாய்	None
नस्ल	இனம்	None
नतमस्तक	வில்	None
नतीजा	விளைவாக	None
नदियाँ	நதிகள்	None
नदियां	நதிகள்	None
नदियों	ஆறுகள்	None
नदी	நதி	None
नज़र	கண்	None
नन्द	நந்தா	None
नबी	நபி	None
नम	ஈரப்பதம்	None
नमः	ஓம் வணக்கத்துடன்	Nan
नमक	உப்பு	None
नमन	வாழ்த்து	None
नमस्कार	வணக்கம்	None
नन्दा	நந்தா	None
नमस्ते	வணக்கம்	None
नजर	பார்வை	None
नजदीक	அருகில்	None
नई	புதியது	Nan
नए	புதியது	Nan
नक़ल	நகலெடுக்கவும்	Nan
नकारात्मक	எதிர்மறை	None
नक्काशी	செதுக்குதல்	Nan
नक्शा	வரைபடம்	None
नजदीकी	அருகில்	None
नक्शे	வரைபடம்	None
नक्षत्रों	விண்மீன்கள்	None
नगर	டவுன்	Nan
नगरपालिका	நகராட்சி	None
नगरी	நகரம்	Nan
नगरीय	நகர்ப்புற	None
नगरों	நகரங்கள்	None
नक्षत्र	நட்சத்திரம்	None
नंदा	நந்தா	None
नमाज़	ஜெபம்	Nan
नमूना	மாதிரி	Nan
नवजात	புதிதாகப் பிறந்தவர்	Nan
नवपाषाण	கற்கால	Nan
नवम्बर	நவம்பர்	None
नवरत्नों	நவரத்னாஸ்	Nan
नवरात्रि	நவராத்திரி	Nan
नवरात्रोत्सव	நவராத்திரி திருவிழா	Nan
नवंबर	நவம்பர்	None
नवाचार	புதுமை	Nan
नवीं	ஒன்பதாவது	None
नवीन	சமீபத்தியது	Nan
नवीनतम	சமீபத்தியது	Nan
नवीनीकृत	புதுப்பிக்கப்பட்டது	Nan
नष्ट	அழிக்கப்பட்டது	Nan
नसीरुद्दीन	நசீருதீன்	Nan
नवाब	நவாப்	Nan
नमी	ஈரப்பதம்	None
नव	புதியது	Nan
नल	தட்டவும்	Nan
नमूने	மாதிரிகள்	None
नमूनों	மாதிரிகள்	None
नम्बर	எண்	None
नम्रता	சாந்தம்	Nan
नया	புதியது	Nan
नयी	புதியது	Nan
नलिकाओं	குழாய்கள்	None
नर	ஆண்	None
नरसंहार	படுகொலை	Nan
नरसिंह	நரசிம்ம	None
नरहरि	நரஹரி	Nan
नरेन्द्र	நரேந்திர	Nan
नरेश	நரேஷ்	Nan
नर्मदा	நர்மதா	Nan
नरक	நரகம்	Nan
निकल	அவுட்	Nan
देरी	தாமதம்	Nan
देने	கொடுப்பதற்கு	Nan
दलों	கட்சிகள்	None
दलितों	தலித்துகள்	Nan
दलित	தலித்	Nan
दलदली	மார்ஷி	Nan
दलदल	போக்	Nan
दर्शाया	சுட்டிக்காட்டப்பட்டது	Nan
दर्शाने	காண்பிக்க	Nan
दर्शाते	பிரதிபலிக்கவும்	Nan
दर्शाती	பிரதிபலிக்கிறது	Nan
दर्शाता	குறிக்கிறது	None
दर्शनों	காட்சிகள்	Nan
दर्शनीय	பார்க்கக்கூடியது	Nan
दर्शनशास्त्र	தத்துவம்	None
दर्शन	வருகை	None
दर्शक	பார்வையாளர்கள்	Nan
दर्पण	கண்ணாடி	None
दर्द	வலி	None
दयाल	தயால்	Nan
दयालु	இரக்கமுள்ள	Nan
दर	வீதம்	None
दरअसल	உண்மையில்	None
दरगाह	தர்கா	Nan
दरबार	நீதிமன்றம்	None
दवा	மருந்து	None
दरबारियों	நீதிமன்ற உறுப்பினர்கள்	Nan
दरभंगा	தர்பங்கா	Nan
दरवाजा	கதவு	None
दरवाजे	கதவுகள்	Nan
दरारें	விரிசல்	Nan
दर्ज	உள்ளிடவும்	Nan
दर्जे	தரம்	None
दरबारी	கோர்டியர்	Nan
दवाएं	மருந்துகள்	None
दवाओं	மருந்துகள்	None
दशकों	தசாப்தங்கள்	Nan
दांत	பற்கள்	Nan
दाईं	வலது	None
दाएँ	வலது	None
दाएं	வலது	None
दाखिल	சேர்க்கை	None
दाता	நன்கொடையாளர்	Nan
दाँत	பற்கள்	Nan
दाद	ரிங்வோர்ம்	Nan
दादा	தாத்தா	Nan
दान	நன்கொடை	Nan
दानव	பேய்	None
दानवों	பேய்கள்	Nan
दाने	தானிய	Nan
दानों	நன்கொடைகள்	Nan
दादरा	தாத்ரா	Nan
दयानन्द	தயானந்த்	Nan
दा	டா	None
दहन	எரிப்பு	Nan
दशमलव	தசம	Nan
दशमी	தசமி	Nan
दशरथ	தசரத	Nan
दशहरा	தசரா	Nan
दशहरे	தசரா	Nan
दशा	நிலை	None
दही	தயிர்	None
दस	பத்து	None
दसवें	பத்தாவது	Nan
दसों	பத்து	None
दस्त	வயிற்றுப்போக்கு	Nan
दस्तावेज	ஆவணம்	None
दस्तावेज़	ஆவணம்	None
दस्तावेजों	ஆவணங்கள்	None
दसवीं	பத்தாவது	Nan
दयानंद	தயானந்த்	Nan
दया	கருணை	None
दमन	தமன்	Nan
त्रिकोणमिति	முக்கோணவியல்	Nan
त्रिकोणमितीय	முக்கோணவியல்	Nan
त्रिज्या	ஆரம்	Nan
त्रिपाठी	திரிபாதி	Nan
त्रिपुरा	திரிபுரா	Nan
त्रिभुज	முக்கோணம்	None
त्रिकोण	முக்கோணம்	None
त्रिमूर्ति	திரித்துவம்	Nan
त्रिशूल	திரிசூலம்	Nan
त्रुटि	பிழை	Nan
त्रुटियां	பிழைகள்	None
त्रुटियों	பிழைகள்	None
त्वचा	தோல்	Nan
त्वरित	விரைந்து சென்றார்	Nan
त्रिवेदी	திரிவேதி	Nan
थ	வது	None
त्रिकुटा	திரிகுடா	Nan
त्यौहार	திருவிழா	None
तैयारी	தயாரிப்பு	None
तैरते	மிதப்பது	Nan
तो	அதனால்	None
तोड़	இடைவெளி	None
तोड़कर	உடைத்தல்	Nan
तोप	பீரங்கி	Nan
त्यौहारों	பண்டிகைகள்	Nan
तोमर	தோமர்	Nan
तोला	டோலா	Nan
तौर	என	Nan
त्याग	தியாகம்	Nan
त्यागपत्र	ராஜினாமா கடிதம்	Nan
त्यागी	சொலிடர்	Nan
त्योहारों	பண்டிகைகள்	Nan
तोरण	ஆர்ச்வே	Nan
दाब	அழுத்தம்	None
थकान	சோர்வு	Nan
थलसेना	இராணுவம்	None
दंत	பல்	None
दक्ष	திறமையானது	Nan
दक्षता	செயல்திறன்	None
दक्षिण	தெற்கு	None
दक्षिणपश्चिम	தென்மேற்கு	None
दक्षिणपूर्व	தென்கிழக்கு	None
दंड	ஒரு தண்டனை	Nan
दक्षिणी	தெற்கு	None
दत्त	தத்தா	Nan
दत्तात्रेय	தத்தாத்ரேயா	Nan
दफन	அடக்கம்	None
दबा	அடக்கப்பட்டது	Nan
दबाव	அழுத்தம்	None
दम	சக்தி	None
दण्ड	தண்டனை	None
थल	நில	None
द	தி	None
थोड़े	சில	None
थाई	தாய்	None
थाईलैंड	தாய்லாந்து	None
थार	தார்	Nan
थाली	தட்டு	None
थियेटर	திரையரங்கம்	Nan
थी	இருந்தது	None
थोथ	தோத்	Nan
थीं	இருந்தன	None
थेरेपी	சிகிச்சை	None
थैली	பை	None
थॉमस	தாமஸ்	None
थोक	மொத்தமாக	None
थोड़ा	சிறிய	None
थोड़ी	சிறிய	None
थे	இருந்தன	None
देर	தாமதமாக	Nan
दाम	விலை	None
दायर	தாக்கல் செய்யப்பட்டது	Nan
दूरसंचार	தொலை தொடர்பு	Nan
दूरदूर	தொலைவில்	None
दूरदर्शी	தொலைநோக்கு	Nan
दूरदर्शन	தூர்தர்ஷன்	Nan
दूर	தொலைவில்	None
दूध	பால்	None
दूत	தூதர்	None
दूँगा	தருவார்	Nan
दुसरे	மற்றவைகள்	Nan
दुष्टों	தீமை	Nan
दुष्ट	தீமை	Nan
दुश्मनों	எதிரிகள்	None
दुश्मनी	விரோதம்	Nan
दुश्मन	எதிரி	Nan
दुर्वासा	துர்வாச	Nan
दुर्लभ	அரிதானது	Nan
दुर्योधन	துரியோதனன்	Nan
दुकानों	கடைகள்	Nan
दुख	துக்கம்	None
दुखी	சோகம்	Nan
दुग्ध	பால்	None
दुनिया	உலகம்	None
दुबई	துபாய்	None
दूरस्थ	தொலைதூர	Nan
दुबारा	மீண்டும்	None
दुर्गम	அணுக முடியாதது	Nan
दुर्गा	துர்கா	Nan
दुर्गों	கோட்டைகள்	Nan
दुर्घटना	விபத்து	None
दुर्दम	டர்ட்	Nan
दुर्बलता	பலவீனம்	Nan
दुर्ग	துர்க்	Nan
दूरी	தூரம்	None
दूषित	சிதைந்தது	Nan
दूसरा	இரண்டாவது	None
देखिए	பார்	None
देखिये	பார்	None
देखी	பார்த்தேன்	Nan
देखे	பார்	None
देखें	பார்	None
देखो	பார்	None
देखा	பார்த்தேன்	Nan
देग	டெக்	Nan
देगी	தருவார்	Nan
देता	தருகிறது	None
देती	தருகிறது	None
देते	கொடுப்பது	None
देना	கொடுங்கள்	Nan
देनी	கொடுங்கள்	Nan
देगा	தருவார்	Nan
दुकानें	கடைகள்	Nan
देखभाल	பராமரிப்பு	None
देखना	பார்க்க	None
दूसरों	மற்றவர்கள்	None
दृढ	தீர்மானிக்கப்பட்டது	Nan
दृढ़ता	உறுதியானது	Nan
दृश्य	காண்க	None
दृष्टि	பார்வை	None
दृष्टिकोण	பார்வை	None
देखने	பார்க்க	None
दृष्टिकोणों	அணுகுமுறைகள்	None
दें	கொடுங்கள்	Nan
देकर	கொடுப்பதன் மூலம்	Nan
देख	பார்	None
देखकर	பார்த்த பிறகு	Nan
देखता	பார்க்கிறது	Nan
देखते	பார்	None
दे	கொடுங்கள்	Nan
दुकान	கடை	Nan
दुःखी	சோகம்	Nan
दुःख	துக்கம்	None
दिखाता	நிகழ்ச்சிகள்	Nan
दिखाते	காண்பிக்கிறது	Nan
दिखाना	காண்பிக்க	Nan
दिखाने	காட்டு	None
दिखाया	காட்டப்பட்டுள்ளது	None
दिखायी	காட்டப்பட்டுள்ளது	None
दिखाई	தெரியும்	None
दिग्विजय	திக்விஜய்	Nan
दिन	நாள்	None
दिनकर	சூரியன்	None
दिनांक	தேதி	None
दिनों	நாட்கள்	None
दिमागी	மனம்	None
दिया	கொடுத்தார்	None
दिति	திதி	Nan
दिया|	கொடுத்தார்	None
दिखा	காண்பிக்கிறது	Nan
दिखने	தெரியும்	None
दायरे	நோக்கம்	Nan
दायें	வலது	None
दार्शनिक	தத்துவஞானி	Nan
दावत	விருந்து	None
दावा	உரிமைகோரல்	Nan
दावे	கூற்றுக்கள்	Nan
दिखलाई	காட்டப்பட்டுள்ளது	None
दास	அடிமை	None
दाहिनी	வலது	None
दाहिने	சரி	None
दि	நாள்	None
दिए	விளக்குகள்	Nan
दिखता	தெரிகிறது	None
दिखती	தெரியும்	None
दासी	பணிப்பெண்	Nan
दामोदर	தாமோதர்	Nan
दिये	கொடுக்கப்பட்டுள்ளது	None
दिलचस्पी	ஆர்வம்	None
दीपक	விளக்கு	None
दीपावली	தீபாவளி	None
दीर्घ	நீண்டது	Nan
दीर्घकालिक	நீண்ட கால	Nan
दीर्घकालीन	நீண்ட கால	Nan
दीर्घा	கேலரி	Nan
दीप	ஆழமான	Nan
दीर्घायु	நீண்ட ஆயுள்	Nan
दीवान	அமைச்சர்	None
दीवाना	பைத்தியம்	Nan
दीवानी	பைத்தியம்	Nan
दीवार	சுவர்	None
दीवारें	சுவர்கள்	None
दीवाली	தீபாவளி	None
दीव	டியு	Nan
दिल	இதயம்	None
दीन	தீன்	None
दीक्षा	தீட்சை	Nan
दिलाई	நிர்வகிக்கப்படுகிறது	Nan
दिलाने	கட்டவிழ்த்து விட	Nan
दिलीप	திலீப்	Nan
दिलों	இதயங்கள்	Nan
दिल्ली	டெல்லி	None
दिल्‍ली	டெல்லி	None
दीक्षित	தீட்சித்	Nan
दिवस	நாள்	None
दिव्य	தெய்வீக	None
दिशा	திசை	None
दिशाओं	திசைகள்	Nan
दिसंबर	டிசம்பர்	Nan
दिसम्बर	டிசம்பர்	Nan
दी	கொடுக்கப்பட்டுள்ளது	None
दिवसीय	நாள்	None
तैयार	தயார்	None
निकलकर	விட்டு	None
निकलती	வெளிவருகிறது	None
परियोजनाओं	திட்டங்கள்	None
परियोजना	பணி அல்லது திட்டம்	Nan
परिमाण	அளவு	None
परिभाषित	வரையறுக்கப்பட்டுள்ளது	Nan
परिभाषाएँ	வரையறைகள்	None
परिभाषा	வரையறை	None
परिपूर्ण	முழுமையான	None
परिपथ	சுற்று	None
परिपक्व	முதிர்ந்த	None
परिधि	சுற்றளவு	None
परिदृश्य	நிலப்பரப்பு	None
परित्याग	கைவிடுதல்	Nan
परिणामों	முடிவுகள்	None
परिणामस्वरूप	இதன் விளைவாக	Nan
परिणत	உருமாற்றம்	None
परिचित	தெரிந்தவர்	Nan
परिचालन	இயங்குகிறது	None
पराक्रमी	வல்லமை	None
पराग	மகரந்தம்	None
परागण	மகரந்தச் சேர்க்கை	Nan
परागन	மகரந்தச் சேர்க்கை	Nan
पराजय	தோல்வி	None
पराजित	தோற்கடிக்கப்பட்டது	Nan
परिलक्षित	பிரதிபலித்தது	Nan
पराबैंगनी	புற ஊதா	Nan
परास्त	தூக்கி எறியப்பட்டது	Nan
परिकल्पना	கருதுகோள்	None
परिक्रमा	சுற்றறிக்கை	Nan
परिक्षण	சோதனை	None
परिचय	அறிமுகம்	None
परिचायक	அடையாளம் காணுதல்	Nan
परामर्श	ஆலோசனை	None
परिवर्तक	மாற்றி	None
परिवर्तन	மாற்றம்	None
परिवर्तनशील	மாறி	None
पर्ची	சீட்டு	Nan
पर्णपाती	இலையுதிர்	None
पर्दाफाश	சிதைந்தது	Nan
पर्दे	திரைச்சீலைகள்	Nan
पर्यटक	சுற்றுலா	None
पर्यटकों	சுற்றுலாப் பயணிகள்	Nan
परोक्ष	மறைமுக	None
पर्यटन	சுற்றுலா	None
पर्यवेक्षण	மேற்பார்வை	Nan
पर्याप्त	போதும்	Nan
पर्याय	ஒத்த பெயர்	Nan
पर्यावरण	சூழல்	None
पर्यावरणीय	சுற்றுச்சூழல்	None
पर्व	திருவிழா	None
पर्यवेक्षक	மேற்பார்வையாளர்	Nan
पराक्रम	தைரியம்	Nan
परेशान	கவலைப்படுகிறார்	Nan
परीक्षित	சோதிக்கப்பட்டது	Nan
परिवर्तनों	மாற்றங்கள்	None
परिवर्तित	மாற்றப்பட்டது	None
परिवर्ती	மாறி	None
परिवहन	போக்குவரத்து	None
परिवारों	குடும்பங்கள்	Nan
परिवेश	சுற்றுச்சூழல்	None
परे	அப்பால்	Nan
परिश्रम	கடின உழைப்பு	Nan
परिष्कृत	அதிநவீன	Nan
परिस्थिति	நிலைமை	None
परिस्थितियों	சூழ்நிலைகள்	None
परीक्षण	சோதனை	None
परीक्षणों	சோதனைகள்	Nan
परीक्षा	தேர்வு	Nan
परिषद	சபை	None
पराकाष्ठा	உச்சம்	Nan
परस्पर	பரஸ்பரம்	Nan
परसाई	பார்சாய்	Nan
पथ	பாதை	None
पद	அஞ்சல்	Nan
पदक	பதக்கம்	Nan
पदानुक्रम	படிநிலை	None
पदार्थ	விஷயம்	Nan
पदार्थो	பொருட்கள்	None
पत्रों	கடிதங்கள்	Nan
पदार्थों	பொருட்கள்	None
पद्धति	முறை	None
पद्धतियाँ	முறைகள்	None
पद्धतियों	முறைகள்	None
पद्म	பத்மா	Nan
पद्य	வசனம்	Nan
पध्दति	முறை	None
पदों	பதிவுகள்	None
पनीर	பாலாடைக்கட்டி	Nan
पत्रिकाओं	பத்திரிகைகள்	None
पत्रिका	பத்திரிகை	None
पत्तन	துறைமுகம்	None
पत्तियाँ	இலைகள்	None
पत्तियों	இலைகள்	None
पत्ती	இலை	None
पत्ते	இலைகள்	None
पत्तों	இலைகள்	None
पत्रिकाएँ	இதழ்கள்	None
पत्थर	கல்	None
पत्नी	மனைவி	None
पत्र	கடிதம்	None
पत्रकार	பத்திரிகையாளர்	Nan
पत्रकारिता	பத்திரிகை	None
पत्रपत्रिकाओं	துண்டு பிரசுரங்கள்	Nan
पत्राचार	கடித தொடர்பு	Nan
पत्थरों	கற்கள்	None
पर्वतमाला	வரம்புகள்	Nan
पन्द्रह	பதினைந்து	Nan
पन्ने	பக்கங்கள்	None
परमहंस	பரமஹன்ச	Nan
परमाणु	ஆட்டம்	None
परमाणुओं	அணுக்கள்	None
परमात्मा	தெய்வீக	None
परमेश्वर	இறைவன்	None
परम्परा	பாரம்பரியம்	None
परम	இறுதி	None
परम्परागत	பாரம்பரியமானது	Nan
परलोक	மற்ற உலகம்	Nan
परवरिश	வளர்ப்பது	Nan
परवर्ती	பிந்தையது	Nan
परवाह	பராமரிப்பு	None
परशुराम	பரசுராம்	Nan
परशुरामजी	பரசுராமாஜி	Nan
परली	பார்லி	Nan
पन्ना	பக்கம்	None
परब्रह्म	பராபிராம்	Nan
परदे	திரை	None
पन्नों	பக்கங்கள்	None
पपड़ी	மேல் ஓடு	Nan
पब्लिक	பொது	None
पम्प	பம்ப்	Nan
पर	ஆன்	None
परंपरा	பாரம்பரியம்	None
परन्तु	ஆனாலும்	None
परंपराएँ	மரபுகள்	None
परंपराओं	மரபுகள்	None
परंपरागत	பாரம்பரியமானது	Nan
परक	சோதனை	None
परजीवी	ஒட்டுண்ணி	Nan
परत	அடுக்கு	None
परतों	அடுக்குகள்	None
परंपराएं	மரபுகள்	None
पति	கணவர்	None
पर्वतीय	மலை	None
पर्वों	விருந்து	None
पाम	பனை	None
पापों	பாவங்கள்	Nan
पापी	பாவி	Nan
पाने	பெறு	Nan
पानीपत	பானிபட்	Nan
पानी	தண்ணீர்	None
पाना	குறடு	Nan
पान	பான்	Nan
पादरियों	பூசாரிகள்	Nan
पादप	ஆலை	None
पाद	குசு	Nan
पात्रों	கதாபாத்திரங்கள்	Nan
पात्र	பாத்திரம்	None
पाते	கண்டுபிடி	Nan
पाती	பெறு	Nan
पाताल	நரகம்	Nan
पाण्डेय	பாண்டே	Nan
पाटन	பாடன்	Nan
पाटलिपुत्र	பாட்னா	Nan
पाटिल	பாட்டீல்	Nan
पाठ	உரை	None
पाठक	வாசகர்	None
पाठकों	வாசகர்கள்	None
पायलट	பைலட்	Nan
पाठशाला	பள்ளி	None
पाठ्यक्रम	பாடத்திட்டங்கள்	Nan
पाणिनि	பாணினி	Nan
पाण्डव	பாண்டவா	Nan
पाण्डवों	பாண்டவர்கள்	Nan
पाण्डु	பாண்டு	Nan
पाण्डे	பாண்டே	Nan
पाठ्य	உரை	None
पाया	பெற்றுள்ளேன்	Nan
पायी	கண்டறியப்பட்டது	Nan
पाये	பெறு	Nan
पार्श्व	பக்க	None
पार्श्वगायन	பின்னணி பாடல்	Nan
पाल	பால்	None
पालतू	செல்லம்	Nan
पालन	கீழ்ப்படிதல்	Nan
पालनपोषण	வளர்ப்பு	None
पार्वती	பார்வதி	None
पालने	தொட்டில்	None
पालिका	பாலிகா	Nan
पावन	புனித	Nan
पावर	சக்தி	None
पाश्चात्य	மேற்கு	None
पाषाण	கல்	None
पास्का	பாஸ்கா	Nan
पाला	கவனிக்கப்பட்டு	Nan
पागल	பைத்தியம்	Nan
पार्थिव	பூமி	None
पार्टियों	கட்சிகள்	None
पार	அப்பால்	Nan
पारंपरिक	பாரம்பரியமானது	Nan
पारदर्शी	ஒளி புகும்	Nan
पारम्परिक	பாரம்பரியமானது	Nan
पारसी	பார்சியா	Nan
पारस्परिक	பரஸ்பர	Nan
पार्टी	கட்சி	None
पाराशर	பராஷர்	Nan
पारिवारिक	குடும்பம்	None
पारिस्थितिक	சுற்றுச்சூழல்	None
पारिस्थितिकी	சூழலியல்	None
पारी	ஷிப்ட்	Nan
पार्क	பூங்கா	None
पार्टनर	பங்குதாரர்	Nan
पारित	தேர்ச்சி பெற்றது	Nan
पाक्षिक	பதினைந்து	Nan
पाकिस्तानी	பாகிஸ்தான்	None
पाकिस्तान	பாகிஸ்தான்	None
पहचानने	அடையாளம் காணக்கூடியது	Nan
पहचाना	அங்கீகரிக்கப்பட்டது	Nan
पहचाने	அங்கீகரிக்கப்பட்டது	Nan
पहनते	அணியுங்கள்	Nan
पहनने	அணியுங்கள்	Nan
पहना	அணிந்திருந்தது	Nan
पहचान	அடையாளம் கண்டு கொள்	Nan
पहने	அணியுங்கள்	Nan
पहलगाम	பஹல்கம்	Nan
पहला	முதலாவதாக	None
पहली	முதலில்	None
पहलुओं	அம்சங்கள்	Nan
पहलू	அம்சம்	None
पहले	முதல்	None
पहल	முன்முயற்சி	Nan
पहाड़	மலை	None
पसन्द	பிடிக்கும்	Nan
पश्‍चिम	மேற்கு நோக்கி	Nan
पर्सनल	தனிப்பட்ட	None
पवन	காற்று	None
पवन-वेग-मापी	காற்றாலை	Nan
पवित्रतम	புனிதமான	None
पवित्रता	தூய்மை	None
पशु	விலங்கு	None
पसंदीदा	பிடித்தது	None
पशुओं	விலங்குகள்	None
पशुपालन	கால்நடை வளர்ப்பு	Nan
पश्चात	பிறகு	None
पश्चाताप	மனஉளைவு	Nan
पश्चात्	பிறகு	None
पश्चिम	மேற்கு	None
पश्चिमी	மேற்கு	None
पशुधन	கால்நடைகள்	Nan
पर्वत्	விருந்து நாள்	Nan
पहाड़ियों	மலைகள்	None
पहाड़ों	மலைகள்	None
पाँव	அடி	None
पांच	ஐந்து	None
पांचवीं	ஐந்தாவது	Nan
पांचवें	ஐந்தாவது	Nan
पांचों	ஐந்து பேரும்	Nan
पांडव	பாண்டவா	Nan
पाँच	ஐந்து	None
पांडे	பாண்டே	Nan
पांवों	அடி	None
पाइरूविक	பைருவிக்	Nan
पाई	பை	None
पाए	பெறு	Nan
पाक	சுத்தமான	None
पाकर	கிடைத்த பிறகு	Nan
पांव	பாதங்கள்	Nan
पहाड़ी	மலை	None
पा	பா	Nan
पहुंचाने	வழங்குங்கள்	Nan
पहिए	சக்கரங்கள்	Nan
पहुँच	அணுகல்	None
पहुँचकर	அடைந்த பிறகு	Nan
पहुँचता	அடையும்	None
पहुँचती	அடையும்	None
पहुँचते	அடையும்	None
पहुंची	வந்து சேர்ந்தது	Nan
पहुँचने	அடைய	None
पहुँचाने	வழங்க	None
पहुँची	அடைந்தது	None
पहुँचे	வந்து சேர்ந்தது	Nan
पहुंच	அணுகல்	None
पहुंचते	அடையும்	None
पहुंचा	வரை அடைந்தது	Nan
पहुँचा	அடைந்தது	None
निकलता	உருவாகிறது	None
पता	முகவரி	None
पतली	மெல்லிய	None
निर्माता	உருவாக்கியவர்	Nan
निर्माणाधीन	கட்டுமானத்தில் உள்ளது	Nan
निर्माण	கட்டுமானம்	None
निर्मल	மென்மையான	None
निर्भरता	சார்பு	None
निर्भर	சார்பு	None
निर्बल	பலவீனமான	Nan
निर्धारित	தீர்மானிக்கப்பட்டது	Nan
निर्धारण	உறுதியை	Nan
निर्धारक	தீர்மானித்தல்	Nan
निर्धन	ஏழை	None
निर्देशों	வழிமுறைகளை	None
निर्देशो	வழிமுறைகள்	None
निर्देशित	இயக்கியது	Nan
निर्देशिका	அடைவு	Nan
निर्देशांक	ஒருங்கிணைத்தல்	Nan
निर्देशन	திசையில்	None
निराकार	உருவமற்றது	Nan
निराला	தனித்துவமான	None
निराश	ஏமாற்றம்	Nan
निराशा	விரக்தி	Nan
निरीक्षण	ஆய்வு	None
निरुक्त	இலவசம்	Nan
निर्माताओं	உற்பத்தியாளர்கள்	Nan
निरूपित	குறிக்கவும்	Nan
निरोध	கருத்தடை	None
निर्गुण	நிர்கன்	Nan
निर्णायक	தீர்க்கமான	Nan
निर्दिष्ट	குறிப்பிடப்பட்டுள்ளது	None
निर्देश	வழிமுறைகள்	None
निर्देशक	இயக்குனர்	None
निरोग	ஆரோக்கியமான	None
निर्यात	ஏற்றுமதி	None
निर्वाचन	தேர்தல்	Nan
निर्वाचित	தேர்ந்தெடுக்கப்பட்டவர்	Nan
निषेचन	கருத்தரித்தல்	Nan
निषेचित	கருவுற்றது	Nan
निषेध	தடை	None
निष्कर्ष	முடிவு	None
निष्कर्षों	கண்டுபிடிப்புகள்	None
निष्क्रिय	செயலற்றது	Nan
निषिद्ध	தடைசெய்யப்பட்டுள்ளது	Nan
निष्पक्ष	நடுநிலை	None
निष्पादित	செயல்படுத்தப்பட்டது	Nan
निसंदेह	நிச்சயமாக	Nan
निहित	உள்ளடக்கியது	None
नींद	தூங்கு	Nan
नींव	அஸ்திவாரம்	Nan
नीच	குறைந்த	None
निष्पादन	செயல்திறன்	None
निरन्तर	தொடர்ந்து	None
निषाद	நிஷாத்	Nan
निश्चय	உறுதிப்பாடு	Nan
निर्वाण	நிர்வாணம்	None
निर्वासित	நாடுகடத்தப்பட்டார்	Nan
निर्वाह	உயிர்வாழ்வு	Nan
निर्विकार	அர்த்தமற்றது	Nan
निर्विवाद	மறுக்கமுடியாதது	Nan
निवारण	தடுப்பு	None
निश्चित	சரி செய்யப்பட்டது	Nan
निवास	குடியிருப்பு	Nan
निवासी	குடியிருப்பாளர்	Nan
निवेदन	கோரிக்கை	None
निवेश	முதலீடு	None
निशान	குறி	None
निशाना	இலக்கு	None
निशुल्क	இலவசம்	Nan
निवासियों	குடியிருப்பாளர்கள்	Nan
निरंतरता	தொடர்ச்சி	None
निरंतर	தொடர்ச்சியான	Nan
निरंकार	நிரங்கர்	Nan
निक्षेप	வைப்பு	Nan
निगम	கார்ப்பரேஷன்	Nan
निगरानी	கண்காணிப்பு	None
निचला	கீழ்	None
निचली	கீழ்	None
निचले	கீழ்	None
निकोलस	நிக்கோலஸ்	Nan
निज़ाम	நிஜாம்	Nan
निजामुद्दीन	நிஜாமுதீன்	Nan
निजी	தனியார்	None
निडारिया	நிடாரியா	Nan
नितांत	முற்றிலும்	None
नित्य	எப்போதும்	None
निदान	நோயறிதல்	Nan
निजाम	நிஜாம்	Nan
निदेशक	இயக்குனர்	None
निकोबार	நிக்கோபார்	None
निकास	வெளியேறுதல்	Nan
निकलते	படி படியாக	Nan
निकलने	வெளியேறுதல்	Nan
निकला	அவுட்	Nan
निकली	வெளியே வந்தது	Nan
निकले	வெளியே வந்தது	Nan
निकायों	உடல்கள்	Nan
निकासी	அனுமதி	None
निकाल	அகற்று	Nan
निकालते	நீக்க	None
निकालना	அகற்றுதல்	Nan
निकालने	பிரித்தெடுத்தல்	Nan
निकाला	அகற்றப்பட்டது	Nan
निकाली	அகற்றப்பட்டது	Nan
निकाले	அகற்று	Nan
निकालकर	அகற்றுவதன் மூலம்	Nan
नीचा	குறைந்த	None
निद्रा	தூங்கு	Nan
निधि	நிதி	None
नियंत्रक	கட்டுப்படுத்தி	None
नियंत्रण	கட்டுப்பாடு	None
नियंत्रित	கட்டுப்படுத்தப்பட்டது	Nan
नियत	சரி செய்யப்பட்டது	Nan
नियति	விதி	None
नियन्त्रण	கட்டுப்பாடு	None
निम्नानुसार	பின்வருமாறு	None
नियम	விதி	None
नियमों	விதிகள்	None
नियामक	சீராக்கி	Nan
नियुक्त	நியமிக்கப்பட்ட	Nan
नियुक्ति	நியமனம்	None
नियोजन	திட்டமிடல்	None
नियोजित	வேலை	None
नियमित	வழக்கமான	None
निधन	இறப்பு	None
निम्नलिखित	தொடர்ந்து	None
निमित्त	நோக்கத்திற்காக	Nan
निपटने	கையாளுதல்	Nan
निपुण	சரியானது	Nan
निबंध	கட்டுரை	None
निबंधकार	கட்டுரையாளர்	Nan
निबंधों	கட்டுரைகள்	None
निभा	நிறைவேற்று	Nan
निमोनिया	நிமோனியா	Nan
निभाई	உடன்	None
निभाते	நாடகங்கள்	None
निभाने	நிறைவேற்றுங்கள்	Nan
निभाया	வைத்திருந்தார்	Nan
निभायी	வைத்திருந்தார்	Nan
निमंत्रण	அழைப்பிதழ்	Nan
निमाड़	நிமர்	Nan
निभाता	நாடகங்கள்	None
पतले	மெல்லிய	None
नीचे	கீழே	None
नीतियाँ	கொள்கைகள்	Nan
पटकथा	ஸ்கிரிப்ட்	None
पचास	ஐம்பது	None
पग	படி	None
पक्षों	பக்கங்களும்	Nan
पक्षी	பறவை	None
पक्षियों	பறவைகள்	None
पक्षपात	பகுதி	Nan
पक्ष	பக்க	None
पक्के	நிச்சயம்	Nan
पक्की	உறுதி	None
पकवान	டிஷ்	Nan
पकड़े	பிடி	None
पकड़ने	பிடி	None
पकड़ना	பிடிக்க	None
पकड़	பிடி	None
पंद्रह	பதினைந்து	Nan
पंथ	வழிபாட்டு	Nan
पंचम	ஐந்தாவது	Nan
पंचमी	பஞ்சமி	Nan
पंचवटी	பஞ்சவதி	Nan
पंचांग	பஞ்சாங்கம்	None
पंचायत	நடுவர்	Nan
पंचायती	பஞ்சாயத்து	Nan
पटना	பாட்னா	Nan
पंचायतों	பஞ்சாயத்துகள்	Nan
पंजाबी	பஞ்சாபி	None
पंजीकरण	பதிவு	Nan
पंजीकृत	பதிவு செய்யப்பட்டுள்ளது	Nan
पंडित	அறிஞர்	None
पंत	பந்த்	Nan
पंतनगर	பன்ட்நகர்	Nan
पंजाब	பஞ்சாப்	None
पटियाला	பாட்டியாலா	Nan
पटेल	படேல்	Nan
पट्टी	ஆடை அவிழ்ப்பு	Nan
पडा	இருந்தது	None
पढने	படி	None
पढ़	படி	None
पढ़ते	படி	None
पढ़ना	படித்தல்	Nan
पढ़ने	படி	None
पड़ोसी	அண்டை வீட்டுக்காரர்கள்	Nan
पढ़ा	படி	None
पढ़े	படி	None
पढ़ें	படி	None
पढाई	படிப்பு	None
पण्डित	அறிஞர்	None
पतंजलि	பதஞ்சலி	Nan
पतन	வீழ்ச்சி	None
पढ़ाई	ஆய்வுகள்	None
पंचतंत्र	பஞ்சதந்திரம்	Nan
पड़ेगी	விழும்	None
पड़े	பொய்	Nan
पठन	படித்தல்	Nan
पठार	பீடபூமி	Nan
पठारी	பீடபூமி	Nan
पड	திண்டு	Nan
पडता	படித்தல்	Nan
पडती	வீழ்ச்சி	None
पड़ेगा	இருக்கும்	None
पड़	வீழ்ச்சி	None
पड़ती	வீழ்ச்சி	None
पड़ते	வீழ்ச்சி	None
पड़ने	வீழ்ச்சி	None
पड़ा	பொய்	Nan
पड़ाव	நிறுத்து	Nan
पड़ी	பொய்	Nan
पड़ता	நீர்வீழ்ச்சி	Nan
पंच	பஞ்ச்	Nan
पंख	சாரி	None
पंक्तियों	வரிசைகள்	Nan
नेता	தலைவர்	None
नेताओं	தலைவர்கள்	None
नेताजी	நேதாஜி	Nan
नेतृत्व	தலைமைத்துவம்	Nan
नेत्र	கண்	None
नेपाल	நேபாளம்	None
नेटस्केप	நெட்ஸ்கேப்	None
नेपाली	நேபாளி	Nan
नेल्सन	நெல்சன்	Nan
नेविगेशन	வழிசெலுத்தல்	Nan
नेहरु	நேரு	None
नैतिक	ஒழுக்கம்	None
नैतिकता	ஒழுக்கம்	None
नैदानिक	நோய் கண்டறிதல்	Nan
नेपोलियन	நெப்போலியன்	None
नैना	நைனா	Nan
नेटवर्किंग	நெட்வொர்க்கிங்	Nan
नेकर	நெக்கர்	Nan
नीतियों	கொள்கைகள்	Nan
नीदरलैंड	நெதர்லாந்து	None
नीम	ஆசாதிராச்ச்தா இண்டிகா	Nan
नील	நீலம்	None
नीलगिरी	யூகலிப்டஸ்	Nan
नीला	நீலம்	None
नेटवर्क	வலைப்பின்னல்	Nan
नीले	நீலம்	None
नुक्सान	சேதம்	None
नृतत्व	நடனம்	None
नृत्य	நடனம்	None
नृविज्ञान	மானுடவியல்	Nan
नृसिंह	நரசிங்	Nan
नें	தி	None
नुकसान	இழப்பு	None
नीति	கொள்கை	None
नैनी	ஆயா	Nan
नैनो	நானோ	None
न्यायालय	நீதிமன்றம்	None
न्यायालयों	நீதிமன்றங்கள்	Nan
न्यायिक	நீதித்துறை	None
न्यू	புதியது	Nan
न्यूज़	செய்தி	None
न्यूजीलैंड	நியூசிலாந்து	None
न्यायाधीश	நீதிபதி	None
न्यूटन	நியூட்டன்	None
न्यूट्रॉन	நியூட்ரான்	Nan
न्यूनतम	குறைந்தபட்சம்	None
न्यूयॉर्क	நியூயார்க்	None
पं	பண்டிட்	None
पंकज	பங்கஜ்	Nan
पंक्ति	வரி	None
न्यूट्रान	நியூட்ரான்	Nan
नैनीताल	நைனிடால்	Nan
न्यायपालिका	நீதித்துறை	None
न्याय	நீதி	None
नॉर्वे	நோர்வே	Nan
नॉस्डेक	நோஸ்டெக்	Nan
नो	இல்லை	None
नोट	குறிப்பு	None
नोट्स	குறிப்புகள்	None
नोबल	உன்னத	Nan
न्यायधीशों	நீதிபதிகள்	None
नौ	ஒன்பது	None
नौकरी	வேலை	None
नौका	படகு	None
नौटियाल	ந auti டியால்	Nan
नौवल	கடற்படை	None
नौसेना	கடற்படை	None
न्यागत	பகிர்ந்தளித்தது	Nan
नौकरियों	வேலைகள்	None
गुरुवार	வியாழக்கிழமை	Nan
तैनात	வெளியிடப்பட்டது	None
तेलुगु	தெலுங்கு	None
छवियों	படங்கள்	Nan
छवि	புகைப்படம்	None
छल्ले	மோதிரங்கள்	Nan
छन्द	வசனம்	Nan
छत्रपति	சத்ரபதி	Nan
छत्तीसगढ़ी	சத்தீஸ்கரி	Nan
छत्तीसगढ़	சத்தீஸ்கர்	Nan
छत्तीसगढ	சத்தீஸ்கர்	Nan
छत	கூரை	None
छड़ी	குச்சி	Nan
छठे	ஆறாவது	None
छठी	ஆறாவது	None
छठा	ஆறாவது	None
छठ	சாத்	Nan
छः	ஆறு	None
छंदों	வசனங்கள்	Nan
छंद	வசனங்கள்	Nan
चौड़ा	பரந்த	None
चौड़ाई	அகலம்	None
चौड़ी	பரந்த	None
चौथ	ச uth த்	Nan
चौथा	நான்காவது	None
चौथाई	காலாண்டு	Nan
छह	ஆறு	None
चौथी	நான்காவது	None
चौदह	பதினான்கு	None
चौधरी	சவுத்ரி	Nan
चौबीस	இருபத்து நான்கு	Nan
चौरासी	எண்பத்துநான்கு	Nan
चौहान	சவுகான்	Nan
च्हिन	சின்	Nan
चौथे	நான்காவது	None
छाछ	மோர்	Nan
छात्र	மாணவர்	None
छात्रवृत्ति	உதவித்தொகை	Nan
छूती	தொடுதல்	Nan
छूने	தொடுவதற்கு	Nan
छेद	துளை	Nan
छोटासा	சிறிய	None
छोटी	சிறிய	None
छोटीछोटी	சிறிய	None
छूट	சலுகை	Nan
छोटे	சிறிய	None
छोड	அதை விடு	Nan
छोड़	விடுங்கள்	Nan
छोड़ते	விட்டு	None
छोड़ने	விட்டு	None
छोड़ा	இடது	None
छोड़ी	இடது	None
छोटेबड़े	பெரியவர்கள் மற்றும் இளைஞர்கள்	Nan
चौकी	அஞ்சல்	Nan
छुपे	மறைக்கப்பட்டுள்ளது	Nan
छुपा	மறைக்கப்பட்டுள்ளது	Nan
छात्रों	மாணவர்கள்	None
छानकर	வடிகட்டிய பின்	Nan
छाया	நிழல்	None
छायावाद	நிழல்	None
छायावादी	ஒளிப்பதிவாளர்	Nan
छाल	பட்டை	None
छुपाने	மறைக்க	Nan
छावनी	கன்டோன்மென்ட்	Nan
छिप	மறைக்கப்பட்டுள்ளது	Nan
छिपा	மறைக்கப்பட்டுள்ளது	Nan
छीन	ஸ்னாட்ச்	Nan
छुटकारा	துயர் நீக்கம்	Nan
छुट्टियों	விடுமுறை நாட்கள்	Nan
छुट्टी	விடுமுறை	None
छिद्रों	வென்ட்கள்	Nan
चौक	சதுரம்	Nan
चोरी	திருட்டு	Nan
चोपड़ा	சோப்ரா	Nan
चिली	சிலி	None
चिश्ती	சிஷ்டி	Nan
चिह्नित	குறிக்கப்பட்டுள்ளது	Nan
चिह्नों	அடையாளங்கள்	None
चींटी	எறும்பு	None
चीज	விஷயம்	Nan
चिरायता	சாலிசி	Nan
चीज़	விஷயம்	Nan
चीजें	விஷயங்கள்	None
चीजों	விஷயங்கள்	None
चीन	சீனா	None
चीफ	முதல்வர்	None
चुंबकिय	காந்தம்	Nan
चुंबकीय	காந்த	None
चीज़ों	விஷயங்கள்	None
चुकी	முடிந்தது	None
चिरहरित	குறிக்கப்படவில்லை	Nan
चिन्हित	குறிக்கப்பட்டுள்ளது	Nan
चित्रकला	ஓவியம்	None
चित्रकार	ஓவியர்	None
चित्रकारी	ஓவியம்	None
चित्रकूट	சித்ரகூட்	Nan
चित्रण	விளக்கம்	None
चित्रलिपि	ஹைரோகிளிஃப்	Nan
चिप	சிப்	Nan
चित्रा	சித்ரா	Nan
चित्रांगद	சித்ரங்கட்	Nan
चित्रित	வர்ணம் பூசப்பட்டது	Nan
चित्रों	படங்கள்	Nan
चिन्तन	சிந்திக்கிறது	Nan
चिन्ता	பராமரிப்பு	None
चिन्ह	சின்னம்	None
चित्रांकन	வரைதல்	None
छोर	முனைகள்	Nan
चुके	இருந்தது	None
चुनकर	தேர்ந்தெடுப்பதன் மூலம்	Nan
चेतावनी	எச்சரிக்கை	None
चेन्नई	சென்னை	None
चेष्टा	முயற்சி	None
चेष्टाओं	முயற்சிகள்	None
चेहरा	முகம்	None
चैतन्य	சைதன்யா	Nan
चेतना	உணர்வு	None
चैत्र	சைத்ரா	Nan
चैनलों	சேனல்கள்	Nan
चैम्पियनशिप	சாம்பியன்ஷிப்	Nan
चॉकलेट	சாக்லேட்	Nan
चोटियाँ	சிகரங்கள்	Nan
चोटियों	சிகரங்கள்	Nan
चोटी	உச்சம்	Nan
चैनल	சேனல்	None
चुन	சுன்	Nan
चेचक	சிக்கன் போக்ஸ்	Nan
चूर्ण	தூள்	Nan
चुनते	தேர்வு செய்யவும்	Nan
चुना	தேர்வு	Nan
चुनाव	தேர்தல்	Nan
चुनावी	தேர்தல்	Nan
चुनावों	தேர்தல்கள்	None
चुनी	தேர்வு	Nan
चेक	காசோலை	Nan
चुने	தேர்ந்தெடு	Nan
चुपचाप	அமைதியாக	Nan
चूँकि	முதல்	None
चूंकि	முதல்	None
चूका	தவறவிட்டது	Nan
चूड़ी	வளையல்	None
चूना	சுண்ணாம்பு	None
चुपके	திருட்டு	Nan
चित्र	படம்	None
ज	ஜெ	None
जंग	துரு	Nan
जलन	பொறாமை	Nan
जलधारा	ஸ்ட்ரீம்	Nan
जलती	எரியும்	None
जल	தண்ணீர்	None
जर्मेनियम	ஜெர்மானியம்	Nan
जर्मनी	ஜெர்மனி	None
जर्मनिक	ஜெர்மானிக்	Nan
जर्मन	ஜெர்மன்	None
जर्नल	இதழ்	None
जरूरी	அவசியம்	None
जरूरत	தேவை	None
जरूर	நிச்சயமாக	Nan
जरुरी	கட்டாயம்	None
जरुरत	தேவை	None
जरिये	மூலம்	None
जरिए	வழியாக	None
जरा	வெறும்	None
जमाव	அமைத்தல்	None
जमीन	நில	None
जमीनी	மைதானம்	None
जम्बूद्वीप	ஜம்புத்வீப்	Nan
जम्मू	ஜம்மு	None
जय	ஜெய்	Nan
जलने	எரியும்	None
जयंती	ஜூபிலி	Nan
जयदेव	ஜெய்தேவ்	Nan
जयपुर	ஜெய்ப்பூர்	Nan
जयप्रकाश	ஜெய் பிரகாஷ்	Nan
जयशंकर	ஜெய்சங்கர்	Nan
जयसिंह	ஜெய்சிங்	Nan
जया	ஜெயா	Nan
जयचंद	ஜெயச்சந்த்	Nan
जलमण्डल	ஹைட்ரோஸ்பியர்	Nan
जलवायु	காலநிலை	None
जलविमान	நீர் கைவினை	Nan
जस्ता	துத்தநாகம்	None
जहर	விஷம்	Nan
जहाँ	எங்கே	None
जहाँगीर	ஜஹாங்கிர்	Nan
जहां	எங்கே	None
जहाज	கப்பல்	None
जश्न	கொண்டாடுங்கள்	Nan
जहाजों	கப்பல்கள்	None
ज़फ़र	ஜாபர்	Nan
ज़मीन	நில	None
ज़रूर	நிச்சயம்	Nan
ज़रूरत	தேவை	None
ज़रूरी	அவசியம்	None
ज़िक्र	குறிப்பிடுங்கள்	Nan
ज़कात	ஜகாத்	Nan
जमाने	சகாப்தம்	None
जवाहरलाल	ஜவஹர்லால்	None
जवाब	பதில்	None
जला	எரிக்க	Nan
जलाई	லிட்	Nan
जलाकर	டார்ச்ச்கள்	Nan
जलाने	கின்டெல்	Nan
जलापूर्ति	தண்ணிர் விநியோகம்	Nan
जलाया	ஒளியூட்டு	Nan
जवाहर	ஜவஹர்	Nan
जलालुद्दीन	ஜலாலுதீன்	Nan
जलियांवाला	ஜாலியன்வாலா	Nan
जलीय	நீர்வாழ்	Nan
जल्द	விரைவில்	None
जल्दी	விரைவில்	None
जवान	இளம்	None
जवानी	இளைஞர்கள்	None
जलाशय	நீர்த்தேக்கம்	Nan
जमा	வைப்பு	Nan
जमशेदपुर	ஜாம்ஷெட்பூர்	Nan
जम	திட	None
जटायु	ஜடாயு	Nan
जटिल	சிக்கலான	None
जड़	வேர்	Nan
जड़े	வேர்	Nan
जड़ें	வேர்கள்	Nan
जताई	வெளிப்படுத்தியது	Nan
जज	நீதிபதி	None
जन	மக்கள்	None
जनगणना	மக்கள் தொகை கணக்கெடுப்பு	Nan
जनजाति	கோத்திரம்	Nan
जनजातियों	பழங்குடியினர்	None
जनजीवन	வாழ்க்கை	None
जनता	பொது	None
जनन	தலைமுறை	None
जनक	பெற்றோர்	None
जननांग	இனப்பெருக்க உறுப்பு	Nan
जगहों	இடங்கள்	None
जगन्नाथ	ஜெகந்நாத்	Nan
जंगल	காடு	None
जंगली	காட்டு	None
जंगलों	காடுகள்	None
जंघा	தொடை	Nan
जंतु	உயிரினம்	None
जंतुओं	விலங்குகள்	None
जगह	இடம்	None
जंबुद्वीप	ஜம்புத்வீப்	Nan
जगजीत	ஜக்ஜித்	Nan
जगत	அண்டம்	None
जगत्	உலகம்	None
जगत्‌	உலகம்	None
जगदीश	ஜெகதீஷ்	Nan
जगद्गुरु	ஜெகத்குரு	Nan
जग	உலகம்	None
जंक्शन	சந்தி	Nan
जननी	அம்மா	None
जनभाषा	பொது மொழி	Nan
जन्मदिन	பிறந்த நாள்	Nan
जन्मस्थान	பிறந்த இடம்	Nan
जन्माष्टमी	ஜன்மாஷ்டமி	Nan
जन्मी	பிறந்தவர்	Nan
जन्मे	பிறந்தவர்	Nan
जन्मों	வாழ்நாள்	None
जन्म	பிறப்பு	None
जन्‍म	பிறப்பு	None
जफर	ஜாபர்	Nan
जब	எப்பொழுது	Nan
जबकि	அதேசமயம்	None
जबरन	வலுக்கட்டாயமாக	Nan
जबाव	பதில்	None
जब्त	பறிமுதல் செய்யப்பட்டது	Nan
जप	கோஷமிடுகிறார்கள்	Nan
जनपद	மாவட்டம்	None
जन्तुओं	விலங்குகள்	None
जनों	மக்கள்	None
जनम	பிறப்பு	None
जनमत	பொது கருத்து	Nan
जनमानस	பொது	None
जनरल	பொது	Nan
जनवरी	ஜனவரி	None
जनवरीमार्च	ஜனவரி அணிவகுப்பு	Nan
जन्तु	விலங்கு	None
जनवादी	ஜனரஞ்சகவாதி	Nan
जनसंख्या	மக்கள் தொகை	Nan
जनसंघ	நிறை	Nan
जनसांख्यिकी	மக்கள்தொகை	None
जनसाधारण	வெகுஜன	None
जनहित	பொதுநலன்	Nan
जनित	உருவாக்கப்பட்டது	None
जनसँख्या	மக்கள் தொகை	Nan
ज़िम्मेदारी	பொறுப்பு	Nan
चित्त	மனம்	None
चिड़ियाघर	மிருகக்காட்சிசாலை	Nan
ग्लूकोज	குளுக்கோஸ்	Nan
ग्लाइकोलिसिस	கிளைகோலிசிஸ்	Nan
ग्रैंड	மாபெரும்	None
ग्रेनाइट	கிரானைட்	Nan
ग्रेट	நன்று	None
ग्रेगोरी	கிரிகோரி	Nan
ग्रुप	குழு	None
ग्रीस	கிரீஸ்	None
ग्रीष्मकालीन	கோடை	None
ग्रीष्म	கோடை	None
ग्रीवा	கருப்பை வாய்	Nan
ग्रीनहाउस	கிரீன்ஹவுஸ்	Nan
ग्रीन	பச்சை	None
ग्रीक	கிரேக்கம்	None
ग्रिगोरियन	கிரிகோரியன்	Nan
ग्राह्य	தகுதியானவர்	Nan
ग्राही	பெறுநர்	Nan
ग्रंथों	நூல்கள்	None
ग्रन्थ	உரை	None
ग्रन्थसूची	நூலியல்	Nan
ग्रन्थों	உரைகள்	Nan
ग्रस्त	பாதிப்பு	None
ग्रहण	கிரகணம்	Nan
ग्लेशियर	பனிப்பாறை	Nan
ग्रहों	கிரகங்கள்	Nan
ग्राफिक	கிராஃபிக்	Nan
ग्राम	கிராம்	Nan
ग्रामीण	கிராமப்புற	Nan
ग्राहक	வாடிக்கையாளர்	Nan
ग्राहकों	வாடிக்கையாளர்கள்	Nan
ग्राहम	கிரஹாம்	Nan
ग्राउंड	தரையில்	None
ग्लोबल	உலகளாவிய	None
ग्वालियर	குவாலியர்	Nan
घ	டி	None
घनी	அடர்த்தியானது	Nan
घने	அடர்த்தியான	None
घर	வீடு	None
घराने	கரானா	Nan
घरेलु	வீடு	None
घरेलू	வீட்டு	None
घनिष्ठ	நெருக்கமான	None
घरों	வீடுகள்	None
घाघरा	பாவாடை	Nan
घाट	கப்பல்	None
घाटियों	பள்ளத்தாக்குகள்	Nan
घाटी	பள்ளத்தாக்கு	None
घाटों	காட்ஸ்	Nan
घातक	கொடியது	Nan
घर्षण	உராய்வு	Nan
ग्रंथियों	சுரப்பிகள்	Nan
घनत्व	அடர்த்தி	None
घटित	நடந்தது	None
घंटा	பெல்	None
घंटी	மணி	None
घंटे	மணி	None
घंटों	மணி	None
घटक	கூறுகள்	None
घटकों	கூறுகள்	None
घड़ी	அந்த கடிகாரம்	Nan
घटती	குறைகிறது	None
घटनाएँ	நிகழ்வுகள்	None
घटनाएं	நிகழ்வுகள்	None
घटनाओं	நிகழ்வுகள்	None
घटनाक्रम	நிகழ்வுகள்	None
घटनायें	நிகழ்வுகள்	None
घटने	குறைகிறது	None
घटना	சம்பவம்	None
ग्रंथि	சுரப்பி	Nan
ग्यास्त्रोएन्टेरोलोजी	கியாஸ்ட்ரோஎன்டாலஜி	Nan
ग्यारहवीं	பதினொன்றாவது	Nan
गेहूं	கோதுமை	None
गैंगलिया	கேங்க்லியா	Nan
गैर	அல்லாத	None
गैलरी	கேலரி	Nan
गैलीलियो	கலிலியோ	Nan
गैस	வாயு	None
गेहूँ	கோதுமை	None
गैसें	வாயுக்கள்	None
गोआ	கோவா	None
गोएंका	கோயங்கா	Nan
गोकुल	கோகுல்	Nan
गोजर	மில்லிபீட்	Nan
गोड	இறைவன்	None
गोडसे	கோட்சே	Nan
गैसों	வாயுக்கள்	None
गोत्र	பழங்குடி	None
गेलिक	கேலிக்	None
गेट्स	கேட்ஸ்	None
गुर्दे	சிறுநீரகம்	None
गुलाब	உயர்ந்தது	Nan
गुलाबी	உயர்ந்தது	Nan
गुलाम	அடிமைகள்	None
गुलामी	அடிமைத்தனம்	Nan
गुस्सा	கோபம்	None
गेम	விளையாட்டு	None
गूगल	கூகிள்	None
गृह	வீடு	None
गृहस्थ	வீட்டுக்காரர்	Nan
गेंद	பந்து	None
गेंदबाजी	பந்துவீச்சு	Nan
गेज	பாதை	None
गेट	வாயில்	None
गूजरी	குஜாரி	Nan
घायल	காயம்	None
गोद	மடியில்	Nan
गोदावरी	கோதாவரி	None
गोले	குண்டுகள்	None
गोल्ड	தங்கம்	None
गोल्फ	கோல்ஃப்	Nan
गोवर्धन	ஆளுகை	Nan
गोवा	கோவா	None
गोविंद	கோவிந்த்	Nan
गोलीबारी	ஷூட்அவுட்	Nan
गोविन्द	கோவிந்த்	Nan
गोस्वामी	கோஸ்வாமி	Nan
गौड़	க ur ர்	Nan
गौण	இரண்டாம் நிலை	Nan
गौतम	க ut தம்	Nan
गौरव	பெருமை	None
गौरी	க ri ரி	Nan
गोस्पेल	நற்செய்தி	None
गोदान	கோதன்	Nan
गोली	துப்பாக்கி சுட்டு	Nan
गोलाकार	வட்ட வடிவம்	Nan
गोपनीयता	தனியுரிமை	Nan
गोपाल	கோபால்	Nan
गोबर	மாடு-சாணம்	Nan
गोबिंदराय	கோபிந்தரை	Nan
गोबिन्द	கோவிந்த்	Nan
गोमती	கோம்தி	Nan
गोलार्द्ध	அரைக்கோளம்	Nan
गोयल	கோயல்	Nan
गोरखपुरी	கோரக்பூர்	Nan
गोरखा	கூர்க்கா	Nan
गोरी	பொன்னிற	Nan
गोल	இலட்சியம்	Nan
गोलक	கோலக்	Nan
गोलकुंडा	கோல்கொண்டா	Nan
गोरखपुर	கோரக்பூர்	Nan
चिता	பைர்	Nan
घास	புல்	None
घिरे	சுற்றிலும்	None
चांद	நிலவு	None
चांडाल	சந்தல்	Nan
चाँदी	வெள்ளி	None
चाँद	நிலா	None
चलो	போகலாம்	Nan
चले	போகலாம்	Nan
चली	நீடித்தது	None
चलाये	இயக்கி	None
चलाया	ஓட்டினார்	Nan
चलाने	ஓடு	None
चलाना	இயக்கி	None
चलाते	ஓடு	None
चलाता	இயங்கும்	None
चलाए	ஓட்டினார்	Nan
चला	நடந்து	None
चलने	நடைபயிற்சி	Nan
चलना	நடப்பதற்க்கு	Nan
चरित	எழுத்து	None
चरित्र	எழுத்து	None
चरों	மாறிகள்	Nan
चर्च	சர்ச்	Nan
चर्चा	கலந்துரையாடல்	Nan
चर्चित	சூடாக	Nan
चांदी	வெள்ளி	None
चर्म	தோல்	None
चल	நட	Nan
चलकर	பின்னர்	None
चलचित्र	திரைப்படங்கள்	None
चलता	நடக்கிறது	None
चलती	நகரும்	None
चलन	பயிற்சி	None
चर्मरोग	தோல் அழற்சி	Nan
चाइना	சீனா	None
चाचा	மாமா	None
चाणक्य	சாணக்யா	Nan
चाहने	நேசிக்கிறார்	Nan
चाहा	வில்ஸ்	Nan
चाहिए	தேவை	None
चाहिये	வேண்டும்	None
चाहे	இருந்தபோதிலும்	Nan
चाहें	விரும்பும்	None
चाहते	வேண்டும்	None
चिंतन	கவலைகள்	Nan
चिकित्सक	மருத்துவர்	None
चिकित्सकीय	பல்	None
चिकित्सकों	மருத்துவர்கள்	None
चिकित्सा	சிகிச்சை	None
चिकित्सीय	சிகிச்சை	None
चिट्ठे	வலைப்பதிவு	None
चिकन	கோழி	None
चरमोत्कर्ष	க்ளைமாக்ஸ்	Nan
चाहती	வேண்டும்	None
चावल	அரிசி	None
चाप	ஆர்க்	Nan
चाय	தேநீர்	None
चार	நான்கு	None
चारा	ஊட்டம்	Nan
चारो	சுற்றிலும்	None
चारों	நான்கு பேரும்	Nan
चाहता	தேவை	None
चार्ज	கட்டணம்	None
चार्ल्स	சார்லஸ்	None
चाल	தந்திரம்	Nan
चालक	இயக்கி	None
चालित	இயக்கப்படுகிறது	Nan
चालीस	நாற்பது	None
चालू	ஆன்	None
चार्टर	சாசனம்	None
चरमआनंद	மிகுந்த இன்பம்	Nan
चरम	தீவிர	None
चरणों	படிகள்	Nan
ङ	4	Nan
चंडी	சண்டி	Nan
चंडीगढ़	சண்டிகர்	None
चंदन	சந்தனம்	Nan
चंद्र	சந்திரா	Nan
चंद्रगुप्त	சந்திரகுப்தர்	Nan
घोसला	கோஸ்லா	Nan
चंद्रमा	நிலா	None
चंद्रयान	சந்திரயான்	Nan
चकित	ஆச்சரியமாக இருக்கிறது	Nan
चक्कर	விவகாரம்	Nan
चक्र	சக்கரம்	None
चक्रवर्ती	சக்ரவர்த்தி	Nan
चक्रवात	சூறாவளி	None
चंद्रमास	சந்திர மாதம்	Nan
चचेरे	உறவினர்	Nan
घोषित	அறிவித்தது	None
घोष	கோஷ்	Nan
घी	நெய்	Nan
घुटनों	முழங்கால்கள்	Nan
घुड़सवार	குதிரைவீரன்	Nan
घुसपैठ	ஊடுருவல்	None
घूम	சுற்றவும்	Nan
घूमते	சுற்றவும்	Nan
घोषणा	பிரகடனம்	None
घूमने	சுற்றவும்	Nan
घृत	உருகிய வெண்ணெய்	Nan
घेघा	உணவுக்குழாய்	Nan
घेरे	சுற்றி	Nan
घोड़ा	குதிரை	None
घोड़े	குதிரைகள்	None
घोड़ों	குதிரைகள்	None
घूर्णन	சுழற்சி	Nan
घिरा	சுற்றிலும்	None
चट्टानों	பாறைகள்	None
चढ़	ஏறியது	Nan
चमकीले	பிரகாசமாக	Nan
चमड़ा	தோல்	None
चमड़ी	தோல்	None
चमड़े	தோல்	None
चमत्कार	அதிசயம்	Nan
चमत्कारिक	அதிசயம்	Nan
चबूतरे	பாப்ஸ்	Nan
चमोली	சாமோலி	Nan
चम्मच	ஸ்பூன்	Nan
चयन	தேர்வு	Nan
चयनात्मक	தேர்ந்தெடுக்கப்பட்ட	None
चयनित	தேர்ந்தெடுக்கப்பட்டது	Nan
चरक	சரக்	Nan
चरण	மேடை	None
चम्बल	சம்பல்	Nan
चट्टोपाध्याय	சட்டோபாத்யாய்	Nan
चन्द्रशेखर	சந்திரசேகர்	None
चन्द्रमा	நிலவு	None
चढ़ने	ஏறுவதற்கு	Nan
चढ़ा	ஏறியது	Nan
चढ़ाई	ஏறு	Nan
चढ़ाना	முலாம் பூசுதல்	Nan
चढ़ाने	முலாம் பூசுதல்	Nan
चढ़ाया	பூசப்பட்ட	Nan
चन्द्रराव	சந்திரராவ்	Nan
चतुर	புத்திசாலி	Nan
चतुर्थी	சதுர்த்தி	None
चतुर्भुज	நாற்கர	Nan
चतुर्वेदी	சதுர்வேதி	Nan
चन्द	நிலவு	None
चन्द्र	சந்திரா	Nan
चन्द्रगुप्त	சந்திர குப்தா	Nan
चतुर्थ	நான்காவது	None
तेलुगू	தெலுங்கு	None
ज़ोन	மண்டலம்	None
ज़्यादा	மேலும்	None
डॉट	புள்ளி	None
डॉग	நாய்	None
डॉक्टरों	மருத்துவர்கள்	None
डॉ	டாக்டர்	None
डैनिश	டேனிஷ்	Nan
डेस्कटॉप	டெஸ்க்டாப்	Nan
डेविडसन	டேவிட்சன்	Nan
डेविड	டேவிட்	Nan
डेल्टा	டெல்டா	Nan
डेली	டெலி	Nan
डेनिस	டெனிஸ்	Nan
डेनमार्क	டென்மார்க்	None
डेढ़	ஒன்றரை	Nan
डेटाबेस	தரவுத்தளம்	Nan
डेटा	தகவல்	None
डे	நாள்	None
डीसी	டி.சி.	Nan
डिजाइन	வடிவமைப்பு	None
डिजाईन	வடிவமைப்பு	None
डिजिटल	டிஜிட்டல்	None
डिजीटल	டிஜிட்டல்	None
डिपो	டிப்போ	Nan
डिलीवरी	டெலிவரி	Nan
डॉन	தாதா	Nan
डिवाइस	சாதனம்	None
डिस्क	வட்டு	None
डी	டி	None
डीजल	டீசல்	Nan
डीडी	dd	Nan
डीडीटी	டி.டி.டி.	Nan
डीवीडी	டிவிடி	None
डिवीजन	பிரிவு	None
डॉलर	டாலர்	None
डॉ०	டாக்டர்.	Nan
डोम	டோம்	Nan
तंत्रिकाओं	நரம்புகள்	Nan
तंबाकू	புகையிலை	None
तकनीक	நுட்பம்	None
तकनीकी	தொழில்நுட்பம்	None
तकनीकें	நுட்பங்கள்	None
तकनीकों	நுட்பங்கள்	None
तंत्रिका	நரம்பு	Nan
तकिया	தலையணை	Nan
तक्षशिला	தக்ஷிலா	Nan
तख्त	இருக்கை	Nan
तट	கடற்கரை	None
तटरक्षक	கடலோர காவல்படை	Nan
तटवर्ती	கடலோர	None
तटीय	கரையோர	Nan
तकियाः	தலையணை	Nan
डिज़ाइन	வடிவமைப்பு	None
तंत्र	தந்திரம்	Nan
ण	கடன்	None
ड्राइव	இயக்கி	None
ड्राईव	இயக்கி	None
ढंग	நடத்தை	None
ढक	கவர்	Nan
ढका	மூடப்பட்ட	Nan
ढ़	பாதி	Nan
तंग	இறுக்கம்	Nan
ढाँचे	சட்டகம்	Nan
ढांचे	கட்டமைப்பு	None
ढाका	டாக்கா	None
ढाल	கவசம்	Nan
ढीले	தளர்வானது	Nan
ढूंढ	கண்டுபிடி	Nan
ढेर	குவியல்	Nan
ढांचा	சட்டகம்	Nan
डिग्री	பட்டம்	None
डिक्शनरी	அகராதி	None
डालो	போடு	Nan
ट्यूब	குழாய்	None
ट्यूमर	கட்டி	None
ट्रस्ट	நம்பிக்கை	None
ट्रान्सफार्मर	மின்மாற்றி	Nan
ट्रान्समिटर	டிரான்ஸ்மிட்டர்	Nan
ट्राम	டிராம்	Nan
टोपे	டோப்	Nan
ट्रिनिटी	திரித்துவம்	Nan
ट्रिमस्टर	டிரிம்ஸ்டர்	Nan
ट्रेड	வர்த்தகம்	None
ट्रेन	தொடர்வண்டி	Nan
ट्वेंटी	இருபது	None
ठंड	குளிர்	Nan
ठंडा	குளிர்	Nan
ट्रिब्यून	ட்ரிப்யூன்	Nan
ठंडी	குளிர்	Nan
टोपी	தொப்பி	Nan
टोकामाक	டோகாமக்	Nan
टेक्स्ट	உரை	None
टेनिस	டென்னிஸ்	None
टेरेसा	தெரசா	Nan
टेलर	தையல்காரர்	Nan
टेलिविज़न	தொலைக்காட்சி	None
टेलीफोन	தொலைபேசி	None
टोक्यो	டோக்கியோ	None
टेलीविजन	தொலைக்காட்சி	None
टैंक	தொட்டி	Nan
टैक्सी	வண்டி	Nan
टैग	குறிச்சொல்	Nan
टैगोर	தாகூர்	None
टैबीरियस	தபாரியஸ்	Nan
टॉवर	கோபுரம்	Nan
टेस्ट	சோதனை	None
तत्काल	உடனடியாக	None
ठंडे	குளிர்	Nan
ठाकुर	பிரபு	None
डाक	இடுகைகள்	Nan
डाक्टर	டாக்டர்	None
डाट	தடுப்பவர்	Nan
डाटा	தகவல்கள்	None
डाटाबेस	தரவுத்தளம்	Nan
डाल	கிளை	None
डाउनलोड	பதிவிறக்க tamil	Nan
डालकर	போடுவதன் மூலம்	Nan
डालती	வைக்கிறது	Nan
डालते	போடு	Nan
डालने	செருக	Nan
डालर	டாலர்	None
डाला	போடு	Nan
डाली	கிளை	None
डालता	வைக்கிறது	Nan
ठाकरे	தாக்கரே	Nan
डाई	சாயம்	Nan
डाइआक्साइड	டை ஆக்சைடு	Nan
ठाणे	தானே	None
ठीक	நல்லது	None
ठेठ	வழக்கமான	None
ठोकर	தடுமாறும்	Nan
ठोस	திட	None
ड	டி	None
डाइऑक्साइड	டை ஆக்சைடு	Nan
डकैती	கொள்ளை	None
डबल्यू	டபிள்யூ	Nan
डब्लू	டபிள்யூ	Nan
डर	பயம்	Nan
डहेलिया	டஹ்லியா	Nan
ड़	இ	None
डा	டாக்டர்	None
डगलस	டக்ளஸ்	Nan
टेक्सास	டெக்சாஸ்	None
तत्कालीन	சமகால	None
तत्पश्चात	அதற்கு பிறகு	Nan
तुमने	நீங்கள்	None
तुगलक	துக்ளக்	Nan
तु	நீங்கள்	None
तीसरे	மூன்றாவது	None
तीसरी	மூன்றாவது	None
तीसरा	மூன்றாவது	None
तीस	முப்பது	None
तीव्रता	தீவிரம்	Nan
तीव्र	தீவிரம்	Nan
तीर्थों	யாத்திரை	None
तीर्थस्थान	சன்னதி	Nan
तीर्थस्थल	புனித யாத்திரை	Nan
तीर्थयात्री	யாத்ரீகர்	Nan
तीर्थयात्रियों	யாத்ரீகர்கள்	Nan
तीर्थयात्रा	யாத்திரை	None
तीर्थ	யாத்திரை	None
तीर	அம்பு	None
तिथि	தேதி	None
तिब्बत	திபெத்	None
तिरंगा	முக்கோணம்	None
तिरंगे	முக்கோணம்	None
तिरुपति	திருப்பதி	None
तिरुमला	திருமலை	None
तुमसे	உன்னிடமிருந்து	Nan
तिल	மச்சம்	Nan
तिल्ली	மண்ணீரல்	Nan
तिवारी	திவாரி	Nan
तिहाई	மூன்றாவது	None
तीन	மூன்று	None
तीनो	மூன்றும்	None
तीनों	மூன்றும்	None
तिलक	திலக்	Nan
तुमि	நீங்கள்	None
तुम्हारा	உங்களுடையது	Nan
तुम्हारे	உங்கள்	None
तेंडुलकर	டெண்டுல்கர்	Nan
तेंदुलकर	டெண்டுல்கர்	Nan
तेग	டெக்	Nan
तेज	வேகமாக	None
तेजस्वी	அதிர்ச்சி தரும்	Nan
तेज़	வேகமாக	None
ते	தே	None
तेज़ी	வேகம்	None
तेरह	பதின்மூன்று	Nan
तेरहवीं	பதின்மூன்றாவது	Nan
तेरा	உங்கள்	None
तेरी	உங்கள்	None
तेरे	உங்கள்	None
तेल	எண்ணெய்	None
तेजी	வேகமாக	None
तालिका	மேசை	Nan
तृतीया	திரிதியா	Nan
तृतीय	மூன்றாவது	None
तुम्हें	உனக்கு	Nan
तुरंत	உடனே	None
तुरन्त	உடனே	None
तुर्क	துர்க்	Nan
तुर्की	துருக்கி	None
तुलना	ஒப்பீடு	None
तृतीयक	மூன்றாம் நிலை	Nan
तुलनात्मक	ஒப்பீட்டு	None
तुलसीदास	துளசிதாஸ்	Nan
तुल्य	இணையான	None
तू	நீங்கள்	None
तूने	நீங்கள்	None
तूफ़ान	புயல்	None
तूफान	புயல்	None
तुलसी	துளசி	None
तालाब	குளம்	None
तालव्य	ரிதம்	Nan
तालमेल	சினெர்ஜி	Nan
तमाम	அனைத்தும்	Nan
तमिल	தமிழ்	None
तम्बाकू	புகையிலை	None
तय	முடிவு	None
तरंग	அலை	None
तरंगों	அலைகள்	None
तभी	பின்னர் மட்டுமே	Nan
तरफ़	பக்கத்தில்	Nan
तरह	கருணை	None
तरहतरह	ஒரு விதமாக	Nan
तराई	தாழ்நிலம்	Nan
तरीके	வழிகள்	None
तरीकों	முறைகள்	None
तर्क	வாதம்	None
तरल	திரவ	None
तर्कसंगत	பகுத்தறிவு	None
तबला	தப்லா	Nan
तपस्या	சிக்கனம்	Nan
तत्पश्चात्	அதன்பிறகு	None
तत्व	உறுப்பு	None
तत्वमीमांसा	மீமெய்யியல்	Nan
तत्वों	கூறுகள்	None
तथाकथित	என்று அழைக்கப்படுபவை	Nan
तथापि	எனினும்	None
तब	பிறகு	None
तथ्य	உண்மை	None
तन	உடல்	None
तना	தண்டு	None
तनाव	பதற்றம்	Nan
तने	தண்டு	None
तन्त्र	அமைப்பு	None
तप	உறுதிப்பாடு	Nan
तथ्यों	உண்மைகள்	None
तत्त्व	உறுப்பு	None
तर्कों	வாதங்கள்	None
तलवार	வாள்	None
तानसेन	டேன்சன்	Nan
ताप	வெப்பம்	None
तापक्रम	வெப்ப நிலை	Nan
तापमान	வெப்ப நிலை	Nan
ताम्र	தாமிரம்	Nan
तार	கம்பி	None
तात्या	தத்யா	Nan
तारा	நட்சத்திரம்	None
तारामंडल	கோளரங்கம்	Nan
तारीख	தேதி	None
तारीख़	தேதி	None
तारों	வயரிங்	Nan
तार्किक	தருக்க	Nan
ताल	rythm	Nan
ताराभौतिकी	வானியற்பியல்	None
तल	தரை	Nan
तात्पर्य	பொருள்	None
ताजा	புதியது	Nan
तलाश	தேடல்	None
तव	கரை	None
तस्वीर	புகைப்படம்	None
तस्वीरें	புகைப்படங்கள்	None
तस्वीरों	படங்கள்	Nan
तहत	கீழ்	None
तात्कालिक	மேம்படுத்தப்பட்டது	Nan
तहसील	தெஹ்ஸில்	Nan
तांबे	தாமிரம்	Nan
ताइवान	தைவான்	Nan
ताकत	வலிமை	None
ताकि	அதனால்	None
ताज	கிரீடம்	Nan
ताजमहल	தாஜ் மஹால்	Nan
तांबा	தாமிரம்	Nan
ज़ोर	வலியுறுத்தல்	Nan
टेक्नालजी	தொழில்நுட்பம்	None
टूटे	உடைந்த	Nan
जिसने	யாராக இருந்தாலும்	Nan
जिसको	யாருக்கு	None
जिसके	யாருடைய	Nan
जिसकी	யாருடைய	Nan
जिसका	யாருடைய	Nan
जिस	ஜிஸ்	Nan
जिलों	மாவட்டங்கள்	None
जिले	மாவட்டம்	None
जिला	மாவட்டம்	None
जिम्मेदारी	பொறுப்பு	Nan
जिम्मेदार	பொறுப்பு	Nan
जिन्होने	who	Nan
जिन्होंने	who	Nan
जिन्हें	யாரை	Nan
जिन्हे	யாரை	Nan
जिन्ना	ஜின்னா	Nan
जिन्दगी	வாழ்க்கை	None
जावास्क्रिप्ट	ஜாவாஸ்கிரிப்ட்	None
जाहिर	வெளிப்படையாக	None
जिंदगी	வாழ்க்கை	None
जिक्र	குறிப்பிடுங்கள்	Nan
जिज्ञासा	ஆர்வம்	None
जितना	எவ்வளவு முடியுமோ	Nan
जिसपर	எதன் மீது	Nan
जितनी	எவ்வளவு முடியுமோ	Nan
जिनका	யாருடைய	Nan
जिनकी	யாருடைய	Nan
जिनको	யாரை	Nan
जिनमे	இதில்	None
जिनमें	இதில்	None
जिनसे	யாரிடமிருந்து	Nan
जिन	ஜின்	Nan
जिसमे	இதில்	None
जिसमें	இதில்	None
जिससे	எதனுடன்	Nan
जीवन	வாழ்க்கை	None
जीवनकाल	ஆயுட்காலம்	Nan
जीवनशैली	வாழ்க்கை	None
जीवनी	சுயசரிதை	None
जीवविज्ञान	உயிரியல்	None
जीवाणु	பாக்டீரியா	None
जीवधारियों	உயிரினங்கள்	None
जीवाणुओं	பாக்டீரியா	None
जीविका	வாழ்வாதாரம்	Nan
जीवित	வாழும்	None
जीवों	உயிரினங்கள்	None
जुटाने	வளர்ப்பது	Nan
जुड़	சேர	None
जुड़ा	இணைக்கப்பட்டுள்ளது	Nan
जीवाश्म	புதைபடிவங்கள்	Nan
जावा	ஜாவா	None
जीवंत	உயிரோட்டமாக	Nan
जीमेल	ஜிமெயில்	None
जिसे	யாரை	Nan
जी	ஆம்	None
जीएसएम	ஜி.எஸ்.எம்	Nan
जीडीपी	மொத்த உள்நாட்டு உற்பத்தி	Nan
जीत	வெற்றி	Nan
जीतने	வெற்றி	Nan
जीव	உயிரினங்கள்	None
जीते	வாழ்க	None
जीना	வாழ்க	None
जीने	வாழ	None
जीनों	மரபணுக்கள்	None
जीनोम	மரபணு	None
जीनोमिक	மரபணு	None
जीपीएस	ஜி.பி.எஸ்	Nan
जीन	ஜீன்	None
जाली	போலியானது	Nan
जालस्थल	இணையதளம்	None
जालपृष्ठ	வலைப்பக்கம்	None
जाट	ஜாட்ஸ்	Nan
जाड़े	குளிர்காலம்	None
जातक	பூர்வீகம்	Nan
जातकों	பூர்வீகம்	Nan
जाता	போ	Nan
जाति	நடிகர்கள்	None
जाग्रत	விழித்தெழு	Nan
जातियाँ	சாதிகள்	Nan
जातियों	சாதிகள்	Nan
जाती	சாதி	None
जातीं	அவள் போகிறாள்	Nan
जातीय	இன	None
जाते	போ	Nan
जादुई	மந்திர	None
जातियां	சாதிகள்	Nan
जादूगर	மந்திரவாதி	Nan
जागृति	விழிப்பு	Nan
जागरूकता	விழிப்புணர்வு	Nan
ज़्यादातर	பெரும்பாலும்	None
जा	போ	Nan
जाँच	விசாரணை	None
जांघों	தொடைகள்	Nan
जांच	ஆய்வு	None
जाए	போ	Nan
जागृत	விழித்தெழு	Nan
जाएँ	போ	Nan
जाएंगे	போவேன்	Nan
जाएगा	போவேன்	Nan
जाएगी	போவேன்	Nan
जाओ	போ	Nan
जाकर	செல்வதன் மூலம்	Nan
जागरण	விழிப்பு	Nan
जाएं	போ	Nan
जुड़ी	இணைக்கப்பட்டுள்ளது	Nan
जान	வாழ்க்கை	None
जानकारियाँ	தகவல்	None
जापानी	ஜப்பானி	Nan
जाम	ஜாம்	Nan
जामा	ஜமா	Nan
जाय	ஜெய்	Nan
जाया	ஜெயா	Nan
जाये	போ	Nan
जाप	கோஷமிடுங்கள்	Nan
जायें	செல்லுங்கள்	Nan
जायेगा	போவேன்	Nan
जायेगी	போவேன்	Nan
जार्ज	ஜார்ஜ்	None
जाल	பொறி	None
जालंधर	ஜலந்தர்	Nan
जालघर	பொறி வீடு	Nan
जायेंगे	விருப்பம்	None
जानकर	தெரிந்தும்	Nan
जानेवाले	வெளிச்செல்லும்	Nan
जानें	அறிய	None
जानकारियां	தகவல்	None
जानकारी	தகவல்	None
जानकी	ஜனகி	Nan
जानता	தெரியும்	None
जानती	தெரியும்	None
जानते	தெரியும்	None
जानेवाली	வெளிச்செல்லும்	Nan
जानना	தெரிந்து கொள்ள	Nan
जानबूझकर	வேண்டுமென்றே	None
जानवर	விலங்கு	None
जानवरों	விலங்குகள்	None
जाना	போ	Nan
जानी	ஜானி	Nan
जाने	தெரியும்	None
जानने	தெரிந்தும்	Nan
टूलकिट	கருவித்தொகுதி	Nan
जुड़े	இணைக்கப்பட்டுள்ளது	Nan
जुडी	ஜூடி	Nan
टर्बाइन	விசையாழி	Nan
टर्की	துருக்கி	None
टमाटर	தக்காளி	Nan
टन	டன்	Nan
टकसाल	புதினா	Nan
टकराने	மோதல்	None
ट	டி	None
ञ	ஜெ	None
झेलम	ஜீலம்	Nan
झूठे	பொய்யர்கள்	Nan
झूठ	பொய்	Nan
झुकाव	சாய்	Nan
झुकाया	குனிந்தான்	Nan
झुका	வளைந்தது	Nan
झुंड	கூட்டம்	None
झीलों	ஏரிகள்	None
झीलें	ஏரிகள்	None
ज्वालामुखी	எரிமலை	Nan
ज्‍योतिष	ஜோதிடம்	Nan
झ	jh	Nan
झंडा	கொடி	Nan
झंडे	கொடி	Nan
झंडों	கொடிகள்	Nan
टर्मिनल	முனையம்	Nan
झटके	நடுக்கம்	None
झा	ஜா	Nan
झाँसी	ஜான்சி	Nan
झांसी	ஜான்சி	Nan
झारखंड	ஜார்க்கண்ட்	Nan
झींगा	இறால்	Nan
झील	ஏரி	None
झलक	பார்வை	None
टर्मिनस	டெர்மினஸ்	Nan
टांगे	கால்கள்	None
टांगों	கால்கள்	None
टीकाटिप्पणी	வர்ணனை	Nan
टीके	தடுப்பு மருந்துகள்	Nan
टीकों	தடுப்பு மருந்துகள்	Nan
टीपू	திப்பு	None
टीम	அணி	None
टीमें	அணிகள்	Nan
टीकाकरण	தடுப்பூசி	None
टीमों	அணிகள்	Nan
टुकड़े	துண்டுகள்	None
टू	இரண்டு	None
टूट	உடைக்க	Nan
टूटने	முறிவு	Nan
टूटा	உடைந்த	Nan
टूटी	உடைந்த	Nan
टीले	திண்ணை	Nan
ज्वाला	சுடர்	Nan
टीका	தடுப்பூசி	None
टिहरी	தெஹ்ரி	Nan
टाइगर	புலி	None
टाइप	வகை	None
टाइपिंग	தட்டச்சு செய்தல்	Nan
टाइम	நேரம்	None
टाइम्स	டைம்ஸ்	None
टाउन	டவுன்	Nan
टी	டி	None
टाटा	வருகிறேன்	Nan
टापू	தீவு	None
टाल	தவிர்ப்பது	Nan
टिकट	டிக்கெட்	Nan
टिन	தகரம்	Nan
टिप्पणियों	அவதானிப்புகள்	Nan
टिप्पणी	கருத்து	None
टाटानगर	டாடாநகர்	Nan
ज्वार	காய்ச்சல்	None
ज्वर	காய்ச்சல்	None
ज्योतिषीय	ஜோதிடம்	Nan
जैन	சமண	None
जैनेंद्र	ஜெயேந்திரா	Nan
जैनेन्द्र	ஜெயேந்திரா	Nan
जैब	ஜப்	Nan
जैबुन्निसा	ஜபுன்னிசா	Nan
जैव	உயிர்	Nan
जैतून	ஆலிவ்	Nan
जैवमण्डल	உயிர்க்கோளம்	Nan
जैसा	என	Nan
जैसी	என	Nan
जैसे	போன்ற	None
जॉन	ஜான்	None
जॉर्ज	ஜார்ஜ்	None
जो	அந்த	None
जैविक	கரிம	None
जोकि	எது	None
जैक्सन	ஜாக்சன்	None
जेसे	பிடிக்கும்	Nan
जुडे	சேர	None
जुताई	உழவு	Nan
जुमेरह	ஜுமேரா	Nan
जुर्माना	தண்டம்	Nan
जुलाई	ஜூலை	None
जुलाईसितंबर	ஜூலை செப்டம்பர்	Nan
जैक	ஜாக்	Nan
जुलु	ஜூலு	Nan
जूते	காலணிகள்	Nan
जून	ஜூன்	None
जूनियर	ஜூனியர்	None
जे	ஜெ	None
जेबेल	ஜெபல்	Nan
जेम्स	ஜேம்ஸ்	None
जुलूस	ஊர்வலம்	Nan
जुडा	சேர	None
जोखिम	ஆபத்து	None
जोड़	கூட்டு	None
ज्ञात	தெரிந்தவை	Nan
ज्ञाता	அறிவுள்ளவர்	Nan
ज्ञान	அறிவு	None
ज्ञानपीठ	ஞான்பித்	Nan
ज्ञानविज्ञान	அறிவு அறிவியல்	Nan
ज्ञानामृतम्	ஞானம்ரிதம்	Nan
जौनपुर	ஜான்பூர்	Nan
ज्यादा	மேலும்	None
ज्यामितीय	வடிவியல்	Nan
ज्यों	என	Nan
ज्योति	ஒளி	None
ज्योतिर्लिङ्ग	ஜோதிர்லிங்	Nan
ज्योतिष	ஜோதிடம்	Nan
ज्योतिषी	ஜோதிடர்	Nan
ज्यादातर	பெரும்பாலும்	None
जोडने	சேர்க்க	None
जौ	பார்லி	Nan
जोशी	ஜோஷி	Nan
जोड़कर	சேர்ப்பதன் மூலம்	Nan
जोड़ता	இணைக்கிறது	Nan
जोड़ती	இணைக்கிறது	Nan
जोड़ते	இணைக்கவும்	Nan
जोड़ा	ஜோடி	Nan
जोड़ी	ஜோடி	Nan
जोसेफ	ஜோசப்	None
जोड़े	ஜோடி	Nan
जोदड़ो	கூட்டு	None
जोधपुर	ஜோத்பூர்	Nan
जोन	மண்டலம்	None
जोर	வலியுறுத்தல்	Nan
जोरदार	வீரியம்	Nan
जोश	வேட்கை	Nan
जोड़ों	மூட்டுகள்	Nan
‎है	என்பது	None
