$	$	None
मालिश	masszázs	Nan
मालिनी	malini	Nan
मालिकों	a tulajdonosok	Nan
मालिकाना	szabadalmazott	Nan
मालिक	tulajdonos	None
माला	girland	Nan
मालदीवज	maldív-szigetek	Nan
मालदीव	maldív-szigetek	Nan
माल	áruk	None
मार्शल	marsall	None
मार्मिक	megható	Nan
मार्टिन	márton	None
मार्चअप्रैल	március április	Nan
मार्च	március	None
मार्गों	az útvonalak	Nan
मार्गशीर्ष	útfej	Nan
मार्गरेट	margaret	None
मार	megöl	Nan
मारना	ölés	Nan
मारने	ölni	Nan
मारवाड़	marwar	Nan
मारा	találat	Nan
मारी	mari	None
मालूम	ismert	None
मारीच	marich	Nan
मार्क	mark	None
मार्क्स	marx	None
मार्क्सवाद	marxizmus	Nan
मार्क्सवादी	marxista	None
मार्ग	út	None
मार्गदर्शन	tanácsadás	Nan
मारे	elesett	None
माले	férfi	None
मासिक	havi	None
मास्टर	fő-	Nan
मिथ्या	hamis	None
मिनट	perc	None
मिनर्वा	minerva	Nan
मिनी	mini	Nan
मिर्च	chili	Nan
मिर्ज़ा	mirza	Nan
मिथुन	ikrek	Nan
मिर्जा	mirza	Nan
मिलकर	együtt	None
मिलती	kap	None
मिलते	találkozunk	Nan
मिलन	milánó	None
मिलना	kap	None
मिलने	találkozni	Nan
मिल	kap	None
माया	maya	Nan
मिथिला	mithilába	Nan
मित्रों	barátok	None
माह	hónap	None
माहवारी	menstruáció	Nan
माहौल	az atmoszféra	Nan
मिंग	ming	Nan
मिट	kitörölt	Nan
मिटटी	talaj	None
मिथक	mítosz	Nan
मिटा	törli	Nan
मिट्टी	talaj	None
मिठाई	édes	None
मिडिया	média	None
मित्तल	mittal	Nan
मित्र	barát	None
मित्रता	barátság	None
मिटाने	törli	Nan
मिला	találkozott	None
मायनों	szórványosan	Nan
मामूली	kisebb	None
माध्यमिक	másodlagos	None
माधुर्य	dallam	Nan
माधुरी	madhuri	Nan
माधव	madhav	Nan
मादा	női	None
मादक	részegítő	Nan
माथे	homlok	Nan
माथुर	foglalta össze	Nan
मात्रा	a mennyiség	Nan
मात्र	csak	None
मातृभाषा	anya nyelv	Nan
मातृ	anya	None
मातापिता	anya apa	Nan
माता	anya	None
मातरम्	mataram	Nan
मात	teljesítményben felülmúl	Nan
माचिस	gyufaskatulya	Nan
मांगी	keresett	None
मांगे	rüh	Nan
मांस	hús	None
मांसपेशियों	az izmok	Nan
मांसाहारी	nem vegetáriánus	Nan
माइक्रो	micro	Nan
माध्यमों	médiumok	Nan
माइक्रोप्रोसेसर	mikroprocesszor	Nan
माई	mai	None
माउंट	hegy	None
माउण्ट	hegy	None
माउन्टबेटन	mountbatten	Nan
माउस	az egér	Nan
माघ	magh	Nan
माइक्रोसॉफ्ट	microsoft	None
मान	értékek	None
मानकीकरण	szabványosítás	Nan
मानकीकृत	szabványosított	Nan
मानी	elfogadott	None
माने	sörény	Nan
मानो	mintha	None
मान्य	érvényes	None
मान्यता	elismerés	Nan
मान्यताओं	hitek	Nan
माना	egyetért	Nan
माप	a mérés	Nan
मापने	mérő	Nan
मापा	mért	None
मामला	ügy	None
मामले	az esetek	Nan
मामलों	az ügyek	Nan
मामा	anyai nagybátyja	Nan
मापन	mérés	Nan
मायने	jelentés	None
मानसून	monszun	Nan
मानसिंह	man singh	Nan
मानकों	a szabványok	Nan
मानचित्र	térkép	None
मानचित्रावली	térkép	None
मानचित्रों	maps	Nan
मानता	egyetért	Nan
मानती	egyetért	Nan
मानसिक	szellemi	None
मानते	fontolgat	Nan
मानना	elfogad	Nan
मानव	emberi	None
मानवता	emberiség	None
मानवीय	emberi	None
मानस	ész	None
मानसरोवर	mansrovar	Nan
मानद	tiszteletbeli	None
मिलाकर	beleértve	None
मिलान	mérkőzés	None
मिलाने	ráz	Nan
मूल्यों	az értékek	Nan
मूल्यांकन	értékelés	Nan
मूल्यवान	értékes	None
मूल्य	érték	Nan
मूलभूत	alapvető	None
मूलतः	alapvetően	None
मूलत	eredetileg	None
मूल	eredeti	None
मूर्धन्य	magyal	Nan
मूर्तियों	bálványok	Nan
मूर्तियां	szobrok	None
मूर्तियाँ	bálványok	Nan
मूर्तिकला	szobor	None
मूर्त	megfogható	Nan
मूर	moore	None
मूत्रमार्ग	húgycső	Nan
मूत्र	vizelet	Nan
मुरादाबाद	moradabad	Nan
मुलाकात	találkozó	None
मुलायम	puha	Nan
मुश्किल	nehéz	None
मुसलमान	muszlim	None
मुसलमानों	muszlimok	None
मूसा	mózes	None
मुहब्बत	szerelem	None
मुहाने	a száj	Nan
मुहावरा	idióma	Nan
मुहावरे	kifejezésmód	Nan
मुहावरों	szólások	Nan
मुहूर्त	kedvező kezdet	Nan
मूक	csendes	None
मुहम्मद	muhammad	Nan
मृग	antilop	Nan
मृगी	szarvas	None
मृत	a halott	Nan
मेन	fő	None
मेनन	menon	Nan
मेमोरियल	emlékmű	None
मेमोरी	memória	None
मेयर	a polgármester	Nan
मेरा	az én	Nan
मेट्रो	metró	None
मेरूशीर्ष	higany	Nan
मेल	hasonlóság	Nan
मेला	becsületes	None
मेले	becsületes	None
मेवाड	mewad	Nan
मेसोपोटामिया	mezopotámia	None
मेहता	mehta	Nan
मेरे	az én	Nan
मुम्बई	mumbai	Nan
मेटास्टेसिस	áttétel	Nan
मेजर	jelentősebb	None
मृतक	a halott	Nan
मृतोत्थान	feltámadás	Nan
मृत्यु	a halál	Nan
मृदा	talaj	None
मे	én	None
मेँ	én	None
मेटाबोलिज्म	anyagcsere	Nan
में	ban ben	Nan
मेगस्थनीज	megasthenes	Nan
मेघ	felhő	Nan
मेघदूत	meghdoot	Nan
मेच	mérkőzés	None
मेजबान	a gazda	Nan
मेजबानी	tárhely	Nan
मेक्सिको	mexikó	None
मुमताज	mumtaz	Nan
मुफ्त	díjmentesen	Nan
मुनियों	monks	Nan
मीथेन	metán	Nan
मीन	halak	None
मीना	meena	Nan
मीनाक्षी	meenakshi	Nan
मीनार	torony	None
मीराबाई	meera bai	Nan
मीडिया	média	None
मील	mi	None
मुंडा	borotvált	Nan
मुंबई	mumbai	Nan
मुंशी	könyvelő	Nan
मुंह	száj	Nan
मुकदमा	bírósági ügy	Nan
मुकदमे	az ügy	Nan
मुँह	a száj	Nan
मुकाबला	verseny	None
मीठे	édes	None
मीट	hús	None
मिलाया	vegyes	None
मिली	kapott	None
मिलेंगे	találkozni fogunk	Nan
मिलेगा	kapni fog	Nan
मिलेनियर	milliomos	Nan
मिशन	küldetés	None
मीटर	a mérő	Nan
मिशनरी	misszionárius	Nan
मिश्रित	vegyes	None
मिसाल	precedens	Nan
मिस्र	egyiptom	None
मिस्रवासियों	egyiptomiak	Nan
मिस्रवासी	egyiptomiak	Nan
मी	m	None
मिश्रण	a keverék	Nan
मांगने	kérni	Nan
मुकाबले	képest	None
मुकेश	mukesh	Nan
मुग़ल	mogul	Nan
मुझको	nekem	None
मुझसे	velem	Nan
मुझे	nekem	None
मुठभेड़	találkozás	Nan
मुताबिक	alapján	None
मुगलों	mogulok	Nan
मुद्दा	a kérdés	Nan
मुद्दों	problémák	None
मुद्रा	valuta	Nan
मुद्राओं	pénznemek	Nan
मुद्रित	nyomtatott	None
मुनाफ़िक़	nyereség	Nan
मुनि	muni	Nan
मुद्दे	a kérdések	Nan
मुकुट	a korona	Nan
मुगल	mogul	Nan
मुख्यालय	a központ	Nan
मुक्त	ingyenes	None
मुक्ति	szabadság	None
मुख	száj	Nan
मुखपृष्ठ	címoldal	Nan
मुखर	nyílt	None
मुखर्जी	mukherjee	Nan
मुख्‍य	fő	None
मुखिया	a fej	Nan
मुख्यत	főként	None
मुख्यतः	főként	None
मुख्यतया	főként	None
मुख्यधारा	főáram	Nan
मुख्यमंत्री	vezető miniszter	Nan
मुख्यमन्त्री	vezető miniszter	Nan
मुख्य	fő	None
मांग	igény	None
मां	anya	None
माँगी	igény	None
मज़बूत	erős	None
मजबूर	tehetetlen	Nan
मजबूत	erős	None
मजनूँ	majnu	Nan
मजदूरी	bér	Nan
मजदूर	munkás	None
मछली	hal	None
मछलियों	halak	None
मच्छरों	szúnyogok	Nan
मच्छर	szúnyog	Nan
मगहर	maghar	Nan
मगर	de	None
मगध	magadh	Nan
मक्खन	vaj	Nan
मक्का	kukorica	None
मकार	makar	Nan
मकानों	házak	None
मंत्री	miniszter	None
मंत्रों	mantrák	Nan
मंथन	ötletelés	Nan
मंदिर	templom	None
मंदिरों	templomok	None
मंदी	a recesszió	Nan
मज्जा	velő	Nan
मई	lehet	None
मकड़ी	pók	None
मकतौम	maktoum	Nan
मकबरा	mauzóleum	Nan
मकबरे	mauzóleum	Nan
मकर	bak	Nan
मकान	ház	None
मकई	kukorica	None
मठ	a kolostor	Nan
मठों	a kolostorok	Nan
मणि	mani	Nan
मदिरा	borok	None
मदिरालय	a kocsma	Nan
मदीना	medina	Nan
मदुरई	madurai	Nan
मद्रास	madrász	Nan
मधुमक्खी	háziméh	Nan
मदर	anya	None
मधुमती	madhumati	Nan
मधुर	édes	None
मधुशाला	rúd	Nan
मध्य	a közép	Nan
मध्यकाल	középkori időszak	Nan
मध्यकालीन	középkori	None
मध्यपूर्व	közel-kelet	Nan
मधुमेह	cukorbetegség	None
मंत्रियों	a miniszterek	Nan
मदनलाल	madanlal	Nan
मददगार	hasznos	None
मणिकर्णिका	manikarnika	Nan
मण्डप	pavilon	Nan
मण्डल	tábla	None
मत	szavazás	None
मतगणना	a szavazatok számlálása	Nan
मतदाताओं	választók	Nan
मदन	madan	Nan
मतदान	szavazás	None
मतानुसार	a vélemény szerint	Nan
मतों	szavazatok	None
मत्स्य	hal	None
मथुरा	mathura	Nan
मद	tétel	None
मदद	segítség	None
मतभेद	különbség	None
मंत्रिमंडल	a szekrény	Nan
मंत्रिपरिषद	miniszteri tanács	Nan
मंत्रि	a miniszter	Nan
भूषण	kegyelem	Nan
भूस्खलन	földcsuszamlás	Nan
भृगु	bhrigu	Nan
भेंट	az áldozat	Nan
भेज	küld	Nan
भेजना	elküldés	Nan
भूवैज्ञानिक	geológus	Nan
भेजने	elküldés	Nan
भेजे	küld	Nan
भेड़	a bárány	Nan
भेद	megkülönböztetés	Nan
भेदभाव	megkülönböztetés	Nan
भेष	álcázás	Nan
भैंस	bivaly	Nan
भेजी	küldött	None
भैरव	bhairav	Nan
भूल	elfelejtett	Nan
भूमिगत	a földalatti	Nan
भूकंपी	földrengés	None
भूकम्पों	földrengések	None
भूख	éhség	Nan
भूखंड	a telek	Nan
भूगोल	földrajz	None
भूटान	bhután	Nan
भूरे	barna	None
भूत	szellem	None
भूभाग	a terep	Nan
भूमध्य	földközi-tenger	Nan
भूमध्यसागरीय	földközi-tenger	Nan
भूमि	föld	None
भूमिका	szerep	None
भूमिकाओं	szerepek	Nan
भूतपूर्व	az egykori	Nan
मध्यप्रदेश	madhya pradesh	Nan
भैरवनाथ	bhairavnath	Nan
भोग	élvezet	Nan
मंगोलिया	mongólia	Nan
मंगोलों	mongolok	None
मंचू	mandzsu	Nan
मंजिल	padló	Nan
मंजूर	jóváhagy	Nan
मंजूरी	vámkezelés	Nan
मंगोल	mongol	None
मंडप	pavilon	Nan
मंडलों	körök	None
मंडी	piac	None
मंडेला	mandela	Nan
मंत्र	mantra	Nan
मंत्रालय	minisztérium	None
मंत्रालयों	minisztériumok	Nan
मंडल	csoport	None
भोंसले	bhonsle	Nan
मंगेशकर	mangeshkar	Nan
मंगल	mars	None
भोज	ünnep	None
भोजन	étel	None
भोजपुरी	bhojpuri	Nan
भोपाल	bhopal	Nan
भोसले	bhosle	Nan
भौगोलिक	földrajzi	None
मंगलवार	kedd	Nan
भौतिक	fizikai	None
भ्रम	egy mítosz	Nan
भ्रमण	túra	Nan
भ्रमित	zavaros	Nan
भ्रष्ट	korrupt	Nan
भ्रष्टाचार	vesztegetés	Nan
भ्रूण	magzat	None
भौतिकी	fizika	None
मेहनत	kemény munka	Nan
मध्ययुग	középkorú	Nan
मध्यवर्ती	közbülső	Nan
महानगरों	a metrót	Nan
महानगरीय	nagyvárosi	Nan
महानगर	nagyvárosi	Nan
महान	nagy	None
महाद्वीपों	kontinensek	Nan
महाद्वीपीय	kontinentális	None
महाद्वीप	kontinens	None
महादेवी	mahadevi	Nan
महादेव	shiva	Nan
महात्मा	mahatma	Nan
महाकाव्यों	eposz	Nan
महाकाव्य	epikus	Nan
महाकालेश्वर	mahakaleshwar	Nan
महाकाल	mahakala	Nan
महाकवि	nagy költő	Nan
महा	szuper	Nan
महसूस	érez	Nan
महंगी	drága	None
महज	csupán	None
महत्ता	fontosság	Nan
महत्त्व	fontosság	Nan
महत्त्वपूर्ण	fontos	None
महत्व	fontosság	Nan
महानता	nagyság	Nan
महत्वपूर्ण	fontos	None
महत्वाकांक्षी	becsvágyó	Nan
महत्‍वपूर्ण	fontos	None
महमूद	mehmood	Nan
महर्षि	maharishi	Nan
महल	palota	None
महलों	paloták	None
महत्वाकांक्षा	ambíció	Nan
महानदी	mahanadi	Nan
महान्	a nagy	Nan
महापुरुषों	nagyszerű emberek	Nan
महिलाएं	nők	None
महिलाओं	nők	None
महिषासुर	mahishasura	Nan
महीना	hónap	None
महीने	hónap	None
महेंद्र	mahendra	Nan
महिलाएँ	nők	None
महेन्द्र	mahendra	Nan
महोत्सव	fesztivál	None
मा	anya	None
माँ	anya	None
माँग	igény	None
माँगने	kérni	Nan
माँगा	manga	None
महेश	mahesh	Nan
महंगा	drága	None
महिमा	dicsőség	Nan
महासागरीय	óceán	None
महाबलि	mahabali	Nan
महाभारत	mahábhárata	Nan
महामंदी	nagy depresszió	Nan
महामारी	járvány	None
महायान	mahayana	Nan
महायुद्ध	világháború	None
महासागरों	oceans	Nan
महाराज	király	None
महाराणा	maharana	Nan
महारानी	a királynő	Nan
महाराष्ट्र	maharashtra	Nan
महाशक्ति	szuper erő	Nan
महाशिवरात्रि	mahashivratri	Nan
महासागर	óceán	None
महाराजा	király	None
मस्ती	móka	Nan
मस्तिष्क	agy	None
मस्तिषक	agy	None
मनोरंजन	szórakozás	Nan
मनोरम	elragadó	Nan
मनोविक्षिप्ति	pszichózis	Nan
मनोविज्ञान	pszichológia	Nan
मनोविज्ञानी	pszichológus	Nan
मनोवैज्ञानिक	pszichológus	Nan
मनोनीत	jelölt	None
मनोवैज्ञानिकों	pszichológusok	Nan
मन्त्र	mantra	Nan
मन्त्री	miniszter	None
मन्त्रों	mantrák	Nan
मन्दिर	a templom	Nan
मन्दिरों	templomok	None
ममता	egy anya szeretet	Nan
मनोहर	bájos	Nan
ममी	múmia	Nan
मनुस्मृति	manusmriti	Nan
मनु	manu	Nan
मध्यस्थ	közvetítő	Nan
मध्यस्थता	közvetítés	Nan
मध्याह्न	délkör	Nan
मन	az elme	Nan
मनन	elmélkedés	Nan
मनमोहन	manmohan	Nan
मनुष्यों	az emberek	Nan
मना	tagadni	Nan
मनाए	ünnepel	Nan
मनाते	ünneplő	Nan
मनाने	meggyőz	Nan
मनाया	ünnepelt	Nan
मनाये	ünnepel	Nan
मनी	pénz	None
मनाई	ünnepelt	Nan
मध्ययुगीन	középkori	None
मय	lehet	None
मरते	meghalni	Nan
मल्होत्रा	malhotra	Nan
मशहूर	híres	None
मशीन	gép	None
मशीनरी	gépezet	Nan
मशीनी	gép	None
मशीनों	a gépek	Nan
मल्टीमीडिया	multimédia	Nan
मसनवी	masnavi	Nan
मसालों	fűszerek	Nan
मसीह	krisztus	None
मसूरी	mussoorie	Nan
मस्जिद	mecset	Nan
मस्जिदों	mecsetek	Nan
मस्तक	fej	None
मसलन	például	None
मर	meghal	None
मलेशिया	malaysia	Nan
मलिक	malik	Nan
मरने	meghalni	Nan
मरम्मत	megjavítani vagy újratelepíteni	Nan
मराठा	maratha	Nan
मराठी	zászló	None
मराठों	marathas	Nan
मरियम	mary	None
मलेरिया	malária	None
मरीज	türelmes	Nan
मरीना	jachtkikötő	Nan
मरुस्थल	a sivatag	Nan
मर्यादा	szerénység	Nan
मल	ürülék	Nan
मलय	maláj	None
मलयालम	malayalam	Nan
मरीजों	betegek	None
मेहरगढ़	mehargarh	Nan
मेहराब	az ív	Nan
मै	nekem	None
रुझान	a trend	Nan
रुचि	érdeklődés	None
रुख	állvány	Nan
रुक्मिणी	rukmini	Nan
रुका	megállt	Nan
रुकने	megállni	Nan
रुक	fagy	Nan
रीति	mód	None
रीढ़	a gerinc	Nan
रीडर	az olvasó	Nan
रिहा	felszabadított	Nan
रिसाव	a szivárgás	Nan
रिसर्च	kutatás	None
रिश्तेदारों	rokonok	Nan
रिश्तेदार	relatív	None
रिश्ते	kapcsolatok	None
रिश्ता	kapcsolat	None
रिकॉर्ड	a felvétel	Nan
रिकॉर्डिंग	felvétel	None
रिक्शा	riksa	Nan
रिचर्ड	richard	None
रिजर्व	lefoglal	Nan
रिपब्लिकन	köztársasági	None
रुड़की	roorkee	Nan
रिपोर्ट	jelentés	None
रियासत	hercegi állam	Nan
रियो	rio	None
रिलायंस	bizalom	Nan
रिलीज	a kiadás	Nan
रिलीज़	kiadás	None
रिवाजों	a szokások	Nan
रियल	igazi	None
रुद्र	rudra	Nan
रुप	a nyomtatvány	Nan
रुपए	pénz	None
रेखा	vonal	None
रेखाएँ	a vonalak	Nan
रेखाओं	a vonalak	Nan
रेखाचित्र	vázlat	Nan
रेगिस्तान	a sivatag	Nan
रेगिस्तानी	a sivatag	Nan
रेंज	hatótávolság	Nan
रेजिमेंट	ezred	Nan
रेडियो	rádió	None
रेडियोधर्मी	radioaktív	None
रेड्डी	reddy	Nan
रेणु	renu	Nan
रेणुका	renuka	Nan
रेत	a homok	Nan
रेड	piros	None
रिकार्ड	a felvétel	Nan
रे	sugár	None
रूस	oroszország	None
रुपये	rúpiát	Nan
रूचि	érdeklődés	None
रूढ़ियों	egyezmények	Nan
रूढ़िवादी	konzervatív	None
रूप	forma	None
रूपक	metafora	Nan
रूसी	orosz	None
रूपरेखा	a körvonal	Nan
रूपांतरण	az átalakítás	Nan
रूपांतरित	konvertált	Nan
रूपान्तर	átalakítás	Nan
रूपान्तरण	átalakítás	Nan
रूपी	néz	None
रूपों	forms	Nan
रूपांतर	alkalmazkodás	Nan
राहुल	rahul	Nan
राहु	rahu	Nan
राही	utazó	None
राधा	radha	Nan
राधाकृष्ण	radhakrishna	Nan
राधाकृष्णन	radhakrishnan	Nan
रानी	királynő	None
राम	ram	Nan
रामकृष्ण	rámakrisna	Nan
रात्रि	éjszaka	None
रामचंद्र	ramchandra	Nan
रामचरितमानस	ramcharitmanas	Nan
रामजी	ramji	Nan
रामदास	ramdas	Nan
रामदेव	ramdev	Nan
रामधारी	ramdhari	Nan
रामनगर	ramnagar	Nan
रामचन्द्र	ram chandra	Nan
रामनवमी	ram navami	Nan
रात	éjszaka	None
राज्‍य	állapot	None
राजस्थानी	radzsasztáni	Nan
राजस्व	jövedelem	Nan
राजा	király	None
राजाओं	a királyok	Nan
राजी	egyetért	Nan
राजीव	rajeev	Nan
राणा	rana	Nan
राजे	ráje	Nan
राजेन्द्र	rajendra	Nan
राजेश	rajesh	Nan
राज्यपाल	kormányzó	None
राज्यसभा	rajya sabha	Nan
राज्याभिषेक	koronázás	Nan
राज्यॉ	államok	None
राजेंद्र	rajendra	Nan
रेतीले	homokos	Nan
रामनाथ	ramnath	Nan
राममोहन	ram mohan	Nan
राष्ट्रमंडल	nemzetközösség	Nan
राष्ट्रवाद	nacionalizmus	None
राष्ट्रवादी	nacionalista	None
राष्ट्रीय	a nemzeti	Nan
राष्ट्रों	a nemzetek	Nan
राष्‍ट्रीय	nemzeti	None
राष्ट्रभाषा	nemzeti nyelv	Nan
रास	raas	Nan
रासायनिक	kémiai	None
रासो	raso	Nan
रास्ता	út	None
रास्ते	az út	Nan
राह	az út	Nan
राहत	megkönnyebbülés	Nan
रासलीला	rasleela	Nan
रामपुर	rampur	Nan
राष्ट्रपति	elnök	None
राष्ट्र	a nemzet	Nan
रामलीला	ram leela	Nan
रामानंद	ramanand	Nan
रामानन्द	ramanand	Nan
रामानुजन	ramanujan	Nan
रामायण	rámájana	Nan
रामेश्वरम	rámesvaram	Nan
राष्ट्रगान	nemzeti himnusz	Nan
राय	vélemény	None
रायपुर	raipur	Nan
रायबरेली	rae bareli	Nan
राव	rao	Nan
रावण	ravana	Nan
राशि	összeg	Nan
राशियों	csillagjegyek	Nan
रायता	raita	Nan
राजस्थान	rajasthan	Nan
रेफरी	játékvezető	None
रेलगाड़ी	a vonat	Nan
लहरें	a hullámok	Nan
लहर	hullám	None
लसिका	nyirok	Nan
लश्कर-ए-तैयबा	lashkar-e-taiba	Nan
लव	szerelem	None
लय	ritmus	Nan
लम्बे	magas	None
लम्बी	hosszú	None
लम्बाई	hossz	Nan
लम्बा	hosszú	None
लन्दन	london	None
लता	kúszónövény	Nan
लड्डू	laddu	Nan
लडाई	csata	None
लड़ाई	harc	None
लड़ाइयाँ	battles	Nan
लड़ा	harcolt	None
लगाव	attachment	Nan
लगी	el volt foglalva	Nan
लगे	eljegyezve lenni	Nan
लगेगा	fog tartani	Nan
लघु	kicsi	None
लटका	lóg	Nan
लहरों	hullámok	None
लड़	harcoló	None
लड़कियों	lányok	None
लड़की	lány	None
लड़के	a fiúk	Nan
लड़कों	fiúk	None
लड़ते	harcoló	None
लड़ने	harc	None
लड़का	a fiú	Nan
ला	la	None
लाइट	fény	None
लाइन	sorban áll	Nan
लाभ	haszon	Nan
लाभकारी	előnyös	None
लाभदायक	jövedelmező	Nan
लाभप्रद	előnyös	None
लाभों	az előnyök	Nan
लामा	láma	Nan
लापता	hiányzó	None
लायक	érdemes	Nan
लायी	hozott	None
लाये	hoz	None
लार्ड	lord	None
लाल	piros	None
लालटेन	lámpa	Nan
लालबहादुर	lal bahadur	Nan
लाया	hozott	None
लगाये	put	Nan
लाने	hoz	None
लादेन	megrakott	Nan
लाइनों	a vonalak	Nan
लाइफ	élet	None
लाइव	élő	None
लाइसेंस	engedély	None
लाए	hozott	None
लाकर	hozva	Nan
लाना	hoz	None
लाख	százezer	None
लागत	költség	Nan
लागू	alkalmazható	None
लाजपत	lajpat	Nan
लाता	hoz	None
लाती	hoz	None
लाते	hoz	None
लाखों	milliók	Nan
लगायी	alkalmazott	None
लगाया	beültetett	Nan
लगाने	rakni	Nan
रोचक	érdekes	None
रोजगार	foglalkoztatás	Nan
रोड	út	None
रोम	róma	None
रोमन	római	Nan
रोमांस	románc	Nan
रोगों	betegségek	None
रोमानी	romantikus	None
रोलिंग	gördülő	Nan
रोशन	világító	Nan
रोशनी	fény	None
रोहिणी	rohini	Nan
ल	le	None
लंकाकाण्ड	lanka	Nan
रोल	tekercs	None
लंगड़ा	béna	Nan
रोगी	türelmes	Nan
रोग	betegség	None
रेलमार्ग	vasúti pálya	Nan
रेलवे	vasúti	None
रेशम	selyem	Nan
रेशमी	selymes	Nan
रैदास	raidas	Nan
रॉक	szikla	Nan
रोगियों	a betegek	Nan
रॉबर्ट	robert	None
रोक	álljon meg	Nan
रोकता	leállítja	Nan
रोकथाम	megelőzés	Nan
रोकना	álljon meg	Nan
रोकने	megelőzni	Nan
रोका	megállt	Nan
रॉयल	királyi	None
रेल	vasút	None
लंगर	horgony	Nan
लंबा	hosszú	None
लगते	látszik	None
लगना	érez	Nan
लगने	látszik	None
लगभग	ról ről	Nan
लगा	filc	Nan
लगाई	tesz	None
लगती	úgy tűnik,	Nan
लगाए	beültetett	Nan
लगाता	alkalmazása	None
लगातार	folyamatosan	None
लगाती	alkalmaz	Nan
लगाते	alkalmazása	None
लगान	adó	None
लगाना	beállít	Nan
लगाकर	jelentkezés által	Nan
लंदन	london	None
लगता	úgy tűnik,	Nan
लखनऊ	lucknow	Nan
लंबाई	hossz	Nan
लंबी	a hosszú	Nan
लंबे	a hosszú	Nan
लकड़ी	faipari	Nan
लक्षण	tünetek	None
लक्षणा	jellemzők	None
लखनवी	lucknowi	Nan
लक्षणों	tünetek	None
लक्ष्मण	laxman	Nan
लक्ष्मी	lakshmi	Nan
लक्ष्मीबाई	laxmi bai	Nan
लक्ष्य	cél	None
लक्ष्यों	a célok	Nan
लक्स	lux	Nan
लक्षित	célzott	Nan
भूकंप	földrengés	None
राजसी	fejedelmi	None
राजवंशों	dinasztiák	Nan
यीशु	jézus	None
याहू	jehu	Nan
यार्क	york	None
यानी	azaz	None
यानि	azaz	None
यान	a jármű	Nan
यादव	yadav	Nan
यादगार	emlékezetes	None
यात्री	az utazó	Nan
यात्रियों	az utasok	Nan
यात्रा	utazás	None
यातायात	szállítás	Nan
याज्ञवल्क्य	yajnavalkya	Nan
याचिका	kérelem	Nan
याचना	kérő	Nan
यांत्रिक	mechanikai	None
या	vagy	None
यथासंभव	amennyire csak lehetséges	Nan
यदि	ha	None
यद्यपि	habár	None
यम	yama	Nan
यमुना	yamuna	Nan
यश	hírnév	Nan
यु	y	None
यह	ez	None
यहाँ	itt	None
यहां	itt	None
यही	csak ezt	Nan
यहीं	csak itt	Nan
यहूदियों	a zsidók	Nan
यहूदी	zsidó	None
यहा	itt	None
युक्त	tartalmazza	None
युक्ति	tipp	Nan
युक्तियों	tippek	Nan
यूट्यूब	youtube	None
यूनवर्स	világegyetem	None
यूनाइटेड	egyesült	None
यूनान	görögország	None
यूनानी	görög	None
यूनिकोड	unicode	Nan
यूजर	használó	None
यूनिक्स	unix	Nan
यूनियन	unió	None
यूनेस्को	unesco	None
यूपीए	upa	Nan
यूरोप	európa	None
यूरोपिय	európai	None
यूरोपियन	európai	None
यूनिट	mértékegység	Nan
यथार्थवादी	valószerű	Nan
यूक्लिड	eukleidész	Nan
यूँ	mint ez	Nan
युग	a korszak	Nan
युगल	párosít	Nan
युगों	korok	Nan
युग्म	a pár	Nan
युद्घ	a csata	Nan
युद्धों	a háborúk	Nan
यूं	mint ez	Nan
युधिष्ठिर	judhisthíra	Nan
युरोप	európa	None
युवक	fiatal fiú	Nan
युवराज	herceg	None
युवा	fiatal	None
युवाओं	ifjúság	None
युवावस्था	ifjúság	None
युनेस्को	unesco	None
यथार्थवाद	realizmus	None
यथार्थ	igaz	None
यथा	mint	None
मॉनसून	monszun	Nan
मॉरीशस	mauritius	Nan
मॉल	a pláza	Nan
मोक्ष	megváltás	Nan
मोटर	motor	None
मोटर्स	motors	Nan
मॉड्यूल	modul	Nan
मोटा	zsír	Nan
मोटी	zsír	Nan
मोटे	zsíros	Nan
मोडल	módbeli	Nan
मोड़	fordulat	None
मोती	gyöngyszem	Nan
मोतीलाल	motilal	Nan
मोटाई	vastagság	Nan
मोदी	modi	Nan
मॉडलिंग	modellezés	Nan
मैसूर	mysore	Nan
मैं	én vagyok	Nan
मैंने	én	None
मैक	mac	None
मैक्स	max	None
मैच	a meccs	Nan
मैचों	gyufa	Nan
मॉडल	a modell	Nan
मैत्री	barátság	None
मैथुन	közösülés	Nan
मैदान	terület	None
मैदानी	a sima	Nan
मैदानों	a síkság	Nan
मैन	férfi	None
मैने	én	None
मैथिलीशरण	maithilisharan	Nan
यूरोपीय	európai	None
मोनोऑक्साइड	monoxid	Nan
मोमबत्ती	gyertya	Nan
मौसम	időjárás	None
मौसमी	évszaki	Nan
म्यूकर	mukker	Nan
म्यूजिक	zene	None
म्यूजियम	múzeum	None
य	ez	None
मौलिक	eredeti	None
यंत्र	az eszköz	Nan
यकृत	máj	None
यक्ष	yaksha	Nan
यजुर्वेद	yajurved	Nan
यज्ञ	yajna	Nan
यज्ञों	yagyas	Nan
यत्न	szorgalmasan	Nan
यंत्रों	instruments	Nan
मोम	viasz	Nan
मौलाना	maulana	Nan
मौर्य	maurja	Nan
मोर्चा	elülső	None
मोहन	mohan	Nan
मोहनदास	mohandász	Nan
मोहम्मद	mohamed	None
मोहित	szerelmes	None
मौका	lehetőség	None
मौर्यों	mauryans	Nan
मौके	véletlen	None
मौजूदा	létező	None
मौत	a halál	Nan
मौतें	a halálesetek	Nan
मौतों	a halálesetek	Nan
मौद्रिक	pénzügyi	None
मौन	csend	Nan
मौजूद	ajándék	Nan
राजशाही	monarchia	None
ये	ezek	None
योग	jóga	Nan
राक्षस	démon	Nan
राकेश	rakesh	Nan
राउटर	router	Nan
राइबोसोम	a riboszóma	Nan
राँची	ranchi	Nan
रहो	marad	None
रहेगी	marad	None
रहेगा	marad	None
रहेंगे	marad	None
रहें	marad	None
रहे	vannak	None
रहीम	rahim	Nan
रहीं	maradt	None
रही	csinál	Nan
रहित	szabad	None
रहा	maradt	None
रहस्यों	a rejtélyek	Nan
रवीन्द्रनाथ	rabindranath	Nan
रस	gyümölcslé	Nan
रसायन	vegyszerek	Nan
रसूल	rasool	Nan
रसोई	konyha	None
रस्सी	kötél	Nan
राक्षसी	démoni	Nan
रह	marad	None
रहता	tart	None
रहते	élő	None
रहना	élő	None
रहने	élő	None
रहमान	rahman	Nan
रहस्य	rejtély	None
रहकर	maradva	Nan
राक्षसों	a démonok	Nan
राख	a hamu	Nan
राखी	rakhi	Nan
राजनीती	politika	None
राजनेता	a politikus	Nan
राजनैतिक	politikai	None
राजन्	rajan	Nan
राजपथ	országút	Nan
राजपूत	rádzsput	Nan
राजनीतिज्ञ	politikus	None
राजपूताना	rajputana	Nan
राजभाषा	hivatalos nyelv	Nan
राजमहल	palota	None
राजमार्ग	országút	Nan
राजमार्गों	autópályák	None
राजवंश	dinasztia	None
राजवंशीय	dinasztikus	Nan
राजपूतों	rádzsputok	Nan
रवि	nap	None
राजनीतिक	politikai	None
राजनितिक	politikai	None
राग	a dallam	Nan
राघव	raghav	Nan
राज	szabály	None
राजकीय	állapot	None
राजकुमार	herceg	None
राजकुमारी	hercegnő	None
राजनीति	politika	None
राजगद्दी	trón	None
राजतंत्र	monarchia	None
राजतन्त्र	monarchia	None
राजदूत	nagykövet	Nan
राजधानियों	capitals	Nan
राजधानी	főváros	None
राजनयिक	diplomata	Nan
राजगुरु	rajguru	Nan
रमेश	ramesh	Nan
रमण	raman	Nan
रफ्तार	sebesség	None
रंगे	festett	None
रंगों	a színek	Nan
रंगोली	rangoli	Nan
रंजन	ranjan	Nan
रक्त	vér	None
रक्तचाप	vérnyomás	None
रंगीन	színes	None
रक्तस्त्राव	vérzés	Nan
रक्षाबंधन	raksha bandhan	Nan
रख	tart	None
रखकर	helyezve	Nan
रखता	tartja	None
रखती	tart	None
रखना	tartani	None
रक्षा	védelem	None
रखने	tart	None
रंगमंच	színpad	Nan
रंगबिरंगे	színes	None
योगदान	hozzájárulás	Nan
योगी	jógi	Nan
योग्य	alkalmas	None
योग्यता	jogosultsági	Nan
योजन	terv	None
योजना	terv	None
रंगभेद	faji megkülönböztetés	Nan
योजनाओं	a tervek	Nan
योनि	hüvely	Nan
यौगिक	összetett	None
यौगिकों	vegyületek	None
यौन	szexuális	None
र	su	Nan
रंग	szín	None
योद्धा	a harcos	Nan
यों	mint ez	Nan
रखरखाव	karbantartás	Nan
रखी	terített	Nan
रजिस्टर	regisztráció	Nan
रज्जब	rajjab	Nan
रणनीति	a stratégia	Nan
रणनीतिक	stratégiai	None
रणनीतियां	a stratégiák	Nan
रणनीतियों	stratégiák	Nan
रजत	ezüst	None
रतन	ékszer	Nan
रत्न	drágakő	Nan
रत्नाकर	ratnakar	Nan
रथ	szekér	Nan
रद्द	törölve	Nan
रन	fuss	Nan
रफ़ी	rafi	Nan
रतिक्रीड़ा	vér sport	Nan
रखा	tartotta	None
रज	uralom	None
रची	kikelt	Nan
रखे	tart	None
रखें	tart	None
रग्बी	rögbi	Nan
रचना	képződés	Nan
रचनाएँ	készítmények	Nan
रचनाएं	készítmények	Nan
रचे	alkotó	None
रचनाओं	készítmények	Nan
रचनाकाल	létrehozási idő	Nan
रचनात्मक	kreatív	Nan
रचनायें	készítmények	Nan
रचयिता	szerző	None
रचा	gyárt	Nan
रचित	tagjai:	Nan
रचनाकार	teremtő	Nan
भूआकृति	tájkép	Nan
भू	föld	None
भुवनेश्वर	bhubaneswar	Nan
प्रशासित	beadott	Nan
प्रशासनिक	közigazgatási	None
प्रशासकीय	közigazgatási	None
प्रशासक	adminisztrátor	Nan
प्रशान्त	békés	None
प्रशांत	békés	None
प्रशस्ति	dicséret	Nan
प्रशस्त	kiterjedt	None
प्रशंसा	felértékelődés	Nan
प्रशंसक	a rajongó	Nan
प्रवेशद्वार	belépési kapu	Nan
प्रवेश	belép	Nan
प्रवृत्तियों	a trendek	Nan
प्रवृत्ति	irányzat	None
प्रवृत्त	hatályban	Nan
प्रवृति	természet	None
प्रवीण	jártas	Nan
प्रयोजनों	cél	None
प्रर्दशित	igazolták	Nan
प्रलय	holocaust	None
प्रलेख	a dokumentum	Nan
प्रलेखों	a dokumentumok	Nan
प्रवचन	prédikáció	Nan
प्रशिक्षण	kiképzés	Nan
प्रवर्तक	elősegítő	None
प्रवास	a tartózkodás	Nan
प्रवासियों	a kivándorlók	Nan
प्रवासी	vándorló	Nan
प्रवाह	folyam	Nan
प्रवाहित	folyt	None
प्रविष्ट	lépett	None
प्रवर्धक	erősítő	Nan
प्रशिक्षित	kiképzett	Nan
प्रश्न	kérdések	None
प्रश्नों	kérdések	None
प्रस्तुतीकरण	benyújtása	Nan
प्रस्थान	indulás	Nan
प्रहार	puffanás	Nan
प्रह्लाद	prahlad	Nan
प्रांगण	az udvar	Nan
प्रांत	a tartomány	Nan
प्रस्तुतिकरण	bemutatás	Nan
प्रांतस्था	cortex	Nan
प्रांतों	a tartományok	Nan
प्राकृत	prakrit	Nan
प्राकृतिक	természetes	None
प्रागैतिहासिक	őskori	Nan
प्राचीन	ősi	None
प्राचीनकाल	ókori idő	Nan
प्रांतीय	vidéki	None
प्रयोजन	a cél	Nan
प्रस्तुति	bemutatás	Nan
प्रस्तावित	a javaslat szerint	Nan
प्रसंग	kontextus	Nan
प्रसन्न	boldog	None
प्रसन्नता	boldogság	Nan
प्रसव	kézbesítés	Nan
प्रसाद	szent áldozatok	Nan
प्रसाधन	wc	Nan
प्रस्तुत	bemutatta	None
प्रसारण	broadcasting	Nan
प्रसिद्द	híres	None
प्रसिद्ध	híres	None
प्रसिद्धि	a hírnév	Nan
प्रसिध्द	híres	None
प्रस्ताव	javaslat	Nan
प्रस्तावना	előszó	Nan
प्रसारित	vetítve	Nan
प्रयोगों	kísérletek	None
प्रयोगात्मक	kísérleti	None
प्रयोगशालाओं	laboratories	Nan
प्रदाताओं	szolgáltatók	Nan
प्रदान	biztosítani	None
प्रदूषक	szennyezőanyag	Nan
प्रदूषकों	szennyező anyagok	Nan
प्रदूषण	környezetszennyezés	Nan
प्रदूषित	szennyezett	Nan
प्रदर्शित	megjelenik	None
प्रदेश	vidék	None
प्रधान	legfontosabb	None
प्रधानता	kiemelten fontos	Nan
प्रधानमंत्री	miniszterelnök	None
प्रधानमन्त्री	miniszterelnök	None
प्रपत्र	forma	None
प्रबंध	vezetés	None
प्रदेशों	területek	None
प्रबंधक	menedzser	Nan
प्रदर्शनों	bemutatók	Nan
प्रदत्त	fizetett	None
प्रतिस्पर्धी	kompetitív	Nan
प्रतीक	szimbólum	None
प्रतीकात्मक	szimbolikus	None
प्रतीकों	szimbólumok	Nan
प्रतीक्षा	várjon	Nan
प्रतीत	látszik	None
प्रदर्शन	kijelző	Nan
प्रत्यंग	ragassza	Nan
प्रत्यय	képző	Nan
प्रत्याशा	előérzet	Nan
प्रत्येक	mindenki	None
प्रथम	első	None
प्रथा	egyedi	None
प्रथाओं	a gyakorlatok	Nan
प्रत्यक्ष	nyilvánvaló	None
प्राचीनतम	a legrégebbi	Nan
प्रबंधकों	a vezetők	Nan
प्रबन्ध	vezetés	None
प्रमस्तिष्क	nagyagy	Nan
प्रमाण	a bizonyíték	Nan
प्रमाणित	hitelesített	Nan
प्रमाणों	a bizonyítékok	Nan
प्रमुख	fő	None
प्रमुखता	kiemelkedés	Nan
प्रभुत्व	az uralom	Nan
प्रयत्न	próbáld ki	Nan
प्रयास	erőfeszítés	Nan
प्रयासों	erőfeszítések	Nan
प्रयोक्ता	a felhasználó	Nan
प्रयोग	kísérlet	None
प्रयोगकर्ता	a felhasználó	Nan
प्रयोगशाला	a laboratórium	Nan
प्रयत्नों	erőfeszítések	Nan
प्रबंधन	vezetés	None
प्रभुता	szuverenitás	Nan
प्रभास	ragyogás	Nan
प्रबन्धन	vezetés	None
प्रबलता	túlsúly	Nan
प्रबुद्ध	felvilágosult	Nan
प्रभा	prabha	Nan
प्रभाकर	prabhakar	Nan
प्रभाग	a megosztás	Nan
प्रभु	lord	None
प्रभात	reggel	None
प्रभाव	hatás	None
प्रभावकारी	hatékony	None
प्रभावित	befolyásolt	Nan
प्रभाविता	hatékonyság	Nan
प्रभावी	hatékony	None
प्रभावों	a hatások	Nan
प्रभार	díj	None
प्रतिष्ठित	kiváló	None
प्राण	élet	None
प्राणियों	a lények	Nan
फ़िर	újra	None
फ़िजी	fiji	Nan
फ़ारसी	perzsa	None
फ़ारस	perzsa	None
फ़ायदा	nyereség	Nan
फ़सल	vág	Nan
फ़ल	fal	None
फ़रवरी	február	None
फ़	f	Nan
फहराया	kitűzte	Nan
फहराना	emelni	Nan
फसलों	növények	None
फसलें	a növények	Nan
फसल	vág	Nan
फलों	a gyümölcsök	Nan
फली	a hüvely	Nan
फलस्वरूप	ennek eredményeként	Nan
प्लेटो	plató	Nan
प्लेटों	a tányérok	Nan
प्लेयर	a játékos	Nan
फंड	alap	None
फकीर	szent	None
फतेहपुर	fatehpur	Nan
फ़िल्म	film	None
फरवरी	február	None
फर्म	cég	None
फर्मियान	fermionos	Nan
फर्श	szintjei	Nan
फल	a gyümölcs	Nan
फलत	ennek eredményeként	Nan
फलस्वरुप	ennek eredményeként	Nan
फर्क	a különbség	Nan
फ़िल्मफेयर	filmfare	Nan
फ़िल्मी	a film	Nan
फ़िल्में	a filmek	Nan
फार्म	a nyomtatvány	Nan
फाल्गुन	phalgun	Nan
फिजी	fiji	Nan
फिट	elfér	Nan
फिनलैंड	finnország	None
फिर	újra	None
फारसी	perzsa	None
फिलहाल	egyelőre	None
फिलोसोफी	filozófia	None
फिल्म	film	None
फिल्मफेयर	filmfare	Nan
फिल्मी	hártyás	Nan
फिल्में	a filmek	Nan
फिल्मों	a filmek	Nan
फिलिस्तीन	palesztina	None
प्लेटफार्म	felület	None
फायरफॉक्स	firefox	None
फायदा	nyereség	Nan
फ़ेस	arc	Nan
फ़ैल	az esés	Nan
फ़ॉन्ट	betűtípus	Nan
फ़ोन	a telefon	Nan
फ़ोर्तूना	fortuna	Nan
फ़्रांस	franciaország	None
फायदे	előny	Nan
फ़्रांसिसी	francia	None
फाँसी	függő	None
फाइनल	végső	None
फाइनेंस	pénzügy	Nan
फाइल	a fájl	Nan
फाइलों	files	Nan
फाउंडेशन	az alapítás	Nan
फ़्रांसीसी	francia	None
प्लास्मोडियम	plasmodium	Nan
प्लास्टिक	műanyag	None
प्लान	terv	None
प्रारंभ	rajt	Nan
प्रारंभिक	a kezdeti	Nan
प्रारम्भ	rajt	Nan
प्रारम्भिक	a kezdeti	Nan
प्रारूप	a formátum	Nan
प्रारूपिक	tipikus	None
प्रायोगिक	kísérleti	None
प्रार्थना	ima	Nan
प्रासंगिक	ide vonatkozó	Nan
प्रासंगिकता	fontosság	Nan
प्रासाद	palota	None
प्रिय	kedves	None
प्रियव्रत	dearvrat	Nan
प्रिया	priya	Nan
प्रावधान	ellátás	Nan
प्रेक्षकों	megfigyelők	Nan
प्रायद्वीप	félsziget	None
प्राय	általában	None
प्राणी	teremtmény	Nan
प्राणों	élet	None
प्रात	reggel	None
प्रातकाल	reggel	None
प्राथमिकता	kiemelten fontos	Nan
प्रादुर्भाव	evolúció	None
प्रायः	általában	None
प्रादेशिक	területi	None
प्रान्त	tartomány	None
प्रान्तों	tartományok	None
प्राप्त	kap	None
प्राप्ति	attainment	Nan
प्रामाणिक	hiteles	None
प्रामाणिकता	hitelesség	Nan
प्राधिकरण	hatóság	None
प्राणायाम	pránajáma	Nan
प्रेक्षण	megfigyelés	Nan
प्रेमचंद	premchand	Nan
प्रोटॉन	proton	Nan
प्रोटोकॉल	a protokoll	Nan
प्रोटोज़ोआ	véglények	Nan
प्रोत्साहन	bátorítás	Nan
प्रोत्साहित	felbátorodva	Nan
प्रोफ़ेसर	egyetemi tanár	Nan
प्रोटेस्टेंट	protestáns	None
प्रोफेसर	egyetemi tanár	Nan
प्रोस्टेट	prosztata	Nan
प्रौद्योगिकियों	technologies	Nan
प्रौद्योगिकी	technológia	None
प्लस	plusz	None
प्लांट	növény	None
प्लाज्मा	vérplazma	Nan
प्रोसेसर	a processzor	Nan
प्रेम	a szerelem	Nan
प्रोटीन	fehérje	Nan
प्रोग्रामों	programok	None
प्रेमिका	szerető	Nan
प्रेमियों	szerelmesek	Nan
प्रेमी	a szerető	Nan
प्रेरक	motivációs	Nan
प्रेरणा	ihlet	Nan
प्रेरित	inspire	Nan
प्रोटान	proton	Nan
प्रेषित	küldött	None
प्रेसिडेंसी	elnökség	Nan
प्रेसीडेंसी	elnökség	Nan
प्रो	pro	None
प्रोग्राम	a program	Nan
प्रोग्रामन	programozás	Nan
प्रोग्रामिंग	programozás	Nan
प्रेस	a sajtó	Nan
फीका	áttűnés	Nan
प्रतिष्ठा	presztízs	Nan
प्रतिवर्ष	évente	None
पूरे	az egész	Nan
पूरी	teljes	None
पूरा	egész	None
पूरब	keleti	None
पूरक	kiegészítés	Nan
पूना	poona	Nan
पूज्य	tiszteletreméltó	Nan
पूजा	ima	Nan
पूजन	az imádat	Nan
पूछे	kérdez	Nan
पूछा	kérdezte	Nan
पूंजीवादी	kapitalista	Nan
पूँजीवादी	kapitalista	Nan
पूँजीवाद	kapitalizmus	None
पूँजी	főváros	None
पू	poo	Nan
पुस्तकों	a könyvek	Nan
पुर्तगाल	portugália	None
पुर्तगालियों	portugál	None
पुर्तगाली	portugál	None
पुल	a híd	Nan
पुलिस	rendőrség	None
पुष्टि	megerősítés	Nan
पूर्ण	teljes	None
पुष्प	virág	None
पुष्य	pushya	Nan
पुष्यमित्र	pushyamitra	Nan
पुस्तक	könyv	None
पुस्तकालय	könyvtár	None
पुस्तकालयों	könyvtárak	None
पुस्तकें	a könyvek	Nan
पुष्पण	virágzás	Nan
पूर्णत	teljesen	None
पूर्णतः	teljesen	None
पूर्णतया	teljesen	None
पृथ्वीराज	prithviraj	Nan
पृष्ट	oldal	None
पृष्ठ	oldal	None
पृष्ठों	oldalak	None
पे	tovább	None
पेंशन	nyugdíj	Nan
पृथ्वी	föld	None
पेज	az oldal	Nan
पेटेंट	a szabadalom	Nan
पेट्रोलियम	petróleum	Nan
पेठ	peth	Nan
पेड	fa	None
पेड़पौधे	fák és növények	Nan
पेड़ों	a fák	Nan
पेट	gyomor	None
पुरे	egész	None
पृथक्करण	az elválasztás	Nan
पूसा	pusa	Nan
पूर्णिमा	telihold	Nan
पूर्ति	kínálat	Nan
पूर्व	keleti	None
पूर्वक	előnyösen	Nan
पूर्वज	ős	Nan
पूर्वजों	az ősök	Nan
पृथक्	különálló	None
पूर्वराजवंशीय	előző	None
पूर्वविधान	ótestamentum	Nan
पूर्वानुमान	előrejelzés	Nan
पूर्वार्ध	első fél	Nan
पूर्वी	keleti	None
पूर्वोक्त	fent említett	Nan
पूर्वोत्तर	északkeleti	None
पूर्ववर्ती	előző	None
पुरूष	férfiak	None
पुरुषोत्तम	purushottam	Nan
पुरुषवाचक	férfias	Nan
पीढ़ी	a generáció	Nan
पीढी	egy generáció	Nan
पीते	ital	None
पीना	inni	Nan
पीने	ivás	Nan
पीनेवाला	ivó	Nan
पीढ़ियों	generációk	Nan
पीनेवाले	itatók	Nan
पीपी	pp	Nan
पीरियड	időszak	None
पीला	sárga	None
पीली	sárga	None
पीले	sárga	None
पीस	béke	None
पीपल	ficus religiosa	Nan
पीसकर	darál	Nan
पीड़ित	az áldozat	Nan
पीटर	péter	None
पिच	a hangmagasság	Nan
पिछड़े	hátrafelé	Nan
पिछली	előző	None
पितामह	nagy apa	Nan
पित्त	epe	Nan
पिनकृमि	pinworm	Nan
पीठ	a hátsó	Nan
पिमलिको	pimlico	Nan
पिलाने	táplálás	Nan
पी	p	None
पीक	csúcs	Nan
पीकर	ivással	Nan
पीछा	a hajsza	Nan
पीछे	mögött	None
पिरामिड	piramis	Nan
पेनाल्टी	büntetés	None
पीसी	pc	None
पुख्ता	erős	None
पुरस्कृत	jutalmazta	Nan
पुरा	teljes	None
पुराणों	mitológia	None
पुरातत्त्व	régészet	Nan
पुरातत्व	régészet	Nan
पुरातत्वविदों	régészek	Nan
पुरस्कार	díj	None
पुरातन	az ősi	Nan
पुराना	régi	None
पुरानी	régi	None
पुराने	régebbi	None
पुरापाषाण	paleolit	Nan
पुरी	puri	Nan
पुरुष	férfi	None
पुरातात्विक	régészeti	None
पुकारा	kiáltott	Nan
पुर	pur	Nan
पुनर्जीवित	újjáéledt	Nan
पुजारियों	a papok	Nan
पुजारी	pap	None
पुट	put	Nan
पुणे	pune	Nan
पुण्य	szent	None
पुत्री	lánya	None
पुनर्निर्माण	újjáépítés	Nan
पुत्रों	sons	Nan
पुनः	újra	None
पुनरीक्षण	felülvizsgálat	Nan
पुनरुत्थान	feltámadás	Nan
पुनर्गठन	átszervezés	Nan
पुनर्जन्म	újjászületés	Nan
पुनर्जागरण	reneszánsz	None
पुन	újra	None
प्रतिशत	százalék	Nan
पेय	az ital	Nan
पेरू	peru	None
प्रताप	felség	Nan
प्रणेता	úttörő	Nan
प्रणीत	pranit	Nan
प्रणाली	rendszer	None
प्रणालियों	a rendszerek	Nan
प्रणालियां	a rendszerek	Nan
प्रणालियाँ	a rendszerek	Nan
प्रणाम	üdvözlet	Nan
प्रणव	pranav	Nan
प्रणयन	szerelem	None
प्रणय	szerelem	None
प्रज्ञा	bölcsesség	Nan
प्रजापति	teremtő	Nan
प्रजातियों	a faj	Nan
प्रजातियां	a faj	Nan
प्रजातियाँ	faj	None
प्रजाति	a faj	Nan
प्रख्यात	neves	None
प्रगति	előrehalad	Nan
प्रगतिशील	haladó	None
प्रचलन	a trend	Nan
प्रचलित	népszerű	None
प्रचार	nyilvánosság	None
प्रतापी	fenséges	Nan
प्रचारक	elősegítő	None
प्रचारिणी	publicista	Nan
प्रचारित	promotált	Nan
प्रचालन	a művelet	Nan
प्रचुर	bőven	None
प्रजनन	reprodukció	Nan
प्रजा	emberek	None
प्रचारप्रसार	propaganda	None
प्रति	per	None
प्रतिकूल	kedvezőtlen	None
प्रतिकृति	hasonmás	Nan
प्रतिमा	a szobor	Nan
प्रतिमाओं	bálványok	Nan
प्रतिमान	modell	None
प्रतियोगिताओं	a versenyek	Nan
प्रतियोगियों	a versenyzők	Nan
प्रतियोगी	a versenyző	Nan
प्रतिभा	tehetség	Nan
प्रतिरक्षा	immunitás	Nan
प्रतिरूप	modell	None
प्रतिरोध	ellenállás	None
प्रतिरोधक	rezisztív	Nan
प्रतिरोधी	ellenálló	Nan
प्रतिलिपि	másolat	Nan
प्रतिलेखन	átírás	Nan
प्रतिरक्षी	védelem	None
प्रखर	éles	None
प्रतिबिम्ब	kép	None
प्रतिबन्ध	korlátozás	Nan
प्रतिक्रिया	reakció	None
प्रतिक्रियाओं	reakciók	Nan
प्रतिज्ञा	az ígéret	Nan
प्रतिदिन	minden nap	Nan
प्रतिद्वंद्वी	vetélytárs	Nan
प्रतिनिधि	reprezentatív	Nan
प्रतिबिंबित	tükröznie	Nan
प्रतिनिधित्व	reprezentáció	Nan
प्रतिपदा	verseny	None
प्रतिपादन	vakolás	Nan
प्रतिपादित	felveti	Nan
प्रतिपुरुष	főszereplő	None
प्रतिबंधित	korlátozott	None
प्रतिबंधों	a korlátozások	Nan
प्रतिनिधियों	a képviselők	Nan
प्रक्षेपास्त्र	rakéta	None
प्रक्षेप	interpoláció	Nan
प्रक्रियाओं	eljárások	None
पैरामिसियम	paramisium	Nan
पैरिस	párizs	None
पैरों	a lábak	Nan
पैलेस	a palota	Nan
पैसा	a pénz	Nan
पैसों	pénz	None
पैराग्वे	paraguay	Nan
पॉटर	fazekas	None
पॉडकास्टिंग	podcasting	Nan
पॉप	pop	None
पॉल	pál	None
पॉलीन्या	paulina	None
पोजीशन	a pozíció	Nan
पोप	pápa	None
पॉडकास्ट	podcast	Nan
पोर्ट	kikötő	None
पैर	láb	None
पैनल	panel	Nan
पेश	ajándék	Nan
पेशकश	ajánlat	Nan
पेशवा	peshwa	Nan
पेशाब	vizelet	Nan
पेशियों	az izmok	Nan
पेशे	a szakma	Nan
पैमाने	a mérleg	Nan
पेशेवर	szakmai	None
पैगम्बर	próféta	None
पैग़म्बर	próféta	None
पैतृक	apai	None
पैदल	gyalog	None
पैदा	született	None
पैदावार	hozam	Nan
पैकेजिंग	a csomagolás	Nan
पेरिस	párizs	None
पोर्ट-ऑ-प्रिंस	port-au-prince	Nan
पोलिश	fényesít	Nan
प्रकार	típus	None
प्रकारों	típusai	None
प्रकाश	fény	None
प्रकाशन	kiadvány	None
प्रकाशनों	közlemények	Nan
प्रकाशसंश्लेषण	fotoszintézis	Nan
प्रकल्प	program	None
प्रकाशिकी	optika	Nan
प्रकाशीय	optikai	None
प्रकीर्णन	szóródás	Nan
प्रकृति	természet	None
प्रकोप	a kitörés	Nan
प्रक्रिया	folyamat	None
प्रक्रियाएं	a folyamatok	Nan
प्रकाशित	közzétett	Nan
पोर्टल	portál	None
प्रकरण	ügy	None
प्यास	szomjúság	Nan
पोलैंड	lengyelország	None
पोशाक	a ruha	Nan
पोषक	tápláló	Nan
पोषित	dédelgetett	Nan
पोस्ट	posta	Nan
पौड़ी	pauri	Nan
प्यूपा	báb	Nan
पौत्र	unokája	None
पौधे	a növények	Nan
पौधों	a növények	Nan
पौराणिक	legendás	None
प्यार	szeretet	None
प्याला	tál	Nan
प्याले	a poharak	Nan
पौधा	növény	None
लाहौर	lahore	Nan
फीड	takarmány	Nan
फील्ड	terület	None
बैटरी	az elem	Nan
बैट	denevér	Nan
बैंड	a zenekar	Nan
बैंगनी	lila	None
बैंकों	banks	Nan
बैंकिंग	banki	Nan
बैंकर	a bankár	Nan
बैंक	bank	None
बेहद	rendkívüli módon	Nan
बेहतरीन	a legjobb	Nan
बेहतर	jobb	None
बेसिन	a medence	Nan
बेसिक	alapvető	None
बेस	bázis	None
बेल्जियम	belgium	None
बेल	harang	Nan
बेरोजगारी	munkanélküliség	None
बुश	bokor	Nan
बूट	a csizma	Nan
बृहस्पति	jupiter	None
बेंच	a padon	Nan
बेक	intés	Nan
बेगम	királynő	None
बैठ	ül	Nan
बेग़म	begum	Nan
बेटद्वारका	betdwarka	Nan
बेटा	fiú	None
बेटी	lánya	None
बेटे	fiú	None
बेदी	bedi	Nan
बेन	ben	None
बेचने	elad	Nan
बैठक	a találkozás	Nan
बैठकों	az ülések	Nan
बैठता	ül	Nan
बोलता	beszél	None
बोलते	beszél	None
बोलना	beszel	Nan
बोलने	beszélő	None
बोला	beszéltem	Nan
बोलियाँ	ajánlatok	Nan
बोलचाल	beszélt	None
बोलियों	ajánlatok	Nan
बोली	nyelv	None
बोले	beszél	None
बोस	főnök	None
बौद्ध	buddhista	None
बौद्धिक	szellemi	None
बौद्धों	buddhisták	Nan
बोलिविया	bolívia	None
बुलाया	hívott	None
बोल	dalszöveg	Nan
बोनापार्ट	bonaparte	None
बैठते	ül	Nan
बैठने	ül	Nan
बैठा	ült	None
बैठें	ül	Nan
बैर	gyűlölet	Nan
बैरम	bairam	Nan
बोर्ड	tábla	None
बैल	a bika	Nan
बॉम्बे	bombay	Nan
बॉल	labda	None
बोझ	teher	Nan
बोध	érzék	Nan
बोधक	magyarázó	Nan
बोनसाई	bonsai	Nan
बॉक्स	doboz	Nan
बुर्ज	tornyocska	Nan
बुरे	a rossz	Nan
बुरी	a rossz	Nan
बिंदुओं	dots	Nan
बिक्री	az eladás	Nan
बिखरे	elszórt	Nan
बिजनेस	üzleti	None
बिजली	villám	Nan
बिड़ला	birla	Nan
बिंदु	pont	None
बिताया	költött	Nan
बिन्दु	a pont	Nan
बिन्दुसार	bindusara	Nan
बियर	sör	None
बिल	számla	Nan
बिलियन	milliárd, ezermillió	Nan
बिल्कुल	teljesen	None
बिन	kuka nélkül	Nan
बिल्ली	macska	None
बाह्यसूत्र	felhám	Nan
बाहरी कड़ियाँ	külső linkek	Nan
बारीक	bírság	Nan
बारे	ról ről	Nan
बाल	gyermek	None
बालक	fiú	None
बालकाण्ड	óvoda	None
बालकृष्ण	balakrishna	Nan
बाह्य	külső	None
बालाजी	balaji	Nan
बालिका	lány	None
बाली	bali	Nan
बालों	haj	Nan
बाल्टिक	balti	None
बाल्यकाल	gyermekkor	Nan
बावजूद	annak ellenére	Nan
बालि	bali	Nan
ब्याज	érdeklődés	None
बिस्तर	ágy	Nan
बिहारी	bihari	None
बीसवीं	huszadik	None
बुंदेलखंड	bundelkhand	Nan
बुक्स	könyvek	None
बुखार	láz	None
बुगरा	bugra	Nan
बुद्ध	buddha	None
बीसवी	huszadik	None
बुद्धि	bölcsesség	Nan
बुध	házasodik	Nan
बुधवार	szerda	Nan
बुनियादी	alapvető	None
बुरा	a rossz	Nan
बुराइयों	evils	Nan
बुराई	gonosz	None
बुद्धिमान	intelligens	None
बिहार	bihar	Nan
बीमारी	betegség	None
बीमार	beteg	None
बी	b	Nan
बीएसई	bét	Nan
बीकानेर	bikaner	Nan
बीच	között	None
बीज	mag	None
बीजिंग	peking	Nan
बीमारियों	betegségek	None
बीजों	a magok	Nan
बीटी	bt	None
बीत	eltelt	None
बीता	múlt	None
बीबीसी	bbc	None
बीम	gerenda	Nan
बीमा	biztosítás	Nan
बीटा	beta	Nan
बारी	fordulat	None
ब्यूरो	hivatal	None
ब्रजभाषा	braj bhasha	Nan
भारी	nehéz	None
भारद्वाज	bhardwaj	Nan
भारतेन्दु	bharatendu	Nan
भारतीयों	indiánok	None
भारतीय	indián	None
भारती	indián	None
भारतवर्ष	india	None
भारत	india	None
भार	teher	Nan
भाभी	sógornő	Nan
भाप	gőz	Nan
भाड़े	hacks	Nan
भाटिया	bhatia	Nan
भाट	vándorénekes	Nan
भाजपा	b j p	Nan
भाग्य	szerencse	Nan
भागो	fuss	Nan
भस्म	fogyasztani	Nan
भाँति	tetszik	None
भांग	kender	Nan
भाइयों	brothers	None
भाई	fiú testvér	Nan
भाईचारे	testvériség	Nan
भालू	medve	None
भाग	fuss	Nan
भागफल	hányados	Nan
भागलपुर	bhagalpur	Nan
भागवत	bhagwat	Nan
भागीदार	a partner	Nan
भागीदारी	részvétel	None
भागीरथी	bhagirathi	Nan
भागने	menekülni	None
भावना	érzés	None
भावनाओं	érzések	Nan
भावनात्मक	érzelmi	None
भिन्नभिन्न	különböző	None
भी	is	None
भीड	tömeg	None
भीड़	tömeg	None
भीतर	belül	None
भीतरी	a belső	Nan
भिन्नता	a különbség	Nan
भीमगोडा	bhimgoda	Nan
भीषण	rettenetes	Nan
भुगतान	fizetés	Nan
भुजा	a kar	Nan
भुजाओं	a karok	Nan
भुला	elfelejtett	Nan
भुवन	bhuvan	Nan
भीमराव	bheemrao	Nan
भव्यता	nagyszerűség	Nan
भित्ति	fal	None
भास्कर	bhaskar	Nan
भावी	jövő	None
भावे	bhave	Nan
भावों	kifejezések	None
भाषण	beszéd	None
भाषा	nyelv	None
भाषाई	nyelvi	None
भि	is	None
भाषाएँ	nyelvek	None
भाषाओं	nyelvek	None
भाषापरिवार	nyelvcsalád	None
भाषायें	nyelvek	None
भाषाविज्ञान	nyelvtudomány	Nan
भाषी	beszélő	None
भाष्य	kommentár	Nan
भाषाएं	nyelvek	None
भव्य	nagy	None
भविष्यवाणी	jóslás	Nan
भविष्य	jövő	None
ब्रिटेन	britannia	None
ब्रितानी	angol	None
ब्रॉडबैंड	szélessávú	Nan
ब्लाग	blog	None
ब्लू	kék	None
ब्लेयर	blair	Nan
ब्रिटिशों	a brit	Nan
ब्लैक	fekete	None
ब्लॉग	a blog	Nan
भ	bh	Nan
भंग	megszeg	Nan
भंडार	a bolt	Nan
भंडारण	tárolás	Nan
भक्त	híve	None
ब्लॉक	a háztömb	Nan
भक्ति	odaadás	Nan
ब्रिटिश	a brit	Nan
ब्राहमण	brahman	Nan
ब्रह्म	brahma	Nan
ब्रह्मचर्य	brahmacharya	Nan
ब्रह्मांड	az univerzum	Nan
ब्रह्माजी	brahma	Nan
ब्रह्माण्ड	az univerzum	Nan
ब्रह्मास्त्र	brahmastra	Nan
ब्रिज	híd	None
ब्रांड	a márka	Nan
ब्राउज़र	a böngésző	Nan
ब्राउज़रों	böngészők	Nan
ब्राउसर	böngésző	None
ब्राज़ील	brasil	Nan
ब्राजील	brazília	None
ब्रायलर	brojler	Nan
ब्राउजर	böngésző	None
ब्रज	braj	Nan
भक्तों	bhakták	Nan
भगत	követő	None
भरती	sorozás	Nan
भरते	töltő	Nan
भरने	töltő	Nan
भरपूर	bőven	None
भरा	teljes	None
भरी	teljes	None
भरतपुर	bharatpur	Nan
भरे	megtöltött	Nan
भला	jól	None
भलाई	jóság	Nan
भली	jól	None
भले	jó	None
भवन	az épület	Nan
भवनों	épületek	None
भर्ती	toborzás	Nan
भक्‍ति	odaadás	Nan
भरत	bharat	Nan
भर	megtöltött	Nan
भगवती	bhagwati	Nan
भगवद्गीता	bhagavad gita	Nan
भगवा	okker	Nan
भगवान	isten	None
भगवान्	isten	None
भगवान्‌	isten	None
भरकर	töltött	None
भगिनी	lánytestvér	Nan
भटक	vándorlás	Nan
भत्ते	juttatások	Nan
भय	félelem	None
भयंकर	ijesztő	Nan
भयभीत	rémült	Nan
भयानक	ijedős	Nan
भजन	zsolozsma	Nan
फीफा	fifa	None
बारिश	eső	None
बारात	felvonulás	Nan
बढ़ते	beépítési	Nan
बढ़ती	emelkedő	None
बढ़कर	több mint	Nan
बढ़	megnövekedett	None
बढती	növekvő	None
बढता	növeli	None
बढ	megnövekedett	None
बडे	nagy	None
बडी	nagy	None
बडा	nagy	None
बड़ेबड़े	nagyok	Nan
बड़े	a nagy	Nan
बड़ी	a nagy	Nan
बड़ा	nagy	None
बटन	kapcsoló	Nan
बजे	idő	None
बजाय	helyette	None
बचत	megtakarítás	Nan
बचना	elkerülni	Nan
बचने	menekülni	None
बचपन	gyermekkor	Nan
बचा	bal	None
बचाने	mentés	Nan
बढ़ना	a fejét	Nan
बचाव	mentés	Nan
बच्चा	gyermek	None
बच्चे	gyermekek	None
बच्चों	gyermekek	None
बजट	költségvetés	None
बजाए	helyette	None
बजाते	ketyegés	Nan
बच्चन	bachchan	Nan
बढ़ने	felnő	Nan
बढ़ाता	javítja	Nan
बढ़ाते	növelni	Nan
बताने	mondd	Nan
बताया	mondta	None
बदनाम	badnaam	Nan
बदल	változás	None
बदलकर	a változtatással	Nan
बदलता	váltakozik	Nan
बताना	elmondani	Nan
बदलती	változó	None
बदलना	változtatni	None
बदलने	változtatni	None
बदला	bosszú	Nan
बदलाव	változás	None
बदले	változás	None
बनकर	tenni	None
बदलते	változó	None
बच	menekülni	None
बताते	jelzi	None
बताता	jelzi	None
बढ़ाना	felnevelni	Nan
बढ़ाया	továbbfejlesztett	Nan
बढ़ावा	bátorítás	Nan
बढ़ी	továbbfejlesztett	Nan
बढा	megnövekedett	None
बढाता	növekvő	None
बताती	jelzi	None
बढाने	növelni	Nan
बढावा	promóció	Nan
बढे	felnő	Nan
बतलाया	mondta	None
बता	mondd	Nan
बताई	mondta	None
बताए	mondd	Nan
बढाया	megnövekedett	None
बगैर	nélkül	None
बगीचों	a kertek	Nan
बगावत	felkelés	None
फैरोओं	fáraó	None
फैल	terjedés	Nan
फैलता	spreads	Nan
फैलने	kitörés	None
फैला	terjedés	Nan
फैलाने	diszperziós	Nan
फैरो	malac	Nan
फैलाया	szétszórt	Nan
फैली	kiterjeszti	Nan
फैशन	divat	None
फैसला	döntés	None
फैसले	az ítélet	Nan
फॉण्ट	betűtípus	Nan
फॉर	mert	None
फैलाव	terjedés	Nan
फोटो	fénykép	Nan
फैबेसी	fabacy	Nan
फेसबुक	facebook	None
फीस	díjak	None
फुट	ft	None
फूट	hasított	Nan
फूल	virág	None
फूलन	phoolan	Nan
फूलपौधों	virágos növények	Nan
फैजाबाद	faizabad	Nan
फूलों	a virágok	Nan
फेंग	agyar	Nan
फेज	fázis	None
फेडरेशन	államszövetség	Nan
फेफड़ों	a tüdők	Nan
फेयर	becsületes	None
फेर	fordulat	None
फेंक	dobás	Nan
बनता	tenni	None
फोटोग्राफी	fényképezés	Nan
फोर्ट	erőd	Nan
बंगलौर	bangalore	Nan
बंगाल	bengália	Nan
बंगाली	bengáli	Nan
बंद	bezárás	Nan
बंदरगाह	kikötő	None
बंदरगाहों	portok	Nan
बंगलोर	bangalore	Nan
बंदी	fogoly	None
बंध	zenekar	None
बंधन	a kötés	Nan
बंधे	megközötve	Nan
बंबई	bombay	Nan
बकरी	kecske	None
बगल	oldal	None
बंदूक	pisztoly	Nan
फोन	telefon	None
बंगलूरू	bangalore	Nan
बंगलादेश	banglades	Nan
फोर्स	kényszerítés	Nan
फौज	katonai	None
फ्रांस	franciaország	None
फ्रांसिस	francis	None
फ्रांसिस्को	francisco	None
फ्रांसीसी	a francia	Nan
बंगलुरु	bangalore	Nan
फ्रेंच	francia	None
फ्लाइट	repülési	Nan
फ्लू	az influenza	Nan
फ्लैश	vaku	Nan
फ्लोएम	faháncs	Nan
फ्लोरिडा	florida	Nan
बंगला	bungaló	Nan
फ्रेम	a keret	Nan
बाराबंकी	barabanki	Nan
बनती	készült	None
बनवाया	felépítettem	Nan
बागवानी	kertészkedés	Nan
बाग	kert	None
बाकी	a maradék	Nan
बाएं	bal	None
बाएँ	bal	None
बाईं	bal	None
बाई	szobalány	Nan
बाइबिल	biblia	None
बाइबल	a biblia	Nan
बाइनरी	kétkomponensű	Nan
बांह	a kar	Nan
बांधने	megkötni	Nan
बांध	a gát	Nan
बांटा	megosztott	None
बांट	terjeszteni	Nan
बांग्लादेश	banglades	Nan
बांग्ला	bangla	Nan
बहिष्कार	kiközösítette	Nan
बहु	többszörös	None
बहुत	nagyon	None
बहुतायत	bőség	Nan
बहुधा	gyakran	None
बहुमत	többség	None
बाग़	a kert	Nan
बहुमुखी	sokoldalú	None
बहुवचन	többes szám	Nan
बहुसंख्यक	számtalan	None
बाँग्ला	bengáli	Nan
बाँट	terjesztés	Nan
बाँटा	megosztott	None
बाँध	köt	None
बहुल	többszörös	None
बागान	ültetvény	Nan
बागों	a kertek	Nan
बाघ	tigris	None
बाध्यकारी	kényszeres	Nan
बाप	apa	None
बापू	bapu	Nan
बाबर	babar	Nan
बाबा	szent	None
बाबू	babu	Nan
बाध्य	összekötött	Nan
बायाँ	bal	None
बायें	bal	None
बार	alkalommal	None
बारबार	többször	None
बारह	tizenkét	None
बारहमासी	örök	None
बारहवीं	tizenkettedik	Nan
बायीं	bal	None
बहाव	az áramlás	Nan
बाधित	megszakított	Nan
बादशाह	király	None
बाजपेयी	bajpai	Nan
बाज़ार	a piac	Nan
बाजार	piac	None
बाजीराव	bajirao	Nan
बाड़ी	kerítés	Nan
बाढ	árvíz	None
बादशाहत	király	None
बाढ़	árvíz	None
बातचीत	chit chat	Nan
बातें	a dolgok	Nan
बातों	dolgok	None
बाद	utána	None
बादल	felhő	Nan
बादलों	a felhők	Nan
बाण	nyíl	Nan
बहाल	folytatódik	None
बहार	tavaszi	None
बहाने	ürügy	Nan
बन्द	zárva	None
बन्दरगाह	kikötő	None
बन्दी	rab	Nan
बन्ध	összekötött	Nan
बम	bomba	None
बम्बई	bombay	Nan
बनेगा	formálódni fog	Nan
बयान	nyilatkozat	None
बरसात	eső	None
बराक	barak	Nan
बराबरी	a par	Nan
बरेली	bareilly	Nan
बर्तन	az edény	Nan
बर्फ	jég	None
बरमूडा	bermuda	Nan
बर्बर	barbár	Nan
बनें	válik	None
बनीं	lett	None
बनाई	készült	None
बनाकर	azáltal, hogy	Nan
बनाता	teszi	None
बनाती	teszi	None
बनाते	készít	None
बनाना	csinálni	Nan
बने	tenni	None
बनाने	készít	None
बनाया	készít	None
बनायी	készült	None
बनाये	készít	None
बनारस	banaras	Nan
बनावट	struktúra	None
बनी	készült	None
बनाम	vs	None
बनते	készülnek	None
बर्बरता	vandalizmus	Nan
बर्लिन	berlin	None
बसी	telepedett	None
बसु	basu	Nan
बसे	telepedett	None
बसें	a buszok	Nan
बस्तियों	a települések	Nan
बस्ती	kolónia	Nan
बसाया	megállapodni	Nan
बह	folyam	Nan
बहने	folyó	None
बहरहाल	azonban	None
बहस	vita	None
बहा	vedlés	Nan
बहादुर	bátor	None
बहाना	mentség	Nan
बहन	lánytestvér	Nan
बर्मा	burma	Nan
बसने	megállapodni	Nan
बल्लेबाजी	ütőkezelés	Nan
बल	az erő	Nan
बलदेव	baldev	Nan
बलपूर्वक	erőteljesen	None
बलबन	balban	Nan
बलराम	balaram	Nan
बलि	áldozat	None
बल्लेबाजों	batsmen	Nan
बलिदान	áldozat	None
बलुआ	homok	Nan
बलों	erők	None
बल्कि	inkább	None
बल्लभ	ballabh	Nan
बल्ले	a denevér	Nan
बल्लेबाज	batsman	Nan
बलिया	baliya	Nan
लिंक	link	Nan
लिंकन	lincoln	None
लिंक्स	linkek	None
सुचना	információ	None
सुगम	könnyen	None
सुगंध	illat	Nan
सुखों	pleasures	Nan
सुखी	boldog	None
सुखा	száraz	None
सुखसागर	sukhsagar	Nan
सुख	boldogság	Nan
सुक्ष्म	bírság	Nan
सुकरात	socrates	Nan
सुई	tű	Nan
सुअर	a malac	Nan
सुंदरवन	sundarbans	Nan
सुंदरता	szépség	None
सुंदर	szép	None
सीसा	vezet	None
सील	a pecsét	Nan
सीधी	egyenes	None
सीधे	közvetlenül	None
सीने	a mellkas	Nan
सीनेट	a szenátus	Nan
सीनेटर	szenátor	Nan
सीमा	határ	None
सुचारु	sima	None
सीमाएँ	a határok	Nan
सीमाओं	határok	None
सीमायें	a határok	Nan
सीमित	korlátozott	None
सीमेंट	cement	Nan
सीरिया	szíria	Nan
सीरीज	a sorozat	Nan
सीमाएं	korlátozások	Nan
सुचारू	sima	None
सुदर्शन	sudarshan	Nan
सुदूर	távoli	None
सुन्दरी	gyönyörű	None
सुन्नी	szunnita	Nan
सुपर	szuper	Nan
सुप्रसिद्ध	jól ismert	Nan
सुबह	reggel	None
सुभद्रा	subhadra	Nan
सुन्दरता	szépség	None
सुभाष	subhash	Nan
सुभाषित	jól meghatározott	Nan
सुमन	suman	Nan
सुमात्रा	sumatra	Nan
सुमित्रा	sumitra	Nan
सुमित्रानंदन	sumitranandan	Nan
सुर	tónus	Nan
सुभाषबाबू	subhash babu	Nan
सीधा	egyenes	None
सुन्दर	gyönyörű	None
सुनीता	sunita	Nan
सुदृढ़	erős	None
सुधा	sudha	Nan
सुधारक	reformátor	Nan
सुधारने	javul	Nan
सुधारों	a reformok	Nan
सुन	hallgat	Nan
सुनील	sunil	Nan
सुनकर	listening	Nan
सुनने	hallgat	Nan
सुना	hallott	Nan
सुनाई	hallott	Nan
सुनाया	narrátor	Nan
सुनिश्चित	győződjön meg róla	Nan
सुनी	hallgatott	None
सुनते	hallgat	Nan
सीताजी	sitaji	Nan
सीता	sita	Nan
सीढ़ी	a létra	Nan
सिख	szikhek	Nan
सिखाने	tanítani	Nan
सिखाया	tanított	None
सिखों	szikhek	Nan
सिगरेट	cigaretta	Nan
सिटी	város	None
सिक्खों	szikhek	Nan
सिडनी	sydney	Nan
सितम्बर	szeptember	None
सितारा	csillag	None
सितारे	csillag	None
सितारों	a csillagok	Nan
सिद्ध	igazolt	None
सिद्धांत	elmélet	None
सितंबर	szeptember	None
सिद्धांतों	az alapelvek	Nan
सिक्के	érmék	Nan
सिक्का	az érme	Nan
साहेब	saheb	Nan
सिंगापुर	singapore	Nan
सिंड्रोम	szindróma	Nan
सिंध	pest	None
सिंधिया	scindia	Nan
सिंधी	szindhi	Nan
सिक्किम	sikkim	Nan
सिंधु	indus	Nan
सिंहली	szingaléz	Nan
सिंहस्थ	simhastha	Nan
सिंहासन	a trón	Nan
सिकंदर	sándor	None
सिकंदराबाद	secunderabad	Nan
सिकन्दर	sándor	None
सिंह	oroszlán	None
सुरंग	az alagút	Nan
सिद्धान्त	elv	None
सिद्धार्थ	siddharth	Nan
सिवाय	kivéve	None
सिविल	civil	None
सिस्टम	a rendszer	Nan
सी++	c ++	Nan
सीकरी	sikri	Nan
सीक्रेट	titok	Nan
सिल्क	selyem	Nan
सीख	tanulás	Nan
सीखा	tanult	None
सीखें	tanul	Nan
सीट	ülés	Nan
सीटें	az ülések	Nan
सीटों	az ülések	Nan
सीडी	cd	None
सीखने	tanulás	Nan
सिद्धान्तों	alapelvek	Nan
सिलाई	öltés	Nan
सिर्फ़	csak	None
सिद्धि	teljesítmény	None
सिनेमा	mozi	None
सिन्ध	pest	None
सिन्धी	szindhi	Nan
सिन्धु	indus	Nan
सिन्हा	sinha	Nan
सिलसिला	folytatás	Nan
सिपाहियों	katonák	None
सिफर्स	kódolások	Nan
सिफारिश	ajánlást	Nan
सिम	sim	Nan
सियोल	szöul	Nan
सिर	fej	None
सिर्फ	csak	None
सिपाही	a katona	Nan
साहित्‍य	irodalom	None
सुरक्षा	biztonság	None
सुरा	sura	Nan
सोडियम	nátrium	Nan
सोचा	gondol	Nan
सोचने	gondolkozni	Nan
सोचते	gondol	Nan
सो	így	None
सॉफ्टवेर	szoftver	None
सॉफ्टवेयर	szoftver	None
सैलानी	turista	Nan
सैलानियों	turisták	None
सैर	a séta	Nan
सैयद	syed	Nan
सैन्य	katonai	None
सैद्धांतिक	elméleti	None
सैकड़ों	több száz	Nan
सेवायें	szolgáltatások	None
सेवाओं	szolgáltatások	None
सेवाएं	szolgáltatások	None
सेतु	híd	None
सेन	sen	Nan
सेना	hadsereg	None
सेनाओं	sereg	None
सेनानी	a harcos	Nan
सेनापति	parancsnok	None
सोते	alvás	Nan
सेन्ट्रोसोम	centroszóma	Nan
सेल	sejt	None
सेलुलर	sejtes	Nan
सेल्यूकस	seleucus	Nan
सेल्सियस	celsius	Nan
सेवक	a cseléd	Nan
सेवाएँ	szolgáltatások	None
सेब	alma	None
सोन	fiú	None
सोना	arany	None
सोनिया	sonia	Nan
सौन्दर्य	szépség	None
सौभाग्य	sok szerencsét	Nan
सौम्य	enyhe	None
सौर	nap	None
सौरमंडल	naprendszer	None
सौरमास	saurmas	Nan
सौदा	az üzlet	Nan
सौराष्ट्र	saurashtra	Nan
स्कन्ध	szárny	Nan
स्काई	ég	None
स्कूल	iskola	None
स्कूली	iskola	None
स्कूलों	az iskolák	Nan
स्केल	skála	Nan
स्कन्द	skand	Nan
सेठ	seth	Nan
सौजन्य	udvariasság	Nan
सौंप	átadott	None
सोने	arany	None
सोपान	lépés	None
सोम	som	Nan
सोमनाथ	somnath	Nan
सोमवार	hétfő	Nan
सोर्स	forrás	None
सौंपा	kijelölt	None
सोलह	tizenhat	Nan
सोविएत	szovjet	None
सोवियत	szovjet	None
सोसाइटी	társadalom	None
सोसायटी	a társadalom	Nan
सौ	száz	None
सौंदर्य	szépség	None
सोलहवीं	tizenhatodik	Nan
सेट	a készlet	Nan
सेगोविआ	segovia	Nan
सेक्स	szex	None
सूअरों	a sertések	Nan
सूक्ष्म	kifinomult	Nan
सूक्ष्मजीव	a mikroorganizmusok	Nan
सूक्ष्मजीवों	a mikroorganizmusok	Nan
सूक्ष्मजैविक	mikrobiológiai	Nan
सूक्ष्मजैविकी	mikrobiológia	Nan
सूअर	sertés	Nan
सूक्ष्मदर्शी	mikroszkópok	Nan
सूखा	száraz	None
सूखापन	szárazság	Nan
सूखी	száraz	None
सूखे	száraz	None
सूचक	jelző	None
सूचकांक	index	None
सूख	szárított	Nan
सूचना	információ	None
सुस्पष्ट	feltűnő	None
सुषमा	sushma	Nan
सुरेन्द्र	surendra	Nan
सुरेश	suresh	Nan
सुलझाने	megoldása	None
सुलभ	hozzáférhető	Nan
सुल्तान	a szultán	Nan
सुल्तानों	sultans	Nan
सुसज्जित	berendezett	Nan
सुवर्ण	arany	None
सुविधाएँ	jellemzők	None
सुविधाएं	a létesítmények	Nan
सुविधाजनक	kényelmes	Nan
सुव्यवस्थित	jól szervezett	Nan
सुशील	susheel	Nan
सुशोभित	kecses	Nan
सुविधा	létesítmény	Nan
सुरक्षित	biztonságos	None
सूचनाएं	értesítések	Nan
सूचि	lista	None
सूर्यकांत	suryakant	Nan
सूर्यदेव	napisten	None
सूर्योदय	napkelte	Nan
सृजन	teremtés	Nan
सृजनगाथा	létrehozási történet	Nan
सृजनात्मक	kreatív	Nan
सूर्य	nap	None
सृजित	alkotó	None
से	tól től	Nan
सेंटर	a közép	Nan
सेंट्रल	központi	None
सेंसेक्स	sensex	Nan
सेकंड	második	None
सेक्टर	ágazat	Nan
सृष्टि	az alkotás	Nan
सूचनाओं	értesítések	Nan
सूरी	suri	Nan
सूरत	arc	Nan
सूचित	tájékoztat	Nan
सूची	a lista	Nan
सूजन	duzzanat	Nan
सूडान	szudán	Nan
सूत्र	a szál	Nan
सूत्रधार	narrátor	Nan
सूरदास	surdas	Nan
सूत्रपात	hírnök	Nan
सूनामी	tsunami	Nan
सूफ़ी	szufi	Nan
सूफी	szufi	Nan
सूबेदार	subedar	Nan
सूर	sur	Nan
सूरज	nap	None
सूत्रों	a források	Nan
स्कैंडिनेवियाई	skandináv	None
साहित्यिक	irodalmi	None
साहित्य	irodalom	None
सरस	saras	Nan
सरलता	egyszerűség	Nan
सरल	könnyen	None
सरन	saran	Nan
सरदार	fő	None
सरकारों	a kormányok	Nan
सरकारें	a kormányok	Nan
सरकारी	a hivatalos	Nan
सरकार	kormány	None
सर	fej	None
सयुंक्त	egyesült	None
सम्राट्	császár	None
सम्राटों	császárok	Nan
सम्राट	a császár	Nan
सम्यक	jobb	None
सम्मेलन	a szeminárium	Nan
सम्मुख	szemben	None
सम्बंधित	összefüggő	None
सम्बंधी	összefüggő	None
सम्बद्ध	szövetséges	None
सम्बन्धित	összefüggő	None
सम्बन्धी	összefüggő	None
सम्बोधित	címzett	Nan
सरसों	mustár	Nan
सम्भवतः	esetleg	None
सम्भोग	közösülés	Nan
सम्मलेन	konferencia	None
सम्मान	a megtiszteltetés	Nan
सम्मानित	megbecsült	Nan
सम्मिलित	tartalmazza	None
सम्मिश्रण	keverés	Nan
सम्भावना	a lehetőség	Nan
सराहना	felértékelődés	Nan
सराहा	értékelt, megbecsült	Nan
सरीसृप	hüllők	Nan
सर्वाधिक	a legtöbb	Nan
सर्विस	szolgáltatás	None
सर्वे	felmérés	Nan
सर्वेक्षण	felmérés	Nan
सर्वोत्तम	a legjobb	Nan
सर्वोपरि	legfontosabb	None
सर्वांगीण	mindenhol	None
सलमान	salman	Nan
सलाहकार	advisor	Nan
सलीम	salim	Nan
सल्तनत	szultánság	Nan
सल्फर	kén	Nan
सल्ल	sall	Nan
सवाई	sawai	Nan
सलाह	tanács	None
सम्बंध	a kapcsolat	Nan
सर्वश्रेष्ठ	a legjobb	Nan
सर्वव्यापी	mindenütt jelenlevő	Nan
सरोवर	tó	None
सर्च	keresés	Nan
सर्दियों	téli	None
सर्दी	hideg	None
सर्प	kígyó	None
सर्पिल	spirál	Nan
सर्वशक्तिमान	mindenható	Nan
सर्वज्ञ	mindentudó	Nan
सर्वदा	örökké	None
सर्वनाम	névmások	Nan
सर्वपल्ली	sarvapalli	Nan
सर्वप्रथम	az első	Nan
सर्वमान्य	általánosan elfogadott	Nan
सर्वर	szerver	Nan
सर्वथा	teljesen	None
सम्प्रदायों	címletek	Nan
सम्प्रदाय	közösség	None
सम्पूर्ण	teljes	None
समाज	társadalom	None
समाजवाद	szocializmus	None
समाजवादी	szocialista	None
समाजशास्त्र	szociológia	None
समाजों	societies	Nan
समाधान	megoldás	None
समाचारपत्रों	újságok	None
समाधि	mauzóleum	Nan
समानता	egyenlőség	None
समानताएं	hasonlóságok	Nan
समानांतर	párhuzamos	None
समानान्तर	párhuzamos	None
समाप्त	vég	Nan
समाप्ति	vége	None
समान	azonos	None
समारोह	a ceremónia	Nan
समाचारपत्र	újság	None
समांतर	párhuzamos	None
समर्थक	támogató	None
समर्थकों	támogatóink	Nan
समर्थन	támogatás	None
समर्पण	elhivatottság	Nan
समर्पयामि	elhivatottság	Nan
समर्पित	dedikált	Nan
समाचार	hírek	None
समशीतोष्ण	mérsékelt	None
समस्त	összes	None
समस्या	probléma	None
समस्याएँ	a problémák	Nan
समस्याएं	problémák	None
समस्याओं	a problémák	Nan
समा	környezet	None
समसामयिक	kortárs	None
सवार	lovaglás	Nan
समारोहों	az ünnepségek	Nan
समाविष्ट	beleértve	None
समूचे	az egész	Nan
समूह	csoport	None
समूहों	csoportok	None
समृद्ध	virágzó	None
समृद्धि	jólét	Nan
समेटे	részén	None
समुद्रों	a tengerek	Nan
समेत	beleértve	None
सम्पत्ति	a tulajdon	Nan
सम्पदा	estates	Nan
सम्पन्न	kész	None
सम्पर्क	kapcsolatba lépni	Nan
सम्पादन	szerkesztés	Nan
सम्पादित	szerkesztette	None
समोच्च	körvonal	Nan
समालोचना	kritika	None
समुद्री	tengeri	None
समुद्रतट	tenger partján	Nan
समावेश	befogadás	Nan
समाहित	foglalt	None
समिति	a bizottság	Nan
समितियों	bizottságok	Nan
समीकरण	az egyenlet	Nan
समीकरणों	egyenletek	Nan
समुद्रतल	tengerszint	None
समीक्षा	felülvizsgálat	Nan
समुचित	megfelelő	None
समुच्चय	készlet	Nan
समुदाय	közösség	None
समुदायों	közösségek	None
समुद्र	tenger	None
समुद्रगुप्त	samudragupta	Nan
समीप	közel	None
साहित्यकार	irodalmár	Nan
सवारी	lovagol	Nan
सविता	savita	Nan
सामना	arc	Nan
सामग्री	anyag	None
सामंजस्य	harmónia	Nan
साम	dolog	None
साबुन	szappan	Nan
साबित	bizonyított	None
साफ्टवेयर	szoftver	None
साफ	tiszta	None
साप्ताहिक	heti	None
सापेक्षता	relativitás	Nan
सापेक्ष	relatív	None
सान्निध्य	határos	None
सानिया	sania	Nan
साध्य	megvalósítható	Nan
साधु	remete	Nan
साधारणतया	általában	None
साधारणतः	általában	None
सातवाँ	hetedik	None
सातवीं	hetedik	None
सात्विक	erkölcsi	None
साथ	val vel	Nan
साथसाथ	együtt	None
साथियों	peer	Nan
सामने	elülső	None
साथी	partner	Nan
साध	segítség	None
साधक	a kereső	Nan
साधन	erőforrások	Nan
साधना	elmélkedés	Nan
साधनों	eszközök	None
साधारण	egyszerű	None
सादगी	egyszerűség	Nan
सामरिक	stratégiai	None
सामान	poggyász	Nan
सामान्य	normál	None
सार्थक	jelentőségteljes	Nan
सार्वजनिक	nyilvános	None
सार्वजानिक	nyilvános	None
सार्वभौमिक	egyetemes	None
साल	év	None
सालाना	évi	None
सारे	összes	None
सालों	évek	None
सावन	monszun	Nan
सावरकर	savarkar	Nan
सावित्री	savitri	Nan
साहब	úr	None
साहसिक	a kaland	Nan
साहसी	bátor	None
सावधान	óvatos	Nan
सात	hét	None
सारी	összes	None
सारा	összes	None
सामान्यत	általában	None
सामान्यतः	általában	None
सामान्यतया	általában	None
सामी	sami	Nan
सामुदायिक	a közösség	Nan
सामूहिक	a kollektív	Nan
सारांश	összefoglalás	Nan
साम्राज्य	a birodalom	Nan
साम्राज्यों	empires	Nan
सायंकाल	este	None
सार	absztrakt	Nan
सारणी	menetrend	Nan
सारथी	szekérhajtó	Nan
सारनाथ	sarnath	Nan
साम्राज्यवाद	imperializmus	Nan
साढेसाती	sadesati	Nan
साड़ी	szári	Nan
साठ	hatvan	Nan
सहस्र	sahasra	Nan
सहस्राब्दी	évezred	Nan
सहस्रों	évezred	Nan
सहानुभूति	együttérzés	Nan
सहाय	segítség	None
सहायक	helyettes	Nan
सहस्त्रपाद	mille	Nan
सहायता	segítség	None
सहारा	segítség	None
सहारे	támogatás	None
सहित	beleértve	None
सहिष्णुता	megértés	Nan
सही	jobb	None
सा	sa	Nan
सहारनपुर	saharanpur	Nan
साँची	sanchi	Nan
सहलक्षण	szimbólum	None
सहयोग	segítség	None
सविन्धान	alkotmány	None
सशक्त	erős	None
सशस्त्र	fegyveres	None
सस्ता	olcsó	None
सस्ते	olcsó	None
सह	a társ	Nan
सहयोगी	partner	Nan
सहकारी	szövetkezet	Nan
सहज	spontán	None
सहजता	természetesség	Nan
सहन	elvisel	Nan
सहनशीलता	megértés	Nan
सहमत	egyetért	Nan
सहमति	megegyezés	Nan
सहगल	sehgal	Nan
सवालों	kérdések	None
साँप	kígyó	None
सांकेतिक	jelképes	Nan
साओ	sao	Nan
साकार	felismerve	Nan
साकी	saki	Nan
साकीबाला	saqibala	Nan
साकेत	saket	Nan
साक्षरता	műveltség	Nan
साईट	az oldal	Nan
साक्षात्	személy	None
साक्षी	tanú	Nan
साक्ष्य	bizonyíték	None
साखी	barát	None
सागर	tenger	None
साझा	közös	None
साझेदारी	partnerségek	Nan
साक्षात्कार	az interjú	Nan
साँस	lehelet	Nan
साई	sai	Nan
साइड	az oldal	Nan
सांख्य	numerikus	Nan
सांख्यिकी	statisztika	Nan
सांख्यिकीय	statisztikai	None
सांची	sanchi	Nan
सांप्रदायिक	kommunális	Nan
सांभर	sambar	Nan
साइडर	almabor	Nan
सांस	lehelet	Nan
सांसारिक	földi	None
सांस्कृतिक	kulturális	None
साइंस	tudomány	None
साइकिल	kerékpár	Nan
साइट	az oldal	Nan
साइटों	sites	Nan
सांसद	a parlament tagja	Nan
समर्थ	képes	None
स्कैन	letapogatás	Nan
स्कॉटलैंड	skócia	None
१००	100	Nan
१०	10	Nan
१	1	Nan
०	0	Nan
ह्रास	romló	Nan
ह्रदय	a szív	Nan
होश	senses	Nan
होली	holi	Nan
होलिका	máglya	Nan
होम्योपैथी	homeopátia	Nan
होमियोपैथी	homeopátia	Nan
होमर	homérosz	Nan
होम	itthon	None
होनेवाले	lenni	None
होनेवाली	lenni	None
होनी	lenni	None
होना	történik	None
हॉल	előszoba	Nan
हॉलीवुड	hollywood	None
हो	ho	None
हों	lenni	None
होंगी	lesz	None
होंगे	lesz	None
१०००	1000	Nan
होकर	keresztül	None
होगी	lesz	None
होटल	szálloda	Nan
होड़	a verseny	Nan
होता	történik	None
होती	lenne	None
होते	előfordul	None
होगा	meg fog történni	Nan
१००००	10000	Nan
१०५	105	Nan
१०८	108	Nan
१८वीं	17.	Nan
१८१५	1815	Nan
१८४०	170	Nan
१८५०	1850	Nan
१८५७	1856	Nan
१८८०	170	Nan
१८	14	Nan
१९	19	Nan
१९००	1900	Nan
१९०१	1901	Nan
१९०२	1902	Nan
१९०३	1903	Nan
१९०४	1906	Nan
१९०६	1906	Nan
१९वीं	19.	Nan
हॉकी	jégkorong	None
१७००	1800	Nan
१६७४	14	Nan
१०९	10 9	Nan
११	11	Nan
१२	12	Nan
१२वीं	12.	Nan
१२०	120	Nan
१३	13	Nan
१७	14	Nan
१४	14	Nan
१५	15	Nan
१५वीं	15.	Nan
१५०	150	Nan
१५००	1500	Nan
१६	14	Nan
१६वीं	17.	Nan
१४००	1800	Nan
हैहालांकि	azonban	None
हैसूर्य	hesury	Nan
हैसियत	az állapot	Nan
हुमायूं	humayun	Nan
हुयी	történt	None
हुये	történt	None
हुसैन	hussain	Nan
हूँ	én vagyok	Nan
हूं	am	None
हुमायूँ	humayun	Nan
हूनान	hunan	Nan
हे	hé	Nan
हेक्टेयर	hektár	Nan
हेतु	mert	None
हेमंत	hemant	Nan
हेमा	hema	Nan
हेरात	herat	Nan
हॅ	van	Nan
हेलोवीन	halloween	Nan
हुगली	hooghly	Nan
हुए	saját	None
हिस्सा	rész	None
हिस्से	alkatrészek	None
हिस्सों	alkatrészek	None
ही	csak	None
हींग	asafoetida	Nan
हीन	alárendelt	Nan
हुक्म	rendelés	Nan
हीनयान	hinajána	Nan
हीरे	diamonds	Nan
हीरो	hős	None
हीलियम	hélium	None
हुआ	történt	None
हुआ|	történt	None
हुईं	történt	None
हीरा	gyémánt	None
१९०७	1906	Nan
हेल्थ	egészség	Nan
है	jelentése	None
हैजब	amikor	None
हैजो	ki kicsoda	Nan
हैतो	azután	None
हैदर	haider	Nan
हैदराबाद	hyderabad	Nan
हैदराबादी	hyderabadi	Nan
हैकुछ	van néhány	Nan
हैयह	ez	None
हैरी	harry	None
हैलेकिन	de	None
हैलोवीन	halloween	Nan
हैवह	ő van	Nan
हैवे	saját	None
हैव्यक्ति	személy	None
हैया	haiya	Nan
हेस्टिया	hestia	Nan
हैकि	hogy	None
हैउसे	neki van	Nan
है|	van	Nan
हैँ	igen	None
हैं	huh	Nan
हैं|	vannak	None
हैंइसके	a	None
हैंउनके	van nekik	Nan
हैएक	van egy	Nan
हैंयह	ez	None
हैंशनि	hanshi	Nan
हैअगर	ha	None
हैइसका	a	None
हैउदाहरण	példa	None
हैउसका	neki van	Nan
हैउसके	neki van	Nan
हैंवे	hanvey	Nan
हिस्ट्री	történelem	None
१९०९	1909	Nan
१९११	1911	Nan
३९	39	Nan
३८	37	Nan
३७	37	Nan
३६	37	Nan
३५०	350	Nan
३५	35	Nan
३४	37	Nan
३३	33	Nan
३२२	322	Nan
३२०	320	Nan
३२	32	Nan
३१	31	Nan
३०००	3000	Nan
३००	300	Nan
३०	30	Nan
३	3	Nan
२९	29	Nan
२००७	2008	Nan
२००८	2008	Nan
२००९	2009	Nan
२०११	2011	Nan
२०१२	2012	Nan
२१	21	Nan
४	4	Nan
२२	22	Nan
२५	25	Nan
२५०	250	Nan
२६	24	Nan
२७	24	Nan
२७३	243	Nan
२८	24	Nan
२३	23	Nan
४०	40	Nan
४००	400	Nan
४२	42	Nan
६४	4	Nan
६५	45	Nan
७	4	Nan
७०	40	Nan
७५	45	Nan
८	4	Nan
६०००	8000	Nan
८०	40	Nan
८४	4	Nan
८५	45	Nan
९	4	Nan
९०	90	Nan
९५	95	Nan
९८	९ ८	Nan
८००	400	Nan
२००६	2008	Nan
६००	400	Nan
६	4	Nan
४३	43	Nan
४५	45	Nan
४६	4	Nan
४७	4	Nan
४८	4	Nan
५	5	Nan
६०	40	Nan
५०	50	Nan
५०००	5000	Nan
५१	51	Nan
५२	52	Nan
५३	53	Nan
५५	55	Nan
५६	58	Nan
५००	500	Nan
२००५	2005	Nan
२००४	2008	Nan
२००३	2003	Nan
१९४५	1945	Nan
१९४७	1949	Nan
१९४८	1949	Nan
१९४९	1949	Nan
१९५०	1950	Nan
१९५२	1952	Nan
१९४३	1963	Nan
१९५३	1953	Nan
१९५५	1955	Nan
१९५६	1956	Nan
१९५७	1956	Nan
१९५९	1959	Nan
१९६०	1960	Nan
१९६१	1961	Nan
१९५४	1956	Nan
१९६२	1962	Nan
१९४२	1962	Nan
१९३७	1937	Nan
१९१७	1914	Nan
१९१८	1914	Nan
१९१९	1919	Nan
१९२१	1921	Nan
१९२२	1922	Nan
१९२४	1926	Nan
१९३९	1939	Nan
१९२५	1925	Nan
१९२९	1929	Nan
१९३०	1930	Nan
१९३१	1931	Nan
१९३२	1932	Nan
१९३४	1937	Nan
१९३६	1937	Nan
१९२८	1926	Nan
१९१०	1910	Nan
१९६४	1949	Nan
१९६८	1949	Nan
१९८९	1949	Nan
१९९०	190	Nan
१९९१	191	Nan
१९९२	192	Nan
१९९४	1949	Nan
१९९६	1949	Nan
१९८८	1949	Nan
१९९७	1949	Nan
१९९९	19	Nan
२	2	Nan
२०	20	Nan
२००	200	Nan
२०००	2000	Nan
२००१	2001	Nan
१९९८	1949	Nan
१९६५	1945	Nan
१९८७	1949	Nan
१९८५	1945	Nan
१९६९	1949	Nan
१९७०	1960	Nan
१९७१	1961	Nan
१९७३	1963	Nan
१९७४	1949	Nan
१९७६	1949	Nan
१९८६	1949	Nan
१९७७	1949	Nan
१९७९	1949	Nan
१९८०	1960	Nan
१९८१	1961	Nan
१९८२	1962	Nan
१९८३	1963	Nan
१९८४	1949	Nan
१९७८	1949	Nan
स्कैनिंग	letapogatás	Nan
हिसाब	számítás	Nan
हिम्मत	bátorság	Nan
स्वयंभू	önjelölt	Nan
स्वयं	maga	None
स्वप्न	az álom	Nan
स्वपोषी	autotróf	Nan
स्वदेशी	az én országom	Nan
स्वदेश	hazájában	Nan
स्वतन्त्रता	szabadság	None
स्वतन्त्र	ingyenes	None
स्वतः	kocsi	None
स्वतंत्रता	szabadság	None
स्वतंत्र	ingyenes	None
स्वच्छमण्डल	tiszta szoba	Nan
स्वच्छता	tisztaság	Nan
स्वच्छंद	önfejű	Nan
स्वच्छ	tiszta	None
स्वंय	maga	None
स्व	az én	Nan
स्पेन	spanyolország	None
स्पेनी	spanyol	None
स्पेशल	különleges	None
स्पेस	tér	None
स्पैनिश	spanyol	None
स्प्रे	permet	Nan
स्वयंवर	swayamvar	Nan
स्मरण	emlékezés	Nan
स्मारकों	műemlékek	Nan
स्मिथ	kovács	None
स्मृति	memória	None
स्राव	mentesítési	Nan
स्रोत	a forrás	Nan
स्रोतों	források	None
स्मारक	emlékmű	None
स्वयंसेवक	önkéntes	None
स्वर	magánhangzó	Nan
स्वराज	swaraj	Nan
स्वामी	tulajdonos	None
स्वामीजी	swamiji	Nan
स्वायत्त	autonóm	None
स्वास्थ्य	egészség	Nan
स्विट्जरलैंड	svájc	None
स्विस	svájci	None
स्वामित्व	tulajdonjog	Nan
स्वीकार	elfogad	Nan
स्वीकृति	elfogadás	Nan
स्वीडन	svédország	None
स्वीडिश	svéd	None
स्‍त्री	női	None
स्‍थान	hely	None
हंस	a hattyú	Nan
स्वीकृत	jóváhagyott	Nan
स्पेक्ट्रम	színkép	Nan
स्वाभिमानी	önérzetes	Nan
स्वाभाविक	természetes	None
स्वरुप	forma	None
स्वरूप	a nyomtatvány	Nan
स्वरों	a magánhangzók	Nan
स्वर्ग	menny	Nan
स्वर्गीय	mennyei	Nan
स्वर्ण	arany	None
स्वाभिमान	önbecsülés	Nan
स्वशासन	önkormányzat	None
स्वाइन	sertés	Nan
स्वागत	üdvözöljük	Nan
स्वाद	íz	Nan
स्वादिष्ट	finom	None
स्वाधीनता	függetlenség	None
स्वानिकी	fonetika	Nan
स्वस्थ	egészséges	None
स्पीकर	hangszóró	Nan
स्पिन	pörgés	Nan
स्पष्टीकरण	a magyarázat	Nan
स्ट्रीम	a patak	Nan
स्तंभ	az oszlop	Nan
स्तंभन	merevedési	Nan
स्तंभों	az oszlopok	Nan
स्तन	mell	Nan
स्तनधारी	emlősök	None
स्ट्रीट	utca	None
स्तम्भ	oszlop	None
स्तरीय	szint	None
स्तुति	dicséret	Nan
स्तूप	sztupa	Nan
स्तोत्र	zsolozsma	Nan
स्त्रियाँ	a nők	Nan
स्त्रियां	a nők	Nan
स्तर	szint	None
स्त्रियों	nők	None
स्ट्राइकर	a csatár	Nan
स्टैण्डर्ड	alapértelmezett	Nan
स्कॉटिश	skót	None
स्कोर	pontszám	Nan
स्क्रबर	súroló	Nan
स्क्रीन	a képernyőn	Nan
स्क्रीनिंग	szűrés	Nan
स्खलन	ejakuláció	Nan
स्टॉक	készlet	Nan
स्टाफ	személyzet	None
स्टील	acél	None
स्टेट	állapot	None
स्टेडियम	a stadion	Nan
स्टेम	származik	None
स्टेशन	állomás	None
स्टेशनों	állomások	Nan
स्टार	csillag	None
हक़	jobb	None
स्त्रीकेसर	bibe	Nan
स्त्रोत	forrás	None
स्थितियों	a feltételek	Nan
स्थिती	pozíció	Nan
स्थिर	rögzített	None
स्थिरता	stabilitás	Nan
स्थूल	macro	Nan
स्थैतिक	statikus	Nan
स्थिति	esemény	None
स्नातक	érettségizni	Nan
स्नान	fürdőkád	Nan
स्नायु	izom	Nan
स्नेह	szeretet	None
स्पर्श	érintés	Nan
स्पष्ट	egyértelmű	None
स्पष्टता	világosság	Nan
स्नातकोत्तर	posztgraduális	Nan
स्त्रीपुरूष	nőies	Nan
स्थित	található	None
स्थापित	alapított	None
स्त्रोतों	források	None
स्थगित	elhalasztott	Nan
स्थल	az oldal	Nan
स्थलाकृति	topográfia	Nan
स्थान	hely	None
स्थानांतरण	átutalás	Nan
स्थायी	állandó	None
स्थानांतरित	áthelyezve	Nan
स्थानीय	helyi	None
स्थानों	helyek	None
स्थापत्य	építészet	None
स्थापत्यकला	építészet	None
स्थापन	telepítés	Nan
स्थापना	a létesítmény	Nan
स्थानिक	helyi	None
हिल	hegy	None
हज	hajj	Nan
हज़रत	hazrat	Nan
हाला	bor	None
हालत	feltétel	None
हाल	feltétel	None
हार्वर्ड	harvard	None
हार्मोन	hormonok	Nan
हार्डी	edzett	Nan
हार्डवेयर	a hardver	Nan
हार	vereség	None
हानिकारक	káros	None
हानि	a veszteség	Nan
हान	han	Nan
हाथों	a kezek	Nan
हाथी	elefánt	Nan
हाथियों	elefántok	Nan
हाथ	kéz	None
हाजी	haji	Nan
हाउसबोट	lakóhajó	Nan
हस्तशिल्प	kézművesség	Nan
हस्ताक्षर	aláírás	Nan
हस्तिनापुर	hastinapur	Nan
हस्तियों	hírességek	Nan
हाँ	igen	None
हां	igen	None
हालाँकि	azonban	None
हांग	hong	Nan
हाइड्रिल्ला	hydrilla	Nan
हाइड्रोकार्बन	szénhidrogének	Nan
हाइड्रोजन	hidrogén	Nan
हाइपर	hiper	Nan
हाई	szia	Nan
हाउस	ház	None
हांगकांग	hong kong	Nan
हालात	körülmények	None
हावी	fölény	Nan
हासिल	szerezze	Nan
हिन्दयूरोपीय	indoeurópai	None
हिन्दी	hindi	Nan
हिन्दीउर्दू	hindi urdu	Nan
हिन्दीकुंज	hindikunj	Nan
हिन्दु	hindu	None
हिन्दुओं	hinduk	Nan
हिन्द	hátsó	None
हिन्दुस्तान	hindusztán	Nan
हिन्दुस्थान	hindusthan	Nan
हिन्दू	hindu	None
हिब्रू	héber	None
हिमनद	a gleccserek	Nan
हिमाचल	himachal	Nan
हिमालयी	himalájai	Nan
हिन्दुस्तानी	hindusztáni	Nan
हस्तलिखित	handwritten	Nan
हितों	interests	Nan
हिटलर	hitler	None
हास्य	humor	None
हि	ő	None
हिंद	hátsó	None
हिंदी	hindi	Nan
हिंदीकुंज	hindikunj	Nan
हिंदु	hindu	None
हित	érdeklődés	None
हिंदुओं	hinduk	Nan
हिंदू	hindu	None
हिंसक	erőszakos	None
हिंसा	erőszak	None
हिक्सोस	hixos	Nan
हिज्री	hijri	Nan
हिट	találat	Nan
हिंदुस्तान	india	None
हस्तमैथुन	maszturbáció	Nan
हस्तक्षेप	interferencia	Nan
हवेली	a kastély	Nan
हथेली	a tenyér	Nan
हद	amennyiben	None
हनन	a visszaélések	Nan
हनुमान	hanuman	Nan
हनुमानजी	hanuman ji	Nan
हम	mi	None
हथियारों	fegyverek	None
हमको	mi	None
हमला	támadás	None
हमले	megtámadja	Nan
हमलों	megtámadja	Nan
हमसे	tőlünk	Nan
हमारा	mi	None
हमारी	a	None
हमने	mi	None
हमारे	mi	None
हथियार	fegyverek	None
हड्डी	csont	Nan
हज़ार	ezer	None
हज़ारों	ezrek	Nan
हजार	ezer	None
हजारी	hazari	Nan
हजारे	hazare	Nan
हजारों	ezrek	Nan
हत्या	a gyilkosság	Nan
हट	kunyhó	Nan
हटा	vegye ki	Nan
हटाकर	eltávolítva	Nan
हटाया	eltávolított	Nan
हड़ताल	a sztrájk	Nan
हड़प्पा	harappa	Nan
हड़प्पाई	harappan	Nan
हटकर	le a	Nan
हजरत	hazrat	Nan
हमीरपुर	hamirpur	Nan
हमें	minket	None
हरेक	minden egyes	Nan
हर्षवर्धन	aki növeli az örömöt	Nan
हल	megoldás	None
हलचल	kavar	Nan
हल्का	fény	None
हल्की	fény	None
हरे	zöld	None
हल्के	könnyűsúlyú	Nan
हवन	imákat kínálva istennek a tűz előtt	Nan
हवा	levegő	None
हवाई	levegős	Nan
हवाएं	szellő	Nan
हवाओं	a szelek	Nan
हवाले	átad	Nan
हल्दी	kurkuma	Nan
हमे	minket	None
हरी	a zöld	Nan
हरिशंकर	harishankar	Nan
हमेशा	mindig	None
हर	minden	None
हरण	emberrablás	Nan
हरदोई	hardoi	Nan
हरमंदिर	harmandir	Nan
हरि	hari	Nan
हरिश्चन्द्र	harish chandra	Nan
हरिकृष्ण	harikrishna	Nan
हरित	zöld	None
हरिता	harita	Nan
हरिदास	haridas	Nan
हरिद्वार	haridwar	Nan
हरियाणा	haryana	Nan
हरिवंश	harivansh	Nan
हरिजन	haridzsan	Nan
पिग्मी	törpe	None
समरकंद	samarkand	Nan
समयसमय	időről időre	Nan
विवेकानंद	vivekananda	Nan
विवेकाधीन	diszkrecionális	Nan
विवेक	belátása	Nan
विविधता	sokféleség	Nan
विविध	különböző	None
विवाहित	házas	Nan
विवाह	házasság	None
विवादों	viták	None
विवादित	vitatott	None
विवादास्पद	vitatott	None
विवादस्पद	vitatott	None
विवाद	vita	None
विवश	erőltetett	Nan
विवर्तन	fényelhajlás	Nan
विवरण	leírás	None
विलुप्त	kihalt	None
विलीन	összeolvadt	Nan
विराम	szünet	None
विरासत	öröklés	Nan
विरुद्ध	ellen	None
विरूद्ध	ellen	None
विरोध	ellen	None
विरोधियों	ellenfelek	Nan
विवेकानन्द	vivekananda	Nan
विरोधी	elleni	None
विलय	magfúzió	Nan
विलयन	egyesülés	Nan
विलाप	nyögés	Nan
विलायक	oldószer	Nan
विलासिता	luxus	Nan
विलियम	vilmos	None
विलक्षण	egyedülálló	None
विवेचन	mérlegelés	Nan
विशद	élénk	None
विशाखापट्नम	visakhapatnam	Nan
विश्लेषण	elemzés	Nan
विश्लेषणात्मक	analitikai	Nan
विश्व	világ	None
विश्वकर्मा	vishwakarma	Nan
विश्वकोश	enciklopédia	None
विश्वकोष	enciklopédia	None
विश्राम	pihenés	Nan
विश्वप्रसिद्ध	világhírű	None
विश्वविख्यात	világhírű	None
विश्वविद्यालयों	egyetemek	None
विश्वव्यापी	világszerte	None
विश्वसनीय	megbízható	None
विश्वामित्र	vishwamitra	Nan
विश्वास	hinni	Nan
विश्वयुद्ध	világháború	None
विराट	virat	Nan
विशेषताओं	jellemzők	None
विशेषताएँ	jellemzők	None
विशाल	hatalmas	None
विशालकाय	az óriás	Nan
विशालता	végtelenség	Nan
विशिष्ट	különleges	None
विशिष्टता	különlegesség	Nan
विशुद्ध	tiszta	None
विशेषताएं	jellemzők	None
विशेष	különleges	None
विशेषज्ञ	szakember	Nan
विशेषज्ञों	szakértők	None
विशेषण	melléknevek	None
विशेषत	különösen	None
विशेषतः	különösen	None
विशेषता	különlegesség	Nan
विशेषकर	különösen	None
विराजमान	ülő	Nan
विरह	hiány	Nan
वियोग	lekapcsolás	Nan
विधवा	özvegy	None
विधा	műfaj	None
विधाओं	műfajok	Nan
विधान	törvényhozás	None
विधानसभा	gyülekezés	Nan
विधायिका	törvényhozás	None
विद्वान्	tudós	None
विधायी	törvényhozó	None
विधियाँ	a módszerek	Nan
विधियां	a módszerek	Nan
विधेयक	számla	Nan
विनती	kérés	Nan
विनम्र	udvarias	Nan
विनय	szerénység	Nan
विधि	módszer	None
विनायकाय	vinayakay	Nan
विद्वानों	tudósok	None
विद्रोही	a lázadók	Nan
विदेशी	külföldi	None
विद्यमान	létező	None
विद्या	tudás	None
विद्याओं	akadémikusok	Nan
विद्यापति	tudós	None
विद्यार्थियों	diákok	None
विद्वान	tudós	None
विद्यार्थी	diák	None
विद्यालयों	az iskolák	Nan
विद्युत	elektromosság	Nan
विद्युत्‌	elektromosság	Nan
विद्युदणु	elektron	Nan
विद्योत्तमा	vidyutma	Nan
विद्रोह	lázadó	None
विद्यालय	iskola	None
विश्वासघात	árulás	Nan
विनाश	megsemmisítés	Nan
विनिमय	csere	None
विभाजन	a megosztás	Nan
विभाजित	hasított	Nan
विभाषा	feloszt	Nan
विभिन्न	különböző	None
विभिन्नता	variáció	Nan
विभिन्‍न	különböző	None
विभागों	osztályok	Nan
विभीषण	megsemmisítés	Nan
विमर्श	vita	None
विमल	vimal	Nan
विमान	repülőgép	None
विमानक्षेत्र	repülőtér	None
विमानों	a repülőgépek	Nan
वियतनाम	vietnam	None
विभेदन	különbségtétel	Nan
विनाशकारी	pusztító	None
विभाग	a részleg	Nan
विफलता	kudarc	None
विनियमन	szabályozás	None
विनियमित	szabályozott	Nan
विनिर्देश	leírás	None
विनिर्माण	gyártás	None
विनोद	humor	None
विनोबा	vinoba	Nan
विभक्त	osztó	Nan
विन्डोज़	ablakok	Nan
विन्यास	configuration	Nan
विपक्ष	ellenzék	None
विपक्षी	ellenzék	None
विपणन	értékesítés	Nan
विपरीत	mellékhatás	Nan
विफल	nem sikerült	Nan
विन्या	vinya	Nan
विदेशियों	külföldiek	Nan
विश्वासों	hitek	Nan
विश्‍वविद्यालय	egyetemi	None
व्यंजना	eufemizmus	Nan
व्यंजन	edények	Nan
व्यंग्यरचना	gúny	Nan
व्यंग्य	gúny	Nan
वोल्टायिक	galván	Nan
वोर्ल	örv	Nan
वोट	a szavazás	Nan
वो	ők	None
वॉट	watt	Nan
वैसे	mellesleg	Nan
वैसी	mint az	Nan
वैसा	mint az	Nan
वैष्णो	vaishno	Nan
वैष्णव	vaishnav	Nan
वैश्वीकरण	globalizáció	None
वैश्विक	globális	None
वैश्य	vaishya	Nan
वैज्ञानिकों	a tudósok	Nan
वैदिक	védikus	Nan
वैद्य	orvos	None
वैद्युत	elektromos	None
वैध	érvényes	None
वैधता	érvényesség	Nan
व्यंजनों	receptek	Nan
वैधानिक	törvényen alapuló	Nan
वैराग्य	csendesség	Nan
वैली	völgy	Nan
वैवाहिक	házas	Nan
वैशाख	baishakh	Nan
वैशाली	vaishali	Nan
वैशेषिक	különleges	None
वैभव	nagyszerűség	Nan
व्यक्त	kifejezve	Nan
व्यक्ति	személy	None
व्यक्तिगत	személyes	None
व्याख्याता	előadó	None
व्याख्यान	előadás	None
व्यापक	átfogó	None
व्यापार	üzleti	None
व्यापारियों	a kereskedők	Nan
व्यापारी	a kereskedő	Nan
व्याख्याओं	értelmezési	Nan
व्यापी	széles	None
व्यायाम	dolgozzanak ki	Nan
व्यावसायिक	szakmai	None
व्यावहारिक	gyakorlati	None
व्यावहारिकता	a praktikusság	Nan
व्यास	átmérő	Nan
व्युत्पत्ति	származtatás	Nan
व्याप्त	mindennapos	Nan
वैज्ञानिकता	szcientizmussal	Nan
व्याख्या	magyarázat	None
व्याकरण	grammer	Nan
व्यक्तित्व	a személyiség	Nan
व्यक्तियों	az egyének	Nan
व्यतीत	múlt	None
व्यय	a költség	Nan
व्यर्थ	hiába	None
व्यवसाय	az üzlet	Nan
व्याकुल	zavarodott	Nan
व्यवसायिक	szakmai	None
व्यवस्था	a megegyezés	Nan
व्यवस्थित	elrendezve	Nan
व्यवहार	a viselkedés	Nan
व्यवहारिक	gyakorlati	None
व्यस्क	felnőtt	None
व्यस्त	elfoglalt	None
व्यवसायों	üzletek	Nan
वैज्ञानिक	tudós	None
वैचारिक	ideológiai	Nan
वैकल्पिक	alternatív	None
विहीन	mentes	None
वीं	th	Nan
वीडियॊ	videó	None
वीडियो	videó	None
वीणा	veena	Nan
वीर	bátor	None
विस्फोट	robbanás	None
वीरता	bátorság	Nan
वीरों	a bátor	Nan
वीर्य	sperma	Nan
वृंदावन	vrindávan	Nan
वृक्ष	fa	None
वृक्षों	fák	None
वृत्तांत	számla	Nan
वीरेन्द्र	virendra	Nan
वृत्ति	hozzáállás	Nan
विस्थापित	displaced	Nan
विस्तारपूर्वक	körülményesen	Nan
विष	méreg	Nan
विषम	páratlan	None
विषय	tantárgy	Nan
विषयक	tematikus	Nan
विषयवस्तु	téma	None
विषयों	a témák	Nan
विस्तृत	részletes	None
विषाणु	vírus	None
विषैले	mérgező	None
विष्णु	vishnu	Nan
विष्णुगुप्त	vishnugupta	Nan
विसर्जन	a merítés	Nan
विसर्जित	merüljön	Nan
विस्तार	részletes	None
विषाणुओं	vírusok	None
विश्‍व	világ	None
वृद्ध	régebbi	None
वृद्धि	növekedés	None
वेनेज़ुएला	venezuela	None
वेब	háló	Nan
वेबदुनिया	webdunia	Nan
वेबसाइट	weboldal	None
वेल्डिंग	hegesztés	None
वेल्श	walesi	Nan
वेधशाला	obszervatórium	Nan
वेल्स	wells	Nan
वेश्या	prostituált	Nan
वेश्याओं	prostituáltak	Nan
वेश्यावृत्ति	prostitúció	Nan
वेस्ट	nyugat	None
वेस्टमिंस्टर	westminster	Nan
वेह	ők	None
वेश	ruha	Nan
वृद्धावस्था	öreg kor	Nan
वेदों	védák	Nan
वेदान्त	védanta	Nan
वृन्दावन	vrindávan	Nan
वृहत	hatalmas	None
वृहद	nagy	None
वृहद्	nagy	None
वे	ők	None
वें	th	Nan
वेदी	az oltár	Nan
वेंकटेश्वर	venkateswara	Nan
वेतन	a bérek	Nan
वेद	veda	Nan
वेदना	kín	Nan
वेदव्यास	vedvyas	Nan
वेदांग	vedang	Nan
वेदांत	védanta	Nan
वेग	sebesség	None
व्युत्पन्न	származtatott	Nan
विदेश	külföldi	None
वित्त	pénzügy	Nan
वक्त	idő	None
वकील	jogász	Nan
वकालत	pártfogás	Nan
वंशावली	genealógia	Nan
वंशानुगत	örökletes	Nan
वंशज	leszármazott	Nan
वंश	dinasztia	None
वंदना	ima	Nan
ळ	4	Nan
लौह	vas	None
लौटा	visszaküldött	Nan
लौटने	visszatérés	None
लौट	visszatérés	None
लौकिक	kozmikus	None
लोहे	vas	None
लोहा	vas	None
लोशन	testápoló	Nan
लोकतान्त्रिक	demokratikus	None
लोकप्रियता	népszerűség	Nan
लोकमान्य	népszerű	None
लोकसभा	lok sabha	Nan
लोकों	emberek	None
लोग	az emberek	Nan
वक्तव्य	nyilatkozat	None
लोगो	peoples	Nan
लोड	betöltés	Nan
लोदी	lodi	Nan
लोधी	lodhi	Nan
लोप	mulasztás	Nan
लोभ	kapzsiság	Nan
लोयस	loys	Nan
लोगों	az emberek	Nan
वक्ता	a beszélő	Nan
वक्र	a görbe	Nan
वक्ष	mell	Nan
वरन्	egyéb	None
वरिष्ठ	idősebb	None
वरुण	varun	Nan
वरुणा	varuna	Nan
वर्ग	kategória	None
वर्गीकरण	osztályozás	Nan
वरन	áldás	Nan
वर्गीकृत	osztályozott	Nan
वर्चस्व	fölény	Nan
वर्जित	korlátozott	None
वर्ड	szó	None
वर्ण	karakterek	None
वर्णक्रम	színkép	Nan
वर्णक्रमीय	spektrális	Nan
वर्गों	a négyzetek	Nan
लोकतांत्रिक	demokratikus	None
वरदान	ajándék	Nan
वयस्क	felnőtt	None
वचन	ígéret	Nan
वचनों	szavak	None
वजन	súly	Nan
वजह	az ok	Nan
वज़न	a súlyt	Nan
वत्स	gyermek	None
वयस्कों	felnőttek	None
वध	megöl	Nan
वनडे	odi	Nan
वनवास	száműzetés	Nan
वनस्पतियों	növényvilág	Nan
वनों	az erdők	Nan
वन्दे	vande	Nan
वन्य	vad	None
वन	erdő	None
लोककथा	folklór	Nan
लोक	vidék	None
लो	vesz	None
लिपियों	scripts	Nan
लिप्यन्तरण	transzliteráció	Nan
लिया	vett	None
लिया|	vett	None
लिये	mert	None
लिये|	mert	None
लिपियाँ	scripts	Nan
लिली	liliom	Nan
लीग	a liga	Nan
लीटर	liter	Nan
लीबनीज	leibniz	Nan
लीबिया	líbia	Nan
लीला	leela	Nan
लीलाओं	kedvtelések	Nan
ली	lee	None
लुईस	louis	None
लिपिक	hivatalnok	Nan
लिनक्स	linux	None
लिंग	nem	None
लिंगानुपात	nemek aránya	Nan
लिए	mert	None
लिख	ír	None
लिखकर	írásban	None
लिखते	írások	None
लिपि	forgatókönyv	None
लिखना	írni	None
लिखा	írt	None
लिखित	írásbeli feljegyzés	Nan
लिखी	írott	None
लिखीं	írt	None
लिखे	ír	None
लिच्छवि	licchavi	Nan
लिखने	ír	None
वर्णन	a leírás	Nan
लुप्त	hiányzó	None
लूटपाट	fosztogatás	Nan
लेनदेन	tranzakció	Nan
लेना	elvenni	Nan
लेनी	vesz	None
लेने	átadás	Nan
लेप	bevonat	Nan
लेबल	a címke	Nan
लेते	vesz	None
लैंगिक	szexuális	None
लैंड	föld	None
लैटिन	latin	None
लैला	laila	Nan
लॉ	törvény	None
लॉर्ड	lord	None
लॉस	veszteség	Nan
लैंग्वेज	a nyelv	Nan
लू	lu	Nan
लेती	tudomásul	Nan
लेट	késő	None
लूट्यन्स	lutyens	Nan
ले	vesz	None
लें	vesz	None
लेक	tó	None
लेकर	val vel	Nan
लेख	cikk	None
लेता	tudomásul	Nan
लेखक	szerző	None
लेखन	írás	None
लेखा	fiókok	Nan
लेखांकन	könyvelés	Nan
लेखों	cikkek	None
लेग	láb	None
लेगा	fog tartani	Nan
लेखकों	a szerzők	Nan
वित्तीय	pénzügyi	None
वर्णनात्मक	leíró	None
वर्णों	a karakterek	Nan
विकास	fejlődés	None
विकारों	rendellenességek	Nan
विकार	rendellenesség	Nan
विकसित	fejlett	None
विकल्प	az opció	Nan
विंग	a szárny	Nan
वि	v	Nan
वाह्य	külső	None
वाहिनी	csatorna	None
वाहिनियों	a csatornák	Nan
वाहनों	járművek	None
वाहन	jármű	None
वास्तुशिल्प	építészet	None
वास्तुकार	építészmérnök	Nan
वास्तुकला	építészet	None
वास्तु	építészeti	None
वास्तविकता	a valóság	Nan
वार्मिंग	melegítés	Nan
वार्षिक	az éves	Nan
वाला	az egyik	Nan
वालो	barátok	None
वालों	azok	None
वाल्मीकि	valmiki	Nan
विकासवादी	evolúciós	None
वाशिंगटन	washington	None
वास	az élőhely	Nan
वासना	vágy	Nan
वासाच	wasach	Nan
वासुदेव	vasudev	Nan
वास्तव	valóság	None
वास्तविक	tényleges	None
वाष्प	gőz	Nan
विकि	wiki	Nan
विकिपीडिया	wikipedia	Nan
विकिमीडिया	wikimedia	Nan
विजय	győzelem	None
विजयनगर	vijayanagar	Nan
विजयी	győztes	None
विजेता	a győztes	Nan
विज्ञान	tudomány	None
विज्ञानियों	a tudósok	Nan
विचित्र	bizarr	None
विज्ञानी	a tudós	Nan
विज्ञापन	hirdetés	Nan
विज्ञापनों	reklámok	Nan
विटामिन	vitamin	Nan
विडियो	videó-	Nan
विण्डोज़	ablakok	Nan
वितरण	kézbesítés	Nan
विज्ञानों	a tudományok	Nan
वार्तालाप	beszélgetések	Nan
विचारों	ötletek	Nan
विचारक	gondolkodó	None
विकिरण	sugárzás	None
विकिस्रोत	wikiforrásban	Nan
विकेट	a kiskapu	Nan
विकेटकीपर	kapusőr	Nan
विक्टोरिया	victoria	None
विक्रम	vikram	Nan
विचारकों	gondolkodók	None
विक्रमादित्य	vikramaditya	Nan
विक्रेता	az eladó	Nan
विख्यात	neves	None
विगत	a múlt	Nan
विघ्न	zavarás	Nan
विचरण	variancia	Nan
विचार	ötlet	None
विक्रय	sales	Nan
वार्ता	beszélgetés	None
वाराणसी	varanasi	Nan
वार	háború	None
वस्तुएं	a dolgok	Nan
वस्तुओं	az elemek	Nan
वस्तुत	valóban	None
वस्तुतः	gyakorlatilag	None
वस्त्र	ruhák	Nan
वस्त्रों	ruházat	Nan
वस्तुएँ	a dolgok	Nan
वह	ő	None
वहाँ	ott	None
वहां	ott	None
वही	ugyanaz	None
वहीं	maga ott van	Nan
वा	wa	Nan
वां	th	Nan
वहन	megfizethető	Nan
वांछित	kívánatos	Nan
वस्तु	dolog	None
वसा	zsír	Nan
वर्तनी	helyesírás	Nan
वर्तमान	ajándék	Nan
वर्मा	verma	Nan
वर्ल्ड	világ	None
वर्ष	az év	Nan
वर्षीय	éves	None
वसूली	felépülés	Nan
वर्षो	az évek	Nan
वल्लभ	vallabh	Nan
वल्लभाचार्य	vallabhacharya	Nan
वश	szelíd	Nan
वशिष्ठ	vashistha	Nan
वसंत	tavaszi	None
वसन्त	tavaszi	None
वर्षों	évek	None
वर्णित	leírt	None
वाइड	széles	None
वाक	beszéd	None
वान	kisteherautó	Nan
वानर	majom	Nan
वानरों	apes	Nan
वापस	vissza	None
वापसी	a visszatérés	Nan
वापिस	vissza	None
वाद्य	a hangszer	Nan
वायरस	vírus	None
वायुगतिकी	aerodinamika	Nan
वायुदाब	levegő nyomás	Nan
वायुमंडल	légkör	None
वायुमंडलीय	légköri	None
वायुयान	repülőgép	None
वायुसेना	légierő	None
वायु	szél	None
वाई	miért	None
वादी	a felperes	Nan
वादक	játékos	None
वाकाटक	vakataka	Nan
वाक्य	a mondat	Nan
वाक्यों	mondatok	Nan
वाचक	olvasó	None
वाजपेयी	vajpayee	Nan
वाट	watt	Nan
वादन	playing	Nan
वाणिज्य	kereskedelmi	None
वाणी	hang	None
वात	levegő	None
वातावरण	légkör	None
वात्सल्य	vatsalya	Nan
वात्स्यायन	vatsyayan	Nan
वाद	öltöny	Nan
वाणिज्यिक	kereskedelmi	None
समर	háború	None
व्यू	kilátás	Nan
व्रत	gyors	None
संयुक्त	közös	None
संयम	mérséklet	Nan
संयंत्र	növény	None
संभोग	nemi közösülés	Nan
संभावित	a potenciál	Nan
संभावनाओं	a lehetőségek	Nan
संभावना	véletlen	None
संभाला	kezelni	None
संभालने	feltételezve	Nan
संभाल	vigyázz magadra	Nan
संभवतया	esetleg	None
संभवतः	esetleg	None
संभवत	valószínűleg	None
संभव	lehetséges	None
संबोधित	címzett	Nan
संबन्धी	összefüggő	None
संबंधों	nyakkendő	Nan
संपत्ति	ingatlan	Nan
संपदा	birtok	None
संपन्न	kész	None
संपर्क	kapcsolatba lépni	Nan
संपादक	szerkesztő	None
संपादन	a szerkesztés	Nan
संयोग	egy egybeesés	Nan
संपादित	szerkesztette	None
संप्रदाय	szekta	Nan
संप्रदायों	címletek	Nan
संप्रभु	szuverén	Nan
संबंध	kapcsolat	None
संबंधित	összefüggő	None
संबंधी	relatív	None
संपूर्ण	teljes	None
संयोगिता	véletlen egybeesés	Nan
संयोजक	összehívó	Nan
संयोजन	a kombináció	Nan
संशोधन	egy módosítás	Nan
संशोधित	felülvizsgált	Nan
संश्लेषण	szintézis	Nan
संसद	parlament	None
संसदीय	parlamenti	None
संसाधन	erőforrások	Nan
संवेदी	szenzoros	Nan
संसाधनों	erőforrások	Nan
संस्करण	kiadás	None
संस्करणों	kötetek	Nan
संस्कार	szentségek	Nan
संस्कारों	rites	Nan
संस्कृत	szanszkrit	None
संस्कृतम्	szanszkrit	None
संसार	világ	None
संन्यासी	saints	Nan
संवेदना	részvétét	Nan
संवेदनशील	érzékeny	None
संरक्षण	védelem	None
संरक्षित	védett	None
संरचना	a szerkezet	Nan
संरचनाओं	a szerkezetek	Nan
संरेखण	igazítás	Nan
संलग्न	csatolni	Nan
संवेदनशीलता	érzékenység	Nan
संलयन	magfúzió	Nan
संवत्	korszak	None
संवाद	beszélgetés	None
संवादों	párbeszédek	Nan
संविधान	alkotmány	None
संविभ्रम	üldözési mánia	Nan
संवेग	lendület	Nan
संवत	korszak	None
संध्या	este	None
संधि	a szerződés	Nan
संदेह	kétség	Nan
संगणक	számítógép	None
संगणना	számítási	Nan
संगत	vállalat	None
संगम	összefolyás	Nan
संगमरमर	üveggolyó	Nan
संगमर्मर	üveggolyó	Nan
संगठनात्मक	szervezeti	None
संगीतकार	zenész	None
संग्रह	gyűjtemény	None
संग्रहण	tárolás	Nan
संग्रहालय	a múzeum	Nan
संग्रहित	memorizált	Nan
संग्राम	küzdelem	None
संग्राहलय	múzeum	None
संगृहीत	memorizált	Nan
संघ	az unió	Nan
संगठन	szervezet	None
संख्याओं	a számok	Nan
संकुचित	összezsugorodik	Nan
संकेत	a jel	Nan
संकेतक	mutatók	Nan
संकेतन	jelölés	None
संकेतों	jelzések	Nan
संकोच	tétovázik	Nan
संग	val vel	Nan
संक्रमण	fertőzés	None
संक्रांति	napforduló	None
संक्रामक	fertőző	None
संक्षिप्त	rövid	None
संक्षेप	a rövid	Nan
संख्या	szám	None
संख्याएँ	a számok	Nan
संक्रमित	fertőzött	None
संस्कृति	kultúra	None
संघटन	fogalmazás	Nan
संघीय	a szövetségi	Nan
संतरा	narancs	None
संतान	gyermekek	None
संतुलन	a mérleg	Nan
संतुलित	kiegyensúlyozott	Nan
संतुष्ट	elégedett	Nan
संतुष्टि	megelégedettség	Nan
संत	szent	None
संतों	saints	Nan
संदमक	inhibitor	Nan
संदर्भ	a referencia	Nan
संदर्भित	hivatkozott	None
संदर्भों	irodalom	None
संदिग्ध	kétséges	Nan
संदेशों	üzenetek	Nan
संतोष	megelégedettség	Nan
संघर्षों	konfliktusok	None
संज्ञानात्मक	megismerő	Nan
संज्ञा	főnév	None
संघों	egyesületek	Nan
संचय	felhalmozódás	Nan
संचरण	terjedés	Nan
संचार	távközlés	Nan
संचारित	továbbított	Nan
संचालक	rendező	None
संज्ञाओं	főnevek	None
संचालन	tevékenységek	None
संचिका	a fájl	Nan
संचिकाएँ	files	Nan
संचिकाओं	files	Nan
संचित	felgyülemlett	Nan
संजय	sanjay	Nan
संजोए	mentés	Nan
संचालित	hajtású	Nan
संकुचन	összehúzódás	Nan
संस्कृतियों	kultúrák	None
संस्थाएँ	intézmények	None
सबकी	mindenki	None
सबका	mindenki	None
सब	összes	None
सफेद	fehér	None
सफारी	szafari	Nan
सफाई	tiszta	None
सफ़लता	siker	None
सफ़ल	sikeres	None
सफ़र	utazás	None
सफलतापूर्वक	sikeresen	None
सफलता	siker	None
सफल	sikeres	None
सफर	az utazás	Nan
सप्ताह	hét	None
सप्तम	hetedik	None
सपने	álmok	Nan
सन्‌	év	None
सदाबहार	örökzöld	Nan
सदियों	évszázadokkal	Nan
सदी	század	None
सदृश	tetszik	None
सदैव	mindig	None
सद्भावना	jóakarat	Nan
सबके	mindenkinek	None
सद्स्य	tag	None
सनातन	örök	None
सन्त	szent	None
सन्तान	gyermekek	None
सन्तों	saints	Nan
सन्दर्भ	irodalom	None
सन्देश	az üzenet	Nan
सन	nap	None
सबको	mindenkinek	None
सबमें	mindenben	Nan
सबसे	az összes	Nan
समझना	megértés	Nan
समझने	megérteni	Nan
समझा	megértett	Nan
समझाने	magyarázd	Nan
समझाया	magyarázatai	Nan
समझी	megértett	Nan
समझते	megért	Nan
समझौता	egy település	Nan
समता	paritás	Nan
समन्वय	egyeztetés	Nan
समन्वित	integrált	Nan
समभाव	egykedvűség	Nan
समय	idő	None
समयरेखा	az idővonal	Nan
समझौते	a megállapodás	Nan
सदाचार	erény	Nan
समझता	megérti	Nan
समग्र	átfogó	None
सबूत	bizonyíték	None
सब्जी	növényi	None
सब्सिडी	szubvenció	Nan
सभा	gyülekezés	Nan
सभाओं	az összejövetelek	Nan
सभापति	elnök	None
समझ	megért	Nan
सभी	összes	None
सभ्यता	kultúra	None
सभ्यताओं	civilizációk	Nan
सम	még	None
समकालीन	kortárs	None
समकोण	derékszög	Nan
समक्ष	előtt	None
सभ्य	megfelelő	None
सदा	mindig	None
सदस्यों	belépés	Nan
सदस्यता	tagság	Nan
सकें	tud	None
सकेगा	képes lesz arra	Nan
सक्रिय	aktív	None
सक्रियता	tevékenység	None
सक्षम	képes	None
सख्त	szigorú	None
सके	tudott	None
सख्ती	szigorúság	Nan
सघन	sűrű	None
सच	igazság	None
सचमुच	igazán	None
सचिन	sachin	Nan
सचिव	titkár	Nan
सचिवालय	titkárság	Nan
सगुण	erény	Nan
सच्चा	igaz	None
सकी	tudott	None
सका	tudott	None
संस्थाएं	intézmények	None
संस्थाओं	intézmények	None
संस्थागत	szervezeti	None
संस्थान	az intézet	Nan
संस्थानों	intézmények	None
संस्थापक	által alapított	Nan
सकारात्मक	igenlő	Nan
संस्थापित	telepített	None
संहार	megsemmisítő	Nan
संहिता	kód	None
सकता	tud	None
सकती	tud	None
सकते	tud	None
सकल	bruttó	None
संस्मरण	emlékezések	Nan
संस्था	a szervezet	Nan
सच्चाई	igazság	None
सजा	büntetés	None
सत्तर	hetven	Nan
सत्ता	erő	None
सत्तारूढ़	az ítélet	Nan
सत्यं	igazság	None
सत्यजीत	satyajit	Nan
सत्यता	az igazság	Nan
सत्कार	üdvözöljük	Nan
सत्यवती	satyavati	Nan
सत्र	az ülés	Nan
सत्रह	tizenhét	None
सत्रहवीं	tizenhetedik	Nan
सदन	a ház	Nan
सदनॉ	házak	None
सदस्य	tag	None
सत्याग्रह	satyagraha	Nan
सच्चे	igaz	None
सत्कर्म	igazság	None
सती	sati	Nan
सजाने	díszít	Nan
सजाया	díszített	None
सजावट	dekoráció	Nan
सजावटी	dekoratív	Nan
सजीव	élő	None
सजीवों	élőlények	None
सतीश	satish	Nan
सज्जन	úriember	Nan
सडक	út	None
सड़क	út	None
सड़कों	az utak	Nan
सतत	folyamatos	None
सतरूपा	hetven	Nan
सतह	felület	None
सटीक	pontos	Nan
व्रण	fekély	Nan
संकीर्ण	keskeny	None
संकल्प	eskü	Nan
शिक्षकों	tanárok	Nan
शिक्षक	tanár	None
शिकारी	vadász	None
शिकार	áldozat	None
शिकायतें	panaszok	Nan
शिकायत	panasz	Nan
शिकागो	chicago	None
शाही	királyi	None
शाहिद	shahid	Nan
शाहजी	shahaji	Nan
शाहजहां	shahjahan	Nan
शाहजहाँ	shah jahan	Nan
शाह	sah	Nan
शास्त्रों	a szentírások	Nan
शास्त्रीय	klasszikus	None
शास्त्री	shastri	Nan
शास्त्रार्थ	vita	None
शाम	este	None
शामिल	tartalmaz	None
शायर	költő	None
शायरी	költészet	None
शारदा	sharda	Nan
शारीरिक	test	None
शिक्षण	tanítás	None
शाश्वत	örökös	None
शासकीय	hivatalos	None
शासकों	az uralkodók	Nan
शासन	kormányzás	Nan
शासनकाल	uralkodik	None
शासित	zárható	Nan
शास्त्र	etológia	Nan
शासक	a vonalzó	Nan
शिक्षाओं	tanításai	Nan
शिक्षित	művelt	None
शिखर	a csúcs	Nan
शीत	hideg	None
शीतकाल	téli	None
शीतोष्ण	mérsékelt	None
शीर्ष	felső	None
शीर्षक	cím	None
शील	szerénység	Nan
शीघ्र	hamar	None
शुंग	sunga	Nan
शुक्रवार	péntek	Nan
शुक्राणु	sperma	Nan
शुक्लयजुर्वेदीय	csillagjóslás	Nan
शुद्ध	tiszta	None
शुद्धता	pontosság	Nan
शुद्धि	tisztítás	Nan
शुक्र	vénusz	None
शाब्दिक	szó szerint	Nan
शिष्य	tanítvány	Nan
शिशुओं	babák	Nan
शिथिल	kipihent	Nan
शिमला	shimla	Nan
शिया	shia	Nan
शिराओं	erek	Nan
शिला	szikla	Nan
शिलालेख	felírás	Nan
शिष्टाचार	modor	Nan
शिव	shiv	Nan
शिवरात्रि	shivratri	Nan
शिवलिंग	shivling	Nan
शिवाजी	shivaji	Nan
शिवालिक	shivalik	Nan
शिविर	tábor	None
शिशु	baba	Nan
शिवजी	shiva	Nan
शाप	átok	Nan
शान्ति	béke	None
शान्तनु	shantanu	Nan
शताब्दी	század	None
शती	század	None
शत्रु	ellenség	None
शत्रुओं	ellenségek	Nan
शनि	szaturnusz	None
शनिदेव	shani dev	Nan
शताब्दियों	évszázadokkal	Nan
शनिवार	szombat	Nan
शब्दकोष	szótár	None
शब्दार्थ	szemantika	Nan
शब्दावली	szójegyzék	None
शब्दों	a szavak	Nan
शमन	enyhítés	Nan
शरण	bolondok háza	Nan
शपथ	eskü	Nan
शरणार्थी	menekültek	None
शतरंज	sakk	None
शटल	űrsikló	Nan
व्हाइट	fehér	None
श	sh	Nan
शंकराचार्य	shankaracharya	Nan
शंकुधारी	toboztermő fa	Nan
शंख	héj	Nan
शंघाई	shanghai	Nan
शतक	század	None
शक	kétség	Nan
शकुन्तला	shakuntala	Nan
शकों	sons	Nan
शक्तियाँ	powers	Nan
शक्तियां	a hatalmak	Nan
शक्तियों	a hatalmak	Nan
शक्तिशाली	a hatalmas	Nan
शकुंतला	shakuntala	Nan
शुभ	jó	None
शरद	ősz	None
शरीफ	dzsentri	Nan
शहीदों	martyrs	Nan
शांत	csendes	None
शांति	béke	None
शाकाहारी	vegetáriánus	Nan
शाक्त	erő	None
शाखा	ág	None
शहीद	mártír	Nan
शाखाएँ	ágak	Nan
शाखाओं	ágak	Nan
शाखायें	ágak	Nan
शादी	esküvő	None
शान	büszkeség	Nan
शानदार	mesés	Nan
शान्त	nyugodt	None
शाखाएं	ágak	Nan
शराब	alkohol	None
शहादत	vértanúság	Nan
शहरो	a városok	Nan
शरीर	a test	Nan
शर्करा	cukor	None
शर्त	tét	Nan
शर्तें	a feltételek	Nan
शर्तों	a feltételek	Nan
शर्मा	sharma	Nan
शहरों	a városok	Nan
शल्य	sebészeti	Nan
शशि	shashi	Nan
शस्त्र	fegyver	None
शहद	édesem	Nan
शहर	város	None
शहरी	városi	None
शहरीकरण	urbanizáció	Nan
शव	halott test	Nan
संकल्पना	koncepció	None
शुभारंभ	az indítás	Nan
शुरुआत	kezdet	Nan
श्रेणीयूरोप	categoryeurope	Nan
श्रेणीमुग़ल	kategória mogul	Nan
श्रेणीमहाभारत	india	None
श्रेणीमध्य	kategorikus	Nan
श्रेणीभौतिकी	fizikai fokozat	Nan
श्रेणीभूगोल	földrajz	None
श्रेणीभारतीय	categoryindian	Nan
श्रेणीबॉलीवुड	kategória bollywood	Nan
श्रेणीबिहार	értékelés	Nan
श्रेणीपौराणिक	kategória	None
श्रेणीपश्चिम	fokozat nyugatra	Nan
श्रेणीनोबेल	grennobel	Nan
श्रेणीधार्मिक	osztály vallásos	Nan
श्रेणीधर्मग्रन्थ	hierarchia	Nan
श्रेणीधर्म	hierarchia	Nan
श्रेणीदेश	fokozatú ország	Nan
श्रेणीदेवीदेवता	kategória isten	Nan
श्रेणीइस्लाम	iszlám kategória	Nan
श्रेणीउत्तम	legjobb osztály	Nan
श्रेणीउत्तर	kategória válasz	Nan
श्रेणीउत्तराखण्ड	uttarakhand kategória	Nan
श्रेणीएशिया	ázsia kategória	Nan
श्रेणीगुगल	kategória	None
श्रेणीराजनीति	kategória irányelv	Nan
श्रेणीग्रह	hierarchia	Nan
श्रेणीजीव	végzetes	Nan
श्रेणीजीवनी	kategória élő	Nan
श्रेणीज्योतिष	gradiens	Nan
श्रेणीतकनीकी	műszaki	None
श्रेणीदर्शन	értékelés	Nan
श्रेणीदिल्ली	delhi	Nan
श्रेणीचीन	kategóriák	Nan
श्रेणीराजस्थान	categoryrajasthan	Nan
श्रेणीरामायण	fokozat	None
श्रेणीवर्ष	évfolyam	Nan
श्रेष्ठतम	a legjobb	Nan
श्रेष्ठता	fölény	Nan
श्रोताओं	hallgatók	Nan
श्लोक	vers	None
श्लोकों	shlokas	Nan
श्वसन	légzés	Nan
श्रेष्ठ	legjobb	None
श्वास	lehelet	Nan
स	s	None
सं	nem.	Nan
संकट	probléma	None
संकर	hibrid	Nan
संकलक	a fordító	Nan
संकलित	összeállított	None
श्वेत	fehér	None
श्रेणीइतिहास	történelem története	Nan
श्रेय	hitel	None
श्रेणीस्वतंत्रता	osztály függetlenség	Nan
श्रेणीविज्ञान	hierarchikus	Nan
श्रेणीव्यक्तिगत	személyre	Nan
श्रेणीशहर	kategória város	Nan
श्रेणीसंगणक	osztályozó	Nan
श्रेणीसंयुक्त	kategória kombinálva	Nan
श्रेणीसंस्कृत	fokozat kulturált	Nan
श्रेणीहिन्दू	fokozat pont	Nan
श्रेणीसंस्कृति	osztálykultúra	Nan
श्रेणीसमाज	osztálytársadalom	Nan
श्रेणीसमाजशास्त्र	hierarchikus	Nan
श्रेणीसाहित्य	kategória irodalom	Nan
श्रेणीसूचना	értékelés	Nan
श्रेणीसॉफ्टवेयर	kategória szoftver	Nan
श्रेणीसौर	kategória	None
श्रेणीसभ्यता	gradability	Nan
श्रेणीआगरा	kategória	None
श्रेणीअर्थशास्त्र	fokozat közgazdaságtan	Nan
श्रेणी	kategória	None
शेष	maradék	None
शैक्षणिक	nevelési	Nan
शैतान	ördög	None
शैलियाँ	stílusok	None
शैलियां	a stílusok	Nan
शैलियों	a stílusok	Nan
शेर्पा	sherpa	Nan
शैली	a stílus	Nan
शॉट	a lövés	Nan
शॉपिंग	bevásárlás	Nan
शो	előadás	None
शोक	gyász	Nan
शोध	kutatás	None
शोधकर्ता	kutató	None
शैव	shaiva	Nan
शोधकर्ताओं	kutatók	None
शेरशाह	sher shah	Nan
शेयरों	megoszt	Nan
शुरुआती	a korai	Nan
शुरुवात	a kezdet	Nan
शुरू	rajt	Nan
शुरूआत	a kezdet	Nan
शुरूआती	a kezdeti	Nan
शुल्क	a díj	Nan
शेर	oroszlán	None
शुष्क	száraz	None
शूटिंग	lövés	Nan
शून्य	nulla	None
शृंखला	a sorozat	Nan
शेख	sejk	Nan
शेखर	sekhar	Nan
शेयर	ossza meg	Nan
शूकर	cukor	None
शुरु	rajt	Nan
शोधन	helyesbítés	Nan
शोभा	kegyelem	Nan
श्रीमद्	shrimad	Nan
श्रीमद्भगवद्गीता	shrimad bhagavad gita	Nan
श्रीमद्भागवत	shrimad bhagwat	Nan
श्रीराम	sriram	Nan
श्रीरामजी	shri ram ji	Nan
श्रीलंका	srí lanka	Nan
श्रीनिवास	srinivas	Nan
श्रीवास्तव	srivastava	Nan
श्रुति	shruti	Nan
श्रृंखला	lánc	Nan
श्रृंखलाओं	a láncok	Nan
श्रृंगार	smink	Nan
श्रेणियाँ	kategóriák	Nan
श्रेणियों	kategóriák	Nan
श्रीशैल	srisail	Nan
शोधपत्र	kutatási papír	Nan
श्रीधर	shridhar	Nan
श्री	úr	None
शोर	zaj	Nan
शोषण	kizsákmányolás	Nan
शोषित	hasznosított	Nan
शौर्य	bátorság	Nan
श्याम	shyam	Nan
श्यामा	shyama	Nan
श्रीकृष्ण	sri krishna	Nan
श्रद्धा	tisztelet	Nan
श्रद्धालुओं	bhakták	Nan
श्रम	munkaerő	None
श्रमिक	munkaerő	None
श्राद्ध	shraddh	Nan
श्राप	az átok	Nan
श्रावण	shravan	Nan
श्रद्धालु	hűséges	None
पिंडों	tárgyak	None
पिंड	test	None
पास्काविषयक	járható	Nan
कर्मी	személyzet	None
कर्मियों	személyzet	None
कर्मचारी	személyzet	None
कर्मचारियों	az alkalmazottak	Nan
कर्मकाण्ड	szertartás	Nan
कर्फ्यू	kijárási tilalom	Nan
कर्नाटक	karnataka	Nan
कर्तव्य	kötelezettség	Nan
कर्ण	karna	Nan
कर्ज	hitel	None
कर्क	rák	None
करोड़ों	milliók	Nan
करोड़	crore	Nan
करोड	crores	Nan
करोगे	megteszi	Nan
करों	adók	None
करो	csináld!	Nan
कराना	csinálni	Nan
कराने	csinálni	Nan
करार	a megállapodás	Nan
करी	curry	Nan
करीना	kareena	Nan
करीब	közel	None
कर्मों	deeds	Nan
करुणा	együttérzés	Nan
करूंगा	megteszi	Nan
करे	csinál	Nan
करें	csináld a	Nan
करेंगे	megteszi	Nan
करेगा	megteszi	Nan
करेगी	megteszi	Nan
करूँगा	megteszi	Nan
कल	holnap	None
कलंक	elhomályosít	Nan
कलकत्ता	calcutta	Nan
कवच	páncél	Nan
कवयित्री	költőnő	Nan
कवर	a borító	Nan
कवरेज	lefedettség	Nan
कवि	költő	None
कविता	vers	None
कल्याणकारी	jólét	Nan
कविताएँ	versek	None
कवियों	költők	None
कश्मीर	kasmír	Nan
कश्मीरी	kasmíri	Nan
कश्यप	kashyap	Nan
कष्ट	szenvedő	None
कसौटी	teszt	None
कविताओं	versek	None
कराते	karate	Nan
कल्याण	jólét	Nan
कल्पना	képzelet	Nan
कलम	toll	Nan
कलश	kalash	Nan
कला	művészet	None
कलाई	csukló	Nan
कलाओं	a művészetek	Nan
कलाकार	a művész	Nan
कल्पित	kitalált	None
कलाकारों	művészek	None
कलात्मक	művészeti	None
कलाम	kalam	Nan
कलियुग	kali yuga	Nan
कली	bimbó	Nan
कल्कि	kalki	Nan
कल्चर	kultúra	None
कलाकृतियों	leletek	None
कराती	karati	Nan
कराता	biztosítja	None
कराची	karachi	Nan
कबीर	kabir	Nan
कबीरदास	kabirdas	Nan
कबीले	a klán	Nan
कब्ज़ा	elfog	Nan
कब्जा	elfog	Nan
कब्र	a sír	Nan
कबड्डी	kabaddi	Nan
कब्रों	a sírok	Nan
कभीकभी	néha	None
कमजोर	gyenge	None
कमजोरी	gyengeség	Nan
कमप्यूटर	számítógép	None
कमर	derék	Nan
कमरे	szobák	Nan
कभी	néha	None
कमल	lótusz	Nan
कब	amikor	None
कप्तान	a kapitány	Nan
कनाडा	kanada	None
कनिष्ठ	beosztott	Nan
कनेक्शन	a kapcsolat	Nan
कन्नड़	kannada	Nan
कन्नौज	kannaudzs	Nan
कन्या	szűz	None
कफ	váladék	Nan
कन्याकुमारी	kanyakumari	Nan
कप	a kupa	Nan
कपड़ा	a ruha	Nan
कपड़ों	ruházat	Nan
कपास	pamut	Nan
कपिल	kapil	Nan
कपूर	kapoor	Nan
कन्हैयालाल	kanhaiyalal	Nan
कस्टम	egyedi	None
कमला	kamla	Nan
कमांडो	kommandó	Nan
करती	csinál	Nan
करतीं	tenne	Nan
करते	csinál	Nan
करना	csinál	Nan
करनी	csinálni	Nan
करने	csinálni	Nan
करता	csinál	Nan
करनेवाला	integrátor	Nan
करवा	csináld meg	Nan
करवाई	megcsináltam	Nan
करवाने	csináld meg	Nan
करवाया	megcsináltam	Nan
करा	kara	Nan
कराई	routed	Nan
करनेवाले	cselekvő	Nan
कमांडर	a parancsnok	Nan
करण	karan	Nan
कर	adó	None
कमाई	kereset	Nan
कमान	parancs	None
कमाने	szerezni	None
कमाल	elképesztő	Nan
कमी	hiány	Nan
कमीशन	a komisszió	Nan
करके	csinálva	Nan
कमेटी	bizottság	None
कम्पनियां	a társaságok	Nan
कम्पनियों	cégek	None
कम्पनी	a cég	Nan
कम्प्यूटर	számítógép	None
कम्प्यूटरों	számítógépek	None
कम्प्यूटिंग	számítástechnika	Nan
कम्पनियाँ	a társaságok	Nan
कद्दू	tök	Nan
कस्बे	városok	None
कह	mond	None
कार्यवाही	akció	None
कार्यरत	dolgozó	None
कार्यभार	feladatok	None
कार्यपालिका	végrehajtó	None
कार्यपालक	végrehajtó	None
कार्यक्षेत्र	munkakör	Nan
कार्यक्षमता	munkaképesség	Nan
कार्यक्रमों	a programok	Nan
कार्यक्रम	program	None
कार्यकारी	az ügyvezető	Nan
कार्यकर्ताओं	a munkások	Nan
कार्यकर्ता	munkás	None
कार्य	munka	None
कार्बोहाइड्रेट्स	szénhidrát	Nan
कार्बोहाइड्रेट	szénhidrát	Nan
कार्बनिक	organikus	Nan
कार्बनडाइऑक्साइड	szén-dioxid	Nan
कारगिल	kargili	Nan
कारण	ok	None
कारणों	az okok	Nan
कारागृह	börtön	Nan
कारावास	bebörtönzés	Nan
कारीगर	kézműves	Nan
कार्यात्मक	funkcionális	Nan
कारीगरों	kézművesek	Nan
कारोबार	üzleti	None
कार्ड	kártya	None
कार्तिक	kartik	Nan
कार्तिकेय	karthikeya	Nan
कार्पोरेशन	corp.	Nan
कार्बन	szén	None
कारों	cars	Nan
कार्यान्वयन	az implementáció	Nan
कार्यालय	az iroda	Nan
कार्यालयों	irodák	Nan
काल्पनिक	álmodozó	Nan
काव्य	költészet	None
काशी	kashi	Nan
काष्ठ	faipari	Nan
कि	hogy	None
किंग	király	None
कालों	feketék	None
किंगडम	királyság	None
किक	rúgás	Nan
किण्वन	erjesztés	Nan
कितना	mennyi	None
कितनी	mennyi	None
कितने	mennyi	None
किताब	könyv	None
किए	kész	None
कारगर	hatékony	None
कालेज	főiskola	None
कालीबंगां	kalibangan	Nan
कार्यो	művek	None
कार्यों	a funkciók	Nan
कार्रवाई	az akció	Nan
कार्ल	karl	None
कार्सिनोजन	rákkeltő anyag	Nan
कार्सिनोमा	carcinoma	Nan
काले	fekete	None
काल	időszak	None
काला	fekete	None
कालांतर	túlóra	Nan
कालान्तर	idő telik el	Nan
कालिदास	kalidas	Nan
कालिया	kalia	Nan
कालीन	a szőnyeg	Nan
कालक्रम	kronológia	Nan
कारखाने	a gyári	Nan
कारखाना	a gyári	Nan
कारकों	tényezők	None
कहीं	valahol	None
कहे	mondás	Nan
कहें	mond	None
क़यामत	ítélet	None
क़ानून	törvény	None
क़ुरआन	korán	None
कहावत	közmondás	Nan
क़ुरान	korán	None
कांगो	kongó	Nan
कांग्रेस	kongresszus	None
कांच	üveg	Nan
कांचीपुरम	kanchipuram	Nan
कांड	botrány	None
कांतिमान	sugárzó	Nan
काँग्रेस	kongresszus	None
कांस्य	egy bronz	Nan
कहानी	sztori	Nan
कहानियां	történetek	None
कहकर	mondva	Nan
कहता	says	Nan
कहती	says	Nan
कहते	mond	None
कहना	mondd	Nan
कहने	mondani	None
कहानियों	történetek	None
कहलाता	hívott	None
कहलाते	hívják	None
कहलाने	hívni kell	Nan
कहलाया	hívott	None
कहा	mondott	None
कहां	ahol	None
कहानियाँ	történetek	None
कहलाती	nak, nek hívják	Nan
कस्बों	a városok	Nan
काउंटी	megye	None
काकोरी	kakori	Nan
काबुल	kabul	Nan
काम	munka	None
कामकाज	a munka	Nan
कामना	szeretnék	Nan
कामयाब	sikeres	None
कामशास्त्र	pszichológia	Nan
काफी	elég	None
कामसूत्र	kamasutra	Nan
कामा	cama	Nan
कामुक	érzéki	None
कामों	művek	None
कायम	tartani	None
कार	autó	None
कारक	a tényező	Nan
कामसूत्रकार	kamasutrakaar	Nan
काउंसिल	tanács	None
काफिर	kafir	Nan
कानूनों	a törvények	Nan
कागज	papír	None
कागज़	a papír	Nan
काजू	kesudió	Nan
काट	vágás	Nan
काटकर	vágással	Nan
काटती	harapás	Nan
काफ़ी	elég	None
काटा	vágott	None
काठियावाड़	kathiawar	Nan
काढ़ा	sörfőzés	Nan
काण्ड	botrány	None
कान	fül	Nan
कानपुर	kanpur	Nan
कानून	törvény	None
काठमांडु	kathmandu	Nan
किन	qin	Nan
कदापि	soha	None
कद	magasság	None
एजेंट	ügynök	None
एचटीएमएल	html	None
एचआईवी	hiv	Nan
एच	h	Nan
एग्रीगेटर	aggregátor	Nan
एग	tojás	Nan
एक्सप्लोरर	felfedező	Nan
एक्सप्रेस	expressz	Nan
एक्सटेंशन	kiterjesztés	Nan
एक्स	x	Nan
एक्शन	akció	None
एकीकृत	integrált	Nan
एकीकरण	integráció	Nan
एकान्त	magányos	None
एकाधिकार	monopólium	Nan
एकाधिक	többszörös	None
एकादशी	ekadashi	Nan
एअर	levegő	None
एक	egy	None
एकक	egy	None
एकजुट	egyesült	None
एकता	egység	None
एकत्र	összegyűjtött	Nan
एजेंसियों	ügynökségek	Nan
एकत्रित	összegyűjtött	Nan
एकदूसरे	a második	Nan
एकमत	egyhangú	Nan
एकमात्र	csak	None
एकरूपता	egyöntetűség	Nan
एकल	szóló	None
एकाग्रता	koncentráció	Nan
एकदम	egyszerre	None
एजेंसी	az ügynökség	Nan
एट	et	None
एटा	etah	Nan
एम०	m.	Nan
एयर	levegő	None
एयरपोर्ट	repülőtér	None
एरिया	terület	None
एल	l	None
एलन	allen	None
एम्	m	None
एलबम	az album	Nan
एलिमेंट	elem	None
एल्काइन	alkin	Nan
एल्गोरिथम	algoritmus	Nan
एल्डिहाइड	aldehid	None
एव	és	None
एवं	és	None
एलिजाबेथ	erzsébet	None
एंव	és	None
एम	m	None
एफ	f	Nan
एटीपी	atp	None
एट्रीब्यूट	tulajdonság	Nan
एट्रीब्यूट्	tulajdonság	Nan
एडम	ádám	None
एडवर्ड	edward	None
एडीज	aedes	Nan
एबं	és	None
एड्स	aids	None
एण्डीज	andies	Nan
एथेंस	athén	None
एनक्रिप्शन	titkosítás	Nan
एनोफ़िलीज़	maláriaterjesztő szúnyog	Nan
एपीजे	apj	Nan
एप्पल	alma	None
एण्ड	és	None
एंड	és	None
ए	egy	None
ऋषियों	a bölcsek	Nan
उलेमा	ulema	Nan
उल्टा	fordított	None
उल्टी	hányás	Nan
उल्लंघन	megsértése	None
उल्लास	vidámság	Nan
उल्लिखित	ahogy vázoltuk	Nan
उलट	az ellenkező	Nan
उल्लेख	említés	Nan
उषा	usha	Nan
उष्णकटिबंधीय	tropikus	Nan
उष्मागतिकी	termodinamika	Nan
उष्मारसायन	termokémia	Nan
उस	hogy	None
उसका	övé	Nan
उल्लेखनीय	jelentős	None
उसकी	neki	None
उलझन	zavar	None
उर्वरता	termékenység	Nan
उभर	feltörekvő	Nan
उभरते	feltörekvő	Nan
उभरा	alakult	None
उभरी	alakult	None
उभरे	alakult	None
उमर	kor	None
उर्वशी	urvashi	Nan
उम्मीद	elvárás	Nan
उम्र	korok	Nan
उर	ur	Nan
उरुग्वे	uruguay	Nan
उर्जा	energia	None
उर्मिला	urmila	Nan
उर्वरक	trágya	Nan
उम्मीदवार	jelölt	None
एवम	és	None
उसके	övé	Nan
उसने	ő	None
ऊन	gyapjú	Nan
ऊपरी	felső	None
ऊर्जा	energia	None
ऊष्मा	hőség	Nan
ऋग्	ruha	Nan
ऋग्वेद	rigveda	Nan
ऊतकों	a szöveteket	Nan
ऋग्वेदीय	rigvedic	Nan
ऋतु	évszak	None
ऋषभ	rishabh	Nan
ऋषभदेव	rishabhdev	Nan
ऋषि	a zsálya	Nan
ऋषिकेश	rishikesh	Nan
ऋषिमुनियों	zsálya madarak	Nan
ऋण	a kölcsön	Nan
उसको	neki	None
ऊतक	szövet	Nan
ऊंची	magas	None
उसपर	azon a	Nan
उसमे	benne	None
उसमें	abban	None
उससे	tőle	None
उसी	ugyanaz	None
उसे	neki	None
ऊंचे	magasabb	None
उस्ताद	fő	None
ऊँचाई	a magasság	Nan
ऊँची	magas	None
ऊँचे	magas	None
ऊँट	teve	Nan
ऊंचा	a magasság	Nan
ऊंचाई	a magasság	Nan
ऊँचा	magas	None
कदम	lépés	None
एवम्	és	None
एशियन	ázsiai	None
कच्ची	nyers	None
कच्चा	nyers	None
कचरे	a szemetet	Nan
कगार	a párkány	Nan
कक्षीय	orbital	Nan
कक्षाओं	az osztályok	Nan
कक्षा	osztály	None
कक्ष	a szoba	Nan
कई	sok	None
कंस	kansa	Nan
कंबोडिया	kambodzsa	Nan
कंबोज	kamboj	Nan
कंप्यूटर	számítógép	None
कंपनी	vállalat	None
कंपनियों	a társaságok	Nan
कंपनियां	cégek	None
कंधे	a váll	Nan
औरतों	nők	None
औरों	egyéb	None
औलिया	aulia	Nan
औषध	kábítószer	Nan
औषधि	a gyógyszer	Nan
औषधियाँ	a drogok	Nan
कच्चे	nyers	None
औषधियों	kábítószer	Nan
औसत	átlagos	None
औसतन	átlagos	None
क	k	Nan
कंट्रोल	ellenőrzés	None
कंठ	torok	Nan
कंडोम	óvszer	Nan
औषधीय	gyógyhatású	Nan
कट	vágott	None
कटरा	terület	None
कटा	szeletelt	Nan
कडी	link	Nan
कण	részecske	Nan
कणों	részecskék	None
कण्ठ	gége	Nan
कण्ठ्य	gége	Nan
कतिपय	bizonyos	None
कडियाँ	linkek	None
कथन	nyilatkozat	None
कथाएँ	a történetek	Nan
कथाओं	a történetek	Nan
कथानक	cselekmény	None
कथावस्तु	cselekmény	None
कथित	mondott	None
कथ्य	a narratívum	Nan
कथा	a történet	Nan
औरगंजेब	aurangzeb	Nan
कड़े	szigorú	None
कड़ियों	linkek	None
कटाई	aratás	Nan
कटौती	levonás	Nan
कट्टर	hardcore	Nan
कट्टरपंथी	fundamentalista	Nan
कठ	lépés	None
कठपुतली	báb	Nan
कड़ी	a kapcsolat	Nan
कठफोड़वा	harkály	Nan
कठिनाइयों	a nehézségek	Nan
कठिनाई	nehézség	Nan
कठोर	durva	None
कठोरता	keménység	None
कड़ा	kemény	None
कड़ियां	linkek	None
कठिन	kemény	None
औरंगजेब	aurangzeb	Nan
औरंगज़ेब	aurangzeb	Nan
और	és	None
ऑक्सीजन	oxigén	None
ऑक्सीय	oxy	Nan
ऑटिज़्म	autizmus	None
ऑटो	kocsi	None
ऑटोमोबाइल	autó	None
ऑटोरिक्शा	auto riksa	Nan
ऑक्सीकरण	oxidáció	Nan
ऑडियो	hang	None
ऑनलाइन	online	Nan
ऑपरेटिंग	üzemeltetési	Nan
ऑपरेशन	művelet	None
ऑफ	ki	None
ऑफ़	ki	None
ऑफिस	hivatal	None
ऑन	tovább	None
ऑबजेक्ट	tárgy	None
ऑक्साइड	oxid	Nan
ऐसी	ilyen	None
एशिया	ázsia	None
एशियाई	ázsiai	None
एस	s	None
एसएमएस	sms	Nan
एसबीआई	sb i	Nan
एससीओ	sco	Nan
ऐसे	ilyen	None
एसिड	sav	Nan
ए०	a.	Nan
ऐतरेय	atreya	Nan
ऐतिहासिक	történelmi	None
ऐश्वर्य	gazdagság	Nan
ऐश्वर्या	aishwarya	Nan
ऐसा	mint ez	Nan
एसोसिएशन	az egyesület	Nan
एवरेस्ट	everest	None
ऑयल	olaj	None
ऑल	összes	None
ओम	om	Nan
ओर	és	None
ओलंपिक	az olimpia	Nan
ओलम्पिक	olimpiai	None
ओवर	felett	None
ओशो	osho	Nan
ओबामा	obama	None
ओसामा	osama	Nan
औचित्य	indokolás	Nan
औजार	eszközök	None
औद्योगिक	ipari	None
औद्योगिकीकरण	iparosítás	Nan
औपचारिक	hivatalos	None
औपनिवेशिक	gyarmati	None
औ	és	None
ऑर्कुट	orkut	Nan
ओपेन	nyisd ki	Nan
ओन	saját	None
ऑव	ow	Nan
ऑस्कर	oscar	None
ऑस्ट्रिया	ausztria	None
ऑस्ट्रेलियन	ausztrál	None
ऑस्ट्रेलिया	ausztrália	None
ऑस्ट्रेलियाई	ausztrál	None
ओपन	nyisd ki	Nan
ओ	o	Nan
ओएस	os	None
ओक	tölgy	Nan
ओजस्वी	erős	None
ओज़ोन	ózon	Nan
ओड़िशा	orisza	Nan
ओड्र	odr	Nan
ओंकार	omkar	Nan
उपेक्षा	figyelmen kívül hagyni	Nan
किनारे	az él	Nan
किन्तु	de	None
गंगायमुना	gangayamuna	Nan
गंगाधर	gangadhar	Nan
गंगाजल	ganga víz	Nan
गंगा	gangesz	Nan
गंग	banda	None
ग	c	Nan
ख्वाजा	khwaja	Nan
ख्याति	hírnév	Nan
खोला	nyitott	None
खोलने	nyítás	Nan
खोल	a héj	Nan
खोपड़ी	koponya	Nan
खोने	vesztes	None
खोजों	felfedezések	None
खोजे	megtalálja	Nan
खोजा	keresés	Nan
खोजने	keresés	Nan
खूब	bőven	None
खूबसूरत	szép	None
खूबसूरती	szépség	None
खेत	farm	Nan
खेती	mezőgazdasági	None
खेतों	a mezők	Nan
गंगोत्री	gangotri	Nan
खेल	sport	None
खेलने	játszani	None
खेला	játszott	None
खेले	játék	None
खेलों	játékok	None
खो	elveszett	None
खोज	keresés	Nan
खेलकूद	sport	None
गंडक	gandak	Nan
गंतव्य	az úticél	Nan
गंध	a szag	Nan
गणना	számítás	Nan
गणपति	ganapati	Nan
गणराज्यों	a köztársaságok	Nan
गणित	matematika	None
गणितज्ञ	matematikus	None
गणितज्ञों	matematikusok	Nan
गणतन्त्र	köztársaság	None
गणितीय	matematikai	None
गणेशजी	ganesh ji	Nan
गणों	gano	Nan
गत	múlt	None
गति	sebesség	None
गतिज	kinetikus	Nan
गतिविधि	a tevékenység	Nan
गणेश	ganesha	Nan
खून	vér	None
गणतंत्र	a köztársaság	Nan
गढ़वाल	garhwal	Nan
गंधर्व	gandharva	Nan
गंभीर	komoly	None
गंभीरता	súlyosság	Nan
गई	ment	None
गईं	went	Nan
गए	ment	None
गण	számol	Nan
गज	yard	Nan
गज़ल	ghazal	Nan
गठन	épít	Nan
गठबन्धन	szövetség	None
गठित	elkészített	Nan
गड्ढे	a gödör	Nan
गढ़	a fellegvár	Nan
गजल	ghazal	Nan
खुसरो	khusro	Nan
खुशी	öröm	Nan
खुश	boldog	None
ख़राब	rossz	None
ख़लीफ़ा	kalifa	Nan
ख़ान	kán	None
ख़ास	különleges	None
ख़िलाफ़	ellen	None
ख़ुद	önmaga	None
ख़बर	hírek	None
ख़ुदा	isten	None
खाँसी	köhögés	Nan
खां	kán	None
खाड़ी	az öböl	Nan
खाता	számla	Nan
खाते	fiókok	Nan
खातों	fiókok	Nan
ख़ुशी	boldogság	Nan
खाद	komposzt	Nan
ख़त्म	befejezett	None
खलीफा	kalifa	Nan
खपत	elfogyasztott	Nan
खबर	hírek	None
खबरें	a hírek	Nan
खमीर	élesztő	Nan
खरगोश	nyúl	None
खराब	rossz	None
ख़तरा	veszély	None
खराबी	disszidál	Nan
खरीदते	megvesz	Nan
खरीददारी	bevásárlás	Nan
खरीदने	megvesz	Nan
खरीदारी	bevásárlás	Nan
खरीदी	vásárolt	None
खर्च	kiadás	None
खरीद	vásárlás	Nan
गतिविधियाँ	a tevékenységek	Nan
खादी	khadi	Nan
खान	kán	None
खीर	desszert	Nan
खुजली	viszkető	Nan
खुद	magamat	Nan
खुदरा	kiskereskedelem	Nan
खुदा	isten	None
खुफिया	intelligencia	Nan
खींचा	rajzolt	Nan
खुल	nyisd ki	Nan
खुलता	megnyitja	Nan
खुलने	nyítás	Nan
खुला	nyisd ki	Nan
खुलासा	közzététel	Nan
खुली	nyisd ki	Nan
खुले	nyisd ki	Nan
खुलकर	nyíltan	None
खाद्य	étel	None
खींच	húzni	Nan
खिलाफ	ellen	None
खानदान	család	None
खानपान	étel és ital	Nan
खाने	eszik	Nan
खानों	mines	Nan
खाया	evett	Nan
खालसा	khalsa	Nan
खिलाफ़	ellen	None
खाली	üres	None
खासकर	különösen	None
खासी	köhögés	Nan
खिलजी	khilji	Nan
खिलाड़ियों	a játékosok	Nan
खिलाड़ी	a játékos	Nan
खिलाडी	játékos	None
खास	különleges	None
खन्ना	étel	None
गतिविधियां	a tevékenységek	Nan
गतिशील	dinamikus	None
गिरी	esik	None
गिरिजाघर	templom	None
गिरावट	az esés	Nan
गिराया	csökkent	None
गिरा	csökkent	None
गिरफ्तार	letartóztatott	Nan
गिरने	eső	None
गिरती	eső	None
गिर	esik	None
गिने	számozott	Nan
गिनीज	guinness	Nan
गिनी	guinea	Nan
गिना	számítani	None
गिनती	számol	Nan
गाल	orca	Nan
गार्डन	a kert	Nan
गार्ड	az őr	Nan
गाथा	a saga	Nan
गान	himnusz	None
गाना	dal	None
गाने	dalok	None
गानों	dalok	None
गान्धी	gandhi	None
गिरीश	girish	Nan
गाय	marha	Nan
गायकों	az énekesek	Nan
गायत्री	gayatri	Nan
गायन	éneklés	Nan
गाया	sang	Nan
गायिका	az énekes	Nan
गारंटी	garancia	Nan
गायक	az énekes	Nan
गिर्द	körül	None
गिल्ड	céh	Nan
गीज़ा	giza	Nan
गुना	szeres	Nan
गुप्तचर	nyomozó	None
गुप्ता	gupta	Nan
गुफा	barlang	Nan
गुफाएं	barlangok	Nan
गुफाओं	barlangok	Nan
गुन	pisztoly	Nan
गुम्बद	a kupola	Nan
गुरु	fő	None
गुरुओं	guruk	Nan
गुरुकुल	gurukul	Nan
गुरुत्व	súly	Nan
गुरुत्वाकर्षण	súly	Nan
गुरुदेव	gurudev	Nan
गुयाना	guyana	Nan
गाते	énekel	None
गुदा	végbélnyílás	Nan
गुणा	szorzás	Nan
गीत	dal	None
गीता	geeta	Nan
गीताप्रेस	gitapress	Nan
गीतों	dalok	None
गीली	nedves	None
गुजरता	bérletek	Nan
गुणों	a tulajdonságok	Nan
गुजरती	pass	Nan
गुजरात	gujarat	Nan
गुजराती	gudzsaráti	Nan
गुट	klikk	Nan
गुड	jaggery	Nan
गुण	minőségi	None
गुणवत्ता	minőség	Nan
गुजरने	elhaladó	Nan
गाढ़ा	vastag	None
गाड़ी	autó	None
गाए	énekel	None
गर्ग	garg	Nan
गर्दन	a nyak	Nan
गर्भ	terhesség	None
गर्भकाल	terhesség	None
गर्भगृह	sanctum sanctorum	Nan
गर्भधारण	fogamzás	Nan
गरुड़	sas	None
गर्भपात	magzatelhajtás	Nan
गर्भाधान	fogamzás	Nan
गर्भायोजित	beültetett	Nan
गर्भावस्था	terhesség	None
गर्भाशय	méh	Nan
गर्म	forró	None
गर्मियों	nyár	None
गर्भवती	terhes	None
गर्मी	hőség	Nan
गरीबों	a szegények	Nan
गरिमा	méltóság	Nan
गतिशीलता	mobilitás	Nan
गद्दी	párnázás	Nan
गद्य	próza	Nan
गद्यकार	próza	Nan
गन्धक	kén	Nan
गन्ना	cukornád	Nan
गरीब	szegény	None
गमेलन	játszma, meccs	Nan
गया|	elmúlt	None
गयी	elmúlt	None
गयीं	went	Nan
गयूम	gayoom	Nan
गये	elmúlt	None
गरम	forró	None
गया	elmúlt	None
गतिविधियों	tevékenységek	None
गलत	rossz	None
गला	torok	Nan
ग़ुलाम	rabszolga	Nan
गा	ga	None
गाँठ	a csomó	Nan
गाँधी	gandhi	None
गाँधीजी	gandhi	None
गाँवों	a falvak	Nan
ग़ालिब	ghalib	Nan
गांगुली	ganguly	Nan
गांठों	lumps	Nan
गांधी	gandhi	None
गांधीजी	gandhi	None
गांव	a falu	Nan
गांवों	a falvak	Nan
गाइड	az útmutató	Nan
गांठ	a csomó	Nan
गलती	hiba	None
ग़लत	helytelen	None
ग़ज़ा	gáza	Nan
गलियों	az utcák	Nan
गली	sáv	None
गले	a torok	Nan
गल्फ	öböl	None
गवाह	a tanú	Nan
गवाही	bizonyság	Nan
ग़म	bánat	Nan
गहन	intenzív	None
गहरा	mély	None
गहराई	a mélység	Nan
गहरी	mély	None
गहरे	mély	None
ग़ज़ल	ghazal	Nan
ग़ज़लों	ghazals	Nan
गहने	ékszerek	Nan
किनारों	a szélek	Nan
खनिज	ásványok	Nan
खत्म	felett	None
केन्द्रक	atommag	Nan
केन्द्र	központ	None
केन	ken	None
केदारनाथ	kedarnath	Nan
केदार	kedar	Nan
केतु	ketu	Nan
केजीबी	kgb	Nan
केंद्रों	a központok	Nan
केंद्रीय	központi	None
केंद्रीकृत	központosított	None
केंद्र	központ	None
के	nak,-nek	Nan
कृष्‍ण	krisna	Nan
कृष्णा	krisna	Nan
कृष्णयजुर्वेदीय	krishnayujurveda	Nan
कृष्णभक्ति	krishnabhakti	Nan
कृष्णपक्ष	krishnapaksha	Nan
कूद	ugrás	Nan
कूल्हों	hips	Nan
कृत	igény	None
कृति	munka	None
कृतियाँ	művek	None
कृतियों	alkotás	None
केन्द्रशासित	középre	Nan
कृत्य	törvény	None
कृत्रिम	mesterséges	None
कृपया	kérem	Nan
कृपा	kérem	Nan
कृषक	kultivátor	Nan
कृषि	mezőgazdaság	None
कृष्ण	krisna	Nan
कृत्यों	apcsel	Nan
केन्द्रीय	központi	None
केन्द्रों	a központok	Nan
केरल	kerala	Nan
कैलिफोर्निया	kalifornia	None
कैलेंडर	a naptár	Nan
कैलोरी	kalória	None
कैल्शियम	kalcium	Nan
कैसा	hogyan	None
कैसे	hogyan	None
कैलाश	kailash	Nan
कैस्पियन	caspian	Nan
कॉफी	kávé	None
कॉम	com	Nan
कॉम्प्लेक्स	összetett	None
कॉरोना	korona	None
कॉर्पोरेट	társasági	None
कॉर्पोरेशन	vállalat	None
कॉपीराइट	szerzői jog	Nan
कूड़ा	szemét	Nan
कैरोल	ének	None
कैरेक्टर	karakter	None
केल्टिक	kelta	None
केवल	főiskolán	Nan
केशव	keshav	Nan
केसर	sáfrány	Nan
कैंडी	cukorka	Nan
कैंब्रिज	cambridge	Nan
कैरेट	hiányjel	Nan
कैंसर	rák	None
कैण्डेला	candela	Nan
कैद	bebörtönzés	Nan
कैपिटल	főváros	None
कैमरा	a kamera	Nan
कैम्ब्रिज	cambridge	Nan
कैरियर	hordozó	Nan
कैकेयी	kaikeyi	Nan
कूट	kód	None
कूच	utazott	None
कुषाण	kushán	Nan
किसे	who	None
किस्म	fajta	Nan
किस्मत	sors	None
किस्में	fajták	None
किस्मों	fajták	None
की	nak,-nek	Nan
किसी	bármi	Nan
कीं	hogy	None
कीटनाशक	növényvédőszer	Nan
कीटनाशकों	rovarirtók	Nan
कीटाणु	csíra	Nan
कीटों	rovarok	Nan
कीटोन	keton	Nan
कीड़े	worms	Nan
कीट	rovar	Nan
कीपर	az őrző	Nan
किसानों	a mezőgazdasági termelők	Nan
किस	csók	Nan
किमी	km	None
किया	tett	Nan
किया|	kész	None
किये	esetleg	None
किरण	gerenda	Nan
किरणों	rays	Nan
किसान	gazda	None
किरदार	a karakter	Nan
किले	az erőd	Nan
किलो	kg	None
किलोग्राम	kilogramm	Nan
किलोमीटर	kilométer	None
किशोर	teen	Nan
किष्किन्धाकाण्ड	kishkindhakaand	Nan
किला	erőd	Nan
कॉलेज	főiskola	None
कीपिंग	tartás	Nan
कीमत	költség	Nan
कुमारगुप्त	kumargupta	Nan
कुमारपाल	kumarpal	Nan
कुमारी	szűz	None
कुरान	korán	None
कुरीतियों	evils	Nan
कुरु	kuru	Nan
कुमार	kumar	Nan
कुरुक्षेत्र	kurukshetra	Nan
कुर्सी	szék	Nan
कुल	a végösszeg	Nan
कुलीन	nemes	None
कुश	kush	Nan
कुशल	szakképzett	Nan
कुशलता	hatékonyság	Nan
कुर्ता	ing	Nan
कीबोर्ड	a billentyűzet	Nan
कुमाऊँ	kumaon	Nan
कुन्डली	horoszkóp	Nan
कीमती	értékes	None
कीमतों	az árak	Nan
कीर्तिमान	rekord	None
कुंड	barázdál	Nan
कुंभ	vízöntő	Nan
कुटिया	kunyhó	Nan
कुबेर	kubera	Nan
कुटीर	a kunyhó	Nan
कुण्डल	a tekercs	Nan
कुतुब	qutub	Nan
कुतुबुद्दीन	qutubuddin	Nan
कुत्ता	kutya	None
कुत्ते	kutyák	None
कुनैन	kinin	Nan
कुण्ड	pool	Nan
खनन	bányászati	Nan
कॉलेजों	főiskolák	Nan
कों	melyik	None
क्षय	hanyatlás	Nan
क्षमा	sajnálom	Nan
क्षमताओं	a képességek	Nan
क्षमता	a képesség	Nan
क्षत्रिय	kshatriya	Nan
क्षतिपूर्ति	kártérítés	Nan
क्षतिग्रस्त	sérült	None
क्षति	kár	Nan
क्षणिक	pillanatnyi	Nan
क्षण	a pillanat	Nan
क्वाथ	főzet	Nan
क्वांटम	kvantum	Nan
क्लोरोफिल	klorofill	Nan
क्लोराइड	klorid	Nan
क्लोनिंग	klónozása	Nan
क्लिक	kettyenés	Nan
क्लिंटन	clinton	Nan
क्रीज	ránc	Nan
क्रीड़ा	sport	None
क्रुद्ध	mérges	Nan
क्रूज	hajókázás	Nan
क्रूर	könyörtelen	Nan
क्रेडिट	hitel	None
क्षरण	rozsdásodás	Nan
क्रोध	harag	Nan
क्रोमोसोम	kromoszóma	Nan
क्रोमोसोमों	a kromoszómák	Nan
क्रोस	a kereszt	Nan
क्लब	a klub	Nan
क्लाइस्ट्रॉन	klisztron	Nan
क्लासिकल	klasszikus	None
क्रोधित	mérges	Nan
क्षिप्रा	kshipra	Nan
क्षीण	gyenge	None
क्षुद्र	piti	Nan
खजुराहो	khajuraho	Nan
खजूर	időpontok	Nan
खड़ा	állvány	Nan
खड़ी	álló	None
खड़ीबोली	a hindi nyelv ősi formája	Nan
खड़े	álló	None
खजाने	kincsek	Nan
खडा	állvány	Nan
खण्ड	blokk	None
खतना	körülmetélés	Nan
खतरनाक	veszélyes	None
खतरा	kockáztatni	Nan
खतरे	veszély	None
खतरों	a veszélyek	Nan
खडी	álló	None
क्रिस्टल	kristály	Nan
खजाना	kincs	Nan
खगोल	astro	Nan
क्षुब्ध	mérges	Nan
क्षेत्र	terület	None
क्षेत्रफल	terület	None
क्षेत्रमापी	terepi mérőműszer	Nan
क्षेत्ररक्षण	fielding	Nan
क्षेत्राधिकार	igazságszolgáltatás	None
खगोलीय	égi	None
क्षेत्रीय	regionális	None
क्षैतिज	vízszintes	None
ख	b	Nan
खंड	szakasz	None
खंडन	tagadás	Nan
खंडित	darabokra tört	Nan
खंडों	a szegmensek	Nan
क्षेत्रों	régiók	None
क्रिसमस	karácsony	None
क्रियान्वयन	végrehajtás	None
क्रियात्मक	funkcionális	Nan
कोरिया	korea	Nan
कोरियाई	koreai	None
कोर्ट	a bíróság	Nan
कोर्स	tanfolyam	Nan
कोलंबिया	colombia	Nan
कोलकाता	kolkata	Nan
कोर	sarok	Nan
कोलोंबिया	kolobia	Nan
कोशिका	a sejt	Nan
कोशिकाएं	a sejtek	Nan
कोशिकाओं	a sejteket	Nan
कोशिकीय	sejtes	Nan
कोशिश	próbáld ki	Nan
कोशों	szinonimaszótár	Nan
कोशल	kosala	Nan
कोष	kincstár	None
कोयले	szén	None
कोमलता	lágyság	Nan
कोंकण	konkan	Nan
कोइ	bármi	Nan
कोई	valaki	None
कोख	méh	Nan
कोच	az edző	Nan
कोट	kabát	Nan
कोयला	szén	None
कोड	kód	None
कोणार्क	konark	Nan
कोणीय	szögletes	Nan
कोणों	angles	Nan
कोने	a sarok	Nan
कोबे	kobe	Nan
कोमल	kedves	None
कोण	a szög	Nan
को	nak nek	Nan
कोसल	kosal	Nan
कोहरा	köd	Nan
क्रमशः	illetőleg	None
क्रमांक	sorozatszám	Nan
क्रय	vásárlás	Nan
क्रांतिकारी	forradalmi	None
क्रान्त	forradalom	None
क्रान्ति	forradalom	None
क्रमश	illetőleg	None
क्रान्तिकारी	forradalmi	None
क्रिकेटर	cricketer	Nan
क्रिप्ट	kripta	Nan
क्रिप्टो	crypto	Nan
क्रिप्टोग्राफ़ी	rejtjelezés	Nan
क्रियाओं	igék	None
क्रियाकलाप	tevékenység	None
क्रिकेट	krikett	Nan
कोसी	kosi	Nan
क्रमबद्ध	fajta	Nan
क्योटो	kyoto	Nan
कोहिनूर	kohinoor	Nan
कौटिल्य	kautilya	Nan
कौन	who	None
कौरव	kaurava	Nan
कौशल	jártasság	Nan
कौशाम्बी	kaushambi	Nan
क्रम	rendelés	Nan
कौशिक	kaushik	Nan
क्यूंकि	mivel	None
क्यूबा	kuba	None
क्यूलेक्स	culex	Nan
क्यों	miért a	Nan
क्योंकि	mivel	None
क्योकि	mivel	None
क्या	mit	None
गुरुद्वारा	gurudwara	Nan
उपिनषद्	upini tanács	Nan
उपासक	imádó	Nan
अर्जी	alkalmazás	None
अर्जित	az elnyert	Nan
अर्ज़ी	alkalmazás	None
अर्चना	archana	Nan
अर्क	kivonat	Nan
अरे	hé	Nan
अरुणाचल	arunachal	Nan
अरुण	egy futás	Nan
अरावली	aravali	Nan
अराजकता	anarchia	Nan
अरस्तू	arisztotelész	None
अरस्तु	arisztotelész	None
अरविन्द	arvind	Nan
अरबों	milliárd	Nan
अरबी	arab	None
अरब	arab	None
अरण्यकाण्ड	őserdő	Nan
अमृतसर	amritsar	Nan
अमेरिकन	amerikai	None
अमेरिका	amerika	None
अमोनिया	ammónia	Nan
अमौसी	amausi	Nan
अम्बा	amba	Nan
अर्जुन	arjun	Nan
अम्बालिका	ambalaika	Nan
अम्बेडकर	ámbédkar	Nan
अम्ल	sav	Nan
अम्लीय	savas	Nan
अम्हारिक	amhara	Nan
अयोध्या	ayodhyába	Nan
अयोध्याकाण्ड	ayodhyába	Nan
अम्बिका	ambika	Nan
अर्जेंटीना	argentína	None
अर्थ	jelentését	None
अर्थविज्ञान	közgazdaságtan	Nan
अलगअलग	különböző	None
अलगाव	elkülönítés	Nan
अलाउद्दीन	alauddin	Nan
अलावा	attól eltekintve	Nan
अलिखित	íratlan	Nan
अली	ali	None
अलग	egymástól	None
अलौकिक	természetfölötti	Nan
अल्पना	alpana	Nan
अल्पायु	fiatal	None
अल्फा	alpha	None
अल्फ्रेड	alfred	None
अल्मोड़ा	almora	Nan
अल्लाह	isten	None
अल्प	kevés	None
अमूल्य	megfizethetetlen	Nan
अलकनन्दा	alaknanda	Nan
अलंकार	díszítés	Nan
अर्थव्यवस्था	gazdaság	None
अर्थव्यवस्थाओं	gazdaságok	Nan
अर्थशास्त्र	közgazdaságtan	Nan
अर्थशास्त्रियों	közgazdászok	Nan
अर्थशास्त्री	a közgazdász	Nan
अर्थात	jelentését	None
अलंकृत	díszes	None
अर्थात्	azaz	None
अर्थों	jelentés	None
अर्द्ध	félig	None
अर्न्तगत	alatt	None
अर्पित	dedikált	Nan
अल	al	None
अलंकरण	díszítés	Nan
अर्थात्‌	azaz	None
अमूर्त	absztrakt	Nan
अमीरात	emirátus	Nan
अमीर	gazdag	None
अब	most	None
अबतक	mostanáig	Nan
अबु	abu	None
अबुल	abul	Nan
अब्द	abd	Nan
अब्दुल	abdul	Nan
अफ्रीकी	afrikai	None
अब्दुल्ला	abdulla	Nan
अब्राहम	abraham	None
अभाव	hiány	Nan
अभिकलन	számítási	Nan
अभिकलित्र	számítógép	None
अभिकल्पना	a dizájn	Nan
अभिक्रिया	reakció	None
अब्बास	abbas	Nan
अभिनय	ható	None
अफ्रीका	afrika	None
अफ़्रीकी	afrikai	None
अपील	a fellebbezés	Nan
अपूर्णता	tökéletlenség	Nan
अपूर्व	ritka	None
अपेक्षा	elvár	Nan
अपेक्षाकृत	viszonylag	None
अपेक्षित	várt	None
अफ्फनपिन्स्चर	afffuncture	Nan
अप्रत्यक्ष	közvetett	None
अप्सरा	manó	Nan
अफगान	afgán	None
अफगानिस्तान	afganisztán	None
अफसर	tiszt	None
अफ़ग़ानिस्तान	afganisztán	None
अफ़्रीका	afrika	None
अप्रैलजून	apriljoon	Nan
अवकाश	az ünnep	Nan
अभिनेता	a színész	Nan
अभिनेत्रियों	színésznők	Nan
अभिहित	kijelölt	None
अभ्यारण्य	a szentély	Nan
अभ्यास	gyakorlat	None
अमर	halhatatlan	Nan
अमरनाथ	amarnath	Nan
अमरावती	amrávati	Nan
अभिषेक	abhishek	Nan
अमरीकन	amerikai	None
अमरीकी	amerikai	None
अमल	végrehajtás	None
अमावस्या	amavasya	Nan
अमिट	kitörölhetetlen	Nan
अमिताभ	amitabh	Nan
अमीटर	árammérő	Nan
अमरीका	amerika	None
अभिनेताओं	a szineszek	Nan
अभिव्यक्ति	a kifejezés	Nan
अभिलेखों	a nyilvántartások	Nan
अभिनेत्री	színésznő	None
अभिन्न	integrál	Nan
अभिप्राय	a szándék	Nan
अभिभाषण	cím	None
अभिमन्यु	abhimanyu	Nan
अभिमान	büszkeség	Nan
अभिव्यक्त	kifejezve	Nan
अभियन्ता	mérnök	None
अभियान	a kampány	Nan
अभियानों	a kampányok	Nan
अभियान्त्रिकी	mérnöki	Nan
अभिरुचि	érdeklődés	None
अभिलाषा	vágy	Nan
अभिलेख	rekord	None
अभियांत्रिकी	mérnöki	Nan
अपितु	de	None
अवतरण	leszállás	None
अवतार	avatar	Nan
आइ	én	None
आंशिक	részleges	None
आंबेडकर	ámbédkar	Nan
आंध्रप्रदेश	andra pradesh	Nan
आंध्र	andhra	Nan
आंधी	vihar	None
आंदोलनों	a mozgások	Nan
आंतरिक	belső	None
आंत	bél	Nan
आंखों	szemek	Nan
आंख	a szem	Nan
आंकडों	ábrák	Nan
आंकडे	ábrák	Nan
आंकडा	adat	None
आंकड़ों	az adat	Nan
आंकड़े	a figurák	Nan
आँसू	tears	Nan
अस्वीकृत	elutasítva	Nan
अस्वीकृति	rosszallás	Nan
अस्सी	nyolcvan	Nan
अहंकार	ego	Nan
अहम	létfontosságú	Nan
अहमद	ahmed	Nan
आइंस्टीन	einstein	None
अहमदाबाद	ahmedabad	Nan
अहिंसा	ahimsa	Nan
आ	jön	None
आँकड़ों	a statisztikák	Nan
आँख	szem	None
आँखें	szemek	Nan
आँखों	szemek	Nan
अहसास	megvalósítás	Nan
आइसलैंड	izland	None
आइसोटोप	izotóp	Nan
आई	jöttem	Nan
आकार	alak	None
आकाश	ég	None
आकाशगंगा	galaktika	Nan
आकाशीय	égi	None
आकिल	aikal	Nan
आकिलखान	értékeljük	Nan
आकांक्षाओं	törekvések	None
आकृतियों	alakzatok	Nan
आक्रमणकारियों	invaders	Nan
आक्रमणों	inváziók	Nan
आक्रामक	agresszív	Nan
आक्सफोर्ड	oxford	None
आक्साइड	oxid	Nan
आक्सीकरण	oxidáció	Nan
आक्रमण	támadás	None
अस्वीकार	elutasít	Nan
आकांक्षा	törekvés	None
आकर्षित	vonzott	Nan
आईं	jött	None
आईएमई	ime	Nan
आईटी	azt	None
आईपॉड	ipod	None
आईबीएम	ibm	None
आईसीसी	icc	Nan
आकस्मिक	véletlen	None
आउट	ki	None
आए	visszatér	None
आएगा	jönni fog	Nan
आओ	jön	None
आकर	jövő után	Nan
आकर्षक	vonzó	Nan
आकर्षण	báj	Nan
आउटपुट	kimenet	Nan
अस्पृश्यता	érinthetetlenség	Nan
अस्पृश्य	érinthetetlen	Nan
अस्पष्ट	homályos	Nan
अवसर	véletlen	None
अवस्था	állapot	None
अवस्थाओं	államok	None
अवार्ड	a díj	Nan
अविश्वास	bizalmatlanság	Nan
अवैध	illegális	None
अवश्य	biztosan	None
अशांति	zavarás	Nan
अशोक	ashok	Nan
अश्वत्थामा	ashwatthama	Nan
अश्वमेध	ashwamedh	Nan
अश्विनी	ashwini	Nan
अष्टमी	nyolcadik	None
असंख्य	számos	None
अशुभ	kedvezőtlen	None
असंतुलन	egyensúlyhiány	Nan
अवशोषित	elnyelt	Nan
अवशोषक	elnyelő anyag	Nan
अवतारों	karakterekkel	Nan
अवतीर्ण	testesült	Nan
अवधारणा	akkreditáció	Nan
अवधारणाओं	a fogalmak	Nan
अवधि	időszak	None
अवधी	awadhi	Nan
अवशोषण	abszorpció	Nan
अवमानना	megvetés	Nan
अवयवों	a hozzávalók	Nan
अवरोध	akadály	Nan
अवलोकन	áttekintés	Nan
अवशिष्ट	maradó	Nan
अवशेष	a maradványok	Nan
अवशेषों	a maradék	Nan
अवयव	az alkatrészek	Nan
अवतरित	leereszkedett	Nan
असंतोष	elégedetlenség	Nan
असफल	nem sikerült	Nan
असेम्बली	az összeszerelés	Nan
असोसिएशन	egyesület	None
अस्त	a készlet	Nan
अस्तित्व	létezés	None
अस्तु	a valóságban	Nan
अस्त्र	fegyver	None
असुरों	a asuras	Nan
अस्त्रों	fegyverek	None
अस्थायी	ideiglenes	None
अस्थि	csont	Nan
अस्थिर	instabil	Nan
अस्थिरता	instabilitás	Nan
अस्पताल	kórház	None
अस्पतालों	kórházak	Nan
अस्थाई	ideiglenes	None
असंभव	lehetetlen	None
असुरक्षित	nem biztonságos	Nan
असीमित	korlátlan	None
असफलता	kudarc	None
असम	assam	Nan
असमर्थ	képtelen	None
असमानता	egyenlőtlenség	Nan
असमिका	asszámi	Nan
असमिया	asszámi	Nan
असुर	az asura	Nan
असर	hatás	None
असली	igazi	None
असहयोग	együtt nem működés	Nan
असहाय	tehetetlen	Nan
असाधारण	rendkívüli	None
असामान्य	szokatlan	None
असीम	végtelen	None
असल	eredeti	None
आक्सीजन	oxigén	None
अपार	kimeríthetetlen	Nan
अपशिष्ट	a hulladék	Nan
अड्डा	barlang	Nan
अठारहवीं	tizennyolcadik	Nan
अठारह	tizennyolc	Nan
अटूट	törhetetlen	Nan
अटलांटिक	az atlanti	Nan
अज्ञेय	megismerhetetlen	Nan
अज्ञान	tudatlanság	Nan
अज्ञात	ismeretlen	None
अजीब	furcsa	None
अजातशत्रु	adzsátasatru	Nan
अज़ीज़	azeez	Nan
अजय	ajay	Nan
अजमेर	ajmer	Nan
अजनाभवर्ष	aajna bhavar	Nan
अजंता	ajanta	Nan
अच्छे	a jó	Nan
अच्छी	jó	None
अखिल	akhil	Nan
अख्तर	akhtar	Nan
अगर	ha	None
अगली	következő	None
अगले	a következő	Nan
अगस्त	augusztus	None
अड्डे	a bázis	Nan
अग्नि	agni	Nan
अग्रणी	vezető	None
अग्रसर	előre	None
अग्रिम	előlegként	Nan
अचल	mozdíthatatlan	Nan
अचानक	hirtelen	None
अच्छा	jó	None
अग्निमित्र	agnimitra	Nan
अणु	molekulák	None
अणुओं	molekulák	None
अण्डमान	andaman	Nan
अत्रि	atri	Nan
अथ	ath	Nan
अथर्व	atharva	Nan
अथर्ववेद	atharvavéda	Nan
अथवा	vagy	None
अदभुत	elképesztő	Nan
अत्याधिक	több	None
अदा	ada	Nan
अदृश्य	láthatatlan	None
अदृष्ट	észrevétlen	Nan
अद्भुत	csodálatos	None
अद्यतन	frissítés	Nan
अद्वितीय	egyedi	None
अद्वैत	advaita	Nan
अदालत	bíróság	None
अखबारों	az újságok	Nan
अत्याचारी	üldöző	Nan
अत्यन्त	nagyon	None
अण्डे	tojás	Nan
अण्डों	tojás	Nan
अत	ezért	None
अतः	ezért	None
अतएव	ezért	None
अति	szélső	None
अत्याचार	kínvallatás	Nan
अतिक्रमण	beavatkozás	None
अतिरिक्त	attól eltekintve	Nan
अतिवादी	szélsőséges	None
अतीत	múlt	None
अतेन	aten	Nan
अत्यंत	rendkívüli módon	Nan
अत्यधिक	többlet	Nan
अतिथि	vendég	Nan
अखबार	újság	None
अखंडता	sértetlenség	Nan
अखंड	töretlen	Nan
अंग्रेज़ी	angol	None
अंग्रेजी	angol	None
अंग्रेजो	britishers	Nan
अंग्रेजों	a brit	Nan
अंचल	zóna	None
अंजाम	az eredmény	Nan
अंग्रेज	angol	None
अंजीर	ábra	Nan
अंडाशय	petefészek	Nan
अंडे	tojás	Nan
अंत	a vége	Nan
अंतत	végül	None
अंततः	végül	None
अंतर	különbség	None
अंडमान	andaman	Nan
अंतरजाल	internet	None
अंगों	végtagok	Nan
अंगूर	szőlő	None
<	&lt;	Nan
=	=	None
==	==	Nan
^	^	Nan
|	|	Nan
~	~	Nan
अंगो	végtagok	Nan
°	°	None
अंकगणित	számtan	Nan
अंकारा	ankara	Nan
अंकित	ankit	Nan
अंकीय	digitális	None
अंकों	számjegy	Nan
अंग	rész	None
अ	egy	None
अधरों	fél	None
अंतरण	átutalás	Nan
अंतराल	intervallum	Nan
अकार	ok	None
अकाल	éhínség	Nan
अकेला	egyedül	None
अकेले	egyedül	None
अक्टूबर	október	None
अक्तूबर	október	None
अकादमी	az akadémia	Nan
अक्तूबरदिसंबर	december október	Nan
अक्षय	megújuló	Nan
अक्षर	a levél	Nan
अक्षरधाम	akshardham	Nan
अक्षांश	szélességi kör	Nan
अक्षुण्ण	ép	Nan
अक्सर	gyakran	None
अक्षम	tiltva	Nan
अंतरराष्ट्रीय	nemzetközi	None
अकबर	akbar	Nan
अंश	rész	None
अंतराष्ट्रीय	nemzetközi	None
अंतरिक्ष	tér	None
अंतरिम	ideiglenes	None
अंतर्गत	alatt	None
अंतर्दृष्टि	bepillantás	Nan
अंतर्राष्ट्रीय	nemzetközi	None
अंशों	fok	Nan
अंतिम	az utolsó	Nan
अंदाज	stílus	None
अंध	vak	None
अंधकार	sötétség	None
अंधेरी	sötét	None
अंपायर	játékvezető	None
अंबानी	ambani	Nan
अंदर	belül	None
अपहरण	elraboltak	Nan
अधर्म	bűntett	Nan
अधिक	több	None
अन्तरिक्ष	tér	None
अन्तरराष्ट्रीय	nemzetközi	None
अन्तरजाल	internet	None
अन्तर	különbség	None
अन्ततः	a végén	Nan
अन्त	vége	None
अनोखी	egyedi	None
अनोखा	egyedi	None
अनैतिक	erkölcstelen	Nan
अनेकों	sok	None
अनेक	számos	None
अनूबिस	anubis	Nan
अनूदित	lefordított	Nan
अनुसूची	menetrend	Nan
अनुसूचित	ütemezett	Nan
अनुसार	eszerint	None
अनुसरण	folytatás	Nan
अनुमानों	az előrejelzések	Nan
अनुयायियों	követő	None
अनुयायी	követő	None
अनुराग	szeretet	None
अनुरूप	szerint	None
अनुरोध	kérés	Nan
अन्तर्गत	alatt	None
अनुवाद	fordítás	None
अनुशासन	dicipline	Nan
अनुशीलन	gyakorlat	None
अनुष्ठान	a rituálé	Nan
अनुष्ठानों	rituálék	Nan
अनुसंधान	a kutatás	Nan
अनुसन्धान	kutatás	None
अनुवादक	fordító	None
अन्तर्राष्ट्रीय	nemzetközi	None
अन्तस्थ	megtestesült	Nan
अन्तिम	az utolsó	Nan
अपनी	enyém	Nan
अपनीअपनी	a te	Nan
अपने	a miénk	Nan
अपनेअपने	a te	Nan
अपभ्रंश	függelék	Nan
अपमान	sértés	Nan
अपनाया	fogadott	None
अपमानित	megsértett	Nan
अपराधियों	a bűnözők	Nan
अपराधी	bűnügyi	None
अपराधों	crimes	Nan
अपलोड	feltöltés	Nan
अपवाद	kivétel	None
अपवाह	lefolyás	Nan
अपराध	bűn	None
अनुमानित	becsült	Nan
अपनाने	elfogad	Nan
अपना	a miénk	Nan
अन्दर	ban ben	Nan
अन्दाज	találd ki	Nan
अन्ध	vak	None
अन्धकार	sötétség	None
अन्धेरा	sötét	None
अन्न	gabona	Nan
अपनाई	üldözött	Nan
अन्ना	anna	None
अन्यत्र	máshol	None
अन्यथा	másképp	Nan
अन्याय	igazságtalanság	Nan
अन्वेषण	felfedezés	Nan
अन्‍य	egyéb	None
अप	fel	None
अन्य	egyéb	None
अनुमान	egy becslés	Nan
अनुमस्तिष्क	kisagy	Nan
अनुमति	engedély	None
अधीन	tárgy	None
अधीनता	alárendeltség	Nan
अधूरा	befejezetlen	None
अध्यक्ष	rendező	None
अध्यक्षता	elnökölt	Nan
अध्ययन	tanulmány	None
अधिवेशन	az ülés	Nan
अध्ययनों	tanulmányok	None
अध्यादेश	rendelet	None
अध्याय	fejezet	None
अध्यायों	fejezetek	Nan
अनंत	végtelen	None
अनघ	anagh	Nan
अनदेखी	észrevétlen	Nan
अध्यात्म	lelkiség	Nan
अनन्त	örökkévaló	Nan
अधिपति	hűbérúr	Nan
अधिग्रहण	beszerzés	Nan
अधिकतम	maximális	None
अधिकतर	a legtöbb	Nan
अधिकता	többlet	Nan
अधिकरण	bíróság	None
अधिकाँश	a legtöbb	Nan
अधिकांश	nagy része	Nan
अधिनियम	törvény	None
अधिकांशत	többnyire	None
अधिकाधिक	több és több	Nan
अधिकार	jogok	None
अधिकारिक	hivatalos	None
अधिकारियों	a tisztek	Nan
अधिकारी	tiszt	None
अधिकृत	felhatalmazott	Nan
अधिकांशतः	többnyire	None
अधातु	nemfémes	Nan
अनन्य	egyedi	None
अनमोल	megfizethetetlen	Nan
अनुचित	alkalmatlan	Nan
अनुच्छेद	cikk	None
अनुदान	grant	None
अनुनाद	resonance	Nan
अनुपम	anupam	Nan
अनुपस्थिति	hiány	Nan
अनुग्रह	kegyelem	Nan
अनुपात	hányados	Nan
अनुप्रयोगों	alkalmazások	None
अनुबंध	a szerződés	Nan
अनुभव	tapasztalat	None
अनुभवी	tapasztalt	None
अनुभाग	a szekció	Nan
अनुभूति	érzés	None
अनुपालन	teljesítés	Nan
अनपढ़	írástudatlan	Nan
अनुक्रम	a szekvencia	Nan
अनुकूल	kedvező	None
अनवर	anwar	Nan
अनवरत	könyörtelenül	Nan
अनशन	gyors	None
अनाज	gabona	Nan
अनाथ	árva	Nan
अनार	gránátalma	Nan
अनुकूलन	testreszabás	Nan
अनावश्यक	szükségtelen	Nan
अनियमित	szabálytalan	Nan
अनिल	anil	Nan
अनिवार्य	kötelező	None
अनिश्चित	bizonytalan	None
अनु	anu	Nan
अनुकरण	tettetés	Nan
अनियंत्रित	ellenőrizetlen	Nan
उपासना	imádat	Nan
आखरी	az utolsó	Nan
आखिरी	az utolsó	Nan
उठते	emelkedő	None
उठती	emelkedő	None
उठता	merülnek fel	Nan
उठ	kelj fel	Nan
उज्जैन	ujjain	Nan
उज्जयिनी	ujjayini	Nan
उजागर	tegye	None
उच्‍च	magas	None
उच्चतर	magasabb	None
उच्चतम	legmagasabb	None
उचित	alkalmas	None
उग्र	tüzes	Nan
उगाया	felnőni	Nan
उगाई	felnőni	Nan
उखाड़	kiirt	Nan
उक्त	mondott	None
उंगलियों	fingers	Nan
ईरान	irán	None
ईरानी	iráni	None
ईश	ish	Nan
ईश्वर	isten	None
ईश्वरीय	istenes	Nan
ईसवी	hirdetés	Nan
उठने	emelkedni	Nan
ईसाइयत	kereszténység	None
ईसाई	keresztény	None
ईसाईयों	keresztények	None
ईसापूर्व	időszámításunk előtt	Nan
ईस्ट	keleti	None
ईस्टर	húsvéti	None
ईस्वी	hirdetés	Nan
ईसाइयों	keresztények	None
उठा	szedés	Nan
उठाकर	felvenni	None
उठाते	feltörés	Nan
उतारने	kirakodás	Nan
उतारा	csökkentette	None
उत्कर्ष	virágzó	None
उत्कीर्ण	bevésett	Nan
उत्कृष्ट	kiváló	None
उत्खनन	kiásás	Nan
उतार	ups	Nan
उत्तम	legjobb	None
उत्तरकाण्ड	uttarkhand	Nan
उत्तरकाशी	uttarkashi	Nan
उत्तरदायित्व	felelősség	Nan
उत्तरदायी	felelős	None
उत्तरपश्चिम	északnyugat	Nan
उत्तरपूर्व	északkeleti	None
उत्तर	válasz	None
ईरप्शन	kitörés	None
उतरने	leszállás	None
उतर	leszáll	Nan
उठाना	felvenni	None
उठाने	emelés	Nan
उठाया	emelt	None
उठाये	felvenni	None
उठी	felállt	Nan
उठे	felállt	Nan
उतरते	csökkenő	None
उड़	légy	Nan
उड़िया	oriya	Nan
उड़ीसा	orissa	Nan
उतक	szövet	Nan
उतना	ennyit	Nan
उतनी	ennyit	Nan
उतने	annyi	None
उड़ने	repülni	Nan
ईमेल	email	None
ईमानदारी	őszinteség	Nan
ईमानदार	becsületes	None
इमाम	pap	None
इमारत	az épület	Nan
इमारतों	az épületek	Nan
इराक	irak	Nan
इराक़	irak	Nan
इरादा	a szándék	Nan
इब्राहिम	ibrahim	Nan
इलाका	a terület	Nan
इलाज	kezelés	None
इलाहाबाद	allahabadi	Nan
इलेक्ट्रान	elektron	Nan
इलेक्ट्रॉन	elektron	Nan
इलेक्ट्रॉनिक	elektronikus	None
इलेक्ट्रॉनिकी	elektronika	Nan
इलाकों	helységek	Nan
इलेक्ट्रॉनिक्स	elektronika	Nan
इबादत	imádat	Nan
इन्होंने	ők	None
इनको	őket	None
इनपुट	bemenet	Nan
इनमे	ezekben	None
इनमें	ezekben	None
इनाम	a díj	Nan
इन्टरनेट	internet	None
इन्होने	ők	None
इन्दिरा	indira	Nan
इन्दौर	indore	Nan
इन्द्रप्रस्थ	indraprastha	Nan
इन्फ्लूएंजा	influenza	None
इन्ही	ezek	None
इन्हे	nekik	None
इन्हें	ezek	None
इन्दु	indu	Nan
उत्तरप्रदेश	uttar pradesh	Nan
इलेक्ट्रॉनों	az elektronok	Nan
इष्ट	helyzetű	Nan
इस्लाम	iszlám	None
इस्लामिक	iszlám	None
इस्लामी	iszlám	None
इस्वी	hirdetés	Nan
ई	e	Nan
ईंट	tégla	Nan
इस्माईल	ismail	Nan
ईंटों	bricks	Nan
ईक्वाडोर	ecuador	Nan
ईटानगर	itanagar	Nan
ईडन	éden	Nan
ईद	eid	Nan
ईपू	bp	None
ईमान	hit	None
ईंधन	az üzemanyag	Nan
इशारा	jelzés	Nan
इस्तेमाल	használt	None
इसीलिये	ezért	None
इस	ez	None
इसका	annak	None
इसकी	övé	Nan
इसके	a	None
इसको	ez	None
इसपर	ezen	None
इसे	neki	None
इसमे	ebben	None
इसरो	isro	Nan
इसलिए	így	None
इसलिये	ezért	None
इसवी	iswi	Nan
इससे	ezáltal	None
इसी	ugyanaz	None
इसमें	ebben	None
इनकी	az	None
उत्तरांचल	uttaranchal	Nan
उत्तराखण्ड	uttarakhand	Nan
उपभोक्ता	fogyasztó	Nan
उपन्यासों	regények	None
उपन्यासकार	regényíró	Nan
उपन्यास	a regény	Nan
उपनिषद्	upanishadokban	Nan
उपनिषदों	upanishadokban	Nan
उपनिषद	upanishadokban	Nan
उपनिवेशों	a kolóniák	Nan
उपनिवेशवाद	gyarmati rendszer	Nan
उपनाम	vezetéknév	Nan
उपनगरों	a külváros	Nan
उपनगरीय	külvárosi	Nan
उपनगर	külváros	Nan
उपधातु	bimetál	Nan
उपदेशों	tanításai	Nan
उपदेश	prédikáció	Nan
उपजाऊ	termékeny	None
उन्हे	őket	None
उन्हें	őket	None
उन्होंने	ők	None
उन्होने	ők	None
उन्होनें	ők	None
उपकरण	felszerelés	Nan
उपभोक्ताओं	fogyasztók	Nan
उपकरणों	eszközök	None
उपक्रम	vállalkozás	None
उपक्षेत्र	részterület	Nan
उपग्रह	műhold	Nan
उपग्रहों	műholdak	Nan
उपचार	a kezelés	Nan
उपचारों	terápiákkal	Nan
उपकार	favor	Nan
उपभोग	fogyasztás	Nan
उपमहाद्वीप	szubkontinens	Nan
उपमा	hasonlat	Nan
उपविभाग	alosztály	Nan
उपशाखा	subhead	Nan
उपसर्ग	előtagja	Nan
उपसहारा	gondozó	Nan
उपस्थित	ajándék	Nan
उपस्थिति	jelenlét	Nan
उपवास	a gyors	Nan
उपहार	ajándékok	Nan
उपाधियाँ	címek	None
उपाध्याय	upadhyay	Nan
उपाय	megoldás	None
उपायुक्त	biztoshelyettes	Nan
उपायों	az intézkedések	Nan
उपार्जित	szerzett	None
उपाधि	fokozat	None
उन्हीं	ugyanaz	None
उपलब्धियों	kitüntetések	Nan
उपलब्धि	elérhetőség	Nan
उपयुक्त	alkalmas	None
उपयोग	használat	None
उपयोगकर्ता	a felhasználó	Nan
उपयोगकर्ताओं	felhasználók	None
उपयोगिता	hasznosság	Nan
उपयोगी	hasznos	None
उपलब्धियाँ	kitüntetések	Nan
उपर	felett	None
उपरान्त	utána	None
उपराष्ट्रपति	alelnök	None
उपरोक्त	fent említett	Nan
उपर्युक्त	fent említett	Nan
उपलब्ध	elérhető	None
उपलब्धता	elérhetőség	Nan
उपरांत	utána	None
उन्ही	ugyanaz	None
उन्मूलन	kiküszöböléséről	Nan
उन्मुख	orientált	Nan
उत्पादित	készült	None
उत्पादों	a termékek	Nan
उत्प्रेरक	katalizátor	Nan
उत्सर्जन	kibocsátás	Nan
उत्सर्जित	kibocsátott	None
उत्सव	fesztivál	None
उत्पादन	termelés	None
उत्सवों	az ünnepségek	Nan
उत्साहित	izgatott	Nan
उदय	ragyog	Nan
उदयपुर	udaipur	Nan
उदर	hasi	Nan
उदहारण	példa	None
उदार	nagylelkű	Nan
उत्साह	izgalom	Nan
उदारता	kedvesség	Nan
उत्पादकता	termelékenység	Nan
उत्पाद	a termék	Nan
उत्तराधिकार	öröklés	Nan
उत्तराधिकारियों	örökösök	Nan
उत्तरार्ध	a levél	Nan
उत्तरी	északi	None
उत्तरोत्तर	fokozatosan	None
उत्तानपाद	termék	None
उत्पादक	gyártó	None
उत्तेजना	izgalom	Nan
उत्तोलक	fogantyú	Nan
उत्थान	regenerálás	Nan
उत्पत्ति	eredet	Nan
उत्पन्न	kivált	Nan
उत्परिवर्तन	mutáció	None
उत्परिवर्तित	mutáns	Nan
उत्तेजित	izgatott	Nan
उत्तराखंड	uttarakhand	Nan
उदारवादी	mérsékelt	None
उदासीन	közömbös	Nan
उधर	onnan	None
उधार	kölcsönzés	Nan
उन	azok	None
उनका	az	None
उनकी	az	None
उनके	az	None
उद्योग	ipar	None
उनको	nekik	None
उनसे	tőlük	None
उन्नत	fejlett	None
उन्नति	haladás	Nan
उन्नयन	frissítés	Nan
उन्नीस	tizenkilenc	Nan
उन्नीसवीं	tizenkilenc	Nan
उनमें	azokban	None
उदारीकरण	a liberalizáció	Nan
उद्यानों	a kertek	Nan
उद्यान	kert	None
उदाहरण	példák	None
उदाहरणस्वरूप	például	None
उदाहरणार्थ	például	None
उदाहरणों	példák	None
उदित	emelt	None
उद्गम	eredet	Nan
उद्यानिकी	kertészet	Nan
उद्घाटन	inaugaration	Nan
उद्धरण	idézetek	None
उद्धार	megszabadítás	Nan
उद्धृत	hivatkozás	None
उद्भव	evolúció	None
उद्यम	a vállalkozás	Nan
उद्यमी	vállalkozó	Nan
उद्देश्यों	a célok	Nan
आखिर	végül	None
इनकार	megtagadni	Nan
इथोपिया	etiópia	Nan
आफ	ki	None
आपूर्ति	a készlet	Nan
आपातकाल	vészhelyzet	Nan
आपसे	tőled	Nan
आपसी	kölcsönös	None
आपस	egymás	None
आपरेशन	művelet	None
आपरेटिंग	üzemeltetési	Nan
आपराधिक	a bűnöző	Nan
आपने	ön	None
आपदाओं	katasztrófák	Nan
आपदा	katasztrófa	None
आपत्ति	ellenvetés	Nan
आपको	ön	None
आपके	a te	Nan
आपकी	a te	Nan
आपका	a te	Nan
आध्यात्मिक	a spirituális	Nan
आन	aan	Nan
आनंद	boldogság	Nan
आनंददायी	élvezetes	Nan
आनन्द	öröm	Nan
आनलाइन	online	Nan
आफ़	ki	None
आना	jön	None
आने	eljövetel	Nan
आनेवाली	beérkező	Nan
आन्तरिक	belső	None
आन्दोलन	a mozgalom	Nan
आन्ध्र	andhra	Nan
आप	ön	None
आनुवंशिक	genetikai	None
आबाद	legénységgel	Nan
आबू	abu	None
आभास	gyanú	Nan
आयाम	méretek	Nan
आयामी	dimenziós	Nan
आयी	jött	None
आयीं	jött	None
आयुर्विज्ञान	orvostudomány	Nan
आयुर्वेद	ayurveda	Nan
आयात	import	Nan
आयुर्वेदिक	ayurvédikus	Nan
आयेगा	jönni fog	Nan
आयोग	a komisszió	Nan
आयोजक	szervező	Nan
आयोजन	tervezés	Nan
आयोजित	held	Nan
आर	r	None
आये	megérkezett	None
आधे	fél	None
आया	jött	None
आयरलैंड	írország	None
आभासी	tényleges	None
आभूषण	ékszerek	Nan
आम	mangó	Nan
आमंत्रण	meghívás	Nan
आमंत्रित	meghívott	Nan
आमतौर	általában	None
आयरिश	ír	None
आमाशय	gyomor	None
आमेर	amer	Nan
आय	jövedelem	Nan
आयतन	hangerő	Nan
आयताकार	négyszögletes	Nan
आयतों	rectangles	Nan
आयनीकृत	az ionizált	Nan
आमिर	aamir	Nan
आधुनिकीकरण	korszerűsítés	Nan
आधुनिकतम	kifinomult	Nan
आधुनिक	modern	None
आज़ादी	szabadság	None
आजादी	függetlenség	None
आजीवन	életre szóló	Nan
आजीविका	megélhetés	Nan
आटा	liszt	None
आठ	nyolc	None
आज़ाद	ingyenes	None
आठवीं	nyolcadik	None
आडवाणी	advani	Nan
आडियो	hang	None
आणविक	molekuláris	None
आण्विक	molekuláris	None
आतंक	terror	Nan
आतंकवाद	terrorizmus	Nan
आठवें	nyolcadik	None
आतंकवादी	terrorista	Nan
आजकल	manapság	None
आच्छादित	fedett	None
आखेट	játszma, meccs	Nan
आख्यान	elbeszélés	None
आग	a tűz	Nan
आगंतुक	a látogató	Nan
आगम	augment	Nan
आगमन	érkezés	Nan
आज	ma	None
आगरा	agra	Nan
आगे	előre	None
आग्रह	kérés	Nan
आघात	a stroke	Nan
आचार	etika	Nan
आचार्य	tanár	None
आचार्यों	acharyák	Nan
आगामी	a közelgő	Nan
आरंभ	rajt	Nan
आता	jön	None
आते	jön	None
आदिकालीन	ősi	None
आदित्य	aditya	Nan
आदिनाथ	adinath	Nan
आदिवासियों	tribals	Nan
आदिवासी	törzsi	None
आदेश	rendelés	Nan
आदिकाल	idő	None
आदेशों	rendelés	Nan
आधार	bázis	None
आधारशिला	cornerstone	Nan
आधारित	alapján	None
आधिकारिक	hivatalos	None
आधिपत्य	fennhatóság	None
आधी	félúton	Nan
आधा	fél	None
आती	jön	None
आदि	stb	None
आदान	bemenet	Nan
आत्म	maga	None
आत्मकथा	önéletrajz	Nan
आत्मकल्याण	autizmus	None
आत्मसमर्पण	megadás	Nan
आत्मसात	asszimiláció	Nan
आत्मा	a lélek	Nan
आदानप्रदान	adok-kapok	Nan
आत्माओं	a szellemek	Nan
आदत	szokás	None
आदम	ádám	None
आदमी	férfi	None
आदर	tisztelet	Nan
आदर्श	ideál	Nan
आदर्शों	ideals	Nan
आत्‍मा	lélek	None
इन	ban ben	Nan
आरंभिक	a kezdeti	Nan
आरक्षण	foglalás	Nan
इंसानों	az emberek	Nan
इंसान	emberi	None
इंद्रियों	az érzékek	Nan
इंद्रिय	érzék	Nan
इंद्र	indra	Nan
इंदौर	indore	Nan
इंदर	inder	Nan
इंतजार	várakozás	Nan
इंडोनेशिया	indonézia	None
इंडीज	indiák	Nan
इंडिया	india	None
इंडियन	indián	None
इंटेल	intel	None
इंटरफेस	az interfész	Nan
इंटरनेशनल	nemzetközi	None
इंटरनेट	internet	None
इंटर	inter	Nan
आस्ट्रेलिया	ausztrália	None
आहार	diéta	Nan
आह्वान	könyörgés	Nan
इंक	inc.	Nan
इंकार	elutasítás	Nan
इंगित	jelzett	Nan
इंसुलिन	inzulin	None
इंग्लिश	angol	None
इंग्लैण्ड	anglia	None
इंच	hüvelyk	None
इंजन	a motor	Nan
इंजीनियर	mérnök	None
इंजीनियरिंग	mérnöki	Nan
इंजीनियरी	mérnöki	Nan
इंग्लैंड	anglia	None
इंस्टाल	telepítés	Nan
इंस्टीट्यूट	intézet	None
इंस्पेक्टर	ellenőr	Nan
इण्टरफेस	felület	None
इण्डिक	ind	Nan
इण्डिया	india	None
इतना	ennyi	Nan
इतनी	olyan sok	Nan
इतालवी	olasz	None
इण्टर	inter	Nan
इति	iti	Nan
इतिहासकार	történész	None
इतिहासकारों	történészek	None
इत्यादि	stb	None
इत्र	parfüm	Nan
इथियोपिया	etiópia	Nan
इथेन	etán	Nan
इतिहास	történelem	None
आसुमल	asmul	Nan
इटावा	etawah	Nan
इटली	olaszország	None
इकट्ठा	gyűjt	Nan
इकठ्ठा	összegyűjtött	Nan
इकाइयाँ	egységek	None
इकाइयों	egységek	None
इकाई	mértékegység	Nan
इक्कीस	huszonegy	Nan
इटालियन	olasz	None
इक्कीसवीं	huszonegyedik	Nan
इच्छा	vágy	Nan
इच्छाओं	kívánságait	Nan
इच्छित	kívánatos	Nan
इच्छुक	sóvárgó	Nan
इजराइल	izrael	None
इजरायल	izrael	None
इक्ष्वाकु	ikshvaku	Nan
आसाम	assam	Nan
आसानी	könnyű	None
आसान	könnyen	None
आर्थर	arthur	None
आर्थिक	gazdasági	None
आर्द्र	nedves	None
आर्द्रता	páratartalom	Nan
आर्मी	hadsereg	None
आर्य	arya	Nan
आर्डर	rendelés	Nan
आर्यावर्त	aryavarta	Nan
आलम	alam	Nan
आलावा	más mint	Nan
आलिकखान	aalikhan	Nan
आलू	burgonya	Nan
आलेख	cikk	None
आलोक	alok	Nan
आर्यों	árják	Nan
आलोचक	kritikus	None
आर्ट्स	arts	Nan
आर्कियोप्टेरिक्स	archaeopteryx	Nan
आरक्षित	fenntartott	Nan
आरटीआई	képletű	Nan
आरती	aarti	Nan
आरम्भ	rajt	Nan
आरम्भिक	a kezdeti	Nan
आराधना	imádat	Nan
आर्ट	művészet	None
आराध्य	imádni való	Nan
आरामदायक	kényelmes	Nan
आरेख	az ábra	Nan
आरोग्य	egészség	Nan
आरोप	szemrehányás	Nan
आरोपों	a díjak	Nan
आर्किमिडिज़	archimedes	Nan
आराम	pihenés	Nan
आरएसएस	rss	None
आलोचकों	a kritikusok	Nan
आलोचनाएँ	kritika	None
आशय	elszánt	Nan
आशा	remény	None
आशीर्वाद	áldások	Nan
आशुतोष	ashutosh	Nan
आश्चर्यचकित	meglepődött	Nan
आश्चर्यजनक	csodálatos	None
आशंका	letartóztatás	Nan
आश्रम	remetelak	Nan
आश्वासन	biztosíték	Nan
आश्विन	ashwin	Nan
आषाढ़	ashadh	Nan
आसन	testtartás	Nan
आसपास	közeli	None
आसमान	ég	None
आश्रित	függő	None
आलोचना	kritika	None
आवेदन	alkalmazás	None
आविष्कारक	a feltaláló	Nan
आलोचनात्मक	kritikai	None
आल्प्स	alpok	None
आवरण	a borító	Nan
आवर्त	a periódus	Nan
आवश्यक	kívánt	None
आवश्यकता	követelmény	Nan
आवृत्ति	a frekvencia	Nan
आवश्यकताओं	követelmények	Nan
आवागमन	forgalom	None
आवाज	hang	None
आवास	a szálláshely	Nan
आवासीय	lakó	None
आविर्भाव	megjelenése	None
आविष्कार	találmány	Nan
आवश्यक्ता	szükség	None
‎में	ban,-ben	Nan
गुरुद्वारे	gurudwara	Nan
गुरू	guru	Nan
धान	gabona	Nan
धातुकर्म	kohászat	Nan
धातुओं	metals	Nan
धातु	fém	None
धागे	a szál	Nan
धवन	dhawan	Nan
धर्मेन्द्र	dharmendra	Nan
धर्मशास्त्र	teológia	None
धर्मनिरपेक्ष	világi	None
धर्मग्रन्थ	szentírás	Nan
धर्मग्रंथ	szentírás	Nan
धर्मगुरु	vallási vezető	Nan
धर्म	vallás	None
धरोहर	örökség	None
धरातल	a felület	Nan
धरा	vereség	None
धरती	föld	None
द्वीपों	a szigetek	Nan
द्वेष	a harag	Nan
द्वैत	kettősség	Nan
धक्के	bumm	Nan
धड़	torzó	Nan
धन	pénz	None
धाम	dham	Nan
धनवान	gazdag	None
धनुष	íj	Nan
धनुषटंकार	csokornyakkendő	Nan
धन्यवाद	köszönöm	Nan
धब्बे	helyek	None
धमनियों	az artériák	Nan
धम्म	dhamma	Nan
धनी	a gazdagok	Nan
धार	áradat	Nan
धारण	tart	None
धारणाएँ	feltételezések	None
धोखे	megtévesztés	Nan
धोना	mosni	Nan
धोनी	dhoni	Nan
धोने	a mosás	Nan
धौली	dhauli	Nan
ध्यान	gondoskodás	Nan
धोखा	megtévesztés	Nan
ध्रुव	pólus	Nan
ध्वज	zászló	None
ध्वनि	hang	None
ध्वनियाँ	a hangok	Nan
ध्वनियों	hangok	None
ध्वस्त	elpusztított	Nan
न	nem	None
ध्रुवीय	poláris	Nan
द्वीपसमूह	szigetvilág	Nan
धैर्य	türelem	Nan
धूल	a por	Nan
धारणाओं	a feltételezések	Nan
धारा	szakasz	None
धाराओं	a patakok	Nan
धारावाहिक	sorozatszám	Nan
धीमी	lassú	None
धीरुभाई	dhirubhai	Nan
धृतराष्ट्र	dhritarashtra	Nan
धीरे	lassú	None
धुम्रपान	dohányzó	Nan
धुरी	a tengely	Nan
धुल	lemosni	Nan
धूम	szikla	Nan
धूमधाम	harsonaszó	Nan
धूम्रपान	dohányzó	Nan
धुंध	köd	Nan
द्वीप	a sziget	Nan
द्विवेदी	dwivedi	Nan
द्वितीयक	másodlagos	None
देसाई	desai	Nan
देसी	desi	Nan
देह	test	None
देहरादून	dehradun	Nan
देहली	küszöb	Nan
देहांत	halál	None
देशों	az országok	Nan
देहान्त	halott	None
दैत्यों	démonok	Nan
दैनन्दिनी	napló	None
दैनिक	napi	None
दैवीय	isteni	None
दैहिक	szomatikus	Nan
दो	kettő	None
दैत्य	a szörny	Nan
दोनो	mindkét	None
देशो	országok	None
देशान्तर	hosszúság	Nan
देवकी	devaki	Nan
देवता	isten	None
देवताओं	az istenek	Nan
देवनागरी	devanagari	Nan
देवराज	devraj	Nan
देवि	devi	Nan
देशी	anyanyelvi	Nan
देवी	istennő	None
देश	ország	None
देशभक्त	hazafi	Nan
देशभक्ति	hazaszeretet	Nan
देशभर	országos	None
देशविदेश	idegen ország	Nan
देशांतर	hosszúság	Nan
देवीदेवताओं	istenek és istennők	Nan
नंद	nanda	Nan
दोनों	mindkét	None
दोबारा	újra	None
द्रव्यमात्रा	tömeg	None
द्रव्यों	folyadékok	Nan
द्रुत	gyors	None
द्रोण	drona	Nan
द्रोणाचार्य	dronacharya	Nan
द्रोणी	mosdó	Nan
द्रव	folyadék	Nan
द्रौपदी	draupadi	Nan
द्वापर	dwapar	Nan
द्वार	a kapu	Nan
द्वारका	dwarka	Nan
द्वारिका	dwarka	Nan
द्विआधारी	kétkomponensű	Nan
द्वितीय	második	None
द्वादश	dwadash	Nan
दोपहर	délután	None
द्योतक	jelképes	Nan
दौरे	a túra	Nan
दोष	a hiba	Nan
दोषी	bűnös	None
दोषों	hiányosságai	Nan
दोस्त	barát	None
दोस्ती	barátság	None
दोस्तों	barátok	None
दौलत	jólét	Nan
दोहन	kizsákmányolás	Nan
दोहरे	kettős	None
दोहा	doha	Nan
दौड़	a verseny	Nan
दौर	a kerek	Nan
दौरा	a túra	Nan
दौरान	alatt	None
दोहरी	dupla	None
देव	isten	None
नंदन	nandan	Nan
नंबर	szám	None
नाम	név	None
नाभिकीय	nukleáris	None
नाभि	köldök	Nan
नापा	mért	None
नाप	intézkedés	Nan
नाना	anyai nagyapa	Nan
नानक	nanak	Nan
नाद	nad	Nan
नाथूराम	nathuram	Nan
नाते	lény	None
नाडु	nadu	Nan
नाट्यशास्त्र	dramaturgia	Nan
नाट्य	színházi	None
नाटो	nato	None
नाटकों	plays	Nan
नाटककारों	drámaírók	Nan
नाटककार	drámaíró	Nan
ना	nem	None
नांसी	nancy	Nan
नाइजीरिया	nigéria	Nan
नाइट्रोजन	nitrogén	Nan
नाक	orr	Nan
नाग	kígyó	None
नामक	hívott	None
नागपुर	nagpur	Nan
नागरिक	polgár	None
नागरिकता	polgárság	Nan
नागरिकों	a polgárok	Nan
नागरी	nagari	Nan
नागार्जुन	nagarjuna	Nan
नाटक	dráma	None
नागर	civil	None
नामकरण	elnevezési	Nan
नाममात्र	névleges	Nan
नामांकन	felvétel	None
नाव	a hajó	Nan
नाविक	tengerész	Nan
नाश	megsemmisítés	Nan
नासा	nasa	None
नासिक	nashik	Nan
नासिर	nasir	Nan
नालन्दा	nalandát	Nan
नास्तिक	ateista	Nan
नि	ingyenes	None
निःशुल्क	ingyenes	None
निकट	bezárás	Nan
निकटतम	a legközelebbi	Nan
निकटता	közelség	Nan
निकटवर्ती	közeli	None
नास्तिकता	ateizmus	Nan
नहीं	nem	None
नालंदा	nalandát	Nan
नारीवाद	feminizmus	Nan
नामांकित	jelölt	None
नामित	kijelölt	None
नामी	híres	None
नामों	a nevek	Nan
नामोत्पत्ति	jelölés	None
नायक	hős	None
नार्वे	norvég	None
नायडू	naidu	Nan
नारंगी	narancs	None
नारद	narada	Nan
नारा	szlogen	Nan
नाराज	mérges	Nan
नारायण	narayan	Nan
नारी	nő	None
नायर	nair	Nan
नही	nem	None
नहर	csatorna	None
नस्ल	a fajta	Nan
नतमस्तक	íj	Nan
नतीजा	eredmény	None
नदियाँ	rivers	Nan
नदियां	a folyók	Nan
नदियों	a folyók	Nan
नदी	folyó	None
नज़र	szem	None
नन्द	nanda	Nan
नबी	próféta	None
नम	nedves	None
नमः	üdvözlettel om-nak	Nan
नमक	só	Nan
नमन	üdvözlet	Nan
नमस्कार	szia	Nan
नन्दा	nanda	Nan
नमस्ते	szia	Nan
नजर	látomás	Nan
नजदीक	közel	None
नई	új	None
नए	új	None
नक़ल	másolat	Nan
नकारात्मक	negatív	None
नक्काशी	faragás	Nan
नक्शा	térkép	None
नजदीकी	a legközelebbi	Nan
नक्शे	a térkép	Nan
नक्षत्रों	csillagképek	Nan
नगर	város	None
नगरपालिका	község	None
नगरी	város	None
नगरीय	városi	None
नगरों	a városok	Nan
नक्षत्र	csillag	None
नंदा	nanda	Nan
नमाज़	ima	Nan
नमूना	a minta	Nan
नवजात	újszülött	Nan
नवपाषाण	neolit	Nan
नवम्बर	november	None
नवरत्नों	navratnas	Nan
नवरात्रि	navratri	Nan
नवरात्रोत्सव	navratri fesztivál	Nan
नवंबर	november	None
नवाचार	innováció	Nan
नवीं	kilencedik	None
नवीन	legújabb	None
नवीनतम	legújabb	None
नवीनीकृत	korszerűsített	Nan
नष्ट	elpusztított	Nan
नसीरुद्दीन	naseeruddin	Nan
नवाब	nawab	Nan
नमी	nedvesség	Nan
नव	új	None
नल	koppintson a	Nan
नमूने	minták	Nan
नमूनों	minták	Nan
नम्बर	szám	None
नम्रता	szelídség	Nan
नया	új	None
नयी	új	None
नलिकाओं	vezetékek	Nan
नर	férfi	None
नरसंहार	mészárlás	None
नरसिंह	narasimha	Nan
नरहरि	narahari	Nan
नरेन्द्र	narendra	Nan
नरेश	naresh	Nan
नर्मदा	narmada	Nan
नरक	pokol	None
निकल	ki	None
देरी	a késés	Nan
देने	adni	None
दलों	a felek	Nan
दलितों	dalitok	Nan
दलित	dalit	Nan
दलदली	mocsaras	None
दलदल	a mocsár	Nan
दर्शाया	jelzett	Nan
दर्शाने	megmutatni	Nan
दर्शाते	tükröznie	Nan
दर्शाती	fényvisszaverő	Nan
दर्शाता	azt jelzi	Nan
दर्शनों	nézetek	None
दर्शनीय	látható	None
दर्शनशास्त्र	filozófia	None
दर्शन	látogatás	Nan
दर्शक	a közönség	Nan
दर्पण	tükör	None
दर्द	fájdalom	None
दयाल	dayal	Nan
दयालु	könyörületes	Nan
दर	mérték	Nan
दरअसल	tulajdonképpen	None
दरगाह	a dargah	Nan
दरबार	a bíróság	Nan
दवा	gyógyszer	None
दरबारियों	udvaroncok	Nan
दरभंगा	darbhanga	Nan
दरवाजा	ajtó	Nan
दरवाजे	az ajtók	Nan
दरारें	repedések	Nan
दर्ज	belép	Nan
दर्जे	fokozat	None
दरबारी	udvaronc	Nan
दवाएं	a gyógyszerek	Nan
दवाओं	a drogok	Nan
दशकों	évtizedek	None
दांत	fogak	None
दाईं	a jobb	Nan
दाएँ	a jobb	Nan
दाएं	a jobb	Nan
दाखिल	belépés	Nan
दाता	donor	Nan
दाँत	fogak	None
दाद	ótvar	Nan
दादा	nagyapa	Nan
दान	adomány	Nan
दानव	démon	Nan
दानवों	démonok	Nan
दाने	gabona	Nan
दानों	adományok	Nan
दादरा	dadra	Nan
दयानन्द	dayanand	Nan
दा	da	None
दहन	az égés	Nan
दशमलव	decimális	Nan
दशमी	dashami	Nan
दशरथ	dasharatha	Nan
दशहरा	dussehra	Nan
दशहरे	dussehra	Nan
दशा	feltétel	None
दही	aludttej	Nan
दस	tíz	None
दसवें	tizedik	None
दसों	tíz	None
दस्त	hasmenés	None
दस्तावेज	dokumentum	None
दस्तावेज़	a dokumentum	Nan
दस्तावेजों	a dokumentumok	Nan
दसवीं	tizedik	None
दयानंद	dayanand	Nan
दया	kegyelem	Nan
दमन	daman	Nan
त्रिकोणमिति	trigonometria	Nan
त्रिकोणमितीय	trigonometrikus	Nan
त्रिज्या	a sugár	Nan
त्रिपाठी	tripathi	Nan
त्रिपुरा	tripura	Nan
त्रिभुज	háromszög	None
त्रिकोण	háromszög	None
त्रिमूर्ति	szentháromság	Nan
त्रिशूल	háromágú szigony	Nan
त्रुटि	hiba	None
त्रुटियां	hibák	None
त्रुटियों	hibák	None
त्वचा	a bőr	Nan
त्वरित	sietett	Nan
त्रिवेदी	trivedi	Nan
थ	th	Nan
त्रिकुटा	trikuta	Nan
त्यौहार	a fesztivál	Nan
तैयारी	készítmény	Nan
तैरते	úszó	None
तो	így	None
तोड़	a szünet	Nan
तोड़कर	törés	Nan
तोप	ágyú	Nan
त्यौहारों	fesztiválok	Nan
तोमर	tomar	Nan
तोला	tola	Nan
तौर	mint	None
त्याग	áldozat	None
त्यागपत्र	felmondólevél	Nan
त्यागी	szoliter	Nan
त्योहारों	fesztiválok	Nan
तोरण	árkádsor	Nan
दाब	nyomás	None
थकान	fáradtság	Nan
थलसेना	hadsereg	None
दंत	fog	None
दक्ष	hatékony	None
दक्षता	hatékonyság	Nan
दक्षिण	déli	None
दक्षिणपश्चिम	délnyugati	None
दक्षिणपूर्व	délkeleti	None
दंड	egy büntetés	Nan
दक्षिणी	a déli	Nan
दत्त	dutta	Nan
दत्तात्रेय	dattatreya	Nan
दफन	temetés	Nan
दबा	elnyomott	Nan
दबाव	nyomás	None
दम	erő	None
दण्ड	büntetés	None
थल	föld	None
द	a	None
थोड़े	kevés	None
थाई	thai	Nan
थाईलैंड	thaiföld	Nan
थार	thar	Nan
थाली	lemez	None
थियेटर	színház	None
थी	volt	None
थोथ	thoth	Nan
थीं	voltak	None
थेरेपी	terápia	None
थैली	a táska	Nan
थॉमस	tamás	None
थोक	tömeg	None
थोड़ा	kis	None
थोड़ी	kis	None
थे	voltak	None
देर	késő	None
दाम	ár	None
दायर	iktatott	Nan
दूरसंचार	telecom	Nan
दूरदूर	messze	None
दूरदर्शी	látnok	Nan
दूरदर्शन	doordarshan	Nan
दूर	el	None
दूध	tej	None
दूत	messanger	Nan
दूँगा	adni fog	Nan
दुसरे	egyéb	None
दुष्टों	a gonosz	Nan
दुष्ट	a gonosz	Nan
दुश्मनों	ellenségek	Nan
दुश्मनी	ellenségeskedés	Nan
दुश्मन	ellenség	None
दुर्वासा	durvasa	Nan
दुर्लभ	ritka	None
दुर्योधन	duryodhana	Nan
दुकानों	a boltok	Nan
दुख	a bánat	Nan
दुखी	szomorú	None
दुग्ध	tej	None
दुनिया	világ	None
दुबई	dubai	Nan
दूरस्थ	távoli	None
दुबारा	újra	None
दुर्गम	megközelíthetetlen	Nan
दुर्गा	durga	Nan
दुर्गों	erődítmények	Nan
दुर्घटना	baleset	None
दुर्दम	durd	Nan
दुर्बलता	gyengeség	Nan
दुर्ग	durg	Nan
दूरी	távolság	None
दूषित	elrontott	Nan
दूसरा	második	None
देखिए	néz	None
देखिये	néz	None
देखी	fűrész	Nan
देखे	lát	None
देखें	lát	None
देखो	néz	None
देखा	fűrész	Nan
देग	dég	Nan
देगी	adni fog	Nan
देता	ad	None
देती	ad	None
देते	giving	Nan
देना	adni	None
देनी	adni	None
देगा	adni fog	Nan
दुकानें	a boltok	Nan
देखभाल	gondoskodás	Nan
देखना	látni	None
दूसरों	a többiek	Nan
दृढ	eltökélt	Nan
दृढ़ता	szilárdság	Nan
दृश्य	kilátás	Nan
दृष्टि	látomás	Nan
दृष्टिकोण	a látás	Nan
देखने	látni	None
दृष्टिकोणों	megközelít	Nan
दें	adni	None
देकर	adva	Nan
देख	lát	None
देखकर	miután láttam	Nan
देखता	lát	None
देखते	lát	None
दे	adni	None
दुकान	üzlet	Nan
दुःखी	szomorú	None
दुःख	a bánat	Nan
दिखाता	műsorok	Nan
दिखाते	kiállítás	None
दिखाना	megmutatni	Nan
दिखाने	előadás	None
दिखाया	látható	None
दिखायी	látható	None
दिखाई	látható	None
दिग्विजय	digvijay	Nan
दिन	nap	None
दिनकर	nap	None
दिनांक	dátum	None
दिनों	napok	None
दिमागी	ész	None
दिया	adott	None
दिति	diti	Nan
दिया|	gave	Nan
दिखा	kiállítás	None
दिखने	látható	None
दायरे	hatálya	Nan
दायें	a jobb	Nan
दार्शनिक	filozófus	None
दावत	ünnep	None
दावा	követelés	Nan
दावे	az állítások	Nan
दिखलाई	látható	None
दास	rabszolga	Nan
दाहिनी	a jobb	Nan
दाहिने	jobb	None
दि	nap	None
दिए	lámpák	Nan
दिखता	úgy néz ki,	Nan
दिखती	látható	None
दासी	szobalány	Nan
दामोदर	damodar	Nan
दिये	adott	None
दिलचस्पी	érdekelt	Nan
दीपक	lámpa	Nan
दीपावली	deepawali	Nan
दीर्घ	hosszú	None
दीर्घकालिक	hosszútávú	Nan
दीर्घकालीन	hosszútávú	Nan
दीर्घा	a galéria	Nan
दीप	mély	None
दीर्घायु	hosszú élet	Nan
दीवान	miniszter	None
दीवाना	őrült	None
दीवानी	őrült	None
दीवार	fal	None
दीवारें	a falak	Nan
दीवाली	diwali	Nan
दीव	diu	Nan
दिल	szív	None
दीन	deen	Nan
दीक्षा	megindítás, inicializálás	Nan
दिलाई	beadott	Nan
दिलाने	engedd szabadon	Nan
दिलीप	dileep	Nan
दिलों	szívek	Nan
दिल्ली	delhi	Nan
दिल्‍ली	delhi	Nan
दीक्षित	dixit	Nan
दिवस	nap	None
दिव्य	isteni	None
दिशा	az irány	Nan
दिशाओं	az irányok	Nan
दिसंबर	december	None
दिसम्बर	december	None
दी	adott	None
दिवसीय	nap	None
तैयार	kész	None
निकलकर	kilépő	Nan
निकलती	kiárad	Nan
परियोजनाओं	a projektek	Nan
परियोजना	feladat vagy projekt	Nan
परिमाण	mennyiség	None
परिभाषित	meghatározott	None
परिभाषाएँ	definíciók	Nan
परिभाषा	meghatározás	Nan
परिपूर्ण	a tökéletes	Nan
परिपथ	áramkör	Nan
परिपक्व	érett	None
परिधि	körméret	Nan
परिदृश्य	a táj	Nan
परित्याग	lemondás	Nan
परिणामों	az eredmények	Nan
परिणामस्वरूप	a kapott	Nan
परिणत	átalakít	Nan
परिचित	ismerős	Nan
परिचालन	üzemeltetési	Nan
पराक्रमी	hatalmas	None
पराग	pollen	Nan
परागण	beporzás	Nan
परागन	beporzás	Nan
पराजय	vereség	None
पराजित	legyőzött	Nan
परिलक्षित	tükröződik	Nan
पराबैंगनी	ultraibolya	Nan
परास्त	megbukott	None
परिकल्पना	a hipotézis	Nan
परिक्रमा	circumambulation	Nan
परिक्षण	tesztelés	Nan
परिचय	bevezetés	None
परिचायक	azonosító	Nan
परामर्श	konzultáció	Nan
परिवर्तक	converter	Nan
परिवर्तन	változás	None
परिवर्तनशील	változó	None
पर्ची	csúszás	Nan
पर्णपाती	lombhullató	Nan
पर्दाफाश	busted	Nan
पर्दे	függöny	Nan
पर्यटक	turista	Nan
पर्यटकों	a turisták	Nan
परोक्ष	közvetett	None
पर्यटन	idegenforgalom	None
पर्यवेक्षण	felügyelet	None
पर्याप्त	elég	None
पर्याय	szinonima	Nan
पर्यावरण	környezet	None
पर्यावरणीय	környezeti	None
पर्व	fesztivál	None
पर्यवेक्षक	felügyelő	None
पराक्रम	bátorság	Nan
परेशान	aggódó	Nan
परीक्षित	kipróbált	Nan
परिवर्तनों	a változások	Nan
परिवर्तित	megváltozott	None
परिवर्ती	változó	None
परिवहन	szállítás	Nan
परिवारों	a családok	Nan
परिवेश	a környezet	Nan
परे	túl	None
परिश्रम	kemény munka	Nan
परिष्कृत	kifinomult	Nan
परिस्थिति	helyzet	None
परिस्थितियों	körülmények	None
परीक्षण	tesztelés	Nan
परीक्षणों	a tesztek	Nan
परीक्षा	vizsga	Nan
परिषद	tanács	None
पराकाष्ठा	csúcspontja	None
परस्पर	közösen	None
परसाई	parsai	Nan
पथ	az út	Nan
पद	posta	Nan
पदक	az érmet	Nan
पदानुक्रम	hierarchia	Nan
पदार्थ	ügy	None
पदार्थो	az anyagok	Nan
पत्रों	a levelek	Nan
पदार्थों	az anyagok	Nan
पद्धति	a módszer	Nan
पद्धतियाँ	a módszerek	Nan
पद्धतियों	a módszerek	Nan
पद्म	padma	Nan
पद्य	vers	None
पध्दति	módszer	None
पदों	a hozzászólások	Nan
पनीर	túró	Nan
पत्रिकाओं	folyóiratok	Nan
पत्रिका	magazin	None
पत्तन	kikötő	None
पत्तियाँ	a levelek	Nan
पत्तियों	a levelek	Nan
पत्ती	levél növényen	Nan
पत्ते	a levelek	Nan
पत्तों	a levelek	Nan
पत्रिकाएँ	magazinok	Nan
पत्थर	kő	None
पत्नी	feleség	None
पत्र	levél	None
पत्रकार	újságíró	None
पत्रकारिता	újságírás	Nan
पत्रपत्रिकाओं	szórólapok	Nan
पत्राचार	levelezés	Nan
पत्थरों	a kövek	Nan
पर्वतमाला	a tartományok	Nan
पन्द्रह	tizenöt	None
पन्ने	oldalak	None
परमहंस	paramhansa	Nan
परमाणु	atom	None
परमाणुओं	atomok	None
परमात्मा	isteni	None
परमेश्वर	isten	None
परम्परा	hagyomány	None
परम	a mindenekfeletti	Nan
परम्परागत	hagyományos	None
परलोक	a másik világ	Nan
परवरिश	nevelés	None
परवर्ती	utóbbi	None
परवाह	gondoskodás	Nan
परशुराम	parashuram	Nan
परशुरामजी	parashuramaji	Nan
परली	parli	Nan
पन्ना	az oldal	Nan
परब्रह्म	parabrahm	Nan
परदे	a függöny	Nan
पन्नों	az oldalak	Nan
पपड़ी	kéreg	None
पब्लिक	nyilvános	None
पम्प	szivattyú	Nan
पर	tovább	None
परंपरा	a hagyomány	Nan
परन्तु	de	None
परंपराएँ	a hagyományok	Nan
परंपराओं	a hagyományok	Nan
परंपरागत	a hagyományos	Nan
परक	teszt	None
परजीवी	élősködő	Nan
परत	réteg	None
परतों	rétegek	None
परंपराएं	a hagyományok	Nan
पति	férj	None
पर्वतीय	hegy	None
पर्वों	ünnep	None
पाम	tenyér	Nan
पापों	sins	Nan
पापी	a bűnös	Nan
पाने	kap	None
पानीपत	panipat	Nan
पानी	víz	None
पाना	csavarkulcs	Nan
पान	pán	Nan
पादरियों	a papság	Nan
पादप	növény	None
पाद	fing	Nan
पात्रों	a karakterek	Nan
पात्र	a karakter	Nan
पाते	megtalálja	Nan
पाती	kap	None
पाताल	pokol	None
पाण्डेय	pandey	Nan
पाटन	paatan	Nan
पाटलिपुत्र	patna	Nan
पाटिल	patil	Nan
पाठ	a szöveg	Nan
पाठक	olvasó	None
पाठकों	az olvasók	Nan
पायलट	a pilóta	Nan
पाठशाला	iskola	None
पाठ्यक्रम	tanterv	Nan
पाणिनि	panini	Nan
पाण्डव	pandava	Nan
पाण्डवों	pándavák	Nan
पाण्डु	pándu	Nan
पाण्डे	pandey	Nan
पाठ्य	a szöveg	Nan
पाया	megvan	None
पायी	megtalálták	None
पाये	kap	None
पार्श्व	oldal	None
पार्श्वगायन	lejátszás éneklés	Nan
पाल	haver	Nan
पालतू	a kisállat	Nan
पालन	engedelmesség	Nan
पालनपोषण	nevelés	None
पार्वती	parvati	Nan
पालने	a bölcső	Nan
पालिका	palika	Nan
पावन	szent	None
पावर	erő	None
पाश्चात्य	nyugati	None
पाषाण	kő	None
पास्का	paska	Nan
पाला	gondozta	Nan
पागल	őrült	None
पार्थिव	föld	None
पार्टियों	a felek	Nan
पार	túl	None
पारंपरिक	hagyományos	None
पारदर्शी	átlátszó	Nan
पारम्परिक	hagyományos	None
पारसी	parsiya	Nan
पारस्परिक	kölcsönös	None
पार्टी	buli	Nan
पाराशर	parashar	Nan
पारिवारिक	család	None
पारिस्थितिक	ökológiai	None
पारिस्थितिकी	ökológia	Nan
पारी	váltás	Nan
पार्क	a park	Nan
पार्टनर	a partner	Nan
पारित	elmúlt	None
पाक्षिक	kétheti	Nan
पाकिस्तानी	pakisztáni	Nan
पाकिस्तान	pakisztán	None
पहचानने	felismerhető	Nan
पहचाना	elismert	None
पहचाने	elismert	None
पहनते	viselet	Nan
पहनने	viselet	Nan
पहना	kopott	Nan
पहचान	elismerik	Nan
पहने	viselet	Nan
पहलगाम	pahalgam	Nan
पहला	az első	Nan
पहली	első	None
पहलुओं	aspects	Nan
पहलू	a szempont	Nan
पहले	első	None
पहल	a kezdeményezés	Nan
पहाड़	a hegy	Nan
पसन्द	tetszik	None
पश्‍चिम	nyugatra	None
पर्सनल	személyes	None
पवन	levegő	None
पवन-वेग-मापी	szélmalom	Nan
पवित्रतम	a legszentebb	Nan
पवित्रता	tisztaság	Nan
पशु	állat	None
पसंदीदा	a kedvenc	Nan
पशुओं	állatok	None
पशुपालन	állattenyésztés	None
पश्चात	utána	None
पश्चाताप	bűntudat	Nan
पश्चात्	utána	None
पश्चिम	a nyugat	Nan
पश्चिमी	nyugati	None
पशुधन	állatállomány	Nan
पर्वत्	böjt nap	Nan
पहाड़ियों	a dombok	Nan
पहाड़ों	a hegyek	Nan
पाँव	a lábak	Nan
पांच	öt	None
पांचवीं	ötödik	None
पांचवें	ötödik	None
पांचों	mind az öt	Nan
पांडव	pandava	Nan
पाँच	öt	None
पांडे	pandey	Nan
पांवों	feet	Nan
पाइरूविक	piroszőlősav	Nan
पाई	a pite	Nan
पाए	kap	None
पाक	tiszta	None
पाकर	megszerzése után	Nan
पांव	a lábak	Nan
पहाड़ी	a domb	Nan
पा	apa	None
पहुंचाने	szállít	Nan
पहिए	a kerekek	Nan
पहुँच	hozzáférés	Nan
पहुँचकर	miután elértem	Nan
पहुँचता	elér	Nan
पहुँचती	elér	Nan
पहुँचते	elérése	None
पहुंची	megérkezett	None
पहुँचने	reach	Nan
पहुँचाने	szállít	Nan
पहुँची	elérte	None
पहुँचे	megérkezett	None
पहुंच	a hozzáférés	Nan
पहुंचते	elérése	None
पहुंचा	nyúlt fel	Nan
पहुँचा	elérte	None
निकलता	származik	None
पता	cím	None
पतली	vékony	None
निर्माता	a teremtő	Nan
निर्माणाधीन	építés alatt	Nan
निर्माण	építkezés	None
निर्मल	puha	Nan
निर्भरता	függőség	Nan
निर्भर	függő	None
निर्बल	gyenge	None
निर्धारित	eltökélt	Nan
निर्धारण	meghatározás	Nan
निर्धारक	döntő	None
निर्धन	szegény	None
निर्देशों	az utasítások	Nan
निर्देशो	utasítás	None
निर्देशित	directed	Nan
निर्देशिका	a könyvtár	Nan
निर्देशांक	koordináta	Nan
निर्देशन	irány	None
निराकार	alaktalan	Nan
निराला	egyedi	None
निराश	csalódást	Nan
निराशा	kétségbeesés	Nan
निरीक्षण	ellenőrzés	None
निरुक्त	ingyenes	None
निर्माताओं	a gyártók	Nan
निरूपित	jelöli	None
निरोध	fogamzásgátlás	Nan
निर्गुण	nirgun	Nan
निर्णायक	döntő	None
निर्दिष्ट	meghatározott	None
निर्देश	utasítás	None
निर्देशक	az igazgató	Nan
निरोग	egészséges	None
निर्यात	export	None
निर्वाचन	választás	None
निर्वाचित	megválasztott	None
निषेचन	termékenyítés	Nan
निषेचित	a megtermékenyített	Nan
निषेध	tilalom	None
निष्कर्ष	a következtetés	Nan
निष्कर्षों	a megállapítások	Nan
निष्क्रिय	tétlen	Nan
निषिद्ध	tiltott	None
निष्पक्ष	semleges	None
निष्पादित	végrehajtott	None
निसंदेह	természetesen	None
निहित	foglalt	None
नींद	alvás	Nan
नींव	az alapítás	Nan
नीच	alacsony	None
निष्पादन	teljesítmény	None
निरन्तर	folyamatosan	None
निषाद	nishad	Nan
निश्चय	a meghatározás	Nan
निर्वाण	nirvána	Nan
निर्वासित	száműzött	Nan
निर्वाह	megélhetési	Nan
निर्विकार	értelmetlen	Nan
निर्विवाद	vitathatatlan	Nan
निवारण	megelőzés	Nan
निश्चित	rögzített	None
निवास	a lakóhely	Nan
निवासी	a lakó	Nan
निवेदन	kérés	Nan
निवेश	beruházás	Nan
निशान	mark	None
निशाना	cél	None
निशुल्क	ingyenes	None
निवासियों	a lakosok	Nan
निरंतरता	folytatás	Nan
निरंतर	folyamatos	None
निरंकार	nirankar	Nan
निक्षेप	letét	Nan
निगम	vállalat	None
निगरानी	felügyelet	None
निचला	alsó	None
निचली	alsó	None
निचले	alsó	None
निकोलस	nicholas	Nan
निज़ाम	haiderabad uralkodója	Nan
निजामुद्दीन	nizamuddin	Nan
निजी	magán	None
निडारिया	nidaria	Nan
नितांत	teljesen	None
नित्य	mindig	None
निदान	a diagnózis	Nan
निजाम	haiderabad uralkodója	Nan
निदेशक	az igazgató	Nan
निकोबार	nicobar	Nan
निकास	a kijárat	Nan
निकलते	fokozva	Nan
निकलने	a kijárat	Nan
निकला	ki	None
निकली	kijött	Nan
निकले	kijött	Nan
निकायों	bodies	Nan
निकासी	vámkezelés	Nan
निकाल	vegye ki	Nan
निकालते	eltávolítani	Nan
निकालना	eltávolítás	Nan
निकालने	kivonat	Nan
निकाला	eltávolított	Nan
निकाली	eltávolított	Nan
निकाले	vegye ki	Nan
निकालकर	eltávolítva	Nan
नीचा	alacsony	None
निद्रा	alvás	Nan
निधि	alap	None
नियंत्रक	vezérlő	Nan
नियंत्रण	ellenőrzés	None
नियंत्रित	ellenőrzött	Nan
नियत	rögzített	None
नियति	sors	None
नियन्त्रण	ellenőrzés	None
निम्नानुसार	alábbiak szerint	Nan
नियम	szabály	None
नियमों	a szabályok	Nan
नियामक	szabályozó	Nan
नियुक्त	kijelölt	None
नियुक्ति	az időpont	Nan
नियोजन	tervezés	Nan
नियोजित	munkavállaló	Nan
नियमित	szabályos	None
निधन	halál	None
निम्नलिखित	következő	None
निमित्त	erre a célra	Nan
निपटने	szerelés	Nan
निपुण	tökéletes	None
निबंध	esszé	Nan
निबंधकार	esszéista	Nan
निबंधों	esszék	Nan
निभा	eleget tesz	Nan
निमोनिया	tüdőgyulladás	Nan
निभाई	játszott	None
निभाते	plays	Nan
निभाने	eleget tesz	Nan
निभाया	tartotta a lépést	Nan
निभायी	tartotta a lépést	Nan
निमंत्रण	meghívás	Nan
निमाड़	nimar	Nan
निभाता	plays	Nan
पतले	vékony	None
नीचे	alsó	None
नीतियाँ	az irányelvek	Nan
पटकथा	a script	Nan
पचास	ötven	None
पग	lépés	None
पक्षों	az oldalak	Nan
पक्षी	madár	None
पक्षियों	a madarak	Nan
पक्षपात	elfogultság	Nan
पक्ष	oldal	None
पक्के	biztos	None
पक्की	megerősített	None
पकवान	a tál	Nan
पकड़े	tart	None
पकड़ने	fogás	Nan
पकड़ना	elkapni	Nan
पकड़	tart	None
पंद्रह	tizenöt	None
पंथ	kultusz	Nan
पंचम	ötödik	None
पंचमी	panchami	Nan
पंचवटी	panchvati	Nan
पंचांग	évkönyv	Nan
पंचायत	zsűri	Nan
पंचायती	panchayati	Nan
पटना	patna	Nan
पंचायतों	panchayats	Nan
पंजाबी	pandzsábi	Nan
पंजीकरण	bejegyzés	Nan
पंजीकृत	bejegyzett	Nan
पंडित	tudós	None
पंत	liheg	Nan
पंतनगर	pantnagar	Nan
पंजाब	pandzsáb	Nan
पटियाला	patiala	Nan
पटेल	patel	Nan
पट्टी	szalag	Nan
पडा	volt	None
पढने	olvas	Nan
पढ़	olvas	Nan
पढ़ते	olvas	Nan
पढ़ना	olvasás	Nan
पढ़ने	olvas	Nan
पड़ोसी	a szomszédok	Nan
पढ़ा	olvas	Nan
पढ़े	olvas	Nan
पढ़ें	olvas	Nan
पढाई	tanulmány	None
पण्डित	tudós	None
पतंजलि	patanjali	Nan
पतन	az esés	Nan
पढ़ाई	tanulmányok	None
पंचतंत्र	panchatantra	Nan
पड़ेगी	le fog esni	Nan
पड़े	fekvő	None
पठन	olvasás	Nan
पठार	fennsík	Nan
पठारी	fennsík	Nan
पड	párna	Nan
पडता	olvasás	Nan
पडती	esik	None
पड़ेगा	lesz	None
पड़	esik	None
पड़ती	esik	None
पड़ते	esik	None
पड़ने	esik	None
पड़ा	fekvő	None
पड़ाव	álljon meg	Nan
पड़ी	fekvő	None
पड़ता	zuhatag	Nan
पंच	puncs	Nan
पंख	szárny	Nan
पंक्तियों	sorok	None
नेता	vezető	None
नेताओं	a vezetők	Nan
नेताजी	netaji	Nan
नेतृत्व	vezetés	None
नेत्र	szem	None
नेपाल	nepál	Nan
नेटस्केप	netscape	Nan
नेपाली	nepáli	Nan
नेल्सन	nelson	None
नेविगेशन	navigáció	Nan
नेहरु	nehru	Nan
नैतिक	erkölcsi	None
नैतिकता	erkölcs	Nan
नैदानिक	diagnosztikai	Nan
नेपोलियन	napóleon	None
नैना	naina	Nan
नेटवर्किंग	hálózat	None
नेकर	nekar	Nan
नीतियों	házirendje	Nan
नीदरलैंड	hollandia	None
नीम	azadirachta indica	Nan
नील	kék	None
नीलगिरी	eukaliptusz	Nan
नीला	kék	None
नेटवर्क	hálózat	None
नीले	kék	None
नुक्सान	kár	Nan
नृतत्व	tánc	None
नृत्य	tánc	None
नृविज्ञान	embertan	Nan
नृसिंह	narsingh	Nan
नें	a	None
नुकसान	veszteség	Nan
नीति	irányelv	Nan
नैनी	dajka	Nan
नैनो	nano	Nan
न्यायालय	bíróság	None
न्यायालयों	bíróságok	None
न्यायिक	bírósági	None
न्यू	új	None
न्यूज़	hírek	None
न्यूजीलैंड	új zéland	Nan
न्यायाधीश	a bíró	Nan
न्यूटन	newton	None
न्यूट्रॉन	neutron	Nan
न्यूनतम	a minimum	Nan
न्यूयॉर्क	new york	Nan
पं	pt	Nan
पंकज	pankaj	Nan
पंक्ति	vonal	None
न्यूट्रान	neutron	Nan
नैनीताल	nainital	Nan
न्यायपालिका	bírói	None
न्याय	az igazságosság	Nan
नॉर्वे	norvégia	None
नॉस्डेक	nosdeck	Nan
नो	nem	None
नोट	jegyzet	Nan
नोट्स	megjegyzések	None
नोबल	nemes	None
न्यायधीशों	a bírók	Nan
नौ	kilenc	None
नौकरी	munka	None
नौका	a hajó	Nan
नौटियाल	nautiyal	Nan
नौवल	haditengerészeti	Nan
नौसेना	haditengerészet	None
न्यागत	decentralizált	Nan
नौकरियों	a munkahelyek	Nan
गुरुवार	csütörtök	Nan
तैनात	közzétett	Nan
तेलुगु	telugu	Nan
छवियों	képek	None
छवि	a kép	Nan
छल्ले	gyűrűk	None
छन्द	vers	None
छत्रपति	chhatrapati	Nan
छत्तीसगढ़ी	chhattisgarhi	Nan
छत्तीसगढ़	cshattíszgarh	Nan
छत्तीसगढ	chattisgarh	Nan
छत	tető	Nan
छड़ी	a bot	Nan
छठे	a hatodik	Nan
छठी	hatodik	None
छठा	a hatodik	Nan
छठ	chhath	Nan
छः	hat	None
छंदों	a versek	Nan
छंद	a versek	Nan
चौड़ा	széles	None
चौड़ाई	a szélesség	Nan
चौड़ी	széles	None
चौथ	chauth	Nan
चौथा	a negyedik	Nan
चौथाई	negyed	None
छह	hat	None
चौथी	negyedik	None
चौदह	tizennégy	None
चौधरी	chaudhary	Nan
चौबीस	huszonnégy	Nan
चौरासी	nyolcvannégy	Nan
चौहान	chauhan	Nan
च्हिन	chhin	Nan
चौथे	negyedik	None
छाछ	író	None
छात्र	diák	None
छात्रवृत्ति	ösztöndíj	Nan
छूती	érintések	Nan
छूने	megérinteni	Nan
छेद	a lyuk	Nan
छोटासा	kis	None
छोटी	kicsi	None
छोटीछोटी	kicsi	None
छूट	engedmény	Nan
छोटे	kicsi	None
छोड	hagyja	None
छोड़	elhagy	Nan
छोड़ते	kilépő	Nan
छोड़ने	kilépő	Nan
छोड़ा	bal	None
छोड़ी	bal	None
छोटेबड़े	idősek és fiatalok	Nan
चौकी	posta	Nan
छुपे	rejtett	None
छुपा	rejtett	None
छात्रों	a diákok	Nan
छानकर	szűrés után	Nan
छाया	árnyék	Nan
छायावाद	shadowism	Nan
छायावादी	operatőr	Nan
छाल	a kéreg	Nan
छुपाने	elbújni	Nan
छावनी	szálláskörzet	Nan
छिप	rejtett	None
छिपा	rejtett	None
छीन	megragad	Nan
छुटकारा	megkönnyebbülés	Nan
छुट्टियों	az ünnepek	Nan
छुट्टी	ünnep	None
छिद्रों	vents	Nan
चौक	a tér	Nan
चोरी	lopás	Nan
चोपड़ा	chopra	Nan
चिली	chile	None
चिश्ती	chishti	Nan
चिह्नित	megjelölt	Nan
चिह्नों	jelölések	None
चींटी	a hangya	Nan
चीज	dolog	None
चिरायता	salicy	Nan
चीज़	dolog	None
चीजें	dolgok	None
चीजों	dolgok	None
चीन	kína	None
चीफ	fő	None
चुंबकिय	mágnes	Nan
चुंबकीय	mágneses	None
चीज़ों	dolgok	None
चुकी	befejezett	None
चिरहरित	jelöletlen	Nan
चिन्हित	megjelölt	Nan
चित्रकला	a festés	Nan
चित्रकार	a festő	Nan
चित्रकारी	festmény	None
चित्रकूट	chitrakoot	Nan
चित्रण	ábra	Nan
चित्रलिपि	hieroglifa	Nan
चिप	a chip	Nan
चित्रा	chitra	Nan
चित्रांगद	chitrangad	Nan
चित्रित	festett	None
चित्रों	a képek	Nan
चिन्तन	gondolkodás	None
चिन्ता	gondoskodás	Nan
चिन्ह	szimbólum	None
चित्रांकन	rajz	Nan
छोर	a végek	Nan
चुके	volt	None
चुनकर	a választással	Nan
चेतावनी	figyelem	Nan
चेन्नई	chennai	Nan
चेष्टा	erőfeszítés	Nan
चेष्टाओं	erőfeszítések	Nan
चेहरा	arc	Nan
चैतन्य	csaitanja	Nan
चेतना	öntudat	Nan
चैत्र	chaitra	Nan
चैनलों	csatornák	None
चैम्पियनशिप	a bajnokság	Nan
चॉकलेट	csokoládé	Nan
चोटियाँ	peaks	Nan
चोटियों	a csúcsok	Nan
चोटी	a csúcs	Nan
चैनल	csatorna	None
चुन	chun	Nan
चेचक	bárányhimlő	Nan
चूर्ण	por	None
चुनते	választ	None
चुना	válaszd	Nan
चुनाव	választás	None
चुनावी	választás	None
चुनावों	választások	None
चुनी	választott	None
चेक	jelölje be	Nan
चुने	választ	None
चुपचाप	csendben	Nan
चूँकि	mivel	None
चूंकि	mivel	None
चूका	nem fogadott	Nan
चूड़ी	karperec	Nan
चूना	mész	Nan
चुपके	lopakodás	Nan
चित्र	kép	None
ज	j	Nan
जंग	rozsda	Nan
जलन	féltékenység	Nan
जलधारा	folyam	Nan
जलती	égő	Nan
जल	víz	None
जर्मेनियम	germánium	Nan
जर्मनी	németország	None
जर्मनिक	germán	None
जर्मन	német	None
जर्नल	a folyóirat	Nan
जरूरी	szükséges	None
जरूरत	annak szükségességét	Nan
जरूर	természetesen	None
जरुरी	kell	None
जरुरत	szükség	None
जरिये	útján	None
जरिए	keresztül	None
जरा	éppen	None
जमाव	beállítás	Nan
जमीन	föld	None
जमीनी	a föld	Nan
जम्बूद्वीप	jambudweep	Nan
जम्मू	dzsammu	Nan
जय	jai	Nan
जलने	égő	Nan
जयंती	jubileum	Nan
जयदेव	jaidev	Nan
जयपुर	jaipur	Nan
जयप्रकाश	jai prakash	Nan
जयशंकर	jaishankar	Nan
जयसिंह	jaisingh	Nan
जया	jaya	Nan
जयचंद	jaychand	Nan
जलमण्डल	hidroszféra	Nan
जलवायु	éghajlat	None
जलविमान	víz kézműves	Nan
जस्ता	cink	Nan
जहर	méreg	Nan
जहाँ	ahol	None
जहाँगीर	jahangir	Nan
जहां	ahol	None
जहाज	hajó	None
जश्न	ünnepel	Nan
जहाजों	a hajók	Nan
ज़फ़र	zafar	Nan
ज़मीन	a föld	Nan
ज़रूर	biztos	None
ज़रूरत	szükség	None
ज़रूरी	szükséges	None
ज़िक्र	említett	None
ज़कात	zakát	Nan
जमाने	korszak	None
जवाहरलाल	dzsavaharlal	Nan
जवाब	válasz	None
जला	éget	Nan
जलाई	megvilágított	Nan
जलाकर	fáklyák	Nan
जलाने	meggyújt	Nan
जलापूर्ति	vízellátás	Nan
जलाया	világít	Nan
जवाहर	jawahar	Nan
जलालुद्दीन	jalaluddin	Nan
जलियांवाला	jallianwala	Nan
जलीय	vízi	None
जल्द	hamar	None
जल्दी	hamar	None
जवान	fiatal	None
जवानी	ifjúság	None
जलाशय	rezervoár	Nan
जमा	letét	Nan
जमशेदपुर	jamshedpur	Nan
जम	szilárd	None
जटायु	jatayu	Nan
जटिल	összetett	None
जड़	a gyökér	Nan
जड़े	gyökér	Nan
जड़ें	a gyökerek	Nan
जताई	kifejezve	Nan
जज	bíró	Nan
जन	emberek	None
जनगणना	népszámlálás	None
जनजाति	a törzs	Nan
जनजातियों	tribes	Nan
जनजीवन	élet	None
जनता	nyilvános	None
जनन	generáció	Nan
जनक	szülő	Nan
जननांग	reproduktív szerv	Nan
जगहों	helyek	None
जगन्नाथ	dzsagannáth	Nan
जंगल	erdő	None
जंगली	vad	None
जंगलों	az erdők	Nan
जंघा	comb	Nan
जंतु	teremtmény	Nan
जंतुओं	állatok	None
जगह	hely	None
जंबुद्वीप	jambudweep	Nan
जगजीत	jagjit	Nan
जगत	az univerzum	Nan
जगत्	a világ	Nan
जगत्‌	világ	None
जगदीश	jagdish	Nan
जगद्गुरु	jagadguru	Nan
जग	világ	None
जंक्शन	a csomópont	Nan
जननी	anya	None
जनभाषा	nyilvános nyelv	Nan
जन्मदिन	születésnap	Nan
जन्मस्थान	születési hely	Nan
जन्माष्टमी	janmashtami	Nan
जन्मी	született	None
जन्मे	született	None
जन्मों	élettartamok	Nan
जन्म	születés	None
जन्‍म	születés	None
जफर	zafar	Nan
जब	amikor	None
जबकि	mivel	None
जबरन	erővel	None
जबाव	válasz	None
जब्त	beszorult	Nan
जप	kántálás	Nan
जनपद	kerület	None
जन्तुओं	állatok	None
जनों	emberek	None
जनम	születés	None
जनमत	közvélemény	None
जनमानस	nyilvános	None
जनरल	tábornok	None
जनवरी	január	None
जनवरीमार्च	január március	Nan
जन्तु	állat	None
जनवादी	a populista	Nan
जनसंख्या	népesség	None
जनसंघ	tömeg	None
जनसांख्यिकी	demográfia	Nan
जनसाधारण	tömegek	None
जनहित	közérdek	Nan
जनित	kivált	Nan
जनसँख्या	népesség	None
ज़िम्मेदारी	a felelősség	Nan
चित्त	ész	None
चिड़ियाघर	állatkert	None
ग्लूकोज	szőlőcukor	Nan
ग्लाइकोलिसिस	glikolízis	Nan
ग्रैंड	nagy	None
ग्रेनाइट	gránit	None
ग्रेट	nagy	None
ग्रेगोरी	gregory	Nan
ग्रुप	csoport	None
ग्रीस	görögország	None
ग्रीष्मकालीन	nyár	None
ग्रीष्म	nyár	None
ग्रीवा	méhnyak	Nan
ग्रीनहाउस	üvegház	Nan
ग्रीन	zöld	None
ग्रीक	görög	None
ग्रिगोरियन	grigorian	Nan
ग्राह्य	választható	Nan
ग्राही	receiver	Nan
ग्रंथों	a szövegek	Nan
ग्रन्थ	szöveg	None
ग्रन्थसूची	bibliográfia	None
ग्रन्थों	szövegek	Nan
ग्रस्त	szenvedni	Nan
ग्रहण	fogyatkozás	Nan
ग्लेशियर	gleccser	Nan
ग्रहों	bolygók	None
ग्राफिक	grafikus	None
ग्राम	gramm	Nan
ग्रामीण	vidéki	None
ग्राहक	vevő	None
ग्राहकों	a vásárlók	Nan
ग्राहम	graham	None
ग्राउंड	talaj	None
ग्लोबल	globális	None
ग्वालियर	gwalior	Nan
घ	d	None
घनी	vastag	None
घने	sűrű	None
घर	ház	None
घराने	gharana	Nan
घरेलु	itthon	None
घरेलू	a háztartás	Nan
घनिष्ठ	bezárás	Nan
घरों	a házak	Nan
घाघरा	szoknya	Nan
घाट	a móló	Nan
घाटियों	a völgyek	Nan
घाटी	a völgy	Nan
घाटों	ghátok	Nan
घातक	halálos	None
घर्षण	súrlódás	Nan
ग्रंथियों	nyálmirigyek	Nan
घनत्व	a sűrűség	Nan
घटित	történt	None
घंटा	harang	Nan
घंटी	a csengő	Nan
घंटे	órák	None
घंटों	órák	None
घटक	az összetevő	Nan
घटकों	az alkatrészek	Nan
घड़ी	az óra	Nan
घटती	csökkenő	None
घटनाएँ	az események	Nan
घटनाएं	események	None
घटनाओं	események	None
घटनाक्रम	események	None
घटनायें	az események	Nan
घटने	csökkenő	None
घटना	incidens	Nan
ग्रंथि	mirigy	Nan
ग्यास्त्रोएन्टेरोलोजी	gyastroenterology	Nan
ग्यारहवीं	tizenegyedik	Nan
गेहूं	búza	None
गैंगलिया	ganglionok	Nan
गैर	nem	None
गैलरी	képtár	None
गैलीलियो	galileo	None
गैस	a gáz	Nan
गेहूँ	búza	None
गैसें	a gázok	Nan
गोआ	goa	Nan
गोएंका	goenka	Nan
गोकुल	gokul	Nan
गोजर	százlábú	Nan
गोड	isten	None
गोडसे	godse	Nan
गैसों	gázok	None
गोत्र	törzs	None
गेलिक	kelta	None
गेट्स	gates	Nan
गुर्दे	vese	None
गुलाब	rózsa	None
गुलाबी	rózsa	None
गुलाम	rabszolgák	None
गुलामी	rabszolgaság	Nan
गुस्सा	harag	Nan
गेम	játszma, meccs	Nan
गूगल	google	None
गृह	itthon	None
गृहस्थ	családfő	Nan
गेंद	a labda	Nan
गेंदबाजी	bowling	Nan
गेज	nyomtáv	Nan
गेट	kapu	None
गूजरी	gujari	Nan
घायल	sérült	None
गोद	öl	Nan
गोदावरी	godavari	Nan
गोले	kagyló	Nan
गोल्ड	arany	None
गोल्फ	golf	Nan
गोवर्धन	kormányzati	None
गोवा	goa	Nan
गोविंद	govind	Nan
गोलीबारी	kiütéses	Nan
गोविन्द	govind	Nan
गोस्वामी	goswami	Nan
गौड़	gaur	Nan
गौण	másodlagos	None
गौतम	gautam	Nan
गौरव	büszkeség	Nan
गौरी	gauri	Nan
गोस्पेल	evangélium	Nan
गोदान	godan	Nan
गोली	gun shot	Nan
गोलाकार	kerek forma	Nan
गोपनीयता	magánélet	Nan
गोपाल	gopal	Nan
गोबर	tehénszar	Nan
गोबिंदराय	gobindarai	Nan
गोबिन्द	govind	Nan
गोमती	gomti	Nan
गोलार्द्ध	félteke	Nan
गोयल	goyal	Nan
गोरखपुरी	gorakhpur	Nan
गोरखा	gurkha	Nan
गोरी	szőke	None
गोल	a cél	Nan
गोलक	golak	Nan
गोलकुंडा	golconda	Nan
गोरखपुर	gorakhpur	Nan
चिता	halotti máglya	Nan
घास	fű	Nan
घिरे	körülvett	Nan
चांद	a hold	Nan
चांडाल	chandal	Nan
चाँदी	ezüst	None
चाँद	hold	None
चलो	gyerünk	Nan
चले	gyerünk	Nan
चली	tartott	None
चलाये	hajtás	Nan
चलाया	hajtott, vezetett	Nan
चलाने	fuss	Nan
चलाना	hajtás	Nan
चलाते	fuss	Nan
चलाता	fut	None
चलाए	hajtott, vezetett	Nan
चला	sétált	Nan
चलने	walking	Nan
चलना	járni	None
चरित	karakter	None
चरित्र	karakter	None
चरों	a változók	Nan
चर्च	templom	None
चर्चा	vita	None
चर्चित	forró	None
चांदी	ezüst	None
चर्म	bőr	None
चल	séta	Nan
चलकर	később	None
चलचित्र	filmek	None
चलता	séták	Nan
चलती	mozgó	None
चलन	gyakorlat	None
चर्मरोग	bőrgyulladás	Nan
चाइना	kína	None
चाचा	nagybácsi	Nan
चाणक्य	chanakya	Nan
चाहने	loves	Nan
चाहा	wills	Nan
चाहिए	szükséges	None
चाहिये	akar	None
चाहे	még akkor is, ha	Nan
चाहें	szeretnék	Nan
चाहते	akar	None
चिंतन	aggodalmak	Nan
चिकित्सक	az orvos	Nan
चिकित्सकीय	fog	None
चिकित्सकों	orvosok	None
चिकित्सा	kezelés	None
चिकित्सीय	gyógyászati	Nan
चिट्ठे	blog	None
चिकन	csirke	Nan
चरमोत्कर्ष	tetőpont	Nan
चाहती	akar	None
चावल	rizs	None
चाप	ív	Nan
चाय	tea	None
चार	négy	None
चारा	takarmány	Nan
चारो	mindenfelé	Nan
चारों	mind a négy	Nan
चाहता	kívánatos	Nan
चार्ज	díj	None
चार्ल्स	károly	None
चाल	trükk	Nan
चालक	sofőr	Nan
चालित	hajtott	None
चालीस	negyven	None
चालू	tovább	None
चार्टर	különjárat	Nan
चरमआनंद	rendkívüli öröm	Nan
चरम	szélső	None
चरणों	a lépések	Nan
ङ	4	Nan
चंडी	chandi	Nan
चंडीगढ़	csandígarh	Nan
चंदन	szantálfa	Nan
चंद्र	chandra	Nan
चंद्रगुप्त	chandragupta	Nan
घोसला	ghosla	Nan
चंद्रमा	hold	None
चंद्रयान	chandrayaan	Nan
चकित	meglepődött	Nan
चक्कर	ügy	None
चक्र	kerék	Nan
चक्रवर्ती	chakravarthy	Nan
चक्रवात	ciklon	Nan
चंद्रमास	holdhónap	Nan
चचेरे	unokatestvér	Nan
घोषित	bevallott	Nan
घोष	ghosh	Nan
घी	ghee	Nan
घुटनों	térd	Nan
घुड़सवार	lovas	None
घुसपैठ	beszivárgás	Nan
घूम	kóborol	Nan
घूमते	kóborol	Nan
घोषणा	nyilatkozat	None
घूमने	kóborol	Nan
घृत	olvasztott vaj	Nan
घेघा	a nyelőcső	Nan
घेरे	körülvesz	Nan
घोड़ा	ló	None
घोड़े	a lovak	Nan
घोड़ों	lovak	None
घूर्णन	forgás	Nan
घिरा	körülvett	Nan
चट्टानों	a sziklák	Nan
चढ़	felmászott	Nan
चमकीले	fényesen	Nan
चमड़ा	bőr	None
चमड़ी	skinned	Nan
चमड़े	bőr	None
चमत्कार	csoda	None
चमत्कारिक	csoda	None
चबूतरे	pops	Nan
चमोली	chamoli	Nan
चम्मच	kanál	Nan
चयन	a választék	Nan
चयनात्मक	szelektív	Nan
चयनित	kiválasztott	None
चरक	charak	Nan
चरण	a színpad	Nan
चम्बल	chambal	Nan
चट्टोपाध्याय	chattopadhyay	Nan
चन्द्रशेखर	chandrashekhar	Nan
चन्द्रमा	a hold	Nan
चढ़ने	mászni	Nan
चढ़ा	bedeszkázott	Nan
चढ़ाई	mászik	Nan
चढ़ाना	galvanizálás	Nan
चढ़ाने	galvanizálás	Nan
चढ़ाया	aranyozott	Nan
चन्द्रराव	chandrarao	Nan
चतुर	okos	Nan
चतुर्थी	chaturthi	Nan
चतुर्भुज	négyszög	Nan
चतुर्वेदी	chaturvedi	Nan
चन्द	a hold	Nan
चन्द्र	chandra	Nan
चन्द्रगुप्त	chandra gupta	Nan
चतुर्थ	a negyedik	Nan
तेलुगू	telugu	Nan
ज़ोन	a zóna	Nan
ज़्यादा	több	None
डॉट	pont	None
डॉग	kutya	None
डॉक्टरों	az orvosok	Nan
डॉ	dr	None
डैनिश	dán	None
डेस्कटॉप	az asztalon	Nan
डेविडसन	davidson	Nan
डेविड	david	None
डेल्टा	delta	Nan
डेली	napi	None
डेनिस	denise	Nan
डेनमार्क	dánia	None
डेढ़	másfél	None
डेटाबेस	az adatbázis	Nan
डेटा	az adat	Nan
डे	nap	None
डीसी	dc	None
डिजाइन	tervezés	Nan
डिजाईन	tervezés	Nan
डिजिटल	digitális	None
डिजीटल	digitális	None
डिपो	raktár	Nan
डिलीवरी	kézbesítés	Nan
डॉन	don	None
डिवाइस	eszköz	None
डिस्क	lemez	None
डी	d	None
डीजल	dízel	Nan
डीडी	dd	Nan
डीडीटी	ddt	Nan
डीवीडी	dvd	None
डिवीजन	osztály	None
डॉलर	dollár	None
डॉ०	dr.	Nan
डोम	kupola	Nan
तंत्रिकाओं	idegek	Nan
तंबाकू	dohány	None
तकनीक	technika	None
तकनीकी	technológia	None
तकनीकें	technikák	None
तकनीकों	technikák	None
तंत्रिका	ideg	Nan
तकिया	párna	Nan
तक्षशिला	takshshila	Nan
तख्त	ülés	Nan
तट	tengerpart	None
तटरक्षक	parti őr	Nan
तटवर्ती	szárazföldi	None
तटीय	parti	None
तकियाः	párna	Nan
डिज़ाइन	a dizájn	Nan
तंत्र	tantra	Nan
ण	hitel	None
ड्राइव	hajtás	Nan
ड्राईव	hajtás	Nan
ढंग	viselkedés	None
ढक	borító	None
ढका	fedett	None
ढ़	fél	None
तंग	szoros	None
ढाँचे	a keret	Nan
ढांचे	a szerkezet	Nan
ढाका	dhaka	Nan
ढाल	pajzs	None
ढीले	laza	None
ढूंढ	megtalálja	Nan
ढेर	halom	Nan
ढांचा	a keret	Nan
डिग्री	fokozat	None
डिक्शनरी	szótár	None
डालो	put	Nan
ट्यूब	cső	Nan
ट्यूमर	tumor	Nan
ट्रस्ट	bizalom	Nan
ट्रान्सफार्मर	transzformátor	None
ट्रान्समिटर	adó	None
ट्राम	villamos	None
टोपे	közönséges kutyacápa	Nan
ट्रिनिटी	szentháromság	Nan
ट्रिमस्टर	trimster	Nan
ट्रेड	kereskedelmi	None
ट्रेन	vonat	Nan
ट्वेंटी	húsz	None
ठंड	hideg	None
ठंडा	hideg	None
ट्रिब्यून	tribunus	Nan
ठंडी	hideg	None
टोपी	kalap	Nan
टोकामाक	tokamakon	Nan
टेक्स्ट	szöveg	None
टेनिस	tenisz	None
टेरेसा	teresa	Nan
टेलर	szabó	None
टेलिविज़न	televízió	None
टेलीफोन	telefon	None
टोक्यो	tokyo	Nan
टेलीविजन	televízió	None
टैंक	a tank	Nan
टैक्सी	a fülke	Nan
टैग	a címke	Nan
टैगोर	tagore	Nan
टैबीरियस	tabarius	Nan
टॉवर	a torony	Nan
टेस्ट	teszt	None
तत्काल	azonnali	None
ठंडे	hideg	None
ठाकुर	nemesember	Nan
डाक	hozzászólások	Nan
डाक्टर	orvos	None
डाट	dugó	Nan
डाटा	adat	None
डाटाबेस	adatbázis	Nan
डाल	ág	None
डाउनलोड	letöltés	Nan
डालकर	azáltal, hogy	Nan
डालती	helyezi	None
डालते	put	Nan
डालने	insert	Nan
डालर	dollár	None
डाला	put	Nan
डाली	ág	None
डालता	helyezi	None
ठाकरे	thackeray	Nan
डाई	festék	Nan
डाइआक्साइड	dioxid	Nan
ठाणे	főúr	Nan
ठीक	bírság	Nan
ठेठ	a tipikus	Nan
ठोकर	botlás	Nan
ठोस	szilárd	None
ड	d	None
डाइऑक्साइड	dioxid	Nan
डकैती	rablás	Nan
डबल्यू	w	Nan
डब्लू	w	Nan
डर	félelem	None
डहेलिया	dália	Nan
ड़	e	Nan
डा	dr	None
डगलस	douglas	None
टेक्सास	texas	None
तत्कालीन	egyidejű	Nan
तत्पश्चात	azután	None
तुमने	ön	None
तुगलक	tughlaq	Nan
तु	ön	None
तीसरे	harmadik	None
तीसरी	a harmadik	Nan
तीसरा	a harmadik	Nan
तीस	harminc	None
तीव्रता	az intenzitás	Nan
तीव्र	erős	None
तीर्थों	zarándoklatok	Nan
तीर्थस्थान	ereklyetartó	Nan
तीर्थस्थल	szent zarándoklat	Nan
तीर्थयात्री	zarándok	Nan
तीर्थयात्रियों	zarándokok	Nan
तीर्थयात्रा	zarándoklat	Nan
तीर्थ	zarándoklat	Nan
तीर	nyíl	Nan
तिथि	dátum	None
तिब्बत	tibet	Nan
तिरंगा	trikolór	Nan
तिरंगे	trikolór	Nan
तिरुपति	tirupati	Nan
तिरुमला	tirumala	Nan
तुमसे	tőled	Nan
तिल	anyajegy	Nan
तिल्ली	lép	None
तिवारी	tiwari	Nan
तिहाई	harmadik	None
तीन	három	None
तीनो	mindhárom	None
तीनों	mindhárom	None
तिलक	tilak	Nan
तुमि	ön	None
तुम्हारा	a tiéd	Nan
तुम्हारे	a te	Nan
तेंडुलकर	tendulkar	Nan
तेंदुलकर	tendulkar	Nan
तेग	kétéves bárány	Nan
तेज	gyors	None
तेजस्वी	megdöbbentő	Nan
तेज़	gyors	None
ते	te	None
तेज़ी	sebesség	None
तेरह	tizenhárom	None
तेरहवीं	tizenharmadik	Nan
तेरा	a te	Nan
तेरी	a te	Nan
तेरे	a te	Nan
तेल	olaj	None
तेजी	gyors	None
तालिका	az asztal	Nan
तृतीया	harmadik	None
तृतीय	harmadik	None
तुम्हें	neked	Nan
तुरंत	azonnal	None
तुरन्त	azonnal	None
तुर्क	török	None
तुर्की	pulyka	Nan
तुलना	összehasonlítás	Nan
तृतीयक	harmadlagos	Nan
तुलनात्मक	összehasonlító	Nan
तुलसीदास	tulsidas	Nan
तुल्य	egyenértékű	Nan
तू	ön	None
तूने	ön	None
तूफ़ान	a vihar	Nan
तूफान	vihar	None
तुलसी	bazsalikom	Nan
तालाब	tavacska	Nan
तालव्य	ritmus	Nan
तालमेल	synergy	Nan
तमाम	összes	None
तमिल	tamil	Nan
तम्बाकू	dohány	None
तय	döntsd el	Nan
तरंग	a hullám	Nan
तरंगों	hullámok	None
तभी	csak akkor	Nan
तरफ़	oldalán	None
तरह	kedves	None
तरहतरह	olyasmi	Nan
तराई	alföld	None
तरीके	módokon	Nan
तरीकों	mód	None
तर्क	érv	Nan
तरल	folyékony	None
तर्कसंगत	racionális	None
तबला	tabla	Nan
तपस्या	a megszorító	Nan
तत्पश्चात्	ezután	None
तत्व	elem	None
तत्वमीमांसा	metafizika	None
तत्वों	az elemek	Nan
तथाकथित	az úgynevezett	Nan
तथापि	azonban	None
तब	azután	None
तथ्य	tény	None
तन	test	None
तना	a szár	Nan
तनाव	feszültség	None
तने	a szár	Nan
तन्त्र	rendszer	None
तप	kitartás	Nan
तथ्यों	a tények	Nan
तत्त्व	elem	None
तर्कों	érvek	Nan
तलवार	kard	None
तानसेन	tansen	Nan
ताप	hőség	Nan
तापक्रम	hőfok	Nan
तापमान	hőfok	Nan
ताम्र	réz	None
तार	huzal	Nan
तात्या	tatya	Nan
तारा	csillag	None
तारामंडल	planetárium	Nan
तारीख	dátum	None
तारीख़	dátum	None
तारों	vezeték	None
तार्किक	logikus	Nan
ताल	ritmus	Nan
ताराभौतिकी	asztrofizika	Nan
तल	a padló	Nan
तात्पर्य	jelentés	None
ताजा	friss	None
तलाश	keresés	Nan
तव	üveggolyó	Nan
तस्वीर	fénykép	Nan
तस्वीरें	a képek	Nan
तस्वीरों	a képek	Nan
तहत	alatt	None
तात्कालिक	rögtönzött	Nan
तहसील	tehsil	Nan
तांबे	réz	None
ताइवान	taiwan	Nan
ताकत	az erő	Nan
ताकि	szóval	None
ताज	korona	None
ताजमहल	taj mahal	Nan
तांबा	réz	None
ज़ोर	a hangsúly	Nan
टेक्नालजी	technológia	None
टूटे	törött	Nan
जिसने	akárki	Nan
जिसको	kinek	None
जिसके	akinek	None
जिसकी	akinek	None
जिसका	akinek	None
जिस	jis	Nan
जिलों	kerületek	None
जिले	a kerület	Nan
जिला	kerület	None
जिम्मेदारी	a felelősség	Nan
जिम्मेदार	felelős	None
जिन्होने	who	None
जिन्होंने	who	None
जिन्हें	kit	None
जिन्हे	kit	None
जिन्ना	jinnah	Nan
जिन्दगी	élet	None
जावास्क्रिप्ट	javascript	Nan
जाहिर	magától értetődően	Nan
जिंदगी	élet	None
जिक्र	említés	Nan
जिज्ञासा	kíváncsiság	Nan
जितना	annyira, mint	Nan
जिसपर	amelyen	None
जितनी	annyira, mint	Nan
जिनका	akinek	None
जिनकी	akinek	None
जिनको	kit	None
जिनमे	amiben	None
जिनमें	amiben	None
जिनसे	kitől	Nan
जिन	gin	Nan
जिसमे	amiben	None
जिसमें	amiben	None
जिससे	amellyel	None
जीवन	élet	None
जीवनकाल	élettartam	None
जीवनशैली	életmód	None
जीवनी	életrajz	None
जीवविज्ञान	a biológia	Nan
जीवाणु	baktériumok	None
जीवधारियों	élőlények	None
जीवाणुओं	baktériumok	None
जीविका	megélhetés	Nan
जीवित	élő	None
जीवों	a lények	Nan
जुटाने	emelés	Nan
जुड़	csatlakozik	None
जुड़ा	csatlakoztatva	Nan
जीवाश्म	ősmaradványok	Nan
जावा	jáva	Nan
जीवंत	élénk	None
जीमेल	gmail	None
जिसे	kit	None
जी	igen	None
जीएसएम	gsm	Nan
जीडीपी	gdp	None
जीत	győzelem	None
जीतने	győzelem	None
जीव	lények	None
जीते	élő	None
जीना	élő	None
जीने	élni	None
जीनों	gének	None
जीनोम	a genom	Nan
जीनोमिक	genomikai	Nan
जीपीएस	gps	Nan
जीन	jean	None
जाली	kovácsolt	Nan
जालस्थल	weboldal	None
जालपृष्ठ	honlap	None
जाट	jats	Nan
जाड़े	téli	None
जातक	anyanyelvi	Nan
जातकों	az őslakosok	Nan
जाता	megy	None
जाति	öntvény	Nan
जाग्रत	ébren	Nan
जातियाँ	kasztok	Nan
जातियों	kasztok	Nan
जाती	kaszt	Nan
जातीं	elmegy	None
जातीय	etnikai	None
जाते	megy	None
जादुई	mágikus	None
जातियां	kasztok	Nan
जादूगर	a varázsló	Nan
जागृति	ébredés	Nan
जागरूकता	tudatosság	Nan
ज़्यादातर	többnyire	None
जा	megy	None
जाँच	a nyomozás	Nan
जांघों	combok	Nan
जांच	az ellenőrzés	Nan
जाए	megy	None
जागृत	ébren	Nan
जाएँ	megy	None
जाएंगे	fog menni	Nan
जाएगा	fog menni	Nan
जाएगी	fog menni	Nan
जाओ	megy	None
जाकर	megy	None
जागरण	ébredés	Nan
जाएं	megy	None
जुड़ी	csatlakoztatva	Nan
जान	élet	None
जानकारियाँ	információ	None
जापानी	japani	Nan
जाम	lekvár	Nan
जामा	jama	Nan
जाय	jai	Nan
जाया	jaya	Nan
जाये	megy	None
जाप	ének	None
जायें	menj	Nan
जायेगा	fog menni	Nan
जायेगी	fog menni	Nan
जार्ज	györgy	None
जाल	a csapda	Nan
जालंधर	jalandhar	Nan
जालघर	csapda ház	Nan
जायेंगे	akarat	None
जानकर	ismerve	Nan
जानेवाले	kimenő	Nan
जानें	tanul	Nan
जानकारियां	információ	None
जानकारी	információ	None
जानकी	janaki	Nan
जानता	tudja	None
जानती	tud	None
जानते	tud	None
जानेवाली	kimenő	Nan
जानना	tudni	None
जानबूझकर	szándékosan	None
जानवर	állat	None
जानवरों	állatok	None
जाना	megy	None
जानी	jani	Nan
जाने	tud	None
जानने	ismerve	Nan
टूलकिट	toolkit	Nan
जुड़े	csatlakoztatva	Nan
जुडी	judit	None
टर्बाइन	turbina	Nan
टर्की	pulyka	Nan
टमाटर	paradicsom	None
टन	tonna	Nan
टकसाल	menta	Nan
टकराने	összeütközik	Nan
ट	t	Nan
ञ	j	Nan
झेलम	jhelum	Nan
झूठे	a hazugok	Nan
झूठ	fekszik	None
झुकाव	billenés	Nan
झुकाया	meghajolt	Nan
झुका	hajlított	Nan
झुंड	csorda	Nan
झीलों	a tavak	Nan
झीलें	a tavak	Nan
ज्वालामुखी	vulkán	None
ज्‍योतिष	csillagjóslás	Nan
झ	jh	Nan
झंडा	a zászló	Nan
झंडे	a zászló	Nan
झंडों	a zászlók	Nan
टर्मिनल	a terminál	Nan
झटके	tremors	Nan
झा	jha	Nan
झाँसी	jhansi	Nan
झांसी	jhansi	Nan
झारखंड	dzshárkhand	Nan
झींगा	garnélarák	Nan
झील	tó	None
झलक	megpillant	Nan
टर्मिनस	végállomás	Nan
टांगे	legs	Nan
टांगों	legs	Nan
टीकाटिप्पणी	kommentár	Nan
टीके	védőoltások	Nan
टीकों	védőoltások	Nan
टीपू	tipu	Nan
टीम	csapat	None
टीमें	a csapatok	Nan
टीकाकरण	oltás	None
टीमों	a csapatok	Nan
टुकड़े	a darabok	Nan
टू	kettő	None
टूट	szünet	None
टूटने	bontás	Nan
टूटा	törött	Nan
टूटी	törött	Nan
टीले	bucka	Nan
ज्वाला	láng	Nan
टीका	oltás	None
टिहरी	tehri	Nan
टाइगर	tigris	None
टाइप	típus	None
टाइपिंग	gépelés	Nan
टाइम	idő	None
टाइम्स	times	Nan
टाउन	város	None
टी	t	Nan
टाटा	viszlát	Nan
टापू	sziget	None
टाल	elkerülése	None
टिकट	jegy	Nan
टिन	ón	Nan
टिप्पणियों	megfigyelések	None
टिप्पणी	megjegyzés	None
टाटानगर	tatanagar	Nan
ज्वार	láz	None
ज्वर	láz	None
ज्योतिषीय	asztrológiai	Nan
जैन	jain	Nan
जैनेंद्र	jainendra	Nan
जैनेन्द्र	jainendra	Nan
जैब	döf	Nan
जैबुन्निसा	jabunnisa	Nan
जैव	bio	Nan
जैतून	olajbogyó	Nan
जैवमण्डल	bioszféra	Nan
जैसा	mint	None
जैसी	mint	None
जैसे	mint	None
जॉन	jános	None
जॉर्ज	györgy	None
जो	hogy	None
जैविक	organikus	Nan
जोकि	ami	None
जैक्सन	jackson	None
जेसे	tetszik	None
जुडे	csatlakozik	None
जुताई	művelés	Nan
जुमेरह	jumeirah	Nan
जुर्माना	büntetés	None
जुलाई	július	None
जुलाईसितंबर	július szeptember	Nan
जैक	jack	None
जुलु	julu	Nan
जूते	a cipők	Nan
जून	június	None
जूनियर	beosztott	Nan
जे	j	Nan
जेबेल	jebel	Nan
जेम्स	james	None
जुलूस	a felvonulás	Nan
जुडा	csatlakozik	None
जोखिम	a kockázat	Nan
जोड़	az ízület	Nan
ज्ञात	ismert	None
ज्ञाता	jól informált	Nan
ज्ञान	tudás	None
ज्ञानपीठ	jnanpith	Nan
ज्ञानविज्ञान	tudástudomány	Nan
ज्ञानामृतम्	gyanamritam	Nan
जौनपुर	jaunpur	Nan
ज्यादा	több	None
ज्यामितीय	geometriai	None
ज्यों	mint	None
ज्योति	fény	None
ज्योतिर्लिङ्ग	jyotirling	Nan
ज्योतिष	csillagjóslás	Nan
ज्योतिषी	csillagjós	Nan
ज्यादातर	többnyire	None
जोडने	hozzáadni	Nan
जौ	árpa	Nan
जोशी	joshi	Nan
जोड़कर	hozzáadásával	Nan
जोड़ता	csatlakozik	None
जोड़ती	csatlakozik	None
जोड़ते	csatlakozás	Nan
जोड़ा	a pár	Nan
जोड़ी	pár	None
जोसेफ	joseph	None
जोड़े	párosít	Nan
जोदड़ो	hozzáad	Nan
जोधपुर	jodhpur	Nan
जोन	zóna	None
जोर	hangsúly	None
जोरदार	élénk	None
जोश	szenvedély	Nan
जोड़ों	az ízületek	Nan
‎है	az a	Nan
