$	$	None
मालिश	masaža	Nan
मालिनी	malini	Nan
मालिकों	vlasnici	Nan
मालिकाना	vlasnički	Nan
मालिक	vlasnik	None
माला	garland	Nan
मालदीवज	maldivi	Nan
मालदीव	maldivi	Nan
माल	roba	None
मार्शल	maršal	Nan
मार्मिक	dirljiv	Nan
मार्टिन	martin	None
मार्चअप्रैल	marta aprila	Nan
मार्च	marta	None
मार्गों	rute	Nan
मार्गशीर्ष	glava puta	Nan
मार्गरेट	margaret	Nan
मार	ubiti	None
मारना	ubijanje	Nan
मारने	ubiti	None
मारवाड़	marwar	Nan
मारा	hit	None
मारी	mari	Nan
मालूम	poznat	None
मारीच	marich	Nan
मार्क	mark	None
मार्क्स	marx	None
मार्क्सवाद	marksizam	Nan
मार्क्सवादी	marksistička	Nan
मार्ग	način	None
मार्गदर्शन	uputstvo	Nan
मारे	ubijen	None
माले	muško	Nan
मासिक	mesečno	Nan
मास्टर	majstore	Nan
मिथ्या	lažno	Nan
मिनट	minut	Nan
मिनर्वा	minerva	Nan
मिनी	mini	None
मिर्च	čili	Nan
मिर्ज़ा	mirza	None
मिथुन	blizanci	Nan
मिर्जा	mirza	None
मिलकर	zajedno	None
मिलती	get	Nan
मिलते	vidimo se	Nan
मिलन	milan	None
मिलना	get	Nan
मिलने	upoznati	Nan
मिल	get	Nan
माया	maja	None
मिथिला	mithila	Nan
मित्रों	prijatelji	None
माह	mesec	Nan
माहवारी	menstruacija	Nan
माहौल	atmosfera	None
मिंग	ming	Nan
मिट	izbrisan	Nan
मिटटी	tlo	None
मिथक	mit	None
मिटा	obriši	Nan
मिट्टी	tlo	None
मिठाई	slatko	Nan
मिडिया	mediji	None
मित्तल	mittal	Nan
मित्र	prijatelju	Nan
मित्रता	prijateljstvo	Nan
मिटाने	obriši	Nan
मिला	upoznali	Nan
मायनों	sporadično	Nan
मामूली	maloljetna	Nan
माध्यमिक	sekundarni	None
माधुर्य	melodija	Nan
माधुरी	madhuri	Nan
माधव	madhav	Nan
मादा	žensko	Nan
मादक	opijeno	Nan
माथे	čelo	None
माथुर	sažeo	Nan
मात्रा	količina	None
मात्र	samo	None
मातृभाषा	majka potez	Nan
मातृ	majko	None
मातापिता	majka otac	Nan
माता	majke	None
मातरम्	mataram	Nan
मात	nadmašiti	Nan
माचिस	matchbox	Nan
मांगी	tražio	None
मांगे	mange	Nan
मांस	meso	None
मांसपेशियों	mišići	None
मांसाहारी	ne vegetarijanstvo	Nan
माइक्रो	micro	Nan
माध्यमों	mediji	None
माइक्रोप्रोसेसर	mikroprocesor	Nan
माई	mai	Nan
माउंट	mount	Nan
माउण्ट	mount	Nan
माउन्टबेटन	mountbatten	Nan
माउस	miš	None
माघ	magh	Nan
माइक्रोसॉफ्ट	microsoft	None
मान	vrijednosti	None
मानकीकरण	standardizacija	Nan
मानकीकृत	standardizovano	Nan
मानी	prihvaćeno	Nan
माने	mane	Nan
मानो	kao da	Nan
मान्य	validan	Nan
मान्यता	prepoznavanje	Nan
मान्यताओं	verovanja	Nan
माना	dogovorili	Nan
माप	merenje	Nan
मापने	merenje	Nan
मापा	merjeno	Nan
मामला	stvar	None
मामले	slučajevi	None
मामलों	posao	None
मामा	majka ujak	Nan
मापन	merenje	Nan
मायने	značenje	None
मानसून	monsun	Nan
मानसिंह	čovječe sing	Nan
मानकों	standardi	None
मानचित्र	mapa	None
मानचित्रावली	mapa	None
मानचित्रों	karte	None
मानता	slaže se	Nan
मानती	slažem se	Nan
मानसिक	mentalno	Nan
मानते	razmislite	Nan
मानना	prihvatiti	None
मानव	čovjek	None
मानवता	čovečanstvo	Nan
मानवीय	čovjek	None
मानस	um	Nan
मानसरोवर	mansrovar	Nan
मानद	počasni	Nan
मिलाकर	uključujući	None
मिलान	utakmica	None
मिलाने	shake	Nan
मूल्यों	vrijednosti	None
मूल्यांकन	procena	Nan
मूल्यवान	cenjeno	Nan
मूल्य	vrijednost	None
मूलभूत	osnovni	None
मूलतः	u osnovi	Nan
मूलत	izvorno	None
मूल	originalni	None
मूर्धन्य	sveto	None
मूर्तियों	idoli	Nan
मूर्तियां	skulpture	Nan
मूर्तियाँ	idoli	Nan
मूर्तिकला	skulptura	Nan
मूर्त	opipljiv	Nan
मूर	moore	Nan
मूत्रमार्ग	urethra	Nan
मूत्र	urin	Nan
मुरादाबाद	moradabad	Nan
मुलाकात	sastanak	Nan
मुलायम	meko	Nan
मुश्किल	teško	None
मुसलमान	muslimanski	None
मुसलमानों	muslimani	None
मूसा	mojsije	Nan
मुहब्बत	ljubav	None
मुहाने	usta	None
मुहावरा	idiom	None
मुहावरे	idiomi	Nan
मुहावरों	idiomi	Nan
मुहूर्त	pogodan početak	Nan
मूक	tiho	Nan
मुहम्मद	muhammad	Nan
मृग	antilope	Nan
मृगी	jelen	Nan
मृत	mrtvi	Nan
मेन	glavni	None
मेनन	menon	Nan
मेमोरियल	spomen obilježje	Nan
मेमोरी	memorija	None
मेयर	gradonačelnik	None
मेरा	moj	None
मेट्रो	metro	Nan
मेरूशीर्ष	merkur	Nan
मेल	sličnost	None
मेला	fer	Nan
मेले	fer	Nan
मेवाड	mewad	Nan
मेसोपोटामिया	mezopotamija	Nan
मेहता	mehta	Nan
मेरे	moj	None
मुम्बई	mumbaj	Nan
मेटास्टेसिस	metastaziranje	Nan
मेजर	bojniče	Nan
मृतक	mrtvi	Nan
मृतोत्थान	uskrsnuće	Nan
मृत्यु	smrt	None
मृदा	tlo	None
मे	ja	None
मेँ	ja	None
मेटाबोलिज्म	metabolizam	None
में	in	Nan
मेगस्थनीज	megasteni	Nan
मेघ	oblak	None
मेघदूत	meghdoot	Nan
मेच	utakmica	None
मेजबान	domaćin	None
मेजबानी	hosting	Nan
मेक्सिको	meksiko	None
मुमताज	mumtaz	Nan
मुफ्त	bez troškova	Nan
मुनियों	monasi	Nan
मीथेन	metan	Nan
मीन	ribe	None
मीना	meena	Nan
मीनाक्षी	meenakshi	Nan
मीनार	kula	None
मीराबाई	meera bai	Nan
मीडिया	mediji	None
मील	mi	None
मुंडा	obrijan	Nan
मुंबई	mumbaj	Nan
मुंशी	računovođa	Nan
मुंह	usta	None
मुकदमा	sudski slučaj	Nan
मुकदमे	slučaj	None
मुँह	usta	None
मुकाबला	konkurencija	Nan
मीठे	slatko	Nan
मीट	meso	None
मिलाया	mešovita	Nan
मिली	imam	None
मिलेंगे	upoznat ćemo se	Nan
मिलेगा	će dobiti	Nan
मिलेनियर	milioner	Nan
मिशन	misija	None
मीटर	brojilo	Nan
मिशनरी	misionarski	Nan
मिश्रित	mešovita	Nan
मिसाल	precednik	Nan
मिस्र	egipat	None
मिस्रवासियों	egipćani	None
मिस्रवासी	egipćani	None
मी	m	None
मिश्रण	smjesa	Nan
मांगने	da tražim	Nan
मुकाबले	u poređenju	Nan
मुकेश	mukesh	Nan
मुग़ल	mughal	Nan
मुझको	ja	None
मुझसे	sa mnom	Nan
मुझे	ja	None
मुठभेड़	susret	None
मुताबिक	prema	None
मुगलों	mughals	Nan
मुद्दा	pitanje	None
मुद्दों	problemi	None
मुद्रा	valuta	None
मुद्राओं	valute	None
मुद्रित	štampano	Nan
मुनाफ़िक़	profit	Nan
मुनि	muni	Nan
मुद्दे	pitanja	None
मुकुट	kruna	None
मुगल	mughal	Nan
मुख्यालय	sjedište	None
मुक्त	besplatno	Nan
मुक्ति	sloboda	None
मुख	usta	None
मुखपृष्ठ	naslovna strana	Nan
मुखर	outspoken	Nan
मुखर्जी	mukherjee	Nan
मुख्‍य	glavni	None
मुखिया	glava	None
मुख्यत	uglavnom	None
मुख्यतः	uglavnom	None
मुख्यतया	uglavnom	None
मुख्यधारा	mainstream	Nan
मुख्यमंत्री	glavni ministar	Nan
मुख्यमन्त्री	glavni ministar	Nan
मुख्य	glavni	None
मांग	potražnja	Nan
मां	majko	None
माँगी	potražnja	Nan
मज़बूत	jak	None
मजबूर	bespomoćan	Nan
मजबूत	jak	None
मजनूँ	majnu	Nan
मजदूरी	plata	Nan
मजदूर	radnik	None
मछली	riba	None
मछलियों	ribe	None
मच्छरों	komarci	Nan
मच्छर	komarci	Nan
मगहर	maghar	Nan
मगर	ali	None
मगध	magadh	Nan
मक्खन	puter	Nan
मक्का	kukuruz	None
मकार	makar	Nan
मकानों	kuće	None
मंत्री	ministra	None
मंत्रों	mantras	Nan
मंथन	brainstorm	Nan
मंदिर	hram	None
मंदिरों	hramovi	Nan
मंदी	recesija	Nan
मज्जा	srž	None
मई	maja	None
मकड़ी	pauk	None
मकतौम	maktoum	Nan
मकबरा	mauzolej	Nan
मकबरे	mauzolej	Nan
मकर	jarac	Nan
मकान	kuća	None
मकई	kukuruz	None
मठ	manastir	None
मठों	manastiri	Nan
मणि	mani	Nan
मदिरा	vina	None
मदिरालय	konoba	Nan
मदीना	medina	None
मदुरई	madurai	Nan
मद्रास	madras	Nan
मधुमक्खी	pcela	Nan
मदर	majko	None
मधुमती	madhumati	Nan
मधुर	slatko	Nan
मधुशाला	bar	None
मध्य	sredina	Nan
मध्यकाल	srednjovekovni period	Nan
मध्यकालीन	srednjovekovni	Nan
मध्यपूर्व	srednji istok	Nan
मधुमेह	dijabetes	Nan
मंत्रियों	ministri	None
मदनलाल	madanlal	Nan
मददगार	korisno	Nan
मणिकर्णिका	manikarnika	Nan
मण्डप	paviljon	Nan
मण्डल	odbor	None
मत	glasanje	Nan
मतगणना	prebrojavanje glasova	Nan
मतदाताओं	birači	Nan
मदन	madan	Nan
मतदान	glasanje	Nan
मतानुसार	prema mišljenju	Nan
मतों	glasova	None
मत्स्य	riba	None
मथुरा	mathura	Nan
मद	predmet	None
मदद	pomoć	None
मतभेद	razlika	None
मंत्रिमंडल	kabinet	Nan
मंत्रिपरिषद	vijeće ministara	Nan
मंत्रि	ministar	None
भूषण	grace	Nan
भूस्खलन	klizište	Nan
भृगु	bhrigu	Nan
भेंट	ponuda	None
भेज	pošalji	Nan
भेजना	slanje	None
भूवैज्ञानिक	geolog	Nan
भेजने	slanje	None
भेजे	pošalji	Nan
भेड़	ovce	Nan
भेद	razlikovanje	None
भेदभाव	diskriminacija	Nan
भेष	prerušiti se	Nan
भैंस	buffalo	Nan
भेजी	poslano	Nan
भैरव	bhairav	Nan
भूल	zaboravio	Nan
भूमिगत	podzemlje	Nan
भूकंपी	zemljotres	Nan
भूकम्पों	zemljotresi	Nan
भूख	glad	Nan
भूखंड	zaplet	Nan
भूगोल	geografija	None
भूटान	butan	Nan
भूरे	smeđe	None
भूत	ghost	Nan
भूभाग	teren	None
भूमध्य	mediteranski	Nan
भूमध्यसागरीय	mediteranski	Nan
भूमि	zemlja	None
भूमिका	uloga	None
भूमिकाओं	uloge	None
भूतपूर्व	bivši	None
मध्यप्रदेश	madhya pradesh	Nan
भैरवनाथ	bhairavnath	Nan
भोग	uživanje	Nan
मंगोलिया	mongolija	Nan
मंगोलों	mongoli	Nan
मंचू	manchu	Nan
मंजिल	pod	None
मंजूर	odobriti	Nan
मंजूरी	čistoća	Nan
मंगोल	mongol	Nan
मंडप	paviljon	Nan
मंडलों	krugovi	None
मंडी	tržište	None
मंडेला	mandela	Nan
मंत्र	mantra	Nan
मंत्रालय	ministarstvo	None
मंत्रालयों	ministarstva	None
मंडल	grupa	None
भोंसले	bhonsle	Nan
मंगेशकर	mangeshkar	Nan
मंगल	mars	None
भोज	gozba	Nan
भोजन	hrana	None
भोजपुरी	bhojpuri	Nan
भोपाल	bhopal	Nan
भोसले	bhosle	Nan
भौगोलिक	geografski	None
मंगलवार	utorak	Nan
भौतिक	fizički	None
भ्रम	mit	None
भ्रमण	obilazak	Nan
भ्रमित	zbunjeni	Nan
भ्रष्ट	korumpiran	Nan
भ्रष्टाचार	korupcija	Nan
भ्रूण	fetus	Nan
भौतिकी	fizika	None
मेहनत	težak posao	Nan
मध्ययुग	srednje godine	Nan
मध्यवर्ती	srednji	None
महानगरों	metros	Nan
महानगरीय	metropolitan	Nan
महानगर	metropolitan	Nan
महान	odlicno	Nan
महाद्वीपों	kontinenti	Nan
महाद्वीपीय	kontinentalni	Nan
महाद्वीप	kontinent	None
महादेवी	mahadevi	Nan
महादेव	shiva	Nan
महात्मा	mahatma	Nan
महाकाव्यों	epovi	Nan
महाकाव्य	epski	Nan
महाकालेश्वर	mahakaleshwar	Nan
महाकाल	mahakala	Nan
महाकवि	sjajan pjesnik	Nan
महा	super	None
महसूस	osjećati	Nan
महंगी	skupo	Nan
महज	samo	None
महत्ता	važnost	None
महत्त्व	važnost	None
महत्त्वपूर्ण	bitan	None
महत्व	važnost	None
महानता	veličanstvo	Nan
महत्वपूर्ण	bitan	None
महत्वाकांक्षी	ambiciozan	Nan
महत्‍वपूर्ण	bitan	None
महमूद	mehmood	Nan
महर्षि	maharishi	Nan
महल	palata	Nan
महलों	palaces	Nan
महत्वाकांक्षा	ambicija	Nan
महानदी	mahanadi	Nan
महान्	veliki	None
महापुरुषों	sjajni ljudi	Nan
महिलाएं	žene	None
महिलाओं	žene	None
महिषासुर	mahishasura	Nan
महीना	mesec	Nan
महीने	mesec	Nan
महेंद्र	mahendra	Nan
महिलाएँ	žene	None
महेन्द्र	mahendra	Nan
महोत्सव	festival	None
मा	majke	None
माँ	majke	None
माँग	potražnja	Nan
माँगने	da tražim	Nan
माँगा	manga	Nan
महेश	mahesh	Nan
महंगा	skupo	Nan
महिमा	slava	Nan
महासागरीय	ocean	Nan
महाबलि	mahabali	Nan
महाभारत	mahabharata	Nan
महामंदी	velika depresija	Nan
महामारी	epidemija	None
महायान	mahayana	Nan
महायुद्ध	svjetski rat	Nan
महासागरों	okeani	Nan
महाराज	kralju	None
महाराणा	maharana	Nan
महारानी	kraljica	None
महाराष्ट्र	maharashtra	Nan
महाशक्ति	super snaga	Nan
महाशिवरात्रि	mahashivratri	Nan
महासागर	ocean	Nan
महाराजा	kralju	None
मस्ती	zabava	Nan
मस्तिष्क	mozak	None
मस्तिषक	mozak	None
मनोरंजन	zabava	Nan
मनोरम	očaravajuće	Nan
मनोविक्षिप्ति	psihoza	Nan
मनोविज्ञान	psihologija	None
मनोविज्ञानी	psiholog	Nan
मनोवैज्ञानिक	psiholog	Nan
मनोनीत	nominovani	Nan
मनोवैज्ञानिकों	psiholozi	Nan
मन्त्र	mantra	Nan
मन्त्री	ministra	None
मन्त्रों	mantras	Nan
मन्दिर	hram	None
मन्दिरों	hramovi	Nan
ममता	ljubav majke	Nan
मनोहर	šarmantan	Nan
ममी	mama	Nan
मनुस्मृति	manusmriti	Nan
मनु	manu	Nan
मध्यस्थ	posrednik	Nan
मध्यस्थता	posredovanje	Nan
मध्याह्न	meridian	Nan
मन	um	Nan
मनन	kontemplacija	Nan
मनमोहन	manmohan	Nan
मनुष्यों	ljudi	None
मना	zanijekati	Nan
मनाए	proslavite	Nan
मनाते	proslava	Nan
मनाने	ubediti	Nan
मनाया	proslavljen	Nan
मनाये	proslavite	Nan
मनी	novac	None
मनाई	proslavljen	Nan
मध्ययुगीन	srednjovekovni	Nan
मय	maja	None
मरते	umrijeti	Nan
मल्होत्रा	malhotra	Nan
मशहूर	poznat	None
मशीन	mašina	None
मशीनरी	mašine	None
मशीनी	mašina	None
मशीनों	mašine	None
मल्टीमीडिया	multimedija	Nan
मसनवी	masnavi	Nan
मसालों	začini	Nan
मसीह	kriste	Nan
मसूरी	mussoorie	Nan
मस्जिद	džamija	None
मस्जिदों	džamije	None
मस्तक	glava	None
मसलन	na primjer	Nan
मर	umri	Nan
मलेशिया	malezija	Nan
मलिक	malik	Nan
मरने	umrijeti	Nan
मरम्मत	popraviti ili ponovo instalirati	Nan
मराठा	maratha	Nan
मराठी	zastava	None
मराठों	marathas	Nan
मरियम	mary	None
मलेरिया	malarija	Nan
मरीज	pacijent	Nan
मरीना	marina	Nan
मरुस्थल	pustinja	None
मर्यादा	skromnost	Nan
मल	izmet	None
मलय	malajski	Nan
मलयालम	malayalam	Nan
मरीजों	pacijenti	Nan
मेहरगढ़	mehargarh	Nan
मेहराब	arh	Nan
मै	ja	None
रुझान	trend	None
रुचि	kamata	Nan
रुख	stand	Nan
रुक्मिणी	rukmini	Nan
रुका	zaustavljeno	Nan
रुकने	zaustaviti	Nan
रुक	freeze	Nan
रीति	način	None
रीढ़	kičma	Nan
रीडर	čitač	Nan
रिहा	pušten	Nan
रिसाव	curenje	Nan
रिसर्च	istraživanje	None
रिश्तेदारों	rođaci	Nan
रिश्तेदार	relativno	None
रिश्ते	odnosi	None
रिश्ता	odnos	None
रिकॉर्ड	zapis	None
रिकॉर्डिंग	snimanje	None
रिक्शा	rickshaw	Nan
रिचर्ड	richard	None
रिजर्व	rezerva	Nan
रिपब्लिकन	republikanski	Nan
रुड़की	roorkee	Nan
रिपोर्ट	izveštaj	Nan
रियासत	domaćinstvo	Nan
रियो	rio	None
रिलायंस	oslanjanje	Nan
रिलीज	izdanje	None
रिलीज़	pustiti	Nan
रिवाजों	carine	Nan
रियल	pravi	None
रुद्र	rudra	Nan
रुप	obrazac	Nan
रुपए	novac	None
रेखा	linija	None
रेखाएँ	linije	None
रेखाओं	linije	None
रेखाचित्र	skica	Nan
रेगिस्तान	pustinja	None
रेगिस्तानी	pustinja	None
रेंज	domet	None
रेजिमेंट	pukovnije	Nan
रेडियो	radio	None
रेडियोधर्मी	radioaktivno	Nan
रेड्डी	reddy	Nan
रेणु	renu	Nan
रेणुका	renuka	Nan
रेत	pesak	Nan
रेड	crveno	Nan
रिकार्ड	zapis	None
रे	zraka	None
रूस	rusija	None
रुपये	rupije	Nan
रूचि	kamata	Nan
रूढ़ियों	konvencije	Nan
रूढ़िवादी	konzervativni	Nan
रूप	forma	None
रूपक	metafora	None
रूसी	ruski	None
रूपरेखा	skica	Nan
रूपांतरण	konverzija	Nan
रूपांतरित	pretvoreno	Nan
रूपान्तर	konverzija	Nan
रूपान्तरण	konverzija	Nan
रूपी	pogledaj	Nan
रूपों	obrasci	Nan
रूपांतर	adaptacija	Nan
राहुल	rahul	Nan
राहु	rahu	Nan
राही	putnik	Nan
राधा	radha	Nan
राधाकृष्ण	radhakrishna	Nan
राधाकृष्णन	radhakrishnan	Nan
रानी	kraljice	None
राम	ram	None
रामकृष्ण	ramakrishna	Nan
रात्रि	noć	None
रामचंद्र	ramchandra	Nan
रामचरितमानस	ramcharitmanas	Nan
रामजी	ramji	Nan
रामदास	ramdas	Nan
रामदेव	ramdev	Nan
रामधारी	ramdhari	Nan
रामनगर	ramnagar	Nan
रामचन्द्र	ram chandra	Nan
रामनवमी	ram navami	Nan
रात	noć	None
राज्‍य	država	None
राजस्थानी	rajasthani	Nan
राजस्व	prihod	Nan
राजा	kralju	None
राजाओं	kraljevi	None
राजी	slažem se	Nan
राजीव	rajeev	Nan
राणा	rana	None
राजे	raje	Nan
राजेन्द्र	rajendra	Nan
राजेश	rajesh	Nan
राज्यपाल	guvernera	None
राज्यसभा	rajya sabha	Nan
राज्याभिषेक	koronacija	Nan
राज्यॉ	države	None
राजेंद्र	rajendra	Nan
रेतीले	sandy	Nan
रामनाथ	ramnath	Nan
राममोहन	ram mohan	Nan
राष्ट्रमंडल	commonwealth	Nan
राष्ट्रवाद	nacionalizam	Nan
राष्ट्रवादी	nacionalistički	Nan
राष्ट्रीय	nacionalni	None
राष्ट्रों	nacije	None
राष्‍ट्रीय	nacionalni	None
राष्ट्रभाषा	nacionalni jezik	Nan
रास	raas	Nan
रासायनिक	hemijski	None
रासो	raso	Nan
रास्ता	način	None
रास्ते	put	None
राह	put	None
राहत	olakšanje	Nan
रासलीला	rasleela	Nan
रामपुर	rampur	Nan
राष्ट्रपति	predsjedniče	Nan
राष्ट्र	nacija	None
रामलीला	ram leela	Nan
रामानंद	ramanand	Nan
रामानन्द	ramanand	Nan
रामानुजन	ramanujan	Nan
रामायण	ramayana	Nan
रामेश्वरम	rameswaram	Nan
राष्ट्रगान	nacionalna himna	Nan
राय	mišljenje	None
रायपुर	raipur	Nan
रायबरेली	rae bareli	Nan
राव	rao	Nan
रावण	ravana	Nan
राशि	iznos	None
राशियों	znakovi zodijaka	Nan
रायता	raita	Nan
राजस्थान	rajasthan	Nan
रेफरी	sudija	None
रेलगाड़ी	voz	Nan
लहरें	valovi	Nan
लहर	talas	Nan
लसिका	limfa	None
लश्कर-ए-तैयबा	lashkar-e-taiba	Nan
लव	ljubav	None
लय	ritam	None
लम्बे	visok	None
लम्बी	dugo	None
लम्बाई	dužina	None
लम्बा	dugo	None
लन्दन	london	None
लता	creeper	Nan
लड्डू	laddu	Nan
लडाई	bitka	None
लड़ाई	borba	None
लड़ाइयाँ	bitke	None
लड़ा	tukao	Nan
लगाव	prilog	None
लगी	bila je angažovana	Nan
लगे	budite zaručeni	Nan
लगेगा	uzet će	Nan
लघु	mala	None
लटका	drži	None
लहरों	talasi	Nan
लड़	borba	None
लड़कियों	djevojke	Nan
लड़की	devojka	Nan
लड़के	dječaci	Nan
लड़कों	momci	Nan
लड़ते	borba	None
लड़ने	borba	None
लड़का	dječak	Nan
ला	la	None
लाइट	svjetlost	None
लाइन	red čekanja	Nan
लाभ	benefit	Nan
लाभकारी	blagotvorno	Nan
लाभदायक	profitabilno	Nan
लाभप्रद	blagotvorno	Nan
लाभों	prednosti	None
लामा	lama	Nan
लापता	nedostaje	Nan
लायक	vredi	Nan
लायी	dovedeno	Nan
लाये	donesi	Nan
लार्ड	gospode	Nan
लाल	crveno	Nan
लालटेन	lanterna	Nan
लालबहादुर	lalbahadur	Nan
लाया	dovedeno	Nan
लगाये	staviti	None
लाने	donesi	Nan
लादेन	laden	Nan
लाइनों	linije	None
लाइफ	život	None
लाइव	uživo	None
लाइसेंस	licenca	Nan
लाए	dovedeno	Nan
लाकर	dovođenjem	Nan
लाना	donijeti	Nan
लाख	lakh	Nan
लागत	trošak	None
लागू	primjenjivo	Nan
लाजपत	lajpat	Nan
लाता	donosi	None
लाती	donesi	Nan
लाते	donesi	Nan
लाखों	milionima	Nan
लगायी	primenjeno	Nan
लगाया	planted	Nan
लगाने	staviti	None
रोचक	zanimljivo	None
रोजगार	zapošljavanje	Nan
रोड	cesta	None
रोम	rim	None
रोमन	rimski	None
रोमांस	romantika	Nan
रोगों	bolesti	None
रोमानी	romantično	Nan
रोलिंग	rolling	Nan
रोशन	svetleće	Nan
रोशनी	svetlost	Nan
रोहिणी	rohini	Nan
ल	le	None
लंकाकाण्ड	lanka	Nan
रोल	roll	None
लंगड़ा	lame	Nan
रोगी	pacijent	Nan
रोग	bolest	None
रेलमार्ग	željeznička pruga	Nan
रेलवे	željeznica	None
रेशम	svila	Nan
रेशमी	svilenkast	Nan
रैदास	raidas	Nan
रॉक	rock	None
रोगियों	pacijenti	Nan
रॉबर्ट	roberte	Nan
रोक	stani	Nan
रोकता	zaustavlja se	Nan
रोकथाम	prevencija	Nan
रोकना	stani	Nan
रोकने	spriječiti	None
रोका	zaustavljeno	Nan
रॉयल	royal	Nan
रेल	željeznica	None
लंगर	sidro	Nan
लंबा	dugo	None
लगते	izgleda	None
लगना	osjećati	Nan
लगने	izgleda	None
लगभग	o:	Nan
लगा	osećao	Nan
लगाई	staviti	None
लगती	izgleda	None
लगाए	planted	Nan
लगाता	primjena	None
लगातार	neprekidno	None
लगाती	prijavite se	Nan
लगाते	primjena	None
लगान	porez	None
लगाना	postaviti	Nan
लगाकर	primjenom	Nan
लंदन	london	None
लगता	izgleda	None
लखनऊ	lucknow	Nan
लंबाई	dužina	None
लंबी	dugo	None
लंबे	dugo	None
लकड़ी	drvo	None
लक्षण	simptomi	None
लक्षणा	karakteristike	None
लखनवी	lucknowi	Nan
लक्षणों	simptomi	None
लक्ष्मण	laxman	Nan
लक्ष्मी	lakšmi	Nan
लक्ष्मीबाई	laxmi bai	Nan
लक्ष्य	cilj	None
लक्ष्यों	ciljevi	None
लक्स	lux	Nan
लक्षित	ciljano	Nan
भूकंप	zemljotres	Nan
राजसी	princeza	None
राजवंशों	dinastije	None
यीशु	isuse	Nan
याहू	yahoo	Nan
यार्क	york	None
यानी	tj	None
यानि	to jest	Nan
यान	vozilo	Nan
यादव	yadav	Nan
यादगार	nezaboravno	Nan
यात्री	putnik	Nan
यात्रियों	putnici	None
यात्रा	putovanje	None
यातायात	prevoz	Nan
याज्ञवल्क्य	yajnavalkya	Nan
याचिका	peticija	Nan
याचना	traženje	None
यांत्रिक	mehanički	None
या	ili	None
यथासंभव	koliko je to moguće	Nan
यदि	ako	None
यद्यपि	iako	None
यम	yama	Nan
यमुना	yamuna	Nan
यश	poznat	None
यु	y	None
यह	ovo	None
यहाँ	ovdje	None
यहां	evo	None
यही	samo ovo	Nan
यहीं	samo ovdje	Nan
यहूदियों	jevreji	None
यहूदी	jevrejski	Nan
यहा	evo	None
युक्त	sadrži	None
युक्ति	savjet	None
युक्तियों	savjeti	Nan
यूट्यूब	youtube	Nan
यूनवर्स	univerzum	Nan
यूनाइटेड	united	None
यूनान	grčka	None
यूनानी	grčki	None
यूनिकोड	unicode	Nan
यूजर	korisnik	None
यूनिक्स	unix	Nan
यूनियन	union	None
यूनेस्को	unesco	Nan
यूपीए	upa	Nan
यूरोप	evropi	None
यूरोपिय	evropski	None
यूरोपियन	evropski	None
यूनिट	jedinica	None
यथार्थवादी	realno	Nan
यूक्लिड	euklid	None
यूँ	volim ovo	Nan
युग	era	None
युगल	par	None
युगों	vijecima	Nan
युग्म	par	None
युद्घ	bitka	None
युद्धों	ratovi	None
यूं	volim ovo	Nan
युधिष्ठिर	yudhisthira	Nan
युरोप	evropi	None
युवक	mladi dječak	Nan
युवराज	princ	None
युवा	mladi	None
युवाओं	omladina	Nan
युवावस्था	omladina	Nan
युनेस्को	unesco	Nan
यथार्थवाद	realizam	Nan
यथार्थ	istinito	Nan
यथा	as	None
मॉनसून	monsun	Nan
मॉरीशस	mauricijus	Nan
मॉल	trzni centar	Nan
मोक्ष	spasenje	Nan
मोटर	motor	Nan
मोटर्स	motori	Nan
मॉड्यूल	modul	Nan
मोटा	debeo	Nan
मोटी	debeo	Nan
मोटे	masna	Nan
मोडल	modal	Nan
मोड़	skrenuti	Nan
मोती	biserno	Nan
मोतीलाल	motilal	Nan
मोटाई	debljina	Nan
मोदी	modi	Nan
मॉडलिंग	modeliranje	Nan
मैसूर	mysore	Nan
मैं	ja sam	Nan
मैंने	ja	None
मैक	mac	None
मैक्स	maks	Nan
मैच	utakmica	None
मैचों	utakmice	None
मॉडल	model	None
मैत्री	prijateljstvo	Nan
मैथुन	kopulacija	Nan
मैदान	polje	None
मैदानी	ravnina	Nan
मैदानों	ravnine	Nan
मैन	čovječe	Nan
मैने	ja	None
मैथिलीशरण	maithilisharan	Nan
यूरोपीय	evropski	None
मोनोऑक्साइड	monoksid	Nan
मोमबत्ती	svijeća	Nan
मौसम	vrijeme	None
मौसमी	sezonski	Nan
म्यूकर	mukker	Nan
म्यूजिक	muzika	None
म्यूजियम	muzej	None
य	ovo	None
मौलिक	originalni	None
यंत्र	uređaj	None
यकृत	jetra	None
यक्ष	yaksha	Nan
यजुर्वेद	yajurved	Nan
यज्ञ	yajna	Nan
यज्ञों	yagyas	Nan
यत्न	naporno	Nan
यंत्रों	instrumenti	Nan
मोम	vosak	None
मौलाना	maulana	Nan
मौर्य	maurya	Nan
मोर्चा	prednji	None
मोहन	mohan	Nan
मोहनदास	mohandas	Nan
मोहम्मद	mohamed	Nan
मोहित	zaljubljen	Nan
मौका	prilika	None
मौर्यों	mauryans	Nan
मौके	šansa	Nan
मौजूदा	postojeće	None
मौत	smrt	None
मौतें	poginuli	Nan
मौतों	poginuli	Nan
मौद्रिक	monetarno	Nan
मौन	tišina	Nan
मौजूद	sadašnjost	Nan
राजशाही	monarhija	None
ये	ove	None
योग	joga	Nan
राक्षस	demon	Nan
राकेश	rakeš	Nan
राउटर	ruter	Nan
राइबोसोम	ribosome	Nan
राँची	ranchi	Nan
रहो	ostani	Nan
रहेगी	ostaće	Nan
रहेगा	ostaće	Nan
रहेंगे	ostaće	Nan
रहें	ostani	Nan
रहे	su	None
रहीम	rahim	Nan
रहीं	ostali	None
रही	radeći	Nan
रहित	bez	None
रहा	ostali	None
रहस्यों	misterije	Nan
रवीन्द्रनाथ	rabindranath	Nan
रस	sok	Nan
रसायन	hemikalije	Nan
रसूल	rasool	Nan
रसोई	kuhinja	Nan
रस्सी	konop	Nan
राक्षसी	demonic	Nan
रह	ostani	Nan
रहता	lasts	Nan
रहते	uživo	None
रहना	uživo	None
रहने	živim	None
रहमान	rahman	Nan
रहस्य	misterija	Nan
रहकर	boravkom	Nan
राक्षसों	demoni	Nan
राख	pepeo	Nan
राखी	rakhi	Nan
राजनीती	politika	None
राजनेता	političarka	Nan
राजनैतिक	politička	None
राजन्	rajan	Nan
राजपथ	autoput	None
राजपूत	rajput	Nan
राजनीतिज्ञ	političar	None
राजपूताना	rajputana	Nan
राजभाषा	službeni jezik	Nan
राजमहल	palata	Nan
राजमार्ग	autoput	None
राजमार्गों	autoceste	Nan
राजवंश	dinastija	None
राजवंशीय	dinastički	Nan
राजपूतों	rajputs	Nan
रवि	sunce	None
राजनीतिक	politička	None
राजनितिक	politička	None
राग	melodija	Nan
राघव	raghav	Nan
राज	pravilo	None
राजकीय	država	None
राजकुमार	princ	None
राजकुमारी	princezo	Nan
राजनीति	politika	None
राजगद्दी	tron	None
राजतंत्र	monarhija	None
राजतन्त्र	monarhija	None
राजदूत	ambasadora	Nan
राजधानियों	prijestolnice	Nan
राजधानी	kapital	None
राजनयिक	diplomat	Nan
राजगुरु	rajguru	Nan
रमेश	ramesh	Nan
रमण	raman	Nan
रफ्तार	brzina	None
रंगे	obojen	Nan
रंगों	boje	None
रंगोली	rangoli	Nan
रंजन	ranjan	Nan
रक्त	krv	None
रक्तचाप	krvni pritisak	Nan
रंगीन	raznobojan	Nan
रक्तस्त्राव	krvarenje	None
रक्षाबंधन	raksha bandhan	Nan
रख	zadržati	None
रखकर	postavljanjem	Nan
रखता	drži	None
रखती	drži	None
रखना	zadržati	None
रक्षा	odbrana	None
रखने	zadržati	None
रंगमंच	pozornica	Nan
रंगबिरंगे	raznobojan	Nan
योगदान	doprinos	None
योगी	yogi	Nan
योग्य	pogodno	Nan
योग्यता	ispunjavanje uslova	Nan
योजन	plan	None
योजना	plan	None
रंगभेद	aparthejd	Nan
योजनाओं	planovi	None
योनि	vagina	None
यौगिक	složeni	Nan
यौगिकों	jedinjenja	None
यौन	seksualni	Nan
र	su	None
रंग	boja	None
योद्धा	ratnik	Nan
यों	volim ovo	Nan
रखरखाव	održavanje	None
रखी	položen	Nan
रजिस्टर	registrujte se	Nan
रज्जब	rajjab	Nan
रणनीति	strategija	None
रणनीतिक	strateški	None
रणनीतियां	strategije	None
रणनीतियों	strategije	None
रजत	srebrna	Nan
रतन	nakit	Nan
रत्न	gemstone	Nan
रत्नाकर	ratnakar	Nan
रथ	kočija	Nan
रद्द	otkazano	Nan
रन	bježi	None
रफ़ी	rafi	Nan
रतिक्रीड़ा	krvavi sport	Nan
रखा	kept	Nan
रज	raj	None
रची	izvezen	Nan
रखे	zadržati	None
रखें	zadržati	None
रग्बी	ragbi	None
रचना	formiranje	None
रचनाएँ	kompozicije	None
रचनाएं	kompozicije	None
रचे	napravljeno	Nan
रचनाओं	kompozicije	None
रचनाकाल	vreme stvaranja	Nan
रचनात्मक	kreativno	Nan
रचनायें	kompozicije	None
रचयिता	autor	None
रचा	izmišljati	Nan
रचित	sastavljeno	Nan
रचनाकार	tvorac	None
भूआकृति	pejzaž	Nan
भू	zemljište	None
भुवनेश्वर	bhubaneswar	Nan
प्रशासित	administrirano	Nan
प्रशासनिक	administrativna	None
प्रशासकीय	administrativna	None
प्रशासक	administrator	Nan
प्रशान्त	pacifik	Nan
प्रशांत	pacifik	Nan
प्रशस्ति	pohvala	Nan
प्रशस्त	ekspanzivan	Nan
प्रशंसा	uvažavanje	Nan
प्रशंसक	ventilator	Nan
प्रवेशद्वार	ulazna kapija	Nan
प्रवेश	uđi	Nan
प्रवृत्तियों	trendovi	Nan
प्रवृत्ति	trend	None
प्रवृत्त	na snazi	Nan
प्रवृति	priroda	None
प्रवीण	profesionalni	Nan
प्रयोजनों	svrhe	None
प्रर्दशित	demonstrirano	Nan
प्रलय	holokaust	Nan
प्रलेख	dokument	None
प्रलेखों	dokumenti	None
प्रवचन	diskurs	Nan
प्रशिक्षण	trening	Nan
प्रवर्तक	promotor	Nan
प्रवास	ostanak	Nan
प्रवासियों	emigranti	Nan
प्रवासी	migrant	Nan
प्रवाह	tok	None
प्रवाहित	tekla	Nan
प्रविष्ट	ušao	None
प्रवर्धक	pojačalo	Nan
प्रशिक्षित	obučeni	Nan
प्रश्न	pitanja	None
प्रश्नों	pitanja	None
प्रस्तुतीकरण	predaja	Nan
प्रस्थान	polazak	Nan
प्रहार	thump	Nan
प्रह्लाद	prahlad	Nan
प्रांगण	dvorište	Nan
प्रांत	pokrajina	None
प्रस्तुतिकरण	prezentacija	None
प्रांतस्था	cortex	Nan
प्रांतों	pokrajine	None
प्राकृत	prakrit	Nan
प्राकृतिक	prirodno	None
प्रागैतिहासिक	prapovijesti	Nan
प्राचीन	drevni	None
प्राचीनकाल	antičko vrijeme	Nan
प्रांतीय	pokrajinski	Nan
प्रयोजन	svrha	None
प्रस्तुति	prezentacija	None
प्रस्तावित	kako je predloženo	Nan
प्रसंग	kontekst	Nan
प्रसन्न	drago mi je	Nan
प्रसन्नता	sreća	Nan
प्रसव	dostava	Nan
प्रसाद	svete ponude	Nan
प्रसाधन	wc	Nan
प्रस्तुत	predstavljeno	Nan
प्रसारण	emitovanje	Nan
प्रसिद्द	poznat	None
प्रसिद्ध	čuven	Nan
प्रसिद्धि	slava	Nan
प्रसिध्द	poznat	None
प्रस्ताव	prijedlog	None
प्रस्तावना	predgovor	Nan
प्रसारित	emitovano	Nan
प्रयोगों	eksperimenti	None
प्रयोगात्मक	eksperimentalno	Nan
प्रयोगशालाओं	laboratorije	Nan
प्रदाताओं	pružatelji usluga	Nan
प्रदान	navedite	Nan
प्रदूषक	zagađivač	Nan
प्रदूषकों	zagađivači	Nan
प्रदूषण	zagađenje	Nan
प्रदूषित	zagađeno	Nan
प्रदर्शित	prikazano	Nan
प्रदेश	region	None
प्रधान	prime	Nan
प्रधानता	prioritet	Nan
प्रधानमंत्री	premijer	None
प्रधानमन्त्री	premijer	None
प्रपत्र	obrazac	Nan
प्रबंध	menadžment	None
प्रदेशों	teritoriji	None
प्रबंधक	menadžer	None
प्रदर्शनों	demonstracije	Nan
प्रदत्त	plaćeno	Nan
प्रतिस्पर्धी	konkurentski	Nan
प्रतीक	simbol	None
प्रतीकात्मक	simbolična	Nan
प्रतीकों	simboli	None
प्रतीक्षा	čekaj	Nan
प्रतीत	izgleda	None
प्रदर्शन	prikaz	None
प्रत्यंग	affix	Nan
प्रत्यय	sufiks	Nan
प्रत्याशा	anticipacija	Nan
प्रत्येक	svi	None
प्रथम	prvo	None
प्रथा	custom	Nan
प्रथाओं	praksa	None
प्रत्यक्ष	evident	Nan
प्राचीनतम	najstariji	None
प्रबंधकों	menadžeri	Nan
प्रबन्ध	menadžment	None
प्रमस्तिष्क	cerebrum	Nan
प्रमाण	dokaz	None
प्रमाणित	sertifikovano	Nan
प्रमाणों	dokazi	None
प्रमुख	šefe	Nan
प्रमुखता	istaknutost	Nan
प्रभुत्व	dominacija	Nan
प्रयत्न	probaj	Nan
प्रयास	napor	None
प्रयासों	napori	Nan
प्रयोक्ता	korisnik	None
प्रयोग	eksperiment	Nan
प्रयोगकर्ता	korisnika	None
प्रयोगशाला	laboratorija	Nan
प्रयत्नों	napori	Nan
प्रबंधन	menadžment	None
प्रभुता	suverenitet	None
प्रभास	radiance	Nan
प्रबन्धन	menadžment	None
प्रबलता	prednost	None
प्रबुद्ध	prosvećen	Nan
प्रभा	prabha	Nan
प्रभाकर	prabhakar	Nan
प्रभाग	podjela	None
प्रभु	gospode	Nan
प्रभात	jutro	None
प्रभाव	efekat	None
प्रभावकारी	efektivno	Nan
प्रभावित	uticao	Nan
प्रभाविता	efikasnost	None
प्रभावी	efektivno	Nan
प्रभावों	efekti	None
प्रभार	naplatiti	Nan
प्रतिष्ठित	istaknuti	None
प्राण	život	None
प्राणियों	stvorenja	Nan
फ़िर	ponovo	None
फ़िजी	fidži	Nan
फ़ारसी	perzijski	None
फ़ारस	perzijski	None
फ़ायदा	profit	Nan
फ़सल	rezati	Nan
फ़ल	fal	Nan
फ़रवरी	februar	None
फ़	f	Nan
फहराया	dizala	Nan
फहराना	za dizanje	Nan
फसलों	usevi	Nan
फसलें	usjevi	Nan
फसल	rezati	Nan
फलों	voće	None
फली	pod	None
फलस्वरूप	kao rezultat	Nan
प्लेटो	platon	None
प्लेटों	ploče	None
प्लेयर	igrač	None
फंड	fond	None
फकीर	sveti	None
फतेहपुर	fatehpur	Nan
फ़िल्म	film	None
फरवरी	februar	None
फर्म	čvrsto	None
फर्मियान	fermion	Nan
फर्श	podovi	Nan
फल	voće	None
फलत	kao rezultat	Nan
फलस्वरुप	kao rezultat	Nan
फर्क	razlika	None
फ़िल्मफेयर	filmfare	Nan
फ़िल्मी	film	None
फ़िल्में	filmove	Nan
फार्म	obrazac	Nan
फाल्गुन	phalgun	Nan
फिजी	fidži	Nan
फिट	fit	Nan
फिनलैंड	finska	None
फिर	ponovo	None
फारसी	perzijski	None
फिलहाल	za sada	Nan
फिलोसोफी	filozofija	None
फिल्म	film	None
फिल्मफेयर	filmfare	Nan
फिल्मी	filmski	None
फिल्में	filmove	Nan
फिल्मों	filmove	Nan
फिलिस्तीन	palestina	Nan
प्लेटफार्म	platforma	Nan
फायरफॉक्स	firefox	None
फायदा	profit	Nan
फ़ेस	lice	None
फ़ैल	pad	None
फ़ॉन्ट	font	Nan
फ़ोन	telefon	Nan
फ़ोर्तूना	fortuna	Nan
फ़्रांस	francuska	None
फायदे	prednost	None
फ़्रांसिसी	francuski	None
फाँसी	vješanje	Nan
फाइनल	konačno	None
फाइनेंस	finansije	None
फाइल	fajl	Nan
फाइलों	datoteke	None
फाउंडेशन	temelj	None
फ़्रांसीसी	francuski	None
प्लास्मोडियम	plazmodijum	Nan
प्लास्टिक	plastični	Nan
प्लान	plan	None
प्रारंभ	početak	None
प्रारंभिक	početno	Nan
प्रारम्भ	početak	None
प्रारम्भिक	početni	Nan
प्रारूप	format	None
प्रारूपिक	tipično	None
प्रायोगिक	eksperimentalno	Nan
प्रार्थना	molitva	None
प्रासंगिक	relevantan	Nan
प्रासंगिकता	relevantnost	Nan
प्रासाद	palata	Nan
प्रिय	poštovani	Nan
प्रियव्रत	dearvrat	Nan
प्रिया	priya	Nan
प्रावधान	odredba	Nan
प्रेक्षकों	posmatrači	Nan
प्रायद्वीप	poluotok	Nan
प्राय	obično	None
प्राणी	stvorenje	Nan
प्राणों	život	None
प्रात	jutro	None
प्रातकाल	jutro	None
प्राथमिकता	prioritet	Nan
प्रादुर्भाव	evolucija	None
प्रायः	obično	None
प्रादेशिक	teritorijalno	None
प्रान्त	provincija	None
प्रान्तों	provincije	None
प्राप्त	dobiti	None
प्राप्ति	dostignuće	Nan
प्रामाणिक	autentična	Nan
प्रामाणिकता	autentičnost	Nan
प्राधिकरण	vlast	None
प्राणायाम	pranayama	Nan
प्रेक्षण	posmatranje	Nan
प्रेमचंद	premchand	Nan
प्रोटॉन	proton	Nan
प्रोटोकॉल	protokol	None
प्रोटोज़ोआ	protozoa	Nan
प्रोत्साहन	podsticanje	Nan
प्रोत्साहित	ohrabreni	Nan
प्रोफ़ेसर	profesore	Nan
प्रोटेस्टेंट	protestantski	Nan
प्रोफेसर	profesore	Nan
प्रोस्टेट	prostata	Nan
प्रौद्योगिकियों	tehnologije	None
प्रौद्योगिकी	tehnologija	None
प्लस	plus	None
प्लांट	biljka	None
प्लाज्मा	plazma	None
प्रोसेसर	procesor	None
प्रेम	ljubav	None
प्रोटीन	protein	Nan
प्रोग्रामों	programi	None
प्रेमिका	ljubavnik	Nan
प्रेमियों	ljubavnici	Nan
प्रेमी	ljubavnik	Nan
प्रेरक	motivacijski	Nan
प्रेरणा	inspiracija	Nan
प्रेरित	inspirirajte	Nan
प्रोटान	proton	Nan
प्रेषित	poslano	Nan
प्रेसिडेंसी	predsjedništvo	None
प्रेसीडेंसी	predsjedništvo	None
प्रो	pro	None
प्रोग्राम	program	None
प्रोग्रामन	programiranje	None
प्रोग्रामिंग	programiranje	None
प्रेस	štampa	None
फीका	blijedi	Nan
प्रतिष्ठा	prestiž	Nan
प्रतिवर्ष	godišnje	None
पूरे	cjelinu	None
पूरी	kompletna	None
पूरा	celina	Nan
पूरब	istok	None
पूरक	dopuna	Nan
पूना	poona	Nan
पूज्य	venerable	Nan
पूजा	molitva	None
पूजन	bogoslužje	Nan
पूछे	pitajte	Nan
पूछा	pitan	Nan
पूंजीवादी	kapitalistički	Nan
पूँजीवादी	kapitalistički	Nan
पूँजीवाद	kapitalizam	Nan
पूँजी	kapital	None
पू	poo	Nan
पुस्तकों	knjige	None
पुर्तगाल	portugal	None
पुर्तगालियों	portugalski	Nan
पुर्तगाली	portugalski	Nan
पुल	most	None
पुलिस	policija	None
पुष्टि	potvrda	Nan
पूर्ण	kompletni	Nan
पुष्प	cvijet	None
पुष्य	pushya	Nan
पुष्यमित्र	pushyamitra	Nan
पुस्तक	knjiga	None
पुस्तकालय	biblioteka	None
पुस्तकालयों	biblioteke	None
पुस्तकें	knjige	None
पुष्पण	cvjetanje	Nan
पूर्णत	potpuno	None
पूर्णतः	potpuno	None
पूर्णतया	potpuno	None
पृथ्वीराज	prithviraj	Nan
पृष्ट	stranica	None
पृष्ठ	stranica	None
पृष्ठों	stranice	None
पे	na	None
पेंशन	pansion	Nan
पृथ्वी	zemlja	None
पेज	stranica	None
पेटेंट	patenta	Nan
पेट्रोलियम	nafta	None
पेठ	peth	Nan
पेड	drvo	None
पेड़पौधे	drveće i biljke	Nan
पेड़ों	drveće	Nan
पेट	želudac	None
पुरे	cijeli	None
पृथक्करण	razdvajanje	None
पूसा	pusa	Nan
पूर्णिमा	puni mjesec	Nan
पूर्ति	snabdevanje	Nan
पूर्व	istok	None
पूर्वक	poželjno	None
पूर्वज	predak	Nan
पूर्वजों	preci	None
पृथक्	odvojeni	None
पूर्वराजवंशीय	prethodnika	Nan
पूर्वविधान	stari zavjet	Nan
पूर्वानुमान	prognoza	Nan
पूर्वार्ध	prva polovina	Nan
पूर्वी	istočno	None
पूर्वोक्त	gore navedeno	Nan
पूर्वोत्तर	sjeveroistok	Nan
पूर्ववर्ती	prethodni	Nan
पुरूष	muškarci	None
पुरुषोत्तम	purushottam	Nan
पुरुषवाचक	muško	Nan
पीढ़ी	generacija	None
पीढी	generacija	None
पीते	pijte	Nan
पीना	piti	Nan
पीने	pijenje	Nan
पीनेवाला	drinker	Nan
पीढ़ियों	generacije	None
पीनेवाले	piće	Nan
पीपी	pp	Nan
पीरियड	period	None
पीला	žuto	None
पीली	žuto	None
पीले	žuto	None
पीस	mir	None
पीपल	ficus religiosa	Nan
पीसकर	samljeti	Nan
पीड़ित	žrtva	None
पीटर	peter	None
पिच	smola	Nan
पिछड़े	unazad	Nan
पिछली	prethodni	Nan
पितामह	grand otac	Nan
पित्त	bile	None
पिनकृमि	pinworm	Nan
पीठ	leđa	None
पिमलिको	pimlico	Nan
पिलाने	hranjenje	Nan
पी	str	Nan
पीक	vrhunac	None
पीकर	pijenjem	Nan
पीछा	potjera	Nan
पीछे	iza	None
पिरामिड	piramida	None
पेनाल्टी	kazna	None
पीसी	pc	None
पुख्ता	jak	None
पुरस्कृत	nagrađeni	Nan
पुरा	pun	None
पुराणों	mitologija	None
पुरातत्त्व	arheologija	Nan
पुरातत्व	arheologija	Nan
पुरातत्वविदों	arheolozi	None
पुरस्कार	nagrada	None
पुरातन	drevni	None
पुराना	stari	None
पुरानी	stari	None
पुराने	stariji	None
पुरापाषाण	paleolitik	Nan
पुरी	puri	Nan
पुरुष	muško	Nan
पुरातात्विक	arheološki	None
पुकारा	prozvao	Nan
पुर	pur	Nan
पुनर्जीवित	oživjela	Nan
पुजारियों	svećenici	Nan
पुजारी	sveštenik	Nan
पुट	staviti	None
पुणे	pune	None
पुण्य	saintly	Nan
पुत्री	kćerka	None
पुनर्निर्माण	rekonstrukcija	Nan
पुत्रों	sinovi	Nan
पुनः	ponovo	None
पुनरीक्षण	revizija	Nan
पुनरुत्थान	uskrsnuće	Nan
पुनर्गठन	reorganizacija	Nan
पुनर्जन्म	preporod	None
पुनर्जागरण	renesansa	Nan
पुन	ponovo	None
प्रतिशत	postotak	None
पेय	piće	Nan
पेरू	peru	None
प्रताप	veličanstvo	Nan
प्रणेता	pionir	Nan
प्रणीत	pranit	Nan
प्रणाली	sistem	None
प्रणालियों	sistemi	None
प्रणालियां	sistemi	None
प्रणालियाँ	sistemi	None
प्रणाम	pozdrav	Nan
प्रणव	pranav	Nan
प्रणयन	ljubav	None
प्रणय	ljubav	None
प्रज्ञा	mudrost	Nan
प्रजापति	tvorac	None
प्रजातियों	vrsta	None
प्रजातियां	vrsta	None
प्रजातियाँ	vrste	None
प्रजाति	vrsta	None
प्रख्यात	primećeno	Nan
प्रगति	napredak	None
प्रगतिशील	progresivan	Nan
प्रचलन	trend	None
प्रचलित	popularno	None
प्रचार	javnost	None
प्रतापी	veličanstven	Nan
प्रचारक	promotor	Nan
प्रचारिणी	publicistički	Nan
प्रचारित	promovisan	Nan
प्रचालन	operacija	None
प्रचुर	puno	None
प्रजनन	reprodukcija	Nan
प्रजा	ljudi	None
प्रचारप्रसार	propaganda	Nan
प्रति	per	Nan
प्रतिकूल	nepovoljno	Nan
प्रतिकृति	faksimile	Nan
प्रतिमा	kip	None
प्रतिमाओं	idoli	Nan
प्रतिमान	model	None
प्रतियोगिताओं	takmičenja	None
प्रतियोगियों	takmičari	Nan
प्रतियोगी	takmičar	Nan
प्रतिभा	talent	Nan
प्रतिरक्षा	imunitet	Nan
प्रतिरूप	model	None
प्रतिरोध	otpor	None
प्रतिरोधक	otporni	Nan
प्रतिरोधी	otporan	Nan
प्रतिलिपि	kopiraj	Nan
प्रतिलेखन	transkripcija	Nan
प्रतिरक्षी	odbrana	None
प्रखर	oštro	None
प्रतिबिम्ब	image	Nan
प्रतिबन्ध	ograničenje	None
प्रतिक्रिया	reakcija	None
प्रतिक्रियाओं	reakcije	None
प्रतिज्ञा	zalog	Nan
प्रतिदिन	svaki dan	Nan
प्रतिद्वंद्वी	rival	Nan
प्रतिनिधि	reprezentativni	Nan
प्रतिबिंबित	reflektiraju	Nan
प्रतिनिधित्व	zastupništvo	Nan
प्रतिपदा	takmičenje	None
प्रतिपादन	iskazivanje	Nan
प्रतिपादित	popularan	None
प्रतिपुरुष	glavni junak	Nan
प्रतिबंधित	ograničena	None
प्रतिबंधों	ograničenja	None
प्रतिनिधियों	predstavnici	None
प्रक्षेपास्त्र	projektila	Nan
प्रक्षेप	interpolacija	None
प्रक्रियाओं	postupci	None
पैरामिसियम	paramisium	Nan
पैरिस	pariz	None
पैरों	noge	None
पैलेस	palata	Nan
पैसा	novac	None
पैसों	novac	None
पैराग्वे	paragvaj	Nan
पॉटर	potter	Nan
पॉडकास्टिंग	podcasting	Nan
पॉप	pop	None
पॉल	paul	None
पॉलीन्या	paulina	Nan
पोजीशन	položaj	None
पोप	papa	None
पॉडकास्ट	podcast	Nan
पोर्ट	luka	None
पैर	noga	Nan
पैनल	panel	Nan
पेश	sadašnjost	Nan
पेशकश	ponuda	None
पेशवा	peshwa	Nan
पेशाब	urin	Nan
पेशियों	mišići	None
पेशे	profesija	Nan
पैमाने	skala	Nan
पेशेवर	profesionalni	Nan
पैगम्बर	poslaniče	Nan
पैग़म्बर	poslaniče	Nan
पैतृक	očinski	Nan
पैदल	na nogama	Nan
पैदा	rođen	None
पैदावार	prinos	Nan
पैकेजिंग	ambalaža	Nan
पेरिस	pariz	None
पोर्ट-ऑ-प्रिंस	port-au-prince	Nan
पोलिश	poljski	None
प्रकार	tip	None
प्रकारों	vrste	None
प्रकाश	svetlost	Nan
प्रकाशन	publikacija	Nan
प्रकाशनों	publikacije	Nan
प्रकाशसंश्लेषण	fotosinteza	None
प्रकल्प	projekat	None
प्रकाशिकी	optika	Nan
प्रकाशीय	optički	None
प्रकीर्णन	rasipanje	Nan
प्रकृति	priroda	None
प्रकोप	izbijanje	Nan
प्रक्रिया	procesa	None
प्रक्रियाएं	procesi	None
प्रकाशित	objavljeno	Nan
पोर्टल	portal	None
प्रकरण	slučaj	None
प्यास	žeđ	Nan
पोलैंड	poljska	None
पोशाक	haljina	Nan
पोषक	hranjiva	Nan
पोषित	negovano	Nan
पोस्ट	pošta	None
पौड़ी	pauri	Nan
प्यूपा	pupa	Nan
पौत्र	unuk	Nan
पौधे	biljke	None
पौधों	biljke	None
पौराणिक	legendarno	Nan
प्यार	ljubav	None
प्याला	posuda	Nan
प्याले	čaše	Nan
पौधा	biljka	None
लाहौर	lahore	Nan
फीड	feed	Nan
फील्ड	polje	None
बैटरी	baterija	None
बैट	šišmiš	Nan
बैंड	bend	None
बैंगनी	ljubičasta	Nan
बैंकों	banke	None
बैंकिंग	bankarstvo	Nan
बैंकर	bankar	Nan
बैंक	banka	None
बेहद	ekstremno	None
बेहतरीन	najbolji	None
बेहतर	bolje	None
बेसिन	umivaonik	Nan
बेसिक	osnovni	None
बेस	baza	None
बेल्जियम	belgija	None
बेल	bell	None
बेरोजगारी	nezaposlenost	None
बुश	bush	Nan
बूट	čizma	Nan
बृहस्पति	jupiter	Nan
बेंच	klupa	Nan
बेक	beck	Nan
बेगम	kraljice	None
बैठ	sjedni	Nan
बेग़म	begum	Nan
बेटद्वारका	betdwarka	Nan
बेटा	sine	Nan
बेटी	kćerka	None
बेटे	sine	Nan
बेदी	bedi	Nan
बेन	ben	Nan
बेचने	prodaja	None
बैठक	sastanak	Nan
बैठकों	sastanci	Nan
बैठता	sjedi	Nan
बोलता	govori	None
बोलते	govori	None
बोलना	govoriti	None
बोलने	govoreći	None
बोला	govorio	None
बोलियाँ	ponude	None
बोलचाल	izgovoreno	Nan
बोलियों	ponude	None
बोली	jezik	None
बोले	govori	None
बोस	šef	None
बौद्ध	budističke	Nan
बौद्धिक	intelektualni	Nan
बौद्धों	budisti	Nan
बोलिविया	bolivija	Nan
बुलाया	nazvani	Nan
बोल	stihovi	None
बोनापार्ट	bonaparte	None
बैठते	sjedni	Nan
बैठने	sjedni	Nan
बैठा	sub	Nan
बैठें	sjedni	Nan
बैर	mržnja	Nan
बैरम	bairam	Nan
बोर्ड	odbor	None
बैल	bik	Nan
बॉम्बे	bombaj	Nan
बॉल	lopta	None
बोझ	teret	None
बोध	sense	Nan
बोधक	objašnjenje	None
बोनसाई	bonsai	Nan
बॉक्स	kutija	Nan
बुर्ज	turret	Nan
बुरे	loše	None
बुरी	loše	None
बिंदुओं	tačkice	Nan
बिक्री	prodaja	None
बिखरे	razbacani	Nan
बिजनेस	posao	None
बिजली	munja	Nan
बिड़ला	birla	Nan
बिंदु	tačka	None
बिताया	potrošen	Nan
बिन्दु	tačka	None
बिन्दुसार	bindusara	Nan
बियर	pivo	Nan
बिल	bill	None
बिलियन	milijardi	Nan
बिल्कुल	apsolutno	None
बिन	bez kante	Nan
बिल्ली	mačka	Nan
बाह्यसूत्र	epidermis	Nan
बाहरी कड़ियाँ	vanjske veze	Nan
बारीक	fino	Nan
बारे	o:	Nan
बाल	dijete	None
बालक	dečko	Nan
बालकाण्ड	predškolska ustanova	Nan
बालकृष्ण	balakrishna	Nan
बाह्य	spoljni	Nan
बालाजी	balaji	Nan
बालिका	djevojka	None
बाली	bali	Nan
बालों	kosa	None
बाल्टिक	baltik	Nan
बाल्यकाल	djetinjstvo	None
बावजूद	uprkos tome	Nan
बालि	bali	Nan
ब्याज	kamata	Nan
बिस्तर	krevet	Nan
बिहारी	bihari	Nan
बीसवीं	dvadeseti	Nan
बुंदेलखंड	bundelkhand	Nan
बुक्स	knjige	None
बुखार	vrućica	Nan
बुगरा	bugra	Nan
बुद्ध	buda	Nan
बीसवी	dvadeseti	Nan
बुद्धि	mudrost	Nan
बुध	sre	Nan
बुधवार	srijeda	Nan
बुनियादी	osnovni	None
बुरा	loše	None
बुराइयों	zli	None
बुराई	zlo	None
बुद्धिमान	inteligentan	Nan
बिहार	bihar	Nan
बीमारी	bolest	None
बीमार	bolestan	Nan
बी	b	None
बीएसई	bse	Nan
बीकानेर	bikaner	Nan
बीच	između	None
बीज	seme	Nan
बीजिंग	peking	Nan
बीमारियों	bolesti	None
बीजों	seme	Nan
बीटी	bt	Nan
बीत	isteklo	Nan
बीता	prošlost	None
बीबीसी	bbc	Nan
बीम	greda	Nan
बीमा	osiguranje	Nan
बीटा	beta	None
बारी	na redu	Nan
ब्यूरो	biro	Nan
ब्रजभाषा	braj bhasha	Nan
भारी	teški	None
भारद्वाज	bhardwaj	Nan
भारतेन्दु	bharatendu	Nan
भारतीयों	indijanci	Nan
भारतीय	indijanski	Nan
भारती	indijanski	Nan
भारतवर्ष	indija	None
भारत	indija	None
भार	teret	None
भाभी	snaha	Nan
भाप	steam	Nan
भाड़े	hakeri	Nan
भाटिया	bhatia	Nan
भाट	minstrel	Nan
भाजपा	b j p	Nan
भाग्य	sreća	Nan
भागो	bježi	None
भस्म	za konzumiranje	Nan
भाँति	kao	None
भांग	kanabis	Nan
भाइयों	braćo	Nan
भाई	brate	Nan
भाईचारे	bratstvo	None
भालू	medvjed	Nan
भाग	trčati	Nan
भागफल	kvocijent	Nan
भागलपुर	bhagalpur	Nan
भागवत	bhagwat	Nan
भागीदार	partner	Nan
भागीदारी	učešće	None
भागीरथी	bhagirathi	Nan
भागने	bijeg	Nan
भावना	osjećaj	None
भावनाओं	osjecanja	Nan
भावनात्मक	emotivni	Nan
भिन्नभिन्न	različite	None
भी	također	None
भीड	gužva	Nan
भीड़	gužva	Nan
भीतर	unutar	None
भीतरी	unutrašnji	None
भिन्नता	razlika	None
भीमगोडा	bhimgoda	Nan
भीषण	stravična	Nan
भुगतान	plaćanje	Nan
भुजा	ruka	None
भुजाओं	ruke	Nan
भुला	zaboravio	Nan
भुवन	bhuvan	Nan
भीमराव	bheemrao	Nan
भव्यता	veličanstvo	Nan
भित्ति	zid	None
भास्कर	bhaskar	Nan
भावी	budućnost	None
भावे	bhave	Nan
भावों	izrazi	None
भाषण	govor	None
भाषा	jezik	None
भाषाई	lingvistički	Nan
भि	također	None
भाषाएँ	jezici	None
भाषाओं	jezici	None
भाषापरिवार	jezička porodica	Nan
भाषायें	jezici	None
भाषाविज्ञान	nauka o jeziku	Nan
भाषी	govoreći	None
भाष्य	komentar	Nan
भाषाएं	jezici	None
भव्य	grand	None
भविष्यवाणी	predviđanje	Nan
भविष्य	budućnost	None
ब्रिटेन	britanija	None
ब्रितानी	britanski	None
ब्रॉडबैंड	širokopojasni	Nan
ब्लाग	blog	None
ब्लू	plava	None
ब्लेयर	blair	Nan
ब्रिटिशों	britanac	Nan
ब्लैक	crna	None
ब्लॉग	blog	None
भ	bh	None
भंग	kršenje	Nan
भंडार	prodavnica	Nan
भंडारण	skladištenje	Nan
भक्त	predan	Nan
ब्लॉक	blok	None
भक्ति	predanost	Nan
ब्रिटिश	britanac	Nan
ब्राहमण	brahmin	Nan
ब्रह्म	brahma	Nan
ब्रह्मचर्य	brahmacharya	Nan
ब्रह्मांड	univerzum	Nan
ब्रह्माजी	brahma	Nan
ब्रह्माण्ड	univerzum	Nan
ब्रह्मास्त्र	brahmastra	Nan
ब्रिज	most	None
ब्रांड	marka	None
ब्राउज़र	pretraživač	Nan
ब्राउज़रों	preglednici	Nan
ब्राउसर	pretraživač	Nan
ब्राज़ील	brazil	None
ब्राजील	brazil	None
ब्रायलर	broiler	Nan
ब्राउजर	pretraživač	Nan
ब्रज	braj	Nan
भक्तों	posvećeni	Nan
भगत	sledbenik	Nan
भरती	regrutacija	Nan
भरते	punjenje	Nan
भरने	punjenje	Nan
भरपूर	puno	None
भरा	pun	None
भरी	pun	None
भरतपुर	bharatpur	Nan
भरे	ispunjeno	Nan
भला	pa	None
भलाई	dobrota	Nan
भली	pa	None
भले	dobro	None
भवन	zgrada	None
भवनों	zgrade	None
भर्ती	zapošljavanje	Nan
भक्‍ति	predanost	Nan
भरत	bharat	Nan
भर	ispunjeno	Nan
भगवती	bhagwati	Nan
भगवद्गीता	bhagavad gita	Nan
भगवा	ocher	Nan
भगवान	bože	None
भगवान्	bože	None
भगवान्‌	bože	None
भरकर	napunjeno	Nan
भगिनी	sestro	Nan
भटक	lutanje	Nan
भत्ते	dodaci	Nan
भय	strah	None
भयंकर	strašno	Nan
भयभीत	uplašen	Nan
भयानक	strašno	Nan
भजन	himna	None
फीफा	fifa	None
बारिश	kiša	None
बारात	povorka	Nan
बढ़ते	montaža	Nan
बढ़ती	ustajanje	Nan
बढ़कर	više nego	Nan
बढ़	povećana	Nan
बढती	povećava	None
बढता	povećava	None
बढ	povećana	Nan
बडे	veliki	None
बडी	veliki	None
बडा	veliko	None
बड़ेबड़े	veliki	None
बड़े	veliki	None
बड़ी	veliki	None
बड़ा	veliki	None
बटन	prekidač	Nan
बजे	vreme	None
बजाय	umjesto toga	Nan
बचत	ušteda	Nan
बचना	izbjeći	Nan
बचने	bijeg	Nan
बचपन	djetinjstvo	None
बचा	levo	Nan
बचाने	spremi	Nan
बढ़ना	na glavu	Nan
बचाव	spašavanje	Nan
बच्चा	dijete	None
बच्चे	deca	Nan
बच्चों	deca	Nan
बजट	budžet	Nan
बजाए	umjesto toga	Nan
बजाते	ticking	Nan
बच्चन	bachchan	Nan
बढ़ने	odrasti	Nan
बढ़ाता	enhances	Nan
बढ़ाते	povećati	Nan
बताने	reci	Nan
बताया	rekao sam	Nan
बदनाम	badnaam	Nan
बदल	promjena	None
बदलकर	promjenom	Nan
बदलता	varira	None
बताना	reći	None
बदलती	različite	None
बदलना	promijeniti	None
बदलने	promijeniti	None
बदला	osveta	Nan
बदलाव	promjena	None
बदले	promjena	None
बनकर	biti napravljen	Nan
बदलते	promjena	None
बच	bijeg	Nan
बताते	kaže	None
बताता	kaže	None
बढ़ाना	podići	Nan
बढ़ाया	poboljšana	Nan
बढ़ावा	ohrabrenje	Nan
बढ़ी	poboljšana	Nan
बढा	povećana	Nan
बढाता	povećava	None
बताती	kaže	None
बढाने	povećati	Nan
बढावा	promocija	Nan
बढे	odrasti	Nan
बतलाया	rekao sam	Nan
बता	reci	Nan
बताई	rekao sam	Nan
बताए	reci	Nan
बढाया	povećana	Nan
बगैर	bez	None
बगीचों	vrtovi	Nan
बगावत	ustanak	None
फैरोओं	faraon	Nan
फैल	širenje	None
फैलता	šire	None
फैलने	izbijanje	Nan
फैला	širenje	None
फैलाने	disperse	Nan
फैरो	farrow	Nan
फैलाया	raspršeni	Nan
फैली	produžuje	Nan
फैशन	moda	Nan
फैसला	odluka	None
फैसले	presuda	Nan
फॉण्ट	font	Nan
फॉर	za	None
फैलाव	širenje	None
फोटो	fotografija	None
फैबेसी	fabacy	Nan
फेसबुक	facebook	None
फीस	naknade	Nan
फुट	ft	Nan
फूट	podijeliti	None
फूल	cvijet	None
फूलन	phoolan	Nan
फूलपौधों	cvjetne biljke	Nan
फैजाबाद	faizabad	Nan
फूलों	cvjetovi	None
फेंग	fang	Nan
फेज	faza	None
फेडरेशन	federacija	None
फेफड़ों	pluća	None
फेयर	fer	Nan
फेर	okreni se	Nan
फेंक	baci	Nan
बनता	napravljeno	Nan
फोटोग्राफी	fotografija	None
फोर्ट	fort	Nan
बंगलौर	bangalor	Nan
बंगाल	bengal	Nan
बंगाली	bengali	Nan
बंद	zatvori	Nan
बंदरगाह	luka	None
बंदरगाहों	portovi	Nan
बंगलोर	bangalor	Nan
बंदी	zarobljen	Nan
बंध	band	Nan
बंधन	obveznica	Nan
बंधे	svezan	Nan
बंबई	bombaj	Nan
बकरी	jarac	Nan
बगल	strana	None
बंदूक	pištolj	Nan
फोन	telefon	Nan
बंगलूरू	bangalor	Nan
बंगलादेश	bangladešu	Nan
फोर्स	sila	None
फौज	vojna	None
फ्रांस	francuska	None
फ्रांसिस	francis	Nan
फ्रांसिस्को	francisco	None
फ्रांसीसी	francuski	None
बंगलुरु	bangalor	Nan
फ्रेंच	francuski	None
फ्लाइट	let	None
फ्लू	gripa	Nan
फ्लैश	bljeskalica	Nan
फ्लोएम	phloem	Nan
फ्लोरिडा	florida	None
बंगला	bungalov	Nan
फ्रेम	okvir	None
बाराबंकी	barabanki	Nan
बनती	izmišljeno	Nan
बनवाया	izgrađen	None
बागवानी	vrtlarstvo	Nan
बाग	vrt	None
बाकी	ostalo	None
बाएं	levo	Nan
बाएँ	levo	Nan
बाईं	levo	Nan
बाई	sobarica	Nan
बाइबिल	biblija	Nan
बाइबल	biblija	Nan
बाइनरी	binarni	None
बांह	ruka	None
बांधने	da se veže	Nan
बांध	brana	Nan
बांटा	distribuirano	Nan
बांट	distribuirati	Nan
बांग्लादेश	bangladešu	Nan
बांग्ला	bangla	Nan
बहिष्कार	disfellowship	Nan
बहु	višestruko	Nan
बहुत	vrlo	None
बहुतायत	obilje	None
बहुधा	često	None
बहुमत	većina	None
बाग़	vrt	None
बहुमुखी	svestran	Nan
बहुवचन	množina	Nan
बहुसंख्यक	multitudinous	Nan
बाँग्ला	bengali	Nan
बाँट	distribucija	None
बाँटा	distribuirano	Nan
बाँध	vezati	Nan
बहुल	višestruko	Nan
बागान	plantaža	Nan
बागों	vrtovi	Nan
बाघ	tigar	Nan
बाध्यकारी	komulzivan	Nan
बाप	otac	None
बापू	bapu	Nan
बाबर	babar	Nan
बाबा	sveti	None
बाबू	babu	Nan
बाध्य	vezani	None
बायाँ	levo	Nan
बायें	levo	Nan
बार	puta	None
बारबार	više puta	Nan
बारह	dvanaest	None
बारहमासी	višegodišnji	Nan
बारहवीं	dvanaesti	Nan
बायीं	levo	Nan
बहाव	tok	None
बाधित	prekinuta	Nan
बादशाह	kralju	None
बाजपेयी	bajpai	Nan
बाज़ार	market	Nan
बाजार	tržište	None
बाजीराव	bajirao	Nan
बाड़ी	ograda	Nan
बाढ	poplava	None
बादशाहत	kralju	None
बाढ़	poplava	None
बातचीत	chit chat	Nan
बातें	stvari	None
बातों	stvari	None
बाद	posle	None
बादल	oblak	None
बादलों	oblaci	None
बाण	strelica	Nan
बहाल	nastavio	None
बहार	proljeće	None
बहाने	izgovori	Nan
बन्द	zatvoreno	Nan
बन्दरगाह	luka	None
बन्दी	zatvorenik	Nan
बन्ध	vezani	None
बम	bomba	None
बम्बई	bombaj	Nan
बनेगा	formiraće se	Nan
बयान	izjava	Nan
बरसात	kiša	None
बराक	barak	Nan
बराबरी	uporedni	Nan
बरेली	bareilly	Nan
बर्तन	plovilo	Nan
बर्फ	led	None
बरमूडा	bermuda	Nan
बर्बर	varvarski	Nan
बनें	postanite	Nan
बनीं	postao	None
बनाई	napravljeno	Nan
बनाकर	pravljenjem	Nan
बनाता	pravi	None
बनाती	pravi	None
बनाते	napravite	Nan
बनाना	napraviti	None
बने	budite napravljeni	Nan
बनाने	napravite	Nan
बनाया	napravite	Nan
बनायी	napravljeno	Nan
बनाये	napravite	Nan
बनारस	banaras	Nan
बनावट	tekstura	Nan
बनी	napravljeno	Nan
बनाम	vs	Nan
बनते	su napravljeni	Nan
बर्बरता	vandalizam	Nan
बर्लिन	berlin	None
बसी	riješen	Nan
बसु	basu	Nan
बसे	riješen	Nan
बसें	autobusi	Nan
बस्तियों	naselja	None
बस्ती	kolonije	None
बसाया	smjestiti se	Nan
बह	tok	None
बहने	teče	None
बहरहाल	kako god	Nan
बहस	debata	Nan
बहा	prolivanje	Nan
बहादुर	hrabar	Nan
बहाना	izgovor	None
बहन	sestra	None
बर्मा	burma	Nan
बसने	smjestiti se	Nan
बल्लेबाजी	batting	Nan
बल	sila	None
बलदेव	baldev	Nan
बलपूर्वक	na silu	Nan
बलबन	balban	Nan
बलराम	balaram	Nan
बलि	žrtva	None
बल्लेबाजों	miševi	Nan
बलिदान	žrtva	None
बलुआ	pesak	Nan
बलों	sile	None
बल्कि	umjesto toga	Nan
बल्लभ	ballabh	Nan
बल्ले	šišmiš	Nan
बल्लेबाज	batsman	Nan
बलिया	baliya	Nan
लिंक	veza	None
लिंकन	lincoln	Nan
लिंक्स	veze	None
सुचना	biljeska	Nan
सुगम	lako	None
सुगंध	miris	None
सुखों	zadovoljstva	Nan
सुखी	sretno	Nan
सुखा	suva	Nan
सुखसागर	sukhsagar	Nan
सुख	sreća	Nan
सुक्ष्म	fino	Nan
सुकरात	sokrat	None
सुई	igla	Nan
सुअर	svinja	None
सुंदरवन	sundarbani	Nan
सुंदरता	ljepota	Nan
सुंदर	prekrasno	Nan
सीसा	olovo	None
सील	pečat	None
सीधी	ravno	None
सीधे	direktno	None
सीने	grudi	Nan
सीनेट	senat	None
सीनेटर	senatore	Nan
सीमा	limit	Nan
सुचारु	glatko	Nan
सीमाएँ	granice	None
सीमाओं	granice	None
सीमायें	granice	None
सीमित	ograničena	None
सीमेंट	cement	Nan
सीरिया	sirije	None
सीरीज	serija	None
सीमाएं	ograničenja	None
सुचारू	glatko	Nan
सुदर्शन	sudarshan	Nan
सुदूर	daljinski	Nan
सुन्दरी	divno	Nan
सुन्नी	sunitski	None
सुपर	super	None
सुप्रसिद्ध	dobro poznata	Nan
सुबह	ujutro	None
सुभद्रा	subhadra	Nan
सुन्दरता	ljepota	Nan
सुभाष	subhash	Nan
सुभाषित	dobro definisano	Nan
सुमन	suman	Nan
सुमात्रा	sumatra	Nan
सुमित्रा	sumitra	Nan
सुमित्रानंदन	sumitranandan	Nan
सुर	tone	None
सुभाषबाबू	subhash babu	Nan
सीधा	ravno	None
सुन्दर	divno	Nan
सुनीता	sunita	Nan
सुदृढ़	jak	None
सुधा	sudha	Nan
सुधारक	reformator	Nan
सुधारने	poboljšati	Nan
सुधारों	reforme	None
सुन	slušaj	Nan
सुनील	sunil	Nan
सुनकर	slušam	Nan
सुनने	slušaj	Nan
सुना	čuo	None
सुनाई	čuo	None
सुनाया	pričala	Nan
सुनिश्चित	budi siguran	Nan
सुनी	slušano	Nan
सुनते	slušaj	Nan
सीताजी	sitaji	Nan
सीता	sita	Nan
सीढ़ी	ljestve	Nan
सिख	sikhsi	Nan
सिखाने	učiti	Nan
सिखाया	poučeno	Nan
सिखों	sikhsi	Nan
सिगरेट	cigareta	Nan
सिटी	grad	None
सिक्खों	sikhsi	Nan
सिडनी	sydney	Nan
सितम्बर	septembra	None
सितारा	zvezda	Nan
सितारे	zvezde	Nan
सितारों	zvijezde	None
सिद्ध	dokazan	Nan
सिद्धांत	teorija	None
सितंबर	septembra	None
सिद्धांतों	principi	None
सिक्के	kovanice	Nan
सिक्का	novac	None
साहेब	saheb	Nan
सिंगापुर	singapuru	Nan
सिंड्रोम	sindrom	None
सिंध	sindh	Nan
सिंधिया	scindia	Nan
सिंधी	sindhi	Nan
सिक्किम	sikkim	Nan
सिंधु	indus	Nan
सिंहली	sinhalese	Nan
सिंहस्थ	simhastha	Nan
सिंहासन	prestol	Nan
सिकंदर	aleksandra	None
सिकंदराबाद	secunderabad	Nan
सिकन्दर	aleksandra	None
सिंह	lav	None
सुरंग	tunel	None
सिद्धान्त	princip	None
सिद्धार्थ	siddharth	Nan
सिवाय	osim	None
सिविल	civil	Nan
सिस्टम	sistem	None
सी++	c ++	Nan
सीकरी	sikri	Nan
सीक्रेट	tajna	None
सिल्क	svila	Nan
सीख	učenje	None
सीखा	naučeno	Nan
सीखें	naučite	Nan
सीट	seat	Nan
सीटें	sedišta	Nan
सीटों	sedišta	Nan
सीडी	cd	None
सीखने	učenje	None
सिद्धान्तों	principi	None
सिलाई	bod	Nan
सिर्फ़	samo	None
सिद्धि	uspjeh	None
सिनेमा	kino	Nan
सिन्ध	sindh	Nan
सिन्धी	sindhi	Nan
सिन्धु	indus	Nan
सिन्हा	sinha	Nan
सिलसिला	nastavak	None
सिपाहियों	vojnici	None
सिफर्स	šifre	Nan
सिफारिश	preporuka	Nan
सिम	sim	Nan
सियोल	seul	Nan
सिर	glava	None
सिर्फ	samo	None
सिपाही	vojnik	None
साहित्‍य	literatura	None
सुरक्षा	sigurnost	None
सुरा	sura	Nan
सोडियम	natrijum	None
सोचा	razmisli	Nan
सोचने	misliti	Nan
सोचते	razmisli	Nan
सो	s / o	Nan
सॉफ्टवेर	softver	None
सॉफ्टवेयर	softver	None
सैलानी	turist	Nan
सैलानियों	turiste	Nan
सैर	šetnja	Nan
सैयद	syed	Nan
सैन्य	vojna	None
सैद्धांतिक	teoretski	None
सैकड़ों	stotine	None
सेवायें	usluge	None
सेवाओं	usluge	None
सेवाएं	usluge	None
सेतु	most	None
सेन	sen	Nan
सेना	vojska	None
सेनाओं	vojske	None
सेनानी	borac	None
सेनापति	komandante	Nan
सोते	spavanje	None
सेन्ट्रोसोम	centrosome	Nan
सेल	ćelija	None
सेलुलर	cellular	Nan
सेल्यूकस	seleuk	Nan
सेल्सियस	celzijusa	Nan
सेवक	sluga	Nan
सेवाएँ	usluge	None
सेब	apple	Nan
सोन	sine	Nan
सोना	zlato	None
सोनिया	sonia	Nan
सौन्दर्य	ljepota	Nan
सौभाग्य	sretno	Nan
सौम्य	blaga	Nan
सौर	solarno	Nan
सौरमंडल	solarni sistem	Nan
सौरमास	saurmas	Nan
सौदा	dogovor	None
सौराष्ट्र	saurashtra	Nan
स्कन्ध	krila	None
स्काई	sky	Nan
स्कूल	škola	None
स्कूली	škola	None
स्कूलों	škole	None
स्केल	skala	Nan
स्कन्द	skand	Nan
सेठ	seth	Nan
सौजन्य	ljubaznošću	Nan
सौंप	predani	Nan
सोने	zlato	None
सोपान	korak	None
सोम	som	Nan
सोमनाथ	somnath	Nan
सोमवार	ponedeljak	Nan
सोर्स	izvor	None
सौंपा	dodeljeno	Nan
सोलह	šesnaest	Nan
सोविएत	sovjetski	None
सोवियत	sovjetski	None
सोसाइटी	društvo	None
सोसायटी	društvo	None
सौ	stotinu	None
सौंदर्य	ljepota	Nan
सोलहवीं	šesnaesti	Nan
सेट	set	None
सेगोविआ	segovia	Nan
सेक्स	seks	None
सूअरों	svinje	None
सूक्ष्म	suptilno	Nan
सूक्ष्मजीव	mikroorganizmi	Nan
सूक्ष्मजीवों	mikroorganizmi	Nan
सूक्ष्मजैविक	mikrobiološka	Nan
सूक्ष्मजैविकी	mikrobiologija	Nan
सूअर	svinje	None
सूक्ष्मदर्शी	mikroskopi	Nan
सूखा	suva	Nan
सूखापन	suvoća	Nan
सूखी	suva	Nan
सूखे	osušen	Nan
सूचक	okvirno	Nan
सूचकांक	indeks	Nan
सूख	osušen	Nan
सूचना	informacija	None
सुस्पष्ट	primetno	Nan
सुषमा	sushma	Nan
सुरेन्द्र	surendra	Nan
सुरेश	suresh	Nan
सुलझाने	rešavanje	Nan
सुलभ	pristupačno	Nan
सुल्तान	sultan	None
सुल्तानों	sultani	Nan
सुसज्जित	namješteno	Nan
सुवर्ण	zlato	None
सुविधाएँ	značajke	Nan
सुविधाएं	sadržaji	Nan
सुविधाजनक	povoljno	Nan
सुव्यवस्थित	dobro organiziran	Nan
सुशील	susheel	Nan
सुशोभित	graciozan	Nan
सुविधा	objekt	None
सुरक्षित	siguran	Nan
सूचनाएं	obavijesti	Nan
सूचि	lista	None
सूर्यकांत	suryakant	Nan
सूर्यदेव	bog sunca	Nan
सूर्योदय	izlazak sunca	Nan
सृजन	kreacija	Nan
सृजनगाथा	priča o stvaranju	Nan
सृजनात्मक	kreativno	Nan
सूर्य	sunce	None
सृजित	napravljeno	Nan
से	od	None
सेंटर	središte	None
सेंट्रल	centralni	None
सेंसेक्स	sensex	Nan
सेकंड	sekunda	Nan
सेक्टर	sektor	None
सृष्टि	stvaranje	None
सूचनाओं	obavijesti	Nan
सूरी	suri	Nan
सूरत	lice	None
सूचित	informišite	Nan
सूची	lista	None
सूजन	oticanje	Nan
सूडान	sudan	Nan
सूत्र	navoj	Nan
सूत्रधार	narator	Nan
सूरदास	surdas	Nan
सूत्रपात	herald	Nan
सूनामी	tsunami	Nan
सूफ़ी	sufiji	Nan
सूफी	sufiji	Nan
सूबेदार	subedar	Nan
सूर	sur	Nan
सूरज	sunce	None
सूत्रों	izvori	None
स्कैंडिनेवियाई	skandinavski	Nan
साहित्यिक	književni	None
साहित्य	literatura	None
सरस	saras	Nan
सरलता	jednostavnost	Nan
सरल	lako	None
सरन	saran	Nan
सरदार	šefe	Nan
सरकारों	vlade	None
सरकारें	vlade	None
सरकारी	službeni	None
सरकार	vlada	None
सर	glava	None
सयुंक्त	united	None
सम्राट्	cara	None
सम्राटों	carevi	Nan
सम्राट	car	None
सम्यक	tačno	None
सम्मेलन	seminara	Nan
सम्मुख	nasuprot	None
सम्बंधित	srodni	Nan
सम्बंधी	srodni	Nan
सम्बद्ध	saveznički	Nan
सम्बन्धित	srodni	Nan
सम्बन्धी	srodni	Nan
सम्बोधित	adresa	None
सरसों	senf	Nan
सम्भवतः	možda	None
सम्भोग	razgovor	None
सम्मलेन	konferencija	Nan
सम्मान	čast	None
सम्मानित	poštovani	Nan
सम्मिलित	uključeno u	Nan
सम्मिश्रण	blending	Nan
सम्भावना	mogućnost	None
सराहना	zahvalnost	Nan
सराहा	cenjeno	Nan
सरीसृप	reptili	Nan
सर्वाधिक	većina	None
सर्विस	usluga	None
सर्वे	anketa	Nan
सर्वेक्षण	anketa	Nan
सर्वोत्तम	najbolji	None
सर्वोपरि	najvažnije	None
सर्वांगीण	sve okolo	Nan
सलमान	salman	Nan
सलाहकार	savjetnik	Nan
सलीम	salim	Nan
सल्तनत	sultanat	Nan
सल्फर	sumpor	None
सल्ल	sall	Nan
सवाई	sawai	Nan
सलाह	savjet	None
सम्बंध	odnos	None
सर्वश्रेष्ठ	najbolji	None
सर्वव्यापी	sveprisutna	Nan
सरोवर	jezero	None
सर्च	traži	None
सर्दियों	zima	None
सर्दी	hladno	Nan
सर्प	zmija	None
सर्पिल	spirala	Nan
सर्वशक्तिमान	svemogući	Nan
सर्वज्ञ	sveznajući	Nan
सर्वदा	zauvijek	None
सर्वनाम	izgovara	None
सर्वपल्ली	sarvapalli	Nan
सर्वप्रथम	prvi	None
सर्वमान्य	univerzalno prihvaćeno	Nan
सर्वर	server	None
सर्वथा	sve u svemu	Nan
सम्प्रदायों	zajednice	None
सम्प्रदाय	zajednica	None
सम्पूर्ण	ukupno	None
समाज	društvo	None
समाजवाद	socijalizam	None
समाजवादी	socijalistička	None
समाजशास्त्र	sociologija	None
समाजों	društva	None
समाधान	rješenje	None
समाचारपत्रों	novine	None
समाधि	mauzolej	Nan
समानता	ravnopravnost	None
समानताएं	sličnosti	None
समानांतर	paralelno	None
समानान्तर	paralelno	None
समाप्त	kraj	None
समाप्ति	kraj	None
समान	isto	None
समारोह	ceremonija	None
समाचारपत्र	novine	None
समांतर	paralelno	None
समर्थक	pristalice	Nan
समर्थकों	pristalice	Nan
समर्थन	podrška	None
समर्पण	posvećenost	Nan
समर्पयामि	posvećenost	Nan
समर्पित	posvećena	None
समाचार	vijesti	None
समशीतोष्ण	umereno	Nan
समस्त	sve	None
समस्या	problem	None
समस्याएँ	problemi	None
समस्याएं	problemi	None
समस्याओं	problemi	None
समा	okolina	None
समसामयिक	savremeni	None
सवार	jahanje	Nan
समारोहों	proslave	Nan
समाविष्ट	uključeno	Nan
समूचे	cjelinu	None
समूह	grupa	None
समूहों	grupe	None
समृद्ध	prosperitetni	Nan
समृद्धि	blagostanje	Nan
समेटे	pohvali	Nan
समुद्रों	mora	None
समेत	uključujući	None
सम्पत्ति	vlasništvo	None
सम्पदा	estates	Nan
सम्पन्न	gotovo	None
सम्पर्क	kontakt	None
सम्पादन	uređivanje	Nan
सम्पादित	izmijenjeno	Nan
समोच्च	kontura	Nan
समालोचना	kritika	None
समुद्री	marine	Nan
समुद्रतट	morska obala	Nan
समावेश	uključenost	Nan
समाहित	sadržani	Nan
समिति	odbor	None
समितियों	odbori	Nan
समीकरण	jednadžba	Nan
समीकरणों	jednadžbe	Nan
समुद्रतल	nivo mora	Nan
समीक्षा	pregled	None
समुचित	ispravno	None
समुच्चय	set od	Nan
समुदाय	zajednica	None
समुदायों	zajednice	None
समुद्र	more	None
समुद्रगुप्त	samudragupta	Nan
समीप	u blizini	Nan
साहित्यकार	litterateur	Nan
सवारी	vozi se	Nan
सविता	savita	Nan
सामना	lice	None
सामग्री	materijala	None
सामंजस्य	harmonija	Nan
साम	stvari	None
साबुन	sapun	Nan
साबित	dokazano	Nan
साफ्टवेयर	softver	None
साफ	čist	None
साप्ताहिक	nedeljno	Nan
सापेक्षता	relativnost	Nan
सापेक्ष	relativno	None
सान्निध्य	neprekidno	None
सानिया	sania	Nan
साध्य	izvodljivo	Nan
साधु	pustinjak	Nan
साधारणतया	uopšte	None
साधारणतः	uopšte	None
सातवाँ	sedma	Nan
सातवीं	sedma	Nan
सात्विक	moralni	None
साथ	sa	None
साथसाथ	zajedno	None
साथियों	vršnjaci	Nan
सामने	prednji	None
साथी	partnera	None
साध	pomoć	None
साधक	tragač	Nan
साधन	resursi	None
साधना	meditacija	Nan
साधनों	znacenje	Nan
साधारण	jednostavno	None
सादगी	jednostavnost	Nan
सामरिक	strateški	None
सामान	prtljaga	Nan
सामान्य	normalno	None
सार्थक	smisleno	Nan
सार्वजनिक	javno	None
सार्वजानिक	javno	None
सार्वभौमिक	univerzalno	Nan
साल	godine	None
सालाना	godišnje	None
सारे	sve	None
सालों	godinama	None
सावन	monsun	Nan
सावरकर	savarkar	Nan
सावित्री	savitri	Nan
साहब	gospodine	Nan
साहसिक	avantura	Nan
साहसी	hrabar	Nan
सावधान	pažljiv	Nan
सात	sedam	None
सारी	sve	None
सारा	sve	None
सामान्यत	uopšte	None
सामान्यतः	uglavnom	None
सामान्यतया	uopšte	None
सामी	sami	None
सामुदायिक	zajednica	None
सामूहिक	kolektiv	Nan
सारांश	sažetak	Nan
साम्राज्य	carstvo	None
साम्राज्यों	carstva	None
सायंकाल	večer	None
सार	apstraktno	Nan
सारणी	raspored	None
सारथी	kočija	Nan
सारनाथ	sarnath	Nan
साम्राज्यवाद	imperijalizam	Nan
साढेसाती	sadesati	Nan
साड़ी	saree	Nan
साठ	šezdeset	Nan
सहस्र	sahasra	Nan
सहस्राब्दी	milenijum	Nan
सहस्रों	milenijum	Nan
सहानुभूति	simpatija	Nan
सहाय	pomoć	None
सहायक	asistent	Nan
सहस्त्रपाद	mille	Nan
सहायता	pomoć	None
सहारा	pomoć	None
सहारे	podrška	None
सहित	uključujući	None
सहिष्णुता	tolerancija	Nan
सही	tačno	None
सा	sa	None
सहारनपुर	saharanpur	Nan
साँची	sanchi	Nan
सहलक्षण	simbol	None
सहयोग	pomoć	None
सविन्धान	ustav	None
सशक्त	jak	None
सशस्त्र	naoružani	Nan
सस्ता	jeftino	Nan
सस्ते	jeftino	Nan
सह	the co	Nan
सहयोगी	partner	Nan
सहकारी	zadruga	Nan
सहज	spontano	Nan
सहजता	prirodnost	Nan
सहन	tolerirati	Nan
सहनशीलता	tolerancija	Nan
सहमत	slažem se	Nan
सहमति	ugovor	None
सहगल	sehgal	Nan
सवालों	pitanja	None
साँप	zmija	None
सांकेतिक	token	Nan
साओ	sao	Nan
साकार	shvatajući	Nan
साकी	saki	Nan
साकीबाला	saqibala	Nan
साकेत	saket	Nan
साक्षरता	pismenost	None
साईट	mjesto	None
साक्षात्	osoba	None
साक्षी	svedok	Nan
साक्ष्य	dokazi	None
साखी	prijatelju	Nan
सागर	more	None
साझा	deljeno	Nan
साझेदारी	partnerstva	Nan
साक्षात्कार	intervju	None
साँस	dah	Nan
साई	sai	Nan
साइड	sa strane	Nan
सांख्य	numerički	Nan
सांख्यिकी	statistika	None
सांख्यिकीय	statistički	None
सांची	sanchi	Nan
सांप्रदायिक	komunalno	Nan
सांभर	sambar	Nan
साइडर	jabukovača	Nan
सांस	dah	Nan
सांसारिक	zemaljski	Nan
सांस्कृतिक	kulturni	None
साइंस	nauka	None
साइकिल	bicikl	Nan
साइट	mjesto	None
साइटों	web stranice	Nan
सांसद	član parlamenta	Nan
समर्थ	sposoban	Nan
स्कैन	skeniranje	Nan
स्कॉटलैंड	škotska	None
१००	100	Nan
१०	10	Nan
१	1	Nan
०	0	Nan
ह्रास	pogoršanje	Nan
ह्रदय	srce	None
होश	osjetila	Nan
होली	holi	Nan
होलिका	kres	Nan
होम्योपैथी	homeopatija	Nan
होमियोपैथी	homeopatija	Nan
होमर	homer	Nan
होम	dom	None
होनेवाले	biti	None
होनेवाली	biti	None
होनी	biti	None
होना	dogodi se	Nan
हॉल	hall	Nan
हॉलीवुड	hollywood	Nan
हो	ho	None
हों	budi	None
होंगी	bice	Nan
होंगे	bice	Nan
१०००	1000	Nan
होकर	kroz	None
होगी	bice	Nan
होटल	hotel	None
होड़	takmičenje	None
होता	dogodi se	Nan
होती	imao bi	Nan
होते	pojavljuju se	Nan
होगा	dogodit će se	Nan
१००००	10000	Nan
१०५	105	Nan
१०८	108	Nan
१८वीं	17th	Nan
१८१५	1815	Nan
१८४०	170	Nan
१८५०	1850	Nan
१८५७	1856	Nan
१८८०	170	Nan
१८	14	Nan
१९	19	Nan
१९००	1900	Nan
१९०१	1901	Nan
१९०२	1902	Nan
१९०३	1903	Nan
१९०४	1906	Nan
१९०६	1906	Nan
१९वीं	19.	Nan
हॉकी	hokej	None
१७००	1800	Nan
१६७४	14	Nan
१०९	10 9	Nan
११	11	Nan
१२	12	Nan
१२वीं	12.	Nan
१२०	120	Nan
१३	13	Nan
१७	14	Nan
१४	14	Nan
१५	15	Nan
१५वीं	15.	Nan
१५०	150	Nan
१५००	1500	Nan
१६	14	Nan
१६वीं	17th	Nan
१४००	1800	Nan
हैहालांकि	kako god	Nan
हैसूर्य	hesury	Nan
हैसियत	status	None
हुमायूं	humayun	Nan
हुयी	dogodilo se	Nan
हुये	dogodilo se	Nan
हुसैन	hussain	Nan
हूँ	ja sam	Nan
हूं	am	Nan
हुमायूँ	humayun	Nan
हूनान	hunan	Nan
हे	hej	Nan
हेक्टेयर	hektara	Nan
हेतु	za	None
हेमंत	hemant	Nan
हेमा	hema	Nan
हेरात	herat	Nan
हॅ	is	Nan
हेलोवीन	noć vještica	Nan
हुगली	huoghly	Nan
हुए	jeste	None
हिस्सा	deo	Nan
हिस्से	delovi	Nan
हिस्सों	delovi	Nan
ही	samo	None
हींग	asafoetida	Nan
हीन	inferiorni	Nan
हुक्म	naredba	None
हीनयान	hinayana	Nan
हीरे	dijamanti	Nan
हीरो	heroj	None
हीलियम	helijum	Nan
हुआ	dogodilo se	Nan
हुआ|	dogodilo se	Nan
हुईं	pojavio se	Nan
हीरा	dijamant	None
१९०७	1906	Nan
हेल्थ	zdravlje	None
है	je	None
हैजब	kada	None
हैजो	ko je ko	Nan
हैतो	onda	None
हैदर	haider	Nan
हैदराबाद	hyderabad	Nan
हैदराबादी	hyderabadi	Nan
हैकुछ	uzmi malo	Nan
हैयह	je li ovo	Nan
हैरी	harry	Nan
हैलेकिन	ali	None
हैलोवीन	noć vještica	Nan
हैवह	on je	Nan
हैवे	jeste	None
हैव्यक्ति	osoba	None
हैया	haiya	Nan
हेस्टिया	hestia	Nan
हैकि	to	None
हैउसे	on ima	Nan
है|	is	Nan
हैँ	da	None
हैं	huh	Nan
हैं|	are	Nan
हैंइसके	njegova	None
हैंउनके	oni imaju	Nan
हैएक	postoji jedan	Nan
हैंयह	to je	Nan
हैंशनि	hanshi	Nan
हैअगर	ako	None
हैइसका	njegova	None
हैउदाहरण	primjer	None
हैउसका	on ima	Nan
हैउसके	on ima	Nan
हैंवे	hanvey	Nan
हिस्ट्री	istorija	None
१९०९	1909	Nan
१९११	1911	Nan
३९	39	Nan
३८	37	Nan
३७	37	Nan
३६	37	Nan
३५०	350	Nan
३५	35	Nan
३४	37	Nan
३३	33	Nan
३२२	322	Nan
३२०	320	Nan
३२	32	Nan
३१	31	Nan
३०००	3000	Nan
३००	300	Nan
३०	30	Nan
३	3	Nan
२९	29	Nan
२००७	2008	Nan
२००८	2008	Nan
२००९	2009	Nan
२०११	2011	Nan
२०१२	2012	Nan
२१	21	Nan
४	4	Nan
२२	22	Nan
२५	25	Nan
२५०	250	Nan
२६	24	Nan
२७	24	Nan
२७३	243	Nan
२८	24	Nan
२३	23	Nan
४०	40	Nan
४००	400	Nan
४२	42	Nan
६४	4	Nan
६५	45	Nan
७	4	Nan
७०	40	Nan
७५	45	Nan
८	4	Nan
६०००	8000	Nan
८०	40	Nan
८४	4	Nan
८५	45	Nan
९	4	Nan
९०	90	Nan
९५	95	Nan
९८	९ ८	Nan
८००	400	Nan
२००६	2008	Nan
६००	400	Nan
६	4	Nan
४३	43	Nan
४५	45	Nan
४६	4	Nan
४७	4	Nan
४८	4	Nan
५	5	Nan
६०	40	Nan
५०	50	Nan
५०००	5000	Nan
५१	51	Nan
५२	52	Nan
५३	53	Nan
५५	55	Nan
५६	58	Nan
५००	500	Nan
२००५	2005	Nan
२००४	2008	Nan
२००३	2003	Nan
१९४५	1945	Nan
१९४७	1949	Nan
१९४८	1949	Nan
१९४९	1949	Nan
१९५०	1950	Nan
१९५२	1952	Nan
१९४३	1963	Nan
१९५३	1953	Nan
१९५५	1955	Nan
१९५६	1956	Nan
१९५७	1956	Nan
१९५९	1959	Nan
१९६०	1960	Nan
१९६१	1961	Nan
१९५४	1956	Nan
१९६२	1962	Nan
१९४२	1962	Nan
१९३७	1937	Nan
१९१७	1914. god	Nan
१९१८	1914. god	Nan
१९१९	1919	Nan
१९२१	1921	Nan
१९२२	1922	Nan
१९२४	1926	Nan
१९३९	1939	Nan
१९२५	1925	Nan
१९२९	1929	Nan
१९३०	1930 god	Nan
१९३१	1931	Nan
१९३२	1932	Nan
१९३४	1937	Nan
१९३६	1937	Nan
१९२८	1926	Nan
१९१०	1910	Nan
१९६४	1949	Nan
१९६८	1949	Nan
१९८९	1949	Nan
१९९०	190	Nan
१९९१	191	Nan
१९९२	192	Nan
१९९४	1949	Nan
१९९६	1949	Nan
१९८८	1949	Nan
१९९७	1949	Nan
१९९९	19	Nan
२	2	Nan
२०	20	Nan
२००	200	Nan
२०००	2000	Nan
२००१	2001	Nan
१९९८	1949	Nan
१९६५	1945	Nan
१९८७	1949	Nan
१९८५	1945	Nan
१९६९	1949	Nan
१९७०	1960	Nan
१९७१	1961	Nan
१९७३	1963	Nan
१९७४	1949	Nan
१९७६	1949	Nan
१९८६	1949	Nan
१९७७	1949	Nan
१९७९	1949	Nan
१९८०	1960	Nan
१९८१	1961	Nan
१९८२	1962	Nan
१९८३	1963	Nan
१९८४	1949	Nan
१९७८	1949	Nan
स्कैनिंग	skeniranje	Nan
हिसाब	proračun	Nan
हिम्मत	hrabrost	None
स्वयंभू	samozvani	Nan
स्वयं	ja	None
स्वप्न	san	None
स्वपोषी	autotrofično	Nan
स्वदेशी	moja zemlja	Nan
स्वदेश	matična zemlja	Nan
स्वतन्त्रता	sloboda	None
स्वतन्त्र	besplatno	Nan
स्वतः	auto	Nan
स्वतंत्रता	sloboda	None
स्वतंत्र	besplatno	Nan
स्वच्छमण्डल	čista soba	Nan
स्वच्छता	čistoća	Nan
स्वच्छंद	wayward	Nan
स्वच्छ	čist	None
स्वंय	sebe	None
स्व	ja	None
स्पेन	španija	None
स्पेनी	španski	None
स्पेशल	poseban	None
स्पेस	prostor	None
स्पैनिश	španski	None
स्प्रे	sprej	Nan
स्वयंवर	swayamvar	Nan
स्मरण	sjećanje	Nan
स्मारकों	spomenici	None
स्मिथ	smith	Nan
स्मृति	memorija	None
स्राव	otpust	Nan
स्रोत	izvor	None
स्रोतों	izvori	None
स्मारक	spomen obilježje	Nan
स्वयंसेवक	volontiranje	Nan
स्वर	samoglasnik	Nan
स्वराज	swaraj	Nan
स्वामी	vlasnik	None
स्वामीजी	svamiji	Nan
स्वायत्त	autonomni	Nan
स्वास्थ्य	zdravlje	None
स्विट्जरलैंड	švajcarska	Nan
स्विस	švajcarski	Nan
स्वामित्व	vlasništvo	None
स्वीकार	prihvati	None
स्वीकृति	prihvatanje	None
स्वीडन	švedska	None
स्वीडिश	švedski	None
स्‍त्री	ženski	None
स्‍थान	mesto	Nan
हंस	labud	Nan
स्वीकृत	odobreno	Nan
स्पेक्ट्रम	spektar	None
स्वाभिमानी	samopoštovanje	Nan
स्वाभाविक	prirodno	None
स्वरुप	obrazac	Nan
स्वरूप	obrazac	Nan
स्वरों	samoglasnici	Nan
स्वर्ग	nebesa	Nan
स्वर्गीय	nebeski	Nan
स्वर्ण	zlato	None
स्वाभिमान	samopoštovanje	Nan
स्वशासन	samouprava	Nan
स्वाइन	svinja	None
स्वागत	dobrodošli	Nan
स्वाद	ukus	None
स्वादिष्ट	ukusno	Nan
स्वाधीनता	nezavisnost	None
स्वानिकी	fonetika	Nan
स्वस्थ	zdrav	Nan
स्पीकर	zvučnik	Nan
स्पिन	okretanje	Nan
स्पष्टीकरण	objašnjenje	None
स्ट्रीम	potok	None
स्तंभ	stupac	Nan
स्तंभन	erektilna	Nan
स्तंभों	stupci	Nan
स्तन	dojke	None
स्तनधारी	sisari	None
स्ट्रीट	ulica	None
स्तम्भ	stupac	Nan
स्तरीय	nivo	None
स्तुति	pohvale	Nan
स्तूप	stupa	Nan
स्तोत्र	himna	None
स्त्रियाँ	žene	None
स्त्रियां	žene	None
स्तर	nivo	None
स्त्रियों	žene	None
स्ट्राइकर	napadač	Nan
स्टैण्डर्ड	standardno	Nan
स्कॉटिश	škotski	Nan
स्कोर	rezultat	None
स्क्रबर	scrubber	Nan
स्क्रीन	ekran	Nan
स्क्रीनिंग	screening	Nan
स्खलन	ejakulacija	Nan
स्टॉक	zaliha	Nan
स्टाफ	osoblje	Nan
स्टील	čelik	None
स्टेट	država	None
स्टेडियम	stadion	None
स्टेम	stabljika	Nan
स्टेशन	stanica	None
स्टेशनों	stanice	None
स्टार	zvijezda	None
हक़	tačno	None
स्त्रीकेसर	tučak	Nan
स्त्रोत	izvor	None
स्थितियों	uslovi	None
स्थिती	pozicija	None
स्थिर	fiksno	Nan
स्थिरता	stabilnost	None
स्थूल	makro	Nan
स्थैतिक	statički	Nan
स्थिति	događaj	None
स्नातक	diplomirati	Nan
स्नान	kupatilo	Nan
स्नायु	mišića	None
स्नेह	ljubav	None
स्पर्श	dodirnite	Nan
स्पष्ट	jasno	None
स्पष्टता	jasnoća	Nan
स्नातकोत्तर	postdiplomski	Nan
स्त्रीपुरूष	žensko	Nan
स्थित	smješten	None
स्थापित	uspostavljeno	Nan
स्त्रोतों	izvori	None
स्थगित	odloženo	Nan
स्थल	mjesto	None
स्थलाकृति	topografija	Nan
स्थान	mesto	Nan
स्थानांतरण	transfer	Nan
स्थायी	stalni	None
स्थानांतरित	premješteno	Nan
स्थानीय	lokalno	None
स्थानों	mjesta	None
स्थापत्य	arhitektura	None
स्थापत्यकला	arhitektura	None
स्थापन	instalacija	Nan
स्थापना	osnivanje	None
स्थानिक	lokalno	None
हिल	brdo	None
हज	hadž	None
हज़रत	hazreti	Nan
हाला	vino	None
हालत	stanje	None
हाल	stanje	None
हार्वर्ड	harvard	Nan
हार्मोन	hormoni	None
हार्डी	hardy	Nan
हार्डवेयर	hardver	None
हार	poraz	None
हानिकारक	štetno	Nan
हानि	gubitak	None
हान	han	None
हाथों	ruke	Nan
हाथी	slon	Nan
हाथियों	slonovi	Nan
हाथ	ruka	None
हाजी	haji	Nan
हाउसबोट	brodski brod	Nan
हस्तशिल्प	ručni rad	Nan
हस्ताक्षर	potpis	Nan
हस्तिनापुर	hastinapur	Nan
हस्तियों	poznate ličnosti	Nan
हाँ	da	None
हां	da	None
हालाँकि	kako god	Nan
हांग	hong	Nan
हाइड्रिल्ला	hydrilla	Nan
हाइड्रोकार्बन	ugljikovodonici	Nan
हाइड्रोजन	vodonik	None
हाइपर	hyper	Nan
हाई	ćao	Nan
हाउस	kuća	None
हांगकांग	hong kong	Nan
हालात	okolnosti	None
हावी	dominance	Nan
हासिल	dobiti	None
हिन्दयूरोपीय	indoeuropski	Nan
हिन्दी	hindski	Nan
हिन्दीउर्दू	hindi urdu	Nan
हिन्दीकुंज	hindikunj	Nan
हिन्दु	hinduistički	Nan
हिन्दुओं	hindusi	Nan
हिन्द	hind	Nan
हिन्दुस्तान	hindustan	Nan
हिन्दुस्थान	hindusthan	Nan
हिन्दू	hinduistički	Nan
हिब्रू	hebrejski	Nan
हिमनद	glečeri	Nan
हिमाचल	himachal	Nan
हिमालयी	himalajska	Nan
हिन्दुस्तानी	hindustani	Nan
हस्तलिखित	rukom pisano	Nan
हितों	interesi	Nan
हिटलर	hitler	None
हास्य	humor	Nan
हि	on	None
हिंद	hind	Nan
हिंदी	hindski	Nan
हिंदीकुंज	hindikunj	Nan
हिंदु	hinduistički	Nan
हित	kamata	Nan
हिंदुओं	hindusi	Nan
हिंदू	hinduistički	Nan
हिंसक	nasilan	Nan
हिंसा	nasilje	Nan
हिक्सोस	hixos	Nan
हिज्री	hidžri	Nan
हिट	hit	None
हिंदुस्तान	indija	None
हस्तमैथुन	masturbacija	Nan
हस्तक्षेप	smetanje	Nan
हवेली	ljetnikovac	Nan
हथेली	dlan	Nan
हद	do te mjere	Nan
हनन	zloupotrebe	Nan
हनुमान	hanuman	Nan
हनुमानजी	hanuman ji	Nan
हम	mi	None
हथियारों	oružje	None
हमको	mi	None
हमला	napada	None
हमले	napadi	None
हमलों	napadi	None
हमसे	od nas	Nan
हमारा	naše	None
हमारी	naši	Nan
हमने	mi	None
हमारे	naše	None
हथियार	oružje	None
हड्डी	kost	None
हज़ार	hiljadu	None
हज़ारों	hiljade	None
हजार	hiljadu	None
हजारी	hazari	Nan
हजारे	hazare	Nan
हजारों	hiljade	None
हत्या	ubijanje	Nan
हट	koliba	Nan
हटा	ukloni	Nan
हटाकर	uklanjanjem	Nan
हटाया	uklonjeno	Nan
हड़ताल	štrajk	Nan
हड़प्पा	harappa	Nan
हड़प्पाई	harappan	Nan
हटकर	off the the	Nan
हजरत	hazreti	Nan
हमीरपुर	hamirpur	Nan
हमें	nas	None
हरेक	svaki	None
हर्षवर्धन	onaj koji povećava radost	Nan
हल	rešenje	Nan
हलचल	promešati	Nan
हल्का	svetlost	Nan
हल्की	svetlost	Nan
हरे	zeleno	None
हल्के	lagan	Nan
हवन	prigovaranje bogu pred vatrom	Nan
हवा	zrak	None
हवाई	prozračan	Nan
हवाएं	povjetarac	Nan
हवाओं	vetrovi	Nan
हवाले	predati	Nan
हल्दी	kurkuma	Nan
हमे	nas	None
हरी	zeleno	None
हरिशंकर	harishankar	Nan
हमेशा	uvek	Nan
हर	svaki	None
हरण	haran	Nan
हरदोई	hardoi	Nan
हरमंदिर	harmandir	Nan
हरि	hari	None
हरिश्चन्द्र	harish chandra	Nan
हरिकृष्ण	harikrishna	Nan
हरित	zeleno	None
हरिता	harita	Nan
हरिदास	haridas	Nan
हरिद्वार	haridwar	Nan
हरियाणा	haryana	Nan
हरिवंश	harivansh	Nan
हरिजन	harijan	Nan
पिग्मी	pygmy	Nan
समरकंद	samarkand	Nan
समयसमय	s vremena na vrijeme	Nan
विवेकानंद	vivekananda	Nan
विवेकाधीन	diskrecionarska	Nan
विवेक	diskrecija	Nan
विविधता	raznolikost	Nan
विविध	raznoliko	Nan
विवाहित	oženjen	None
विवाह	brak	None
विवादों	sporovi	Nan
विवादित	sporno	Nan
विवादास्पद	kontroverzni	Nan
विवादस्पद	kontroverzni	Nan
विवाद	kontroverze	Nan
विवश	ograničeno	None
विवर्तन	difrakcija	Nan
विवरण	opis	None
विलुप्त	izumrli	Nan
विलीन	spojeni	Nan
विराम	pauza	None
विरासत	nasljeđivanje	Nan
विरुद्ध	protiv	None
विरूद्ध	protiv	None
विरोध	protiv	None
विरोधियों	protivnici	None
विवेकानन्द	vivekananda	Nan
विरोधी	anti	Nan
विलय	fuzija	Nan
विलयन	spajanje	Nan
विलाप	stenjati	Nan
विलायक	rastvarač	Nan
विलासिता	luksuzan	Nan
विलियम	william	None
विलक्षण	jednina	Nan
विवेचन	deliberation	Nan
विशद	živa	None
विशाखापट्नम	visakhapatnam	Nan
विश्लेषण	analiza	None
विश्लेषणात्मक	analitički	Nan
विश्व	svetu	Nan
विश्वकर्मा	vishwakarma	Nan
विश्वकोश	enciklopedija	None
विश्वकोष	enciklopedija	None
विश्राम	počivaj	Nan
विश्वप्रसिद्ध	svjetski poznati	Nan
विश्वविख्यात	svjetski poznati	Nan
विश्वविद्यालयों	univerziteti	Nan
विश्वव्यापी	širom svijeta	Nan
विश्वसनीय	pouzdan	Nan
विश्वामित्र	vishwamitra	Nan
विश्वास	vjerujte	Nan
विश्वयुद्ध	svjetski rat	Nan
विराट	virat	Nan
विशेषताओं	karakteristike	None
विशेषताएँ	značajke	Nan
विशाल	ogroman	None
विशालकाय	div	Nan
विशालता	prolaznost	Nan
विशिष्ट	specifično	Nan
विशिष्टता	specijalnost	Nan
विशुद्ध	čista	Nan
विशेषताएं	značajke	Nan
विशेष	poseban	None
विशेषज्ञ	specijalista	Nan
विशेषज्ञों	stručnjaci	None
विशेषण	pridjevi	Nan
विशेषत	naročito	None
विशेषतः	posebno	None
विशेषता	specijalnost	Nan
विशेषकर	naročito	None
विराजमान	sjedeći	Nan
विरह	odsustvo	Nan
वियोग	prekid veze	Nan
विधवा	udovica	None
विधा	žanr	Nan
विधाओं	žanrovi	Nan
विधान	zakonodavstvo	Nan
विधानसभा	skupština	None
विधायिका	zakonodavstvo	Nan
विद्वान्	znalca	Nan
विधायी	zakonodavni	Nan
विधियाँ	metode	None
विधियां	metode	None
विधेयक	bill	None
विनती	zahtjev	None
विनम्र	uljudno	Nan
विनय	skromnost	Nan
विधि	metoda	None
विनायकाय	vinayakay	Nan
विद्वानों	stipendisti	Nan
विद्रोही	pobunjenici	None
विदेशी	stranac	Nan
विद्यमान	postojeće	None
विद्या	znanje	None
विद्याओं	akademici	Nan
विद्यापति	znalca	Nan
विद्यार्थियों	studenti	None
विद्वान	znalca	Nan
विद्यार्थी	student	None
विद्यालयों	škole	None
विद्युत	struja	None
विद्युत्‌	struja	None
विद्युदणु	electron	Nan
विद्योत्तमा	vidyutma	Nan
विद्रोह	pobuna	None
विद्यालय	škola	None
विश्वासघात	izdajstvo	Nan
विनाश	uništenje	Nan
विनिमय	razmjena	None
विभाजन	podela	Nan
विभाजित	podijeliti	None
विभाषा	particija	Nan
विभिन्न	različite	None
विभिन्नता	varijacija	Nan
विभिन्‍न	različite	None
विभागों	odjeli	Nan
विभीषण	uništenje	Nan
विमर्श	diskusija	Nan
विमल	vimal	Nan
विमान	avion	None
विमानक्षेत्र	zračna luka	Nan
विमानों	avioni	None
वियतनाम	vijetnam	Nan
विभेदन	diferencijacija	Nan
विनाशकारी	destruktivno	Nan
विभाग	odjel	Nan
विफलता	neuspjeh	Nan
विनियमन	uredba	Nan
विनियमित	regulirano	Nan
विनिर्देश	specifikacija	Nan
विनिर्माण	proizvodnja	None
विनोद	humor	Nan
विनोबा	vinoba	Nan
विभक्त	razdjelnik	Nan
विन्डोज़	windows	Nan
विन्यास	konfiguracija	Nan
विपक्ष	opozicija	Nan
विपक्षी	opozicija	Nan
विपणन	marketing	None
विपरीत	štetno	Nan
विफल	nije uspjelo	Nan
विन्या	vinya	Nan
विदेशियों	stranci	None
विश्वासों	verovanja	Nan
विश्‍वविद्यालय	univerzitet	None
व्यंजना	eufemizam	Nan
व्यंजन	posuđe	Nan
व्यंग्यरचना	sarkazam	Nan
व्यंग्य	sarkazam	Nan
वोल्टायिक	voltaic	Nan
वोर्ल	whorl	Nan
वोट	glasanje	Nan
वो	oni	None
वॉट	watt	Nan
वैसे	između ostalog	Nan
वैसी	kao to	Nan
वैसा	kao to	Nan
वैष्णो	vaishno	Nan
वैष्णव	vaishnav	Nan
वैश्वीकरण	globalizacija	None
वैश्विक	globalno	Nan
वैश्य	vaishya	Nan
वैज्ञानिकों	naučnici	None
वैदिक	vedskog	Nan
वैद्य	doktore	Nan
वैद्युत	električni	None
वैध	validan	Nan
वैधता	validnost	Nan
व्यंजनों	recepti	Nan
वैधानिक	zakonski	None
वैराग्य	tišina	Nan
वैली	dolina	None
वैवाहिक	oženjen	None
वैशाख	baishakh	Nan
वैशाली	vaishali	Nan
वैशेषिक	poseban	None
वैभव	veličanstvo	Nan
व्यक्त	izraženo	Nan
व्यक्ति	osoba	None
व्यक्तिगत	lični	None
व्याख्याता	predavač	Nan
व्याख्यान	predavanje	Nan
व्यापक	sveobuhvatno	Nan
व्यापार	posao	None
व्यापारियों	trgovci	None
व्यापारी	trgovac	Nan
व्याख्याओं	tumačenja	None
व्यापी	široki	None
व्यायाम	vježbati	Nan
व्यावसायिक	profesionalni	Nan
व्यावहारिक	praktična	Nan
व्यावहारिकता	praktičnost	Nan
व्यास	prečnik	Nan
व्युत्पत्ति	izvođenje	None
व्याप्त	rife	Nan
वैज्ञानिकता	scijentizam	Nan
व्याख्या	objašnjenje	None
व्याकरण	grammer	Nan
व्यक्तित्व	ličnost	None
व्यक्तियों	pojedinci	None
व्यतीत	prošlost	None
व्यय	trošak	None
व्यर्थ	uzalud	Nan
व्यवसाय	biznis	Nan
व्याकुल	uznemireno	Nan
व्यवसायिक	profesionalni	Nan
व्यवस्था	aranžman	Nan
व्यवस्थित	uređeni	Nan
व्यवहार	ponašanje	None
व्यवहारिक	praktična	Nan
व्यस्क	odrasli	Nan
व्यस्त	zauzeto	Nan
व्यवसायों	preduzeća	None
वैज्ञानिक	naučni	None
वैचारिक	ideološki	Nan
वैकल्पिक	alternativa	Nan
विहीन	oduženi	Nan
वीं	th	Nan
वीडियॊ	video	None
वीडियो	video	None
वीणा	veena	Nan
वीर	hrabar	Nan
विस्फोट	eksplozija	Nan
वीरता	hrabrost	None
वीरों	hrabri	Nan
वीर्य	semen	Nan
वृंदावन	vrindavan	Nan
वृक्ष	drvo	None
वृक्षों	drveće	Nan
वृत्तांत	račun	None
वीरेन्द्र	virendra	Nan
वृत्ति	stav	None
विस्थापित	raseljeni	Nan
विस्तारपूर्वक	okružno	Nan
विष	otrov	None
विषम	čudno	Nan
विषय	predmet	None
विषयक	tematski	None
विषयवस्तु	predmet	None
विषयों	teme	None
विस्तृत	detaljno	Nan
विषाणु	virus	None
विषैले	toksično	Nan
विष्णु	vishnu	Nan
विष्णुगुप्त	vishnugupta	Nan
विसर्जन	uranjanje	Nan
विसर्जित	gotovo	None
विस्तार	detaljno	Nan
विषाणुओं	virusi	Nan
विश्‍व	svetu	Nan
वृद्ध	stariji	None
वृद्धि	rast	None
वेनेज़ुएला	venezuela	Nan
वेब	web	Nan
वेबदुनिया	webdunia	Nan
वेबसाइट	veb stranica	Nan
वेल्डिंग	zavarivanje	Nan
वेल्श	velški	Nan
वेधशाला	opservatorija	Nan
वेल्स	wells	Nan
वेश्या	prostitutka	Nan
वेश्याओं	prostitutke	Nan
वेश्यावृत्ति	prostitucija	Nan
वेस्ट	zapad	None
वेस्टमिंस्टर	westminster	Nan
वेह	oni	None
वेश	haljina	Nan
वृद्धावस्था	starost	None
वेदों	vede	Nan
वेदान्त	vedanta	Nan
वृन्दावन	vrindavan	Nan
वृहत	prostrani	Nan
वृहद	veliko	None
वृहद्	veliko	None
वे	oni	None
वें	th	Nan
वेदी	oltar	Nan
वेंकटेश्वर	venkateswara	Nan
वेतन	plate	Nan
वेद	veda	Nan
वेदना	ljut	Nan
वेदव्यास	vedvyas	Nan
वेदांग	vedang	Nan
वेदांत	vedanta	Nan
वेग	velocity	Nan
व्युत्पन्न	izvedeno	Nan
विदेश	strani	None
वित्त	finansije	None
वक्त	vreme	None
वकील	advokat	Nan
वकालत	zagovaranje	Nan
वंशावली	genealogija	Nan
वंशानुगत	nasljedna	Nan
वंशज	potomak	Nan
वंश	dinastija	None
वंदना	molitva	None
ळ	4	Nan
लौह	gvožđe	Nan
लौटा	vraćen	Nan
लौटने	povratak	None
लौट	povratak	None
लौकिक	kosmički	Nan
लोहे	gvožđe	Nan
लोहा	gvožđe	Nan
लोशन	losion	Nan
लोकतान्त्रिक	demokratske	None
लोकप्रियता	popularnost	None
लोकमान्य	popularno	None
लोकसभा	lok sabha	Nan
लोकों	ljudi	None
लोग	ljudi	None
वक्तव्य	izjava	Nan
लोगो	narodi	None
लोड	opterećenje	Nan
लोदी	lodi	Nan
लोधी	lodhi	Nan
लोप	propust	Nan
लोभ	avarice	Nan
लोयस	loys	Nan
लोगों	ljudi	None
वक्ता	zvučnik	Nan
वक्र	krivulja	Nan
वक्ष	grudi	Nan
वरन्	ostalo	None
वरिष्ठ	stariji	None
वरुण	varun	Nan
वरुणा	varuna	Nan
वर्ग	kategoriju	None
वर्गीकरण	klasifikacija	None
वरन	boon	Nan
वर्गीकृत	klasificirano	Nan
वर्चस्व	nadmoć	Nan
वर्जित	ograničeno	None
वर्ड	riječ	None
वर्ण	likovi	None
वर्णक्रम	spektar	None
वर्णक्रमीय	spektralni	Nan
वर्गों	kvadrati	Nan
लोकतांत्रिक	demokratske	None
वरदान	poklon	Nan
वयस्क	odrasli	Nan
वचन	obećanje	Nan
वचनों	riječi	None
वजन	težina	None
वजह	razlog	None
वज़न	težina	None
वत्स	dete	Nan
वयस्कों	odrasli	Nan
वध	ubiti	None
वनडे	odi	Nan
वनवास	izgnanstvo	Nan
वनस्पतियों	flora	Nan
वनों	šume	None
वन्दे	vande	Nan
वन्य	divlji	Nan
वन	šuma	None
लोककथा	folklora	Nan
लोक	region	None
लो	uzmi	Nan
लिपियों	skripte	Nan
लिप्यन्तरण	transliteracija	Nan
लिया	uzeo	None
लिया|	uzeo	None
लिये	za	None
लिये|	za	None
लिपियाँ	skripte	Nan
लिली	lily	Nan
लीग	liga	None
लीटर	litra	Nan
लीबनीज	leibniz	Nan
लीबिया	libija	Nan
लीला	leela	Nan
लीलाओं	pastimes	Nan
ली	lee	Nan
लुईस	louisu	Nan
लिपिक	službenik	Nan
लिनक्स	linux	None
लिंग	pol	Nan
लिंगानुपात	omjer spola	Nan
लिए	za	None
लिख	pisati	None
लिखकर	pisanjem	Nan
लिखते	piše	None
लिपि	skripta	Nan
लिखना	pisati	None
लिखा	napisala	Nan
लिखित	zapisnik	Nan
लिखी	pismeno	Nan
लिखीं	napisala	Nan
लिखे	pisati	None
लिच्छवि	licchavi	Nan
लिखने	pisati	None
वर्णन	opis	None
लुप्त	nedostaje	Nan
लूटपाट	pljačka	Nan
लेनदेन	transakcija	None
लेना	uzeti	None
लेनी	lenny	Nan
लेने	uzimam	Nan
लेप	premaz	Nan
लेबल	etiketa	Nan
लेते	uzmi	Nan
लैंगिक	seksualni	Nan
लैंड	zemljište	None
लैटिन	latinski	None
लैला	laila	Nan
लॉ	zakon	None
लॉर्ड	gospode	Nan
लॉस	gubitak	None
लैंग्वेज	jezik	None
लू	lu	Nan
लेती	uzima	None
लेट	kasno	None
लूट्यन्स	lutyens	Nan
ले	uzmi	Nan
लें	uzmi	Nan
लेक	jezero	None
लेकर	sa	None
लेख	član	None
लेता	uzima	None
लेखक	autor	None
लेखन	pisanje	None
लेखा	računi	Nan
लेखांकन	računovodstvo	None
लेखों	članci	None
लेग	noga	Nan
लेगा	uzet će	Nan
लेखकों	autori	None
वित्तीय	finansijski	Nan
वर्णनात्मक	deskriptivni	Nan
वर्णों	likovi	None
विकास	razvoj	None
विकारों	poremećaji	None
विकार	nered	Nan
विकसित	razvijen	None
विकल्प	mogućnost	None
विंग	krilo	None
वि	v	None
वाह्य	spoljni	Nan
वाहिनी	duct	Nan
वाहिनियों	kanali	None
वाहनों	vozila	None
वाहन	vozilo	Nan
वास्तुशिल्प	arhitektura	None
वास्तुकार	arhitekta	None
वास्तुकला	arhitektura	None
वास्तु	arhitektonski	None
वास्तविकता	stvarnost	None
वार्मिंग	zagrijavanje	Nan
वार्षिक	godišnja	None
वाला	jedan	None
वालो	prijatelji	None
वालों	oni	None
वाल्मीकि	valmiki	Nan
विकासवादी	evolucijski	Nan
वाशिंगटन	washington	None
वास	stanište	Nan
वासना	želja	None
वासाच	wasach	Nan
वासुदेव	vasudev	Nan
वास्तव	stvarnost	None
वास्तविक	aktuelno	Nan
वाष्प	steam	Nan
विकि	wiki	None
विकिपीडिया	wikipedija	Nan
विकिमीडिया	wikimedia	Nan
विजय	pobjeda	None
विजयनगर	vijayanagar	Nan
विजयी	pobjednički	Nan
विजेता	pobjednik	None
विज्ञान	nauka	None
विज्ञानियों	naučnici	None
विचित्र	bizarno	Nan
विज्ञानी	naučnik	None
विज्ञापन	oglas	Nan
विज्ञापनों	oglasi	Nan
विटामिन	vitamin	None
विडियो	video	None
विण्डोज़	windows	Nan
वितरण	dostava	Nan
विज्ञानों	nauke	None
वार्तालाप	razgovori	Nan
विचारों	ideje	None
विचारक	mislilac	Nan
विकिरण	zračenje	None
विकिस्रोत	wikisource	Nan
विकेट	wicket	Nan
विकेटकीपर	čuvar vitlaja	Nan
विक्टोरिया	victoria	Nan
विक्रम	vikram	Nan
विचारकों	mislioci	Nan
विक्रमादित्य	vikramaditya	Nan
विक्रेता	prodavac	Nan
विख्यात	primećeno	Nan
विगत	prošlost	None
विघ्न	poremećaj	None
विचरण	varijanca	Nan
विचार	ideja	None
विक्रय	prodaja	None
वार्ता	talk	Nan
वाराणसी	varanasi	Nan
वार	rata	None
वस्तुएं	stvari	None
वस्तुओं	predmeti	None
वस्तुत	zaista	None
वस्तुतः	zapravo	None
वस्त्र	odeća	Nan
वस्त्रों	odjeća	Nan
वस्तुएँ	stvari	None
वह	ona	None
वहाँ	tamo	None
वहां	tamo	None
वही	isto	None
वहीं	tu samu	Nan
वा	wa	Nan
वां	th	Nan
वहन	pristupačna	Nan
वांछित	željeno	Nan
वस्तु	stvar	None
वसा	debeo	Nan
वर्तनी	pravopis	None
वर्तमान	sadašnjost	Nan
वर्मा	verma	Nan
वर्ल्ड	svetu	Nan
वर्ष	godina	None
वर्षीय	godinu	None
वसूली	oporavak	Nan
वर्षो	godine	None
वल्लभ	vallabh	Nan
वल्लभाचार्य	vallabhacharya	Nan
वश	tame	Nan
वशिष्ठ	vashistha	Nan
वसंत	proljeće	None
वसन्त	proljeće	None
वर्षों	godinama	None
वर्णित	opisano	Nan
वाइड	široki	None
वाक	govor	None
वान	van	None
वानर	majmun	Nan
वानरों	majmuni	Nan
वापस	nazad	None
वापसी	povratak	None
वापिस	povratak	None
वाद्य	instrument	None
वायरस	virus	None
वायुगतिकी	aerodinamika	Nan
वायुदाब	zračni pritisak	Nan
वायुमंडल	atmosfera	None
वायुमंडलीय	atmosferska	Nan
वायुयान	avion	None
वायुसेना	zračne snage	Nan
वायु	vetar	None
वाई	zašto	None
वादी	tužitelj	Nan
वादक	player	Nan
वाकाटक	vakataka	Nan
वाक्य	rečenica	None
वाक्यों	presude	Nan
वाचक	čitač	Nan
वाजपेयी	vajpayee	Nan
वाट	watt	Nan
वादन	sviranje	Nan
वाणिज्य	komercijalno	Nan
वाणी	glas	None
वात	zrak	None
वातावरण	atmosfera	None
वात्सल्य	vatsalya	Nan
वात्स्यायन	vatsyayan	Nan
वाद	odijelo	Nan
वाणिज्यिक	komercijalno	Nan
समर	rata	None
व्यू	pogled	None
व्रत	brzo	None
संयुक्त	zajedničko	None
संयम	umjerenost	Nan
संयंत्र	biljka	None
संभोग	seksualni odnos	Nan
संभावित	potencijal	None
संभावनाओं	mogućnosti	None
संभावना	šansa	Nan
संभाला	rukovao	Nan
संभालने	pretpostavimo	Nan
संभाल	čuvaj se	Nan
संभवतया	možda	None
संभवतः	možda	None
संभवत	vjerovatno	None
संभव	moguće	None
संबोधित	adresa	None
संबन्धी	srodni	Nan
संबंधों	veze	None
संपत्ति	vlasništvo	None
संपदा	estate	Nan
संपन्न	gotovo	None
संपर्क	kontakt	None
संपादक	urednik	None
संपादन	uređivanje	Nan
संयोग	slučajnost	Nan
संपादित	izmijenjeno	Nan
संप्रदाय	sekta	Nan
संप्रदायों	nominacije	Nan
संप्रभु	suvereni	Nan
संबंध	odnos	None
संबंधित	srodni	Nan
संबंधी	relativno	None
संपूर्ण	kompletni	Nan
संयोगिता	slučajnost	Nan
संयोजक	konvener	Nan
संयोजन	kombinacija	None
संशोधन	amandman	Nan
संशोधित	revidiran	Nan
संश्लेषण	sinteza	None
संसद	parlament	None
संसदीय	parlamentarni	Nan
संसाधन	resursi	None
संवेदी	senzorno	Nan
संसाधनों	resursi	None
संस्करण	izdanje	None
संस्करणों	volumen	None
संस्कार	sakramenti	Nan
संस्कारों	rituali	Nan
संस्कृत	sanskrit	Nan
संस्कृतम्	sanskrit	Nan
संसार	svetu	Nan
संन्यासी	sveci	Nan
संवेदना	saučešća	Nan
संवेदनशील	osetljiv	Nan
संरक्षण	zaštita	None
संरक्षित	zaštićeno	Nan
संरचना	struktura	None
संरचनाओं	strukture	None
संरेखण	poravnanje	Nan
संलग्न	priložiti	Nan
संवेदनशीलता	osjetljivost	Nan
संलयन	fuzija	Nan
संवत्	era	None
संवाद	razgovor	None
संवादों	dijalozi	Nan
संविधान	ustav	None
संविभ्रम	paranoja	Nan
संवेग	momentum	Nan
संवत	era	None
संध्या	veče	Nan
संधि	ugovor	None
संदेह	sumnja	Nan
संगणक	kompjuter	Nan
संगणना	računanje	None
संगत	kompanija	None
संगम	ušće	None
संगमरमर	mramor	None
संगमर्मर	mramor	None
संगठनात्मक	organizacioni	Nan
संगीतकार	muzičar	None
संग्रह	kolekcija	None
संग्रहण	skladištenje	Nan
संग्रहालय	muzej	None
संग्रहित	spremljeno	Nan
संग्राम	boriti se	Nan
संग्राहलय	muzej	None
संगृहीत	spremljeno	Nan
संघ	sindikat	Nan
संगठन	organizacija	None
संख्याओं	brojevi	None
संकुचित	smanjiti se	Nan
संकेत	signal	None
संकेतक	indikatori	Nan
संकेतन	napomena	None
संकेतों	signali	Nan
संकोच	hesitate	Nan
संग	sa	None
संक्रमण	infekcija	Nan
संक्रांति	solsticij	Nan
संक्रामक	zarazni	Nan
संक्षिप्त	ukratko	None
संक्षेप	ukratko	None
संख्या	broj	None
संख्याएँ	brojevi	None
संक्रमित	inficiran	Nan
संस्कृति	kultura	None
संघटन	sastav	None
संघीय	federalni	None
संतरा	narandžasta	Nan
संतान	deca	Nan
संतुलन	ravnoteža	Nan
संतुलित	uravnotežen	Nan
संतुष्ट	zadovoljna	Nan
संतुष्टि	zadovoljstvo	Nan
संत	sveti	None
संतों	sveci	Nan
संदमक	inhibitora	Nan
संदर्भ	upućivanje	Nan
संदर्भित	navedeno	None
संदर्भों	reference	None
संदिग्ध	dvojbeno	Nan
संदेशों	poruke	None
संतोष	zadovoljstvo	Nan
संघर्षों	sukobi	None
संज्ञानात्मक	kognitivni	Nan
संज्ञा	imenica	Nan
संघों	udruženja	None
संचय	akumulacija	Nan
संचरण	prenos	None
संचार	komunikacije	None
संचारित	preneseno	Nan
संचालक	direktor	None
संज्ञाओं	imenice	None
संचालन	operacije	None
संचिका	fajl	Nan
संचिकाएँ	datoteke	None
संचिकाओं	datoteke	None
संचित	akumulirano	Nan
संजय	sanjay	Nan
संजोए	spremi	Nan
संचालित	operirano	Nan
संकुचन	kontrakcija	Nan
संस्कृतियों	kulture	None
संस्थाएँ	institucije	None
सबकी	svi su	Nan
सबका	svi	None
सब	sve	None
सफेद	bijelo	None
सफारी	safari	Nan
सफाई	čist	None
सफ़लता	uspeh	Nan
सफ़ल	uspešno	Nan
सफ़र	putovanje	None
सफलतापूर्वक	uspješno	None
सफलता	uspeh	Nan
सफल	uspešno	Nan
सफर	putovanje	None
सप्ताह	sedmicu	Nan
सप्तम	sedma	Nan
सपने	snovi	Nan
सन्‌	godina	None
सदाबहार	evergreen	Nan
सदियों	vekovima	Nan
सदी	veka	Nan
सदृश	kao	None
सदैव	uvek	Nan
सद्भावना	dobre volje	Nan
सबके	svima	None
सद्स्य	član	None
सनातन	večni	Nan
सन्त	sveti	None
सन्तान	deca	Nan
सन्तों	sveci	Nan
सन्दर्भ	reference	None
सन्देश	poruka	None
सन	sunce	None
सबको	za sve	Nan
सबमें	u svemu	Nan
सबसे	od svih	Nan
समझना	razumevanje	Nan
समझने	razumjeti	None
समझा	razumeo	Nan
समझाने	objasnite	Nan
समझाया	objašnjeno	Nan
समझी	razumeo	Nan
समझते	shvati	Nan
समझौता	naselje	None
समता	paritet	Nan
समन्वय	koordinacija	Nan
समन्वित	integrisana	Nan
समभाव	ravnodušnost	Nan
समय	vreme	None
समयरेखा	vremenska traka	Nan
समझौते	sporazum	None
सदाचार	vrlina	None
समझता	razumije	Nan
समग्र	sveukupno	Nan
सबूत	dokaz	None
सब्जी	povrće	None
सब्सिडी	subvencija	Nan
सभा	skupština	None
सभाओं	okupljanja	Nan
सभापति	predsjedavajućeg	Nan
समझ	razumiju	Nan
सभी	sve	None
सभ्यता	kultura	None
सभ्यताओं	civilizacije	None
सम	čak	None
समकालीन	savremeni	None
समकोण	pravi ugao	Nan
समक्ष	prije	None
सभ्य	prilično	None
सदा	uvek	Nan
सदस्यों	članovi	None
सदस्यता	članstvo	None
सकें	može	None
सकेगा	će biti u mogućnosti	Nan
सक्रिय	aktivno	None
सक्रियता	aktivnost	None
सक्षम	sposobna	Nan
सख्त	stroga	Nan
सके	može	None
सख्ती	strogost	Nan
सघन	gusta	Nan
सच	istina	None
सचमुच	zaista	None
सचिन	sachin	Nan
सचिव	sekretara	Nan
सचिवालय	sekretarijat	Nan
सगुण	vrlina	None
सच्चा	istinito	Nan
सकी	može	None
सका	može	None
संस्थाएं	institucije	None
संस्थाओं	institucije	None
संस्थागत	institucionalni	Nan
संस्थान	institut	None
संस्थानों	institucije	None
संस्थापक	osnovao	None
सकारात्मक	potvrdno	Nan
संस्थापित	instalirano	Nan
संहार	uništiti	None
संहिता	šifra	Nan
सकता	može	None
सकती	može	None
सकते	može	None
सकल	bruto	None
संस्मरण	memoari	Nan
संस्था	organizacija	None
सच्चाई	istina	None
सजा	kazna	None
सत्तर	sedamdeset	Nan
सत्ता	snage	None
सत्तारूढ़	presuda	Nan
सत्यं	istina	None
सत्यजीत	satyajit	Nan
सत्यता	istina	None
सत्कार	dobrodošli	Nan
सत्यवती	satyavati	Nan
सत्र	sjednica	Nan
सत्रह	sedamnaest	Nan
सत्रहवीं	sedamnaesti	Nan
सदन	kuća	None
सदनॉ	kuće	None
सदस्य	član	None
सत्याग्रह	satyagraha	Nan
सच्चे	istinito	Nan
सत्कर्म	istina	None
सती	sati	None
सजाने	ukrasite	Nan
सजाया	dekorisan	Nan
सजावट	dekoracija	Nan
सजावटी	dekorativni	Nan
सजीव	uživo	None
सजीवों	živa bića	Nan
सतीश	satish	Nan
सज्जन	gospodo	Nan
सडक	cesta	None
सड़क	cesta	None
सड़कों	putevi	None
सतत	kontinuirano	Nan
सतरूपा	sedamdeset	Nan
सतह	površina	None
सटीक	tacno	Nan
व्रण	čir	Nan
संकीर्ण	uzak	Nan
संकल्प	zakletva	Nan
शिक्षकों	nastavnici	Nan
शिक्षक	učitelj	None
शिकारी	hunter	Nan
शिकार	plen	Nan
शिकायतें	žalbe	Nan
शिकायत	prigovor	Nan
शिकागो	chicago	None
शाही	royal	Nan
शाहिद	šehid	Nan
शाहजी	shahaji	Nan
शाहजहां	shahjahan	Nan
शाहजहाँ	shah jahan	Nan
शाह	shah	Nan
शास्त्रों	pisma	None
शास्त्रीय	klasična	None
शास्त्री	shastri	Nan
शास्त्रार्थ	debata	Nan
शाम	veče	Nan
शामिल	uključi	Nan
शायर	pjesnik	None
शायरी	poezija	None
शारदा	sharda	Nan
शारीरिक	telo	Nan
शिक्षण	nastava	None
शाश्वत	večno	Nan
शासकीय	zvanična	None
शासकों	vladari	None
शासन	upravljanje	None
शासनकाल	vladavina	None
शासित	vladao	None
शास्त्र	etologija	Nan
शासक	vladar	None
शिक्षाओं	predavanja	None
शिक्षित	obrazovani	Nan
शिखर	vrhunac	None
शीत	hladno	Nan
शीतकाल	zima	None
शीतोष्ण	umereno	Nan
शीर्ष	vrh	None
शीर्षक	naslov	None
शील	skromnost	Nan
शीघ्र	uskoro	None
शुंग	sunga	Nan
शुक्रवार	petak	None
शुक्राणु	sperma	Nan
शुक्लयजुर्वेदीय	astrologija	Nan
शुद्ध	čista	Nan
शुद्धता	tačnost	Nan
शुद्धि	pročišćavanje	Nan
शुक्र	venera	None
शाब्दिक	bukvalno	None
शिष्य	učenik	None
शिशुओं	bebe	Nan
शिथिल	opušten	Nan
शिमला	shimla	Nan
शिया	shia	Nan
शिराओं	vene	None
शिला	rock	None
शिलालेख	natpis	None
शिष्टाचार	maniri	Nan
शिव	shiv	Nan
शिवरात्रि	shivratri	Nan
शिवलिंग	shivling	Nan
शिवाजी	shivaji	Nan
शिवालिक	shivalik	Nan
शिविर	kamp	Nan
शिशु	dušo	Nan
शिवजी	shiva	Nan
शाप	prokletstvo	Nan
शान्ति	mir	None
शान्तनु	shantanu	Nan
शताब्दी	veka	Nan
शती	veka	Nan
शत्रु	neprijatelj	None
शत्रुओं	neprijatelji	Nan
शनि	saturn	Nan
शनिदेव	shani dev	Nan
शताब्दियों	vekovima	Nan
शनिवार	subota	Nan
शब्दकोष	rečnik	Nan
शब्दार्थ	semantika	None
शब्दावली	rječnik	None
शब्दों	riječi	None
शमन	ublažavanje	Nan
शरण	azil	Nan
शपथ	zakletva	Nan
शरणार्थी	izbeglice	Nan
शतरंज	šah	None
शटल	shuttle	Nan
व्हाइट	bijelo	None
श	sh	Nan
शंकराचार्य	shankaracharya	Nan
शंकुधारी	četinari	Nan
शंख	shell	Nan
शंघाई	šangaj	Nan
शतक	veka	Nan
शक	sumnje	None
शकुन्तला	shakuntala	Nan
शकों	sinovi	Nan
शक्तियाँ	ovlaštenja	Nan
शक्तियां	ovlaštenja	Nan
शक्तियों	ovlaštenja	Nan
शक्तिशाली	snažni	Nan
शकुंतला	shakuntala	Nan
शुभ	dobro	None
शरद	jesen	None
शरीफ	gentry	Nan
शहीदों	mučenici	Nan
शांत	tiho	Nan
शांति	mir	None
शाकाहारी	vegetarijanski	Nan
शाक्त	snaga	None
शाखा	filijala	Nan
शहीद	mučenik	Nan
शाखाएँ	podružnice	Nan
शाखाओं	podružnice	Nan
शाखायें	podružnice	Nan
शादी	vjenčanje	Nan
शान	ponos	Nan
शानदार	fabulous	Nan
शान्त	miran	Nan
शाखाएं	podružnice	Nan
शराब	alkohol	None
शहादत	mučeništvo	Nan
शहरो	gradovi	None
शरीर	tijelo	None
शर्करा	šećer	None
शर्त	kladiti se	Nan
शर्तें	uslovi	None
शर्तों	uslovi	None
शर्मा	sharma	Nan
शहरों	gradovi	None
शल्य	hirurški	Nan
शशि	shashi	Nan
शस्त्र	ruke	Nan
शहद	dušo	Nan
शहर	grad	None
शहरी	urban	Nan
शहरीकरण	urbanizacija	Nan
शव	mrtvo tijelo	Nan
संकल्पना	koncept	None
शुभारंभ	lansiranje	Nan
शुरुआत	početak	None
श्रेणीयूरोप	kategorijaeuropa	Nan
श्रेणीमुग़ल	mogul kategorije	Nan
श्रेणीमहाभारत	indija	None
श्रेणीमध्य	kategoričan	Nan
श्रेणीभौतिकी	fizika razreda	Nan
श्रेणीभूगोल	geografija	None
श्रेणीभारतीय	kategorijaindijski	Nan
श्रेणीबॉलीवुड	kategorija bollywood	Nan
श्रेणीबिहार	ocjena	None
श्रेणीपौराणिक	kategorija	None
श्रेणीपश्चिम	klasa zapad	Nan
श्रेणीनोबेल	grennobel	Nan
श्रेणीधार्मिक	klasa religiozna	Nan
श्रेणीधर्मग्रन्थ	hijerarhija	None
श्रेणीधर्म	hijerarhija	None
श्रेणीदेश	zemlja klase	Nan
श्रेणीदेवीदेवता	god	None
श्रेणीइस्लाम	kategorija islam	Nan
श्रेणीउत्तम	najbolja klasa	Nan
श्रेणीउत्तर	odgovor kategorije	Nan
श्रेणीउत्तराखण्ड	kategorija uttarakhand	Nan
श्रेणीएशिया	kategorija azija	Nan
श्रेणीगुगल	kategorija	None
श्रेणीराजनीति	politika kategorija	Nan
श्रेणीग्रह	hijerarhija	None
श्रेणीजीव	katastrofalno	Nan
श्रेणीजीवनी	kategorija uživo	Nan
श्रेणीज्योतिष	gradient	Nan
श्रेणीतकनीकी	tehnički	None
श्रेणीदर्शन	ocjena	None
श्रेणीदिल्ली	delhi	Nan
श्रेणीचीन	gradechina	Nan
श्रेणीराजस्थान	kategorijarajasthan	Nan
श्रेणीरामायण	gradacija	Nan
श्रेणीवर्ष	godina	None
श्रेष्ठतम	najbolji	None
श्रेष्ठता	superiornost	Nan
श्रोताओं	slušaoci	Nan
श्लोक	stih	Nan
श्लोकों	shlokas	Nan
श्वसन	respiracija	Nan
श्रेष्ठ	najbolje	None
श्वास	dah	Nan
स	s	None
सं	br.	Nan
संकट	problem	None
संकर	hibridni	Nan
संकलक	kompajler	None
संकलित	kompajlirano	Nan
श्वेत	bijelo	None
श्रेणीइतिहास	istorija istorije	Nan
श्रेय	kredit	Nan
श्रेणीस्वतंत्रता	klasna neovisnost	Nan
श्रेणीविज्ञान	hijerarhijski	Nan
श्रेणीव्यक्तिगत	personalizirano	Nan
श्रेणीशहर	grad grad	Nan
श्रेणीसंगणक	klasifikator	Nan
श्रेणीसंयुक्त	kategorija kombinirana	Nan
श्रेणीसंस्कृत	kultiviran	Nan
श्रेणीहिन्दू	točka ocjene	Nan
श्रेणीसंस्कृति	klasna kultura	Nan
श्रेणीसमाज	društvo klasa	Nan
श्रेणीसमाजशास्त्र	hijerarhijski	Nan
श्रेणीसाहित्य	kategorija literature	Nan
श्रेणीसूचना	ocjena	None
श्रेणीसॉफ्टवेयर	kategorija softver	Nan
श्रेणीसौर	kategorija	None
श्रेणीसभ्यता	gradabilnost	Nan
श्रेणीआगरा	kategorija	None
श्रेणीअर्थशास्त्र	ekonomska ocjena	Nan
श्रेणी	kategoriju	None
शेष	ostatak	None
शैक्षणिक	obrazovni	Nan
शैतान	đavo	Nan
शैलियाँ	stilovi	Nan
शैलियां	stilovi	Nan
शैलियों	stilovi	Nan
शेर्पा	sherpa	Nan
शैली	stil	None
शॉट	udarac	None
शॉपिंग	kupovina	Nan
शो	pokaži	Nan
शोक	tuga	Nan
शोध	istraživanje	None
शोधकर्ता	istraživač	None
शैव	shaiva	Nan
शोधकर्ताओं	istraživači	None
शेरशाह	sher shah	Nan
शेयरों	dionice	None
शुरुआती	rana	None
शुरुवात	početak	None
शुरू	početak	None
शुरूआत	početak	None
शुरूआती	početno	Nan
शुल्क	naknada	Nan
शेर	lav	None
शुष्क	suva	Nan
शूटिंग	pucanje	Nan
शून्य	nula	None
शृंखला	serija	None
शेख	šeik	Nan
शेखर	sekhar	Nan
शेयर	podeliti	Nan
शूकर	šećer	None
शुरु	početak	None
शोधन	ispravljanje	Nan
शोभा	grace	Nan
श्रीमद्	shrimad	Nan
श्रीमद्भगवद्गीता	shrimad bhagavad gita	Nan
श्रीमद्भागवत	shrimad bhagwat	Nan
श्रीराम	sriram	Nan
श्रीरामजी	shri ram ji	Nan
श्रीलंका	šri lanka	Nan
श्रीनिवास	srinivas	Nan
श्रीवास्तव	srivastava	Nan
श्रुति	shruti	Nan
श्रृंखला	lanac	None
श्रृंखलाओं	lanci	None
श्रृंगार	šminka	Nan
श्रेणियाँ	kategorije	None
श्रेणियों	kategorije	None
श्रीशैल	shrisail	Nan
शोधपत्र	istraživački rad	Nan
श्रीधर	shridhar	Nan
श्री	gospodin	None
शोर	šum	Nan
शोषण	eksploataciju	Nan
शोषित	eksploatirano	Nan
शौर्य	galantrija	Nan
श्याम	shyam	Nan
श्यामा	shyama	Nan
श्रीकृष्ण	šri krišna	Nan
श्रद्धा	poštovanje	None
श्रद्धालुओं	posvećeni	Nan
श्रम	rad	None
श्रमिक	rad	None
श्राद्ध	shraddh	Nan
श्राप	kurs	Nan
श्रावण	shravan	Nan
श्रद्धालु	vjerni	Nan
पिंडों	predmeti	None
पिंड	telo	Nan
पास्काविषयक	prohodan	Nan
कर्मी	osoblje	Nan
कर्मियों	osoblje	Nan
कर्मचारी	osoblje	Nan
कर्मचारियों	zaposleni	Nan
कर्मकाण्ड	ritual	Nan
कर्फ्यू	policijski sat	Nan
कर्नाटक	karnataka	Nan
कर्तव्य	obaveza	None
कर्ण	karna	Nan
कर्ज	zajam	Nan
कर्क	rak	None
करोड़ों	milionima	Nan
करोड़	crore	Nan
करोड	crores	Nan
करोगे	uradit ću	Nan
करों	porezi	None
करो	učini to	Nan
कराना	uraditi	None
कराने	napraviti	None
करार	sporazum	None
करी	curry	Nan
करीना	kareena	Nan
करीब	u blizini	Nan
कर्मों	djela	None
करुणा	saosećanje	Nan
करूंगा	uradit ću	Nan
करे	učiniti	None
करें	uradi	None
करेंगे	uradit ću	Nan
करेगा	uradit ću	Nan
करेगी	uradit ću	Nan
करूँगा	uradit ću	Nan
कल	sutra	Nan
कलंक	zamagljivanje	Nan
कलकत्ता	kalkuta	Nan
कवच	oklop	None
कवयित्री	poetess	Nan
कवर	poklopac	Nan
कवरेज	pokrivenost	Nan
कवि	pjesnik	None
कविता	pjesma	None
कल्याणकारी	dobrobit	Nan
कविताएँ	pesme	Nan
कवियों	pjesnici	None
कश्मीर	kašmir	Nan
कश्मीरी	kašmiri	Nan
कश्यप	kashyap	Nan
कष्ट	patnja	Nan
कसौटी	test	Nan
कविताओं	pesme	Nan
कराते	karate	None
कल्याण	dobrobit	Nan
कल्पना	mašta	Nan
कलम	olovka	Nan
कलश	kalash	Nan
कला	umjetnost	None
कलाई	ručni zglob	Nan
कलाओं	umetnost	Nan
कलाकार	umjetnik	None
कल्पित	izmišljen	Nan
कलाकारों	umetnici	Nan
कलात्मक	umetnički	Nan
कलाम	kalam	Nan
कलियुग	kali yuga	Nan
कली	bud	Nan
कल्कि	kalki	Nan
कल्चर	kultura	None
कलाकृतियों	artefakti	Nan
कराती	karati	Nan
कराता	pruža	None
कराची	karači	Nan
कबीर	kabir	Nan
कबीरदास	kabirdas	Nan
कबीले	klan	Nan
कब्ज़ा	hvatanje	Nan
कब्जा	snimite	Nan
कब्र	grob	None
कबड्डी	kabaddi	Nan
कब्रों	grobnice	None
कभीकभी	ponekad	None
कमजोर	slabi	None
कमजोरी	slabost	Nan
कमप्यूटर	kompjuter	Nan
कमर	struk	Nan
कमरे	sobe	None
कभी	ponekad	None
कमल	lotus	Nan
कब	kada	None
कप्तान	kapetan	None
कनाडा	kanada	None
कनिष्ठ	junior	Nan
कनेक्शन	veza	None
कन्नड़	kannada	Nan
कन्नौज	kannauj	Nan
कन्या	djevica	Nan
कफ	flegm	Nan
कन्याकुमारी	kanyakumari	Nan
कप	šolja	Nan
कपड़ा	krpa	Nan
कपड़ों	odjeća	Nan
कपास	pamuk	None
कपिल	kapil	Nan
कपूर	kapoor	Nan
कन्हैयालाल	kanhaiyalal	Nan
कस्टम	custom	Nan
कमला	kamla	Nan
कमांडो	commando	Nan
करती	da li	Nan
करतीं	uradio bih	Nan
करते	učiniti	None
करना	učiniti	None
करनी	uraditi	None
करने	uraditi	None
करता	da li	Nan
करनेवाला	integrator	Nan
करवा	uradi to	Nan
करवाई	shvatio sam	Nan
करवाने	uradi to	Nan
करवाया	shvatio sam	Nan
करा	kara	Nan
कराई	usmjereni	Nan
करनेवाले	doer	Nan
कमांडर	zapovjednika	Nan
करण	karan	Nan
कर	porez	None
कमाई	zarada	Nan
कमान	komanda	Nan
कमाने	zaraditi	Nan
कमाल	neverovatno	Nan
कमी	nedostatak	None
कमीशन	komisija	None
करके	radeći	Nan
कमेटी	komiteta	Nan
कम्पनियां	kompanije	None
कम्पनियों	kompanije	None
कम्पनी	kompanija	None
कम्प्यूटर	kompjuter	Nan
कम्प्यूटरों	računari	None
कम्प्यूटिंग	računarstvo	None
कम्पनियाँ	kompanije	None
कद्दू	tikva	Nan
कस्बे	gradovi	None
कह	reci	Nan
कार्यवाही	akcija	None
कार्यरत	radeći	Nan
कार्यभार	zadaci	Nan
कार्यपालिका	izvršni	Nan
कार्यपालक	izvršni	Nan
कार्यक्षेत्र	obim posla	Nan
कार्यक्षमता	radna sposobnost	Nan
कार्यक्रमों	programi	None
कार्यक्रम	program	None
कार्यकारी	izvršni	Nan
कार्यकर्ताओं	radnici	None
कार्यकर्ता	radnik	None
कार्य	posao	None
कार्बोहाइड्रेट्स	ugljikohidrati	None
कार्बोहाइड्रेट	ugljikohidrati	None
कार्बनिक	organski	Nan
कार्बनडाइऑक्साइड	ugljen-dioksid	Nan
कारगिल	kargil	Nan
कारण	razlog	None
कारणों	razlozi	None
कारागृह	zatvor	Nan
कारावास	zatvorski zatvor	Nan
कारीगर	artisan	Nan
कार्यात्मक	funkcionalni	Nan
कारीगरों	artisans	Nan
कारोबार	posao	None
कार्ड	kartica	None
कार्तिक	kartik	Nan
कार्तिकेय	karthikeya	Nan
कार्पोरेशन	corp.	Nan
कार्बन	ugljik	None
कारों	automobili	Nan
कार्यान्वयन	provedba	Nan
कार्यालय	ured	Nan
कार्यालयों	uredi	Nan
काल्पनिक	sanjiv	Nan
काव्य	poezija	None
काशी	kashi	Nan
काष्ठ	wood	Nan
कि	to	None
किंग	kralju	None
कालों	crnci	Nan
किंगडम	kraljevstvo	None
किक	udarac	None
किण्वन	fermentacija	Nan
कितना	koliko	None
कितनी	koliko	None
कितने	koliko	None
किताब	knjiga	None
किए	gotovo	None
कारगर	efektivno	Nan
कालेज	koledž	Nan
कालीबंगां	kalibangan	Nan
कार्यो	radi	None
कार्यों	funkcije	None
कार्रवाई	akcija	None
कार्ल	karl	None
कार्सिनोजन	karcinogen	Nan
कार्सिनोमा	karcinom	None
काले	crna	None
काल	period	None
काला	crna	None
कालांतर	prekovremeno	Nan
कालान्तर	istek vremena	Nan
कालिदास	kalidas	Nan
कालिया	kalia	Nan
कालीन	tepih	Nan
कालक्रम	hronologija	Nan
कारखाने	fabrika	None
कारखाना	fabrika	None
कारकों	čimbenici	Nan
कहीं	negdje	None
कहे	govoreći	None
कहें	reci	Nan
क़यामत	osuda	Nan
क़ानून	zakon	None
क़ुरआन	kur&#39;an	Nan
कहावत	poslovica	Nan
क़ुरान	kur&#39;an	Nan
कांगो	kongo	Nan
कांग्रेस	kongres	None
कांच	staklo	Nan
कांचीपुरम	kanchipuram	Nan
कांड	skandal	Nan
कांतिमान	zračna	Nan
काँग्रेस	kongres	None
कांस्य	bronca	Nan
कहानी	priča	None
कहानियां	priče	None
कहकर	izgovorom	Nan
कहता	kaže	None
कहती	kaže	None
कहते	reci	Nan
कहना	reci	Nan
कहने	reći	None
कहानियों	priče	None
कहलाता	nazvani	Nan
कहलाते	su pozvani	Nan
कहलाने	da se zove	Nan
कहलाया	nazvani	Nan
कहा	rekao	None
कहां	gde	None
कहानियाँ	priče	None
कहलाती	zove se	Nan
कस्बों	gradovi	None
काउंटी	okrug	None
काकोरी	kakori	Nan
काबुल	kabul	Nan
काम	posla	None
कामकाज	posao	None
कामना	želja	None
कामयाब	uspešno	Nan
कामशास्त्र	psihologija	None
काफी	dosta	None
कामसूत्र	kamasutra	Nan
कामा	cama	Nan
कामुक	senzualna	Nan
कामों	radi	None
कायम	da traje	Nan
कार	auto	Nan
कारक	faktor	None
कामसूत्रकार	kamasutrakaar	Nan
काउंसिल	savet	Nan
काफिर	kafir	Nan
कानूनों	zakoni	None
कागज	papir	None
कागज़	papir	None
काजू	cashew	Nan
काट	sečenje	Nan
काटकर	rezanjem	Nan
काटती	ujedi	Nan
काफ़ी	dosta	None
काटा	rez	Nan
काठियावाड़	kathiawar	Nan
काढ़ा	brew	Nan
काण्ड	skandal	Nan
कान	uho	Nan
कानपुर	kanpur	Nan
कानून	zakon	None
काठमांडु	katmandu	Nan
किन	qin	Nan
कदापि	nikad	None
कद	visina	None
एजेंट	agente	Nan
एचटीएमएल	html	None
एचआईवी	hiv	Nan
एच	h	None
एग्रीगेटर	agregator	Nan
एग	jaje	Nan
एक्सप्लोरर	explorer	Nan
एक्सप्रेस	express	Nan
एक्सटेंशन	produžetak	Nan
एक्स	x	None
एक्शन	akcija	None
एकीकृत	integrisana	Nan
एकीकरण	integracija	Nan
एकान्त	samotna	Nan
एकाधिकार	monopol	None
एकाधिक	višestruko	Nan
एकादशी	ekadashi	Nan
एअर	zrak	None
एक	jedan	None
एकक	jedan	None
एकजुट	united	None
एकता	jedinstvo	None
एकत्र	prikupljeno	Nan
एजेंसियों	agencije	None
एकत्रित	prikupljeno	Nan
एकदूसरे	drugi	None
एकमत	jednoglasno	Nan
एकमात्र	samo	None
एकरूपता	uniformnost	Nan
एकल	solo	None
एकाग्रता	koncentracija	None
एकदम	odjednom	Nan
एजेंसी	agencija	None
एट	et	None
एटा	etah	Nan
एम०	m.	Nan
एयर	zrak	None
एयरपोर्ट	zračna luka	Nan
एरिया	područje	None
एल	l	None
एलन	allen	Nan
एम्	m	None
एलबम	album	None
एलिमेंट	element	None
एल्काइन	alkine	Nan
एल्गोरिथम	algoritam	None
एल्डिहाइड	aldehid	Nan
एव	i	None
एवं	i	None
एलिजाबेथ	elizabeth	None
एंव	i	None
एम	m	None
एफ	f	Nan
एटीपी	atp	None
एट्रीब्यूट	atributi	Nan
एट्रीब्यूट्	atributi	Nan
एडम	adame	Nan
एडवर्ड	edward	None
एडीज	aedes	Nan
एबं	i	None
एड्स	aids	Nan
एण्डीज	andies	Nan
एथेंस	atina	None
एनक्रिप्शन	šifriranje	Nan
एनोफ़िलीज़	anopheles	Nan
एपीजे	apj	Nan
एप्पल	apple	Nan
एण्ड	i	None
एंड	i	None
ए	a	None
ऋषियों	mudraci	Nan
उलेमा	ulema	Nan
उल्टा	obrnuto	None
उल्टी	povraćanje	Nan
उल्लंघन	kršenje	Nan
उल्लास	glee	Nan
उल्लिखित	kao što je istaknuto	Nan
उलट	suprotno	None
उल्लेख	spomena	Nan
उषा	usha	Nan
उष्णकटिबंधीय	tropska	Nan
उष्मागतिकी	termodinamika	Nan
उष्मारसायन	termohemija	Nan
उस	to	None
उसका	njegova	None
उल्लेखनीय	primetna	Nan
उसकी	ona	None
उलझन	zbunjenost	Nan
उर्वरता	plodnost	Nan
उभर	emerging	Nan
उभरते	emerging	Nan
उभरा	nastao	None
उभरी	nastao	None
उभरे	nastao	None
उमर	dob	None
उर्वशी	urvashi	Nan
उम्मीद	očekivanje	Nan
उम्र	vijecima	Nan
उर	ur	Nan
उरुग्वे	urugvaj	Nan
उर्जा	energija	None
उर्मिला	urmila	Nan
उर्वरक	đubrivo	Nan
उम्मीदवार	kandidat	Nan
एवम	i	None
उसके	njegov	None
उसने	on	None
ऊन	vuna	Nan
ऊपरी	gornja	None
ऊर्जा	energija	None
ऊष्मा	toplina	Nan
ऋग्	rig	Nan
ऋग्वेद	rigveda	Nan
ऊतकों	maramice	Nan
ऋग्वेदीय	rigvedic	Nan
ऋतु	sezona	None
ऋषभ	rishabh	Nan
ऋषभदेव	rishabhdev	Nan
ऋषि	kadulja	Nan
ऋषिकेश	rishikesh	Nan
ऋषिमुनियों	kadulje	Nan
ऋण	zajam	Nan
उसको	za njega	Nan
ऊतक	tkivo	None
ऊंची	visokog	None
उसपर	na tome	Nan
उसमे	u tome	Nan
उसमें	u tome	Nan
उससे	od njega	Nan
उसी	isto	None
उसे	njega	None
ऊंचे	viši	None
उस्ताद	učiteljice	Nan
ऊँचाई	visina	None
ऊँची	visokog	None
ऊँचे	visokog	None
ऊँट	deva	Nan
ऊंचा	visokog	None
ऊंचाई	visina	None
ऊँचा	visokog	None
कदम	korak	None
एवम्	i	None
एशियन	azijski	Nan
कच्ची	sirova	Nan
कच्चा	sirovog	Nan
कचरे	smeće	Nan
कगार	izvod	Nan
कक्षीय	orbitalno	Nan
कक्षाओं	časovi	Nan
कक्षा	klasa	None
कक्ष	soba	None
कई	mnogi	None
कंस	kansa	Nan
कंबोडिया	kambodža	Nan
कंबोज	kamboj	Nan
कंप्यूटर	kompjuter	Nan
कंपनी	kompanija	None
कंपनियों	kompanije	None
कंपनियां	kompanije	None
कंधे	rame	Nan
औरतों	žene	None
औरों	ostali	None
औलिया	aulia	Nan
औषध	lijekovi	None
औषधि	lijek	None
औषधियाँ	lijekovi	None
कच्चे	sirova	Nan
औषधियों	lijekovi	None
औसत	prosječno	None
औसतन	prosječno	None
क	k	None
कंट्रोल	kontrola	None
कंठ	grlo	Nan
कंडोम	kondomi	Nan
औषधीय	ljekovite	Nan
कट	rez	Nan
कटरा	područje	None
कटा	isjeckan	Nan
कडी	veza	None
कण	čestica	None
कणों	čestice	None
कण्ठ	klisura	Nan
कण्ठ्य	klisura	Nan
कतिपय	izvesno	Nan
कडियाँ	veze	None
कथन	izjava	Nan
कथाएँ	priče	None
कथाओं	priče	None
कथानक	zemljište	None
कथावस्तु	zemljište	None
कथित	rekao je	Nan
कथ्य	narativ	Nan
कथा	priča	None
औरगंजेब	aurangzeb	Nan
कड़े	strog	Nan
कड़ियों	veze	None
कटाई	berba	Nan
कटौती	odbitak	Nan
कट्टर	hardcore	Nan
कट्टरपंथी	fundamentalistički	Nan
कठ	korak	None
कठपुतली	lutka	Nan
कड़ी	link	Nan
कठफोड़वा	woodpecker	Nan
कठिनाइयों	poteškoće	Nan
कठिनाई	poteškoća	Nan
कठोर	oštro	None
कठोरता	tvrdoća	None
कड़ा	tvrdo	Nan
कड़ियां	veze	None
कठिन	tvrdo	Nan
औरंगजेब	aurangzeb	Nan
औरंगज़ेब	aurangzeb	Nan
और	i	None
ऑक्सीजन	kiseonik	None
ऑक्सीय	oxy	Nan
ऑटिज़्म	autizam	None
ऑटो	auto	Nan
ऑटोमोबाइल	automobilski	Nan
ऑटोरिक्शा	auto rikša	Nan
ऑक्सीकरण	oksidacija	None
ऑडियो	audio	Nan
ऑनलाइन	online	None
ऑपरेटिंग	operating	Nan
ऑपरेशन	operacija	None
ऑफ	isključeno	Nan
ऑफ़	isključeno	Nan
ऑफिस	ured	Nan
ऑन	on	None
ऑबजेक्ट	objekt	None
ऑक्साइड	oksid	None
ऐसी	takve	None
एशिया	aziji	None
एशियाई	azijski	Nan
एस	s	None
एसएमएस	sms	Nan
एसबीआई	sb i	Nan
एससीओ	sco	Nan
ऐसे	takve	None
एसिड	kiselina	None
ए०	a.	Nan
ऐतरेय	atreya	Nan
ऐतिहासिक	istorijskog	Nan
ऐश्वर्य	bogatstvo	None
ऐश्वर्या	aishwarya	Nan
ऐसा	volim ovo	Nan
एसोसिएशन	udruženje	None
एवरेस्ट	everest	Nan
ऑयल	ulje	Nan
ऑल	sve	None
ओम	om	Nan
ओर	i	None
ओलंपिक	olimpijske igre	Nan
ओलम्पिक	olimpijski	None
ओवर	preko	None
ओशो	osho	Nan
ओबामा	obama	Nan
ओसामा	osama	Nan
औचित्य	opravdanje	Nan
औजार	alati	None
औद्योगिक	industrijski	None
औद्योगिकीकरण	industrijalizacija	Nan
औपचारिक	formalno	None
औपनिवेशिक	kolonijalni	Nan
औ	i	None
ऑर्कुट	orkut	Nan
ओपेन	otvori	Nan
ओन	vlastita	None
ऑव	ow	Nan
ऑस्कर	oscar	Nan
ऑस्ट्रिया	austrija	None
ऑस्ट्रेलियन	australijski	Nan
ऑस्ट्रेलिया	australija	None
ऑस्ट्रेलियाई	australijski	Nan
ओपन	otvorena	None
ओ	o	None
ओएस	os	None
ओक	hrast	Nan
ओजस्वी	moćan	Nan
ओज़ोन	ozon	Nan
ओड़िशा	odisha	Nan
ओड्र	odr	Nan
ओंकार	omkar	Nan
उपेक्षा	ignoriraj	Nan
किनारे	ivica	None
किन्तु	ali	None
गंगायमुना	gangayamuna	Nan
गंगाधर	gangadhar	Nan
गंगाजल	ganga voda	Nan
गंगा	ganges	Nan
गंग	gang	Nan
ग	c	None
ख्वाजा	khwaja	Nan
ख्याति	poznat	None
खोला	otvoreno	None
खोलने	otvaranje	None
खोल	školjka	Nan
खोपड़ी	lobanja	None
खोने	gubljenje	Nan
खोजों	otkrića	None
खोजे	pronađi	Nan
खोजा	pretražen	Nan
खोजने	traži	None
खूब	puno	None
खूबसूरत	prekrasno	Nan
खूबसूरती	ljepota	Nan
खेत	farma	Nan
खेती	poljodjelstvo	Nan
खेतों	polja	None
गंगोत्री	gangotri	Nan
खेल	sport	None
खेलने	igrati se	Nan
खेला	odigrano	Nan
खेले	sviraj	Nan
खेलों	igre	None
खो	izgubljeni	Nan
खोज	traži	None
खेलकूद	sport	None
गंडक	gandak	Nan
गंतव्य	odredište	Nan
गंध	miris	None
गणना	proračun	Nan
गणपति	ganapati	Nan
गणराज्यों	republike	None
गणित	matematika	None
गणितज्ञ	matematičar	None
गणितज्ञों	matematičari	Nan
गणतन्त्र	republika	None
गणितीय	matematički	None
गणेशजी	ganesh ji	Nan
गणों	gano	Nan
गत	prošlost	None
गति	brzina	None
गतिज	kinetic	Nan
गतिविधि	aktivnost	None
गणेश	ganesha	Nan
खून	krv	None
गणतंत्र	republika	None
गढ़वाल	garhwal	Nan
गंधर्व	gandharva	Nan
गंभीर	ozbiljan	Nan
गंभीरता	ozbiljnost	Nan
गई	je otišao	Nan
गईं	išli	Nan
गए	otišli	None
गण	brojati	Nan
गज	dvorišta	Nan
गज़ल	ghazal	Nan
गठन	izgraditi	Nan
गठबन्धन	savez	None
गठित	konstituisana	Nan
गड्ढे	jama	Nan
गढ़	citadela	Nan
गजल	ghazal	Nan
खुसरो	khusro	Nan
खुशी	radost	Nan
खुश	sretno	Nan
ख़राब	loše	None
ख़लीफ़ा	kalif	Nan
ख़ान	khan	Nan
ख़ास	poseban	None
ख़िलाफ़	protiv	None
ख़ुद	sebe	None
ख़बर	vijesti	None
ख़ुदा	bože	None
खाँसी	kašalj	Nan
खां	khan	Nan
खाड़ी	uvala	Nan
खाता	račun	None
खाते	računi	Nan
खातों	računi	Nan
ख़ुशी	sreća	Nan
खाद	kompost	Nan
ख़त्म	gotov	Nan
खलीफा	khalifa	Nan
खपत	konzumira	Nan
खबर	vijesti	None
खबरें	vijesti	None
खमीर	kvasac	Nan
खरगोश	zec	Nan
खराब	loše	None
ख़तरा	opasnost	None
खराबी	defekt	Nan
खरीदते	kupite	Nan
खरीददारी	kupovina	Nan
खरीदने	kupite	Nan
खरीदारी	kupovina	Nan
खरीदी	kupljeno	Nan
खर्च	rashodi	Nan
खरीद	kupovina	Nan
गतिविधियाँ	aktivnosti	None
खादी	khadi	Nan
खान	khan	Nan
खीर	desert	Nan
खुजली	svrbež	Nan
खुद	ja	None
खुदरा	maloprodaja	Nan
खुदा	bože	None
खुफिया	inteligencija	None
खींचा	drew	Nan
खुल	otvori	Nan
खुलता	otvara se	Nan
खुलने	otvaranje	None
खुला	otvori	Nan
खुलासा	otkrivanje	Nan
खुली	otvorena	None
खुले	otvori	Nan
खुलकर	otvoreno	None
खाद्य	hrana	None
खींच	povuci	Nan
खिलाफ	protiv	None
खानदान	porodica	None
खानपान	hrana i piće	Nan
खाने	jedi	Nan
खानों	mine	Nan
खाया	jeo	Nan
खालसा	khalsa	Nan
खिलाफ़	protiv	None
खाली	prazno	Nan
खासकर	naročito	None
खासी	kašalj	Nan
खिलजी	khilji	Nan
खिलाड़ियों	igrači	None
खिलाड़ी	igrač	None
खिलाडी	igrači	None
खास	poseban	None
खन्ना	hrana	None
गतिविधियां	aktivnosti	None
गतिशील	dinamičan	Nan
गिरी	pad	None
गिरिजाघर	crkva	None
गिरावट	pad	None
गिराया	odbačeno	Nan
गिरा	odbačeno	Nan
गिरफ्तार	uhapšeni	Nan
गिरने	pad	None
गिरती	pad	None
गिर	pad	None
गिने	numerisan	Nan
गिनीज	guinness	Nan
गिनी	gvineja	None
गिना	računati	Nan
गिनती	grof	None
गाल	obraz	Nan
गार्डन	vrt	None
गार्ड	stražar	Nan
गाथा	saga	Nan
गान	himna	None
गाना	pjesma	None
गाने	pesme	Nan
गानों	pesme	Nan
गान्धी	gandhi	None
गिरीश	girish	Nan
गाय	goveda	Nan
गायकों	pevači	Nan
गायत्री	gayatri	Nan
गायन	pjevati	Nan
गाया	sang	Nan
गायिका	pjevač	None
गारंटी	garancija	Nan
गायक	pjevač	None
गिर्द	okolo	Nan
गिल्ड	ceh	Nan
गीज़ा	giza	Nan
गुना	saviti	Nan
गुप्तचर	detektive	Nan
गुप्ता	gupta	Nan
गुफा	pećina	None
गुफाएं	špilje	Nan
गुफाओं	pećine	None
गुन	pištolj	Nan
गुम्बद	kupola	Nan
गुरु	učiteljice	Nan
गुरुओं	gurusi	Nan
गुरुकुल	gurukul	Nan
गुरुत्व	gravitacija	Nan
गुरुत्वाकर्षण	gravitacija	Nan
गुरुदेव	gurudev	Nan
गुयाना	gvajana	Nan
गाते	pevaj	Nan
गुदा	analni otvor	Nan
गुणा	množenje	Nan
गीत	pjesma	None
गीता	geeta	Nan
गीताप्रेस	gitapress	Nan
गीतों	pesme	Nan
गीली	mokro	Nan
गुजरता	prolazi	None
गुणों	osobine	None
गुजरती	pass	Nan
गुजरात	gujarat	Nan
गुजराती	gujarati	Nan
गुट	frakcija	Nan
गुड	jaggery	Nan
गुण	kvaliteta	None
गुणवत्ता	kvaliteta	None
गुजरने	prolazi	None
गाढ़ा	debela	Nan
गाड़ी	auto	Nan
गाए	pevaj	Nan
गर्ग	garg	Nan
गर्दन	vrat	Nan
गर्भ	trudnoća	None
गर्भकाल	gestacija	Nan
गर्भगृह	sanctum sanctorum	Nan
गर्भधारण	začeće	Nan
गरुड़	orao	Nan
गर्भपात	pobačaj	None
गर्भाधान	začeće	Nan
गर्भायोजित	implantirano	Nan
गर्भावस्था	trudnoća	None
गर्भाशय	maternice	Nan
गर्म	vruće	Nan
गर्मियों	ljeto	None
गर्भवती	trudna	None
गर्मी	toplina	Nan
गरीबों	siromašni	Nan
गरिमा	dostojanstvo	Nan
गतिशीलता	mobilnost	Nan
गद्दी	padding	Nan
गद्य	proza	None
गद्यकार	proza	None
गन्धक	sumpor	None
गन्ना	šećerna trska	Nan
गरीब	siromašan	Nan
गमेलन	igra	None
गया|	gone	Nan
गयी	gone	Nan
गयीं	išli	Nan
गयूम	gayoom	Nan
गये	gone	Nan
गरम	vruće	Nan
गया	gone	Nan
गतिविधियों	aktivnosti	None
गलत	pogrešno	None
गला	grlo	Nan
ग़ुलाम	rob	None
गा	ga	None
गाँठ	čvor	None
गाँधी	gandhi	None
गाँधीजी	gandhi	None
गाँवों	sela	None
ग़ालिब	ghalib	Nan
गांगुली	ganguly	Nan
गांठों	kvržice	Nan
गांधी	gandhi	None
गांधीजी	gandhiji	Nan
गांव	selo	None
गांवों	sela	None
गाइड	vodič	None
गांठ	čvor	None
गलती	greška	None
ग़लत	netacno	Nan
ग़ज़ा	gaza	Nan
गलियों	ulice	None
गली	lane	Nan
गले	grlo	Nan
गल्फ	zaljev	Nan
गवाह	svedok	Nan
गवाही	svjedočenje	Nan
ग़म	sorrow	Nan
गहन	intenzivno	None
गहरा	duboko	None
गहराई	dubina	Nan
गहरी	duboko	None
गहरे	duboko	None
ग़ज़ल	ghazal	Nan
ग़ज़लों	ghazals	Nan
गहने	nakit	Nan
किनारों	rubovi	Nan
खनिज	minerali	None
खत्म	preko	None
केन्द्रक	nukleus	Nan
केन्द्र	centar	None
केन	ken	Nan
केदारनाथ	kedarnath	Nan
केदार	kedar	Nan
केतु	ketu	Nan
केजीबी	kgb	Nan
केंद्रों	centre	None
केंद्रीय	centralni	None
केंद्रीकृत	centralizovano	Nan
केंद्र	centar	None
के	of	None
कृष्‍ण	krišna	Nan
कृष्णा	krišna	Nan
कृष्णयजुर्वेदीय	krishnayujurvedi	Nan
कृष्णभक्ति	krišnabhakti	Nan
कृष्णपक्ष	krishnapaksha	Nan
कूद	skok	Nan
कूल्हों	bokovi	Nan
कृत	potražnja	Nan
कृति	posao	None
कृतियाँ	radi	None
कृतियों	kreacije	Nan
केन्द्रशासित	centrirano	Nan
कृत्य	zakon	None
कृत्रिम	veštačka	Nan
कृपया	molim te	Nan
कृपा	molim te	Nan
कृषक	kultivator	Nan
कृषि	poljoprivreda	None
कृष्ण	krišna	Nan
कृत्यों	djela	None
केन्द्रीय	centralni	None
केन्द्रों	centre	None
केरल	kerala	Nan
कैलिफोर्निया	kaliforniji	Nan
कैलेंडर	kalendar	None
कैलोरी	kalorija	None
कैल्शियम	kalcijum	None
कैसा	kako	None
कैसे	kako	None
कैलाश	kailash	Nan
कैस्पियन	kaspijsko	Nan
कॉफी	kafa	Nan
कॉम	com	Nan
कॉम्प्लेक्स	kompleks	None
कॉरोना	corona	Nan
कॉर्पोरेट	korporativni	Nan
कॉर्पोरेशन	corporation	Nan
कॉपीराइट	autorska prava	Nan
कूड़ा	leglo	Nan
कैरोल	carol	Nan
कैरेक्टर	lik	None
केल्टिक	keltski	Nan
केवल	na fakultetu	Nan
केशव	keshav	Nan
केसर	šafran	Nan
कैंडी	candy	Nan
कैंब्रिज	cambridge	Nan
कैरेट	caret	Nan
कैंसर	rak	None
कैण्डेला	candela	Nan
कैद	zatvorski zatvor	Nan
कैपिटल	kapital	None
कैमरा	kamera	Nan
कैम्ब्रिज	cambridge	Nan
कैरियर	prevoznik	Nan
कैकेयी	kaikeyi	Nan
कूट	šifra	Nan
कूच	putovao	Nan
कुषाण	kushan	Nan
किसे	szo	Nan
किस्म	raznolikost	Nan
किस्मत	sudbina	None
किस्में	sorte	None
किस्मों	sorte	None
की	of	None
किसी	bilo koji	Nan
कीं	to	None
कीटनाशक	pesticidi	Nan
कीटनाशकों	pesticidi	Nan
कीटाणु	germ	Nan
कीटों	insekti	Nan
कीटोन	ketone	Nan
कीड़े	crvi	Nan
कीट	insekt	Nan
कीपर	čuvar	Nan
किसानों	poljoprivrednici	Nan
किस	poljubac	Nan
किमी	km	None
किया	jeste	None
किया|	gotovo	None
किये	jeste	None
किरण	snop	Nan
किरणों	zraci	Nan
किसान	farmer	Nan
किरदार	lik	None
किले	utvrda	None
किलो	kg	Nan
किलोग्राम	kilogram	Nan
किलोमीटर	kilometar	Nan
किशोर	teen	Nan
किष्किन्धाकाण्ड	kishkindhakaand	Nan
किला	fort	Nan
कॉलेज	koledž	Nan
कीपिंग	zadržavanje	Nan
कीमत	trošak	None
कुमारगुप्त	kumargupta	Nan
कुमारपाल	kumarpal	Nan
कुमारी	djevica	Nan
कुरान	kur&#39;an	Nan
कुरीतियों	zli	None
कुरु	kuru	Nan
कुमार	kumar	Nan
कुरुक्षेत्र	kurukshetra	Nan
कुर्सी	stolica	Nan
कुल	ukupno	None
कुलीन	plemenita	Nan
कुश	kush	Nan
कुशल	vešt	Nan
कुशलता	efikasnost	None
कुर्ता	košulja	Nan
कीबोर्ड	tastatura	None
कुमाऊँ	kumaon	Nan
कुन्डली	horoskop	Nan
कीमती	predivno	Nan
कीमतों	cijene	None
कीर्तिमान	zapis	None
कुंड	furrow	Nan
कुंभ	vodolija	Nan
कुटिया	koliba	Nan
कुबेर	kubera	Nan
कुटीर	vikendica	Nan
कुण्डल	zavojnica	Nan
कुतुब	qutub	Nan
कुतुबुद्दीन	qutubuddin	Nan
कुत्ता	pas	Nan
कुत्ते	psi	Nan
कुनैन	quinine	Nan
कुण्ड	bazen	None
खनन	rudarstvo	None
कॉलेजों	koledži	Nan
कों	koji	None
क्षय	propadanje	Nan
क्षमा	izvini	Nan
क्षमताओं	sposobnosti	None
क्षमता	mogućnost	None
क्षत्रिय	kshatriya	Nan
क्षतिपूर्ति	naknada	Nan
क्षतिग्रस्त	oštećen	Nan
क्षति	šteta	None
क्षणिक	momentalno	Nan
क्षण	trenutak	None
क्वाथ	dekocija	Nan
क्वांटम	kvant	Nan
क्लोरोफिल	hlorofil	Nan
क्लोराइड	hlorid	None
क्लोनिंग	kloniranje	Nan
क्लिक	kliknite	Nan
क्लिंटन	clinton	Nan
क्रीज	crease	Nan
क्रीड़ा	sport	None
क्रुद्ध	ljuta	Nan
क्रूज	krstarenje	Nan
क्रूर	nemilosrdan	Nan
क्रेडिट	kredit	Nan
क्षरण	korozija	None
क्रोध	ljutnja	Nan
क्रोमोसोम	hromosom	Nan
क्रोमोसोमों	hromosomi	Nan
क्रोस	krst	Nan
क्लब	klub	None
क्लाइस्ट्रॉन	klystron	Nan
क्लासिकल	klasična	None
क्रोधित	ljuta	Nan
क्षिप्रा	kshipra	Nan
क्षीण	slabi	None
क्षुद्र	petty	Nan
खजुराहो	khajuraho	Nan
खजूर	datumi	Nan
खड़ा	stand	Nan
खड़ी	stojeći	Nan
खड़ीबोली	drevni oblik hindskog jezika	Nan
खड़े	stojeći	Nan
खजाने	blaga	Nan
खडा	stand	Nan
खण्ड	blok	None
खतना	obrezivanje	Nan
खतरनाक	opasno	Nan
खतरा	riskirati	Nan
खतरे	opasnost	None
खतरों	opasnosti	None
खडी	stojeći	Nan
क्रिस्टल	kristal	Nan
खजाना	blago	None
खगोल	astro	Nan
क्षुब्ध	ljuta	Nan
क्षेत्र	područje	None
क्षेत्रफल	područje	None
क्षेत्रमापी	mjerač polja	Nan
क्षेत्ररक्षण	fielding	Nan
क्षेत्राधिकार	nadležnost	Nan
खगोलीय	nebeska	None
क्षेत्रीय	regionalni	None
क्षैतिज	horizontalno	Nan
ख	b	None
खंड	odjeljak	Nan
खंडन	uskraćivanje	Nan
खंडित	fragmentiran	Nan
खंडों	segmenti	Nan
क्षेत्रों	regioni	Nan
क्रिसमस	božić	None
क्रियान्वयन	izvršenje	None
क्रियात्मक	funkcionalni	Nan
कोरिया	koreju	Nan
कोरियाई	korejski	Nan
कोर्ट	sud	None
कोर्स	kurs	Nan
कोलंबिया	kolumbija	None
कोलकाता	kolkata	Nan
कोर	kutak	Nan
कोलोंबिया	kolobia	Nan
कोशिका	ćelija	None
कोशिकाएं	ćelije	None
कोशिकाओं	ćelije	None
कोशिकीय	cellular	Nan
कोशिश	probaj	Nan
कोशों	tezaurus	Nan
कोशल	kosala	Nan
कोष	riznica	Nan
कोयले	ugljen	None
कोमलता	mekoća	Nan
कोंकण	konkan	Nan
कोइ	bilo koji	Nan
कोई	nekoga	Nan
कोख	womb	Nan
कोच	trener	None
कोट	kaput	Nan
कोयला	ugljen	None
कोड	šifra	Nan
कोणार्क	konark	Nan
कोणीय	ugaona	Nan
कोणों	uglovi	Nan
कोने	ugao	None
कोबे	kobe	Nan
कोमल	nježan	Nan
कोण	ugao	None
को	za	None
कोसल	kosal	Nan
कोहरा	magla	Nan
क्रमशः	prema tome	Nan
क्रमांक	serijski broj	Nan
क्रय	kupovina	Nan
क्रांतिकारी	revolucionarni	Nan
क्रान्त	revolucija	None
क्रान्ति	revolucija	None
क्रमश	prema tome	Nan
क्रान्तिकारी	revolucionarni	Nan
क्रिकेटर	cricketer	Nan
क्रिप्ट	kripta	Nan
क्रिप्टो	kripto	Nan
क्रिप्टोग्राफ़ी	kriptografija	Nan
क्रियाओं	glagoli	Nan
क्रियाकलाप	aktivnost	None
क्रिकेट	kriket	Nan
कोसी	kosi	Nan
क्रमबद्ध	poredaj	Nan
क्योटो	kjoto	Nan
कोहिनूर	kohinoor	Nan
कौटिल्य	kautilya	Nan
कौन	szo	Nan
कौरव	kaurava	Nan
कौशल	veština	Nan
कौशाम्बी	kaushambi	Nan
क्रम	naredba	None
कौशिक	kaushik	Nan
क्यूंकि	jer	None
क्यूबा	kuba	Nan
क्यूलेक्स	culex	Nan
क्यों	zašto	None
क्योंकि	jer	None
क्योकि	jer	None
क्या	šta	None
गुरुद्वारा	gurudwara	Nan
उपिनषद्	upinashad	Nan
उपासक	worshiper	Nan
अर्जी	primjena	None
अर्जित	zaradio	Nan
अर्ज़ी	primjena	None
अर्चना	archana	Nan
अर्क	ekstrakt	Nan
अरे	hej	Nan
अरुणाचल	arunachal	Nan
अरुण	arun	Nan
अरावली	aravali	Nan
अराजकता	anarhija	Nan
अरस्तू	aristotel	None
अरस्तु	aristotel	None
अरविन्द	arvind	Nan
अरबों	milijarde	Nan
अरबी	arapski	None
अरब	arapski	None
अरण्यकाण्ड	backwoods	Nan
अमृतसर	amritsar	Nan
अमेरिकन	američko	Nan
अमेरिका	amerika	None
अमोनिया	amonijak	Nan
अमौसी	amausi	Nan
अम्बा	amba	Nan
अर्जुन	arjun	Nan
अम्बालिका	ambalaika	Nan
अम्बेडकर	ambedkar	Nan
अम्ल	kiselina	None
अम्लीय	kisele	Nan
अम्हारिक	amharski	Nan
अयोध्या	ayodhya	Nan
अयोध्याकाण्ड	ayodhya	Nan
अम्बिका	ambika	Nan
अर्जेंटीना	argentina	None
अर्थ	značenje	None
अर्थविज्ञान	ekonomija	None
अलगअलग	različite	None
अलगाव	izolacija	Nan
अलाउद्दीन	alauddin	Nan
अलावा	osim	None
अलिखित	nepisano	Nan
अली	ali	None
अलग	osim	None
अलौकिक	nadnaravno	Nan
अल्पना	alpana	Nan
अल्पायु	mladi	None
अल्फा	alfa	Nan
अल्फ्रेड	alfred	Nan
अल्मोड़ा	almora	Nan
अल्लाह	bože	None
अल्प	malo	None
अमूल्य	neprocjenjivo	Nan
अलकनन्दा	alaknanda	Nan
अलंकार	ornamentacija	Nan
अर्थव्यवस्था	ekonomija	None
अर्थव्यवस्थाओं	ekonomije	None
अर्थशास्त्र	ekonomija	None
अर्थशास्त्रियों	ekonomisti	Nan
अर्थशास्त्री	ekonomista	Nan
अर्थात	značenje	None
अलंकृत	ukrašen	Nan
अर्थात्	to jest	Nan
अर्थों	značenje	None
अर्द्ध	polu	Nan
अर्न्तगत	under	Nan
अर्पित	posvećen	Nan
अल	al	None
अलंकरण	ornamentacija	Nan
अर्थात्‌	to jest	Nan
अमूर्त	sažetak	Nan
अमीरात	emirate	Nan
अमीर	bogat	None
अब	sad	None
अबतक	do sada	Nan
अबु	abu	None
अबुल	abul	Nan
अब्द	abd	Nan
अब्दुल	abdul	None
अफ्रीकी	afrički	Nan
अब्दुल्ला	abdulla	Nan
अब्राहम	abraham	None
अभाव	nedostatak	None
अभिकलन	računanje	None
अभिकलित्र	kompjuter	Nan
अभिकल्पना	dizajn	None
अभिक्रिया	reakcija	None
अब्बास	abbas	Nan
अभिनय	glume	Nan
अफ्रीका	afrika	None
अफ़्रीकी	afrički	Nan
अपील	žalba	Nan
अपूर्णता	nesavršenost	Nan
अपूर्व	retko	Nan
अपेक्षा	ocekujte	Nan
अपेक्षाकृत	relativno	None
अपेक्षित	očekivano	Nan
अफ्फनपिन्स्चर	afffuncture	Nan
अप्रत्यक्ष	indirektno	None
अप्सरा	patuljak	Nan
अफगान	afganistanski	Nan
अफगानिस्तान	afganistan	None
अफसर	policajac	Nan
अफ़ग़ानिस्तान	afganistan	None
अफ़्रीका	afrika	None
अप्रैलजून	apriljoon	Nan
अवकाश	praznik	None
अभिनेता	glumac	None
अभिनेत्रियों	glumice	Nan
अभिहित	namenjen	Nan
अभ्यारण्य	svetište	Nan
अभ्यास	vežba	Nan
अमर	besmrtna	Nan
अमरनाथ	amarnath	Nan
अमरावती	amravati	Nan
अभिषेक	abhishek	Nan
अमरीकन	američko	Nan
अमरीकी	američko	Nan
अमल	izvršenje	None
अमावस्या	amavasya	Nan
अमिट	neizbrisivo	Nan
अमिताभ	amitabh	Nan
अमीटर	ampermetar	Nan
अमरीका	amerika	None
अभिनेताओं	glumci	None
अभिव्यक्ति	izraz	None
अभिलेखों	zapisi	None
अभिनेत्री	glumica	None
अभिन्न	integral	Nan
अभिप्राय	namjera	None
अभिभाषण	adresa	None
अभिमन्यु	abhimanyu	Nan
अभिमान	ponos	Nan
अभिव्यक्त	izraženo	Nan
अभियन्ता	inženjer	Nan
अभियान	kampanja	Nan
अभियानों	kampanje	Nan
अभियान्त्रिकी	inženjering	None
अभिरुचि	kamata	Nan
अभिलाषा	želja	None
अभिलेख	zapis	None
अभियांत्रिकी	inženjering	None
अपितु	ali	None
अवतरण	sletanje	Nan
अवतार	avatar	Nan
आइ	ja	None
आंशिक	djelomičan	Nan
आंबेडकर	ambedkar	Nan
आंध्रप्रदेश	andra pradesh	Nan
आंध्र	andhra	Nan
आंधी	oluja	None
आंदोलनों	pokreti	None
आंतरिक	interni	Nan
आंत	crijeva	None
आंखों	oči	None
आंख	oko	None
आंकडों	brojke	Nan
आंकडे	brojke	Nan
आंकडा	podaci	None
आंकड़ों	podaci	None
आंकड़े	brojke	Nan
आँसू	suze	Nan
अस्वीकृत	odbijeno	Nan
अस्वीकृति	neodobravanje	Nan
अस्सी	osamdeset	Nan
अहंकार	ego	Nan
अहम	vital	Nan
अहमद	ahmed	None
आइंस्टीन	ajnštajn	Nan
अहमदाबाद	ahmedabad	Nan
अहिंसा	ahimsa	Nan
आ	dođi	Nan
आँकड़ों	statistika	None
आँख	oko	None
आँखें	oči	None
आँखों	oči	None
अहसास	realizacija	Nan
आइसलैंड	island	None
आइसोटोप	izotop	Nan
आई	došao sam	Nan
आकार	oblik	None
आकाश	sky	Nan
आकाशगंगा	galaksija	Nan
आकाशीय	nebeska	None
आकिल	aikal	Nan
आकिलखान	procijenite	Nan
आकांक्षाओं	aspiracije	Nan
आकृतियों	oblici	None
आक्रमणकारियों	invaders	Nan
आक्रमणों	invazije	None
आक्रामक	agresivan	Nan
आक्सफोर्ड	oxford	Nan
आक्साइड	oksid	None
आक्सीकरण	oksidacija	None
आक्रमण	napada	None
अस्वीकार	odbaci	Nan
आकांक्षा	aspiracija	Nan
आकर्षित	privučena	Nan
आईं	ona je došla	Nan
आईएमई	ime	None
आईटी	it	None
आईपॉड	ipod	Nan
आईबीएम	ibm	Nan
आईसीसी	icc	Nan
आकस्मिक	slučajno	None
आउट	napolje	Nan
आए	vraća	None
आएगा	će doći	Nan
आओ	dođi	Nan
आकर	nakon dolaska	Nan
आकर्षक	atraktivna	Nan
आकर्षण	šarm	Nan
आउटपुट	izlaz	None
अस्पृश्यता	nedodirljivost	Nan
अस्पृश्य	nedodirljiv	Nan
अस्पष्ट	nejasno	Nan
अवसर	šansa	Nan
अवस्था	država	None
अवस्थाओं	države	None
अवार्ड	nagrada	None
अविश्वास	nepoverenje	Nan
अवैध	nezakonito	Nan
अवश्य	svakako	None
अशांति	poremećaj	None
अशोक	ashok	Nan
अश्वत्थामा	ashwatthama	Nan
अश्वमेध	ashwamedh	Nan
अश्विनी	ashwini	Nan
अष्टमी	osmo	Nan
असंख्य	mnogobrojne	None
अशुभ	neuspješno	Nan
असंतुलन	neravnoteža	Nan
अवशोषित	apsorbirano	Nan
अवशोषक	apsorber	Nan
अवतारों	avatari	Nan
अवतीर्ण	utjelovljena	Nan
अवधारणा	akreditacija	Nan
अवधारणाओं	pojmovi	None
अवधि	period	None
अवधी	awadhi	Nan
अवशोषण	apsorpcija	Nan
अवमानना	prezir	Nan
अवयवों	sastojci	Nan
अवरोध	pregrada	Nan
अवलोकन	pregled	None
अवशिष्ट	preostali	Nan
अवशेष	ostaci	None
अवशेषों	ostatak	None
अवयव	komponente	None
अवतरित	descended	Nan
असंतोष	nezadovoljstvo	None
असफल	nije uspjelo	Nan
असेम्बली	skupština	None
असोसिएशन	udruženje	None
अस्त	set	None
अस्तित्व	postojanje	None
अस्तु	u stvarnosti	Nan
अस्त्र	oružje	None
असुरों	asuras	Nan
अस्त्रों	oružje	None
अस्थायी	privremena	Nan
अस्थि	kost	None
अस्थिर	nestabilno	Nan
अस्थिरता	nestabilnost	Nan
अस्पताल	bolnica	None
अस्पतालों	bolnice	Nan
अस्थाई	privremena	Nan
असंभव	nemoguće	None
असुरक्षित	nesiguran	Nan
असीमित	neograničeno	Nan
असफलता	neuspjeh	Nan
असम	assam	Nan
असमर्थ	nije moguće	Nan
असमानता	nejednakost	None
असमिका	assamese	Nan
असमिया	assamese	Nan
असुर	asura	Nan
असर	uticaj	None
असली	pravi	None
असहयोग	nesaradnja	Nan
असहाय	bespomoćno	Nan
असाधारण	izvanredan	Nan
असामान्य	neobično	None
असीम	beskonačno	Nan
असल	originalni	None
आक्सीजन	kiseonik	None
अपार	neiscrpno	Nan
अपशिष्ट	otpad	Nan
अड्डा	den	Nan
अठारहवीं	osamnaesti	Nan
अठारह	osamnaest	Nan
अटूट	neraskidiva	Nan
अटलांटिक	atlantika	Nan
अज्ञेय	nepoznat	Nan
अज्ञान	neznanje	Nan
अज्ञात	nepoznato	None
अजीब	čudno	Nan
अजातशत्रु	ajatashatru	Nan
अज़ीज़	azeez	Nan
अजय	ajay	Nan
अजमेर	ajmer	Nan
अजनाभवर्ष	aajna bhavar	Nan
अजंता	ajanta	Nan
अच्छे	dobro	None
अच्छी	dobro	None
अखिल	akhil	Nan
अख्तर	akhtar	Nan
अगर	ako	None
अगली	sljedeći	None
अगले	sljedeći	None
अगस्त	avgusta	Nan
अड्डे	baza	None
अग्नि	agni	Nan
अग्रणी	vodeći	None
अग्रसर	napred	Nan
अग्रिम	unaprijed	None
अचल	nepokretna	Nan
अचानक	odjednom	Nan
अच्छा	dobro	None
अग्निमित्र	agnimitra	Nan
अणु	molekule	None
अणुओं	molekule	None
अण्डमान	andaman	Nan
अत्रि	atri	Nan
अथ	ath	Nan
अथर्व	atharva	Nan
अथर्ववेद	atharvaveda	Nan
अथवा	ili	None
अदभुत	nevjerojatno	Nan
अत्याधिक	još	None
अदा	ada	Nan
अदृश्य	nevidljivo	Nan
अदृष्ट	neviđeno	Nan
अद्भुत	divno	Nan
अद्यतन	ažuriranja	Nan
अद्वितीय	jedinstven	None
अद्वैत	advaita	Nan
अदालत	sud	None
अखबारों	novine	None
अत्याचारी	progonitelj	Nan
अत्यन्त	veoma	None
अण्डे	jaja	None
अण्डों	jaja	None
अत	stoga	None
अतः	stoga	None
अतएव	stoga	None
अति	ekstremno	None
अत्याचार	mučenja	Nan
अतिक्रमण	enkroachment	Nan
अतिरिक्त	osim	None
अतिवादी	ekstremistički	Nan
अतीत	prošlost	None
अतेन	aten	Nan
अत्यंत	ekstremno	None
अत्यधिक	višak	Nan
अतिथि	gost	Nan
अखबार	novine	None
अखंडता	integritet	Nan
अखंड	neprekinuta	Nan
अंग्रेज़ी	engleski	None
अंग्रेजी	engleski	None
अंग्रेजो	britanci	None
अंग्रेजों	britanac	Nan
अंचल	zona	None
अंजाम	rezultat	None
अंग्रेज	engleski	None
अंजीर	sl	None
अंडाशय	jajnik	Nan
अंडे	jaja	None
अंत	završetak	None
अंतत	napokon	None
अंततः	napokon	None
अंतर	razlika	None
अंडमान	andaman	Nan
अंतरजाल	internet	None
अंगों	udovi	Nan
अंगूर	grožđe	Nan
<	&lt;	Nan
=	=	Nan
==	==	Nan
^	^	Nan
|	|	Nan
~	~	Nan
अंगो	udovi	Nan
°	°	Nan
अंकगणित	aritmetika	None
अंकारा	ankara	Nan
अंकित	ankit	Nan
अंकीय	digitalni	None
अंकों	cifre	Nan
अंग	deo	Nan
अ	a	None
अधरों	polovina	None
अंतरण	transfer	Nan
अंतराल	interval	Nan
अकार	uzrok	None
अकाल	glad	Nan
अकेला	sam	None
अकेले	sam	None
अक्टूबर	oktobar	Nan
अक्तूबर	oktobar	Nan
अकादमी	akademija	None
अक्तूबरदिसंबर	oktobar decembar	Nan
अक्षय	obnovljivi	Nan
अक्षर	pismo	None
अक्षरधाम	akshardham	Nan
अक्षांश	zemljopisna širina	Nan
अक्षुण्ण	netaknut	Nan
अक्सर	često	None
अक्षम	onemogućeno	Nan
अंतरराष्ट्रीय	međunarodni	None
अकबर	akbar	Nan
अंश	deo	Nan
अंतराष्ट्रीय	međunarodni	None
अंतरिक्ष	prostor	None
अंतरिम	privremena	Nan
अंतर्गत	under	Nan
अंतर्दृष्टि	uvid	Nan
अंतर्राष्ट्रीय	međunarodni	None
अंशों	stepeni	Nan
अंतिम	zadnji	None
अंदाज	stil	None
अंध	slepa	Nan
अंधकार	tama	Nan
अंधेरी	mračno	Nan
अंपायर	umrijeti	Nan
अंबानी	ambani	Nan
अंदर	iznutra	Nan
अपहरण	kidnapped	Nan
अधर्म	pogrešno	None
अधिक	više	None
अन्तरिक्ष	prostor	None
अन्तरराष्ट्रीय	međunarodni	None
अन्तरजाल	internet	None
अन्तर	razlika	None
अन्ततः	na kraju	Nan
अन्त	kraj	None
अनोखी	jedinstven	None
अनोखा	jedinstven	None
अनैतिक	nemoralno	Nan
अनेकों	mnogi	None
अनेक	nekoliko	None
अनूबिस	anubis	Nan
अनूदित	prevedeno	Nan
अनुसूची	raspored	None
अनुसूचित	planirano	Nan
अनुसार	prema tome	Nan
अनुसरण	potraga	Nan
अनुमानों	projekcije	Nan
अनुयायियों	sljedbenici	None
अनुयायी	sljedbenici	None
अनुराग	naklonost	Nan
अनुरूप	prema	None
अनुरोध	zahtjev	None
अन्तर्गत	under	Nan
अनुवाद	prevod	Nan
अनुशासन	dicipline	Nan
अनुशीलन	vežba	Nan
अनुष्ठान	ritual	Nan
अनुष्ठानों	rituali	Nan
अनुसंधान	istraživanje	None
अनुसन्धान	istraživanje	None
अनुवादक	prevodilac	Nan
अन्तर्राष्ट्रीय	međunarodni	None
अन्तस्थ	utelovljen	Nan
अन्तिम	zadnji	None
अपनी	moj	None
अपनीअपनी	tvoj	Nan
अपने	naši	Nan
अपनेअपने	tvoj	Nan
अपभ्रंश	dodatak	None
अपमान	uvreda	Nan
अपनाया	usvojena	None
अपमानित	uvređena	Nan
अपराधियों	zločinci	Nan
अपराधी	zločinački	Nan
अपराधों	zločini	Nan
अपलोड	pošaljite	Nan
अपवाद	izuzetak	None
अपवाह	ottok	Nan
अपराध	zločin	None
अनुमानित	procenjena	Nan
अपनाने	usvojiti	Nan
अपना	naše	None
अन्दर	in	Nan
अन्दाज	pogodi	Nan
अन्ध	slepa	Nan
अन्धकार	tama	Nan
अन्धेरा	mračno	Nan
अन्न	zrno	Nan
अपनाई	nastavili	None
अन्ना	anna	Nan
अन्यत्र	negdje drugdje	Nan
अन्यथा	inače	None
अन्याय	nepravde	Nan
अन्वेषण	istraživanje	None
अन्‍य	drugo	None
अप	gore	None
अन्य	drugo	None
अनुमान	procjena	Nan
अनुमस्तिष्क	cerebellum	Nan
अनुमति	dozvola	None
अधीन	under	Nan
अधीनता	podređivanje	Nan
अधूरा	nepotpuno	Nan
अध्यक्ष	redatelja	Nan
अध्यक्षता	predsjedavao	Nan
अध्ययन	studija	None
अधिवेशन	sjednica	Nan
अध्ययनों	studije	None
अध्यादेश	pravilnik	Nan
अध्याय	poglavlje	Nan
अध्यायों	poglavlja	Nan
अनंत	beskrajan	Nan
अनघ	anagh	Nan
अनदेखी	neviđeno	Nan
अध्यात्म	duhovnost	Nan
अनन्त	vječna	Nan
अधिपति	suzerain	Nan
अधिग्रहण	akvizicija	Nan
अधिकतम	maksimalno	None
अधिकतर	večina	Nan
अधिकता	višak	Nan
अधिकरण	tribunal	Nan
अधिकाँश	većina	None
अधिकांश	većina	None
अधिनियम	zakon	None
अधिकांशत	uglavnom	None
अधिकाधिक	više i više	Nan
अधिकार	prava	None
अधिकारिक	zvanična	None
अधिकारियों	oficiri	Nan
अधिकारी	policajac	Nan
अधिकृत	ovlašteno	Nan
अधिकांशतः	uglavnom	None
अधातु	nemetalni	Nan
अनन्य	jedinstven	None
अनमोल	neprocjenjivo	Nan
अनुचित	neprikladno	Nan
अनुच्छेद	član	None
अनुदान	grant	Nan
अनुनाद	rezonanca	None
अनुपम	anupam	Nan
अनुपस्थिति	odsutnost	Nan
अनुग्रह	grace	Nan
अनुपात	omjer	Nan
अनुप्रयोगों	aplikacije	None
अनुबंध	ugovor	None
अनुभव	iskustvo	None
अनुभवी	iskusan	Nan
अनुभाग	odjeljak	Nan
अनुभूति	osjećaj	None
अनुपालन	usklađenost	Nan
अनपढ़	nepismeni	Nan
अनुक्रम	slijed	Nan
अनुकूल	povoljno	Nan
अनवर	anwar	Nan
अनवरत	neumoljivo	Nan
अनशन	brzo	None
अनाज	zrno	Nan
अनाथ	siroče	Nan
अनार	šipak	Nan
अनुकूलन	prilagodba	Nan
अनावश्यक	nepotrebno	Nan
अनियमित	nepravilno	Nan
अनिल	anil	Nan
अनिवार्य	obavezno	None
अनिश्चित	nesigurna	Nan
अनु	anu	Nan
अनुकरण	simulacija	Nan
अनियंत्रित	nekontrolirano	Nan
उपासना	obožavanje	Nan
आखरी	zadnji	None
आखिरी	zadnji	None
उठते	ustajanje	Nan
उठती	ustajanje	Nan
उठता	ustani	Nan
उठ	probudi se	Nan
उज्जैन	ujjain	Nan
उज्जयिनी	ujjayini	Nan
उजागर	izložite	Nan
उच्‍च	visokog	None
उच्चतर	viši	None
उच्चतम	najviši	None
उचित	pogodno	Nan
उग्र	vatreno	Nan
उगाया	odrasti	Nan
उगाई	odrasti	Nan
उखाड़	uproot	Nan
उक्त	rekao je	Nan
उंगलियों	prsti	Nan
ईरान	iran	None
ईरानी	iranski	Nan
ईश	ish	Nan
ईश्वर	bože	None
ईश्वरीय	pobožno	Nan
ईसवी	ad	None
उठने	ustati	Nan
ईसाइयत	hrišćanstvo	Nan
ईसाई	hrišćanin	Nan
ईसाईयों	kršćani	None
ईसापूर्व	b.c	Nan
ईस्ट	istok	None
ईस्टर	uskrs	None
ईस्वी	ad	None
ईसाइयों	kršćani	None
उठा	branje	Nan
उठाकर	pokupljanje	Nan
उठाते	branje	Nan
उतारने	istovar	Nan
उतारा	spušten	Nan
उत्कर्ष	cvjetanje	Nan
उत्कीर्ण	gravirano	Nan
उत्कृष्ट	odlična	Nan
उत्खनन	iskopavanje	Nan
उतार	ups	Nan
उत्तम	najbolje	None
उत्तरकाण्ड	uttarkhand	Nan
उत्तरकाशी	uttarkashi	Nan
उत्तरदायित्व	odgovornost	None
उत्तरदायी	odgovorni	Nan
उत्तरपश्चिम	sjeverozapad	Nan
उत्तरपूर्व	sjeveroistok	Nan
उत्तर	odgovor	None
ईरप्शन	erupcija	Nan
उतरने	sletanje	Nan
उतर	spusti se	Nan
उठाना	pokupiti	Nan
उठाने	podizanje	Nan
उठाया	uzdignuta	Nan
उठाये	pokupiti	Nan
उठी	ustao sam	Nan
उठे	ustao sam	Nan
उतरते	silazno	Nan
उड़	leti	Nan
उड़िया	oriya	Nan
उड़ीसा	orissa	Nan
उतक	tkivo	None
उतना	toliko	None
उतनी	toliko	None
उतने	što više	Nan
उड़ने	letjeti	Nan
ईमेल	e-mail	Nan
ईमानदारी	iskrenost	Nan
ईमानदार	iskren	Nan
इमाम	sveštenik	Nan
इमारत	zgrada	None
इमारतों	zgrade	None
इराक	irak	Nan
इराक़	irak	Nan
इरादा	namjera	None
इब्राहिम	ibrahim	None
इलाका	područje	None
इलाज	tretman	None
इलाहाबाद	allahabad	Nan
इलेक्ट्रान	electron	Nan
इलेक्ट्रॉन	electron	Nan
इलेक्ट्रॉनिक	elektronski	None
इलेक्ट्रॉनिकी	elektronika	None
इलाकों	lokaliteti	Nan
इलेक्ट्रॉनिक्स	elektronika	None
इबादत	obožavanje	Nan
इन्होंने	oni	None
इनको	njih	None
इनपुट	ulaz	None
इनमे	u ovim	Nan
इनमें	u ovim	Nan
इनाम	nagrada	None
इन्टरनेट	internet	None
इन्होने	oni	None
इन्दिरा	indira	Nan
इन्दौर	indore	Nan
इन्द्रप्रस्थ	indraprastha	Nan
इन्फ्लूएंजा	gripa	Nan
इन्ही	ovi	None
इन्हे	njima	None
इन्हें	ovi	None
इन्दु	indu	Nan
उत्तरप्रदेश	uttar pradesh	Nan
इलेक्ट्रॉनों	elektroni	Nan
इष्ट	favorizovano	Nan
इस्लाम	islam	None
इस्लामिक	islamska	None
इस्लामी	islamska	None
इस्वी	ad	None
ई	e	None
ईंट	opeka	Nan
इस्माईल	ismail	Nan
ईंटों	opeka	Nan
ईक्वाडोर	ekvador	None
ईटानगर	itanagar	Nan
ईडन	eden	Nan
ईद	bajram	None
ईपू	bp	Nan
ईमान	vjera	None
ईंधन	gorivo	None
इशारा	indikacija	Nan
इस्तेमाल	rabljeni	Nan
इसीलिये	zbog toga	Nan
इस	ovo	None
इसका	svoje	None
इसकी	njegov	None
इसके	njegova	None
इसको	ovo	None
इसपर	na ovom	Nan
इसे	njega	None
इसमे	u ovom	Nan
इसरो	isro	Nan
इसलिए	dakle	None
इसलिये	zbog toga	Nan
इसवी	iswi	Nan
इससे	ovim	None
इसी	isto	None
इसमें	u ovom	Nan
इनकी	njihova	None
उत्तरांचल	uttaranchal	Nan
उत्तराखण्ड	uttarakhand	Nan
उपभोक्ता	potrošački	Nan
उपन्यासों	novele	None
उपन्यासकार	novelist	Nan
उपन्यास	roman	None
उपनिषद्	upanishadi	Nan
उपनिषदों	upanishadi	Nan
उपनिषद	upanishadi	Nan
उपनिवेशों	kolonije	None
उपनिवेशवाद	kolonijalizam	Nan
उपनाम	prezime	None
उपनगरों	predgrađa	Nan
उपनगरीय	suburban	Nan
उपनगर	predgrađe	Nan
उपधातु	bimetalni	Nan
उपदेशों	predavanja	None
उपदेश	propovijedanje	Nan
उपजाऊ	plodna	Nan
उन्हे	njih	None
उन्हें	njih	None
उन्होंने	oni	None
उन्होने	oni	None
उन्होनें	oni	None
उपकरण	opreme	None
उपभोक्ताओं	potrošači	Nan
उपकरणों	uređaji	None
उपक्रम	enterprise	Nan
उपक्षेत्र	podpolje	Nan
उपग्रह	satelitski	Nan
उपग्रहों	sateliti	None
उपचार	tretman	None
उपचारों	terapije	Nan
उपकार	favor	Nan
उपभोग	potrošnja	Nan
उपमहाद्वीप	subkontinent	Nan
उपमा	simile	Nan
उपविभाग	podsektor	Nan
उपशाखा	podnaslov	Nan
उपसर्ग	prefiks	Nan
उपसहारा	nurturer	Nan
उपस्थित	sadašnjost	Nan
उपस्थिति	prisustvo	None
उपवास	brzi	None
उपहार	pokloni	Nan
उपाधियाँ	naslovi	Nan
उपाध्याय	upadhyay	Nan
उपाय	rješenje	None
उपायुक्त	zamenika komesara	Nan
उपायों	mere	Nan
उपार्जित	stečeno	Nan
उपाधि	stupanj	Nan
उन्हीं	isto	None
उपलब्धियों	postignuća	Nan
उपलब्धि	dostupnost	Nan
उपयुक्त	pogodno	Nan
उपयोग	upotreba	None
उपयोगकर्ता	korisnika	None
उपयोगकर्ताओं	korisnici	None
उपयोगिता	korisnost	Nan
उपयोगी	korisno	Nan
उपलब्धियाँ	postignuća	Nan
उपर	iznad	None
उपरान्त	posle	None
उपराष्ट्रपति	potpredsjednik	Nan
उपरोक्त	gore spomenuto	Nan
उपर्युक्त	gore spomenuto	Nan
उपलब्ध	na raspolaganju	Nan
उपलब्धता	dostupnost	Nan
उपरांत	posle	None
उन्ही	isto	None
उन्मूलन	eliminacija	Nan
उन्मुख	orijentisana	Nan
उत्पादित	proizvedeno	Nan
उत्पादों	proizvodi	None
उत्प्रेरक	katalizator	Nan
उत्सर्जन	emisija	Nan
उत्सर्जित	emitovano	Nan
उत्सव	festivalu	None
उत्पादन	proizvodnja	None
उत्सवों	svečanosti	Nan
उत्साहित	uzbuđeno	Nan
उदय	sijati	Nan
उदयपुर	udaipur	Nan
उदर	trbušni	Nan
उदहारण	primjer	None
उदार	velikodušan	Nan
उत्साह	uzbuđenje	Nan
उदारता	ljubaznost	Nan
उत्पादकता	produktivnost	Nan
उत्पाद	proizvod	None
उत्तराधिकार	uspjeh	None
उत्तराधिकारियों	nasljednici	None
उत्तरार्ध	potonji	Nan
उत्तरी	sjeverno	None
उत्तरोत्तर	postepeno	None
उत्तानपाद	proizvod	None
उत्पादक	proizvođač	None
उत्तेजना	uzbuđenje	Nan
उत्तोलक	poluga	None
उत्थान	regeneracija	Nan
उत्पत्ति	porijeklo	None
उत्पन्न	generirano	Nan
उत्परिवर्तन	mutacija	Nan
उत्परिवर्तित	mutirano	Nan
उत्तेजित	uzbuđeno	Nan
उत्तराखंड	uttarakhand	Nan
उदारवादी	umeren	Nan
उदासीन	ravnodušan	Nan
उधर	odatle	None
उधार	pozajmi	Nan
उन	oni	None
उनका	njihova	None
उनकी	njihova	None
उनके	njihova	None
उद्योग	industrija	None
उनको	njima	None
उनसे	od njih	Nan
उन्नत	napredno	Nan
उन्नति	napredovanje	Nan
उन्नयन	nadogradite	Nan
उन्नीस	devetnaest	Nan
उन्नीसवीं	devetnaest	Nan
उनमें	u tim	Nan
उदारीकरण	liberalizacija	Nan
उद्यानों	vrtovi	Nan
उद्यान	vrt	None
उदाहरण	primjeri	None
उदाहरणस्वरूप	na primjer	Nan
उदाहरणार्थ	na primjer	Nan
उदाहरणों	primjeri	None
उदित	podignuta	Nan
उद्गम	porijeklo	None
उद्यानिकी	hortikultura	Nan
उद्घाटन	inaugaracija	Nan
उद्धरण	citati	Nan
उद्धार	izbavljenje	Nan
उद्धृत	citirano	Nan
उद्भव	evolucija	None
उद्यम	preduzeće	None
उद्यमी	preduzetnik	Nan
उद्देश्यों	ciljevi	None
आखिर	nakon svega	Nan
इनकार	odbiti	Nan
इथोपिया	etiopija	Nan
आफ	isključeno	Nan
आपूर्ति	snabdevanje	Nan
आपातकाल	hitno	Nan
आपसे	od tebe	Nan
आपसी	uzajamno	Nan
आपस	jedan drugog	Nan
आपरेशन	operacija	None
आपरेटिंग	operating	Nan
आपराधिक	zločinac	Nan
आपने	ti	None
आपदाओं	katastrofe	Nan
आपदा	katastrofa	Nan
आपत्ति	prigovor	Nan
आपको	ti	None
आपके	tvoj	Nan
आपकी	tvoj	Nan
आपका	tvoj	Nan
आध्यात्मिक	duhovno	None
आन	aan	Nan
आनंद	sreća	Nan
आनंददायी	ugodno	Nan
आनन्द	radost	Nan
आनलाइन	online	None
आफ़	isključeno	Nan
आना	dođi	Nan
आने	dolazim	Nan
आनेवाली	dolazni	Nan
आन्तरिक	interni	Nan
आन्दोलन	pokret	None
आन्ध्र	andhra	Nan
आप	ti	None
आनुवंशिक	genetski	Nan
आबाद	manned	Nan
आबू	abu	None
आभास	inkling	Nan
आयाम	dimenzije	None
आयामी	dimenzionalno	Nan
आयी	došao	None
आयीं	došao	None
आयुर्विज्ञान	medicinska nauka	Nan
आयुर्वेद	ayurveda	Nan
आयात	uvoz	Nan
आयुर्वेदिक	ayurvedic	Nan
आयेगा	će doći	Nan
आयोग	komisija	None
आयोजक	organizator	Nan
आयोजन	planiranje	None
आयोजित	drzati	Nan
आर	r	None
आये	stigao	None
आधे	polovina	None
आया	on je došao	Nan
आयरलैंड	irska	None
आभासी	virtualna	Nan
आभूषण	nakit	Nan
आम	mango	Nan
आमंत्रण	pozivnica	Nan
आमंत्रित	pozvani	Nan
आमतौर	obično	None
आयरिश	irski	Nan
आमाशय	stomach	Nan
आमेर	amer	Nan
आय	prihodi	None
आयतन	volumen	None
आयताकार	pravokutni	Nan
आयतों	pravokutnici	Nan
आयनीकृत	jonizovana	Nan
आमिर	aamir	Nan
आधुनिकीकरण	modernizacija	Nan
आधुनिकतम	sofisticiran	Nan
आधुनिक	moderan	Nan
आज़ादी	sloboda	None
आजादी	nezavisnost	None
आजीवन	doživotna	Nan
आजीविका	sredstva za život	Nan
आटा	brašno	Nan
आठ	osam	None
आज़ाद	besplatno	Nan
आठवीं	osmo	Nan
आडवाणी	advani	Nan
आडियो	audio	Nan
आणविक	molekularni	Nan
आण्विक	molekularni	Nan
आतंक	teror	Nan
आतंकवाद	terorizam	Nan
आठवें	osmo	Nan
आतंकवादी	teroristički	Nan
आजकल	sada-a-dana	Nan
आच्छादित	pokriveno	Nan
आखेट	igra	None
आख्यान	narativni	Nan
आग	vatra	None
आगंतुक	posetilac	Nan
आगम	augment	Nan
आगमन	dolazak	None
आज	danas	None
आगरा	agra	Nan
आगे	ispred	None
आग्रह	zahtjev	None
आघात	udaraca	Nan
आचार	etika	None
आचार्य	učiteljice	Nan
आचार्यों	aharije	Nan
आगामी	predstojeće	Nan
आरंभ	početak	None
आता	dođi	Nan
आते	dođi	Nan
आदिकालीन	prvobitni	Nan
आदित्य	aditya	Nan
आदिनाथ	adinath	Nan
आदिवासियों	tribala	Nan
आदिवासी	plemenski	Nan
आदेश	red	None
आदिकाल	vreme	None
आदेशों	nalozi	Nan
आधार	baza	None
आधारशिला	cornerstone	Nan
आधारित	na osnovu	Nan
आधिकारिक	zvanična	None
आधिपत्य	suzerainty	Nan
आधी	na pola puta	Nan
आधा	polovina	None
आती	dođi	Nan
आदि	e.t.c	Nan
आदान	ulaz	None
आत्म	ja	None
आत्मकथा	autobiografija	Nan
आत्मकल्याण	autizam	None
आत्मसमर्पण	predati	Nan
आत्मसात	asimilacija	Nan
आत्मा	duša	None
आदानप्रदान	davanje i uzimanje	Nan
आत्माओं	duhovi	Nan
आदत	navika	Nan
आदम	adame	Nan
आदमी	čovek	Nan
आदर	poštovanje	None
आदर्श	idealno	None
आदर्शों	ideali	Nan
आत्‍मा	duša	None
इन	in	Nan
आरंभिक	početni	Nan
आरक्षण	rezervacija	Nan
इंसानों	ljudi	None
इंसान	čovjek	None
इंद्रियों	osjetila	Nan
इंद्रिय	sense	Nan
इंद्र	indra	Nan
इंदौर	indore	Nan
इंदर	inder	Nan
इंतजार	čekaju	Nan
इंडोनेशिया	indonezija	None
इंडीज	indies	Nan
इंडिया	indija	None
इंडियन	indijanski	Nan
इंटेल	intel	Nan
इंटरफेस	sučelje	Nan
इंटरनेशनल	međunarodni	None
इंटरनेट	internet	None
इंटर	inter	Nan
आस्ट्रेलिया	australija	None
आहार	dijeta	Nan
आह्वान	poziv	None
इंक	inc.	Nan
इंकार	odbijanje	Nan
इंगित	navedeno	None
इंसुलिन	inzulin	Nan
इंग्लिश	engleski	None
इंग्लैण्ड	engleska	None
इंच	inč	Nan
इंजन	motor	Nan
इंजीनियर	inženjer	Nan
इंजीनियरिंग	inženjering	None
इंजीनियरी	inženjering	None
इंग्लैंड	engleska	None
इंस्टाल	instalacija	Nan
इंस्टीट्यूट	institut	None
इंस्पेक्टर	inspektore	Nan
इण्टरफेस	interfejs	None
इण्डिक	indic	Nan
इण्डिया	indija	None
इतना	ovoliko	Nan
इतनी	tako puno	Nan
इतालवी	italijanski	None
इण्टर	inter	Nan
इति	iti	Nan
इतिहासकार	istoričar	Nan
इतिहासकारों	istoričari	Nan
इत्यादि	i tako dalje	Nan
इत्र	parfem	Nan
इथियोपिया	etiopija	Nan
इथेन	etan	None
इतिहास	istorija	None
आसुमल	asmul	Nan
इटावा	etawah	Nan
इटली	italija	None
इकट्ठा	skupite	Nan
इकठ्ठा	okupljeni	Nan
इकाइयाँ	jedinice	None
इकाइयों	jedinice	None
इकाई	jedinica	None
इक्कीस	dvadeset jedan	Nan
इटालियन	italijanski	None
इक्कीसवीं	dvadeset prvi	Nan
इच्छा	želja	None
इच्छाओं	želje	None
इच्छित	željeno	Nan
इच्छुक	željan	Nan
इजराइल	izraela	None
इजरायल	izraela	None
इक्ष्वाकु	ikshvaku	Nan
आसाम	assam	Nan
आसानी	lakoća	Nan
आसान	lako	None
आर्थर	arthur	Nan
आर्थिक	ekonomski	None
आर्द्र	vlažna	None
आर्द्रता	vlažnost	None
आर्मी	vojska	None
आर्य	arya	Nan
आर्डर	naredba	None
आर्यावर्त	aryavarta	Nan
आलम	alam	Nan
आलावा	osim toga	Nan
आलिकखान	aalikhan	Nan
आलू	krompira	Nan
आलेख	članak	None
आलोक	alok	Nan
आर्यों	arijci	Nan
आलोचक	kritičar	Nan
आर्ट्स	umetnosti	Nan
आर्कियोप्टेरिक्स	arheopteryx	Nan
आरक्षित	rezervisano	Nan
आरटीआई	rti	Nan
आरती	aarti	Nan
आरम्भ	početak	None
आरम्भिक	početni	Nan
आराधना	obožavanje	Nan
आर्ट	čl	Nan
आराध्य	predivan	Nan
आरामदायक	udobno	Nan
आरेख	dijagram	Nan
आरोग्य	zdravlje	None
आरोप	kriviti	Nan
आरोपों	optužbe	Nan
आर्किमिडिज़	arhimed	Nan
आराम	počivaj	Nan
आरएसएस	rss	Nan
आलोचकों	kritičari	None
आलोचनाएँ	kritike	None
आशय	namjera	None
आशा	nada	None
आशीर्वाद	blagoslovima	Nan
आशुतोष	ašutosh	Nan
आश्चर्यचकित	iznenađen	Nan
आश्चर्यजनक	divno	Nan
आशंका	strah	None
आश्रम	hermitage	Nan
आश्वासन	osiguranje	Nan
आश्विन	ashwin	Nan
आषाढ़	ashadh	Nan
आसन	držanje	None
आसपास	u blizini	Nan
आसमान	nebo	None
आश्रित	zavisni	Nan
आलोचना	kritika	None
आवेदन	aplikacija	None
आविष्कारक	izumitelj	Nan
आलोचनात्मक	kritično	Nan
आल्प्स	alpe	Nan
आवरण	korica	Nan
आवर्त	period	None
आवश्यक	obavezno	None
आवश्यकता	zahtev	Nan
आवृत्ति	frekvencija	None
आवश्यकताओं	zahtevi	Nan
आवागमन	saobraćaj	None
आवाज	glas	None
आवास	smještaj	Nan
आवासीय	stambeni	Nan
आविर्भाव	pojava	None
आविष्कार	izum	Nan
आवश्यक्ता	treba	None
‎में	u	None
गुरुद्वारे	gurudwara	Nan
गुरू	guru	Nan
धान	zrno	Nan
धातुकर्म	metalurgija	None
धातुओं	metali	None
धातु	metal	None
धागे	navoj	Nan
धवन	dhawan	Nan
धर्मेन्द्र	dharmendra	Nan
धर्मशास्त्र	teologija	Nan
धर्मनिरपेक्ष	sekularni	Nan
धर्मग्रन्थ	sveto pismo	Nan
धर्मग्रंथ	sveto pismo	Nan
धर्मगुरु	vjerski vođa	Nan
धर्म	religija	None
धरोहर	baština	None
धरातल	podloga	None
धरा	porazi	Nan
धरती	zemlja	None
द्वीपों	otoci	Nan
द्वेष	grudge	Nan
द्वैत	dualnost	Nan
धक्के	prasak	Nan
धड़	torzo	None
धन	novac	None
धाम	dham	Nan
धनवान	bogat	None
धनुष	luk	None
धनुषटंकार	kravata	Nan
धन्यवाद	hvala ti	Nan
धब्बे	spots	Nan
धमनियों	arterije	None
धम्म	dhamma	Nan
धनी	bogati	None
धार	gush	Nan
धारण	zadržite	Nan
धारणाएँ	pretpostavke	None
धोखे	obmana	Nan
धोना	oprati	Nan
धोनी	dhoni	Nan
धोने	pranje	Nan
धौली	dhauli	Nan
ध्यान	njega	None
धोखा	obmana	Nan
ध्रुव	pol	Nan
ध्वज	zastava	None
ध्वनि	zvuk	None
ध्वनियाँ	zvukovi	Nan
ध्वनियों	zvuči	Nan
ध्वस्त	uništeno	Nan
न	ne	None
ध्रुवीय	polarni	Nan
द्वीपसमूह	arhipelag	None
धैर्य	strpljenje	Nan
धूल	prašina	Nan
धारणाओं	pretpostavke	None
धारा	odjeljak	Nan
धाराओं	potoci	Nan
धारावाहिक	serijski	Nan
धीमी	sporo	None
धीरुभाई	dhirubhai	Nan
धृतराष्ट्र	dhritarashtra	Nan
धीरे	sporo	None
धुम्रपान	pušenje	None
धुरी	os	None
धुल	oprani	Nan
धूम	rock	None
धूमधाम	fanfare	Nan
धूम्रपान	pušenje	None
धुंध	magla	Nan
द्वीप	ostrvo	None
द्विवेदी	dwivedi	Nan
द्वितीयक	sekundarni	None
देसाई	desai	Nan
देसी	desi	Nan
देह	telo	Nan
देहरादून	dehradun	Nan
देहली	prag	None
देहांत	smrt	None
देशों	zemlje	None
देहान्त	smrt	None
दैत्यों	demoni	Nan
दैनन्दिनी	dnevnik	Nan
दैनिक	svakodnevno	None
दैवीय	božanstveno	Nan
दैहिक	somatski	Nan
दो	dva	None
दैत्य	čudovište	Nan
दोनो	i jedno i drugo	Nan
देशो	zemlje	None
देशान्तर	zemljopisna dužina	Nan
देवकी	devaki	Nan
देवता	bože	None
देवताओं	bogovi	None
देवनागरी	devanagari	Nan
देवराज	devraj	Nan
देवि	devi	Nan
देशी	native	Nan
देवी	božice	Nan
देश	država	None
देशभक्त	patriot	Nan
देशभक्ति	patriotizam	Nan
देशभर	širom zemlje	Nan
देशविदेश	strana država	Nan
देशांतर	zemljopisna dužina	Nan
देवीदेवताओं	bogovi i boginje	Nan
नंद	nanda	Nan
दोनों	i jedno i drugo	Nan
दोबारा	ponovo	None
द्रव्यमात्रा	misa	Nan
द्रव्यों	tečnosti	None
द्रुत	brzo	None
द्रोण	drona	Nan
द्रोणाचार्य	dronacharya	Nan
द्रोणी	umivaonik	Nan
द्रव	tečnost	None
द्रौपदी	draupadi	Nan
द्वापर	dwapar	Nan
द्वार	kapija	None
द्वारका	dwarka	Nan
द्वारिका	dwarka	Nan
द्विआधारी	binarni	None
द्वितीय	sekunda	Nan
द्वादश	dwadash	Nan
दोपहर	popodne	Nan
द्योतक	emblematičan	Nan
दौरे	obilazak	Nan
दोष	greška	None
दोषी	kriv	Nan
दोषों	pogreške	Nan
दोस्त	prijatelju	Nan
दोस्ती	prijateljstvo	Nan
दोस्तों	prijatelji	None
दौलत	bogatstvo	None
दोहन	eksploatacija	Nan
दोहरे	dvokrevetna	Nan
दोहा	doha	Nan
दौड़	utrka	Nan
दौर	runda	Nan
दौरा	obilazak	Nan
दौरान	tokom	None
दोहरी	dual	Nan
देव	bože	None
नंदन	nandan	Nan
नंबर	broj	None
नाम	ime	None
नाभिकीय	nuklearna	None
नाभि	pupak	Nan
नापा	merjeno	Nan
नाप	izmjerite	Nan
नाना	djed po majci	Nan
नानक	nanak	Nan
नाद	nad	None
नाथूराम	nathuram	Nan
नाते	biti	None
नाडु	nadu	Nan
नाट्यशास्त्र	dramaturgija	Nan
नाट्य	kazališni	Nan
नाटो	nato	None
नाटकों	predstave	None
नाटककारों	dramatičari	Nan
नाटककार	dramatičar	Nan
ना	ne	None
नांसी	nancy	Nan
नाइजीरिया	nigerija	Nan
नाइट्रोजन	nitrogen	Nan
नाक	nos	Nan
नाग	zmija	None
नामक	nazvani	Nan
नागपुर	nagpur	Nan
नागरिक	građanin	None
नागरिकता	državljanstvo	Nan
नागरिकों	građani	None
नागरी	nagari	Nan
नागार्जुन	nagarjuna	Nan
नाटक	drame	None
नागर	civil	Nan
नामकरण	imenovanje	Nan
नाममात्र	nominalno	Nan
नामांकन	upis	Nan
नाव	čamac	Nan
नाविक	mornar	Nan
नाश	uništenje	Nan
नासा	nasa	Nan
नासिक	nashik	Nan
नासिर	nasir	Nan
नालन्दा	nalanda	Nan
नास्तिक	ateist	Nan
नि	besplatno	Nan
निःशुल्क	besplatno	Nan
निकट	zatvori	Nan
निकटतम	najbliži	Nan
निकटता	blizina	Nan
निकटवर्ती	u blizini	Nan
नास्तिकता	ateizam	Nan
नहीं	ne	None
नालंदा	nalanda	Nan
नारीवाद	feminizam	None
नामांकित	nominee	Nan
नामित	namenjen	Nan
नामी	poznat	None
नामों	imena	None
नामोत्पत्ति	nominacija	Nan
नायक	heroj	None
नार्वे	norveški	Nan
नायडू	naidu	Nan
नारंगी	narandžasta	Nan
नारद	narada	Nan
नारा	slogan	Nan
नाराज	ljuti	Nan
नारायण	narayan	Nan
नारी	žena	None
नायर	nair	Nan
नही	ne	None
नहर	kanal	None
नस्ल	pasmina	Nan
नतमस्तक	luk	None
नतीजा	rezultat	None
नदियाँ	rijeke	None
नदियां	reke	Nan
नदियों	reke	Nan
नदी	river	Nan
नज़र	oko	None
नन्द	nanda	Nan
नबी	poslaniče	Nan
नम	vlažno	Nan
नमः	uz pozdrav om	Nan
नमक	sol	Nan
नमन	pozdrav	Nan
नमस्कार	ćao	Nan
नन्दा	nanda	Nan
नमस्ते	zdravo	Nan
नजर	vizija	Nan
नजदीक	u blizini	Nan
नई	novo	None
नए	novo	None
नक़ल	kopiraj	Nan
नकारात्मक	negativno	None
नक्काशी	rezbarenje	Nan
नक्शा	mapa	None
नजदीकी	najbliži	Nan
नक्शे	mapa	None
नक्षत्रों	sazvežđa	Nan
नगर	grad	None
नगरपालिका	opština	Nan
नगरी	grad	None
नगरीय	urban	Nan
नगरों	gradovi	None
नक्षत्र	zvezda	Nan
नंदा	nanda	Nan
नमाज़	molitva	None
नमूना	uzorak	Nan
नवजात	novorođenče	Nan
नवपाषाण	neolitik	Nan
नवम्बर	novembra	None
नवरत्नों	navratnas	Nan
नवरात्रि	navratri	Nan
नवरात्रोत्सव	navratri festival	Nan
नवंबर	novembra	None
नवाचार	inovacija	None
नवीं	deveti	Nan
नवीन	najnoviji	Nan
नवीनतम	najnoviji	Nan
नवीनीकृत	ažurirano	Nan
नष्ट	uništeno	Nan
नसीरुद्दीन	naseeruddin	Nan
नवाब	nawab	Nan
नमी	vlaga	Nan
नव	novo	None
नल	kucnite	Nan
नमूने	uzorci	Nan
नमूनों	uzorci	Nan
नम्बर	broj	None
नम्रता	krotkost	Nan
नया	novo	None
नयी	novo	None
नलिकाओं	kanali	None
नर	muško	Nan
नरसंहार	masakr	None
नरसिंह	narasimha	Nan
नरहरि	narahari	Nan
नरेन्द्र	narendra	Nan
नरेश	naresh	Nan
नर्मदा	narmada	Nan
नरक	dodjavola	Nan
निकल	napolje	Nan
देरी	kašnjenje	Nan
देने	dati	None
दलों	stranke	None
दलितों	daliti	Nan
दलित	dalit	Nan
दलदली	mračan	Nan
दलदल	the bog	Nan
दर्शाया	navedeno	None
दर्शाने	pokazati	None
दर्शाते	reflektiraju	Nan
दर्शाती	reflektirajući	Nan
दर्शाता	označava	None
दर्शनों	pregledi	Nan
दर्शनीय	vidljiv	None
दर्शनशास्त्र	filozofija	None
दर्शन	poseta	Nan
दर्शक	publika	None
दर्पण	ogledalo	Nan
दर्द	bol	None
दयाल	dayal	Nan
दयालु	saosećajni	Nan
दर	stopa	None
दरअसल	zapravo	None
दरगाह	dargah	Nan
दरबार	sud	None
दवा	lijek	None
दरबारियों	dvorjani	Nan
दरभंगा	darbhanga	Nan
दरवाजा	vrata	None
दरवाजे	vrata	None
दरारें	pukotine	Nan
दर्ज	unesite	Nan
दर्जे	grade	None
दरबारी	dvorišni	Nan
दवाएं	lijekovi	None
दवाओं	lijekovi	None
दशकों	desetljeća	None
दांत	zubi	None
दाईं	pravo	None
दाएँ	pravo	None
दाएं	pravo	None
दाखिल	prijem	Nan
दाता	donator	Nan
दाँत	zubi	None
दाद	ringworm	Nan
दादा	djed	Nan
दान	donacija	Nan
दानव	demon	Nan
दानवों	demoni	Nan
दाने	zrno	Nan
दानों	donacije	Nan
दादरा	dadra	Nan
दयानन्द	dayanand	Nan
दा	da	None
दहन	sagorijevanje	Nan
दशमलव	decimalno	Nan
दशमी	dashami	Nan
दशरथ	dasharatha	Nan
दशहरा	dussehra	Nan
दशहरे	dussehra	Nan
दशा	stanje	None
दही	skuta	Nan
दस	deset	None
दसवें	deseti	Nan
दसों	deset	None
दस्त	dijareja	Nan
दस्तावेज	dokument	None
दस्तावेज़	dokument	None
दस्तावेजों	dokumenti	None
दसवीं	deseti	Nan
दयानंद	dayanand	Nan
दया	mercy	Nan
दमन	daman	Nan
त्रिकोणमिति	trigonometrija	Nan
त्रिकोणमितीय	trigonometrijski	Nan
त्रिज्या	polumjer	Nan
त्रिपाठी	tripathi	Nan
त्रिपुरा	tripura	Nan
त्रिभुज	trougao	None
त्रिकोण	trougao	None
त्रिमूर्ति	trojstvo	Nan
त्रिशूल	trident	Nan
त्रुटि	greška	None
त्रुटियां	greške	None
त्रुटियों	greške	None
त्वचा	koža	None
त्वरित	požurio	Nan
त्रिवेदी	trivedi	Nan
थ	th	Nan
त्रिकुटा	trikuta	Nan
त्यौहार	festival	None
तैयारी	priprema	None
तैरते	lebdeći	Nan
तो	tako	None
तोड़	pauza	None
तोड़कर	razbijanje	Nan
तोप	cannon	Nan
त्यौहारों	festivali	None
तोमर	tomar	Nan
तोला	tola	Nan
तौर	as	None
त्याग	žrtva	None
त्यागपत्र	pismo ostavke	Nan
त्यागी	pasijans	Nan
त्योहारों	festivali	None
तोरण	archway	Nan
दाब	pritisak	None
थकान	umor	Nan
थलसेना	vojska	None
दंत	stomatološka	Nan
दक्ष	efikasan	Nan
दक्षता	efikasnost	None
दक्षिण	jug	None
दक्षिणपश्चिम	jugozapad	Nan
दक्षिणपूर्व	jugoistok	Nan
दंड	kazna	None
दक्षिणी	južna	None
दत्त	dutta	Nan
दत्तात्रेय	dattatreya	Nan
दफन	pokop	Nan
दबा	potisnuta	Nan
दबाव	pritisak	None
दम	snage	None
दण्ड	kazna	None
थल	zemljište	None
द	the	None
थोड़े	malo	None
थाई	tajlandski	Nan
थाईलैंड	tajlandu	Nan
थार	thar	Nan
थाली	tanjur	Nan
थियेटर	pozorište	None
थी	bio	None
थोथ	thoth	Nan
थीं	jeste	None
थेरेपी	terapija	None
थैली	torba	Nan
थॉमस	thomas	None
थोक	bulk	Nan
थोड़ा	malo	None
थोड़ी	malo	None
थे	jeste	None
देर	kasno	None
दाम	cijena	None
दायर	podneseno	Nan
दूरसंचार	telekom	Nan
दूरदूर	daleko	None
दूरदर्शी	vizionarski	Nan
दूरदर्शन	doordarshan	Nan
दूर	daleko	None
दूध	mlijeko	None
दूत	messanger	Nan
दूँगा	daće	Nan
दुसरे	ostali	None
दुष्टों	zlo	None
दुष्ट	zlo	None
दुश्मनों	neprijatelji	Nan
दुश्मनी	neprijateljstvo	Nan
दुश्मन	neprijatelja	None
दुर्वासा	durvasa	Nan
दुर्लभ	retko	Nan
दुर्योधन	duryodhana	Nan
दुकानों	trgovine	None
दुख	tuga	Nan
दुखी	tužan	Nan
दुग्ध	mlijeko	None
दुनिया	svetu	Nan
दुबई	dubai	Nan
दूरस्थ	udaljeni	Nan
दुबारा	ponovo	None
दुर्गम	nepristupačno	Nan
दुर्गा	durga	Nan
दुर्गों	utvrđenja	None
दुर्घटना	nesreća	Nan
दुर्दम	durdam	Nan
दुर्बलता	slabost	Nan
दुर्ग	durg	Nan
दूरी	razdaljina	Nan
दूषित	oštećen	Nan
दूसरा	sekunda	Nan
देखिए	pogledaj	Nan
देखिये	pogledaj	Nan
देखी	pila	Nan
देखे	vidi	None
देखें	vidi	None
देखो	pogledaj	Nan
देखा	pila	Nan
देग	stupanj	Nan
देगी	daće	Nan
देता	daje	None
देती	daje	None
देते	davanje	Nan
देना	daj	Nan
देनी	daj	Nan
देगा	daće	Nan
दुकानें	trgovine	None
देखभाल	njega	None
देखना	vidjeti	None
दूसरों	ostali	None
दृढ	odlučna	Nan
दृढ़ता	čvrstoća	Nan
दृश्य	pogled	None
दृष्टि	vizija	Nan
दृष्टिकोण	vizija	Nan
देखने	vidjeti	None
दृष्टिकोणों	pristupi	Nan
दें	daj	Nan
देकर	davanjem	Nan
देख	vidi	None
देखकर	nakon viđenja	Nan
देखता	sees	Nan
देखते	vidi	None
दे	daj	Nan
दुकान	prodavnica	Nan
दुःखी	tužan	Nan
दुःख	tuga	Nan
दिखाता	prikazuje	None
दिखाते	prikazuje se	Nan
दिखाना	pokazati	None
दिखाने	pokaži	Nan
दिखाया	pokazano	Nan
दिखायी	pokazano	Nan
दिखाई	vidljivo	None
दिग्विजय	digvijay	Nan
दिन	dan	None
दिनकर	sunce	None
दिनांक	datum	None
दिनों	dani	None
दिमागी	um	Nan
दिया	dao	None
दिति	diti	Nan
दिया|	dao	None
दिखा	prikazuje se	Nan
दिखने	vidljivo	None
दायरे	obim	None
दायें	pravo	None
दार्शनिक	filozof	None
दावत	gozba	Nan
दावा	tvrditi	Nan
दावे	tvrdnje	None
दिखलाई	pokazano	Nan
दास	rob	None
दाहिनी	pravo	None
दाहिने	tačno	None
दि	dan	None
दिए	lampe	Nan
दिखता	izgleda	None
दिखती	vidljivo	None
दासी	sluškinja	Nan
दामोदर	damodar	Nan
दिये	s obzirom	Nan
दिलचस्पी	zainteresovani	Nan
दीपक	svjetiljka	Nan
दीपावली	deepawali	Nan
दीर्घ	dugo	None
दीर्घकालिक	dugoročno	Nan
दीर्घकालीन	dugoročno	Nan
दीर्घा	galerija	None
दीप	duboko	None
दीर्घायु	dugovječnost	Nan
दीवान	ministra	None
दीवाना	luda	Nan
दीवानी	luda	Nan
दीवार	zid	None
दीवारें	zidovi	None
दीवाली	diwali	Nan
दीव	diu	Nan
दिल	srce	None
दीन	deen	Nan
दीक्षा	iniciranje	Nan
दिलाई	administrirano	Nan
दिलाने	da se oslobodim	Nan
दिलीप	dileep	Nan
दिलों	srca	None
दिल्ली	delhi	Nan
दिल्‍ली	delhi	Nan
दीक्षित	dixit	Nan
दिवस	dan	None
दिव्य	božansko	Nan
दिशा	smjer	None
दिशाओं	smjerovi	Nan
दिसंबर	prosinca	Nan
दिसम्बर	prosinca	Nan
दी	s obzirom	Nan
दिवसीय	dan	None
तैयार	spreman	Nan
निकलकर	odlazeći	Nan
निकलती	emanates	Nan
परियोजनाओं	projekti	None
परियोजना	zadatak ili projekat	Nan
परिमाण	količina	None
परिभाषित	definisan	None
परिभाषाएँ	definicije	None
परिभाषा	definicija	None
परिपूर्ण	savršeno	Nan
परिपथ	krug	None
परिपक्व	zreli	Nan
परिधि	opseg	Nan
परिदृश्य	pejzaž	Nan
परित्याग	napuštanje	Nan
परिणामों	rezultati	None
परिणामस्वरूप	rezultiralo	None
परिणत	preobraziti	Nan
परिचित	poznat	None
परिचालन	operating	Nan
पराक्रमी	moćan	Nan
पराग	polen	Nan
परागण	zagađenje	Nan
परागन	zagađenje	Nan
पराजय	poraz	None
पराजित	poražen	None
परिलक्षित	reflektirano	Nan
पराबैंगनी	ultraljubičasto	Nan
परास्त	svrgnut	Nan
परिकल्पना	hipoteza	Nan
परिक्रमा	cirkamamulacija	Nan
परिक्षण	testiranje	Nan
परिचय	uvod	None
परिचायक	prepoznavanje	Nan
परामर्श	konsultacije	Nan
परिवर्तक	pretvarač	Nan
परिवर्तन	promjena	None
परिवर्तनशील	promenljiva	Nan
पर्ची	skliznuti	Nan
पर्णपाती	listopadni	Nan
पर्दाफाश	razbijen	Nan
पर्दे	zavjese	Nan
पर्यटक	turist	Nan
पर्यटकों	turisti	Nan
परोक्ष	indirektno	None
पर्यटन	turizam	None
पर्यवेक्षण	nadzor	None
पर्याप्त	dosta	None
पर्याय	sinonim	None
पर्यावरण	okruženje	None
पर्यावरणीय	ekološka	Nan
पर्व	festival	None
पर्यवेक्षक	supervizor	Nan
पराक्रम	hrabrost	None
परेशान	zabrinut	Nan
परीक्षित	testirano	Nan
परिवर्तनों	promjene	None
परिवर्तित	promenjeno	Nan
परिवर्ती	promenljiva	Nan
परिवहन	prevoz	Nan
परिवारों	porodice	None
परिवेश	okoliš	Nan
परे	iza	None
परिश्रम	težak posao	Nan
परिष्कृत	sofisticiran	Nan
परिस्थिति	situacija	None
परिस्थितियों	okolnosti	None
परीक्षण	testiranje	Nan
परीक्षणों	testovi	None
परीक्षा	ispit	Nan
परिषद	savet	Nan
पराकाष्ठा	kulminacija	Nan
परस्पर	uzajamno	Nan
परसाई	parsai	Nan
पथ	put	None
पद	pošta	None
पदक	medalja	None
पदानुक्रम	hijerarhija	None
पदार्थ	stvar	None
पदार्थो	supstance	None
पत्रों	pisma	None
पदार्थों	supstance	None
पद्धति	metoda	None
पद्धतियाँ	metode	None
पद्धतियों	metode	None
पद्म	padma	Nan
पद्य	stih	Nan
पध्दति	metoda	None
पदों	objave	None
पनीर	skuti sir	Nan
पत्रिकाओं	časopisi	Nan
पत्रिका	časopis	Nan
पत्तन	luka	None
पत्तियाँ	lišće	Nan
पत्तियों	lišće	Nan
पत्ती	list	None
पत्ते	lišće	Nan
पत्तों	lišće	Nan
पत्रिकाएँ	časopisi	Nan
पत्थर	kamena	None
पत्नी	supruga	None
पत्र	pismo	None
पत्रकार	novinar	None
पत्रकारिता	novinarstvo	None
पत्रपत्रिकाओं	leci	Nan
पत्राचार	prepiska	Nan
पत्थरों	kamenje	None
पर्वतमाला	raspon	Nan
पन्द्रह	petnaest	None
पन्ने	stranice	None
परमहंस	paramhansa	Nan
परमाणु	atom	None
परमाणुओं	atomi	Nan
परमात्मा	božanstveno	Nan
परमेश्वर	bože	None
परम्परा	tradicija	None
परम	ultimativno	Nan
परम्परागत	tradicionalno	None
परलोक	drugi svijet	Nan
परवरिश	odgoj	None
परवर्ती	kasnije	None
परवाह	njega	None
परशुराम	parashuram	Nan
परशुरामजी	parashuramaji	Nan
परली	parli	Nan
पन्ना	stranica	None
परब्रह्म	parabrahm	Nan
परदे	zavjesa	Nan
पन्नों	stranice	None
पपड़ी	kora	None
पब्लिक	javno	None
पम्प	pumpa	None
पर	on	None
परंपरा	tradicija	None
परन्तु	ali	None
परंपराएँ	tradicije	None
परंपराओं	tradicije	None
परंपरागत	tradicionalna	None
परक	test	Nan
परजीवी	parazit	Nan
परत	sloj	None
परतों	slojevi	Nan
परंपराएं	tradicije	None
पति	muž	None
पर्वतीय	planina	None
पर्वों	gozba	Nan
पाम	dlan	Nan
पापों	grijesi	Nan
पापी	griješnik	Nan
पाने	get	Nan
पानीपत	panipat	Nan
पानी	voda	None
पाना	ključ	None
पान	pan	Nan
पादरियों	svećenstvo	Nan
पादप	biljka	None
पाद	prdne	Nan
पात्रों	likovi	None
पात्र	lik	None
पाते	pronađi	Nan
पाती	get	Nan
पाताल	pakao	Nan
पाण्डेय	pandey	Nan
पाटन	paatan	Nan
पाटलिपुत्र	patna	Nan
पाटिल	patil	Nan
पाठ	tekst	None
पाठक	čitač	Nan
पाठकों	čitaoci	Nan
पायलट	pilot	Nan
पाठशाला	škola	None
पाठ्यक्रम	nastavni plan	Nan
पाणिनि	panini	Nan
पाण्डव	pandava	Nan
पाण्डवों	pandavas	Nan
पाण्डु	pandu	Nan
पाण्डे	pandey	Nan
पाठ्य	tekst	None
पाया	je dobio	Nan
पायी	pronađen	None
पाये	get	Nan
पार्श्व	side	Nan
पार्श्वगायन	playback pjevanje	Nan
पाल	pal	Nan
पालतू	kućni ljubimac	Nan
पालन	poslušnost	Nan
पालनपोषण	odgoj	None
पार्वती	parvati	Nan
पालने	kolevka	Nan
पालिका	palika	Nan
पावन	sveto	None
पावर	snaga	None
पाश्चात्य	zapadnjački	Nan
पाषाण	stone	Nan
पास्का	paska	Nan
पाला	pazilo	Nan
पागल	luda	Nan
पार्थिव	zemlja	None
पार्टियों	stranke	None
पार	iza	None
पारंपरिक	tradicionalno	None
पारदर्शी	transparentno	Nan
पारम्परिक	tradicionalno	None
पारसी	parsiya	Nan
पारस्परिक	uzajamno	Nan
पार्टी	zabava	Nan
पाराशर	parashar	Nan
पारिवारिक	porodica	None
पारिस्थितिक	ekološki	Nan
पारिस्थितिकी	ekologija	None
पारी	shift	Nan
पार्क	park	None
पार्टनर	partner	Nan
पारित	prošao	None
पाक्षिक	fortnightly	Nan
पाकिस्तानी	pakistani	Nan
पाकिस्तान	pakistan	None
पहचानने	prepoznatljiv	None
पहचाना	prepoznat	Nan
पहचाने	prepoznat	Nan
पहनते	nosite	Nan
पहनने	nosite	Nan
पहना	nošen	Nan
पहचान	prepoznati	Nan
पहने	nosite	Nan
पहलगाम	pahalgam	Nan
पहला	prvi	None
पहली	prvo	None
पहलुओं	aspekti	Nan
पहलू	aspekt	None
पहले	prvo	None
पहल	inicijativa	Nan
पहाड़	planina	None
पसन्द	kao	None
पश्‍चिम	na zapadu	Nan
पर्सनल	lični	None
पवन	zrak	None
पवन-वेग-मापी	vjetrenjača	Nan
पवित्रतम	najsvetiji	Nan
पवित्रता	čistoća	Nan
पशु	životinja	None
पसंदीदा	najdraža	Nan
पशुओं	životinje	None
पशुपालन	stočarstvo	None
पश्चात	posle	None
पश्चाताप	kajanje	Nan
पश्चात्	posle	None
पश्चिम	zapad	None
पश्चिमी	zapadnjački	Nan
पशुधन	stoka	Nan
पर्वत्	praznik	None
पहाड़ियों	brda	None
पहाड़ों	planine	None
पाँव	stopala	Nan
पांच	pet	None
पांचवीं	peto	Nan
पांचवें	peto	Nan
पांचों	svih pet	Nan
पांडव	pandava	Nan
पाँच	pet	None
पांडे	pandey	Nan
पांवों	stopala	Nan
पाइरूविक	pyruvic	Nan
पाई	pita	None
पाए	get	Nan
पाक	čist	None
पाकर	nakon dobivanja	Nan
पांव	stopala	Nan
पहाड़ी	brdo	None
पा	tata	Nan
पहुंचाने	isporuči	Nan
पहिए	točkovi	Nan
पहुँच	pristup	None
पहुँचकर	nakon što posegnu	Nan
पहुँचता	doseže	Nan
पहुँचती	doseže	Nan
पहुँचते	dosezanje	Nan
पहुंची	stigao	None
पहुँचने	dosegni	Nan
पहुँचाने	dostaviti	Nan
पहुँची	dosegnuo	Nan
पहुँचे	stigao	None
पहुंच	pristup	None
पहुंचते	dosezanje	Nan
पहुंचा	posegnula	Nan
पहुँचा	dosegnuo	Nan
निकलता	potječe	None
पता	adresa	None
पतली	tanka	Nan
निर्माता	tvorac	None
निर्माणाधीन	u izgradnji	Nan
निर्माण	izgradnja	None
निर्मल	meko	Nan
निर्भरता	zavisnost	Nan
निर्भर	zavisan	Nan
निर्बल	slabi	None
निर्धारित	odlučna	Nan
निर्धारण	odlučnost	Nan
निर्धारक	određujući	Nan
निर्धन	jadno	Nan
निर्देशों	uputstva	Nan
निर्देशो	instrukcije	None
निर्देशित	režirano	Nan
निर्देशिका	imenik	Nan
निर्देशांक	koordinat	Nan
निर्देशन	smjer	None
निराकार	neformalni	Nan
निराला	jedinstven	None
निराश	razočarati	Nan
निराशा	očaj	Nan
निरीक्षण	inspekcija	Nan
निरुक्त	besplatno	Nan
निर्माताओं	proizvođači	None
निरूपित	označi	Nan
निरोध	kontracepcija	Nan
निर्गुण	nirgun	Nan
निर्णायक	odlučujući	Nan
निर्दिष्ट	navedeno	None
निर्देश	instrukcije	None
निर्देशक	direktor	None
निरोग	zdrava	Nan
निर्यात	izvoz	None
निर्वाचन	izbori	None
निर्वाचित	izabran	None
निषेचन	gnojidba	Nan
निषेचित	gnojiti	Nan
निषेध	zabrana	Nan
निष्कर्ष	zaključak	None
निष्कर्षों	nalazi	None
निष्क्रिय	neaktivan	Nan
निषिद्ध	zabranjeno	None
निष्पक्ष	neutralan	Nan
निष्पादित	izvršeno	Nan
निसंदेह	naravno	None
निहित	sadržani	Nan
नींद	spavaj	Nan
नींव	temelj	None
नीच	nizak	None
निष्पादन	performanse	None
निरन्तर	neprekidno	None
निषाद	nishad	Nan
निश्चय	odlučnost	Nan
निर्वाण	nirvana	Nan
निर्वासित	u progonstvu	Nan
निर्वाह	preživljavanje	Nan
निर्विकार	besmisleno	Nan
निर्विवाद	neosporno	Nan
निवारण	prevencija	Nan
निश्चित	fiksno	Nan
निवास	rezidencija	Nan
निवासी	stanovnik	Nan
निवेदन	zahtjev	None
निवेश	investicije	Nan
निशान	mark	None
निशाना	cilj	None
निशुल्क	besplatno	Nan
निवासियों	stanovnici	None
निरंतरता	nastavak	None
निरंतर	kontinuirano	Nan
निरंकार	nirankar	Nan
निक्षेप	depozit	Nan
निगम	corporation	Nan
निगरानी	nadzor	None
निचला	niže	None
निचली	niže	None
निचले	niže	None
निकोलस	nicholas	Nan
निज़ाम	nizam	Nan
निजामुद्दीन	nizamuddin	Nan
निजी	privatno	None
निडारिया	nidaria	Nan
नितांत	apsolutno	None
नित्य	uvek	Nan
निदान	dijagnoza	None
निजाम	nizam	Nan
निदेशक	direktor	None
निकोबार	nicobar	Nan
निकास	izlaz	None
निकलते	pojačanje	Nan
निकलने	izlaz	None
निकला	napolje	Nan
निकली	izašao	None
निकले	izašao	None
निकायों	tijela	None
निकासी	čistoća	Nan
निकाल	ukloni	Nan
निकालते	ukloniti	None
निकालना	odstranjivanje	Nan
निकालने	ekstrakt	Nan
निकाला	uklonjeno	Nan
निकाली	uklonjeno	Nan
निकाले	ukloni	Nan
निकालकर	uklanjanjem	Nan
नीचा	nizak	None
निद्रा	spavaj	Nan
निधि	fond	None
नियंत्रक	kontroler	Nan
नियंत्रण	kontrola	None
नियंत्रित	kontrolirano	Nan
नियत	fiksno	Nan
नियति	sudbina	None
नियन्त्रण	kontrola	None
निम्नानुसार	kao što slijedi	Nan
नियम	pravilo	None
नियमों	pravila	None
नियामक	regulator	Nan
नियुक्त	imenovan	None
नियुक्ति	imenovanje	Nan
नियोजन	planiranje	None
नियोजित	zaposlen	Nan
नियमित	redovno	None
निधन	smrt	None
निम्नलिखित	sledi	Nan
निमित्त	za svrhu	Nan
निपटने	rješavanje	None
निपुण	savršeno	Nan
निबंध	esej	Nan
निबंधकार	esejista	Nan
निबंधों	eseji	Nan
निभा	ispunite	Nan
निमोनिया	upala pluća	Nan
निभाई	odigrano	Nan
निभाते	predstave	None
निभाने	ispuni	None
निभाया	zadržao	None
निभायी	zadržao	None
निमंत्रण	pozivnica	Nan
निमाड़	nimar	Nan
निभाता	predstave	None
पतले	tanka	Nan
नीचे	dno	None
नीतियाँ	politike	None
पटकथा	skripta	Nan
पचास	pedeset	None
पग	korak	None
पक्षों	stranice	None
पक्षी	bird	Nan
पक्षियों	ptice	None
पक्षपात	partijalnost	Nan
पक्ष	strana	None
पक्के	naravno	None
पक्की	potvrđeno	None
पकवान	jelo	Nan
पकड़े	zadržite	Nan
पकड़ने	uhvatiti	Nan
पकड़ना	uhvatiti	Nan
पकड़	zadržite	Nan
पंद्रह	petnaest	None
पंथ	kult	None
पंचम	peto	Nan
पंचमी	panchami	Nan
पंचवटी	panchvati	Nan
पंचांग	almanah	Nan
पंचायत	porota	Nan
पंचायती	panchayati	Nan
पटना	patna	Nan
पंचायतों	panchayats	Nan
पंजाबी	punjabi	Nan
पंजीकरण	registracija	Nan
पंजीकृत	registrovan	Nan
पंडित	znalca	Nan
पंत	pant	Nan
पंतनगर	pantnagar	Nan
पंजाब	punjab	Nan
पटियाला	patiala	Nan
पटेल	patel	Nan
पट्टी	skinuti se	Nan
पडा	had	Nan
पढने	pročitajte	Nan
पढ़	pročitajte	Nan
पढ़ते	pročitajte	Nan
पढ़ना	čitanje	None
पढ़ने	pročitajte	Nan
पड़ोसी	komšije	Nan
पढ़ा	pročitajte	Nan
पढ़े	pročitajte	Nan
पढ़ें	pročitajte	Nan
पढाई	studija	None
पण्डित	znalca	Nan
पतंजलि	patanjali	Nan
पतन	pad	None
पढ़ाई	studije	None
पंचतंत्र	panchatantra	Nan
पड़ेगी	padće	Nan
पड़े	laže	Nan
पठन	čitanje	None
पठार	visoravan	None
पठारी	visoravan	None
पड	pad	None
पडता	čitanje	None
पडती	pad	None
पड़ेगा	hoće	None
पड़	pad	None
पड़ती	pad	None
पड़ते	pad	None
पड़ने	pad	None
पड़ा	laže	Nan
पड़ाव	stani	Nan
पड़ी	laže	Nan
पड़ता	falls	Nan
पंच	punch	Nan
पंख	krilo	None
पंक्तियों	redovi	Nan
नेता	vođa	None
नेताओं	vođe	None
नेताजी	netaji	Nan
नेतृत्व	liderstvo	Nan
नेत्र	oko	None
नेपाल	nepal	Nan
नेटस्केप	netscape	Nan
नेपाली	nepalski	Nan
नेल्सन	nelson	Nan
नेविगेशन	navigacija	Nan
नेहरु	nehru	Nan
नैतिक	moralni	None
नैतिकता	moral	None
नैदानिक	dijagnostička	Nan
नेपोलियन	napoleon	None
नैना	naina	Nan
नेटवर्किंग	umrežavanje	None
नेकर	nekar	Nan
नीतियों	politike	None
नीदरलैंड	holandija	None
नीम	azadirachta indica	Nan
नील	plava	None
नीलगिरी	eukaliptus	Nan
नीला	plava	None
नेटवर्क	mreža	None
नीले	plava	None
नुक्सान	šteta	None
नृतत्व	ples	Nan
नृत्य	ples	Nan
नृविज्ञान	antropologija	None
नृसिंह	narsingh	Nan
नें	the	None
नुकसान	gubitak	None
नीति	politika	None
नैनी	dadilja	Nan
नैनो	nano	Nan
न्यायालय	sud	None
न्यायालयों	sudovi	None
न्यायिक	sudska	None
न्यू	novo	None
न्यूज़	vijesti	None
न्यूजीलैंड	novi zeland	Nan
न्यायाधीश	sudija	None
न्यूटन	newton	Nan
न्यूट्रॉन	neutron	Nan
न्यूनतम	minimum	None
न्यूयॉर्क	njujork	Nan
पं	pt	Nan
पंकज	pankaj	Nan
पंक्ति	linija	None
न्यूट्रान	neutron	Nan
नैनीताल	nainital	Nan
न्यायपालिका	pravosuđe	Nan
न्याय	pravda	Nan
नॉर्वे	norveška	None
नॉस्डेक	nosdeck	Nan
नो	ne	None
नोट	bilješka	Nan
नोट्स	napomene	Nan
नोबल	plemenita	Nan
न्यायधीशों	sudije	None
नौ	devet	Nan
नौकरी	posao	None
नौका	čamac	Nan
नौटियाल	nautiyal	Nan
नौवल	mornarička	Nan
नौसेना	mornarica	Nan
न्यागत	preneseno	Nan
नौकरियों	poslovi	Nan
गुरुवार	četvrtak	None
तैनात	objavljeno	Nan
तेलुगु	telugu	Nan
छवियों	slike	None
छवि	slika	None
छल्ले	prstenovi	Nan
छन्द	stih	Nan
छत्रपति	chhatrapati	Nan
छत्तीसगढ़ी	chhattisgarhi	Nan
छत्तीसगढ़	chhattisgarh	Nan
छत्तीसगढ	chattisgarh	Nan
छत	krov	Nan
छड़ी	štap	Nan
छठे	šesti	Nan
छठी	šesto	Nan
छठा	šesti	Nan
छठ	chhath	Nan
छः	šest	None
छंदों	stihovi	None
छंद	stihovi	None
चौड़ा	široki	None
चौड़ाई	širina	Nan
चौड़ी	široki	None
चौथ	chauth	Nan
चौथा	četvrti	None
चौथाई	četvrtina	Nan
छह	šest	None
चौथी	četvrto	Nan
चौदह	četrnaest	Nan
चौधरी	chaudhary	Nan
चौबीस	dvadeset četiri	Nan
चौरासी	osamdeset cetiri	Nan
चौहान	chauhan	Nan
च्हिन	chhin	Nan
चौथे	četvrto	Nan
छाछ	maslac	Nan
छात्र	student	None
छात्रवृत्ति	stipendija	Nan
छूती	dodiri	Nan
छूने	za dodir	Nan
छेद	rupa	None
छोटासा	malo	None
छोटी	mala	None
छोटीछोटी	mala	None
छूट	koncesija	Nan
छोटे	mala	None
छोड	ostavi to	Nan
छोड़	otići	Nan
छोड़ते	odlazeći	Nan
छोड़ने	odlazeći	Nan
छोड़ा	levo	Nan
छोड़ी	levo	Nan
छोटेबड़े	starješine i omladine	Nan
चौकी	pošta	None
छुपे	skrivena	Nan
छुपा	skrivena	Nan
छात्रों	studenti	None
छानकर	nakon filtriranja	Nan
छाया	senka	Nan
छायावाद	shadowism	Nan
छायावादी	kinematograf	Nan
छाल	kora	None
छुपाने	sakriti	Nan
छावनी	kantonment	Nan
छिप	skrivena	Nan
छिपा	skrivena	Nan
छीन	snatch	Nan
छुटकारा	olakšanje	Nan
छुट्टियों	praznici	None
छुट्टी	odmor	None
छिद्रों	vents	Nan
चौक	trg	None
चोरी	krađa	Nan
चोपड़ा	chopra	Nan
चिली	čile	None
चिश्ती	chishti	Nan
चिह्नित	označeno	Nan
चिह्नों	oznake	None
चींटी	mrav	None
चीज	stvar	None
चिरायता	salicy	Nan
चीज़	stvar	None
चीजें	stvari	None
चीजों	stvari	None
चीन	kina	None
चीफ	šefe	Nan
चुंबकिय	magnet	Nan
चुंबकीय	magnetska	Nan
चीज़ों	stvari	None
चुकी	gotov	Nan
चिरहरित	neoznačeno	Nan
चिन्हित	označeno	Nan
चित्रकला	slika	None
चित्रकार	slikar	None
चित्रकारी	slikarstvo	Nan
चित्रकूट	chitrakoot	Nan
चित्रण	ilustracija	Nan
चित्रलिपि	hieroglif	Nan
चिप	čip	None
चित्रा	chitra	Nan
चित्रांगद	chitrangad	Nan
चित्रित	slikano	Nan
चित्रों	slike	None
चिन्तन	razmišljam	Nan
चिन्ता	njega	None
चिन्ह	simbol	None
चित्रांकन	crtanje	Nan
छोर	krajevi	None
चुके	had	Nan
चुनकर	izborom	Nan
चेतावनी	upozorenje	Nan
चेन्नई	chennai	Nan
चेष्टा	napor	None
चेष्टाओं	napori	Nan
चेहरा	lice	None
चैतन्य	chaitanya	Nan
चेतना	svijest	None
चैत्र	chaitra	Nan
चैनलों	kanali	None
चैम्पियनशिप	prvenstvo	None
चॉकलेट	čokolada	Nan
चोटियाँ	vrhovi	None
चोटियों	vrhovi	None
चोटी	vrhunac	None
चैनल	kanal	None
चुन	chun	Nan
चेचक	kozica	Nan
चूर्ण	puder	Nan
चुनते	odaberite	Nan
चुना	izaberi	Nan
चुनाव	izbori	None
चुनावी	izbori	None
चुनावों	izbori	None
चुनी	izabran	None
चेक	proverite	Nan
चुने	odaberite	Nan
चुपचाप	tiho	Nan
चूँकि	od tada	Nan
चूंकि	od tada	Nan
चूका	propušteno	Nan
चूड़ी	bangle	Nan
चूना	vapno	Nan
चुपके	prikrivenost	Nan
चित्र	slika	None
ज	j	Nan
जंग	rđa	Nan
जलन	ljubomora	Nan
जलधारा	potok	None
जलती	gori	None
जल	voda	None
जर्मेनियम	germanij	Nan
जर्मनी	nemačke	Nan
जर्मनिक	germanska	Nan
जर्मन	njemački	None
जर्नल	časopis	Nan
जरूरी	potrebno	None
जरूरत	potreba	None
जरूर	naravno	None
जरुरी	mora	None
जरुरत	potreba	None
जरिये	pomoću	None
जरिए	via	Nan
जरा	samo	None
जमाव	podešavanje	Nan
जमीन	zemljište	None
जमीनी	tlo	None
जम्बूद्वीप	jambudweep	Nan
जम्मू	jammu	Nan
जय	jai	Nan
जलने	gori	None
जयंती	jubilarni	Nan
जयदेव	jaidev	Nan
जयपुर	jaipur	Nan
जयप्रकाश	jai prakash	Nan
जयशंकर	jaishankar	Nan
जयसिंह	jaisingh	Nan
जया	jaya	Nan
जयचंद	jaychand	Nan
जलमण्डल	hidrosfera	Nan
जलवायु	klima	None
जलविमान	vodni zanat	Nan
जस्ता	cink	None
जहर	otrov	None
जहाँ	gde	None
जहाँगीर	jahangir	Nan
जहां	gde	None
जहाज	brod	None
जश्न	proslavite	Nan
जहाजों	brodovi	None
ज़फ़र	zafar	Nan
ज़मीन	tlo	None
ज़रूर	naravno	None
ज़रूरत	treba	None
ज़रूरी	potrebno	None
ज़िक्र	pominje se	Nan
ज़कात	zakat	Nan
जमाने	era	None
जवाहरलाल	jawaharlal	Nan
जवाब	odgovor	None
जला	izgaranje	Nan
जलाई	upaljeno	Nan
जलाकर	baklje	Nan
जलाने	kindle	Nan
जलापूर्ति	snabdijevanje vodom	Nan
जलाया	upaljena	Nan
जवाहर	jawahar	Nan
जलालुद्दीन	jalaluddin	Nan
जलियांवाला	jallianwala	Nan
जलीय	vodeni	None
जल्द	uskoro	None
जल्दी	uskoro	None
जवान	mlad	None
जवानी	mladost	None
जलाशय	rezervoar	Nan
जमा	depozit	Nan
जमशेदपुर	jamshedpur	Nan
जम	čvrsta	None
जटायु	jatayu	Nan
जटिल	kompleks	None
जड़	koren	Nan
जड़े	korijen	None
जड़ें	koreni	Nan
जताई	izraženo	Nan
जज	sudija	None
जन	ljudi	None
जनगणना	popis	None
जनजाति	pleme	None
जनजातियों	plemena	None
जनजीवन	život	None
जनता	javni	None
जनन	generacija	None
जनक	roditelj	Nan
जननांग	reproduktivni organ	Nan
जगहों	mjesta	None
जगन्नाथ	jagannath	Nan
जंगल	šuma	None
जंगली	divlji	Nan
जंगलों	šume	None
जंघा	butina	Nan
जंतु	stvorenje	Nan
जंतुओं	životinje	None
जगह	mesto	Nan
जंबुद्वीप	jambudweep	Nan
जगजीत	jagjit	Nan
जगत	univerzum	Nan
जगत्	svijet	None
जगत्‌	svijet	None
जगदीश	jagdish	Nan
जगद्गुरु	jagadguru	Nan
जग	svijet	None
जंक्शन	spoj	None
जननी	majko	None
जनभाषा	javni jezik	Nan
जन्मदिन	rođendan	Nan
जन्मस्थान	mjesto rođenja	Nan
जन्माष्टमी	janmashtami	Nan
जन्मी	rođen	None
जन्मे	rođen	None
जन्मों	životni vekovi	Nan
जन्म	rođenje	None
जन्‍म	rođenje	None
जफर	zafar	Nan
जब	kada	None
जबकि	dok	None
जबरन	prisilno	Nan
जबाव	odgovori	Nan
जब्त	zaplijenjeni	Nan
जप	pjevanje	None
जनपद	okrug	None
जन्तुओं	životinje	None
जनों	ljudi	None
जनम	rođenje	None
जनमत	javno mnjenje	Nan
जनमानस	javno	None
जनरल	opšte	None
जनवरी	januar	None
जनवरीमार्च	januarski marš	Nan
जन्तु	životinja	None
जनवादी	populistički	Nan
जनसंख्या	stanovništvo	None
जनसंघ	misa	Nan
जनसांख्यिकी	demografija	None
जनसाधारण	mise	Nan
जनहित	javni interes	Nan
जनित	generirano	Nan
जनसँख्या	stanovništvo	None
ज़िम्मेदारी	odgovornost	None
चित्त	um	Nan
चिड़ियाघर	zoo	Nan
ग्लूकोज	glukoza	None
ग्लाइकोलिसिस	glikoliza	Nan
ग्रैंड	grand	None
ग्रेनाइट	granit	Nan
ग्रेट	odlično	Nan
ग्रेगोरी	gregory	Nan
ग्रुप	grupa	None
ग्रीस	grčka	None
ग्रीष्मकालीन	ljeto	None
ग्रीष्म	ljeto	None
ग्रीवा	cervix	Nan
ग्रीनहाउस	staklenik	Nan
ग्रीन	zeleno	None
ग्रीक	grčki	None
ग्रिगोरियन	grigorian	Nan
ग्राह्य	ispunjava uvjete	Nan
ग्राही	prijemnik	Nan
ग्रंथों	tekstovi	None
ग्रन्थ	tekst	None
ग्रन्थसूची	bibliografija	None
ग्रन्थों	tekstovi	None
ग्रस्त	patiti	Nan
ग्रहण	eklipsa	Nan
ग्लेशियर	glecier	Nan
ग्रहों	planete	None
ग्राफिक	grafički	None
ग्राम	gram	Nan
ग्रामीण	seoski	None
ग्राहक	kupac	Nan
ग्राहकों	kupci	Nan
ग्राहम	graham	Nan
ग्राउंड	ground	Nan
ग्लोबल	globalno	Nan
ग्वालियर	gwalior	Nan
घ	d	Nan
घनी	debela	Nan
घने	gusta	Nan
घर	kuća	None
घराने	gharana	Nan
घरेलु	dom	None
घरेलू	domaćinstvo	Nan
घनिष्ठ	zatvori	Nan
घरों	kuće	None
घाघरा	suknja	Nan
घाट	pomol	Nan
घाटियों	doline	None
घाटी	dolina	None
घाटों	ghats	Nan
घातक	smrtonosna	Nan
घर्षण	trenje	None
ग्रंथियों	žlezde	Nan
घनत्व	gustina	None
घटित	dogodilo	None
घंटा	bell	None
घंटी	zvono	Nan
घंटे	sati	None
घंटों	sati	None
घटक	komponente	None
घटकों	komponente	None
घड़ी	sat	None
घटती	umanjuje se	Nan
घटनाएँ	događaji	None
घटनाएं	događaji	None
घटनाओं	događaji	None
घटनाक्रम	događaji	None
घटनायें	događaji	None
घटने	umanjuje se	Nan
घटना	incident	Nan
ग्रंथि	žlezda	Nan
ग्यास्त्रोएन्टेरोलोजी	gyastroenterologija	Nan
ग्यारहवीं	jedanaesta	Nan
गेहूं	pšenica	None
गैंगलिया	ganglia	Nan
गैर	non	Nan
गैलरी	galerija	None
गैलीलियो	galileo	Nan
गैस	plin	Nan
गेहूँ	pšenice	Nan
गैसें	gasovi	Nan
गोआ	goa	Nan
गोएंका	goenka	Nan
गोकुल	gokul	Nan
गोजर	millipede	Nan
गोड	bože	None
गोडसे	godse	Nan
गैसों	gasovi	Nan
गोत्र	pleme	None
गेलिक	galski	Nan
गेट्स	kapije	Nan
गुर्दे	bubrega	None
गुलाब	rose	Nan
गुलाबी	ruža	None
गुलाम	robovi	None
गुलामी	ropstvo	None
गुस्सा	ljutnja	Nan
गेम	igra	None
गूगल	google	None
गृह	dom	None
गृहस्थ	domaćinstvo	Nan
गेंद	lopta	None
गेंदबाजी	kuglanje	Nan
गेज	mjerilo	Nan
गेट	kapija	None
गूजरी	gujari	Nan
घायल	povređeni	Nan
गोद	lap	Nan
गोदावरी	godavari	Nan
गोले	školjke	Nan
गोल्ड	zlato	None
गोल्फ	golf	Nan
गोवर्धन	vlada	None
गोवा	goa	Nan
गोविंद	govind	Nan
गोलीबारी	pucnjava	Nan
गोविन्द	govind	Nan
गोस्वामी	goswami	Nan
गौड़	gaur	Nan
गौण	sekundarni	None
गौतम	gautam	Nan
गौरव	ponos	Nan
गौरी	gauri	Nan
गोस्पेल	evanđelje	Nan
गोदान	godan	Nan
गोली	gun shot	Nan
गोलाकार	okrugli oblik	Nan
गोपनीयता	privatnost	Nan
गोपाल	gopal	Nan
गोबर	kravlji gnoj	Nan
गोबिंदराय	gobindarai	Nan
गोबिन्द	govind	Nan
गोमती	gomti	Nan
गोलार्द्ध	hemisfera	Nan
गोयल	goyal	Nan
गोरखपुरी	gorakhpur	Nan
गोरखा	gurkha	Nan
गोरी	plavuša	Nan
गोल	cilj	None
गोलक	golak	Nan
गोलकुंडा	golconda	Nan
गोरखपुर	gorakhpur	Nan
चिता	pyre	Nan
घास	trava	Nan
घिरे	okružen	None
चांद	mjesec	None
चांडाल	chandal	Nan
चाँदी	srebrna	Nan
चाँद	mesec	Nan
चलो	idemo	Nan
चले	idemo	Nan
चली	kasnio	Nan
चलाये	vozite	Nan
चलाया	vozio	Nan
चलाने	bježi	None
चलाना	vozite	Nan
चलाते	bježi	None
चलाता	pokreće	None
चलाए	vozio	Nan
चला	prošetao	Nan
चलने	hodanje	Nan
चलना	hodati	Nan
चरित	lik	None
चरित्र	lik	None
चरों	varijable	None
चर्च	crkva	None
चर्चा	diskusija	Nan
चर्चित	vruće	Nan
चांदी	srebro	None
चर्म	koža	None
चल	šetnja	Nan
चलकर	kasnije	None
चलचित्र	filmovi	None
चलता	šetnje	Nan
चलती	krećući se	Nan
चलन	vežba	Nan
चर्मरोग	dermatitis	Nan
चाइना	kina	None
चाचा	stric	Nan
चाणक्य	chanakya	Nan
चाहने	loves	Nan
चाहा	wills	Nan
चाहिए	potrebno	None
चाहिये	željeti	Nan
चाहे	čak iako	Nan
चाहें	želja	None
चाहते	željeti	Nan
चिंतन	zabrinutosti	Nan
चिकित्सक	doktor	None
चिकित्सकीय	stomatološka	Nan
चिकित्सकों	lekari	Nan
चिकित्सा	lečenje	Nan
चिकित्सीय	terapijski	Nan
चिट्ठे	blog	None
चिकन	piletina	Nan
चरमोत्कर्ष	climax	Nan
चाहती	željeti	Nan
चावल	riža	None
चाप	arc	Nan
चाय	čaj	Nan
चार	četiri	None
चारा	feed	Nan
चारो	svuda okolo	Nan
चारों	sva četvorica	Nan
चाहता	potrazi	None
चार्ज	punjenje	Nan
चार्ल्स	charles	None
चाल	trik	Nan
चालक	vozač	Nan
चालित	vođen	Nan
चालीस	četrdeset	None
चालू	on	None
चार्टर	povelja	None
चरमआनंद	izuzetno zadovoljstvo	Nan
चरम	ekstremno	None
चरणों	koraci	None
ङ	4	Nan
चंडी	chandi	Nan
चंडीगढ़	chandigarh	Nan
चंदन	sandalovina	Nan
चंद्र	chandra	Nan
चंद्रगुप्त	chandragupta	Nan
घोसला	ghosla	Nan
चंद्रमा	mesec	Nan
चंद्रयान	chandrayaan	Nan
चकित	iznenađen	Nan
चक्कर	afera	None
चक्र	točak	Nan
चक्रवर्ती	chakravarthy	Nan
चक्रवात	ciklona	Nan
चंद्रमास	lunarni mjesec	Nan
चचेरे	rođake	Nan
घोषित	deklarirano	Nan
घोष	ghosh	Nan
घी	ghee	Nan
घुटनों	koljena	None
घुड़सवार	konjanik	Nan
घुसपैठ	infiltracija	Nan
घूम	roam	Nan
घूमते	roam	Nan
घोषणा	deklaracija	None
घूमने	lutaju	Nan
घृत	rastopljeni puter	Nan
घेघा	jednjak	Nan
घेरे	okružuju	None
घोड़ा	konj	None
घोड़े	konji	None
घोड़ों	konji	None
घूर्णन	rotacija	Nan
घिरा	okružen	None
चट्टानों	stijene	None
चढ़	penjao	Nan
चमकीले	jasno	None
चमड़ा	koža	None
चमड़ी	skinned	Nan
चमड़े	koža	None
चमत्कार	čudo	None
चमत्कारिक	čudo	None
चबूतरे	pops	Nan
चमोली	šamoli	Nan
चम्मच	kašika	Nan
चयन	izbor	None
चयनात्मक	selektivni	Nan
चयनित	odabrano	Nan
चरक	charak	Nan
चरण	pozorište	None
चम्बल	chambal	Nan
चट्टोपाध्याय	chattopadhyay	Nan
चन्द्रशेखर	chandrashekhar	Nan
चन्द्रमा	mjesec	None
चढ़ने	popeti se	Nan
चढ़ा	ukrcali se	Nan
चढ़ाई	uspon	None
चढ़ाना	pozlaćivanje	Nan
चढ़ाने	pozlaćivanje	Nan
चढ़ाया	podložen	Nan
चन्द्रराव	chandrarao	Nan
चतुर	pametna	Nan
चतुर्थी	chaturthi	Nan
चतुर्भुज	četverostrani	Nan
चतुर्वेदी	chaturvedi	Nan
चन्द	mjesec	None
चन्द्र	chandra	Nan
चन्द्रगुप्त	chandra gupta	Nan
चतुर्थ	četvrti	None
तेलुगू	telugu	Nan
ज़ोन	zona	None
ज़्यादा	još	None
डॉट	tačka	None
डॉग	pas	Nan
डॉक्टरों	lekari	Nan
डॉ	dr	None
डैनिश	danski	None
डेस्कटॉप	radna površina	Nan
डेविडसन	davidson	Nan
डेविड	david	None
डेल्टा	delta	None
डेली	deli	Nan
डेनिस	denise	Nan
डेनमार्क	danska	None
डेढ़	jedan i po	Nan
डेटाबेस	baza podataka	Nan
डेटा	podaci	None
डे	dan	None
डीसी	dc	Nan
डिजाइन	dizajn	None
डिजाईन	dizajn	None
डिजिटल	digitalni	None
डिजीटल	digitalni	None
डिपो	depo	Nan
डिलीवरी	dostava	Nan
डॉन	don	None
डिवाइस	uređaj	None
डिस्क	disk	None
डी	d	Nan
डीजल	dizel	Nan
डीडी	dd	None
डीडीटी	ddt	Nan
डीवीडी	dvd	Nan
डिवीजन	divizija	None
डॉलर	dolar	None
डॉ०	dr.	Nan
डोम	kupola	Nan
तंत्रिकाओं	nervi	Nan
तंबाकू	duhan	None
तकनीक	tehnika	None
तकनीकी	tehnologija	None
तकनीकें	tehnike	None
तकनीकों	tehnike	None
तंत्रिका	nerva	Nan
तकिया	jastuk	Nan
तक्षशिला	takshshila	Nan
तख्त	seat	Nan
तट	obala	None
तटरक्षक	obalna straža	Nan
तटवर्ती	na obali	Nan
तटीय	primorski	Nan
तकियाः	jastuk	Nan
डिज़ाइन	dizajn	None
तंत्र	tantra	Nan
ण	kredit	Nan
ड्राइव	vozite	Nan
ड्राईव	vozite	Nan
ढंग	ponašanje	None
ढक	cover	Nan
ढका	pokriveno	Nan
ढ़	polovina	None
तंग	čvrsto	None
ढाँचे	okvir	None
ढांचे	struktura	None
ढाका	dhaka	Nan
ढाल	štit	None
ढीले	loose	Nan
ढूंढ	pronađi	Nan
ढेर	gomila	Nan
ढांचा	okvir	None
डिग्री	stupanj	Nan
डिक्शनरी	rečnik	Nan
डालो	staviti	None
ट्यूब	tube	Nan
ट्यूमर	tumor	None
ट्रस्ट	poverenje	Nan
ट्रान्सफार्मर	transformator	Nan
ट्रान्समिटर	odašiljač	Nan
ट्राम	tramvaj	Nan
टोपे	tope	Nan
ट्रिनिटी	trojstvo	Nan
ट्रिमस्टर	trimster	Nan
ट्रेड	trgovina	None
ट्रेन	voz	Nan
ट्वेंटी	dvadeset	None
ठंड	hladno	Nan
ठंडा	hladno	Nan
ट्रिब्यून	tribune	Nan
ठंडी	hladno	Nan
टोपी	šešir	Nan
टोकामाक	tokamak	Nan
टेक्स्ट	tekst	None
टेनिस	tenis	None
टेरेसा	tereza	None
टेलर	krojač	Nan
टेलिविज़न	televizija	None
टेलीफोन	telefon	Nan
टोक्यो	tokio	Nan
टेलीविजन	televizija	None
टैंक	cisterna	Nan
टैक्सी	kabina	Nan
टैग	oznaka	None
टैगोर	tagore	Nan
टैबीरियस	tabarius	Nan
टॉवर	toranj	None
टेस्ट	test	Nan
तत्काल	odmah	None
ठंडे	hladno	Nan
ठाकुर	plemić	Nan
डाक	postovi	Nan
डाक्टर	doktore	Nan
डाट	stopper	Nan
डाटा	podaci	None
डाटाबेस	baza podataka	Nan
डाल	filijala	Nan
डाउनलोड	skinuti	Nan
डालकर	stavljanjem	Nan
डालती	stavlja	None
डालते	staviti	None
डालने	umetni	Nan
डालर	dolar	None
डाला	staviti	None
डाली	ogranak	None
डालता	stavlja	None
ठाकरे	thackeray	Nan
डाई	dye	Nan
डाइआक्साइड	dioksid	None
ठाणे	thane	Nan
ठीक	fino	Nan
ठेठ	tipično	None
ठोकर	posrnuti	Nan
ठोस	čvrsta	None
ड	d	Nan
डाइऑक्साइड	dioksid	None
डकैती	razbojništvo	Nan
डबल्यू	w	Nan
डब्लू	w	Nan
डर	strah	None
डहेलिया	dahlia	Nan
ड़	e	None
डा	dr	None
डगलस	douglas	Nan
टेक्सास	texas	Nan
तत्कालीन	savremeni	None
तत्पश्चात	nakon toga	Nan
तुमने	ti	None
तुगलक	tughlaq	Nan
तु	ti	None
तीसरे	treće	None
तीसरी	treći	None
तीसरा	treći	None
तीस	trideset	None
तीव्रता	intenzitet	Nan
तीव्र	intenzivno	None
तीर्थों	hodočašća	Nan
तीर्थस्थान	svetište	Nan
तीर्थस्थल	sveto hodočašće	Nan
तीर्थयात्री	hodočasnik	Nan
तीर्थयात्रियों	hodočasnici	Nan
तीर्थयात्रा	hodočašće	Nan
तीर्थ	hodočašće	Nan
तीर	strelica	Nan
तिथि	datum	None
तिब्बत	tibet	Nan
तिरंगा	trobojnica	Nan
तिरंगे	trobojnica	Nan
तिरुपति	tirupati	Nan
तिरुमला	tirumala	Nan
तुमसे	od tebe	Nan
तिल	krtica	Nan
तिल्ली	slezena	Nan
तिवारी	tiwari	Nan
तिहाई	treće	None
तीन	tri	None
तीनो	sva trojica	Nan
तीनों	sva trojica	Nan
तिलक	tilak	Nan
तुमि	ti	None
तुम्हारा	tvojih	Nan
तुम्हारे	tvoj	Nan
तेंडुलकर	tendulkar	Nan
तेंदुलकर	tendulkar	Nan
तेग	teg	Nan
तेज	brzo	None
तेजस्वी	zapanjujuće	Nan
तेज़	brzo	None
ते	te	None
तेज़ी	brzina	None
तेरह	trinaest	Nan
तेरहवीं	trinaesti	Nan
तेरा	tvoj	Nan
तेरी	tvoj	Nan
तेरे	tvoj	Nan
तेल	ulje	Nan
तेजी	brzo	None
तालिका	stol	Nan
तृतीया	tritiya	Nan
तृतीय	treće	None
तुम्हें	za tebe	Nan
तुरंत	odmah	None
तुरन्त	odmah	None
तुर्क	turk	Nan
तुर्की	turska	None
तुलना	poređenje	None
तृतीयक	tercijar	Nan
तुलनात्मक	uporedni	Nan
तुलसीदास	tulsidas	Nan
तुल्य	ekvivalentno	Nan
तू	ti	None
तूने	ti	None
तूफ़ान	oluja	None
तूफान	oluja	None
तुलसी	bosiljak	Nan
तालाब	ribnjak	Nan
तालव्य	ritam	None
तालमेल	sinergija	Nan
तमाम	sve	None
तमिल	tamilski	Nan
तम्बाकू	duhan	None
तय	odlučiti	Nan
तरंग	val	None
तरंगों	talasi	Nan
तभी	samo tada	Nan
तरफ़	na strani	Nan
तरह	ljubazni	Nan
तरहतरह	vrsta	None
तराई	lowland	Nan
तरीके	načini	None
तरीकों	metode	None
तर्क	argument	Nan
तरल	tečnost	None
तर्कसंगत	racionalno	Nan
तबला	tabla	Nan
तपस्या	strogost	Nan
तत्पश्चात्	poslije toga	Nan
तत्व	element	None
तत्वमीमांसा	metafizika	None
तत्वों	elementi	None
तथाकथित	takozvani	None
तथापि	kako god	Nan
तब	onda	None
तथ्य	činjenica	None
तन	telo	Nan
तना	stabljika	Nan
तनाव	tenzija	Nan
तने	stabljika	Nan
तन्त्र	sistem	None
तप	upornost	Nan
तथ्यों	činjenice	None
तत्त्व	element	None
तर्कों	argumenti	Nan
तलवार	mač	None
तानसेन	tansen	Nan
ताप	toplina	Nan
तापक्रम	temperatura	None
तापमान	temperatura	None
ताम्र	bakar	None
तार	žica	Nan
तात्या	tatya	Nan
तारा	zvezda	Nan
तारामंडल	planetarijum	Nan
तारीख	datum	None
तारीख़	datum	None
तारों	ožičenje	Nan
तार्किक	logički	Nan
ताल	ritam	None
ताराभौतिकी	astrofizika	Nan
तल	pod	None
तात्पर्य	značenje	None
ताजा	svježe	Nan
तलाश	pretraživanje	Nan
तव	taw	Nan
तस्वीर	fotografija	None
तस्वीरें	fotografije	None
तस्वीरों	slike	None
तहत	under	Nan
तात्कालिक	improvizirano	Nan
तहसील	tehsil	Nan
तांबे	bakar	None
ताइवान	tajvan	Nan
ताकत	snaga	None
ताकि	tako da	Nan
ताज	kruna	None
ताजमहल	taj mahal	Nan
तांबा	bakar	None
ज़ोर	naglasak	Nan
टेक्नालजी	tehnologija	None
टूटे	slomljeno	Nan
जिसने	ko god	Nan
जिसको	kome	None
जिसके	čiji	None
जिसकी	čiji	None
जिसका	čiji	None
जिस	jis	Nan
जिलों	okrug	None
जिले	okrug	None
जिला	okrug	None
जिम्मेदारी	odgovornost	None
जिम्मेदार	odgovorni	Nan
जिन्होने	szo	Nan
जिन्होंने	szo	Nan
जिन्हें	koga	None
जिन्हे	koga	None
जिन्ना	jinnah	Nan
जिन्दगी	život	None
जावास्क्रिप्ट	javascript	Nan
जाहिर	očigledno	Nan
जिंदगी	život	None
जिक्र	spomenuti	None
जिज्ञासा	radoznalost	Nan
जितना	toliko koliko	Nan
जिसपर	na kojoj	Nan
जितनी	toliko koliko	Nan
जिनका	čiji	None
जिनकी	čiji	None
जिनको	koga	None
जिनमे	u kojem	Nan
जिनमें	u kojem	Nan
जिनसे	od koga	Nan
जिन	gin	Nan
जिसमे	u kojem	Nan
जिसमें	u kojem	Nan
जिससे	s kojim	Nan
जीवन	život	None
जीवनकाल	životni vijek	Nan
जीवनशैली	stil života	Nan
जीवनी	biografija	None
जीवविज्ञान	biologija	None
जीवाणु	bakterije	None
जीवधारियों	živa bića	Nan
जीवाणुओं	bakterije	None
जीविका	sredstva za život	Nan
जीवित	živim	None
जीवों	stvorenja	Nan
जुटाने	podizanje	Nan
जुड़	pridružite se	Nan
जुड़ा	povezano	None
जीवाश्म	fosili	None
जावा	java	None
जीवंत	živahno	Nan
जीमेल	gmail	Nan
जिसे	koga	None
जी	da	None
जीएसएम	gsm	Nan
जीडीपी	bdp	None
जीत	pobijediti	Nan
जीतने	pobedi	Nan
जीव	stvorenja	Nan
जीते	uživo	None
जीना	uživo	None
जीने	živjeti	None
जीनों	geni	Nan
जीनोम	genom	Nan
जीनोमिक	genomski	Nan
जीपीएस	gps	Nan
जीन	jean	None
जाली	skovan	Nan
जालस्थल	veb stranica	Nan
जालपृष्ठ	web stranica	Nan
जाट	jats	Nan
जाड़े	zima	None
जातक	native	Nan
जातकों	domorodci	Nan
जाता	idi	Nan
जाति	uloge	None
जाग्रत	probudi se	Nan
जातियाँ	kaste	Nan
जातियों	kaste	Nan
जाती	caste	Nan
जातीं	ona ide	Nan
जातीय	etnički	None
जाते	idi	Nan
जादुई	čarobno	Nan
जातियां	kaste	Nan
जादूगर	čarobnjak	Nan
जागृति	buđenje	Nan
जागरूकता	svest	Nan
ज़्यादातर	uglavnom	None
जा	idi	Nan
जाँच	istraga	Nan
जांघों	butine	Nan
जांच	inspekcija	Nan
जाए	idi	Nan
जागृत	probudi se	Nan
जाएँ	idi	Nan
जाएंगे	idemo	Nan
जाएगा	idemo	Nan
जाएगी	idemo	Nan
जाओ	idi	Nan
जाकर	odlazeći	Nan
जागरण	buđenje	Nan
जाएं	idi	Nan
जुड़ी	povezano	None
जान	život	None
जानकारियाँ	informacije	None
जापानी	japani	Nan
जाम	džem	Nan
जामा	jama	Nan
जाय	jai	Nan
जाया	jaya	Nan
जाये	idi	Nan
जाप	chant	Nan
जायें	idi	Nan
जायेगा	će ići	Nan
जायेगी	idemo	Nan
जार्ज	george	None
जाल	zamka	Nan
जालंधर	jalandhar	Nan
जालघर	zamka kuća	Nan
जायेंगे	volja	None
जानकर	znajući	Nan
जानेवाले	odlazni	Nan
जानें	naučite	Nan
जानकारियां	informacije	None
जानकारी	informacije	None
जानकी	janaki	Nan
जानता	zna	None
जानती	znaš	Nan
जानते	znaš	Nan
जानेवाली	odlazni	Nan
जानना	znati	None
जानबूझकर	namerno	Nan
जानवर	životinja	None
जानवरों	životinje	None
जाना	idi	Nan
जानी	jani	Nan
जाने	znaš	Nan
जानने	znajući	Nan
टूलकिट	toolkit	Nan
जुड़े	povezano	None
जुडी	judy	Nan
टर्बाइन	turbina	Nan
टर्की	turska	None
टमाटर	rajčice	Nan
टन	tona	Nan
टकसाल	menta	Nan
टकराने	sudar	Nan
ट	t	Nan
ञ	j	Nan
झेलम	jhelum	Nan
झूठे	lažljivci	Nan
झूठ	laž	Nan
झुकाव	nagib	Nan
झुकाया	naklonjen	Nan
झुका	savijen	Nan
झुंड	stado	Nan
झीलों	jezera	None
झीलें	jezera	None
ज्वालामुखी	vulkan	Nan
ज्‍योतिष	astrologija	Nan
झ	jh	Nan
झंडा	zastava	None
झंडे	zastava	None
झंडों	zastave	None
टर्मिनल	terminal	Nan
झटके	drhtavica	Nan
झा	jha	Nan
झाँसी	jhansi	Nan
झांसी	jhansi	Nan
झारखंड	jharkhand	Nan
झींगा	kozice	Nan
झील	jezero	None
झलक	glimpse	Nan
टर्मिनस	terminus	Nan
टांगे	noge	None
टांगों	noge	None
टीकाटिप्पणी	komentar	Nan
टीके	vakcine	Nan
टीकों	vakcine	Nan
टीपू	tipu	None
टीम	tim	None
टीमें	timovi	None
टीकाकरण	vakcinacija	Nan
टीमों	timovi	None
टुकड़े	komadi	Nan
टू	dva	None
टूट	odmor	None
टूटने	slom	None
टूटा	slomljeno	Nan
टूटी	slomljeno	Nan
टीले	mound	Nan
ज्वाला	plamen	None
टीका	vakcinacija	Nan
टिहरी	tehri	Nan
टाइगर	tigar	Nan
टाइप	tip	None
टाइपिंग	kucanje	Nan
टाइम	vreme	None
टाइम्स	vremena	None
टाउन	grad	None
टी	t	Nan
टाटा	ćao	Nan
टापू	ostrvo	None
टाल	izbegavanje	Nan
टिकट	ulaznica	Nan
टिन	tin	Nan
टिप्पणियों	zapažanja	Nan
टिप्पणी	komentiraj	Nan
टाटानगर	tatanagar	Nan
ज्वार	vrućica	Nan
ज्वर	vrućica	Nan
ज्योतिषीय	astrološki	Nan
जैन	jain	Nan
जैनेंद्र	jainendra	Nan
जैनेन्द्र	jainendra	Nan
जैब	jab	Nan
जैबुन्निसा	jabunnisa	Nan
जैव	bio	None
जैतून	maslina	Nan
जैवमण्डल	biosfera	None
जैसा	as	None
जैसी	as	None
जैसे	kao	None
जॉन	john	None
जॉर्ज	george	None
जो	da	None
जैविक	organski	Nan
जोकि	koji je	Nan
जैक्सन	jackson	None
जेसे	kao	None
जुडे	pridružite se	Nan
जुताई	obrada zemlje	Nan
जुमेरह	jumeirah	Nan
जुर्माना	kazna	None
जुलाई	jula	None
जुलाईसितंबर	jula septembra	Nan
जैक	jack	Nan
जुलु	julu	None
जूते	cipele	Nan
जून	juna	None
जूनियर	junior	Nan
जे	j	Nan
जेबेल	jebel	Nan
जेम्स	james	None
जुलूस	povorka	Nan
जुडा	pridružite se	Nan
जोखिम	rizik	None
जोड़	zglob	Nan
ज्ञात	poznat	None
ज्ञाता	znajući	Nan
ज्ञान	znanje	None
ज्ञानपीठ	jnanpith	Nan
ज्ञानविज्ञान	nauka znanja	Nan
ज्ञानामृतम्	gyanamritam	Nan
जौनपुर	jaunpur	Nan
ज्यादा	više	None
ज्यामितीय	geometrijski	None
ज्यों	as	None
ज्योति	svjetlost	None
ज्योतिर्लिङ्ग	jyotirling	Nan
ज्योतिष	astrologija	Nan
ज्योतिषी	astrolog	Nan
ज्यादातर	uglavnom	None
जोडने	dodati	None
जौ	ječam	None
जोशी	joshi	Nan
जोड़कर	dodavanjem	None
जोड़ता	povezuje	None
जोड़ती	povezuje	None
जोड़ते	povežite se	Nan
जोड़ा	par	None
जोड़ी	par	None
जोसेफ	joseph	None
जोड़े	par	None
जोदड़ो	dodati	None
जोधपुर	jodhpur	Nan
जोन	zona	None
जोर	naglasak	Nan
जोरदार	snažna	None
जोश	strast	Nan
जोड़ों	zglobovi	Nan
‎है	je	None
