$	$	Nan
parlamentben	ile igbimọ aṣofin	Nan
parlamenti	ile igbimọ aṣofin	Nan
parlamentáris	ile igbimọ aṣofin	Nan
part	ẹgbẹ	Nan
parti	etikun	Nan
partjai	etikun	Nan
partján	eti okun	Nan
partnere	alabaṣepọ	Nan
partnerei	awọn alabaṣiṣẹpọ	Nan
partnerek	awọn alabaṣiṣẹpọ	Nan
parton	ti ebute	Nan
partra	ti ebute	Nan
partraszállás	ibalẹ	Nan
party	ẹgbẹ	Nan
pascal	pasita	Nan
parlament	ile igbimọ aṣofin	Nan
passzív	palolo	Nan
parkot	gbesile	Nan
parkjai	ogba	Nan
paradicsom	tomati	Nan
paralelogramma	parallelogram	Nan
parancs	pipaṣẹ	Nan
parancsnok	balogun	Nan
parancsnoka	balogun	Nan
parancsnoki	balogun	Nan
parancsot	pipaṣẹ	Nan
parancsára	pipaṣẹ	Nan
parasztok	epa	None
parasztság	elekunre	Nan
parco	parco	Nan
paris	paris	Nan
park	gbesile	Nan
parkban	gbesile	Nan
parker	adugbo	Nan
parkok	ogba	Nan
papírra	iwe	Nan
pata	hoofuu	Nan
pataky	pataky	Nan
perui	ara ilu peruvian	Nan
perzsa	páṣíà	Nan
perzsia	iran	Nan
perzsák	ara ilu pasia	Nan
pest	kokoro	Nan
pesten	budapest	Nan
pesti	kokoro	Nan
pestis	aarun	Nan
pestre	si budapest	Nan
pete	ẹyin	Nan
peter	pétérù	Nan
petőfi	petőfi	Nan
phi	phi	Nan
phil	phil	Nan
philip	philli	Nan
peru	perú	Nan
patak	odò	Nan
persze	dajudaju	Nan
periódusos	tabili	None
patrick	patrick	Nan
paul	poul	Nan
paula	paula	Nan
paulina	paulina	Nan
paulo	paulo	Nan
paunik	paun	Nan
pc	pc	Nan
pearl	parili	Nan
pedig	leteto	Nan
pekingi	beijing	None
per	didi	Nan
perc	iseju	Nan
peremén	eti	Nan
periféria	ẹba	Nan
period	asiko	Nan
perry	ariyanjiyan	Nan
papír	iwe	Nan
papp	papp	Nan
papok	awọn alufa	Nan
oszkár	oscar	None
oszlik	pin	Nan
oszlop	ẹka	Nan
oszlott	pin	Nan
oszmán	osman	Nan
osztható	ifihan	Nan
osztja	mọlẹbi	Nan
osztják	pin	Nan
osztotta	pin	Nan
osztották	pin	Nan
osztrák	ara ilu austrian	Nan
osztrákmagyar	austria ati hungary	Nan
osztrákok	omo ilu osirelia	Nan
osztály	kilasi	Nan
osztályban	kilasi	Nan
ostroma	dóti	Nan
ott	ní	None
ostrom	dotì	Nan
oscardíjat	oscar	None
országokból	awọn orilẹ-ede	Nan
országos	orilẹ-ede	Nan
országot	orilẹ-ede	Nan
országra	orilẹ-ede	Nan
országszerte	jakejado	Nan
országában	orilẹ-ede	Nan
országát	orilẹ-ede	Nan
ortodox	àtijọ	Nan
orvos	dokita	Nan
orvosi	egbogi	Nan
orvosok	onisegun	Nan
orális	ẹnu	Nan
os	baba	Nan
oscar	oscar	None
oscardíj	oscar	None
osiris	osiris	Nan
ottani	ní	None
otthagyta	otilo	Nan
otthon	ni ile	Nan
paleoindiánok	paleo-india	Nan
palesztin	palestini	Nan
palesztina	palestine	Nan
palin	palin	Nan
pallas	pallas	Nan
palota	ààfin	Nan
palotája	ààfin	Nan
paloták	ààfin	Nan
pannon	pannonian	Nan
pannonius	pannonius	Nan
panoráma	panorama	Nan
panthera	panthera	Nan
paolo	paolo	Nan
pap	alufaa	Nan
papi	àlùfáà	Nan
palazzo	palazzo	Nan
palaisztra	palaestra	Nan
pakisztán	pakistan	Nan
pajzsoscankó	ruff	Nan
otthona	ile	Nan
otthoni	ile	Nan
otthont	ile	Nan
otthonában	ile	Nan
otto	otto	Nan
ottó	otto	Nan
our	tiwa	Nan
philipposz	fílípì	Nan
over	lori	Nan
oxford	oxford	Nan
oxigén	atẹgun	Nan
p	p	Nan
pablo	pablo	Nan
pacino	pacino	Nan
paice	paice	Nan
pajzs	asà	Nan
overdose	àṣejù	Nan
phoebe	phoebe	Nan
phoenix	phoenix	Nan
pi	pi	Nan
programja	eto	Nan
programok	awọn eto	Nan
programokat	awọn eto	Nan
programot	eto	Nan
programozási	siseto	Nan
progresszív	onitẹsiwaju	Nan
project	ise agbese	Nan
projekt	ise agbese	Nan
propaganda	ete ti	Nan
propilén	propylene	Nan
prost	tẹriba	Nan
protestáns	alatẹnumọ	Nan
protiszták	awọn alatako	Nan
prága	prague	Nan
prágai	prague	Nan
program	eto	Nan
prágában	prague	Nan
profi	ọjọgbọn	Nan
professzor	ọjọgbọn	Nan
private	ikọkọ	Nan
privát	ikọkọ	Nan
pro	pro	Nan
probléma	iṣoro	Nan
problémái	awọn iṣoro	Nan
problémája	iṣoro	Nan
problémák	awọn iṣoro	Nan
problémákat	awọn iṣoro	Nan
problémákkal	awọn ọran	Nan
problémát	iṣoro	Nan
processzor	ero isise	Nan
producer	aṣelọpọ	Nan
producere	aṣelọpọ	Nan
produceri	awọn iṣelọpọ	Nan
produkció	gbóògì	Nan
professzora	alamọdaju	Nan
próbál	gbidanwo	Nan
próbálja	gbidanwo	Nan
próbálják	gbidanwo	Nan
python	python	Nan
páciens	alaisan	Nan
pál	poul	Nan
pálinka	ọti oyinbo	Nan
pálya	kootu	Nan
pályafutása	rẹ	None
pályafutását	rẹ	None
pályaudvar	ibudo	Nan
pályája	awọn orin	Nan
pályájának	ọnà	Nan
pályáját	rẹ	None
pályán	kootu	Nan
pályára	ọnà	Nan
pályát	ọnà	Nan
páncélos	ihamọra	Nan
px|thumb|a	px | atan | | a	Nan
pusztító	iparun	Nan
pusztán	jo	None
puszta	si igboro	Nan
próbálkozott	gbiyanju	Nan
próbált	gbiyanju	Nan
próbálta	gbiyanju	Nan
próbálták	gbiyanju	Nan
próféta	woli	Nan
prózai	prose	Nan
pszichedelikus	psychedelic	Nan
prince	ọmọ	None
pszichológiai	oroinuokan	Nan
public	gbangba	Nan
publikált	atejade	Nan
publikálta	atejade	Nan
puerto	puerto	Nan
punk	pọnki	Nan
purple	elese	Nan
puskás	ajagun	None
pszichotikus	alamọdaju	Nan
országokban	awọn orilẹ-ede	Nan
primer	jc	Nan
pozíciót	ipo	None
piusz	pius	Nan
pl	apẹẹrẹ	Nan
platón	plato	Nan
plusz	pẹlu	Nan
poe	po	None
pogány	keferi	Nan
pokol	apaadi	Nan
pole	òpó	Nan
polgár	ara ilu	Nan
polgárháború	ogun	None
polgári	ara ilu	Nan
polgármester	arabinrin	Nan
polgárok	ara ilu	Nan
poliszacharid	polysaccharides	Nan
politika	eto imulo	Nan
piton	python	Nan
politikai	oselu	Nan
piszkos	dọti	Nan
piramisok	awọn jibiti	Nan
piac	ọjà	Nan
piaci	ọjà	Nan
piacra	ọjà	Nan
piazza	piazza	Nan
picasso	picasso	Nan
picchu	picchu	Nan
pictures	awọn aworan	Nan
pietro	pietro	Nan
pietà	pieta	Nan
pillanatban	akoko	Nan
pillanatában	akoko	Nan
pilóta	awaoko	Nan
pilóták	awakọ awakọ	Nan
pink	pupa	None
pioneer	aṣáájú-ọ̀nà	Nan
piros	pupa	None
politikailag	iṣelu	Nan
politikus	oloselu	Nan
politikusok	oloselu	Nan
port	lulú	Nan
porta	gbigba	Nan
porto	ifiweranṣẹ	Nan
portré	aworan	Nan
portugál	ilu pọtugali	Nan
portugália	ilu pọtugali	Nan
portál	ọna abawọle	Nan
poszméh	oúnjẹ	None
posztot	awọn ifiweranṣẹ	Nan
posztumusz	posthumous	Nan
potlach	potlatch	Nan
pozitív	rere	None
pozsony	pozsony	Nan
pozsonyban	ni bratislava	Nan
pozsonyi	bratislava	Nan
porosz	prussian	Nan
por	lulú	Nan
populáris	gbajumọ	Nan
populáció	olugbe	Nan
politikája	eto imulo	Nan
politikáját	eto imulo	Nan
politikát	eto imulo	Nan
pompeius	pompey	Nan
pont	ojuami	Nan
ponte	ponte	Nan
pontja	ti	Nan
premier	afihan	Nan
pontjai	awọn aaye	Nan
pontok	awọn aaye	Nan
ponton	pontoon	Nan
pontosabban	diẹ gbọgán	Nan
pontosan	gangan	Nan
pontot	awọn aaye	Nan
ponttal	awọn aaye	Nan
pop	agbejade	Nan
pontján	ojuami	Nan
országok	awọn orilẹ-ede	Nan
országnak	orilẹ-ede	Nan
országház	orilẹ-ede ile	Nan
nálunk	nibi	Nan
nándor	nándor	Nan
nándorfehérvári	belgrade	Nan
nápolyi	nepolitan	Nan
négy	mẹrin	Nan
négyes	mẹrin	Nan
négyszer	merin	None
néha	nigbami	Nan
néhol	ibikan	Nan
néhány	diẹ ninu	Nan
néhányan	diẹ ninu	Nan
nélkül	laisi	Nan
nélküli	laisi	Nan
nélkülözhetetlen	pataki	Nan
némely	diẹ ninu	Nan
náluk	wọn	None
némelyik	diẹ ninu	Nan
nála	rẹ	None
nádor	palatine	Nan
nyugtató	oogun aifọkanbalẹ	Nan
nyár	igba ooru	Nan
nyári	igba ooru	Nan
nyáron	ni igba ooru	Nan
nyílik	ṣii	Nan
nyílt	ṣii	Nan
nyíltan	gbangba	Nan
nyújt	ìfilọ	Nan
nyújtanak	ìfilọ	Nan
nyújtott	pese	Nan
nyújtottak	silẹ	Nan
nyúl	ehoro	Nan
nyúlik	ibaṣepọ	Nan
náci	ara nazi	Nan
nácik	nazis	Nan
nál	ni	Nan
német	jẹmánì	Nan
németek	awọn ara jamani	Nan
németeket	awọn ara jamani	Nan
népi	eniyan	Nan
népies	aṣiwere	Nan
népköztársaság	eniyan eniyan republic	Nan
néppárt	ká	None
néprajz	atọwọdọwọ	Nan
néprajzi	ẹda abinibi	Nan
népszavazás	idapada	Nan
népszerű	gbajumọ	Nan
népszerűek	gbajumọ	Nan
népszerűsége	gbaye-gbale	Nan
népszerűségnek	gbaye-gbale	Nan
népszerűségét	gbaye-gbale	Nan
népszerűvé	gbajumọ	Nan
népszámlálás	ìkànìyàn	Nan
népszámlálási	ìkànìyàn	Nan
népességének	olugbe	Nan
népességnövekedés	idagbasoke	None
népessége	olugbe	Nan
népesség	olugbe	Nan
németh	omo bibi	Nan
németország	jẹmánì	Nan
németországban	ni jámánì	Nan
németországgal	awọn ipinlẹ jamani	Nan
németországi	jẹmánì	Nan
németországnak	jẹmánì	Nan
németrómai	ara ilu roman ara jamani	Nan
nyugszik	sinmi	Nan
németül	ni jẹmánì	Nan
némileg	fẹẹrẹ	Nan
néni	arabinrin	Nan
nép	eniyan	Nan
népcsoport	ẹgbẹ ẹya	Nan
népcsoportok	olugbe	Nan
népe	eniyan	Nan
népek	awọn eniyan	Nan
némi	diẹ ninu	Nan
népsűrűség	iwuwo olugbe	Nan
nyugodt	tunu	Nan
nyugatra	iwọ oorun	Nan
nyelvjárások	awọn iledìí	Nan
nyelvnek	ede	None
nyelvre	ede	None
nyelvvel	ahọn	Nan
nyelvén	ede	None
nyelvű	nsoro	Nan
nyer	ṣẹgun	Nan
nyeri	aamieye	Nan
nyerni	ṣẹgun	Nan
nyers	aise	Nan
nyersanyagok	awọn ohun elo aise	Nan
nyert	bori	Nan
nyerte	bori	Nan
nyertek	bori	Nan
nyerték	bori	Nan
nyelvjárás	iledìí	Nan
nyilatkozat	alaye	Nan
nyelvi	ede	None
nyelvet	ede	None
novemberben	ni oṣu kọkanla	Nan
now	bayi	None
nr	n	Nan
nukleáris	iparun	Nan
nulla	odo	Nan
ny	ìè	Nan
nyak	ọrùn	Nan
nyelv	ede	None
nyelvben	ede	None
nyelvcsalád	ede	None
nyelve	ede	None
nyelvek	ede	None
nyelvekben	ede	None
nyelveket	ede	None
nyelven	gẹẹsi	Nan
nyelvhez	ede	None
nyilatkozata	alaye	Nan
nyilatkozott	ṣalaye	Nan
nyilatkozta	pé	None
nyomozás	iwadii	Nan
nyomozó	otelemuye	Nan
nyomtatott	tejede	Nan
nyomtatás	titẹ sita	Nan
nyomtatásban	tẹjade	Nan
nyomában	ẹsẹ	None
nyomán	tẹle	Nan
nyomás	titẹ	Nan
nyomására	titẹ lati	Nan
nyugalomra	alafia	Nan
nyugat	oorun	Nan
nyugateurópa	oorun yuroopu	Nan
nyugateurópai	ara ilu yuroopu	Nan
nyugati	oorun	Nan
nyugaton	iwọ oorun	Nan
nyomon	tẹle	Nan
nyomda	tẹ	Nan
nyomait	wa	Nan
nyoma	kakiri	None
nyilván	o han ni	Nan
nyilvános	gbangba	Nan
nyilvánosan	gbangba	Nan
nyilvánosság	gbangba	Nan
nyilvánosságra	atejade	Nan
nyilvánvaló	kedere	Nan
nyilvánvalóan	o han ni	Nan
nyugatról	ìwọ oòrùn	Nan
nyilvánvalóvá	ko	None
nyilvánították	ṣalaye	Nan
nyitott	ṣii	Nan
nyitva	ṣii	Nan
nyolc	mẹjọ	Nan
nyolcaddöntő	ipari kẹjọ	Nan
nyolcadik	ikẹjọ	Nan
nyolcvanas	eighties	Nan
nyilvánította	ṣalaye	Nan
pánik	ẹrù	Nan
népvándorlás	ijira	Nan
név	orukọ	Nan
olimpiai	olimpiiki	Nan
olimpián	olimpiiki	Nan
olimpiát	olimpiiki	Nan
oliver	ẹṣọ	Nan
oltás	ajesara	Nan
olvadt	didan	Nan
olvasható	ṣeékà	Nan
olvasni	ka	Nan
olvasott	ka	Nan
olvasta	ka	Nan
olvasó	kika	Nan
olvasók	mo nkawe	Nan
oly	nipasẹ	Nan
olyan	nitorinaa	Nan
olyannyira	insomuch	Nan
olimpia	olimiad	Nan
olyanok	jẹ	Nan
olga	olga	Nan
oldalát	awọn ẹgbẹ	Nan
olaszországban	ilu italia	Nan
olaszországi	ilu italia	Nan
olaszul	ni italia	Nan
olcsó	olowo poku	Nan
oldal	ẹgbẹ	Nan
oldala	ẹgbẹ	Nan
oldalain	awọn ẹgbẹ	Nan
oldalak	awọn oju-iwe	Nan
oldali	ni ọtun	Nan
oldalon	oju iwe	Nan
oldalra	si apa	Nan
oldalról	lati ẹgbẹ	Nan
oldalt	awọn ọna ẹgbẹ	Nan
oldalán	awọn ẹgbẹ	Nan
oldalára	aaye ayelujara	Nan
oldat	ojutu	Nan
olykor	nigbami	Nan
one	tirẹ	Nan
oneil	ọkanil	Nan
oroszország	rọ́ṣíà	Nan
oroszországban	rọ́ṣíà	Nan
oroszországból	rísia	Nan
oroszországi	rọ́ṣíà	Nan
orrvérzés	imu ẹjẹ	Nan
orsolya	orsolya	Nan
ország	orilẹ-ede	Nan
országa	orilẹ-ede	Nan
országai	awọn orilẹ-ede	Nan
országba	orilẹ-ede	Nan
országban	orilẹ-ede	Nan
országból	orilẹ-ede	Nan
országgyűlés	ile igbimọ aṣofin	Nan
országgyűlésen	ounje	Nan
országgyűlési	ile igbimọ aṣofin	Nan
oroszok	ara ilu rọ́ṣíà	Nan
oroszlánok	awọn kiniun	Nan
oroszlán	kiniun	Nan
orosz	ara ilu rọsia	Nan
onnan	ibẹ	Nan
open	ṣii	Nan
openen	ṣi,	Nan
opera	opera	Nan
operaház	opera ile	Nan
operációs	ṣiṣiṣẹ	Nan
operái	ṣiṣẹ	Nan
olaszország	ilu italia	Nan
operája	opera	Nan
operáját	opera	Nan
operát	opera	Nan
optikai	opitika	Nan
opus	opus	Nan
oratórium	oratorio	Nan
orbán	orbán	Nan
orlando	orlando	Nan
operájának	opera	Nan
népzene	orin awọn eniyan	Nan
olaszok	awọn ara italia	Nan
olaj	epo	Nan
növekedési	idagba	Nan
növekedésével	posi	Nan
növekszik	posi	Nan
növekvő	ndagba	Nan
növeli	pọ si	Nan
növelik	pọ si	Nan
növelte	pọ si	Nan
növelése	npo si	Nan
növény	ohun ọgbin	Nan
növények	eweko	Nan
növényi	ewebe	Nan
növényzet	ewéko	Nan
nő	obinrin	Nan
nőgyógyászati	ẹkọ ẹla	Nan
női	obinrin	Nan
növekedése	idagba	Nan
nők	obinrin	Nan
növekedés	idagba	Nan
nóra	nóra	Nan
névelő	nkan	None
néven	bi	Nan
névmás	faṣẹ orúkọ	Nan
névre	ti a npè ni	Nan
névtelen	ailorukọ	Nan
névvel	orukọ	Nan
néz	wo	Nan
nézet	iwo	Nan
nézetei	awọn iwo	Nan
nézeteit	awọn iwo	Nan
nézetek	awọn iwo	Nan
nézve	fun	None
néző	oluwo	Nan
nézők	awọn oluwo	Nan
nílus	nile	Nan
növekedett	dagba	Nan
nőket	obinrin	Nan
nőnek	dagba	Nan
nőstény	obinrin	Nan
okozhat	fa	Nan
okoznak	fa	Nan
okozott	ṣẹlẹ	Nan
okozta	ṣẹlẹ	Nan
okoztak	ṣẹlẹ	Nan
okozva	nfa	Nan
okozza	awọn okunfa	Nan
okozzák	fa	Nan
okozó	ifẹsẹmulẹ	Nan
oktatás	eko	None
oktatási	eko	None
október	oṣu kẹwa	Nan
októberben	ni oṣu kẹwa	Nan
okán	nipa idi ti	Nan
okát	fa	Nan
okoz	fa	Nan
okot	fa	Nan
okokból	awọn idi	Nan
okok	awọn idi	Nan
nőt	obinrin	Nan
nőtt	dagba	Nan
nőtte	o ti dagba	Nan
nővére	rẹ	None
obama	oba	None
objektum	nnkan	Nan
objektumok	nkan	None
olasz	ilu italia	Nan
oceanic	òkun	Nan
odaát	nibe	None
odáig	titi si asiko yi	Nan
odüsszeusz	odysseus	Nan
ok	o dara	Nan
oka	idi	Nan
okai	awọn okunfa	Nan
okból	lati	Nan
oda	ní	None
pápa	pope	Nan
pápai	papal	Nan
pápát	pọọlu	Nan
seregek	ogun	None
sereget	ogun	None
seregét	rẹ	None
seregével	ogun	None
serkentő	safikun	Nan
sertésinfluenza	elede	None
service	iṣẹ	Nan
shakespeare	sekisipia	Nan
sherlock	sherlock	Nan
shore	eti okun	Nan
si	siki	Nan
side	ẹgbẹ	Nan
sierra	sierra	Nan
siker	aṣeyọri	Nan
sikere	aṣeyọri	Nan
seregei	ogun	None
sikerei	awọn aṣeyọri	Nan
serege	ogun	None
senna	senna	Nan
segítségével	egba	None
segítő	oluranlọwọ	Nan
sehol	besi	Nan
sejt	sẹẹli	Nan
sejtek	sẹẹli	Nan
select	yan	None
selejtező	oye	Nan
sem	bẹni	Nan
semleges	didoju	Nan
semmelweis	semmelweis	Nan
semmi	ohunkohun	Nan
semmiféle	rárá	Nan
semmilyen	rárá	Nan
semmit	ohunkohun	Nan
senki	kankan	None
sereg	igboya	Nan
sikerek	awọn aṣeyọri	Nan
sikereket	aṣeyọri	Nan
sikeres	aṣeyọri	Nan
smith	smith	Nan
society	awujọ	Nan
soha	rara	Nan
sohasem	rara	Nan
sok	lọpọlọpọ	Nan
sokak	lọpọlọpọ	Nan
sokan	lọpọlọpọ	Nan
sokat	pupo	Nan
sokféle	iyatọ	Nan
sokkal	pọ	Nan
sokoldalú	wapọ	Nan
sokszor	nigbagbogbo	Nan
sokszínű	ọpọlọpọ-pupọ	Nan
sokáig	gun	None
somogyi	somogy	Nan
skót	scotsman	Nan
skócia	ilu scotland	Nan
skizofrénia	schizophrenia	Nan
skandináv	scandinavian	Nan
sikeresen	ni ifijišẹ	Nan
sikerrel	aṣeyọri	Nan
sikert	aṣeyọri	Nan
sikertelen	aṣeyọri	Nan
sikertelenül	laiṣeeṣe	Nan
sikerét	aṣeyọri	Nan
sikerül	ṣaṣeyọri	Nan
segítségét	egba	None
sikerült	ṣaṣeyọri	Nan
sima	dan	Nan
simabálnák	awọn ẹja nla	Nan
simon	simoni	Nan
sin	oju irin	Nan
sincs	rárá	Nan
singer	akorin	Nan
sir	sir	Nan
sikerű	aṣeyọri	Nan
son	ọmọ	None
segítségére	egba	None
segítség	egba	None
rövidítése	dúró	None
s	s	Nan
saint	mimọ	Nan
sajnos	laanu	Nan
sajtó	tẹ	Nan
saját	tirẹ	Nan
sajátos	ni pataki	Nan
sajátossága	awọn iyasọtọ	Nan
sakk	chess	Nan
sakk-matt	chess ẹni	Nan
salamon	solomoni	Nan
salvador	salvador	Nan
salzburg	salzburg	Nan
salzburgi	salzburg	Nan
sam	sam	Nan
rövidesen	laipẹ	Nan
samu	gba	None
röviden	kukuru	Nan
röviddel	laipẹ	Nan
róluk	nipa akoko	Nan
róma	lomu	Nan
rómaiak	róòmù	Nan
rómeó	romeo	Nan
rómába	romeò	Nan
rómában	lomu	Nan
rómát	lomu	Nan
róza	dide	Nan
rózsa	dide	Nan
rózsaszín	pupa	None
rögtön	lẹsẹkẹsẹ	Nan
rögzített	ti o wa titi	Nan
rögzítette	ti o gbasilẹ	Nan
rögzítették	ti o gbasilẹ	Nan
rövid	kukuru	Nan
rövidebb	kikuru	Nan
samuel	sámúẹ́lì	Nan
san	san	Nan
sant	sant	Nan
se	bẹni	Nan
sean	ifa	Nan
sebastian	sebastian	Nan
sebesség	iyara	Nan
sebessége	iyara	Nan
sebességgel	iyara	Nan
sebességét	iyara	Nan
sebestyén	sebestyén	Nan
see	wo	Nan
segíteni	lati ṣe iranlọwọ	Nan
segített	iranwo	Nan
segítette	iranwo	Nan
segíti	iranlọwọ	Nan
segítik	egba	None
segítsen	ran mi lowo	Nan
scott	scott	Nan
scorsese	scorsese	Nan
scooter	ofofo	Nan
scifi	scifi	Nan
santa	arọ	None
santiago	santiago	Nan
sarah	sarah	Nan
sarki	pola	Nan
sarolta	sarolta	Nan
sas	idì	Nan
sata	sata	Nan
segítséget	egba	None
saturn	saturn	Nan
schengeni	schengen	Nan
schiller	schiller	Nan
schneider	oloye	None
school	ile-iwe	Nan
schumacher	schumacher	Nan
schwartz	schwartz	Nan
science	sayensi	Nan
savaria	ilu savaria	Nan
róla	rẹ	None
sopron	sopron	Nan
sor	kana	Nan
szabadkőművesség	masque	Nan
szabadon	ọfẹ	Nan
szabadság	ominira	Nan
szabadságharc	ogun	None
szabadságot	ominira	Nan
szabadságát	ominira	Nan
szabadtéri	ita gbangba	Nan
szabolcs	szabolcs	Nan
szabvány	boṣewa	Nan
szabály	ṣàkóso	Nan
szabályai	ipo	None
szabályok	ofin	None
szabályokat	ofin	None
szabályos	deede	Nan
szabályozás	ilana	None
szabadkőműves	freemasoni	Nan
szabó	telo	Nan
szabadka	subotica	Nan
szabad	ọfẹ	Nan
stílusát	ara	Nan
stílusú	ara	Nan
stúdió	ile isise	Nan
stúdióban	ile isise	Nan
sugár	tan	Nan
sugárzás	itusilẹ	Nan
sulinet	epo oyinbo	Nan
sun	hedgehog	Nan
surányi	surányi	Nan
susan	susan	Nan
svájc	switzerland	Nan
svájcban	switzerland	Nan
svájci	switzerland	Nan
svéd	ara ilu sweden	Nan
svédország	sweden	Nan
szabadidő	fàájì	Nan
szakadt	ya	Nan
szakasz	platoon	Nan
szakasza	apakan	Nan
szarvasmarha	ẹran	Nan
szaturnusz	saturn	Nan
szavai	rẹ	None
szavak	awọn ọrọ	Nan
szavakat	awọn ọrọ	Nan
szavakkal	awọn ọrọ	Nan
szavazatok	ibo	Nan
szavazás	dibo	Nan
szcientológia	ijinle sayensi	Nan
szecesszió	ipinya	Nan
szecessziós	art nouveau	Nan
szeged	szeged	Nan
szegeden	cruz	Nan
szegedi	lati szeged	Nan
szegfű	gbigbe	Nan
szarvas	agbọnrin	Nan
szarkofág	ẹṣẹ	Nan
szapolyai	szapolyai	Nan
szanszkrit	sanskrit	Nan
szakaszban	apakan	Nan
szakaszok	awọn apakan	Nan
szakaszon	apakan	Nan
szakaszt	apakan	Nan
szakaszában	alakoso	Nan
szakaszát	apakan	Nan
szakemberek	awọn akosemose	Nan
stílust	ara	Nan
szakirodalom	litireso ọjọgbọn	Nan
szakkád	wadi	Nan
szakképző	idanileko	Nan
szakközépiskola	ile-ẹkọ sẹkọndiri	Nan
szakmai	ọjọgbọn	Nan
szakértők	awọn amoye	Nan
szakított	bu	None
szalai	szalai	Nan
szakiskola	ile-iwe osise	Nan
soproni	sopron	Nan
stílusok	awọn aza	Nan
stílusa	ara	Nan
sorrendben	ni eto	Nan
sors	ayanmọ	Nan
sorsa	awọn ayanmọ	Nan
sorsát	ipo	None
során	ninu	Nan
sorát	kana	Nan
sosem	rara	Nan
south	guusu	None
space	aaye	Nan
spanyol	ede	None
spanyolok	ede	None
spanyolország	ilu sibeeni	Nan
spanyolországban	ilu sibeeni	Nan
spanyolul	ede	None
spd	spd	Nan
sorrend	ọkọọkan	Nan
speciális	pataki	Nan
sorra	kana	Nan
sorozatot	jara	Nan
sora	kana	Nan
sorba	ni tito	Nan
sorban	kana	Nan
sorok	ori	None
sorolható	classifiable	Nan
sorolják	classified	Nan
soron	kana	Nan
soros	tẹlentẹle	Nan
sorozat	jara	Nan
sorozata	jara	Nan
sorozatban	jara	Nan
sorozatból	jara	Nan
sorozatnak	jara	Nan
sorozatok	jara	Nan
sorozatos	tẹlentẹle	Nan
sorozatát	jara	Nan
spencer	jaketi idotin	Nan
spontán	lẹẹkọkan	Nan
sport	eré ìdárayá	Nan
steve	steve	Nan
steven	steven	Nan
stewart	stewart	Nan
stone	okuta	Nan
stonehenge	stonehenge	Nan
stones	okuta	Nan
stratégiai	ilana	None
street	opopona	Nan
stressz	aapọn	Nan
struktúra	be	Nan
stuart	aṣaju	Nan
studio	ile isise	Nan
stuttgart	stuttgart	Nan
stáb	atuko	Nan
stílus	ara	Nan
stephen	alairi	Nan
stb	abbl.	Nan
statisztikák	eeka	Nan
statisztikai	eeka	Nan
sportok	eré ìdárayá	Nan
sportolók	elere idaraya	Nan
sportág	eré ìdárayá	Nan
spártai	spartan	Nan
sql	sql	Nan
ss	s	Nan
st	st.	Nan
stílusban	ara	Nan
stabil	iduroṣinṣin	Nan
stadionban	papa-iṣere	Nan
stallone	stallone	Nan
stan	onidan	Nan
standard	boṣewa	Nan
stanley	ìlù	Nan
star	irawo	Nan
start	bẹrẹ	Nan
stadion	papa-iṣere	Nan
november	oṣu kọkanla	Nan
ról	nipa	Nan
róbert	robert	Nan
remix	remix	Nan
remény	ireti	Nan
renault	renault	Nan
rend	paṣẹ	Nan
rendbe	ni ọtun	Nan
rendben	o dara	Nan
rendek	awọn ohun-ini	Nan
rendelet	aṣẹ	Nan
rendelkezett	ní	None
rendelkezik	ní	None
rendelkeznek	ni	Nan
rendelkeztek	ní	None
rendelkezések	awọn ipese	Nan
rendelkezésre	ni ife	Nan
rendelkező	pẹlu	Nan
remek	nla	Nan
rendelt	paṣẹ	Nan
rembrandt	rembrandt	Nan
relativitáselmélet	yiyamọ ti ibaramu	Nan
regisztrált	forukọsilẹ	Nan
regény	aramada	Nan
regényben	itan-akọọlẹ	Nan
regénye	aramada	Nan
regényei	iwe	Nan
regények	iwe	Nan
regényt	aramada	Nan
regényének	aramada	Nan
reise	reise	Nan
rejtett	farapamọ	Nan
rejtély	ohun ijinlẹ	Nan
rejtélyes	aramada	Nan
rekord	igbasilẹ	Nan
rekordok	awọn igbasilẹ	Nan
rekordot	igbasilẹ	Nan
relatív	ibatan	Nan
rendelte	paṣẹ	Nan
rendes	deede	Nan
rendesen	afinju	Nan
rendszer	eto	Nan
rendszerbe	eto	Nan
rendszerben	eto	Nan
rendszere	eto	Nan
rendszerek	awọn ọna šiše	Nan
rendszeres	eto eto	Nan
rendszeresen	nigbagbogbo	Nan
rendszerint	nigbagbogbo	Nan
rendszerrel	eto	Nan
rendszert	eto	Nan
rendszerváltás	ijọba	Nan
rendszerét	eto	Nan
rendszerű	eto	Nan
rendőr	ọlọpa	Nan
rendőri	ọlọpa	Nan
rendre	leralera	Nan
rendkívüli	extraordinary	Nan
rendkívül	àṣejù	Nan
rendje	eto imulo	Nan
rendet	eto imulo	Nan
rendezett	lẹsẹsẹ	Nan
rendeznek	wa ni waye	Nan
rendezni	lati berefun	Nan
rendezte	dari	Nan
rendeztek	ṣeto	Nan
rendezték	ṣeto	Nan
regionális	agbegbe	Nan
rendezvény	ìṣẹlẹ	Nan
rendezése	pinpin okun	Nan
rendezésében	too ti	Nan
rendező	oludari	Nan
rendezője	oludari	Nan
rendfokozatok	ipo	None
rendhagyó	alaibamu	Nan
rendi	eto imulo	Nan
rendezvények	iṣẹlẹ	Nan
rendőrség	ọlọpa	Nan
regina	regina	Nan
reggel	owurọ	Nan
példák	awọn apẹẹrẹ	Nan
például	fun	None
pénz	owo	Nan
pénzt	owo	Nan
pénzügyi	owo	Nan
péter	pétérù	Nan
pók	alantakun	Nan
pókok	awọn alamọrin	Nan
püspök	bishop	Nan
püspöki	episcopal	Nan
q	q	Nan
r	r	Nan
ra	sí	Nan
rabszolgák	ẹrú	Nan
rachel	aṣọ awọleke	Nan
példája	apẹẹrẹ	Nan
racionális	onipin	None
példa	apẹẹrẹ	Nan
pécsett	awọn ẹgbẹ	Nan
pár	ìpínrọ̀	Nan
páratlan	tí a kò ṣàfiwé	Nan
párhuzamos	pọgba	Nan
párhuzamosan	pọgba	Nan
párizs	paris	Nan
párizsba	paris	Nan
párizsban	paris	Nan
párizsi	parisi	Nan
páros	ani	Nan
párt	ẹgbẹ	Nan
pártja	rẹ	None
pártok	awọn ẹgbẹ	Nan
pártot	ẹgbẹ	Nan
pásztor	oluṣọ-agutan	Nan
pécs	awọn sẹẹli	Nan
pécsi	awọn ẹgbẹ	Nan
radikális	ti ipilẹṣẹ	Nan
radio	redio	Nan
radioaktív	ohun ipanilara	Nan
raúl	raúl	Nan
re	lati	Nan
reakció	ifura	Nan
reaktor	riakito	Nan
real	gidi	Nan
realista	onigbagbo	Nan
realizmus	otito	Nan
records	awọn igbasilẹ	Nan
reform	atunṣe	Nan
reformkor	atunṣe era	Nan
reformok	awọn atunṣe	Nan
reformokat	awọn atunṣe	Nan
reformáció	atunformatione	Nan
református	tun ṣe atunṣe	Nan
reggae	reggae	None
ray	eegun	Nan
rangú	ipo	None
rangra	ipo	None
rangot	ipo	None
radnóti	radnóti	Nan
rafael	rafaeli	Nan
ragadozók	aperanje	Nan
ragaszkodott	ti kuna	Nan
raid	igbogun ti	Nan
rajna	rhine	Nan
rajongó	àìpẹ	Nan
reggeli	ounjẹ aarọ	Nan
rajongói	àìpẹ	Nan
rajta	loju	Nan
rajtnál	ila	Nan
rajtuk	wọn	None
rajza	yiya	Nan
rakéta	misaili	Nan
rammstein	rammstein	Nan
randy	olufẹ	Nan
rajongók	egeb onijakidijagan	Nan
róka	kọlọkọ	Nan
rendőrségi	ọlọpa	Nan
reneszánsz	renesansi	Nan
ránk	lori wa	Nan
ráta	oṣuwọn	Nan
rázza	gbọn	Nan
räikkönen	raikkonen	Nan
régebben	tẹlẹ	Nan
régebbi	agbalagba	Nan
régen	igba pipẹ seyin	Nan
régi	atijọ	Nan
régió	ẹkùn	Nan
régióban	ẹkùn	Nan
régiók	awọn ẹkun ni	Nan
régészeti	igba atijọ	Nan
régóta	tipẹ	Nan
rész	apakan	Nan
részben	apakan	Nan
rákóczi	rákóczi	Nan
részből	awọn ẹya	Nan
rákosi	ọdan	Nan
rájött	ṣẹ	Nan
royal	ọba	Nan
rss	rp	Nan
rt	rt	Nan
rtl	rtl	Nan
rudolf	rudolf	Nan
rukia	rukia	Nan
russell	rùn	Nan
ruténium	ruthenium	Nan
rá	rẹ	None
ráadásul	pẹlupẹlu	Nan
rába	raba	Nan
rádió	redio	Nan
rádióban	redio	Nan
rájuk	wọn	None
rájön	ṣewadi	Nan
rák	akàn	Nan
része	apakan ti	Nan
részecskék	patikulu	Nan
részei	awọn ẹya	Nan
részvételével	ikopa	Nan
részében	apakan	Nan
részén	apakan	Nan
részének	apakan	Nan
részére	fun	None
részéről	fun	None
részét	apakan	Nan
részével	apakan	Nan
részévé	apakan	Nan
részük	wọn	None
réteg	ipele	None
rétege	fẹlẹfẹlẹ	Nan
rétegek	fẹlẹfẹlẹ	Nan
révén	nipasẹ	Nan
réz	bàbà	Nan
részvétel	ikopa	Nan
résztvevők	olukopa	Nan
résztvevője	alabaṣe	Nan
résztvevő	alabaṣe	Nan
részein	awọn ẹya	Nan
részeit	awọn ẹya	Nan
részek	awọn ẹya	Nan
részeken	awọn ẹya	Nan
részeket	awọn ẹya	Nan
részeként	gẹgẹ bi ara ti	Nan
részen	apakan	Nan
roxfort	hogwarts	Nan
részes	ẹgbẹ	Nan
részlet	alaye	Nan
részletek	awọn alaye	Nan
részletes	alaye	Nan
részletesen	ni apejuwe	Nan
részre	awọn ẹya	Nan
részről	apakan	Nan
részt	apakan	Nan
részleges	apa	Nan
rendőrök	awọn ọlọpa	Nan
rowling	rowling	Nan
rovás	ṣiṣe	Nan
rihanna	rihanna	Nan
ring	òrùka	Nan
rio	rio	Nan
rita	rita	Nan
ritka	ṣọwọn	Nan
ritkábban	kere nigbagbogbo	Nan
ritkák	ṣọwọn	Nan
ritkán	ṣọwọn	Nan
rituális	irubo	Nan
rivális	orogun	Nan
rizs	iresi	Nan
rob	jale	Nan
robbant	gbuuru	Nan
robbanás	bugbamu	Nan
robert	robert	Nan
right|thumb|px|a	ọtun | atanpako | px | awọn	Nan
roberto	roberto	Nan
richárd	ọlọrọ̀	Nan
richards	richards	Nan
rengeteg	ọpọlọpọ ti	Nan
rené	rené	Nan
reológia	rheology	Nan
republikánus	oloṣelu ijọba olominira	Nan
repülés	ọkọ ofurufu	Nan
repülő	fò	Nan
repülőgép	ọkọ ofurufu	Nan
repülőtere	papa	None
repülőterek	papa	None
repülőtér	papa	None
return	padà	Nan
rex	rex	Nan
rezonancia	resonance	Nan
ricardo	ricardo	Nan
richard	richard	None
richterskála	iwọn titobi ọlọla	Nan
robin	robin	Nan
rocky	rocky	Nan
rod	ọpá	Nan
romániai	romania	Nan
romániában	romania	Nan
románok	awọn ara ilu romania	Nan
románul	ni romania	Nan
ron	ron	Nan
ronaldo	ronaldo	Nan
roosevelt	roosevelt	Nan
rory	rory	Nan
rosberg	rosberg	Nan
ross	rosa	Nan
rossz	buburu	Nan
rosszindulatú	irira	Nan
rosszul	ibi	Nan
rourke	rourke	Nan
rousseau	rousseau	Nan
románia	romania	Nan
román	romania	Nan
romák	róòmù	Nan
rommel	rommeli	Nan
roger	roger	Nan
rohamosan	apace	Nan
rokon	ibatan	Nan
rokona	awọn ibatan	Nan
rokonai	awọn ibatan	Nan
rokonságban	ti o ni ibatan	Nan
roland	roland	Nan
rovásírás	rovásírás	Nan
roll	yipo	Nan
rom	iparun	Nan
roma	lomu	Nan
romantika	ifẹ-ifẹ	Nan
romantikus	ti alefi ife han	Nan
romeo	romeo	Nan
romjai	awọn dabaru	Nan
romlott	ṣe yẹyẹ	Nan
rolling	yiyi	Nan
szegény	talaka	None
novellák	awọn itan kukuru	Nan
nova	ko	None
matematikus	oniṣiro-ọrọ	Nan
matt	matte pari	Nan
max	sókè	Nan
maximum	o pọju	Nan
maximális	o pọju	Nan
may	le	None
mccartney	mccartney	Nan
mclaren	mclaren	Nan
mdp	mdp	Nan
me	emi	Nan
meccs	baramu	Nan
meccsen	eré	Nan
meccset	ja	Nan
mechanikai	darí	Nan
mechanikus	darí	Nan
matematikai	iṣiro	Nan
medici	medici	Nan
matematika	mathimatiki	None
massa	massa	Nan
marley	marley	Nan
marokkó	ilu morocco	Nan
maros	tirgu	Nan
marosvásárhely	marosvásárhely	Nan
marosvásárhelyen	targu mures	Nan
marosvásárhelyi	tirgu mures	Nan
mars	maasi	Nan
marsall	marshal	Nan
marsh	mars	None
martin	martin	Nan
marx	marxism	Nan
marxista	marxist	Nan
mary	mary	Nan
maría	amí	Nan
mason	mason	Nan
master	ọga	Nan
marketing	titaja	Nan
medicina	òògùn	Nan
medián	agbedemeji	Nan
megegyeznek	gba	None
megegyező	ikan	None
megelőzte	niwaju	None
megelőzve	niwaju	None
megelőző	prophylactic	Nan
megelőzően	ṣaaju	Nan
megengedett	gba	None
megerősített	ni okun	Nan
megerősítette	timo	Nan
megerősítették	timo	Nan
megfelel	ibamu	Nan
megfelelő	ni ọtun	Nan
megfelelően	bojumu	Nan
megfelelője	ẹlẹgbẹ	Nan
megfigyelhető	ṣe alaye	Nan
megegyezik	gba	None
mediterrán	mẹditarenia	Nan
megegyezett	gba	None
megbízást	igbimọ	Nan
medve	jẹri	Nan
medveállatkák	tardigrades	Nan
meg	ati	Nan
megadott	fifun	Nan
megakadályozni	ṣe idiwọ	Nan
megakadályozta	idilọwọ	Nan
megalakult	ibiyi	Nan
megalakulása	ipile	Nan
megalapította	ipilẹ	Nan
megalapították	ipilẹ	Nan
megalkotta	ṣẹda	Nan
megbetegedett	aisan	Nan
megbukott	kuna	Nan
megbízható	gbẹkẹle	Nan
megbízott	amọdaju	Nan
megbízásából	fifun ni	Nan
mark	samisi	Nan
mario	mario	Nan
marie	ọkọ	Nan
magyarázata	se alaye	Nan
magyarázatot	alaye	Nan
magyarázható	explicable	Nan
magyarázzák	se alaye	Nan
magzat	ọmọ	None
magába	to	None
magában	o ni	Nan
magához	iho	Nan
magán	ikọkọ	Nan
magának	iho	Nan
magánhangzók	àwọn ẹ̀jẹ́	Nan
magányos	dawa	Nan
magánélete	ikọkọ ikọkọ	Nan
magára	iho	Nan
magáról	iho	Nan
magyarázat	alaye	Nan
magát	iwo	Nan
magyarul	ede	None
magyarországért	họnari	Nan
magukat	iwo	Nan
magukkal	wọn	None
maguknak	awọn funrararẹ	Nan
magukra	awọn funrararẹ	Nan
magvető	irugbin	Nan
magyar	ara ilu hungary	Nan
magyarok	ara ilu hungaria	Nan
magyarokat	ara ilu hungaria	Nan
magyarország	họnari	Nan
magyarországi	ara ilu hungary	Nan
magyarországnak	onigun	Nan
magyarországon	ni ilu họnda	Nan
magyarországot	onigun	Nan
magyarországra	to	None
magyarországról	lati hungary	Nan
magyarság	ara ilu hungaria	Nan
magától	funrararẹ	Nan
magával	pẹlú	Nan
mai	igbalode	Nan
maradjon	dúró	None
maradnak	dúró	None
maradni	dúró	None
maradt	osi	Nan
maradtak	ṣẹku	Nan
maradványai	ku	None
maradványait	ku	None
maradék	isimi na	Nan
marcell	makiro	Nan
marco	ọkọ ofurufu	Nan
marcus	ayase	Nan
margaret	ẹla	Nan
margit	margaret	Nan
mari	mari	Nan
maria	arabinrin	Nan
maradandó	ailagbara	Nan
marad	dúró	None
manuel	manuel	Nan
manson	manson	Nan
main	loni	Nan
maja	maya	None
majd	lẹhinna	Nan
majdnem	fẹẹrẹ	Nan
makedón	makedonia	None
makedónok	makedonia	None
malcolm	ibi	Nan
megfigyelése	wíwo	Nan
malfoy	malfoy	Nan
maláj	ede	None
malária	aisan	Nan
manapság	lasiko	Nan
manchester	ilu manchester	Nan
manga	manga	Nan
mann	mánà	Nan
mansell	mansell	Nan
malthusianizmus	malthusianism	Nan
megfigyelések	awọn akiyesi	Nan
megfigyelő	oluwo	Nan
megfogalmazott	gbekale	Nan
megtagadta	kọ	Nan
megtalálható	le	None
megtalálhatók	ri	Nan
megtalálni	lati wa	Nan
megtalálta	ri	Nan
megtalálták	ri	Nan
megtartotta	ni idaduro	Nan
megtartották	ni idaduro	Nan
megteremtése	ṣiṣẹda	Nan
megtett	ajo	None
megtiltotta	kọsilẹ	Nan
megtudja	ṣewadi	Nan
megtámadta	kọlu	Nan
megtámadták	wọn	None
megtörtént	ṣẹlẹ	Nan
megsérült	farapa	Nan
megvalósítani	lati mọ	Nan
megsértése	irufin	Nan
megszűnt	imukuro	Nan
megszerezni	lati mu	Nan
megszerezte	mina	Nan
megszerzett	ipasẹ	Nan
megszerzése	ohun-ini	Nan
megszokott	arinrin	Nan
megszállt	ti tẹdo	Nan
megszállta	gbogun ti	Nan
megszállták	gbogun ti	Nan
megszállás	iṣẹ	Nan
megszállása	iṣẹ	Nan
megszületett	a bi	Nan
megszüntette	paarẹ	Nan
megszüntették	paarẹ	Nan
megszüntetése	ṣiṣẹ	Nan
megszűnik	gbawọ	Nan
megszűnése	ifopinsi	Nan
megvan	ní	None
megválasztott	dibo	Nan
megválasztották	dibo	Nan
megírására	kọ	Nan
megítélése	idajọ	Nan
megöli	pipa	Nan
megölte	pa	Nan
megölték	nwon pa	Nan
megőrizte	ni ifipamọ	Nan
mein	mein	Nan
mek	mek	Nan
meklizin	meclizine	Nan
meleg	loworo	Nan
melegebb	igbona	Nan
melinda	melinda	Nan
mellett	tele	None
mellette	lẹgbẹẹ ẹ	Nan
melletti	itele	Nan
megírta	kọ	Nan
megírt	kọ	Nan
megérkezett	dé	None
megállapították	ri	Nan
megváltozik	yipada	None
megváltozott	yipada	None
megváltoztatta	yipada	None
megváltoztatták	yipada	None
megvédte	gbeja	Nan
megy	lọ	Nan
megye	county	Nan
megszakadt	aborted	Nan
megyei	county	Nan
megyében	county	Nan
megyéhez	county	Nan
megyék	awọn kaunti	Nan
megállapodás	àdéhùn	Nan
megállapodást	àdéhùn	Nan
megállapítani	mulẹ	Nan
megállapította	ri	Nan
megyeszékhely	ijoko county	Nan
maguk	awọn funrararẹ	Nan
megsemmisült	parun	Nan
megrendezésre	ibi	Nan
megismerés	cognition	Nan
megismerése	oye	Nan
megjegyezni	ranti	Nan
megjegyezte	ṣe akiyesi	Nan
megjegyzendő	ṣe akiyesi	Nan
megjegyzés	asọye	Nan
megjegyzések	awọn akọsilẹ	Nan
megjelenik	han	Nan
megjelennek	han	Nan
megjelent	tu silẹ	Nan
megjelentek	han	Nan
megjelenés	hihan	Nan
megjelenése	hihan	Nan
megjelenésének	hihan	Nan
megjelenését	hihan	Nan
megismerkedett	o pade	Nan
megjelenő	ifarahan	Nan
megint	lẹẹkansi	Nan
meghódította	yiya	Nan
megfordult	yipada	None
meggyengült	ailera	Nan
meghajtó	wakọ	Nan
meghal	kú	Nan
meghaladja	koja	Nan
meghaladta	koja	Nan
meghalt	kú	Nan
meghatározható	asọye	Nan
meghatározni	lati pinnu	Nan
meghatározott	pàtó	Nan
meghatározta	ṣe idanimọ	Nan
meghatározza	setumo	Nan
meghatározása	ipinnu	Nan
meghatározó	ti npinnu	Nan
meghívta	pe	Nan
megindult	ṣí	Nan
megkapta	gba	None
megkezdte	bẹrẹ	Nan
megkezdték	wọn	None
megnövekedett	pọ si	Nan
megnőtt	dagba	Nan
megoldani	lati yanju	Nan
megoldás	ojutu	Nan
megoldása	solusan	Nan
megoldást	ojutu	Nan
megoszlás	pinpin	Nan
megoszlása	pinpin	Nan
megosztott	pin	Nan
megosztotta	pin	Nan
megpróbálja	gbiyanju lati	Nan
megpróbált	gbiyanju	Nan
megpróbálta	gbiyanju	Nan
megpróbálták	wọn	None
megrendezett	waye	Nan
megnyílt	ṣí	Nan
megnyitotta	ṣí	Nan
megnyerték	bori	Nan
megnyerte	bori	Nan
megkezdődött	bẹrẹ	Nan
megkérte	o beere	Nan
megkísérelte	igbidanwo	Nan
megközelítés	sunmọ	Nan
megközelítőleg	sunmọ	Nan
megkülönböztetünk	ṣe iyatọ	Nan
meglehetősen	dipo	Nan
megromlott	bajẹ	Nan
meglepő	iyalẹnu	Nan
meglévő	wa	Nan
megmaradt	osi	Nan
megmutatta	fihan	None
megnevezés	denomination	Nan
megnevezése	orukọ	Nan
megnyerni	lati bori	Nan
megnyert	bori	Nan
meglátogatta	àbẹwò	Nan
magma	magma	Nan
magja	mojuto	Nan
magdolna	magdolna	Nan
leó	leo	None
liberalizmus	ominira	Nan
liberális	olutayo	Nan
library	ile ikawe	Nan
liechtenstein	irọke-oniṣẹ	Nan
liechtensteini	liechtenstein	Nan
life	igbesi aye	Nan
liga	ajumọṣe	Nan
light	ina	Nan
ligája	ajumọṣe	Nan
ligájában	ajumọṣe	Nan
likőr	oti alagbara	Nan
lila	elese	Nan
lily	lily	Nan
lincoln	linmọlẹ	Nan
leíró	sapejuwe	Nan
linda	linda	Nan
leírása	ijuwe	Nan
leírt	kọ	Nan
levelek	awọn lẹta	Nan
levelet	kọ	Nan
levelében	nipa lẹta	Nan
levelét	lẹta naa	Nan
levél	leta	Nan
levélben	meeli	Nan
levéltár	nkan	None
levő	jije	None
lewis	lewis	Nan
lexikon	igbasilẹ	Nan
lexikona	ologbo	Nan
lezajlott	o ṣẹlẹ	Nan
lezáró	miiran ti	Nan
leány	ọmọbinrin	Nan
leánya	awọn ọmọbinrin	Nan
leírás	ijuwe	Nan
lindemann	lindemann	Nan
line	laini	Nan
lineáris	laini	Nan
liverpool	liverpool	Nan
logan	logan	Nan
logika	kannaa	Nan
logikai	kannaa	Nan
logisztika	eekaderi	Nan
loki	loki	Nan
london	lọndọnu	None
londonba	london	Nan
londonban	london	Nan
londoni	lọndọnu	None
long	gun	None
lord	oluwa	Nan
lorelai	lorelai	Nan
lorenzo	lorenzo	Nan
los	los	Nan
live	wa laaye	Nan
litánia	lilé	Nan
litvánia	lithuania	Nan
litván	lithuania	Nan
linkek	awọn ọna asopọ	Nan
linkgyűjtemény	ọna asopọ gbigba	Nan
linkin	ọna asopọ	Nan
linux	àlẹmọ	Nan
lipcse	leipzig	Nan
lipcsei	leipzig	Nan
lipcsében	leipzig	Nan
leveleiben	awọn lẹta	Nan
lipót	leopold	Nan
lista	atokọ	Nan
listája	atokọ	Nan
listáján	atokọ	Nan
listák	awọn akojọ	Nan
listán	atokọ	Nan
listát	atokọ	Nan
liszt	iyẹfun	Nan
lisa	lisa	Nan
lost	sọnu	Nan
levelei	ewé	None
levegőben	ninu afefe	Nan
lehetett	le	None
lehetne	le	None
lehetnek	boya	Nan
lehetséges	ṣeeṣe	Nan
lehettek	le	None
lehető	ṣeeṣe	Nan
lehetőleg	pelu	Nan
lehetőség	seese	Nan
lehetősége	aye	Nan
lehetőségek	awọn aye	Nan
lehetőségeket	awọn aye	Nan
lehetőséget	aye	Nan
lehetőségét	aye	Nan
lehetővé	gba	None
lelet	wa	Nan
lehetetlenné	soro	Nan
leletek	awọn ohun-iṣere	Nan
lehetetlen	soro	Nan
lehessen	le	None
legtöbb	julọ	Nan
legtöbben	wọn	None
legtöbbet	julọ	Nan
legtöbbször	ọpọlọpọ igba	Nan
legutolsó	tuntun	None
legutóbbi	kẹhin	Nan
legyen	jẹ	Nan
legyenek	jẹ	Nan
legyőzte	lu	Nan
legyőzték	ṣẹgun	Nan
legénység	atuko	Nan
legértékesebb	julọ niyelori	Nan
legészakibb	ariwa	Nan
legújabb	tuntun	None
legősibb	akọbi	Nan
lehet	le	None
lelke	ọkàn	Nan
lelkek	awọn ẹmi	Nan
lelkes	onítara	Nan
leonardo	leonardo	Nan
leopold	leopold	Nan
les	les	Nan
lesz	yio	None
lesznek	yio	None
leszállás	ibalẹ	Nan
leszámítva	ayafi	Nan
leszármazottai	iru-ọmọ	Nan
leszármazottja	ọmọ-ọmọ	Nan
let	jije	None
letartóztatták	mu	Nan
lett	di	Nan
lettek	wọn	None
lettország	latvia	None
levegő	ategun	Nan
leonard	adẹtẹ	Nan
leo	leo	None
lennének	yoo	None
lennon	lennon	Nan
lelki	nípa tẹ̀mí	Nan
lemez	awo	None
lemezek	awọn disiki	Nan
lemezen	disiki	Nan
lemezt	disiki	Nan
lemond	ipo	None
lemondott	ipo	None
levele	lẹta	Nan
lemondását	ifiwesile re	Nan
lengyelek	awọn ọpá	Nan
lengyelország	polandii	Nan
lengyelországban	polandii	Nan
lenin	leninisi	Nan
lenne	yoo	None
lenni	lati jẹ	Nan
lennie	jẹ	Nan
lengyel	pólándì	Nan
mellszobra	igbamu	Nan
lotus	lotus	Nan
lovag	ọbẹ	Nan
létesített	mulẹ	Nan
létesült	mulẹ	Nan
létezett	wa	Nan
létezik	wa	Nan
léteznek	o wa	Nan
létezés	iwalaaye	Nan
létezését	aye ti	Nan
létező	wa	Nan
létre	sókè	Nan
létrehozni	lati ṣẹda	Nan
létrehozott	ṣẹda	Nan
létrehozta	ṣẹda	Nan
létrehozták	ṣẹda	Nan
létrehozása	ẹda	Nan
létrejött	ṣẹda	Nan
léte	ní	None
létrejövő	ṣẹda	Nan
lét	jije	None
lépéseket	awọn igbesẹ	Nan
lélek	ọkàn	Nan
lény	jije	None
lényege	lodi	Nan
lényeges	pataki	Nan
lényegesen	pataki	Nan
lényegében	pataki	Nan
lények	awọn ẹda	Nan
lép	olorun	Nan
lépett	ti tẹ	Nan
léphet	jade	Nan
lépnek	mu	Nan
lépni	igbesẹ	Nan
léptek	ẹsẹ	None
lépés	igbesẹ	Nan
lépése	igbesẹ	Nan
lépést	sókè	Nan
létszáma	nọmba naa	Nan
létszámát	nọmba	Nan
létszámú	nọmba	Nan
madonna	madona	Nan
madrid	ilu madrid	Nan
madách	madách	Nan
madár	eye	Nan
maffia	nsomi	Nan
mag	mojuto	Nan
maga	iho	Nan
magam	funrarami	Nan
magas	ga	Nan
magasabb	ga	Nan
magasra	ga	Nan
magasság	gíga	Nan
magassága	gíga	Nan
magazin	iwe irohin	Nan
magda	magda	Nan
madarak	àwọn ẹyẹ	Nan
macskák	ologbo	Nan
macska	o nran	Nan
machu	machu	Nan
létét	aye ti	Nan
lévén	jije	None
lévő	jije	None
líceum	iṣọn	Nan
líra	lira	Nan
lírai	lyrical	Nan
ló	iyaworan	Nan
légköri	ti oyi oju aye	Nan
lóránt	níránt	Nan
lőcsei	lőcsei	Nan
lőrinc	agbofinro	Nan
lőtt	gbon	Nan
m	m	Nan
ma	loni	Nan
mac	mac	Nan
macedónia	makedonia	None
lúdformák	anserinae	Nan
louis	louis	Nan
légköre	bugbamu	Nan
légkörbe	bugbamu	Nan
luxemburgi	luxembourg	Nan
lyuk	iho	Nan
láb	ẹsẹ	None
lába	esè	Nan
lábjegyzet	ẹsẹ	None
lábon	ẹsẹ	None
lábánál	kekere	None
lábát	ẹsẹ	None
láden	laden	Nan
lágy	rirọ	Nan
lánchíd	pq bridge	Nan
lány	ọmọbinrin	Nan
lánya	rẹ	None
lányok	awon odomobirin	Nan
lányt	ọmọbinrin	Nan
luxemburg	luxembourg	Nan
lányát	ọmọbinrin	Nan
luther	luther	None
lunar	osan	Nan
lovagok	awọn ọbẹ	Nan
lovak	ẹṣin	Nan
lovas	ẹlẹṣin	Nan
lovat	ẹṣin	Nan
love	ni ife	Nan
lsd	wo	Nan
luca	luca	Nan
lucas	lucas	Nan
lucifer	lucifer	Nan
ludwig	ludwig	Nan
luigi	luigi	Nan
luis	luis	Nan
luke	awure	Nan
lukács	lukács	Nan
luna	luna	Nan
lupus	lupus	Nan
lásd	wo	Nan
lászló	asia	Nan
lát	wo	Nan
látszólagos	gbangba	Nan
látta	rí	Nan
láttak	nwon ri	Nan
látták	ti ri	Nan
látva	ríran	Nan
látványos	iyalẹnu	Nan
látás	ríran	Nan
láva	lava	Nan
láz	ibà	Nan
lázadás	iṣọtẹ	Nan
lázadó	ọlọtẹ	Nan
lázár	lasaru	Nan
légi	ategun	Nan
légierő	ategun	Nan
légkör	bugbamu	Nan
látszólag	nkqwe	Nan
látszott	wò	Nan
látszik	han	Nan
látott	ti ri	Nan
láthatatlan	alaihan	Nan
látható	han	Nan
láthatóak	han	Nan
láthatók	han	Nan
látja	rí	Nan
látjuk	a rii	Nan
látják	nwqn ri	Nan
légkörben	bugbamu	Nan
látképe	wiwo naa	Nan
látnivalói	fojusi	Nan
látnivalók	fojusi	Nan
látogatott	ṣàbẹwò	Nan
látogatta	ṣàbẹwò	Nan
látogatása	ṣàbẹwò	Nan
látogató	àlejò	Nan
látogatók	àlejò	Nan
látni	wo	Nan
mellyel	ewo	Nan
mellé	tele	None
melléknevek	awọn afẹsodi	Nan
műhely	idanileko	Nan
működik	iṣẹ	Nan
működnek	ṣiṣẹ	Nan
működtek	ṣiṣẹ	Nan
működés	isẹ	Nan
működése	isẹ	Nan
működési	iṣẹ ṣiṣe	Nan
működésének	mosi	Nan
működését	isẹ	Nan
működött	ṣiṣẹ	Nan
működő	anesitetiki	Nan
műsor	ṣafihan	Nan
műszaki	imọ ẹrọ	Nan
műve	mosi	Nan
művei	ṣiṣẹ	Nan
műfaja	oriṣi	Nan
műveiben	rẹ	None
műfaj	oriṣi	Nan
műben	ohun ọgbin	Nan
mögött	sile	None
mögötte	sile	None
mögötti	sile	None
múlt	ti o ti kọja	Nan
múlva	nigbamii	Nan
múzeum	musiọmu	Nan
múzeuma	musiọmu	Nan
múzeumban	musiọmu	Nan
múzeumok	awọn musiọmu	Nan
müller	müller	Nan
münchen	munich	Nan
münchenben	munich	Nan
müncheni	munich	Nan
mű	wọn	None
műanyag	ṣiṣu	Nan
műemlékei	awọn arabara	Nan
műveiből	awọn iṣẹ	Nan
műveinek	awọn iṣẹ	Nan
műveit	awọn iṣẹ	Nan
nacional	nacional	Nan
nacionalista	t’orilẹ-ede	Nan
nacionalizmus	t’orilẹ-ede	Nan
nagy	tobi	Nan
nagyanyai	agba	None
nagyapai	agba	None
nagyapja	agba	None
nagyarányú	titobi	Nan
nagyban	osunwon	Nan
nagybritannia	ilu oyinbo briteeni	Nan
nagybritanniában	ilu oyinbo briteeni	Nan
nagybátyja	aburo	Nan
nagydíj	grand prix	Nan
nagydíjat	joju nla	Nan
nagydíjon	grand prix	Nan
n	n	Nan
művét	rẹ	None
művészi	iṣẹ ọna	Nan
művészetének	aworan	Nan
művek	ṣiṣẹ	Nan
műveket	ṣiṣẹ	Nan
művelet	isẹ	Nan
művelt	gboye	Nan
művelődési	aṣa	Nan
művet	iṣẹ ni	Nan
művében	rẹ	None
mögé	sile	None
művének	rẹ	None
művészek	awọn oṣere	Nan
művészet	aworan	Nan
művészetben	aworan	Nan
művészete	iṣẹ ọna	Nan
művészetek	ona ona	Nan
művészeti	iṣẹ ọna	Nan
művészetoktatási	eko	None
művész	olorin	Nan
nagyfokú	kikoro	Nan
mózes	mósè	Nan
móra	mora	Nan
másodszor	keji	Nan
mások	awọn miiran	Nan
másrészt	ti a ba tun wo lo	Nan
mást	omiiran	Nan
mátrix	matrix	Nan
mátyás	mátánì	Nan
máté	mátíù	Nan
máv	mav	Nan
média	media	Nan
médiában	awọn media	Nan
még	diẹ sii	Nan
méghozzá	ani	Nan
mégis	lai ti iyẹn	Nan
mégpedig	eyun	Nan
mégsem	kii ṣe	Nan
másodperc	ikeji	Nan
méltó	yẹ	Nan
másodlagos	atẹle	Nan
másnap	ni ijọ keji	Nan
márciusban	kẹta	None
mária	màríà	Nan
máris	bayi	None
márk	samisi	Nan
mármár	marmar	Nan
márquez	márquez	Nan
márta	márta	Nan
márton	martin	Nan
más	omiiran	Nan
másfél	idaji	None
máshol	ibomiiran	Nan
másik	omiiran	Nan
máskor	igba miiran	Nan
másként	bibẹẹkọ	Nan
másmás	miiran miiran	Nan
második	ikeji	Nan
mély	jinjin	Nan
mélyebb	wole	None
mélyen	jinjin	Nan
méter	mita	Nan
mézga	gomu	Nan
míg	nigba ti	Nan
mígnem	titi	Nan
mód	ipo	None
módja	ọna	Nan
módon	ọna	Nan
módosított	títúnṣe	Nan
módszer	ọna	Nan
módszere	ọna	Nan
módszerek	awọn ọna	Nan
módszerekkel	awọn ọna	Nan
módszerrel	awọn ọna	Nan
módszert	awọn ọna	Nan
mór	moorish	Nan
mészáros	alagbata	Nan
mészárlás	ipakupa	Nan
mészkő	okuta-ilẹ	Nan
mérések	iwọn	Nan
méret	iwọn	Nan
mérete	iwọn	Nan
méretét	iwọn ti	Nan
méretű	won	Nan
mérgessiklófélék	elapidae	Nan
mérgező	majele	Nan
mérkőzés	baramu	Nan
móricz	moricz	Nan
mérkőzések	awọn ibaamu	Nan
mérkőzést	baramu	Nan
mérnök	ẹnjinia	Nan
mérsékelt	iwọntunwọnsi	Nan
mért	nitori	Nan
mértékben	iye	Nan
mértéke	ìyí	Nan
mértékű	ìyí	Nan
mérkőzésen	baramu	Nan
március	kẹta	None
nagyhatalmak	agbara	None
nagyjából	ni aijọju	Nan
nevei	awọn orukọ ti	Nan
nevek	awọn orukọ	Nan
nevelkedett	dide	Nan
nevelte	dide	Nan
nevelés	eko	None
neves	ṣe akiyesi	Nan
nevet	orukọ	Nan
nevezetes	o lapẹẹrẹ	Nan
nevezett	wi	Nan
nevezhető	o ti a npe ni	Nan
nevezi	n pe e	Nan
nevezik	ti a pe	Nan
neveznek	pe	Nan
nevezni	lati pe	Nan
nevezte	ti a npè ni	Nan
neve	orukọ	Nan
neveztek	ti a npè ni	Nan
neumann	neumann	Nan
nemzetközileg	kariaye	Nan
nemesi	patrician	Nan
nemesség	ọlaju	Nan
nemfémek	ti kii-irin	Nan
nemi	diẹ ninu	Nan
nemsokára	laipẹ	Nan
nemzedék	iran	Nan
nemzet	orílẹ-èdè	Nan
nemzetek	awọn orilẹ-ede	Nan
nemzetgyűlés	apejọ ti orilẹ-ede	Nan
nemzeti	orilẹ-ede	Nan
nemzetiség	abínibí-èdè	Nan
nemzetiségek	awọn orilẹ-ede	Nan
nemzetiségi	abínibí-èdè	Nan
nemzetiségű	abínibí-èdè	Nan
nemzetközi	kariaye	Nan
network	nẹtiwọọki	Nan
nevezték	ti a npè ni	Nan
nevezzük	ti a pe	Nan
neville	neville	Nan
nirvana	nirvana	Nan
nixon	nixon	Nan
no	obinrin	Nan
nob	rárá	Nan
nobeldíj	nobel	None
nobeldíjas	nobeldíjas	Nan
nobeldíjat	nobel	None
noha	biotilejepe	Nan
nomád	orukọ ara ilu	Nan
norman	arabinrin	Nan
normál	deede	Nan
normális	deede	Nan
norvég	nowejiani	Nan
norvégia	norway	Nan
nostradamus	nostradamus	Nan
niro	niro	Nan
nincsenek	ko	None
nincsen	kiise	Nan
nincs	rárá	Nan
nevében	lori dípò ti	Nan
nevéből	rẹ	None
nevéhez	oruko	None
nevén	mọ bi	Nan
nevének	orukọ	Nan
nevét	orukọ	Nan
nevével	orukọ	Nan
nemesek	awọn ọlọla	Nan
nevük	wọn	None
nevű	diẹ sii	Nan
newton	newton	Nan
nick	lóyún	Nan
nicolas	ohun inu-inu	Nan
nietzsche	nietzsche	Nan
night	alẹ	Nan
nikola	nikola	Nan
nevüket	wọn	None
nagyhatalom	agbara	None
nemes	ọlọla	Nan
nem	rárá	Nan
napforduló	solstice	Nan
napi	ojoojumo	Nan
napig	àwọn ọjọ́	Nan
napilap	irohin ojoojumọ	Nan
napisten	oorun ọlọrun	Nan
napja	ọjọ	Nan
napjaink	loni	Nan
napjainkban	lasiko	Nan
napjainkig	loni	Nan
napjainkra	loni	Nan
napján	ọjọ	Nan
napló	iwe itosiwe	Nan
naplója	iwe itosiwe	Nan
napok	àwọn ọjọ́	Nan
napokban	ni awọn ọjọ	Nan
napfoltok	oorun	Nan
napon	lori oorun	Nan
napfogyatkozás	oloorun	Nan
nagyvárosok	awọn ilu	Nan
nagyközönség	ita	Nan
nagyméretű	titobi nla	Nan
nagymértékben	gidigidi	None
nagyobb	tobi	Nan
nagyon	pupọ	Nan
nagyra	gíga	Nan
nagyrészt	ibebe	Nan
nagyszabású	arabara	Nan
nagyszerű	o ga o	Nan
nagyszámú	lọpọlọpọ	Nan
nagysága	ilẹ	None
nagyvárad	nagyvárad	Nan
nagyváradi	oradea	Nan
nagyváradon	oradea	Nan
nagyváros	ilu	Nan
nap	ọjọ	Nan
naponta	ojoojumo	Nan
napos	sun	None
napot	ọjọ	Nan
negatív	odi	Nan
negyed	mẹẹdogun	Nan
negyeddöntő	mẹẹdogun	Nan
negyeddöntőben	mẹẹdogun	Nan
negyedik	kẹrin	None
negyven	ogoji	Nan
nehezebb	gba	None
nehezen	lile	Nan
nehogy	boya	Nan
nehéz	lile	Nan
nehézségek	awọn ìṣoro	Nan
nekem	emi	Nan
neki	rẹ	None
nekik	wọn	None
nelson	nelson	Nan
nedves	ririn	Nan
ne	kii ṣe	Nan
ndk	ila-oorun jẹmánì	Nan
nb	nb	Nan
nappal	ọjọ	Nan
nappali	yara nla ibugbe	Nan
napra	ọjọ	Nan
naprendszer	eto oorun	Nan
naprendszerben	eto oorun	Nan
napszél	oorun afẹfẹ	Nan
naptár	kalẹnda	Nan
nemcsak	kii ṣe nikan	Nan
naptól	ọjọ	Nan
napóleoni	napoleonic	Nan
narancs	ọsan	Nan
naruto	naruto	Nan
nasa	tirẹ	Nan
national	orilẹ-ede	Nan
nato	nato	None
nazionale	nazionale	Nan
napóleon	napoleon	Nan
novella	itan kukuru	Nan
márai	márai	Nan
már	tẹlẹ	Nan
milano	milan	Nan
millenniumi	ọdun ẹgbẹrun	Nan
miller	miller	Nan
millió	million	Nan
milyen	irú èwo	Nan
milánó	milan	Nan
milánóban	malan	Nan
milánói	milanese	Nan
mind	gbogbo	Nan
mindaddig	gun	None
mindazonáltal	sibẹsibẹ	Nan
mindegyik	kọọkan	Nan
mindegyike	kọọkan	Nan
mindegyikük	gbogbo won	Nan
mindeközben	nibayi	Nan
milan	malan	Nan
mindemellett	yàtò	None
miközben	nigba ti	Nan
mikszáth	mikszath	Nan
miatt	fun	None
miatti	nitori	Nan
michael	olorin	Nan
michel	michel	Nan
michelangelo	michelangelo	Nan
michelle	michelle	None
mick	mick	Nan
microsoft	microsoft	Nan
midőn	nigbawo	Nan
mielőtt	ṣaaju	Nan
miguel	miguel	Nan
mihály	mikaeli	Nan
miklós	mikaeli	Nan
mikor	nigbawo	Nan
miksa	awọn aporo	Nan
miként	bawo	Nan
minden	gbogbo	Nan
mindenekelőtt	a la koko	Nan
mindenesetre	ko	None
mindössze	kan	None
minimum	o kere ju	Nan
minimális	o kere ju	Nan
miniszter	òjíṣẹ́	Nan
miniszterek	awọn minisita	Nan
miniszterelnök	adari igbimọ ijọba	Nan
miniszterelnöki	adari igbimọ ijọba	Nan
miniszterelnököt	nomba	Nan
minisztérium	iṣẹ́ òjíṣẹ́	Nan
minket	u.s	Nan
mint	bi	Nan
mintegy	diẹ ninu	Nan
mintha	bii pe	Nan
minthogy	bẹ yẹn	Nan
mintsem	ju	Nan
mindvégig	ni gbogbo igba	Nan
mindmáig	bayi	None
mindkét	mejeeji	Nan
mindketten	mejeeji	Nan
mindenféle	gbogbo iru	Nan
mindenhol	ibi gbogbo	Nan
mindenki	gbogbo eyan	Nan
mindenkinek	fun	None
mindenkit	gbogbo eniyan	Nan
mindenkori	ti nmulẹ	Nan
mindenképpen	dajudaju	Nan
miami	miami	Nan
mindennapi	lojojumo	Nan
mindenütt	ibi gbogbo	Nan
mindez	gbogbo eyi	Nan
mindezek	gbogbo awọn wọnyi	Nan
mindezt	gbogbo	Nan
mindhárom	gbogbo awọn mẹta	Nan
mindig	nigbagbogbo	Nan
mindinkább	ati siwaju sii	Nan
mindent	ohun gbogbo	Nan
mintájára	awoṣe	Nan
mialatt	lakoko ti	Nan
mh	mh	Nan
menekült	asasala	Nan
menekültek	asasala	Nan
menekülő	asasala	Nan
menet	yika	Nan
mennek	yoo	None
menni	lati lọ	Nan
mennydörgés	ààrá	Nan
mennyi	elo ni	Nan
mennyire	bawo	Nan
mennyiség	opoiye	Nan
mennyiségben	iye	Nan
mennyiségét	oye	Nan
menstruációs	nkan	None
ment	lọ	Nan
mentek	iwo lo	Nan
menekülni	sa asala	Nan
mentes	giga	Nan
menedéket	koseemani	Nan
memória	iranti	Nan
melléknév	ajẹtífù	Nan
melléknévi	ajẹtífù	Nan
mely	jinjin	Nan
melyben	ewo	Nan
melyből	ewo	Nan
melyek	ewo	Nan
melyekben	ewo	Nan
melyeket	ewo	Nan
melyeknek	iyẹn ni	Nan
melyen	jinjin	Nan
melyet	ewo	Nan
melyhez	ewo	Nan
melyik	ewo	Nan
melynek	ewo	Nan
melyre	ewo	Nan
menedzsere	oluṣakoso	Nan
mentette	ti o ti fipamọ	Nan
menti	gbà là	Nan
mentális	ọpọlọ	Nan
metal	irin	Nan
metallica	metallica	Nan
metionin	methionine	Nan
metró	agbegbe	Nan
metélőhagyma	chives	Nan
mexikó	meksiko	None
mexikóban	meksiko	None
mexikói	meksiko	None
meyer	meyer	Nan
mezopotámia	mesopotamia	Nan
meztelen	ihoho	Nan
mező	pápá	Nan
mezőgazdaság	ogbin	Nan
mezőgazdasági	ogbin	Nan
mezőny	gbagede	Nan
metafizika	afiwera	Nan
meséli	awọn atunbere	Nan
mesék	fun	None
mesterségesen	atọwọda	Nan
mentén	pẹlú	Nan
mercedes	mercedes	Nan
mercury	makiuri	Nan
merev	le	None
merevlemez	dirafu lile	Nan
merkúr	makiuri	Nan
mert	nitori	Nan
mi	àwa	Nan
merénylet	ibinu	Nan
messenger	ojiṣẹ	Nan
messi	miése	Nan
messze	jinna	Nan
mester	ọga	Nan
mestere	ọga	Nan
mesterek	ọga	Nan
mesterséges	atọwọda	Nan
merült	dide	Nan
mára	fun	None
minél	diẹ sii	Nan
minőségi	agbara	None
mtv	mtv	Nan
multinacionális	lọpọlọpọ	Nan
munka	iṣẹ	Nan
munkaerő	laala	Nan
munkanélküliség	alainiṣẹ	Nan
munkaszüneti	isinmi	Nan
munkatársa	oṣiṣẹ	Nan
munkatársai	oṣiṣẹ	Nan
munkácsy	munkácsy	Nan
munkái	awọn iṣẹ	Nan
munkáinak	awọn iṣẹ ti	Nan
munkáit	awọn iṣẹ	Nan
munkája	iṣẹ	Nan
munkájában	iṣẹ	Nan
munkájának	iṣẹ	Nan
mta	mta	Nan
munkáját	iṣẹ	Nan
mszp	ẹgbẹ alagbase	Nan
mr	mr	Nan
mozdonyok	awọn agbegbe	Nan
mozgalmak	awọn agbeka	Nan
mozgalmat	ronu	Nan
mozgalom	ronu	Nan
mozgás	gbe	None
mozgása	išipopada	Nan
mozgások	awọn agbeka	Nan
mozgást	išipopada	Nan
mozgását	išipopada	Nan
mozgó	gbigbe	Nan
mozi	sinima	Nan
mozifilm	aworan išipopada	Nan
mozikban	cinima	Nan
mozilla	mozilla	None
mozog	gbe	None
mrs	mrs	Nan
munkák	ṣiṣẹ	Nan
munkákat	awọn iṣẹ	Nan
munkálatok	ṣiṣẹ	Nan
mutatott	han	Nan
mutatta	fihan	None
mutattak	ṣafihan	Nan
mutatták	ṣafihan	Nan
mutató	atọka	Nan
mutáció	iyipada	Nan
muzulmán	musulumi	Nan
mágikus	ti idan	Nan
mágneses	oofa	Nan
máj	ẹdọ	Nan
május	karun	None
májusban	karun	None
málta	malta	Nan
máltai	malita	Nan
mániás	manic	Nan
mutatni	fihan	None
mutatnak	ṣafihan	Nan
mutatkozott	o wa	Nan
mutatkozik	o wa	Nan
munkás	oṣiṣẹ	Nan
munkások	osise	Nan
munkáspárt	ẹgbẹ laala	Nan
munkássága	rẹ	None
munkásságát	rẹ	None
munkát	iṣẹ	Nan
museo	ile musiọmu	Nan
mozart	mozart	Nan
museum	musiọmu	Nan
musical	gaju ni	Nan
mussolini	mussolini	Nan
muszlim	musulumi	Nan
muszlimok	musulumi	Nan
mutat	ṣafihan	Nan
mutatja	mu wa	Nan
mutatják	ṣafihan	Nan
music	orin	Nan
minősége	awọn didara	Nan
movie	fiimu	Nan
motoros	moto	Nan
modell	awoṣe	Nan
modellek	awọn awoṣe	Nan
modellt	awoṣe	Nan
modern	igbalode	Nan
mohamed	mohammed	Nan
mohácsi	mohácsi	Nan
moldova	moldova	Nan
moldovai	moludofa	Nan
moldvai	moldavian	Nan
molekulák	molikula	Nan
molekuláris	molikula	Nan
molibdén	molybdenum	Nan
molnár	miller	Nan
mon	mon	Nan
mona	mona	Nan
mode	ipo	None
monaco	monaco	Nan
mocsaras	marshy	Nan
mivel	nitori	Nan
minőségű	didara	Nan
minősül	o ka bi	Nan
mire	kini	Nan
mise	ọpọ	Nan
miskolc	miskolc	Nan
miskolci	miskolc	Nan
miskolcon	miskolc	Nan
miss	padanu	Nan
miszerint	iyẹn	Nan
misztikus	mystic	Nan
mit	kini	Nan
mitológia	itan aye atijọ	Nan
mitológiai	itan aye atijọ	Nan
mitológiában	itan aye atijọ	Nan
miután	nini	Nan
miért	idi	Nan
monacói	ilu monaco	Nan
monarchia	olú ọba	Nan
mond	sọ	None
more	diẹ sii	Nan
morgan	morgan	None
morrison	ẹlẹwọn	Nan
morse	pẹtẹlẹ	Nan
morva	moravian	Nan
morvai	moravian	Nan
mos	wẹ	Nan
most	bayi	None
mostani	lọwọlọwọ	Nan
moszkva	ilu moscow	Nan
moszkvai	ilu moscow	Nan
moszkvában	ilu moscow	Nan
motor	ẹnjinia	Nan
motorkerékpározás	alupupu	Nan
motorok	ẹnjini	Nan
moore	moore	Nan
moon	osupa	Nan
monumentális	arabara	Nan
monty	monty	Nan
mondani	sọ	None
mondat	gbolohun ọrọ	Nan
mondható	le	None
mondja	pé	None
mondott	wi	Nan
mondta	fun	None
mondták	nwọn wipe	Nan
mount	òkè	Nan
mondván	sisọ,	Nan
mongol	mongolian	Nan
mongolok	awọn mongoli	Nan
monica	monica	Nan
monk	araye	Nan
monte	monte	Nan
montenegró	montenegro	Nan
montgomery	montgomery	Nan
mondák	sagas	Nan
szegények	talaka	None
szegénység	osi	Nan
szeijú	szeijú	Nan
várat	ile odi	Nan
váratlan	airotẹlẹ	Nan
váratlanul	lairotẹlẹ	Nan
várban	ile odi	Nan
várható	o ti ṣe yẹ	Nan
várja	fun	None
várkonyi	várkony	Nan
vármegye	county	Nan
várnegyed	agbegbe castle	Nan
várni	duro de	Nan
város	ilu	Nan
városa	ilu	Nan
városai	awọn ilu	Nan
városba	ilu	Nan
városban	ni ilu	Nan
vára	ile kasulu	Nan
városból	ilu	Nan
vár	ile kasulu	Nan
vámpírok	vampires	Nan
változnak	yipada	None
változott	yipada	None
változtatni	yipada	None
változtatott	yipada	None
változtatta	yipada	None
változás	yipada	None
változása	yipada	None
változások	awọn ayipada	Nan
változásokat	awọn ayipada si	Nan
változást	yipada	None
változó	oniyipada	Nan
válás	yigi	Nan
válása	yigi	Nan
váló	yigi	Nan
vámpír	fanpaya	Nan
vándoroltak	kópa	Nan
változik	yipada	None
városhoz	ilu	Nan
városi	ilu	Nan
védelmet	aabo	Nan
védelmi	igbeja	Nan
védelmében	dáàbò	Nan
védelmére	aabo	Nan
védelmét	aabo	Nan
védett	ni idaabobo	Nan
védte	gbeja	Nan
védő	olugbeja	Nan
végbe	ibi	Nan
vége	lori	Nan
végeredmény	igbesoke	None
véget	ipari	Nan
végett	fun	None
végez	ṣe	Nan
végeznek	ṣe	Nan
védelme	aabo	Nan
városháza	gbongan ilu	Nan
védelem	aabo	Nan
vásárolt	rà	Nan
városnak	ilu	Nan
városok	awọn ilu	Nan
városokat	awọn ilu	Nan
városokban	awọn ilu	Nan
városon	ilu	Nan
városrész	ilu	Nan
városrészek	adugbo	Nan
várossá	ilu	Nan
várost	ilu	Nan
várostól	ilu	Nan
városában	ilu	Nan
városának	ilu	Nan
városát	ilu	Nan
várt	o ti ṣe yẹ	Nan
várta	o ti ṣe yẹ	Nan
védekező	olugbeja	Nan
változatát	ẹya ti	Nan
változatában	ẹya	Nan
változatot	ẹya	Nan
vulkáni	ẹgbin	Nan
vulkánok	onina	Nan
váci	vac	Nan
vád	ibanirojọ	Nan
vádjával	idiyele	Nan
vádolták	onimo	Nan
vágott	ge	Nan
vágya	tabi	None
válasz	idahun	Nan
válaszolt	dahùn	Nan
választ	yan	None
választani	yan	None
választja	yan	None
választják	dibo	Nan
választott	yàn	Nan
vulkán	onina	Nan
választotta	dibo	Nan
vulkanikus	onina aruwo	Nan
voyager	ajo	None
vonala	laini	Nan
vonalak	awọn ila	Nan
vonalat	laini	Nan
vonalon	laini	Nan
vonalán	laini	Nan
vonatkozik	ibakcdun	Nan
vonatkoznak	waye	Nan
vonatkozó	nipa	Nan
vonatkozóan	pẹlu ọwọ si	Nan
vonatok	awọn ọkọ oju-irin	Nan
vonják	yorawonkuro	Nan
vonta	fà	Nan
vonták	yorawonkuro	Nan
vonult	fẹyìntì	Nan
vonultak	wọn	None
vs	la	Nan
választottak	dibo	Nan
választották	dibo	Nan
választás	yiyan	Nan
válogatás	yiyan	Nan
válság	rogbodiyan	None
vált	yipada	None
váltak	wọn	None
váltakozó	omiiran	Nan
váltja	rọpo	Nan
váltott	yipada	None
váltotta	rọpo	Nan
váltották	rọpo	Nan
változat	ẹya	Nan
változata	ẹya ti	Nan
változatai	awọn ẹya	Nan
változatban	awọn ẹya	Nan
változatok	awọn ẹya	Nan
változatos	iyatọ	Nan
válogatottban	egbe	None
válogatott	oriṣiriṣi	Nan
válni	lati di	Nan
válnak	yio	None
választása	yan	None
választási	idibo	Nan
választások	awọn idibo	Nan
választásokat	awọn idibo	Nan
választásokon	awọn idibo	Nan
választáson	idibo	Nan
választófejedelem	aafin	Nan
végezte	ṣe	Nan
válaszul	fesi	Nan
válik	di	Nan
vállal	pinu	None
vállalat	ile-iṣẹ	Nan
vállalatok	awọn ile-iṣẹ	Nan
vállalkozás	pinu	None
vállalt	agbeyewo	Nan
vállalta	bẹrẹ	Nan
válhat	le	None
végeztek	o waiye	Nan
végezték	o waiye	Nan
végeztével	ti pari	Nan
wilde	wilde	Nan
wilhelm	wilhelm	Nan
william	william	Nan
williams	williams	Nan
willis	iwe	Nan
wilson	wilónì	Nan
windows	windows	Nan
winston	winston	Nan
wolfgang	wolfgang	Nan
wolfner	wolfner	Nan
wood	igi	Nan
xii	xii	Nan
xiii	xiii	Nan
xiv	xiv	None
xix	xix	Nan
wikipédia	wikipedia	Nan
xp	xp	Nan
wifi	wifi	Nan
who	àjọ who	Nan
way	ọna	Nan
wayne	ọna	Nan
weasley	weasley	Nan
web	wẹẹbu	Nan
weber	onirin	Nan
webes	wẹẹbu	Nan
weboldal	aaye ayelujara	Nan
weboldala	aaye ayelujara	Nan
weimarban	weimar	Nan
weimari	weimar	Nan
werner	werner	Nan
wesselényi	wesselényi	Nan
west	iwọ oorun	Nan
weöres	weöres	Nan
white	funfun	Nan
wien	vienna	Nan
xv	xv	Nan
xvii	xvii	Nan
xviii	xviii	Nan
zene	orin	Nan
zenei	gaju ni	Nan
zeneileg	gaan	Nan
zenekar	ẹgbẹ	Nan
zenekara	olutoju	Nan
zenekari	olukopa	Nan
zenekart	olutoju	Nan
zeneműkiadó	akede orin	Nan
zeneszerző	olupilẹṣẹ	Nan
zeneszerzői	olupilẹṣẹ	Nan
zeneszerzők	oluṣeto	Nan
zeneszerzőnek	olupilẹṣẹ	Nan
zeneszerzőt	olupilẹṣẹ	Nan
zenében	orin	Nan
zenéje	ohun orin	Nan
zavarok	yọ	None
zavargások	rudurudu	Nan
zavar	rudurudu	Nan
zalaegerszegi	zalaegerszeg	Nan
y	y	Nan
year	ọdun	Nan
york	york	None
yorkba	york	None
yorkban	york	None
yorki	york	None
you	iwo	Nan
watson	watson	Nan
young	odo	Nan
z	z	Nan
zajlik	mu aye	Nan
zajlott	ṣẹlẹ	Nan
zajlottak	wáyé	Nan
zajló	mu aye	Nan
zala	zala	Nan
zalaegerszeg	zalaegerszeg	Nan
youtube	youtube	Nan
vonal	laini	Nan
waters	omi	None
washingtoni	washington	Nan
végéig	ipari	Nan
végén	ni ipari ti	Nan
végére	nipa ipari ti	Nan
végét	pari	Nan
végétől	ipari	Nan
végül	lakotan	Nan
vékony	tinrin	Nan
vélemény	ero	Nan
véleménye	ero	Nan
vélemények	awọn ero	Nan
véleményét	atunyẹwo	Nan
véletlen	id	Nan
véletlenül	lairotẹlẹ	Nan
vélhetően	boya	Nan
véli	iwo	Nan
végződött	pari	Nan
vélik	ronu	Nan
végződik	fopin si	Nan
végzik	o waiye	Nan
végi	ipari	Nan
végig	nipasẹ	Nan
végleg	lakotan	Nan
végleges	pataki	Nan
véglegesen	titilai	Nan
végre	lakotan	Nan
végrehajtott	imuse	Nan
végrehajtás	imuse	Nan
végrehajtó	bailiff	Nan
végső	ipari	Nan
végtelen	ailopin	Nan
végvári	odi odi	Nan
végzet	dumu	Nan
végzett	ti pari	Nan
végzi	ṣe	Nan
végző	sise	None
vélt	putative	Nan
vélte	iwo	Nan
vélték	ronu	Nan
vö	jc	Nan
völgye	àfonífojì	Nan
völgyében	afonifoji	Nan
vörös	pupa	None
vörösmarty	vörösmarty	Nan
wagner	ọkọ-akẹru	Nan
wales	oyo	Nan
wall	w w	Nan
wallace	wallace	Nan
walt	walt	Nan
walter	walter	Nan
warcraft	jagunjagun	Nan
warhol	warhol	Nan
washington	aṣọ iwẹ	Nan
washingtonban	washington dc	Nan
vízzel	omi	None
vízszintes	petele	Nan
vízrajz	olomi-akọọlẹ	Nan
vízkereszt	epiphany	Nan
vénusz	usúsì	Nan
vér	ẹ̀jẹ̀	Nan
vércukorszint	ẹjẹ suga	Nan
véres	ẹlẹjẹ	Nan
vérnyomás	ẹjẹ titẹ	Nan
vért	ihamọra	Nan
vértanúk	ajẹriku	Nan
wass	wass	Nan
véve	iwo	Nan
vírus	àrùn	None
vírusok	awọn ọlọjẹ	Nan
vívott	ja	Nan
víz	omi	None
vízben	omi	None
vízgyűjtő	apeja	None
vízi	aromiyo	Nan
vígjáték	awada	Nan
von	von	Nan
volte	folti	Nan
voltam	sọ	None
vers	ewi	Nan
verse	ẹsẹ	None
versei	awọn ewi	Nan
verseit	awọn ewi	Nan
versek	awọn ewi	Nan
verseket	oríkì	None
verseny	ije	None
versenyegérformák	gerbil	Nan
versenyen	figagbaga	Nan
versenyt	idije	Nan
versenyzett	idije	Nan
versenyző	oludije	Nan
versenyzője	elere idaraya	Nan
versenyzők	awọn oludije	Nan
versenyén	iṣẹlẹ	Nan
vereséget	ṣẹgun	Nan
verses	rhymed	Nan
veresége	ṣẹgun	Nan
verdi	verdi	Nan
vegyipari	ile-iṣẹ kemikali	Nan
vegyületek	awọn iṣiro	Nan
vele	rẹ	None
velence	àlépa	Nan
velencei	ede	None
velencében	icede	Nan
velük	wọn	None
vencel	awọn ayaba	Nan
vendégek	awon alejo	Nan
venezia	venezia	Nan
venezuela	venezuela	None
venni	ra	None
venus	ẹṣẹ	Nan
venyera	venera	Nan
vera	vera	Nan
vereség	ṣẹgun	Nan
verset	ewi	Nan
versét	ewi	Nan
verte	lu	Nan
veszélyeztetett	gbogun	Nan
veszélyt	irokeke	Nan
vet	gbìn	Nan
vetett	gbon	Nan
vetette	ju	Nan
vetették	wọn	None
vett	mu	Nan
vette	mu	Nan
vettek	wọn	None
vettel	vettel	Nan
vették	wọn	None
vetítés	ilana	None
vevő	alabara	Nan
vezet	darí	Nan
vezetett	dari	Nan
veszélyes	lewu	Nan
veszélye	ijamba	Nan
veszély	ijamba	Nan
vesztette	sọnu	Nan
verték	lu	Nan
verzió	ẹya	Nan
verziója	ẹya	Nan
verébalkatúak	verébalkatúak	Nan
vese	àrùn	None
vesz	ra	None
veszettség	awọn rabies	Nan
vegyipar	ile-iṣẹ kemikali	Nan
veszi	gba	None
vesznek	ninu	Nan
veszprém	veszprem	Nan
veszprémi	veszprém	Nan
vesztes	ipadanu	Nan
veszteségek	adanu	Nan
veszteségeket	adanu	Nan
vesztett	àìlera	Nan
veszik	mu	Nan
vezethet	darí	Nan
vegyi	kẹmika	Nan
vegyen	mu	Nan
valamennyi	gbogbo	Nan
valami	nkan	None
valamiféle	diẹ ninu irú	Nan
valamikor	nigbakan	None
valamilyen	eyikeyi	Nan
valamint	si be e si	Nan
valamit	nkan	None
valamivel	fẹẹrẹ	Nan
valencia	valencia	Nan
valkűr	valkyrie	Nan
vallja	pé	None
vallon	wolika	Nan
vallott	ṣalaye	Nan
vallotta	bẹbẹ	Nan
vallás	ẹsin	Nan
valamelyik	ọkan	Nan
vallási	ẹlẹsin	Nan
valamely	a	Nan
valahol	ibikan	Nan
utólag	náà	None
vacsora	ounje ale	Nan
vad	ibanirojọ	Nan
vadon	egan	Nan
vadász	ọdẹ	Nan
vadászat	ọdẹ	Nan
vagy	aimọkan kuro	Nan
vagyis	ti o jẹ,	Nan
vagyok	mo wa	Nan
vagyunk	a wà	Nan
vajda	voivod	Nan
vajon	boya	Nan
vak	afoju	Nan
vakkígyófélék	typhlopidae	Nan
valaha	lailai	Nan
valaki	ẹnikan	Nan
vallások	awọn ẹsin	Nan
vallásos	ẹlẹsin	Nan
vallást	ẹsin	Nan
varázslók	oṣó	Nan
vas	irin	Nan
vasi	alpine	Nan
vastag	nipọn	Nan
vasárnap	ọjọ sundee	Nan
vasárnapi	ọjọ sundee	Nan
vasérc	irin irin	Nan
vasút	reluwe	Nan
vasúti	reluwe	Nan
vasútvonal	laini ọkọ oju-irin	Nan
vasútvonalak	oju opopona	Nan
vasútállomás	ibudo ọkọ oju irin	Nan
vatikán	ilu vatican	Nan
vatikáni	ilu vatican	Nan
vegetáció	ewéko	Nan
varázsló	oluṣeto	Nan
varsói	warsaw	Nan
varsó	warsaw	Nan
varrás	ranko	Nan
vallású	ẹsin	Nan
való	sí	Nan
valóban	looto	Nan
valódi	gidi	Nan
valójában	ni pato	Nan
valós	gidi	Nan
valósult	imuse	Nan
vegyes	dapọ	Nan
valószínű	seese	Nan
valószínűséggel	seese	Nan
valóság	otito	Nan
valóságban	ni otito	Nan
valóságos	gidi	Nan
vane	vane	Nan
vannak	jẹ	Nan
varga	ṣamọni	Nan
valószínűleg	boya	Nan
zenéjét	orin	Nan
vezethető	isọdi	Nan
vezetnek	darí	Nan
visszaesett	kọ	Nan
visszatér	padà	Nan
visszatérni	láti padà	Nan
visszatért	pada wa	Nan
visszatértek	padà	Nan
visszatérve	padà	Nan
visszatérés	padà	Nan
visszatérése	padà	Nan
visszatérő	loorekoore	Nan
visszautasította	kọ	Nan
visszavonta	yorawonkuro	Nan
visszavonult	fẹyìntì	Nan
visszaélés	ilokulo	Nan
viszi	gba	None
viszont	sibẹsibẹ	Nan
vissza	sẹhin	Nan
viszony	ibatan	Nan
visnu	vishnu	Nan
viselte	ti wọ	Nan
vinci	vinci	Nan
vinni	mu	Nan
virginia	virginia	Nan
virtuális	foju	Nan
virtuóz	virtuoso	Nan
virág	òdòdó	Nan
virágzott	pọ	Nan
virágzó	itanna	Nan
visel	wọ	Nan
viseli	beari	Nan
viselkedik	huwa	Nan
viselkedés	ihuwasi	Nan
viselkedése	ihuwasi	Nan
viselkedését	ihuwasi	Nan
viselt	wọ	Nan
viselő	nso	None
viszonya	ibatan	Nan
viszonylag	jo	None
viszonylagos	ibatan	Nan
vizsgálata	àyẹ̀wò	Nan
vizsgálatok	awọn iwadii	Nan
vizsgálatot	iwadii	Nan
vizsgált	ayewo	Nan
vizsgálta	ayewo	Nan
vizsla	beari	Nan
vizuális	wiwo	Nan
vlagyimir	vladimir	Nan
vokális	t’ohun	Nan
voldemort	voldemort	Nan
volga	volga	Nan
volna	yoo	None
volt	folti	Nan
volta	iseda	Nan
voltak	wọn	None
vizsgálat	idanwo	Nan
vizet	omi	None
vizes	olomi	Nan
vizelethajtó	diuretic	Nan
viszonyok	ipo	None
viszonyt	ibatan	Nan
viszonyát	ibatan	Nan
viszonyítva	farawe si	Nan
vita	ijiroro	Nan
vitatott	idije	Nan
vitiligo	vitiligo	Nan
vincent	vincent	Nan
vitt	gbe	None
vitték	wọn	None
viták	àríyànjiyàn	Nan
vitákat	àríyànjiyàn	Nan
vitát	ijiroro	Nan
vitéz	ọgangan	Nan
vivaldi	vivaldi	Nan
vizek	omi	None
vitte	mu	Nan
vezeti	darí	Nan
vince	vince	Nan
világörökség	agbaye	None
vezérkar	ofin	None
vezérkari	oloye	None
vi	vi	Nan
via	nipasẹ	Nan
victor	segun	Nan
victoria	iṣẹgun	Nan
video	fidio	Nan
videó	fidio	Nan
videók	awọn fidio	Nan
vidrafűfélék	menyanthaceae	Nan
vidám	dun	None
vidék	orilẹ-ede	Nan
vidéke	ẹkùn	Nan
vidékeken	awọn agbegbe	Nan
vidéken	igberiko	None
vezére	oludari	Nan
vidéki	igberiko	None
vezér	darí	Nan
vezetők	awọn adari	Nan
vezetni	wakọ	Nan
vezette	ni ṣiṣi	Nan
vezettek	darí	Nan
vezették	ṣafihan	Nan
vezeték	okun waya	Nan
vezetés	iṣakoso	Nan
vezetése	oludari	Nan
vezetést	darí	Nan
vezetését	oludari	Nan
vezetésével	oludari	Nan
vezető	oludari	Nan
vezetői	iṣakoso	Nan
vezetőinek	awọn adari	Nan
vezetője	oludari	Nan
vezetőjét	oludari	Nan
vezényelte	o waiye	Nan
vidékén	igberiko	None
vietnam	vietnam	Nan
vietnami	ede	None
világháborút	agbaye	None
világhírű	agbaye	None
világi	alailesin	Nan
világon	agbaye	None
világos	ko	None
világosabb	tan imọlẹ	Nan
világossá	ko	None
világot	agbaye	None
világra	agbaye	None
világszerte	kariaye	Nan
világszervezet	araiye	Nan
világválság	ibanujẹ	Nan
világába	ileaye	Nan
világában	ileaye	Nan
világát	agbaye	None
világháborús	agbaye	None
világháborúban	agbaye	None
világháború	ogun	None
világegyetem	agbaye	None
vihar	ìjì	Nan
vii	vii	Nan
viii	viii	Nan
viktor	victor	None
villa	orita	Nan
villamos	itanna	Nan
vilmos	william	Nan
világörökségi	agbaye	None
világ	agbaye	None
világatlasz	agbaye	None
világbajnok	agbaye	None
világbajnoki	agbaye	None
világbajnokság	agbaye	None
világbajnokságon	world championship	Nan
világbajnokságot	agbaye	None
világban	agbaye	None
világa	agbaye	None
zenés	gaju ni	Nan
zenész	olorin	Nan
zenészek	awọn akọrin	Nan
évtizedek	ewadun	Nan
évtizedekben	ewadun	Nan
évtizeden	ewadun	Nan
évvel	ọdun	Nan
évében	ọdun	Nan
ës	ati	Nan
így	nitorinaa	Nan
ígéretet	ṣèlérí	Nan
ígért	ti ṣèlérí	Nan
ír	irish	Nan
írja	levin	Nan
írják	kọ	Nan
írnak	kọ	Nan
írni	kọ	Nan
írország	orile-ede ireland	Nan
évtizedben	ewadun	Nan
írott	kọ	Nan
évtized	ewadun	Nan
évszázadok	sehin	Nan
évekkel	ọdun	Nan
évekre	ọdun	Nan
évektől	siwaju	Nan
éven	ọdun	Nan
évenként	ododun	Nan
évente	ododun	Nan
éves	lododun	Nan
évesen	ori	None
évet	ọdun	Nan
évi	lododun	Nan
évig	ọdun	Nan
évre	ọdun	Nan
évről	ọdun	Nan
évszak	akoko	Nan
évszázad	orundun	Nan
évszázados	alailesin	Nan
írt	kọ	Nan
írta	kọ nipasẹ	Nan
írtak	kọ	Nan
ítélt	ẹjọ	Nan
ítélte	ẹjọ	Nan
ítélték	ẹjọ	Nan
ízben	aago	Nan
ízületi	articular	Nan
ó	oun	None
óceán	okun	Nan
óceáni	òkun	Nan
ókor	akọmalu	Nan
ókorban	ohun atijọ	Nan
ókori	atijọ	Nan
óra	wakati	Nan
óriás	omiran	Nan
óriási	omiran	Nan
órák	wakati	Nan
ítéletet	idajọ	Nan
ítélet	idajọ	Nan
írók	ko	None
írója	onkqwe	Nan
írták	kọ	Nan
írva	kọ	Nan
írás	kikọ	Nan
írása	kikọ	Nan
írásai	awọn ipese	Nan
írásban	ni kikọ	Nan
írásjegy	iwe kikọ	Nan
évekig	ọdun	Nan
írásjegyek	kikọ awọn ami	Nan
írásos	kikọ	Nan
írással	kikọ	Nan
írást	kikọ	Nan
írásában	kikọ	Nan
író	onkqwe	Nan
íródott	kọ	Nan
írói	onkqwe	Nan
írások	awọn iwe	Nan
órás	wakati	Nan
éveken	ọdun	Nan
évek	ọdun	Nan
értelmező	itumọ	Nan
értelmi	ọgbọn	Nan
értelmében	gẹgẹ bi	Nan
értesült	kọ ẹkọ	Nan
értett	gbọye	Nan
érthető	loye	Nan
értjük	tumọ	Nan
értéke	jẹ	Nan
értékek	awọn iye	Nan
értékeket	awọn iye	Nan
értékes	niyelori	Nan
értéket	iye	Nan
értékét	iye	Nan
értékű	iye	Nan
érvényben	ni ipa	Nan
értelmezése	oye	Nan
érvényes	wulo	Nan
értelmezés	itumọ	Nan
értelemben	ori	None
érintkezés	kan	None
érintő	kan	None
érkezett	dé	None
érkezik	wá	Nan
érkeznek	n bọ	Nan
érkeztek	dé	None
érkezése	dide	Nan
érkező	n bọ	Nan
érsek	archbishop	Nan
érseki	archbishop	Nan
ért	loye	Nan
érte	okunrin	None
értek	iye	Nan
értekezés	ikede	Nan
értelem	itumo	None
értelme	itumo	None
érvényesül	bori	Nan
érzelmek	ikunsinu	Nan
érzelmeket	awọn ẹdun	Nan
északról	ariwa	Nan
északvietnami	északvietnami	Nan
észre	akiyesi	Nan
észt	ede	None
észtország	estonia	Nan
étel	oúnjẹ	None
ételek	awọn ounjẹ	Nan
étterem	ile-ounjẹ	Nan
év	ọdun	Nan
éva	efa	Nan
évad	akoko	Nan
évadban	akoko	Nan
évben	ọdun	Nan
éve	ọdun	Nan
évei	ọdun	Nan
északra	ariwa	Nan
északon	ariwa	Nan
északnyugati	ariwa iwọ-oorun	Nan
északkorea	koria ile larubawa	Nan
érzelmi	ẹdun	Nan
érzett	ro	None
érzi	rilara	Nan
érzékeny	kókó	Nan
érzéki	ti oye	Nan
érzés	rilara	Nan
és	ati	Nan
években	ọdun	Nan
ész	wit	Nan
északamerika	amerika	None
északamerikai	amerika	None
északamerikában	ni north america	Nan
északdéli	ariwa-guusu	Nan
északi	ariwa	Nan
északiak	àríwá	Nan
északkeleti	àríwá	Nan
észak	ariwa	Nan
érinti	fọwọkan	Nan
órával	wakati	Nan
óvoda	ile-ẹkọ jẹle-ẹkọ	Nan
útját	ọnà	Nan
útközben	loju ọna	Nan
útnak	ọnà	Nan
úton	loju ọna	Nan
útra	lati	Nan
útvonal	ipa ọna	Nan
útvonalak	awọn ipa ọna	Nan
ügy	iṣowo	Nan
ügyben	bi o ba ṣẹlẹ pe	Nan
ügye	ni ọtun	Nan
ügyek	àlámọrí	Nan
ügyet	ọran	Nan
ügynök	aṣoju	Nan
ügyvéd	agbẹjọro	Nan
ügyében	ọran	Nan
útjára	ọnà	Nan
ült	joko	Nan
útján	nipasẹ	Nan
útikalauz	ajo	None
újlatin	ara ilu romania	Nan
újonnan	tuntun	None
újra	lẹẹkansi	Nan
újszerű	aramada	Nan
újság	iwe iroyin	Nan
újságok	iwe iroyin	Nan
újságíró	akọrohin	Nan
újságírók	awon oniroyin	Nan
újzéland	ilu niu silandii	Nan
újév	odun titun	Nan
ún	ti a pe	Nan
úr	ogbeni	Nan
úszó	omi	None
út	lu	Nan
úti	awọn ibi	Nan
útja	ọnà	Nan
ünnep	isinmi	Nan
ünnepe	àse	Nan
ünnepek	awọn isinmi	Nan
őrség	ṣọ	Nan
őrzi	ṣe itọju	Nan
őrzik	ni ifipamọ	Nan
őrült	irikuri	Nan
őse	baba	Nan
ősei	awọn baba	Nan
őshonos	abinibi	Nan
ősi	atijọ	Nan
ősszel	ni isubu	Nan
ősz	ewe	None
őszi	ewe	None
őt	marun	Nan
űrhajó	ọkọ ofurufu	Nan
űrhajós	aredumare	Nan
űrhajósok	awọn awòràwọ	Nan
őrnagy	maj.	Nan
őket	wọn	None
ők	o dara	Nan
ő	oun	None
ünnepelték	ṣe ayẹyẹ	Nan
ünneplik	ṣe ayẹyẹ	Nan
ünnepélyes	aigbagbọ	Nan
üres	ofo	Nan
ütemben	ije	None
ütközet	ogun	None
ütközetben	ogun	None
újkori	igbalode	Nan
ütközés	ikọlu	Nan
üvegházhatású	eefin	Nan
üzemanyag	epo	Nan
üzen	fi	None
üzenet	ifiranṣẹ	Nan
üzenetet	ifiranṣẹ	Nan
üzent	ogun	None
üzleti	iṣowo	Nan
ütközött	jamba	Nan
óta	niwon	Nan
újkor	tuntun	None
újból	lẹẹkansi	Nan
ördög	eṣu	Nan
öreg	atijọ	Nan
örmény	armenia	Nan
örvendett	gbadun	Nan
örök	ayeraye	Nan
örökké	lailai	Nan
örökre	lailai	Nan
örökség	ogún	Nan
öröksége	ogún	Nan
örökölte	jogun	None
örökös	ajogun	Nan
örököse	ajogun	Nan
örökösödési	aṣeyọri	Nan
örömmel	fi	None
ös	baba	Nan
önéletrajzi	itan ara ẹni	Nan
össze	papọ	Nan
önállóan	tirẹ	Nan
önmagát	t’okan	Nan
óvárosa	atijọ ilu	Nan
öböl	bay	Nan
öccse	kekere	None
ödön	odon	Nan
ökológiai	ilolupo	Nan
ömlik	ṣiṣan	Nan
ön	iwo	Nan
öngyilkos	igbẹmi ara ẹni	Nan
önkormányzat	igbimọ	Nan
önkormányzati	agbegbe ijoba	Nan
önkormányzatok	awọn ijọba	Nan
önként	tinútinú	Nan
önkéntes	atinuwa	Nan
önmaga	iho	Nan
önmagában	iho	Nan
önálló	olominira	Nan
összeesküvés	iditẹ	Nan
összefoglaló	gbogboogbo	Nan
összefüggés	o tọ	Nan
ötlet	imọran	Nan
ötlete	imọran	Nan
ötletet	awọn imọran	Nan
ötven	aadọta	Nan
ötéves	odun marun	Nan
ötödik	karun	None
övezet	agbegbe aago	Nan
özvegy	opó	Nan
úgy	iṣowo	Nan
úgyhogy	nitorinaa	Nan
úgynevezett	bẹ-ti a npe	Nan
új	tuntun	None
újabb	tuntun	None
újabban	laipẹ	Nan
újat	tuntun	None
öt	marun	Nan
ösztönözte	iwuri	Nan
összhangban	ni ibamu pẹlu	Nan
összeállított	kojọpọ	Nan
összefüggésbe	ti o ni ibatan	Nan
összefüggésben	o tọ	Nan
összefüggő	ti sopọ	Nan
összege	iye	Nan
összeget	aropọ	Nan
összehasonlítása	afiwe	Nan
összekötő	oluṣọkan	Nan
újjá	atunkọ	Nan
összeomlott	wó lulẹ	Nan
összes	gbogbo	Nan
összesen	lapapọ	Nan
összességében	lapapọ	Nan
összetett	eka	None
összetétel	tiwqn	Nan
összetétele	tiwqn	Nan
összetűzésbe	rogbodiyan	None
összeomlása	subu	Nan
utókor	iran iran	Nan
érintette	fowo	Nan
érik	pọn	Nan
állapotát	ipo	None
állat	ẹranko	Nan
állati	ẹranko	Nan
állatkert	zoo	Nan
állatok	ẹranko	Nan
állatokat	ẹranko	Nan
állatot	ẹranko	Nan
állattenyésztés	ibisi ẹran	Nan
állatvilág	fauna	Nan
állatvilága	fauna	Nan
állhat	boya	Nan
álljon	ti	Nan
állnak	jẹ	Nan
állni	duro	Nan
állomány	oṣiṣẹ	Nan
állapotot	ipinle	Nan
állomás	ibudo	Nan
állapotban	ni majemu	Nan
állapota	rẹ	None
államfő	olú ìlú	Nan
állami	ipinle	Nan
államnak	ipinle	Nan
államok	awọn ipinlẹ	Nan
államokat	awọn ipinlẹ	Nan
államokba	awọn ipinlẹ	Nan
államokban	awọn ipinlẹ	Nan
államokkal	awọn ipinlẹ	Nan
államoknak	awọn ipinlẹ	Nan
államot	ipinle	Nan
állampolgár	ara ilu	Nan
államszervezet	ipinle agbari	Nan
állandó	loorekoore	Nan
állandóan	nigbagbogbo	Nan
állapot	majemu	Nan
állapotba	ipinle	Nan
állomása	ibudo	Nan
állomásozó	ibudo	Nan
állott	stale	Nan
álmos	oorun	Nan
álnéven	ailorukọ	Nan
álom	àlá	Nan
által	nipasẹ	Nan
általi	nipasẹ	Nan
általuk	wọn	None
általában	nigbagbogbo	Nan
általános	gbogboogbo	Nan
általánosan	gbogbogbo	None
általánosságban	gbogbogbo	None
ám	sibẹsibẹ,	Nan
án	loju	Nan
ányos	iya-iya	Nan
április	kẹrin	None
áprilisban	kẹrin	None
álma	apu	Nan
álló	dúró	None
állítólagos	esun	Nan
állítólag	titẹnumọ	Nan
állt	duro	Nan
álltak	wọn	None
állás	iṣẹ	Nan
álláspont	ibi iduro	Nan
álláspontja	awari	None
állást	iṣẹ	Nan
állását	wiwa	Nan
államformája	fọọmu ti ijọba	Nan
állít	ṣeto	Nan
állítja	awọn ipinlẹ	Nan
állítják	beere	Nan
állított	ṣeto	Nan
állította	ṣalaye	Nan
állítottak	ti	Nan
állították	oun	None
állítása	tun	Nan
állítani	ṣeto	Nan
áprilisi	kẹrin	None
államforma	fọọmu ti ijọba	Nan
államban	ipinle	Nan
zárt	ni pipade	Nan
zárta	ni pipade	Nan
zárták	ni pipade	Nan
zárult	pari	Nan
zárva	ni pipade	Nan
záró	miiran ti	Nan
zárójelben	ni akomo	Nan
zászlaja	asia	Nan
zászló	asia	Nan
zászlós	faṣẹ si	Nan
zászlót	asia	Nan
zóna	agbegbe aago	Nan
zöld	ewe	None
zöldség	ewebe	Nan
zöme	pupọ ti	Nan
zu	zu	Nan
 	 	Nan
zsófia	sophie	Nan
zsuzsa	zsuzsa	Nan
zenét	orin	Nan
zeusz	zeus	Nan
zoltán	zoltán	Nan
zongora	duru	Nan
zongorára	duru	Nan
zrt	ltd.	Nan
zrínyi	zrinski	Nan
zseniális	o wuyi	Nan
zsidó	juu	Nan
zsidók	ju	Nan
zsidókat	ju	Nan
zsidóság	ẹsin juu	Nan
zsigmond	sigismund	Nan
zsinagóga	sínágọ́gù	Nan
zsolt	awọn orin	Nan
zsuzsanna	zsuzsanna	Nan
cm	cm	Nan
kg	kg	Nan
km	km	Nan
ága	ẹka	Nan
ágai	awọn ẹka	Nan
ágazatok	awọn apa	Nan
ágnes	ágnes	Nan
ágon	ẹka	Nan
ágost	orile-ede	Nan
ágoston	augustine	Nan
áldozat	rúbọ	Nan
áldozata	olufaragba	Nan
áldozatai	olufaragba	Nan
áldozatok	olufaragba	Nan
áldozatot	njiya	Nan
áll	duro	Nan
állam	ipinle	Nan
állama	awọn ipinlẹ	Nan
ág	ẹka	Nan
ádám	adam	Nan
ábécé	abidi	None
ábrázoló	aṣoju	Nan
kmes	awọn ọrọ	Nan
kmre	km kuro	Nan
km²	km²	Nan
mg	miligiramu	Nan
mm	mm	Nan
km	km	Nan
°c	° c	Nan
állambeli	ipinle	Nan
§	§	Nan
×	×	Nan
á	awọn	Nan
ábrázolja	fihan	None
ábrázolják	aṣoju	Nan
ábrázolt	ṣàpèjúwe	Nan
ábrázolták	ṣafihan	Nan
ábrázolása	oniduro	Nan
°	° °	Nan
érintett	fowo	Nan
ár	owo	Nan
áram	lọwọlọwọ	Nan
énekesek	awọn akọrin	Nan
énekesnő	akorin	Nan
épp	bayi	None
éppen	kan	None
éppúgy	pelu	Nan
építeni	kọ	Nan
épített	itumọ	Nan
építette	itumọ	Nan
építettek	wọn	None
építették	wọn	None
építkezés	ikole	Nan
építmény	edifice	Nan
építtetett	itumọ	Nan
építés	ikole	Nan
építése	ikole ti	Nan
énekes	akorin	Nan
építési	ikole	Nan
énekelt	kọrin	Nan
ének	orin	Nan
élt	gbé	None
élte	gbé	None
éltek	gbe	None
élve	laaye	Nan
élvezte	gbadun	Nan
élén	ni ṣiṣi	Nan
élénk	iwunlere	Nan
élére	ori	None
élüszion	élüszion	Nan
élő	wa laaye	Nan
élők	eniyan	Nan
élőlény	ngbe laaye	Nan
élőlények	awọn ẹda	Nan
élővilág	egan	Nan
én	emi	Nan
énekel	kọrin	Nan
építész	ayaworan	Nan
építészek	awọn ayaworan ile	Nan
építészet	faaji	Nan
érdekessége	iwariiri	Nan
érdekességek	awọn ikede	Nan
érdeklődés	iwulo	None
érdeklődése	iwulo	None
érdeklődést	iwulo	None
érdeklődését	iwulo	None
érdeklődött	beere	Nan
érdekében	sí	Nan
érdemi	ti o nilari	Nan
érdemrend	anfani	Nan
érett	pọn	Nan
érettségizett	matriculated	Nan
érezte	rilara	Nan
érhető	wa	Nan
éri	tọ	Nan
érdekesség	iwariiri	Nan
érdekes	awon	Nan
érdekelte	nife	Nan
érdekeit	nifesi	Nan
építészeti	ayaworan	Nan
építésének	ikole	Nan
építését	ikole	Nan
épül	kọ	Nan
épület	ile	Nan
épületben	ile	Nan
épülete	ile	Nan
élni	gbe	None
épületei	awọn ile	Nan
épületet	ile	Nan
épületében	ile	Nan
épülnek	wọn	None
épült	itumọ	Nan
épültek	wọn	None
épülő	da	None
ér	iṣọn	Nan
épületek	awọn ile	Nan
ára	owo	Nan
élnek	gbe	None
életünk	awọn aye wa	Nan
átlagos	aropin	Nan
átlagosan	lori apapọ	Nan
átmeneti	fun	None
átmenetileg	fun	None
átmérője	opin	Nan
átszámítás	recalculation	Nan
áttörést	itusilẹ	Nan
átvett	gba	None
átvette	mu	Nan
átvették	mu	Nan
ázsia	esia	None
ázsiai	esia	None
ázsiában	esia	None
édes	adun	Nan
édesanyja	iya	Nan
átlaghőmérséklet	otutu	None
édesapja	baba	Nan
átlag	aropin	Nan
átdolgozta	tunwo	Nan
áron	owo	Nan
árpád	árpád	Nan
árpádházi	árpád	Nan
árpádsávos	àpótí	Nan
áruk	ẹru	Nan
árvíz	omi	None
árán	inawo	Nan
ás	ma wà	Nan
ásványi	alumọni	Nan
át	nipasẹ	Nan
átadja	gba	None
átadott	silẹ	Nan
átadta	fi	None
átalakult	yipada	None
átalakulás	iyipada	Nan
átfogó	okeerẹ	Nan
ég	ọrun	Nan
éghajlat	afefe	Nan
éghajlata	afefe	Nan
életet	igbesi aye	Nan
életmód	ọna igbesi aye	Nan
életmódot	igbesi aye	Nan
életrajz	isedale	Nan
életrajza	itan igbesiaye	Nan
életrajzi	biographical	Nan
életre	si igbesi aye	Nan
élettartam	igbesi aye	Nan
élettartama	igbesi aye	Nan
életében	rẹ	None
életének	rẹ	None
életére	laaye	Nan
életéről	igbesi aye	Nan
életét	igbesi aye	Nan
életüket	aye won	Nan
életem	igbesi aye mi	Nan
élete	rẹ	None
életben	laaye	Nan
életbe	ipa	Nan
éghajlati	afefe	Nan
égi	ti ọrun	Nan
égitest	awọn ara ọrun	Nan
égitestek	awọn orbs	Nan
éj	alẹ	Nan
éjjel	alẹ	Nan
éjszaka	alẹ	Nan
életű	igbasilẹ	Nan
éjszakai	moju	Nan
élelmiszer	oúnjẹ	None
élelmiszerek	oúnjẹ	None
élelmiszeripari	oúnjẹ	None
élen	oludari	Nan
éles	didasilẹ	Nan
élesen	ndinku	Nan
élet	igbesi aye	Nan
él	wa laaye	Nan
utódja	agbapo	Nan
utódai	arọpo	Nan
utóda	agbapo	Nan
születéskor	ibi	Nan
születésnapja	ojo	None
születésének	ibi	Nan
születésű	bi	Nan
szülés	ọmọ	None
szülőháza	ibi ibi	Nan
szülők	awọn obi	Nan
szünet	sinmi	Nan
szürke	grẹy	Nan
szürkület	ikún	None
szőke	bilondi	Nan
szőlő	adashe	Nan
szőlőrigó	atunkọ	Nan
szűk	dín	Nan
szűkebb	dín	Nan
születési	ibi	Nan
szűnt	parẹ	Nan
születésekor	ibi	Nan
születés	ibi	Nan
szövetsége	igbimọ	Nan
szövetséges	ore	Nan
szövetségesek	allies	Nan
szövetséget	alliance	Nan
szövetségi	federal	Nan
szúnyogkapófélék	panini	Nan
szükség	nilo	Nan
szüksége	nilo	Nan
szükséges	beere	Nan
szükségessé	pataki	Nan
szül	jẹri	Nan
szülei	awọn obi	Nan
született	bi	Nan
születik	a bi	Nan
születtek	bi	Nan
születése	ibi	Nan
szűz	wundia	Nan
sámuel	sámúẹ́lì	Nan
sándor	alaapọn	Nan
sóska	sorrel	Nan
sör	kana	Nan
sörök	ori	None
sötét	dudu	Nan
sötétebb	ṣokunkun	Nan
sötétség	okunkun	None
sújtotta	lu	Nan
súlya	rẹ	None
súlyos	to	None
súlyosabb	to	None
súlyosan	wuwo	Nan
sült	rosoti	Nan
sőt	pẹlupẹlu	Nan
sűrű	ipon	Nan
sűrűn	iwuwo	Nan
sós	sos	Nan
sólyom	falcon	Nan
sírja	ibojì	None
sírfelirat	eefun	Nan
sándorral	sandor	Nan
sándort	sandor	Nan
sárga	odo	Nan
sárkány	dragoni	Nan
sátán	satani	Nan
sáv	acid	Nan
são	ãò	Nan
szövetség	majẹmu	Nan
séf	oluwanje	Nan
sérülése	ipalara	Nan
sérülések	nosi	Nan
sérüléseket	nosi	Nan
síita	shiite	Nan
sík	alapin	Nan
síkság	pẹtẹlẹ	Nan
síremléke	ibojì	None
sérült	farapa	Nan
sűrűség	iwuwo	Nan
szövegét	ọrọ naa	Nan
szöveget	ọrọ	Nan
szépirodalmi	itan-akọọlẹ	Nan
szépirodalom	litireso	Nan
szépművészeti	itanran aworan	Nan
szépség	ẹwa	Nan
szét	yato si	Nan
szín	awọ	Nan
színben	awọn awọ	Nan
színe	awọ	Nan
színeiben	awọn awọ	Nan
színek	awọn awọ	Nan
színeket	awọn awọ	Nan
színes	awọ	Nan
színhelye	ibi isere naa	Nan
színház	itage	Nan
színházak	imiran	Nan
szép	lẹwa	Nan
színházban	itage	Nan
széndioxid	erogba oloro	Nan
szélén	selenium	Nan
székelyföldön	ilẹ	None
székelymagyar	hongari szekely	Nan
székelység	székely	Nan
székesegyház	katidira	Nan
székesegyházban	katidira	Nan
székesfehérvár	székesfehérvár	Nan
székhely	ijoko	Nan
székhelye	olú	Nan
szél	afẹfẹ	Nan
széles	gbooro	Nan
szélesebb	fẹẹrẹ	Nan
szélessége	ibú	Nan
szélességi	fifẹ	Nan
szélső	awọn iwọn	Nan
szélsőséges	ajagun	None
szén	eedu	Nan
színházi	tiata	Nan
színmű	színmű	Nan
színpadi	tiata	Nan
szól	sọrọ	Nan
szólal	ìró	None
szólnak	sọrọ	Nan
szólt	ti asọye	Nan
szólította	pípè	Nan
szóló	adashe	Nan
szórakoztató	idanilaraya	Nan
szót	ọrọ	Nan
szótár	iwe itumọ	Nan
szótárak	itumo	None
szóval	nitorinaa	Nan
szög	igun	Nan
szörnyű	oburewa	Nan
szöveg	ọrọ	Nan
szövege	ọrọ naa	Nan
szójegyzék	iwe afọwọkọ	Nan
szócikkek	nkan	None
szócikk	nkan	None
szóból	náà	None
színpadon	ipele	None
színpadra	ipele	None
színre	awọ	Nan
színt	ipele	None
színvonalú	didara	Nan
színész	oṣere	Nan
színészek	olukopa	Nan
szövegkönyvet	awọn iwe ọrọ	Nan
színészi	arápùpù	Nan
színű	awọ	Nan
szív	obi	Nan
szíve	obi	Nan
szívesen	tinútinú	Nan
szó	hun	None
szóba	yara	Nan
szóban	ẹnu	Nan
színésznő	oṣere	Nan
székelyföldi	székelyföld	Nan
sűrűsége	iwuwo	Nan
tagja	ọmọ	None
tartozik	jẹ ti	Nan
tartoznak	jẹ	Nan
tartozott	o jẹ ti	Nan
tartoztak	wọn	None
tartozó	fun	None
tartva	tọju	Nan
tartása	tọju	Nan
tartó	dimu	Nan
tartós	tọ	Nan
tartózkodott	dúró	None
tartózkodása	dúró	None
tartózkodó	olugbe	Nan
tatár	jábánì	Nan
tatárjárás	ajagun	None
tatárok	tatars	Nan
tartották	oun	None
tava	adagun	Nan
tartottak	waye	Nan
tartott	waye	Nan
tartalmazta	ninu	Nan
tartalmazza	to	None
tartalmazzák	ni	Nan
tartalmazó	pẹlu	Nan
tartalmú	akoonu	Nan
tartalom	akoonu	Nan
tartanak	wa ni waye	Nan
tartani	tọju	Nan
tartja	dimu	Nan
tartják	ṣakiyesi	Nan
tartomány	igberiko	None
tartományban	igberiko	None
tartományi	igberiko	None
tartományok	agbegbe	Nan
tartományt	igberiko	None
tartotta	waye	Nan
tavak	adagun	Nan
tavasszal	omi	None
tavasz	omi	None
tekintenek	ṣakiyesi	Nan
tekinteni	kasi	Nan
tekintetben	ọwọ	Nan
tekintett	ṣakiyesi	Nan
tekintette	ṣakiyesi	Nan
tekintettel	iwo	Nan
tekintették	ṣakiyesi	Nan
tekintetében	pẹlú ọwọ	Nan
tekinthető	jẹ gbero	Nan
tekinthetők	jẹ gbero	Nan
tekinti	ronu	Nan
tekintik	ṣakiyesi	Nan
tekintve	nronu	Nan
tekintélyes	olokiki	Nan
tele	kun	Nan
tekint	wo	Nan
tekercs	okun	Nan
tej	wara	Nan
tehát	nitorinaa	Nan
tavaszi	omi	None
taylor	taylor	Nan
te	iwo	Nan
tea	tii	Nan
teatro	teatro	Nan
technika	ilana	None
technikai	imọ ẹrọ	Nan
tartalmazott	ninu	Nan
technikák	awọn imuposi	Nan
technológia	imọ-ẹrọ	Nan
technológiai	imọ-ẹrọ	Nan
ted	ted	Nan
tegye	ṣe	Nan
tehetséges	ẹbun	Nan
tehetségét	ẹbun	Nan
tehető	wa ni waye	Nan
technikát	ilana	None
tag	gbooro	Nan
tartalmaznak	ni	Nan
tartalma	awọn akoonu	Nan
találhatóak	nipa	Nan
találhatók	ri	Nan
találja	nwa	None
találják	wa	Nan
találkozhatunk	le	None
találkozik	wa kọja	Nan
találkozott	pàdé	Nan
találkoztak	wọn	None
találkozó	ipade	Nan
találnak	wa	Nan
találni	lati wa	Nan
talált	ri	Nan
találta	ri	Nan
találtak	ri	Nan
találták	ri	Nan
található	ninu	Nan
találunk	wa	Nan
találhatunk	ri	Nan
tallium	thallium	Nan
tagjai	ọmọ	None
tagjainak	ọmọ	None
tagjait	ọmọ	None
tagjaként	kan	None
tagjának	ọmọ	None
tagját	ọmọ	None
tagjává	ọmọ	None
tagok	ọmọ	None
tagolt	sọrọ	Nan
tagállamok	egbe	None
tajvan	taiwan	Nan
taktikai	ọgbọn	Nan
takács	òwú	Nan
talaj	ile	Nan
talajon	ilẹ	None
talál	wa	Nan
talán	boya	Nan
tamás	thomas	Nan
tanait	awọn tẹnisi	Nan
tanított	kọ	Nan
tanította	kọ	Nan
tanítványa	ọmọ	None
tanítványai	omo ile	Nan
tanítás	nkọ́ni	Nan
tanítása	nkọ́ni	Nan
tanúi	ẹlẹri	Nan
tanúsága	ṣafihan	Nan
tanúsított	ifọwọsi	Nan
tapasztalat	iriri	Nan
tapasztalatok	awọn iriri	Nan
tapasztalható	kari	Nan
tapasztalt	kari	Nan
tarantino	tarantino	Nan
tart	dimu	Nan
tanári	nkọ́ni	Nan
tanára	alamọdaju	Nan
tanár	olukọ	Nan
tanácsok	awọn imọran	Nan
tandíj	owo ileiwe	Nan
tangarafélék	kekere	None
tankönyvkiadó	akede iwe	Nan
tanulmány	iwadi	None
tanulmányai	awọn ijinlẹ	Nan
tanulmányait	awọn ijinlẹ	Nan
tanulmányok	awọn ijinlẹ	Nan
tartalmaz	ni	Nan
tanulmányozta	iwadi	None
tanulni	lati kọ ẹkọ	Nan
tanult	kọ ẹkọ	Nan
tanuló	akẹẹkọ	Nan
tanács	imọran	Nan
tanácsa	igbimọ	Nan
tanácsadó	oludamoran	Nan
tanácsköztársaság	ara ilu soviet	Nan
tanulmányozása	keko	None
telefon	foonu	Nan
székelyföld	ilẹ	None
székely	szekely	Nan
szerkezetet	be	Nan
szerkezeti	igbekale	Nan
szerkezetű	be	Nan
szerszám	irinse	Nan
szert	jere	Nan
szerte	yika	Nan
szerv	ara	Nan
szerva	sìn	Nan
szerve	awọn ara	Nan
szervek	awọn ara	Nan
szerves	organic	Nan
szervez	ṣeto	Nan
szervezet	agbari	Nan
szervezetben	ara	Nan
szervezete	agbari	Nan
szerkezete	be	Nan
szervezetek	ajo	None
szerkezet	be	Nan
szerkesztője	olootu	Nan
szerette	fẹràn	Nan
szerették	fẹràn	Nan
szerez	jere	Nan
szerezni	gba	None
szerezte	bori	Nan
szereztek	gba	None
szerint	nipasẹ	Nan
szerinte	gẹgẹ bi tirẹ	Nan
szerinti	ti	Nan
szerintük	ronu	Nan
szerk	ṣatunkọ	Nan
szerkesztett	ko	None
szerkesztette	satunkọ	Nan
szerkesztő	olootu	Nan
szerkesztői	olootu	Nan
szerkesztők	awọn olootu	Nan
szervezetet	ajo	None
szervezeti	ilana	None
szervezett	ṣeto	Nan
szezonban	akoko	Nan
szezont	akoko	Nan
szibériai	siberian	Nan
szicíliai	siciliisi	Nan
sziget	erekusu	Nan
szigete	erekusu	Nan
szigetei	erekusu	Nan
szigetek	awọn erekusu	Nan
szigeten	erekusu	Nan
szigetet	erekusu	Nan
szigeti	aṣiri	Nan
szigetre	erekusu	Nan
szigetén	erekusu	Nan
szigetét	erekusu ti	Nan
szigorú	muna	Nan
szezon	akoko	Nan
szexuális	ibalopọ	Nan
szexualitás	ibalopọ	Nan
szex	ibalopọ	Nan
szervezte	ṣeto	Nan
szerveztek	ṣeto	Nan
szervezésében	ṣeto nipasẹ	Nan
szerzetes	araye	Nan
szerzetesek	monks	Nan
szerzett	ipasẹ	Nan
szerző	onkọwe	Nan
szeretné	fẹ	Nan
szerződés	àdéhùn	Nan
szerződést	siwe	Nan
szerzői	onkọwe	Nan
szerzője	onkọwe	Nan
szerzők	awọn onkọwe	Nan
szeráf	serafu	Nan
szerény	iwọntunwọnsi	Nan
szetter	oniwasu	Nan
szerződésben	àdéhùn	Nan
szigorúan	ṣofintoto	Nan
szeretne	yoo	None
szeretet	ni ife	Nan
szempontjából	irisi	None
szemében	oju	Nan
személy	eniyan	Nan
személye	ti a nṣe	Nan
személyek	eniyan	Nan
személyes	ti ara ẹni	Nan
személyesen	tikalararẹ	Nan
személyi	ti ara ẹni	Nan
személyiség	eniyan	Nan
személyisége	eniyan	Nan
személyzet	oṣiṣẹ	Nan
személyében	eniyan ti	Nan
személyét	eniyan ti	Nan
szent	mimọ	Nan
szentek	awon eniyan mimo	Nan
szempontból	irisi	None
szentelt	mimọ	Nan
szempont	iwo	Nan
szemle	atunyẹwo	Nan
szektor	eka	None
szekunder	atẹle	Nan
szelek	efuufu	Nan
szelekció	yiyan	Nan
szellem	ẹmi	Nan
szelleme	ẹmi	Nan
szellemi	ọgbọn	Nan
szelén	selenium	Nan
szem	oju	Nan
szembe	oju	Nan
szemben	idakeji	Nan
szembeni	lodi si	Nan
szeme	rẹ	None
szemere	szemere	Nan
szemközti	idakeji	Nan
szemmel	oju	Nan
szentgyörgyi	szentgyörgy	Nan
szenved	jiya	Nan
szenvedett	jiya	Nan
szerepel	ninu	Nan
szerepelnek	to	None
szerepelt	ifihan	Nan
szerepet	ipa	Nan
szerephez	ipa	Nan
szereplő	ninu	Nan
szereplői	olukopa	Nan
szereplője	oṣere	Nan
szereplők	olukopa	Nan
szereplőt	olukopa	Nan
szerepében	ipa ti	Nan
szerepére	ipa ti	Nan
szerepét	ipa	Nan
szerepük	ipa	Nan
szeret	ni ife	Nan
szerepe	rẹ	None
szerep	ipa	Nan
szerencsés	oriire	None
szerencsére	fun	None
szenvedtek	jiya	Nan
szenvedés	ibanujẹ	Nan
szenvedő	ijiya	Nan
szenátus	alagba	Nan
szeptember	oṣu kẹsan	Nan
szeptemberben	ni oṣu kẹsan	Nan
szer	aṣoju	Nan
szereti	fẹràn	Nan
szerb	serbian	Nan
szerbia	serbia	Nan
szerbiában	serbia	Nan
szerbül	serbian	Nan
szerelem	ni ife	Nan
szerelme	rẹ	None
szerelmes	ni ife	Nan
szerelmi	amily	Nan
szerbek	awọn iṣẹ	Nan
székelyek	szekely	Nan
szilveszter	ojo	None
szilárd	líle	Nan
száma	nọmba	Nan
számban	nọmba	Nan
számmal	nọmba	Nan
számok	awọn nọmba	Nan
számokat	isiro	Nan
számolt	royin	Nan
számon	rara.	Nan
számos	lọpọlọpọ	Nan
számot	nọmba	Nan
számottevő	akude	Nan
számtalan	ainiye	Nan
számuk	wọn	None
számukra	wọn	None
számvitel	iṣiro	Nan
számában	àtúnse	Nan
szám	orin	Nan
számának	nọmba	Nan
szálló	hotẹẹli	Nan
szállították	gbigbe	Nan
szovjetek	soviets	Nan
szovjetunió	igbimo sofieti	Nan
szovjetunióban	ussr	Nan
sztálin	stalinism	Nan
szubjektív	alaye	Nan
szultán	sultan	Nan
szumátra	sumatra	Nan
szurkolói	awọn olufowosi	Nan
szurkolók	awọn ika ọwọ rekoja	Nan
szájpad	aafin	Nan
szálasi	szálasi	Nan
száll	fò	Nan
szállt	gbe	None
szálltak	gbe	None
szállított	pese	Nan
szállító	olutaja	Nan
számára	fun	None
számát	nọmba	Nan
számít	ṣe iṣiro	Nan
szárazföldön	ilẹ	None
származik	pilẹṣẹ	Nan
származnak	wa lati	Nan
származott	wa lati	Nan
származása	oti	Nan
származású	idile	Nan
származó	deri	Nan
szász	saxon	Nan
száz	ọgọrun	Nan
század	orundun	Nan
században	orundun	Nan
századforduló	tan ti awọn orundun	Nan
századi	orundun	Nan
százezer	lakh	Nan
széchenyi	széchenyi	Nan
szárazföldi	ilẹ	None
szárazföld	ilẹ	None
száraz	gbẹ	Nan
szántó	ṣagbe	Nan
számítanak	ka	Nan
számítani	ṣe iṣiro	Nan
számított	iṣiro	Nan
számítottak	o ti ṣe yẹ	Nan
számítva	kika	Nan
számító	iṣiro	Nan
számítógép	kọmputa	Nan
szovjet	rosia	Nan
számítógépek	awọn kọmputa	Nan
számú	rara.	Nan
szándéka	ero	Nan
szándékos	mọọmọ	Nan
szándékosan	mọọmọ	Nan
szánt	ti a pinnu	Nan
szánta	ti a pinnu	Nan
szánták	ti a pinnu	Nan
számítógépes	kọmputa	Nan
szilágyi	szilágyi	Nan
szorult	fẹẹrẹ	Nan
szorosan	sunmọ	Nan
szlovákiai	slovakia	Nan
szlovákiában	ni ilu slovakia	Nan
szlovákok	slovaks	Nan
szlovén	ede	None
szlovénia	slovenia	Nan
szláv	slavic	Nan
szlávok	awọn slav	Nan
szobor	ere	Nan
szobra	ere	Nan
szobrok	awọn ere	Nan
szobrot	ere	Nan
szobrász	ere	Nan
szobrászat	ere	Nan
szobrászművész	ere	Nan
szobrát	ere	Nan
szlovákia	slovakia	Nan
szocialista	alamọdaju	Nan
szlovák	ede	None
szinusz	oniye	Nan
szimbolikus	apẹẹrẹ	Nan
szimbólum	aami	Nan
szimbóluma	aami	Nan
szimfonikus	aanu	None
szimfónia	aanu	None
szinkronhangja	ohun naa	Nan
szinkronizálva	muuṣiṣẹpọ	Nan
szint	ipele	None
szinte	fẹẹrẹ	Nan
szinten	tun	Nan
szintje	ipele	None
szintjén	ipele	None
szintre	ipele	None
szintén	tun	Nan
szintű	ipele	None
szkandium	iruju	Nan
szocializmus	ọrọ ajumọṣe	Nan
szociológia	sociology	Nan
szociológiai	socioloji	Nan
szolgáltatások	awọn iṣẹ	Nan
szolgáltató	olupese	Nan
szolgáló	sìn	Nan
szolnok	szolnok	Nan
szolnoki	szolnok	Nan
szolnokon	szolnok	Nan
szombathely	szombathely	Nan
szombathelyi	szombathely	Nan
szomorú	ibanujẹ	Nan
szomszéd	aládùúgbò	Nan
szomszédos	nitosi	None
szomszédságában	adugbo	Nan
szonda	wadi	Nan
szor	irun	Nan
szoros	fẹẹrẹ	Nan
szolgáltatás	iṣẹ	Nan
szolgáltak	yoo	None
szolgált	yoo	None
szolgálnak	sìn	Nan
szociáldemokrata	ijọba tiwantiwa	Nan
szociális	lawujọ	Nan
szoftver	sọfitiwia	Nan
szoftverek	sọfitiwia	Nan
szokatlan	dani	None
szokott	o lo	Nan
szokták	lo lati	Nan
szorul	fẹẹrẹ	Nan
szokás	ihuwasi	Nan
szokásos	tẹlẹ	Nan
szolgál	sìn	Nan
szolgálat	iṣẹ	Nan
szolgálati	oṣiṣẹ	Nan
szolgálatot	iṣẹ	Nan
szolgálatában	iṣẹ ti	Nan
szolgálja	sìn	Nan
szokások	isesi	Nan
legsűrűbben	julọ iwuwo	Nan
telek	pupo	Nan
telepedett	yanju	Nan
több	diẹ sii	Nan
többek	pẹlu	Nan
többen	diẹ sii	Nan
többes	lọpọlọpọ	Nan
többet	diẹ sii	Nan
többféle	lọpọlọpọ	Nan
többi	omiiran	Nan
többiek	awọn miiran	Nan
többnyire	okeene	Nan
többször	leralera	Nan
többszörös	lọpọlọpọ	Nan
többség	poju	Nan
többségben	awọn poju	Nan
többsége	pupọ	Nan
többségi	poju	Nan
tóth	éù	Nan
többségét	ni opolopo ti	Nan
tól	lati	Nan
tízes	ayalegbe	Nan
tért	padà	Nan
tértek	padà	Nan
tétel	nkan	None
tétele	sise	None
téve	ràkúnmí	Nan
téves	èké	Nan
tévesen	aṣiṣe	Nan
tífusz	ẹwẹ-inu	Nan
típus	oriṣi	Nan
típusa	oriṣi	Nan
típusai	awọn oriṣi	Nan
típusok	awọn oriṣi	Nan
típust	awọn oriṣi	Nan
típusú	oriṣi	Nan
tíz	mẹwa	Nan
tó	adagun	Nan
többségük	wọn	None
többé	eyikeyi diẹ sii	Nan
többékevésbé	tabi	None
tör	fọ	Nan
törekedett	wá	Nan
törekvés	lepa	Nan
törekvések	aspirations	Nan
törpe	arara	Nan
tört	fifọ	Nan
törtek	fifọ	Nan
történelem	itan	Nan
történelemben	itan	Nan
történelme	itan	Nan
történelmet	itan	Nan
történelmi	itan	Nan
történet	itan	Nan
történetben	itan	Nan
története	itan	Nan
tömegű	iwuwo	Nan
tömegének	iwuwo	Nan
tömegközlekedési	ọkọ irinna	Nan
tömegközlekedés	ọkọ irinna	Nan
tökéletes	pipe	Nan
tökéletesen	pipe	Nan
tölt	agbara	None
töltenek	na	Nan
tölti	na	Nan
töltik	na	Nan
töltött	agbara	None
térségében	ẹkùn	Nan
töltötte	lo	Nan
töltötték	wọn	None
tömb	dina	Nan
tömeg	ogunlọgọ	Nan
tömege	iwuwo	Nan
tömegek	ọpọ eniyan	Nan
tömeges	lowo	Nan
tömegesen	ifọwọra	Nan
töltöttek	wọn	None
történetek	awọn itan	Nan
térségben	ẹkùn	Nan
térképek	maapu	None
tárgyalt	idunadura	Nan
tárgyalások	idunadura	Nan
tárgyalásokat	idunadura	Nan
tárgyat	nkan	None
tárgyeset	ẹsun	Nan
tárgyát	koko	Nan
tárgyú	ofin	None
társa	ẹlẹgbẹ	Nan
társadalmi	lawujọ	Nan
társadalom	awujọ	Nan
társadalomban	awujọ	Nan
társai	awọn ẹlomiran	Nan
társas	gregarious	Nan
társaság	ile-iṣẹ	Nan
társasági	ajọ	Nan
tárgyakat	nkan	None
társaságában	ile-iṣẹ	Nan
tárgyak	ohun	Nan
tárgy	nnkan	Nan
támogatják	atilẹyin	Nan
támogatott	atilẹyin	Nan
támogatta	atilẹyin	Nan
támogatták	atilẹyin	Nan
támogatás	iranlowo	Nan
támogatása	atilẹyin	Nan
támogatással	atilẹyin	Nan
támogatást	atilẹyin	Nan
támogatására	atilẹyin	Nan
támogatását	atilẹyin	Nan
támogatásával	atilẹyin	Nan
támogató	ni atilẹyin	Nan
támogatói	awọn olufowosi	Nan
tánc	jó	Nan
táplálék	ounjẹ	Nan
tárgya	nnkan	Nan
társulat	ile-iṣẹ	Nan
társult	nkan	None
távol	jinna	Nan
témákat	awọn akọle	Nan
témát	akori	Nan
tény	o daju	Nan
tények	ododo	None
tényező	ifosiwewe	Nan
tényezők	awọn okunfa	Nan
tényleg	nitootọ	Nan
tényleges	gangan	Nan
ténylegesen	de facto	Nan
tér	aaye	Nan
térben	lẹhin	Nan
téren	lori square	Nan
téri	odo	Nan
térkép	maapu	None
térképe	maapu	None
témák	awọn akori	Nan
témájú	tiwon	Nan
témája	akori	Nan
témában	ninu akọle	Nan
távolabb	nitosi	None
távolabbi	siwaju	Nan
távoli	latọna jijin	Nan
távolság	jinna	Nan
távolsági	gigun	Nan
távolságra	lati	Nan
távon	igba	Nan
térség	ẹkùn	Nan
távozik	ori	None
távozása	ilọkuro	Nan
távú	igba	Nan
téglatest	kuboidi	Nan
tél	otutu	None
télen	otutu	None
téli	otutu	None
téma	koko	Nan
távozott	kuro	Nan
támogatja	lati ṣe atilẹyin	Nan
történeteket	awọn itan	Nan
történeti	itan	Nan
unokaöccse	ọmọ	None
unokája	ọmọ-ọmọ	Nan
up	sókè	Nan
ura	oluwa	Nan
urahara	urahara	Nan
uralkodik	jọba roost	Nan
uralkodott	o jọba	Nan
uralkodása	jọba	Nan
uralkodásának	jọba	Nan
uralkodó	ṣàkóso	Nan
uralkodói	regal	Nan
uralkodója	adarí	Nan
uralkodók	awọn alaṣẹ	Nan
uralma	jọba	Nan
uralmát	ṣàkóso	Nan
uniós	euroopu	Nan
uralom	ṣàkóso	Nan
unióhoz	apapọ	Nan
univerzum	agbaye	None
ugyanígy	ni ọna kanna	Nan
ugyanúgy	pelu	Nan
ukrajna	yukirenia	Nan
ukrán	yukirenia	Nan
ulrich	ọra	Nan
ulászló	ulászló	Nan
un	un	Nan
und	ati be be lo	Nan
under	tẹnumọ	Nan
underground	ipamo	Nan
unesco	unesco	Nan
unit	ẹyọkan	Nan
united	isọdọkan	Nan
unitárius	aanu	None
university	yunifasiti	Nan
unió	apapọ	Nan
uralta	jẹ gaba lori	Nan
urán	kẹmika	Nan
uránusz	uranu	Nan
utazó	irin-ajo	Nan
utca	opopona	Nan
utcai	opopona	Nan
utcában	loju ọna	Nan
utcák	ita	Nan
utcán	loju ọna	Nan
utoljára	fun	None
utolsó	kẹhin	Nan
után	lẹhin	Nan
utána	lẹhin	Nan
utáni	ifiweranṣẹ	Nan
utóbb	nigbamii	Nan
utóbbi	igbeyin	Nan
utóbbiak	ikeji	Nan
utóbbit	ikeji	Nan
utazást	irin-ajo	Nan
utazás	irin-ajo	Nan
utaztak	ajo	None
utazott	ajo	None
usa	amẹrika	Nan
usaban	usa	Nan
usb	usb	Nan
uss	us	Nan
utak	opopona	Nan
utal	korira	Nan
utalnak	ṣafihan	Nan
ugyanolyan	iru kanna	Nan
utalt	korira	Nan
utalás	itọkasi	Nan
utaló	ti o ni ibatan	Nan
utasította	kọ	Nan
utasítás	ilana	None
utasítást	ilana	None
utat	ọna	Nan
utazik	irin-ajo	Nan
utalva	ifilo si	Nan
történetet	itan	Nan
ugyanis	eyun	Nan
ugyanezen	ikan	None
törvénytelen	arufin	Nan
törzs	ẹyà	Nan
törzsek	awọn igara	Nan
törzsi	ẹya	Nan
török	ọfun	Nan
törökország	tọki	Nan
törökországban	tọki	Nan
törökök	tooki	Nan
törölték	pawonre	Nan
túl	paapaa	None
túli	lori	Nan
túlnyomó	lagbara	Nan
túlnyomórészt	bori	Nan
túlságosan	paapaa	None
túlzott	apọju	Nan
törvényt	owo	Nan
túlélte	ye	Nan
törvényhozó	aṣofin	Nan
törvényes	t’olofin	Nan
történetében	itan	Nan
történetének	itan	Nan
történetét	itan	Nan
történetíró	akẹkọ itan-akọọlẹ	Nan
történik	ṣẹlẹ	Nan
történt	ṣẹlẹ	Nan
történtek	ṣẹlẹ	Nan
történész	akẹkọ itan-akọọlẹ	Nan
történészek	òpìtàn	Nan
történő	loju	Nan
törvény	ofin	None
törvénye	ofin	None
törvényei	ofin	None
törvények	ofin	None
törvényeket	ofin	None
törvényhozás	ofin	None
túlélők	to	None
tükrözi	awọn digi	Nan
tükör	digi	Nan
udvari	kootu	Nan
udvarában	àgbàlá	Nan
udvarán	àgbàlá	Nan
uefa	uefa	Nan
uefakupa	uefakupa	Nan
ugor	olórí	Nan
ugyan	botilẹjẹpe	Nan
ugyanabban	ikan	None
ugyanaz	kanna	Nan
ugyanazon	ikan	None
ugyanazt	ikan	None
ugyancsak	bakanna	Nan
ugyanebben	ikan	None
ugyanekkor	ni igba kaana	Nan
ugyanez	ikan	None
udvarban	kootu	Nan
udvar	kootu	Nan
tűzte	ṣeto	Nan
tűz	ina	Nan
tünetei	awọn aami aisan	Nan
tünetek	awọn aami aisan	Nan
tüneteket	awọn aami aisan	Nan
tüntetők	awọn alainitelorun	Nan
türk	tọki	Nan
tüskés	ifowopamo	Nan
tüzet	ina	Nan
ugyanezt	ikan	None
tüzérségi	ohun ija	Nan
től	lati	Nan
tőle	rẹ	None
tőlük	wọn	None
tűnik	dabi	Nan
tűnnek	han	Nan
tűnt	han	Nan
tűnő	dabi ẹnipe	Nan
tőke	olu	Nan
teleki	teleki	Nan
támasztja	atilẹyin	Nan
támadó	ajagun	None
teréz	hysteresis	Nan
terézia	koreia	Nan
terül	oun	None
terület	agbegbe	Nan
területe	agbegbe	Nan
területei	awọn agbegbe	Nan
területein	awọn agbegbe	Nan
területeinek	awọn agbegbe	Nan
területeit	awọn agbegbe	Nan
területek	awọn agbegbe	Nan
területeken	awọn agbegbe	Nan
területeket	awọn agbegbe	Nan
területekre	awọn agbegbe	Nan
területekről	awọn agbegbe	Nan
területen	agbegbe	Nan
terén	lori square	Nan
területet	agbegbe	Nan
terápia	itọju ailera	Nan
tervezték	ti a ṣe	Nan
természeti	àbínibí	Nan
természettudományi	awọn sáyẹnsì nipa ti ara	Nan
természetvédelem	idaabobo iseda	Nan
természetvédelmi	itoju	Nan
terrier	terrier	Nan
terry	ilẹkun	Nan
terv	gbero	Nan
terve	apẹrẹ	Nan
tervei	awọn ero	Nan
terveit	awọn ero	Nan
tervek	awọn ero	Nan
terveket	awọn ero	Nan
tervet	gbero	Nan
tervezett	ngbero	None
tervezte	ngbero	None
tervét	gbero	Nan
területi	agbegbe	Nan
területre	agbegbe	Nan
területén	agbegbe	Nan
teszik	ṣe	Nan
tesznek	wọn	None
teszt	idanwo	Nan
tetején	lori oke	Nan
tetrakain	tetracaine	Nan
tetszett	mo feran re	Nan
tetszik	fẹran	Nan
tetszőleges	eyikeyi	Nan
tette	ṣe	Nan
tettek	wọn	None
tették	wọn	None
teutonok	awọn teutons	Nan
tevékenykedett	ṣiṣẹ	Nan
tevékenység	ìṣe	Nan
tevékenysége	ìṣe	Nan
teszi	ṣe	Nan
tesz	ṣe	Nan
testület	ara	Nan
testét	rẹ	None
területének	agbegbe	Nan
területére	agbegbe	Nan
területéről	lati	Nan
területét	agbegbe	Nan
területű	agbegbe	Nan
tesla	tesla	Nan
test	ara	Nan
természetfeletti	iyanu	Nan
teste	rẹ	None
testet	ara	Nan
testi	ti ara	Nan
testvér	arakunrin	Nan
testvére	arakunrin	Nan
testvérei	awọn arakunrin	Nan
testvérek	arakunrin ati arabinrin	Nan
testvérvárosai	arabinrin ilu	Nan
testek	awọn ara	Nan
tevékenységek	akitiyan	Nan
természetesen	nipa ti	Nan
természete	aye	Nan
teljesítményt	agbara	None
telt	kun	Nan
temesvár	timisoara	Nan
temesvári	timisoara	Nan
temették	sin	Nan
temető	ibojì	None
temetőben	ibi-isinku	Nan
templom	tẹmpili	Nan
temploma	tẹmpili	Nan
templomban	ijo	Nan
templomi	ijo	Nan
templomok	awọn ile-oriṣa	Nan
templomot	ijo	Nan
tengely	àá	Nan
tenger	okun	Nan
teljesítménye	agbara	None
tengeralattjáró	kekere	None
teljesítmény	imuṣere	Nan
teljesen	patapata	Nan
telepedtek	yanju	Nan
telepesek	atipo	Nan
telepített	fi	None
települt	yanju	Nan
település	pinpin okun	Nan
települése	awọn ibugbe	Nan
települései	awọn ibugbe	Nan
települések	awọn ibugbe	Nan
településeken	awọn ibugbe	Nan
településen	pinpin okun	Nan
települést	pinpin okun	Nan
televízió	tẹlifisiọnu	Nan
televíziós	tẹlifisiọnu	Nan
teli	otutu	None
teljes	pari	Nan
teljesített	ošišẹ	Nan
tengeralattjárók	omi	None
tengerbe	okun	Nan
tengeren	omi	None
terjedt	tànkálẹ	Nan
terjedő	sí	Nan
terjesztette	silẹ	Nan
termelnek	mu jade	Nan
termelt	produced	None
termelés	gbóògì	Nan
termelése	gbóògì	Nan
termelési	gbóògì	Nan
termék	ọja	Nan
terméke	awọn ọja	Nan
termékei	awọn ọja	Nan
termékek	awọn ọja	Nan
termékeny	irọyin	Nan
természet	iseda	Nan
természetben	ninu iseda	Nan
terjed	tànkálẹ	Nan
terhesség	oyun	Nan
terhes	loyun	Nan
teret	aaye	Nan
tengerentúli	okeokun	Nan
tengeri	omi	None
tengerpart	eti okun	Nan
tengerparti	okun	Nan
tengerparton	eti okun	Nan
tengerszint	omi	None
tenisz	tẹnisi	Nan
természetes	àbínibí	Nan
teniszező	tennis	Nan
tenni	lati ṣe	Nan
tennis	tẹnisi	Nan
teodicea	iṣọtẹ	Nan
teológia	eko	None
teológiai	imq ẹkọ	Nan
tere	tere	Nan
teremtett	ṣẹda	Nan
tenke	tenke	Nan
támadók	awọn olukopa	Nan
tevékenységet	ìṣe	Nan
texas	texas	Nan
tudom	mo mo	Nan
tudomány	sayensi	Nan
tudományegyetem	yunifasiti	Nan
tudományok	sáyẹnsì	Nan
tudományos	sayensi	Nan
tudomást	kọ ẹkọ	Nan
tudott	mọ	Nan
tudta	o mọ	Nan
tudtak	le	None
tudták	le	None
tudunk	a mọ	Nan
tudás	imo	Nan
tudós	onimo-jinlẹ	Nan
tudósok	sayensi	Nan
tulajdonképpen	gangan	Nan
tudni	lati mọ	Nan
tulajdonképpeni	foju	Nan
tudnak	wọn	None
tudjuk	a mọ	Nan
trianoni	trianon	Nan
trója	tiro	Nan
trójai	tirojanu	Nan
trón	itẹ	Nan
trónra	itẹ	Nan
trónörökös	dauphin	Nan
trópusi	tropical	Nan
tucat	mejila	None
tud	le	None
tudat	mimọ	Nan
tudatosan	mọọmọ	Nan
tudatában	imo	Nan
tudható	isọdi	Nan
tudja	le	None
tudjon	kọ ẹkọ	Nan
tudják	wọn	None
tulajdonos	oniwun	Nan
tulajdonosa	oniwun	Nan
tulajdonsága	ohun-ini	Nan
tábornokok	gbogbogbo	None
tábornokot	gbogbogbo	None
tábort	àgọ́	None
tágabb	gbooro	Nan
táj	ala-ilẹ	Nan
tájak	iwoye	Nan
táján	yika	Nan
támadt	ní	None
támadta	kọlu	Nan
támadtak	wọn	None
támadták	wọn	None
támadás	kọlu	Nan
támadása	kọlu	Nan
támadások	ku	None
támadást	kọlu	Nan
tábornok	gbogboogbo	Nan
táborba	àgọ́	None
tábor	àgọ́	None
táblázatban	tabili	None
tulajdonságai	awọn ohun-ini	Nan
tulajdonságait	awọn ẹya	Nan
tulajdonságok	awọn ohun-ini	Nan
tulajdonában	ohun ini	Nan
tupac	tupac	Nan
turisták	ajo	None
turisztikai	oniriajo	Nan
trek	irin-ajo	Nan
turizmus	irin-ajo	Nan
turné	ajo	None
turnéja	ajo	None
tutanhamon	tutankhamun	Nan
tv	tv	Nan
typotex	typotex	Nan
tábla	tabili	None
táblázat	iwe kaunti	Nan
turner	oluṣọ	Nan
tevékenységét	ìṣe	Nan
tranzisztor	transistor	Nan
tragédiája	ajalu	Nan
tim	aago	Nan
time	aago	Nan
timeaxis	asiko	Nan
tipikus	aṣoju	Nan
tisza	yew	Nan
tiszt	oṣiṣẹ	Nan
tiszta	mọ	Nan
tisztek	awọn olori	Nan
tiszteletbeli	ọlá	Nan
tiszteletben	fun	None
tisztelete	ọwọ	Nan
tiszteletére	ọlá	Nan
tisztelt	fun	None
tisztelték	lola	Nan
tiszti	oṣiṣẹ	Nan
tiltott	leewọ	Nan
tisztséget	ọfiisi	Nan
tiltakozott	fi	None
till	titi	Nan
texasi	texas	Nan
textilipar	ile ise aso	Nan
teája	tii	Nan
teáját	tii	Nan
the	awọn	Nan
theory	yii	Nan
this	eyi	Nan
thomas	thomas	Nan
thumb|right|px|az	atanpako | ọtun | px | awọn	Nan
thököly	eni t’ojö	Nan
ti	iwo	Nan
tibeti	tibetian	Nan
tibor	tibor	Nan
tigris	ẹyẹ	Nan
tilalom	gbesele	Nan
tilos	ko	None
tisztában	mò	None
tisztán	ko	None
tisztázott	koyewa	Nan
tony	ikan	None
topográf	arosọ	Nan
torna	ibi idaraya	Nan
tornán	figagbaga	Nan
tornát	figagbaga	Nan
torony	ile-iṣọ	Nan
torres	awon odo	Nan
tovább	itele	Nan
további	siwaju	Nan
továbbiakban	ninu atẹle	Nan
továbbra	tẹsiwaju	Nan
továbbá	pẹlupẹlu	Nan
tradicionális	ibile	None
tragikus	ajalu	Nan
tragédia	ajalu	Nan
tolkien	tolkien	Nan
toldi	fun	None
toldalék	samisi	Nan
tokaji	tokay	Nan
titanic	titanic	Nan
titkos	aṣiri	Nan
titkára	akọwe	Nan
tito	idalẹjọ	Nan
titokban	ni ikoko	Nan
titokzatos	aramada	Nan
titán	titani	Nan
transzformátor	oluyipada	Nan
tivadar	tivadar	Nan
tizenegy	mọkanla	Nan
tizenhárom	mẹtala	Nan
tizenhét	mẹtadinlogun	Nan
tizenkét	mejila	None
tizennégy	mẹrinla	Nan
tizenöt	mẹẹdogun	Nan
todd	ọmọ	None
tizedik	kẹwa	Nan
legsúlyosabb	awọn buru	Nan
legszebb	julọ lẹwa	Nan
legsikeresebb	aṣeyọri	Nan
eltűnik	farasin	Nan
eltűnt	parẹ	Nan
eltűntek	parẹ	Nan
elutasította	kọ	Nan
elutasították	kọ	Nan
elv	opo	Nan
elve	awọn opo	Nan
elveszett	sọnu	Nan
elvesztett	sọnu	Nan
elvesztette	o padanu	Nan
elvesztése	ipadanu	Nan
elveszítette	sọnu	Nan
elvileg	ni yii	Nan
elvis	igbonwo	Nan
elvállalta	bẹrẹ	Nan
eltöltött	lo	Nan
elváltak	kọsilẹ	Nan
eltérően	lọtọ	Nan
eltérések	awọn iyatọ	Nan
elsődleges	jc	Nan
elsők	akoko	Nan
elsőként	akoko	Nan
elsősorban	nipataki	Nan
elte	tun	Nan
eltekintve	yàtò	None
eltelt	koja	Nan
elteltével	lẹhin	Nan
elterjedt	lọwọlọwọ	Nan
elterjedtek	tànkálẹ	Nan
elterjedése	tànkálẹ	Nan
elterülő	o wa	Nan
eltávolították	kuro	Nan
eltér	yàtọ	Nan
eltérés	iyato	None
eltérő	yatọ	Nan
első	akoko	Nan
elvét	opo	Nan
elég	to	None
előadó	oluṣe	Nan
előadók	awọn agbohunsoke	Nan
előbb	ṣaaju	Nan
előbbi	tele	None
elődje	rẹ	None
elődöntő	agbedemeji	Nan
elődöntőben	semifinals	Nan
előfordul	waye	Nan
előfordulhat	waye	Nan
előfordulnak	waye	Nan
előfordult	ṣẹlẹ	Nan
előfordulása	iṣẹlẹ	Nan
előforduló	waye	Nan
előkelő	ọlọla	Nan
előkerült	tu jade	Nan
előadásában	ikowe	Nan
elé	eti	Nan
előadást	ikowe	Nan
előadások	ifarahan	Nan
eléggé	to	None
elérheti	de ọdọ	Nan
elérhető	wa	Nan
elérhetővé	wa	Nan
eléri	de ọdọ	Nan
elérni	lati de odo	Nan
elért	de ọdọ	Nan
elérte	de ọdọ	Nan
elérték	de ọdọ	Nan
elérése	iwọle si	Nan
elítélt	gbesewon	Nan
elülső	iwaju	Nan
elő	wa laaye	Nan
előadás	ikowe	Nan
előadása	ikowe	Nan
előadásokat	awọn iṣe	Nan
elsüllyedt	rì	Nan
elszenvedett	jiya	Nan
else	omiiran	Nan
ellenfél	alatako	Nan
elleni	egboogi	Nan
ellenjavallat	contraindication	Nan
ellenkező	ilodi si	Nan
ellenség	ọtá	Nan
ellenséges	agbalejo	Nan
ellentmondásos	ilodi	Nan
ellentét	ilodi si	Nan
ellentétben	ko	None
ellentétek	alatako	Nan
ellentétes	idakeji	Nan
ellenzék	àtakò	Nan
ellenzéki	àtakò	Nan
ellenállás	alatako	Nan
ellenállást	atako	Nan
ellenfele	alatako	Nan
ellenében	lodi si	Nan
ellenezte	tako	Nan
ellenben	sibẹsibẹ	Nan
elkerülése	fun	None
elkezdett	bere	Nan
elkezdte	bẹrẹ	Nan
elkezdték	wọn	None
elkezdődött	bẹrẹ	Nan
elképzelhető	ironu	Nan
elképzelés	iro	Nan
elképzelése	imọran	Nan
elképzelések	awọn oju inu	Nan
elkészítette	gbaradi	Nan
elkészült	pari	Nan
elkövetett	ti ṣe	Nan
elkövetkező	atẹle	Nan
elküldte	firanṣẹ	Nan
ellen	lodi si	Nan
ellene	lodi si	Nan
ellenére	pelu	Nan
ellenük	wọn	None
ellenőrzés	iṣakoso	Nan
elnevezése	lorukọ	Nan
elnevezést	yiyan	Nan
elnevezésű	ti a npè ni	Nan
elnyerte	bori	Nan
elnök	alaga	Nan
elnöke	alakoso	Nan
elnöki	ajé	Nan
elnöknek	alakoso	Nan
elnöksége	alakoso	Nan
elnökválasztás	ajodun idibo	Nan
elnökének	alakoso	Nan
elnökévé	alakoso	Nan
elnököt	alakoso	Nan
elpusztult	ṣègbé	Nan
elrendelte	paṣẹ	Nan
elnevezés	orukọ	Nan
elnevezett	ti a npè ni	Nan
elmúlt	ti o ti kọja	Nan
elméletét	yii	Nan
ellenőrzése	yiyewo	Nan
ellátott	pese	Nan
elmaradt	ipadanu	Nan
elmegy	kuro patapata	Nan
elmenekült	sá lọ	Nan
elment	lọ	Nan
elmondható	nsoro	Nan
előkészítő	igbaradi	Nan
elmondja	sọ	None
elmondása	enikeji	Nan
elmélet	yii	Nan
elmélete	yii	Nan
elméletek	awọn imọ-jinlẹ	Nan
elméletet	yii	Nan
elméleti	ẹkọ	Nan
elméletileg	ni yii	Nan
elmondta	wi	Nan
elől	awọn taya	Nan
előnyben	pataki	Nan
előnye	awọn oniwe-anfani	Nan
enyhébb	milder	Nan
enyhén	rọra	Nan
ep	mule	Nan
epizód	isele	Nan
epizódban	isele	Nan
epizódok	awọn ere	Nan
epizódot	isele	Nan
erdély	transylvania	Nan
erdélyben	transylvania	Nan
erdélyi	transylvania	Nan
erdélyt	transylvania	Nan
erdő	igbo	Nan
erdőben	igi	Nan
erdők	igbo	Nan
erdős	igi	Nan
enyhe	onirẹlẹ	Nan
ered	dide	Nan
ensz	un	Nan
engem	emi	Nan
en	emi	Nan
enciklopédia	encyclopedia	Nan
end	ipari	Nan
endre	andrew	Nan
energia	agbara	None
energiája	agbara	None
energiát	agbara	None
enged	gba	None
engedte	ki	None
engedték	tu silẹ	Nan
engedély	iwe-aṣẹ	Nan
engedélyezett	iwe-aṣẹ	Nan
engedélyezte	yọọda	Nan
engedélyezték	fun	None
engedélyt	igbanilaaye	Nan
ennek	fun	None
eredete	rẹ	None
eredeti	atilẹba	Nan
eredetileg	ni akọkọ	Nan
erejű	ipinnu	Nan
eric	eric	Nan
erika	erika	Nan
erkel	erkel	Nan
erkölcsi	iwa	Nan
ernest	àṣìṣe	Nan
ernst	erést	Nan
ernő	ernő	Nan
erotikus	itara	Nan
erre	eyi	Nan
erről	nipa eyi	Nan
ervin	ervin	Nan
erzsébet	elizabeth	Nan
erzsébetet	elizabeth	Nan
erő	ipa	Nan
erejével	agbara	None
erejét	agbara	None
ereje	agbara	None
eredő	esi	Nan
eredetét	oti ti	Nan
eredetű	orukọ idile	Nan
eredménnyel	awọn esi	Nan
eredmény	esi	Nan
eredménye	awọn esi	Nan
eredményei	awọn esi	Nan
eredményeit	awọn esi	Nan
emésztést	walẹ	Nan
eredmények	awọn esi	Nan
eredményeként	bii abajade ti	Nan
eredményeképpen	esi	Nan
eredményez	esi	Nan
eredményezett	yorisi ni	Nan
eredményezte	yorisi	Nan
eredményt	awọn esi	Nan
eredményét	abajade	Nan
eredményeket	awọn esi	Nan
eljárást	ilana	None
emo	emo	Nan
emlősök	osin	Nan
előírások	ilana	None
email	í-meèlì	Nan
emancipáció	emancipation	Nan
ember	ènìyàn	Nan
emberben	ọkunrin	Nan
embere	ọkunrin	Nan
emberei	eniyan	Nan
emberek	eniyan	Nan
embereket	eniyan	Nan
embereknek	fun	None
emberi	ènìyàn	Nan
emberiség	ọmọ	None
embernek	eniyan	Nan
emberre	ọkunrin	Nan
emberrel	eniyan	Nan
előállítása	gbóògì	Nan
embert	eniyan	Nan
előállított	gbaradi	Nan
előző	ti tẹlẹ	Nan
előnyös	anfani	Nan
előre	siwaju	Nan
előrehaladtával	onitẹsiwaju	Nan
elősegítette	tiwon	Nan
elősegíti	iranlọwọ	Nan
elősegítő	olugbeleke	Nan
előszeretettel	asọtẹlẹ	Nan
először	akoko	Nan
előtt	ṣaaju	Nan
előtte	ṣaaju	Nan
előtti	aito	Nan
előtérbe	iwaju	Nan
előzetes	alakoko	Nan
előzmények	itan	Nan
előzte	ṣaju	Nan
előzőleg	ṣaju	Nan
eme	iwọnyi	Nan
emeli	posi	Nan
emelkedett	ga	Nan
emlékezett	ranti	Nan
emlékeztet	ran leti	Nan
emlékeztető	olurannileti	Nan
emlékmű	arabara	Nan
emlékműve	ìrántí	Nan
emléktábla	okuta	Nan
emléktáblája	okuta	Nan
emlékére	ni iranti ti	Nan
emlékét	iranti	Nan
említett	mẹnuba	Nan
említi	nmẹnuba	Nan
említik	mẹnuba	Nan
említésre	mẹnuba	Nan
említést	mẹnuba	Nan
emlősei	osin	Nan
emlékezetes	iranti	Nan
emlékezete	iranti	Nan
emléket	ìrántí	Nan
emlékek	ìrántí	Nan
emelkedik	dide	Nan
emelkedő	si oke	Nan
emellett	yàtò	None
emelt	dide	Nan
emelte	gbe	None
emeltek	tẹre	Nan
emiatt	nitori eyi	Nan
emma	emma	Nan
emigráció	ijira	Nan
emil	emil	Nan
emily	emily	Nan
emlegetett	toka si	Nan
emlegetik	toka si	Nan
emlék	iranti	Nan
emléke	iranti	Nan
emlékei	ìrántí	Nan
emigráns	emigrant	Nan
eljárások	ilana	None
eljárás	ejo	Nan
eljutott	de ọdọ	Nan
döntöttek	pinnu	Nan
döntő	ipari	Nan
döntőbe	ipari	Nan
döntőben	ipari	Nan
döntően	decisively	Nan
döntős	finalists	Nan
döntőt	ipari	Nan
dőlt	slanted	Nan
east	ila-oorun	Nan
eastwood	eastwood	Nan
eb	aja	Nan
ebbe	ninu eyi	Nan
ebben	ninu eyi	Nan
ebből	lati eyi	Nan
edda	edda	Nan
döntött	pinnu	Nan
eddie	eddie	Nan
döntést	ipinnu	Nan
döntés	ipinnu	Nan
dénes	dénes	Nan
día	díá	Nan
díj	owo	Nan
díja	owo	Nan
díjai	owo	Nan
díjak	owo	Nan
díjat	eye	Nan
díját	eye	Nan
díszes	ohun ọṣọ	Nan
díszpolgárai	ilu ti ohun ọṣọ	Nan
díszített	ti a ṣe ọṣọ	Nan
dóm	dome	Nan
dózsa	dózsa	Nan
dönt	pinnu	Nan
döntetlen	fa	Nan
döntése	awọn ipinnu	Nan
eddig	titi si asiko yi	Nan
eddigi	titi si asiko yi	Nan
ede	salọ	Nan
egyegy	ọkan-ọkan	Nan
egyelőre	kan	None
egyenes	taara	Nan
egyenesen	taara	Nan
egyenként	kookan	None
egyenlet	idogba	Nan
egyenletes	iduroṣinṣin	Nan
egyenlítő	olumeta	Nan
egyenlítői	dọgbadọgba	Nan
egyenlő	dogba	Nan
egyenlőség	dọgbadọgba	Nan
egyes	ẹnikọọkan	Nan
egyesek	diẹ ninu	Nan
egyesített	ni idapo	Nan
egyesület	ẹgbẹ	Nan
egyedülálló	alailẹgbẹ	Nan
egyedüli	nikan	Nan
egyedül	nikan	Nan
egyedi	alailẹgbẹ	Nan
edgar	edgar	Nan
edison	edison	Nan
edit	satunkọ	Nan
edition	àtúnse	Nan
edward	edward	Nan
edzés	ṣee ṣe	Nan
edző	olukọ	Nan
délvietnami	délvietnami	Nan
eger	asin	Nan
egri	eger	Nan
egy	ọkan	Nan
egyaránt	dọgbadọgba	Nan
egyben	tun	Nan
egyebek	awọn miiran	Nan
egyed	olori	Nan
egyedek	olúkúlùkù	Nan
egerek	eku	Nan
egyesült	isọdọkan	Nan
délután	ọsán	Nan
délről	guusu	None
dolgozta	to	None
dolgoztak	ṣiṣẹ	Nan
dolgozó	ṣiṣẹ	Nan
dolgozók	osise	Nan
dollár	dola	Nan
dolog	ohun	Nan
domborzat	iderun	Nan
domborzati	ibigbogbo ile	Nan
domenico	domenico	Nan
domináns	jẹ gaba lori	Nan
domokos	domokos	Nan
domonkos	dominican	Nan
domén	ašẹ	Nan
don	don	Nan
donald	donald	Nan
dolgozott	ṣiṣẹ	Nan
dont	pinnu	Nan
dolgozni	lati ṣiṣẹ	Nan
dolgozik	iṣẹ	Nan
diák	ọmọ	None
diákok	omo ile	Nan
diána	diana	Nan
dns	dns	Nan
dobos	onilu	Nan
dog	aja	Nan
dohány	taba	Nan
doktor	dokita	Nan
doktori	dokita	Nan
dokumentum	iwe	Nan
dokumentumfilm	itan	Nan
dokumentumok	awọn iwe aṣẹ	Nan
dolgok	ohun	Nan
dolgokat	ohun	Nan
dolgot	ohun	Nan
dolgoznak	wọn	None
douglas	douglas	Nan
down	silẹ	Nan
dr	dókítà	Nan
dédanyjan	dédanyjan	Nan
dédapjan	dédapjan	Nan
dél	guusu	None
délafrikai	south afirika	Nan
délamerika	amerika	None
délamerikai	amerika	None
délelőtt	owurọ	Nan
délen	guusu	None
déli	guusu	None
déliek	guusu	None
délkeleti	guusu	None
délkorea	south korea	Nan
délnyugati	guusu	None
délnyugaton	guusu	None
délre	guusu	None
dávid	dáfídì	Nan
dátuma	awọn ọrọ	Nan
dátum	ọjọ	Nan
dániel	daniel	Nan
dragon	dragoni	Nan
drum	ilu	Nan
drága	gbowolori	Nan
dráma	eré	Nan
drámai	ìgbésẹ	Nan
du	du	None
dumbledore	dumbledore	Nan
délszláv	south slavic	Nan
duna	danube	Nan
dunán	danube	Nan
dupla	ilọpo meji	Nan
durva	ti o ni inira	Nan
dvd	dvd	Nan
dvdn	dvdn	Nan
dán	ede	None
dánia	egeskov	Nan
dunai	danube	Nan
erői	awọn ipa	Nan
egyet	ọkan	Nan
egyetemek	egbelegbe	Nan
eleget	pàdé	Nan
elegáns	daradara groomed	Nan
eleinte	lakoko	Nan
eleje	kutukutu	Nan
elején	ni ibere	Nan
elejére	oke	Nan
elejétől	bẹrẹ	Nan
elek	gbe	None
elektrokémia	itanna	Nan
elektromos	itanna	Nan
elektromágneses	itanna	Nan
elektronikai	itanna	Nan
elektronikus	itanna	Nan
elektronok	elekitironi	Nan
elem	ano	Nan
elegendő	to	None
eleme	awọn ohun	Nan
elbeszélő	onirohin	Nan
elbeszélés	itan	Nan
ei	éi	Nan
ein	éù	Nan
einstein	einstein	Nan
ejtsd	oyè	Nan
ekkor	ni	Nan
ekkora	pupọ gaan	Nan
ekkoriban	ni akoko yi	Nan
ekkorra	nipasẹ akoko yi	Nan
ekkortájt	ni ayika akoko yii	Nan
ekkortól	lati igbanna	Nan
eközben	lasiko	Nan
el	kuro	Nan
eladott	ti ta	Nan
eladta	ti ta	Nan
eladási	ta	Nan
elbeszélések	awọn itan kukuru	Nan
elemei	awọn eroja	Nan
elemeit	awọn eroja	Nan
elemek	awọn eroja	Nan
elhagyták	kọ silẹ	Nan
elhangzott	gbo	Nan
elhatározta	pinnu	Nan
elhelyezett	o wa	Nan
elhelyezkedése	rẹ	None
elhelyezkedő	o wa	Nan
elhunyt	kú	Nan
elindult	ti bẹrẹ	Nan
elismeri	ṣe idanimọ	Nan
elismert	gba	None
elismerte	mọ	Nan
elismerések	idanimọ	Nan
elismerést	idanimọ	Nan
elit	gbajumo	Nan
elizabeth	elizabeth	Nan
elhagyta	sọnu	Nan
elhagyja	lọ	Nan
elfoglalása	iṣẹ	Nan
elfoglalták	ti tẹdo	Nan
elemeket	awọn ohun	Nan
elemekkel	awọn ohun	Nan
elemet	batiri	Nan
elemi	alakọbẹrẹ	Nan
elesett	pa	Nan
eleve	a priori	Nan
elfogadható	itewogba	Nan
ehnaton	akhenaten	Nan
elfogadja	gba	None
elfogadott	gba	None
elfogadta	gba	None
elfogadták	gba	None
elfoglalják	gbalaye	Nan
elfoglalni	gbalaye	Nan
elfoglalt	nṣiṣe lọwọ	Nan
elfoglalta	ti tẹdo	Nan
elfogadni	gba	None
egyetem	yunifasiti	Nan
ehhez	eyi	Nan
egészét	odidi	Nan
egyiptom	íjíbítì	Nan
egyiptomban	íjíbítì	Nan
egyiptomi	ara egipti	Nan
egykor	nigbati a	Nan
egykori	kan	None
egykét	tabi	None
egymillió	kan	None
egymás	olukuluuku ara wa	Nan
egymáshoz	si kọọkan miiran	Nan
egymásnak	si kọọkan miiran	Nan
egymásra	lori kọọkan miiran	Nan
egymással	pẹlu kọọkan miiran	Nan
egymást	olukuluuku ara wa	Nan
egymástól	lati kọọkan miiran	Nan
egyre	lailai	Nan
egyikük	wọn	None
egyrészt	lọna miiran	Nan
egyike	ọkan	Nan
egyidőben	kan	None
egyetemen	ni yunifasiti	Nan
egyetemes	agbaye	None
egyetemet	yunifasiti	Nan
egyetemi	yunifasiti	Nan
egyetemre	yunifasiti	Nan
egyetlen	ọkan	Nan
egyetértés	àdéhùn	Nan
egyezik	baramu	Nan
egyezmény	apejọ	Nan
egyezményt	apejọ	Nan
egyfajta	kan	None
egyforma	kanna	Nan
egyház	ijo	Nan
egyházak	awọn ile ijọsin	Nan
egyidejűleg	kan	None
egyik	ọkan	Nan
egyszer	lẹẹkan	Nan
egyszeri	ẹyọkan	Nan
egyszerre	kan	None
egyértelműen	o han ni	Nan
egyúttal	kan	None
együtt	papọ	Nan
együttes	ni idapo	Nan
együttese	ṣajọpọ	Nan
együttesek	igbohunsafefe	Nan
együttesen	apapọ	Nan
együttesnek	ṣajọpọ	Nan
együttest	eka	None
együttműködés	ifowosowopo	Nan
egér	asin	Nan
egész	gbogbo	Nan
egészen	oyimbo	Nan
egészséges	ni ilera	Nan
egészében	gbogbo	Nan
egyértelmű	ko	None
egyéni	ẹnikọọkan	Nan
egyének	olúkúlùkù	Nan
egyén	ẹnikọọkan	Nan
egyszerű	o rọrun	Nan
egyszerűbb	o rorun gan	Nan
egyszerűen	nirọrun	Nan
egyszerűsített	irọrun	Nan
egység	ẹyọkan	Nan
egysége	isokan	Nan
egységei	awọn ohun amorindun	Nan
ehelyett	dipo	Nan
egységek	awọn sipo	Nan
egységes	ti iṣọkan	Nan
egységesen	iṣọkan	Nan
egységet	isokan	Nan
egységre	isokan	Nan
egyáltalán	rara	Nan
egyéb	omiiran	Nan
egyébként	le	None
egységeket	awọn sipo	Nan
erők	awọn ipa	Nan
erőket	awọn ipa	Nan
erős	lagbara	Nan
filozófiája	imoye	Nan
filozófus	onimoye	Nan
filozófusok	onimoye	Nan
finger	ika	Nan
finn	ede	None
finnország	finland	Nan
finnugor	finno-ugric	Nan
finom	dara	Nan
fire	ina	Nan
firefox	firefox	Nan
firenze	florence	Nan
firenzei	florentine	Nan
firenzében	florence	Nan
fityma	foreskin	Nan
fiume	fiume	Nan
filozófiai	ori	None
fizetett	san	Nan
filozófia	imoye	Nan
filmográfia	filmography	Nan
film	fiimu	Nan
filmben	fiimu	Nan
filmek	sinima	Nan
filmekben	sinima	Nan
filmeket	sinima	Nan
filmes	filmmaker	Nan
filmet	fiimu	Nan
filmfesztivál	ajọdun fiimu	Nan
filmje	fiimu	Nan
filmjei	fiimu	Nan
filmjében	fiimu	Nan
filmjét	fiimu	Nan
filmkritikusok	fiimu alariwisi	Nan
filmművészet	sinima	Nan
filmnek	fiimu	Nan
filmre	fiimu	Nan
fizetni	lati san	Nan
fizetési	isanwo	Nan
fizika	fisiksi	Nan
fogadták	gba	None
fogak	eyin	None
fogalma	imọran	Nan
fogalmak	awọn erongba	Nan
fogalmazta	gbekale	Nan
fogalmát	erongba	Nan
fogalom	erongba	Nan
fogja	yoo	None
fogják	yoo	None
foglal	ifipamọ	Nan
foglalja	iwe	Nan
foglalják	gbalaye	Nan
foglalkozik	ibaṣowo	Nan
foglalkoznak	ibaṣowo	Nan
foglalkozni	ibaṣowo	Nan
fogadta	gba	None
fogadott	gba	None
fogadja	gba	None
fog	ehin	Nan
fizikai	ti ara	Nan
fizikailag	nipa ti ara	Nan
fizikus	oníṣègùn	Nan
fizikusok	fisiksi	Nan
fiának	ọmọ	None
fiát	ọmọ	None
fiával	ọmọ	None
figyelmét	akiyesi	Nan
fiú	ọmọkunrin	Nan
fiút	ọmọkunrin	Nan
fk	fk	Nan
flamand	flemish	Nan
flotta	kekere	None
floyd	floyd	Nan
fm	fm	Nan
fodor	frill	Nan
fiúk	awọn ọmọkunrin	Nan
foglalkozott	ti a ti tẹdo pẹlu	Nan
figyelmet	akiyesi	Nan
figyelhető	šakiyesi	Nan
fenn	sókè	Nan
fennhatóság	suzerainty	Nan
fennhatósága	aṣẹ	Nan
fennmaradt	ni ifipamọ	Nan
fennmaradó	ku	None
fenntartani	lati ṣetọju	Nan
fennálló	wa	Nan
fenol	phenol	Nan
fent	loke	Nan
fenti	loke	Nan
fenyegette	idẹruba	Nan
ferdinand	ferdinand	Nan
ferdinánd	ferdinand	Nan
ferenc	franciscan	Nan
ferenccel	ferenc	Nan
felől	lati	Nan
ferences	franciscan	Nan
felületet	dada	Nan
felület	dada	Nan
felállították	tẹre	Nan
felé	sí	Nan
felében	idaji	None
felén	idaji	None
felépítése	be	Nan
felépítését	be	Nan
felépítésű	be	Nan
felépült	gba	None
felét	idaji	None
felújítás	imupada	Nan
felújítása	atunkọ	Nan
felügyelet	abojuto	Nan
felügyelete	abojuto	Nan
felügyelő	alabojuto	Nan
felül	lori	Nan
felületen	dada	Nan
ferencet	francis	None
ferencz	ferencz	Nan
ferenczy	ferenczy	Nan
feszültséget	ẹdọfu	Nan
feudális	feudal	Nan
fia	ọmọ	None
fiai	ọmọ	None
fiatal	odo	Nan
fiatalabb	abikẹhin	Nan
fiatalok	odo	Nan
fiatalon	odo	Nan
fiction	itan-akọọlẹ	Nan
fidel	iṣootọ	Nan
fidesz	didi	Nan
fifa	fifa	Nan
figura	isiro	Nan
figyelembe	mu	Nan
figyelemmel	pẹlu akiyesi	Nan
feszültségek	aifokanbale	Nan
feszültség	ẹdọfu	Nan
fesztiválon	ajọdun	Nan
fesztivál	ajọdun	Nan
fernando	fernando	Nan
ferrari	ferrari	Nan
fertőzés	akoran	Nan
fertőzések	awọn àkóràn	Nan
fertőzött	àrùn	None
fertőző	akoran	Nan
festett	ya	Nan
figyelmen	ero	Nan
festette	ya nipasẹ	Nan
festmény	kikun	Nan
festménye	awọn kikun	Nan
festményei	awọn kikun	Nan
festészet	kikun	Nan
festő	ayaworan	Nan
festők	awọn kikun	Nan
festőművész	ayaworan	Nan
festival	ajọdun	Nan
felállított	ṣeto	Nan
foglalkoztak	jiya	Nan
foglalkozó	loju	Nan
formái	awọn fọọmu	Nan
formája	apẹrẹ	Nan
formájában	awọn fọọmu	Nan
formáját	apẹrẹ	Nan
formájú	apẹrẹ	Nan
formák	awọn fọọmu	Nan
formális	lodo	None
formát	apẹrẹ	Nan
forradalmat	iyika	Nan
forradalmi	rogbodiyan	None
forradalom	iyika	Nan
forradalomban	iyika	Nan
forrás	orisun	None
forrása	orisun	None
forrásból	orisun	None
formában	apẹrẹ	Nan
források	orisun	None
formulaes	awọn agbekalẹ	Nan
formula	agbekalẹ	Nan
forgalom	ijabọ	Nan
forgalomba	ọjà	Nan
forgalomban	ijabọ	Nan
forgatta	yipada	None
forgatták	filimu	Nan
forgatás	gbon	Nan
forgatása	o nya aworan	Nan
forgatókönyv	ohn	Nan
forgatókönyvcs	forgatókönyvcs	Nan
forgása	iyipo	Nan
forgási	iyipo	Nan
forgó	yiyi	Nan
forint	forin	Nan
forma	fọọmu	Nan
formai	lodo	None
formulaben	rẹ	None
forrásokból	orisun	None
forró	gbona	Nan
forum	apejọ	Nan
françois	faranse	None
fred	fo	Nan
freddie	freddie	Nan
frekvencia	igbohunsafẹfẹ	Nan
freud	freudianism	Nan
friedrich	didin	Nan
frigyes	fredoni	Nan
friss	alabapade	Nan
frissen	alabapade	Nan
from	lati	Nan
front	iwaju	Nan
fronton	iwaju	Nan
ft	ft	Nan
fulham	fulham	Nan
fulladt	rì	Nan
franz	franz	Nan
franklin	franklin	Nan
frankfurt	ffefurt	Nan
frank	franc	Nan
fosszilis	fosaili	Nan
fotók	awọn fọto	Nan
foundation	ipile	Nan
fox	kọlọkọ	Nan
france	itanran	Nan
francesco	faranse	None
francia	faranse	None
forgalmi	ijabọ	Nan
franciaország	faranse	None
franciaországban	faranse	None
franciaországi	faranse	None
francis	francis	None
francisco	francisco	Nan
franciák	faranse	None
franciául	faranse	None
franco	franco	Nan
franciaországba	faranse	None
foglalkozás	oojọ	Nan
forgalmat	ijabọ	Nan
fordítások	ogbufọ	Nan
folyamat	ilana	None
folyamata	ilana	None
folyamatban	ni ilọsiwaju	Nan
folyamatok	ilana	None
folyamatos	lemọlemọfún	Nan
folyamatosan	loorekoore	Nan
folyamatot	ilana	None
folyik	ṣiṣan	Nan
folyt	lati jẹrisi	Nan
folytak	o waiye	Nan
folytatja	o tesiwaju	Nan
folytatják	tẹsiwaju	Nan
folytatni	tẹsiwaju	Nan
folytatott	pẹlu	Nan
folytatta	o tesiwaju	Nan
foltok	yẹriyẹri	Nan
folytattak	o waiye	Nan
fokú	ìyí	Nan
fokozta	kikankikan	Nan
foglalt	nṣiṣe lọwọ	Nan
foglalta	ti tẹdo	Nan
foglalták	kọnputa	Nan
fognak	yoo	None
fogoly	ẹlẹwọn	Nan
fogott	mú	Nan
fogságba	igbekun	Nan
fogta	mu	Nan
fogva	lati	Nan
fogyasztják	run	Nan
fogyasztása	lilo	Nan
fokozat	ìyí	Nan
fokozatos	di mimọ	Nan
fokozatosan	di .di.	Nan
fokozott	kikankikan	Nan
fokozza	posi	Nan
folytatták	tesiwaju	Nan
folytatása	tẹsiwaju	Nan
folytatását	tẹsiwaju	Nan
forbes	forbes	Nan
ford	ṣeéṣe	Nan
fordul	yiyi	Nan
fordulat	yiyi	Nan
fordulatot	yi pada	Nan
fordulnak	waye	Nan
fordult	yipada	None
fordultak	yipada	None
forduló	yiyi	Nan
fordulóban	yika	Nan
fordított	yiyipada	Nan
fordította	itumọ	Nan
fordítva	inversely	Nan
fordítás	translation	Nan
fordítása	translation	Nan
football	bọọlu	Nan
fonálkígyófélék	leptotyphlopidae	Nan
fontsizes	fontsizes	Nan
fontosságú	pataki	Nan
folytatódik	tẹsiwaju	Nan
folytatódott	tesiwaju	Nan
folytonos	loorekoore	Nan
folytán	nitori	Nan
folyékony	omi	None
folyó	odo	Nan
folyói	odo	Nan
fordító	onitumọ	Nan
folyóirat	iwe irohin	Nan
folyók	odo	Nan
folyón	odo	Nan
font	iwon	Nan
fontos	pataki	Nan
fontosabb	diẹ pataki	Nan
fontosak	pataki	Nan
fontosnak	pataki	Nan
folyója	odo	Nan
dizartria	dysarthria	Nan
felvételi	gbon	Nan
felvételek	awọn gbigbasilẹ	Nan
ezeket	iwọnyi	Nan
ezekkel	pẹlu awọn wọnyi	Nan
ezeknek	iwọnyi	Nan
ezekre	fun	None
ezelőtt	ti o ti kọja	Nan
ezen	lori eyi	Nan
ezenkívül	yàtò	None
ezentúl	láti ìsisìnyí	Nan
ezer	ẹgbẹrun	Nan
ezerjófű	ọgọọgọrun	Nan
ezredes	ogun	None
ezt	eyi	Nan
ezután	lẹhinna	Nan
ezzel	pẹlu eyi	Nan
ezáltal	nitorina	Nan
ezeken	iwọnyi	Nan
ezért	nitorinaa	Nan
ezekből	iwọnyi	Nan
ezek	iwọnyi	Nan
európát	yuroopu	Nan
evangélikus	onilu	Nan
evans	awọn ikede	Nan
everest	everest	Nan
evolúció	itankalẹ	Nan
evolúciós	itankalẹ	Nan
ewing	ewing	Nan
expedíció	ajo	None
experience	iriri	Nan
explorer	aṣawakiri	Nan
export	okeere	None
exporttermékek	okeere	None
express	han	Nan
ez	eyi	Nan
ezalatt	nibayi	Nan
ezekben	ninu wọnyi	Nan
ezúttal	ni akoko yi	Nan
ezüst	fadaka	Nan
ezüstérmes	ohun-ini fadaka	Nan
faragott	gbẹ	Nan
farkas	ikooko	Nan
fasiszta	fascist	Nan
fauvizmus	fauvism	Nan
fazekas	amọkoko	Nan
fc	fc	Nan
február	oṣu kínní	Nan
februárban	ni kínní	Nan
federer	federer	Nan
fedett	ti bo	Nan
fedezte	awari	None
fedezték	awari	None
fedi	ideri	Nan
fedélzetén	wa ninu ọkọ	Nan
fegyver	ohun ija	Nan
fantasztikus	ikọja	Nan
fantasy	irokuro	Nan
falán	ogiri	Nan
falvak	abule	Nan
eötvös	eötvös	Nan
fa	igi	Nan
facebook	facebook	Nan
facto	facto	Nan
faj	eya	None
faji	ẹlẹyamẹya	Nan
fajok	eya	None
európán	yuroopu	Nan
fajtái	awọn oriṣi	Nan
fajták	awọn oriṣi	Nan
fakad	wa lati	Nan
fakadó	deri	Nan
fal	ogiri	Nan
falat	jẹ lẹnu	Nan
falu	abule	Nan
falusi	abule	Nan
fajtája	irú	Nan
fegyverek	awon ibon	Nan
európában	ni yuroopu	Nan
európaiak	ara ilu yuroopu	Nan
események	iṣẹlẹ	Nan
eseményeket	iṣẹlẹ	Nan
eseményt	ìṣẹlẹ	Nan
eset	ọran	Nan
esetben	ọran	Nan
esete	ẹjọ naa	Nan
esetek	awọn ọran	Nan
esetekben	awọn ọran	Nan
esetenként	nigba miiran	Nan
esetet	ọran	Nan
esetleg	o ṣee	Nan
esetleges	airotẹlẹ	Nan
esett	ṣubu	Nan
esetében	fun	None
esetén	ti o ba ti	Nan
eseményei	iṣẹlẹ	Nan
esik	ṣubu	Nan
eseménye	iṣẹlẹ	Nan
es	ati	Nan
erősebb	okun sii	Nan
erősen	lagbara	Nan
erőssége	okun	Nan
erősségű	okun	Nan
erőszak	iwa-ipa	Nan
erőszakkal	agbara	None
erőszakos	iwa-ipa	Nan
erősítette	ni okun	Nan
erősítették	timo	Nan
erősíti	arawa	Nan
erősödő	kikankikan	Nan
erőt	okun	Nan
erőteljes	alagbara	Nan
erőteljesen	strongly	Nan
erővel	agbara	None
esemény	ìṣẹlẹ	Nan
esküvő	igbeyawo	None
esnek	ṣubu	Nan
esp	esp	Nan
esélyét	awọn aye	Nan
eső	ojo	None
esős	òjò	Nan
et	àti	Nan
etikai	iwa	Nan
etnikai	ẹya	Nan
etruszk	etruscan	Nan
ettől	lati	Nan
eu	eu	Nan
eur	eur	Nan
europe	yuroopu	Nan
european	oyinbo	Nan
euró	euro	None
európa	yuroopu	Nan
európai	oyinbo	Nan
esélye	aye	Nan
esztétikai	darapupo	Nan
esztergomi	esztergom	Nan
esztergom	esztergom	Nan
est	irọlẹ	Nan
este	irọlẹ	Nan
estek	irọlẹ	Nan
esterházy	esterházy	Nan
esti	irọlẹ	Nan
eszerint	accordingly	Nan
eszköz	ẹrọ	Nan
európába	si yuroopu	Nan
eszköze	ọna	Nan
eszközök	ọna	Nan
eszközöket	ohun-ìní	Nan
eszközökkel	ọna	Nan
eszme	oyun	Nan
eszméi	awọn imọran	Nan
esztendő	ọdun	Nan
eszter	ester	Nan
eszközt	ọna	Nan
felvételeket	awọn gbigbasilẹ	Nan
fegyveres	ni ihamọra	Nan
fegyvert	ohun ija	Nan
felkerült	fi	None
felkérte	pe	Nan
felkérést	pe	Nan
fellelhető	le	None
fellépett	ošišẹ	Nan
felléptek	sise	None
fellépés	awọn iṣẹ	Nan
fellépése	awọn iṣẹ	Nan
fellépő	oluṣe	Nan
felmelegedés	alapapo	Nan
felmerült	dide	Nan
felnőtt	agba	None
felnőttek	agbalagba	Nan
felosztás	ipin	None
felosztása	awọn oriṣi	Nan
felkereste	ṣàbẹwò	Nan
felsorolt	ṣe akojọ	Nan
felkelők	alatako	Nan
felkarcsont	humerus	Nan
felfedezése	ṣawari	Nan
felfedezések	awari	None
felfelé	sókè	Nan
felfogás	iwoye	Nan
felgyorsult	onikiakia	Nan
felhasznált	ti lo	Nan
felhasználva	ti lo	Nan
felhasználása	lilo ti	Nan
felhasználásával	lilo	Nan
felhasználó	olumulo	Nan
felhasználói	olumulo	Nan
felhasználók	awọn olumulo	Nan
felirat	atunkọ	Nan
felismerte	mọ	Nan
feljegyzések	awọn igbasilẹ	Nan
felkelés	rogbodiyan	None
felszerelt	ni ipese	Nan
felszín	dada	Nan
felszíne	dada	Nan
feltételezés	idawọle	Nan
feltételezések	awọn arosinu	Nan
feltétlenül	egba	None
feltűnik	han	Nan
feltűnt	han	Nan
feltűnő	t’ohun	Nan
felvenni	gbe	None
felvett	ti o gbasilẹ	Nan
felvette	kíkó	Nan
felvették	gba	None
felvilágosodás	imoye	Nan
felvonás	iṣe	Nan
felváltva	bibẹẹkọ	Nan
felvétel	gbigbasilẹ	Nan
felvétele	igbasilẹ	Nan
feltételezhető	aigbega	Nan
feltételezett	fura si	Nan
feltételeket	ipo	None
feltételek	ipo	None
felszínen	lori dada	Nan
felszíni	dada	Nan
felszínre	hiho okun	Nan
felszínt	dada	Nan
felszínén	awọn dada	Nan
felszínét	dada	Nan
felszólította	ro	None
felfedezték	awari	None
felső	loke	Nan
felsőfokú	alabojuto	Nan
felsőoktatási	eto-eko giga	Nan
feltehetően	jasi	Nan
feltehetőleg	aigbekele	Nan
feltárt	fi	None
feltétel	majemu	Nan
feltétele	ibeere	Nan
felsőbb	loke	Nan
fegyverrel	ohun ija	Nan
felfedezte	awari	None
felfedezett	awari	None
fejlesztések	idagbasoke	None
fejlesztési	idagbasoke	None
fejlett	ti ni ilọsiwaju	Nan
fejlettebb	to	None
fejlődik	da	None
fejlődtek	idagbasoke	None
fejlődés	idagbasoke	None
fejlődése	itankalẹ	Nan
fejlődési	idagbasoke	None
fejlődésnek	itankalẹ	Nan
fejlődést	ilọsiwaju	Nan
fejlődésének	itankalẹ	Nan
fejlődésére	itankalẹ	Nan
fejlődését	itankalẹ	Nan
fejlődött	imudarasi	Nan
fejlesztése	idagbasoke	None
fejlődő	sese	Nan
fejlesztés	idagbasoke	None
fejlesztette	idagbasoke	None
fehér	funfun	Nan
fehérek	alawo funfun	Nan
fehérjék	awọn ọlọjẹ	Nan
fej	ori	None
feje	ori	None
fejedelem	ọmọ	None
fejedelemség	ijoye	Nan
fejedelme	ọmọ	None
fejedelmek	awọn ọmọ-alade	Nan
fejedelmi	ọmọ-alade	Nan
fejezet	orí	Nan
fejezi	ṣe	Nan
fejezte	ti ṣalaye	Nan
fejezték	pari	Nan
fejlesztett	ti ni ilọsiwaju	Nan
fejlesztették	idagbasoke	None
fejtette	se alaye	Nan
fejében	awọn ọkàn	Nan
fejér	fejér	Nan
felel	idahun	Nan
felelt	idahun	Nan
felelős	lodidi	Nan
felelősek	fun	None
felelőssé	fun	None
felesleges	aibojumu	Nan
feleség	iyawo	None
felesége	iyawo	None
feleségek	aya	None
feleségének	iyawo	None
feleségét	iyawo	None
feleségével	iyawo	None
feleségül	iyawo	None
felett	loke	Nan
feletti	lori	Nan
fele	idaji	None
feldolgozó	ero isise	Nan
feldolgozása	sisẹ	Nan
felbomlása	ya kuro	Nan
fejét	ori	None
fekete	dudu	Nan
feketetenger	seakun dúdú	Nan
feketék	alawodudu	Nan
fekszik	parọ	Nan
fekvése	ipo	None
fekvő	irọ	Nan
felfedezni	ṣawari	Nan
feküdt	irọ	Nan
feladat	iṣẹ-ṣiṣe	Nan
feladata	ojuse	None
feladatok	awọn iṣẹ-ṣiṣe	Nan
feladatokat	awọn iṣẹ-ṣiṣe	Nan
feladatot	iṣẹ-ṣiṣe	Nan
feladta	sílẹ̀	None
felajánlotta	ti a nṣe	Nan
fel	sókè	Nan
divatos	asiko	Nan
divat	njagun	Nan
diszkográfia	itan	Nan
arena	gbagede	Nan
argentin	ara ilu arẹnu	Nan
argentína	ilu amẹrika	Nan
arisztokrácia	aristocracy	Nan
arisztotelész	aristotle	Nan
arnold	arnold	Nan
arra	sí	Nan
arról	nipa	Nan
arsenal	asọgun	Nan
art	awọn eewu	Nan
arthur	akite	Nan
artúr	artúr	Nan
arány	wúrà	Nan
aránya	o yẹ	Nan
arányban	ipin	None
arcát	rẹ	None
aránylag	jo	None
arcképe	aworan	Nan
arattak	kórè	Nan
apjával	baba	Nan
apollo	apollo	Nan
apolloprogram	aporoloplop	Nan
apostol	aposteli	Nan
apple	apu	Nan
apró	kekere	None
arab	lárúbáwá	None
arabok	awọn ara larubawa	Nan
arad	arad	Nan
aradi	aradi	Nan
aragóniai	aragonni	Nan
arany	wúrà	Nan
aranybulla	ẹwẹ bọọlu	Nan
aranycsapat	egbe	None
aratott	isegun	Nan
arca	rẹ	None
arányos	wuyi	Nan
arányuk	wọn	None
asimov	asimov	Nan
augusztusban	ni oṣu kẹjọ	Nan
aus	aus	Nan
auschwitz	auschwitz	Nan
ausztria	austria	Nan
ausztriában	austria	Nan
ausztriát	austria	Nan
ausztrál	ilu ọstrelia	Nan
ausztrália	australia	None
ausztráliai	australia	None
ausztráliában	australia	None
autizmus	autism	Nan
autoimmun	autoimmune	Nan
automatikus	laifọwọyi	Nan
automatikusan	laifọwọyi	Nan
autonóm	adase	Nan
augusztus	oṣu kẹjọ	Nan
atyja	baba	Nan
atya	baba	Nan
attila	attila	Nan
aspergerszindrómás	aspergerszindrómás	Nan
assisi	assisi	Nan
asszony	obinrin	Nan
asszonyok	obinrin	Nan
asztali	tabili	None
at	ni	Nan
athenaeum	athenaeum	Nan
apját	baba	Nan
athén	hensténì	Nan
atlantisz	atlantis	Nan
atlantióceán	apata okun atlanti	Nan
atlético	àlético	Nan
atom	ọgbọn	Nan
atombomba	bombu atomiki	Nan
atomok	awọn ọta	Nan
atp	atp	Nan
athéni	henténì	Nan
autonómiát	ijọba ara ẹni	Nan
apjának	baba	Nan
apai	obi	Nan
angeles	awọn angeles	Nan
angelesben	àríwá	Nan
angelesi	àríwá	Nan
angelina	angẹli	Nan
anglia	england	Nan
angliai	england	Nan
anglikán	angẹli	Nan
angliába	england	Nan
angliában	ni england	Nan
angol	gẹẹsi	Nan
angolok	arakunrin gẹẹsi	Nan
angolszász	anglo-saxon	Nan
angolszászok	anglo-saxons	Nan
angolul	ede	None
angyal	angẹli	Nan
andy	andy	Nan
angyalok	awọn angẹli	Nan
andré	andré	Nan
andrás	andrew	Nan
amiről	nipa	Nan
amit	kini	Nan
amivel	ewo	Nan
amiért	idi	Nan
amy	amy	Nan
amíg	titi	Nan
amúgy	le	None
an	á	Nan
anapesztus	afọwọkọ	Nan
anatómiai	ẹda ara	Nan
anderson	anderson	Nan
andok	andes	Nan
andor	andor	Nan
andrea	andrea	Nan
andrew	andrew	Nan
andrássy	andrássy	Nan
anikó	anikó	Nan
anime	anime	Nan
animációs	iwara	Nan
anyag	ohun elo	Nan
anyaga	ohun elo	Nan
anyagból	ohun elo	Nan
anyagi	ohun elo	Nan
anyagok	awọn ohun elo	Nan
anyagokat	oludoti	Nan
anyagot	ohun elo	Nan
anyagát	ohun elo	Nan
anyai	ìyá	Nan
anyanyelvű	nsoro	Nan
anyja	iya	Nan
anyjának	iya	Nan
anyját	iya	Nan
anyák	àwọn ìyá	Nan
apa	baba	Nan
anya	ìyá	Nan
antonio	antonio	Nan
anton	anton	Nan
antológia	anthology	Nan
animében	anime	Nan
anita	anita	None
ann	ann	Nan
anna	anna	Nan
annak	sí	Nan
anne	arene	Nan
annyi	pupọ gaan	Nan
apja	baba	Nan
annyira	iyẹn	Nan
annál	diẹ sii	Nan
antal	àṣírí	Nan
antant	entente	Nan
anthony	oloye	None
anticiklon	apakokoro	Nan
antigoné	antigone	Nan
antik	ohun atijọ	Nan
annyit	elo yẹn	Nan
amire	iwo	Nan
autó	ọkọ ayọkẹlẹ	Nan
autója	ọkọ ayọkẹlẹ	Nan
barátságos	ore	Nan
barátságot	ore	Nan
bass	baasi	Nan
batman	batman	Nan
batthyány	batthyány	Nan
bay	bay	Nan
bayern	bayern	Nan
bazilika	basilica	Nan
bazsarózsa	peony	Nan
bbc	bbc	Nan
be	loju	Nan
beagle	beari	Nan
beatles	awọn iṣẹgun	Nan
beavatkozás	ilowosi	Nan
beceneve	inagije	Nan
barátság	ore	Nan
beck	beki	Nan
barátok	ọrẹ	Nan
barátjával	ọ̀rẹ́	Nan
barcelonában	agbọnrin	Nan
barhesz	challah	Nan
barna	brown	Nan
barney	agbọnrin	Nan
barokk	baroque	Nan
barométer	barometer	Nan
barrett	iṣẹ	Nan
barry	abọ	Nan
bartók	bartók	Nan
barát	ọ̀rẹ́	Nan
barátai	ọrẹ	Nan
baráti	ore	Nan
barátja	ore	Nan
barátjának	ọ̀rẹ́	Nan
barátját	ọ̀rẹ́	Nan
barátnője	ọrẹbinrin	Nan
beckham	beckham	Nan
becslés	iṣiro	Nan
becslések	awọn iṣiro	Nan
bekövetkezett	ninu	Nan
bekövetkező	ninu	Nan
bel	bel	Nan
bele	sinu	Nan
beleegyezett	gba	None
beleértve	pẹlu	Nan
belföldi	t’ile	Nan
belga	belijiomu	Nan
belgium	bẹljiọmu	Nan
belgrád	belgrade	Nan
bell	agogo	Nan
bella	bella	Nan
belseje	inu ilohunsoke	Nan
belsejében	inu	Nan
belső	ti abẹnu	Nan
bekerült	to	None
bek	§	Nan
bejárata	ẹnu ọna	Nan
bejutott	oye	Nan
becsületes	ooto	Nan
beethoven	beethoven	Nan
befejezetlen	ailopin	Nan
befejezett	ti pari	Nan
befejezte	ti pari	Nan
befejezése	ipari	Nan
befolyás	ipa	Nan
barcelona	agbọnrin	Nan
befolyása	awọn ipa	Nan
befolyásolják	kan	None
befolyásolta	fowo	Nan
befolyásos	gbajugbaja	Nan
befolyással	ipa	Nan
beiratkozott	forukọsilẹ	Nan
bejelentette	kede	Nan
bejelenti	n kede	Nan
befolyásolja	ipa	Nan
autóbusz	bosi	Nan
barbara	barbara	Nan
barack	eso pishi	Nan
azoknak	awon na	Nan
azokon	loju	Nan
azokra	awon na	Nan
azon	awọn	Nan
azonban	sibẹsibẹ	Nan
azonnal	lẹsẹkẹsẹ	Nan
azonnali	lẹsẹkẹsẹ	Nan
azonos	kanna	Nan
azonosították	ṣe idanimọ	Nan
azt	rẹ	None
aztán	lẹhinna	Nan
azután	lẹhinna	Nan
azzal	pẹlu	Nan
azért	nitorinaa	Nan
azóta	lailai niwon	Nan
azokkal	pẹlu	Nan
babits	awọn ọmọ-ọwọ	Nan
azokban	ninu	Nan
azok	awon na	Nan
autók	oko	None
autópálya	opopona	Nan
autópályák	opopona	Nan
autót	ọkọ ayọkẹlẹ	Nan
avagy	tabi	None
avar	avá	Nan
avarok	avars	Nan
avatták	inaugurated	Nan
award	eye	Nan
awards	ẹbun	Nan
ayrton	ayrton	Nan
az	awọn	Nan
azaz	sọ	None
azelőtt	ṣaaju	Nan
aznap	ọjọ́ yẹn	Nan
azokat	awon na	Nan
bach	biriki	Nan
baja	ko	None
bajnai	bajnai	Nan
balogh	balogh	Nan
baloldali	osi	Nan
balra	lo si owo osi	Nan
balról	lati osi	Nan
balti	baliki	Nan
balázs	balásìs	Nan
ban	ninu	Nan
band	ẹgbẹ	Nan
banda	ẹgbẹ	Nan
bank	banki	Nan
bankjegyek	owo	Nan
bankok	bèbe	Nan
baptizmus	iribomi	Nan
bar	pẹpẹ	Nan
barabás	baraba	Nan
balkáni	balkan	Nan
balett	baluu	Nan
balesetet	ijamba	Nan
baleset	ijamba	Nan
bajnok	olubori	Nan
bajnoki	aṣaju	Nan
bajnokok	awọn aṣaju	Nan
bajnokság	aṣaju	Nan
bajnokságban	aṣaju	Nan
bajnokságot	aṣaju	Nan
bajor	bavarian	Nan
baranya	baranya	Nan
baksis	àgbọn	Nan
baktérium	alamọmọ	Nan
baktériumok	arun	None
baktériumokat	arun	None
bal	bọọlu	Nan
balassa	balassa	Nan
balassi	balassi	Nan
balaton	lake balaton	Nan
bakteriális	alamọdaju	Nan
belváros	aarin ilu	Nan
amint	bi	Nan
aminek	ewo	Nan
akit	tani	Nan
akitől	tani	Nan
akivel	oelu tani	Nan
akkor	lẹhinna	Nan
akkora	iwọn	Nan
akkori	lẹhinna	Nan
akkoriban	ni igba yen	Nan
aktuális	lọwọlọwọ	Nan
aktív	lọwọ	Nan
aktívan	actively	Nan
akusztikus	ẹyẹ	Nan
akác	acikia	Nan
akár	yoo	None
akárcsak	kan	None
al	al	Nan
akiről	àjọ who	Nan
alacsony	kekere	None
akinek	si tani	Nan
akikkel	oelu tani	Nan
akadémián	omowe	Nan
akar	yoo	None
akarat	yoo	None
akarata	yoo	None
akarja	si	Nan
akarnak	fé	None
akart	fẹ	Nan
akarta	fẹ	Nan
akartak	wọn	None
akarták	wọn	None
akció	ìṣe	Nan
akhilleusz	achilles	Nan
aki	àjọ who	Nan
akik	àjọ who	Nan
akiket	àjọ who	Nan
akiknek	si tani	Nan
alacsonyabb	kere	Nan
aladár	aladar	Nan
alagút	eefin	Nan
alakítottak	ṣẹda	Nan
alakították	ti a ṣe	Nan
alakító	lara	Nan
alakú	sókè	Nan
alan	alan	Nan
alanyeset	alanyeset	Nan
alap	ipilẹ	Nan
alapfokú	alakọbẹrẹ	Nan
alapja	ipile	Nan
alapjai	awọn ipilẹ	Nan
alapjait	awọn ipilẹ	Nan
alapján	da	None
alapját	ipilẹ	Nan
alapjául	ipilẹ	Nan
alapon	ipilẹ	Nan
alakította	sókè	Nan
alakított	akoso	Nan
alakítja	awọn iyipada	Nan
alakít	apẹrẹ	Nan
alajos	alajos	Nan
alak	fọọmu	Nan
alakban	apẹrẹ	Nan
alakja	apẹrẹ	Nan
alakjai	isiro	Nan
alakjában	awọn fọọmu	Nan
alakját	apẹrẹ	Nan
akadémiai	omowe	Nan
alakok	isiro	Nan
alakul	ndagba	Nan
alakulat	ibiyi	Nan
alakulatok	awọn ipa	Nan
alakulnak	da	None
alakult	ipilẹ	Nan
alakultak	idagbasoke	None
alakulása	itankalẹ	Nan
alakot	apẹrẹ	Nan
alaposan	daradara	Nan
akadémia	omowe	Nan
akadtak	won wa	Nan
ad	fifun	Nan
adam	adam	Nan
adams	adams	Nan
adat	data	Nan
adatai	alaye	Nan
adatait	alaye	Nan
adatok	data	Nan
adatokat	data	Nan
adatot	data	Nan
addig	titi lẹhinna	Nan
addigi	ti tẹlẹ	Nan
addigra	to	None
adja	tẹ	Nan
adjon	fifun	Nan
adminisztratív	isakoso	Nan
acél	irin	Nan
admirális	ẹwa	Nan
act	iṣe	Nan
acdc	acdc	Nan
=	=	Nan
>	&gt;	Nan
a	awọn	Nan
ab	ab	Nan
aba	aba	Nan
abba	rẹ	None
abban	rẹ	None
abból	lati ibẹ	Nan
abc	abc	Nan
abraham	rabúráhámù	Nan
abszint	absinthe	Nan
abszintot	absinthe	Nan
abszolút	idi	Nan
abu	nkan	None
ac	ac	Nan
achát	agate	Nan
adnak	wọn	None
adni	fifun	Nan
adolf	adágún	Nan
ahogyan	bi	Nan
ahol	nibo	Nan
ahonnan	lati ibo	Nan
ahova	nibo	Nan
ahová	nibo	Nan
ai	ai	Nan
aids	eedi	Nan
air	ategun	Nan
aires	afẹfẹ	Nan
airsoft	ategun	Nan
ajánlatot	ìfilọ	Nan
ajánlott	niyanju	Nan
ajánlotta	niyanju	Nan
akad	lags	Nan
akadt	mú	Nan
ahogy	bi	Nan
ahhoz	si o	Nan
agy	ọpọlọ	Nan
agatha	agatha	Nan
adott	fifun	Nan
adrian	adrian	Nan
adta	fún	Nan
adtak	wọn	None
adták	tu silẹ	Nan
ady	ady	Nan
adó	owo-ori	Nan
akadályozta	idilọwọ	Nan
adódik	nitori	Nan
adót	ori	None
afganisztán	afiganisitani	Nan
afganisztáni	afiganisitani	Nan
afgán	ara ilu afiganisitani	Nan
afrika	afirika	Nan
afrikai	ara ilu afirika	Nan
afrikában	afirika	Nan
adók	fun	None
aminosavak	amino acids	Nan
alapot	ipile	Nan
alapul	da	None
alpesi	alpine	Nan
alpha	alfa	Nan
alpok	alẹ	Nan
alsó	kere	Nan
alsóbb	kere	Nan
alternatív	omiiran	Nan
alul	isalẹ	Nan
alumínium	alumọni	Nan
alá	ni isalẹ	Nan
alább	nibi	Nan
alábbi	ni isalẹ	Nan
alábbiak	atẹle naa	Nan
aláírta	fowo si	Nan
aláírása	fowo si	Nan
alól	lati	Nan
alonso	alonso	Nan
am	emi	Nan
alma	apu	Nan
allen	pẹlẹ	Nan
alkotnak	fọọmu	Nan
alkotott	ṣẹda	Nan
alkotta	ṣẹda	Nan
alkottak	ṣẹda	Nan
alkották	ṣẹda	Nan
alkotás	ẹda	Nan
alkotása	paṣipaarọ naa	Nan
alkotásai	awọn idasilẹ	Nan
alkotások	awọn ẹda	Nan
alkotó	ẹda	Nan
alkotói	ẹda	Nan
alkotója	eleda	Nan
alkotók	awọn ẹlẹda	Nan
alkotórésze	paati	Nan
allan	allan	Nan
allél	allele	Nan
amatőr	magbowo	Nan
ambrus	ikọlu	Nan
amellett	yàtò	None
american	ara ilu amẹrika	Nan
amerika	amẹrika	Nan
amerikai	ara ilu amẹrika	Nan
amerikaiak	ara amẹrika	Nan
amerikába	si america	Nan
amerikában	amẹrika	Nan
ami	ewo	Nan
amiben	ninu eyiti	Nan
amiből	ewo	Nan
amihez	ewo	Nan
amik	kini	Nan
amiket	kini	Nan
amikor	nigbawo	Nan
amilyen	bi	Nan
amin	amine	Nan
america	america	Nan
amennyiben	iní	None
amennyi	bi ni	Nan
amelyről	ewo	Nan
amellyel	pẹlu eyiti	Nan
amely	ewo	Nan
amelybe	ewo	Nan
amelyből	ewo	Nan
amelyek	ewo	Nan
amelyekben	ewo	Nan
amelyeken	ewo	Nan
alkotmányt	ofin	None
amelyeket	ewo	Nan
amelyeknek	ewo	Nan
amelyen	ewo	Nan
amelyet	ewo	Nan
amelyhez	ewo	Nan
amelyik	ewo	Nan
amelynek	ewo	Nan
amelyre	ewo	Nan
amelyekkel	ewo	Nan
alapszik	da	None
alkotmányos	t’olofin	Nan
alkotmánya	t’olofin	Nan
albuma	awo-orin	Nan
albumok	awọn awo-orin	Nan
albumon	awo-orin	Nan
albumot	awo-orin	Nan
albumról	awo-orin	Nan
albumuk	awo-orin	Nan
albumát	awo-orin	Nan
albán	albania	Nan
albánia	albania	Nan
albánok	awọn ara alibani	Nan
aldehid	aldehyde	Nan
alelnök	igbakeji piresidenti	Nan
alessandro	alessandro	Nan
alex	alex	Nan
alexander	alaapọn	Nan
album	awo-orin	Nan
alexandra	alexandra	None
alberto	alberto	Nan
alatti	ni isalẹ	Nan
alapuló	loju	Nan
alapvető	ipilẹ	Nan
alapvetően	besikale	Nan
alapított	ipilẹ	Nan
alapította	ipilẹ	Nan
alapítottak	ipilẹ	Nan
alapították	ipilẹ	Nan
alapítvány	ipile	Nan
alapítása	ipile	Nan
alapító	oludasile	Nan
alapítója	oludasile	Nan
alapú	orisun	None
alaszka	alaska	Nan
alatt	labẹ	Nan
alatta	labẹ	Nan
albert	ominira	Nan
alexandrosz	alexander	Nan
alfa	alfa	Nan
alfonz	alfonso	Nan
alkalmazás	ohun elo	Nan
alkalmazása	ohun elo	Nan
alkalmazások	awọn ohun elo	Nan
alkalmazásával	ohun elo	Nan
alkalmi	àjọsọpọ	Nan
alkalmából	lori ayeye ti	Nan
alkalmával	ayeye	Nan
alkalom	ayeye	Nan
alkalommal	aago	Nan
alkatrészek	awọn ẹya	Nan
alkohol	oti	Nan
alkoholt	oti	Nan
alkot	ṣẹda	Nan
alkotják	ifipaju	Nan
alkotmány	t’olofin	Nan
alkalmazzák	waye	Nan
alkalmazza	waye	Nan
alkalmazták	ti lo	Nan
alkalmaztak	ti lo	Nan
alfred	sẹsẹ	Nan
alfréd	alfred	Nan
alföld	kekere	None
alföldi	awọn pẹtẹlẹ nla	Nan
ali	ali	Nan
alig	igboro	Nan
alján	isalẹ	Nan
alkotmánybíróság	court of t’olofin	Nan
alkalmanként	lẹẹkọọkan	Nan
alkalmasak	o dara	Nan
alkalmat	aye	Nan
alkalmazható	wulo	Nan
alkalmaznak	ti lo	Nan
alkalmazni	waye	Nan
alkalmazott	oṣiṣẹ	Nan
alkalmazta	gbẹyin	Nan
alkalmas	o dara	Nan
funkció	iṣẹ	Nan
belvárosban	aarin ilu	Nan
belépett	wọle	Nan
családot	idile	Nan
csapadék	ojo	None
csapadékmennyiség	òjò	Nan
csapat	egbe	None
csapata	ẹgbẹ naa	Nan
csapatai	awọn ẹgbẹ	Nan
csapatait	ogun	None
csapatban	egbe	None
csapatnak	egbe	None
csapatok	ogun	None
csapatokat	ogun	None
csapatot	egbe	None
csapattal	egbe	None
csapattársa	ẹlẹgbẹ	Nan
csapatának	olukọ	Nan
családok	idile	Nan
csapatát	egbe	None
családnak	idile	Nan
családját	idile	Nan
cross	rekọja	Nan
cruz	cruz	Nan
csaba	csaba	Nan
csak	kan	None
csakhamar	laipe	Nan
csakis	nikan	Nan
csaknem	fẹẹrẹ	Nan
csakúgy	nítorípé	None
család	idile	Nan
családban	idile	Nan
családból	idile	Nan
családfája	molebi	Nan
családi	idile	Nan
családja	ebi	None
családjának	idile	Nan
családjával	ebi	None
csapás	ajalu	Nan
csapást	fẹ	Nan
csarnok	gbongan	Nan
cselekvés	ìṣe	Nan
csendes	dakẹrọrọ	Nan
csendesóceán	okun pasifiki	Nan
csendesóceáni	pacific	Nan
csere	paṣipaarọ	Nan
cserébe	ni paṣipaarọ	Nan
csillag	irawo	Nan
csillaga	irawo	Nan
csillagok	irawọ	Nan
csillagunk	irawo wa	Nan
csillagász	awòràwọ	Nan
csillagászat	aworawo	Nan
csillagászati	aworawo	Nan
csillagászok	aworawo	Nan
csinált	ṣe	Nan
cselekménye	iṣe	Nan
cselekmény	ìṣe	Nan
csekély	diẹ	Nan
csehszlovákia	czechoslovakia	Nan
csata	ogun	None
csatlakozik	darapo	None
csatlakozott	darapo	None
csatlakoztak	darapo	None
csatlakozó	jaketi	Nan
csatolt	somọ	Nan
csatolták	somọ	Nan
costa	idiyele	Nan
csatorna	ikanni	Nan
csatornán	ikanni	Nan
csatában	ogun	None
csatát	ogun	None
cseh	czech	Nan
csehek	czechs	Nan
csehország	ilẹ	None
csehszlovák	czechoslovak	Nan
csatornák	awọn ikanni	Nan
csoda	iyanu	Nan
corvina	corvina	Nan
corona	koko	Nan
channel	ikanni	Nan
chaplin	tẹmpili	Nan
chapman	ijosin	None
charles	awọn ẹru	Nan
charlie	ṣaja	Nan
chase	lepa	Nan
che	che	Nan
chelsea	chelsea	Nan
chicago	chicago	Nan
chile	ede	None
chopin	chopin	Nan
chris	kilasi	Nan
christian	kristiẹni	Nan
christie	kristiẹni	Nan
christopher	christi	Nan
chandler	chandler	Nan
chuck	chuck	Nan
cf	cf	Nan
center	aarin	Nan
campo	campo	Nan
can	le	None
canis	ibori	None
capone	capone	Nan
carl	carl	Nan
carlo	ọkọ ayọkẹlẹ	Nan
carlos	carlos	Nan
carter	ataja	Nan
cartman	alagbẹdẹ	Nan
cartographia	cartograsia	Nan
casa	casa	Nan
castro	ọpọlọ	Nan
catherine	catherine	None
cc	cc	Nan
cd	cd	Nan
cenzúra	ipanu	Nan
churchill	churchill	Nan
cia	bẹẹ	Nan
cigány	gypsy	Nan
claude	robi	Nan
cleese	cleese	Nan
cleveland	cleveland	Nan
cliff	àpáta	Nan
clint	clint	Nan
club	ọgọ	Nan
co	co	Nan
cobain	cobain	Nan
cobra	kobi	Nan
college	kọlẹji	Nan
color	awọ	Nan
columbia	ẹyẹ	Nan
comedy	awada	Nan
comics	awada	Nan
concerto	gbimọ	Nan
class	kilasi	Nan
clark	pẹtẹlẹ	Nan
civilizáció	ọlaju	Nan
civil	ara ilu	Nan
cigányok	gypsies	Nan
cigányság	gypsies	Nan
cikk	nkan	None
cikke	nkan	None
cikkei	nkan	None
cikkek	nkan	None
cikkeket	nkan	None
corvin	corvin	Nan
cikket	nkan	None
ciklámen	cyclamen	Nan
cikászfélék	awọn kẹkẹ	Nan
ciprus	kírúsì	Nan
ciprusi	kírúsì	Nan
cirill	cyrillic	Nan
cirkon	zircon	Nan
city	ilu	Nan
ciklus	ọmọ	None
camp	àgọ́	None
csodálatos	iyanu	Nan
csoma	jade	Nan
dead	kú	Nan
dean	diini	Nan
debrecen	debrecen	Nan
debrecenben	ni debrecen	Nan
debreceni	debrecen	Nan
debütált	uncomfortable	Nan
debütáló	uncomfortable	Nan
december	oṣu kejila	Nan
decemberben	ni oṣu kejìlá	Nan
definíció	itumo	None
dei	dei	Nan
del	guusu	None
delfin	ẹja abirun	Nan
delle	delle	Nan
demográfiai	ibi eeyan	Nan
de	ṣugbọn	Nan
demokrata	tiwantiwa	Nan
dc	dc	Nan
david	dáfídì	Nan
dalát	orin	Nan
dalí	dalí	Nan
dan	ede	None
daniel	daniel	Nan
dante	dante	Nan
darab	nkan	None
darabja	nkan	None
darabjai	awọn ege	Nan
darabok	awọn ege	Nan
darabot	awọn ege	Nan
dareiosz	dariusi	Nan
dark	dudu	Nan
darualakúak	gruiformes	Nan
darwin	darwin	Nan
dave	dave	Nan
davis	davis	Nan
demokratikus	tiwantiwa	Nan
demokraták	awọn alagbawi	Nan
demokrácia	tiwantiwa	Nan
diamond	okuta iyebiye	Nan
dicaprio	dicaprio	Nan
dick	dick	Nan
die	kú	Nan
diego	kú	Nan
digitális	oni-nọmba	Nan
diktatúra	ijọba ijọba	Nan
dilléniafélék	dilléniafélék	Nan
dinamikus	ìmúdàgba	Nan
dinasztia	oba	None
dinoszaurusz	dainoso	Nan
dinoszauruszok	dinosaurs	Nan
diplomáciai	oselu ara ilu	Nan
diplomát	ìyí nínú	Nan
disney	disney	Nan
diagnózis	ayẹwo	Nan
diabétesz	atọgbẹ	Nan
diabetes	atọgbẹ	Nan
di	di	Nan
dennis	dennis	Nan
denudáció	aigbagbọ	Nan
depeche	depeche	Nan
depresszió	ibanujẹ	Nan
der	der	Nan
derékszögű	onigun mẹrin	Nan
derül	fi	None
dalt	orin	Nan
derült	ko	None
descartes	descartes	Nan
deutsche	deutsche	Nan
dexter	dexter	Nan
dezoxiribóz	deoxyribose	Nan
dezső	dezső	Nan
deák	akọwe	Nan
dharma	dharma	Nan
des	des	None
csokonai	csokonai	Nan
dalokat	awọn orin	Nan
dalmácia	dalmatia	Nan
csík	ṣiṣan	Nan
csíkszereda	miercurea ciuc	Nan
csökken	dinku	Nan
csökkent	dinku	Nan
csökkentette	dinku	Nan
csökkenti	n dinku	Nan
csökkentik	din	None
csökkentése	atehinwa	Nan
csökkenése	dinku	Nan
csökkenő	dinku	Nan
csúcsa	tente oke	Nan
csúcspontja	gongo	Nan
csúcsán	tente oke	Nan
cukor	ṣuga	Nan
cukorbetegség	atọgbẹ	Nan
császárt	emperor	Nan
cup	ife	Nan
császárság	ottoman	Nan
császárnak	késárì	Nan
csomópont	isunpọ	Nan
csontváry	csontvary	Nan
csontváz	egungun	Nan
csoport	ẹgbẹ	Nan
csoportba	ẹgbẹ	Nan
csoportban	ẹgbẹ	Nan
csoportja	ẹgbẹ	Nan
csoportkör	iyipo alakoko	Nan
csoportok	awọn ẹgbẹ	Nan
csoportot	ẹgbẹ	Nan
csoportra	awọn ẹgbẹ	Nan
csupán	nikan	Nan
csák	kan	None
császár	olú ọba	Nan
császári	ọba	Nan
császárral	emperor	Nan
cár	tsar	Nan
cég	ile-iṣẹ	Nan
cégek	awọn ile-iṣẹ	Nan
címere	orileede	None
címet	adirẹsi	Nan
címlapja	bo	Nan
címmel	adirẹsi	Nan
címén	adirẹsi	Nan
címét	adirẹsi	Nan
című	loju	Nan
d	o	Nan
da	da	None
dacára	pelu	Nan
dal	orin	Nan
dala	orin	Nan
dalai	dalai	Nan
dalait	awọn orin	Nan
dallas	dallas	Nan
címer	didimu	Nan
címen	ni	Nan
címek	awọn akọle	Nan
címe	o jẹ akọle	Nan
céget	ile-iṣẹ	Nan
cél	ilepa	Nan
célba	ìfọkànsí	Nan
célból	ipari	Nan
céljuk	wọn	None
céljából	le	None
célját	idi	Nan
dalok	awọn orin	Nan
céllal	ibasepo	Nan
célpontja	ibi-afẹde	Nan
célra	fun	None
célszerű	expedient	Nan
célt	ibi-afẹde	Nan
célul	ibi-afẹde	Nan
célú	idi	Nan
cím	akọle	Nan
célokra	awọn idi	Nan
belvárosi	aarin ilu	Nan
cameron	akọni	Nan
c++	c ++	Nan
bizonnyal	esan	Nan
bizonyos	dajudaju	Nan
bizonytalan	aidaniloju	Nan
bizonyult	oun	None
bizonyultak	safihan lati jẹ	Nan
bizonyítja	fi	None
bizonyítják	ṣafihan	Nan
bizonyított	safihan	Nan
bizonyíték	ẹri	Nan
bizonyítékok	ẹri	Nan
bizonyítékot	ẹri	Nan
bizottság	igbimọ	Nan
bizottsága	igbimo	Nan
bizottságot	igbimo	Nan
bizottságának	igbimo	Nan
bizarr	eemọ	Nan
biztonság	aabo	Nan
birtokában	ohun-ini	Nan
birtok	ohun-ini	Nan
bibliát	bibeli	None
bihari	bihari	Nan
bill	owo	Nan
billentyűs	onkọwe itẹwe	Nan
billentyűzet	keyboard	Nan
billy	oniruru	Nan
bin	binrin	Nan
biogeográfia	biogeography	Nan
biológiai	ẹkọ oniye	Nan
bipoláris	arabinrin	Nan
birodalma	ọba	Nan
birodalmat	ọba	Nan
birodalmi	ọba	Nan
birodalom	ottoman	Nan
birodalomban	ọba	Nan
birtokos	dimu	Nan
biztonsági	aabo	Nan
biztonságos	lailewu	Nan
biztos	daju	Nan
bob	bobsled	Nan
bobby	ariwo	Nan
bocskai	bocskai	Nan
bokros	bushy	Nan
boldog	dun	None
bolgár	ede	None
bolgárok	bulgarians	Nan
bolsevik	bolshevik	Nan
bolyai	bolyai	Nan
bolygó	ile aye	Nan
bolygók	aye orun	Nan
bolygót	ile aye	Nan
bolívia	bolivia	Nan
bolíviai	bolivian	Nan
bomba	gbamu	Nan
bmw	bmw	Nan
blokk	awọn bulọọki	Nan
blogok	awọn bulọọgi	Nan
blog	bulọọgi	Nan
biztosan	nitõtọ	Nan
biztosít	yọọda	Nan
biztosítanak	ìfilọ	Nan
biztosítani	lati fidani	Nan
biztosítja	rii daju	Nan
biztosítják	rii daju	Nan
biztosított	aṣeduro	Nan
bibliában	bibeli	None
biztosította	pese	Nan
biztosítva	aridaju	Nan
biztosítása	aridaju	Nan
biztosító	aṣeduro	Nan
bizánc	byzantine	Nan
bizánci	byzantine	Nan
bl	bl	Nan
blackmore	blackmore	Nan
biztosították	pese	Nan
bon	iwe adehun	Nan
bibliográfia	iwe itan	Nan
biblia	bibeli	None
beosztás	ifiweranṣẹ	Nan
berendezések	ohun elo	Nan
berlin	berlin	None
berlinben	berlin	None
berlini	berlin	None
bernard	bernard	Nan
bertalan	bertalan	Nan
berzsenyi	berzsenyi	Nan
best	dara julọ	Nan
beszéd	ọrọ	Nan
beszéde	ọrọ	Nan
beszédei	awọn ọrọ	Nan
beszédek	awọn ọrọ	Nan
beszédet	ọrọ	Nan
beszédében	ọrọ	Nan
bennük	wọn	None
beszél	sọrọ	Nan
benne	ninu e	Nan
benedek	onigbọnna	Nan
belül	laarin	None
belüli	ninu	Nan
belőle	rẹ	None
belőlük	wọn	None
bem	bem	Nan
bemutatja	mu wa	Nan
bemutatni	lọwọlọwọ	Nan
bemutatott	ifihan	Nan
bemutatta	gbekalẹ	Nan
bemutatták	gbekalẹ	Nan
bemutatása	igbejade	Nan
bemutató	ifihan	Nan
bemutatója	ibaṣepọ	Nan
ben	ninu	Nan
bencés	benedictine	Nan
benefícium	anfani	Nan
beszélgetés	sọrọ	Nan
beszélhetünk	le	None
beszélik	sọrọ	Nan
bevallása	gbigba	Nan
bevett	mulẹ	Nan
bevezetett	ṣafihan	Nan
bevezette	ṣafihan	Nan
bevezették	ṣafihan	Nan
bevezetés	ifihan	Nan
bevezetése	ifihan	Nan
bevezetését	ifihan ti	Nan
bevezető	ifaara	Nan
bevált	o dara	Nan
bevándorlás	iṣilọ	Nan
bevándorlók	aṣikiri	Nan
bevétele	owo-wiwọle	Nan
bevételi	owo-wiwọle	Nan
beépített	-itumọ ti	Nan
betűkkel	awọn lẹta	Nan
betűk	awọn lẹta	Nan
betű	leta	Nan
betört	gbogun ti	Nan
beszélnek	sọrọ	Nan
beszélni	sọrọ	Nan
beszélt	sọ	None
beszéltek	nsoro	Nan
beszélünk	an	None
beszélő	nsoro	Nan
beteg	alaisan	Nan
bibliai	bibeli	None
betegek	alaisan	Nan
betegsége	aisan	Nan
betegségek	arun	None
betegséget	aisan	Nan
bethlen	betlen	Nan
betiltotta	gbesele	Nan
betiltották	gbesele	Nan
betöltött	ti kojọpọ	Nan
betegség	aisan	Nan
caesar	késárì	Nan
bonaparte	bonaparte	Nan
bontakozott	ṣi silẹ	Nan
bécsi	ede	None
békaszőlőfélék	potamogetonaceae	Nan
béke	alafia	Nan
békeszerződés	adehun alafia	Nan
békeszerződést	adehun alafia	Nan
békében	alafia	Nan
békés	alaafia	None
békéscsaba	békéscsaba	Nan
békéscsabán	békéscsaba	Nan
békét	alafia	Nan
béla	bééla	Nan
bélhurut	àtọgbẹ	Nan
bélyegkép|a	atanpako | a	Nan
bélyegkép|balra|px|a	atanpako | osi | px | awọn	Nan
bélyegkép|jobbra|px|	atanpako | ọtun | px |	Nan
bécsben	ni wienna	Nan
bélyegkép|jobbra|px|az	atanpako | ọtun | px | awọn	Nan
bécsbe	vienna	Nan
bázis	mimọ	Nan
bánt	ṣẹ	Nan
bántalmak	ẹdun ọkan	Nan
bányászat	iwakusa	Nan
bár	pẹpẹ	Nan
bárki	ẹnikẹni	Nan
bármely	eyikeyi	Nan
bármelyik	boya	Nan
bármikor	nigbakugba	Nan
bármilyen	eyikeyi	Nan
bárány	agutan	Nan
báró	baron	Nan
bástya	ipilẹ	Nan
báthory	bathory	Nan
bátor	onígboyà	Nan
bátyja	arakunrin	Nan
bécs	vienna	Nan
bélyegkép|jobb|px|a	atanpako | ọtun | px | awọn	Nan
bélyegkép|px|a	thumbnail | px | awọn	Nan
bélyegkép|px|balra|a	atanpako | px | osi | a	Nan
büntetés	itanran	Nan
büntetést	itanran	Nan
büszke	agberaga	Nan
ből	lati	Nan
bőr	awọ	Nan
bővebben	diẹ sii	Nan
bőven	lọpọlọpọ	Nan
bűn	ẹṣẹ	Nan
bűncselekmény	ilufin	Nan
bűncselekmények	awọn ẹṣẹ	Nan
bűnök	odaran	Nan
bűnös	ẹlẹṣẹ	Nan
bűnözés	ilufin	Nan
bűnöző	ọdaran	Nan
bűnügyi	ọdaran	Nan
búza	alikama	Nan
búcsú	o ṣeeṣe	Nan
börtönben	ẹwọn	Nan
börtönbe	ẹwọn	Nan
bélyegkép|px|jobb|a	atanpako | px | otun | awọn	Nan
bérelt	yiyalo	Nan
bíboros	kadinal	Nan
bír	ni	Nan
bírálta	ti ṣofintoto	Nan
bírói	ofin	None
bíróság	kootu	Nan
bánk	banki	Nan
bírósági	ofin	None
bízott	gbekele	Nan
bízta	le	None
bízták	le	None
ból	lati	Nan
bölcs	sage	Nan
bölcsek	ologbon	Nan
böngésző	aṣàwákiri	Nan
bíróságok	kootu	Nan
bond	mnu	Nan
bán	ninu	Nan
bácskiskun	arakunrin kiskun	Nan
botticelli	botticelli	Nan
box	àpótí	Nan
boy	ọmọkunrin	Nan
bozsik	bozsik	Nan
bp	bp	Nan
bpest	bpest	Nan
brassó	brasov	Nan
brassói	brasov	Nan
bratislava	bratislava	Nan
brazil	ara ilu brazil	Nan
brazília	ilu brazil	Nan
brazíliában	brazil	Nan
bregma	bregma	Nan
brian	bẹtẹli	Nan
bridge	afara	Nan
botrányt	ẹgan	Nan
brit	ilẹ̀ ọba gẹẹsi	Nan
botrány	ẹgan	Nan
boszniahercegovina	boszniahercegovina	Nan
bonyolult	eka	None
bonyolultabb	diẹ idiju	Nan
book	iwe	Nan
books	awọn iwe	Nan
bor	awọ	Nan
borderline	ààlà	Nan
borok	awọn ẹmu	Nan
borsodabaújzemplén	borsod abaúj zemplén	Nan
borvidék	orilẹ-ede waini	Nan
borítja	ti bo	Nan
borított	ti bo	Nan
borító	ideri	Nan
bosnyák	bosniani	Nan
bosszút	ẹsan	Nan
bosznia	bosnia	Nan
boszniai	bosnia	Nan
britannia	gẹẹsi	Nan
britek	ijọba	Nan
british	oloogun	Nan
buddhizmus	buddhism	Nan
budán	ni buda	Nan
buenos	buenos	Nan
bukarest	bucharest	Nan
bukott	ṣubú	Nan
bukása	ṣubu	Nan
bulgária	bulgaria	Nan
burton	ajekii	Nan
bush	igbo	Nan
busz	bosi	Nan
buszok	awọn ọkọ akero	Nan
buzérfélék	rubiaceae	Nan
bvitamin	bvitamin	Nan
by	nipasẹ	Nan
bácsi	arakunrin	Nan
buddhista	buddhist	Nan
buddha	buddha	Nan
budavári	buda	Nan
budapestre	si budapest	Nan
britney	britney	Nan
bronz	idẹ	Nan
bros	bros	Nan
brothers	awọn arakunrin	Nan
brown	brown	Nan
bruce	bruce	Nan
bruttó	gbogbogbo	None
bálint	falenta	Nan
brüsszel	biroseli	Nan
bt	bt	Nan
bud	egbọn	Nan
buda	buda	Nan
budai	buda	Nan
budapest	budapest	Nan
budapesten	ni budapest	Nan
budapesti	lati budapest	Nan
brüsszelben	ni bẹljiọmu	Nan
űrszonda	ọkọ ofurufu	Nan
funkciója	iṣẹ	Nan
furcsa	ajeji	Nan
kezd	bẹrẹ	Nan
kezdeményezett	ipilẹṣẹ	Nan
kezdeményezés	ipilẹṣẹ	Nan
kezdeményezésére	ipilẹṣẹ	Nan
kezdenek	berè	Nan
kezdetben	lakoko	Nan
kezdete	bẹrẹ	Nan
kezdetek	awọn ibẹrẹ	Nan
kezdetektől	bẹrẹ	Nan
kezdeti	ni ibẹrẹ	Nan
kezdett	bẹrẹ	Nan
kezdettől	bẹrẹ	Nan
kezdetén	ni ibere	Nan
kezdetét	ibẹrẹ ti	Nan
kezdi	bẹrẹ	Nan
kevéssé	diẹ	Nan
kezdte	bẹrẹ	Nan
kevésbé	ti o kere	Nan
keveset	diẹ	Nan
keskeny	dín	Nan
kesu	cashew	Nan
kettejük	wọn	None
ketten	àwa méjì	Nan
kettes	meji	Nan
kettő	meji	Nan
kettős	meji	Nan
kettőt	meji	Nan
keveredett	dapọ	Nan
kevert	dapọ	Nan
keverék	dapọ	Nan
keveréke	dapọ	Nan
kevesebb	ti o kere	Nan
kevesebbet	ti o kere	Nan
kevesen	diẹ	Nan
kevés	diẹ	Nan
keserű	kikoro	Nan
kezdtek	bẹrẹ	Nan
kezdve	lati	Nan
kiad	oro	Nan
kiadatlan	tí a tẹjade	Nan
kiadott	atejade	Nan
kiadta	tu silẹ	Nan
kiadták	tu silẹ	Nan
kiadvány	atẹjade	Nan
kiadványok	jẹ ti	Nan
kiadás	inawo	Nan
kiadása	àtúnse	Nan
kiadások	inawo	Nan
kiadásában	àtúnse	Nan
kiadását	àtúnse	Nan
kiadó	akede	Nan
kiadója	akede	Nan
kialakult	mulẹ	Nan
ki	àjọ who	Nan
kezdték	wọn	None
kft	ltd.	Nan
kezére	ọwọ	Nan
kezdő	alakọbẹrẹ	Nan
kezdődik	berè	Nan
kezdődtek	bẹrẹ	Nan
kezdődött	bẹrẹ	Nan
kezdődően	bẹrẹ	Nan
keze	ọwọ	Nan
kezeli	kapa	Nan
kezelik	tọju	Nan
kezelni	ibaṣowo	Nan
kezelte	tọju	Nan
kezelés	itọju	Nan
kezelése	rẹ	None
kezelésére	itọju	Nan
kezébe	ọwọ	Nan
kezében	ọwọ	Nan
kezét	ọwọ	Nan
kerülő	lati jẹ	Nan
kerülése	etanje	Nan
kerültek	wọn	None
kemény	lile	Nan
keményebb	gba	None
keményen	lile	Nan
keménység	líle	Nan
ken	efin	Nan
kennedy	keniyan	Nan
kenny	omobirin	Nan
kerek	mo beere	Nan
kerepesi	awọn kerepes	Nan
keres	fun	None
keresett	wá	Nan
keresi	nwa	None
kereskedelem	iṣowo	Nan
kereskedelmi	isowo	Nan
kereskedő	oniṣowo	Nan
kelták	awọn celts	Nan
kereskedők	awon eniti onta moto	Nan
keltett	ṣẹda	Nan
kelt	fa	Nan
keletkeznek	ṣẹda	Nan
keletkeztek	dide	Nan
keletkezése	ibiyi	Nan
keletkezésének	dida ti	Nan
keletkező	abajade	Nan
keletre	si ila-oorun	Nan
keletről	ila-oorun	Nan
keletű	laipẹ	Nan
kell	gbọdọ	Nan
kellemes	dídùn	Nan
kellemetlen	alailoriire	Nan
kellene	yẹ	Nan
kellett	nilo	Nan
kelly	kelly	Nan
kellő	nilo	Nan
kelta	seliketi	Nan
keresni	lati wa	Nan
kereste	wá	Nan
kereszt	rekọja	Nan
kert	ọgba	Nan
kertjében	ọgba	Nan
kertész	oluṣọgba	Nan
kerül	iye owo	Nan
kerület	agbegbe	Nan
kerületben	agbegbe	Nan
kerülete	agbegbe	Nan
kerületek	awọn agbegbe	Nan
kerületi	kaakiri	Nan
kerületében	agbegbe	Nan
kerülhet	mu	Nan
kerülhetett	le	None
kerülnek	jẹ	Nan
kerülni	fun	None
került	iye owo	Nan
kernel	ekuro	Nan
keringő	waltz	Nan
keringési	kaakiri	Nan
keringenek	orbitin	Nan
keresztapa	omo baba olorun	Nan
keresztelő	keresimesi	Nan
keresztes	agbelebu	Nan
keresztesek	awọn ọgagun	Nan
keresztény	kristiẹni	Nan
kereszténydemokrata	kristiẹni	Nan
keresztények	awọn kristiani	Nan
kialakultak	idagbasoke	None
kereszténység	kristiẹniti	Nan
keresztül	kọja	Nan
kereső	oluwari	Nan
keretein	ilana	None
keretek	awọn fireemu	Nan
keretében	ilana	None
keretén	ilana	None
kering	orbitin	Nan
kereszténységet	kristiẹniti	Nan
kialakulása	ibiyi	Nan
kialakulásában	ibiyi	Nan
kialakulásához	ibiyi	Nan
kiterjesztette	afikun	Nan
kitört	parun	Nan
kitörés	ariwo	Nan
kitörése	ìbújáde	Nan
kitörések	iparun	Nan
kitűnő	o tayọ	Nan
kitűzött	ṣeto	Nan
kiválasztott	yan	None
kiváltság	prerogative	Nan
kiváltó	fa	Nan
kiváló	o tayọ	Nan
kiválóan	pipe	Nan
kivégezték	pa	Nan
kivégzés	ipaniyan	Nan
kivétel	ayafi	Nan
kiterjedő	gbooro si	Nan
kivételek	imukuro	Nan
kiterjedésű	onisẹpo	Nan
kiterjedt	sanlalu	Nan
kisebbnagyobb	kekere	None
kisebbség	ẹlẹgbẹ	Nan
kisebbségek	kekere	None
kisebbségi	kekere	None
kisfaludy	kisfaludy	Nan
kisimoto	kisimoto	Nan
kislemez	awọn ẹlẹgbẹ	Nan
kislemeze	ẹyọkan	Nan
kispályás	ẹgbẹ-ẹgbẹ	Nan
kiss	fẹnuko	Nan
kissé	a bit	Nan
kistérség	ipinya	Nan
kisváros	kekere	None
kit	tani	Nan
kitalált	aijẹ ootọ	Nan
kiterjedése	itẹsiwaju	Nan
kivételes	yatọ	Nan
kivételt	ayafi	Nan
kivételével	ayafi	Nan
kolostor	monastery	Nan
kolozsvár	kolozsvár	Nan
kolozsvári	cluj	Nan
kolumbia	ilu columbia	Nan
kolumbusz	ilu columbus	Nan
komikus	apanilerin	Nan
kommunikáció	ibaraẹnisọrọ	Nan
kommunikációs	ibaraenisọrọ	Nan
kommunista	communist	Nan
kommunisták	komunisonu	Nan
kommunizmus	ibaraẹnisọrọ	Nan
komoly	to	None
komolyabb	to	None
komolyan	isẹ	Nan
komplex	eka	None
kollégium	ibusun	Nan
kollektív	collective	Nan
kodály	kodály	Nan
kocsis	ataja	Nan
kivéve	ayafi	Nan
kizárólag	iyasọtọ	Nan
kiállítás	ifihan	Nan
klasszicista	ayebaye	Nan
klasszicizmus	ayebaye	Nan
klasszikus	ayebaye	Nan
klaus	klaus	Nan
kisebbik	kere	Nan
klimatológia	oke-nla	Nan
klub	ọgọ	Nan
klubok	ọgọ	Nan
klára	klára	Nan
km	km	Nan
koalíció	isokan	Nan
koalíciós	isokan	Nan
kocsi	ọkọ ayọkẹlẹ	Nan
klinikai	isẹgun	Nan
keletkezik	ti ipilẹṣẹ	Nan
kisebb	ti o kere	Nan
királyt	ọba	Nan
kiesett	subu	Nan
kifejezetten	ni pataki	Nan
kifejezés	ikosile	Nan
kifejezések	awọn ikosile	Nan
kifejezést	ikosile	Nan
kifejlesztett	idagbasoke	None
kifelé	jade	Nan
kifolyólag	fun	None
kihalt	parun	Nan
kihalási	iparun	Nan
kihasználva	mu anfani	Nan
kiindulva	bẹrẹ lati	Nan
kiinduló	ni ibẹrẹ	Nan
kijelentette	ṣalaye	Nan
kijelenti	awọn ipinlẹ	Nan
kiemelt	tẹnumọ	Nan
kijelölt	yan	None
kiemelkedően	dayato	Nan
kielégítő	itelorun	Nan
kialakulásának	ibiyi	Nan
kialakulását	ibiyi	Nan
kialakuló	dagbasi	Nan
kialakított	akoso	Nan
kialakítása	apẹrẹ	Nan
kialakításában	ilosiwaju ti	Nan
kiazmus	chiasmus	Nan
kibocsátott	ti oniṣowo	Nan
kicsi	kekere	None
kicsit	diẹ	Nan
kiderül	han	Nan
kiderült	o wa ni tan	Nan
kidolgozott	idagbasoke	None
kiegyezés	adehun adehun	Nan
kiegészítő	afikun	Nan
kiemelkedő	dayato	Nan
kik	àjọ who	Nan
kikiáltották	kede	Nan
kikötő	ibudo	Nan
királlyal	ọba	Nan
királlyá	ọba	Nan
király	ọba	Nan
királya	ọba	Nan
királyfi	olori	Nan
királygébics-alkatúak	ijọba	Nan
királyhoz	ọba	Nan
királyi	ọba	Nan
királynak	ọba	Nan
királyné	ayaba	Nan
királynő	ayaba	Nan
királyok	awọn ọba	Nan
királyság	ijọba	Nan
királyságban	ijọba	Nan
királyságot	ijọba	Nan
kirk	kirk	Nan
king	ọba	Nan
kinevezett	yan	None
kinek	fun	None
kikötője	omi	None
kikötők	omi	None
kilenc	mẹsan	Nan
kilencedik	ẹkẹsan	Nan
kilencvenes	ọkan-din-logun	Nan
kilométer	kilomita	Nan
kilépett	jade wá	Nan
kis	kekere	None
kim	kim	Nan
kimaradt	osi jade	Nan
kimi	rẹrin	Nan
kimondja	awọn ipinlẹ	Nan
kimondta	ti o wi	Nan
kimutatható	ri	Nan
kimutatták	han	Nan
kincstár	ìṣúra	Nan
kimagasló	dayato	Nan
keletkezett	ti ipilẹṣẹ	Nan
keleti	ila-oorun	Nan
keleteurópai	ara ilu yuroopu	Nan
josep	josepha	Nan
joseph	joseph	Nan
josé	josé	Nan
journal	iwe irohin	Nan
jpn	jpn	Nan
jr	jr	Nan
juan	juan	Nan
judaizmus	ẹsin juu	Nan
judit	idajọ	Nan
jugoszláv	yugoslav	Nan
jugoszlávia	yugoslavia	Nan
juh	agutan	Nan
juhász	oluṣọ-agutan	Nan
juhászkutya	ajá àgùntàn	Nan
julius	oṣu keje	Nan
jordan	jordan	Nan
jump	fo	Nan
jones	awọn agbegbe	Nan
jon	jon	Nan
joggal	ni ọtun	Nan
jogi	yogi	Nan
jogok	awọn ẹtọ	Nan
jogokat	awọn ẹtọ	Nan
jogot	ni ọtun	Nan
jogát	ni ọtun	Nan
jogú	ni ọtun	Nan
johann	johann	None
johanna	jean	Nan
johannes	johannes	Nan
john	john	Nan
johnny	johnny	Nan
johnson	johnson	Nan
jolie	jolie	Nan
jolán	jolán	Nan
jonathan	jonathan	Nan
jupiter	jupita	Nan
jut	wá	Nan
jutnak	gba	None
játssza	ìtàgé	Nan
játsszák	mu ṣiṣẹ	Nan
játszanak	wọn	None
játszani	lati mu ṣiṣẹ	Nan
játszhatott	dun	None
játszik	mu ṣiṣẹ	Nan
játszott	dun	None
játszotta	dun	None
játszottak	dun	None
játszották	dun	None
játszó	ibi isereile	Nan
játszódik	ibi	Nan
játszódó	ṣeto sinu	Nan
játék	eré	Nan
játékban	eré	Nan
járó	pẹlu	Nan
járás	rìn	None
járvány	àrùn	None
járult	tiwon	Nan
jutni	gba	None
jutott	de ọdọ	Nan
jutottak	de ọdọ	Nan
jutó	fun	None
juventus	juventus	Nan
jános	jòhánù	Nan
jánost	jòhánù	Nan
jogait	awọn ẹtọ	Nan
jár	lọ	Nan
jármű	ọkọ	Nan
járművek	awọn ọkọ	Nan
járnak	jẹ	Nan
járni	lati rin	Nan
járt	lọ	Nan
járta	ija ebora	Nan
jártak	ṣàbẹwò	Nan
járai	jarai	Nan
játékok	awọn ere	Nan
joga	yoga	Nan
joey	joey	Nan
jelentősége	pataki	Nan
jelentőségét	pataki ti	Nan
jelentőségű	pataki	Nan
jeles	fowo si	Nan
jelezte	itọkasi	Nan
jelképe	kan	None
jelképezi	aṣoju	Nan
jellege	iseda	Nan
jellegzetes	aṣoju	Nan
jellegzetessége	abuda	Nan
jellegét	iseda	Nan
jellegű	iseda	Nan
jellemezte	characterized nipasẹ	Nan
jellemzi	awọn ẹya	Nan
jellemzik	characterized nipasẹ	Nan
jelentősebb	pataki	Nan
jellemző	pàtó	Nan
jelentős	pataki	Nan
jelentésű	itumo	None
jelentett	túmọ	Nan
jelentette	royin	Nan
jelentettek	royin	Nan
jelentették	royin	Nan
jelenthet	aṣoju	Nan
jelenti	ọna	Nan
jelentik	jẹ	Nan
jelentkezett	fowo si	Nan
jelentkezik	waye	Nan
jelentkező	oludije	Nan
jelentéktelen	ainiye	Nan
jelentés	ijabọ	Nan
jelentése	itumo	None
jelentést	awọn ijabọ	Nan
jelentését	itumo	None
jelentő	ijabọ	Nan
jellemzőek	aṣoju	Nan
jellemzően	melo	None
jellemzői	awọn ẹya	Nan
jeruzsálemi	jerusalẹmu	Nan
jezsuita	jesuit	Nan
jim	jimọọ	Nan
jimi	jimi	Nan
jimmy	jimmy	Nan
joan	joan	Nan
jobb	ni ọtun	Nan
jobban	dara julọ	Nan
jobbik	dara julọ	Nan
jobboldali	apa ọtun	Nan
jobbra	ni ọtun	Nan
jobbra|bélyegkép|px|a	ọtun | atanpako | px | awọn	Nan
jobbra|px|bélyegkép|a	ọtun | px | atanpako | a	Nan
jobbára	okeene	Nan
joe	joe	Nan
jeruzsálem	jerusalẹmu	Nan
jerry	jeri	Nan
jenő	eugene	Nan
jennifer	jennifer	Nan
jellemzője	ẹya	Nan
jellemzők	awọn ẹya	Nan
jelzi	tọka	Nan
jelzik	ṣafihan	Nan
jelző	aami	Nan
jelöl	tọka	Nan
jelöli	sọtọ	Nan
jog	ofin	None
jelölik	yan	None
jelölte	ṣe idanimọ	Nan
jelöltek	oludije	Nan
jelölték	yan	None
jelölés	akiyesi	Nan
jelölése	siṣamisi	Nan
jelölések	awọn yiyan	Nan
jelölést	samisi	Nan
jelölt	oludije	Nan
komponált	kq	Nan
játékokat	awọn ere	Nan
játékos	player	Nan
kastély	ile odi	Nan
kat	kíkà	Nan
kata	kata	Nan
katalin	catherine	None
katalán	ede	None
katasztrofális	ìparun	Nan
katasztrófa	ajalu	Nan
kategória	ẹka	Nan
kategóriaa	ẹka	Nan
kategóriaamerikai	american ẹka	Nan
kategóriaaz	kategóriaaz	Nan
kategóriabudapest	ẹka budapest	Nan
kategóriagországok	kategóriagországok	Nan
kategóriahalálozások	kategóriahalálozások	Nan
kategóriakezdőlapon	oju-iwe ile ẹka	Nan
kassai	kassa	Nan
kategóriamagyar	ẹya ara ilu họnariani	Nan
kassa	kassa	Nan
karácsony	keresimesi	Nan
kapta	gba	None
kaptak	wọn	None
kapták	wọn	None
kapu	ilekun nla	Nan
kapunk	gba	None
kapus	aṣọ́kun	Nan
kar	bibajẹ	Nan
karakter	ohun kikọ	Nan
karakterek	ohun kikọ	Nan
karbid	kabu ọkọ ayọkẹlẹ	Nan
kard	idà	Nan
karinthy	karinthy	Nan
karl	karili	Nan
karmester	oludari	Nan
karrierje	iṣẹ	Nan
karácsonyi	keresimesi	Nan
kategóriamagyarország	ẹya hungary	Nan
kategóriamtatagok	kategóriamtatagok	Nan
kategórianevet	orukọ ẹka	Nan
kecskeméten	kecskemét	Nan
kecskeméti	kecskemét	Nan
kedvelt	feran	Nan
kedvelte	feran	Nan
kedvenc	ayanfẹ	Nan
kedves	wuyi	Nan
kedvező	ọjo	Nan
kedvezőtlen	alailori	Nan
kedvéért	nitori	Nan
kegyetlen	ìkà	Nan
keith	keith	Nan
kel	ji	Nan
kelemen	kelemen	Nan
kelet	ila-oorun	Nan
keleten	ila-oorun	Nan
kecskemét	kecskemét	Nan
kecske	ewurẹ	Nan
kb	ca.	Nan
kazinczy	kazinczy	Nan
kategórianémet	awọn ẹka jẹmánì	Nan
kategóriaországgyűlési	ile igbimọ aṣofin	Nan
kategóriazsidó	ẹya juu	Nan
kategóriába	ẹka	Nan
kategóriában	ẹka	Nan
kath	iwọ	Nan
katolikus	ẹlẹsin katoliki	Nan
kapott	gba	None
katolikusok	katoliki	Nan
katonai	ologun	Nan
katonái	ologun	Nan
katonák	jagunjagun	Nan
katonákat	jagunjagun	Nan
kaukázus	caucasus	Nan
kazah	kasakara	Nan
kazahsztán	kasakisitani	Nan
katona	jagunjagun	Nan
játékokon	awọn ere	Nan
kapni	lati mu	Nan
kapja	gba	None
jót	o dara	Nan
jótékony	alaanu	Nan
jótékonysági	aanu	None
jóval	pọ	Nan
józsef	jósẹ́fù	Nan
jön	wá	Nan
jönnek	wọn	None
jött	wa	Nan
jöttek	wọn	None
jövő	ojo	None
jövőben	ojo	None
júlia	julia	Nan
július	oṣu keje	Nan
júliusban	ni oṣu keje	Nan
június	karun	None
jószág	ẹran	Nan
júniusban	ni oṣu june	Nan
jórészt	ibebe	Nan
jól	daradara	Nan
játékosa	player	Nan
játékosnak	player	Nan
játékosok	awọn oṣere	Nan
játékot	eré	Nan
játékvezető	kọsọ	Nan
jég	yinyin	Nan
jéghegy	berg	Nan
jégkorong	ẹlẹsẹ	Nan
jégkorszak	ori	None
jégmadárfélék	kingfisher	Nan
jéna	jena	Nan
jézus	jesu	None
jézust	jesu	None
jó	o dara	Nan
jókai	jókai	Nan
jóllehet	biotilejepe	Nan
kafka	kafka	Nan
kajmánhalfélék	gar	Nan
kakas	akukọ	Nan
kapcsolatba	kan	None
kapcsolatban	ìbáṣepọ	Nan
kapcsolatok	awọn ibatan	Nan
kapcsolatokat	awọn ibatan	Nan
kapcsolatos	ti o ni ibatan	Nan
kapcsolatot	ibatan	Nan
kapcsolatuk	ibatan	Nan
kapcsolatát	ibatan	Nan
kapcsolódik	sopọ	Nan
kapcsolódnak	ti sopọ	Nan
kapcsolódó	sisopọ	Nan
kapcsán	ìbáṣepọ	Nan
kapitalizmus	kapitalisimu	Nan
kapitány	balogun	Nan
kapitánya	balogun	Nan
kapcsolatai	ẹbí	Nan
kapcsolata	ibatan	Nan
kapcsolat	ibatan	Nan
kap	gba	None
kal	nipasẹ	Nan
kalandjai	irinajo seresere	Nan
kalauz	oludari	Nan
kalifornia	california	Nan
kaliforniai	californian	Nan
kalocsai	kalocsai	Nan
kalória	kalori	Nan
kapnak	gba	None
kambrium	cambrian	Nan
kanadai	ara ilu kanada	Nan
kanadában	kánádà	None
kancellár	ọga adari	Nan
kandela	kekere	None
kane	kane	Nan
kant	kant	Nan
kanton	canton	Nan
kanada	kánádà	None
komponálta	kq	Nan
komárom	komárom	Nan
koncentrációs	fojusi	Nan
közepette	larin	Nan
közepéig	aarin	Nan
közepén	ni aarin	Nan
közepére	àárín	None
közepétől	àárín	None
közgazdasági	aje	None
közgyűlés	gbogbogbo	None
közigazgatás	isakoso gbangba	Nan
közigazgatási	isakoso	Nan
közigazgatásilag	abojuto	Nan
közismert	daradara-mọ	Nan
közlekedés	irinna	Nan
közlekedése	iyika	Nan
közlekedési	ijabọ	Nan
közli	ibasọrọ	Nan
közepes	alabọde	Nan
központ	aarin	Nan
közepe	àárín	None
közelébe	sunmọ	Nan
következőképpen	telẹ	Nan
követte	tẹle	Nan
követték	tẹle	Nan
követve	atẹle	Nan
követő	ọmọlẹyìn	Nan
követően	atẹle	Nan
követői	ọmọlẹyìn	Nan
köz	gbangba	Nan
közben	lakoko	Nan
köze	lati ṣe	Nan
közel	sunmọ	Nan
közelebb	sunmọ	Nan
közelgő	ti n bọ	Nan
közeli	sunmọ	Nan
közelkeleti	arin ila-oorun	Nan
közelében	nitosi	None
központi	aringbungbun	Nan
központja	olú	Nan
központjában	aarin	Nan
közép	àárín	None
középen	ni aarin	Nan
középeurópa	aarin yuroopu	Nan
középeurópai	arin-yuroopu	Nan
középhőmérséklet	otutu	None
középiskola	ile-iwe giga	Nan
középiskolai	ile-iwe giga	Nan
középiskolák	ile-iwe giga	Nan
középkor	ori	None
középkori	igba atijọ	Nan
középpontja	aarin	Nan
középpontjában	idojukọ	Nan
középre|px	aarin | px	Nan
középső	àárín	None
közölt	atejade	Nan
közéleti	gbangba isiro	Nan
közé	laarin	None
közzé	atejade	Nan
közvélemény	gbangba	Nan
központjává	ibudo	Nan
központosított	ti aarin	Nan
közre	tiwon	Nan
közreműködésével	ni ifowosowopo	Nan
közreműködött	tiwon	Nan
község	agbegbe	Nan
közt	laarin	None
következőket	atẹle	Nan
közti	laarin	None
köztársaság	olominira	Nan
köztársasági	olominira	Nan
köztársaságot	olominira	Nan
köztük	pẹlu	Nan
közvetett	aiṣe-taara	Nan
közvetlen	taara	Nan
közvetlenül	taara	Nan
köztudatban	gbangba	Nan
közölte	fun	None
következők	telẹ	Nan
következtében	nitori	Nan
környéke	agbegbe	Nan
környéken	adugbo	Nan
környéki	yika	Nan
környékén	yika	Nan
környékét	agbegbe	Nan
kört	yika	Nan
körzet	agbegbe	Nan
köré	yika	Nan
körében	ni circle ti	Nan
körök	awọn iyika	Nan
körökben	awọn iyika	Nan
körút	boulevard	Nan
körül	yika	Nan
körülbelül	nipa	Nan
körüli	yika	Nan
környék	agbegbe	Nan
körülményei	ipo	None
környező	agbegbe	Nan
környezetvédelmi	ayika	Nan
könyvtára	awọn ile ikawe	Nan
könyvtárak	awọn ile ikawe	Nan
könyvtárban	iwe itọsọna	Nan
könyvében	iwe	Nan
könyvének	iwe	Nan
könyvét	iwe	Nan
köpeny	jaketi	Nan
kör	aisan	Nan
körbe	yika	Nan
körben	yika	Nan
köre	awọn dopin	Nan
környezet	ayika	Nan
környezetben	ayika	Nan
környezeti	ayika	Nan
környezetvédelem	idaabobo ayika	Nan
környezetében	agbegbe	Nan
körülmények	ipo	None
körülvevő	agbegbe	Nan
körülötte	yika	Nan
kötődő	owun	Nan
kövek	okuta	Nan
követ	tẹle	Nan
követelt	beere	Nan
követelte	beere	Nan
követett	tele	None
követi	telẹ	Nan
követik	tẹle	Nan
következett	ṣẹlẹ	Nan
következik	tẹle	Nan
következménye	awọn gaju	Nan
következményei	awọn abajade	Nan
következményeként	kan	None
következtek	ṣẹlẹ	Nan
következtetni	pari	Nan
kötődik	owun	Nan
kötötték	pari	Nan
kötöttek	pari	Nan
kötötte	so	None
körű	okeerẹ	Nan
köszönheti	jẹri	Nan
köszönhető	o ṣeun	Nan
köszönhetően	nitori	Nan
köt	dipọ	Nan
köteles	owun	Nan
kötelező	dandan	None
következő	atẹle	Nan
kötet	iwọn didun	Nan
kötete	iwọn didun	Nan
kötetet	iwọn didun	Nan
köthető	ti o ni ibatan	Nan
köti	owun	Nan
kötik	owun	Nan
kötés	abuda	Nan
kötött	owun	Nan
kötetben	iwọn didun	Nan
könyvtár	ile ikawe	Nan
közönség	jepe	Nan
közös	wọpọ	Nan
ld	jc	Nan
le	oje	Nan
league	ajumọṣe	Nan
lee	lee	Nan
leendő	ifojusọna	Nan
lefelé	silẹ	Nan
legalacsonyabb	ni asuwon ti	Nan
legalább	o kere ju	Nan
legalábbis	o kere ju	Nan
legegyszerűbb	rọọrun	Nan
legelső	akoko	Nan
legelterjedtebb	awọn wọpọ	Nan
legenda	arosọ	Nan
legendája	arosọ	Nan
legendák	arosọ	Nan
laza	tú	None
legendás	arosọ	Nan
lawrence	agbofinro	Nan
latinovits	latinovits	Nan
lakói	olugbe	Nan
lakótelep	ibugbe	Nan
lambdacizmus	lambdacizmus	Nan
land	ilẹ	None
lane	ọna tooro	Nan
lap	oju iwe	Nan
lapja	oju iwe	Nan
lapok	awọn oju-iwe	Nan
lapos	alapin	Nan
lapot	dì	None
larry	larry	Nan
las	las	Nan
lassan	laiyara	Nan
lassú	lọra	Nan
latin	latini	None
latinul	latini	None
legeredményesebb	aṣeyọri julọ	Nan
legerősebb	lágbára	Nan
legfejlettebb	onitẹsiwaju	Nan
legkisebb	o kere ju	Nan
legkiválóbb	ṣaaju	Nan
legkorábbi	ìliestliest..	Nan
legközelebb	nigba miran	Nan
legközelebbi	nitosi	None
legmagasabb	ga julọ	Nan
legmeghatározóbb	julọ	Nan
legmélyebb	ti aigbagbo	Nan
legnagyobb	logan	Nan
legnagyobbak	tobi julo	Nan
legnépesebb	po	None
legnépszerűbb	julọ olokiki	Nan
legrosszabb	buru	Nan
legrégebbi	akọbi	Nan
legrégibb	atijọ	Nan
legjobban	dara julọ	Nan
legjobb	dara julọ	Nan
legjelentősebbek	pataki julọ	Nan
legjelentősebb	julọ	Nan
legfeljebb	ni julọ	Nan
legfelső	oke	Nan
legfelsőbb	adajọ	Nan
legfiatalabb	abikẹhin	Nan
legfontosabb	ni pataki julọ	Nan
legfőbb	olórí	Nan
leggazdagabb	richest	Nan
lakó	ibugbe	Nan
leggyakoribb	wọpọ julọ	Nan
leggyorsabb	yiyara	Nan
leggyorsabban	yiyara	Nan
leghosszabb	gunjulo	Nan
leghíresebb	julọ olokiki	Nan
legidősebb	akọbi	Nan
leginkább	okeene	Nan
legismertebb	ti o dara julọ-mọ	Nan
leggyakrabban	julọ igba	Nan
közönséges	wọpọ	Nan
lakást	iyẹwu	Nan
lakta	gbé	None
külkereskedelmi	ajeji isowo	Nan
külpolitikai	eto imulo ajeji	Nan
külső	ita	Nan
külsőleg	ita	Nan
külön	lọtọ	Nan
különbség	iyato	None
különbségek	awọn iyatọ	Nan
különbséget	iyato	None
különbözik	yàtọ	Nan
különböző	yatọ	Nan
különféle	oniruru	Nan
különleges	pataki	Nan
különálló	lọtọ	Nan
különös	ajeji	Nan
különösebb	pataki	Nan
külföldön	odi	Nan
különösen	ni pataki	Nan
külföldi	ajeji	Nan
küldték	pipa	Nan
közösen	papọ	Nan
közösség	agbegbe	Nan
közössége	agbegbe	Nan
közösségek	awọn agbegbe	Nan
közösségi	ẹgbẹ	Nan
között	laarin	None
közötti	lati	Nan
közöttük	to	None
közúti	kẹkẹ ele	Nan
közül	ti	Nan
közülük	wọn	None
kúp	konu	Nan
küldetés	ise	Nan
küldte	firanṣẹ	Nan
küldtek	firanṣẹ	Nan
küldött	firanṣẹ	Nan
külügyminiszter	minisita ajeji	Nan
kürtvirágfélék	sarraceniaceae	Nan
küzd	ijakadi	None
lago	ẹru	Nan
lagúna	ọsa	Nan
lajhármakifélék	lorisidae	Nan
lajos	louis	Nan
lakatlan	aini-gbé	Nan
lake	adagun	Nan
lakik	wa laaye	Nan
lakos	olùgbé	Nan
lakosainak	olugbe ti	Nan
lakosok	olugbe	Nan
lakosság	olugbe	Nan
lakossága	olugbe	Nan
lakosságot	olugbe	Nan
lakosságának	olugbe	Nan
lakott	gbé	None
lady	iyaafin	Nan
labdát	bọọlu	Nan
labdarúgóválogatott	egbe	None
labdarúgószövetség	bọọlu afẹsẹgba	Nan
küzdelem	ijakadi	None
küzdött	ja	Nan
küzdő	gbagede	Nan
kő	okuta	Nan
kőolaj	epo	Nan
kőrösi	kőrösi	Nan
kőzetek	awọn apata	Nan
laktak	gbe	None
kőzetekből	awọn apata	Nan
la	la	Nan
labda	bọọlu	Nan
labdarúgás	bọọlu	Nan
labdarúgó	ẹlẹsẹ ẹlẹsẹ	Nan
labdarúgói	ẹlẹsẹ ẹlẹsẹ	Nan
labdarúgók	bọọlu	Nan
labdarúgókupa	bọọlu afẹsẹgba	Nan
l	l	Nan
jelentetett	atejade	Nan
könyvkiadó	akede	Nan
könyveket	awọn iwe	Nan
krími	ilu ilu crimean	Nan
krónika	akọọlẹ	Nan
krónikus	onibaje	Nan
krónikája	chronicle	Nan
krúdy	krúdy	Nan
kuba	kuba	Nan
kubai	kuba	Nan
kubo	kubo	Nan
kucsmagombafélék	morchellaceae	Nan
kudarc	ikuna	Nan
kukorica	agbado	None
kullancsok	ticks	Nan
kulturális	aṣa	Nan
kultusza	awọn egbeokunkun	Nan
kultúra	aṣa	Nan
kréta	chalk	Nan
kultúrában	aṣa	Nan
kráter	arekereke	Nan
kritikát	ibaniwi	Nan
kovács	alawodudu	Nan
kovász	pẹlẹbẹ	Nan
kozmikus	agba	None
kr	cr	Nan
kristályos	okuta	Nan
kristóf	christi	Nan
krisztina	krisztina	Nan
krisztus	kristi	Nan
kritika	ibaniwi	Nan
kritikai	lominu	Nan
kritikus	alariwisi	Nan
kritikusok	alariwisi	Nan
kritikája	oloye-pupọ	Nan
kritikák	ibaniwi	Nan
kritikákat	agbeyewo	Nan
kritizálták	ti ṣofintoto	Nan
kultúrája	aṣa	Nan
kultúrák	awọn asa	Nan
kultúrát	aṣa	Nan
kámaszútra	kama sutra	Nan
kán	khan	Nan
kápolna	ijosin	None
károkat	bibajẹ	Nan
károly	charles	None
károlyi	károlyi	Nan
káros	ipalara	Nan
kárpáti	carpathian	Nan
kárpátmedence	ipilẹ carpathian	Nan
kárpátmedencei	ipilẹ carpathian	Nan
kárpátmedencében	ipilẹ carpathian	Nan
kárpátok	carpathians	Nan
kártya	kaadi	Nan
kávé	kọfi	Nan
kék	bulu	Nan
kálvin	calvin	Nan
kálmán	kálmán	Nan
kádár	konbo	Nan
kyle	kyle	Nan
kun	kun	Nan
kupa	ife	Nan
kupát	olowoiyebiye	Nan
kuroszaki	kuroszaki	Nan
kurt	iwo	Nan
kuruc	kuruc	Nan
kurucok	kuruc	Nan
kovalens	covalent	Nan
kutatás	iwadii	Nan
kutatásai	iwadii	Nan
kutatási	iwadii	Nan
kutatások	iwadii	Nan
kutató	oniwadi	Nan
kutatók	oniwadi	Nan
kutya	aja	Nan
kutyák	ajá	Nan
kutatása	iwadii	Nan
kémia	kemistri	Nan
kosárlabda	bọọlu inu agbọn	Nan
kosztka	kosztka	Nan
kontinensen	kọntinia	Nan
kontinentális	continental	Nan
konyha	ibi idana	Nan
konzervatív	konsafetifu	Nan
kopó	hound	Nan
kor	aisan	Nan
kora	kutukutu	Nan
korabeli	asiko	Nan
korai	kutukutu	Nan
korban	awọn ọjọ-ori	Nan
korból	awọn ọjọ-ori	Nan
koreai	ara ilu korea	Nan
kori	tele	None
korlátlan	ailopin	Nan
korlátozott	lopin	Nan
kontinens	kọntinia	Nan
korlátozták	lopin	Nan
konstantin	konstantin	Nan
konkrét	nja	Nan
koncepció	erongba	Nan
koncert	ere orin	Nan
koncertek	awọn ere orin	Nan
koncerteken	awọn ere orin	Nan
koncerteket	awọn ere orin	Nan
koncerten	ere orin	Nan
koncertet	ere orin	Nan
konferencia	apejọ	Nan
konferencián	apejọ	Nan
konfliktus	rogbodiyan	None
konfliktusok	rogbodiyan	None
konföderáció	confederation	Nan
konföderációs	iṣeduro	Nan
kongresszus	ile asofin ijoba	Nan
kongói	kongo	None
konrád	konrad	Nan
kormány	ijọba	Nan
kormánya	ijọba	Nan
kormányfő	nomba	Nan
kortársai	awọn ẹlẹgbẹ	Nan
kortársak	awọn ẹlẹgbẹ	Nan
korában	akoko	Nan
korábban	sẹyìn	Nan
korábbi	tele	None
koráig	ti ọjọ-ori	Nan
korán	kutukutu	Nan
korának	rẹ	None
korántsem	jinna	Nan
korát	ori	None
kossuth	kossuth	Nan
koszinusz	ẹwa	Nan
koszorú	aṣiri	Nan
koszovó	kosovo	Nan
koszovói	kosovo	Nan
kortárs	imusin	None
kort	awọn ọjọ-ori	Nan
korszerű	igbalode	Nan
korszakot	akoko	Nan
kormánynak	ijọba	Nan
kormányok	awọn ijọba	Nan
kormányt	ijọba	Nan
kormányzat	ijọba	Nan
kormányzati	ti ijọba	Nan
kormányzó	gomina	None
kormányának	ijọba	Nan
kosztolányi	kosztolányi	Nan
kornél	kornel	Nan
korong	puck	Nan
koronát	ade	Nan
koronázási	coronation	Nan
korrupció	ibajẹ	Nan
korszak	akoko	Nan
korszaka	akoko	Nan
korszakban	akoko	Nan
korona	ade	Nan
könyvet	iwe	Nan
kémiai	kẹmika	Nan
kényszerítették	agbara	None
kígyószisz	chigúmù	Nan
kína	ṣaina	Nan
kínai	ṣaina	Nan
kínaiak	ṣaina	Nan
kínában	ṣaina	Nan
kíséretében	de pelu	Nan
kísérlet	ṣàdánwò	Nan
kísérlete	igbiyanju	Nan
kísérletek	awọn adanwo	Nan
kísérletet	ṣàdánwò	Nan
kísérleti	esiperimenta	Nan
kísérte	de	Nan
kíván	fẹ	Nan
kívánja	fẹ	Nan
kívánt	beere	Nan
kígyó	ejo	Nan
kívánta	wá	Nan
kézzel	pẹlu ọwọ	Nan
kézilabda	bọọlu	Nan
késő	pẹ	Nan
később	nigbamii	Nan
későbbi	nigbamii	Nan
későbbiekben	nigbamii	Nan
késői	pẹ	Nan
későn	pẹ	Nan
két	meji	Nan
kétféle	meji lo wa	Nan
kétkamarás	bicameral	Nan
kétszer	lemeji	Nan
kétszeres	meji	Nan
kétszáz	igba	Nan
kétségbe	ibeere	Nan
kétségtelenül	laiseaniani	Nan
kéz	ọwọ	Nan
kézre	ọwọ	Nan
kívül	ita	Nan
kívüli	ju	Nan
kívülről	lati ita	Nan
költözött	ṣí	Nan
költő	ewi	Nan
költői	ewi	Nan
költők	awọn ewi	Nan
költőt	ewi	Nan
könnyebb	o rorun gan	Nan
könnyebben	o rorun gan	Nan
könnyedén	pẹlu irọrun	Nan
könnyen	rọrun	Nan
könnyű	rọrun	Nan
könnyűzenei	orin agbejade	Nan
könyv	iwe	Nan
könyvben	iwe	Nan
könyve	iwe	Nan
könyvek	awọn iwe	Nan
költöztek	gbe	None
költészete	oríkì	None
költészet	oríkì	None
költségvetési	eto isuna	Nan
kód	owusu	Nan
kórház	ile-iwosan	Nan
kórházba	ile-iwosan	Nan
kórházban	iwosan	None
kölcsey	kolcsey	Nan
kölcsönhatás	ibaraenisepo	Nan
kölcsönző	yiyalo	Nan
készülő	fun	None
kölcsönös	pelu ara	Nan
költemény	ewi	Nan
költeményei	awọn ewi	Nan
költemények	awọn ohun orin	Nan
költségeit	awọn idiyele	Nan
költségek	inawo	Nan
költséges	gbowolori	Nan
költségvetés	isuna	Nan
költ	na	Nan
kényszerítette	agbara	None
készültek	wọn	None
készülnek	wọn	None
képezi	jẹ	Nan
képezik	jẹ	Nan
képeznek	fọọmu	Nan
képezte	nipasẹ	Nan
képezték	oṣiṣẹ	Nan
képező	lara	Nan
képi	kepi	Nan
képregény	erere	Nan
képtelen	lagbara	Nan
képtár	àwòrán àwòrán	Nan
képviseli	aṣoju	Nan
képviselt	aṣoju	Nan
képviselte	aṣoju	Nan
képviselő	aṣoju	Nan
képviselőház	ile awọn aṣoju	Nan
képez	fọọmu	Nan
képviselői	awọn aṣoju	Nan
képet	aworan	Nan
képességű	agbara	None
kényszerült	agbara	None
kénytelen	iwulo	None
kénytelenek	agbara	None
kép	aworan	Nan
képe	aworan	Nan
képei	awọn fọto	Nan
képek	awọn aworan	Nan
képeket	awọn aworan	Nan
képen	lori aworan	Nan
képes	le	None
képesek	anfani	Nan
képesség	agbara	None
képessége	agbara	None
képességei	agbara	None
képességeit	ogbon	Nan
képest	afiwe	Nan
képviselője	aṣoju	Nan
képviselők	awọn igbesẹ	Nan
képzett	tóyẹ	Nan
kései	pẹ	Nan
kész	ṣetan	Nan
készen	ṣetan	Nan
késztette	ti ṣetan	Nan
készít	ṣe	Nan
készítenek	fa	Nan
készíteni	ṣe	Nan
készített	ninu	Nan
készítette	ṣe nipasẹ	Nan
készítettek	ṣẹda	Nan
készítették	gbaradi	Nan
készítik	gbaradi	Nan
készítése	sise	None
készítők	awọn ẹlẹda	Nan
készül	mura	Nan
kérésére	ni ibeere	Nan
kérték	beere	Nan
kérte	beere	Nan
kéri	béèrè	Nan
képzés	idanileko	Nan
képzése	idanileko	Nan
képződik	ibiyi	Nan
képzőművészet	ona ona	Nan
képzőművészetek	awọn ọna wiwo	Nan
képzőművészeti	aworan	Nan
képét	aworan	Nan
készült	ṣe	Nan
kér	béèrè	Nan
kérdésben	awọn ọran	Nan
kérdése	ibeere naa	Nan
kérdések	awọn ibeere	Nan
kérdéseket	awọn ọran	Nan
kérdéses	ni ibeere	Nan
kérdést	ibeere	Nan
kéreg	erunrun	Nan
kérdés	ibeere	Nan
jelentenek	jẹ	Nan
jelentek	atejade	Nan
jelent	tumọ	Nan
haladva	lọ	Nan
haladó	ti ni ilọsiwaju	Nan
halak	pisces	Nan
hallani	gbọ́	Nan
hallgatott	gbọ	Nan
hallható	adití	Nan
halott	kú	Nan
halottak	kú	Nan
halotti	ibi-isinku	Nan
halt	kú	Nan
haltak	kú	Nan
haltetvek	branchiura	Nan
halál	iku	None
halála	iku	None
halálakor	iku	None
haladt	ṣí	Nan
halálbüntetés	ijiya olu	Nan
halad	tẹsiwaju	Nan
hajót	ọkọ oju-omi	Nan
hagyta	ki	None
hagyták	wọn	None
hagyva	nlọ	Nan
hajdani	ti yore	Nan
hajlandó	fẹ	Nan
hajnal	owurọ	Nan
hajnalban	owurọ	Nan
hajnali	auro	Nan
hajtott	iwakọ	Nan
hajtotta	jade	Nan
hajtottak	ti	Nan
hajó	ọkọ oju-omi	Nan
hajók	omi	None
hajón	wa ninu ọkọ	Nan
hajós	atukọ̀	Nan
hal	ẹja	Nan
halálbüntetést	iku	None
halálistenek	iku	None
halállal	iku	None
hangját	ohun	Nan
hangok	awọn ohun	Nan
hangot	ìró	None
hangszer	irinse	Nan
hangszerek	èlò	None
hangszeres	irinse	Nan
hangsúly	tcnu	Nan
hangsúlyos	imulẹ	Nan
hangsúlyt	idojukọ	Nan
hangulat	vibe	Nan
hangversenyt	ere orin	Nan
hangvételű	ohun orin	Nan
hangyászmadárfélék	ẹja apọn	Nan
hangzik	ìró	None
hangzott	dun	None
hangján	ohun	Nan
hangja	ìró	None
hang	ohun	Nan
hanem	sugbon pelu	Nan
halálos	ku	None
halálra	iku	None
halált	iku	None
haláláig	iku	None
halálának	iku	None
halálát	iku	None
halálával	iku	None
hagyott	osi	Nan
halászat	ipeja	Nan
hamarabb	sẹyìn	Nan
hamarosan	laipẹ	Nan
hamburg	hamburg	Nan
hamilton	amọtẹ	Nan
hamis	èké	Nan
hamlet	hamlet	Nan
hamvait	ru	Nan
hamar	laipẹ	Nan
hangzású	ariwo	Nan
hagyományosan	aṣa	Nan
hagyományok	aṣa	Nan
gól	ibi-afẹde	Nan
gólját	ibi-afẹde	Nan
góljával	ibi-afẹde	Nan
góllal	gbon	Nan
gólok	ibi-afẹde	Nan
gólt	darí	Nan
gótika	gotik	Nan
gótikus	gotik	Nan
gödényfélék	gödényfélék	Nan
gömb	orb	Nan
görbe	ohun ti tẹ	Nan
görgei	gorgei	Nan
görgey	görgey	Nan
görög	griki	Nan
görögország	griki	Nan
gírosz	gyros	Nan
görögországban	griki	Nan
géza	géza	Nan
gépek	ero	Nan
gyűlés	ipade	Nan
gyűrű	òrùka	Nan
gyűrűk	oruka	Nan
gyűrűt	òrùka	Nan
gábor	gábor	Nan
gárda	awọn oluṣọ	Nan
gárdonyi	gárdony	Nan
gáspár	jasper	Nan
gátolja	awọn bulọọki	Nan
gáz	gaasi	Nan
gázok	ategun	Nan
gébicsfélék	gbọn	Nan
gén	ẹbun	Nan
gének	jiini	Nan
gép	ẹrọ	Nan
gépgyártás	enjinnia mekaniki	Nan
görögök	awọn hellene	Nan
görögül	griki	Nan
ha	ti o ba ti	Nan
hadseregcsoport	ogun	None
hadserege	ogun	None
hadsereget	ogun	None
hadtest	yinbon	Nan
hadvezetés	adari ologun	Nan
hadvezér	gbogboogbo	Nan
hadászati	ilana	None
hagyatéka	sakani	Nan
hagyja	lọ	Nan
hagyják	lọ	Nan
hagyni	lọ	Nan
hagynia	lọ	Nan
hagyomány	atọwọdọwọ	Nan
hagyománya	aṣa	Nan
hagyományai	aṣa	Nan
hadseregben	ogun	None
hadsereg	ogun	None
hadosztály	pipin	Nan
hadnagy	lieutenant	Nan
habsburg	habsburg	None
habsburgház	habsburg	None
habsburgok	awọn ohun elo habsburgs	Nan
habár	itanjẹ	Nan
had	ologun	Nan
hadaikum	hadean	Nan
hadak	ogun	None
hagyományos	ibile	None
hadarás	gabble	Nan
haderő	awọn ipa	Nan
hadi	ologun	Nan
haditengerészet	ogun	None
hadjárat	ipolongo	Nan
hadjáratok	awọn ipolongo	Nan
hadjáratot	ipolongo	Nan
hadművelet	mosi	Nan
hadat	ogun	None
gyűjtött	gbà	Nan
hangú	gba	None
hannah	hannah	Nan
hatását	ipa	Nan
hatású	ipa	Nan
hatékony	munadoko	Nan
ható	anesitetiki	Nan
hatóság	awọn alaṣẹ	Nan
hatóságok	awọn alaṣẹ	Nan
havi	oṣooṣu	Nan
havonta	kan	None
hawaii	hawaii	None
haydn	haydn	Nan
haydnt	haydn	Nan
haza	ile	Nan
hazafelé	ile	Nan
hazafias	olufẹ orilẹ-ede	Nan
hazai	t’ile	Nan
hatására	ipa	Nan
hazatért	wa si ile	Nan
hatást	ipa	Nan
hatásos	munadoko	Nan
határos	nitosi	None
határozott	asọye	Nan
határozottan	ìdúróṣinṣin	Nan
határozta	ṣe idanimọ	Nan
határozza	pinnu	Nan
határozzák	pinnu	Nan
határozószó	adverb	Nan
határt	to	None
határában	aala	None
határán	ààlà	Nan
határát	ààlà	Nan
hatás	ipa	Nan
hatása	ipa	Nan
hatásai	awọn ipa	Nan
hatások	awọn ipa	Nan
hatással	kan	None
hazája	orilẹ-ede	Nan
hazánk	họnari	Nan
hazánkban	orilẹ-ede wa	Nan
helyes	tọ	Nan
helyesen	o ti tọ	Nan
helyet	ibi	Nan
helyett	dipo	Nan
helyette	dipo	Nan
helyezett	won won	Nan
helyezi	fi	None
helyezik	gbe	None
helyezkedik	wa	Nan
helyezkednek	wa	Nan
helyezte	gbe	None
helyeztek	gbe	None
helyezték	gbe	None
helyezés	ibi	Nan
helyi	agbegbe	Nan
helyenként	ninu awọn aye	Nan
helyen	ibi	Nan
helyeken	ipo	None
helyek	àwọn ibò	Nan
head	ori	None
hegedű	violin	Nan
hegedűs	fiddler	Nan
hegesztés	alurinmorin	Nan
hegy	òkè	Nan
hegyek	awọn oke-nla	Nan
hegyi	òkè	Nan
határon	ààlà	Nan
hegység	òkè	Nan
hegyvidéki	olórí òkè	Nan
heinrich	heinrich	None
helikon	ọkọ ofurufu	Nan
heliocentrikus	oye	Nan
hely	ibi	Nan
helyben	ni aaye	Nan
helye	ibi	Nan
hegyvidék	awọn ilu giga	Nan
hanks	awọn han	Nan
határolja	gbo	Nan
határait	aala	None
harmincas	ọgbọn	Nan
harold	harold	Nan
harrison	ẹwọn	Nan
harry	harry	Nan
harryt	harry	Nan
harvard	harvard	Nan
hasfelmetsző	riiki	Nan
hashajtó	laxative	Nan
hasmenés	gbuuru	Nan
hasonlít	jọra	Nan
hasonlítanak	fẹran	Nan
hasonlított	fẹran	Nan
hasonló	jọra	Nan
hasonlóan	fẹran	Nan
hasonlóképpen	bakanna	Nan
harminc	ọgbọn	Nan
hasznos	wulo	Nan
harmadik	kẹta	None
hargita	harghita	Nan
hans	han	Nan
harc	ja	Nan
harca	ja	Nan
harcba	ja	Nan
harcban	ja	Nan
harci	ogun	None
harcművészeti	ijakadi	None
harcok	ogun	None
harcokban	ogun	None
harcolt	ja	Nan
harcoltak	ja	Nan
harcoló	ija	Nan
harcos	jagunjagun	Nan
harcosok	jagunjagun	Nan
harcot	ja	Nan
harkályfélék	awọn igi onikẹ	Nan
használ	lo	Nan
használat	lo	Nan
használata	lo	Nan
hatalmas	alagbara	Nan
hatalmat	agbara	None
hatalmi	agbara	None
hatalmának	agbara	None
hatalmát	agbara	None
hatalom	agbara	None
hatalommal	agbara	None
hatalomra	agbara	None
hatodik	kẹfa	Nan
hatott	le	None
hatottak	fowo	Nan
hatvanas	sexagesimal	Nan
határ	ààlà	Nan
határa	to	None
határain	aala	None
hatalmak	agbara	None
hatalma	agbara	None
hat	mefa	Nan
használó	olumulo	Nan
használatban	ni lilo	Nan
használatos	wulo	Nan
használatára	lo	Nan
használatát	lilo	Nan
használatával	lilo	Nan
használható	nkan	None
használja	lo	Nan
határok	awọn ifilelẹ lọ	Nan
használjuk	ti lo	Nan
használnak	ti lo	Nan
használni	lo	Nan
használt	ti lo	Nan
használta	ti lo	Nan
használtak	ti lo	Nan
használták	ti lo	Nan
használva	lilo	Nan
használják	ti lo	Nan
helyre	ibi	Nan
gyűjteménye	gbigba	Nan
győző	gyozo	Nan
főnök	ọga	Nan
főnöke	ọga	Nan
főparancsnoka	alakoso ni olori	Nan
főre	eniyan	Nan
fős	eniyan	Nan
főszerepet	akọkọ ipa	Nan
főszereplésével	kikopa	Nan
főszereplő	protagonist	Nan
főszereplője	kikopa	Nan
főszereplők	awọn oṣere akọkọ	Nan
főurak	awọn oluwa	Nan
főváros	olu	Nan
fővárosa	olu	Nan
fővárosba	olu	Nan
fővárosban	olu	Nan
főnévi	ipilẹṣẹ	Nan
fővárosi	ilu	Nan
főnév	nọun	Nan
főnevek	awọn orukọ	Nan
fülöp	philippines	Nan
fülöpszigetek	philippines	Nan
für	lu	Nan
fürdő	iwẹ	Nan
füves	koriko	Nan
fő	akọkọ	Nan
főbb	akọkọ	Nan
főherceg	archduke	Nan
főhercegnő	archduchess	Nan
főhős	protagonist	Nan
főiskola	kọlẹji	Nan
főiskolai	kọlẹji	Nan
főként	o kun	Nan
főképp	okeene	Nan
főleg	ni pataki	Nan
főnix	phoenix	Nan
fővárost	olu	Nan
főút	opopona	Nan
fűződik	ifihan	Nan
gazdasági	aje	None
gazdaságilag	ti ọrọ-aje	Nan
gazdaságot	aje	None
gbr	gbr	Nan
gdp	gdp	Nan
gedeon	gedeoni	Nan
gellért	gellért	Nan
general	se ina	Nan
generációs	iran	Nan
genetikai	jiini	Nan
genf	geneva	None
genfben	geneva	None
genfi	genevan	Nan
geológiai	ilẹ	None
geometria	geometry	Nan
gazdasága	aje	None
gazdaság	eto-aje	Nan
gazdag	ọlọrọ	Nan
gazda	agbẹ	Nan
fűződő	kiko	None
ga	ga	Nan
gabriel	gabriel	Nan
gabriela	gabriela	Nan
gabriella	gabriella	Nan
gaga	gaga	Nan
galaxis	galaxy	Nan
fülbemászók	awọn afikọti eti	Nan
galilei	galilei	Nan
gall	gaul	Nan
galleria	galleria	Nan
galéria	àwòrán àwòrán	Nan
gandhi	gandhi	Nan
garcía	garcía	Nan
gary	iwin	Nan
gasztronómia	onibaje	Nan
galileo	galileo	Nan
geometriai	geometric	Nan
függőleges	inaro	Nan
függő	igbẹkẹle	Nan
félidőben	idaji	None
félig	idaji	None
félsziget	ile larubawa	Nan
féltekén	itatẹtẹ	Nan
félvér	idaji-ajọbi	Nan
fém	irin	Nan
fémek	awọn irin	Nan
fémes	ti fadaka	Nan
fény	ina	Nan
fényes	didan	Nan
fényképek	awọn fọto	Nan
fényt	ina	Nan
féregatkák	pentastomida	Nan
férfi	ọkunrin	Nan
férfiak	okunrin	None
félelem	bẹru	Nan
férfinév	akọ orukọ	Nan
fél	ẹgbẹ	Nan
fáraó	fáráò	Nan
fut	sáré	Nan
futam	ije	None
futamon	ije	None
futamot	ije	None
futball	bọọlu	Nan
futott	kikan	Nan
futó	alapapo	Nan
fából	igi	Nan
fácánfélék	eye aparo	Nan
fájdalom	irora	Nan
fájl	faili	Nan
fájlbudapest	faili budapest	Nan
fájlcharacter	fájlcharacter	Nan
fájlok	awọn faili	Nan
fák	igi	Nan
fázis	alakoso	Nan
férfit	ọkunrin	Nan
férj	ọkọ	Nan
férje	rẹ	None
földtörténeti	itan aye	Nan
földön	ilẹ	None
fölé	loke	Nan
fölött	loke	Nan
fúzió	apapọ	Nan
fúziós	ifun	Nan
függ	o gbarale	Nan
független	olominira	Nan
függetlenség	ominira	Nan
függetlenséget	ominira	Nan
függetlenségi	ominira	Nan
függetlenségét	ominira	Nan
függetlenül	ominira	Nan
függvény	iṣẹ	Nan
függvények	awọn iṣẹ	Nan
földről	ilẹ	None
földrengések	awọn iwariri-ilẹ	Nan
földrengés	ìṣẹlẹ	Nan
földre	silẹ	Nan
férjhez	iyawo	None
férjét	ọkọ	Nan
fórum	apejọ	Nan
föderáció	federation	Nan
föl	sókè	Nan
föld	ile aye	Nan
földalatti	ipamo	Nan
függően	fehin ti	Nan
földet	ile aye	Nan
földi	ilẹ	None
földközitenger	okun mẹditarenia	Nan
földművelés	fun	None
földpátok	awọn ege	Nan
földrajz	ilẹ	None
földrajza	ilẹ	None
földrajzi	àgbègbè	Nan
földgáz	ategun ayebaye	Nan
gyűjtemény	gbigba	Nan
geomorfológia	geomorphology	Nan
george	george	Nan
gyerekeket	ọmọ	None
gyerekkorában	ewe	None
gyermek	ọmọ	None
gyermeke	ọmọ	None
gyermekei	ọmọ	None
gyermekek	ọmọ	None
gyermekeként	bi ọmọde	Nan
gyermeket	ọmọ	None
gyermekkora	ewe	None
gyermekkori	ewe	None
gyermekkorában	ewe	None
gyermekét	ọmọ	None
gyermekük	ọmọ	None
gyilkos	apaniyan	Nan
gyilkosság	paniyan	Nan
gyerekek	ọmọ	None
gyilkosságok	awọn ipaniyan	Nan
gyerek	ọmọ	None
gyenge	ailera	Nan
gyakoriak	wọpọ	Nan
gyakoribb	diẹ wọpọ	Nan
gyakorlat	ere idaraya	Nan
gyakorlatban	ninu iwa	Nan
gyakorlati	ilowo	Nan
gyakorlatilag	fẹẹrẹ	Nan
gyakorló	adaṣe	Nan
gyakorolt	loju	Nan
gyakoroltak	adaṣe	Nan
gyakorta	ti igbakan	Nan
gyakrabban	fe e je gbogbo igba	Nan
gyakran	nigbagbogbo	Nan
gyalog	ẹsẹ	None
gyarmat	ileto	Nan
gyarmati	amunisin	Nan
gyengébb	alailagbara	Nan
gyom	igbo	Nan
gyomor	ikun	Nan
gyors	yara	Nan
gyöngyház	nacre	Nan
gyönyörű	lẹwa	Nan
györgy	george	Nan
gyümölcs	eso	Nan
győr	győr	Nan
győri	győr	Nan
győzelem	isegun	Nan
győzelemmel	isegun	Nan
győzelme	isegun	Nan
győzelmet	isegun	Nan
győzelmét	isegun	Nan
győzelmével	isegun	Nan
győzni	lati bori	Nan
győztes	olubori	Nan
győzött	bori	Nan
gyökerei	wá	Nan
gyógyszerek	àwọn òògùn	Nan
gyógyszer	oogun	Nan
gyógyhatása	alumoni	None
gyorsabb	yara ju	Nan
gyorsabban	yara ju	Nan
gyorsan	yara	Nan
gyorsforgalmi	ikosile	Nan
gyula	alba	Nan
gyulai	gyula	Nan
gyulladás	igbona	Nan
gyakori	loorekoore	Nan
gyurcsány	gyurcsány	Nan
gyártás	gbóògì	Nan
gyártása	iṣelọpọ	Nan
gyártási	iṣelọpọ	Nan
gyártó	olupese	Nan
gyémánt	okuta iyebiye	Nan
gyémántok	awọn okuta iyebiye	Nan
gyógyfürdő	sipaa	Nan
gyár	ile ise	Nan
georg	georg	Nan
guy	eniyan	Nan
gumó	ẹwẹ	Nan
gizella	gizella	Nan
gleccserek	glaciers	Nan
globalizáció	agbaye	None
globe	agbaiye	Nan
globedíj	ere kariaye	Nan
globális	kariaye	Nan
glover	ologo	Nan
gmail	gmail	Nan
gnu	gnu	Nan
goethe	goethe	Nan
gogh	gogh	Nan
gold	wúrà	Nan
golden	ti goolu	Nan
gomb	orb	Nan
gomba	osun	Nan
giuseppe	giuseppe	Nan
gombák	olu	Nan
gitáros	olorin	Nan
gitár	gita	Nan
georges	georges	Nan
ger	pin	Nan
gera	gera	Nan
gergely	john	Nan
germán	jẹmánì	Nan
get	gba	None
gillan	gillan	Nan
gilliam	gilliam	Nan
gilmour	gílémónì	Nan
gimnázium	ile-iwe giga	Nan
gimnáziumban	ile-iwe giga	Nan
giorgio	giorgio	Nan
giovanni	giovanni	Nan
girl	ọmọbinrin	Nan
girls	awon odomobirin	Nan
gitárok	gita	Nan
gondok	iṣoro	Nan
gondolat	ronu	Nan
gondolata	awọn ero	Nan
grand	agba	None
grande	giga	Nan
grant	yọọda	Nan
gravitációs	walẹ	Nan
gray	grẹy	Nan
griffin	griffin	Nan
groom	iyawo	None
group	ẹgbẹ	Nan
gránit	giranaiti	Nan
gróf	eti	Nan
grófja	awọn ka	Nan
grófság	earldom	Nan
grúz	georgian	Nan
guevara	guevara	Nan
guide	itọsọna	Nan
gran	gran	Nan
graham	graham	Nan
grafit	ayaworan	Nan
grafikus	ayaworan	Nan
gondolatok	awọn ero	Nan
gondolja	ronu	Nan
gondolják	ronu	Nan
gondolkodás	lerongba	Nan
gondolkodó	lerongba	Nan
gondolkodók	nronu	Nan
gondolta	ronu	Nan
gusztáv	gustav	Nan
gondolták	ronu	Nan
gondot	wahala	Nan
gong	gong	Nan
gonosz	ibi	Nan
google	nipasẹ google	Nan
gordon	meji baasi	Nan
got	gotik	Nan
gottfried	gottfried	Nan
gondosan	farabalẹ	Nan
funkciók	awọn iṣẹ	Nan
helyről	ibi	Nan
helyszíne	awọn aaye	Nan
indiai	ara ilu indiani	Nan
indiában	india	Nan
indián	ara ilu indiani	Nan
indiánok	ara ilu inde	Nan
indoeurópai	indo-european	Nan
indonéz	indonesian	Nan
indonézia	indonesia	Nan
indul	bẹrẹ	Nan
indulnak	kuro	Nan
indult	bẹrẹ	Nan
indultak	se igbekale	Nan
induló	irin-ajo	Nan
indított	se igbekale	Nan
indította	se igbekale	Nan
indítottak	se igbekale	Nan
india	india	Nan
indították	se igbekale	Nan
indexhu	atọka	Nan
increment	afikun	Nan
illyés	vinton	Nan
illés	elijahlíjà	Nan
illúzió	iruju	Nan
ilona	ilona	Nan
ily	bayi	None
ilyen	iru	Nan
ilyenek	eyikeyi	Nan
ilyenkor	ni akoko yi	Nan
im	im	Nan
immunrendszer	ma ajesara	Nan
immár	bayi	None
imperial	ọba	Nan
importtermékek	awọn ọja wọle	Nan
imre	imre	Nan
in	tendoni	Nan
index	atọka	Nan
infinitiv	ailopin	Nan
influenza	aisan	Nan
infláció	afikun	Nan
international	international	Nan
internazionale	internazionale	Nan
internet	intanẹẹti	Nan
interneten	lori intanẹẹti	Nan
internetes	lori ayelujara	Nan
intézet	ilé-ìwé	Nan
intézett	sọrọ	Nan
intézkedések	awọn ipese	Nan
intézmény	igbekalẹ	Nan
intézménye	awọn ile-iṣẹ	Nan
intézményei	awọn ile-iṣẹ	Nan
intézmények	awọn ile-iṣẹ	Nan
inzulin	hisulini	Nan
io	io	Nan
ipar	ile ise	Nan
interjúban	ifọrọwanilẹnuwo	Nan
interjú	ifọrọwanilẹnuwo	Nan
interaktív	ibanisọrọ	Nan
intenzív	lekoko	Nan
információ	alaye	Nan
információk	awọn alaye	Nan
információkat	alaye	Nan
információs	alaye	Nan
információt	alaye	Nan
infrastruktúra	amayederun	Nan
ingyen	ọfẹ	Nan
illetőleg	leralera	Nan
ingyenes	ọfẹ	Nan
inkább	dipo	Nan
innen	nibi	Nan
innentől	lati ibi	Nan
institute	ilé-ìwé	Nan
int	int	Nan
intel	intel	Nan
intelligens	oloye	None
inka	inca	Nan
iparban	ile ise	Nan
illetően	n ṣakiyesi	Nan
illetve	tabi	None
idősebb	alàgbà	Nan
időszak	asiko	Nan
időszaka	akoko	Nan
időszakban	akoko	Nan
időszakot	dúró	None
időszakra	akoko	Nan
időszakában	aago	Nan
időszámítás	aago	Nan
időt	aago	Nan
idővel	pẹlu akoko	Nan
ie	b.c	Nan
ifj	jr.	Nan
ifjabb	junior	Nan
ifjú	ọdọ	Nan
ifjúkora	rẹ	None
idős	agbalagba	Nan
ifjúság	ọdọ	Nan
időről	aago	Nan
időpontja	aago	Nan
idény	akoko	Nan
idézet	imoye	Nan
idézetek	avvon	Nan
idézi	rántí	Nan
idő	aago	Nan
időben	ni asiko	Nan
időjárás	ojo	None
időjárási	meteorological	Nan
idők	aago	Nan
időkben	aago	Nan
időközben	nibayi	Nan
időmérő	ìlà	None
időn	aago	Nan
időnként	nigbami	Nan
időpont	aago	Nan
időre	aago	Nan
ifjúsági	ewe	None
ig	sókè	Nan
igaz	ooto	Nan
igény	nilo	Nan
igénybe	iraye si	Nan
igénye	beere	Nan
igényel	nilo	Nan
igénylő	to	None
igényt	beere	Nan
ihlette	atilẹyin	Nan
ii	ii	Nan
iii	iii	Nan
ikarus	ikarus	Nan
il	yl	Nan
ildikó	ildikó	Nan
ill	tabi	None
illegális	arufin	Nan
illeti	ifiyesi	Nan
igék	ìse	Nan
igyekszik	gbiyanju lati	Nan
igyekeztek	wá	Nan
igyekeznek	gbiyanju lati	Nan
igazgató	oludari	Nan
igazgatója	oludari	Nan
igazi	gidi	Nan
igazolt	fihan	None
igazság	ooto	Nan
igazságot	ooto	Nan
igazságszolgáltatás	ododo	None
illető	oniwun	Nan
igazságügyi	idajo	None
igazán	looto	Nan
ige	ìse	Nan
igen	bẹẹni	Nan
igencsak	pupọ	Nan
igenév	bẹẹni ọdun	Nan
ignác	ignatius	Nan
igyekezett	wá	Nan
igazából	iwongba	Nan
ideális	bojumu	Nan
ipari	ile ise	Nan
iphone	ipad	Nan
jaj	alas	Nan
jakab	awọn orukọ james	Nan
jakamárfélék	jakamárfélék	Nan
jamaica	jamaica	None
jambus	iambus	Nan
james	awọn orukọ james	Nan
jan	oṣu kini	Nan
jane	jane	Nan
janus	janus	Nan
január	oṣu kini	Nan
januárban	ni oṣu kini	Nan
japán	japan	Nan
japánban	japan	Nan
japánok	japanese	Nan
jason	jason	Nan
jagger	jagger	Nan
java	java	Nan
jacques	jacques	Nan
jack	jaketi	Nan
itt	nibi	Nan
itteni	nibi	Nan
itthon	ile	Nan
itália	ilu italia	Nan
itáliai	ilu italia	Nan
itáliában	ilu italia	Nan
iv	aaki	Nan
ivan	evan	Nan
iván	iván	Nan
ix	ix	Nan
izabella	isabella	Nan
izland	iceland	None
izlandi	ede	None
izrael	israeli	Nan
izraeli	ọmọ	None
jackson	apinfunni	Nan
javaslatot	igbero	Nan
javaslatára	igbero	Nan
javasolt	niyanju	Nan
jelenetek	awọn iwoye	Nan
jeleneteket	awọn iwoye	Nan
jelenetet	ibi isẹlẹ	Nan
jelenik	yoo	None
jelenkor	imusin	None
jelenkori	imusin	None
jelenleg	lọwọlọwọ	Nan
jelenlegi	lọwọlọwọ	Nan
jelenléte	iwaju naa	Nan
jelenlétében	niwaju	None
jelenlétét	iwaju naa	Nan
jelennek	han	Nan
jelenség	lasan	Nan
jelenségek	iṣẹlẹ	Nan
jelenséget	lasan	Nan
jelenetben	ibi isẹlẹ	Nan
jelenet	ibi isẹlẹ	Nan
jelen	lọwọlọwọ	Nan
jelek	awọn ami	Nan
javasolta	niyanju	Nan
javult	imudarasi	Nan
javára	anfani	Nan
jay	jay	Nan
jazz	jazz	Nan
jean	jean	Nan
jedlik	jedlik	Nan
italok	ohun mimu	Nan
jeges	oninrin	Nan
jegyezte	ṣe akiyesi	Nan
jegyzetek	awọn akọsilẹ	Nan
jegyében	ẹmi	Nan
jehova	jèhófà	Nan
jel	samisi	Nan
jele	ami	Nan
jelei	awọn ami	Nan
jegyek	iwe iwọle	Nan
iparművészeti	ona ati ise ona	Nan
ital	mu	Nan
iszlám	islamu	Nan
irányzatok	lominu	Nan
irányába	ninu itọsọna ti	Nan
irányítja	dari	Nan
irányított	dari	Nan
irányította	dari	Nan
irányítása	iṣakoso	Nan
irányítását	iṣakoso	Nan
irányító	oludari	Nan
irányú	ọna	Nan
is	tun	Nan
isaac	isale	Nan
isbn	isbn	Nan
iskola	ile-iwe	Nan
iskolai	ile-iwe	Nan
iskolába	si ile iwe	Nan
irányzat	aṣa	Nan
iskolában	ile-iwe	Nan
irányuló	fun	None
irányból	awọn itọsọna	Nan
ipod	ipod	Nan
iraki	ara ilu iraaki	Nan
iratok	awọn iwe aṣẹ	Nan
iroda	ọfiisi	Nan
irodalmi	imọwe	Nan
irodalom	litireso	Nan
irodalomban	litireso	Nan
irán	iran	Nan
iráni	ara ilu iran	Nan
iránt	si ọna	Nan
iránti	fun	None
irány	itọsọna	Nan
iránya	itọsọna	Nan
irányba	itọsọna	Nan
irányban	itọsọna	Nan
irányt	itọsọna	Nan
iskolája	ile-iwe	Nan
iskolák	awọn ile-iwe	Nan
iskolát	ile-iwe	Nan
ismét	lẹẹkansi	Nan
ismételten	leralera	Nan
ismétlődő	tun ṣe	Nan
iso	ipin	None
isten	ọlọrun	Nan
istene	ọlọrun	Nan
istenek	oriṣa	Nan
isteni	ibawi	Nan
istennek	ọlọrun	Nan
istennő	oriṣa	Nan
istennője	oriṣa	Nan
istent	ọlọrun	Nan
istván	alairi	Nan
istvánnak	istván	Nan
iszaphal	ẹja pẹtẹlẹ	Nan
ismerünk	a mọ	Nan
ismerték	mọ	Nan
ismertté	mọ	Nan
ismertette	se alaye	Nan
island	erekusu	Nan
ism	àm	Nan
ismer	mọ	Nan
ismerete	imo	Nan
ismeretek	mọmọ	Nan
ismeretes	mọ	Nan
ismeretlen	aimọ	Nan
isztambul	ilu istanbul	Nan
ismeretterjesztő	ti alaye	Nan
ismerik	mọ	Nan
ismerjük	mọ	Nan
ismerkedett	pàdé	Nan
ismert	mọ	Nan
ismerte	mọ	Nan
ismertebb	mọ	Nan
ismertek	mọ	Nan
ismeri	mọ	Nan
helyszín	ibi isere	Nan
ideológia	arojinle	Nan
idejére	akoko naa	Nan
holdkomp	lunar module	Nan
holdon	osupa	Nan
holdra	osupa	Nan
holland	dutch	Nan
hollandia	fiorino	Nan
hollandiában	ni fiorino	Nan
hollywood	hollywood	Nan
hollywoodi	hollywood	Nan
holló	ẹyẹ	Nan
holmes	awọn iho	Nan
holnap	ọla	Nan
holocaust	bibajẹ	Nan
holokauszt	bibajẹ	Nan
holott	biotilejepe	Nan
holtan	kú	Nan
holdi	oṣupa	Nan
holttestét	òkú	None
holdat	osupa	Nan
hold	osupa	Nan
hivatkozás	itọkasi	Nan
hivatkozások	awọn itọkasi	Nan
hivatott	ti a pinnu lati	Nan
hivatásos	ọjọgbọn	Nan
hiába	lasan	Nan
hiánya	aini	Nan
hiányzik	padanu	Nan
hiányzott	o sonu	Nan
hiányzó	sonu	Nan
hiányában	kuna	Nan
hn	loni	Nan
ho	osù	Nan
hogy	iyẹn	Nan
hogyan	bawo	Nan
hol	nibo	Nan
holdak	osu	Nan
homo	jọpọ	Nan
homoszexuális	fohun	Nan
honda	honda	Nan
hotel	hotẹẹli	Nan
house	ilé	None
howard	bawo	Nan
hoz	sí	Nan
hoznak	mu	Nan
hozni	muwa	Nan
hozott	mu	Nan
hozta	mu	Nan
hoztak	mu	Nan
hozták	oun	None
hozza	yoo	None
hozzá	rẹ	None
hozzájuk	wọn	None
hozzájárul	tiwon	Nan
hozzájárult	tiwon	Nan
hosszúságú	gigun	Nan
hosszú	gun	None
hosszas	gigun	Nan
hosszan	gun	None
honfoglalás	iṣẹgun	Nan
hongkong	ilu họngi kọngi	Nan
hongkongi	ilu họngi kọngi	Nan
honlap	aaye ayelujara	Nan
honlapja	aaye ayelujara	Nan
honlapján	aaye ayelujara	Nan
honvéd	olugbeja	Nan
hivatkozva	ifilo si	Nan
honvédelmi	olugbeja	Nan
horthy	itaniloju	Nan
horvát	croatiani	Nan
horváth	ìparun	Nan
horvátok	awọn irugbin croats	Nan
horvátország	kroatia	Nan
hossza	gigun	Nan
hosszabb	gun	None
honvédség	ogun	None
hozzájárultak	tiwon	Nan
hivatkozott	tọka	Nan
hivatalosan	ifowosi	Nan
henry	henry	Nan
hepatitis	jedojedo	Nan
herbert	herbert	Nan
herceg	ọmọ	None
hercege	the	None
hercegi	ducal	Nan
hercegnő	ọmọ-alade	Nan
hercegség	adodo	Nan
hermann	hermann	Nan
hermione	hermione	Nan
hess	anfani	Nan
hetedik	keje	Nan
hetek	emi	Nan
hetente	sẹsẹ	Nan
hetet	ọsẹ	Nan
henrik	henry	Nan
hetfield	hetfield	Nan
henri	henri	Nan
hemingway	hemingway	Nan
helyszínei	awọn aaye	Nan
helyszínek	awọn aaye	Nan
helyszínen	aaye	Nan
helytelen	ko	None
helyzet	ipinle	Nan
helyzetbe	ipo	None
helyzetben	ipo	None
helyzete	ipo	None
helyzetet	ipo	None
helyzetét	ipo	None
helyébe	rọpo	Nan
helyén	ibi	Nan
helyére	ibi	Nan
helyét	ibi	Nan
helyüket	ibi	Nan
hendrix	hendrix	Nan
heti	sẹsẹ	Nan
hetvenes	agogo	Nan
heves	kikan	Nan
hiszi	ro	None
hit	igbagbọ	Nan
hite	hite	Nan
hitel	kirẹditi	Nan
hiteles	ojulowo	Nan
hitet	igbagbọ	Nan
hitler	kọlu	Nan
hitre	igbagbọ	Nan
hitt	gbagbọ ninu	Nan
hitte	ronu	Nan
hitték	ronu	Nan
hivatal	ọfiisi	Nan
hivatala	ọfiisi	Nan
hivatali	isakoso	Nan
hivatalos	osise	Nan
hiszen	nitori	Nan
hisz	ronu	Nan
history	itan	Nan
hirtelen	lojiji	Nan
hiba	ẹbi	Nan
hibák	awọn aṣiṣe	Nan
hibás	ko	None
hibát	awọn aṣiṣe	Nan
hidak	afara	Nan
hidat	afara	Nan
hideg	tutu	Nan
hivatkoznak	ọna asopọ	Nan
hidegháború	ogun	None
hill	òkè	Nan
himnusz	orin oloyin	Nan
himnusza	hemó .ù	Nan
hindu	arakunrin hinia	Nan
hinduizmus	hinduism	Nan
hirdetett	ni igbega	Nan
hirdette	waasu	Nan
hihetetlen	iyalẹnu	Nan
idejét	aago	Nan
hozzák	mu	Nan
hozó	igbekale	Nan
hódító	asegun	Nan
hónap	osù	Nan
hónapban	osù	Nan
hónapig	awọn oṣu	Nan
hónapok	awọn oṣu	Nan
hónapokban	awọn oṣu	Nan
hónapos	osù	Nan
hónapot	awọn oṣu	Nan
hónappal	awọn oṣu	Nan
hónapra	awọn oṣu	Nan
hölgy	arabinrin	Nan
húga	arabinrin	Nan
húr	okun	Nan
húrok	lupu	Nan
húrtartó	ìrù	Nan
hódítás	iṣẹgun	Nan
hús	eran	Nan
hódoltság	iṣẹ	Nan
hó	osù	Nan
hírnevét	orukọ	Nan
hírt	awọn iroyin	Nan
hírére	awọn iroyin	Nan
hírű	olokiki	Nan
híve	olufokansin	Nan
hívei	awọn alafaramọ	Nan
hívja	pe	Nan
hívjuk	pe	Nan
hívják	pe	Nan
hívnak	wọn	None
hívott	ti a pe	Nan
hívta	o pe	Nan
hívták	wọn	None
hívő	olupe	Nan
hívők	oloootitọ	Nan
hódfélék	castoridae	Nan
húsvét	ajinde	Nan
húsvéti	ajinde	Nan
húsz	ogun	None
ibolya	awọ aro	Nan
ich	ich	Nan
icsigo	icsigo	Nan
id	id	Nan
ida	ida	Nan
ide	nibi	Nan
idegen	ajeji	Nan
idegenforgalmi	oniriajo	Nan
idegenforgalom	irin-ajo	Nan
ideig	aago	Nan
ideiglenes	fun	None
ideiglenesen	fun	None
ideje	aago	Nan
idejében	aago	Nan
idején	ninu	Nan
ibn	abinibi	Nan
ibm	ai bi emu	Nan
ian	ian	Nan
i	emi	Nan
húzódik	gbooro	Nan
húzódott	fà	Nan
húzódó	nínàá	Nan
hüvelyk	inch	Nan
hő	osù	Nan
hőmérséklet	otutu	None
hőmérséklete	otutu	None
hírnevet	okiki	Nan
hőmérsékleten	otutu	None
hős	akọni	Nan
hőse	akọni	Nan
hősi	akọni	Nan
hősök	awọn akọni	Nan
hű	adúróṣinṣin	Nan
hűséges	oloootitọ	Nan
hűvös	tutu	Nan
hőmérsékleti	otutu	None
hozzávetőleg	sunmọ	Nan
hírneve	orukọ	Nan
hírhedt	olokiki	Nan
háborúban	ogun	None
háborúellenes	antiwar	Nan
háborúja	ogun	None
háborúk	ogun	None
háborús	ogun	None
háborút	ogun	None
hálózat	nẹtiwọọki	Nan
hálózati	agbara	None
hálózatok	awọn nẹtiwọki	Nan
hány	melo	None
hármas	meteta	Nan
három	mẹta	Nan
háromszor	emeta	Nan
háromszög	onigun mẹta	Nan
hártyásszárnyúak	hymenoptera	Nan
háborúba	ogun	None
hát	sẹhin	Nan
háború	ogun	None
huszár	hussar	Nan
html	html	Nan
hugh	ofiri	Nan
hughes	famọra	Nan
hugo	hugo	Nan
hullám	igbi	Nan
hullámok	igbi	Nan
humanista	eniyan	Nan
humor	yẹyẹ	Nan
humoros	apanilẹrin	Nan
hun	hun	None
hungary	onigun	Nan
hunok	huns	Nan
hunyadi	hunyadi	Nan
hunyt	kú	Nan
huszadik	ọdun keji	Nan
hybrid	arabara	Nan
hátra	sẹhin	Nan
hátránya	konsi	Nan
hátsó	ru	Nan
héber	heberu	Nan
hélium	irinse	Nan
hét	meje	Nan
héten	ọsẹ	Nan
hétig	kan	None
héttel	ọsẹ	Nan
híd	afara	Nan
hídon	afara	Nan
híján	aito	Nan
hím	akọ	Nan
hír	awọn iroyin	Nan
híre	awọn iroyin	Nan
hírek	awọn iroyin	Nan
híres	olokiki	Nan
híressé	olokiki	Nan
händel	händel	Nan
häkkinen	hakkinen	Nan
házában	ilé	None
házi	ile	Nan
háttere	lẹhin	Nan
hátterében	lẹhin	Nan
háttér	lẹhin	Nan
háttérbe	lẹhin	Nan
háttérben	lẹhin	Nan
hátulról	sile	None
hátán	rẹ	None
hírlap	iwe iroyin	Nan
ház	ilé	None
házak	awọn ile	Nan
házaspár	tọkọtaya	Nan
házasság	igbeyawo	None
házasságot	iyawo	None
házat	ilé	None
házba	ilé	None
házban	ilé	None
háza	ile	Nan
−	-	Nan
