$	$	None
paus	whale	Nan
pawai	socdaal	None
payah	curyaan	Nan
payudara	naas	Nan
payung	dallad	Nan
pbb	midoobay	None
pc	pc	Nan
pci	pci	Nan
pda	pda	Nan
pdb	pdb	Nan
pdf	pdf	Nan
pdi	pdi	Nan
pdip	pdip	Nan
pdrb	pdrb	Nan
pebisnis	ganacsade	None
paul	paul	None
pecah	jabay	None
patungpatung	taallada	Nan
pattimura	pattimura	Nan
pasti	ahaan	None
pasukan	ciidamada	None
pasukannya	ciidankiisii	None
pasukanpasukan	ciidamada	None
pasundan	pasundan	Nan
pasuruan	pasuruan	Nan
patah	jabay	None
patahan	qalad	None
paten	patent	Nan
pati	istaarij	Nan
patih	gudoomiye	None
patogen	pathogen	Nan
patologi	cilmi	None
patrick	patrick	Nan
patroli	roondo	Nan
patung	taallada	Nan
pasteur	pasteur	Nan
pecahan	jajab	Nan
pecel	midab	None
pekanbaru	pekanbaru	Nan
pekat	saaray	None
pekerja	shaqaalaha	None
pekerjaan	xirfad	None
pekerjaannya	shaqadiisa	None
pelabuhan	dekeda	None
peladen	server	Nan
pelajar	arday	None
pelajaran	cashar	Nan
pelaksana	fuliyaha	Nan
pelaksanaan	hirgelinta	Nan
pelaksanaannya	hirgelinta	Nan
pelaku	dambiilayaasha	Nan
pelanggan	macmiil	Nan
pelanggaran	xadgudbay	None
pekan	toddobaad	Nan
pecahnya	jabin	Nan
pekalongan	pekalongan	Nan
pejuang	dagaalyahan	Nan
pecinta	lover	Nan
pedagang	ganacsade	None
pedagogi	barbaarin	None
pedalaman	gudaha	None
pedang	seef	Nan
pedangnya	seefta	Nan
pedas	basbaas	Nan
pedesaan	miyiga	None
pedoman	tilmaamaha	Nan
peduli	daryeel	None
pegangan	xamili	Nan
pegawai	shaqaale	None
pegunungan	buuraha	None
pein	pein	Nan
pejabat	ah	None
peka	ah	None
pelangi	qaansoroobaad	Nan
passer	qof	None
pasokan	sahay	Nan
paolo	paolo	Nan
papan	gole	Nan
paparan	u	None
papua	papua	Nan
para	para	Nan
parade	socdaal	None
paradigma	muuqaal	Nan
paragraf	sadarka	Nan
paraguay	paraguay	Nan
parah	daran	None
paralel	ah	None
parameter	xudun	Nan
parang	machete	Nan
pararaton	pararaton	Nan
parasit	dulle	Nan
pantun	pantun	Nan
pariaman	pariaman	Nan
panti	guri	None
pantas	habboon	None
panggang	dubay	Nan
panggilan	wacid	Nan
panggung	marxalad	None
pangkal	saldhig	None
pangkalan	saldhig	None
pangkalpinang	salka	None
pangkat	darajo	None
panglima	taliyaha	None
panitia	gudi	Nan
panjalu	dheer	None
panjang	dheer	None
panjangnya	dherer	None
panji	calan	None
pankreas	beeryarada	Nan
pantai	xeebta	None
panthera	panthera	Nan
pass	gudub	Nan
parikesit	parikesit	Nan
paris	paris	None
pas	sax	None
pasai	pasai	Nan
pasal	maqaal	Nan
pasang	rakibo	Nan
pasangan	lammaane	Nan
pasangannya	lammaanahiisa	Nan
pasar	suuqa	None
pasaran	suuqa	None
pasca	dhajin	Nan
pascal	baalka	Nan
pasien	bukaan	Nan
pasif	ah	None
pasifik	baasifiga	Nan
pasir	ciid	None
paskah	ciida	None
parwa	parwa	Nan
paripurna	kooban	None
paruparu	sambabka	Nan
paru	sambabka	Nan
parit	jeexdin	Nan
pariwisata	dalxiiska	None
park	baarkin	Nan
parkir	baarkinka	Nan
parlemen	baarlamaanka	None
parlementer	baarlamaanka	None
parman	parman	Nan
parsial	ahaan	None
partai	xaflad	Nan
partaipartai	xaflad	Nan
partikel	qayb	None
partikelpartikel	kooban	None
partisi	qayb	None
partisipasi	kaqeybgal	Nan
partner	lammaane	Nan
paruh	gadhka	Nan
pelaporan	soo	None
pelarangan	mamnuucid	Nan
pelarian	baxsad	Nan
pemeliharaan	dayactirka	Nan
pemeluk	dhunkasho	Nan
pemenang	guuleyste	Nan
pemencaran	kala	None
pemenuhan	oofinta	Nan
pemeran	jilaa	None
pemerataan	yahay	None
pemeriksa	baaraha	Nan
pemeriksaan	baaritaan	None
pemerintah	dowladda	None
pemerintahan	dowladda	None
pemerintahannya	dowladiisa	Nan
pemetaan	khariidaynta	Nan
pemikir	fikir	Nan
pemikiran	fikir	Nan
pemekaran	qaybinta	Nan
pemikiranpemikiran	fikradaha	Nan
pemegang	haye	Nan
pemburu	ugaadhsade	Nan
pembinaan	tababarka	None
pemblokiran	xannibaadda	Nan
pembuahan	rimay	Nan
pembuangan	daadinta	Nan
pembuat	sameeye	Nan
pembuatan	sameynta	Nan
pembuatannya	samaynta	Nan
pembubaran	kala	None
pembuka	furfuran	Nan
pembukaan	furitaanka	Nan
pembuktian	cadayn	Nan
pembuluh	maraakiibta	None
pembungkus	duubista	Nan
pembunuh	dilaaga	Nan
pembunuhan	dil	None
pemecahan	xalinta	Nan
pembicaraan	wadahadal	None
pemilahan	kala	None
pemilihan	doorashada	None
pemukiman	dejinta	Nan
pemula	ah	None
pemuliaan	taranka	Nan
pemulihan	soo	None
pemungutan	ururinta	Nan
penafsiran	tarjumaad	Nan
penakluk	guuleyste	Nan
penaklukan	guul	None
penalaran	sababaynta	Nan
penalti	rigoore	Nan
penamaan	magacaabista	Nan
penambahan	dheer	None
penampakan	aragga	Nan
penampilan	muuqaal	Nan
penampilannya	muuqaalkiisa	Nan
pemujaan	cibaadada	None
pemilih	doorta	Nan
pemugaran	soo	None
pemrosesan	howsha	Nan
pemilik	milkiilaha	None
pemiliknya	milkiilaha	None
pemilu	doorashooyinka	None
pemimpi	riyooday	Nan
pemimpin	hogaamiye	None
pemimpinnya	hogaankeeda	Nan
pemindahan	ka	None
pemindai	iskaanka	Nan
pemisah	gooni	None
pemisahan	go	None
pemodelan	qaabeynta	Nan
pemotongan	goynta	Nan
pempek	pempek	Nan
pemrogram	barnaamijka	None
pemrograman	barnaamijyada	None
pemuda	ah	None
pembicara	hadalka	None
pembiayaan	maalgelinta	Nan
pembesaran	weyneynta	None
peluncuran	furitanka	Nan
peluru	xabbad	Nan
peluruhan	burburka	None
pemahaman	fahamka	None
pemain	ciyaaryahan	Nan
pemakai	adeegsade	Nan
pemakaian	isticmaalka	None
pemakaman	aas	None
pemakan	cuno	None
pemanasan	diirimaad	Nan
pemancar	gudbiyaha	Nan
pemandangan	muuqaal	Nan
pemandian	qubeyska	Nan
pemanfaatan	ka	None
pemangsa	ugaadhsade	Nan
pelukis	rinjiye	Nan
pemasangan	rakibaadda	Nan
peluang	fursad	None
pelita	laambada	Nan
pelarut	solvent	Nan
pelataran	maxkamada	None
pelatih	tababaraha	Nan
pelatihan	tababarka	None
pelaut	badmaax	Nan
pelayan	suge	Nan
pelayanan	adeeg	None
pelayaran	doonnida	Nan
pelbagai	duwan	None
pelengkap	dhammaystir	Nan
pelepah	midrib	Nan
pelepasan	sii	None
pelestarian	ilaalinta	None
peliharaan	xayawaanka	Nan
pelindung	ilaaliyaha	None
pelopor	hormuud	Nan
pemasaran	suuqgeynta	Nan
pemasok	alaab-qeybiye	Nan
pemasukan	dakhliga	Nan
pembelahan	qaybinta	Nan
pembelajaran	barashada	None
pembeli	iibsade	Nan
pembelian	iibsan	Nan
pembentuk	formers	Nan
pembentukan	sameynta	Nan
pembentukannya	aasaaskeeda	Nan
pemberantasan	ciribtirka	Nan
pemberdayaan	xoojinta	None
pemberhentian	ruqseyn	Nan
pemberi	bixiye	Nan
pemberian	siinta	Nan
pemberontak	fallaagada	Nan
pemberontakan	fallaagada	Nan
pembersihan	nadiifinta	Nan
pembela	difaaca	None
pembedahan	qalliinka	Nan
pembebasan	badbaadinta	None
pembayaran	bixinta	None
pembaca	akhristaha	Nan
pembacaan	akhrinta	None
pembagian	qaybinta	Nan
pembaharuan	cusboonaysiinta	Nan
pembahasan	dood	None
pembakaran	gubashada	Nan
pembalap	racer	Nan
pangeran	amiir	None
pembalasan	aargudasho	Nan
pembangunan	horumarin	Nan
pembantaian	gawraca	Nan
pembantu	gabadh	None
pembaruan	cusboonaysiinta	Nan
pembatas	kalimad	Nan
pembatasan	xayiraad	Nan
pembawa	side	None
pembangkit	matoor	Nan
penampungan	hoy	Nan
pangan	cuntada	None
panel	gole	Nan
nurani	damiirka	Nan
nusa	hooyo	None
nusantara	jasiiradyo	Nan
nutrien	leh	None
nutrisi	nafaqada	Nan
nv	nv	Nan
nvram	nvram	Nan
ny	ny	Nan
nya	uu	None
nyai	nyai	Nan
nyak	nyak	Nan
nyaman	leh	None
nyamuk	kaneecada	Nan
nyanyian	heesta	None
nyaris	ku	None
numerik	nambar	Nan
nyata	ah	None
nuklir	nukliyeerka	Nan
nukleat	nucleate	Nan
normatif	ah	None
north	waqooyiga	None
norwegia	norwey	None
notasi	astaamo	None
nova	nova	Nan
novel	sheeko	None
november	nofembar	Nan
nox	nox	Nan
nt	nt	Nan
ntb	ntb	Nan
ntt	ntt	Nan
nu	nu	Nan
nuansa	nuance	Nan
nugini	nugini	Nan
nugroho	nugroho	Nan
nukleus	xudunta	Nan
normanorma	ah	None
nyawa	nool	None
nyi	nyi	Nan
oh	oh	Nan
ohm	ohm	Nan
oil	saliid	None
oksida	oxide	Nan
oksidasi	oksidaynta	Nan
oksidatif	oxidative	Nan
oksigen	oksijiin	Nan
oktet	octet	Nan
oktober	oktoobar	None
olah	kastoo	None
olahraga	ciyaaraha	None
old	jir	None
oleh	by	None
olehnya	isaga	None
olimpiade	olombikada	None
ogan	ogan	Nan
nyeri	xanuun	None
official	ah	None
off	dami	Nan
o	o	None
obama	obama	None
obat	daroogada	Nan
obatobatan	daroogada	Nan
obesitas	cayilka	Nan
obito	obito	Nan
objek	shayga	None
objekobjek	shay	None
objektif	ujeedo	Nan
obligasi	dammaanad	Nan
observasi	fiirsasho	Nan
observatorium	kormeer	Nan
obyek	walax	Nan
ocean	badda	None
of	ee	None
office	xafiiska	None
olympus	olympus	Nan
norman	norman	Nan
normal	ah	None
neoliberal	neoliberal	Nan
neoliberalisme	neoliberalism	Nan
neptunus	neptune	Nan
neraca	warqad	None
neraka	cadaabta	Nan
net	shabaq	Nan
netral	dhexdhexaad	None
network	shabakad	None
networks	shabakadaha	Nan
neumann	neumann	Nan
neuron	neurons	Nan
neutrofil	naafo	Nan
neutron	dheelitir	Nan
newton	newton	Nan
ngawi	ngawi	Nan
neoklasik	neoclassical	Nan
ngetop	ah	None
nenek	ayeeyo	Nan
nelayan	kalluumaysi	Nan
natural	ah	None
naturalis	ah	None
navigasi	badhanka	Nan
nazi	naasiis	Nan
near	dhow	None
nebula	nebulae	Nan
negara	wadanka	None
negaranegara	wadamada	None
negaranya	dalka	None
negatif	diidmo	Nan
negeri	wadanka	None
negerinegeri	wadanka	None
negerinya	dalka	None
negosiasi	gorgortanka	Nan
neji	neji	Nan
nelson	nelson	None
normalnya	caadiyan	Nan
ngurah	ngurah	Nan
ni	ni	Nan
no	maya	Nan
nobel	marin	None
nobita	nobita	Nan
noda	wasakh	Nan
node	buur	None
nol	eber	Nan
nominal	magacaabid	Nan
nominasi	magacaabista	Nan
nomor	tirada	None
non	ahayn	None
nonblok	isku	None
nong	nong	Nan
nonlogam	ahayn	None
noor	noor	Nan
norma	ah	None
nitrogen	nitrogen	Nan
nh	nh	Nan
nitrat	amooniyam	Nan
ninjutsu	ninjutsu	Nan
niaga	ganacsiga	None
nias	nias	Nan
niat	ujeedo	Nan
nic	nic	Nan
nica	nica	Nan
nigeria	nigeria	Nan
nike	nike	Nan
nikel	nickel	Nan
nikita	nikita	Nan
nikmat	nimco	Nan
nil	eber	Nan
nilai	goolal	Nan
nilainilai	qiyamka	Nan
nilainya	qiimaheeda	Nan
ninja	ninja	Nan
nirkabel	wireless	None
oma	oma	Nan
ombak	hirar	Nan
on	dul	None
page	bogga	None
pagi	subax	None
paham	fahmay	None
pahit	qadhaadh	Nan
pahlawan	geesi	None
pain	xanuun	None
pajajaran	waxbarista	Nan
pajak	cashuurta	Nan
pajang	bandhig	Nan
pak	sir	None
pakai	isticmaal	None
pakaian	dharka	None
pakan	quudin	Nan
pakar	khabiir	None
paket	xirmo	Nan
pagaruyung	pagaruyung	Nan
paketpaket	xirmo	Nan
pagar	deedka	Nan
padri	padri	Nan
pacar	ah	None
pacific	pacific	Nan
pacitan	ah	None
packet	baakad	Nan
pacu	orod	None
pacuan	tartan	Nan
pada	dul	None
padahal	oo	None
padang	paddock	Nan
padanya	isaga	None
padat	adag	None
padatan	ah	None
padepokan	xoolaha	None
paderi	wadaad	None
padi	bariis	None
paduan	alloy	Nan
pabrik	warshad	Nan
pakistan	pakistan	Nan
paksa	qasbay	None
pamungkas	ugu	None
panah	fallaadh	Nan
panas	kulul	None
panasonic	panasonic	Nan
panca	shan	None
pancaran	dhalaalaya	Nan
pancasila	pancasila	Nan
pandai	badan	None
pandang	aragtida	None
pandangan	arag	None
pandangannya	aragtidiisa	Nan
pandeglang	pandeglang	Nan
pandu	indha	None
panduan	hage	Nan
pane	pane	Nan
pameran	bandhig	Nan
pakpak	sayid	None
pamannya	adeerkiis	None
palung	kuleyl	Nan
paku	ciddiyaha	Nan
pakualaman	ciddiyaha	Nan
pakuan	fern	Nan
pakubuwono	pakubuwono	Nan
pala	nutmeg	Nan
palangka	palangka	Nan
palembang	palembang	Nan
palestina	palestine	Nan
palestine	palestine	Nan
palestinian	palestiin	Nan
pali	pali	Nan
paling	badan	None
pallu	pallu	Nan
palsu	ah	None
palu	dubbe	Nan
paman	adeer	None
p	p	None
ozon	ozone	Nan
ozawa	ozawa	Nan
optimal	fiicnayn	Nan
or	ama	None
oral	afka	None
orang	qof	None
orangorang	dadka	None
orangtua	waalidiinta	Nan
orangtuanya	waalidkiis	Nan
orangutan	orangutan	Nan
oranye	oranji	Nan
orbit	orbit	Nan
orbital	orbitals	Nan
orbitnya	socodkiisa	Nan
orde	amar	None
order	amar	None
ordo	amar	None
optika	indhaha	None
organ	xubin	None
optik	indhaha	None
oppie	dulmiga	None
oncom	oncom	Nan
ongkos	lacag	None
online	khadka	None
oort	oort	Nan
opak	opaque	Nan
opec	opec	Nan
opera	opera	Nan
operasi	hawlgal	Nan
operasional	shaqeeya	None
operating	shaqeeya	None
operator	wadeen	None
opini	ra&#39;yi	Nan
opium	opium	Nan
oportunistik	fursad	None
oposisi	mucaaradka	None
opsi	ikhtiyaar	Nan
organel	organelle	Nan
organik	ah	None
organisasi	urur	None
otomatis	ah	None
otomotif	baabuurta	None
otonom	madaxbannaan	None
otonomi	madax-bannaanida	Nan
otoritas	maamulka	None
otot	murqaha	Nan
ottoman	ottoman	Nan
our	our	Nan
out	banaanka	None
outdoor	bannaanka	Nan
output	saarka	None
oval	oval	Nan
ovarium	ugxan	Nan
ovum	ovum	Nan
oxford	oxford	Nan
otak	maskaxda	None
osteoporosis	osteoporosis	Nan
ost	ost	Nan
osmosis	osmosis	Nan
organisasiorganisasi	urur	None
organisme	noolaha	None
organization	urur	None
orgasme	uurjiifka	Nan
oriental	oriental	Nan
orientasi	hanuuninta	Nan
original	ah	None
panen	goosashada	Nan
orihime	orihime	Nan
ornamen	qurxinta	Nan
orochimaru	orochimaru	Nan
ortodoks	caado	None
os	os	Nan
osing	osing	Nan
osis	ardayda	None
oslo	oslo	Nan
orkes	orchestra	Nan
penanaman	beero	None
penanda	sumadeeyaha	Nan
penandatanganan	saxiixa	Nan
perkataan	ereyada	None
perkawinan	guur	None
perkebunan	dhirta	None
perkecualian	ka	None
perkelahian	la	None
perkembangan	horumarin	Nan
perkembangannya	horumarinteeda	Nan
perkiraan	qiyaas	None
perkotaan	magaalo	None
perkumpulan	urur	None
perlahan	ah	None
perlahanlahan	ah	None
perlakuan	daaweynta	Nan
perlawanan	iska	None
perlengkapan	qalab	None
perkara	kiis	Nan
perlindungan	ilaalin	None
perkapita	per capita	Nan
perkampungan	tuulo	None
perindustrian	warshadaha	None
peringatan	digniin	None
peringkat	darajada	Nan
perintah	amar	None
perintis	hormuud	Nan
periode	muddo	None
periodik	xilliyeed	Nan
perisai	gaashaan	None
peristiwa	dhacdo	None
peristiwaperistiwa	dhacdooyinka	None
perjalanan	safarka	None
perjalanannya	safarkiisa	Nan
perjan	axdiga	None
perjanjian	heshiis	None
perjuangan	halgan	None
perkantoran	xafiis	None
perimbangan	dheelitirka	Nan
perlombaan	tartan	Nan
perluasan	fidinta	None
perorangan	shaqsi	None
perpaduan	wajiga	Nan
perpajakan	cashuuraha	Nan
perpanjangan	kordhinta	None
perpecahan	go	None
perpindahan	barakac	Nan
perpustakaan	maktabad	Nan
pers	sii	None
persada	hooyo	None
persahabatan	saaxiibtinimo	None
persaingan	tartan	Nan
persalinan	foosha	Nan
persamaan	isleeg	None
persatuan	midnimo	None
persaudaraan	walaaltinimo	None
perombakan	isku	None
perlu	baahi	None
perolehan	helitaan	Nan
pernikahan	aroos	Nan
permainan	ciyaarta	None
permanen	ah	None
permasalahan	dhibaatada	None
permata	qurxinta	Nan
permen	nacnac	Nan
permintaan	codsi	None
permohonan	qirasho	Nan
permukaan	dusha	None
permukaannya	dushiisa	Nan
permukiman	dejinta	Nan
permulaan	bilowga	Nan
permusyawaratan	wadatashi	Nan
pernah	waligaa	Nan
pernapasan	neefsashada	Nan
perniagaan	ganacsiga	None
pernyataan	bayaan	Nan
persebaran	faafin	Nan
perilaku	dhaqan	None
perihelion	dulmiga	None
perawatan	daryeel	None
perawi	sheekeeye	Nan
perayaan	dabaaldeg	Nan
perbaikan	horumar	None
perbandingan	isbarbar dhig	Nan
perbankan	bangiyada	Nan
perbanyakan	faafinta	None
perbatasan	xadka	None
perbedaan	kala	None
perbedaannya	u	None
perbelanjaan	dukaamaysiga	Nan
perbendaharaan	khasnadda	Nan
perbuatan	camal	None
perbudakan	addoonsiga	Nan
perbukitan	buuraha	None
perawan	bikro	Nan
percakapan	wadahadal	None
peraturan	xeerarka	None
peranti	qalab	None
perak	lacag	None
peralatan	qalab	None
peralihan	bedel	Nan
peramban	biraawsarka	Nan
peran	door	None
peranan	door	None
perancang	naqshadeeye	Nan
perancangan	naqshadeynta	Nan
perancis	faransiiska	None
perang	dagaal	None
perangkat	qalab	None
perangko	shaambooyin	Nan
perantara	dhexdhexaad	None
perantau	guuraaga	None
perantauan	dibada	None
perasaan	dareen	None
perikanan	kalluumaysiga	Nan
percaya	aamin	None
perceraian	furiin	Nan
pergaulan	urur	None
pergelangan	curcurka	Nan
pergerakan	dhaqdhaqaaq	None
pergeseran	beddelasho	Nan
pergi	tag	Nan
perguruan	kulliyad	Nan
perhatian	feejignaan	Nan
perhatiannya	dareenkiisa	Nan
perhatikan	fiirso	Nan
perhiasan	dahabka	None
perhimpunan	urur	None
perhitungan	xisaabinta	Nan
perhubungan	gaadiid	None
peri	cirfiid	Nan
peribadatan	cibaadada	None
pergantian	beddelasho	Nan
percepatan	dardargelinta	Nan
performa	waxqabadka	Nan
perencanaan	qorshaynta	Nan
percintaan	jacayl	None
percobaan	maxkamad	None
perdagangan	ganacsiga	None
perdamaian	nabad	None
perdana	wasaare	None
perdarahan	dhiigbax	Nan
perdata	ah	None
perdebatan	dood	None
perebutan	u	None
peredaran	wareegga	Nan
perekam	duubista	Nan
perekonomian	dhaqaalaha	None
perempuan	haweenka	None
perempuannya	gabadha	None
perenang	dabaasha	Nan
perez	perez	Nan
persediaan	saamiga	Nan
persegi	labajibaaran	Nan
persekutuan	iskaashi	None
phoenix	phoenix	Nan
photo	sawir	None
photoshop	sawiro	Nan
php	php	Nan
physical	jir	None
pi	pi	Nan
piagam	jaartarka	Nan
piaget	piaget	Nan
piala	wareeg	Nan
piano	biyaano	Nan
piccolo	pcololo	Nan
pictures	sawirro	None
pidana	dambiile	Nan
pidato	hadalka	None
piece	gabal	Nan
phobos	phobos	Nan
pierre	deked	Nan
philip	falal	None
ph	ph	Nan
peterpan	sahamin	Nan
peti	xabadka	Nan
petinggi	kaca	None
petir	hillaac	Nan
petrus	petrus	Nan
petualangan	tacabur	Nan
petugas	sarkaalka	Nan
petunjuk	ahaan	None
peuyeum	peuyeum	Nan
pewaris	dhaxle	Nan
pewarisan	dhaxal	None
pewarnaan	midabaynta	Nan
pewayangan	puppet show	Nan
peziarah	xujaajta	Nan
pgri	pgri	Nan
phase	marxaladda	Nan
peternakan	xoolaha	None
pigmen	midabka	None
pihakpihak	xisbiyada	None
pintu	albaab	Nan
pipa	tuubbo	Nan
pippin	pippin	Nan
piramida	ahraam	Nan
piranti	qalab	None
pires	budhcad badeedda	Nan
piring	saxanka	Nan
piringan	disk	Nan
piruvat	pyruvate	Nan
pisang	mooska	None
pisau	mindi	Nan
pita	sharooto	Nan
piutang	karo	None
pkb	pkb	Nan
pki	pki	Nan
pintar	badan	None
pihak	xaflad	Nan
pinjaman	deyn	Nan
pinggul	sinta	Nan
pikir	ka	None
pikiran	maanka	None
pilar	tiir	None
pilih	xulo	Nan
pilihan	xulasho	Nan
pilot	pilot	Nan
pilpres	madaxweynaha	None
pimpinan	hogaamiye	None
pinang	betel nut	Nan
pindah	dhaqaaq	None
pindang	kariyey	None
ping	ping	Nan
pinggang	dhexda	None
pinggir	gees	None
pinggiran	geesaha	Nan
pingsan	gudbay	None
peter	butros	Nan
petani	ahaa	None
peta	khariidad	Nan
personal	shaqsiyeed	Nan
personel	shaqaalaha	None
perspektif	aragtida	None
persyaratan	shuruudaha	Nan
pertahanan	difaaca	None
pertama	hore	None
pertamanya	horreeyay	None
pertamatama	hore	None
pertambahan	aaminaad	Nan
pertambangan	macdan qodista	Nan
pertamina	pertamina	Nan
pertandingan	tartan	Nan
pertanggungjawaban	deyn	Nan
pertanian	beeraha	None
pertanyaan	su’aal	Nan
persoalan	dhibaato	None
pertapa	hidde	Nan
persis	ah	None
persija	persija	Nan
perselisihan	muran	None
persemakmuran	wadajirka	None
persembahan	qurbaanno	Nan
persen	boqolkiiba	None
persenjataan	hub	None
persentase	boqolkiiba	None
perseorangan	shaqsi	None
persepsi	aragti	None
perserikatan	midowga	None
persero	shirkad	None
perseroan	shirkad	None
persetujuan	oggolaansho	Nan
persia	adkeysi	Nan
persiapan	diyaarinta	Nan
persidangan	garsooraha	Nan
persilangan	iskutallaabta	Nan
pertarungan	la	None
pertempuran	dagaal	None
pertemuan	kulan	None
perusahaanperusahaan	shirkadaha	None
perusakan	kharribaad	Nan
perut	caloosha	Nan
perwakilan	wakiil	None
perwara	perwara	Nan
perwira	loo	None
perwujudan	xiraf	Nan
pesaing	tartamaya	Nan
pesan	farriin	Nan
pesantren	iskuul dhigashada	Nan
pesat	ah	None
pesawat	diyaaradda	Nan
peserta	kaqeybgale	Nan
pesisir	xeebta	None
pesta	xaflad	Nan
perusahaan	shirkad	None
perunggu	naxaas	Nan
perundingan	gorgortanka	Nan
perundangundangan	sharci	None
pertengahan	dhexda	None
pertentangan	dood	None
pertikaian	dagaal	None
pertimbangan	tixgelin	Nan
pertiwi	hooyo	None
pertolongan	i	None
pertukaran	sarrifka	Nan
perairan	biyaha	None
pertumbuhan	koritaanka	Nan
pertunjukan	show	Nan
pertunjukkan	showga	Nan
perubahan	beddel	Nan
perubahanperubahan	isbeddelada	Nan
perum	dadweynaha	None
perumahan	guryaha	None
perumusan	qaabeynta	Nan
pertumbuhannya	koritaankiisa	Nan
perahu	doon	None
peradilan	cadaaladda	None
peradangan	caabuq	Nan
pengalaman	khibrad	None
pengalamatan	ka	None
pengalihan	weecinta	Nan
pengamalan	dhaqan	None
pengamat	goobjooge	Nan
pengamatan	fiirsasho	Nan
pengambil	taker	Nan
pengambilan	qaadashada	None
pengangguran	shaqo	None
pengangkatan	balanta	Nan
pengangkut	side	None
pengangkutan	gaadiid	None
pengantar	hordhac	None
pengantin	iyo	None
penganut	raacsan	None
pengakuan	aqoonsi	None
pengarang	qoraa	None
pengajaran	waxbarista	Nan
pengadilan	maxkamada	None
penerangan	nalka	Nan
penerapan	codsi	None
penerbangan	duulimaadka	Nan
penerbit	soo	None
penerbitan	daabacaadda	Nan
penerima	qaataha	Nan
penerimaan	soo	None
penerjemah	turjubaan	Nan
penerjemahan	turjumaad	Nan
penerus	guuleystaha	Nan
penetapan	qaadashada	None
penetrasi	guska	Nan
pengabdian	cibaadada	None
pengacara	garyaqaan	None
pengadaan	soo	None
pengajar	macallin	None
penentuan	qaadashada	None
pengaruh	saameyn	Nan
pengasingan	masaafuris	Nan
pengendalian	xakamayn	Nan
pengendapan	dhigis	Nan
pengertian	qeexitaan	Nan
pengesahan	oggolaansho	Nan
pengetahuan	aqoon	None
penggabungan	midoobaya	Nan
penggalian	qodis	Nan
penggambaran	muuqaal	Nan
pengganti	badal	None
penggantian	beddelaad	Nan
penggemar	fan	Nan
penggemarnya	taageerayaashiisa	Nan
penggerak	dhaqdhaqaaqa	None
penggolongan	kala	None
pengguguran	soo	None
pengendali	xakameeyaha	Nan
pengaruhnya	saamaynta	None
pengenalan	hordhac	None
pengembang	kobciyaha	Nan
pengatur	sharciyeye	Nan
pengaturan	dejinta	Nan
pengawal	ilaaliye	Nan
pengawas	kormeeraha	Nan
pengawasan	kormeerka	Nan
pengeboman	qarxis	Nan
pengeboran	qodista	Nan
pengecualian	reebo	None
pengejaran	eryan	Nan
pengekspor	dhoofinta	Nan
pengelola	maamulaha	None
pengelolaan	maaraynta	None
pengelompokan	kooxaynta	Nan
pengeluaran	kharash garaynta	Nan
pengembalian	noqo	None
pengembangan	horumarin	Nan
penentu	go&#39;aan qaadasho	Nan
penentangan	mucaaradka	None
penemuanpenemuan	daahfurka	Nan
pencarian	raadin	Nan
pencatatan	duubista	Nan
pencegahan	ka	None
pencemar	codbixiyaha	Nan
pencemaran	wasakheynta	Nan
pencerahan	iftiin	Nan
pencerap	nuugta	Nan
pencernaan	dheefshiidka	Nan
pencetak	daabacaad	Nan
pencetus	ahaan	None
pencipta	abuuraha	Nan
penciptaan	abuurista	Nan
penculikan	afduubka	Nan
pendaftar	xirfadle	Nan
pendaftaran	diiwaangelinta	Nan
pencari	baadiye	None
pendahuluan	ah	None
pencapaian	guul	None
pencak	qalin	None
penang	penang	Nan
penanganan	maaraynta	None
penanggalan	kalandarka	None
penanggulangan	ka	None
penangkapan	qabasho	Nan
penangkaran	ahaan	None
penari	dhaanto	None
penarikan	bixitaan	Nan
penasehat	la	None
penasihat	lataliye	Nan
penataan	abaabul	None
penataran	u	None
penawaran	bixin	None
pencabutan	kala	None
pencaharian	nololeed	None
pencampuran	isku	None
pendakian	fuulid	Nan
pendamping	wehel	None
pendapat	ra&#39;yi	Nan
penduduknya	deggan	None
pendukung	taageerayaasha	None
pendukungnya	taageerayaasheeda	Nan
penebangan	qorista	None
penegak	dhaqangeliyaha	Nan
penegakan	hirgelinta	Nan
penekanan	xoojinta	None
peneliti	baaraha	Nan
penelitian	baaris	None
penelitiannya	daraasaddiisa	Nan
penembakan	toogashada	Nan
penempatan	meeleyn	Nan
penemu	soo	None
penemuan	curinta	Nan
penemuannya	daahfurka	Nan
pendudukan	shaqo	None
penduduk	dadka	None
pendorong	xoojin	Nan
pendirian	aasaasid	Nan
pendapatan	dakhliga	Nan
pendarahan	dhiigbax	Nan
pendaratan	degid	Nan
pendatang	majaajillo	Nan
pendek	gaaban	None
pendekar	dagaalyahan	Nan
pendekatan	u	None
pengguna	adeegsadaha	Nan
pendengaran	maqalka	Nan
penderitaan	silica	Nan
pendet	pendet	Nan
pendeta	wadaad	None
pendidikan	waxbarasho	None
pendidikannya	waxbarashadiisa	None
pendinginan	qaboojinta	Nan
pendiri	aabihiis	None
penderita	xanuunsanaya	Nan
natsir	natsir	Nan
penggunaan	isticmaal	None
penggunanya	adeegsadeyaasheeda	Nan
penyakit	cudur	None
penyakitpenyakit	cudur	None
penyalahgunaan	xadgudubka	Nan
penyaluran	qaybinta	Nan
penyambutan	soo	None
penyampaian	gaarsiinta	None
penyangga	dhuumaaleysi	Nan
penyanyi	fanaan	None
penyatuan	midowga	None
penyebab	sabab	None
penyebabnya	sababta	None
penyebar	fidiyaha	Nan
penyebaran	faafitaan	Nan
penyebutan	xusid	None
penyederhanaan	fududaynta	Nan
penyajian	soo	None
penyedia	bixiyaha	Nan
penyair	gabayaa	Nan
penutup	xiritaanka	Nan
pensiun	hawlgab	Nan
pentaeritritol	pentaerythritol	Nan
pentas	marxalad	None
penting	ah	None
pentingnya	muhiimadda	Nan
penuh	buuxa	None
penukaran	sarrifka	Nan
penularan	gudbinta	Nan
penulis	qoraa	None
penulisan	qoraal	None
penumpang	rakaab	Nan
penumpukan	dhiso	None
penunjang	taageero	None
penunjuk	tilmaame	Nan
penurunan	yareyn	Nan
penutur	hadalka	None
penonton	dhagaystayaasha	Nan
penyediaan	bixinta	None
penyelamatan	badbaadinta	None
penyimpanan	kaydinta	Nan
penyimpangan	weecasho	Nan
penyokong	taageere	Nan
penyuluhan	talin	None
penyusun	compiler	Nan
penyusunan	qoritaanka	Nan
penyusunnya	xubnaheeda	Nan
peoples	dadyowga	Nan
pepagan	jaahiliin	Nan
peperangan	dagaal	None
pepes	pepes	Nan
pepohonan	geedaha	None
peptidoglikan	peptidoglycan	Nan
per	per	Nan
peradaban	ilbaxnimo	Nan
penyihir	saaxir	Nan
penyelamat	badbaadiye	Nan
penyidikan	baaritaan	None
penyiar	ogeysiis	Nan
penyelenggara	qabanqaabiye	Nan
penyelenggaraan	hirgelinta	Nan
penyelesaian	dejinta	Nan
penyelidik	baaraha	Nan
penyelidikan	baaritaan	None
penyembuhan	bogsashada	Nan
penyempitan	ah	None
penyempurnaan	horumar	None
penyerahan	dhiib	None
penyerang	weerar	None
penyerangan	weerar	None
penyerapan	nuugista	Nan
penyerbukan	ubax	None
penyertaan	ku	None
penyesuaian	hagaajinta	Nan
penyiaran	baahin	Nan
penolakan	diidmada	None
penjuru	dhaaftay	None
penjumlahan	dheer	None
penginderaan	dareen	None
pengirim	dira	Nan
pengiriman	gaarsiinta	None
pengisi	buufin	Nan
pengkajian	qiimeyn	Nan
pengkhianatan	khiyaano	Nan
penglihatan	aragti	None
pengobatan	daaweynta	Nan
pengolah	processor	Nan
pengolahan	howsha	Nan
pengomposan	isku	None
pengorbanan	allabari	Nan
pengorganisasian	abaabulka	Nan
penguapan	uumi bax	Nan
penguasa	taliye	None
pengikutnya	raacsan	None
penguasaan	awood	None
pengikut	raacsan	None
pengikat	xarkaha	Nan
penghalang	caqabad	Nan
penghambat	horjoogayaasha	Nan
penghancuran	halaag	None
penghapusan	ka	None
penghargaan	qadarin	Nan
penghasil	soo	None
penghasilan	dakhliga	Nan
penghentian	joojinta	Nan
penghitungan	xisaabinta	Nan
penghormatan	cashuur	Nan
penghubung	isku	None
penghujan	roob	None
penghujung	dhamaadka	None
penghulu	madax	None
penghuni	degganaan	Nan
pengikatan	ku	None
penguat	xoojin	Nan
pengubahan	beddelaad	Nan
pengucapan	dhawaaqa	Nan
peninggalan	relic	Nan
peningkatan	xoojinta	None
penis	guska	Nan
penjabaran	sharraxaad	Nan
penjaga	amniga	None
penjahat	the	None
penjajah	duulaanka	Nan
penjajahan	gumeysiga	None
penjara	xabsi	None
penjelajah	baadhis	Nan
penjelajahan	sahaminta	Nan
penjelasan	sharraxaad	Nan
penjelmaan	ahaan	None
penjual	iibiye	Nan
penjualan	iibinta	Nan
penindasan	dulmiga	None
penimbunan	hoarding	Nan
penilaian	qiimeyn	Nan
pengusaha	ganacsade	None
pengujian	tijaabinaya	Nan
pengukur	xiirid	Nan
pengukuran	cabbiraadda	Nan
pengulangan	ku	None
pengumpul	aruuriyaha	Nan
pengumpulan	ururinta	Nan
pengumuman	ku	None
penggunaannya	isticmaalkeeda	Nan
pengunduran	is	None
pengungsi	qaxooti	None
pengungsian	hoy	Nan
pengunjung	soo	None
penguraian	giirte	Nan
pengurangan	kala	None
pengurus	daryeele	Nan
pengurusan	abaabul	None
pengungkapan	siidaynta	None
natrium	sodium	Nan
national	qaran	None
nation	qaran	None
mempelajari	baro	None
mempengaruhi	saameyn	Nan
memperbaiki	hagaajin	Nan
memperbanyak	ku	None
memperbesar	weyneeya	Nan
memperbolehkan	ogolaan	None
memperburuk	xumaaday	None
mempercayai	aamin	None
mempercepat	xawaare	Nan
memperebutkan	la	None
mempergunakan	isticmaal	None
memperhatikan	yeelo	None
memperhitungkan	xisaabta	None
memperingati	xusid	None
memperingatkan	digniin	None
memotong	gooyaa	Nan
memperjelas	caddee	Nan
memory	xusuusta	Nan
memopulerkan	baahin	Nan
memikirkan	ka	None
memilih	dooro	None
memiliki	leeyihiin	None
memilki	leeyihiin	None
memimpin	horseed	None
memindahkan	dhaqaaq	None
meminjam	deynsato	Nan
meminjamkan	deynsato	Nan
meminta	weydiiso	None
meminum	cab	Nan
memisahkan	ah	None
memodifikasi	ka	None
memohon	dawarsanaya	Nan
memompa	bamgare	Nan
memonitor	kormeer	Nan
memori	xusuusta	Nan
memicu	kiciya	Nan
memperjuangkan	u	None
memperkenalkan	baro	None
mempunyai	leeyihiin	None
memuaskan	qancin	Nan
memuat	rar	Nan
memudahkan	fududee	Nan
memuja	u	None
memuji	ammaanta	Nan
memukul	garaacid	Nan
memulai	bilow	None
memuliakan	ammaana	Nan
memulihkan	celin	None
memuncak	qulqulaya	Nan
memunculkan	keen	Nan
memungkinkan	gal	None
memusatkan	saar	None
memusnahkan	tirtira	Nan
mempublikasikan	loo	None
memperkaya	kobcin	Nan
memproses	loo	None
memproklamasikan	ku	None
memperkirakan	qiyaas	None
memperkuat	xoojin	Nan
memperlambat	gaabis	Nan
memperlihatkan	u	None
memperluas	fidin	None
mempermudah	fududeeyo	Nan
memperoleh	hel	Nan
memperpanjang	fidin	None
mempersiapkan	diyaari	Nan
mempertahankan	dayactir	None
mempertanyakan	su’aal	Nan
mempertimbangkan	tixgelin	Nan
memprediksi	saadaalin	Nan
memprediksikan	saadaalin	Nan
memproduksi	saar	None
mempromosikan	dallacsiin	Nan
memutuskan	qaadashada	None
memfokuskan	diiradda	Nan
memetakan	khariidad	Nan
membenci	nacayb	None
membendung	jirridda	Nan
membentang	fidiyey	None
membentuk	qaab	None
memberantas	cirib tir	Nan
memberi	siin	None
memberikan	dhiibid	None
memberinya	sii	None
memberitahu	sheegaya	None
memberitahukan	sheeg	None
memberlakukan	sharciyeynta	Nan
memberontak	fallaagada	Nan
membersihkan	ah	None
membesar	weyneeya	Nan
membiarkan	daa	None
membenarkan	qiil	Nan
membiayai	dhaqaalaha	None
membeli	iibso	None
membela	difaaco	Nan
membangun	dhisaan	None
membantah	doodaan	None
membantu	i	None
membantunya	iyada	None
membatalkan	baajin	Nan
membatasi	xad	None
membawa	keen	Nan
membawakan	keen	Nan
membawanya	qaado	None
membayangkan	qiyaas	None
membayar	bixin	None
membebaskan	xorayn	Nan
membedakan	kala	None
membedakannya	saar	None
membeku	barafow	Nan
membelah	kala	None
memfasilitasi	fududeyn	Nan
membicarakan	kahadlaya	Nan
membina	dhiso	None
memecah	jab	None
memecahkan	xallin	Nan
memegang	xaji	None
memelihara	dayactir	None
memeluk	dhunkashada	Nan
memenangi	guuleysto	None
memenangkan	guuleysto	None
memengaruhi	loo	None
mementingkan	ugu	None
memenuhi	dhamaystir	Nan
memerangi	la	None
memeriksa	hubin	Nan
memerintah	xil	None
memerintahkan	baro	None
memerlukan	baahi	None
membutuhkan	baahi	None
membidangi	adeeg	None
memburuk	kasii	None
membunuhnya	dila	None
membingungkan	jahwareer	Nan
membintangi	jira	None
membolehkan	ogolaan	None
membran	xuubka	Nan
membuahi	bacrimiya	Nan
membuahkan	dhal	None
membuang	tuuro	None
membuat	samee	Nan
membuatnya	samee	Nan
membubarkan	diraan	None
membujuk	qancin	Nan
membuka	fur	Nan
membuktikan	caddeyn	Nan
membungkus	duub	None
membunuh	dilo	None
memburu	loo	None
men	ragga	None
menabrak	galay	None
menafsirkan	tarjunto	Nan
menenangkan	leh	None
menendang	laad	Nan
menengah	ah	None
menentang	soo	None
menentukan	go&#39;aamiso	Nan
menerangkan	sharrax	Nan
menerapkan	dalbo	Nan
menerbitkan	arrin	None
menerima	hel	Nan
menerjang	shil	None
menerjemahkan	tarjunto	Nan
menerus	ah	None
meneruskan	sii	None
menetap	joog	None
menetapkan	dhigay	None
menemukan	hel	Nan
menetas	dillaacaan	Nan
menemui	kulan	None
menempel	ku	None
menduduki	mashquul	None
menduga	qiyaasey	Nan
mendukung	taageero	None
mendut	mendut	Nan
menegakkan	taageer	Nan
menegaskan	xaqiijinaya	Nan
menekan	riix	Nan
menekankan	adkeyn	Nan
menelan	liqid	Nan
meneliti	baarista	Nan
menelusuri	raadin	Nan
menembak	toogasho	None
menembus	gelin	None
menempati	mashquul	None
menempatkan	gelin	None
menempuh	marayo	None
mendorong	riixid	Nan
menewaskan	dilay	None
mengacu	tixraac	None
mengalir	qulqulka	Nan
mengalirkan	daadi	Nan
mengamankan	aamin	None
mengamati	fiirso	Nan
mengambil	qaadan	None
mengamuk	duqeynta	Nan
menganalisis	loo	None
mengancam	hanjabaad	Nan
mengandalkan	aaminid	Nan
mengandung	kooban	None
menganggap	qaadan	None
menganggapnya	tixgeli	Nan
mengangkat	u	None
mengangkut	gaadiid	None
menganjurkan	talin	None
mengalihkan	leexinta	Nan
mengabaikan	iska	None
mengalami	leh	None
mengalahkan	garaacid	Nan
mengadakan	gasho	Nan
mengadopsi	loo	None
mengadu	digaag	Nan
mengagumkan	leh	None
mengajak	casuumad	Nan
mengajar	baro	None
mengajarkan	baro	None
mengajukan	feyl	Nan
mengakhiri	dhamaadka	None
mengakibatkan	in	None
mengakses	marin	None
mengaktifkan	firfircooni	None
mengaktivasi	firfircooni	None
mengaku	qiran	Nan
mengakui	qirasho	Nan
mengalahkannya	ka	None
mendominasi	xukumaa	Nan
mendistribusikan	qaybin	None
mendirikan	aasaasid	Nan
menanggapi	jawaab	Nan
menangis	ooyaya	Nan
menangkap	qabasho	Nan
menantang	loolan	Nan
menantu	soddog	Nan
menanyakan	weydiiso	None
menara	munaarad	Nan
menari	dhaanto	None
menarik	leh	None
menaruh	gelin	None
menawarkan	bixin	None
mencabut	ka	None
mencair	dhalaasho	Nan
mencakup	daboolida	None
mencampurkan	isku	None
menangani	xamili	Nan
mencapai	gaaro	None
menang	guuleysto	None
menandakan	saxeex	Nan
menahan	u	None
menaiki	fuulay	None
menaikkan	qaad	None
menaklukkan	guuleysta	Nan
menakutkan	cabsi	None
menamai	magacaa	Nan
menamakan	magacaa	Nan
menambah	dar	None
menambahkan	dar	None
menampakkan	muujinta	Nan
menampilkan	bandhigo	None
menampung	dejin	Nan
menanam	dhirta	None
menanamkan	ku	None
menandai	calaamadee	Nan
menandatangani	saxeex	Nan
mencari	raadinaya	Nan
mencatat	qoroso	Nan
mencegah	ka	None
mendasari	hoostiisa	None
mendatang	mustaqbalka	None
mendatangi	kaalay	Nan
mendatangkan	keen	Nan
mendefinisikan	qeex	Nan
mendekati	soo	None
mendel	barar	Nan
mendengar	maqal	None
mendengarkan	dhageyso	Nan
menderita	la	None
mendesak	ah	None
mendeskripsikan	sharrax	Nan
mendeteksi	ogaansho	Nan
mendiami	degid	Nan
mendidik	waxbarid	Nan
mendasar	ah	None
mendarat	degay	None
mendapatkan	helay	None
mendapati	hel	Nan
menceritakan	sheego	None
mencerminkan	milicsato	Nan
mencerna	dheefshiidka	Nan
mencetak	daabacan	Nan
mencintai	jacayl	None
menciptakan	abuuraan	Nan
mencoba	isku	None
membangkitkan	toosay	Nan
mencolok	leh	None
mencukupi	filan	None
mencuri	xado	Nan
mendadak	kadis	Nan
mendahului	gaadho	None
mendalam	dheer	None
mendalami	dheer	None
mendapat	helay	None
mencuci	dhaq	None
membandingkan	isbarbar dhig	Nan
membalas	jawaab	Nan
membakar	gubasho	Nan
maps	khariidadaha	Nan
marah	xanaaqsan	Nan
march	socod	Nan
marco	marco	Nan
maret	maarso	None
marga	qabiil	None
maria	maryan	None
marie	guur	None
mario	mario	Nan
maritim	badaha	Nan
mark	calaamadee	Nan
markas	xarunta	None
market	suuqa	None
marketing	suuqgeynta	Nan
maroko	morocco	Nan
mao	mao	None
mars	mars	Nan
many	badan	None
manufaktur	saar	None
mangga	mangoon	Nan
mangkuk	baaquli	Nan
mangsa	ugaarsiga	Nan
mangsanya	ugaarsigeeda	Nan
mangunkusumo	mangunkusumo	Nan
manifestasi	muujinta	Nan
manik	kuusha	Nan
manila	manila	Nan
manipulasi	kadeedis	Nan
manis	macaan	None
manisan	candied	Nan
mantan	ex	None
mantap	weyn	None
mantel	jaakad	Nan
manual	buugga	None
manusia	aadanaha	None
mangekyou	mangekyou	Nan
marshall	marshall	Nan
martin	martin	Nan
mask	maaskaro	Nan
maskapai	diyaaradda	Nan
maslow	maslow	Nan
massa	tiro	None
massal	tiro	None
massanya	cufnaantiisa	Nan
master	sayidkii	Nan
masturbasi	naaso	Nan
masuk	gal	None
masukan	fikrad	None
masuknya	gelitaanka	Nan
masyarakat	dadweynaha	None
masyarakatnya	dadka	None
masyumi	masyumi	Nan
mata	isha	None
masjid	masaajidka	None
marshanda	marshanda	Nan
masingmasing	kasta	None
masih	wali	None
marwan	marwan	Nan
marx	marx	None
marxis	marxis	Nan
marxisme	marxism	Nan
mary	maryo	Nan
marzuki	marzuki	Nan
mas	sayid	None
masa	runtii	None
masak	kariye	Nan
masakan	kari	None
masalah	dhibaato	None
masalahmasalah	dhibaatooyinka	None
masamasa	da	None
masanya	waqtigiisii	Nan
masehi	mas	Nan
masing	kala	None
manga	manga	Nan
manfaat	faa&#39;iidooyinka	Nan
mandiri	banaan	None
makhluk	xayawaan	None
makhluknya	abuurkiisa	Nan
maki	maki	Nan
makin	badan	None
makkah	makkah	Nan
makmur	barwaaqo	None
makna	macnaheedu	None
makro	macro	Nan
makrofaga	macrophages	Nan
maksimal	ugu	None
maksimum	ugu	None
maksud	macnaheedu	None
maksudnya	waa	None
mal	suuqa	None
malah	xitaa	None
makassar	makassar	Nan
malaikat	malaa&#39;ig	Nan
makanannya	cuntada	None
makan	cun	None
mahkota	taaj	Nan
mahluk	xayawaan	None
mahmud	mahmud	Nan
mail	boostada	Nan
main	ciyaar	None
majalah	joornaal	Nan
majalahmajalah	joornaalka majaladda	Nan
majalengka	majalengka	Nan
majapahit	majapahit	Nan
majas	hadalka	None
majelis	shirkii	None
majemuk	xarunta	None
maju	kor	None
maka	markaa	None
makam	xabaal	None
makanan	cuntada	None
malaka	malacca	Nan
malakh	malakh	Nan
malam	habeen	None
manager	maamulaha	None
manajemen	maaraynta	None
manajer	maamulaha	None
manakala	goorma	Nan
manamana	manamana	Nan
manapun	wax	None
mancanegara	shisheeye	None
manchester	manchester	None
mandailing	maamulid	Nan
mandala	mandala	Nan
mandar	mandar	Nan
mandarin	mandarin	Nan
mandat	waajib	None
mandela	mandela	None
mandi	qubeyska	Nan
management	maaraynta	None
manado	manado	Nan
mana	halkee	Nan
mampu	leh	None
malang	ah	None
malaria	duumada	Nan
malaya	malaya	Nan
malaysia	malaysiya	None
malayu	malays	Nan
maldini	maldini	Nan
malik	malik	Nan
matahari	qorrax	Nan
malin	malin	Nan
mallaby	mallaby	Nan
malta	malta	None
malu	ceeb	None
maluku	ceebtayda	Nan
mama	hooyo	None
mamalia	dameeraha	Nan
mamori	mamori	Nan
mall	suuq	None
mengantar	tuur	None
matamata	indhaha	None
matanya	indhihiisa	Nan
melingkar	wareegsan	None
melingkupi	dabool	Nan
melintang	transverse	Nan
melintas	maraya	Nan
melintasi	ahaan	None
meliputi	daboolida	None
mellitus	mellitus	Nan
mello	mello	Nan
melodi	heeso	None
meloloskan	la	None
melompat	bood	None
meluas	baahsan	Nan
meluaskan	fidin	None
melucuti	ka	None
melukai	dhaawacay	Nan
melindungi	ilaali	None
melukis	rinjiga	None
melimpah	qulqulka	Nan
melihatnya	arag	None
melekat	ku	None
melemah	daciifay	Nan
melemahkan	daciifin	Nan
melempar	tuur	None
melemparkan	tuuray	None
melengkapi	dhameystiran	Nan
melengkung	qalooca	Nan
melepas	qaataan	None
melepaskan	daa	None
melestarikan	ilaalin	None
meletakkan	gelin	None
meletus	qarxay	Nan
melewati	mari	None
melibatkan	lug	None
melihat	eegid	Nan
melilit	ku	None
meledak	qarxin	Nan
meluncurkan	furitanka	Nan
memacu	dhirbaaxo	Nan
memantau	kormeer	Nan
memantulkan	milicsato	Nan
memasak	kariye	Nan
memasang	dul	None
memastikan	hubiyo	Nan
memasukan	gelin	None
memasuki	gala	None
memasukkan	gala	None
mematahkan	jab	None
mematikan	dami	Nan
membaca	akhri	None
membagi	qaybin	None
membahas	hadal	None
membahayakan	gelin	None
membaik	bood	None
memanjang	dherer	None
melupakan	hilmaam	Nan
memanipulasi	kadhig	Nan
memanggilnya	u	None
memadai	filan	None
memadukan	fiyuus	Nan
memahami	fahmay	None
memainkan	ciyaar	None
memajukan	soco	None
memakai	xidho	None
memakan	cun	None
memaksa	ku	None
memanah	qaanso	Nan
memancarkan	iftiin	Nan
memancing	kalluumeysiga	Nan
memandang	eegay	None
memanfaatkan	looga	None
memang	ahaantii	None
memanggil	wacid	Nan
memangsa	ugaadhsato	Nan
melebur	dar	None
melebihi	dhaaf	None
melayu	malays	Nan
maxwell	maxwell	Nan
may	yaabaa	None
maya	maya	Nan
mayat	mayd	Nan
mayjen	magaalada	None
mayor	weyn	None
mayoritas	aqlabiyad	None
mazhab	dugsiga	None
mb	mb	Nan
medali	bilad	Nan
medan	duurka	None
medang	medang	Nan
media	warbaahinta	None
medical	caafimaad	None
medik	caafimaad	None
max	max	Nan
medika	medica	Nan
mawar	kacay	None
maupun	kale	None
mataram	mataraad	Nan
matematika	xisaabta	None
matematikawan	xisaabiye	Nan
matematis	xisaab	None
materi	fikradda	Nan
material	wax	None
materiil	wax	None
materimateri	wax	None
mati	dhinto	None
matius	dhinto	None
matriks	matrix	Nan
matsumoto	matsumoto	Nan
matt	matt	Nan
mau	raba	None
maulana	maulana	Nan
maut	geeri	None
medis	caafimaad	None
mediterania	badweynta	None
medium	ah	None
melambangkan	ah	None
melampaui	kabaxsan	None
melancarkan	bilaabid	Nan
melanda	dhuftay	None
melanggar	burburin	Nan
melanjutkan	sii	None
melantik	caleema saarkii	Nan
melaporkan	warbixin	None
melarang	mamnuuc	Nan
melarikan	orod	None
melarutkan	diri	None
melati	yaasiin	None
melatih	tareen	None
melawan	soo	None
melayani	adeeg	None
melalui	marayo	None
melakukannya	samee	Nan
melakukan	sameeyo	None
melaksanakan	samaynaya	None
mega	mega	Nan
megah	badan	None
megawati	megawati	Nan
mei	yaabaa	None
meitantei	meitantei	Nan
meja	miis	Nan
mekanik	makaanik	Nan
matang	baaluq	Nan
mekanika	makaanikada	Nan
mekanisme	farsamada	None
mekkah	mecca	Nan
meksiko	mexico	Nan
melacak	waddo	None
melahirkan	dhalo	Nan
melainkan	laakiin	None
melaka	melaka	Nan
mekanis	yaqaan	None
pks	pks	Nan
mengantarkan	gaarsiin	Nan
mengapa	sababta	None
minyak	saliid	None
miring	jeexay	Nan
mirip	ah	None
misa	tiro	None
misal	tusaale	None
misalkan	ahaan	None
misalnya	ahaan	None
mischa	mischa	Nan
misi	howlgalka	Nan
misil	gantaal	Nan
misionaris	adeegayaashii	Nan
miskin	ah	None
mission	howlgalka	Nan
misteri	qarsoodiga	Nan
misterius	dahsoon	None
minuman	cabitaan	Nan
mistik	suugaanta	None
minum	cab	Nan
minoritas	yahay	None
mimpi	riyo	None
minahasa	minahasa	Nan
minang	minang	Nan
minangkabau	minangkabau	Nan
minat	dan	None
minato	minato	Nan
mineral	macdanta	Nan
ming	ming	Nan
minggu	axad	None
mingguan	toddobaadle	Nan
mini	mini	Nan
minimal	yar	None
minimum	yar	None
mining	macdan qodista	Nan
minor	yar	None
minta	weydiiso	None
milton	milton	Nan
mistisisme	mysticism	Nan
mitologi	khuraafaad	Nan
mohammad	mohammad	Nan
mojokerto	mojokerto	Nan
molekul	molecule	Nan
molekular	moodeel	Nan
molekuler	moodeel	Nan
molekulmolekul	molecule	Nan
momen	daqiiqad	Nan
momentum	xawaare	Nan
monarki	boqortooyadii	None
monas	monas	Nan
moneter	lacag	None
money	lacag	None
mongol	mongol	Nan
mongolia	mongolia	Nan
monica	monica	Nan
mohamad	mohamad	Nan
mitokondria	mitochondria	Nan
moh	moh	Nan
modifikasi	ka	None
mitos	khuraafaad	Nan
mitra	lammaane	Nan
mk	mk	Nan
mm	mm	Nan
mobil	baabuur	None
mobile	mobilada	Nan
mobilitas	dhaqdhaqaaqa	None
mochtar	mochtar	Nan
modal	caasimada	None
mode	hab	None
model	moodel	Nan
modelmodel	moodooyinka	Nan
modem	modem	Nan
modern	ah	None
modernisasi	casriyeynta	Nan
modus	hab	None
monitor	kormeeraha	Nan
militer	ciidan	None
miliknya	uu	None
mesir	masar	None
mesjid	masaajidka	None
meski	kastoo	None
meskipun	oo	None
messenger	farriin	Nan
mesti	waa	None
metabolisme	kiimikaad	None
metal	bir	None
metamorfosis	metamorphosis	Nan
metana	methane	Nan
metanol	methanol	Nan
metastasis	metastasis	Nan
meteor	meteor	Nan
meteorologi	meteorologist	Nan
meter	mitir	Nan
mesinmesin	mashiinka	Nan
metionina	methionine	Nan
mesin	mashiinka	Nan
merupakan	waa	None
merencanakan	qorshe	None
merendahkan	u	None
merepresentasikan	matalo	Nan
merespon	jawaab	Nan
merger	midnimo	None
meriam	cannon	Nan
merilis	sii	None
merkuri	meerkurida	Nan
merkurius	meerkurida	Nan
merokok	qiiqa	Nan
merosot	xumaaday	None
merpati	qoolley	Nan
merugikan	leh	None
merujuk	tixraac	None
merumuskan	qaabeynta	Nan
merusak	burburin	Nan
milisi	maleeshiyo	Nan
metoda	habka	None
metodemetode	hababka	None
migrasi	haajirida	Nan
mike	moo	Nan
mikro	micro	Nan
mikroba	microbes	Nan
mikrobiologi	microbiology	Nan
mikroorganisme	microorganisms	Nan
mikroprosesor	microprocessor	Nan
mikroskop	microscope	Nan
mikroskopik	microscopic	Nan
mil	mayl	None
milan	milan	Nan
milenium	sano	None
miliar	bilyan	Nan
milik	leh	None
miliki	leeyihiin	None
mie	doofaar	None
metode	habka	None
middle	dhexe	None
microscope	microscope	Nan
metodologi	habka	None
metro	metro	Nan
metropolitan	weyn	None
mewah	leh	None
mewajibkan	ah	None
mewakili	matalo	Nan
mewarisi	dhaxal	None
mewariskan	ah	None
mewujudkan	garasho	None
meyakini	aaminsan	None
meyakinkan	qancin	Nan
mh	mh	Nan
mhc	mhc	Nan
mi	mi	None
michael	michael	Nan
microsoft	microsoft	None
monograf	hal-abuur	Nan
monoksida	monoxide	Nan
monopoli	hal-adayg	Nan
mutu	tayo	None
muzik	muusig	None
my	aniga	None
myanmar	myanmar	Nan
myth	khuraafaad	Nan
münchen	munich	Nan
n	n	Nan
na	na	None
nabati	khudradda	Nan
nabi	nebi	None
nada	cod	None
nafsu	damac	None
naga	masduulaagii	Nan
nagarakretagama	nagarakretagama	Nan
nagari	nagari	Nan
mutlak	ahaanba	None
nagato	nagato	Nan
mutiara	luul	Nan
mutakhir	hadda	None
musica	musica	Nan
musik	muusig	None
musiknya	heesaha	None
musim	xilli	None
musiman	xilliyeed	Nan
musisi	muusikiiste	Nan
muslim	muslim	None
muslimin	muslim	None
musnah	burburay	None
mustafa	mustafa	None
mustahil	aheyn	None
musuh	cadowga	Nan
musuhnya	cadowgiisa	Nan
musyawarah	dood	None
mutagen	mutagen	Nan
mutasi	isbadal	None
music	heesaha	None
nahdlatul	nahdlatul	Nan
naiknya	kaca	None
narkotika	maandooriyaha	Nan
naruto	naruto	Nan
nasa	nasa	Nan
nasabah	macaamiisha	None
nasi	bariis	None
nasib	qaddar	Nan
nasihat	talo	None
nasional	qaran	None
nasionalis	wadani	None
nasionalisme	qaranimo	Nan
naskah	qoraalka	None
naskahnaskah	qoraal	None
nasution	sanka	None
nat	nat	Nan
natal	kirismas	Nan
narkoba	daroogada	Nan
naik	fuushan	Nan
narasi	sheeko	None
napoleon	napoleon	Nan
nakal	ah	None
nakula	nakul	Nan
nama	magac	None
namanama	magacaa	Nan
namanya	magaca	None
name	magac	None
namek	magac	None
namikaze	ragkaze	Nan
nampak	muuqan	Nan
nampaknya	u	None
namun	ha	None
nan	nan	Nan
nanti	dambe	None
nantinya	dambe	None
napas	neef	None
nara	nara	Nan
musibah	musiibo	Nan
musi	musi	Nan
mushaf	mushaf	Nan
moyang	awooweyaal	Nan
moza	moza	Nan
mozart	mozart	Nan
mozilla	mozilla	None
mpr	mpr	Nan
mprdpr	mprdpr	Nan
mprs	mprs	Nan
mpu	mpu	Nan
mr	mudane	None
mrna	mrna	Nan
ms	m	None
msdos	msdos	Nan
mtv	mtv	Nan
mu	aad	None
mual	lallabbo	Nan
movie	filimka	Nan
muara	estuary	Nan
motor	mooto	Nan
motivasi	dhiirigelin	None
monosakarida	monosaccharides	Nan
monoteisme	monotheism	Nan
monster	daanyeerka	Nan
monsun	monsoon	Nan
monta	monta	Nan
monumen	taallo	Nan
monyet	daanyeer	Nan
moon	dayaxa	None
moral	akhlaaqda	None
more	inbadan	None
morfem	morpheme	Nan
morfin	morphine	Nan
morfologi	cilmi	None
morgan	morgan	Nan
motif	ujeedo	Nan
motogp	motogp	Nan
muat	xero	None
muatan	eedaynta	Nan
muawiyah	muawiyah	Nan
muncullah	muuqday	None
munculnya	muuqaal	Nan
mundo	mundo	Nan
mundur	uga	None
mungkin	in	None
muntah	tuur	None
murah	ah	None
murid	arday	None
muridmurid	ardayda	None
muridmuridnya	ardayda	None
muridnya	ardaygiisa	Nan
murni	ah	None
musa	musa	Nan
musafir	socotada	None
museum	madxaf	Nan
muncul	muuqan	Nan
mulutnya	afkiisa	Nan
mulut	afka	None
multiplatinum	multiplatinum	Nan
muda	ah	None
mudah	fududaan	Nan
mudra	mudra	Nan
mufakat	ogolaansho	Nan
muhammad	muhammad	Nan
muhammadiyah	muxamediyah	Nan
muka	soco	None
merekrut	shaqaalaysiinta	Nan
mula	bilaw	Nan
mulamula	hore	None
mulanya	hore	None
mulia	leh	None
multi	badan	None
multikulturalisme	badan	None
multimedia	badan	None
multinasional	badan	None
mulai	bilow	None
merekam	duub	None
mereka	iyaga	None
merek	sumad	Nan
mengirimkan	dir	None
mengisahkan	sheeko	None
mengisi	buuxi	Nan
mengitari	hareeraha	None
mengizinkan	ogolaan	None
mengkaji	waxbarasho	None
mengklaim	sheegasho	Nan
mengklasifikasikan	saar	None
mengkritik	cambaareyn	Nan
mengobati	dawee	Nan
mengolah	habka	None
mengonsumsi	cunid	None
mengontrol	xakamayn	Nan
mengoperasikan	shaqee	Nan
mengorbankan	allabari	Nan
mengirim	dir	None
mengorbit	billoowga	Nan
mengira	ka	None
menginginkan	raba	None
menghormati	ixtiraam	Nan
menghubungkan	xir	None
menghuni	degid	Nan
mengidentifikasi	garto	None
mengidentifikasikan	cadee	Nan
mengijinkan	ogolaan	None
mengikat	ku	None
mengikuti	raac	Nan
mengimpor	soo	None
menginap	habeyn seexo	Nan
mengindikasikan	tilmaam	Nan
menginduksi	kadhig	Nan
menginfeksi	faafin	Nan
mengingat	xusaya	Nan
mengingatkan	xasuusin	Nan
menginvasi	duulaan	None
menghitung	xisaabiso	Nan
menguap	uumibixin	Nan
menguat	xooji	Nan
mengurusi	ilaali	None
mengusir	kaxeyn	Nan
mengusulkan	soo	None
mengusung	qaado	None
mengutamakan	siin	None
mengutip	xigasho	Nan
mengutus	ergo	None
menikah	guursaday	None
menikahi	guursaday	None
menikmati	raaxayso	Nan
menilai	heerka	None
menimbulkan	siin	None
menimpa	tirtirid	Nan
meninggal	dhintay	None
meninggalkan	bax	Nan
mengurus	ilaali	None
menguasai	xukumaa	Nan
mengurangi	yareyn	Nan
menguntungkan	leh	None
menguatkan	xoojin	Nan
mengubah	beddel	Nan
mengubahnya	beddelo	None
mengucapkan	dheh	None
menguji	tijaabin	Nan
mengukur	cabir	None
mengulang	celi	None
mengumpulkan	ururin	Nan
mengumumkan	ku	None
mengundang	casuumad	Nan
mengundurkan	noqo	None
mengungkap	qaawi	Nan
mengungkapkan	qaaday	None
mengungsi	daad	None
mengunjungi	booqasho	Nan
menguraikan	dhaaf	None
menghindari	ilaali	None
menghina	aflagaado	Nan
menghimpun	ururin	Nan
mengembang	faafin	Nan
mengembangkan	horumar	None
mengemukakan	hor	None
mengenai	saabsan	None
mengenakan	gasho	Nan
mengenal	ogaada	Nan
mengenali	aqoonsan	None
mengenalkan	baro	None
mengenang	xusaya	Nan
mengendalikan	xakamayn	Nan
mengendarai	fuushan	Nan
mengerahkan	dadaal	None
mengerikan	leh	None
mengerjakan	samee	Nan
mengerti	fahmay	None
mengemban	qaado	None
mengesahkan	ogolaansho	Nan
mengembalikan	celin	None
mengeluarkan	ah	None
mengarah	horseedaa	Nan
mengarahkan	toosinta	Nan
mengatakan	dhaho	None
mengatasi	xalin	None
mengatur	dhigay	None
mengawali	bilaw	Nan
mengawasi	daawashada	Nan
mengecil	dhacaan	None
mengedari	wareejin	None
mengejar	eryana	Nan
mengejutkan	leh	None
mengekspresikan	muuji	Nan
mengelilingi	wareegsan	None
mengelola	maamul	None
mengelompokkan	kooxaynta	Nan
mengeluh	cabasho	Nan
mengesankan	ah	None
mengetahui	ogaansho	Nan
mengevaluasi	qiimee	Nan
menghancurkan	burburin	Nan
menghantarkan	gaarsiin	Nan
menghapus	saar	None
menghapuskan	tirtirid	Nan
mengharapkan	filasho	Nan
menghargai	qadarin	Nan
mengharuskan	baahan	None
menghasilkan	saar	None
menghemat	badbaadin	Nan
menghendaki	doonaa	None
menghentikan	jooji	Nan
menghibur	madadaalo	Nan
menghidupkan	shid	Nan
menghilang	baaba&#39;aan	Nan
menghilangkan	ka	None
menghambat	xayiraad	Nan
menghalangi	gala	None
menghadiri	ka	None
menghadapi	ilaa	None
menggabungkan	daro	None
menggali	qodo	Nan
menggambar	sawir	None
menggambarkan	tusaalayn	Nan
mengganggu	khalkhal	Nan
mengganti	beddelo	None
menggantikan	beddelo	None
meninggalnya	dhimashadiisa	Nan
menggelar	duub	None
menggigit	qaniinyo	Nan
menggiring	horseed	None
menggunakan	isticmaal	None
menggunakannya	adeegso	Nan
menghabisi	dhammee	Nan
menghabiskan	kharash garee	Nan
menghadap	saaray	None
menggerakkan	dhaqaaq	None
menganut	u	None
meningkat	kordhay	Nan
meningkatnya	kordhaya	Nan
menyembuhkan	daawo	None
menyembunyikan	qari	Nan
menyempurnakan	ah	None
menyenangkan	badan	None
menyentuh	taabasho	Nan
menyerah	dhiib	None
menyerahkan	wareejin	None
menyerang	weerar	None
menyerangnya	isaga	None
menyerap	nuugid	Nan
menyertai	socda	None
menyertakan	xirid	Nan
menyerukan	yeedhay	None
menyerupai	eg	None
menyesuaikan	hagaajin	Nan
menyembah	cibaadada	None
menyetujui	ansixinta	Nan
menyeluruh	dhammaystiran	Nan
menyelesaikan	dhameystiran	Nan
menyarankan	talin	None
menyatakan	sheegay	None
menyatu	biiro	None
menyatukan	midayn	Nan
menyebabkan	sabab	None
menyebabkannya	u	None
menyebar	faafitaan	Nan
menyebarkan	faafitaan	Nan
menyebut	wacid	Nan
menyebutkan	xuso	None
menyebutnya	u	None
menyediakan	siin	None
menyegel	shaabad	Nan
menyelamatkan	badbaadin	Nan
menyelenggarakan	abaabul	None
menyelidiki	baaris	None
menyanyikan	heesaa	None
menyiapkan	dhigay	None
menyimpan	badbaadin	Nan
merambat	faafin	Nan
merancang	naqshadeynta	Nan
merangsang	kicin	Nan
merantau	wareega	None
meranti	meranti	Nan
merapi	merapi	Nan
merasa	dareento	Nan
merasakan	dareento	Nan
merata	ah	None
merawat	ilaali	None
merayakan	dabaaldeg	Nan
merdeka	banaan	None
merebak	faafin	Nan
merebut	qabasho	Nan
meredam	xabbad	Nan
merambah	galay	None
menyiarkan	baahin	Nan
meramalkan	saadaaliyay	Nan
meraih	gaadho	None
menyimpulkan	gabagabayn	Nan
menyinggung	gef	Nan
menyingkirkan	ka	None
menyisakan	bixitaanka	Nan
menyokong	taageero	None
menyukai	jecel	None
menyulitkan	adkayn	Nan
menyumbang	tabaruc	Nan
menyumbangkan	tabaruc	Nan
menyuruh	amray	None
menyusul	soco	None
menyusun	diyaarin	Nan
menyusut	ruxid	Nan
meragukan	gelin	None
merah	casaan	Nan
merak	digaag	Nan
menyanyi	heesaa	None
menyangkut	leedahay	None
menyampaikan	gaarsiin	Nan
menjelajahi	sahamin	Nan
menjelang	soo	None
menjelaskan	sharrax	Nan
menjemput	qaado	None
menjual	iibin	None
menjuarai	guuleysto	None
menjumpai	soo	None
menjunjung	taageer	Nan
menko	wasiirka	None
menolak	diido	None
menolong	i	None
menonjol	istaag	Nan
menonjolkan	xoojin	Nan
menonton	daawasho	Nan
menopang	fidin	None
menjawab	jawaabo	None
menopause	caadada	Nan
menjauhi	joog	None
menjatuhkan	daadasho	Nan
menipu	nacas	None
meniru	ku	None
menit	daqiiqad	Nan
menjabat	u	None
menjadi	noqo	None
menjadikan	samee	Nan
menjadikannya	samee	Nan
menjaga	hayn	None
menjahit	tolidda	Nan
menjalani	socda	None
menjalankan	orod	None
menjalin	xarig	Nan
menjamin	hubiyo	Nan
menjangkau	gaadho	None
menjanjikan	qaad	None
menjauh	joog	None
menstruasi	caadada	Nan
mentah	cayriin	Nan
mental	ahaan	None
menurut	xigtay	None
menurutnya	sheegay	None
menutup	xir	None
menutupi	dabool	Nan
menuturkan	yidhi	None
menyadari	ka	None
menyaingi	xafiiltan	Nan
menyajikan	xaadir	Nan
menyaksikan	daawaday	Nan
menyala	iftiin	Nan
menyalakan	shid	Nan
menyalin	nuqul	Nan
menyalurkan	kanaal	None
menyamar	isbadal	None
menyambut	soo	None
menurunnya	dhaca	None
menurunkan	keena	None
menurun	dhacay	None
menuntut	dacweyn	Nan
mentawai	mentawai	Nan
menteng	menteng	Nan
menteri	wasiir	None
menterimenteri	wasiir	None
menu	menu	Nan
menuai	goosashada	Nan
menuju	ahaa	None
meningkatkan	casriyeyn	Nan
menular	badan	None
menuliskan	qor	Nan
menumbuhkan	koraan	Nan
menunggu	sugaya	Nan
menunjang	taageero	None
menunjuk	tilmaamay	None
menunjukan	muujinaya	None
menunjukkan	u	None
menulis	qor	Nan
planet	meeraha	Nan
planetplanet	meeraha	Nan
plantae	qorsheeyaha	Nan
tembak	toogasho	None
tembakan	toogasho	None
tembakau	tubaakada	Nan
tembok	darbiga	None
tembolok	khasnad	Nan
tempat	meesha	None
tempatnya	meesha	None
tempattempat	meelaha	None
tempe	heerkul	Nan
temperatur	heerkulka	Nan
tempo	ah	None
tempoyak	igbayak	Nan
tempur	la	None
temuan	natiijooyinka	Nan
temurun	dhaxalka	None
tembaga	naxaas	Nan
ten	toban	None
tematema	dulucda	None
temantemannya	asxaabtiisa	None
telekomunikasi	isgaarsiinta	None
telepon	taleefanka	Nan
teleskop	telescope	Nan
televisi	telefishan	Nan
telinga	dhegta	Nan
teliti	dhammaystiran	Nan
telkom	telkom	Nan
telpon	taleefanka	Nan
teluk	bay	None
telur	ukun	Nan
telurnya	ukunta	Nan
tema	mawduuc	Nan
teman	saaxiib	None
temannya	saaxiibkeed	Nan
temanteman	asxaabta	Nan
temari	temari	Nan
telapak	timirta	None
tenaga	awood	None
tendangan	laad	Nan
teori	aragti	None
teorinya	aragtida	None
teoriteori	aragti	None
teoritis	ahaan	None
tepat	sax	None
tepatnya	ah	None
tepi	geeska	None
tepian	jihooyinka	Nan
tepung	bur	None
terakhir	ugu	None
terakhirnya	dambeeya	None
terancam	hanjabay	Nan
terang	iftiin	Nan
terangterangan	aflagaado	Nan
terapan	codsatay	Nan
teoretis	ahaan	None
tenang	xasilloon	Nan
teorema	aragti	None
tenun	saqafka	Nan
tengah	dhexda	None
tengahan	dhexe	None
tengahnya	dhexda	None
tengahtengah	dhexda	None
tenggara	koonfur-bari	Nan
tenggelam	u	None
tengger	tengger	Nan
tenggorokan	cunaha	Nan
tengkorak	qalfoofka	Nan
tenis	tennis	Nan
tentang	saabsan	None
tentara	ciidan	None
tentaranya	ciidanka	None
tentu	dabcan	Nan
tentunya	dabcan	Nan
teologi	fiqiga	None
terapi	daaweynta	Nan
telanjang	qaawan	Nan
telaga	haro	Nan
tape	sharooto	Nan
tapi	laakiin	None
tapis	s	None
taraf	heer	None
tarakan	tarakan	Nan
target	bartilmaameed	Nan
tari	dhaanto	None
tarian	dhaanto	None
tarif	sicirka	Nan
tarik	jiid	Nan
tarikan	jiid	Nan
tarikh	taariikhda	None
taruhan	sharad	Nan
tarumanagara	tarumanagara	Nan
tarumanegara	dalka	None
tapanuli	tapanuli	Nan
tarusbawa	tarusbawa	Nan
tapak	raad-raac	Nan
tanzania	tanzania	Nan
tangerang	tangerang	Nan
tangga	jaranjarada	Nan
tanggal	taariikhda	None
tanggapan	jawaab	Nan
tanggul	dirqin	Nan
tanggung	adkeysi	Nan
tangkai	caws	None
tangkap	qabasho	Nan
tangkis	tiriyey	None
tangkuban	tangkuban	Nan
tani	beeraley	Nan
tanjung	cape	None
tanjungpinang	tanjung pinang	Nan
tanpa	la’aan	Nan
tantangan	loolan	Nan
tap	tuubada	Nan
telah	lahaa	None
tas	boorso	Nan
tasya	tasya	Nan
tegal	tegal	Nan
tegangan	kuleylka	Nan
tegas	caddeyn	Nan
teguh	adag	None
teh	shaah	None
tehnik	farsamada	None
tekad	qaadashada	None
tekanan	cadaadis	None
teknik	farsamada	None
teknikteknik	farsamada	None
teknis	farsamo	None
teknologi	tikniyoolajiyadda	Nan
teks	qoraal	None
tekstil	dharka	None
tektonik	tectonic	Nan
tegak	toosan	None
tasikmalaya	tasikmalaya	Nan
technology	tikniyoolajiyadda	Nan
tebing	dhagaxyada	Nan
tata	nidaam	None
tatabahasa	naxwaha	None
tatanan	amar	None
tau	ogaada	Nan
tawanan	maxbuus	Nan
tawar	dhadhan la&#39;aan	Nan
tawaran	dalabka	Nan
tayang	hawada	None
taylor	taylor	Nan
tbk	tbk	Nan
tcpip	tcpip	Nan
team	koox	None
teater	tiyaatar	Nan
tebakan	qiyaase	Nan
tebal	weyn	None
tebu	bakoorad	Nan
teras	terrace	Nan
terasa	dareemaa	Nan
teratai	bakhtiyaa	Nan
terlatih	tababaran	None
terlebih	sidaas	None
terlengkap	ugu	None
terlepas	loo	None
terletak	yaal	None
terlibat	leh	None
terlihat	arkay	None
terlindungi	ilaaliyo	None
terluar	baxsan	None
terluas	ballaaran	None
terluka	dhaawacmay	None
termal	kuleyl	Nan
termasuk	yihiin	None
terminal	garoonka	None
terminologi	ereybixin	Nan
terlarut	diri	None
termionik	heerkulbeegga	Nan
terlarang	reebay	None
terlalu	kale	None
terkait	xiriira	None
terkalahkan	karin	None
terkandung	jira	None
terkecil	yar	None
terkejut	yaab	None
terkemuka	hogaaminaya	None
terkena	u	None
terkenal	ah	None
terkendali	haya	None
terkesan	soo	None
terkini	hadda	None
terkonsentrasi	saaray	None
terkontrol	la	None
terkuat	badan	None
terkumpul	ururiyey	Nan
terlambat	daahay	None
terkadang	qaar	None
termodinamika	heerkulbeegga	Nan
termosfer	cimilada	None
terpenting	muhiimsan	None
terperangkap	ku	None
terperinci	faahfaahsan	None
terpilih	la	None
terpimpin	hagay	Nan
terpisah	ah	None
terpisahkan	isku	None
terpusat	xudun	Nan
terputus	go’ay	Nan
tersambung	iskuxiran	Nan
tersangka	tuhunsan	Nan
tersebar	faafitaan	Nan
tersebut	ah	None
tersedia	karo	None
tersedianya	helitaan	Nan
terpengaruh	la	None
termometer	heer-kul	Nan
terpencil	go&#39;doon	Nan
terpantau	socdo	None
termuda	yaraa	None
ternak	xoolaha	None
ternama	ah	None
ternate	ternate	Nan
ternyata	cad	None
teroksidasi	oxidized	Nan
teror	argagax	Nan
terorganisasi	abaabulan	Nan
teroris	argagixiso	Nan
terorisme	argagixiso	Nan
terowongan	tuneel	Nan
terpadat	badan	None
terpadu	isku	None
terpaksa	qasbay	None
terpanjang	dheer	None
terpecah	kala	None
terjun	boobid	Nan
terjual	iibiyay	Nan
terjemahan	tarjun	Nan
terbit	la	None
terbitan	arrin	None
terbuat	sameeyay	None
terbuka	fur	Nan
terbukti	cadeeyay	None
terbunuh	dilay	None
terburuk	xumaa	None
tercampur	isku	None
tercantum	ku	None
tercapai	gaadhay	None
tercatat	duubay	None
tercemar	go&#39;ay	Nan
tercepat	soonka	None
tercermin	muujiyey	None
tercipta	abuuray	None
terbiasa	barto	None
terciptanya	abuurista	Nan
terbesar	weyn	None
terbentuklah	sameeyo	None
teratas	kor	None
teratur	ah	None
terbagi	qaybsan	Nan
terbaik	fiican	None
terbakar	dab	None
terbalik	kaca	None
terbang	aad	None
terbanyak	badan	None
terbaru	dambeeyay	None
terbatas	xaddidan	Nan
terbawa	kaxaystay	None
terbebas	ah	None
terbenam	u	None
terbentang	furma	Nan
terbentuk	sameeyay	None
terbentuknya	sameynta	Nan
terdaftar	diiwaangashan	Nan
terdahulu	hortiis	Nan
terdapat	jira	None
terima	aqbal	Nan
terinfeksi	qaadey	None
terinspirasi	loo	None
terintegrasi	isku	None
teripang	badda	None
terisi	buuxsamay	Nan
terisolasi	go&#39;doon	Nan
teritori	dhul	None
teritorial	dhuleed	None
terjadi	dhici	None
terjadilah	dhacay	None
terjadinya	dhacdo	None
terjangkau	karo	None
terjauh	fog	None
terjebak	dhegan	None
terikat	xidhxidhan	Nan
terhubung	ku	None
terhingga	kooban	None
terhenti	istaagay	None
terdekat	dhow	None
terdengar	cod	None
terdesak	cadaadis	None
terdiri	yahay	None
terduga	filayay	Nan
terelakkan	ah	None
terencana	qorsheeyay	Nan
tangannya	gacantiisa	None
terendah	hooseeya	None
terfavorit	jecel	None
tergabung	daray	None
terganggu	wareersan	Nan
tergantung	waxay	None
tergolong	saaray	None
terhadap	ku	None
terhambat	curyaamiyay	Nan
terengganu	terengganu	Nan
tangan	gacanta	None
tanduk	gees	None
tandatanda	calaamadaha	Nan
suara	cod	None
suaranya	codkiisa	Nan
suasana	jawi	None
suatu	wax	None
sub	sub	Nan
subadra	subhadra	Nan
subang	gorgor	None
subbagian	hoosaad	None
subduksi	hoosaadka	Nan
subinterval	hoosaadka	Nan
subjek	maaddada	Nan
subjektif	mawduuc	Nan
subkultur	hoosaad	None
subnet	subnet	Nan
subsahara	subsahara	Nan
suaminya	ninkeeda	Nan
subsidi	kabid	Nan
suami	nin	None
stupa	nacasnimo	Nan
stratifikasi	qalafsanaanta	Nan
stratosfer	stratosphere	Nan
street	wadada	None
stres	badan	None
stress	badan	None
stroke	istaroog	Nan
stroma	stroma	Nan
struktur	qaab	None
struktural	ah	None
strukturnya	qaabkeeda	Nan
studi	waxbarasho	None
studies	waxbarasho	None
studinya	daraasaddiisa	Nan
studio	istuudiyaha	Nan
study	waxbarasho	None
suaka	magangalyo	Nan
strategis	istiraatiijiyadeed	Nan
subspesies	ciriiriyo	Nan
substitusi	beddelasho	Nan
suka	yahay	None
sukabumi	sukabumi	Nan
sukar	adag	None
sukarela	tabaruc	Nan
sukarno	adag	None
sukses	guul	None
suksesi	isku	None
suku	qabiil	None
sukusuku	qabiilkeyga	Nan
sulaiman	sulaymaan	Nan
sulawesi	sulawesi	Nan
sulfat	baaruud	Nan
sulfur	baaruud	Nan
suling	duulaan	None
sulit	adag	None
suiton	suun	Nan
substansi	walax	Nan
suite	suite	Nan
suhunya	heerkulka	Nan
substrat	beddelo	None
subtipe	hoosaad	None
subtropis	hoosaad	None
subur	ah	None
subyek	mawduuc	Nan
subyektif	mawduuc	Nan
suci	qoduus	Nan
sudah	durba	None
sudan	sudan	None
sudirman	sudirman	Nan
sudut	geeska	None
sufi	amarka suufiyada	Nan
sufyan	sufyan	Nan
suharto	suharto	Nan
suhu	heerkulka	Nan
suigetsu	suigetsu	Nan
strategi	istiraatiijiyad	Nan
strata	heer	None
story	sheeko	None
spekulasi	mala-awaal	Nan
sperma	shahwada	Nan
spesial	ah	None
spesialis	takhasusle	Nan
spesialisasi	takhasuska	Nan
spesiasi	takhasus	Nan
spesies	noocyada	None
spesiesspesies	noocyada	None
spesifik	ah	None
spesifikasi	faahfaahinta	Nan
spesimen	muunad	Nan
spin	wareejin	None
spiral	wareegsan	None
spiritual	ruux	None
spons	isbuunyo	Nan
spektrum	muuqaal	Nan
sponsor	kafaalasho	Nan
speed	xawaare	Nan
special	ah	None
sosialisme	hantiwadaag	Nan
sosialnya	ahaan	None
sosiologi	bulshada	None
sosiologis	bulshada	None
sosok	jaantus	Nan
soto	soto	Nan
soundtrack	codka	None
south	koonfur	None
southeast	koonfur-bari	Nan
southern	koonfurta	None
soviet	soofiyeeti	Nan
spa	dalxiis	None
space	booska	Nan
spacetoon	spacetoon	Nan
spanyol	isbaanish	Nan
species	noocyada	None
spontan	ah	None
spora	spores	Nan
sql	sql	Nan
start	bilow	None
stasiun	saldhigga	None
stateful	dowladnimo	Nan
station	saldhigga	None
statis	taagan	None
statistik	tirakoobka	Nan
statistika	tirakoobka	Nan
status	xaalad	Nan
statusnya	xaaladdeeda	Nan
stephen	gabadh	None
steve	steve	Nan
stie	tuug	None
stigma	dhaleeceyn	Nan
stkip	boodboodid	Nan
stmik	stmik	Nan
stapala	stapala	Nan
stanford	stanford	Nan
standardisasi	habaynta	Nan
standard	heerka	None
square	labajibaaran	Nan
sri	sri	None
sriwijaya	sriwijaya	Nan
ss	ss	Nan
st	st	None
stabil	deggan	None
stabilisasi	xasilloonida	Nan
sultan	suldaan	None
stabilitas	xasiloonida	None
stadium	garoon	None
staf	shaqaalaha	None
stain	wasakh	Nan
stambul	stambul	Nan
stamford	stamford	Nan
stan	teendho	Nan
standar	heerka	None
stadion	garoomada	None
tersegel	shaabadaysan	Nan
sumatera	sumatra	Nan
sumbangan	deeq	None
tabrakan	shil	None
tabu	taboo	Nan
tabung	tuubbo	Nan
tabungan	kaydinta	Nan
tadi	hadda	None
tadinya	ahaa	None
tafsir	tarjumaad	Nan
tahan	xaji	None
tahanan	maxbuus	Nan
tahap	tallaabo	Nan
tahapan	marxaladaha	Nan
tahapantahapan	masraxa	None
tahta	carshiga	Nan
tahu	tofu	Nan
tahun	sanadka	None
tabloid	tabloid	Nan
tahunan	ah	None
tablet	kiniin	Nan
tabanan	tabanan	Nan
syaratsyarat	shuruud	Nan
syariah	shareecada	None
syariat	shareecada	None
syarif	sharif	None
sydney	sydney	Nan
syeikh	sheekh	None
syekh	sheekh	None
syiah	shia	Nan
syok	naxdin	Nan
syria	shareecada	None
systems	nidaamyada	Nan
t	t	None
ta	ta	None
taala	tan	None
taat	addeecid	Nan
tabel	miis	Nan
syarat	xaalad	Nan
tahunnya	sanadka	None
taijutsu	taijutsu	Nan
tameng	gaashaan	None
tamil	taamil	Nan
tampak	fiiriyey	Nan
tampaknya	u	None
tampan	badan	None
tampil	muuqan	Nan
tampilan	bandhig	Nan
tamu	marti	None
tan	tan	None
tana	tana	Nan
tanah	ciid	None
tanahnya	dhulka	None
tanam	beero	None
tanaman	dhirta	None
tanda	saxeex	Nan
tambo	tambo	Nan
tahuntahun	sano	None
tambang	leh	None
tambahan	ah	None
taiwan	taiwan	Nan
tajam	fiiqan	Nan
tak	aha	None
takami	takami	Nan
takdir	aayaha	Nan
takhta	carshiga	Nan
taklukan	adkaaday	None
taksi	tagsi	Nan
taksonomi	cashuurta	Nan
taktik	xeelad	Nan
takus	takus	Nan
takut	cabsi	None
tali	xarig	Nan
talib	talib	Nan
taman	beerta	None
tambak	balli	Nan
syaraf	dareemayaasha	Nan
syara	syara	Nan
syair	gabay	None
sungai	wabiga	None
sungaisungai	wabiga	None
sungguh	runtii	None
sungguhsungguh	ahaantii	None
sungkar	jab	None
sunnah	sunna	Nan
sunni	sunni	None
sunter	qoraxda	None
suntik	mudis	Nan
suntikan	mudis	Nan
sunting	tafatir	Nan
supaya	darteed	None
super	super	None
supernatural	ka	None
supernova	supernova	Nan
suneo	suneo	Nan
supersemar	sare	None
sundagaluh	sundagaluh	Nan
sunan	magac	None
sumbawa	sumbawa	Nan
sumber	isha	None
sumberdaya	kheyraadka	None
sumbernya	isha	None
sumbersumber	ilo	None
sumbi	xuub	Nan
sumbu	dhidibka	Nan
sumedang	sumedang	Nan
sumenep	ciriiri	None
sumpah	dhaar	None
sumsum	dhuuxa	Nan
sumur	fiican	None
sun	qorrax	Nan
suna	suna	None
sunah	sunna	Nan
sunda	sunda	Nan
suplai	sahayda	Nan
support	taageero	None
surabaya	surabaya	Nan
sutomo	sutomo	Nan
sutra	xariir	None
sutradara	agaasime	None
suzuna	suzuna	Nan
swami	swami	Nan
swasta	gaar	None
swedia	sweden	None
swimming	dabaasha	Nan
swiss	swiss	Nan
switch	wareejinta	Nan
syafii	shaafici	None
syah	shah	Nan
syahadat	caqiido	Nan
syahrir	syahrir	Nan
syaikh	shaykh	Nan
sutera	xariir	None
sutan	sutan	Nan
susunan	abaabul	None
susu	caano	None
surakarta	surakarta	Nan
surat	warqad	None
suratsurat	warqad	None
surawisesa	surawisesa	Nan
surel	emayl	Nan
surga	jannada	None
suriah	shareecada	None
sumatra	sumatra	Nan
suriname	suriname	Nan
survei	sahamin	Nan
survey	sahamin	Nan
surya	qorrax	Nan
susah	adag	None
susanoo	susanoo	Nan
susilo	susilo	Nan
suspensi	joojin	Nan
surut	noqo	None
sosialisasi	bulshada	None
tersembunyi	qarsoon	None
tersier	jaamacadda	None
vietnam	fiyatnaamiis	Nan
view	arag	None
vihara	keniisad	Nan
vii	vii	Nan
viii	viii	Nan
vinci	vinci	Nan
violin	violin	Nan
viral	viral	Nan
virtual	dalxiis	None
virus	fayruus	Nan
visi	aragti	None
vista	fiisooyinka	Nan
visual	ah	None
vital	ah	None
vitamin	fitamiin	Nan
video	fiidiyowga	Nan
vitro	vitro	Nan
via	marayo	None
vga	vga	Nan
vatikan	vatican	Nan
vba	vba	Nan
vegetasi	doogga	Nan
vektor	vector	Nan
venezuela	venezuela	None
venus	venus	Nan
vereeniging	kormeerid	Nan
versi	nooca	None
versiversi	hor	None
versus	hor	None
vertebrata	ah	None
vertikal	toosan	None
vesikel	vesicles	Nan
vestimentum	dharka	None
veteran	halyeey	None
vi	vi	Nan
varietas	noocyo	Nan
voc	voc	Nan
vokal	cod	None
wahyu	muujinta	Nan
wajah	waji	None
wajahnya	wajigiisa	Nan
wajar	ah	None
wajib	yahay	None
wajik	dheeman	Nan
wajo	wow	None
wakil	xigeen	None
wakilwakil	wakiilka	None
waktu	waqti	None
waktunya	talagalay	None
walau	kastoo	None
walaupun	oo	None
wales	wales	Nan
wali	ilaaliyaha	None
wahid	topnotch	Nan
voice	cod	None
wahana	gaari	None
wafat	dhintay	None
vokalis	cod	None
vol	vol	None
voldemort	voldemort	Nan
voli	kubbadda laliska	Nan
volksraad	volksraad	Nan
volume	mugga	None
von	von	Nan
voyager	socdaal	None
vs	vs	Nan
vulkanik	foolxanuun	Nan
w	w	None
wabah	daacuunka	Nan
wacana	hadal	None
wadah	weel	None
waduk	biyo	None
wafatnya	dhimashadiisa	Nan
walikota	magaalada	None
variasi	kala	None
variabel	is	None
uraian	sharraxaad	Nan
uranian	uranian	Nan
uranium	uranium	Nan
uranus	uranus	Nan
urat	xididka	Nan
urin	kaadida	Nan
url	url	Nan
uruguay	urruce	Nan
ururu	ururu	Nan
urusan	arrimaha	None
urut	isku	None
urutan	amar	None
us	anaga	Nan
us$	$	None
usa	usa	None
urahara	urahara	Nan
usaha	dadaal	None
upeti	cashuur	Nan
upayaupaya	dadaal	None
universe	caalamka	None
universitas	jaamacad	None
university	jaamacad	None
unix	halbeeg	Nan
unjuk	muuji	Nan
unsur	element	Nan
unsurunsur	ka	None
untuk	ee	None
untukmu	adiga	None
untung	faa&#39;iido	Nan
untungnya	wanaag	None
unus	ahayn	None
upacara	xaflad	Nan
upah	mushahar	Nan
upaya	dadaal	None
update	cusboonaysiin	Nan
varian	duwan	None
usahanya	dadaalkiisa	Nan
user	adeegsade	Nan
utusan	farriin	Nan
uu	uu	None
uud	uud	Nan
uut	uut	Nan
uzumaki	uzumaki	Nan
v	v	None
vagina	siilka	Nan
vaksin	tallaal	Nan
vaksinasi	tallaal	Nan
vakum	madhan	Nan
vakuola	madhan	Nan
valensi	naxariis	None
valentine	jacayl	None
vampir	vampire	Nan
van	baabuur	None
utuh	isku	None
usahausaha	ganacsiga	None
utsman	utsman	Nan
utilitas	utility	Nan
usia	da	None
usianya	da&#39;deeda	Nan
uskup	hoggaamiyaha kiniisaddu	Nan
usul	soo	None
usulan	soo	None
usus	xiidmaha	Nan
ut	ut	Nan
utama	weyn	None
utamanya	weyn	None
utan	utan	Nan
utang	deyn	Nan
utara	waqooyiga	None
utas	dunta	Nan
uteri	uteri	Nan
uterus	ilmo	None
utomo	utomo	Nan
walisongo	wali	None
walk	soco	None
wall	darbiga	None
yaman	yaman	None
yamato	yamato	Nan
yamin	yamin	Nan
yang	taasi	None
yani	yani	Nan
yanti	yanti	Nan
yatim	agoon	None
yayasan	aasaaska	None
yazid	yaziid	Nan
year	sanadka	None
yerusalem	yeruusaalem	Nan
yesus	ciise	None
yg	yang	Nan
yogyakarta	yogyakarta	Nan
yohanes	yooxanaa	Nan
yamaha	yamaha	Nan
yondaime	yondaime	Nan
yakni	waa	None
yaitu	waa	None
x	x	None
xaverius	xaverius	Nan
xi	xi	Nan
xml	xml	Nan
xp	xp	Nan
xvi	xvi	Nan
xx	xx	Nan
xxi	xxi	Nan
y	y	None
ya	haa	None
yagami	yagami	Nan
yahoo	yahoo	Nan
yahudi	ah	None
yahweh	yahweh	Nan
yahya	haa	None
yakin	hubaal	None
www	www	Nan
yordania	urdun	None
yoruichi	yoruichi	Nan
ziarah	xajka	None
zimbabwe	zimbabwe	Nan
zodiak	zodiac	Nan
zona	aagga	None
zone	aag	Nan
zoologi	cilmiga	None
zuckerberg	zuckerberg	Nan
zurnali	zurnali	Nan
k	k	None
km	km	None
°c	c	None
km	km	None
±	±	Nan
×	×	Nan
ƒ	ƒ	Nan
zeus	zeus	Nan
york	york	None
zetsu	zetsu	Nan
zatzat	walax	Nan
you	adiga	None
youtube	youtube	Nan
yudhoyono	yudhoyono	Nan
yudistira	yudistira	Nan
yugoslavia	yugoslavia	Nan
yunani	giriigga	None
yupiter	jupiter	Nan
yusuf	yusuf	None
yuzu	yuzu	Nan
z	z	Nan
zainal	zainal	Nan
zakat	zakada	Nan
zaman	erayada	None
zambia	zambiya	Nan
zat	walax	Nan
zea	xamaasad	Nan
wuruk	wuruk	Nan
wujudnya	qaabkiisa	Nan
wujud	foom	Nan
wasit	garsoore	None
wat	wat	Nan
watson	watson	Nan
wawancara	wareysiga	Nan
wawasan	fahanka	Nan
way	dariiqa	Nan
wayang	puppet	Nan
wealth	hanti	None
weasley	weasley	Nan
weber	weber	Nan
website	websaydhka	Nan
weda	weda	Nan
wedang	wedang	Nan
weekly	toddobaadle	Nan
wereng	geedka	None
washington	dhar	None
west	galbeed	None
was	ahaa	None
waru	waru	Nan
wallace	wallace	Nan
wallacea	wallacea	Nan
walter	walter	Nan
wan	wan	None
wangsa	guri	None
wangsakerta	wareysii	Nan
wanita	naag	None
war	dagaal	None
warga	muwaadiniinta	None
warisan	dhaxalka	None
warna	midab	None
warnanya	midabka	None
warnawarna	multicolour	Nan
warok	warok	Nan
wartawan	wariye	None
warung	dukaan	None
western	galbeed	None
wewenang	amar	None
wewenangnya	awooddiisa	Nan
winkler	baalal	Nan
wirabhumi	wirabhumi	Nan
wiracarita	xudunta xudunta	Nan
wiranto	wiranto	Nan
wisata	safar	None
wisatawan	socotada	None
wishnu	vishnu	Nan
wisnu	vishnu	Nan
with	leh	None
wong	wow	None
works	shaqeeya	None
world	adduunka	None
worlds	adduunyada	None
wright	caqli	None
writer	qoraa	None
windows	daaqadaha	None
window	daaqad	None
wina	marwo	None
wimax	wimax	Nan
what	maxay	None
which	taas	None
who	aduunka	None
widya	widya	Nan
wifi	wifi	Nan
wijaya	wijaya	Nan
wiki	wiki	None
universal	ah	None
wikimedia	wikimedia	Nan
wikramawardhana	wikramawardhana	Nan
wilayah	gobolka	None
wilayahnya	dhulkeeda	None
wilayahwilayah	gobollada	None
wilhelm	wilhelm	Nan
william	william	Nan
wilson	wilson	Nan
wikipedia	wikipedia	None
unitunit	cutub	None
united	united	None
unit	cutubka	Nan
tiongkok	shiinaha	None
tipe	nooca	None
tipis	dhuuban	Nan
tips	talooyin	Nan
tipuan	khiyaano	Nan
tiri	adeer	None
tiro	tiro	None
tiruan	ku	None
titan	titan	Nan
titanic	titanic	Nan
titik	barta	None
titiktitik	dhibco	Nan
tjipto	tjipto	Nan
tjokroaminoto	tjokroaminoto	Nan
tk	tk	Nan
tionghoa	shiine	Nan
tni	tni	Nan
tinju	feerka	Nan
tingkat	heer	None
timbulnya	soo	None
times	jeer	None
timnas	qaranka	None
timor	bari	None
timorleste	timor leste	Nan
timtim	timtim	Nan
timur	bari	None
tindak	fal	None
tindakan	ficil	None
tindakantindakan	ficil	None
tindih	kormeer	Nan
tinggal	toos	None
tinggi	sare	None
tingginya	dhererkeeda	Nan
tingkah	fal	None
tingkatan	tiers	Nan
timbul	kac	Nan
toba	toba	Nan
tokek	gecko	Nan
topi	koofiyad	Nan
topik	mawduucyada	Nan
topografi	topography	Nan
topologi	topology	Nan
toraja	toraja	Nan
total	wadarta	None
tour	safar	None
tousen	tousen	Nan
tower	munaarad	Nan
town	magaalada	None
trade	ganacsiga	None
tradisi	dhaqan	None
tradisional	ahaan	None
tragedi	musiibo	Nan
trans	trans	Nan
topeng	maaskaro	Nan
tobi	tobi	Nan
top	kor	None
tonjolan	bulug	Nan
toko	dukaan	None
tokoh	jaantus	Nan
tokohtokoh	tirooyinka	Nan
tokotoko	cuntada	None
tokyo	tokyo	Nan
tol	lacag	None
tolak	dhac	None
toleransi	dulqaad	None
tom	tom	Nan
tomat	yaanyo	Nan
tombak	waran	None
tombol	badhanka	Nan
tongkat	ul	None
tongkol	cob	Nan
tongkonan	tongkonan	Nan
tony	toy	Nan
timbal	horseed	None
timah	horseed	None
timaeus	timaeus	Nan
terusan	kanaalka	None
terusmenerus	qaaradaha	None
terutama	ahaan	None
terutamanya	ahaan	None
terwujud	qalabaysan	Nan
tes	tijaabin	Nan
test	tijaabin	Nan
tetangga	deriska	None
tetangganya	deriskeeda	Nan
tetap	ah	None
tetapi	laakiin	None
tetesan	dhibco	Nan
tetua	odayaasha	None
teuku	teuku	Nan
teungku	teungku	Nan
terus	sii	None
tewas	dilay	None
terurai	furfurnaansho	Nan
tertutup	xidhan	Nan
tersimpan	kaydiyay	Nan
tersisa	haray	None
tersukses	badan	None
tersusun	abaabulay	None
tertanam	xirxiray	Nan
tertanggal	taariikhdeeyay	Nan
tertangkap	qabtay	None
tertarik	xiiseynaya	Nan
tertawa	qosol	None
tertentu	ah	None
tertib	nidaamsan	Nan
tertinggal	tagay	None
tertinggi	sareeya	None
tertua	weyn	None
tertulis	qoran	None
terungkap	qaaday	None
texas	texas	Nan
text	qoraal	None
thai	thai	Nan
tibatiba	ah	None
tibet	tibet	Nan
tidak	aha	None
tidaklah	ahan	None
tidaknya	ama	None
tidore	tidore	Nan
tidur	seexo	Nan
tien	tien	Nan
tifa	tifa	Nan
tiga	saddex	None
tigris	tigris	Nan
tikus	jiirka	Nan
tilakoid	thylakooid	Nan
tilu	tilu	Nan
tim	koox	None
tiba	yimid	None
tiaptiap	kasta	None
tiap	kasta	None
tiang	cirif	Nan
thailand	thailand	Nan
thalib	talib	Nan
thamrin	thamrin	Nan
the	ah	None
thebes	thebes	Nan
their	iyaga	None
theme	mawduuc	Nan
transaksi	ganacsi	None
theogonia	theogonia	Nan
third	saddexaad	None
thomas	thomas	Nan
thought	fikir	Nan
thumb|	|	None
thumb|px|peta	|	None
ti	ti	None
tiada	tegey	None
theravada	theravada	Nan
tersendiri	kali	None
transduksi	wareejinta	Nan
transformasi	isbadal	None
uang	lacag	None
uap	uumi	Nan
ubi	macaan	None
ucapan	hadalka	None
uchiha	uchiha	Nan
udang	shiir	Nan
udara	hawo	None
ue	ue	Nan
uefa	uefa	Nan
ufo	ufo	Nan
ufos	ufos	Nan
ugm	ummad	None
ui	ui	Nan
uji	tijaabin	Nan
ujian	imtixaan	Nan
u	aad	None
ujung	dhamaadka	None
twitter	twitter	Nan
tvri	tvri	Nan
tunggal	hal	None
tunisia	tunis	None
tuntutan	dalabaadka	Nan
tur	socdaalka	None
turis	dalxiis	None
turki	turkiga	None
turnamen	tartan	Nan
turun	hoos	None
turunan	soosaarid	Nan
turunnya	faraca	Nan
turut	kaqeybgal	Nan
tutorial	umeerin	Nan
tutup	been	None
tuturan	hadalka	None
tv	tv	None
twilight	fiidkii	Nan
tunduk	mawduuc	Nan
ujungnya	caarada	Nan
ukiran	xardho	Nan
undang	casuumad	Nan
undangan	casuumaad	Nan
undangundang	dastuurka	None
under	hooseeya	None
underground	hoostiisa	None
unesco	unesco	Nan
unggas	digaagga	Nan
unggul	ka	None
ungkapan	muujinta	Nan
ungu	guduud	None
uni	uni	Nan
unicast	ahayn	None
unidentified	la	None
unik	ah	None
union	midowga	None
un	un	None
uk	uk	Nan
umur	da	None
umum	guud	None
ukraina	ukraine	Nan
ukur	cabiridda	Nan
ukuran	cabir	None
ukurannya	cabirkeeda	Nan
ulama	wadaad	None
ulang	u	None
ular	abeeso	Nan
ultraviolet	ultraviolet	Nan
ulu	ulu	Nan
umar	umar	Nan
umat	dadka	None
umayyah	umayyah	Nan
ummat	ummad	None
umpan	sed	Nan
umrah	umrah	Nan
umumnya	ahaan	None
tunas	dillaac	Nan
tumpukan	tuulmo	Nan
tumpang	isugeyn	Nan
triangle	saddex	None
trigliserida	triglycerides	Nan
triliun	trillion	Nan
trimurti	saxan	Nan
trio	saddex	None
trisakti	trisakti	Nan
tristan	tristan	Nan
triton	triton	Nan
triwulan	mar	None
trofi	koobka	Nan
tropik	tropic	Nan
tropika	kuleylaha	Nan
tropis	kuleylaha	Nan
troposfer	xinjirow	Nan
trowulan	trowulan	Nan
tri	tri	Nan
troya	troya	Nan
tren	isbeddelka	Nan
trauma	dhaawac	None
transformator	isbadal	None
transfusi	ku-shubista	Nan
transisi	guur	None
transistor	transistor	Nan
transkripsi	transcript	Nan
transmigrasi	socdaalka	None
transmisi	gudbinta	Nan
transmission	gudbinta	Nan
transmutasi	transmynta	Nan
transparan	hufan	Nan
transparansi	daahfurnaan	Nan
transparency	daahfurnaan	Nan
transplantasi	ku	None
transpor	gaadiid	None
transportasi	gaadiid	None
treatment	daaweynta	Nan
tsunade	tsunade	Nan
tsunami	tsunami	Nan
tua	jir	None
tukang	handyman	Nan
tukar	sarrifka	Nan
tulang	laf	None
tulis	qor	Nan
tulisan	qoraal	None
tulisannya	qoraalkiisa	Nan
tulisantulisan	qoraal	None
tulungagung	tulungagung	Nan
tumapel	tumapel	Nan
tumbuh	koraan	Nan
tumbuhan	dhirta	None
tumbuhnya	koritaanka	Nan
tumbuhtumbuhan	doogga	Nan
tumbukan	dhac	None
tumor	buro	None
tujuh	toddobo	None
tujuantujuan	yoolalka	Nan
tujuannya	ujeedkeeda	Nan
tujuan	ujeedada	None
tuak	khamri timireed	Nan
tuan	sir	None
tuanku	sayidow	Nan
tuanya	hore	None
tuban	tuban	Nan
tuberkulosis	qaaxada	Nan
tubrukan	dhac	None
transfer	wareejin	None
tubuh	jirka	None
tubulus	tubule	Nan
tuduhan	eedeyn	Nan
tugas	waajib	None
tugasnya	xilkiisa	Nan
tugastugas	hawlaha	None
tugu	taallo	Nan
tuhan	ilaahow	Nan
tubuhnya	jirkiisa	Nan
mahkamah	maxkamada	None
sosialis	hantiwadaag	Nan
sorong	duulista	Nan
rem	fariin	None
remaja	ah	None
rembang	dhalaalaya	Nan
remote	fog	None
rempahrempah	udgoon	None
renaisans	renaissance	Nan
renalis	renalis	Nan
renang	dabaasha	Nan
rencana	qorshe	None
rencananya	qorshaha	Nan
rencong	rencong	Nan
rendah	hooseeya	None
rendahnya	dhaca	None
rendra	rendra	Nan
rengasdengklok	rengasdengklok	Nan
relung	niche	Nan
renji	renji	Nan
religius	diinta	None
relief	nasinta	Nan
rekannya	lammaanahiisa	Nan
rekayasa	kadeedis	Nan
rekomendasi	talinta	Nan
rekonstruksi	dhiska	None
rekor	duub	None
rekreasi	madadaalo	Nan
reksa	wadaaga	None
reksadana	dhinac	None
rektum	malawadka	Nan
rel	tareenka	Nan
rela	diyaar	None
relasi	qaraabo	Nan
relatif	ahaan	None
relativitas	isu-falcelin	Nan
relevan	xiriira	None
religi	diinta	None
rekan	saaxiib	None
rentan	u	None
reog	reog	Nan
resmi	ah	None
resminya	ah	None
resolusi	qaraar	None
resolver	xallin	Nan
resonansi	resonance	Nan
resource	kheyraadka	None
respirasi	neefsashada	Nan
respon	jawaabta	Nan
respons	jawaabta	Nan
restoran	makhaayad	None
retikulum	manhajka	None
retina	retina	Nan
rev	noole	None
reverse	gadaal	None
revisi	u	None
resistor	iska	None
rentang	xadka	None
resistansi	iska	None
residu	haray	None
replika	ah	None
replikasi	taranka	Nan
report	warbixin	None
representasi	metelaad	Nan
reproduksi	taranka	Nan
reptil	xamaarato	Nan
republik	jamhuuriyada	None
republika	republika	Nan
reputasi	sumcad	Nan
reruntuhan	burburka	None
resep	karinayo	Nan
reseptor	soo	None
resi	rasiid	Nan
residen	degane	Nan
residentie	degane	Nan
resiko	khatar	None
revolusi	kacaan	None
rekaman	duubista	Nan
rehabilitasi	baxnaaninta	Nan
ras	tartan	Nan
rasa	dhadhan	Nan
rasanya	dhadhan	Nan
rasengan	rasengan	Nan
rasi	astaantii	Nan
rasio	saamiga	Nan
rasional	ah	None
rasul	rasuul	None
rasulullah	rasulullah	Nan
rata	fidsan	None
ratapan	oohin	None
ratarata	celcelis	Nan
rating	qiimeynta	Nan
ratna	cillad	Nan
ratu	boqoradda	Nan
rara	iibin	None
ratus	boqol	None
rapi	nidaamsan	Nan
rapat	kulan	None
ramai	badan	None
ramayana	ramayana	Nan
rambut	timo	None
rambutnya	timaheeda	Nan
ramuan	potion	Nan
ranah	boqortooyada	None
rancangan	ah	None
randai	randa	Nan
rangga	jaranjarada	Nan
rangka	amar	None
rangkaian	xulka	None
rangkap	labanlaab	Nan
rangsangan	kicinta	Nan
rantai	silsilad	Nan
rantau	dibada	None
rapatan	xidh	None
reinkarnasi	reincarnation	Nan
ratusan	boqolaal	Nan
rawa	qoyan	Nan
redoks	redox	Nan
reduksi	yareyn	Nan
redup	dhudhun	Nan
referendum	afti	Nan
referensi	tixraac	None
refleks	firfircoonaanta	Nan
refleksi	milicsiga	Nan
reformasi	u	None
regenerasi	soo	None
regional	ahaan	None
register	diiwaangelinta	Nan
registrasi	diiwaangelinta	Nan
regu	koox	None
regulasi	sharciyeynta	Nan
reguler	ah	None
redaksi	tifaftire	Nan
raw	cayriin	Nan
red	casaan	Nan
receiver	qaataha	Nan
rawan	nugul	Nan
rawana	rawana	Nan
rawat	daryeelo	Nan
ray	raajo	Nan
raya	weyn	None
rcti	rcti	Nan
re	re	Nan
reagan	reagan	Nan
reaksi	falcelin	Nan
reaktan	jawaabeyaasha	Nan
reaktif	falcelin	Nan
real	ah	None
realitas	xaqiiqada	None
rebab	camal	None
rebo	rebo	Nan
record	duub	None
revolusioner	kacaan	None
revolution	kacaan	None
rezim	taliska	None
rumah	guriga	None
rumahan	guriga	None
rumahnya	gurigeeda	Nan
rumahrumah	guryo	None
rumania	romania	None
rumit	adag	None
rumpun	jajabinta	Nan
rumput	cawska	Nan
rumus	qaaciddada	Nan
rumusan	qaabeynta	Nan
runnerup	orodley	Nan
runtuh	dumin	None
runtuhnya	dumin	None
rupa	eg	None
rupadhatu	rupadhatu	Nan
rukun	gal	None
rupanya	muuqata	None
rujukan	tixraac	None
rugi	khasaaro	Nan
rp	rp	Nan
rrc	rc	None
rri	rri	Nan
rs	r	Nan
rsi	rsi	Nan
rss	rss	Nan
rsu	rsu	Nan
rsud	isbitaal	None
ruam	finanka	Nan
ruang	qol	Nan
ruangan	qol	Nan
ruangruang	booska	Nan
ruas	gabal	Nan
rubah	dawaco	Nan
rugby	rugby	Nan
rujak	saladh	Nan
royong	ah	None
rupiah	rupiah	Nan
rusa	deerada	Nan
sabun	saabuun	Nan
sacchi	sacchi	Nan
sadar	ka	None
sadewa	sadewa	Nan
saga	sagaaro	Nan
sage	sage	Nan
sagu	sago	Nan
sah	ah	None
sahabat	saaxiib	None
sahabatnya	fiican	None
saham	saamiga	Nan
sahamnya	saamiyadeeda	Nan
sahara	sahara	Nan
sai	wey	None
said	yidhi	None
sabuk	suunka	Nan
rups	rups	Nan
sabtu	sabti	None
sabana	savanna	Nan
rusak	jabay	None
rusaknya	waxyeelada	Nan
rusia	ruushka	None
russia	russia	Nan
rusuk	dambe	None
rute	wadada	None
rutin	ah	None
ruu	ruu	Nan
ryan	ryan	Nan
ryuzaki	ryuzaki	Nan
s	s	None
sa	sa	None
saat	goorma	Nan
saatsaat	daqiiqado	Nan
sabah	sabah	Nan
sabit	jiran	Nan
royal	boqornimo	Nan
roy	roy	Nan
rowling	isku	None
rin	biyo	None
rinci	faahfaahsan	None
rincian	faahfaahinta	Nan
rindu	seegto	Nan
ring	garaac	Nan
ringan	iftiin	Nan
ringkas	kooban	None
ringkasan	soo	None
rintangan	caqabadaha	Nan
rio	rio	Nan
ris	ris	Nan
risalah	daaweyn	Nan
riset	baaris	None
risiko	khatar	None
ritual	dhaqan	None
rimba	kaymaha	None
rival	xafiiltannada	Nan
rima	laxanka	Nan
riku	riku	Nan
rezky	rezky	Nan
rfc	rfc	Nan
rhodes	rhodes	Nan
rhoma	rhoma	Nan
ri	ri	None
riau	riau	Nan
ribosom	ribosome	Nan
ribu	kun	None
ribuan	kun	None
ricardo	ricardo	Nan
rice	bariis	None
richard	richard	None
ricky	ricky	Nan
right	sax	None
riil	ah	None
rilis	sii	None
riwayat	taariikhda	None
rizal	rizal	Nan
rna	rna	Nan
ronaldo	ronaldo	Nan
rongga	dalool	None
root	xidid	None
rosa	rosa	Nan
rose	kacay	None
roses	ubax	None
rossi	rossi	Nan
roswell	roswell	Nan
rotan	rattan	Nan
rotasi	wareejin	None
roti	rooti	Nan
rotterdam	rotterdam	None
router	router	Nan
routing	socodka	None
routledge	socodsiin	Nan
ronald	ronald	Nan
ron	ron	Nan
rombongan	kooxda	None
romawi	roman	None
robert	robert	Nan
roberto	roberto	Nan
robin	robin	Nan
robot	robot	Nan
rock	weyn	None
roda	giraangiraha	Nan
roger	roger	Nan
ramah	leh	None
roh	ruux	None
rokan	rokan	Nan
roket	gantaal	Nan
rokok	sigaarka	Nan
rom	rom	Nan
roma	rome	None
roman	jacayl	None
romantis	jacayl	None
rohani	ruux	None
ramadhan	ramadan	Nan
ramadan	ramadaan	None
rama	rama	Nan
pranala	iskuxiran	Nan
prancis	faransiiska	None
prasarana	kaabayaasha	Nan
prasasti	qoraal	None
prasejarah	prehistoric	Nan
pratama	pratama	Nan
predator	ugaadhsade	Nan
predikat	saadaalin	Nan
prediksi	saadaalin	Nan
prefiks	horgale	Nan
premium	bixin	None
presentasi	soo	None
presenter	soo	None
presiden	madaxweynaha	None
presidensial	madaxweynaha	None
pramuka	indha	None
presipitasi	roobab	None
prambanan	prambanan	Nan
praktis	ah	None
potongan	gabal	Nan
potret	sawir	None
potter	dheryasameeyaha	Nan
power	awood	None
powerpoint	barta	None
pp	pp	Nan
ppki	ppki	Nan
ppp	ppp	Nan
pra	hore	None
prabu	prabu	Nan
prajurit	askari	None
prakiraan	saadaalin	Nan
praktek	dhaqan	None
prakteknya	dhaqanka	None
praktik	dhaqan	None
praktisi	xirfadle	Nan
potong	gooyaa	Nan
presisi	saxsanaanta	Nan
prestasi	guul	None
private	gaar	None
privatisasi	kali	None
pro	pro	Nan
probabilitas	itimaalka	Nan
problem	dhibaato	None
probolinggo	probolinggo	Nan
prodip	prodip	Nan
production	saar	None
produk	sheyga	Nan
produkproduk	waxyaabaha	None
produksi	saar	None
produksinya	saarkooda	None
produktif	leh	None
produktivitas	saar	None
produsen	soo	None
privat	gaar	None
press	riix	Nan
privasi	asturnaanta	Nan
priok	mudnaanta	Nan
prestise	sharaf	None
pria	ragga	None
priangan	nin	None
pribadi	shaqsiyeed	Nan
pribadinya	shaqsiyadiisa	Nan
pribumi	ahaan	None
price	qiimo	None
priestley	wadaad	None
prima	wasaare	None
primata	digaaga	Nan
primer	ah	None
primitif	hore	None
prinsip	mabda &#39;	Nan
prinsipprinsip	mabaadi&#39;da	Nan
printer	daabacad	Nan
prioritas	mudnaanta	Nan
potensial	suurtagal	Nan
potensi	awood	None
poster	dhejis	Nan
point	barta	None
pokok	maamulaha	None
pola	qaabka	None
polandia	booland	Nan
polapola	polapola	Nan
polar	polar	Nan
polemik	khaldan	Nan
polimer	polymer	Nan
polio	dabeysha	Nan
polisakarida	polysaccharides	Nan
polisi	booliska	None
politeknik	farsamada	None
politics	siyaasada	None
politik	siyaasadeed	None
politiknya	siyaasadeeda	Nan
poin	dhibco	Nan
politikus	siyaasiga	None
pohonpohon	geed	None
pocong	pocong	Nan
plasma	plasma	Nan
plasmodium	plasmodium	Nan
plastik	caag	None
platform	madal	Nan
platinum	platinum	Nan
plato	plateau	Nan
playboy	ciyaar	None
plaza	plaza	Nan
plot	shirqoolka	Nan
pluit	qaylo	Nan
plus	daro	None
pluto	pluto	Nan
pm	pm	Nan
pn	pn	Nan
pni	pni	Nan
pohon	geed	None
politis	siyaasadeed	None
politisi	siyaasiga	None
polo	polo	Nan
pornografi	sawir	None
porong	riix	Nan
poros	dhidibka	Nan
porsi	qayb	None
portal	portal	Nan
portland	xeebta	None
portofolio	boortofooliyada	Nan
portugal	boortaqiiska	Nan
portugis	boortaqiiska	Nan
pos	dhajin	Nan
poseidon	poseidon	Nan
posisi	booska	Nan
posisinya	mowqifkeeda	Nan
positif	togan	Nan
post	dhajin	Nan
pornoaksi	xumo	None
porno	qaawan	Nan
poripori	jilicsan	None
porifera	porifera	Nan
polri	booliska	None
polusi	wasakheynta	Nan
pompa	bamgare	Nan
pondasi	aasaaska	None
pondok	aqal	None
pong	pong	Nan
pongo	pongo	Nan
produser	soo	None
ponorogo	ponorogo	Nan
pontianak	pontianak	Nan
pop	pop	Nan
popular	ah	None
popularitas	caan	None
populasi	dadka	None
populasinya	dadkeeda	None
populer	ah	None
ponsel	taleefanka gacantu	Nan
sailendra	sailendra	Nan
prof	prof	None
profesional	leh	None
putranya	wiilkiisa	None
putri	princess	Nan
putu	putu	Nan
putus	jab	None
putusan	go’aan	Nan
px|bendera	calanka	None
pygmaeus	pygmaeus	Nan
qadir	qadir	Nan
qatar	qatar	None
qs	qs	Nan
quebec	quebec	Nan
query	weydiinta	None
quraisy	quraysh	None
quran	quranka	Nan
r	r	Nan
putra	wiil	None
ra	ra	None
putik	bastoolad	Nan
puteri	gabar	None
purba	ah	None
purbakala	ah	None
puri	qalcad	Nan
purn	murugo	Nan
purnama	buuxa	None
purnawarman	noqday	None
purwakarta	purwakarta	Nan
pusaka	dhaxalka	None
pusat	xarunta	None
pusatpusat	xarumaha	None
pusing	dawakh	Nan
pustaka	tixraacyada	None
putaran	wareega	None
putera	wiil	None
puteranya	wiilkiisa	None
putih	cad	None
pura	macbudka	Nan
rabies	rabbaaniin	Nan
racun	sunta	None
rai	rai	Nan
raja	boqorka	None
raja-udang	king-shrimp	Nan
rajanya	boqorka	None
rajaraja	rajaraja	Nan
rajasa	rajasa	Nan
rajin	badan	None
raket	xabbad	Nan
rakeyan	rakeyan	Nan
rakryan	rakryan	Nan
raksa	meerkurida	Nan
raksasa	weyn	None
rakyat	dadka	None
rakyatnya	dadkeeda	None
ram	wan	None
rahmat	nimco	Nan
rabu	arbacada	Nan
rahman	rahman	Nan
rahasia	sirta	None
radang	caabuq	Nan
radar	radar	Nan
raden	raden	Nan
radiasi	shucaac	Nan
radikal	ah	None
radin	radin	Nan
radio	raadiyaha	Nan
radioaktif	shucaac	Nan
radius	radius	None
raffa	raffa	Nan
raffles	rafles	Nan
raga	jirka	None
ragam	duwan	None
ragi	khamiir	Nan
rahang	daanka	Nan
rahim	ilmo	None
pupuk	bacriminta	Nan
punya	leeyihiin	None
punk	punk	Nan
prosa	maahmaah	Nan
prosedur	nidaamka	None
proses	habka	None
prosesor	processor-ka	Nan
prosesproses	habka	None
protease	ilaalinta	None
protein	borotiin	Nan
proteksi	ilaalin	None
protes	mudaharaad	Nan
protestan	protestant	Nan
protista	protist	Nan
protocol	hab	None
protokol	hab	None
proton	proton	Nan
protozoa	protozoa	Nan
proporsi	saami	None
provider	bixiye	Nan
propinsi	gobolka	None
propaganda	dacaayad	Nan
profesor	borofisar	Nan
professional	leh	None
profil	guud	None
profile	guud	None
progo	progo	Nan
program	barnaamijka	None
programmer	programmer	Nan
programprogram	barnaamijyada	None
progresif	horusocod	Nan
project	mashruuc	None
prokariota	prokaryotes	Nan
proklamasi	ku	None
proliferasi	fiditaan	Nan
prominensa	prominensa	Nan
promosi	dallacsiin	Nan
properti	hanti	None
provinsi	gobolka	None
provinsiprovinsi	gobolada	None
provokatus	xanaaq	Nan
pula	kale	None
pulang	noqo	None
pulau	jasiirad	None
pulaupulau	jasiirad	None
pulih	soo	None
pulo	pulo	Nan
puluh	labaatan	None
puluhan	daraasiin	Nan
pun	xitaa	None
punah	tirtiraa	Nan
punca	jirridda	Nan
puncak	ugu	None
puncaknya	ugu	None
punggung	dib	None
pungutan	canshuur	Nan
pukulan	afuufid	Nan
pukul	saac	Nan
pujangga	gabayaa	Nan
puisi	gabay	None
proxemiks	proxemiks	Nan
proyek	mashruuc	None
proyekproyek	mashaariicda	Nan
proyeksi	saadaalin	Nan
ps	ps	Nan
psikologi	cilmu-nafsiga	Nan
psikologis	cilmi	None
profesi	xirfad	None
psikotropika	cilmi	None
pt	pt	Nan
puas	ku	None
puasa	sooman	None
public	dadweynaha	None
publik	dadweynaha	None
publikasi	daabacaad	Nan
pucuk	dillaac	Nan
pssi	pssi	Nan
sosial	bulsho	None
saingan	xafiiltan	Nan
saja	kaliya	None
sesuai	u	None
sesuatu	wax	None
sesudah	dib	None
sesudahnya	kadib	None
sesungguhnya	runtii	None
set	dhigay	None
setahun	sanad	None
setan	ibliis	Nan
setara	isleeg	None
setelah	dib	None
setelahnya	dib	None
setempat	ah	None
setengah	badh	None
seterusnya	sidaas	None
setia	daacad	None
sesi	kalfadhiga	Nan
setiap	kasta	None
sesepuh	odayaasha	None
sesekali	ah	None
serpihan	jajabinta	Nan
serpong	serpong	Nan
serta	iyo	None
sertifikasi	caddeynta	Nan
sertifikat	caddeyn	Nan
serum	serum	Nan
serupa	ah	None
server	adeegaha	Nan
service	adeeg	None
services	adeegyada	None
serviks	makaanka afkiisa	Nan
servis	adeeg	None
sesaat	daqiiqad	Nan
sesak	badan	None
sesama	wehel	None
seseorang	qof	None
serius	ah	None
setidaknya	yaraan	None
setingkat	heer	None
shin	shin	Nan
shinichi	shinichi	Nan
shinigami	shinigami	Nan
shino	shino	Nan
shinobi	shinobi	Nan
shinta	shinta	Nan
shinto	shinto	Nan
shireen	shireen	Nan
shizuka	shizuka	Nan
show	show	Nan
shukaku	shukaku	Nan
shuriken	shuriken	Nan
si	si	None
siaga	heegan	Nan
siak	siak	Nan
shikamaru	shikamaru	Nan
setinggi	ugu	None
shell	qolofka	Nan
sharingan	sharean	Nan
setting	dejinta	Nan
setuju	ogolaado	Nan
seumur	isla	None
seusai	dib	None
seven	toddobo	None
sevenfold	todoba	None
sewa	kiro	Nan
sewaktu	goorma	Nan
sewaktuwaktu	markasta	None
sewu	sewu	Nan
sex	galmada	Nan
sh	sh	None
shadows	hooska	Nan
shah	shah	Nan
shankly	shanqadh	Nan
sharp	fiiqan	Nan
siam	siam	Nan
seringkali	badanaa	None
serikat	midowga	None
sensor	dareemayaasha	Nan
sensus	tirakoobka	Nan
sentra	xarunta	None
sentral	dhexe	None
sentuhan	taabasho	Nan
senyawa	xarunta	None
senyawasenyawa	xarunta	None
seolaholah	sida	None
seorang	a	None
seoul	seoul	Nan
sepak	cagta	None
sepakat	ogolaaday	None
sepanjang	inta	None
separuh	badh	None
sepasang	lammaane	Nan
sensitif	ah	None
sepatu	kabaha	None
sensasi	dareen	None
senja	fiid	None
senator	senator	None
senayan	senayan	Nan
sendi	kala	None
sendiri	kali	None
sendirian	kali	None
sendirinya	lafteeda	Nan
senen	isniinta	Nan
seng	zinc	Nan
sengaja	ujeedo	Nan
sengit	leh	None
sengketa	muran	None
seni	fanka	None
seniman	fanaaniinta	None
senin	isniinta	Nan
senior	sareeya	None
senjata	hubka	None
sering	badanaa	None
sepeda	baaskiil	Nan
sepenuhnya	buuxda	None
serangkaian	ah	None
serapan	qaadasho	Nan
serasah	qashin	Nan
serat	fiber	Nan
seratus	boqol	None
serba	dhamaantiin	Nan
serbia	serbia	None
serbuk	budo	Nan
serdadu	askari	None
serentak	mar	None
seri	taxanaha	Nan
serial	serial	Nan
seribu	kun	None
series	taxanaha	Nan
serigala	yeey	Nan
serangga	cayayaan	Nan
sepeninggal	dib	None
seranganserangan	weerar	None
serang	weerar	None
seperempat	hal	None
seperti	sida	None
sepertiga	meel	None
sepertinya	u	None
sepihak	midaysan	Nan
september	sebtember	Nan
sepuluh	toban	None
sepupu	inaadeer	Nan
sepupunya	inaadeerkiis	Nan
seputar	hareeraha	None
serabut	fiber	Nan
serafim	seraafim	Nan
seragam	labis	Nan
seram	leh	None
serambi	balbalaad	Nan
serangan	weerar	None
siang	duhurkii	None
sianida	cyanide	Nan
siap	diyaar	None
situs	goobta	None
situssitus	goobta	None
siwa	shiva	Nan
sjahrir	sjahrir	Nan
sk	sk	Nan
skala	cabir	None
skandal	fadeexad	Nan
skema	qorshe	None
skenario	muuqaal	Nan
sketsa	sawir	None
skor	goolal	Nan
skotlandia	iskodland	Nan
sky	cirka	None
slamet	slamet	Nan
sleman	mudanayaal	Nan
situbondo	situbondo	Nan
slide	slide	Nan
situasi	xaalad	Nan
sitoskeleton	cytoskeleton	Nan
sisasisa	sisasisa	Nan
sisi	dhinac	None
sisinya	dhinaceeda	None
sistem	nidaam	None
sistematik	nidaamsan	Nan
sistematis	nidaamsan	Nan
sistemik	nidaamsan	Nan
siswa	ardayga	Nan
siswasiswi	ardayda	None
sita	la	None
site	goobta	None
siti	siti	Nan
sitokina	cytokines	Nan
sitologi	sayniska	None
sitoplasma	cytoplasm	Nan
situ	halkaas	None
sisanya	kale	None
slot	booska	Nan
sm	sm	Nan
software	software	None
sokrates	sokrates	Nan
sol	sol	Nan
solar	qoraxda	None
solo	solo	Nan
solok	solok	Nan
solusi	xalka	Nan
somalia	somalia	None
soneta	sonnet	Nan
songket	heeso	None
songo	songo	Nan
sop	maraq	Nan
soppeng	soppeng	Nan
sore	galab	None
sorga	jannada	None
soewardi	soewardi	Nan
slovenia	slovenia	Nan
soekarnoputri	soekarnoputri	Nan
soekarno	soekarno	Nan
sma	sare	None
smart	badan	None
smith	smith	Nan
smp	sare	None
sms	sms	None
smu	smu	Nan
sn	sn	Nan
snape	dabin	Nan
so	sidaas	None
soal	su’aal	Nan
social	bulsho	None
society	bulshada	None
soebardjo	soebardjo	Nan
soedirman	sudirman	Nan
soeharto	suharto	Nan
soekarnohatta	soekarnohatta	Nan
sisa	kale	None
sirkulasi	wareegga	Nan
sirkuit	wareegga	Nan
silat	silat	Nan
silek	silek	Nan
silikat	silicate	Nan
silikon	silicon	Nan
silinder	dhululubo	Nan
siliwangi	siliwangi	Nan
silsilah	qoys	None
siluman	stealth	Nan
simalungun	simalungun	Nan
simbiosis	waraabowga	Nan
simbol	astaan	None
simbolik	astaan	None
simbolsimbol	calaamadaha	Nan
simetri	summad	Nan
simetris	ahaan	None
silang	iskutallaabta	Nan
simfoni	heeso	None
sila	fadlan	None
siklon	duufaan	None
siapa	aduunka	None
siapapun	kasta	None
siaran	baahin	Nan
siberia	siberiya	Nan
sibuk	mashquul	None
sidang	maxkamadaynta	Nan
sidoarjo	sidoarjo	Nan
sierra	siraa	Nan
sifat	dabeecad	None
sifatnya	dabeecaddeeda	Nan
sifatsifat	dabeecadda	Nan
signifikan	ah	None
sihir	sixir	Nan
sikap	dabeecad	None
sikapnya	dabeecaddiisa	None
siklus	wareegga	Nan
simon	simon	Nan
simpanan	dhigaalka	Nan
simpanse	qiiq	None
singkong	kaabsal	Nan
single	hal	None
sini	halkan	None
sinonim	ereyga	None
sinta	adkeysi	Nan
sintaks	syntax	Nan
sintesis	soo	None
sintetis	dardaro	Nan
sinyal	calaamad	None
sipil	ah	None
siprus	cyprus	Nan
sir	sayid	None
siregar	siregar	Nan
sirih	khiyaamo	None
sirius	sirius	Nan
singkawang	heeskawang	Nan
singkatnya	gaabiyo	None
singkatan	soo	None
singkat	gaaban	None
simpati	naxariis	None
simtoma	calaamad	None
simulasi	jilitaanka	Nan
sina	sina	Nan
sinar	fallaaraha	Nan
sinarx	raajo	Nan
sindiran	innuendo	Nan
senat	senate	Nan
sindrom	syndrome	Nan
sinetron	saabuun opera	Nan
singa	libaax	None
singapura	singapore	Nan
singel	hal	None
singer	fanaan	None
singgah	istaag	Nan
singhasari	singasari	Nan
sinemart	shineemo	None
senar	xargaha	Nan
senantiasa	jeer	None
senang	faraxsan	None
satya	satya	Nan
saudara	walaalo	None
saudaranya	walaalkiis	None
saudarasaudaranya	walaalkiis	None
saudi	saudi	None
saus	maraq	Nan
saw	ahaato	None
sawah	bariiska	None
sawit	timirta	None
saya	aniga	None
sayang	gacaliye	Nan
sayangnya	daro	None
sayap	garabka	Nan
sayembara	tartan	Nan
sayur	khudradda	Nan
satwa	xayawaanka	Nan
sayuran	khudradda	Nan
satusatunya	kaliya	None
satupun	uun	None
sartika	sartika	Nan
sarung	sarong	Nan
sarutobi	sarutobi	Nan
sasaran	bartilmaameed	Nan
sasori	sasori	Nan
sastra	suugaanta	None
sastrawan	qoraa	None
sasuke	waalan	Nan
sate	satay	Nan
satelit	dayax	None
satelitsatelit	satelitsatelit	Nan
satria	habeen	None
satu	mid	None
satuan	cutub	None
satunya	keliya	None
saturnus	saturn	Nan
sarjana	bachelor	None
sayyid	sayyid	Nan
school	dugsiga	None
sebaiknya	in	None
sebaliknya	kale	None
sebanding	isbarbar dhig	Nan
sebanyak	badan	None
sebaran	qaybinta	Nan
sebatas	xaddidan	Nan
sebelah	xiga	None
sebelas	toban	None
sebelum	kahor	None
sebelumnya	hore	None
sebenarnya	ahaan	None
sebentar	kooban	None
seberang	soo	None
seberapa	intee	Nan
sebesar	ee	None
sebaikbaiknya	fiican	None
sby	sby	Nan
sebagian	ahaan	None
sebagaimana	yahay	None
science	sayniska	None
sciences	cilmiga	None
scientific	ah	None
scipio	scipio	Nan
scott	scott	Nan
sctv	sctv	Nan
sd	sd	Nan
sda	sda	Nan
se	se	Nan
searah	isla	None
search	raadin	Nan
season	xilli	None
sebab	yeelay	None
sebabnya	sababta	None
sebagai	sida	None
sebagainya	sidaas	None
sari	sari	Nan
sarekat	sarekat	Nan
sarawak	sarawak	Nan
saluran	kanaal	None
salzburg	salzburg	Nan
sam	sam	Nan
sama	ah	None
saman	saman	Nan
samarinda	samarinda	Nan
samasama	mudan	None
sambal	maraq chili	Nan
sambas	sambas	Nan
sambil	halka	None
sambungan	isku	None
sambutan	soo	None
samosir	samosir	Nan
sampah	qashinka	Nan
sampai	ku	None
salju	baraf	None
sampel	tusaalaha	Nan
saling	kale	None
salim	salim	Nan
sajak	laxanka	Nan
sajaksajak	kali	None
saka	kaa	None
sakit	jiran	Nan
saksi	marag	Nan
sakti	sixir	Nan
sakura	sakura	Nan
sakuraba	sakuraba	Nan
salah	waa	None
salak	jilif	Nan
salam	salaan	None
salat	salat	Nan
saleh	cibaadada	None
salemba	salemba	Nan
salib	iskutallaabta	Nan
salinan	nuqul	Nan
samping	dhinac	None
sampingan	dhinac	None
sampul	dabool	Nan
sani	sani	Nan
sanjaya	sanjaya	Nan
sanksi	rigoore	Nan
sannin	sannin	Nan
sanskerta	sanskrit	Nan
santa	santa	Nan
santo	qoduus	Nan
sanusi	sanusi	Nan
sapi	lo&#39;da	Nan
sapu	xaaqin	Nan
saraf	dareemayaasha	Nan
sarah	sarah	Nan
saran	soo	None
sarana	macnaheedu	None
sarang	buul	Nan
sangkuriang	sangkuriang	Nan
sangkar	qafis	Nan
sanghyang	sanghyang	Nan
sanggup	leh	None
samudera	badda	None
samudra	badweynta	None
samuel	samuel	Nan
san	san	None
sana	halkaas	None
sanad	sanad	None
sanadnya	sanad	None
sebetulnya	ahaantii	None
sanak	qaraabada	Nan
sandi	password	Nan
sandiwara	tiyaatarka	Nan
sandra	la	None
sanfotsi	sanfotsi	Nan
sang	ah	None
sangat	aad	None
sangatlah	runtii	None
sandang	dharka	None
sains	sayniska	None
sebuah	a	None
sebut	u	None
selera	dhadhan	Nan
selesai	sameeyay	None
seljuk	adag	None
selling	iibinta	Nan
selnya	qolkiisa	Nan
selsel	selsel	Nan
seluas	aag	Nan
selubung	gunta	Nan
selular	gacanta	None
seluler	gacanta	None
selulosa	cellulose	Nan
seluruh	dhammaan	None
seluruhnya	dhan	None
sem	sem	Nan
semacam	ah	None
selepas	dib	None
semak	baadiyaha	Nan
selektif	xulasho	Nan
selatpanjang	south long	Nan
sekutu	saaxiibtinimo	None
sel	qolka	Nan
selain	sokow	None
selaku	aniga	None
selalu	jeer	None
selam	quusin	Nan
selama	muddadii	None
selamanya	weligiis	Nan
selamat	hambalyo	Nan
selandia	xamar	None
selangor	ah	None
selanjutnya	xiga	None
selaput	xuubka	Nan
selat	cidhiidhi	Nan
selatan	koonfur	None
seleksi	xulasho	Nan
sekurangkurangnya	yaraan	None
semakin	badan	None
semanggi	dhir	None
semikonduktor	semiconductor	Nan
seminar	seminar	Nan
seminggu	todobaad	None
semisal	sida	None
sempat	heshay	None
sempit	dhuuban	Nan
sempurna	ah	None
semu	been	None
semua	dhamaan	None
semuanya	dhamaan	None
semula	bilaabo	None
semusim	xilli	None
semut	quraanjo	Nan
sena	sena	Nan
senam	jimicsiga	Nan
semi	semi-	Nan
semangat	ruux	None
semesta	caalamka	None
sementara	halka	None
semantik	aqoon	None
semar	semar	Nan
semarang	semarang	Nan
semasa	lagu	None
semata	kaliya	None
sematamata	sematamata	Nan
sembahyang	duco	None
sembarang	kasta	None
sembilan	sagaal	None
semboyan	ujeeddo	None
sembuh	ladnaada	Nan
semburan	dillaac	Nan
semen	sibidhka	Nan
semenanjung	jasiiradda	Nan
semenjak	ilaa	None
semeru	semeru	Nan
sekunder	labaad	None
sekumpulan	farabadan	None
sekuler	ah	None
segenap	dhamaan	None
segera	dhow	None
segi	waji	None
segitiga	saddex	None
segmen	gabal	Nan
sego	sego	Nan
sehari	maalin	None
seharihari	kasta	None
seharusnya	in	None
sehat	leh	None
sehingga	darteed	None
sehubungan	xiran	None
seimbang	isu	None
seiring	weheliya	Nan
seiyu	seiyu	Nan
segel	shaabad	Nan
sejahtera	barwaaqo	None
segar	cusub	None
seekor	mid	None
sebutan	magacaabis	Nan
secara	hab	None
second	labaad	None
secret	sirta	None
security	amniga	None
sedang	saaran	None
sedangkan	halka	None
sedemikian	ah	None
sederhana	fudud	None
sedih	leh	None
sedikit	yar	None
sedikitnya	yaraan	None
sedimen	qallooc	Nan
sedna	sedna	Nan
sedunia	adduunka	None
segala	dhamaan	None
sejajar	ah	None
sejak	ilaa	None
sejalan	safka	Nan
sekitar	hareeraha	None
sekitarnya	hareeraha	None
sekolah	dugsiga	None
sekolahnya	dugsiga	None
sekolahsekolah	dugsiga	None
sekresi	sirta	None
sekretari	xoghaye	Nan
sekretariat	xoghaynta	Nan
sekretaris	xoghaye	Nan
seks	galmada	Nan
seksi	sexy	Nan
seksual	galmo	Nan
seksualitas	galmada	Nan
sekte	dariiqo	Nan
sektor	waaxda	None
sekilas	jaleec	Nan
sekian	intaas	None
seketika	markiiba	None
sekelompok	ah	None
sejarah	taariikhda	None
sejarahnya	taariikhdeeda	Nan
sejarawan	taariikhyahan	None
sejati	run	None
sejauh	hadda	None
sejenis	ah	None
sejuk	qabow	None
sebulan	bil	None
sejumlah	tiro	None
sekali	mar	None
sekaligus	mar	None
sekalipun	kastoo	None
sekarang	hadda	None
sekarat	dhimanaya	Nan
sekedar	kaliya	None
sekeliling	hareeraha	None
sekadar	kaliya	None
ω	ω	Nan
mahir	leh	None
mahayana	mahayana	Nan
datuk	abtirsiinyo	Nan
daud	daud	None
daulah	daulah	Nan
daun	caleen	Nan
daur	wareegga	Nan
dave	dajin	Nan
david	david	Nan
davis	davis	Nan
dawai	xarig	Nan
daya	awood	None
dayak	dayak	Nan
dayang	maxkamada	None
dc	dc	Nan
de	de	None
debat	dood	None
dataran	cad	None
debu	boodh	Nan
datar	fidsan	None
datanglah	kaalay	Nan
darma	darma	Nan
darul	darul	Nan
darurat	ah	None
darussalam	darussalam	Nan
darwin	darwin	Nan
das	das	Nan
dasar	ah	None
dasarata	gundhig	Nan
dasardasar	ah	None
dasarnya	ahaan	None
dasawarsa	sano	None
data	xogta	Nan
database	keydka macluumaadka	Nan
datadata	datadata	Nan
datang	kaalay	Nan
datangnya	socda	None
daripada	ee	None
debut	horeysay	None
default	caadi	None
deli	dhiib	None
delta	delta	Nan
demak	sidaas	None
demam	qandho	Nan
demensia	waallida	Nan
demi	aawadood	Nan
demikian	sidaasaa	Nan
demografi	dadka	None
demokrasi	dimuqraadiyadda	None
demokrat	dimoqoraadiyad	Nan
demokratik	ah	None
demokratis	ah	None
demonstrasi	banaanbax	Nan
den	been	None
dendam	aargudasho	Nan
delegasi	wafdi	None
dec	dec	None
delapan	sideed	None
dekrit	wareegto	Nan
definisi	qeexitaan	Nan
defisiensi	yaraanta	Nan
defisit	dhac	None
degradasi	xaalufinta	Nan
deidara	deidara	Nan
deimon	diimon	Nan
dek	deked	Nan
dekade	sano	None
dekat	xir	None
dekatnya	dhow	None
dekisugi	dekisugi	Nan
dekker	dekker	Nan
deklarasi	caddeyn	Nan
deklinasi	dhac	None
dekomposisi	giirte	Nan
del	del	Nan
dengan	leh	None
darinya	ka	None
dari	ka	None
curam	dillaac	Nan
curug	mareen	None
cut	gooyaa	Nan
cuti	ah	None
cyanobacteria	cyanobacteria	Nan
da	da	None
dada	xabadka	Nan
dadu	laadhuu	Nan
daendels	daendels	Nan
daerah	aag	Nan
daerahdaerah	aag	Nan
daerahnya	aagga	None
daftar	liiska	None
dagang	ganacsiga	None
daging	hilib	Nan
curah	roob	None
daha	bye	Nan
cup	koob	None
culture	dhaqanka	None
cover	dabool	Nan
cowok	nin	None
cpa	cpa	Nan
cpu	processor	Nan
critias	dhaleeceyn	Nan
crocodylus	yaxaas	Nan
cs	cs	None
cu	cu	Nan
cuaca	cimilo	None
cucu	awoowe	None
cuka	khal	None
cukai	banaanka	None
cukup	filan	None
cula	gees	None
cullen	cullen	Nan
cuma	kaliya	None
daring	ah	None
dahlan	dahlan	Nan
dahulu	hore	None
dangdut	dangdut	Nan
dangkal	gacmeed	Nan
daniel	daniel	Nan
danum	danum	Nan
danzo	danzo	Nan
danzou	danzou	Nan
dapat	kari	None
dapatkan	hel	Nan
dapatlah	helay	None
dapur	jikada	Nan
dara	bikro	Nan
darah	dhiig	None
darahnya	dhiiga	Nan
darat	dhul	None
daratan	weyn	None
danau	haro	Nan
dahsyat	leh	None
danatau	iyo	None
dan	iyo	None
dahulunya	kahor	None
dai	yey	Nan
dajal	dajal	Nan
dajjal	ah	None
dakwah	dacaayad	Nan
dalam	gudaha	None
dalamnya	ah	None
dalang	puppeteer	Nan
dalem	qasriga	Nan
dalglish	dalglish	Nan
dalil	soo	None
dam	biyo	None
damai	nabad	None
dampak	saamaynta	None
dampaknya	saamaynta	None
dana	maal	None
dengannya	leh	None
dengue	dengue	Nan
denmark	danmark	Nan
diatomik	diatomic	Nan
diatur	nidaamsan	Nan
diawali	bilaabay	None
diawasi	kormeeray	Nan
dibaca	la	None
dibagi	qaybsan	Nan
dibagibagi	wadaag	Nan
dibahas	hadlay	None
dibakar	gubay	None
dibalik	gadaal	None
dibanding	isbarbar dhig	Nan
dibandingkan	isbarbar dhig	Nan
dibangun	dhisay	None
dibangunnya	dhisay	None
dibantu	caawiyay	Nan
diatasi	laga	None
dibatalkan	baajiyay	Nan
diatas	xusan	None
diasingkan	masaafuriyey	Nan
diameter	dhexroor	Nan
dian	dian	Nan
diancam	hanjabay	Nan
dianggap	la	None
dianggapnya	tixgelin	Nan
diangkat	magacaabay	None
dianjurkan	lagu	None
diantara	dhexeeya	None
diantaranya	ah	None
dianut	duubay	None
diapit	qalloocan	Nan
diaplikasikan	codsatay	Nan
diarahkan	toosiyay	Nan
diare	shuban biyoodka	Nan
diartikan	loo	None
diasosiasikan	xiriira	None
diamdiam	aamusnaan	Nan
dibatasi	xaddidan	Nan
dibawah	hoosta	None
dibuahi	lagu	None
dibuang	tuuray	None
dibuat	sameeyay	None
dibuatnya	dhigay	None
dibubarkan	diri	None
dibudidayakan	beero	None
dibuka	furay	None
dibuktikan	cadeeyay	None
dibungkus	duudduubay	Nan
dibunuh	dilay	None
dibutuhkan	yahay	None
dicabut	buriyay	Nan
dicampur	isku	None
dicantumkan	daro	None
dicapai	gaadhay	None
dibintangi	xiddigta	Nan
dibawa	keenay	None
dibicarakan	hadlay	None
dibiarkan	tagay	None
dibawakan	keenay	None
dibayar	qaata	None
dibayarkan	bixisay	None
dibebaskan	xoreeyay	None
dibedakan	kala	None
dibeli	iibsaday	None
dibenarkan	qiil	Nan
dibentuk	sameeyay	None
dibentuknya	sameeyay	None
diberhentikan	laga	None
diberi	siiyay	None
diberikan	siiyay	None
diberlakukan	geliyay	None
diberlakukannya	dhaqangelinta	Nan
dibesarkan	koray	None
dibiayai	lagu	None
diambil	qaatay	None
diamati	arkay	None
diam	aamus	None
desain	nashqadeynta	Nan
desakan	adkeysi	Nan
desanya	tuulada	None
desember	diseembar	None
deskripsi	sharraxaad	Nan
deskriptif	sharraxa	Nan
desktop	desktop-ka	Nan
detail	faahfaahinta	Nan
deteksi	ogaansho	Nan
detektif	dambi baadhe	Nan
detik	ilbidhiqsiyo	Nan
detil	faahfaahin	Nan
deuterium	deuterium	Nan
development	horumarin	Nan
device	qalab	None
desa	tuulo	None
devisa	qalaad	None
derivatif	soosaarid	Nan
deret	saf	Nan
denominasi	xaraf	None
denpasar	diidmo	Nan
densitas	cufnaanta	Nan
depan	hore	None
depannya	horteeda	Nan
departemen	waaxda	None
department	waaxda	None
depok	depok	Nan
depresi	jab	None
deputi	xigeen	None
der	der	Nan
derainbow	derainbow	Nan
derajat	heer	None
deras	culus	None
derby	ciyaar	None
deretan	saf	Nan
dewa	ilaah	None
dewadewa	dewadewa	Nan
dewadewi	ilaahyada	Nan
diagnosis	cudurka	None
diagram	jaantus	Nan
diajak	casuumay	None
diajarkan	baray	None
diajukan	gudbiyay	Nan
diakhiri	la	None
diakibatkan	sababay	None
diakses	gartay	None
diakui	yahay	None
dialah	waa	None
dialami	leh	None
dialek	lahjad	Nan
dialihkan	wareejiyay	None
dialog	hadal	None
dialup	diiriye	None
diagnosa	cudurka	None
diafragma	diaphragm	Nan
diadopsi	korsaday	Nan
diadaptasi	qabatimay	None
dewan	gole	Nan
dewantara	dewantara	Nan
dewasa	weyn	None
dewata	ilaahyada	Nan
dewi	ilaahoow	Nan
dgn	leh	None
dhamma	dhamma	Nan
court	maxkamada	None
dharma	dharma	Nan
dhien	dhien	Nan
di	gudaha	None
dia	isagu	None
diabadikan	horumarsan	Nan
diabaikan	la	None
diabetes	sonkorow	Nan
diadakan	qabtay	None
dharmasraya	dharmasraya	Nan
dicari	raadinaya	Nan
council	gole	Nan
corak	qaabka	None
busana	moodada	Nan
busby	busby	Nan
business	ganacsiga	None
busur	qaanso	Nan
but	laakiin	None
buta	indhoole	Nan
butir	shay	None
butiran	granules	Nan
buton	badh	None
buwono	buwono	Nan
by	by	None
byakuya	byakuya	Nan
byasa	byasa	Nan
byzantium	byzantium	Nan
c	c	None
bus	baska	Nan
c++	c	None
burungburung	shimbiraha	None
buruk	xun	None
buncis	digir	None
bunda	hooyo	None
bundar	wareega	None
bung	nin	None
bunga	ubax	None
bungsu	yar	None
buni	buni	Nan
bunshin	bunshin	Nan
bunuh	dilo	None
bunyi	cod	None
bupati	regent	Nan
burma	burma	None
bursa	sarrifka saamiga	Nan
buruan	ugaarsiga	Nan
buruh	shaqaalaha	None
burung	shimbiraha	None
bunaken	duushay	Nan
ca	ca	Nan
cabang	laanta	None
calvin	calvin	Nan
cambridge	cambridge	Nan
camp	xero	None
campak	jadeecada	Nan
campur	isku	None
campuran	isku	None
can	karaa	None
canada	kanada	None
cancer	kansarka	Nan
candi	macbudka	Nan
candicandi	nacnaca	Nan
canggih	casriyeysan	Nan
cangkang	qolof	Nan
cantik	badan	None
cap	shaabad	Nan
calon	musharrax	Nan
cabai	jiilaal	None
california	kaliforniya	Nan
cakung	cakung	Nan
cabangcabang	laanta	None
cabe	jiilaal	None
cacar	furuq	Nan
cacat	cilladaysan	Nan
cacing	dirxi	Nan
cadangan	keyd	Nan
cafe	kafeega	Nan
cagar	kaydka	None
cahaya	iftiin	Nan
cair	dareere	Nan
cairan	dheecaan	None
cak	cak	Nan
cakar	xajin	None
cakra	chakra	Nan
cakram	disc	None
cakupan	baaxadda	None
cape	daalay	Nan
bumn	baaluq	Nan
bumbu	xawaash	Nan
bsd	bsd	Nan
bsi	bsi	Nan
bu	ma&#39;am	Nan
buah	miro	Nan
buahbuah	miraha	None
buahbuahan	miraha	None
buahnya	midhaha	Nan
buana	dhulka	None
buang	tuur	None
buangan	xun	None
buat	ee	None
buatan	ahayn	None
buaya	yaxaas	Nan
bubar	diraan	None
bubat	xumbo	Nan
bruto	guud	None
bubuh	fuud	Nan
brunei	brunei	Nan
brown	bunni	Nan
brantas	brantas	Nan
brasil	baraasiil	Nan
brawijaya	brawijaya	Nan
brebes	sare	None
bridge	buundo	None
brigadir	guuto	Nan
brigjen	brigjen	Nan
britain	britain	None
britania	britain	None
britannica	britannica	Nan
british	garaacid	Nan
broadband	ballaadhan	None
broadcast	baahin	Nan
bromo	bromo	Nan
bronkodilator	bronchodilator	Nan
browser	biraawsarka	Nan
bumi	dhulka	None
bubuk	budo	Nan
budak	addoonsiga	Nan
buktibukti	cadayn	Nan
buku	buugga	None
bukubuku	buugaagta	None
bukunya	buugga	None
bulan	bishii	None
bulanan	kasta	None
bulanbulan	bishii	None
bulat	wareega	None
bulatan	goobaabin	Nan
buleleng	buleleng	Nan
buletin	qoraal	None
bulgaria	bulgaria	None
bulir	dhegaha	None
bulu	dhogorta	Nan
buluh	cawsduur	Nan
bukti	cadayn	Nan
bubur	boorash	Nan
bukittinggi	bukittinggi	Nan
bukhari	bukhaari	None
budaya	dhaqanka	None
budayanya	dhaqanka	None
buddha	buddha	Nan
buddhisme	buddhism	Nan
budha	buddha	Nan
budi	maanka	None
budidaya	beerista	Nan
budiman	gacaliye	Nan
bugis	cayayaanka	Nan
bujur	dhaadheer	None
buka	furan	None
bukaan	dhaqdhaqaaq	None
bukan	aha	None
bukanlah	ahan	None
bukannya	halkii	None
bukit	buuraha	None
capital	caasimada	None
caplak	sax	None
cara	dariiqa	Nan
cina	shiinaha	None
cincin	garaac	Nan
cincincincin	fardaha	None
cinema	shineemo	None
cinta	jacayl	None
cintanya	jacaylkiisa	Nan
cipta	abuuraan	Nan
ciptaan	abuurista	Nan
ciptaannya	abuurkiisa	Nan
ciputra	ciputra	Nan
circuit	wareeg	Nan
cirebon	saarbon	Nan
ciri	ahaan	None
ciriciri	garto	None
ciricirinya	astaamaheeda	Nan
cimahi	cimahi	Nan
cita	maanka	None
ciliwung	ciliwung	Nan
cilik	cunug	Nan
chola	chola	Nan
chouji	chouji	Nan
chris	chris	Nan
christ	kiristaan	None
christian	kiristaanka	Nan
chunin	chunin	Nan
chuunin	chuunin	Nan
ci	ci	Nan
cia	biyaa	Nan
ciamis	ciamis	Nan
cianjur	cianjur	Nan
cicero	cicero	Nan
cikal	horjooge	Nan
cilacap	cilacap	Nan
cilegon	cilegon	Nan
cilincing	cilincing	Nan
choice	doorashada	None
citacita	hami	Nan
citarum	citarum	Nan
college	kulliyad	Nan
columbia	columbia	Nan
com	com	Nan
common	ah	None
communication	isgaarsiinta	None
computer	kumbuyuutar	None
conan	conan	Nan
condong	caatada	Nan
conflict	dhac	None
constitution	dastuurka	None
contoh	tusaale	None
contohcontoh	tusaale	None
contohnya	tusaale	None
control	xakamayn	Nan
convention	shir	None
collection	ururinta	Nan
citacitanya	aragtidiisa	Nan
coklat	shukulaato	Nan
code	koodh	Nan
citra	muuqaal	Nan
city	magaalada	None
civil	ah	None
clan	qabiil	None
classic	ah	None
claude	cad	None
climate	cimilada	None
clinton	clinton	None
club	naadi	Nan
cmos	cmos	Nan
co	co	Nan
coal	dhuxul	None
coba	isku	None
cocok	habboon	None
cocos	cocos	Nan
cokelat	shukulaato	Nan
choh	choh	Nan
chiyo	chiyo	Nan
chip	chip	Nan
cedera	dhaawac	None
ceko	czech	Nan
cekungan	berkadda	Nan
celah	farqi	None
celana	surwaal	Nan
cell	qolka	Nan
celsius	celsius	Nan
cemaran	faddarayn	Nan
cemerlang	badan	None
cendana	sandalwood	Nan
cendekiawan	caaqil	None
cenderung	eg	None
cengkeh	ah	None
centauri	centauri	Nan
center	xarunta	None
cdrom	cdrom	Nan
center|px	|	None
cdma	cdma	Nan
cd+	+	None
caracara	dariiqa	Nan
caranya	sida	None
card	kaarka	Nan
cari	raadinaya	Nan
carl	carl	Nan
carlo	carlo	Nan
case	kiis	Nan
cassini	cassini	Nan
castro	castro	Nan
cat	rinjiga	None
catatan	qoraal	None
catatancatatan	qoraalada	None
catatannya	qoraalka	None
catur	chess	Nan
cd	cd	Nan
cdc	cdc	Nan
central	dhexe	None
cepat	dhakhso	None
cerah	dhalaalaya	Nan
channel	kanaal	None
chapter	cutubka	Nan
charles	gawaarida	Nan
charlie	charlie	Nan
charon	daacad	None
chart	shaxanka	Nan
che	che	Nan
chelsea	chelsea	Nan
chester	qallooc	Nan
chi	chi	Nan
chicago	chicago	Nan
chidori	chidori	Nan
chikungunya	chikungunya	Nan
chili	chile	Nan
china	shiinaha	None
change	beddel	Nan
chandra	chandra	Nan
champions	horyaalnimada	Nan
champion	horyaal	None
cerdas	badan	None
ceres	seeraha	Nan
ceria	faraxsan	None
cerita	sheeko	None
ceritacerita	sheeko-sheeko	Nan
ceritanya	sheekada	None
cermat	taxaddar	Nan
corporation	shirkad	None
cermin	muraayad	Nan
cetak	daabacan	Nan
cetakan	daabacan	Nan
cewek	gabadh	None
ch	ch	Nan
chad	chad	Nan
chairil	kursi	Nan
chakra	chakra	Nan
certified	caddeeyay	None
dicatat	xusuus	None
dicegah	hortagay	None
diceritakan	sheegay	None
ditempati	degay	None
ditempatkan	meeleeyay	Nan
ditempuh	safray	None
ditemui	kulmay	None
ditemukan	helay	None
ditemukannya	helay	None
ditentang	soo	None
ditentukan	go&#39;aamiyay	Nan
diterangkan	sharxay	Nan
diterapkan	codsatay	Nan
diterbitkan	la	None
diterima	helay	None
diterjemahkan	tarjumay	Nan
diteruskan	gudbay	None
ditetapkan	dhigay	None
ditelusuri	raacay	None
ditimbulkan	qasbay	None
diteliti	la	None
ditekankan	adkeeyay	Nan
ditaklukkan	laga	None
ditambah	daro	None
ditambahkan	daray	None
ditampilkan	bandhigay	None
ditanam	beeray	None
ditandai	lagu	None
ditandatangani	saaray	None
ditangani	hayo	None
ditangkap	qabtay	None
ditarik	jiiday	Nan
ditarikan	dheelid	Nan
ditawarkan	bandhigay	None
ditayangkan	hawada	None
ditegaskan	xaqiijiyay	Nan
ditekan	riixday	Nan
ditelan	liqay	Nan
ditahan	hakin	Nan
ditinggalkan	tagay	None
ditinjau	eegay	None
diubah	bedelay	None
diucapkan	hadal	None
diuji	tijaabiyey	Nan
diukur	lagu	None
diumumkan	dhawaaqay	None
diundang	casuumay	None
diunduh	dejiyay	None
diungkapkan	la	None
diuraikan	tilmaamay	None
diurus	is	None
diusahakan	dadaalay	Nan
diusir	laaday	Nan
diusulkan	jeediyay	None
divisi	qaybinta	Nan
diwajibkan	yahay	None
dituturkan	hadlay	None
ditingkatkan	hagaajiyay	Nan
ditutupi	daboolay	Nan
diturunkan	maray	None
ditjen	guud	None
ditolak	diiday	None
ditonton	daawaday	Nan
ditransmisikan	gudbiyo	Nan
dituangkan	ku	None
dituduh	eedeeyay	None
ditugaskan	loo	None
dituju	madax	None
ditujukan	talagalay	None
ditularkan	gudbiyo	Nan
ditulis	qoran	None
dituliskan	qoran	None
ditunjuk	magacaabay	None
ditunjukkan	tusay	Nan
dituntut	dacwooday	Nan
ditutup	xidhan	Nan
diwakili	matalay	Nan
ditafsirkan	tarjumay	Nan
disusul	dhaaftay	None
disamakan	isbarbar dhig	Nan
disambut	soo	None
disampaikan	loo	None
disamping	sokow	None
disana	halkaas	None
disangka	qaatay	None
disarankan	lagu	None
disatukan	isu	None
disease	cudur	None
diseases	cudurada	Nan
disebabkan	sababay	None
disebarkan	faafin	Nan
disebut	yaqaan	None
disebutkan	xusan	None
disebutsebut	xusan	None
disaksikan	ahaa	None
disederhanakan	fududeeyay	None
disajikan	u	None
disahkan	taageeray	Nan
direktorat	agaasinka	Nan
direktori	buugga	None
direktur	agaasime	None
direncanakan	qorsheeyay	Nan
diresmikan	furitaanka	Nan
diri	naftaada	Nan
dirilis	daayay	None
dirintis	u	None
dirinya	naftiisa	None
diriwayatkan	sheeko	None
dirugikan	waxyeelay	Nan
dirujuk	tixraac	None
dirumuskan	qaabeysay	Nan
disaat	xilligan	None
disadari	xaqiiqsaday	Nan
disain	naqshadeynta	Nan
disusun	abaabulay	None
disediakan	lasiiyay	Nan
diselamatkan	badbaadi	Nan
disintesis	isku	None
disiplin	edbin	Nan
disk	diskiga	Nan
diskografi	riwaayad	Nan
diskriminan	takoorid	Nan
diskriminasi	takoorid	Nan
diskusi	dood	None
displasia	cudurka	None
display	bandhig	Nan
disponsori	qaaday	None
distribusi	qaybinta	Nan
distrik	degmo	None
distro	leh	None
disukai	doorbiday	Nan
disuruh	sheegay	None
disini	halkan	None
disekitar	hareeraha	None
disingkat	soo	None
disimpan	badbaadiyey	None
diselenggarakan	qabtay	None
diselesaikan	la	None
diseluruh	dhan	None
disempurnakan	ah	None
disengaja	ah	None
disepakati	lagu	None
diserahkan	leexleexday	Nan
diserang	weeraray	None
diserap	nuugo	Nan
disertai	weheliyay	Nan
disertakan	ahaa	None
disesuaikan	hagaajiyay	Nan
disetujui	ogolaaday	None
disfungsi	cillad la&#39;aan	Nan
disiarkan	baahin	Nan
disimpulkan	soo	None
diwariskan	yaqaan	None
diwarnai	leh	None
diwujudkan	muujiyey	None
dynamic	firfircoon	None
e	e	None
earl	dheg	None
early	hore	None
eclipse	qorrax madoobaadka	Nan
economic	dhaqaale	None
economics	dhaqaalaha	None
economy	dhaqaalaha	None
ed	ed	Nan
edaran	wareegsan	None
edisi	daabacaad	Nan
edison	edison	Nan
edition	daabacaad	Nan
editor	tifaftire	Nan
education	waxbarasho	None
dx	dx	Nan
edward	edward	Nan
dwi	bi	Nan
duta	safiirka	None
duke	digaag	Nan
dukun	shaman	Nan
dukungan	taageero	None
dulu	dhaafay	None
dulunya	jiray	None
dumbledore	dumbledore	Nan
dunia	adduunka	None
duo	duo	Nan
dur	dur	Nan
durasi	muddo	None
duren	durian	Nan
duri	qodxan	Nan
durian	durian	Nan
duryodana	duryodhan	Nan
dusun	tuulo	None
dvd	dvd	Nan
duka	baroorta	Nan
efek	saamayn	Nan
efektivitas	waxtarka	Nan
eksentrisitas	eccentricity	Nan
eksis	jiraan	None
eksistensi	jiritaanka	None
eksklusif	ah	None
ekskresi	saafiga	Nan
ekspansi	fidinta	None
ekspatriat	qurbaha	None
ekspedisi	socdaal	None
eksperimen	tijaabin	Nan
eksperimental	ah	None
eksplisit	cadayn	Nan
eksploitasi	dhiig-miirashada	Nan
eksplorasi	sahaminta	Nan
ekspor	dhoofinta	Nan
eksportir	dhoofinta	Nan
eksekutif	fulinta	Nan
efektif	ah	None
eksekusi	dil	None
ekor	dabada	None
efesien	hufan	Nan
effendi	effendi	Nan
efisien	hufan	Nan
efisiensi	hufnaan	Nan
ego	ego	Nan
eiffel	eiffel	Nan
einstein	einstein	Nan
ejaan	higgaadinta	Nan
ejakulasi	kacsanaan	Nan
ekliptika	ecliptic	Nan
ekologi	xoolaha	None
ekonom	dhaqaaleyahan	Nan
ekonomi	dhaqaalaha	None
ekonominya	dhaqaalaheeda	Nan
ekonomis	dhaqaale	None
ekosistem	deegaanka	None
dugaan	male awaal	Nan
dufan	dufan	Nan
duet	duet	Nan
dokumendokumen	dukumiintiyada	Nan
dokumentasi	dukumiinti	Nan
dolar	dollar	Nan
dolly	dolly	Nan
domain	domain	Nan
domba	adhiga	None
domestik	gudaha	None
domestikasi	hoyga	None
dominan	xukumaa	Nan
dominasi	xukun	None
don	deeq	None
donald	donald	Nan
dong	fadlan	None
dongeng	sheeko	None
donor	deeq	None
dokumen	dokumenti	Nan
dont	ha	None
doktrin	caqiido	Nan
dokter	dhakhtar	Nan
diy	qurxiyo	Nan
diyakini	rumeeyey	Nan
djakarta	djakarta	Nan
djoko	djoko	Nan
dki	dki	Nan
dkk	al	None
dll	iwm	None
dmasiv	dmasiv	Nan
dna	dna	Nan
dns	dns	Nan
do	samee	Nan
doa	duco	None
dodol	cuqdad	Nan
dog	eey	None
dogs	eeyaha	Nan
doktor	dhakhtarnimada	Nan
door	albaabka	None
doraemon	doraemon	Nan
dorami	dorami	Nan
drastis	daran	None
dream	riyo	None
dretarastra	dretarastra	Nan
drive	wadista	Nan
driver	darawalka	Nan
drona	drona	Nan
dropadi	dropadi	Nan
drs	drs	None
drum	durbaan	None
dsb	iwm.	Nan
dsl	iwm.	Nan
dtp	dtp	Nan
du	du	None
dua	laba	None
duduk	fadhiiso	Nan
dramatis	riwaayad	Nan
drama	riwaayadaha	Nan
dram	dram	Nan
drainase	dheecaanka	Nan
dorong	riix	Nan
dorongan	dhiirigelin	None
dos	qaadasho	Nan
dosa	dembiga	None
dosen	macalin	None
dosis	qaadasho	Nan
douglas	douglas	Nan
direksi	agaasimayaasha	Nan
douwes	douwes	Nan
download	soo	None
dpd	dpd	Nan
dpr	dpr	Nan
dprd	dprd	Nan
dprmpr	dprmpr	Nan
dr	dr	None
draco	draco	Nan
down	hoos	None
direkrut	shaqaalaysiiyay	Nan
direkomendasikan	lagu	None
direkam	duubay	None
dijaga	ilaaliyo	None
dijajah	gumaysiga	None
dijalankan	orod	None
dijamin	qaaday	None
dijatuhkan	dhacay	None
dijelaskan	sharxay	Nan
dijual	iibka	Nan
dijuluki	lagu	None
dijumpai	helay	None
dikabarkan	xanta	None
dikaitkan	isku	None
dikaji	bartay	None
dikalahkan	adkaaday	None
dikalangan	ah	None
dikarenakan	ah	None
dijadikan	sameeyey	None
dikaruniai	barakeeyey	Nan
diizinkan	yahay	None
diiringi	weheliyay	Nan
dihindari	fogaado	None
dihisap	la	None
dihitung	tirin	None
dihormati	la	None
dihubungkan	xidho	None
dihukum	ciqaabay	Nan
dihuni	deganaan	Nan
diidentifikasi	tilmaamo	None
diikat	xidhxidhay	Nan
diikuti	raacay	None
diimplementasikan	hirgaliyay	Nan
diinduksi	qasbay	None
diingat	xasuusto	None
diinginkan	wacan	None
diintegrasikan	isku	None
diisi	buuxsamay	Nan
dihilangkan	saaray	None
dikatakan	yidhi	None
dikelilingi	hareereysan	None
dikirim	diray	None
dikirimkan	diray	None
dikisahkan	sheegay	None
diklaim	sheegatay	Nan
diklasifikasikan	saaray	None
diklat	tababarka	None
dikombinasikan	darka	None
dikompilasi	ururiyey	Nan
dikonsumsi	cunay	None
dikontrol	la	None
dikonversi	beddelay	Nan
dikotil	dicot	Nan
dikritik	lagu	None
dikuasai	badan	None
dikumpulkan	ururiyey	Nan
dikhususkan	huray	None
dikategorikan	sidii	None
diketuai	gudoomiya	Nan
dikerjakan	sameeyay	None
dikelola	maamulay	Nan
dikelompokkan	kooxeed	Nan
dikeluarkan	saaray	None
dikeluarkannya	la	None
dikembalikan	noqday	None
dikembangkan	horumaray	Nan
dikemudian	dambe	None
dikemukakan	hor	None
dikenai	xiran	None
dikenakan	xirtay	Nan
dikenal	yaqaan	None
dikenali	aqoonsado	None
dikendalikan	la	None
dikepalai	madax	None
dikeringkan	qallalay	Nan
diketahui	yaqaan	None
dihidupkan	shid	Nan
dihiasi	qurxin	Nan
dihentikan	la	None
didasarkan	ku	None
didatangkan	keenay	None
didaur	loo	None
didefinisikan	lagu	None
didengar	maqlo	None
diderita	xanuunsaday	None
didesain	talagalay	None
dideskripsikan	tilmaamay	None
dideteksi	ogaaday	None
didih	karkariyo	Nan
didik	ardayda	None
didirikan	aasaasay	None
didistribusikan	qaybiyey	Nan
didokumentasikan	caddeeyay	None
didominasi	xukumaa	Nan
didasari	ku	None
didorong	riixay	Nan
didapatkan	helay	None
didapat	helay	None
dicerna	dheefshiido	Nan
dicetak	daabacan	Nan
dicetuskan	kiciyay	Nan
diciptakan	abuuray	None
dicirikan	lagu	None
dicky	caaqil	None
dicoba	dayo	None
dictionary	qaamuus	None
diculik	la	None
didaerah	aagga	None
didaftarkan	diiwaangashan	Nan
didalam	ee	None
didalamnya	dhexdeeda	None
didampingi	weheliyay	Nan
didanai	maalgeliyey	Nan
didapati	heli	None
diduduki	degay	None
diduga	yahay	None
didukung	taageeray	Nan
digit	god	None
digital	ah	None
digolongkan	saaray	None
digunakan	loo	None
digunakannya	adeegso	Nan
dihadang	xannibay	Nan
dihadapi	wajahay	Nan
dihadiri	galay	None
dihancurkan	burburay	None
dihapus	la	None
dihapuskan	la	None
diharapkan	la	None
dihargai	qiimeeyay	Nan
diharuskan	yahay	None
dihasilkan	saaray	None
digerakkan	dhaqaaqay	None
digemari	doorbiday	Nan
digelar	qabtay	None
digantikan	bedelay	None
die	dhinto	None
diedarkan	wareegsan	None
dieksekusi	fuliyay	Nan
diekspresikan	muujiyey	None
dien	quus	Nan
dieng	dieng	Nan
diesel	naaftada	Nan
dikunjungi	booqday	None
diet	cuntada	None
diferensiasi	kala	None
difokuskan	saaray	None
difusi	fidin	None
digabungkan	darka	None
digambarkan	sawiran	None
diganggu	dhib	None
diganti	bedelay	None
diferensial	kala	None
bram	xabad	None
dikurangi	dhimay	Nan
dilacak	dabagashay	Nan
dipercepat	geliyay	None
diperdagangkan	baayacday	Nan
diperdebatkan	dooday	None
dipergunakan	adeegsado	None
diperhatikan	ilaali	None
diperhitungkan	la	None
diperiksa	hubiyay	Nan
diperingati	xuso	None
diperintah	amray	None
diperintahkan	amar	None
diperkenalkan	bandhigay	None
diperkirakan	qiyaasay	None
diperkuat	xoojiyay	Nan
diperlakukan	lagu	None
diperlihatkan	muujiyey	None
dipercayai	aamin	None
diperluas	ballaariyey	Nan
dipercaya	aaminay	Nan
diperbesar	weynaaday	Nan
dipasarkan	suuq	None
dipastikan	xaqiijiyay	Nan
dipecah	burburay	None
dipecahkan	xallin	Nan
dipecat	eryay	None
dipegang	qabtay	None
dipelajari	bartay	None
dipelihara	hayey	None
dipelopori	ahaa	None
dipeluk	xirtay	Nan
dipengaruhi	yeeshay	None
dipenuhi	oofiyey	Nan
diperankan	ciyaaray	None
diperbaharui	cusboonaysiin	Nan
diperbaiki	hagaajiyay	Nan
diperbolehkan	yahay	None
dipasang	rakibay	Nan
diperlukan	yahay	None
diperolehnya	helay	None
diproduksi	saaray	None
diproses	baaraandeg	Nan
dipublikasikan	la	None
dipukul	garaacay	None
dipungut	ururiyey	Nan
diputar	wareeray	Nan
diputuskan	la	None
diragukan	shaki	None
diraih	guuleystay	None
dirancang	loo	None
dirasakan	dareemay	None
dirawat	lagu	None
dirayakan	loo	None
direbut	qabtay	None
directory	buugga	None
diprediksi	saadaaliyay	Nan
diperoleh	helay	None
dipraktikkan	dhaqma	None
dipopulerkan	baahsan	Nan
dipersembahkan	bandhigay	None
dipersiapkan	diyaar	None
dipertahankan	hayey	None
dipertimbangkan	tixgelin	Nan
dipertuan	sayidka	None
diperuntukkan	talagalay	None
dipicu	kiciyay	Nan
dipilih	la	None
dipimpin	hogaamiyay	Nan
dipindahkan	dhaqaaqay	None
dipisahkan	kala	None
diplomasi	diblomaasiyadda	Nan
diplomatik	diblomaasiyadeed	Nan
dipol	halkiile	Nan
diponegoro	diponegoro	Nan
dipotong	jaray	None
dipantau	socdo	None
dipanggil	yeedhay	None
dipandang	arkay	None
diletakkan	dhigay	None
dilewati	gudbay	None
dilihat	arkay	None
dilindungi	ilaaliyo	None
dilintasi	gudbey	None
diluar	banaanka	None
diluncurkan	bilaabay	None
dilupakan	ha	None
dimainkan	ciyaaray	None
dimakamkan	aasay	None
dimakan	cunay	None
dimaksud	tixraac	None
dimaksudkan	talagalay	None
dimana	halkee	Nan
dimanfaatkan	adeegsado	None
dilepaskan	daayay	None
dimasukkan	galay	None
dilepas	kala	None
dilayani	u	None
dilafazkan	dhawaaqay	None
dilahirkan	dhashay	None
dilaksanakan	hirgaliyay	Nan
dilakukan	sameeyay	None
dilakukannya	wuu	None
dilalui	loo	None
dilambangkan	astaan	None
dilanda	by	None
dilangsungkan	qabtaa	None
dilanjutkan	xiga	None
dilantik	dhaariyay	Nan
dilapisi	leh	None
dilaporkan	sheegay	None
dilarang	mamnuucay	Nan
dilatih	la	None
dilengkapi	qalabeysan	Nan
dimenangkan	guuleystay	None
dimengerti	karo	None
dimensi	cabir	None
dinilai	lagu	None
dinobatkan	saaray	None
dinyanyikan	gabyaa	None
dinyatakan	sheegay	None
dioda	diode	Nan
diode	diode	Nan
dioksida	dioxide	Nan
diolah	baaraandeg	Nan
dioperasikan	shaqeeya	None
dipahami	fahmay	None
dipakai	xirtay	Nan
dipaksa	qasbay	None
dipaksakan	qasbay	None
dipanaskan	kululeynaya	Nan
dipancarkan	saaray	None
dinikmati	raaxaystay	Nan
dini	hore	None
dingin	qabow	None
dinding	darbiga	None
dimiliki	leh	None
dimilikinya	waxeey	None
diminta	codsaday	None
diminum	sakhraansan	Nan
dimodifikasi	laga	None
dimuat	xirmay	Nan
dimulai	bilaabmaa	Nan
dikutip	xigtay	None
dimulainya	bilowga	Nan
dimusnahkan	burburay	None
dinamai	dib	None
dinamakan	magacaabay	None
dinamika	dhaqdhaqaaq	None
dinamis	firfircoon	None
dinas	adeeg	None
dinasti	boqortooyadii	None
dimungkinkan	suurtagal	Nan
brahmana	brahmin	Nan
brahman	brahman	Nan
brahma	brahma	Nan
arthropoda	arthropod	Nan
arthur	arthur	Nan
arti	macnaha	None
artian	macnaha	None
artikel	maqaal	Nan
artileri	madaafiicda	Nan
artinya	waa	None
artis	fanaaniinta	None
artist	fanaaniinta	None
artistik	farshaxanimo	Nan
aru	aru	Nan
arus	hadda	None
arwah	ruux	None
arya	arya	Nan
as	us	None
artha	artha	Nan
as$	$	None
arteri	halbowlayaasha	Nan
art	fanka	None
aritmatika	xisaabinta	Nan
arjuna	arjuna	Nan
arkeolog	cilmu-nafte	Nan
arkeologi	cilmiga	None
armada	maraakiib	Nan
armenia	armenia	Nan
armijn	armijn	Nan
arnold	gabbaad	Nan
aroma	carafta	Nan
aromatik	udgoon	None
arpanet	arpanet	Nan
arrancar	qabanqaabiyaal	Nan
arsip	faylasha	Nan
arsitek	naqshadeeye	Nan
arsitektur	dhisme	None
artefak	farshaxanimada	Nan
aristoteles	aristotle	Nan
asal	ahaan	None
asalnya	ahaan	None
asisten	kaaliye	Nan
asli	ah	None
aslinya	ah	None
asma	neefta	Nan
asmara	jacayl	None
asoka	ashoka	Nan
asosiasi	urur	None
aspek	dhinac	None
aspekaspek	dhinacyada	None
aspirasi	hamiga	Nan
asrama	jiifka	Nan
assayyid	assayyid	Nan
astana	astaan	None
astenosfer	asthenosphere	Nan
asteroid	asteroid	Nan
asing	shisheeye	None
asalkan	lasiiyay	Nan
asin	cusbada	Nan
asilasi	acylation	Nan
asalusul	ahaan	None
asam	aashito	Nan
asamasam	dhanaan	None
asambasa	asambasa	Nan
asap	qiiqa	Nan
asas	mabda &#39;	Nan
asasi	ah	None
asean	asean	Nan
aseksual	asexual	Nan
aset	hanti	None
asetat	acetate	Nan
asetilkoa	acetylkoa	Nan
asia	aasiya	None
asian	aasiya	None
asih	jacayl	None
asimilasi	isdhaafsiga	Nan
astrofisika	astrophysics	Nan
arifin	arifin	Nan
ariel	ariel	Nan
antibiotik	antibiyootig	Nan
antibodi	antibody	Nan
antigen	antigen	Nan
antik	ah	None
antioksidan	antioxidant	Nan
antiretrovirus	antiretrovirus	Nan
antivirus	anti virus	Nan
anton	anton	Nan
antonio	antonio	Nan
antropologi	cilmu-nafsiga	Nan
anugerah	hadiyad	Nan
anus	futada	Nan
anwar	anwar	Nan
apa	maxay	None
apaapa	kasta	None
anti	anti	Nan
apabila	haddii	None
anthropologi	cilmu-nafsiga	Nan
antasari	antasari	Nan
animalia	xayawaan	None
animasi	animation	Nan
anime	anime	Nan
animisme	animism	Nan
anjing	eey	None
anna	anna	None
anoa	anoa	Nan
anorganik	inorganic	Nan
antar	gaarsiinta	None
antara	ah	None
antaranya	ah	None
antarbintang	gal	None
antariksa	booska	Nan
antariksawan	cosmonaut	Nan
antarmuka	ah	None
antena	anteeno	Nan
arif	badan	None
apakah	waa	None
apapun	wax	None
arafat	arafat	Nan
arah	jihada	Nan
arahan	tilmaamaha	Nan
arai	arai	Nan
arang	dhuxusha	None
aras	heer	None
arca	taallada	Nan
ardilla	ardilla	Nan
area	aag	Nan
areal	aag	Nan
arena	garoon	None
argentina	argentina	Nan
argumen	dood	None
argumentasi	dood	None
ari	ari	None
arabisrael	arabisrael	Nan
apalagi	weliba	None
arabia	arabia	Nan
ar	ar	None
aparat	qalab	None
apartheid	kala	None
apbn	gobolka	None
apel	apple	Nan
apem	apem	Nan
api	dab	None
aplikasi	codsi	None
apollo	raali	None
apoptosis	baqashada	Nan
app	appka	Nan
apple	tufaax	Nan
applications	codsiyada	Nan
april	abriil	None
aprilia	aprilia	Nan
apung	sabayn	Nan
arab	carab	None
astronom	astronomer	Nan
astronomi	cilmiga	None
astronomical	cilmiga	None
bahan	ah	None
bahanbahan	maaddooyinka	Nan
bahari	nautical	Nan
bahasa	af	None
bahasabahasa	luqadaha	None
bahasan	dood	None
bahaya	khatar	None
bahkan	xitaa	None
bahu	garabka	Nan
bahwa	taasi	None
baik	fiican	None
bait	lammaane	Nan
baja	birta	None
bajak	jeexjeexin	Nan
baju	dharka	None
bahagia	faraxsan	None
bakal	doonaa	None
bagus	fiican	None
baginda	sire	Nan
badannya	jirkiisa	Nan
badaruddin	badaruddin	Nan
baduga	baduga	Nan
badung	badung	Nan
baduy	baduy	Nan
bagaikan	jecel	None
bagaimana	sidee	None
bagaimanapun	ha	None
bagansiapiapi	bagapiapiapi	Nan
bagawan	wanaagsan	None
baghdad	baqdaad	None
bagi	ee	None
bagian	qayb	None
bagianbagian	qaybo	None
bagimu	adiga	None
baginya	isaga	None
badanbadan	jirka	None
bakar	gub	Nan
bakau	mangrove	Nan
ball	kubad	Nan
balok	laambad	Nan
balon	buufin	Nan
bambang	diidayg	Nan
bambu	bamboo	Nan
ban	daal	Nan
band	guutadii	Nan
banda	banda	Nan
bandar	bookie	Nan
bandara	diyaaradaha	None
banding	rafcaan	Nan
bandingkan	isbarbar dhig	Nan
bandung	faashad	Nan
bang	bangi	Nan
bangga	ku	None
baling-baling	soo-saare	Nan
bakat	hibo	None
balikpapan	balikpapan	Nan
bali	bali	Nan
bakmi	doofaar	None
bakn	dubay	Nan
bakrie	bakriir	Nan
baksa	qasbay	None
bakteri	bakteeriyada	Nan
bakti	cibaadada	None
baku	cayriin	Nan
bala	xoojinta	None
balada	ballaadhan	None
balado	balado	Nan
balai	hoolka	Nan
balap	orod	None
balapan	tartan	Nan
balas	celin	None
balasan	jawaab	Nan
balik	gadaal	None
badan	jirka	None
badak	wiyil	Nan
badai	duufaan	None
atmosfernya	jawigeeda	Nan
atom	atom	None
atomatom	atomatom	Nan
atraksi	soo	None
atribut	sifo	Nan
aturan	xeerarka	None
aturanaturan	xeerarka	None
au	au	Nan
audio	maqal	None
audit	xisaab	None
auditing	xisaabinta	Nan
aura	aura	Nan
aurora	aurora	Nan
aus	gaboobay	Nan
australia	australia	None
atmosfer	jawi	None
australian	australiyaan	Nan
atma	atma	Nan
atlet	orodyahan	Nan
astronomis	cilmiga	None
asuhan	daryeel	None
asuma	asuma	Nan
asumsi	mala awaal	Nan
asupan	qaadasho	Nan
asuransi	caymis	Nan
atap	saqafka	Nan
atas	dul	None
atasnya	dushiisa	Nan
atau	ama	None
ataupun	ama	None
athena	athena	Nan
atlantik	atlanta	Nan
atlantis	atlantis	Nan
atlas	atlas	Nan
atletik	fudud	None
austrasia	austrasia	Nan
austria	austria	Nan
austronesia	austronesia	Nan
azerbaijan	azerbaijan	Nan
azhar	azhar	Nan
aziz	aziz	Nan
ba	ba	None
bab	cutubka	Nan
babad	taariikhda	None
babak	badh	None
babi	doofaarka	Nan
babilonia	babylonia	Nan
babirusa	hog deerada	Nan
baby	cunug	Nan
baca	akhriso	None
bacaan	akhrinta	None
back	dib	None
bacteria	bakteeriyada	Nan
ayunan	wareejin	None
ayu	ayu	Nan
ayatayat	aayadaha	None
ayat	sadarka	Nan
autentikasi	xaqiijinta	Nan
autism	autism	Nan
autisme	autism	Nan
autotrof	autotroph	Nan
av	av	Nan
awak	shaqaalihii	None
awal	hore	None
angsa	goose	Nan
awalan	horgale	Nan
awam	jiifay	Nan
awan	daruur	Nan
award	abaalmarin	Nan
awards	abaalmarino	Nan
ayah	aabe	None
ayahnya	aabaheed	Nan
ayam	digaag	Nan
awalnya	hore	None
angola	angola	None
angkutan	gaadiid	None
angkor	angkor	Nan
agresif	badan	None
agrikultur	beeraha	None
agung	weyn	None
agus	agus	Nan
agustus	ogast	Nan
ah	ah	None
ahli	khabiir	None
ahlul	khabiir	None
ahmad	axmad	None
aidit	i	None
aids	gargaarka	None
air	biyo	None
airbus	diyaarad	Nan
airlangga	airlangga	Nan
airlines	diyaaradaha	None
agresi	gardarada	Nan
aizen	hawo	None
agraris	caaqil	None
ageng	ageng	Nan
advokat	u	None
aedes	aedes	Nan
aero	aero	Nan
aerobik	aerobics	Nan
affan	affan	Nan
affandi	affandi	Nan
afrika	afrika	None
ag	ag	None
agak	xoogaa	None
agama	diinta	None
agamaagama	diinta	None
agar	darteed	None
agen	wakiilka	None
agency	wakaalad	Nan
agenda	ajandaha	Nan
agnes	agnes	Nan
adu	mahad	None
ajaib	ah	None
ajar	baro	None
akrab	yaqaan	None
aksara	qoraal	None
akses	marin	None
aksi	ficil	None
akson	axon	Nan
akta	camal	None
aktif	firfircoon	None
akting	jilitaanka	Nan
aktiva	hantida	None
aktivasi	waxqabadka	Nan
aktivator	firfircoon	None
aktivis	u	None
aktivitas	waxqabadka	Nan
aktivitasaktivitas	waxqabadka	Nan
aktivitasnya	hawlaheeda	Nan
akibatnya	keentay	None
ajang	dhacdada	Nan
akibat	cawaaqib	Nan
akhiran	dabakhaadhuf	Nan
ajaran	waxbarista	Nan
ajarannya	waxbaristiisa	Nan
ajax	ajax	Nan
aji	aji	Nan
akademi	akadeemiyada	Nan
akademik	tacliin	None
akademis	tacliin	None
akal	sabab	None
akan	doonaa	None
akar	xidid	None
akarakar	calakar	Nan
akatsuki	akatsuki	Nan
akbar	awoowe	None
akhir	dhamaadka	None
akhirakhir	dhamaadka	None
akhirnya	ugu	None
adsl	adsl	Nan
adolf	adolf	Nan
adobe	adobe	Nan
abidin	abidin	Nan
abiotik	abiotic	Nan
abjad	alifbeetada	Nan
abnormal	ahayn	None
aborsi	soo	None
abortion	soo	None
abortus	soo	None
about	saabsan	None
abraham	abraham	Nan
abri	abri	Nan
absolut	ahaanba	None
abstrak	aan	None
abstraksi	diidmada	None
abu	dambaska	Nan
abuabu	cirro	None
abi	abi	Nan
abul	abul	None
abendanon	abendanon	Nan
abdulmalik	abdulmalik	Nan
+	+	None
<	&lt;	Nan
=	=	None
ab	ab	None
abad	qarnigii	None
abadi	ah	None
abang	walaal	None
abarai	abarai	Nan
abbas	abbot	Nan
abbasiyah	abbasiyah	Nan
abbasiyyah	abbasiyyah	Nan
abc	c	None
abdi	addoon	None
abdul	abdul	None
abdullah	abdullah	None
abdurrahman	abdurrahman	Nan
ac	qaboojiyaha	Nan
acak	random	Nan
acara	dhacdo	None
adaptif	la	None
adapun	sida	None
adat	caado	None
address	cinwaanka	None
adegan	goobta	None
adi	adi	None
adidas	adidas	Nan
adik	walaasha	Nan
adiknya	yar	None
adiktif	qabatinka	Nan
adil	ah	None
adipati	digaag	Nan
administrasi	maamulka	None
administratif	maamul	None
administrator	maamulaha	None
adaptasi	qabsashada	None
adanya	waa	None
adams	adams	Nan
adam	adam	None
acaraacara	dhacdo	None
accelerator	xawaare	Nan
access	marin	None
account	koonto	Nan
accountant	xisaabiye	Nan
accountants	xisaabiyeyaal	Nan
accounting	xisaabinta	Nan
aktor	jilaa	None
ace	yar	None
achmad	achmad	Nan
acid	aashito	Nan
act	fal	None
acuan	tixraac	None
ad	xayeysiis	Nan
ada	jira	None
adalah	waa	None
aceh	aceh	Nan
bangka	fart	Nan
aktris	jilaa	None
akumulasi	uruurinta	Nan
amsterdam	amsterdam	Nan
an	a	None
anaerobik	anaerobic	Nan
anak	cunug	Nan
anakanak	carruurta	None
anakanaknya	carruurtiisa	None
anaknya	wiilkiisa	None
anal	falaqsan	Nan
analis	falanqeeye	Nan
analisis	falanqaynta	Nan
analog	analog	Nan
anang	marwo	None
anarki	fowdo	Nan
anarkisme	xasuuq	None
anatomi	anatomy	Nan
ampera	ampera	Nan
anbu	anbu	Nan
ampel	ampel	Nan
amir	amir	None
amatir	hiwaayadda	Nan
ambang	marinka	None
ambarawa	ambarawa	Nan
ambil	qaadan	None
ambon	ambon	Nan
amdal	amdal	Nan
america	ameerika	None
american	ameerika	None
amerika	ameerika	None
ami	amy	Nan
amien	aamiin	Nan
amik	xijaab	Nan
amin	aamiin	Nan
aminah	aminah	Nan
amino	amino	Nan
amonia	ammonia	Nan
amati	fiirso	Nan
ancaman	hanjabaad	Nan
ancient	ah	None
anggota	xubin	None
anggotaanggota	xubnaha	None
anggotaanggotanya	xubnaheeda	Nan
anggotanya	xubnaheeda	Nan
anggrek	orchid	Nan
anggun	badan	None
anggur	canab	Nan
angin	dabayl	Nan
angiospermae	anjioosiyada	Nan
angka	tirada	None
angkaangka	lambarada	Nan
angkasa	booska	Nan
angkat	u	None
angkatan	xoog	None
angklung	angklung	Nan
anggaran	miisaaniyadda	Nan
ancelotti	ancelotti	Nan
anggapan	mala awaal	Nan
angel	malaa&#39;ig	Nan
ancol	ancol	Nan
and	iyo	None
anda	adiga	None
andalan	weyn	None
andalannya	calanka	None
andesit	andesite	Nan
andi	aniga	None
andil	wadaag	Nan
andorra	andorra	None
andrea	andrea	Nan
andrew	andrew	Nan
android	android	Nan
aneh	leh	None
aneka	duwan	None
anemia	dhiig	None
angeles	xanaaq	Nan
amat	aad	None
amandemen	ka	None
amanda	amanda	Nan
alat	qalab	None
alatalat	qalab	None
albania	albania	None
albert	albert	Nan
alberto	alberto	Nan
album	album	Nan
albumnya	albumka	Nan
aldo	aldo	Nan
alel	qiil	Nan
alergi	xasaasiyad	Nan
alex	alex	Nan
alexander	alexander	Nan
alexandria	alexandria	Nan
alfred	alfred	Nan
alga	algae	Nan
alasannya	sababta	None
algoritma	algorithm-ka	Nan
alasan	sabab	None
alan	alan	Nan
akun	koonto	Nan
akuntan	xisaabiye	Nan
akuntansi	xisaabinta	Nan
akurasi	saxsanaanta	Nan
akurat	ah	None
akustik	acoustic	Nan
akut	aniga	None
al	al	None
ala	ala	None
alakbar	alakbar	Nan
alam	ah	None
alamat	cinwaanka	None
alamatalamat	cinwaanka	None
alami	ah	None
alamiah	ah	None
alas	lugta	None
ali	cali	None
aliansi	isbahaysi	Nan
alias	magac	None
alquran	al-qur&#39;aan	Nan
also	kale	None
alternatif	kale	None
alu	cayayaan	Nan
aluminium	aluminium	Nan
alumni	qalinjabiyeyaasha	Nan
alunalun	alunalun	Nan
alur	shirqool	None
alveolata	alveolata	Nan
alwi	alwi	Nan
alzheimer	alzheimer	Nan
am	am	None
amal	sadaqo	None
aman	aamin	None
amanat	waajib	None
alpha	alfa	Nan
alpen	alps	Nan
alokasi	qoondaynta	Nan
almarhum	daahay	None
alien	shisheeyaha	Nan
align	is	None
alih	dhaaftay	None
alimam	alimam	Nan
aliran	nooc	None
aliranaliran	durdurro	Nan
aljabar	aljebrada	Nan
aku	aniga	None
aljazair	algeria	Nan
alkana	alxamdiid	Nan
alkil	alkyl	Nan
alkimia	xumaha	Nan
alkitab	baybalka	None
alkohol	khamriga	Nan
allah	ilaahow	Nan
allen	hiil	None
alkali	alkali	Nan
eksposisi	muujinta	Nan
bangkai	bakhtigu	Nan
bangkit	kacaan	None
berpuasa	soon	None
berpurapura	iska	None
berpusat	xudun	Nan
berputar	lafdhabarta	None
berputra	wiil	None
bersabda	yidhi	None
bersahabat	leh	None
bersaing	tartami	None
bersalah	dambiile	Nan
bersalin	dhalmada	Nan
bersama	wada	None
bersamaan	mar	None
bersamasama	wada	None
bersangkutan	ka	None
bersatu	midayn	Nan
berpotensi	ah	None
bersaudara	walaalo	None
berpisah	kala	None
berpindah	dhaqaaq	None
berotasi	wareejin	None
berpakaian	xidho	None
berpartisipasi	kaqeybgal	Nan
berpasangan	labo-labo	Nan
berpegang	xaji	None
berpendapat	dooday	None
berpenduduk	weyne	None
berpengalaman	leh	None
berpengaruh	gal	None
berperan	ciyaar	None
berperang	dagaalka	None
berperilaku	dhaqan	None
berperioda	muddo	None
berpidato	ka	None
berpikir	ka	None
berpindahpindah	dhaqaaq	None
berorientasi	ku	None
bersayap	garabka	Nan
bersejarah	ah	None
bertahap	tartiib tartiib	Nan
bertahuntahun	badan	None
bertajuk	dhigay	None
bertambah	kordhiyo	None
bertambahnya	kordhinta	None
bertanding	tartami	None
bertanggung	noqo	None
bertanggungjawab	noqdo	None
bertanya	weydiinaya	Nan
bertapa	xidho	None
bertarung	la	None
bertekad	go&#39;aamiyay	Nan
bertekanan	cadaadis	None
berteman	saaxiibo samee	Nan
bertempat	degay	None
bertahan	dambeeya	None
bersedia	diyaar	None
bertabrakan	dhaca	None
berstatus	xaalad	Nan
bersekolah	aad	None
bersekutu	saaxiibtinimo	None
bersel	qolka	Nan
bersemangat	farax	None
bersemayam	deganaanshaha	Nan
bersembunyi	dhuumasho	None
bersenjata	hubaysan	None
bersepakat	ogolaado	Nan
bersiap	diyaar	None
bersifat	waa	None
bersih	ah	None
bersikap	dhaqan	None
bersinar	iftiin	Nan
bersinyal	signaled	Nan
berskala	cabir	None
bersumber	dhanaan	None
bertempur	dagaal	None
beroperasi	shaqee	Nan
bernyanyi	heesaa	None
berkuda	fardo	None
berkulit	maqaar	Nan
berkumpul	urursada	Nan
berkunjung	booqasho	Nan
berkurang	dhimay	Nan
berkurangnya	dhimay	Nan
berlainan	duwan	None
berlaku	karo	None
berlakunya	dhaqangelinta	Nan
berlalu	gudbay	None
berlandaskan	ku	None
berlangganan	rukumo	Nan
berlangsung	meel	None
berlangsungnya	soco	None
berlanjut	socdaa	None
berkuasa	awooda	None
berlapis	jilicsan	None
berkualitas	tayo	None
berkonsentrasi	xooga	None
berkedudukan	domicile	Nan
berkekuatan	leh	None
berkelana	warwareega	Nan
berkelanjutan	waara	Nan
berkeley	berkeley	Nan
berkeliling	hareeraha	None
berkelompok	ahaan	None
berkembang	horumarinta	None
berkembangnya	horumarinteeda	Nan
berkenaan	saabsan	None
berkepanjangan	dheeraaday	Nan
berkisah	sheekooyinka	None
berkisar	duwan	None
berkompetisi	tartamaya	Nan
berkomunikasi	xiriir	None
berkontribusi	ku	None
berolahraga	jimicsi	Nan
berlari	orod	None
berlatih	dhaqan	None
bermotor	mooto	Nan
bermuara	fuulo	Nan
bermuatan	eedeeyay	None
bermuda	bermuda	Nan
bermukim	degay	None
bermula	bilaabay	None
bermunculan	u	None
bermutu	tayo	None
bernada	meeleeyay	Nan
bernafaskan	neefsasho	Nan
bernama	magacaabay	None
bernapas	neefsasho	Nan
berniat	tahay	None
bernilai	mudan	None
bernuansa	nuugnaa	Nan
berminat	xiiseynaya	Nan
berlatar	dhigay	None
bermigrasi	haajiraan	Nan
bermasyarakat	ahaan	None
berlawanan	soo	None
berlayar	doonta	None
berlebih	ah	None
berlebihan	buunbuuniyay	Nan
berlian	dheeman	Nan
berlin	berlin	Nan
berlindung	dabool	Nan
berlokasi	habboon	None
bermacam	duwan	None
bermacammacam	ah	None
bermain	ciyaaray	None
bermakna	leh	None
bermaksud	jeedaa	None
bermanfaat	leh	None
bermassa	tiro	None
bermesin	xardhan	Nan
bertemu	kulan	None
bertentangan	is	None
bertepatan	beegan	None
biosintesis	biosynthesis	Nan
bioskop	shineemo	None
bioteknologi	bayoolaji	Nan
biotik	noolaha	None
bir	biir	None
birma	burma	None
biro	xafiiska	None
birokrasi	bureaucracy	Nan
biru	buluug	Nan
bisa	karaa	None
bisnis	ganacsiga	None
bit	xoogaa	None
bizantium	byzantine	Nan
bj	bj	Nan
bksap	bksap	Nan
bios	noolaha	None
blackberry	blackberry	Nan
biologis	noolaha	None
biola	violin	Nan
bill	biil	Nan
bima	bima	Nan
bimbingan	hanuun	None
bin	wiil	None
bina	dhisaan	None
binatang	xayawaanka	Nan
biner	binary	Nan
bintan	bintan	Nan
bintang	xiddig	Nan
bintangbintang	xiddigo	Nan
binti	bint	Nan
bintik	dhibco	Nan
bioetika	noolaha	None
biografi	nololeed	None
biokimia	bayoolajiga	Nan
biologi	bayoolaji	Nan
bilik	halbeega	Nan
bleach	warankiilo	Nan
block	xannib	Nan
bonang	bonang	Nan
bonaparte	bonaparte	Nan
bondowoso	bondowoso	Nan
bone	laf	None
boneka	caruusad	Nan
bonjol	knurl	Nan
books	buugaagta	None
boot	kabaha	None
borneo	borneo	Nan
borobudur	borobudur	Nan
botani	doofaar	None
botol	dhalo	Nan
bpd	bpd	Nan
bpk	cpc	Nan
bpupki	bpupki	Nan
bom	bambo	Nan
blitar	blitar	Nan
bolu	isbuunyo	Nan
boleh	karaa	None
blog	barta	None
blok	xannib	Nan
blood	dhiig	None
blora	blora	Nan
blue	buluug	Nan
bni	bni	None
bob	bob	Nan
bodoh	ah	None
body	jirka	None
boediono	boediono	Nan
boeing	caajiska	Nan
bogor	bogor	Nan
bojonegoro	bojonegoro	Nan
bola	kubad	Nan
bolakbalik	gadaal	None
bolivia	bolivia	Nan
bilangan	tirada	None
bilang	dheh	None
bila	goorma	Nan
berukuran	cabbir	Nan
berulang	badan	None
berulangulang	badan	None
berumur	da	None
berundak	jaranjarada fuul	Nan
berupa	ah	None
berupaya	dadaal	None
berurutan	si	None
berusaha	dayay	None
berusia	da	None
bervariasi	duwan	None
berwarna	leh	None
berwenang	idman	Nan
berwujud	karo	None
besar	weyn	None
berujung	tirtiray	Nan
besaran	cabir	None
berubahubah	beddel	Nan
berubah	beddel	Nan
bertindak	fal	None
bertingkat	darajayn	Nan
bertitik	dhibic	Nan
bertiup	afuufa	Nan
bertolak	kaxayso	Nan
bertopik	jooniska	Nan
bertubuh	xaydh	Nan
bertugas	shaqada	None
bertujuan	ujeedada	None
bertukar	sarrifka	Nan
bertulang	xoojiyay	Nan
bertuliskan	waa	None
bertumbuh	koraan	Nan
bertumpu	naso	Nan
berturutturut	isku	None
berubahnya	beddelo	None
besarbesaran	haa	None
besarnya	weynaanta	Nan
beserta	weheliso	Nan
biaya	qiimaha	None
bibir	dibnaha	Nan
bibit	abuurka	Nan
bicara	hadalka	None
bidadari	malaa&#39;ig	Nan
bidang	duurka	None
bidangbidang	beeraha	None
big	weyn	None
bijak	badan	None
bijaksana	badan	None
biji	abuur	Nan
bijibiji	abuurka	Nan
bijinya	abuurka	Nan
bijuu	bijuu	Nan
biksu	wadaad	None
biawak	kormeeraha liifka	Nan
biasanya	ah	None
biasa	ah	None
biarkan	ahaato	None
besi	bir	None
besinyal	signaled	Nan
beta	beta	Nan
betapa	sida	None
betawi	betawi	Nan
betina	dhedig	Nan
beton	karo	None
berkecepatan	xawaare	Nan
bhagawadgita	bhagawadgita	Nan
bharata	bharata	Nan
bharatayuddha	bharatayuddha	Nan
bhinneka	bhinneka	Nan
bhre	bhre	Nan
bi	bi	Nan
biak	ku	None
biara	keniisad	Nan
bhakti	cibaadada	None
berkebudayaan	abaabulay	None
berkebangsaan	dhalasho	None
berkata	yidhi	None
becak	rickshaw	Nan
beda	duwan	None
bedah	qalliin	Nan
bee	shinni	Nan
begitu	sidaas	None
beijing	beijing	Nan
bekas	hore	None
bekasi	bekasi	Nan
bekerja	shaqada	None
bekerjasama	iskaashi	None
beku	barafoobay	Nan
bela	difaaco	Nan
beladiri	is-difaaca	Nan
belah	go	None
belahan	hemisphere	Nan
beberapa	qaar	None
belajar	baro	None
bebek	digaag	Nan
bebas	ah	None
bayar	bixin	None
bayaran	bixinta	None
bayern	bavaria	Nan
bayi	cunug	Nan
bayu	bayu	Nan
bb	bb	Nan
bbc	bbc	None
bbm	bbm	Nan
bc	bc	Nan
be	noqon	None
bea	waajibka	None
beagle	gorgor	None
beasiswa	waxbarasho	None
beat	garaacid	Nan
beban	rar	Nan
bebatuan	dhagaxyada	Nan
bayangan	hooska	Nan
belaka	ah	None
belakangan	dambe	None
benci	nacayb	None
benda	shay	None
bendabenda	walxaha	Nan
bendera	calanka	None
bendungan	biyo	None
bengawan	leh	None
benggala	bengal	Nan
bengkulu	bengkulu	Nan
bening	caddee	Nan
bensin	shidaal	None
bentang	dhareer	Nan
benteng	qalcaddii	Nan
bentuk	qaab	None
bentukan	sameynta	Nan
bentukbentuk	qaababka	None
bench	keydka	Nan
belakang	dib	None
bencana	musiibo	Nan
benar	sax	None
belakangnya	gadaashiisa	Nan
belanda	nederland	None
belanja	dukaamaysiga	Nan
belas	naxariis	None
belasan	toban	None
belerang	baaruud	Nan
belgia	beljamka	Nan
beli	iibso	None
beliau	isagu	None
belitung	belitung	Nan
bell	gambaleel	Nan
bella	bella	Nan
belum	wali	None
ben	ben	Nan
benang	yarn	Nan
benarbenar	ahaantii	None
bawang	basal	Nan
bawahnya	hoosta	None
bawahan	hoosaad	None
bantuan	i	None
bantul	bantul	Nan
banyak	badan	None
banyaknya	badan	None
banyumas	banyumas	Nan
banyuwangi	banyuwangi	Nan
bapak	aabe	None
bara	ember	Nan
barakuda	barracuda	Nan
barang	alaabada	Nan
barangbarang	alaabada	Nan
barangkali	laga	None
barangsiapa	kii	None
barat	galbeed	None
barcelona	barcelona	Nan
bantu	i	None
baris	xariiq	Nan
banteng	dibi	None
bankbank	bangiga	None
bangkitnya	kaca	None
bangkok	bangkok	Nan
bangladesh	bangaladesh	Nan
bangsa	qaran	None
bangsabangsa	qaran	None
bangsawan	leh	None
bangun	toos	None
bangunan	dhisme	None
bangunanbangunan	dhismayaasha	None
bani	bani	None
banjar	banjar	Nan
banjarmasin	banjarmasin	Nan
banjir	daad	None
bank	bangiga	None
bankai	bankai	Nan
banten	bixin	None
barisan	safka	Nan
barito	barito	Nan
baru	cusub	None
batasbatas	xuduudaha	None
batavia	batavia	Nan
baterai	baytariga	Nan
batik	batik	Nan
batin	gudaha	None
bats	fiidmeerta	Nan
batu	dhagax	None
batuan	weyn	None
batubara	dhuxul	None
batubatu	dhagxaanta	Nan
batuk	qufac	Nan
batutulis	qoray	None
bau	ur	None
bawaan	caadi	None
bawah	hooseeya	None
batasan	soohdin	Nan
batas	xad	None
batara	ilaah	None
batang	jirridda	Nan
barubaru	dhow	None
barulah	markaa	None
barunya	cusubi	None
barus	hadda	None
basa	saldhigyada	Nan
basah	qoyan	Nan
basal	dhibicsan	Nan
bentuknya	qaabka	None
base	saldhig	None
basic	ah	None
basis	saldhig	None
basket	koleyga	None
basuki	basuki	Nan
bata	leben	Nan
batak	batak	Nan
batam	batam	Nan
baseball	koleyga	None
bangkalan	bangkalan	Nan
benturan	dhac	None
benuaq	continentalq	Nan
berevolusi	isbeddel	Nan
berfikir	fikirka	Nan
berfirman	yidhi	None
berfokus	saaray	None
berfungsi	shaqo	None
bergabung	biir	None
berganda	badan	None
berganti	beddel	Nan
bergantian	taa	None
bergantung	ku	None
bergaya	quruxsan	None
bergelar	lahaansho	Nan
bergerak	dhaqaaq	None
bergeser	wareejin	None
berguna	leh	None
bereproduksi	dhalid	Nan
berhadapan	waji	None
berenergi	firfircoonaan	Nan
berenang	dabaasha	Nan
berdaulat	boqornimo	Nan
berdaun	caleenta	Nan
berdaya	awood	None
berdebat	dood	None
berdekatan	xir	None
berdiam	joog	None
berdiameter	dhexroor	Nan
berdiri	istaag	Nan
berdirinya	aasaasid	Nan
berdoa	duceeya	Nan
berdosa	dembaabay	Nan
berdua	labadaba	None
bereaksi	falcelin	Nan
beredar	wareejin	None
berekor	go&#39;ay	Nan
berencana	qorsheeyay	Nan
berdasarkan	ku	None
berhak	leeyahay	None
berharap	rajo	None
berjalannya	maraa	None
berjanji	qaad	None
berjarak	fogaan	Nan
berjasa	leh	None
berjenis	badan	None
berjiwa	huur	Nan
berjuang	la	None
berjudul	cinwaanka	None
berjumlah	xaddiga	Nan
berkaitan	xiriira	None
berkala	mar	None
berkalikali	badan	None
berkas	feyl	Nan
berkaspramuka	faylka kormeerka	Nan
berkat	mahadsanid	Nan
berjalan	soco	None
berhala	sanamyada	Nan
beritaberita	war	None
beristirahat	nasasho	Nan
berharga	leh	None
berhasil	way	None
berhenti	jooji	Nan
berhubungan	xiriira	None
beribadah	cibaadada	None
beribukota	madax	None
berikatan	xidh	None
beriklim	dabacsan	Nan
berikut	socda	None
berikutnya	xiga	None
beriman	iimaan	None
berinteraksi	is	None
berisi	kooban	None
berisikan	kooban	None
berisiko	ah	None
berita	news	None
berdasar	saldhig	None
berdarah	dhiiga	Nan
berdampingan	dhinac	None
beranggapan	qaadan	None
beranggotakan	leeyihiin	None
berangkat	ka	None
berangsurangsur	tartiib tartiib	Nan
berani	ah	None
beranjak	dhaqaaq	None
berapa	immisa	Nan
berapi	holac	Nan
berarti	waa	None
beras	bariis	None
berasal	ahaan	None
berasosiasi	iskaashi	None
berat	culeys	Nan
beratnya	culeyska	Nan
beraturan	ah	None
beraneka	duwan	None
berau	berau	Nan
beranak	leeyihiin	None
beraliran	garabka	Nan
benyamin	benyamin	Nan
bepergian	safarka	None
berabadabad	qarniyo	None
beracun	ah	None
berada	jiraan	None
beradab	ilbaxnimo	Nan
beradaptasi	is	None
beragam	duwan	None
beragama	diinta	None
berakar	xidid	None
berakhir	dhammaad	Nan
berakhirnya	dhamaadka	None
berakibat	sababay	None
beraksi	ahaan	None
beralih	beddelo	None
berambut	xiiray	None
berawal	bilaabay	None
berbagai	duwan	None
berbagi	la	None
berbunga	ubax	None
berbunyi	akhriyaa	Nan
berburu	ugaarsi	Nan
bercabang	laan	None
bercahaya	dhalaalaya	Nan
bercampur	isku	None
bercerai	furay	None
bercerita	sheekooyinka	None
bercinta	sameeyo	None
bercitacita	himilo	Nan
bercocok	beeraha	None
bercorak	qaabaysan	Nan
berdagang	ganacsiga	None
berdaging	jilicsan	None
berdampak	yeeshaan	None
berbulu	leh	None
berbuka	soonka	None
berbuat	samee	Nan
berbiji	abuur	Nan
berbahan	sameeyay	None
berbahasa	hadal	None
berbahaya	ah	None
berbakat	leh	None
berbalik	soo	None
berbanding	isbarbar dhig	Nan
berbangsa	qaran	None
benua	qaaradda	None
berbaring	jiifsaday	Nan
berbatasan	xadka	None
berbau	urinta	Nan
berbayar	bixiyay	None
berbeda	duwan	None
berbedabeda	duwan	None
berbentuk	qaabeeyaa	Nan
berbicara	hadal	None
berbasis	ku	None
ekspresi	muujinta	Nan
eksternal	dibedda	None
ekstra	ah	None
kenyataan	xaqiiqada	None
kenyataannya	xaqiiqda	None
kep	kep	Nan
kepada	ku	None
kepadanya	iyada	None
kepadatan	cufnaanta	Nan
kepahlawanan	geesinimo	None
kepala	madaxa	None
kepalanya	madaxiisa	Nan
kepanduan	baadi	None
kepastian	hubaal	None
kepemilikan	lahaansho	Nan
kepemimpinan	hogaaminta	Nan
kepemimpinannya	hogaankiisa	Nan
kependekan	gaaban	None
kenya	kenya	None
kependudukan	dadka	None
kentang	baradhada	Nan
kenny	kenyan	Nan
kena	garaacid	Nan
kenaikan	kordhiyo	None
kenal	ogaada	Nan
kenampakan	muuqaal	Nan
kenangan	xusuusta	Nan
kencana	kenya	None
kencang	adkeyn	Nan
kencing	piss	Nan
kendala	caqabadaha	Nan
kendali	xakamayn	Nan
kendaraan	gaari	None
kendati	oo	None
kenegaraan	dowladnimada	Nan
kenikmatan	raaxo	None
kenneth	kenneth	Nan
kental	weyn	None
ken	ken	Nan
kepentingan	danaha	Nan
keperawatan	caafimaad	None
keragaman	kala	None
kerah	collar	Nan
kerajaan	boqortooyada	None
kerajaankerajaan	boqortooyada	None
kerajaannya	boqortooyadiisa	Nan
kerajinan	farsamada	None
kerak	qolof	Nan
kerakyatan	populist	Nan
keramik	dhoobada	Nan
kerang	clam	Nan
kerangka	qaab	None
keranjang	dambiil	Nan
kerap	badanaa	None
kerapatan	cufnaanta	Nan
keras	adag	None
keracunan	sumayn	Nan
kepentingannya	muhiimadeeda	Nan
kerabat	qaraabo	Nan
keputusan	go’aan	Nan
kepercayaan	aamin	None
keperluan	daruuri	Nan
keping	qori	None
kepolisian	booliska	None
kepompong	cocoon	Nan
kepopuleran	caan	None
keppres	madaxweynaha	None
kepramukaan	baadi	None
kepresidenan	madaxtooyada	None
kepribadian	shaqsiyan	Nan
kepuasan	qanacsanaanta	Nan
kepulauan	jasiirad	None
kepunahan	baabi&#39;inta	Nan
kepustakaan	suugaanta	None
keputihan	dheecaanka siilka	Nan
kera	daanyeer	Nan
keraton	qasriga	Nan
kemungkinan	suurtagal	Nan
kemunculan	soo	None
kelengkapan	dhameystir	Nan
kelenjar	qanjir	Nan
kelenteng	macbudka	Nan
kelihatan	muuqda	None
kelihatannya	u	None
keliling	hareeraha	None
kelima	shanaad	None
kelinci	bakayle	Nan
keliru	khalad	Nan
kelompok	koox	None
kelompokkelompok	kooxaha	None
kelompoknya	kooxdiisa	Nan
kelopak	xayawaannada	Nan
keluar	ka	None
keluaran	saar	None
kelembapan	qoyaan	Nan
keluarga	reerka	None
kelembaban	qoyaan	Nan
kelelahan	daal	Nan
kelak	dambe	None
kelakuan	dhaqan	None
kelamin	galmada	Nan
kelancaran	jilicsanaan	Nan
kelangkaan	yaraanta	Nan
kelangsungan	sii	None
kelanjutan	sii	None
kelantan	kelantan	Nan
kelapa	qumbaha	Nan
kelaparan	gaajo	None
kelarutan	solubility	Nan
kelas	fasalka	Nan
kelaskelas	fasalka fasalka	Nan
kelautan	badda	None
kelebihan	faa&#39;iidooyinka	Nan
kelemahan	daciifnimo	Nan
kemunduran	dhac	None
keluarganya	qoyskiisa	Nan
keluhan	cabasho	Nan
kembang	ubax	None
kembar	mataano	Nan
kemenangan	guul	None
kementerian	wasaaradda	None
kementrian	wasaaradda	None
kemerahan	guduudan	Nan
kemerdekaan	madaxbanaanida	None
kemerdekaannya	madaxbanaanideeda	Nan
kemih	kaadi mareenka	Nan
kemiringan	dhaadheer	None
kemiripan	eg	None
kemiskinan	saboolnimada	Nan
kemitraan	iskaashi	None
kemudahan	fudayd	Nan
kemudian	markaa	None
kembalinya	noqo	None
keluarnya	dheecaan	None
kembali	dib	None
kematiannya	dhimashadiisa	Nan
kelurahan	tuulada	None
kelvin	kelvin	Nan
kemacetan	ciriiri	None
kemaharajaan	boqortooyada	None
kemajuan	horumar	None
kemakmuran	barwaaqo	None
kemampuan	karti	None
kemampuannya	awoodiisa	Nan
kemandirian	madaxbanaanida	None
kemang	kemang	Nan
kemanusiaan	aadanaha	None
kemarahan	xanaaq	Nan
kemarau	qalalan	Nan
kemasyarakatan	bulsho	None
kematian	dhintay	None
kemayoran	kemayoran	Nan
kerbau	digaag	Nan
kerdil	dwarf	Nan
kereta	tareenka	Nan
keuangan	dhaqaalaha	None
keunggulan	ah	None
keunikan	midnimo	None
keuntungan	faa&#39;iidada	Nan
keutuhan	wadajirka	None
kevin	kevin	Nan
kewajiban	waajib	None
kewajibannya	waajibaadka	Nan
kewalahan	buuxsamay	Nan
kewarganegaraan	dhalasho	None
kewenangan	amar	None
keyakinan	kalsooni	None
keynes	keynes	Nan
khadijah	khadija	Nan
khalayak	dhagaystayaasha	Nan
keturunannya	farcankiisa	Nan
khalifah	caliph	Nan
keturunan	farac	None
ketujuh	toddobaad	Nan
ketidak	maya	Nan
ketidakmampuan	awood	None
ketidakpastian	hubin la’aan	Nan
ketidakpuasan	qanacsanaanta	Nan
ketidakseimbangan	isu	None
ketidakstabilan	degenaansho	None
ketiga	saddexaad	None
ketiganya	saddexda	None
ketika	goorma	Nan
ketimbang	halkii	None
ketinggalan	dambe	None
ketinggian	dherer	None
ketoprak	ketoprak	Nan
ketua	gudoomiye	None
ketuhanan	ilaah	None
ketuk	garaac	Nan
ketiadaan	waxba	None
khan	khan	Nan
khasnya	ah	None
kimiawan	farmashiistaha	Nan
kimiawi	kiimiko	Nan
kinabalu	kinabalu	Nan
kinerja	waxqabadka	Nan
kinetik	qaraabo	Nan
kinetika	kinetik	Nan
king	boqorka	None
kini	hadda	None
kiong	kiong	Nan
kipas	fan	Nan
kira	ka	None
kirakira	qiyaastii	None
kiri	bidix	None
kirigakure	kirigakure	Nan
kirinya	bidix	None
kimia	kimistariga	Nan
khas	ah	None
kim	kim	Nan
kilang	warshadaynta	Nan
khatulistiwa	barbaraha	Nan
khawatir	walwalsan	Nan
khilafah	khilafah	Nan
khmer	khmer	Nan
khusus	ah	None
khususnya	ahaan	None
ki	ki	None
kiai	riii	Nan
kiamat	qiyaamaha	None
kian	badan	None
kiba	kiba	Nan
kicauan	chirp	Nan
kidal	bidix	None
kids	carruurta	None
kijang	deerada	Nan
kilometer	kiiloomitir	Nan
ketetapan	qaynuun	Nan
ketertiban	amar	None
ketertarikan	dan	None
keruntuhan	dumin	None
kerupuk	dillaacis	Nan
kerusakan	dhaawac	None
kerusuhan	darro	None
kesadaran	wacyigelinta	None
kesaksian	marag	Nan
kesal	xanaaqsan	Nan
kesalahan	qalad	None
kesamaan	eg	None
kesan	aragti	None
kesatria	mindiyo	Nan
kesatuan	midnimo	None
kesedihan	murugo	Nan
kesehatan	caafimaadka	None
keseimbangan	dheelitirka	Nan
kerumitan	kakanaanta	Nan
kesejahteraan	fayoobaanta	Nan
kerugian	khasaaro	Nan
kertanegara	wadanka	None
kerikil	jug	Nan
kerinci	faahfaahin	Nan
kering	qalalan	Nan
keringat	dhidid	Nan
keripik	qolof	Nan
keris	kris	Nan
kerja	shaqada	None
kerjanya	way	None
kerjasama	iskaashi	None
kernel	koronto	None
kerohanian	ah	None
keroncong	keroncong	Nan
kertabhumi	kertabhumi	Nan
kertajaya	kertajaya	Nan
kertanagara	kertanagara	Nan
kertas	warqad	None
keselamatan	amniga	None
keseluruh	dhamaan	None
keseluruhan	dhan	None
ketan	leh	None
ketapang	ketapang	Nan
ketat	adag	None
ketatanegaraan	gobolka	None
ketebalan	dhumuc	Nan
ketegangan	xiisad	Nan
ketentuan	qodobbada	Nan
ketepatan	saxsanaanta	Nan
keterampilan	xirfado	Nan
keterangan	macluumaad	None
keterbatasan	xaddidaadda	Nan
ketergantungan	ku	None
keterkaitan	isku	None
keterlibatan	lahaanshaha	None
ketersediaan	helitaan	Nan
ketakutan	farxad	None
ketahui	ogaada	Nan
ketahanan	dulqaadasho	Nan
kesusastraan	suugaanta	None
kesembilan	sagaalaad	None
kesempatan	fursad	None
kesemuanya	dhamaantood	None
kesenangan	raaxo	None
kesenian	fanka	None
kesenjangan	farqiga	Nan
kesepakatan	heshiis	None
kelainan	ahayn	None
kesetaraan	sinnaan	Nan
kesetimbangan	isu	None
kesimpulan	gabagabo	Nan
kestabilan	xasiloonida	None
kesuburan	bacrinta	Nan
kesuksesan	guul	None
kesulitan	dhibaato	None
kesultanan	boqortooyada	None
kesetiaan	daacada	Nan
kelahirannya	dhalashadiisa	Nan
kelahiran	dhalasho	None
kelabu	cawlan	Nan
kas	lacag	None
kasar	caqli	None
kasat	karin	None
kaset	cajalad	None
kasih	jacayl	None
kaskus	kaskus	Nan
kaskuser	kaskuser	Nan
kaspia	ah	None
kasta	casaan	Nan
kasus	kiis	Nan
kasuskasus	kiis	Nan
kata	ereyga	None
katai	dwarf	Nan
katak	xayawaan	None
katakan	dheh	None
karyawan	shaqaalaha	None
katakata	ereyada	None
karyanya	shaqadiisa	None
karyakarya	shaqada	None
karin	karin	None
karl	karl	None
karma	karma	Nan
karna	yeelay	None
karnivora	doofaar	None
karno	karno	None
karo	karo	None
karsinogen	sunta	None
karsinoma	kansarka	Nan
kartanegara	kartanegara	Nan
kartika	kartika	Nan
kartini	kartini	Nan
kartu	kaarka	Nan
kartun	kartoon	Nan
karya	abuurista	Nan
karyakaryanya	shaqadiisa	None
kariernya	mustaqbalkiisa	Nan
katalis	xoojiya	Nan
katanya	yidhi	None
kategorisejarah	ah	None
kategorisistem	nidaamka	None
kategoritokoh	guud	None
kation	cation	Nan
katode	cathode	Nan
katolik	kaatoolig	Nan
katup	waalka	Nan
kau	adiga	None
kaum	dad	None
kawah	dhir	None
kawan	saaxiib	None
kawanan	lo	None
kawankawannya	saaxiib	None
kawasan	gobolka	None
kawasankawasan	gobolka	None
kategoriplanet	nooca	None
katalog	buugga	None
kategoriperangkat	qalabka	None
kategoripenyanyi	ah	None
kategori	qayb	None
kategoriaktris	nooca	None
kategorialumni	kategorialumni	Nan
kategorianatomi	categoricalatomy	Nan
kategorianime	shaqada	None
kategoriartikel	qaybta	None
kategoribahasa	nooca	None
kategoridaftar	qaybaha	None
kategoriekonomi	dhaqaalaha	None
kategorifilm	nooca	None
kategorigrup	kooxda	None
kategoriindonesia	indonesian	None
kategorimanga	kategorimanga	Nan
kategorinegara	dalka	None
kategoripenyakit	cudurka	None
kategoriperang	dagaalka	None
karier	shaqo	None
karibia	kaariga	Nan
karet	caag	None
kanal	kanaalka	None
kanan	sax	None
kancah	goobta	None
kandang	qafis	Nan
kandidat	musharrax	Nan
kandung	noolaha	None
kandungan	ilmo	None
kang	kang	Nan
kanji	istaarij	Nan
kanker	kansarka	Nan
kanton	gobanimo	None
kantong	boorso	Nan
kantor	xafiiska	None
kantorkantor	xafiiska	None
kantung	boorso	Nan
kanakkanak	cunug	Nan
kapak	faas	Nan
kanada	kanada	None
kamu	adiga	None
kalinya	waqti	None
kalium	potassium	Nan
kalkulator	xisaabiyaha	Nan
kalkulus	calculus	Nan
kalsium	kaalshiyam	Nan
kamar	qol	Nan
kambing	ari	None
kamboja	kamboodiya	Nan
kamera	kamarad	Nan
kami	anaga	Nan
kamis	khamiista	None
kampanye	olole	None
kampar	kampar	Nan
kampung	tuulo	None
kampus	kambuyuutar	Nan
kamus	qaamuus	None
kapal	markab	None
kapalkapal	markab	None
kapan	goorma	Nan
karangan	qormada	Nan
karangasem	karangasem	Nan
karat	miridhku	Nan
karavan	safarkii	None
karawang	karawang	Nan
karbida	carbide	Nan
karbohidrat	karbohaydrayt	Nan
karboksil	carboxyl	Nan
karbon	kaarboon	Nan
karbonat	kaarboon	Nan
karbondioksida	carbon dioxide	Nan
kardiovaskular	wadnaha	None
karena	yeelay	None
karenanya	darteed	None
karesidenan	degenaanshaha	Nan
karang	dhagax	None
karakura	karakura	Nan
karakterkarakter	jilayaasha	Nan
karakteristik	astaamaha	None
kapang	caaryada	Nan
kapas	suuf	Nan
kapasitas	awood	None
kapiler	xornimo	None
kapita	caato	None
kapital	caasimada	None
kapitalis	raasamaal	Nan
kawat	silig	Nan
kapitalisme	raasamaal	Nan
kapsid	capsid	Nan
kapsul	kaabsal	Nan
kapten	kabtan	Nan
kapuas	kapuas	Nan
kapur	nabar	Nan
kara	kara	None
karakter	dabeecad	None
kapitan	taliye	None
kisah	sheeko	None
kawi	kawi	Nan
kaya	ah	None
kehabisan	orod	None
kehadiran	joogitaan	Nan
kehakiman	garsoorka	None
kehamilan	uur	None
kehancuran	halaag	None
keharusan	waa	None
kehendak	doonaa	None
kehidupan	nolosha	None
kehidupannya	noloshiisa	None
kehilangan	lumiso	Nan
kehormatan	sharaf	None
kehutanan	kaymaha	None
keilmuan	sayniska	None
keindahan	qurux	None
keinginan	rabitaan	Nan
kegunaan	adeegsiga	None
keinginannya	hamigiisa	Nan
kegiatannya	hawlaheeda	Nan
kegiatan	nashaadaadka	Nan
kediri	kediri	Nan
kedokteran	caafimaad	None
kedu	kedu	Nan
kedua	labaad	None
keduanya	labadaba	None
kedudukan	booska	Nan
kedudukannya	booskiisa	Nan
kedutaan	safaaradda	Nan
keemasan	ah	None
keempat	afraad	Nan
keenam	lixaad	None
keesokan	berri	Nan
kegagalan	fashil	Nan
keganasan	darro	None
kegelapan	gudcurka	Nan
kegiatankegiatan	hawlaha	None
kedinasan	ah	None
keistimewaan	mudnaan	Nan
kejadiankejadian	dhacdo	None
kekerabatan	ehelnimo	Nan
kekerasan	rabshad	Nan
kekeringan	abaarta	None
kekhalifahan	khaliif	None
kekhasan	peculiarity	Nan
kekhawatiran	walwal	Nan
kekosongan	faaruqnimo	Nan
kekristenan	masiixiyada	Nan
kekuasaan	awood	None
kekuasaannya	awoodiisa	Nan
kekuatan	awood	None
kekuatankekuatan	xoojinta	None
kekuatannya	xooggiisa	Nan
kekuningan	hurdi	Nan
kekurangan	yaraanta	Nan
kekeluargaan	ehelnimo	Nan
kejadian	shilka	Nan
kekekalan	daa&#39;in	Nan
kekebalan	xasaanad	Nan
kejahatan	danbi	None
kejaksaan	qareen	Nan
kejam	daran	None
kejatuhan	ka	None
kejayaan	ammaanta	Nan
kejayaannya	sharafteeda	Nan
kejuaraan	horyaalnimada	Nan
kejutan	yaab	None
kekacauan	fowdo	Nan
kekaisaran	boqortooyada	None
kekal	ah	None
kekalahan	guuldarro	Nan
kekasih	lover	Nan
kekayaan	hanti	None
kekayaannya	maalkiisa	Nan
kekejaman	naxariis	None
kediaman	deganaansho	Nan
kedelapan	sideedaad	None
kedelai	soy	Nan
kebalikan	soo	None
kebanggaan	kibirka	None
kebangkitan	sarakicidda	Nan
kebangsaan	dhalasho	None
kebanyakan	badan	None
kebayoran	kebayoran	Nan
kebebasan	xorriyadda	Nan
kebenaran	run	None
kebenarannya	runta	None
kebencian	nacayb	None
keberadaan	jiritaanka	None
keberadaannya	jiritaankeeda	None
keberagaman	kala	None
keberanian	geesinimo	None
keberatan	maanka	None
kebal	difaaca	None
keberhasilan	guul	None
kebakaran	dabka	None
kebahagiaan	farxad	None
kayu	qoryaha	Nan
kazekage	kazekage	Nan
kbbi	kbbi	Nan
kd	kd	Nan
ke	ku	None
keadaan	xaalada	None
keadilan	cadaalada	None
keagamaan	diinta	None
keahlian	khibrad	None
keajaiban	mucjiso	None
keamanan	amniga	None
keanekaragaman	kala	None
keanggotaan	xubinimada	Nan
keasaman	aysidhka	Nan
keatas	sare	None
kebaikan	ah	None
kebersamaan	wadajir	None
kebersihan	nadaafad	Nan
keberuntungan	nasiib	None
kecenderungan	isbeddel	Nan
kecepatan	xawaare	Nan
kecepatannya	xawaareheeda	Nan
kecerdasan	sirdoonka	None
kecewa	jab	None
kecil	yar	None
kecilnya	yarkeeda	Nan
kecuali	reebo	None
kedah	kedah	Nan
kedalam	galay	None
kedalaman	dheer	None
kedamaian	nabad	None
kedatangan	imaanshaha	Nan
kedaulatan	gobanimada	Nan
kedekatan	u	None
kecelakaan	shil	None
kecambah	ubax	None
kecamatan	degmo-hoosaad	Nan
kecakapan	xirfad	None
kebesaran	weynaan	Nan
kebetulan	shil	None
kebiasaan	caado	None
kebidanan	umulisooyinka	Nan
kebijakan	siyaasada	None
kebijakankebijakan	siyaasad	None
kebijaksanaan	xikmad	None
kawin	guur	None
kebingungan	jahwareer	Nan
kebon	kebon	Nan
kebudayaan	dhaqanka	None
kebugaran	taam ahaansho	Nan
kebumian	dhulka	None
kebun	beerta	None
kebutuhan	baahi	None
kecak	kecak	Nan
kebocoran	daadinta	Nan
kalimat	xukun	None
kisahkisah	sheeko	None
kisaran	xadka	None
lebarnya	ahaan	None
lebat	culus	None
lebih	inbadan	None
lebur	dhalaalay	Nan
ledakan	qarax	Nan
lee	lee	Nan
legal	ah	None
legenda	halyeey	None
legendaris	halyeey	None
legislasi	sharci	None
legislatif	sharci	None
legitimasi	ahaanshaha	None
leher	luqunta	Nan
leibniz	leibniz	Nan
leiden	leeden	Nan
lebaran	ciid	None
lelah	daalay	Nan
lebar	ballaaran	None
lebak	yaabay	None
lava	lava	Nan
lavey	lavey	Nan
lavoisier	lavoisier	Nan
lawan	kasoo	None
lawang	naag	None
lawannya	horjeeday	None
layak	yahay	None
layaknya	sida	None
layanan	adeeg	None
layang	dhaaf	None
layar	shaashadda	Nan
lazim	baahsan	Nan
lazimnya	ah	None
lc	lc	Nan
lebah	shinni	Nan
lebanon	lebanon	Nan
lautnya	badda	None
lelaki	nin	None
leluhur	awooweyaal	Nan
lenyap	libdhay	Nan
leonardo	leonardo	Nan
leopold	leopold	Nan
lepas	ah	None
lereng	dhaadheer	None
lestari	waara	Nan
leste	leste	Nan
letak	goobta	None
letaknya	goobteeda	Nan
letkol	taliye	None
letnan	taliye	None
letusan	qarxis	Nan
leukemia	dhiigga	None
leukosit	leukocytes	Nan
leuser	leuser	Nan
lensa	lens	Nan
lelang	xaraash	Nan
lengkung	qalooca	Nan
lengan	gacanta	None
lemah	ah	None
lemak	dufan	Nan
lemas	dhutin	Nan
lembaga	machadka	None
lembagalembaga	hay&#39;ad	Nan
lembah	dooxada	None
lembap	digaag	Nan
lembar	xaashi	None
lembaran	xaashi	None
lembut	jilicsan	None
lempeng	saxanka	Nan
lempengan	dharbaaxo	Nan
lempenglempeng	saxanka	Nan
lencana	calaamad	None
lendir	xab	Nan
lengkap	dhameystiran	Nan
leusina	leusina	Nan
lautan	badda	None
laura	laura	Nan
lakshmana	lakshmana	Nan
laktat	hooyada	None
laku	dhaqan	None
lakukan	samee	Nan
lalu	markaa	None
lalunya	dhaafay	None
lama	dheer	None
lamanya	weligiis	Nan
lambang	astaan	None
lambat	gaabis	Nan
lambung	caloosha	Nan
lamongan	lamongan	Nan
lampau	dhaafay	None
lampu	iftiin	Nan
lampung	laambad	Nan
laksamana	qaali	None
lan	lan	Nan
lakilaki	lab	None
lainnya	kale	None
laboratorium	shaybaar	Nan
labu	bocor	Nan
lada	basbaas	Nan
ladang	duurka	None
lagi	labaad	None
lagu	heesta	None
lagulagu	hees	None
lagunya	heesta	None
lah	lah	Nan
lahan	dhul	None
lahir	dhashay	None
lahirlah	karaa	None
lahirnya	dhalashadiisa	Nan
lain	kale	None
lainlain	iwm	None
laju	heerka	None
laut	badda	None
lancar	leh	None
langgam	qaabka	None
laptop	laptop-ka	Nan
larangan	mamnuucid	Nan
lari	orod	None
laris	baahida	None
larut	daahay	None
larutan	xalka	Nan
larva	dirxiga	Nan
laser	laser	Nan
laskar	milatariga	None
last	dambeeya	None
lastri	lastri	Nan
latar	asalka	None
latihan	dhaqan	None
latin	laatiin	Nan
laun	tartiib tartiib	Nan
laporan	warbixin	None
landasan	saldhig	None
lapisanlapisan	lakabka lakabka	Nan
lapis	lakab	Nan
langit	cirka	None
langka	naadir	Nan
langkah	tallaabo	Nan
langkahlangkah	tallaabooyinka	Nan
langkan	qalin	None
langsung	noolaan	None
lanjut	waday	None
lanjutan	horumarsan	Nan
lanka	lanka	None
lantai	dabaqa	None
lantas	sidaas	None
laos	laos	None
lapangan	duurka	None
lapar	gaajaysan	Nan
lapindo	lapindo	Nan
lapisan	lakab	Nan
level	heer	None
lewat	marayo	None
lewis	lewis	None
lubang	dalool	None
luhur	leh	None
luka	boog	Nan
lukaluka	lukaluka	Nan
lukis	rinjiyeynta	Nan
lukisan	rinjiga	None
lulus	qalin	None
lulusan	qalin	None
lumajang	badan	None
lumbalumba	dolphins	Nan
lumbung	barn	Nan
luminositas	iftiin	Nan
lumpur	dhoobo	None
lumut	ajada	Nan
luna	luna	Nan
luasnya	ballaadhka	Nan
lunak	jilicsan	None
luas	weyn	None
luar	banaanka	None
lomba	tartan	Nan
lombok	chilli	Nan
lompat	bood	None
lompatan	boodboodid	Nan
london	london	None
long	dheer	None
longgar	dabacsan	Nan
longsor	avalanche	Nan
lonjong	oval	Nan
lontong	bariiska	None
lorong	hoolka	Nan
los	los	Nan
louis	louis	Nan
low	hooseeya	None
luapan	qulqulka	Nan
luarnya	banaanka	None
lolos	ka	None
lung	sambabka	Nan
lupus	lupus	Nan
madu	malab	Nan
madura	madura	Nan
maeda	maeda	Nan
magelang	magelang	Nan
magnesium	magnesium	Nan
magnet	magnetism	Nan
magnetik	magnetic	Nan
magnetosfer	magnetosphere	Nan
magnitudo	weynaanta	Nan
maha	maha	Nan
mahabharata	mahabharata	Nan
mahal	ah	None
mahar	yarad	Nan
maharaja	maharaja	Nan
mahasiswa	arday	None
madrid	madrid	Nan
lupa	hilmaam	Nan
madiun	madiun	Nan
made	sameeyey	None
lurus	toosan	None
lutut	jilibka	Nan
luwu	dabacsan	Nan
lyon	lyon	Nan
m	m	None
ma	ma	None
maaf	ka	None
mac	mac	Nan
macam	noocyo	Nan
macammacam	duwan	None
macan	shabeel	None
macintosh	macintosh	Nan
macro	macros	Nan
mada	mada	Nan
madara	madara	Nan
madinah	madiina	None
lokasinya	goobta	None
lokasi	goobta	None
lokal	ah	None
lily	ubax	None
lima	shan	None
limbah	qashin	Nan
limfosit	jirka	None
limit	xad	None
lincoln	lincoln	Nan
lindung	ilaaliyo	None
line	xariiq	Nan
linear	toosan	None
lingga	finanka	Nan
linggarjati	linggarjati	Nan
lingkar	goobada	Nan
lingkaran	goobaabin	Nan
lingkungan	deegaanka	None
lingkungannya	deegaankeeda	Nan
lilitan	xarig	Nan
lingkup	baaxadda	None
lilin	shumac	Nan
likeur	likeur	Nan
lhokseumawe	lhokseumawe	Nan
lia	been	None
liang	rut	Nan
liar	ah	None
liat	arag	None
liberal	xorriyadda	Nan
liberalisme	xorriyadda	Nan
libur	fasax	None
libya	liibiya	None
lidah	carrab	Nan
life	nolosha	None
lift	wiish	Nan
liga	horyaal	None
light	iftiin	Nan
lihat	arag	None
likuiditas	dareere ahaansho	Nan
linguistik	luqadaha	None
link	iskuxiran	Nan
linkin	linkin	Nan
liur	candhuufta	Nan
live	noolaan	None
liver	beerka	Nan
liverpool	beerpool	Nan
lobus	lobe	Nan
local	ah	None
locke	xayawaan	None
log	qor	Nan
logam	bir	None
logaritma	logarithm	Nan
logat	lahjad	Nan
logika	gal	None
logis	ah	None
logistik	saadka	None
logo	astaanta	None
little	yar	None
litosfer	lithosphere	Nan
literatur	suugaanta	None
litani	litany	Nan
lintang	latitude	Nan
lintas	iskutallaabta	Nan
lintasan	dariiqa	Nan
linux	linux	None
lion	libaax	None
liontin	pendant	Nan
lipat	laalaabid	Nan
label	sumad	Nan
lipid	lipids	Nan
lirik	heesaha	None
lisa	lisa	Nan
lisan	afka	None
lisensi	shati	Nan
lisosom	lysosome	Nan
list	liiska	None
listrik	korantada	Nan
liputan	caymiska	Nan
laba	faa&#39;iido	Nan
la	la	None
l	l	None
komunikasi	isgaarsiinta	None
komunis	wadaag	Nan
komunisme	shuuciyada	Nan
komunitas	bulshada	None
kondensasi	uumiga	Nan
kondisi	xaalad	Nan
kondisikondisi	xaalad xaalad	Nan
kondom	cinjirka galmada	Nan
konduktivitas	dhaqdhaqaaqa	None
koneksi	isku	None
konfederasi	taga	None
konferensi	shir	None
konfigurasi	qaabeynta	Nan
konflik	dhac	None
konfrontasi	hor	None
komputindo	komputindo	Nan
kong	kong	None
komputerkomputer	kumbuyuutar	None
komputasi	xisaabinta	Nan
kompetensi	kartida	Nan
kompetisi	tartan	Nan
kompetitif	tartamaya	Nan
kompilasi	uruurinta	Nan
komplek	adag	None
kompleks	adag	None
kompleksitas	kakanaanta	Nan
komplemen	dhammaystir	Nan
komplikasi	dhibaatooyinka	None
komponen	qayb	None
komponenkomponen	qayb	None
kompos	qashinka	Nan
komposisi	halabuurka	Nan
komposisinya	halabuurka	Nan
kompromi	tanaasulka	Nan
komputer	kumbuyuutar	None
kompensasi	magdhow	Nan
konghucu	konfucius	Nan
kongres	shir	None
konstanta	ah	None
konstituante	ahaan	None
konstitusi	dastuurka	None
konstitusional	dastuurka	None
konstruksi	dhismaha	None
konsultan	la-taliye	Nan
konsultasi	wadatashi	Nan
konsumen	macaamiisha	None
konsumsi	isticmaalka	None
kontak	xiriir	None
konteks	guud	None
kontemporer	ah	None
konten	nuxurka	Nan
kontes	tartan	Nan
kontra	miiska	None
konstan	ah	None
kongo	kongo	None
konspirasi	shirqool	None
konsisten	ah	None
konkret	karo	None
konoha	konoha	Nan
konohagakure	konohagakure	Nan
konon	loo	None
konsekuensi	cawaaqibka	Nan
konsensus	ogolaansho	Nan
konsentrasi	feejignaan	Nan
konsep	fikradda	Nan
konsepkonsep	fikradda	Nan
konsepsi	rimay	Nan
konser	riwaayad	Nan
konservasi	ilaalinta	None
konservatif	muxaafid	Nan
konsil	gole	Nan
konsili	gole	Nan
konsonan	shibane	None
kompatibilitas	is	None
kompas	wareeg	Nan
komparatif	isbarbar dhig	Nan
klorofil	chlorophyll	Nan
kloroplas	chloroplast	Nan
klub	naadi	Nan
klungkung	klungkung	Nan
kluster	kooxdu	Nan
km	km	None
knowledge	aqoon	None
ko	ko	Nan
koalisi	isbahaysi	Nan
koch	koch	Nan
kode	koodh	Nan
kodifikasi	codaynta	Nan
kodok	xayawaan	None
koefisien	isku	None
koenzim	coenzyme	Nan
klorin	koloriin	Nan
kofaktor	cofactor	Nan
klorida	koloriin	Nan
klitoris	kintirka	Nan
kisuke	kisuke	Nan
kita	anaga	Nan
kitab	buugga	None
kitabkitab	buugaagta	None
klaim	sheegasho	Nan
klan	qabiil	None
klasifikasi	kala	None
klasik	ah	None
klaten	klaten	Nan
klien	macmiil	Nan
klik	guji	Nan
klimatologi	cimilada	None
klinik	caafimaad	None
klinis	caafimaad	None
klip	cajalad	None
klon	xariif	Nan
kognitif	garashada	None
koh	koh	Nan
koin	qadaadiic	Nan
kombinasi	darka	None
komedi	majaajilo	Nan
komentar	faallo	Nan
komering	kombiyuutarka	Nan
komersial	ganacsi	None
komersil	ganacsi	None
komet	majaajillo	Nan
komik	majaajillo	Nan
komisaris	gudoomiyaha	None
komisi	guddi	Nan
komite	gudi	Nan
komitmen	ballanqaad	Nan
komoditas	badeecad	Nan
komoditi	badeecad	Nan
komodo	komodo masduulaagii	Nan
komando	amar	None
komandan	taliyaha	None
koma	kooma	Nan
kolonisasi	gumeysiga	None
kok	runtii	None
kokain	kookaha	Nan
kokoh	adkeyn	Nan
kolaborasi	iskaashi	None
kolam	barkad	Nan
koleksi	ururinta	Nan
kolektif	wadareed	Nan
kontrak	qandaraas	Nan
kolektor	aruuriyaha	Nan
koloid	colloid	Nan
kolom	tiirka	None
kolombia	colombia	None
kolonel	kornayl	Nan
koloni	gumeysi	None
kolonial	gumeysiga	None
kolonialisme	gumeysiga	None
kolesterol	kolesteroolka	Nan
kisame	kisame	Nan
kontraksi	foosha	Nan
kontribusi	tabarucaad	Nan
kudus	qoduus	Nan
kue	keega	Nan
kuhp	kuhp	Nan
kuil	macbudka	Nan
kuiper	kuiper	Nan
kuliah	kulliyad	Nan
kuliner	culuunta	None
kulit	maqaarka	Nan
kulitnya	maqaarka	Nan
kulon	kulon	Nan
kultivar	cultivar	Nan
kultur	dhaqanka	None
kultus	dhaqan	None
kuman	jeermiga	Nan
kumpulan	dhigay	None
kudeta	afgambi	None
kuna	kuna	None
kuda	faras	None
kuchiyose	kuchiyose	Nan
kualitas	leh	None
kualitatif	ahaan	None
kuantitas	tiro	None
kuantitatif	ahaan	None
kuantum	tiro	None
kuark	ruxid	Nan
kuasa	awood	None
kuat	leh	None
kuatnya	leh	None
kuba	cuba	Nan
kubah	xamar	None
kubu	qalcado	Nan
kubur	xabaal	None
kuburan	qabriga	None
kuchiki	kuchiki	Nan
kucing	bisad	Nan
kualifikasi	shahaadada	None
kunci	fure	Nan
kuning	ah	None
kurung	biraha	Nan
kurva	qalooca	Nan
kushina	kushina	Nan
kusuma	kusuma	Nan
kuta	kuta	Nan
kutai	kutai	Nan
kutipan	xigasho	Nan
kutu	boodada	Nan
kutub	ulaha	Nan
kutukan	habaar	Nan
kuwait	kuwait	None
kyai	culimada	None
kyoto	kyoto	Nan
kyubi	kyubi	Nan
kyuubi	kyuubi	Nan
kurun	muddo	None
kundang	kundang	Nan
kurukshetra	kurukshetra	Nan
kursi	kursiga	None
kuningan	naxaas	Nan
kunjungan	booqasho	Nan
kuno	ah	None
kunti	kunti	Nan
kuntilanak	kuntilanak	Nan
kupang	kupang	Nan
kupon	kuuban	Nan
kupukupu	balanbaalis	Nan
kurang	yar	None
kurangnya	la&#39;aanta	Nan
kurenai	kurenai	Nan
kurikulum	manhajka	None
kurita	kurita	Nan
kurniawan	kurniawan	Nan
kurosaki	kurosaki	Nan
kuru	kuru	Nan
kuala	kuala	Nan
kuah	maraq	Nan
kuadrat	labajibaaran	Nan
koreografi	choreography	Nan
koridor	dariiqa	Nan
korona	corona	Nan
korosif	daxalka	Nan
korporasi	shirkad	None
korps	maydka	None
korteks	kiliyaha	Nan
korupsi	musuqmaasuq	Nan
kosa	ereyada	None
kosakata	ereyada	None
kosmik	cosmic	Nan
kosmogoni	quruxda	None
kosmologi	cosmology	Nan
kosong	madhan	Nan
kostum	dharka	None
koreksi	sixitaan	Nan
kota	magaalada	None
korea	kuuriya	None
korawa	korawa	Nan
kontributor	tabaruc	Nan
kontrol	xakamayn	Nan
kontroversi	muran	None
kontroversial	muransan	Nan
konveksi	gaarsiinta	None
konvektif	gaadhsiin	Nan
konvensi	shir	None
konvensional	ah	None
konversi	beddelaad	Nan
koordinasi	isuduwidda	Nan
koordinat	isku	None
koordinator	isu	None
koperasi	iskaashi	None
kopi	kafee	Nan
koran	wargeys	Nan
korban	dhibane	Nan
kotak	sanduuq	Nan
kotakota	magaalooyinka	None
kotamadya	degmo	None
kristus	masiixa	Nan
kriteria	shuruudaha	Nan
kritik	dhaliil	None
kritikus	dhaliil	None
kritis	ah	None
kroasia	croatia	Nan
kromosom	koromosoom	Nan
kronik	raaga	Nan
kronis	raaga	Nan
kronologi	taariikhda	None
kronologis	taariikh	None
kronos	kronos	Nan
ksatria	mindiyo	Nan
ktt	ktt	Nan
ku	aniga	None
kristiani	kiristaanka	Nan
kristen	ah	None
kristal	krist	Nan
krisis	qalalaase	None
kotanya	magaalada	None
kotor	ah	None
kotoran	wasakh	Nan
kovalen	covalent	Nan
kpk	kpk	Nan
krakatau	krakatau	Nan
krama	dhaqan	None
kontras	isbarbar dhig	Nan
kramat	kramat	Nan
kreativitas	hal-abuurnimo	Nan
kredit	deyn	Nan
kresna	krishna	Nan
kreta	kreta	Nan
kri	kri	Nan
kriminal	dambiile	Nan
krisdayanti	krisdayanti	Nan
kraton	qasriga	Nan
mahdi	mahdi	None
kalimantan	kalimantan	Nan
kaliber	caliber	Nan
gerhana	qorrax madoobaadka	Nan
gerilya	jabhad	None
gesek	kareyso	Nan
gesekan	isqabqabsi	Nan
get	hel	Nan
getah	dheecaan	None
getaran	gariir	Nan
getsuga	getuga	Nan
gigi	ilig	Nan
gigih	leh	None
gigitan	qaniinyo	Nan
gila	waali	Nan
gilbreth	gilbreth	Nan
gilirannya	leexo	Nan
ginjal	kelyaha	Nan
gereja	kaniisad	None
giovanni	giovanni	Nan
gerbang	irridda	Nan
gerakangerakan	noqo	None
genjutsu	genjutsu	Nan
genom	hidde	Nan
genre	nooc	None
genus	hidde	Nan
geografer	juquraafiga	Nan
geografi	juquraafiga	Nan
geografis	ahaan	None
geologi	dhulka	None
geologis	ahaan	None
geometri	joomatari	Nan
geomorfologi	joomorphology	Nan
george	george	Nan
georgia	georgia	Nan
gerak	mooshin	Nan
gerakan	dhaqdhaqaaq	None
gerakannya	dhaqdhaqaaqyadiisa	Nan
genin	hidde	Nan
giral	giral	Nan
giribangun	giribangun	Nan
goku	goku	Nan
gol	hadaf	Nan
gold	dahab	None
golden	ah	None
golf	golf	Nan
golkar	golkar	Nan
golongan	koox	None
gong	gong	Nan
google	google	Nan
gordon	gordon	Nan
goreng	shiilay	Nan
goresan	xoqid	Nan
gosip	xanta	None
gotong	iskaashiga	None
government	dowladda	None
gohan	gohan	Nan
giri	gabadh	None
goa	god	None
gnu	gnuun	Nan
gitar	gitaarka	Nan
giuseppe	giuseppe	Nan
gizi	nafaqada	Nan
glikogen	glycogen	Nan
glikolisis	glycolysis	Nan
glikoprotein	glycoprotein	Nan
gliserol	glycerol	Nan
global	ah	None
globalisasi	caalamiyeynta	Nan
globe	adduunka	None
glosarium	qaamuus	None
glukagon	glucagon	Nan
glukosa	gulukoos	Nan
gmail	gmail	Nan
gnb	gnb	Nan
go	tag	Nan
gowa	gowa	Nan
genggam	haysta	None
genetika	hiddo-wadaha	Nan
gangguan	carqalad	Nan
ganja	marijuana	Nan
ganti	dhaaftay	None
gantinya	halkii	None
gantung	laalaaday	Nan
gapura	irridda	Nan
garaa	garaa	Nan
garam	cusbo	Nan
garden	beerta	None
garis	xariiq	Nan
garisgaris	khadadka	Nan
garuda	garuda	Nan
garut	fallaadh	Nan
gas	gaas	Nan
gasgas	gaaska gaaska	Nan
ganggang	algae	Nan
gates	irdaha	Nan
gangga	ganga	Nan
ganesha	ganesha	Nan
gambang	xylophone	Nan
gambar	sawir	None
gambaran	sawir	None
gambargambar	sawirada	None
gambir	gambier	Nan
gambut	peat	Nan
game	ciyaarta	None
gamelan	gamelan	Nan
games	ciyaaraha	None
gamma	gamma	Nan
gamping	lime	Nan
ganas	leh	None
ganda	labanlaab	Nan
gandum	sarreen	Nan
gandut	madhalays	Nan
gang	sariirta	Nan
geng	burcad	Nan
gateway	irridda	Nan
gawang	bartilmaameedka	Nan
gelora	qalliin	Nan
geluh	loam	Nan
gemar	jecel	None
gembira	faraxsan	None
gemilang	badan	None
gempa	dhulgariirkii	Nan
gemuk	dufan	Nan
gen	hiddo-wadayaasha	Nan
genangan	boorso	Nan
gencatan	jooji	Nan
gendang	durbaan	None
general	guud	None
generasi	jiil	Nan
generator	matoor	Nan
genetik	hidde	Nan
gelombang	mowjad	Nan
gautama	gautama	Nan
gelgel	gelgel	Nan
gelatik	wren	Nan
gaya	qaab	None
gayo	gayo	Nan
gaza	gaza	Nan
gdp	gdp	Nan
gede	weyn	None
gedung	dhisme	None
gedunggedung	dhisme	None
gejala	astaamaha	None
gejalagejala	calaamadaha	Nan
gejolak	jahwareer	Nan
gelang	jijin	Nan
gelanggang	garoon	None
gelap	ah	None
gelar	shahaado	None
gelas	galaas	Nan
gelembung	xumbo	Nan
gp	gp	Nan
gprs	gprs	None
gps	gps	Nan
hara	leh	None
harafiah	suugaaneed	Nan
haram	xaaraan	Nan
harapan	rajo	None
hardware	qalabka	None
harfiah	ahaan	None
harga	qiimo	None
hari	maalin	None
harian	kasta	None
harihari	maalmood	None
harimau	shabeel	None
harinya	maalinta	None
harmoni	wada	None
harold	harold	Nan
harry	harry	Nan
hanyutan	maydh	None
hart	hart	Nan
hanyalah	kaliya	None
hantu	cirfiid	Nan
hamas	hamas	Nan
hamba	addoon	None
hambatan	iska	None
hamengku	hamengku	Nan
hamengkubuwono	hamengkubuwono	Nan
hamid	hamid	Nan
hamil	leh	None
hamka	hamka	Nan
hampir	ku	None
hamzah	hamza	Nan
han	han	Nan
hancur	burburay	None
handal	karo	None
hang	laalaada	Nan
hangat	diiran	None
hanya	kaliya	None
hama	cayayaan	Nan
harta	khasnad	Nan
harun	harun	Nan
hawa	cimilo	None
hawaii	hawaii	None
hayam	hayam	Nan
hayat	nolosha	None
hayati	noolaha	None
he	isagu	None
health	caafimaadka	None
heart	wadnaha	None
hebat	weyn	None
heinrich	henry	Nan
helen	helen	Nan
helikopter	helikobtar	Nan
heliopause	heliopause	Nan
helios	helios	Nan
heliosfer	heliosphere	Nan
haumea	haumea	Nan
harum	udgoon	None
hatta	hatta	Nan
hatihati	soco	None
haruno	haruno	Nan
harus	waa	None
haruslah	in	None
harvard	harraad	None
hasan	hasan	None
hasanuddin	hasanuddin	Nan
hasil	natiijooyinka	Nan
hasilhasil	natiijooyinka	Nan
hasilnya	natiijada	None
hasrat	rabitaan	Nan
hastinapura	hastinapura	Nan
hasyim	hashim	Nan
hata	hata	Nan
hatake	dillaac	Nan
hati	wadnaha	None
hatinya	qalbigiisa	None
ham	ham	Nan
halus	jilicsan	None
halo	salaan	None
gugus	koox	None
gugusan	kooxdu	Nan
gui	gui	Nan
guide	hage	Nan
guido	guido	Nan
guinea	guinea	None
gula	sonkorta	None
gulai	curry	Nan
gulma	haramaha	Nan
gulungan	duub	None
guna	isticmaalo	None
gunakan	adeegso	Nan
gunawan	gunawan	Nan
gunung	buurta	None
gununggunung	volcano	Nan
gugur	dhicid	Nan
gurindam	gurindam	Nan
guevara	guevara	Nan
gubernur	gudoomiye	None
gradien	jaangooyo	Nan
grafik	shaxanka	Nan
grafis	jaantus	Nan
graha	graha	Nan
gram	garaam	Nan
grand	awoowe	None
gratis	ah	None
gravitasi	cufnaanta	Nan
gresik	gresik	Nan
grimmjow	grimmjow	Nan
ground	dhulka	None
group	koox	None
grup	koox	None
gua	god	None
guatemala	guatemala	Nan
gudang	bakhaar	Nan
guru	macallin	None
guruh	onkod	Nan
gurun	ah	None
haid	caadada	Nan
hajar	garaacid	Nan
haji	xajka	None
hak	sax	None
hakhak	xuquuqda	None
hakikat	nuxurka	Nan
hakim	xukumaan	Nan
haku	haku	Nan
hal	shay	None
halaman	bogga	None
halhal	waxyaabaha	None
halim	haye	Nan
hall	hoolka	Nan
halloween	halbeega	Nan
halnya	kiiska	Nan
hai	hi	Nan
hadits	xadiiska	None
hadist	xadiiska	None
hadis	xadiiska	None
gurunya	macalinka	Nan
gus	gus	Nan
gusti	halganka	None
gutawa	gutawa	Nan
guy	nin	None
h+	+	None
ha	ha	None
gam	gam	Nan
haart	haart	Nan
habis	kacay	None
habitat	degaan	None
hadapan	kahor	None
hadi	hadi	Nan
hadiah	hadiyad	Nan
hadir	xaadir	Nan
hadirnya	imaanshaha	Nan
habibie	habibie	Nan
galuh	leh	None
galileo	galileo	Nan
galeri	maktabadda	Nan
etanol	ethanol	Nan
ethernet	ethernet	Nan
ethiopia	ethiopia	None
etik	anshaxa	Nan
etika	anshaxa	Nan
etimologi	etymology	Nan
etnik	qowmiyadeed	Nan
etnis	qowmiyadeed	Nan
eukariota	eukaryotes	Nan
eukariotik	eukaryotic	Nan
eurasia	eurasia	Nan
euro	euro	Nan
european	yurub	None
evaluasi	qiimaynta	Nan
event	dhacdo	None
et	iyo	None
evil	shar	Nan
estrogen	estrogen	Nan
espada	espada	Nan
erat	xidh	None
erectus	erectus	Nan
ereksi	kacsi	Nan
eric	cunsur	Nan
eris	eris	Nan
eritrosit	erythrocytes	Nan
eropa	europe	None
erosi	guur	None
erotik	dabacsan	Nan
erupsi	qarxis	Nan
erwin	erwin	Nan
es	baraf	None
esa	mid	None
esem	esem	Nan
esensial	ah	None
estetika	qurxinta	Nan
era	erayada	None
evolusi	horumar	None
evolution	horumar	None
fakultas	kuliyadaha	Nan
fall	dhicid	Nan
fals	ah	None
falsafah	falsafada	Nan
famili	reerka	None
fanatik	fanaanad	None
fans	taageerayaasha	None
fantasi	khayaali	Nan
farmasi	farmashiyaha	Nan
farrel	farre	Nan
fase	marxaladda	Nan
fashion	moodada	Nan
fasilitas	adeegyada	None
fatah	fatah	Nan
fatahillah	fatahillah	Nan
faktorfaktor	arrimaha	None
evolusioner	horumar	None
faktor	factor	Nan
fakir	ah	None
ex	ex	None
excel	ah	None
explorer	sahamin	Nan
express	muuji	Nan
eyeshield	indhihiisa	Nan
f	f	None
fa	fa	Nan
facebook	facebook	Nan
factbook	buugga	None
facto	facto	Nan
factor	factor	Nan
fagosit	phagocyte	Nan
fair	ah	None
faiz	faiz	Nan
fajar	waaberiga	Nan
fakta	xaqiiqda	None
eps	eps	Nan
episode	dhacdo	None
epik	epic	Nan
elektronika	elektaroonig	Nan
elektrostatik	elektaroonig	Nan
elemen	element	Nan
elemenelemen	ka	None
elex	maroodi	None
elips	xusul	Nan
elit	aqoonyahanada	Nan
elizabeth	elizabeth	Nan
email	emayl	Nan
emansipasi	xorayn	Nan
emas	dahab	None
embarkasi	gunta	Nan
embrio	uurjiifka	Nan
emirat	imaaraadka	Nan
emisi	qulqulka	Nan
elektronik	ah	None
emiten	soo	None
elektronelektron	elektaroonig	Nan
elektron	elektaroonig	Nan
ekstraksi	soo	None
ekstraselular	extracellular	Nan
ekstrem	ah	None
ekuator	barbaraha	Nan
elang	gorgorka	Nan
elder	waayeel	None
electron	elektaroonig	Nan
electronic	ah	None
electronics	elektaroonig	Nan
elektrik	ahaan	None
elektrode	electrode	Nan
elektrokimia	elektaroonigga	Nan
elektrolisis	electrolysis	Nan
elektrolit	electrolyte	Nan
elektromagnetik	elektromagnetic	Nan
elektronegativitas	elektaroonigga	Nan
emosi	shucuur	Nan
emosional	ahaan	None
empat	afar	None
engineering	injineerinka	Nan
england	ingiriiska	None
ensiklopedi	encyclopedia	Nan
ensiklopedia	encyclopedia	Nan
entah	uun	None
enterprise	ganacsi	None
entertainment	madadaalo	Nan
entitas	hay&#39;ad	Nan
entri	gelitaanka	Nan
entropi	entropy	Nan
environmental	deegaanka	None
enzim	enzyme	Nan
enzimenzim	enzyme	Nan
eosen	eocene	Nan
epidermis	epidermis	Nan
engine	matoor	Nan
enggan	diidan	Nan
engels	somali	None
energy	tamar	None
empedu	bile	None
empekempek	empekempek	Nan
empire	boqortooyada	None
empiris	leh	None
enak	macaan	None
enam	lix	None
encer	orod	None
fatal	ah	None
encyclopedia	encyclopedia	Nan
endapan	saadaalin	Nan
endemik	ah	None
endokrin	endocrine	Nan
endoplasma	endoplasm	Nan
endositosis	endocytosis	Nan
energi	tamar	None
energinya	tamarteeda	Nan
end	dhamaadka	None
helium	hilibka	None
fatimah	fatimah	Nan
fatwa	fatwa	Nan
fotosistem	sawirka	None
foundation	aasaaska	None
frac	frac	Nan
fragmen	jajab	Nan
fraksi	jajab	Nan
fraktur	jab	None
frame	jirku	Nan
france	france	Nan
francis	francis	Nan
francisco	francisco	Nan
frank	ah	None
frankia	frankia	Nan
frans	frans	Nan
frasa	weedha	Nan
fred	xirmay	Nan
fotosintesis	sawir-qaadis	Nan
frederick	frederick	Nan
fotosfer	qaade	None
fotokimia	sawir-qaade	Nan
formal	ah	None
formasi	sameynta	Nan
format	qaab	None
formula	qaaciddada	Nan
fort	qalcad	Nan
forum	madal	Nan
fosfat	fosfooras	Nan
fosfolipid	fosfooraska	Nan
fosfor	phosphor	Nan
fosforilasi	fosfooraska	Nan
fosil	fossil	Nan
foto	sawir	None
fotofoto	sawir	None
fotografer	qaade	None
fotografi	sawir	None
foton	photon	Nan
form	foom	Nan
free	ah	None
frekuensi	jeer	None
gabungan	darka	None
gabus	guf	Nan
gadang	gadang	Nan
gading	maroodi	None
gadis	gabadh	None
gadjah	taxan	Nan
gagal	fashilmay	None
gagasan	fikrad	None
gagasangagasan	fikradaha fikirka	Nan
gaib	sixir	Nan
gairah	shucuur	Nan
gajah	maroodiga	None
gaji	mushahar	Nan
galaksi	galaxy	Nan
galaksigalaksi	galaxiyada	Nan
gabah	hadhuudh	Nan
freedom	xorriyadda	Nan
gaara	gaadho	None
g	g	None
french	faransiis	None
freud	xariir	None
friedrich	shiil	Nan
from	ka	None
ftp	ftp	Nan
full	buuxa	None
fundamental	ah	None
fungi	fangaska	Nan
fungsi	shaqo	None
fungsifungsi	howlaha	None
fungsinya	shaqo	None
fungsional	shaqeynaya	None
fusi	wajiga	Nan
futsal	futsal	Nan
fx	fx	Nan
ga	ga	None
forest	kaymaha	None
for	ee	None
food	cuntada	None
fibrosis	fibrosis	Nan
fidel	aamin	None
field	duurka	None
fifa	fifa	Nan
figur	jaantus	Nan
fiksasi	hagaajin	Nan
fiksi	ah	None
fiktif	ah	None
filamen	xarig	Nan
file	feyl	Nan
filecandi	filecandi	Nan
filipina	filibiin	Nan
film	filim	Nan
filmfilm	filimada	Nan
filmografi	filim	Nan
fet	uurjiif	Nan
filosofi	falsafada	Nan
festival	dabaaldag	Nan
ferguson	feranne	Nan
fauna	fauna	Nan
favorit	jecel	None
fbi	fbi	Nan
fe	fe	Nan
featuring	muujinta	Nan
februari	febraayo	None
federal	federaalka	None
federasi	xiriirka	None
federation	xiriirka	None
female	dhedig	Nan
fenol	phenol	Nan
fenomena	ifafaale	Nan
fenotipe	phenotype	Nan
feodal	feudal	Nan
ferdinand	ferdinand	Nan
fermentasi	halsano	Nan
filosofis	ahaan	None
filsafat	falsafada	Nan
filsuf	falsafad	Nan
fiturfitur	astaamaha	None
fleksibel	dabacsan	Nan
floem	eray	None
flogiston	flogiston	Nan
floppy	ubax	None
flora	ubax	None
flores	dabaqyada	Nan
flu	hargab	Nan
fluida	dheecaan	None
fluks	qulqulka	Nan
flying	duulaya	Nan
fm	fm	Nan
fmfm	fmfm	Nan
fokus	diiradda	Nan
fonem	telefoon	None
fitur	astaamaha	None
fitri	fitri	Nan
fiskal	miisaaniyad	Nan
fisiologis	jir	None
filter	filter	Nan
filum	phylum	Nan
final	ah	None
financial	dhaqaale	None
finansial	dhaqaale	None
finlandia	finland	None
firefox	firefox	None
fatmawati	fatmawati	Nan
firewall	dabka	None
first	hore	None
fisi	fuuqsanaan	Nan
fisik	jir	None
fisika	fisikiska	Nan
fisikawan	fiisikiska	Nan
fisiknya	jir	None
fisiologi	jirdhiska	Nan
firman	ereyga	None
kalijaga	ilaali	None
hemoglobin	haemoglobin	Nan
hendaknya	in	None
jaksa	xeerilaaliyaha	Nan
jalan	wadada	None
jalanan	wadada	None
jalanjalan	wadada	None
jalannya	jidka	None
jalur	haadka	Nan
jam	saac	Nan
jamaah	xujaajta	Nan
jamak	jamac	None
jamal	jamal	None
jamaluddin	jamaaludiin	Nan
jambi	jambi	Nan
jambu	guava	Nan
james	james	Nan
jaminan	qaad	None
jakarta	jakarta	None
jamur	likaha	Nan
jaka	jaka	Nan
jajak	codbixinta	Nan
jabatan	booska	Nan
jabatannya	booskiisa	Nan
jack	jaakad	Nan
jackson	jackson	Nan
jacob	yacquub	None
jacobin	jacobin	Nan
jadi	sidaas	None
jadwal	jadwal	Nan
jafar	jacfar	None
jagung	galley	Nan
jahat	shar	Nan
jahe	sinjibiil	Nan
jaipongan	jaipongan	Nan
jaja	jaja	Nan
jajahan	gumeysi	None
jajaran	safka	Nan
izin	ogolaansho	Nan
jan	jan	Nan
jang	jang	Nan
jas	suud	Nan
jasa	adeegyada	None
jasanya	adeegyadiisa	Nan
jasmani	jir	None
jasminum	jasminum	Nan
jati	teak	Nan
jatinegara	jatinegara	Nan
jatuh	dhac	None
jatuhnya	dayrta	Nan
jauh	fog	None
java	java	Nan
jawa	java	Nan
jawab	jawaab	Nan
jawaban	jawaabta	Nan
jawatan	adeeg	None
jarum	irbad	Nan
janda	carmal	Nan
jaringanjaringan	shabakad	None
jaring	shabaqa	Nan
jangan	ha	None
jangka	muddo	None
jangkauan	duwan	None
janin	uurjiifka	Nan
janji	qaad	None
jantan	lab	None
jantung	wadnaha	None
januari	janawari	Nan
japan	japan	Nan
japonica	japonica	Nan
jarak	masaafada	None
jaraknya	masaafada	None
jarang	dhif	Nan
jari	farta	None
jarijari	faraha	None
jaringan	shabakad	None
jawi	dibiga	Nan
ix	ix	Nan
iv	iv	Nan
ionosfer	ionosphere	Nan
ip	ip	Nan
ipcc	ipcc	Nan
ipv	ipv	Nan
ir	ir	Nan
irak	ciraaq	None
irama	laxanka	Nan
iran	iiraan	None
iri	masayr	Nan
irian	masayr	Nan
irigasi	waraabka	Nan
iris	jarjaran	Nan
iritasi	xanaaq	Nan
irlandia	ireland	Nan
iruka	iruka	Nan
ionisasi	ionization	Nan
is	waa	None
ionik	ionic	Nan
io	io	Nan
interpreter	turjubaan	Nan
interval	dhexda	None
intervensi	faragelin	None
inti	xudunta	Nan
intifada	intifada	Nan
intinya	barta	None
intranet	furan	None
intraselular	intracellular	Nan
intrinsik	qarsoon	None
introduction	hordhac	None
invasi	duulaan	None
invertebrata	isweydaarsiga	Nan
investasi	maalgashiga	Nan
investigasi	baaritaan	None
investor	maalgashade	Nan
ion	ion	Nan
iwan	iwan	Nan
isa	waa	None
isbn	isbn	Nan
istirahat	jab	None
istri	naag	None
istrinya	xaaskiisa	Nan
isu	arrin	None
isuisu	arrin	None
isyarat	tilmaamid	Nan
ita	ita	Nan
itachi	itachi	Nan
italia	talyaaniga	None
itanium	itonia	Nan
itb	itb	Nan
its	ay	None
itu	taasi	None
itulah	taasi	None
iupac	iupac	Nan
istimewa	ah	None
isaac	isaaq	None
istilahistilah	ereybixin	Nan
istiadat	caadooyinka	Nan
ishida	ishida	Nan
isi	nuxurka	Nan
isinya	yahay	None
iskandar	iskandar	Nan
islam	islaamka	None
islami	islaam	None
ismail	ismail	None
iso	go&#39;doon	Nan
isolasi	karantiil	Nan
isotop	isotope	Nan
isp	isp	Nan
israel	israa&#39;iil	Nan
isshin	isshin	Nan
istana	qasriga	Nan
isteri	naag	None
istilah	muddo	None
jaya	guuleystey	Nan
jayakarta	jayakarta	Nan
jayakatwang	jayakatwang	Nan
kabar	news	None
kabel	fiilo	Nan
kabinet	wasiirada	None
kabupaten	degmooyinka	None
kabupatenkota	kabupatenkota	Nan
kabur	cararaan	Nan
kabut	ceeryaamo	None
kabuto	kabuto	Nan
kaca	galaas	Nan
kacang	lowska	None
kacau	xoqday	Nan
kadal	libaax	None
kadang	qaar	None
kadangkadang	qaar	None
kadangkala	qaar	None
kabah	kaaba	Nan
kadar	nuxurka	Nan
kab	degdeg	None
k	k	None
jupe	casiir	Nan
jupiter	jupiter	Nan
jurang	yaamayska	Nan
juri	xeerbeegtida	Nan
jurnal	joornaal	Nan
jurnalis	wariye	None
juru	turjubaan	Nan
jurus	qaabka	None
jurusan	majors	Nan
justru	ah	None
jusuf	yuusuf	None
juta	milyan	None
jutaan	malaayiin	Nan
jutsu	jutsu	Nan
juventus	juventus	Nan
ka	ka	None
junior	yar	None
kadensa	kadensa	Nan
kadiri	ka	None
kakek	awoowe	None
kakeknya	awoowe	None
kaki	cagaha	Nan
kakinya	cagihiisa	Nan
kaku	adag	None
kakuzu	kakuzu	Nan
kala	waqti	None
kalah	lumiso	Nan
kalangan	wareegyada	Nan
kalapa	wixii	None
kalasan	kalasan	Nan
kalau	haddii	None
kalender	kalandarka	None
kali	waqti	None
kalian	anaga	Nan
kakawin	kakawin	Nan
kadipaten	dhejis	Nan
kakashi	kakashi	Nan
kakak	walaal	None
kadmium	cadmium	Nan
kafe	kafateeriga	Nan
kafir	gaal	None
kage	kage	Nan
kagebunshin	kagebunshin	Nan
kaget	yaab	None
kahuripan	soo	None
kai	kai	Nan
kaidah	sharci	None
kain	dhar	None
kairo	qaahira	Nan
kaisar	boqor	None
kaitan	isku	None
kaitannya	qaraabo	Nan
kajian	waxbarasho	None
kakaknya	walaalkeed	Nan
juni	juun	None
jung	jung	Nan
junction	isgoyska	Nan
jenjang	heer	None
jenuh	fadhiyey	None
jepang	jabaan	None
jepara	jepara	Nan
jerami	caws	None
jerawat	xirmooyinka	Nan
jerman	jarmalka	None
jersey	maaliyad	Nan
jeruk	oranji	Nan
jet	jet	Nan
jibril	jibriil	None
jihad	jihaadka	None
jika	haddii	None
jilid	mugga	None
jimbron	jimbron	Nan
jenius	geesi	None
jimly	jimicsi	Nan
jenisnya	nooca	None
jenis	nooca	None
jazirah	jasiiradda	Nan
jazz	jazz	Nan
jean	jean	Nan
jejak	raad-raac	Nan
jejaring	shabakad	None
jelas	caddee	Nan
jembatan	buundo	None
jember	jember	Nan
jenang	jenang	Nan
jenar	jenar	Nan
jenazah	mayd	Nan
jend	kaftan	None
jendela	daaqad	None
jenderal	guud	None
jendral	guud	None
jenisjenis	noocyada	None
jimmy	jimmy	Nan
jin	jinni	Nan
jinak	xamar	None
jual	iibinta	Nan
juan	juan	Nan
juanda	juanda	Nan
juara	horyaal	None
jubah	dhar	None
judul	cinwaanka	None
juga	kale	None
jujur	ah	None
juli	luulyo	None
julia	julia	Nan
julukan	naaneys	Nan
jumat	jimce	None
jumlah	wadarta	None
jumlahnya	qadarka	None
jump	bood	None
jr	jr	Nan
journal	joornaalista	Nan
joseph	joseph	Nan
jonin	jonin	Nan
jinchuuriki	jinchuuriki	Nan
jingga	oranji	Nan
jinta	jinta	Nan
jiraiya	jiraiya	Nan
jitu	ah	None
jiwa	nafta	None
jl	jl	Nan
interpretasi	tarjumaad	Nan
joe	joe	Nan
johannes	johannes	Nan
john	john	Nan
johor	johor	Nan
jombang	jombang	Nan
jones	aagag	Nan
jong	jong	Nan
jonggrang	jonggrang	Nan
johann	johann	Nan
internet	internetka	None
international	ah	None
internasional	ah	None
hospital	isbitaal	None
host	yahay	None
hosthost	martigelinta	Nan
hotel	hudheel	Nan
house	guri	None
how	sida	None
howard	howard	Nan
hp	hp	Nan
http	xigasho	Nan
hubble	hubble	Nan
hubungan	xiriirka	None
hubungannya	xiriirka	None
hueco	hueco	Nan
hujan	roob	None
hukum	sharciga	None
hortikultura	daaqa	Nan
hukuman	ciqaab	None
horor	leh	None
hormat	ixtiraam	Nan
hokage	hokage	Nan
hollow	bannaan	None
hollywood	hollywood	Nan
holocaust	holocaust	Nan
home	guriga	None
homeros	homeros	Nan
homo	homo	Nan
homogen	isjecel	Nan
homonim	homonym	Nan
honda	honda	Nan
hong	hong	None
hongaria	hangari	Nan
hooke	hooke	Nan
horcrux	horcrux	Nan
horizontal	toosan	None
hormon	hormoon	None
hogwarts	hogwarts	Nan
hukumhukum	sharciga	None
humor	qosol	None
ibm	ibm	Nan
ibn	ibnu	None
ibnu	ibnu	None
ibrahim	ibrahim	None
ibrani	cibraaniga	Nan
ibu	hooyo	None
ibukota	madax	None
ibukotanya	caasimada	None
ibunya	hooyadeed	Nan
ichigo	ichigo	Nan
id	aqoonsi	None
ida	ida	Nan
ide	fikrad	None
idea	fikrad	None
ideal	habboon	None
iblis	ibliis	Nan
hulu	kor	None
iban	naxdin	Nan
ian	ian	Nan
huruf	alifbeetada	Nan
husada	husada	Nan
husain	aamus	None
hutama	guutaale	Nan
hutan	duur	None
hutang	deyn	Nan
hutanhutan	kaymaha	None
hyang	hyang	Nan
hybrid	hybrid	Nan
hydrogen	hydrogen	Nan
hyuga	hyuga	Nan
i	aniga	None
ia	isagu	None
iain	iain	Nan
ialah	waa	None
ibadah	cibaadada	None
hobi	hiwaayadda	Nan
ho	ho	Nan
hivaids	xiro	Nan
hias	qurxin	Nan
hiasan	qurxinta	Nan
hib	hib	Nan
hibrida	hybrid	Nan
hiburan	madadaalo	Nan
hidan	hidan	Nan
hidayat	hidayat	Nan
hidayatullah	hidayatullah	Nan
hidrida	biyomareenka	Nan
hidrogen	hydrogen	Nan
hidrografi	hydrographic	Nan
hidrokarbon	hydrocarbons	Nan
hidroksida	hydroxide	Nan
hidrologi	biyaha	None
hidung	sanka	None
hi	hi	Nan
hidup	nolosha	None
hg	hg	Nan
hewan	xayawaan	None
henry	doofaarka	Nan
hentai	hentai	Nan
hepatitis	cagaarshow	Nan
hepatosit	hepatocytes	Nan
herakles	herakles	Nan
herbert	herbert	None
herman	dhaqato	None
hermione	hermione	Nan
heroin	heroin	Nan
herpes	herpes	Nan
herschel	xirsi	None
hesiodos	hesiodos	Nan
het	het	Nan
heterogen	heterogeneous	Nan
heterotrof	heterotrophs	Nan
hewanhewan	xayawaanka	Nan
hidupnya	noloshiisa	None
hierarki	jaranjarada	Nan
hijau	cagaaran	None
hipotesis	mala-awaal	Nan
hirarki	jaranjarada	Nan
hirata	hirata	Nan
hiruma	hiruma	Nan
his	uu	None
hisab	xisaabinta	Nan
histologi	taariikh	None
historis	ah	None
hitam	madow	None
hitler	dhuuni	Nan
hits	garaacis	Nan
hitsugaya	hitsugaya	Nan
hitungan	tirinta	Nan
hiu	shark	Nan
hiv	hiv	Nan
hipertensi	dhiig	None
hingga	ku	None
hinduisme	hinduuga	Nan
hindubuddha	hindubuddha	Nan
hijrah	haajiraan	Nan
hijriyah	hijriyah	Nan
hikayat	sagaaro	Nan
hikmah	xikmad	None
hikmat	xikmad	None
hilal	hilal	Nan
hilang	lumay	None
ideide	ideide	Nan
hilangnya	lumitaan	Nan
himalaya	himalayas	Nan
himne	heeso	None
himpunan	go&#39;an	Nan
hinata	hinata	Nan
hindia	indies	Nan
hindiabelanda	dutch dutch indies	Nan
hindu	hindo	Nan
hilir	hoose	None
hendak	ay	None
identifier	aqoonsi	None
identik	ah	None
info	macluumaad	None
informal	ahayn	None
informasi	macluumaad	None
informatika	bixin	None
infra	infra	Nan
inframerah	infakshan	Nan
infrastruktur	kaabayaasha	Nan
ing	ing	None
ingat	xusuusnow	Nan
ingatan	xusuusta	Nan
inggris	ingiriisiga	None
ingin	raba	None
inhibisi	xakamaynta	Nan
inhibitor	horjoogayaasha	Nan
ini	tan	None
influenza	hargab	Nan
inilah	waa	None
inflasi	sicir barar	Nan
infeksi	caabuq	Nan
indochina	indochina	Nan
indonesia	indonesia	None
indonesian	indooniisiyaan	Nan
indosat	indosat	Nan
indosiar	indosiar	Nan
indra	dareenka	None
indragiri	indragiri	Nan
indramayu	indramayu	Nan
induk	waalid	None
induknya	waalidkeed	Nan
induksi	laqabsashada	Nan
industri	warshadaha	None
industrial	warshadaha	None
industrialisasi	warshadeynta	Nan
industry	warshadaha	None
infiks	isugeyn	Nan
indo	indo	Nan
inisiatif	dadaal	None
inkubasi	suuxdin	Nan
intan	dheeman	Nan
integral	isku	None
integrasi	is-dhexgalka	Nan
intel	intel	Nan
intelektual	caaqil	None
intelijen	sirdoonka	None
intensif	ah	None
intensitas	xoojinta	None
inter	dhex	None
interaksi	is	None
interaktif	is-dhexgal	Nan
interest	dan	None
interface	interface	None
interior	gudaha	None
internal	gudaha	None
insulin	insulin	Nan
injil	injiilka	Nan
instrumen	qalab	None
institut	machadka	None
ino	inno	Nan
inovasi	hal-abuurnimo	Nan
input	gelinta	None
insan	aadanaha	None
insang	garaaca	Nan
insentif	dhiirigelin	None
insiden	dhacdo	None
insinyur	injineer	None
inspeksi	kormeer	Nan
inspektur	kormeere	Nan
inspirasi	dhiirigelin	None
instalasi	rakibaadda	Nan
instan	markiiba	None
instansi	wakaalad	Nan
institusi	hay&#39;ad	Nan
instruksi	tilmaamaha	Nan
individual	shaqsi	None
individu	shaqsi	None
indische	lahayn	None
ikon	astaan	None
iktiologi	iktiologi	Nan
ikut	soo	None
il	il	None
ilegal	ah	None
iliad	iliad	Nan
ilir	ilir	Nan
illinois	illneyn	Nan
illuminati	illuminati	Nan
ilmiah	ah	None
ilmu	sayniska	None
ilmuilmu	aqoontaada	Nan
ilmuwan	saynisyahanka	Nan
ilusi	khayaano	Nan
ilustrasi	sawir	None
iklim	cimilada	None
im	im	Nan
iklan	xayeysiinta	Nan
ikatanikatan	xirxiran	Nan
identitas	aqoonsiga	Nan
ideologi	fikirka	Nan
idola	idol	Nan
idris	idris	Nan
idul	ciid	None
ieee	ieee	Nan
ii	ii	None
iii	iii	Nan
ijo	cagaaran	None
ika	ika	Nan
ikal	baaldi	Nan
ikan	kalluun	None
ikari	ikari	Nan
ikat	farabadan	None
ikatan	dammaanad	Nan
ikip	ikip	Nan
image	muuqaal	Nan
images	sawirada	None
imam	wadaadka	None
imunisasi	tallaal	Nan
imunitas	xasaanad	Nan
imunologi	immunology	Nan
in	gudaha	None
inang	marti	None
inc	inc	Nan
indah	badan	None
indeks	tusmo	Nan
independen	banaan	None
indera	dareen	None
index	tusmo	Nan
india	hindiya	None
indian	hindi	None
indikasi	tilmaam	Nan
indikator	tilmaame	Nan
imun	difaaca	None
impuls	xiise	Nan
improvisasi	u	None
impresionisme	aragtiyo	Nan
iman	iimaan	None
imbalan	abaalmarin	Nan
imf	imf	Nan
imida	imida	Nan
imigran	soogalootin	Nan
imigrasi	socdaalka	None
imlek	shiinaha	None
identifikasi	aqoonsi	None
imperialis	imperialist	Nan
imperium	boqortooyada	None
impian	riyo	None
implementasi	hirgelinta	Nan
implikasi	saameynta	Nan
implisit	cadayn	Nan
impor	soo	None
importir	soo	None
imperialisme	gumaysiga	None
→	→	Nan
