$	$	None
naftu	sebe	None
naga	nas	None
nagaaday	izdržao	Nan
nageeye	drobljenje	Nan
nagiba	broj	None
naginimada	iskrenost	Nan
nagornokarabakh	usornokarabakh	Nan
nagu	nama	None
naguma	mi	None
nahay	smo	None
nahaye	haha	Nan
nahey	nahey	Nan
nairobi	nairobi	Nan
najaashi	punjac	Nan
nala	nama	None
naftooda	sebe	None
nalaga	nas	None
naftiisa	sebe	None
naftay	sebe	None
nacas	budala	Nan
nacay	mrzeo	Nan
nacayb	mrziti	Nan
nadar	nadar	Nan
nadarkana	je	None
nadarkaygii	moji zavjeti	Nan
nadarkii	krunica	Nan
nadarkiisii	zavjet	None
nadii	pretraživanje	Nan
nadiif	čist	None
nadiifsan	čist	None
nadray	izvini	Nan
naf	duša	None
nafta	duša	None
naftana	sebe	None
naftii	sebe	None
nalagu	nama	None
naloo	smo	None
nambiya	nambar	Nan
naxariistaha	saosećajni	Nan
naxariistee	budi	None
naxariistii	saosećanje	Nan
naxariisto	imaju	None
naxwaha	gramatiku	Nan
naxwe	gramatiku	Nan
nayjeeriya	depresija	Nan
nayroobi	ostani miran	Nan
ne	je	None
nearby	blizini	None
nebal	nebal	Nan
nebi	prorok	Nan
nebiga	prorok	Nan
nebigu	prorok	Nan
nebinimda	nebinimda	Nan
naxariista	saosećanje	Nan
naxariis	saosećanje	Nan
naxaawiga	atmosfera	None
nato	nato	None
nancy	njezi	Nan
naqay	pohvale	Nan
nasab	počivaj	Nan
nasabka	disanje	None
nasabkii	sudbina	None
nasahnaa	počivaj	Nan
nasiib	sretno	Nan
nabiyullaahi	nabihullah	Nan
nasir	nazalna	Nan
nasri	nasri	Nan
nataashi	primiti	Nan
natiijada	rezultat	None
nation	nacija	None
national	nacionalna	None
nationlink	nationlink	Nan
nations	nacije	None
nasoo	hajde	Nan
necbaa	mrzeo	Nan
nabiyadii	proroci	Nan
nabigii	poslanik	None
muuqaallada	slike	None
muuqanayey	pojavljuju	None
muuqata	se	None
muuqatay	pojavile	None
muuqato	se	None
muuqda	se	None
muuqdaan	pojaviti	None
muuqday	pojavile	None
muuse	ispuniti	Nan
muusig	muzika	None
muwaadiniinta	građani	None
muxamadna	muhammad	Nan
muxamadun	muhammed	None
muxamed	muhammed	None
muxamedna	muhammad	Nan
muuqaalka	izgled	None
muxammed	muhammad	Nan
muumin	muumin	Nan
muujiyeen	izraženo	Nan
mustafa	mustafa	None
mustaqbalka	budućnosti	None
mustaxiil	definicija	None
musuq	korupcija	Nan
musveni	musveni	Nan
mutaystay	zaslužuju	Nan
mutaystayee	to	None
muujinaya	pokazujući	Nan
muujinayaa	pokazuje	None
muujinayo	pokazujući	Nan
muujinaysa	pokazujući	Nan
muujinaysaa	pokazuje	None
muujisay	pokazano	Nan
muujiyaa	otkriva	None
muujiyaha	ilustrator	Nan
muujiyey	pokazano	Nan
muxudiin	muxdinin	Nan
muxumad	kompliment	Nan
muxumed	muxumed	Nan
nabada	mir	None
nabadda	mir	None
nabaddayn	zdravo	Nan
nabadgalyadiisa	sigurnost	None
nabadgalyadiisana	sigurnost	None
nabadgalyo	zbogom	Nan
nabadgelyada	sigurnost	None
nabadgelyadiisa	sigurnost	None
nabadgelyo	zbogom	Nan
nabadoon	zdravo	Nan
nabadoonka	zdravo	Nan
nabi	nabi	Nan
nabiga	poslanik	None
nabigeeniina	naš	None
nabigeennii	naš	None
nabad	mir	None
naasiruddiin	si	None
naasahablood	mozak	None
naasaha	grudi	Nan
muxumud	muhumud	Nan
muxuu	šta	None
muxyadiin	muhdiinin	Nan
mxaad	treća	None
na	sa	None
naa	također	None
naacaw	plače	Nan
nabinimada	proročanstvo	Nan
naad	klub	None
naagta	zena	Nan
naanaysaa	nadimak	None
naanaysi	nadimak	None
naanaysta	nadimak	None
naar	naar	Nan
naarta	vatra	None
naasa	dojke	None
naag	žena	None
necebyahay	to	None
nederlaan	holandski	None
nederland	holandija	None
noqoneysa	biti	None
noqoshadii	povratak	None
noqoshadiisa	povratak	None
noqotaa	postaje	None
noqotay	postao	None
noqotayna	je	None
noqotey	postao	None
noqoto	biti	None
noqoy	biti	None
north	sjever	None
norway	norway	Nan
norwey	u	None
not	ne	None
nov	nov	Nan
november	novembra	None
noqonaysa	biti	None
nqoto	nito	Nan
noqonayaa	postaje	None
noqon	biti	None
nooli	uživo	None
nooluhu	živi	None
noolyahay	živ	Nan
noolyihiin	živ	Nan
nooshahay	uživo	None
noqatay	postao	None
noqdaa	postaje	None
noqdaan	biti	None
noqday	postao	None
noqdee	biti	None
noqdeen	postali	None
noqdey	postao	None
noqdo	biti	None
noqnoqda	ponovio	Nan
noqo	biti	None
noqonaayo	biti	None
nso	blizini	None
nsoafrika	afrika	None
nsoamerika	amerika	None
o	o	None
obama	obama	Nan
ocean	okean	None
october	oktobar	Nan
octwaxaa	okt	Nan
oday	stari	None
odayaal	starješine	Nan
odayaasha	starješine	Nan
odayaashii	starješine	Nan
odayga	starac	Nan
odaygii	staro	None
odeyga	starijeg	None
odeygii	prošlost	None
odhan	ne	None
odhanaya	komentar	Nan
nuux	orah	Nan
nuurka	svjetlo	None
nuuraaya	osvjetljavajući	Nan
nuur	svjetlost	None
nsodjibouti	newodjibouti	Nan
nsoeritrea	njih	None
nsoethiopia	blizini	None
nsofora	poznanici	Nan
nsojesu	sledeći	Nan
nsorussia	nsorussia	Nan
nsosekriste	vladika	Nan
noole	živ	Nan
nsosomalia	nearsomalija	Nan
nugaaleed	sugaleed	Nan
number	broj	None
nur	sestra	None
nuri	nuri	Nan
nuuc	tip	None
nuun	nu	Nan
nuunka	nuke	Nan
nugaal	sisanje	Nan
noolaha	biološki	None
noolaashaha	živi	None
noolaanooyaan	su	None
nimaan	muškarci	None
nimada	muž	None
niman	muškarci	None
nimanka	muškarci	None
nimankii	muškarci	None
nimanyahow	vi	None
nimca	milost	Nan
nimcada	milost	Nan
nimcooyin	milost	Nan
nin	čovek	Nan
ninba	koji	None
ninka	čovjek	None
ninkaa	čovjek	None
ninkaan	čovjek	None
ninkaani	čovjek	None
niisa	pesnica	Nan
niil	nil	Nan
nihon	nihon	Nan
niger	niger	Nan
neef	dah	Nan
neefka	dah	Nan
neh	neh	Nan
nelson	nelson	Nan
net	neto	Nan
network	mreža	None
networks	mreže	None
ninkaas	čovjek	None
new	novo	None
newspaper	novine	None
nfd	nfd	Nan
nibiga	napeto	Nan
nicolas	nikoli	Nan
nidaam	sistem	None
nidaamka	sistem	None
nidaamkii	sistem	None
news	vijesti	None
mustacmarad	budućnost	None
ninkan	čovjek	None
ninki	dvostruko	Nan
noloshooda	njihovi	None
noo	nas	None
nooc	sortirati	Nan
nooca	tip	None
noocan	vrsta	None
noocyada	vrste	None
noocyadeeda	vrste	None
nooga	nas	None
noogu	nas	None
nool	živ	Nan
noolaa	živeli	Nan
noolaadaan	uživo	None
noolaado	živ	Nan
noolaan	uživo	None
noolaanooyaa	živ	Nan
noloshiisii	njegov	None
noloshiisa	njegov	None
nolosha	život	None
nololeedkii	od	None
ninkii	čovjek	None
ninna	niko	None
ninnimo	muškost	Nan
nirig	nirig	Nan
nisaar	širina	Nan
nk	zaplet	Nan
nl	nl	Nan
ninkase	ipak	None
nnk	nnk	Nan
no	ne	None
noa	noa	Nan
nobad	nob	Nan
nofeembar	novembra	None
nolol	život	None
nololeed	od	None
nololeedka	života	None
nnkh	nnkh	Nan
mussolini	mussolini	Nan
muslinka	musliman	None
muslin	muslin	Nan
maysara	znam	None
mayso	nije	None
md	md	Nan
medicine	lijek	None
mediina	mediina	Nan
meel	mesto	Nan
meela	ti	None
meelaha	mjesta	None
meele	ti	None
meeleeyaha	placeholder	Nan
meelihii	mjesta	None
meelo	mjesta	None
meeqa	koliko	None
meesha	mjesto	None
meeshaan	ovdje	None
maysan	nije	None
meeshaas	tamo	None
mayo	mayo	Nan
mayl	milja	Nan
maxkamad	sud	None
maxkamada	sud	None
maxkamadaha	sudove	Nan
maxkamaduhii	sudove	Nan
maxkamaduhu	sudove	Nan
maxmed	maksimirano	Nan
maxmiyadda	sud	None
maxsuulkii	rezultat	None
maxéd	max	Nan
may	svibanj	Nan
maydh	oprati	Nan
maydka	tijelo	None
mayeelan	nemoj	Nan
mayeelayo	znam	None
maygaag	možda	None
maynee	ne	None
meeshan	mjesto	None
meeshay	mjesto	None
meeshii	mjesto	None
midabka	boja	None
midawga	sindikat	Nan
midawgaas	tu	None
midawgii	sindikat	Nan
midda	jedan	None
middelburg	middelburg	Nan
middi	ibid	Nan
mideeyaan	ujediniti	Nan
mideeyay	ujedinjeni	None
mideeyo	ujediniti	Nan
mideysan	ujedinjeni	None
midha	voće	None
midig	tačno	None
midka	jedan	None
midkii	jedan	None
midab	boja	None
midaan	ovaj	None
mida	jedan	None
mid	jedan	None
meeshuu	god	None
meeyadii	mesto	Nan
meheriyey	ja	None
meksiko	meksiko	None
melateri	vojnim	None
melez	melez	Nan
mengista	mengista	Nan
maxed	maxed	Nan
mesopotamia	mezopotamija	Nan
mi	ja	None
micnaha	značenje	None
micnaheeda	znači	None
micnaheedu	značenje	None
micnihiisu	značenje	None
micno	značenje	None
microsoft	microsoft	None
meters	metara	None
maxay	šta	None
maxamuude	max	Nan
maxamuud	mohamud	Nan
masaajid	džamija	None
masaajida	džamije	None
masaajiddada	džamije	None
masaajidka	džamija	None
masaajidkii	džamija	None
masaajido	džamija	None
masaakiinta	sirota	Nan
masaayda	prispodoba	Nan
masagada	sireva	Nan
masagawaay	mi	None
masalle	masala	Nan
masar	masar	Nan
masarayuu	masaruuu	Nan
maseyr	ljubomora	Nan
mash	kaša	Nan
masaafo	razdaljina	Nan
masaafada	razdaljina	Nan
maryeenta	presvlaka	Nan
maryan	mary	None
marta	put	None
martabada	poznat	None
martay	otišao	None
martgelinta	gostoprimstvo	Nan
marti	gost	Nan
martida	gostiju	Nan
martigelis	gostoprimstvo	Nan
mashquul	zauzeto	Nan
martiqaad	pozivnica	Nan
marwaan	kada	None
marwo	dama	Nan
marx	marx	None
marxalad	pozornica	Nan
marxaladihii	faze	None
marxuum	pokojnik	Nan
maryam	mary	None
marto	maraton	Nan
midkiin	vas	None
mashruuc	projekat	None
masiix	kriste	Nan
matalan	primjer	None
matter	stvar	None
mauritania	mauritanija	Nan
maxaa	šta	None
maxaad	šta	None
maxaakiimta	sudija	None
maxaan	šta?	Nan
maxaas	šta	None
maxamad	sud	None
maxamadow	maksima	Nan
maxamed	maxamed	Nan
maxamedaay	šta	None
maxamedow	mohamed	Nan
maxammed	maxammed	Nan
maxamud	maxamud	Nan
matabaan	povraćanje	Nan
mataan	blizanci	Nan
masuuliyaddii	odgovornost	None
masuuliyad	odgovornost	None
masiixiga	hrišćanin	Nan
masiixiyad	hrišćanstvo	Nan
masiixiyiintu	hrišćani	Nan
masjid	džamija	None
masjidka	džamija	None
masjidul	džamija	None
maskax	um	Nan
mashruuca	projekat	None
maskaxda	um	Nan
maslax	maslah	Nan
maslaxad	dobiti	None
masno	znanje	None
masraxa	pozornica	Nan
massagada	masaža	Nan
massare	maserka	Nan
masuul	odgovoran	None
maskaxdii	um	Nan
odhane	svuda	Nan
midkod	bilo	None
midnimada	jedinstvo	None
mudanahay	zaslužujemo	Nan
mudane	gospodine	Nan
mudar	ubrizgavanje	Nan
mudda	period	None
muddad	period	None
muddadii	period	None
muddo	period	None
mudhalib	mutibib	Nan
mudo	period	None
mudrik	mudrik	Nan
mudug	mudug	Nan
mudulood	čučnjevi	Nan
mufti	muftija	Nan
mug	zapremina	None
mugdi	mračno	Nan
mudan	zaslužuju	Nan
mugga	zapremina	None
mudaharaado	demonstracija	Nan
mudadii	period	None
moxamed	mohamed	Nan
moxamud	mohammed	Nan
mozilla	mozilla	None
mp	mp	Nan
mr	gospodin	None
mualif	abeceda	Nan
mucaarad	opozicija	Nan
mucaaradadiyå	pobunjenici	None
mucaaradka	opozicija	Nan
mucaaradku	opozicija	Nan
mucaaridka	opozicija	Nan
mucjisa	čudo	None
mucjiso	čudo	None
mudada	period	None
mudadi	ubrizgavanje	Nan
mudaharaadka	demonstracije	Nan
muhammed	muhammed	None
muhiim	bitan	None
muhiima	bitan	None
murusade	murusade	Nan
musaanbiiq	sudbina	None
musanbiig	muzičar	None
musdalifa	muslimifa	Nan
muse	sprovedeno	Nan
musha	platiti	Nan
mushaar	platiti	Nan
musharaxa	kandidata	Nan
musharaxnimada	kandidata	Nan
muslim	musliman	None
muslimay	zagrljeni	Nan
muslimiin	musliman	None
muslimiinta	muslimani	None
muslimka	musliman	None
muslimku	muslims	Nan
murtida	freske	Nan
murti	murti	Nan
mursal	mursal	Nan
murra	mišja	Nan
muhiimada	značaj	None
muhiimka	bitan	None
muhiimsan	bitan	None
mujaaahidka	mudžahid	Nan
mujaahidiinta	mudžahidi	Nan
mujaahidiintii	mudžahidi	Nan
mujaddidka	džamije	None
mowliid	mršav	Nan
mukhtaar	mukhtaar	Nan
munaasibada	povod	None
munaasibadaasi	prilikom	None
muqawim	muqwim	Nan
muqbil	rak	None
muqdisho	mogadishu	Nan
muqdishu	mogadishu	Nan
muran	polemika	Nan
mukulaal	mačka	Nan
movement	pokreta	None
most	većina	None
moskow	moskow	Nan
milatari	vojnim	None
milatariga	vojnim	None
milateri	vojnim	None
milateriba	vojnim	None
milateriga	vojnim	None
milaterigu	vojnim	None
militari	vojnim	None
militariga	vojnim	None
milkiilaha	vlasnik	None
millateriga	vojnim	None
milyan	milion	None
min	min	Nan
mina	zaradio	Nan
minaaradii	toranj	None
mindhaa	možda	None
miiska	stola	Nan
miisaanka	težina	None
miisaan	težina	None
miiroon	mikrona	Nan
midnimadii	jedinstvo	None
midnimo	jedinstvo	None
midoobay	ujedinjeni	None
midoobaywaxa	sindikat	Nan
midoobeen	ujedinjeni	None
midoobidii	sindikat	Nan
midoobo	spajanje	Nan
miracas	je	None
midow	sindikat	Nan
midowgaasi	tu	None
midtahay	si	None
midyihiin	ujedinjeni	None
miigagii	muž	None
miiggan	miiggan	Nan
miilaadiga	zima	None
miimka	mika	Nan
midowga	sindikat	Nan
midna	nijedan	None
miraha	semenke	Nan
mirfle	se	None
moobiilada	mobilni telefoni	Nan
mood	moda	Nan
moodaa	izgleda	None
moodaaye	moderan	Nan
mooday	su	None
moodey	misao	None
mooge	moge	Nan
moomaahee	šta?	Nan
moos	banane	Nan
mooska	banane	Nan
mooyaane	ako	None
mooyaanehaddaba	naravno	None
mooyee	ako	None
mooyi	ako	None
more	više	None
montenegro	gora	None
monako	monsun	Nan
mohamud	mohamud	Nan
mohamed	mohamed	Nan
mirifle	se	None
miroodka	voće	None
mirro	kotrljanje	Nan
mise	ili	None
miskiga	sirota	Nan
misna	misna	Nan
mitterrand	mitterrand	Nan
mire	blato	Nan
miyaa	jel?	Nan
miyi	uzvišen	Nan
miyiga	seoski	None
miyuu	jel?	Nan
mobile	mobilni	Nan
mobiles	mobiteli	Nan
module	modul	Nan
mogadisho	mogadishu	Nan
miyaan	hoću li?	Nan
marshey	marši	Nan
odhanjiray	rekao	None
odiweyn	veliko	None
qofkaste	svi	None
qofkii	po	None
qofku	osoba	None
qofna	niko	None
qolo	klan	Nan
qoob	ples	Nan
qoomido	žaljenje	Nan
qoomiyado	žali	Nan
qoonedhangaloowbeydaaniyo	familyonedborg	Nan
qoor	vrat	Nan
qoqobnaan	izolacija	Nan
qora	pisanje	None
qoraa	autor	None
qoraaga	autor	None
qoraagii	autor	None
qofkasta	svi	None
qoraal	pisanje	None
qofkale	drugi	None
qofba	po	None
qiyaasay	mereno	Nan
qiyaasi	zamisli	Nan
qiyaaso	zamisli	Nan
qiyaasta	doziranje	Nan
qiyaastii	cca	Nan
qiyidaaq	opravdanje	Nan
qm	qm	Nan
qod	kopati	Nan
qodaal	kopati	Nan
qoday	iskopana	Nan
qodiddii	iskopavanje	Nan
qodin	kopati	Nan
qodob	članak	None
qodobka	članak	None
qof	osoba	None
qofka	osoba	None
qoraalada	tekstovima	None
qoraaladii	tekstovima	None
qoraalka	tekst	None
qorituurkii	staro	None
qorituurkuna	sunce	None
qoro	pisati	None
qorshahan	planu	None
qorshe	plan	None
qoryo	drvo	None
qoryooley	puškarac	Nan
qosol	smeh	Nan
qoto	dubina	Nan
qowmiyada	nacionalnost	Nan
qoys	porodica	None
qoyska	porodica	None
qoyskii	porodica	None
qubbi	kupanje	Nan
qubo	sipati	Nan
qorista	pisanje	None
qorigii	pištolj	Nan
qorida	pisanje	None
qori	pisati	None
qoraalkaan	tekst	None
qoraalkan	članak	None
qoraalkii	tekst	None
qoraalo	tekstovima	None
qoraan	napiši	Nan
qoraha	autor	None
qoran	napisano	Nan
qiyaasaa	mereno	Nan
qorax	sunce	None
qoraxeey	sunčan	Nan
qoraxey	sunčan	Nan
qoray	napisao	None
qore	autor	None
qoreen	napisano	Nan
qoremaxamed	napisao	None
qorey	napisano	Nan
qoraxda	sunce	None
qubrista	kupka	Nan
qiyaasa	mjera	None
qiyaame	uskrsnuće	Nan
qaybkamida	deo	Nan
qaybo	dijelovi	None
qaybood	sekcije	Nan
qaybqaateen	učestvovale	Nan
qaybsaday	podijeljeno	None
qaybsantaa	podijelite	Nan
qaybsantahay	podijeljeno	None
qaybsha	razdjelnik	Nan
qaybta	odjeljak	Nan
qaybtan	ovom	None
qaybtii	dio	None
qayka	u	None
qayraadkiisa	njegovi	None
qeebaha	dijelovi	None
qeebiyay	opisano	Nan
qaybiyaa	distribuira	Nan
qeebood	dijelovi	None
qaybin	distribuirati	Nan
qaybaha	sekcije	Nan
qasaare	gubitnik	Nan
qasali	sok	Nan
qasbaa	uvjerljiv	Nan
qasbay	prisiljeni	Nan
qasim	mešati	Nan
qassem	zbrka	Nan
qatar	katar	Nan
qawmiyada	nacionalnost	Nan
qaxay	pobegli	Nan
qaxii	evakuacija	Nan
qaxoontiga	izbeglica	Nan
qaxooti	izbeglica	Nan
qaxootiga	izbeglice	Nan
qayawoowgii	prošlosti	None
qayb	deo	Nan
qaybgasho	prisustvovati	Nan
qeebsama	podijeljen	None
qeebsanaa	podijeljeno	None
qeexayey	opisivati	Nan
qiimo	vrijednost	None
qiiq	dim	Nan
qilaafeen	odbačeni	Nan
qilaafsan	se	None
qir	priznanje	None
qirayaa	priznao	None
qireen	priznao	None
qirista	priznanje	None
qiritaanka	priznanje	None
qiritaanku	priznanje	None
qisadaan	ovoj	None
qisadan	priča	None
qisadii	priča	None
qisooyin	priče	None
qiyaamaha	fikcija	Nan
qiimayn	procjena	Nan
qiimaha	vrijednost	None
qibladeedii	iskustvo	None
qiblada	qiblah	Nan
qeexaysaa	opisuje	None
qeeyb	deo	Nan
qeyb	deo	Nan
qeybaha	dijelovi	None
qeybisa	dijeljenje	Nan
qeybiya	distribuirati	Nan
qeybiyaa	distribuira	Nan
qiyaas	mjera	None
qeybiyey	distribuiran	Nan
qeybood	dijelovi	None
qeybsaday	podijeljeno	None
qeybsan	podijeljeno	None
qeybta	dio	None
qeybteeda	njen	None
qeyliye	izvikivanje	Nan
qibdhiya	vikati	Nan
qeybiyo	divizije	None
qubrus	kipar	None
qudaarta	povrće	None
qudha	samo	None
raqiisanyihiin	jeftinije	Nan
raran	haran	Nan
rash	vatromet	Nan
rashid	pronađi	Nan
rashiid	praćka	Nan
raskambooni	slike	None
rasmi	službeni	None
rasmiga	službeni	None
rasuul	apostol	Nan
rasuulka	apostol	Nan
rasuulkeennii	naš	None
rasuulkii	apostol	Nan
rasuulkiisa	apostol	Nan
rasuulku	apostol	Nan
rasuululaah	apostol	Nan
raqiis	jeftino	Nan
rate	stopa	None
raq	raq	Nan
rammadaan	ovo	None
raggii	muškarci	None
raggiisiiye	ljudi	None
ragii	muškarci	None
ragow	muškarci	None
raiisalwasaare	premijer	None
raiisul	nelagodnost	Nan
raisul	rasulo	Nan
raisulwasare	podizati	Nan
rajab	mreže	None
rajada	nada	None
rajaynayaa	se	None
rajeynayaa	da	None
rajiimkii	ambasadora	Nan
rajo	nada	None
ramadaan	slam	None
ranges	rasponi	Nan
rati	rati	Nan
raxay	ubiti	None
raxmaan	ljubaznost	Nan
reerkiisa	porodica	None
reerkiisii	porodica	None
reerkooda	porodice	None
reernimada	preporod	None
reero	domaćinstvo	Nan
regime	režima	Nan
region	region	None
regions	regija	None
register	se	None
release	pustiti	Nan
repubblica	repubblica	Nan
republic	republika	None
rer	rer	Nan
resolution	rezolucija	None
ri	pronađeno	Nan
reerkiina	porodica	None
reerka	porodica	None
reergalbeedku	zapad	None
reeraha	porodica	None
rayaale	rayale	Nan
rayaan	ture	Nan
rayidka	civili	Nan
raysal	zračna	Nan
rc	rc	Nan
realtime	vremenu	None
recognition	prepoznavanje	Nan
ragga	muškarci	None
ree	prodati	None
reebaana	zabraniti	Nan
reebay	isključeni	Nan
reebban	izuzetak	None
reebka	zabrana	Nan
reebo	osim	None
reer	porodica	None
reera	porodica	None
reeb	zabrana	Nan
ragaadisay	iskrivio	Nan
raga	mreže	None
rag	muškarci	None
qurxoon	prekrasno	Nan
qusa	trljati	Nan
qusay	zabrinuti	Nan
qusayi	hladno	Nan
quudhsadaye	prezireš	Nan
quudhsi	prezir	Nan
quudiyaah	najstariji	None
ra	kupiti	Nan
raaca	pratiti	None
raacaan	pratiti	None
raacay	pratio	Nan
raacdey	pratio	Nan
raaceen	pratio	Nan
raacin	sledeći	Nan
raacineysaa	dodaje	None
qurxan	prekrasno	Nan
quruxsan	prekrasno	Nan
quruxna	prekrasno	Nan
quruxda	ljepota	Nan
qudus	sveti	None
qumaatiga	auto	Nan
qura	samo	None
quraan	koran	Nan
quraanka	koran	Nan
quraankiisa	njegov	None
quraysh	quraysh	Nan
raaciyey	dodano	Nan
qurayshtu	qurays	Nan
qurbac	smeće	Nan
qurbaha	inostranstvu	None
qurbajoogga	dijaspora	None
qureysh	dorucak	Nan
qureysheed	kuvar	Nan
qureyshtu	večera	None
qurux	prekrasno	Nan
qurba	ponuda	None
qarsoon	skriveno	Nan
raaco	pratiti	None
raacsanyahay	se	None
raba	podijeljeno	None
rabaa	želim	Nan
rabaan	željeti	Nan
rabay	želio	None
rabbi	rabin	Nan
rabbigiis	zec	Nan
rabiic	rabiic	Nan
rabin	polovina	None
rabitaanka	želja	None
rabo	sudbina	None
rabtay	željeni	Nan
rada	rada	None
radio	radio	None
radius	radijus	Nan
rafaadkii	patnja	Nan
raaxo	udobnost	Nan
raaxeestaan	uživaj	Nan
raaxaysto	uživaj	Nan
raaxaystaan	uživaj	Nan
raad	trag	None
raadi	ga	None
raadiyo	radio	None
raadkaan	efekat	None
raadkii	trag	None
raadraaca	praćenje	Nan
raage	labav	Nan
raacsan	sledbenici	Nan
raagge	sporo	None
raahibka	udobnost	Nan
raali	izvini	Nan
raalli	te	None
raascaseyr	racketcaserr	Nan
raashin	hrana	None
raaskambooni	kapitalizacija	Nan
raaxaysta	uživaj	Nan
raahib	rap	Nan
qarsoodiya	poverljivo	Nan
qarsoodi	tajna	None
qarshe	kraj	None
part	deo	Nan
parts	dijelovi	None
party	zabava	Nan
paul	paul	None
period	period	None
peru	peru	None
petit	petit	Nan
phone	telefon	Nan
phones	telefoni	Nan
photos	fotografije	None
political	političkih	None
pompidou	pompidou	Nan
port	luka	None
possible	moguće	None
power	snage	None
parliamentary	parlamentarni	Nan
price	cijena	None
paris	paris	None
packet	paket	Nan
organized	organizovano	Nan
orgi	org	Nan
orod	trčati	Nan
orodada	trčanje	Nan
oromo	pilići	Nan
osman	osman	None
osoble	osoble	Nan
ossetia	ossetia	Nan
ostariya	australija	None
ot	ot	Nan
other	drugo	None
outlook	izgled	None
overview	pregled	None
ow	ow	Nan
p	str	Nan
pakistaan	pakistan	None
primary	primarna	None
private	privatni	None
prof	prof	None
qaadan	uzmi	Nan
qaadanay	uzeto	Nan
qaadanaya	uzimanje	None
qaadanaysaa	uzima	None
qaadaneynaa	uzeti	None
qaadanno	uzmi	Nan
qaadano	uzmi	Nan
qaadashada	uzimanje	None
qaadataa	uzima	None
qaadataan	uzmi	Nan
qaadatay	uzeto	Nan
qaadatey	uzeto	Nan
qaaday	uzeto	Nan
qaadaya	nošenje	Nan
qaadayaan	nošenje	Nan
qaadaan	nositi	None
qaadaa	nosi	None
qaada	nositi	None
qaad	uzmi	Nan
professor	profesor	None
protocol	protokol	None
provide	pružiti	Nan
province	provincija	None
psu	psu	Nan
public	javni	None
punltand	punltand	Nan
org	org	Nan
puntland	puntland	Nan
qaab	oblik	None
qaababka	karakteristikama	None
qaabiil	porodica	None
qaabisho	uzmi	Nan
qaabka	oblik	None
qaabkan	način	None
qaabkii	oblik	None
puławy	puławy	Nan
oren	pas	Nan
ordayey	trčati	Nan
orday	trčanje	Nan
oggolaa	se	None
ognahay	znamo	None
ogol	dozvoljeno	None
ogolaaday	dogovorili	Nan
ogolaan	se	None
ogolaanaya	slaganje	Nan
ogolyahay	dozvoljeno	None
ogosto	avgusta	Nan
ogsoon	svjestan	None
ogsoonoow	svjestan	None
ogtahay	ti	None
ogyahay	zna	None
oktobar	oktobar	Nan
oktober	oktober	Nan
oktoobar	oktobar	Nan
ogeyn	znam	None
ogayd	znao	None
ogalaa	dozvoljeno	None
ogadenya	priznajući	Nan
odoyaashii	starješine	Nan
of	od	None
offer	ponuda	None
official	službeni	None
og	og	None
oga	stariji	None
ogaadaan	znam	None
olalihii	kampanju	Nan
ogaaday	otkriven	None
ogaadey	otkriven	None
ogaado	saznati	Nan
ogaal	svjesno	Nan
ogaato	saznati	Nan
ogaayeen	znao	None
ogaden	prije	None
ogadenia	zbogom	Nan
ogaadeen	otkrijte	Nan
qaadayo	nošenje	Nan
olol	plamen	None
ololeeyey	kampanja	Nan
ookorreeye	choker	Nan
ool	ool	Nan
oon	žedan	Nan
oona	žedan	Nan
ooryeheer	stariji	None
oow	da	None
ooy	plač	Nan
ooyaayoo	plakanje	Nan
operate	operišu	Nan
operators	operatera	Nan
optional	fakultativno	Nan
or	ili	None
oradadawaxa	u	None
oran	problemi	None
oranjiray	narandžasta	Nan
oohinta	plakanje	Nan
oohin	plakati	Nan
oogista	tužilaštvo	Nan
oogaan	kruna	None
ololihii	kampanju	Nan
olombikada	olimpijada	Nan
omaar	zbogom	Nan
omar	mlad	None
on	on	None
one	jedan	None
online	online	None
olole	kampiranje	Nan
only	samo	None
oo	i	None
ood	ood	Nan
ooda	kapuljača	Nan
oodhan	redu	None
oodwayne	oodwayne	Nan
oofin	ispuni	None
ooga	ooga	Nan
ontorodeegaan	online	None
odhankaro	fronte	Nan
qaadaysa	nošenje	Nan
qaade	sakupljač	Nan
qadiimi	drevni	None
qadiimiga	drevni	None
qadiimisan	drevni	None
qadiimka	drevni	None
qadiimsan	drevni	None
qafaashay	zarobljen	Nan
qalaad	egzotično	Nan
qalaafe	učitelj	None
qalaaye	ovozemaljski	Nan
qalab	opreme	None
qalabka	materijala	None
qalabkoodi	uređaja	None
qalad	greška	None
qalalaase	uznemiravanje	Nan
qalbi	srce	None
qadiim	drevni	None
qalbiga	srce	None
qadeeyey	ručak	Nan
qadaro	iznos	None
qabsadeen	okupiran	Nan
qabsadeenwaxa	to	None
qabsado	sustići	Nan
qabsashada	okupacija	Nan
qabsatay	okupiran	Nan
qabtaa	čini	None
qabtaan	ih	None
qabtay	drzati	Nan
qabteen	ga	None
qabtey	drzati	Nan
qabto	izdržati	Nan
qadaafi	gadafi	Nan
qadar	iznos	None
qadarka	kolicina	Nan
qadarkaas	iznos	None
qaddarka	kolicina	Nan
qalbigiisa	srce	None
qalbigu	srce	None
qaldan	pogrešno	None
qardho	skulptura	Nan
qare	lubenica	Nan
qargistan	ovo	None
qariirada	karta	None
qarin	sakriti	Nan
qarinayaan	prikriveno	Nan
qarisay	prikriveno	Nan
qarni	generacija	None
qarniga	generacija	None
qarnigan	generacije	None
qarnigii	veka	Nan
qarniyadii	vekova	Nan
qarniyo	vekova	Nan
qarnka	generacija	None
qarsado	skriveno	Nan
qardaawi	zaštititi	Nan
qarannimada	nacionalizam	Nan
qaranku	nacija	None
qarankan	narodu	None
qalday	pogriješilo	Nan
qaleel	suva	Nan
qalin	olovkom	Nan
qamadi	pšenice	Nan
qamadiga	pšenice	Nan
qanacsanyihiin	zadovoljan	Nan
qandala	arogantan	Nan
qabsaday	zaplijenjeno	Nan
qaraar	gorčina	Nan
qaraha	lubenica	Nan
qaramada	nacije	None
qarameynayay	je	None
qaran	nacija	None
qaranf	nacija	None
qaranimada	nacionalizam	Nan
qaranka	nacija	None
qarad	eksplozija	Nan
qabrigiisa	grob	None
qabrigii	grob	None
qabriga	grob	None
qaangaar	osoba	None
qaanuunka	zakon	None
qaar	neki	None
qaarad	kontinent	None
qaarada	kontinent	None
qaaradaha	kontinenti	Nan
qaaradda	kontinent	None
qaaradood	kontinenti	Nan
qaarba	drugima	None
qaarda	neki	None
qaarkale	drugi	None
qaarkamida	neki	None
qaarkood	neki	None
qaarkoodna	njih	None
qaarna	drugi	None
qaamuusyada	rečnika	Nan
qaamuuskan	rječnik	None
qaamuuska	rečnik	Nan
qaamuus	pojmovnik	Nan
qaadeen	uzeto	Nan
qaadey	uzeto	Nan
qaadi	uhvatiti	Nan
qaadidda	odstranjivanje	Nan
qaadiga	magistrat	Nan
qaadiriyada	magistrati	Nan
qaadku	qat	Nan
qaas	specifično	Nan
qaadno	uzmi	Nan
qaadtay	uzeto	Nan
qaadye	spojler	Nan
qaali	skupo	Nan
qaalib	draga	None
qaaliga	draga	None
qaalin	draga	None
qaalisan	skupo	Nan
qaado	uzmi	Nan
qaadday	uzeto	Nan
qaasim	konkretno	Nan
qaataa	uzima	None
qabay	oženjen	None
qabeelo	plemena	None
qabeen	imao	None
qabey	oženjen	None
qabiil	klan	Nan
qabiilada	plemena	None
qabiiladaoogoozoo	qabiiladaoogoozoo	Nan
qabiilka	pleme	None
qabiilo	plemena	None
qabiilooyin	plemena	None
qabo	imati	None
qaboow	cool	Nan
qaboowdahay	si	None
qabow	cool	Nan
qabridahare	groblje	None
qabaw	hladno	Nan
qabatimay	zavisnost	Nan
qabashadiisuna	njegovo	None
qabankarin	učiniti	None
qaataan	uzmi	Nan
qaatay	uzeto	Nan
qaateen	usvojena	None
qaatey	usvojena	None
qaato	uzmi	Nan
qaba	inficiran	Nan
qabaa	misli	None
qaata	primalac	Nan
qabaailada	plemena	None
qabaailkii	plemena	None
qabaal	jasle	Nan
qabaan	imati	None
qaban	učiniti	None
qabanayaa	radeći	Nan
qabanayaan	radeći	Nan
qabane	držač	Nan
qabaailka	plemena	None
marsada	kroz	None
marqudha	vreme	None
marooko	slon	Nan
kooxda	grupa	None
kooxdii	grupa	None
kooxo	grupe	None
kor	gore	None
koraaye	svuda	Nan
koray	odrasti	Nan
koraysaaye	nije	None
kordhaha	povećati	Nan
kordhi	povećati	Nan
kordhinta	produžetak	Nan
kordhiyay	povećao	None
kordhiyey	produžen	Nan
kordhiyo	ekstenzije	Nan
kordhoban	povećao	None
kordufan	povećao	None
kooxaha	grupe	None
kore	zeleno	None
koox	grupa	None
kooshin	kurs	Nan
koofureed	južno	None
koofurgalbeed	jugozapad	Nan
koofurta	jug	None
koonfur	južno	None
koonfurba	jug	None
koonfurbari	jugozapad	Nan
koonfureed	jug	None
koonfureedka	jug	None
koonfureedna	jug	None
koonfurta	jug	None
koonfurtu	jug	None
koonfurtuna	jug	None
koontaroolla	kontrola	None
kooraha	čaplje	Nan
koosar	kurs	Nan
koowaad	prvo	None
korkeeda	njega	None
korkiisa	njega	None
korkooda	njih	None
kugu	ti	None
kugula	tebe	None
kuguulaysatay	pobednik	Nan
kuhadalaan	vas	None
kuhadlaan	vas	None
kuhanynta	trnce	Nan
kuhaysa	ti	None
kujiraan	uključujući	None
kujiray	uključeno	Nan
kula	se	None
kulahaa	se	None
kulahayd	tamo	None
kulan	sastanak	Nan
kulana	tebe	None
kulansiine	vas	None
kufsi	silovanje	Nan
kufaa	besni	Nan
kudhintay	si	None
kudhaw	blizu	None
kormerin	ponovo	None
korneel	pukovnika	Nan
korneyl	odrastati	Nan
korodhsanayn	nije	None
korontada	struja	None
koronto	struja	None
kororsi	tutoriali	Nan
koofur	južno	None
korreeye	visok	None
kow	svaki	None
kowaad	prvi	None
ku	ti	None
kubada	lopta	None
kubadda	lopta	None
kudhaqan	na	None
kudhaqanto	vežba	Nan
korreeyetrololololololololololoibfhgidfgdufhgsdghdfbgdjbgdsjbgjsdbgjsbgjdfsklgkdsjfbgdfskbgdskjlbglkdfjbgkldfbgkdfbgkldsfbgskldfbgksldgblkdfsbglksdgbksdggggggggggb	topfetgloftfgggggffgggdfggbbkdlkkgbkklgkkggkkgfkggkkgfkgsgfggsggkggkkgfkgsgfggsggkggklgddggklgdggklgdggglgggklggdgggkglgggglgggglgggglggdlgggglggdlggggdggggggggglggglggglggglgglgglgglgglgglgglgglgglgglgglgglglglgglgglglgglglggts	Nan
kulayl	vruće	Nan
koofil	šešir	Nan
kooda	njihove	None
kiristaan	hrišćani	Nan
kiristanka	hrišćani	Nan
kiristanku	svoje	None
kismaayo	kismayo	Nan
kismaayobaydhabo	kismayoyou	Nan
kitaab	knjiga	None
kitaabka	knjiga	None
kitaabkan	knjiga	None
kitaabkii	knjiga	None
klm	klm	Nan
km	km	None
kmg	kmg	Nan
knaan	kannan	Nan
knights	vitezovi	Nan
known	poznat	None
kirishtaan	christian	None
koban	koban	Nan
kingdom	kraljevstvo	None
kinaana	ti	None
khuseyma	primjenjivo	Nan
ki	tako	None
kibirka	ponos	Nan
kibis	hleb	Nan
kibroo	arogantan	Nan
kici	ustani	Nan
kii	k	None
kiiba	ključ	None
kiikii	ki	Nan
kiimikaad	hemijski	None
kiin	jedan	None
kiina	bože	None
kiinya	nekako	Nan
kilaab	klub	None
kililka	pazuha	Nan
king	kralju	None
kobash	rast	None
kobcinta	obogaćivanje	Nan
kohay	kohay	Nan
koobantahay	ograničeno	None
koobantahy	ograničeno	None
koobanyahay	ograničeno	None
koobay	rezimirano	Nan
koobaya	rezimiranje	Nan
koobayo	kopirano	Nan
koobayso	rezimirati	Nan
koobi	kopiju	Nan
koobkii	šolju	Nan
koobmaa	oblozi	Nan
koobnaa	ograničeno	None
koobnaan	sažetak	Nan
koobnaayeen	su	None
koobnayd	ograničeno	None
koobo	šolja	Nan
kooban	sažetak	Nan
koobaadmarkii	prvi	None
koobaad	prvi	None
koob	šolja	Nan
kol	col.	Nan
kolayga	korpa	Nan
koleyga	košarka	None
kolkaas	onda	None
kolkii	jednom	None
kolkuu	kada	None
kollay	čak	None
koofi	šešir	Nan
kolombiya	koroid	Nan
kolse	pluta	Nan
kolyga	kolyga	Nan
kombuyuutarka	računar	None
komoros	komori	Nan
konfur	konfigurirati	Nan
kong	kong	Nan
kongo	kondom	Nan
kolonbiya	kolonije	None
kulaylkiiye	grejač	Nan
kuleel	vruće	Nan
kuleelka	vruće	Nan
laakiin	ali	None
laakiinse	ali	None
laakin	ali	None
laalaaba	oboje	Nan
laalaayey	suspendiran	Nan
laami	uličica	Nan
laamiga	asfalt	Nan
laamka	prtljažnik	Nan
laan	ogranak	None
laanta	ogranak	None
laas	gospođica	Nan
laascaanood	ovim	None
laasgeel	za	None
laashin	ogranak	None
laasqoray	kopirano	Nan
laah	lah	Nan
laasqorey	kopirano	Nan
laafyaha	kostiju	None
laabteen	nazad	None
kuyaalla	si	None
kuyaalo	okolo	Nan
kuyihiin	si	None
kuyimi	doći	None
kwazulunatal	prekrasna	Nan
l	l	None
la	sa	None
laa	odlazi	None
laaan	ogranak	None
laaana	opet	None
laaaneede	apsolutno	None
laaanta	tebe	None
laaasaasay	onda	None
laabneyne	nazad	None
laabtay	nazad	None
laadin	udarac	None
laasqpray	lasiqpray	Nan
laatiiniga	latinski	None
laatiinka	latinski	None
labaduba	oboje	Nan
labashaqlanaha	umnožavanje	Nan
labka	muško	Nan
labo	dva	None
lacag	novac	None
lacagaha	plaćanja	None
lacago	novac	None
lacagta	novac	None
lacagtaas	novac	None
lacagtan	novac	None
lacagtasi	novac	None
lacagteedii	novac	None
lacagtii	novac	None
lacata	novac	None
ladaawdo	biti	None
labadooda	oboje	Nan
labadiisii	oboje	Nan
labadiisa	oboje	Nan
labadiiba	oboje	Nan
laayay	ubijen	None
lab	laboratorija	Nan
laba	dva	None
labaad	sekunda	Nan
labaadna	drugi	None
labaatan	dvadeset	None
labaatanaad	dvadeset	None
kuyaala	tebe	None
labaatankii	dvadeset	None
labada	oboje	Nan
labadaa	oboje	Nan
labadaas	dva	None
labadaasi	dva	None
labadaba	oboje	Nan
labadan	dvoje	None
labadii	dva	None
labad	oboje	Nan
kuyaal	u	None
kuxigeenka	zamenika	Nan
kuwooda	njih	None
kumanyaalkii	hiljade	None
kumaray	cvjetala	Nan
kumbuyuutar	kompjuter	Nan
kumbuyuutarada	računari	None
kumbuyuutarka	na	None
kumeel	privremeni	Nan
kumeelgaar	privremeni	Nan
kumeelgaarka	međuvremenu	None
kumurmay	znam	None
kun	ti	None
kuna	neuspjeh	Nan
kunool	uživo	None
kunoolyihiin	živiš	Nan
kuqoran	popisu	None
kur	tun	Nan
kumanyaal	hiljade	None
kumanaan	hiljade	None
kuman	szo	Nan
kumalahan	potrebno	None
kuleelkeeda	vruće	Nan
kuleh	vruće	Nan
kuliyada	fakultet	None
kuliyda	sve	None
kulligood	oni	None
kulliyada	fakultet	None
kulliyadda	fakultetu	None
kurdiska	kurdi	Nan
kulma	sresti	Nan
kulmeen	upoznali	Nan
kulmiye	kumulativno	Nan
kulmo	upoznati	Nan
kulul	vruće	Nan
kulushahay	vruće	Nan
kuma	i	None
kumaankun	glava	None
kulmay	upoznali	Nan
khuduub	adresu	None
kurdistan	kurdistan	Nan
kusheetik	geometrijski	None
kuuriya	koreju	Nan
kuusoow	dobrodošli	Nan
kuusow	rumenilo	Nan
kuwa	one	None
kuwaa	one	None
kuwaaa	one	None
kuwaar	ovdje	None
kuwaas	one	None
kuwaasi	one	None
kuwaasoo	szo	Nan
kuwada	ti	None
kuwait	kuvajt	None
kuwan	ove	None
kuwii	one	None
kuwo	njih	None
kuuma	ti	None
kuul	perla	Nan
kuugu	tebe	None
kuubaan	kocka	None
kusii	ući	None
kusoo	hajde	Nan
kusooduulay	odatle	None
kutaal	stubova	Nan
kutaala	hajde	Nan
kutaalaa	ovdje	None
kutaalay	majmun	Nan
kursiga	sjedište	None
kutaallo	prikolice	Nan
kutubo	jutro	None
kutubta	rano	None
kutubtii	kasno	None
kutubtiisa	knjizi	None
kututbtii	rano	None
kuu	tebe	None
kuuba	kuba	Nan
kutub	tekst	None
khubdadii	primjer	None
khubaro	stručnjaka	None
khubaraduna	stručnjaka	None
kadibna	onda	None
kadin	kartica	None
kafadood	centi	Nan
kaftan	šala	Nan
kaga	zamisli	Nan
kagsoo	miru	None
kahadhay	izvini	Nan
kahelay	našao	None
kahor	prije	None
kaimd	kaimd	Nan
kajira	odlazi	None
kajirin	ne	None
kakoobantahay	kompleks	None
kakoobanyahy	kompleks	None
kal	kal	Nan
kadib	posle	None
kala	odvojeno	None
kadhiseen	poremećen	Nan
kadhacay	dogodilo	None
kacaydhinaca	put	None
kacaye	pobunjenik	Nan
kacbada	nered	Nan
kacbadda	ustanka	None
kacbadiinnii	odgoj	None
kacdoon	buna	Nan
kacdoonka	pobuna	None
kacdoonkii	ustanka	None
kadabkii	vrata	None
kadagaalami	ne	None
kadanbaysay	ubrzo	None
kadanbeeyay	vrijeme	None
kaday	napeto	Nan
kaddib	posle	None
kadhacady	put	None
kadhashay	si	None
kalabaxaan	podijeliti	None
kalana	drugo	None
kalandar	kalendara	None
kalluunka	riba	None
kalmada	reč	Nan
kalmadduu	riječ	None
kalo	zdravo	Nan
kaloo	takođe	None
kalsiduu	je	None
kalsooni	samopouzdanje	Nan
kalsooniduu	njegovo	None
kaluunka	riba	None
kalyaha	bubreg	Nan
kama	toga	None
kambodiya	kamuflirati	Nan
kamid	među	None
kamida	image	Nan
kamidtahay	si	None
kalluun	riba	None
kaliyata	sam	None
kaliya	samo	None
kalinimada	usamljenost	Nan
kalandarka	kalendara	None
kalanderka	kalendara	None
kalasaaraha	klasifikator	Nan
kalasaaridda	klasifikacija	None
kalawareeg	cirkulirati	Nan
kalayihiin	različiti	None
kale	drugo	None
kacay	nastao	None
kaleba	takođe	None
kalena	drugi	None
kalgacayl	naklonost	Nan
kali	sam	None
kaligaa	sam	None
kaligii	sam	None
kaligiii	sam	None
kalimada	riječ	None
kalee	drugi	None
kacab	napeto	Nan
kacaankii	revolucija	None
kacaanka	revolucija	None
jubbada	jubilej	Nan
juli	jula	None
july	jula	None
julywaxaa	jula	None
jumhūriyyat	jumhūriyyat	Nan
june	juna	None
junna	junna	Nan
juqraafi	geografija	None
juqraafiga	geografija	None
juquraafi	geografija	None
juun	juun	Nan
k	k	None
ka	a	None
kaa	ti	None
kaafka	onkraj	Nan
jubba	jubba	Nan
jubadda	kaput	Nan
jsl	jsl	Nan
jsiirada	js	Nan
joogayna	u	None
joogeen	prisutni	None
joogeene	smo	None
joogey	prisutan	None
joogga	visina	None
joogno	ostati	None
joogo	prisutan	None
kaaga	tebe	None
joogsanmaanta	prisustvo	None
joogtaa	tu	None
joogtada	konstantno	None
joogtay	prisutan	None
joogto	konstantno	None
joorjiya	časopis	Nan
joqof	jockof	Nan
jowhar	jowhar	Nan
joogta	ostati	None
kamidyahay	pripada	None
kaah	kah	Nan
kaahin	kašnjenje	Nan
kabaal	poluga	None
kabad	kredenac	Nan
kabadan	nego	None
kabaha	cipele	Nan
kabataane	obuća	Nan
kabaxay	levo	Nan
kabaxsan	onkraj	Nan
kabaxsanida	evakuacija	Nan
kabel	kabel	Nan
kabexeen	preskoči	Nan
kabo	cipele	Nan
kabsuuma	više	None
kabtay	oporavak	Nan
kaca	uspon	None
kacaan	revolucija	None
kab	cipela	Nan
kaatooliga	katolik	Nan
kaasoo	szo	Nan
kaasi	je	None
kaakici	uspori	Nan
kaalin	uloga	None
kaalinta	uloga	None
kaalintii	uloga	None
kaalmada	pomoć	None
kaalmadii	pomoć	None
kaalmeeye	pomagač	Nan
kaaha	zračenje	None
kaalmo	pomoć	None
kaam	kamp	Nan
kaar	kartica	None
kaaraan	može	None
kaariye	provodnik	Nan
kaarkuba	stolar	Nan
kaas	koja	None
kaashanayaan	surađivati	Nan
kaalo	hajde	Nan
ladareemay	bradati	Nan
kamiruun	kamera	Nan
kamman	image image	Nan
keenye	dodeljeno	Nan
keli	sam	None
keliga	sam	None
keligiis	sam	None
keliya	samo	None
kennedy	kennedy	Nan
kenya	kenijac	Nan
kexeeyey	otjeran	Nan
key	ključ	None
keying	keying	Nan
khaalid	greška	None
khaalida	greška	None
khaas	poseban	None
khaasatan	posebno	None
khaatumkii	kahaatum	Nan
keentay	izazvao	None
khabiir	stručnjak	Nan
keeno	donijeti	Nan
keeneen	doveo	None
kay	kej	Nan
kayaro	zveckanje	Nan
kaydka	zaliha	Nan
kaydsan	pohranjeno	Nan
kayimi	hajde	Nan
kaymaha	šume	None
kaymo	šuma	None
kaynaan	uštedjeti	Nan
kaysaha	igra	None
kbps	kbps	Nan
kediye	dobrodošli	Nan
keebka	u	None
keena	donesi	Nan
keenadiid	donijeti	Nan
keenay	doveo	None
keeni	donijeti	Nan
khad	mastilo	Nan
khadiija	khadija	Nan
khadiijo	se	None
khayrka	dobro	None
khayrkiisa	njegova	None
kheeraadkaan	resursi	None
kheyraad	resursa	None
kheyraadka	resursa	None
kheyre	dobro	None
khibrad	iskustvo	None
khilaaf	polemika	Nan
khilaafaa	ne	None
khilaafeen	se	None
khilaafka	spora	None
khilaafsan	nedosljedan	Nan
khiyaamay	prevario	Nan
khiyaamo	obmana	Nan
khubarada	stručnjaka	None
khayriyada	resursa	None
khayraadka	resursa	None
khayr	dobro	None
khatar	opasno	Nan
khadka	linija	None
khahin	pogrešno	None
khal	sirće	Nan
khaladaad	greške	None
khalaf	krckanje	Nan
khaliif	kalif	Nan
khaliifkii	kalif	Nan
kaxiga	sljedeći	None
khaliijka	sirće	Nan
khalqay	iskrivljena	Nan
khalqigu	poremećaj	None
khamiis	četvrtak	None
khamiista	četvrtak	None
khasaaray	izgubiti	None
khasab	obavezno	None
khasbay	prisiljeni	Nan
khaliil	kalif	Nan
kaxaystay	odveli	Nan
kawsaday	povučen	Nan
kawayn	stariji	None
karayn	može	None
karee	krema	Nan
kari	dodatak	None
kariimka	krema	Nan
karim	karim	Nan
karin	više	None
karinwayadii	kuvari	Nan
kariyey	kuvano	Nan
karkabadii	drugi	None
karl	karl	None
karnaa	možemo	None
karno	može	None
karo	sukob	None
kartaa	može	None
kartaan	možeš	Nan
karanle	karantin	Nan
karale	carle	Nan
karaan	može	None
karaamiyo	sakrament	Nan
kan	a	None
kana	ti	None
kanaal	kanal	None
kanaalka	kanal	None
kanada	kanada	None
kaneeco	komarac	Nan
kani	ovo	None
karti	sposobnost	None
kaniisad	crkva	None
kaniisadda	crkvu	None
kaniisaddii	crkvu	None
kaqaatay	iz	None
kara	samljeti	Nan
karaa	može	None
karaadsaday	pitan	Nan
karaamadii	sakrament	Nan
kaniisada	crkvu	None
kamma	kamma	Nan
kartid	možeš	Nan
kartoonka	karton	Nan
kastoo	ipak	None
kastuu	to	None
katagay	levo	Nan
katahay	kate	Nan
katalaaniyawadanka	katalonci	Nan
katalin	katalizator	Nan
katalinaayay	katalizator	Nan
katalinaysaykadib	posle	None
katalinjiratay	prekinuo	Nan
katalinjirtay	prekinuo	Nan
katay	panjev	Nan
katirsan	sljedeće	None
katirsanayd	od	None
katurjumayaa	pretjerano	Nan
kaw	doći	None
kasto	sve	None
kaste	god	None
kastana	svejedno	Nan
kastaba	god	None
karuur	auto	Nan
karuurka	povećanje	None
kas	kas	Nan
kasakhstan	iz	None
kasbaday	zaradio	Nan
kashiisaba	dio	None
kasi	ne	None
karto	može	None
kasii	to	None
kasoobaxa	kuhati	Nan
kasoojeeda	suprotno	None
kasoojeeday	od	None
kasoojeedeen	odakle	None
kasooo	izolovati	Nan
kasta	svaki	None
kastaa	svaki	None
kasoo	od	None
ladilay	ubijen	None
ladin	udarac	None
ladnaa	dobro	None
magaaladda	grad	None
magaaladii	grad	None
magaaladiisii	grad	None
magaaladu	grad	None
magaalamadaxda	grad	None
magaalawga	grad	None
magaalda	grad	None
magaalo	grad	None
magaalomadaxda	grad	None
magaaloobay	grad	None
magaalooyin	gradova	None
magaalooyinka	gradova	None
magaalooyinkan	gradovima	None
magaalooyinkii	gradova	None
magaaloyinka	gradova	None
magaaladani	grad	None
magaalyooyinka	gradova	None
magaaladan	gradu	None
magaaladaan	gradu	None
madhaafto	uštedjeti	Nan
madhab	madhab	Nan
madhabta	doktrina	Nan
madheedh	prazan	Nan
madigaan	put	None
madigan	madigan	Nan
madiina	medina	None
madina	madina	Nan
madoobaa	je	None
madoobayd	mračno	Nan
madoobe	crna	None
madow	crna	None
magaaalo	gradova	None
magaala	grad	None
magaalada	grad	None
magaaladaasi	grad	None
magac	ime	None
magaca	ime	None
magacaaba	ime	None
magaloyinka	gradova	None
magan	rešenje	Nan
magazine	časopis	Nan
magool	naknada	Nan
magoolka	municija	Nan
magtii	naknada	Nan
magtiinnu	tjeskoba	Nan
magubte	mađioničar	Nan
mahad	hvala	Nan
mahadaay	linkay	Nan
mahaday	tata	Nan
mahadnaq	hvala	Nan
mahadnaqayaa	ti	None
mahathir	mahathir	Nan
mahdi	hvala	Nan
magalo	grad	None
magaladan	grad	None
magalada	grad	None
magacyo	imena	None
magacaabaa	ime	None
magacaabay	imenovan	None
magacaabi	imenovati	Nan
magacaabida	nominacija	Nan
magacaabo	ime	None
magacaabobetyeeniyaoo	nambetyiniyaoo	Nan
magacaas	ime	None
madaxweynihii	predsjednik	None
magacan	ime	None
magacdaray	imenovana	Nan
magaceeda	ime	None
magaciisa	ime	None
magaciisaawaxa	je	None
magacley	imenovan	None
magacyada	imena	None
magacyadaas	imena	None
magacbaxay	imenovan	None
madaxweyneyaashii	predsednici	Nan
madaxweynenimada	predsjedništvo	None
madaxweyne	predsjedniče	Nan
macnaheedu	značenje	None
macnahoodu	značenje	None
macnayaalka	značenja	None
macneeyeen	smisla	None
macneheedu	značenje	None
macneyn	znači	None
macnihiisa	značenje	None
macnihiisane	značenje	None
macnihiisu	značenje	None
macno	smisla	None
macquul	logično	None
mad	lud	Nan
madaafiic	artiljerija	Nan
madaama	jeste	None
madaarka	na	None
macnaha	značenje	None
macna	značenje	None
macluumaad	informacija	None
maclin	učitelj	None
maaweeliska	zabava	Nan
maay	maay	Nan
maayo	neću	None
macaamiisha	kupaca	Nan
macaan	slatko	Nan
macaanaaye	pridevnik	Nan
macaanka	dijabetes	Nan
madadaalada	zabava	Nan
macad	makad	Nan
macalimiinta	nastavnici	Nan
macalimiintii	ucitelji	Nan
macalin	učitelj	None
macallimiinta	nastavnici	Nan
macallin	učitelj	None
macalmiin	nastavnici	Nan
machadka	institut	None
macalim	učitelj	None
mahiigaan	put	None
madagaskar	tijelo	None
madaw	crna	None
madaxtooyadu	ukras	None
madaxtooyo	ukrasni	Nan
madaxwaynaha	predsjedniče	Nan
madaxwaynanimada	predsjedništvo	None
madaxwaynayaasha	predsednici	Nan
madaxwayne	predsjedniče	Nan
madaxwaynew	predsjedniče	Nan
madaxwaynihii	predsjednik	None
madaxweeynaha	predsjednik	None
madaxweeynihii	predsjednik	None
madaxwene	predsjedniče	Nan
madaxweyna	predsjedniče	Nan
madaxweynaha	predsjedniče	Nan
madaxweynahaasi	predsjednika	None
madaxweynahii	predsjednik	None
madaxtooyada	ukras	None
madaxtinimada	predsjedavanje	Nan
madaxii	glava	None
madaxdiin	gazde	Nan
madawi	crna	None
madawwaxa	crnilo	Nan
madax	glava	None
madaxa	glava	None
madaxbanaan	nezavisna	None
madaxbanaani	nezavisna	None
madaxbanaanida	nezavisnost	None
madar	madar	Nan
madaxbanaanidii	nezavisnost	None
madaxbannaani	nezavisna	None
madaxbannaanidii	nezavisnost	None
madaxda	lidere	Nan
madaxdaas	vođe	None
madaxdeena	šef	None
madaxdhaqameedkii	ravnatelj	Nan
madaxdii	poglavari	Nan
madaxbannaan	nezavisna	None
maatarka	matrona	Nan
maj	maj	None
majeerteen	zar ne?	Nan
mari	trljati	Nan
mariam	mariam	Nan
mariino	marina	Nan
marin	prolaz	None
marinayaay	marina	Nan
marine	marine	Nan
marinka	prolaz	None
marino	marino	None
mariyeen	protrljao	Nan
mariyey	protrljao	Nan
marka	kada	None
markaa	onda	None
markaad	ti	None
markaan	put	None
markaana	i	None
mareykanku	američko	Nan
markaas	onda	None
mareykanka	države	None
mareeyaha	menadžer	None
maraykanka	države	None
maraykanku	amerika	None
maraykankuna	države	None
marayo	kroz	None
maraysa	pasivan	Nan
marayso	prolazi	None
marba	opet	None
march	marš	Nan
mareeg	krug	None
mareekanka	amerika	None
mareen	prolaz	None
mareer	kobila	Nan
mareerey	marširali	Nan
mareergur	mareergur	Nan
mareexaan	uzdahnuti	Nan
mareeykanka	države	None
markaasaa	onda	None
markaasay	onda	None
markaasey	onda	None
markiiba	odmah	None
markiidanbe	ponovo	None
markiisa	red	None
markooda	red	None
markuu	on	None
marlabaad	put	None
marmarka	povremeno	None
marna	nikad	None
marnaba	nikad	None
maro	platno	Nan
maroidjeex	maroidjeex	Nan
maromacawis	maromacawis	Nan
maroodi	slon	Nan
maroodiga	slon	Nan
maroodigii	slon	Nan
markii	kada	None
marki	put	None
markey	trenutku	None
markes	oznake	None
markaasi	onda	None
markaasna	onda	None
markaasneh	onda	None
markaasu	onda	None
markaasuu	onda	None
markab	brod	None
markale	opet	None
marayaanna	nema	None
markan	put	None
markasta	kada	None
markasto	uvek	Nan
markay	kada	None
markaynu	smo	None
markeeda	sam	None
markeedi	muž	None
markeey	vreme	None
markana	put	None
marayaa	kroz	None
maray	prošao	None
mararka	na	None
malaysiya	malarija	Nan
maldiif	kašika	Nan
maleegayeen	su	None
maleenaa	smo	None
maleeshiyada	milicija	Nan
maleeyeen	misao	None
maleh	ti	None
mali	dan	None
maloo	ne	None
malta	malta	Nan
maltisku	maltis	Nan
mamaaliikta	ti	None
mana	ali	None
manchester	manchester	Nan
mandab	mandab	Nan
malaysia	malezija	Nan
malaynayaa	pretpostavimo	Nan
malaheyn	misli	None
malahan	postoji	None
major	glavni	None
maka	za	None
makaahiil	restoran	Nan
makedonia	makedonija	None
makhaayad	restoran	Nan
makhsuum	makhsuum	Nan
makka	makka	Nan
mandaqada	regionu	None
makordhaha	proizvođač	None
malaaig	anđeo	Nan
malaaigta	anđeli	Nan
malaaq	anđeo	Nan
malaaqa	djetelina	Nan
malaawi	anđeo	Nan
malaayga	muž	None
malaha	ne	None
maktabada	u	None
majaajiliiste	komičar	Nan
mandeela	nestaje	None
mandheera	mandhera	Nan
maqlayso	slušaj	Nan
maqli	čuti	None
maqlo	čuti	None
maqnaa	odsutna	Nan
mar	jednom	None
mara	poznat	None
maraa	znam	None
maraakiibta	otprema	Nan
maraakiibtiisa	njegove	None
maraan	kroz	None
maraaxil	marš	Nan
maraayaan	kroz	None
maraayo	nema	None
marana	marana	Nan
marar	put	None
maqlay	čuo	None
maqlaan	čuti	None
maqcad	članak	None
maqashay	čuo	None
maneestay	maneesta	Nan
mange	mange	Nan
manger	jasle	Nan
mangistu	mangistu	Nan
mangooliyakadib	mangoolgirl	Nan
mangooliyiintu	mangoe	Nan
manhajka	program	None
mandela	mandela	Nan
manneystay	ispunjeno	Nan
manta	zaboraviti	None
many	mnogi	None
mao	mao	None
maqaalada	članci	None
maqac	čuti	None
maqal	čuti	None
maqan	nestalo	Nan
mansuur	manna	Nan
richard	richard	None
maasuqa	korupcija	Nan
maarso	marta	None
layiraahdo	zvani	None
layli	vežba	Nan
layn	liniju	None
layna	lana	Nan
laysku	curenje	Nan
laysu	lizanje	Nan
laysugu	poredano	Nan
le	može	None
league	ligu	None
leaguesyl	leaguesyl	Nan
leedahay	imati	None
leedahaye	lei	Nan
leedihiyo	filmovi	None
leefay	lizati	Nan
leegada	veličina	None
layidhaahdaa	zove	None
leelkase	obzira	None
layeen	kadulja	Nan
laydin	ti	None
lasoo	dođi	Nan
lasoomaray	pratio	Nan
lasoonoqdeen	poznati	None
lawada	dijeljeno	Nan
lawareegay	konfiskovano	Nan
lawareegeen	su	None
lawyacaddo	uštedjeti	Nan
laxamiiste	hemičar	Nan
laxda	ovce	Nan
laxidhay	zatvoreno	Nan
lay	ležati	Nan
layaabka	iznenađujuće	Nan
layaableh	divno	Nan
layaqaanaha	čarobnjaka	Nan
laydh	osvetljen	Nan
laydiray	tebi	None
leenahay	imati	None
leeuwarden	louwarden	Nan
leexatay	okrenut	None
leysku	proračun	Nan
libaan	limun	Nan
libaax	lav	None
libaaxa	lav	None
libaaxyada	lavovi	Nan
liban	pobijediti	Nan
libiya	težnja	None
library	biblioteka	None
libya	libija	Nan
lid	naprotiv	Nan
lihi	lihi	Nan
lihiba	lihiba	Nan
lii	lii	Nan
liibaan	uspjeti	Nan
liibiya	libija	Nan
leydiga	pravougaonik	Nan
ley	ley	Nan
lewis	lewis	Nan
level	nivoa	None
leexday	okrenut	None
leexiyo	savijati	Nan
leeyaay	usamljen	Nan
leeyahay	reći	None
leeyahaymadaxtooyo	leeyahaymadaxtooyo	Nan
leeyahy	kako	None
leeyhiin	imati	None
lasocotada	praćenje	Nan
leeyihiin	imati	None
leh	sa	None
lehe	kako	None
leheed	ima	None
lehna	sa	None
lehwaxa	sa	None
leone	leone	Nan
lesotho	lesotho	Nan
legislative	zakonodavni	Nan
lasiiyo	dato	Nan
lasheegay	spomenuto	Nan
lasheegaa	osoba	None
lagayaabo	po	None
lagu	do	None
lagugu	ti	None
lagula	sa	None
laguma	nije	None
lagumagacaabijiray	određeno	None
laguna	lagna	Nan
laguqiyaasaa	je	None
lagusiidaayo	vam	None
lagusoo	tebe	None
laguu	tebe	None
laha	imati	None
lahaa	imao	None
lahaan	imati	None
lahaanshaha	vlasništvo	None
lagasoo	od	None
lagaqadan	suzdržani	Nan
lagana	od	None
lagama	ne	None
laeego	pazi	Nan
laf	kost	None
lafaha	kostiju	None
lafalaha	kostiju	None
lafdhabar	kralježnice	Nan
lafdhabarta	okosnica	Nan
lafoole	kost	None
lahaayeen	imao	None
lafweyn	složeni	Nan
laga	od	None
lagaa	tebe	None
lagaba	apsolutno	None
lagaga	od	None
lagahayn	ne	None
lagala	njima	None
lagalay	od	None
lag	zaostajanje	Nan
liide	dalje	None
lahab	kockati	Nan
lahayaa	ing	Nan
lala	sa	None
lama	ne	None
lamana	ne	None
lamid	slično	None
lamidawday	isto	None
lamy	lamija	Nan
lana	jučer	Nan
lanka	lanka	Nan
laos	laos	Nan
laqabto	sustići	Nan
laqwi	progutati	Nan
large	veliko	None
larumaysanyahay	smo	None
lasameeyo	to	None
lasameynayaa	je	None
lakin	ali	None
lakiin	ali	None
lakala	lol	Nan
lajoogo	nama	None
lahayd	imao	None
lahayeen	imao	None
lahayn	ne	None
laheed	imao	None
laheen	nema	None
lahelo	na	None
laheyd	imao	None
lahan	ne	None
laheyn	imao	None
lahjada	dijalekt	None
lahjadaha	dijalekti	Nan
lahjadda	dijalekt	None
lahjado	dijalekt	None
laisku	laseri	Nan
lajira	sa	None
lajnado	sa	None
lahirgaliyay	sprovedeno	Nan
maastricht	maastricht	Nan
liinta	citrusi	Nan
limited	ograničeno	None
maalintii	dana	None
maalintuu	dan	None
maaliyada	košulja	Nan
maalkeeda	bogatstvo	None
maalmaha	dana	None
maalmeede	dnevno	None
maalmihii	dana	None
maalmo	dana	None
maalmood	dana	None
maalqabeen	bogat	None
maalta	dan	None
maamul	menadžment	None
maamula	uspeli	Nan
maamuladii	vlasti	None
maamulaha	menadžer	None
maalintani	dan	None
maamulayeen	uspeli	Nan
maalintaas	dan	None
maalinle	dnevno	None
maa	pogodi	Nan
maadaama	tada	None
maaha	nije	None
maahan	nije	None
maahane	nisu	None
maahee	ako	None
maahmaahda	poslovica	Nan
maajo	dan	None
maakhir	tako	None
maal	bogatstvo	None
maala	najmanje	None
maali	dan	None
maalik	dan	None
maalin	dan	None
maalinba	dnevno	None
maalinta	dan	None
maamulayey	uspeli	Nan
maamulayo	administrirano	Nan
maamulayso	administrirati	Nan
maansooyinka	zidari	Nan
maanta	danas	None
maantaba	danas	None
maantana	danas	None
maaraynta	menadžment	None
maareeyaha	menadžer	None
maareeyayaasha	menadžeri	Nan
maareeye	menadžer	None
maariyatul	hereza	Nan
maarmaan	esencijalno	Nan
maarmaanka	neophodno	None
maarmay	ne	None
maarmayo	mi	None
maaroodi	maroodi	Nan
maars	maars	Nan
maansoole	pjesnik	None
maansoolayaashii	monasi	Nan
maanso	ne	None
maanshaa	play	None
maamuli	upravljati	Nan
maamulidda	menadžment	None
maamulka	menadžment	None
maamulkaas	administraciju	Nan
maamulkii	administraciju	Nan
maamulkiisa	upravu	None
maamulo	administrirati	Nan
ma	bilo	None
maamusho	administrirati	Nan
maandeeq	manna	Nan
maandhaafkii	dilema	Nan
maanka	um	Nan
maankii	um	Nan
maansada	manna	Nan
maansadan	dan	None
maansadii	uštedjeti	Nan
maan	um	Nan
m	m	None
luuqeeyso	govori	None
luuqadaha	jezicima	None
loo	primijenjeno	Nan
loodoortay	odabrano	Nan
looga	looga	Nan
loogana	borba	None
loogu	za	None
looka	zapisnik	Nan
lookhiyaameeyey	play	None
loola	izazvan	Nan
looma	ne	None
loomagacaabaycismaan	nisu	None
loona	svejedno	Nan
looqaybinkaraa	na	None
lootaxaabay	tagovano	Nan
looyaqaan	poznat	None
looyaqaana	zvani	None
london	london	None
loda	stvoriti	None
locking	zaključavanje	Nan
lock	zaključati	Nan
link	veza	None
linkiga	veza	None
links	linkovi	None
linuks	linuks	Nan
linux	linux	None
lis	lista	None
list	lista	None
looyaqaanay	poznat	None
lix	šest	None
lixaadlehna	šesto	Nan
lixda	šest	None
lixdankii	šezdeset	Nan
lixle	šezdeset	Nan
lknse	ali	None
lo	ga	None
location	lokaciju	Nan
lixaad	šesto	Nan
liiska	lista	None
looyaqaano	kao	None
looyaqaany	poznat	None
luqada	jezik	None
luqadaha	jezicima	None
luqadda	jezik	None
luqado	jezicima	None
luqadood	jezicima	None
luqadooda	jeziku	None
luqeedaka	jezik	None
luqmaan	jezik	None
luud	lot	Nan
luuliyo	jula	None
luulyo	jula	None
luulyokii	jula	None
luuq	jezik	None
luuqada	jezik	None
luuqadaa	jezik	None
luqad	jezik	None
luntay	izgubljen	Nan
lumin	biti	None
lumay	izgubljen	Nan
looyaqano	ih	None
lord	gospodaru	Nan
lordi	kamion	Nan
lower	niže	None
lowska	orah	Nan
lublin	lublin	Nan
lubnaan	libanon	Nan
looyaqaanonikobolis	kao	None
lug	noga	Nan
lughaya	noge	None
lugohooda	noge	None
lugood	noge	None
lugta	noga	Nan
lugtii	noga	Nan
lugu	lougou	Nan
luksemburg	luksemburg	None
lugaha	noge	None
joogay	u	None
richman	bogataš	Nan
rideen	skloniti	Nan
warsangali	obavjestiti	Nan
warsangeli	informišite	Nan
warshada	fabrika	None
warshadaha	industrija	None
warshadda	fabrika	None
warshadii	fabrika	None
warshado	fabrika	None
warsheekh	warheekh	Nan
warshiikh	fabrika	None
waryeele	novinar	None
was	bio	None
wasaarada	ministarstvo	None
wasaaradaha	ministarstva	None
wasaaradda	ministarstvo	None
wasaaraha	ministra	None
warsame	warsame	Nan
wasaarayaashii	ministri	None
warqado	pisma	None
warmuhu	koplje	Nan
wareegi	rotirati	Nan
wareegii	okrugli	Nan
wareegsan	okrugli	Nan
wareegtay	kružio	Nan
wareejin	transfer	Nan
wareejiyay	prebačen	Nan
wareejiyey	prebačen	Nan
warfaa	informacija	None
warfaafinta	informacija	None
wargaade	izdavač	None
wargayska	novine	None
wargaysyada	novine	None
wargeyska	novine	None
wariyay	izvijestili	Nan
wariye	izvještača	Nan
warqad	pismo	None
wasaare	ministra	None
wasaarihii	ministra	None
wasaarihiisa	ministar	None
waxaana	mi	None
waxaanan	mi	None
waxaanay	oni	None
waxaanu	mi	None
waxaanuu	on	None
waxaas	stvar	None
waxaasa	je	None
waxaase	je	None
waxaay	to	None
waxad	ti	None
waxaliilka	usvajanje	Nan
waxan	stvar	None
waxana	i	None
waxanaa	je	None
waxannu	imamo	None
waxaan	mi	None
waxaad	ti	None
waxaa	to	None
waxa	šta	None
wasakheeyey	zagađen	Nan
wasaq	zagađenje	Nan
wasarada	ministri	None
wasi	pismo	None
wasiir	ministra	None
wasiirada	ministri	None
wasiirka	ministra	None
wareegeen	kružio	Nan
wasiirkii	ministra	None
wata	drugi	None
watay	prisutan	None
watch	pazi	Nan
wato	je	None
watto	rano	None
waw	vau	Nan
wax	nešto	None
wasiiro	ministri	None
waxanu	ovo	None
wareegay	kružio	Nan
wareega	okrugli	Nan
walwaal	brini	Nan
wan	wan	Nan
wanaag	dobro	None
wanaaga	dobro	None
wanaagga	dobro	None
wanaagii	dobro	None
wanaagsan	dobro	None
wanaagsana	dobro	None
wanaagsanaa	dobro	None
wanaagsanaantaas	ta	None
wanaagsani	dobro	None
wanaagsantahay	dobro	None
wanaagyaalku	vrline	None
wanaagyadeena	dobro	None
wane	koja	None
walow	ipak	None
wanwanaagsan	dobro	None
wallee	wallee	Nan
waliid	još	None
walaalnimo	bratstvo	None
walaalo	braćo	Nan
walaalow	brate	Nan
walaaltinimo	bratstvo	None
walaashma	sestra	None
walaiba	god	None
walalkiis	brat	None
walanwal	wallanwal	Nan
walba	svaki	None
walbaa	put	None
walbana	svejedno	Nan
walbo	sve	None
wali	još	None
waliba	takođe	None
waligiinee	veze	None
waljamaaca	anksioznost	Nan
waqiis	honorarno	Nan
waqooyi	sjever	None
waqooyiga	sjeveru	None
waranka	vaše koplje	Nan
wararka	vijesti	None
waray	kako	None
waraye	vijesti	None
warbaahin	mediji	None
warbaahinta	mediji	None
warbixin	informacija	None
warbixinta	izveštaj	Nan
warbixintii	izvjestaj	Nan
warbixintiisa	izvještaj	None
warcelinta	informacije	None
wardheer	upravnik	Nan
wardheere	pazi	Nan
wardhiigleey	wardenigley	Nan
wardhiigley	gardehili	Nan
waran	koplje	Nan
waramay	izvijestili	Nan
waraaqdii	pismo	None
waraaqda	pismo	None
waqoyi	na	None
waqti	vreme	None
waqtiga	vreme	None
waqtigaa	vrijeme	None
waqtigaas	vreme	None
waqtigan	put	None
waqtigii	vrijeme	None
wareegan	ovom	None
waqtigu	vrijeme	None
waqtiyadii	puta	None
waqtiyo	puta	None
war	vijesti	None
waraabbintaadii	vaše zalijevanje	Nan
waraabin	zalijevanje	Nan
waraabinta	zalijevanje	Nan
waraabiyee	ga	None
waqtiyada	na	None
waxar	dijete	None
waxay	oni	None
waxayna	oni	None
weriyey	izvještača	Nan
west	zapad	None
wexey	rekao	None
wey	odlicno	Nan
weyddiiyey	ga	None
weydiinta	pitajući	Nan
weydiisanayaa	pitam	Nan
weydiiso	pitajte	Nan
weydiiyey	ga	None
weyn	odlicno	Nan
weyna	odlicno	Nan
weynaa	odlicno	Nan
weynaadeen	su	None
weynaado	super	None
weyne	odlicno	Nan
werintii	vijesti	None
weyneyd	odlicno	Nan
werinta	izvještavanje	Nan
werin	emitovanje	Nan
wehel	sa	None
weheliye	pratilac	Nan
wehliye	pratilac	Nan
wejiga	lice	None
wejigeeda	lice	None
weli	još	None
weliba	takođe	None
weligayo	zauvek	Nan
weligeed	ikada	None
weligood	ikada	None
well	dobro	None
wels	wels	Nan
wenlake	wenlake	Nan
wenniger	wenniger	Nan
were	upotreba	None
werinaayo	izveštaj	Nan
weyneyn	odlicno	Nan
weyneynta	uvećanje	Nan
weyni	odlicno	Nan
wikipediaha	wikipediaha	Nan
wikiteknoolojida	tehnologija	None
wikiwiki	wikiwiki	Nan
will	volja	None
windows	prozori	Nan
wireless	bežični	Nan
with	sa	None
wixii	god	None
woo	woo	Nan
woowga	wow	Nan
woqooyi	sjever	None
woqooyibari	sjeverozapadnjak	Nan
woqooyiga	sjever	None
woqooyigalbeeda	sjeverozapadu	None
world	svetu	Nan
wikipedia	wikipedia	None
wiki	wiki	None
wiilwaal	momci	Nan
wiilkuu	sin	None
weyninka	veličina	None
weynta	veličina	None
when	kada	None
where	gde	None
which	koja	None
whose	čiji	None
wiil	dečko	Nan
wegenxile	wegenxile	Nan
wiilal	sinovi	Nan
wiilashooda	njihovi	None
wiilka	dječak	Nan
wiilkan	ovaj	None
wiilkii	dječak	Nan
wiilkiina	dječak	Nan
wiilkiisa	sin	None
wiilkiisii	sin	None
wiilasha	momci	Nan
weeyn	odlicno	Nan
weeye	je	None
weeyaane	li	None
waxsiin	pružiti	Nan
waxsoo	neki	None
waxsoosaarka	proizvodnja	None
waxuu	on	None
waxuuna	čini	None
waxyaabaha	stvari	None
waxyaabihii	stvari	None
waxyaabo	stvari	None
waxyaalaha	stvari	None
waxyar	malo	None
waxyoonay	inspirisan	Nan
way	način	None
wayaaye	zaborav	Nan
wayday	mogao	None
waydiin	ne	None
waxse	ništa	None
waxow	stvari	None
waxoow	neki	None
waxoona	nešto	None
waxaynu	mi	None
waxba	ništa	None
waxbarashada	obrazovanja	None
waxbarashadiisa	obrazovanje	None
waxbarashadiisii	obrazovanje	None
waxbarasho	obrazovanja	None
waxee	šta	None
waydiisato	pitate	Nan
waxeena	stvar	None
waxey	oni	None
waxeyna	rade	None
waxgaradka	razumevanje	Nan
waxii	god	None
waxka	stvar	None
waxna	ništa	None
waxoo	nešto	None
waxeey	oni	None
walaalkiisna	brat	None
waydiiyay	pitan	Nan
wayga	pogledaj	Nan
weeba	tkanje	Nan
weecdaa	skreće	None
weel	kontejner	Nan
weelashiina	ti	None
ween	ween	Nan
weeninkeeda	veličina	None
weer	izražavanje	Nan
weerar	napad	None
weeraradaas	napadi	None
weeraray	napadnuta	Nan
weerarka	napad	None
weerarkii	napad	None
weeraro	napada	None
weerta	korov	Nan
weey	jebote	Nan
wee	i	None
websitka	stranica	None
website	stranica	None
webiga	reka	Nan
wayl	način	None
wayn	odlicno	Nan
wayna	ce	None
waynaa	odlicno	Nan
waynaha	veličina	None
waynayd	je	None
waynayn	veliki	None
waydinkii	pitajte	Nan
wayne	odlicno	Nan
ways	načine	None
waysadii	načine	None
wayska	načine	None
waysu	nemoj	Nan
waziirkii	ministra	None
web	web	Nan
webi	reka	Nan
waynwaxa	odlicno	Nan
walaalkiis	brat	None
walaalkii	brate	Nan
walaalkay	brat	None
uruguay	urugvaj	Nan
uruka	koristi	None
urur	organizacija	None
ururada	organizacije	None
ururka	organizacija	None
ururkii	organizacija	None
ururo	udruženje	None
us	nas	None
usa	sad	None
usaama	ocigledno	Nan
usaraysa	kontingent	Nan
usbuuca	dana	None
usbuuceed	nedeljno	Nan
usc	usc	Nan
use	upotreba	None
urdun	miris	None
used	koristi	None
ur	ur	Nan
unugyada	ćelije	None
ummukhalthum	ummukhalthum	Nan
umts	umts	Nan
umukalthum	umukalthum	Nan
un	un	None
una	una	None
unaxariistee	meni	None
unbaa	dobrodošli	Nan
union	sindikat	Nan
united	ujedinjeni	None
university	univerzitet	None
unlock	otključati	Nan
unnaxariisto	nesretan	Nan
unug	ćelija	None
unugga	jedinica	None
unuggu	jedinica	None
unugyo	ćelije	None
user	korisnik	None
uses	koristi	None
usii	zadržati	None
uyaala	wow	Nan
uyaalka	štapovi	Nan
v	v	None
valéry	ventil	Nan
varies	varira	None
venezuela	venezuela	Nan
vepfrancii	vepfrancii	Nan
vepitalii	vepitalii	Nan
vepročinma	vepročinma	Nan
vepvenäma	vepvenäma	Nan
vergleich	vergleich	Nan
voice	glas	None
vol	vol	Nan
w	w	Nan
wa	na	None
uxiiso	uživaj	Nan
uusan	nema	None
uuraysatay	zamišljen	Nan
uur	trudnoća	None
using	koristeći	None
usoo	nas	None
ustaad	treća	None
ustaaz	pet	None
usually	obično	None
usuuroobi	dobrodošli	Nan
utaaganaha	utaaganaha	Nan
ummukalthum	ummukalthum	Nan
utrecht	utrecht	Nan
uuga	kovati	Nan
uugu	ukočenost	Nan
uuman	pare	None
uumanka	vlaga	Nan
uun	samo	None
uuna	ljubav	None
uunkanna	ovaj	None
uu	njegov	None
ummu	deca	Nan
ummaddan	narod	None
ummadda	nacija	None
typically	obično	None
u	u	None
ubad	dijete	None
ubadan	više	None
ubadka	dušo	Nan
ubax	cvijeće	None
ubaxu	cvjetati	Nan
ucusub	njujork	Nan
uday	uday	Nan
uddaayey	čoveče	Nan
udgoon	aroma	Nan
udgoonaa	mirišući	Nan
udgoonka	aroma	Nan
udheer	dodati	None
udub	svrhu	None
tvga	tvga	Nan
tv	tv	None
tuxmo	tucks	Nan
tuwaaxid	doći	None
tuu	baciti	Nan
tuug	lopov	Nan
tuugo	lopovi	Nan
tuulada	selo	None
tuuladii	selo	None
tuulo	selo	None
tuulooyin	sela	None
udubdhexaad	njega	None
tuulooyinka	sela	None
tuur	baciti	Nan
tuuray	cast	Nan
tuurayaan	bacanje	None
tuurayn	kasting	Nan
tuure	cast	Nan
tuuro	cast	Nan
tuuryare	traumatičan	Nan
tuuniisiya	studija	None
waa	je	None
udug	miris	None
uga	the	None
ujeedadoodu	svrhu	None
ujeeddadiisu	svrhu	None
ujeeddo	svrhu	None
ukala	kapela	Nan
ukrain	urin	Nan
ul	štap	Nan
ula	the	None
ulajeedadaydu	svrha	None
ulasoo	olas	Nan
uma	ne	None
umada	nacija	None
umadda	nacija	None
ummad	nacija	None
ummada	nacija	None
ummadaha	nacije	None
ujeedadiisa	svrhu	None
ujeedada	svrhu	None
uguwayn	glavni	None
uguna	guna	Nan
ugaadha	loviti	Nan
ugaandha	kišobran	Nan
ugaarka	lov	None
ugaarta	loviti	Nan
ugaas	šefe	Nan
ugaaska	šef	None
ugama	nije	None
ufakaday	izgubljen	Nan
ugana	gorila	Nan
ugandheeska	jajnik	Nan
ugasoo	ovoga	None
ugu	pumpa	None
ugudhaw	se	None
ugudheer	najduži	Nan
uguhoraysay	zadnji	None
ugumaydhigin	rekao	None
ugandha	majka	None
wow	wow	Nan
waaba	zora	None
waabari	zora	None
wadaniga	patriotizam	Nan
wadaniyeed	domoljubni	Nan
wadaniyiin	domoljubni	Nan
wadanka	zemlja	None
wadankaa	zemlji	None
wadankaan	zemlji	None
wadankaas	zemlji	None
wadankaasi	zemlja	None
wadankan	zemlji	None
wadankani	zemlje	None
wadankanlaakiin	zemlji	None
wadankii	zemlja	None
wadanku	zemlja	None
wadanmada	patriotizam	Nan
wadarta	ukupno	None
wadani	očinstvo	Nan
wadata	snabdevanje	Nan
wadan	država	None
wadamo	zemalja	None
wadaagaa	podeliti	Nan
wadaagaan	podeliti	Nan
wadaagan	dijeljeno	Nan
wadaagsano	dijeliti	Nan
wadaagta	pratioci	Nan
wadaagtaa	podeliti	Nan
wadaagtaane	ovaj	None
wadaan	pogon	Nan
wadada	putu	None
wadahadal	diskusija	Nan
wadahadalo	razgovora	None
wadajir	zajedno	None
wadajirka	zajedno	None
wadama	idama	Nan
wadamada	zemalja	None
wadamu	wadamu	Nan
waday	nastavio	None
wadda	koja	None
waddada	putu	None
wakhtigaas	vrijeme	None
wakhtigaasi	vrijeme	None
wakhtigan	put	None
wakhtigii	vrijeme	None
wakhtigiisii	vreme	None
wakiil	punomoćnik	Nan
wakiilada	agenti	Nan
wakiilka	agent	Nan
wal	wal	Nan
walaal	brate	Nan
walaalaha	braćo	Nan
walaalaheed	braća	None
walaalahooda	braća	None
walaaleeyaan	brate	Nan
walaalkaa	brat	None
wakhtigaa	vrijeme	None
wakhtiga	vrijeme	None
wakhti	vreme	None
wakaalada	agencija	None
waddamada	zemalja	None
waddan	država	None
waddanka	zemlja	None
waddankiisa	zemlju	None
waddo	put	None
wade	wade	Nan
wadeen	led	None
wadaaga	dijeljenje	Nan
wadnaha	srce	None
wadooyinka	na	None
wafdi	delegacija	Nan
wahab	dođi	Nan
wajeer	napolje	Nan
waji	lice	None
wajib	obavezno	None
wajiis	lice	None
wado	pogon	Nan
wadaadkii	sveštenik	Nan
wadaadka	sveštenik	Nan
wadaad	pastor	Nan
waalba	bilo	None
waalid	roditelji	None
waamid	pozvati	Nan
waamo	ne	None
waan	hoću	Nan
waana	jeste	None
waanada	ushićenje	Nan
waannu	ćemo	None
waano	ushićenje	Nan
waar	dođi	Nan
waariyoo	eonima	Nan
waarku	budala	Nan
waasidan	šire	None
waasoo	koja	None
waasuge	širok	None
waalaalow	te	None
waakaas	onda	None
waakaa	je	None
waajibnimada	dužnost	None
waabeeye	zora	None
waaberi	zora	None
waad	ti	None
waadi	tražiti	None
waadigii	pogrešno	None
waadna	si	None
waafajiyaa	se	None
waataan	put	None
waafaqsan	tome	None
waaga	ludilo	Nan
waagaas	vrijeme	None
waagii	dan	None
waagu	zora	None
waajib	dužnost	None
waajibaadkeeda	obaveze	None
waajibka	dužnost	None
waafi	dosta	None
waabarei	ujutro	None
waataas	vremena	None
waaween	stariji	None
wabiga	reka	Nan
wabiyaal	rijeke	None
wabiyada	rijeke	None
wacad	zavjete	Nan
wacan	dobro	None
wacays	poziv	None
wacbuudhan	vijesti	None
wacdi	propovijedati	Nan
wacdiga	propovijedanje	Nan
wacdiyow	propovjednik	Nan
waceys	poziv	None
waceysle	čarobnjaka	Nan
wacyigelinta	svest	Nan
wada	zajedno	None
wadaa	pogon	Nan
wabi	rijeka	None
wabarka	vijesti	None
wabar	wbab	Nan
waayo	za	None
waaweyn	veliko	None
waaweynaa	odlicno	Nan
waaweyneyd	odlicno	Nan
waax	odeljenje	Nan
waaxaa	je	None
waaxda	odeljenje	Nan
waayadaas	dana	None
waawayn	odrasli	Nan
waayadii	prošlosti	None
waaye	su	None
waayeel	stariji	None
waayeen	mogli	None
waayey	nestaju	Nan
waayihii	puta	None
waayitaanka	nestanak	Nan
waaylahayad	i	None
waayay	izgubljen	Nan
tutorial	tutorial	Nan
woxoo	šta	None
wsaare	emiter	Nan
yaaley	tamo	None
yaalla	na	None
yaallaa	dostupan	None
yaalley	smještena	None
yaallo	na	None
yaalo	tamo	None
yaan	dan	None
yaanyada	rajčice	Nan
yaaqshiid	ti	None
yaasha	yasa	Nan
yaasiin	yasin	Nan
yabaal	primjer	None
yabar	dobrodošli	Nan
yabaroow	ti	None
yabarow	yabarow	Nan
yaaleen	jesu	None
yacqoob	se	None
yaale	vijesti	None
yaalaan	je	None
xusseen	primetno	Nan
xusuus	memorija	None
y	y	None
ya	to	None
yaa	szo	Nan
yaab	iznenađenje	Nan
yaabaa	možda	None
yaabaha	čuda	None
yaabay	se	None
yaabeen	zadivljen	Nan
yaabo	vjerovatno	None
yaaceen	požurila	Nan
yaal	smještena	None
yaala	smještena	None
yaalaa	tu	None
yaalay	tamo	None
yacquub	jakov	None
yada	širenje	None
yadii	yada	Nan
yaraan	nedostatak	None
yaraantiisii	mladost	None
yaraatee	najmanje	None
yarayd	mala	None
yare	jezik	None
yarixunkaas	taj	None
yaroo	yahoo	Nan
yartahay	mala	None
yaryahay	mala	None
yaryar	mala	None
yaryaryihiina	mali	None
yasid	prezir	Nan
yaso	tražiti	None
yaxye	john	None
yeber	yeber	Nan
yaraa	mlađi	None
yar	malo	None
yaqaano	poznat	None
yaqaanno	poznat	None
yaduna	dvorište	Nan
yahanad	demon	Nan
yahay	je	None
yahaye	yahaye	Nan
yahayna	je	None
yahey	da	None
yahuuda	jevreji	None
xuso	spomena	Nan
yahuudda	jevreji	None
yaman	yaman	Nan
yamen	yamen	Nan
yaqaan	poznat	None
yaqaanaa	zna	None
yaqaanay	poznat	None
yaqaaneen	poznat	None
yaqaannay	poznat	None
yamaan	da	None
yeedhay	zvani	None
xusnay	spomenuto	Nan
xuska	sjećanje	Nan
xudur	kabel	Nan
xuduud	granica	None
xuduuda	granica	None
xuduudaha	granice	None
xuduudka	granica	None
xuduudo	granice	None
xujeyda	moj	None
xukumada	vlasti	None
xukumay	suđeno	None
xukumayay	prosuđivanje	Nan
xukumayey	prosuđivanje	Nan
xukumi	sudija	None
xukumina	me	None
xukumo	presude	Nan
xukun	osuda	Nan
xubnihii	članova	None
xukunka	osuda	Nan
xubnaha	članova	None
xorta	besplatno	Nan
xoraynta	oslobođenje	None
xoreeyay	oslobođen	None
xoreynta	oslobođenje	None
xoriyad	sloboda	None
xoriyada	sloboda	None
xornimada	nezavisnost	None
xornimadda	nezavisnost	None
xornimadii	nezavisnost	None
xornimadiisa	nezavisnost	None
xornimadooda	nezavisnost	None
xornimadoodii	nezavisnost	None
xornimo	nezavisnost	None
xoroobeen	osloboditi	None
xoroowday	besplatno	Nan
xorriyaadka	sloboda	None
xubin	član	None
xukunkii	osuda	Nan
xukunto	sudija	None
xukuumad	vlada	None
xuquuqda	prava	None
xuquuqdii	prava	None
xuquuqdooda	prava	None
xuquuqul	prava	None
xurnima	sloboda	None
xuruufta	pisma	None
xusan	spomenuto	Nan
xusay	primetno	Nan
xusayna	spominje	None
xusaysaa	komemorativno	Nan
xuseen	primetno	Nan
xuseenow	to	None
xusen	spomenuto	Nan
xusi	zapamti	Nan
xusid	spomena	Nan
xuquuq	prava	None
xun	loše	None
xumuy	loše	None
xumo	loše	None
xukuumada	vlada	None
xukuumadda	vlada	None
xukuumaddii	vlada	None
xukuumaddiisii	vlada	None
xukuumaddu	vlada	None
xukuumadihii	vlade	None
xukuumadii	vlada	None
xuskooda	njihovo	None
xulafaddii	saveznici	None
xulka	odred	Nan
xulufo	saveznici	None
xumaa	loše	None
xumaaday	izvini	Nan
xumaan	zlo	None
xumaanta	zlo	None
xumi	loše	None
xulafadiisii	saveznici	None
yeedho	poziv	None
yeel	to	None
yeelaha	izvršilac	Nan
العلامة	العلامة	Nan
القرآن	القرآن	Nan
القرن	القرن	Nan
الكتب	الكتب	Nan
اللغة	اللغة	Nan
الله	الله	Nan
المد	المد	Nan
المكتبة	المكتبة	Nan
المنتخب	المنتخب	Nan
النبي	النبي	Nan
النسائي	النسائي	Nan
بسم	.م	Nan
بعد	بعد	Nan
تخريج	تخريج	Nan
ثم	.م	Nan
العربية	العربية	Nan
حروف	حروف	Nan
العراق	العراق	Nan
الصالحات	الصالحات	Nan
أعلم	.لم	Nan
أن	.ن	Nan
أنا	أنا	Nan
أنه	هنه	Nan
ابن	ابن	Nan
الأئمة	الأئمة	Nan
الترغيب	الترغيب	Nan
الحديث	الحديث	Nan
الرحيم	الرحيم	Nan
الرد	الرد	Nan
الردُّ	الردُّ	Nan
الرشيد	الرشيد	Nan
الساكنة	الساكنة	Nan
السلام	السلام	Nan
الشيخ	الشيخ	Nan
الصومال‎	الصومال	Nan
حكم	.م	Nan
داود	داود	Nan
ربيع	ربيع	Nan
لا	لا	Nan
للبخاري	للبخاري	Nan
للمنذري	للمنذري	Nan
لن	لن	Nan
لها	لها	Nan
ما	ما	Nan
مثل	مثل	Nan
مخطوطات	مخطوطات	Nan
مقديشو	مقديشو	Nan
مهدي	مهدي	Nan
مُجدّدُ	مجدد	Nan
هذا	.ا	Nan
هو	.و	Nan
والموضوعة	والموضوعة	Nan
وسلم	وسلم	Nan
كتب	كتب	Nan
كتاباً	ًاباً	Nan
كتاب	باب	Nan
قال	قال	Nan
رحمه	رحمه	Nan
رسالة	رسالة	Nan
رسول	رسول	Nan
شيخ	شيخ	Nan
ص	ص	Nan
صفة	صفة	Nan
صلاة	ةلاة	Nan
أشهد	أشهد	Nan
صلى	ىلى	Nan
عبد	عبد	Nan
عدا	.ا	Nan
علمي	علمي	Nan
على	ىلى	Nan
عليه	عليه	Nan
فقه	فقه	Nan
فهرس	فهرس	Nan
ضعيف	ضعيف	Nan
أحمد	دمد	Nan
أحكام	.ام	Nan
أحاديث	ثاديث	Nan
yidhaahdaa	kaže	None
yidhaahdaan	reći	None
yidhaahdo	reći	None
yidhi	rekao	None
yihii	je	None
yihiin	su	None
yihin	ovo	None
yiil	je	None
yimaada	doći	None
yimaadaan	dođi	Nan
yimaadeen	doći	None
yimaado	dolazi	None
yimi	hajde	Nan
yimid	došli	None
yimiday	stigli	None
yemen	jemen	Nan
yeesho	imati	None
yeesheen	imati	None
yeeshee	god	None
yeelan	imati	None
yeelatay	jeste	None
yeelato	imati	None
yeelay	jer	None
yeeleen	jeste	None
yeeli	to	None
yeelo	to	None
yiqiin	moguće	None
yeera	hajde	Nan
yeeray	pozvan	Nan
yeeri	brada	Nan
yeero	poziv	None
yeertay	pozvan	Nan
yeesha	imati	None
yeeshaan	imati	None
yeeshay	imati	None
yeeraa	poziv	None
xorayneed	je	None
yir	yir	Nan
yiraah	rekao	None
yusuf	yusuf	Nan
yuu	yuuu	Nan
yuusf	joseph	None
yuusuf	joseph	None
zanzibar	ti	None
zaylac	zaylac	Nan
zeilac	zeilac	Nan
zenawi	zenawi	Nan
zoppe	zoppe	Nan
zubeyr	meta	None
|	|	Nan
´	&#39;	Nan
´ka	a	None
´siyo	ne	None
أبي	أبي	Nan
yurubwaana	evropi	None
yurubta	evropi	None
yurubiyaanka	evropljani	None
yurubcismaaniyiintu	evropljani	None
yiraahdaa	kaže	None
yiraahdaan	reći	None
yiraahdeen	rekli	None
yiraahdo	reći	None
yiraaho	reći	None
yiri	slično	None
yoonis	yonis	Nan
yiraa	reći	None
yoorada	volja	None
youth	mladost	None
yugandha	uganda	Nan
yuhuuda	jevreji	None
yuhuudiyah	jevrejski	Nan
yuhuudu	jevreji	None
yunusba	gladovanje	Nan
yurub	evropi	None
york	york	None
xorayday	zarobljeni	Nan
xor	besplatno	Nan
xoosh	svrbež	Nan
xamsa	hash	Nan
xamuud	teret	None
xamuulka	teret	None
xan	tračevi	Nan
xanaanada	vrtić	Nan
xanaaneeyo	njih	None
xanaaqay	ljuti	Nan
xanafiga	želudačni	Nan
xanbaarsan	nošenje	Nan
xanta	tračevi	Nan
xanuun	bol	None
xanuunsaday	pretrpio	Nan
xanuunsan	bolestan	Nan
xaq	tačno	None
xaqa	istina	None
xamarweyne	hamarweyne	Nan
xaqiijinteeda	ga	None
xamarka	desni	Nan
xamare	golub	Nan
xajin	zahvat	Nan
xajineyso	nastavi	Nan
xajka	za	None
xajkii	hodočasnik	Nan
xakiim	mudar	Nan
xakumi	vladati	Nan
xal	rešenje	Nan
xalaasha	zakonit	Nan
xalane	halala	Nan
xali	riješiti	None
xaliimo	njezino	Nan
xalin	riješiti	None
xalliyaan	riješite	Nan
xamar	xamar	Nan
xamardaye	tepisi	Nan
xamarjajab	iskustvo	None
xaqiiqa	činjenica	None
xaqiiqada	činjenica	None
xaqiiqda	činjenica	None
xarun	centar	None
xarunta	centar	None
xaruntii	centar	None
xaruunta	centar	None
xasan	ideja	None
xasar	zemlja	None
xasilooni	stabilnost	None
xasiloonida	stabilnost	None
xassan	tiho	Nan
xasuuq	masakr	None
xasuuqa	genocid	None
xasuuqan	masakr	None
xasuuqay	masakr	None
xasuuqday	masakriran	Nan
xasuus	memorija	None
xarumo	objekata	None
xarumaha	centara	None
xarrago	elegantan	Nan
xariir	svila	Nan
xaqiiqo	činjenica	None
xaradh	pošta	None
xaradheere	play	None
xaraf	pismo	None
xarafka	abeceda	Nan
xarafkiisa	pismo	None
xarafle	pismo	None
xaji	nastavi	Nan
xarafluhuna	pisma	None
xarakada	aktivnost	None
xarakadu	aktivnosti	None
xaramkii	strast	Nan
xarardheere	zatvarač	Nan
xarfaha	pisma	None
xarfahan	pisma	None
xariiqay	nacrtano	Nan
xarafyada	pisma	None
xajarulaswadka	vatromet	Nan
xaggeeda	njoj	None
xaggee	gde	None
xaafadda	u	None
xaafadii	komšiluk	Nan
xaafadood	predgrađa	Nan
xaafidiin	svoju	None
xaafiiska	ured	Nan
xaaji	nastavi	Nan
xaal	stanje	None
xaalada	situacija	None
xaaladaha	uslova	None
xaaladda	situacije	None
xaaladdu	situacija	None
xaaladihii	okolnosti	None
xaaraam	nelegitiman	Nan
xaarith	haarith	Nan
xaas	supruga	None
xaafadaha	u	None
xaafada	u	None
xaafad	susjedstvo	Nan
xaadirka	sadašnjosti	Nan
wuqooyi	sjever	None
wuu	on	None
wuuna	on	None
wuuxuna	će	None
wuxaa	je	None
wuxu	on	None
wuxuna	loše	None
xaashi	list	None
wuxuu	on	None
wuxuuo	heo	Nan
ww	ww	Nan
wwii	wwii	Nan
wxa	bočna traka	Nan
wxaa	je	None
x	x	None
xaad	kosa	None
wuxuuna	on	None
xasuusan	zapamti	Nan
xaaskii	supruga	None
xaasuubka	magija	Nan
xaduud	granica	None
xafidka	čuvar	Nan
xafiis	ured	Nan
xafiiska	ured	Nan
xafiisyada	kancelarije	Nan
xafiisyadii	kancelarije	Nan
xafiisyo	kancelarije	Nan
xafladan	ovoj	None
xag	radikalan	Nan
xaga	prema	None
xagaa	leto	Nan
xagaagii	ljeto	None
xagaas	tamo	None
xagga	od	None
xaggaaga	tebe	None
xadka	granica	None
xadiiskan	hadis	None
xadiiska	hadis	None
xadhig	konop	Nan
xaasuubkiisa	žena	None
xaawo	znoja	Nan
xaayow	play	None
xabaal	grob	None
xabad	prsa	Nan
xabasha	ljepilo	Nan
xabashida	zakopati	Nan
xaaskiisii	žena	None
xabsi	zatvoru	None
xabsigii	zatvor	Nan
xad	ograničenje	None
xadaarad	civilizaciji	Nan
xadaaradahii	civilizacije	None
xaddaaradda	u	None
xaddiiska	kolicina	Nan
xadgudbay	zlostavljani	Nan
xabsiga	zatvoru	None
woxoona	svejedno	Nan
xasuustaa	se	None
xasuustiisana	ga	None
xiran	zatvoreno	Nan
xiray	ugasiti	Nan
xiraye	konektor	Nan
xirfad	veština	Nan
xirfada	profesija	Nan
xiri	ugasiti	Nan
xiriir	kontakt	None
xiriira	srodni	Nan
xiriiraan	komunicirati	Nan
xiriiri	kontakt	None
xiriiriyaha	kontakt	None
xiriirka	odnosi	None
xiriirto	kontakt	None
xirnaa	zatvoreno	Nan
xirneen	šuti	Nan
xir	ugasiti	Nan
xirnimo	zatvaranje	Nan
xingalool	trnce	Nan
xilliyo	doba	None
xiligan	trenutku	None
xiligii	vrijeme	None
xiligiimuraadkii	vremenima	None
xiliyada	doba	None
xiliyadii	doba	None
xiliyo	puta	None
xilka	odgovornost	None
xilkaas	položaju	None
xilkeeda	položaju	None
xilli	sezona	None
xilligaa	vrijeme	None
xilligaas	vrijeme	None
xilligaasi	vrijeme	None
xilligan	trenutku	None
xilligii	sezona	None
ximyar	dijete	None
xirsi	njezino	Nan
xirta	ugasiti	Nan
xirtaa	šuti	Nan
xooga	fokus	Nan
xoogaa	neki	None
xoogag	snage	None
xoogan	jak	None
xoogana	jak	None
xoogaysteen	jak	None
xoogga	snage	None
xoojinta	konsolidacija	Nan
xoola	stada	Nan
xoolaha	stoka	Nan
xoolaheeda	životinje	None
xoolaley	stočari	Nan
xoolihii	životinje	None
xoolo	stoka	Nan
xooluhuna	stoka	Nan
xoog	snage	None
xogo	informacija	None
xoghayaha	sekretara	Nan
xoghaya	sekretara	Nan
xirtaan	to	None
xisaab	matematika	None
xisaabaadka	računi	Nan
xisaabin	izračunati	Nan
xisaabta	matematika	None
xisaabtan	odgovornost	None
xisbi	zabava	Nan
xiligaasoo	vrijeme	None
xisbiga	zabava	Nan
xisbigiisa	stranka	None
xisbiyada	zabave	Nan
xisbiyo	zabave	Nan
xishoon	sramota	Nan
xitaa	čak	None
xkhayre	jahač	Nan
xog	informacija	None
xisbigii	zabava	Nan
xiligaasi	vrijeme	None
xiligaas	vrijeme	None
xiligaa	vrijeme	None
xeeran	okolo	Nan
xeerar	pravila	None
xeerarka	pravila	None
xeerarkeeda	pravila	None
xeerka	pravilo	None
xeraale	kamper	Nan
xerada	kamp	Nan
xero	kamp	Nan
xh	xh	Nan
xhks	xhks	Nan
xidh	ugasiti	Nan
xidha	ugasiti	Nan
xidhaayey	gašenje	Nan
xidhay	ugasiti	Nan
xidhiidh	kontakt	None
xeer	pravilo	None
xeelliga	kontekstu	None
xeeldheeri	taktike	Nan
xeeldheer	u	None
xasuusto	zapamti	Nan
xataa	čak	None
xawaadle	akcelerator	Nan
xawaaladaha	doznake	Nan
xawaannada	brzinom	None
xawda	brzina	None
xayaawaanaadka	životinje	None
xidhiidha	srodni	Nan
xayawaan	životinja	None
xayle	debeo	Nan
xds	xds	Nan
xeeb	plaža	Nan
xeebaha	plaže	Nan
xeebeed	obala	None
xeebta	plaža	Nan
xeel	takt	Nan
xayawaanaadka	životinje	None
xasuustaan	zapamti	Nan
xidhiidhka	komunikacija	None
xidhiidhno	kontakti	Nan
xigto	rodbina	Nan
xiiirto	brijati	Nan
xiiray	obrijan	Nan
xiiseyneysid	zainteresovani	Nan
xiiso	zanimljivo	None
xijaaz	xijaaz	Nan
xijrootay	se	None
xikmad	mudrost	Nan
xil	odgovornost	None
xilagan	put	None
xilal	odgovornosti	None
xildhibaan	mp	Nan
xilgii	vrijeme	None
xili	period	None
xiliga	sezona	None
xigtay	sljedeći	None
xigtaa	sljedeći	None
xigta	sljedeći	None
xigo	sljedeći	None
xidhiidho	kontakti	Nan
xidhka	trošenje	Nan
xidhkii	the	None
xidhnaan	šuti	Nan
xidhnaantii	šuti	Nan
xidho	to	None
xidid	root	Nan
xidhiidhkaasi	odnos	None
xifdin	zadržati	None
xigaa	sljedeći	None
xigaan	sljedeći	None
xigay	sljedeći	None
xigeen	porok	Nan
xigeenka	porok	Nan
xigeenkii	poručniče	Nan
xigmadda	mudrost	Nan
xiga	sljedeći	None
tuso	pokazati	None
tusaayo	podrazumijeva	None
tusaan	im	None
shacbigu	javnost	None
shaciga	zakon	None
shadoor	napolju	Nan
shahaadada	stepen	None
shahaadataynku	certifikat	Nan
shahaado	stepen	None
shahiirsanadii	varvari	Nan
shaki	sumnje	None
shalaanbood	čestitke	Nan
shalay	jučer	Nan
shan	piće	Nan
shanaad	peti	None
shanaadwaxaana	peti	None
shanfarood	pet	None
shanta	pet	None
shacbigii	javnost	None
shantaan	pet	None
shacbigana	ljudi	None
shacbi	javnost	None
shabac	šabab	Nan
shabahdaa	da	None
shabakad	web	Nan
shabakada	web	Nan
shabeel	tigar	Nan
shabeelaha	tigra	Nan
shabeellaha	tigra	Nan
shabeelle	shabelle	Nan
shabele	shabele	Nan
shabelle	shabelle	Nan
shacab	civili	Nan
shacabka	ljudi	None
shacabkii	javnost	None
shacabkooda	ljudi	None
shacabku	javnost	None
shacbiga	javnost	None
shantaasi	da	None
shaqaalaha	zaposleni	Nan
shaqaale	zaposleni	Nan
shaqeynaya	radeći	Nan
shaqeynayay	radeći	Nan
shaqeysata	radeći	Nan
shaqo	posla	None
shaqooyinka	poslovi	Nan
shaqsi	pojedinac	Nan
shaqsiyaad	pojedinci	None
shaqsiyaadka	pojedinci	None
sharaf	čast	None
sharafkii	čast	None
sharafta	dostojanstvo	Nan
sharaxday	objašnjeno	Nan
sharci	zakon	None
sharciga	zakon	None
sharcigaa	zakon	None
shaqeeyo	radeći	Nan
shaqeeyey	radio	None
shaqeeyeen	radio	None
shaqeeyay	radio	None
shaqaalihii	radnici	None
shaqaaq	uznemiravanje	Nan
shaqada	na	None
shaqadii	posao	None
shaqadiisa	posao	None
shaqal	samoglasnik	Nan
shaqalka	samoglasnik	Nan
shabaabka	mreža	None
shaqayn	posla	None
shaqaysay	radio	None
shaqeen	radio	None
shaqeesa	sebe	None
shaqeesaa	djela	None
shaqeeya	radeći	Nan
shaqeeyaa	djela	None
shaqeeyaan	posla	None
shaqaynta	radeći	Nan
sharcigu	zakon	None
shaati	košulja	Nan
shaam	sramota	Nan
saxaarada	pladanj	Nan
saxaaro	stolica	Nan
saxaraa	stolica	Nan
saxaraha	izmet	None
saxda	tacno	Nan
saxeexday	potpisan	None
saxeexdeen	potpisan	None
saxiixday	potpisan	None
saxiixdeen	potpisan	None
saxo	tacno	Nan
saxons	saksoni	Nan
say	reći	None
sayid	majstore	Nan
sayidka	gospod	Nan
sayidku	majstore	Nan
saxaafadda	u	None
saylac	reći	None
saxaafada	u	None
sax	tacno	Nan
sarkaalkii	oficir	Nan
sarkozy	sarkozy	Nan
sarreeye	visok	None
sasha	sasha	Nan
sasiiliya	safir	Nan
saudi	saudi	Nan
sawaaxiliga	svahili	Nan
sawir	fotografirati	Nan
sawirada	slike	None
sawiran	slici	None
sawiray	fotografirali	Nan
sawiraya	crtanje	Nan
sawirka	slika	None
sawirmaan	izvući	Nan
sawirro	slike	None
saxaabi	tacno	Nan
saylada	market	Nan
saylici	majstore	Nan
saynis	nauka	None
senator	senatore	Nan
sep	sep	Nan
serbia	srbija	None
servant	sluga	Nan
service	usluga	None
services	usluge	None
several	nekoliko	None
seyfi	sefi	Nan
seynab	zaynab	Nan
sgaas	cigara	Nan
sh	sh	Nan
shaac	proglasio	None
shaafici	stranicu	Nan
shaah	čaj	Nan
shaahii	čaj	Nan
seexday	spavao	Nan
seexan	spavati	Nan
seegaaya	nedostajati	Nan
sedex	tri	None
sayniska	nauka	None
schleicher	schleicher	Nan
school	škola	None
schoolership	kola	None
schoolka	škola	None
schools	škole	None
scw	scw	Nan
shaarub	brkovi	Nan
sdarbi	jedan	None
sebteembar	septembra	None
sebtembar	septembra	None
second	sekunda	Nan
secondary	sekundarno	Nan
section	odjeljak	Nan
security	sigurnost	None
sede	kopiju	Nan
sdwo	posjetiti	Nan
sharciya	zakonit	Nan
sharciyada	zakoni	None
sharciyeed	legalni	Nan
shinema	sijati	Nan
shingaani	barijere	Nan
shiniile	aligator	Nan
shir	konferencija	Nan
shirakadahani	kompanije	None
shirarkii	konferencije	Nan
shirdahan	ovaj	None
shire	shire	Nan
shirkaa	kongres	None
shirkaas	sastanku	None
shirkad	kompanija	None
shirkada	kompanija	None
shirkadaha	kompanije	None
shirkadahaas	kompanije	None
shirkadahan	kompanije	None
shineemo	bioskop	Nan
shirkadahani	kompanije	None
shimbiruhu	ptice	None
shimbiraha	ptice	None
shige	stane	Nan
shiikh	šeik	Nan
shiikha	shiikha	Nan
shiikhu	shiikhu	Nan
shiinaha	kina	None
shiinuhu	kina	None
shiiq	shiiq	Nan
shiiqaal	jebote	Nan
shiiraar	platno	Nan
shil	nesreća	Nan
shilaabo	dobrodošli	Nan
shilin	šilinga	Nan
shilinka	novac	None
shilling	šiling	Nan
shimbir	ptica	None
shimbiro	ptice	None
shirkadda	kompanija	None
shirkado	kompanije	None
shirkadood	kompanije	None
siday	kao	None
sidda	kao	None
side	strana	None
sidee	kako	None
sideed	osam	None
sideedaad	osmi	Nan
sideedan	osam	None
sideedii	osam	None
sideetameeyadii	osamdesete	Nan
sidey	nositi	None
sidi	kao	None
sidii	kao	None
sidiisii	njegovom	None
sido	nositi	None
sidoo	takođe	None
sidatan	kao	None
sidan	ovuda	Nan
sidae	kako	None
sidaasi	tome	None
shirkan	ovaj	None
shirki	pripisana	Nan
shirkii	sabor	None
shiro	tišina	Nan
shirqool	zavjera	Nan
shirweynahan	konferenciji	None
shisheeye	strani	None
shift	smjena	Nan
shuceyb	nedostajati	Nan
siad	gurnuti	Nan
siciid	može	None
sida	kao	None
sidaa	tako	None
sidaad	kako	None
sidaan	ovuda	Nan
sidaas	tako	None
si	do	None
shido	uključi	Nan
shiday	upaljen	Nan
shidaalka	gorivo	None
shayga	objekta	None
shcali	primjer	None
sheeg	reći	None
sheega	reći	None
sheegaa	potraživanja	Nan
sheegaan	reći	None
sheegaas	tvrdnja	None
sheeganaya	tvrditi	Nan
sheegay	navedeno	None
sheegaya	spominje	None
sheegayaa	spominje	None
sheegayaan	reći	None
sheegayo	spominje	None
sheegeen	navedeno	None
sheegey	tvrdio	None
shaydaan	sotona	Nan
shaybah	šejba	Nan
shay	objekta	None
shaxda	stola	Nan
sharciyeynaayey	legitimno	Nan
sharciyo	pravila	None
shardi	stanje	None
shardiga	stanje	None
shareecada	šerijat	Nan
sharif	šarif	Nan
shariif	sharif	Nan
sheegganaa	tvrditi	Nan
shariifka	šerif	Nan
sharkiisa	njegova	None
sharkiisaba	njegova	None
sharmaarke	zlo	None
sharmaarkeعبد	komentar عبد	Nan
sharmake	sharmake	Nan
shatt	shatt	Nan
shax	stola	Nan
shariifku	polica	Nan
sarkaal	oficir	Nan
sheegganayd	tvrdio	None
sheegi	reci	Nan
sheekhu	priča	None
sheekhulislaam	šeikulislam	Nan
sheeko	priča	None
sheekooyinka	priče	None
sheekooyinkii	priče	None
sheikh	šeik	Nan
shekh	shekh	Nan
sheyba	sheaba	Nan
sheydaankii	đavo	Nan
shibane	shiban	Nan
shibil	nesreća	Nan
shibilka	nesreća	Nan
shibis	konferencije	Nan
shicibka	javnost	None
shidaal	gorivo	None
sheekhii	priča	None
sheekheena	priča	None
sheekhaal	priča	None
sheekha	pripovjedač	Nan
sheegin	ne	None
sheegnay	spomenuto	Nan
sheegnaya	spominje	None
sheegnayba	ment	Nan
sheego	reći	None
sheegsheegta	tvrditi	Nan
sheegta	tvrditi	Nan
sheeggayga	tvrdnja	None
sheegtaa	potraživanja	Nan
sheegtada	tvrditi	Nan
sheegtay	tvrdio	None
sheegto	tvrditi	Nan
sheekada	priča	None
sheekayn	priča	None
sheekayno	ćaskati	Nan
sheekh	šeik	Nan
sheegtaan	tvrditi	Nan
sarifo	razmjena	None
sarfiga	abeceda	Nan
sareysa	visok	None
saara	ukloniti	None
saaraa	uklonjen	Nan
saaraan	uklonjen	Nan
saaran	na	None
saaray	izbaci	Nan
saarayso	isključeni	Nan
saareen	tugovali	Nan
saarey	izostavljeno	Nan
saari	ukloniti	None
saarida	isključenje	Nan
saarka	proizvod	None
saarkeeda	njemu	None
saarkooda	oči	None
saarnaa	na	None
saaro	uklonjen	Nan
saar	ukloniti	None
saartaa	ga	None
saanmarino	šaman	Nan
saan	ovo	None
saabsan	otprilike	None
saabsanaa	otprilike	None
saacad	sat	None
saacada	sat	None
saacadaha	sati	None
saadka	logistika	Nan
saaiidi	i	None
saalax	oprostite	Nan
saamaxday	pomilovan	Nan
saamaxeen	pomilovan	Nan
saamaynta	efekti	None
saamaysay	pogođeni	Nan
saambiya	safir	Nan
saami	proporcija	Nan
saamo	zaliha	Nan
saanad	godina	None
saartay	izbaci	Nan
saas	tako	None
saaxiib	prijatelju	Nan
sabtida	subota	Nan
sabtiga	u	None
sac	krava	None
sacad	koliba	Nan
sacaridalaxdageelka	mlati	Nan
saciid	pljuvačka	Nan
sacuudi	saudijski	Nan
sacuudiga	svetac	Nan
sadaam	sadam	Nan
sadaan	s	None
sadam	sadam	Nan
sadamna	sadna	Nan
sadaqada	organizacija	None
sadaqo	organizacija	None
sadax	tri	None
sabti	subota	Nan
sabriye	sablja	Nan
saboolsan	siromašan	Nan
sabool	siromašan	Nan
saaxiibka	prijatelju	Nan
saaxiibtinimo	prijateljstvo	Nan
saaxiibtinnimo	prijateljstvo	Nan
saaxiil	čarobnjaka	Nan
saaxil	čarobnjaka	Nan
sab	zahvaljujući	None
saba	nedosljedan	Nan
sa	set	None
sabab	razlog	None
sababay	izazvao	None
sababeen	izazvao	None
sababta	zašto	None
sababtay	izazvao	None
sababto	uzroka	None
sababtoo	jer	None
sablaale	klizač	Nan
sababaha	razlozi	None
s	s	None
ruwanda	voda	None
ruuxna	niko	None
roma	romi	None
romaankuba	šipak	Nan
roman	romanski	Nan
romania	rumunija	None
romanku	romanski	Nan
rome	hrom	Nan
roob	kiša	None
roobab	padavine	None
roobka	kiša	None
roobkana	kiša	None
roobku	kiša	None
rooble	duga	None
roobleh	duga	None
roof	krov	Nan
rooma	šipak	Nan
rogrogan	uvrnut	Nan
rogaye	uvrnut	Nan
rogay	izokrenuto	Nan
roelof	roelof	Nan
ridey	let	None
rido	započnite	Nan
rigliga	oprema	None
rinjiga	boje	None
river	rijeka	None
riyaale	san	None
riyada	san	None
roomaaniyiinta	rumuni	Nan
riyadaas	san	None
riyadoodii	san	None
riyaha	koze	Nan
riyo	san	None
roaming	roaming	Nan
robust	robustan	Nan
rodes	štapovi	Nan
rodolfo	poundolfo	Nan
riyadii	san	None
sadaxaad	treća	None
roomaanka	rimljani	None
roon	dobro	None
rumeysan	vjerujte	Nan
rumeysey	vjeruj	Nan
run	istinito	Nan
runta	istina	None
runtii	zaista	None
runtiisa	istina	None
ruqiya	perverzno	Nan
ruqiyo	iluzije	Nan
rususha	posipati	Nan
rusushii	jahač	Nan
ruug	čvršće	Nan
ruush	ruski	None
ruushka	ruski	None
ruux	duha	None
ruuxii	duh	None
rumeyn	vjeruj	Nan
rumeeyo	vjeruj	Nan
rumeeyay	verovali	Nan
rumeeyana	mi	None
roone	roon	Nan
rooraaye	roaming	Nan
rootiga	hleb	Nan
rotterdam	roterdam	Nan
rpp	rpp	Nan
rugta	košnica	Nan
rukuucda	patenti	Nan
roomaanku	rumunski	None
rumawdo	rumawdo	Nan
rumaynta	vjerujući	Nan
rumayntooda	njihovo	None
rumayntu	vjerujući	Nan
rumaynu	mi	None
rumaysan	vjerujte	Nan
rumaysanyahay	tebe	None
rumayso	vjeruj	Nan
rumaynayo	vjeruj	Nan
sidookele	takođe	None
sadaxaadna	treći	None
saddax	tri	None
sameeyo	učiniti	None
sameyn	učiniti	None
sameysa	učiniti	None
sameyso	to	None
sameystay	napravljeno	Nan
samidiyo	video	None
samir	budi	None
samo	pronađeno	Nan
samow	zdravo	Nan
samroon	sambar	Nan
samsamka	sams	Nan
samyn	učiniti	None
san	znam	None
sanaag	sag	Nan
sanad	godine	None
sameeyey	jeste	None
sanadadii	godina	None
sameeyeen	jeste	None
sameeyawaa	uradi	None
samaawiga	nebo	None
samada	nebesa	Nan
samaron	theron	Nan
samaroon	nebo	None
samaroonku	nebo	None
samatalis	samatalis	Nan
samatar	prijedlog	None
samayn	učiniti	None
samaynaya	radeći	Nan
samaysan	napravljeno	Nan
samaysay	jeste	None
samaysiga	formacija	None
sameenta	čine	None
sameeya	učiniti	None
sameeyaan	učiniti	None
sameeyay	jeste	None
sanadahan	godinama	None
sanadihii	godina	None
sanadii	godine	None
sannadkii	godine	None
sannadku	godine	None
sano	godina	None
sapienza	sapienza	Nan
saqiireen	podne	None
saraakiil	oficiri	Nan
saraakiisha	zvaničnici	Nan
saraakiishii	oficiri	Nan
saraar	palata	Nan
saransoor	saransoor	Nan
sardiiniya	sardius	Nan
sare	visok	None
sareeya	visok	None
sareeyo	visok	None
sarena	visok	None
sannadkaasna	godine	None
sannadkaas	godine	None
sannadihii	godina	None
sannadahan	godinama	None
sanadka	godine	None
sanadkaa	godine	None
sanadkaana	godine	None
sanadkaas	godine	None
sanadkan	godine	None
sanadki	godišnje	None
sanadkii	godine	None
samaale	sam	None
sanadkiiba	godišnje	None
sanadku	godine	None
sanado	godina	None
sanadood	godina	None
sanca	sanca	Nan
sand	peska	Nan
sandkii	godine	None
sanka	nosa	Nan
sanadkooda	godine	None
salma	salma	Nan
salka	baza	None
saliim	salim	Nan
safraan	putovanje	None
safray	putovali	Nan
safraya	putovanja	None
safri	putovanje	None
sagaal	devet	Nan
sagaalaad	deveti	Nan
sagaaliyotobnaad	devetnaesto stoljece	Nan
sagaalkooda	njihovih	None
sahal	lako	None
sahashay	uklet	Nan
sahlan	lako	None
sahra	sarara	Nan
saint	svetac	Nan
sakada	u	None
sakariye	sjebani	Nan
safiya	ujutro	None
safiirkii	ambasadora	Nan
safiirka	ambasadora	Nan
safarrada	izleti	Nan
saddaxda	tri	None
saddex	tri	None
saddexaad	treća	None
saddexda	tri	None
saddexdooduba	troje	None
sadex	tri	None
sadexaad	treća	None
sakiin	žilet	Nan
sadexda	tri	None
sadqeeyay	donirao	Nan
safaarada	ambasada	Nan
safaaradaha	ambasade	Nan
safar	putovanje	None
safarka	putovanje	None
safarkii	putovanje	None
safarkiisii	putovanje	None
sadexdii	tri	None
sadaxda	tri	None
sako	poruka	None
sal	sal	Nan
salbalaadhan	ovo	None
saldanad	godina	None
saldanada	naše	None
saldanadda	stubova	Nan
saldanadii	otac	None
saldanado	godina	None
saldhig	baza	None
saldhiga	baza	None
saldhigga	podnožju	None
saldhigyo	baze	None
saleebaan	cond	Nan
saleemaan	ih	None
salfiyo	soli	None
saliid	ulje	Nan
saliida	ulje	Nan
salaysanyahay	zasnovana	None
salaysan	zasnovana	None
salal	salal	Nan
salafusaalixa	pozdrav	Nan
salaad	molitva	None
salaadda	molitva	None
salaaddu	molitva	None
salaadeed	molitva	None
salaadood	molitve	None
salaam	zdravo	Nan
salaama	zdravo	Nan
saksonku	te	None
salaan	zdravo	Nan
salaanee	zdravo	Nan
salaanka	merdevine	Nan
salaannee	te	None
salaaxudiin	pozdrav	Nan
salad	salata	Nan
salafiyiinta	salafisti	Nan
salafka	šafran	Nan
salaancarrabey	salutecarrabey	Nan
siduu	tome	None
sierra	sierra	Nan
sifaadkiisa	atributi	Nan
tansaaniya	tanzanija	Nan
taqaan	ti	None
taqaano	ti	None
taqasusay	specijalizacija	Nan
taqasustay	za	None
tara	devet	Nan
taraawiil	prikolica	Nan
tarayn	gluposti	Nan
tarbiyada	uzgoj	None
tarbiyeesan	spljoštena	Nan
tareen	voz	Nan
tari	kašalj	Nan
tarjamada	prijevodi	Nan
tartamaayey	se	None
tartami	se	None
tani	szo	Nan
tartanka	konkurencija	Nan
tan	ovo	None
tamar	energije	None
taliyaaniga	italijanski	None
taliyaanigu	italijanski	None
taliyaanu	vladar	None
taliyaha	vladar	None
taliye	vladar	None
taliyeen	savjetovan	Nan
taliyihii	guvernera	None
taliyo	pravilo	None
talo	savjet	None
talyaani	italijanski	None
talyaaniga	italijanski	None
talyaanigasyl	italijanski	None
talyaanigu	italijanski	None
talyaaniguna	italija	None
talyaniga	italijanski	None
tamarta	energije	None
tartankii	takmičenje	None
tashaday	konsultovao	Nan
tashik	odlazak	Nan
teelteel	periodično	Nan
tegay	otišao	None
tegey	otišao	None
tegeysaan	idete	Nan
tegi	odlazi	None
tegin	odlazi	None
telcom	telcom	Nan
teleefonada	preko	None
telefoion	telefonon	Nan
telefoon	telefonom	Nan
telefoonada	telefoni	Nan
terre	terre	Nan
testify	svedočiti	Nan
textalign	textalign	Nan
tfgda	tfgda	Nan
teedsan	uz	None
teeda	ona	None
technology	tehnologija	None
tech	tech	Nan
tashteen	otrcan	Nan
tasi	tasi	Nan
tawraad	nehotice	Nan
tawreet	ti	None
taxaabaan	su	None
taxane	serija	None
taxnaa	serija	None
taliyaani	zapovjednika	Nan
tay	tay	Nan
taymiya	ukrotiti	Nan
tayo	kvaliteta	None
ta´shilin	putovanja	None
tchad	tchad	Nan
tdma	tdma	Nan
tebin	prevesti	Nan
tebiyey	izvijestili	Nan
tayada	kvaliteta	None
taliskii	pravilo	None
taliska	naredba	None
talisa	riječi	None
taasaa	to	None
taasi	da	None
taasina	da	None
taasna	to	None
taasoo	koja	None
taaxane	bogat	None
taba	duvan	Nan
tababarada	trening	Nan
tababaran	obučeni	Nan
tababare	trener	None
tababarka	trening	Nan
tabo	tacka	Nan
tacliin	obrazovanja	None
tacliinta	akademici	Nan
tada	podići	Nan
taas	da	None
taarikhda	istorija	None
taarikh	istorija	None
taariiqyahano	istoričara	Nan
taan	ovo	None
taangiyada	tenkova	Nan
taar	datum	None
taariikh	istorija	None
taariikhda	istorija	None
taariikhdadhaqanka	poplava	None
taariikhdii	istorija	None
tafiirmaan	odlazi	None
taariikhdu	istorija	None
taariikhi	istorijskog	Nan
taariikhiga	istorijskog	Nan
taariikho	datumi	Nan
taariikhood	datumi	Nan
taariikhyahan	istoričar	Nan
taariikhyahanada	istoričara	Nan
taariiqyahanka	istorija	None
taariikheed	istorijskog	Nan
th	th	Nan
tafsiirka	interpretacija	Nan
tagaa	idi	Nan
talaabadan	korak	None
talaabo	korak	None
talaadada	u	None
talaado	utorak	Nan
talada	savjet	None
taladana	savjet	None
taladii	savjet	None
taladu	savjet	None
talagalay	za	None
talayaaniga	italijanski	None
taleefoonada	telefoni	Nan
taleex	telefonom	Nan
tali	szo	Nan
talin	branilac	Nan
talis	naredba	None
talaabada	korak	None
tala	savjet	None
tajwiidka	u	None
tahliil	dijalekt	None
tagaan	idi	Nan
tagay	otišao	None
tagaya	dalje	None
tage	ići	None
tageen	otišao	None
tagey	otišao	None
tagin	ne	None
taga	prozor	None
tagisteeduna	njen	None
tagsiile	taksi	Nan
tagtada	oznaka	None
tagteen	otišao	None
tagto	idi	Nan
tahay	si	None
tahaye	depresivno	Nan
tahayna	si	None
tago	idi	Nan
taamyeeloo	stane	Nan
that	da	None
their	njihove	None
tolayoo	puretina	Nan
tolkayoo	zdravica	Nan
tooda	zdravica	Nan
toogasho	pucanje	Nan
toona	da	None
tooreyda	gušavac	Nan
toori	da	None
toos	direktan	Nan
toosa	se	None
toosan	ravno	None
toosanaha	direktan	Nan
toose	neposredan	Nan
toosoo	se	None
top	vrh	None
toqoshi	baciti	Nan
tol	tol	Nan
towfiiq	towfiiq	Nan
togwajaale	ostalog	None
togga	reka	Nan
tobankii	deset	None
tobnaad	deseti	Nan
toc	toc	Nan
todabaadka	sedmicu	Nan
today	danas	None
toddoba	sedam	None
toddobo	sedam	None
todoba	sedam	None
todobaad	sedmicu	Nan
todobaadka	sedmice	None
todobada	sedam	None
todobo	sedam	None
togagga	potoci	Nan
togdheer	preklopnik	Nan
togdheersanaag	budi	None
togo	ići	None
town	grad	None
towxiidka	meditacija	Nan
training	trening	Nan
turjumaha	prevodilac	Nan
turjume	prevodilac	Nan
turjumey	prevedeno	Nan
turkey	puretina	Nan
turki	puretina	Nan
turkida	puretina	Nan
turkiga	puretina	Nan
turkigamaadaama	jer	None
turkigawaxa	puretina	Nan
turkigu	puretina	Nan
turkish	turski	None
turkiya	turska	None
turkki	turkki	Nan
turkumaanka	turku	Nan
tusaale	primjer	None
tunisya	tunesya	Nan
tunisiya	podsetiti	Nan
tunisia	tunis	None
tunis	melodija	Nan
transmission	prijenos	None
transnistria	transnistria	Nan
tu	tu	None
tubane	tubane	Nan
tubayoo	konverzija	Nan
tubeec	tubeec	Nan
tukado	se	None
tobanka	deset	None
tukan	se	None
tukanayo	se	None
tukelalmimurcood	tukelalmimurcood	Nan
tukuhu	đubrivo	Nan
tuldo	tuldo	Nan
tuluddiiye	učitelj	None
tumay	tumor	None
tuni	podseća	Nan
tukanaya	se	None
toban	deset	None
to	do	None
tixraacyada	reference	None
tiirsada	njega	None
tiirsan	zavisni	Nan
tiirsanaa	zavisni	Nan
tiirsantahay	zavisni	Nan
tiirsanyahay	tebe	None
tijaaradii	eksperiment	Nan
tijaareeyo	stenjati	Nan
tijaaro	drhtati	Nan
tikrit	ulaznica	Nan
tilaami	tilami	Nan
tilmaamaa	identificira	Nan
tilmaamaan	istaći	Nan
tilmaaman	naznačeno	Nan
tilmaamay	istaknuo	Nan
tilmaamayo	ističući	Nan
tiirka	stub	Nan
tiirarkaasina	ovi	None
tiirarka	stubova	Nan
tiirar	stubova	Nan
there	tamo	None
these	ove	None
they	oni	None
this	ovo	None
through	kroz	None
throughout	širom	None
ti	od	None
tilmaameen	istaknuo	Nan
tidhaah	kaže	None
tignolajiyada	tehnologija	None
tigreega	ulaznica	Nan
tihiin	si	None
tii	čaj	Nan
tiil	crijep	Nan
tiille	tiille	Nan
tiir	stupac	Nan
tidhi	je	None
the	the	None
tilmaami	istaći	Nan
tilmaanayba	istaći	Nan
tiriyey	se	None
tiriyo	brojati	Nan
tiro	broj	None
tirokoob	statistika	None
tirsan	član	None
tirsana	ih	None
tirsanaa	bio	None
tirsanaan	brojati	Nan
tix	usp.	Nan
tixda	lista	None
tixdan	smatra	None
tixdii	obzir	None
tixdiisa	njegovo	None
tixihiisa	njegove	None
tixraac	referenca	Nan
tiriyay	se	None
tirin	brojati	Nan
tiri	brojati	Nan
tiran	crijep	Nan
timaadada	hajde	Nan
timaaddo	doći	None
timacade	idi	Nan
time	vreme	None
times	puta	None
timi	hajde	Nan
timid	stigli	None
tilmaamo	instrukcije	None
timide	hajde	Nan
timo	kosa	None
timocade	timokada	Nan
tinta	kosa	None
tira	napeto	Nan
tirad	broj	None
tirada	broj	None
tirakoob	statistika	None
timirta	dlan	Nan
riday	spustiti	Nan
taamaayee	ti	None
taalla	dostupan	None
socotada	putnik	Nan
socotay	nastavio	None
socoto	toku	None
soddon	trideset	None
software	softver	None
softwareku	softver	None
sogüt	sogüt	Nan
soka	probušiti	Nan
sokeeyay	čuvano	Nan
sokeeye	civil	Nan
sokow	toga	None
soltelco	soltelco	Nan
somaaliland	somaliland	Nan
somaaliya	somalija	Nan
somaaliyeed	somalijski	Nan
socota	sledeći	Nan
somailand	somaliland	Nan
socono	mi	None
socon	hodanje	Nan
socda	sledeći	Nan
socdaa	toku	None
socdaal	putovanja	None
socdaale	putnik	Nan
socdaalka	imigracija	Nan
socdaan	hodanje	Nan
socdaanba	toku	None
socday	ide	None
socdaydhaqaalaha	socioekonomski	Nan
socdeen	prošetao	Nan
socdey	nastavio	None
socdeyna	hodanje	Nan
socdo	toku	None
soco	nastavi	Nan
socodka	hodanje	Nan
soconno	hodanje	Nan
somali	somalijski	Nan
somalia	somalija	Nan
somalialand	u	None
soogelitaankii	dolazak	None
soojeedinta	prezentacija	None
sool	sool	Nan
soomaaiya	brzo	None
soomaal	somalijski	Nan
soomaali	engleski	None
soomaalia	u	None
soomaalida	somalijski	Nan
soomaalidii	the	None
soomaalidu	ljudi	None
soomaaliga	engleskom	None
soomaaligalbeed	budućnosti	None
soomaaliland	u	None
soomaaliya	somalija	Nan
soomaaliyakiinya	ti	None
soogalistii	soogalistii	Nan
soodhaafanay	smo	None
soo	dođi	Nan
sonkorta	šećer	None
somalida	ljudi	None
somalidu	somalijski	Nan
somaliga	engleskom	None
somalilada	u	None
somalilanad	engleskom	None
somaliland	u	None
somalilandintaas	je	None
so	ljubav	None
somalilandna	u	None
somaliwayn	somalijski	Nan
somaliya	somalija	Nan
somaliyeed	somalijski	Nan
somaray	play	None
some	neki	None
somlialnd	somlialnd	Nan
somtel	somtel	Nan
somalinimada	somalihood	Nan
snmta	snmta	Nan
snmlooma	snmlooma	Nan
snm	snm	Nan
siiyaymagaca	ime	None
siiyeen	im	None
siiyey	dato	Nan
siiyo	daj	Nan
silanyo	siloon	Nan
silic	patnja	Nan
sim	sim	Nan
siman	jednak	None
simantahay	jednak	None
simanyihiin	jednak	None
simbaabwi	uspori	Nan
simo	izjednačiti	Nan
sinaan	jednakost	None
sinaanta	jednakost	None
sinigaal	sediment	Nan
siiyaycalan	daj	Nan
siiyay	dato	Nan
siiya	pasmina	Nan
siisay	dao	None
sifeynta	dijaliza	Nan
sifiican	dobro	None
sifoobay	rafinirano	Nan
signal	signal	None
signals	signala	None
sii	daj	Nan
siiba	posebno	None
sir	gospodine	Nan
siid	pustiti	Nan
siidaynta	izdanje	None
siilaanyo	sions	Nan
siin	daj	Nan
siinayo	davanje	Nan
siinjiray	dato	Nan
siirada	ings	Nan
siisa	baciti	Nan
siidaayey	odbaciti	Nan
soomaaliyana	u	None
sirasmi	sirsmi	Nan
sirdoonyaasha	inteligencija	None
siyaasi	političar	None
siyaasiga	politika	None
siyaasiinta	političari	None
siyaasiyiin	političari	None
siyaasiyiinta	političari	None
siyaasiyiintan	političari	None
siyaasiyiinytii	političari	None
siyad	siad	Nan
siyasadeed	političkih	None
skandinafia	skandinafija	Nan
slitaz	slitaz	Nan
smaller	manji	None
smart	pametan	Nan
sms	sms	Nan
snaciidamada	zmije	None
siyaasadii	politike	None
siyaasadeed	političkih	None
siyaasaddeed	političkih	None
siyaasadda	politika	None
siri	teško	None
sirta	tajne	None
sisiiliya	cilia	Nan
sisinta	susam	Nan
sitay	sit	Nan
siticmaalaa	ga	None
sitoosa	nedeljno	Nan
sirdoonka	inteligencija	None
siwaaqroon	način	None
sixadeeda	godinama	None
siyaa	ing	Nan
siyaad	siad	Nan
siyaadna	više	None
siyaaraadka	politika	None
siyaasad	politika	None
siyaasada	politika	None
siweyn	široko	None
taalo	stojeći	Nan
soomaaliyeed	engleskom	None
soomaaliyeey	nisam	None
suuq	tržište	None
suuqa	market	Nan
suuqyada	tržišta	None
suurada	sura	Nan
suuradda	ličnost	None
suurado	moguće	None
suuratu	sura	Nan
suuratul	moguće	None
suuratulfiil	suuratulfil	Nan
suuriya	sirijski	Nan
suurogal	moguće	None
suurto	moguće	None
suways	suways	Nan
suwees	tužbe	Nan
swasiland	švajcarska	Nan
suugaanyahankii	književnosti	None
sweden	švedska	None
suugaanyahan	literatura	None
suugaantiisa	njegovu	None
supports	nosači	Nan
suqa	ments	Nan
surinam	moj	None
sus	sus	Nan
suu	su	None
suuban	zvuk	None
suubanaa	pravu	None
suubban	zbogom	Nan
suubiye	dozvoljeno	None
suudaan	surah	Nan
suudaanitoobiya	superstar	Nan
suufi	sufiji	Nan
suugaan	književnosti	None
suugaanta	književnosti	None
suugaantii	književnosti	None
suugaantu	književnosti	None
switching	prebacivanje	Nan
switzerland	švajcarska	Nan
swt	swt	Nan
taageerayaasha	pristalice	Nan
taageero	podrška	None
taageersan	podržani	Nan
taageersanaa	podržani	Nan
taagi	čvrsto	None
taagnaa	stojeći	Nan
taajir	bogat	None
taajirsan	bogat	None
taaka	pomoć	None
taako	baciti	Nan
taal	na	None
taala	na	None
taalaa	si	None
taalada	kip	None
taale	danas	None
taageerayaal	pristalice	Nan
taageerada	podrška	None
taageera	podrška	None
taagay	podignut	Nan
sxb	sxb	Nan
syc	syc	Nan
syl	syl	Nan
syria	syria	Nan
system	sistem	None
systems	sistema	None
sénégal	sperma	Nan
superka	superka	Nan
t	t	Nan
taa	danas	None
taaban	dodir	None
taaboo	dodir	None
taad	taad	Nan
taagan	stojeći	Nan
taagantahay	stojeći	Nan
taaganyahay	stojeći	Nan
ta	ona	None
super	super	None
suntan	otrov	None
sunta	otrovan	Nan
soonku	brzo	None
soosocota	dolazi	None
sooyaalka	istorija	None
sos	čarape	Nan
soviet	sovjetski	None
sri	sri	Nan
ssdf	ssdf	Nan
st	st	Nan
stadium	stadion	None
standard	standardna	None
standards	standardima	None
state	država	None
states	država	None
station	stanica	None
stockholm	stockholm	Nan
soonkood	post	None
soonka	post	None
soona	brzo	None
soon	uskoro	None
soomali	engleski	None
soomalida	post	None
soomalidu	brzo	None
soomaliga	the	None
soomalimaad	hajde	Nan
soomaliya	somalija	Nan
soomaliyadii	the	None
strom	strom	Nan
soomaliyeed	somalijski	Nan
soomanaado	brzo	None
soomanahay	brzo	None
soomane	brzo	None
soomaray	brzo	None
soomidda	post	None
soomman	brzo	None
soommani	brzo	None
sooman	brzo	None
soomaaliyeeed	somalijski	Nan
stronger	ojačana	Nan
su	njih	None
sugnaakii	sačekaj	Nan
sugulle	konobar	Nan
suhra	suhra	Nan
suldaan	sultan	None
suldaanka	sin	None
suldaankii	sultan	None
suliman	suliman	Nan
sultan	sultan	None
sumada	simbol	None
sumerianku	sumerianku	Nan
sun	sunce	None
suna	ime	None
sunday	nedjelja	None
sunnada	sunnet	None
sunni	sunni	Nan
sugnaaday	je	None
sugnaa	čekali	Nan
sugeysey	čekalo	Nan
sugaysa	čekaju	Nan
suaal	pitanje	None
suaalo	pitanja	None
subac	subac	Nan
subag	puter	Nan
subax	ujutro	None
subayr	debeo	Nan
subscriber	pretplatnika	Nan
style=fontsize	veličina	None
subsystem	podsistema	Nan
such	takve	None
sucuudiga	saudijski	Nan
sudan	sudan	Nan
sudhan	visi	Nan
sugaal	sačekaj	Nan
sugan	sigurno	None
sugay	sačekaj	Nan
subxaanahu	potpunica	Nan
يسوع	يسوع	Nan
joogaba	vidljivo	None
joogaan	ostati	None
cilmi	naučni	None
cilmiga	nauke	None
cilmina	znanje	None
cilmiyada	nauke	None
cilmiyeedka	naučni	None
cilmu	cilmu	Nan
cimilada	vrijeme	None
cimiladeeda	klima	None
cimillada	generacije	None
cimilo	vrijeme	None
cimraan	vijekovima	None
cinwaanka	adresu	None
ciqaab	kazna	None
cir	cir	Nan
ciraaq	irak	Nan
cilmaaniya	informirati	Nan
ciraaqka	iraku	None
ciisuhu	udisati	Nan
ciisaha	isuse	Nan
ciidamadee	trupe	None
ciidamadii	trupe	None
ciidamadiisa	vojska	None
ciidamadu	trupe	None
ciidamdii	trupe	None
ciidamo	trupe	None
ciidan	vojska	None
ciidangale	vojska	None
ciidanka	vojska	None
ciidankii	vojska	None
ciidankiisii	vojska	None
ciidanku	vojska	None
ciidda	tlo	None
ciil	uznemiravanje	Nan
ciimadii	sveti	None
ciise	isuse	Nan
cirid	žvaka	Nan
cirifka	nebo	None
ciriiri	uska	Nan
ckariin	drugi	None
claahi	claahi	Nan
clahi	clahi	Nan
clinton	clinton	Nan
cllahi	bože	None
clle	clle	Nan
cllhi	cllhi	Nan
cod	glas	None
codec	kodek	Nan
codecs	kodeke	Nan
codka	glas	None
codsaday	traženo	Nan
codsanayaan	traženje	None
codsi	zahtjev	None
codsiga	aplikacija	None
ckariim	jastuk	Nan
ciyaarta	igra	None
ciyaaro	igre	None
ciyaarihii	igre	None
ciriiriga	zagušenja	Nan
cirka	nebo	None
cirro	blijed	Nan
cishaba	laku noc	Nan
cismaan	uživo	None
cismaaniya	pohvalan	Nan
cismaaniyiinta	pentekostalci	Nan
ciidamada	trupe	None
cismaaniyiintu	kršćani	None
cities	gradova	None
civil	civil	Nan
ciyaalka	deca	Nan
ciyaar	igra	None
ciyaaraa	igra	None
ciyaaraha	igre	None
ciyaaray	odigrao	None
cismaniyada	sekularizam	Nan
codsigaas	taj	None
ciida	bajram	None
cigalxasan	nastavio	None
ceelal	dobro	None
ceelasha	bunari	Nan
ceelbuur	bunar	Nan
ceelcad	dobro	None
ceeldheer	bunar	Nan
ceelgaal	dobro	None
ceelhuur	bunar	Nan
ceelka	bunar	Nan
ceelkii	bunar	Nan
ceelku	bunar	Nan
ceerigaabo	magla	Nan
ceerigabo	je	None
ceeryaamo	izmaglica	Nan
celi	ponovite	Nan
celin	ponavljanje	None
ceelaayo	besramno	Nan
celisa	suzdržan	Nan
ceel	dobro	None
ccc	ccc	Nan
casuumay	pozvan	Nan
casuura	pozvati	Nan
cawaale	lopata	Nan
cawil	siva	Nan
cawo	žvakati	Nan
caws	trava	Nan
cay	uvreda	Nan
cayaar	igra	None
cayaaraha	sport	None
caydiid	uvreda	Nan
cayiman	specificirano	Nan
cayimey	specificirano	Nan
cayn	ljubazan	Nan
caynaba	vrste	None
caynabo	nasmijanost	Nan
ceeb	sramota	Nan
celiya	se	None
celiyay	suzdržana	Nan
celiyo	ponovite	Nan
cida	szo	Nan
cidamada	u	None
cidda	szo	Nan
ciddii	szo	Nan
cidhifyada	ivice	Nan
cidi	cidi	Nan
cidii	szo	Nan
cidina	niko	None
cidla	pustoš	Nan
cidlo	usamljen	Nan
cidluu	usamljen	Nan
cidna	niko	None
ciel	ciel	Nan
cigaal	cigareta	Nan
cigaaljpg|maxamed	smaljpg |	Nan
cid	koga	None
cibaarada	štovanje	Nan
cibaado	pobožnost	Nan
cibaadada	štovanje	Nan
cell	ćelija	None
cells	ćelije	None
cellular	mobilni	Nan
celmi	se	None
center	centar	None
centre	centar	None
cerulli	cerulli	Nan
ciid	peska	Nan
channel	kanal	None
charles	charles	None
chavez	chavez	Nan
chemistry	hemija	None
chirac	chirac	Nan
christian	christian	None
christos	christos	Nan
church	crkva	None
channels	kanali	None
col	col	Nan
colaad	neprijateljski	Nan
colaada	sukob	None
daahir	čisto	None
daain	daain	Nan
daakhiliga	domaće	None
daalash	kišobran	Nan
daalicii	umor	Nan
daalin	umor	Nan
daallo	iscrpljeni	Nan
daalo	iscrpljeni	Nan
daalye	iscrpljeni	Nan
daaqad	prozor	None
daaqadaha	prozori	Nan
daaqadkasta	prozor	None
daaqiliga	pašnjaci	Nan
daar	skrenuti	Nan
daaraha	zgrade	None
daahfurayay	proizvodnja	None
daardaari	neprihvatljivo	Nan
daahay	kasno	None
daafta	odbrana	None
d	d	Nan
da	i	None
daa	pusti	Nan
daab	ispisati	Nan
daabacaada	ispisati	Nan
daabacdo	štampano	Nan
daabicin	objaviti	Nan
daacad	iskren	Nan
daacadda	iskrenost	Nan
daaci	gorčina	Nan
daad	poplava	None
daadagine	ne	None
daadagno	poplavljen	Nan
daadhey	poplavljen	Nan
daafaha	preko	None
daaha	sloj	None
daarood	krov	Nan
daaroodafka	prozor	None
daaroode	kuća	None
dabadeed	posle	None
dabadeede	kasnije	None
dabadeedna	onda	None
dabadiisii	rep	None
dabadood	njih	None
dabaq	kat	Nan
dabaqa	pod	None
dabaqadda	klasa	None
dabarre	iskorjenjivanje	Nan
dabayaaqadii	kasno	None
dabayloobey	vetar	None
dabcigiyo	naravno	None
dabeecad	ponašanje	None
dabeecada	priroda	None
dabeecaddiisa	priroda	None
dabada	rep	None
dabaasho	plivanje	Nan
dabaal	slaviti	Nan
daba	pratiti	None
daaroodka	živice	Nan
daarta	kuća	None
daas	kalaj	None
daauud	daud	Nan
daawad	pazi	Nan
daawada	lijek	None
daawado	pazi	Nan
cyimi	cyimi	Nan
daawanayay	posmatrajući	Nan
daawo	lek	Nan
daayay	pušten	Nan
daaye	zbogom	Nan
daayey	besplatno	Nan
daayin	the	None
daayo	pustiti	Nan
dab	vatra	None
daaweeyey	lečeni	Nan
cwahaab	odgovor	None
cutub	poglavlje	Nan
cuthmaaniyiintii	kultovi	Nan
countries	zemalja	None
country	država	None
course	kurs	Nan
coverage	pokrivenost	Nan
cqaadir	arogancija	Nan
crashiid	sudar	Nan
craxmaan	žudjeti	Nan
craxman	craxman	Nan
crd	crd	Nan
crisaaq	nered	Nan
cs	cs	Nan
csw	csw	Nan
cubeyd	cubeyd	Nan
cudur	bolest	None
cudurka	bolest	None
could	mogao	None
cost	trošak	None
cosoble	cosoble	Nan
core	jezgra	None
colba	colba	Nan
colenel	kolenel	Nan
colkayagii	neprijatelj	None
college	fakultet	None
colombia	kolumbija	None
colow	kukavica	Nan
colspan=	colspan =	Nan
cufanka	masa	None
communication	komunikacija	None
computers	računari	None
conditions	uslova	None
congo	kongo	Nan
congress	kongres	None
congresska	kongres	None
conoco	konoko	Nan
coofey	kuharica	Nan
computer	kompjuter	Nan
casumay	pozvan	Nan
culays	gravitacija	Nan
culimadii	učenjaka	Nan
cunteeyo	obrok	Nan
cunto	hrana	None
curadka	prvorođeni	Nan
curatay	prvorođeni	Nan
curious	znatiželjni	Nan
curiya	hrom	Nan
cuseyr	novije	None
cusmaan	play	None
cusmaaniyiinta	beskućnici	Nan
cusmaankii	novo	None
cusman	kusman	Nan
cusri	cusri	Nan
customer	kupac	Nan
cusub	novo	None
cusubi	novo	None
cuntada	hrana	None
cuno	jesti	None
cunin	nije	None
cunid	jesti	None
culimadu	učenjaka	Nan
culimo	učenjaka	Nan
culumaaudiinka	vjerski	None
culumada	učenjaka	Nan
culus	teška	None
culusoow	teška	None
culuumta	nauka	None
culimada	učenjaka	Nan
culuunta	učenjaka	Nan
cumar	omar	Nan
cun	jesti	None
cunaan	jesti	None
cunay	jeo	Nan
cune	jesti	None
cuneen	jeo	Nan
cuni	jesti	None
cumaan	oman	Nan
casriyeesanwaxeena	državi	None
casriyeesan	ažurni	Nan
casriyadii	modernog	None
caasimada	kapital	None
caasimadaha	prijestolnice	Nan
caasimadda	kapital	None
caasimadiisa	grad	None
caato	tanka	Nan
caawa	večeras	Nan
caawin	pomoć	None
caawinaayaan	asistencije	Nan
caawisayba	pomoglo	Nan
caawiyey	pomoglo	Nan
caawiyo	pomoć	None
cabaar	trenutak	None
cabaas	kabare	Nan
cabbaas	kablovi	Nan
cabbay	pio	Nan
caasimad	kapital	None
cabbeen	pio	Nan
caashaqa	ljubav	None
caasha	ljubav	None
caalin	branilac	Nan
caalmaka	bića	None
caalmka	svijetu	None
caamul	cam	Nan
caan	čuven	Nan
caana	mlijeko	None
caanaha	mlijeko	None
caanbaxday	je	None
caanka	čuven	Nan
caano	mlijeko	None
caansan	popularan	None
caansana	čuven	Nan
caansanaa	čuven	Nan
caaqil	mudar	Nan
caas	kapital	None
caashaq	ljubav	None
cabdalla	cabdalla	Nan
cabdalle	cabdalle	Nan
cabdi	pijte	Nan
cabdullaahi	abdullah	None
cabdullahi	abdullah	None
cabdulle	abdulle	Nan
cabdulmalik	cabalmalik	Nan
cabdulmuncim	cabdulmuncim	Nan
cabdulqaadir	patuljasti	Nan
cabdulraxmaan	sin	None
cabduqaadir	zagušenja	Nan
cabduraxmaan	pojanje	Nan
cabid	piti	Nan
cabir	skala	Nan
cabirka	veličina	None
cabitaanka	pijenje	Nan
cable	kabl	Nan
cabsada	strah	None
cabdule	kabulo	Nan
cabdulahi	cabalhihi	Nan
cabdulaahi	kafe	Nan
cabdmudhalib	savez	None
cabdicasiis	zastrašujuće	Nan
cabdilaahi	abdulahi	Nan
cabdillaahi	abdullah	None
cabdillahi	abdulahi	Nan
cabdille	cabdille	Nan
cabdimanaaf	komore	None
cabdimudhalib	cabdimudhalib	Nan
caalimudiin	učenjak	Nan
cabdinaasir	zavisnost	Nan
cabdirashid	kabrarashid	Nan
cabdirashiid	mjera	None
cabdiraxmaan	objasniti	None
cabdiraxman	cabdirahman	Nan
cabdirisaaq	mjera	None
cabdisalaan	se	None
cabdixaaji	bude	None
cabdiqaasim	cabhyqaasim	Nan
caalimkii	učenjak	Nan
caalim	učenjak	Nan
caalamku	univerzum	Nan
but	ali	None
butaan	pohvale	Nan
buu	on	None
buuciya	hranjiv	Nan
buug	knjiga	None
buuga	knjiga	None
buugaagta	knjige	None
buugga	knjiga	None
buuhoodle	zujanje	Nan
buulo	gnijezdo	None
buuloburde	buldožer	Nan
buuloburte	štene	Nan
buundo	most	None
buuq	bučno	Nan
buur	planina	None
busra	brašno	Nan
buskoon	na	None
businessman	biznismen	Nan
bushaaranaynaa	blagoslivljamo	Nan
burburiyay	uništen	Nan
burburiyeen	uništen	Nan
burburiyey	uništen	Nan
burburka	uništenje	Nan
burburkii	kolaps	Nan
burburku	uništenje	Nan
burburtay	srušio	Nan
buuraha	planine	None
burco	burco	Nan
burma	burma	Nan
buro	tumor	None
bursadeen	lovio	Nan
burtinle	burtinle	Nan
burton	burton	Nan
burundi	burundi	Nan
bush	grm	Nan
burkina	moji hamburgeri	Nan
cabsi	strah	None
buurdhuubo	desni	Nan
buuro	planine	None
caadalad	pogrešno	None
caadi	normalno	None
caadiga	normalno	None
caado	navika	Nan
caafimaad	zdravlja	None
caafimaadka	zdravlja	None
caag	plastični	Nan
caaggan	ovaj	None
caaid	pomoć	None
caajis	dosadan	Nan
caalami	međunarodno	None
caalamiga	međunarodno	None
caalamiya	međunarodno	None
caalamka	univerzum	Nan
caalamkka	međunarodno	None
caad	običaj	Nan
caabudwaaq	štovanje	Nan
caabudo	štovanje	Nan
caabudistiisa	njegovo	None
buurta	planina	None
buurweyn	gojaznost	Nan
buuxa	pun	None
buuxaan	pun	None
buuxda	pun	None
buuxin	ispuniti	Nan
buuxinaya	punjenje	Nan
buuriga	duvan	Nan
buuxsadaye	puno	None
c	c	None
caabbi	otpor	None
caabinta	otpor	None
caabuda	štovanje	Nan
caabudaa	štovanje	Nan
caabudaan	štovanje	Nan
caabudi	štovanje	Nan
by	od	None
dabiici	priroda	None
cabsida	strah	None
cad	jasno	None
caraba	arapi	None
carabi	arapskom	None
carabiga	arapskom	None
carabigu	arapskom	None
carabiya	arabiji	None
carabka	jezik	None
carabkana	jeziku	None
carabta	arapi	None
carabtii	podne	None
carabtu	arapski	None
carabعبد	arapski	None
carabعبدالله	karab عبدالله	Nan
carafaat	karafaat	Nan
cararay	pobegli	Nan
carareen	pobegli	Nan
carab	arapskom	None
carartay	pobegli	Nan
caraaye	frustriran	Nan
car	auto	Nan
cambaha	maniri	Nan
camiran	camiran	Nan
campaign	kampanju	Nan
camuud	peska	Nan
can	tamo	None
canbaha	loza	None
canfar	gripa	Nan
canfartu	hladno	Nan
cape	ogrtač	Nan
captain	kapetane	Nan
caqabadna	izazov	Nan
caqiidada	doktrina	Nan
caqli	mudar	Nan
caqliga	intelekt	Nan
caqligu	logika	None
caraale	karamela	Nan
carbeed	arapskom	None
carbta	jezik	None
card	kartica	None
cas	crveno	Nan
case	slučaj	None
casharadan	ovoj	None
casharka	lekcija	Nan
casharkii	lekcija	Nan
casho	za	None
cashocado	za	None
casi	crveno	Nan
casiis	crveno	Nan
casimada	uveče	Nan
casir	ažuriranje	Nan
casmara	crveno	Nan
casri	moderan	Nan
casriga	moderan	Nan
casrigan	doba	None
caruurtooda	djeca	None
caruurtiisa	djecu	None
caruurtii	djeca	None
caruurta	deca	Nan
carif	šaran	Nan
cariif	lagana	Nan
caroone	caroton	Nan
carqaladaynkaro	poremećen	Nan
carrabey	nijem	Nan
carro	tlo	None
carruur	deca	Nan
camar	camar	Nan
carruureede	deca	Nan
carruurtiisa	djecu	None
carruurtiisu	djecu	None
cars	automobili	Nan
carta	carta	Nan
cartan	kolica	Nan
carte	kolica	Nan
caruur	deca	Nan
carruurta	deca	Nan
camaloow	kockar	Nan
camalladiisa	djela	None
camallada	djela	None
caddaalad	pravda	Nan
caddaatay	jasno	None
caddayn	dokaz	None
caddaynaya	to	None
caddaynta	dokaz	None
cadde	dokazati	Nan
caddeeyay	dokazao	None
caddoow	biti	None
cade	biti	None
cadeeyay	dokazao	None
cadexamar	biti	None
cadi	bela	Nan
cadmeed	kadet	Nan
cadnaa	ocigledno	Nan
cadnaan	kadence	Nan
cadceedu	sunce	None
cadceed	sunce	None
cadcad	jasno	None
cadaymaa	dokaz	None
cadaa	bela	Nan
cadaada	kompresije	Nan
cadaadis	ugnjetavanja	Nan
cadaado	jasno	None
cadaalada	pravda	Nan
cadaaladda	pravda	Nan
cadaalda	pravda	Nan
cadoo	kad	None
cadaan	bela	Nan
cadaatay	dokazao	None
cadaawe	neprijateljski	Nan
cadal	parfem	Nan
cadale	adair	Nan
cadami	kadmijum	None
cadan	bela	Nan
cadawga	neprijatelja	None
cadaanka	belci	Nan
cabudhiyaan	zastrašiti	Nan
cadoow	neprijatelj	None
cadowgiin	neprijatelj	None
calan	zastava	None
calanka	zastava	None
calankaba	zastava	None
calanku	zastava	None
calanle	zastava	None
calasoow	provjeri	Nan
calasow	zastava	None
calayhi	ujutro	None
cali	kali	Nan
caliaxmed	caliaxmed	Nan
called	zvani	None
calool	želudac	None
caluula	bezobrazan	Nan
camaamad	obveznica	Nan
camal	djelo	None
calaamooyinkaas	znakovi	None
calaamooyin	znakovi	None
calaamka	znak	None
calaamdaha	simptomi	None
cadrad	parfem	Nan
cafaan	pardon	Nan
cafariga	oproštaj	Nan
cafarigaluqada	oproštaj	Nan
cafimaad	zdravlja	None
caga	bosonog	Nan
cagaaran	zeleno	None
cadow	neprijatelja	None
cagaarka	zelje	Nan
cagta	stopalo	Nan
cairo	bijes	Nan
cajalad	traka	Nan
cajiib	divno	Nan
calaa	negodovanje	Nan
calaamad	znak	None
calaamd	znak	None
cago	stopalo	Nan
burburintii	uništenje	Nan
dabiiciga	priroda	None
dable	dable	Nan
dhacan	događaj	None
dhacana	se	None
dhacay	dogodilo	None
dhacaye	se	None
dhacayey	se	None
dhacayeye	incident	Nan
dhacda	nastaju	None
dhacdaa	se	None
dhacday	dogodilo	None
dhacdo	događaj	None
dhacdooyin	događaji	None
dhacdooyinka	događaji	None
dhaceen	pao	None
dhaco	se	None
dhadigana	zena	Nan
dhacaan	dogoditi	Nan
dhadigna	žensko	Nan
dhacaa	se	None
dhac	pljačka	Nan
dhaanto	ples	Nan
dhaar	zakletva	Nan
dhaarannaye	se	None
dhaarsho	zakletva	Nan
dhaarta	zakletva	Nan
dhaawac	ozljeda	Nan
dhaawacmay	povrijeđen	Nan
dhaaxaan	proći	None
dhab	originalan	Nan
dhabar	nazad	None
dhabarka	leđa	None
dhabbada	put	None
dhabeeyaan	izvesti	None
dhabnimadeeda	njenu	None
dhabta	stvaran	Nan
dhaca	se	None
dhafaruur	pokolj	Nan
dhagan	zbijeno	Nan
dhaganyahay	zbijeno	Nan
dhalashadiisii	rođenje	None
dhalashadiisu	njegov	None
dhalasho	rođenje	None
dhalashooyin	rođendana	Nan
dhalatay	rođen	None
dhalay	begat	Nan
dhalaye	rastopiti	Nan
dhaleen	unuci	Nan
dhaliil	kritikovati	Nan
dhaliilaha	kritičar	Nan
dhalin	prinos	Nan
dhalinaya	okidač	Nan
dhalinyar	mladost	None
dhalinyara	mladost	None
dhalinyarada	mladost	None
dhalashadii	rođendan	Nan
dhalashada	rođenje	None
dhalanteede	rođenja	None
dhalan	rođen	None
dhagar	obmanjivati	Nan
dhagaweyne	preljev	Nan
dhagax	kamena	None
dhagaxa	kamen	None
dhagaxaasi	kamen	None
dhagaxawoqooyiga	stijena	None
dhagaxbuur	pukotine	Nan
dhaameen	gotov	Nan
dhagaxii	kamen	None
dhaha	reći	None
dhahaa	reći	None
dhahar	reći	None
dhaheen	rekli	None
dhaho	reći	None
dhakhso	brzo	None
dhal	prinos	Nan
dhagaysto	slušaj	Nan
dhalinyaradii	mladi	None
dhaalib	onesviješten	Nan
dhaafsado	proći	None
degmadan	okrugu	None
degmadda	okrug	None
degmadu	okrug	None
degmo	okrug	None
degmooyinka	okruga	None
degno	se	None
dego	se	None
degoo	hajde	Nan
degree	stepen	None
degtaa	se	None
degtaan	se	None
degtay	silazio	Nan
degto	se	None
dejintii	podešavanje	Nan
dejiyay	smješteni	None
degmadaan	okrugu	None
dejiyey	se	None
degmada	okrug	None
degganaa	naseljen	None
deganaa	naseljen	None
deganaana	se	None
degay	sletio	Nan
degayare	bradati	Nan
degaye	rezident	Nan
degdeg	hitnost	Nan
degeen	se	None
degen	se	None
degenaa	bio	None
degenaan	se	None
degenaansho	bude	None
degeneen	se	None
degenyihiin	borave	Nan
degey	se	None
deggan	stabilan	Nan
degi	se	None
dekad	luka	None
dekada	luka	None
dekadda	luka	None
development	razvoj	None
devices	uređaja	None
deyey	ted	Nan
deyiba	postiđen	Nan
dfkmg	dfkmg	Nan
dhaabad	pad	None
dhaabadeeyaan	to	None
dhaadashada	plima	Nan
dhaadheer	visok	None
dhaaf	proći	None
dhaafay	prošlost	None
dhaafayn	proći	None
dhaafaysaa	prolazi	None
dhaafi	proći	None
dhaafo	proći	None
destaing	destaing	Nan
designed	dizajniran	Nan
derivative	izvedena	None
derisna	komšija	Nan
dekadiiba	luka	None
dekeda	luka	None
dekedda	luka	None
dekeeya	se	None
delhi	nemoj	Nan
dembi	grijeh	Nan
dembiga	grijeh	Nan
dhaaftay	zaobiđena	Nan
democratic	demokratskom	Nan
denmark	denmark	Nan
depending	zavisnosti	None
deputato	lista	None
derejada	stepen	None
derejo	čin	None
deris	komšija	Nan
deriska	komšije	Nan
den	den	Nan
dhalinyaro	mladost	None
dhalisay	pokrenuo	None
dhaliyey	pokrenuo	None
dhaw	zatvoriti	Nan
dhawaadaan	vrijeme	None
dhawaado	uskoro	None
dhawaan	nedavno	None
dhawaaqaa	izjavljuje	Nan
dhawaaqaan	zvuk	None
dhawaaqay	proglasio	None
dhawaaqday	proglasio	None
dhawaaqida	izgovor	None
dhawaaqidda	izgovor	None
dhawaaqo	zvuk	None
dhawaaqtada	zvucima	Nan
dhawdahay	blizu	None
dhaweeyay	dobrodošla	Nan
dhawr	to	None
dhasida	ples	Nan
dhawre	čuvar	Nan
dhashtay	rođen	None
dhashaywaxaanuu	rođen	None
dhaqmay	djelovao	Nan
dhaqmaysayna	glumio	Nan
dhaqmo	djeluju	None
dhaqso	brzo	None
dhaqtar	doktor	None
dhar	odjeća	Nan
dharaar	dan	None
dharaaraba	ujutro	None
dhararka	tkanina	Nan
dharka	odjeća	Nan
dharkeenleey	naša	None
dharkoodii	njihova	None
dhasahy	nedavno	None
dhashaa	rođena	None
dhashay	rođen	None
dhasheen	su	None
dhax	nasljedna	Nan
dhaxal	nasljedstvo	Nan
dhaxalaa	nasljediti	Nan
dhaxmaro	naslijeđen	Nan
dhay	se	None
dhaygag	zuriti	Nan
dhaymo	odevanje	Nan
dhaytubaako	neprijateljski	Nan
dhebaandhebiye	portir	Nan
dhebi	klikni	Nan
dheceen	pao	None
dheddig	žensko	Nan
dheddiga	ženke	None
dheddigga	žene	None
dheecaan	pražnjenje	Nan
dheer	dugo	None
dheeraa	dugo	None
dheeraad	više	None
dhaxmaraa	intervenira	Nan
dhaxlay	naslijeđen	Nan
dhaxeysay	srednji	None
dhaxeysaa	između	None
dhaxalgalka	nasljedstvo	Nan
dhaxalka	nasljedstvo	Nan
dhaxalkeeda	njeno	None
dhaxanta	hladno	Nan
dhaxaye	razbio	Nan
dhaxaysa	između	None
dhaxaysaa	između	None
dhaqmaan	djeluju	None
dhaxaysay	njih	None
dhaxe	između	None
dhaxeesay	njih	None
dhaxeeya	njih	None
dhaxeeyaa	između	None
dhaxeeyeen	njih	None
dhaxeeyey	njih	None
dhaxeysa	između	None
dhaxda	sredini	None
dhaqma	djeluju	None
dhaqidda	pranje	Nan
dhaqdo	oprati	Nan
dhameystay	gotov	Nan
dhami	sve	None
dhamiba	uopšte	None
dhammaa	celinu	Nan
dhammaadkii	kraj	None
dhammaan	sve	None
dhammaantiis	to	None
dhammaantood	oni	None
dhammanteen	mi	None
dhammeeyeen	gotov	Nan
dhan	sve	None
dhanaan	kiselo	Nan
dhanee	dobrodošli	Nan
dhanka	strani	None
dhankaas	naprotiv	Nan
dhameeyay	gotov	Nan
dhameeyaan	dovršite	Nan
dhameestirnociidanka	postupak	None
dhamaystirane	kompletni	Nan
dhallinyaradu	ljudi	None
dhallinyaro	mlad	None
dhamaadaa	krajevima	None
dhamaadaan	kraj	None
dhamaaday	završio	None
dhamaadka	kraj	None
dhamaadkii	kraj	None
dhankooda	strani	None
dhamaado	kraj	None
dhamaan	sve	None
dhamaantiis	to	None
dhamaantood	oni	None
dhamaatay	je	None
dhamaha	na	None
dhamaystay	završen	None
dhamaystiran	kompletni	Nan
dhamaag	kraj	None
degan	tiho	Nan
dhanna	uopšte	None
dhantahay	je	None
dhaqane	djeluju	None
dhaqanka	tradicija	None
dhaqankooda	kulture	None
dhaqankoodu	kultura	None
dhaqanta	vežba	Nan
dhaqashada	pranje	Nan
dhaqatada	pastoralisti	Nan
dhaqato	oprati	Nan
dhaqay	opran	Nan
dhaqdhaaaqyadii	aktivnosti	None
dhaqdhaqaaq	pokreta	None
dhaqdhaqaaqa	pokreta	None
dhaqdhaqaaqii	pokreta	None
dhaqdhaqaaqyadii	aktivnosti	None
dhaqdhaqaaqyo	aktivnosti	None
dhaqan	tradicija	None
dhaqamo	kulture	None
dhaqameed	tradicionalno	None
dhaqaaqyo	pokreti	None
dhanyahay	kompletni	Nan
dhaq	oprati	Nan
dhaqaalaba	ekonomski	None
dhaqaalaha	ekonomija	None
dhaqaalaha´	ekonomija	None
dhaqaale	ekonomski	None
dhaqaalha	ekonomija	None
dhanoo	sve	None
dhaqaalihii	ekonomija	None
dhaqaalihiisuna	finansije	None
dhaqaalo	ekonomija	None
dhaqaaloheeda	ekonomija	None
dhaqaalohiisa	finansije	None
dhaqaaq	potez	Nan
dhaqaaqay	preselili	Nan
dhaqaaqo	potez	Nan
dhaqaalihiisa	ekonomija	None
degaanka	lokalni	None
degaanada	mještani	Nan
degaan	prebivalište	Nan
dakhalka	prihod	Nan
dal	dal	Nan
dalab	potražnja	Nan
dalad	kišobran	Nan
dalaga	rezati	Nan
dalagyada	usjevi	Nan
dalagyo	usjevi	Nan
dalaka	zemljišta	None
dalal	zemalja	None
dalalka	zemalja	None
dalandoole	rezanci	Nan
daleeyay	iscrpljeni	Nan
daliil	dokaz	None
daljirka	jahač	Nan
dalka	zemlja	None
dakano	put	None
dalkaas	zemlji	None
dajiyaa	spustiti	Nan
dahsoon	anoniman	Nan
daganyihiin	naseljen	None
dagay	naseljavali	None
dagi	se	None
dagmada	okrug	None
dagmo	okrug	None
dagmooyinka	okruga	None
dago	dago	Nan
dagta	ići	None
dagtaa	se	None
dagto	se	None
dahab	zlato	None
dahabka	zlato	None
dahay	redu	None
dahaye	prikriveno	Nan
dahir	čisto	None
dain	dain	Nan
dalkayagu	zemlja	None
dalkeeda	zemlja	None
dalkeena	zemlja	None
damal	brana	Nan
dambana	kasnije	None
dambayntii	zadnji	None
dambe	kasnije	None
dambeba	kasnije	None
dambeeya	potonji	Nan
dambeeyay	nedavno	None
dambeeyey	zadnji	None
dambeeyo	zadnji	None
dambeyntiina	napokon	None
dambeysay	zadnji	None
dambeysey	zadnji	None
dambidhaafe	pardon	Nan
damceen	želja	None
dameer	magarac	Nan
damacii	požuda	Nan
damaca	želja	None
damac	želja	None
dalxiiso	turist	Nan
dalkii	zemljišta	None
dalkiisa	zemlju	None
dalkjirka	hodočasnik	Nan
dalkjirkan	zemlje	None
dalkooda	zemlju	None
dalku	domovina	None
dalmar	dalmar	Nan
daganayn	nestabilno	Nan
dalool	rupa	None
dalxiisaan	turneja	None
dalxiisayaasha	turiste	Nan
dalxiise	turist	Nan
dalxiiseyaasha	turiste	Nan
dalxiisi	turizam	None
dalxiiska	turizam	None
dalxiiskeeda	turizam	None
dalxiis	turizam	None
daganaayeen	imaju	None
dagan	tiho	Nan
dagalki	sukob	None
dadaalka	naporima	Nan
dadaalo	naporima	Nan
dadaaloosa	naporima	Nan
dadaashaane	budi	None
dadab	vrata	None
dadaka	ljudi	None
dadbadani	gužva	Nan
dadee	sačekaj	Nan
dadeedu	dole	Nan
dadi	ukusno	Nan
dadiisu	ukusno	Nan
dadka	ljudi	None
dadkaa	ljudi	None
dadkaan	ljudi	None
dadkaas	ljudi	None
dadaali	napor	None
dadaaleen	težeći	Nan
dadaalaayay	težeći	Nan
dadaalaan	budi	None
daboolida	poklopac	Nan
dabqaxa	pod	None
dabuubtaan	završava	None
dabuubtiyo	oblozi	Nan
dacal	merdevine	Nan
dacallada	ravnicu	Nan
dacar	crv	Nan
dadkaasi	ljudi	None
dacas	daas	Nan
dacda	pogrešno	None
daciifa	oslabiti	Nan
dacwad	parnica	Nan
dacwada	parnica	Nan
dad	ljudi	None
dada	stane	Nan
dadaal	napor	None
dacay	udubljenja	Nan
damiin	jamčevina	Nan
dadkaba	ljudi	None
dadkani	ljudi	None
dagaalamayay	borbe	None
dagaalamayeen	se	None
dagaalamey	borili	None
dagaalka	rata	None
dagaalkaas	ratu	None
dagaalkani	ratu	None
dagaalkii	rata	None
dagaalku	rata	None
dagaallada	ratovi	None
dagaallo	ratovi	None
dagaalo	bitke	None
dagaalwaxaa	rata	None
dagaan	odavde	Nan
dagal	borba	None
dagalka	rata	None
dagaalamay	borili	None
dagaaladii	ratovi	None
dagaaladaas	ratovima	None
dagaalada	rata	None
dadkeeda	ljudi	None
dadkeedii	ljudi	None
dadkeedu	ljudi	None
dadkii	ljudi	None
dadkiina	ljudi	None
dadkiisa	narod	None
dadkiisii	narod	None
dadkana	ljudi	None
dadkoo	ljudi	None
dadkuna	ljudi	None
dadlka	ljudi	None
dadow	ljudi	None
dadweynaha	javnost	None
dadx	čoveče	Nan
daga	od	None
dagaal	rata	None
dadku	ljudi	None
dabka	vatra	None
damiir	savjest	Nan
dan	sine	Nan
dawlad	vlada	None
dawlada	vlada	None
dawladaasi	vlada	None
dawladaasii	vlada	None
dawladaha	vlade	None
dawladanwaxa	vlada	None
dawladda	vlada	None
dawladdii	vlada	None
dawladeed	vlada	None
dawladi	vlada	None
dawladihii	vlade	None
dawladii	vlada	None
dawladnimo	vlada	None
dawlado	vlade	None
dawladood	vlade	None
dawgii	lisica	Nan
dawladu	vlada	None
dawgalaye	regeneracija	Nan
dawaldu	pogon	Nan
darti	zbog	None
dartiina	dakle	None
dartiis	njega	None
darto	drenaža	Nan
daruufo	okolnosti	None
daruuriga	nužnost	Nan
daruuro	oblaci	None
darxuma	nespretno	Nan
darxumo	nažalost	None
daryeel	briga	Nan
dasnnee	dasnnee	Nan
dastuur	ustav	None
dastuurka	ustav	None
data	podataka	None
daud	daud	Nan
dawga	konj	None
dawliskii	vlada	None
dawr	dawr	Nan
dayaan	dinastija	None
deegaanka	okruženje	None
deegaannada	kolonije	None
deegaano	okruženje	None
deegta	kasno	None
deelqaaf	crawlspace	Nan
deeq	donacija	Nan
deeqeen	donirao	Nan
deeqsi	velikodušan	Nan
deeqsiiyo	donirati	Nan
deero	jelen	Nan
deerow	sunčanica	Nan
deetana	sljedeći	None
deexda	sunca	None
dega	dole	Nan
degaa	se	None
deegaanada	kolonije	None
deegaan	okruženje	None
december	decembra	None
dec	dec	Nan
dayactir	popravak	Nan
dayar	drugi	None
dayax	mesec	Nan
dayaxa	mjesec	None
dayay	pokušao	None
daydka	dvoriste	Nan
daye	svetu	Nan
dartey	to	None
dayeen	ted	Nan
dayeynahay	se	None
dayn	dug	None
dayniile	dug	None
dayo	dobro	None
dayrka	dvorište	Nan
de	doći	None
debate	debata	Nan
dayey	boja	None
darteed	zbog	None
dartay	dodano	Nan
darsoomaa	play	None
danishka	poljski	None
danjiraha	ambasadora	Nan
danjire	ambasadora	Nan
danta	sin	None
dao	dao	None
daomeesha	daomeesha	Nan
dar	dodati	None
daraa	studija	None
daraaddeed	dakle	None
daraadeed	dakle	None
daraan	mešati	Nan
daraawiish	darvijski	Nan
daraawiishi	traži:	Nan
daraawiishta	darwiishta	Nan
darafyada	krajevi	None
dangorayo	orgo	Nan
daneysa	interesa	None
danbi	zločin	None
danbeysayisla	ne	None
danaynayn	nezainteresovan	Nan
danbana	brat	None
danbayna	onda	None
danbayntii	napokon	None
danbaysa	kasnije	None
danbaysay	zadnji	None
danbaysta	kraj	None
darajo	čin	None
danbe	kasnije	None
danbeeyay	zadnji	None
danbeeyey	zadnji	None
danbeeyo	zadnji	None
danbena	naše	None
danbeyay	iza	None
danbeyntii	kraju	None
danbeysay	zadnji	None
danbeesay	kasnije	None
damqaday	boli	None
daran	teška	None
darane	gradova	None
dareenka	smisla	None
dareenku	osjećaj	None
dariiq	način	None
dariiqada	način	None
dariishad	prozor	None
darin	smite	Nan
daris	komšija	Nan
dariska	komšije	Nan
daristay	komšija	Nan
darka	nered	Nan
daro	dodatak	None
darood	voda	None
darro	negativno	None
darsado	naučite	Nan
darsamaan	međusobno	None
dareen	smisla	None
dareemi	osjećati	Nan
dareemeen	osećao	Nan
dareemaysaa	osjeća	None
daray	dodano	Nan
darayaaye	te	None
darayey	dodano	Nan
darayga	novorođenčad	Nan
darbad	metak	Nan
darbadaaley	play	None
darbadna	više	None
darandoorriga	u	None
darbane	ispustiti	Nan
darbiga	zid	None
darbigeed	zid	None
darbiyada	zidovi	None
dardaanay	tions	Nan
dardaaran	volja	None
dardaarmay	usmjereni	Nan
dareemay	osećao	Nan
darbi	ulica	None
burburinta	destruktivne	Nan
burburay	srušio	Nan
burbur	uništenje	Nan
allow	dopustiti	Nan
allowing	dopuštajući	Nan
allows	dozvoljava	None
almadkhali	almskhali	Nan
almajid	učenik	None
almunawara	razvod	None
alnour	alnour	Nan
alpine	alpski	Nan
alqaacida	al	None
alshabaab	al	None
alshabab	alšabab	Nan
also	takođe	None
alustaad	te	None
alwaadici	građanin	None
alxalabi	algebra	Nan
allena	bože	None
alxamraa	zavarivanje	Nan
allee	alee	Nan
allaylehe	noći	None
alislām	alislām	Nan
aljabarti	algebra	Nan
aljazeera	algebra	Nan
aljaziira	algebra	Nan
aljeeriya	algebra	Nan
all	sve	None
alla	kako	None
allaa	ikada	None
allaaba	uopšte	None
allaah	bože	None
allaahu	bog	None
allah	bože	None
allaha	bog	None
allahaa	bože	None
allahu	bože	None
alle	bože	None
am	am	Nan
ama	ili	None
amaan	sigurno	None
aminsanyihiin	ste	None
amir	amir	None
aml	aml	Nan
ammaan	pohvale	Nan
ammaanadana	pohvale	Nan
ammaanadii	pohvale	Nan
ammaanadiisa	njegove	None
amnesty	amnestija	Nan
amniga	sigurnost	None
amoud	amoud	Nan
amray	zapovjedio	Nan
amxaari	amharski	Nan
an	an	None
anaa	smo	None
anaadoolee	dođi ovamo	Nan
amiirka	princ	None
amiir	princ	None
amiin	obroka	Nan
american	američko	Nan
amaandarada	sigurnost	None
amaani	sigurno	None
amaanka	sigurnost	None
amaanku	sigurnost	None
amaanta	pohvale	Nan
amaba	ili	None
amagaalooyinka	gradova	None
alislaax	etično	Nan
amar	red	None
amaradiisana	njegove	None
amarkiis	njegovu	None
amase	ili	None
ambaradooriyadii	ambulanta	Nan
ameerika	amerika	None
ameerikada	američko	Nan
america	amerika	None
amarada	zabrane	Nan
anad	oglas	Nan
align=right	desno	None
alifay	abeceda	Nan
ahmiyada	značaj	None
ahn	ah	Nan
ahna	i	None
ahoo	ahoo	Nan
ahtiirarka	slike	None
ahwaxay	je	None
ahyad	ahya	Nan
ahyd	bezvodni	Nan
aid	pomoć	None
air	zrak	None
airlines	aviokompanije	Nan
airport	aerodrom	None
airways	dišne puteve	Nan
ajaanibta	stranci	None
ajar	otvorenu	Nan
ahmiyad	značaj	None
ajnabi	stranci	None
ahmed	ahmed	None
ahluxaddiiska	jednadžbe	Nan
ahay	sam	None
ahayd	bio	None
ahayde	ja	None
ahaydkadib	kasnije	None
ahayee	bude	None
ahayn	nije	None
ahba	da	None
ahcafariga	izvinjenje	Nan
ahe	ahem	Nan
aheed	ahed	Nan
aheyd	bio	None
aheyn	biti	None
ahi	je	None
ahina	da	None
ahlu	ah	Nan
ahluxaddiisku	tome	None
ajuuraan	naplatiti	Nan
ak	priča	None
akhlaaqda	ponašanje	None
albaabka	vrata	None
albaani	vrata	None
albaaniya	albaniji	None
albakr	albakr	Nan
albania	albania	Nan
albaqrahaayada	vratima	None
alcallaama	pšenice	Nan
aldalanj	aldalanj	Nan
alfaatex	alfaatex	Nan
alfaatixoo	alfa	Nan
algorithm	algoritam	None
algorithms	algoritmi	None
alhilaali	ručna izrada	Nan
ali	ali	None
alif	alif	Nan
alazhar	carstvo	None
alalbaani	gadno	Nan
alaha	haha	Nan
alaabtiisii	roba	None
akhlaaqdii	moral	None
akhri	čitati	None
akhrin	čitati	None
akhrinducaysiilaah	čitanje	None
akhrinta	čitanje	None
akhrisan	čitati	None
akhriska	čitanje	None
alifka	abeceda	Nan
akhriso	čitati	None
akhriyaan	čitati	None
akhriyay	čitati	None
akhriyo	čitati	None
akr	inventara	Nan
al	al	None
ala	dole	Nan
alaabta	proizvodi	None
akhristo	čitati	None
anagaa	mi	None
anagoo	nas	None
anagu	mi	None
arkayninba	neće	None
arkayo	vidjevši	Nan
arkaysaa	vidiš	Nan
arkeen	pila	Nan
arkey	arkey	Nan
arki	vidi	None
arko	viđeno	Nan
arkoon	neće	None
arlada	zemlji	None
arligiina	bogatstvo	None
aroor	ujutro	None
arrimaha	problemi	None
arrimahaas	pitanja	None
arrimo	problemi	None
arrin	stvar	None
arkay	viđeno	Nan
arrinkaa	slučaju	None
arkaan	vidi	None
arjantiina	moj	None
arif	arif	Nan
ariga	jarac	Nan
arima	problem	None
arimaha	problemi	None
arimahaa	pitanja	None
arimahaas	pitanja	None
arimo	problemi	None
arimood	problemi	None
arin	sredina	Nan
arinkaas	slučaju	None
arinta	pitanje	None
arintaa	slučaju	None
arintaas	slučaju	None
arintaasi	to	None
arintan	problem	None
arkaa	vidi	None
arrinkaan	pitanju	None
arrinkaas	slučaju	None
arrinkii	stvar	None
asalka	porijeklo	None
asalkooda	porijeklo	None
asalkoodii	porijeklo	None
asalkoodu	porijeklo	None
asaxaabtu	prijatelji	None
asc	asc	Nan
aserbiijaan	play	None
asharaaf	izdaja	Nan
ashhadu	pepeo	Nan
ashyaada	stvari	None
asiga	ja	None
askar	vojnici	None
askari	vojnik	None
askarta	vojnici	None
askax	vojnici	None
asal	porijeklo	None
asagoo	od	None
asagana	vrijeme	None
asaga	njega	None
arrinku	stvar	None
arrintaa	slučaju	None
arrintaan	pitanju	None
arrintaas	slučaju	None
arrintan	broju	None
arrintii	stvar	None
arrintu	stvar	None
ari	pozajmljeno	Nan
arwa	arwa	Nan
arxan	nepristojan	Nan
arxanka	arogancija	Nan
as	kao	None
asaasay	osnovana	None
asaaseen	uspostavljen	Nan
asaasidii	temelji	None
asad	asad	Nan
arwaaq	drvo	None
argagixisa	teroristi	Nan
argagaxa	panika	Nan
areas	područja	None
application	aplikacija	None
april	april	None
aqaan	znam	None
aqal	kuca	Nan
aqalgalay	usvojena	None
aqalka	kuća	None
aqbalay	prihvaćeno	Nan
aqlabiyad	većina	None
aqlabiyada	većina	None
aqliyad	većina	None
aqoon	znanje	None
aqoone	znanje	None
aqoonsadaan	ih	None
aqoonsadayafka	identifikatore	Nan
aqoonsado	prepoznaje	None
any	nas	None
antiilis	antiilis	Nan
antenna	antena	Nan
ansaxa	važenje	Nan
anan	ovdje	None
anbaqaaday	usvojena	None
anbaxaxeen	su	None
anbieter	anbieter	Nan
and	i	None
andocootay	andocootay	Nan
andorra	andora	None
aqoonsan	prepoznat	Nan
anfac	korisno	Nan
aniga	ja	None
anigaa	ja	None
anigoo	ja	None
anigu	ja	None
anna	anna	Nan
annaga	nas	None
anoo	anoo	Nan
angola	ne	None
ahana	ne	None
aqoonsanayn	nesvesno	Nan
aqoonsato	prepoznaje	None
aragti	teorija	None
aragtid	vidiš	Nan
aragtida	teorija	None
aragto	vidi	None
arbaco	srijeda	Nan
ardada	studenti	None
ardaqal	bradati	Nan
arday	student	None
ardayda	studenti	None
ardaydiisii	studenti	None
ardaygii	student	None
ardoqalna	drugo	None
ardul	ardul	Nan
arduqalwaxa	buka	Nan
are	su	None
aragtay	viđeno	Nan
aragtaa	vidiš	Nan
aragnimo	iskustvo	None
arag	vidi	None
aqoonsi	prepoznavanje	Nan
aqoonta	znanje	None
aqoontiisa	znanje	None
aqoontoodu	znanje	None
aqoonyahan	učenjak	Nan
aqoonyahanad	učenjaka	Nan
aqoonyahano	učenjaka	Nan
aqoonsatay	prepoznat	Nan
aqrinayaa	čitati	None
aqrineysaa	čitati	None
aqrinta	čitanje	None
aqriyey	čitati	None
aqriyo	citati	Nan
ar	ar	None
arab	arapski	None
arabsiyo	drugog	None
aqrinayo	čitanje	None
ahan	nije	None
ahada	ime	None
ahaayeen	bili	None
abaarta	suša	None
abaartii	suša	None
ababa	sljedeći	None
ababuleen	ukinuta	Nan
abd	abd	Nan
abdalle	abdalle	Nan
abdi	abd	Nan
abdirahman	prijatelju	Nan
abdirashid	abdrashid	Nan
abdul	abdul	None
abdulkarim	abdulkarim	Nan
abdullah	abdullah	None
abdullahi	prijatelji	None
abdulle	abdulle	Nan
abdulrahman	abdulrahman	Nan
abaarso	cilj	None
abdulsalam	abdulsalam	Nan
abaaro	vijak	Nan
abaalmariyo	nagrade	None
aasaasy	temelj	None
aasan	počivaj	Nan
aasanyahay	pokopan	Nan
aasay	pokopan	Nan
aasaynaa	zakopati	Nan
aasiya	aziji	None
aasiyamaanta	njegova	None
aasiyo	privržen	Nan
aay	aay	Nan
aayadaha	stihovi	None
aayadda	stih	Nan
ab	ab	Nan
abaabul	mobilizirati	Nan
abaabulay	organizovano	Nan
abaal	nagrada	None
abaar	suša	None
abeba	leptir	Nan
abgaal	kašika	Nan
abii	itd.	Nan
abu	stvar	None
abul	abul	Nan
abuu	stvoriti	None
abuubakar	tvorac	None
abuubakari	tvorac	None
abuukar	tvorac	None
abuuraa	stvara	None
abuurantay	kreirao	Nan
abuuray	kreirao	Nan
abuurey	kreirao	Nan
abuuro	stvoriti	None
abuurtay	kreirao	Nan
abwaan	umjetnik	None
abwaanada	pjesnici	None
abwaanka	adresu	None
abtiyaashiis	roda	None
abtirsiinyada	genealogija	Nan
abtirsadaan	genealogija	Nan
abtirsada	genealogija	Nan
abiidhaalib	savez	None
abiikar	najmanje	None
abil	sposobnosti	None
abkhazia	abhazija	Nan
abokar	prijatelju	Nan
abokor	prijatelju	Nan
abooreey	zmija	None
aasaastay	osnovana	None
abraha	abras	Nan
abroone	abroone	Nan
absame	absame	Nan
abshir	abshir	Nan
absuge	abusege	Nan
abti	stric	Nan
abtigiis	njegov	None
abtirisiinyihiisu	bezbroj	Nan
abriil	aprila	None
aasaaskii	temelj	None
aasaaska	temelj	None
aasaasihii	osnivač	None
aad	ti	None
aada	idi	Nan
aadam	čovječanstvo	Nan
aadamka	ljudi	None
aadamuhu	čovječanstvo	Nan
aadan	ti	None
aadanaha	bića	None
aadanuhu	ljudi	None
aaday	otišli	None
aaden	si	None
aadey	otišao	None
aadka	vrlo	None
aadna	idi	Nan
aado	ići	None
aafo	kriza	None
aabihiisna	otac	None
aabihiis	otac	None
aabihiina	otac	None
aabihii	otac	None
+	+	None
<i>	<i>	Nan
<i><i>	<i><i>	Nan
<wareega	<wareega	Nan
=	=	Nan
==	==	Nan
===xoriyadii	sloboda	None
aagga	područje	None
a	a	None
aaayadda	stih	Nan
aabaha	otac	None
aabahayo	otac	None
aabbe	otac	None
aabbihii	otac	None
aabbihiis	otac	None
aabe	otac	None
aa	a	None
abwaankii	umjetnik	None
aaggii	područje	None
aakhiraba	na	None
aannu	nas	None
aanu	saosećanje	Nan
aanuu	bez	None
aar	aar	Nan
aargoosi	osveta	Nan
aas	ukop	Nan
aasaar	ukop	Nan
aasaarta	ukop	Nan
aasaartan	temelj	None
aasaasaha	osnivač	None
aasaasay	osnovana	None
aasaasayaasha	osnivači	Nan
aasaasayaashii	osnivači	Nan
aasaasi	osnovni	None
aasaasiga	osnovni	None
aannaan	nismo	None
aanay	nisu	None
aanan	nisam	None
aan	ne	None
aakhirana	na	None
aakhiro	na	None
aakhiroba	u	None
aalacimraan	nema	None
aalo	alat	None
aamdiga	priznanje	None
aamin	povjerenje	None
aakhiraa	na	None
aaminaan	vjerujte	Nan
aamino	vjerujte	Nan
aaminsan	vjerujte	Nan
aaminsanyahay	mi	None
aaminsanyihiin	vjerujte	Nan
aamisan	vjeruj	Nan
aammiin	mi	None
aamus	budi	None
aamini	pouzdan	Nan
aslam	aslam	Nan
abwaanku	umjetnik	None
abwaano	stvari	None
afraadwaana	četvrti	None
afrah	afrah	Nan
afrax	četvrto	Nan
africa	afrika	None
african	afrički	Nan
afrika	afrika	None
afrikaba	africi	None
afrikada	africi	None
afrikakadib	afrički	Nan
afroaasiya	afazija	Nan
afsomaliga	u	None
afsoomaali	jezik	None
afsoomaaliga	engleskom	None
afsoomaaligu	engleskom	None
afsoomali	jezik	None
afmadow	primjer	None
afsoomaliga	engleskom	None
afkiisuna	usta	None
afjaro	kraj	None
afdhere	slomljen	Nan
affaransiis	afrički	Nan
afgaanistaan	afganistan	None
afgambi	puč	Nan
afgambigii	puča	Nan
afganistan	afganistan	None
afgaranwaa	slažu	None
afgobaadsi	otmica	Nan
afgooye	otmičar	Nan
afgoye	ostalog	None
afhayeenka	zvučnika	Nan
afikada	jezik	None
afingiriis	engleski	None
afisbaanish	španski	None
afjaray	kraj	None
afka	usta	None
aftahan	ovaj	None
after	posle	None
aftigree	aftigree	Nan
ahaaday	je	None
ahaadee	bude	None
ahaado	biti	None
ahaan	biti	None
ahaana	jeste	None
ahaanba	apsolutno	None
ahaanjirtay	bilo	None
ahaanna	jeste	None
ahaanshaha	biće	None
ahaantii	zapravo	None
ahaataye	tebe	None
ahaatee	još	None
ahaato	biti	None
ahaay	bio	None
ahaaye	ne	None
ahaa	bio	None
aha	ne	None
ah	ah	Nan
agtiisa	njega	None
afturki	afturki	Nan
afurayo	ujutro	None
ag	ag	Nan
aga	idi	Nan
agaasimaha	direktor	None
agaasime	redatelja	Nan
agaasimihii	direktor	None
afdheer	četiri	None
agagaarka	okolo	Nan
agasimihii	direktor	None
agoon	siroče	Nan
agoontii	siroče	Nan
agoonyar	revolucionarni	Nan
agoosto	avgusta	Nan
agrario	agrario	Nan
agteeda	nje	None
agagaarkeeda	nje	None
afcarabi	primjer	None
afartii	četiri	None
afartankii	četrdeset	None
adduunka	svijet	None
adduunkan	svijetu	None
adduunku	svijet	None
adduunyada	svijeta	None
adduunyadu	svijeta	None
adeeg	usluga	None
adeega	usluga	None
adeegayooda	usluge	None
adeegsadaa	koristi	None
adeegsadaan	upotreba	None
adeegsado	koristi	None
adeegsan	upotreba	None
adeegsatay	koristi	None
adeegsiga	upotreba	None
adeegtana	usluga	None
adduun	svijet	None
addoonku	sluga	Nan
addoonkiisa	njegov	None
addoonkii	sluga	Nan
account	račun	None
ad	oglas	Nan
adaa	ti	None
adaan	ovaj	None
adag	teško	None
adal	adal	Nan
adam	čovjek	None
adeegyada	usluge	None
adan	šišmiš	Nan
addaa	tebe	None
addis	addis	Nan
addoomada	robovi	None
addoomadiisa	njegove	None
addoomo	robovi	None
addoon	sluga	Nan
addoonka	sluga	Nan
add	dodati	None
abwaannada	pjesnici	None
adeegyadii	usluge	None
adeegyo	usluge	None
adna	adna	Nan
adoo	tebe	None
adoomada	robovi	None
adoon	adobe	None
aduu	glatka	Nan
aduunka	svijet	None
aduunyada	svijet	None
af	ostalog	None
afaf	jezicima	None
afafka	jezicima	None
afar	četiri	None
afaraad	četvrto	Nan
afaraadna	četvrti	None
afarta	četiri	None
afartaas	četiri	None
administartion	administartion	Nan
adkeynta	zatezanje	Nan
adkaysan	izdržao	Nan
adkaade	osvajač	None
adeer	stric	Nan
adeerka	stric	Nan
adeerkii	stric	Nan
adeerkiis	njegov	None
adeerkood	njihov	None
adeerradii	ujaka	Nan
aden	aden	Nan
adeegyadooda	usluge	None
adhiga	ovce	Nan
adiga	ti	None
adigaa	ti	None
adigoo	tebe	None
adigu	ti	None
adiinoo	tebe	None
adkaaaday	poražen	None
adkaaday	prevladao	Nan
adi	biti	None
asluubta	disciplina	None
asna	asna	Nan
assaid	hajde	Nan
beelihii	zajednice	None
beelo	izgubljen	Nan
beelood	zajednice	None
beelweynta	zajednica	None
been	lažno	Nan
beenawday	lagao	Nan
beeni	zanijekati	Nan
beeniyana	zanijekati	Nan
beeniyeen	odbijen	Nan
beenta	laži	Nan
beentana	ne	None
beer	polje	None
beera	sijati	Nan
beeraha	poljoprivreda	None
beeraleey	farmer	Nan
beelahakan	zajednicama	None
beerato	biljka	None
beelahaas	zajednice	None
beel	zajednica	None
baytulaxam	sposobnost	None
bbc	itd.	Nan
be	biti	None
bebad	brada	Nan
bed	krevet	Nan
beddelo	promjena	None
bedelaan	promjena	None
bedelay	izmenjen	Nan
bedeli	promijeni	Nan
bedelin	nepromijenjen	Nan
bedka	prostor	None
beebeen	izgubljen	Nan
beedkeediiduqaydii	moj	None
beegan	slučajnost	Nan
beegsaday	ciljano	Nan
beelaha	zajednice	None
beeray	posađeno	Nan
beereed	pitajte	Nan
beero	sijati	Nan
bern	bern	Nan
besha	besha	Nan
between	između	None
bey	bej	Nan
beytkiisa	kuća	None
biblia	biblia	Nan
bidcada	jeresi	Nan
bidco	bidco	Nan
bidix	levo	Nan
biir	pivo	Nan
biira	pivo	Nan
biiray	pridružio	None
biirey	pridružio	None
biiro	mozgovi	Nan
biirtay	pridružio	None
bermer	bermer	Nan
berigii	kasnije	None
berberaburao	sutra	Nan
berbera	smokve	Nan
beeroley	farmer	Nan
beerta	u	None
beerto	sadnja	Nan
beesha	zajednica	None
beeshu	bradu	Nan
beeyay	m	None
being	biće	None
bayoolojiga	biologija	None
belarus	bjeloruski	Nan
belfast	belfast	Nan
belgium	belgija	None
beljim	belgijski	Nan
belkooda	pojas	None
belo	belo	Nan
benin	klupa	Nan
benito	benito	Nan
beledweyne	beledweyne	Nan
bayolojigu	biologija	None
bayoloji	biologija	None
bayna	način	None
barrow	kolica	Nan
barsane	barsane	Nan
barta	poenta	Nan
bartaan	naučite	Nan
bartamaha	sredini	None
bartamihii	sredini	None
bartan	mjestu	None
bartay	naučio	None
bartey	nekako	Nan
barto	naučite	Nan
barwaaqa	blagostanje	Nan
barwaaqo	blagostanje	Nan
baryaya	otvoreno	None
baryayaa	se	None
baryey	molio	Nan
barre	barre	Nan
barooyosoomaaliya	profil	None
baroordiiqda	tugovanje	Nan
baroordiiqa	tugovanje	Nan
barina	levo	Nan
barisoomaaliya	indoktrinacija	Nan
barista	podučavanje	Nan
baritish	baritski	Nan
barkaan	polovina	None
barkaanle	pomagač	Nan
barkada	bazen	None
baryi	moliti	Nan
barlamaankadfkmg	mira	None
barlamanka	parlament	None
barlaskooni	barricone	Nan
barliin	barlin	Nan
barnaamijka	program	None
barnaamijkan	programu	None
barnaamijyada	programi	None
baro	naučite	Nan
barlamaankiyo	parlament	None
bik	bi	None
basaas	špijun	Nan
based	zasnovana	None
baxiira	šuti	Nan
baxo	lišće	Nan
baxrayn	ukrotiti	Nan
baxsaday	pobegao	Nan
baxsadeen	pobegao	Nan
baxsan	napolju	Nan
baxsanida	bijeg	Nan
baxshay	plaćen	Nan
bay	zaljev	Nan
baybalka	biblija	Nan
baybalku	biblija	Nan
baydhaba	se	None
baydhabo	ispada	Nan
baydhabotan	ovuda	Nan
baylah	ranjivi	Nan
baxeen	su	None
baxdo	izaći	Nan
baxday	izašao	None
baxdaa	izaći	Nan
baseey	baza	None
bashiir	bankrot	Nan
bashir	bashir	Nan
bataatiga	krompira	Nan
batalaale	prijatelji	None
batay	povećao	None
bateen	pomnoženo	Nan
base	baza	None
batroolka	nafta	None
baw	bow	Nan
baxa	izači	Nan
baxaa	lišće	Nan
baxaan	izači	Nan
baxay	napolje	Nan
baxayaa	lišće	Nan
baxda	izači	Nan
batuuta	laž	Nan
bariiska	pirinča	Nan
bikra	djevice	Nan
bilaa	bez	None
boorin	nagoniti	Nan
boorinta	ushićenje	Nan
boosaaso	bosaso	Nan
boosaha	pošta	None
booskii	mjesto	None
booskiisii	njegovo	None
boqol	sto	None
boqolkii	sto	None
boqolkiiba	procenat	None
boqolsoon	sto	None
boqor	kralj	None
boqorad	kraljice	None
boqoraddii	kraljica	None
boqorka	kralj	None
boqorkayow	kralj	None
boorame	tikva	Nan
boqorkii	kralj	None
boorama	tikva	Nan
booqdayaasha	posetilaca	Nan
bombeelmada	bombardovanje	Nan
boob	plijen	Nan
bood	skokovi	Nan
boodhari	uvijanje	Nan
booliiska	policija	None
booliska	policija	None
boon	blagodat	Nan
boondheere	za	None
booqan	poseta	Nan
booqanaya	poseta	Nan
booqashada	poseta	Nan
booqashadeydi	moja	None
booqdaa	poseta	Nan
booqdaan	posjetiti	Nan
booqday	posjetio	None
booqdo	poseta	Nan
boqornimada	kraljevstvo	None
boqortooyada	kraljevstvo	None
boqortooyadii	kraljevstvo	None
bukhaari	kapuljača	Nan
bukhari	buhari	Nan
bulgaariya	bugarska	None
bulgaria	bugarska	None
bullaxaar	kanalizacija	Nan
bulleted	pucano	Nan
bulshada	zajednica	None
bulshadabawaayo	zajednice	None
bulshadeennu	zajednica	None
bulshadii	zajednica	None
bulsho	socijalni	None
bun	lepinja	Nan
buq	zujanje	Nan
bur	brašno	Nan
buraan	tumor	None
buka	bolestan	Nan
buhoodle	kupac	Nan
budh	buddh	Nan
buaale	dolara	None
boqortooyadu	kraljevstvo	None
boqortooyo	kraljevstvo	None
boqray	kralju	None
borama	borama	Nan
borogaramyo	programeri	Nan
bortaqiiska	portugalski	Nan
borwa	doći	None
bollywood	bollywood	Nan
bosniya	depresija	Nan
botswana	bocvana	Nan
brdm	brdm	Nan
britain	britanija	None
britan	sutra	Nan
britanwaxa	sutra	Nan
british	britanski	None
btr	btr	Nan
botha	botha	Nan
bolkaniskaee	play	None
bolis	bolus	Nan
boliifia	biliifia	Nan
billaabo	početka	None
biloobo	preliminarni	Nan
bilood	mjeseci	None
bilow	start	Nan
bilowday	započeo	None
bilowgii	početka	None
bilsho	bilsho	Nan
bilwaday	ruža	None
bin	sledeći	Nan
bini	čovjek	None
biniaadamka	čovječanstvo	Nan
biniaadanka	tvoja humanost	Nan
bintu	bintu	Nan
binu	izvini	Nan
bir	gvožđe	Nan
bill	račun	None
bile	žuč	Nan
bilay	mesec	Nan
bilawgii	početka	None
bilaabaan	start	Nan
bilaabata	započinje	None
bilaabatay	započeo	None
bilaabato	započinje	None
bilaabay	započeo	None
bilaabayaa	započinje	None
bilaabeen	započeo	None
biritishka	britanci	None
bilaabidda	inicijacija	Nan
bilaabo	od	None
bilaal	medalja	None
bilaawday	započeo	None
biladao	medalja	None
bilaha	mjeseci	None
bilawday	započeo	None
bilawga	početak	None
bilaabmay	započeo	None
bil	mesec	Nan
birmingham	birmingham	Nan
bisha	mesec	Nan
bmp	bmp	Nan
bni	bni	Nan
bog	stranicu	Nan
boga	stranicu	Nan
bogaadin	kompliment	Nan
bogaan	ovu	None
bogan	bogan	Nan
bogga	stranicu	Nan
boggan	ovu	None
bohol	krater	Nan
boire	boire	Nan
bois	bois	Nan
boland	boland	Nan
bold	podebljano	Nan
bole	bole	Nan
biyo	voda	None
biyihii	voda	None
biyaha	voda	None
bixiyey	pod	None
bishii	mesec	Nan
bishiisa	njegov	None
bishuna	bishuna	Nan
bisinka	bis	Nan
bisiqa	biceps	Nan
bisiqley	bisiqley	Nan
bislaado	zrelo	Nan
birta	gvožđe	Nan
bislaanaayo	zrelo	Nan
bixin	napolje	Nan
bixinta	odredba	Nan
bixisaa	pruža	None
bixisay	plaćen	Nan
bixiya	pod	None
bixiyaan	pružiti	Nan
bixiyay	pod	None
bixi	izači	Nan
dheeraada	više	None
bariise	pirinča	Nan
bariire	ječam	None
baa	je	None
baabal	nestaju	Nan
baabii	se	None
baabulmandab	carpool	Nan
baabuur	auto	Nan
baabuurta	automobili	Nan
baad	ti	None
baadi	greška	None
baadicadde	izdajnik	Nan
baadiye	istraživač	None
baahan	potreba	None
baahday	potrebno	None
baahi	potreba	None
baahiayay	otkriven	None
baahida	potreba	None
ba	ne	None
baahintaasi	emitovanje	Nan
b	b	None
azc	azc	Nan
ayeey	život	None
ayey	način	None
ayeyna	su	None
ayna	ime	None
aynaan	ne	None
aynaanshe	je	None
aynu	hajde	Nan
ayoo	sjaj	Nan
aysan	nisu	None
aysanna	drugo	None
ayuu	on	None
ayuub	heb	Nan
ayuun	srećna	Nan
ayuuna	je	None
ayuuu	on	None
aṣṣūmāl	anūmālāl	Nan
baahna	potrebe	None
baahnaa	potrebno	None
baal	pero	None
baarlamaanka	parlament	None
baarliin	balon	Nan
baarri	ljubaznost	Nan
baaruude	djevice	Nan
baasifik	plastični	Nan
baath	baath	Nan
baaxad	obim	None
baaxada	veličina	None
baaxadda	veličina	None
baaxadiisu	obim	None
baay	uvala	Nan
baayacmushtar	roba	None
baayasiid	trgovina	None
baaz	buz	Nan
babaayga	otac	None
baarlamaan	parlament	None
baaritaan	istraga	Nan
baaris	istraživanja	None
baariis	paraliza	Nan
baalakan	krila	None
baallacad	uvećana	Nan
baalle	balet	Nan
baan	banka	None
baanka	banka	None
baannu	imamo	None
baanu	izvini	Nan
ayeen	oni	None
baaq	poziv	None
baaqan	preostali	Nan
baaqayeen	su	None
baaqaysay	je	None
baar	pretraživanje	Nan
baardheere	parker	Nan
baargaal	cjenjkanje	Nan
baari	baari	Nan
baaqa	poziv	None
ayee	prilika	None
aydinaan	ted	Nan
aydhiyooliyadda	sudbina	None
avv	avv	Nan
aw	aw	Nan
awal	šl	Nan
awaxaana	li	None
awdadl	awdadl	Nan
awdal	awdal	Nan
awdalxiligaasoo	vremena	None
awdigil	žena	None
awdigilwuxuu	to	None
aweys	dvostruko	Nan
awgeed	njega	None
awliyada	tions	Nan
awmuuse	ispunjenje	Nan
awood	snage	None
awooda	sposobnost	None
average	prosečan	Nan
avenue	avenija	Nan
available	na	None
authentication	autentifikacija	Nan
assembly	montaža	Nan
astaamaha	simptomi	None
astaamo	simptomi	None
astaan	simbol	None
astaannta	simbolizam	Nan
astaanta	simbol	None
asturaa	izvini	Nan
awoodaha	ovlašćenja	Nan
asxaabtii	prijatelji	None
at	u	None
atlaantik	atlantik	Nan
atom	atom	None
attaxiyaadka	teorije	None
audio	audio	Nan
august	avgusta	Nan
australia	australia	Nan
asxaabtiisa	prijatelji	None
babac	gore	None
awooday	stanju	None
awoodeedu	moć	None
ayaa	the	None
ayaad	ti	None
ayaamo	dana	None
ayaan	ja	None
ayaana	to	None
ayaanle	menta	Nan
ayaanu	ćemo	None
ayaay	oni	None
ayada	ona	None
ayadoo	sa	None
ayaga	njih	None
ayagoo	njima	None
ayan	nisu	None
ayay	oni	None
aybakar	savjetovanje	Nan
aya	stih	Nan
ay	oni	None
axmedعبدالله	sjekirom عبدالله	Nan
axmed	sjekirom	Nan
awoodii	sposobnost	None
awoodoodiiwaxayna	moći	None
awoow	djed	Nan
awoowe	djed	Nan
awoowgiis	njegov	None
awoowgiisii	njegov	None
awqaafta	teorem	None
awoodda	snage	None
awsamaale	primjer	None
axaaddiista	ekshumacija	Nan
axaadiista	hadis	None
axad	nedelja	Nan
axdiga	savez	None
axdigii	savez	None
axkaamta	naprotiv	Nan
axmad	savez	None
axaaaddiistuba	hadis	None
bariis	pirinča	Nan
babayga	otac	None
bacadle	unazad	Nan
bandhigo	izlaže	Nan
bandhigtay	predstavljeno	Nan
bangiga	banka	None
bangigu	banka	None
bangladesh	bangladeš	Nan
bani	čovjek	None
baniaadamka	bića	None
banii	banii	Nan
bank	banka	None
banka	banka	None
banna	suprotno	None
bannaan	prostor	None
bannaanayd	prazno	Nan
baqaa	uplašen	Nan
baqay	uplašen	Nan
bandhigeen	predstavljeno	Nan
baqaya	se	None
bandhigay	predstavljeno	Nan
banadir	retko	Nan
baledweyn	veliko	None
balila	ječam	None
ballaadhaan	uvećana	Nan
ballaadhan	širok	None
ballaaran	širok	None
ballaariyeen	uvećana	Nan
ballan	obećanje	Nan
ballanta	imenovanje	Nan
balqiisa	balkon	Nan
balse	ali	None
bamkii	pumpa	None
banaadir	banadir	Nan
banaan	prazan	Nan
banaanideeda	napolju	Nan
banaanka	napolju	Nan
bandarbayla	policijski čas	Nan
baqdaad	prtljaga	Nan
bar	bar	None
bara	godine	None
baray	učio	None
barayaal	vaspitači	Nan
barayoo	učenja	None
barbaaray	uzdignuta	Nan
barbaarin	uzgoj	None
barbaarinta	djece	None
barbaariyo	njegovati	Nan
barbaraawi	barbaraw	Nan
barde	barre	Nan
bare	instruktor	Nan
bareen	studija	None
bari	neka	None
baridiisa	njegov	None
bariga	istok	None
bariidka	pirinča	Nan
barax	paraliza	Nan
barawe	imitacija	Nan
barasiil	pirinča	Nan
barasho	učenja	None
baraako	blagoslovljen	Nan
baraalan	razbuktao	Nan
baraan	podučavati	Nan
baraarug	svest	Nan
baraawe	poslovično	Nan
baracaatika	raseljavanje	Nan
barack	barack	Nan
balcad	balon	Nan
baraf	snijeg	None
barakaat	ti	None
barakacii	raseljavanje	Nan
baran	naučite	Nan
barano	naučimo	Nan
barashada	učenja	None
barashadiisa	učenje	None
barashadiisii	učenje	None
baraguay	blagoslov	Nan
balantii	obecanje	Nan
balanqaadyadii	obećanja	Nan
balanqaaday	obećao	Nan
badantahay	mnogi	None
badanyahay	mnogi	None
badanyihiin	mnogi	None
badashay	izmenjen	Nan
badaye	većina	None
badbaaday	je	None
badbaadayso	biti	None
badbaadid	uštedjeti	Nan
badbaadinta	štede	Nan
badbaadiyey	sačuvano	Nan
badbaadiyo	sačuvaj	Nan
badda	more	None
baddacas	baddacas	Nan
baddii	more	None
badh	polovina	None
badanna	mnogo	None
badankoodu	njih	None
badankooda	njih	None
badankood	njih	None
bachelor	prvostupnik	Nan
bad	loše	None
bada	davanje	Nan
badacas	morska trava	Nan
badal	promjena	None
badalay	izmenjen	Nan
badaleen	izmenjen	Nan
badhaadhe	puta	None
badalin	nepromijenjen	Nan
badan	mnogi	None
badana	često	None
badanaa	obično	None
badanaayey	često	None
badane	mnogo	None
badani	mnogi	None
badanina	njih	None
badalo	promjena	None
bacaadka	peska	Nan
badhan	dugme	None
badhtamaha	sredini	None
bahdil	sramotno	Nan
bahdood	potrebi	None
bahoobayxafladan	događaj	None
bakaaraha	bakaaro	Nan
baki	crna	None
bakistaan	u	None
bakool	bakool	Nan
bakoolgalgaduudnugaal	zapanjujući	Nan
bakr	bakr	Nan
bal	vidi	None
balaadhan	širok	None
balaaran	veliko	None
balaarintii	ekspanzija	Nan
balad	ćelav	Nan
baladhaan	ova	None
bahda	prijatelju	Nan
bahal	zver	Nan
bahabar	brijač	Nan
bah	bah	Nan
badhtamihii	sredini	None
badiba	uglavnom	None
badiyaa	obično	None
badka	more	None
badmareen	otplovio	Nan
badn	loše	None
badnaa	mnogi	None
badhigtay	sačuvano	Nan
badnayd	u	None
badnayn	mnogo	None
badneyn	mnogo	None
badno	više	None
badood	mora	None
badwaynta	okean	None
badweynta	okean	None
baghdad	abecedno	Nan
badnaydna	u	None
joogaanba	su	None
dheeraadka	dodatak	None
dheere	dugo	None
helaynin	naći	None
helayo	pronađi	Nan
helaysaa	dobiješ	Nan
heleen	pronađeno	Nan
heleysa	primanje	Nan
heli	pronađi	Nan
helin	pronađi	Nan
helitaanka	dostupnost	Nan
heliwaa	dostupan	None
helno	pronađi	Nan
helo	pronađi	Nan
helsinki	helmsinki	Nan
herar	herar	Nan
herbert	herbert	Nan
herer	herer	Nan
helaye	pronađi	Nan
heshay	primljeni	Nan
helayaa	na	None
helay	pronađeno	Nan
heesaa	pevaj	Nan
heesaan	pevaj	Nan
heesaha	pjesme	None
heesanin	pevaj	Nan
heesayaan	pevaj	Nan
heesihii	pjesme	None
heeso	pevaj	Nan
heesta	pjesma	None
heestaan	pjesmu	None
heestay	otpevano	Nan
heestii	pjesma	None
heesto	pevaj	Nan
height	visina	None
helaa	pronađi	Nan
helaan	pronađi	Nan
helaya	primanje	Nan
heshid	pronađi	Nan
heshiis	sporazum	None
heshiiska	sporazum	None
hijrada	migracija	None
hijriga	migracija	None
hijrigu	migracija	None
hijriyada	migracija	None
hilibka	meso	None
hilibku	meso	None
hillary	hillary	Nan
hilowle	zdravo	Nan
hindi	hindi	Nan
hindida	stražnji uvid	Nan
hindiya	hindi	Nan
hindu	hinduistički	Nan
hingaada	pravopis	None
hingaadda	pravopis	None
hiraab	kockati	Nan
hiiraan	hira	Nan
hiil	hiil	Nan
high	visok	None
hiddo	baština	None
heshiiskii	sporazum	None
heshiiso	se	None
heshiisyo	ugovori	Nan
heshiiyeen	dogovorili	Nan
hesho	pronađi	Nan
heshowali	se	None
heyada	peta	Nan
heesa	pevaj	Nan
heyn	izdržati	Nan
heystayna	imati	None
heysto	imati	None
hibaaqeey	zakucao	Nan
hibada	poklon	Nan
hibo	talent	Nan
hibrahim	hibrahim	Nan
hiddaha	tradicija	None
heysta	imati	None
hiraabe	ćaskati	Nan
hees	pjesma	None
heerka	nivoa	None
hawd	hawd	Nan
haween	žene	None
haweenaydii	zena	Nan
haweenka	žene	None
haweenkii	žene	None
haweenku	žene	None
hawiyaha	uređaj	None
hawiye	dobro	None
hawl	zadatak	None
hawlaha	aktivnosti	None
hawo	leti	Nan
hawood	hawood	Nan
hawshaas	zadatak	None
hawshii	zadatak	None
hay	sijeno	Nan
hawayga	suze	Nan
haya	najam	Nan
hawaii	havaji	Nan
haw	haw	Nan
hargeisa	hargaisa	Nan
hargesa	hargesa	Nan
hargeysa	hargeisa	Nan
hariin	racija	Nan
harimacadka	gužva	Nan
harraad	žeđ	Nan
harti	harti	Nan
hartigu	kornjača	None
has	ima	None
hasan	hasan	None
hase	god	None
haseyeeshee	god	None
hashiisii	njegove	None
hassan	hassan	Nan
have	imati	None
hawada	u	None
hayaa	izdržati	Nan
hayaan	izdržati	Nan
hayada	agencija	None
haysateen	imao	None
haysato	imati	None
haysay	zadržan	Nan
hayso	to	None
haysta	opsjednut	Nan
haystaan	imati	None
haystay	imao	None
haystee	to	None
haysteen	imao	None
haysto	imati	None
hdms	hdms	Nan
he	on	None
hebel	hebel	Nan
heeganaa	u	None
heer	nivoa	None
haysatay	imao	None
haysata	imati	None
haysan	imati	None
haysaan	imati	None
hayadaha	agencije	None
hayadda	telo	Nan
hayay	zadržan	Nan
haybadoofdii	izvrsnost	Nan
hayd	da	None
hayeen	imati	None
hayeeshee	god	None
heersare	izvrsnost	Nan
hayey	zadržan	Nan
hayin	onkraj	Nan
hayn	zadržati	None
haynin	to	None
hayo	izdržati	Nan
hays	imati	None
haysa	izdržati	Nan
haysaa	imati	None
hayeyguddoomiyaha	guvernera	None
hirayo	posudio	Nan
hireey	hiree	Nan
hirgelinteeda	primjena	None
hormaro	poboljšati	Nan
hormarsan	napredni	Nan
hormood	progresivan	Nan
hormoon	hormona	None
hormuudka	preteča	Nan
horraantii	ranije	None
horrayntii	prvo	None
horraysay	prvo	None
horreeya	prvo	None
horreeyay	prvi	None
horreeyey	prvi	None
horreyey	prethodio	Nan
horreysa	prvo	None
horsed	uzjašen	Nan
horseed	vodeći	None
hormar	napredak	None
horseedaan	olovo	None
horm	unaprijed	None
horjoogsan	ometao	Nan
horeeysay	prvo	None
horeeyso	prvo	None
horena	već	None
horey	ranije	None
horeyay	prethodna	Nan
horeysay	prvo	None
horeysey	ranije	None
horjeed	suprotno	None
horjeeda	suprotno	None
horjeeday	suprotstavljeni	Nan
horjeedeen	suprotstavljeni	Nan
horjeeedo	suprotno	None
horjeesatay	suprotstavljeni	Nan
horjeestay	suprotstavljeni	Nan
horjeesteen	suprotstavljeni	Nan
horkeentay	njega	None
horseeday	led	None
hortagay	sprečeno	Nan
hortageen	suočen	Nan
howlo	aktivnosti	None
howlwadaag	partnera	None
hoyatay	majka	None
hoyga	sklonište	None
hoyisay	smešten	Nan
hoyn	sklonište	None
httpsowikipediaorgwikidigiliyomirifle	httpsowikipediaorgwikidigiliyomirifle	Nan
httpwwwfreewebscominawarfaa	httpwwwfreewebscominawarfaa	Nan
httpwwwfreewebscominawarfaaindexhtm	httpwwwfreewebscominawarfaaindexhtm	Nan
httpwwwyoutubecomwatchv=lzyegdtes	httpwwwyoutubecomwatchv = lzyegdtes	Nan
huang	huang	None
hub	oružje	None
hubaal	sigurno	None
hubaysan	naoružani	Nan
hubiyey	provjereno	Nan
howlgal	operacija	None
howlaha	aktivnosti	None
however	god	None
how	kako	None
hortago	sprečiti	Nan
hortii	prvo	None
hortiisa	njim	None
horumar	napredak	None
horumarinta	razvoj	None
horumarka	napredak	None
horumartay	razvijen	None
horeeyo	prvo	None
horuu	huu	Nan
horyimid	tebe	None
hospital	bolnica	None
hospitaller	bolnica	None
hoteel	hotel	None
hoteelada	hoteli	None
hotel	hotel	None
hotelada	hoteli	None
horyaal	ligu	None
horeeyey	ranije	None
horeeye	prvi	None
horeeyay	prvo	None
hogaamiyayaal	lidere	Nan
hogaamiye	lider	Nan
hogaamiyihii	lider	Nan
hogaamiyihiis	vođa	None
hogaan	rukovodstvo	Nan
hogaanka	olovo	None
hogaankii	rukovodstvo	Nan
hoggaaminaayo	vodi	None
hoggaamiyihii	lider	Nan
hoggaanka	rukovodstvo	Nan
hogol	hogol	Nan
hohey	hohey	Nan
hohob	hohob	Nan
holand	holland	Nan
holland	holland	Nan
hogaamiyaha	lider	Nan
hogaamiya	vodeći	None
hogaaminayey	led	None
hogaaminayeen	led	None
hirgeliyo	prisilno	Nan
hirka	plima	Nan
hiroshima	hiroshima	Nan
history	istorija	None
hivga	hivga	Nan
hiyiga	hobi	Nan
hlibka	tele	Nan
home	dom	None
hobalada	vol	Nan
hobolada	holokaustima	Nan
hobyo	hobyo	Nan
hodan	bogat	None
hoddaye	imućan	Nan
hogaaminaayey	vodeći	None
hogaaminaya	vodeći	None
hogaaminayay	vodeći	None
hobolad	lebdjeti	Nan
hargaysi	hladno	Nan
hona	dušo	Nan
hoo	hoo	Nan
hooyadood	majka	None
hooyay	majke	None
hooyeen	majke	None
hooyey	majke	None
hooyo	majke	None
hor	prije	None
horaa	već	None
horaantii	ranije	None
horay	ranije	None
horaysay	prvo	None
hordhac	uvod	None
hordhaca	uvod	None
hore	ranije	None
horeba	već	None
horeeya	prvo	None
hooyadiis	majka	None
hooyadii	majka	None
hooyada	majka	None
hooy	sklonište	None
hooggiinee	vama	None
hooreysa	toku	None
hoos	dole	Nan
hoosaad	sub	Nan
hoosdhaban	niska	None
hoose	ispod	None
hoosedhexe	linija	None
hong	hong	Nan
hooseeya	niska	None
hoosta	ispod	None
hoostaga	ispod	None
hoostagaan	potčinjen	Nan
hoosteeda	ispod	None
hoostiis	ispod	None
hoostiisa	ispod	None
hooteelka	hotelu	None
hooseshabeelaha	podređeni	Nan
hargaysa	hargeisa	Nan
hargaha	kože	None
hareeyey	opkoljen	Nan
guryahoodii	kuće	None
guryihii	kuće	None
guryo	kuće	None
guryohoodii	kuće	None
guto	to	None
guubaabiyey	stimulisana	Nan
guud	opšte	None
guude	odvezati	Nan
guudkeeda	površini	None
guul	uspeh	Nan
guulaysatay	uspešan	Nan
guulaystay	uspešan	Nan
guuldaraystay	uspio	None
guuleed	osvojen	Nan
guuleestay	pobijedio	None
guryaha	kuće	None
guuleyso	uspješan	None
gurmadeenitoobiya	stranica	None
gurigiisa	kuća	None
gumeestihii	kolonisti	Nan
gumeestiyaashii	kolonisti	Nan
gumeysi	kolonijalizam	Nan
gumeysiga	kolonijalizam	Nan
gumeysigii	kolonijalizam	Nan
gumeystaha	pukovnika	Nan
gumeystihii	pukovnika	Nan
gumeysto	kolonizirati	Nan
guray	siva	Nan
gureey	guliti dole	Nan
gurey	razbijena	Nan
guri	kuca	Nan
guriceel	guriel	Nan
guriga	kod	None
gurigii	kuća	None
gurigiisii	kuća	None
guuleystay	uspešan	Nan
guuleysto	budi	None
guulihii	dostignuća	None
guursatay	oženjen	None
guurtida	senat	None
guusha	uspeh	Nan
guyana	proglasio	None
gyastayn	popraviti	Nan
göteborg	göteborg	Nan
h	h	None
ha	njih	None
haa	da	None
haadaan	da	None
haadku	zagrljaji	Nan
haag	tačno	None
haagu	levo	Nan
haajiray	emigrirali	Nan
haajirtay	emigrirali	Nan
guursado	se	None
guursadey	se	None
guursadaye	oženjen	None
guursaday	oženjen	None
guullahay	uspešan	Nan
guulo	uspeh	Nan
guulside	poraz	None
guulwadayaasha	pobednici	Nan
guulwade	pobednik	Nan
guur	vjenčati	Nan
guuraaga	se	None
gumeestayaasha	kolonisti	Nan
guuraan	se	None
guure	potez	Nan
guureen	se	None
guurey	preselili	Nan
guuriyaha	supruga	None
guurka	brak	None
guuro	potez	Nan
guursadaan	vjenčati	Nan
guuray	preselili	Nan
gumeestay	goth	Nan
gumeesiga	koloniju	Nan
gumeesanin	kolonizovan	Nan
gowracay	zaklao	Nan
gowracayn	klanja	None
gowraco	klanja	None
goysay	rez	Nan
gpp	gpp	Nan
gprs	gprs	Nan
grand	grand	None
graziani	graziani	Nan
groningen	groningen	Nan
groups	grupe	None
gsare	preskoči	Nan
gsm	gsm	Nan
gsmka	gsumm	Nan
gu	gu	Nan
gubay	izgorela	Nan
gowrac	klanja	None
government	vlada	None
gorgor	orao	Nan
gorfayna	gorfayna	Nan
goobtain	mjesto	None
goobtan	mjestu	None
goobtani	mjestu	None
goobtii	lokaciju	Nan
goobweyn	lokaciju	Nan
googoayey	odsečen	Nan
gooni	odvojiti	Nan
gud	obrezan	Nan
goor	vreme	None
goorta	kada	None
goortii	kada	None
goortuu	on	None
goosha	ciljevi	None
goostay	ubrano	Nan
gooyo	rez	Nan
goray	goray	Nan
goorba	uvek	Nan
haan	haan	Nan
guda	isto	None
gudaha	iznutra	Nan
gugii	proljeća	None
guilliani	guilliani	Nan
guinea	gvineja	None
guluf	guluf	Nan
gumaaday	napukao	Nan
gumaysan	kolonizovan	Nan
gumaysiga	kolonijalizam	Nan
gumaysigii	kolonijalizam	Nan
gumaysta	kolonijalizam	Nan
gumaystaha	kolonijalistički	Nan
gumaystay	kolonizovan	Nan
gumaystayaasha	kolonisti	Nan
gumaystayaashii	kolonisti	Nan
gumaystayaashu	kolonisti	Nan
gumaystihii	kolonijalni	Nan
guga	proljeće	None
guduud	crveno	Nan
gudoonsiiyaya	doniranje	Nan
gudoomiyihii	guvernera	None
gudaheeda	unutar	None
gudanno	obrezan	Nan
gudbay	prošao	None
gudbey	prošao	None
gudbin	uputiti	Nan
gudbo	proći	None
guddidii	ploča	None
gudabaarsan	zaobljeni	Nan
guddiga	komitet	Nan
guddoomiyihii	guvernera	None
guddoonsaday	primljeni	Nan
gudiga	komitet	Nan
gudihiisa	iznutra	Nan
gudo	obrezati	Nan
gudoomiyaha	predsjedavajući	Nan
gudoomiye	predsjedavajući	Nan
guddoomiyaha	guvernera	None
hubka	oružje	None
haare	haare	Nan
haashim	haashim	Nan
halgankii	borba	None
halhays	legenda	None
halis	opasno	Nan
halka	dok	None
halkaa	tamo	None
halkaan	ovdje	None
halkaana	tamo	None
halkaas	tamo	None
halkaasi	tamo	None
halkaasna	odatle	None
halkaasoo	gde	None
halkan	ovdje	None
halkanna	tamo	None
halkay	gde	None
halkii	toga	None
halgankaas	borbi	None
halkiisii	toga	None
halganka	borba	None
halgame	osoba	None
haji	hodočašće	Nan
haka	tako	None
hakad	pauza	None
hal	jedan	None
halaad	uništiti	None
halaag	uništiti	None
halac	halal	Nan
haldoor	haldoor	Nan
haldoorka	haldard	Nan
half	polovina	None
halfrate	polusat	Nan
halgamaa	borba	None
halgamaayaashii	aktivisti	Nan
halgamay	mučio	Nan
halgamayaashaasi	borbe	None
halgan	borba	None
halmar	jednom	None
halqabsadeen	jesu	None
halyeey	legenda	None
hantida	vlasništvo	None
hantiwadaaga	socijalizam	None
hanto	vezanje	Nan
hanuun	vodstvo	Nan
hanuuniye	nestašluk	Nan
hanuunka	vodstvo	Nan
har	dok	None
harag	koža	None
harar	debeo	Nan
haray	preostali	Nan
haraye	ćao	Nan
hareen	preostali	Nan
hareeraha	okolo	Nan
hareereheeda	nje	None
hareereysan	okolno	Nan
hanti	bogatstvo	None
hanoolaato	žele	None
hannaan	procesa	None
handsets	mobilne slušalice	Nan
halyey	legenda	None
hamashka	mreža	None
hamdan	hamdan	Nan
hamiyayey	zavedena	Nan
hamzada	oproštaj	Nan
hamzo	maglovito	Nan
hana	sprečiti	Nan
haile	haile	Nan
hanaaqaadeen	zbunjen	Nan
hanaqaad	raste	None
hanaqaaday	dijete	None
hanaqaadeen	su	None
hanaqaadkii	odgoj	None
hanato	debeo	Nan
hanbalyo	čestitke	Nan
handset	telefon	Nan
hanan	se	None
hagistiisu	njegovo	None
hagayay	vodič	None
hagari	hag	Nan
hablood	devojke	Nan
haboon	odgovarajuće	None
habsamiya	glatka	Nan
had	imao	None
hada	uključeno	Nan
hadaad	ti	None
hadaaftimo	cilj	None
hadaan	ne	None
hadaba	dakle	None
hadad	ti	None
hadal	razgovarati	Nan
hadaladii	izjave	Nan
hadalka	govor	None
hadalkana	govor	None
hadalkii	riječ	None
hablaha	devojke	Nan
habkii	put	None
habka	metoda	None
habeenkii	noći	None
haatan	sad	None
haatuf	haatuf	Nan
haayo	zadržati	None
hab	metoda	None
haba	haba	Nan
habaabay	zabludu	Nan
hababka	metode	None
hadalkiisa	govor	None
habar	tetka	Nan
habarjeclo	dobrodošli	Nan
habartii	sada	None
habaysan	organizovano	Nan
habboon	pravilno	None
habdhiska	sistem	None
habeen	noć	None
habeenkeeda	noć	None
habargidir	dobrodošli	Nan
haaruun	haroon	Nan
hadana	god	None
hadasho	razgovarati	Nan
hadla	govore	None
hadlaa	govori	None
hadlaan	govore	None
hadlay	govorio	None
hadlaya	govoreći	None
hadlayaayey	govoreći	None
hadlayana	govoreći	None
hadlayo	govoreći	None
hadli	govore	None
hadlid	razgovarati	Nan
hadlin	govori	None
hadlo	govore	None
hadraawi	hadis	None
haduu	imao	None
hagar	haggard	Nan
hadiye	progutati	Nan
hadii	ako	None
hadhwanaag	sumrak	None
hadhay	levo	Nan
haday	ako	None
hadayn	ne	None
hadba	dođe	None
hadda	sad	None
haddaa	tako	None
haddaad	ti	None
haddaan	ne	None
hadane	svejedno	Nan
haddaba	sad	None
hadday	ako	None
haddii	ako	None
haddiise	tako	None
hadduu	on	None
hadduusan	ne	None
hadeer	sad	None
hadey	ako	None
haddana	opet	None
goobta	lokaciju	Nan
hubkuu	oružje	None
hubsaday	uvjereni	Nan
iyaguna	bum	Nan
iyana	isto	None
iyo	i	None
iyoama	da	None
iyoturkigawaxaanuu	kornjača	None
j	j	Nan
jaad	jaad	Nan
jaadjaad	čarolija	Nan
jaadka	miš	None
jaahiligii	neznalica	Nan
jaajuus	špijun	Nan
jaale	žuto	None
jaaliyadaha	udruženja	None
jaalle	žuto	None
jaamac	univerzitet	None
iyagu	njih	None
jaamaca	univerzitet	None
iyagoon	kanon	Nan
iyagana	ograničenja	None
itoopiya	rekreacija	Nan
itopiyanka	rastvaranje	Nan
its	svoje	None
iuyo	šum	Nan
iwm	itd.	Nan
iyaba	majke	None
iyada	ona	None
iyadana	moja	None
iyadii	ona	None
iyadoo	sa	None
iyadoon	toga	None
iyadu	majke	None
iyaduna	porodica	None
iyaga	njih	None
iyagaa	njih	None
iyagoo	njih	None
jaamacad	univerzitet	None
jaamacada	univerzitet	None
jaamacadaha	univerziteti	Nan
jabouti	japanci	Nan
jabriil	aprila	None
jabtay	slomljen	Nan
jabuuti	džibuti	Nan
jabuuticiisaha	evolucionistički	Nan
jabuutiwaxaa	u	None
jabuutti	jabuutti	Nan
jacayl	ljubav	None
jacaylka	ljubav	None
jaceyl	ljubav	None
jacfar	ljubav	None
jaciir	kora	None
jacques	jacques	None
jagada	pozicija	None
jago	vodič	None
jabkaas	ti	None
jabiyey	razbio	Nan
jabhado	prelomi	Nan
jabhadii	prelomi	Nan
jaamacadda	univerzitet	None
jaamacadii	univerzitet	None
jaamacado	univerziteti	Nan
jaamacadu	univerzitet	None
jaamcada	univerzitet	None
jaamow	da	None
jaantuska	dijagram	Nan
itoobiyana	etiopija	Nan
jab	prelom	Nan
jabaanlaakiin	slomljen	Nan
jaban	slomljen	Nan
jabay	slomljen	Nan
jabhad	džihad	Nan
jabhada	prelomi	Nan
jabhadda	borba	None
jabhaddii	naoružani	Nan
jabaan	slomljen	Nan
jahannamo	dodjavola	Nan
itoobiyaereteriya	etiopljan	Nan
itoobiyaan	etiopljani	Nan
ismaandhaafkooda	njihovo	None
ismaciil	ismail	Nan
ismacil	podneti ostavku	Nan
ismail	ismail	Nan
isna	rekao	None
isniin	ponedeljak	Nan
iso	doći	None
israaca	zajedno	None
israaiil	israaiil	Nan
israailaye	vječnost	Nan
israel	israel	None
israil	israil	Nan
isreebreeb	kvalificirajući	Nan
isse	projekat	None
issisalaamya	priča	None
ismaan	play	None
isssssssslam	isssssssslam	Nan
ismaamulo	sebe	None
ismaamulgoboleedka	lobanja	None
islam	islamska	None
islamarkaana	vrijeme	None
islamarkaasna	vrijeme	None
islamdu	islam	None
islamic	islamska	None
islamka	islam	None
island	ostrvo	None
isleeg	jednako	None
isleegta	jednadžbe	Nan
islii	eastleigh	Nan
islofaakiya	šizofrenija	Nan
islofeeniya	šizofrenija	Nan
isloveeniya	isloveenia	Nan
isma	nije	None
ismaaciil	ismael	Nan
ismaamulka	sopstvo	Nan
istaagay	stali	Nan
istaagey	stali	Nan
istaagi	ustani	Nan
istiraajiyada	strategije	None
isu	sebe	None
isufahmeen	se	None
isugu	isto	None
isuma	znam	None
iswiidhan	švedska	None
iswiisarland	švajcarska	Nan
iswiizerlaan	svingeri	Nan
iswisarland	švajcarska	Nan
isxaaq	od	None
it	to	None
itaaliya	italija	None
italiana	italiana	Nan
item	stavka	Nan
itoobiya	etiopija	Nan
istiraaji	budi	None
isticmalka	upotreba	None
isticmalaa	koristi	None
isticmaasho	upotreba	None
istaago	stani	Nan
istabta	tetovaža	Nan
istanbuul	nedosljednost	Nan
istandharka	naknada	Nan
istarliin	otuđen	Nan
isticmaal	upotreba	None
isticmaalaa	koristi	None
itoobiyaanka	etiopski	Nan
isticmaalaan	upotreba	None
isticmaalay	koristi	None
isticmaalayaasha	korisnika	None
isticmaalayo	koristeći	None
isticmaali	upotreba	None
isticmaalka	upotreba	None
isticmaalo	upotreba	None
isticmaarka	upotreba	None
isticmaalaha	korisnika	None
jakarta	torba	Nan
jama	ljudi	None
jamaal	ljudi	None
jiita	minuta	None
jiitaan	vuča	Nan
jijeele	varljiv	Nan
jilaa	glumca	Nan
jilaamasrax	jilaamasrax	Nan
jili	bili	None
jilib	koljeno	Nan
jilibkiisa	koljeno	Nan
jilicsan	meko	Nan
jimcaale	zaljubljen	Nan
jimcale	cjelini	None
jimce	petak	None
jimcihii	petak	None
jimco	petak	None
jinka	usta	None
jiir	pacov	Nan
jiq	zveckanje	Nan
jiinow	ostati	None
jiilashii	potomaka	Nan
jidkaas	putem	None
jidkan	ovuda	Nan
jidkii	put	None
jidle	bogatstvo	None
jifadiisa	sin	None
jigjiga	slagalica	Nan
jihaad	džihad	Nan
jihaaday	usmjereni	Nan
jihaadka	džihad	Nan
jiho	država	None
jiidaas	području	None
jiidasho	privlačnost	Nan
jiido	vuča	Nan
jiilaal	zimi	None
jiilasha	generacija	None
jiilkii	generacija	None
jir	stari	None
jira	čekaj	Nan
jiraa	je	None
jirney	smo	None
jiro	postoje	None
jirsaday	skreće	None
jirta	postoji	None
jirtaa	je	None
jirtay	postojao	None
jirteen	postoje	None
jirtey	postojao	None
jirto	postoje	None
jirtowax	je	None
johannesburg	johannesburg	Nan
johnston	johnston	Nan
joog	ostati	None
jooga	u	None
joogaa	ovdje	None
jirkii	tijelo	None
jirka	telo	Nan
jiritaankeeda	postojanje	None
jiritaanka	postojanje	None
jiraan	tamo	None
jiraba	zapravo	None
jirae	tamo	None
jirataaa	ste	None
jiray	postojao	None
jiraye	postoje	None
jiraysoomaaliya	somalija	Nan
jidka	put	None
jireen	bio	None
jireenan	bio	None
jireenka	postojanje	None
jireenwaxee	bio	None
jirey	postoje	None
jiri	upotreba	None
jirin	ne	None
jirinhaddaba	uopšte	None
jireena	tamo	None
jideeyey	zadržan	Nan
jideeyay	zadržan	Nan
jid	način	None
jareen	odsečen	Nan
jareer	baka	Nan
jariiban	žargon	Nan
jarmaankakuwaas	mlad	None
jarmal	njemački	None
jarmalka	njemački	None
jaro	rez	Nan
jasiira	ostrvo	None
jasiirad	otok	None
jasiirada	ostrvo	None
jasiiradaha	otoci	Nan
jasiirado	otoci	Nan
jasiiradood	otoci	Nan
jawaabay	odgovorila	Nan
jawaabeen	odgovorila	Nan
jaray	odsečen	Nan
jaraaidka	novine	None
janno	raj	None
jannada	nebesa	Nan
jamaame	gužva	Nan
jamac	množina	Nan
jamacada	množina	Nan
jamal	jamal	Nan
jameecada	sabor	None
jameeco	sabor	None
jamhuriyada	republika	None
jawaabey	odgovori	Nan
jamhuriyadda	republika	None
jamhuuriyad	republika	None
jamhuuriyada	republika	None
jamhuuriyadda	republika	None
janaayo	januar	None
janaraal	opšte	None
jannaale	jan	Nan
jannaayo	januar	None
jamhuuriya	republika	None
islaax	saviti	Nan
jawaabo	odgovori	Nan
jawi	okruženje	None
jeelle	žele	None
jeer	puta	None
jeerin	dezinficirati	Nan
jeex	suza	Nan
jeexwaxaana	i	None
jen	do	None
jenaraal	opšte	None
jenaraalkii	opšti	Nan
jeneraal	general	None
jeneral	opšte	None
jesus	jezus	Nan
jibaaran	kvadrat	Nan
jibiyay	razbio	Nan
jibriil	gabriel	Nan
jicib	baciti	Nan
jeedo	skrenuti	Nan
jeediyo	prijedlozi	Nan
jeediyeen	predložio	Nan
jeediyay	predložio	Nan
jawiga	atmosfera	None
jaziirada	ostrvo	None
je	idi	Nan
jebiyey	razbio	Nan
jecel	ljubav	None
jecelyahay	volio	None
jecelyihiin	ljubav	None
jawhar	vrijeme	None
jeclaa	volio	None
jeclayn	volim	None
jeclaystay	volio	None
jeeda	skrenuti	Nan
jeedaa	na	None
jeedaan	se	None
jeeday	okrenut	None
jeediyana	skrenuti	Nan
jeclaan	ljubav	None
islaanimo	ateizam	Nan
islaan	razvod	None
islaamu	isto	None
ilbaxnimadii	civilizaciji	Nan
ilka	zub	None
ilkaha	zubi	None
illaa	do	None
ilma	dijete	None
ilmada	suze	Nan
ilmadu	suze	Nan
ilmo	dijete	None
ilmohooda	djeca	None
ilo	upotreba	None
ilyaas	suze	Nan
imaaday	stigli	None
imaadeen	stigli	None
imaam	imam	None
imaamka	imam	None
ilbaxnimada	civilizaciji	Nan
imaamkii	imam	None
ilaha	izvori	None
ilaawaan	zaboravi	None
ilaaha	bog	None
ilaahay	bože	None
ilaahayna	bože	None
ilaaheey	bože	None
ilaahey	bože	None
ilaahyo	bogovi	None
ilaalada	stražari	Nan
ilaali	pazi	Nan
ilaalin	zaštititi	Nan
ilaalinta	zaštita	None
ilaaliya	čuvar	Nan
ilaaliyaha	čuvar	Nan
ilaaliyo	zaštićen	Nan
ilaalo	čuvar	Nan
ilaashado	mene	None
ilah	da	None
imaamu	stane	Nan
imaan	doći	None
imaaraatka	svest	Nan
inaad	do	None
inaadan	ne	None
inaan	do	None
inaanu	ne	None
inaga	nas	None
inana	mama	Nan
inay	do	None
inaynu	trebali	None
inaysan	ne	None
inbadan	više	None
included	uključeno	Nan
including	uključujući	None
indha	oči	None
indhabuur	oči	None
indhaha	oči	None
ina	svjetlost	None
in	u	None
important	bitan	None
immam	imam	None
imaarad	amaterski	Nan
imaatay	stigli	None
imagekaahinjpg|daahir	čisto	None
imagekontulan	imagekontulan	Nan
imagem	moja	None
imagemadaxwaynahaygajpg|siilaanyo	slika	None
imagemogadishusjpg|	imagemogadishusjpg |	Nan
ilaah	bože	None
imagetuurjpg|cabdiraxman	imagetuurjpg | cabdiraxman	Nan
iman	dođi	Nan
imanaysa	dolazi	None
imbaradooriyado	telekomunikacije	None
imei	imei	Nan
imid	dođi	Nan
imika	sad	None
iminka	sad	None
imagexamarcadejpg|	imagexamarcadejpg |	Nan
ilaa	do	None
ila	liniju	None
il	oko	None
ianaynu	hajde	Nan
iaygoo	meni	None
ibin	štovanje	Nan
ibn	ibn	None
ibnu	zakriti	Nan
ibraahiim	slagalica	Nan
ibraahim	znam	None
ibraahin	govori	None
ibrahim	ibrahim	None
ictiraaf	prepoznavanje	Nan
ictiraafsanyahay	priznao	None
idaacada	stanica	None
idaacadaha	stanice	None
idaha	scenu	None
identity	identitet	None
ialahayna	meni	None
iadoo	meni	None
i	i	None
huud	kapuljača	Nan
hudheello	hotel	None
hudhudkii	palata	Nan
hungaria	gladovanje	Nan
huraan	udarac	None
huray	promuklih	Nan
hurda	spavanje	None
hurdada	spavati	Nan
idhi	sam	None
hurdadii	spavati	Nan
hureen	slomljen	Nan
hurin	hitnost	Nan
hurre	uporediti	Nan
hurumarka	napredak	None
huruud	žuto	None
huseen	huseen	Nan
hussein	hussein	Nan
hurdo	spavati	Nan
indheergarad	intelektualni	Nan
idiin	tebe	None
idin	ti	None
iibsadaan	kupiti	Nan
iibsaday	kupio	Nan
iibso	ga	None
iidow	gozba	Nan
iiga	meni	None
iigu	mene	None
iikeeneen	me	None
iima	da	None
iimaan	vjera	None
iimaanka	vjera	None
iimaankuna	vjera	None
iiraan	iran	None
iisoo	meni	None
ikhyaartii	mogućnost	None
ikwadoor	podrška	None
iibiyo	prodati	None
iibiyey	prodano	Nan
iibin	prodati	None
iibgayn	prodati	None
idinka	ti	None
idinkaa	ti	None
idinkana	također	None
idinkaysu	sebe	None
idinla	sa	None
idiris	žvakati	Nan
idlaaday	je	None
idil	celinu	Nan
iesus	iesus	Nan
ifka	ifka	Nan
iftin	cvijet	None
iga	ići	None
igad	goad	Nan
igu	ja	None
ihi	i	None
ii	ii	None
if	ako	None
hubo	sigurno	None
indho	oči	None
india	indija	None
isbania	domovina	None
isbayn	sebe	None
isbeheysi	pravopis	None
isbheysigii	samoizlječenje	Nan
isbitaal	bolnica	None
isbitaalada	bolnice	Nan
isbitaalka	u	None
isboorti	sport	None
isdaba	niz	None
isdullayn	zavisnost	Nan
isga	saha	Nan
isgaadhsiinta	komunikacija	None
isgaadhsiintu	komunikacija	None
isgaarsiinta	komunikacija	None
isha	oko	None
isbadalka	promjena	None
ishkin	hashkin	Nan
isbadalin	nepromijenjen	Nan
isbadalada	promjene	None
irmaan	hlače	Nan
irridka	vrata	None
irridkaa	ovuda	Nan
irsaaqa	kupiti	Nan
is	je	None
isa	dosta	None
isaaq	play	None
isaaqu	dati	None
isaga	njega	None
isagoo	vlasništvo	None
isagu	on	None
isanimo	odsustvo	Nan
isaxaaq	zvižduk	Nan
isbadal	promjena	None
isbadala	promjena	None
isbadaladii	promjene	None
isi	glava	None
isjiiraya	se	None
iska	zrak	None
islaamay	zagrljeni	Nan
islaamcarabi	play	None
islaameen	jeste	None
islaami	islam	None
islaamiga	islam	None
islaamiya	play	None
islaamiyiinta	islamisti	Nan
islaamka	islam	None
islaamkaayuu	islam	None
islaamku	islam	None
islaamkuna	islam	None
islaamnimada	islamizam	Nan
islaamnimadiisa	njegov	None
islaamnimo	islam	None
islaamoow	zdravo	Nan
islaama	isto	None
islaam	islam	None
isla	isto	None
iskuxigxiga	niz	None
iskaashi	surađivati	Nan
iskaashiga	saradnja	None
iskaga	odlazi	None
iskama	postoji	None
iskoolada	škole	None
isku	isto	None
iskudar	dodaj	Nan
iritareeya	bježi	None
iskudayay	pokušao	None
iskula	isto	None
iskuqabashada	sukob	None
iskusoo	otpasti	Nan
iskuulada	škole	None
iskuulka	školi	None
iskuulo	škole	None
iskuxidhka	umrežavanje	None
iskugu	sastaviti	Nan
irir	kosa	None
iri	naprezanje	Nan
iraq	iraq	Nan
ingriisugu	engleski	None
initiated	pokrenut	Nan
injiil	evanđelje	Nan
injineer	inženjer	Nan
inka	mastilo	Nan
inkasta	ipak	None
inkastoo	ipak	None
inkastoon	cenzura	Nan
inna	mama	Nan
innagaa	nas	None
innoo	nas	None
innooga	naglasak	Nan
innoogu	nas	None
inoo	nas	None
inoogu	nas	None
ingriisla	engleski	None
ingriisku	engleski	None
ingriiska	engleski	None
ingriis	engleski	None
indonesia	indonezija	None
indonesian	indonezijski	Nan
indoniishiya	indonezijski	Nan
indoor	zatvoreni	None
indoors	prostoru	None
indunisiya	indonezijski	Nan
ineey	do	None
inqilaab	uvijanje	Nan
iney	do	None
information	informacija	None
ing	ing	Nan
ingiriis	engleski	None
ingiriisiga	engleskom	None
ingiriiska	engleskom	None
ingiriisku	engleski	None
ingirisku	engleski	None
ineysan	nisu	None
indhuhu	oči	None
inqilaabeen	postali	None
inqilaabkaasna	taj	None
internetka	internetu	None
intey	intey	Nan
intii	dok	None
intiisa	ostalo	None
into	u	None
intooda	njih	None
intuba	svuda	Nan
intuu	on	None
inu	iznutra	Nan
inuu	do	None
inuusan	nije	None
inxiraaf	izdašan	Nan
iqtiyaar	neobavezno	Nan
iraan	iran	None
iran	generacija	None
internet	internet	None
international	međunarodni	None
interference	smetnje	None
interface	interfejs	None
inqilaabkii	puča	Nan
insaanka	čovječanstvo	Nan
insaykalobeedhiya	enciklopedija	None
insha	insha	Nan
insuliinka	inzulin	Nan
inta	dok	None
intaa	toga	None
inqilaabka	državnom	None
intaad	ti	None
intaas	da	None
intaasi	da	None
intaasoo	tome	None
intaba	oboje	Nan
intay	oni	None
inteeda	njih	None
inteedii	ostalo	None
intaan	ovo	None
goobo	krug	None
goobihii	lokacije	None
goobeede	veleprodaja	Nan
doorkii	uloga	None
dooro	odaberite	Nan
doorroone	poželjno	None
doorsamaye	otvoren	None
doorsan	odabrano	Nan
doorshaane	odaberite	Nan
doortaa	odaberite	Nan
doortay	izabran	None
doorteen	izabran	None
doorto	odaberite	Nan
dooxa	dolina	None
dooxada	dolini	None
dooxadii	dolini	None
doqon	glupo	Nan
doqonniimo	budalaština	Nan
doorka	uloga	None
dorraato	aukciji	Nan
dooriyee	pobijediti	Nan
doorashooyinkii	izbori	None
doono	volja	None
doonta	brod	None
doontaa	tražiti	None
doonto	volja	None
doonyaha	brodovi	None
door	uloga	None
dooranayay	izbor	None
dooranayeen	izbor	None
doorashada	izbor	None
doorashadaas	izbor	None
doorashadan	opcija	None
doorashadii	izbori	None
doorasho	izbori	None
doorashooyin	izbori	None
doorashooyinka	izbori	None
doorin	ne	None
dowlad	vlada	None
dowlada	vlada	None
dowladaha	vlade	None
duduwan	ljubice	Nan
dufowdoo	ga	None
dug	iskopan	Nan
dugsi	škola	None
dugsiga	školi	None
dugsigii	škola	None
dugsiyada	škole	None
dugsiyo	škole	None
dugulka	škola	None
duhur	podne	None
duhurkii	podne	None
dukaan	prodavnica	Nan
dul	na	None
dulka	površina	None
dulli	sramota	Nan
duco	blagoslov	Nan
duceeyo	se	None
ducaynaa	se	None
ducada	molitva	None
dowladahaas	vlade	None
dowladda	vlada	None
dowladdii	vlada	None
dowladeed	vlada	None
dowladihii	vlade	None
dowladii	vlada	None
dowlado	vlade	None
doonno	ćemo	None
dowladood	vlade	None
dowr	dowr	Nan
dr	dr	None
drs	drs	Nan
du	du	None
dubad	pravougaon	Nan
dubai	dubai	Nan
ducaadda	blagoslov	Nan
download	skinuti	Nan
dulliga	ponižavajući	Nan
doonnaaye	ćemo	None
doonistii	želja	None
diyaaradaha	avioni	None
diyaaradeed	avion	None
diyaaradii	avion	None
diyaaradood	avioni	None
diyaaraduhu	avioni	None
diyaarintii	priprema	None
diyaariyay	pripremljeni	Nan
diyaariyey	pripremljeni	Nan
diyaarka	spreman	Nan
diyaradaha	avioni	None
djacday	šokiran	Nan
djibouti	novije	None
do	učiniti	None
doc	doc	Nan
doh	doh	Nan
diyaarada	avion	None
dola	dolara	None
diyaar	spreman	Nan
dit	dit	Nan
diri	izdržati	Nan
dirir	se	None
dirirayaashii	ratnici	None
dirirka	svađa	Nan
diriro	se	None
dirirtii	borba	None
diriyo	svađa	Nan
dirkii	otprema	Nan
dirsaday	poslao	None
disc	disk	None
diseembar	prosinca	Nan
distoori	distoori	Nan
distoorkii	ustav	None
distributed	distribuiran	Nan
distuurka	ustav	None
dix	dix	Nan
dominika	dominikanski	Nan
doob	dob	None
doobcadale	drugi	None
doona	tražiti	None
doonaa	volja	None
doonaan	volja	None
doonaayey	želio	None
doonan	tražiti	None
doonay	željeni	Nan
doonaya	željeti	Nan
doonayaa	željeti	Nan
doonayeen	željeni	Nan
doonayo	željeti	Nan
dooneen	traženo	Nan
dooneyid	ti	None
dooneysaa	ti	None
doonin	tražiti	None
dooninna	tražite	Nan
doon	brod	None
doolow	se	None
doolo	ble	Nan
doollo	kvas	Nan
doobi	srna	Nan
dooc	doc	Nan
dood	debata	Nan
dooda	debata	Nan
doodaan	ovaj	None
dooday	raspravljalo	Nan
doodayaan	se	None
doonka	čamac	Nan
doodday	raspravljalo	Nan
doodi	debata	Nan
doodo	debata	Nan
doofaar	svinja	None
doog	biljka	None
dooga	trava	Nan
doogsin	oslabiti	Nan
doojey	samljeti	Nan
doodeen	tvrdio	None
dulmiga	ugnjetavanja	Nan
dulmiya	ugnjetavati	Nan
dulqaad	budi	None
eegayeen	izgleda	None
eegayo	gledajući	Nan
eegno	pogledaj	Nan
eego	pogledaj	Nan
eegto	pogledaj	Nan
een	da	None
eersadaye	bog	None
eesan	kasnije	None
eey	pas	Nan
eeysan	pas	Nan
eg	npr.	Nan
egyihiin	kao	None
eheed	je	None
eheen	je	None
eheyd	bio	None
eegay	pogledao	Nan
eight	osam	None
eegaayey	izgleda	None
eeerland	unutrašnjost	None
education	obrazovanja	None
ee	da	None
eebbaa	da	None
eebbaana	da	None
eebbaha	glavu	None
eebbahay	otac	None
eebbana	ne	None
eebbe	bože	None
eebbow	gore	None
eebe	bože	None
eed	kriviti	Nan
eedaysay	optuženi	Nan
eedeeyay	optuženi	Nan
eedeeyey	optuženi	Nan
eedeyay	optuženi	Nan
eeg	pogledaj	Nan
ekaa	otprilike	None
el	el	None
elarab	elarab	Nan
erayada	reči	Nan
eraydan	riječ	None
erayga	riječ	None
eraygan	riječ	None
erega	erekcija	Nan
eretereya	igra	None
ereteriya	sportista	None
eretrie	eretrie	Nan
erey	reč	Nan
ereyada	reči	Nan
ereyga	reč	Nan
ereygaasi	riječ	None
ergo	ergo	Nan
eriga	eriga	Nan
erigavo	erigavo	Nan
eray	reč	Nan
eratiya	reč	Nan
erataria	eratarija	Nan
eratareya	riječ	None
elektrooniga	elektronika	None
elements	elemente	None
elmi	elmi	Nan
email	email	None
emailkiisa	email	None
embedded	ugrađen	Nan
en	en	Nan
economy	ekonomija	None
eng	eng	None
engineering	inženjering	None
engineerku	inženjer	Nan
engiriiska	engleskom	None
england	engleska	None
english	engleski	None
equipment	opreme	None
eraga	reč	Nan
engineer	inženjer	Nan
ebekargaab	prečesto	Nan
ebbow	ebbow	Nan
eau	eau	Nan
dunuub	bore	None
duq	stari	None
duqa	gradonačelnik	None
duqayn	bombardovanje	Nan
duqeeyay	bombardovana	Nan
duqsan	stari	None
duqsansoomaalida	bradati	Nan
duqsanwaxyaabaha	stvari	None
duray	ubrizgavanje	Nan
durba	već	None
durbaan	bubanj	Nan
durbadiiba	već	None
durdur	potok	None
durdurkii	potok	None
during	tokom	None
dunidda	svijet	None
dunidana	svijet	None
dunidalaakiin	svijet	None
dunida	svijet	None
dulqaadaan	budi	None
dultaagi	se	None
dulucda	tema	None
dulugle	klovn	Nan
dumaal	snaha	Nan
dumar	žene	None
dumarka	žene	None
durkoo	god	None
dumarkii	žene	None
dumey	dumey	Nan
dumin	smeće	Nan
duminayaa	srušen	Nan
dumis	rušenje	Nan
dumiyo	uništiti	None
dun	ukusno	Nan
duni	svetu	Nan
dumay	srušio	Nan
dirgen	dirgen	Nan
duruufaheeda	okolnosti	None
duryaad	maglovito	Nan
duullaankii	invazija	Nan
duumaa	play	None
duunyo	životinja	None
duur	divlji	Nan
duurgalay	se	None
duurka	terenu	None
duwan	različito	None
duwanaa	drugačije	None
duwanyahay	je	None
dvdx	dvdx	Nan
e	e	None
each	svaki	None
east	istok	None
eastleigh	eastleigh	Nan
eastliegh	eastliegh	Nan
duulka	let	None
duuliyihii	pilot	Nan
duuliye	pilot	Nan
duulay	odleteli	Nan
dusha	površina	None
dusheeda	njemu	None
duub	rola	Nan
duuban	snimljeno	Nan
duubay	snimljeno	Nan
duubi	snimanje	None
duud	grm	Nan
duruufihii	okolnosti	None
duudka	u	None
duufaan	oluja	None
duug	stari	None
duugey	zakopati	Nan
duugmay	istrošen	Nan
duugta	masaža	Nan
duul	letjeti	Nan
duulaan	napasti	None
duudsiiyey	srušen	Nan
direy	poslao	None
dirayoo	poslao	None
dirayay	slanje	None
dhinacakale´shilinka	strane	None
dhinacba	drugog	None
dhinaceeda	nje	None
dhinacyada	strane	None
dhinacyo	strane	None
dhinicii	bočno	Nan
dhintay	smrt	None
dhinteen	su	None
dhintey	umro	None
dhinto	umire	None
dhir	peršun	Nan
dhiraandhirinta	analize	None
dhiraha	biljke	None
dhirindhireed	bilje	None
dhirirka	visina	None
dhinacakale	strane	None
dhirirkeeda	dužina	None
dhinaca	strani	None
dhimatay	smrt	None
dhiigii	krv	None
dhiilka	tions	Nan
dhiillo	bludnica	Nan
dhiiragalin	ohrabruju	Nan
dhiiri	ohrabruju	Nan
dhiirigelin	ohrabruju	Nan
dhiirigelisay	ohrabreni	Nan
dhiirri	ohrabruju	Nan
dhikanyee	tako	None
dhiman	umrijeti	Nan
dhimanayey	umirao	Nan
dhimane	smrtno	Nan
dhimashadiisii	smrt	None
dhimasho	smrt	None
dhimashooyin	smrti	None
dhinac	strana	None
dhirta	biljke	None
dhirtu	biljke	None
dhis	graditi	Nan
dhisteen	izgrađeno	Nan
dhixine	ne	None
dhoho	reći	None
dhooble	osmijeh	Nan
dhoobo	blato	Nan
dhoof	jedriti	Nan
dhoofin	izvoz	None
dhoofiska	izvoz	None
dhoofista	izvoz	None
dhoofiyaa	izvezeni	Nan
dhoofiyo	izvoz	None
dhool	osmijeh	Nan
dhoore	jelen	Nan
dhow	zatvoriti	Nan
dhowaaneynaa	uskoro	None
dhistay	izgrađeno	Nan
dhiso	graditi	Nan
dhisnayd	izgrađeno	Nan
dhisnaa	izgrađeno	Nan
dhisaan	graditi	Nan
dhisaayeen	gradili	None
dhisan	strukturirano	Nan
dhisay	izgrađeno	Nan
dhiseen	ga	None
dhisida	zgrada	None
dhisin	graditi	Nan
dhiigga	krv	None
dhisitaan	napraviti	None
dhiska	građevina	None
dhismaha	građevina	None
dhismayaal	zgrade	None
dhismayaasha	zgrade	None
dhisme	zgrada	None
dhismihii	zgrada	None
dhismo	građevina	None
dhisitaankii	konstrukciju	Nan
dhiig	krv	None
dhiibid	predati	Nan
dhiibi	predati	Nan
dhexdeeda	unutar	None
dhexdhexaad	neutralan	Nan
dhexdhexaadinta	posredovanje	Nan
dhexdiisa	unutar	None
dhexdooda	njima	None
dhexe	centralni	None
dhexeeya	između	None
dhexeysa	između	None
dhexmara	kroz	None
dhexmaray	prekinuo	Nan
dhextaala	usred	Nan
dhib	nevolja	Nan
dhibaatada	problem	None
dhibaatadii	problem	None
dhibaato	problem	None
dhexda	sredini	None
dhexaysa	između	None
dhexadka	sredini	None
dhexaad	neutralan	Nan
dheereeyo	visina	None
dheereshiinehaabiilhabane	fluidnost	Nan
dheereyn	produžetak	Nan
dheereynayaa	produženo	Nan
dheerka	toga	None
dheg	uho	Nan
dhegaha	uši	Nan
dhibaatooyin	problemi	None
dhegan	zaglavili	Nan
dhegtay	uho	Nan
dheh	reći	None
dheheen	rekli	None
dherer	dužina	None
dhererkiisu	dužina	None
dhererkoodu	visina	None
dhex	sredini	None
dhegen	štap	Nan
dhowdahay	blizu	None
dhibaatooyinka	problemi	None
dhibay	uznemiren	Nan
dhigeen	položen	Nan
dhigeendhulka	igračka	Nan
dhigey	položen	Nan
dhigi	to	None
dhigin	stavlja	None
dhignaa	priznao	None
dhigo	set	None
dhigtan	put	None
dhigtay	položen	Nan
dhigteen	položen	Nan
dhigto	park	None
dhihi	reći	None
dhiib	odustati	Nan
dhiibay	predali	Nan
dhiibayaa	ga	None
dhigaysa	stavlja	None
dhigayo	položen	Nan
dhigaye	preko	None
dhigaya	staviti	None
dhibi	gnjaviti	Nan
dhibina	ne	None
dhibka	problem	None
dhibkii	problem	None
dhiblaawe	bezbrižno	Nan
dhibta	problem	None
dhici	pad	None
dhibaatooyinkii	problemi	None
dhicin	pad	None
dhicisoobay	pobačaj	None
dhiga	staviti	None
dhigaa	set	None
dhigaan	to	None
dhigan	park	None
dhigateene	tim	None
dhigay	set	None
dhicine	ističu	None
ertariya	eritreja	Nan
dhowna	blizu	None
dhowree	zaštititi	Nan
diinle	deinle	Nan
diinsoor	dynsoor	Nan
diinta	religija	None
diintaas	religija	None
diintan	religija	None
diintana	ovo	None
diinteena	religija	None
diintiisa	religija	None
diintooda	religije	None
diintoodii	religije	None
diintu	religije	None
diintuna	dint	Nan
diiqsan	depresivan	Nan
diir	oguliti	Nan
diiraabay	zagrijan	Nan
diinka	religija	None
diiran	toplo	Nan
diiniga	religije	None
diine	diine	Nan
diide	odbiti	Nan
diideen	odbačeni	Nan
diidey	odbačeni	Nan
diidmada	prigovor	Nan
diido	skrenuti	Nan
diidoo	odbiti	Nan
diidye	odbija	None
diif	diph	Nan
diifta	difterija	Nan
diimaha	religije	None
diimeedka	religiozni	Nan
diimo	religije	None
diimood	vjera	None
diimuqraadiga	demokratskom	Nan
diin	religija	None
diini	dekan	Nan
diiray	oguljen	Nan
diiriye	zbunjen	Nan
diirka	oguliti	Nan
dimuqaraadiga	demokratija	None
dimuqraadiga	demokratskom	Nan
dimuqraadiyada	demokratija	None
dimuqraadiyadda	demokratija	None
dimuquraadi	demokratija	None
dimuquraadiya	demokratija	None
dimuquraadiyada	demokratija	None
dininig	dininig	Nan
dir	poslati	Nan
diraa	poslao	None
diraac	gulaš	Nan
diraacoode	ih	None
diraan	poslati	Nan
diran	očajno	Nan
diray	poslao	None
dimoqaraadiyadda	demokratija	None
dimishiq	demokratija	None
dilo	ubiti	None
dillapress	dillapress	Nan
diirki	oguliti	Nan
diiro	fokus	Nan
diirsado	zagrijavanje	Nan
dil	ubistvo	None
dila	diler	Nan
dilaa	ubija	None
dilaan	ga	None
diiddo	odbiti	Nan
dilay	ubijen	None
dileen	ubijen	None
diley	ubijen	None
dilkii	ubistvo	None
dilkiisa	ubistvo	None
dilku	ubistvo	None
dilla	napukao	Nan
dillaaco	pukotine	Nan
dilaye	diler	Nan
diidday	odbačeni	Nan
diidayaana	zanijekati	Nan
diidayaa	odbija	None
dhulkan	zemlja	None
dhulkeeda	zemlju	None
dhulkii	zemlja	None
dhulkiisaa	zemlju	None
dhulku	zemlja	None
dhulwaynaha	kopno	Nan
dhunkaal	poljubac	Nan
dhuraye	vodopad	Nan
dhuub	tanka	Nan
dhuumasho	se	None
dhuunta	grlo	Nan
dhuurta	šuma	None
dhuusamareeb	ponoć	Nan
dhuux	srž	None
dhuwan	sakriti	Nan
dhulkaas	zemlji	None
dhulkaan	zemlja	None
dhulkaa	zemlja	None
dhulka	zemlja	None
dhowrsada	dužnost	None
dhowrsan	zaštićen	Nan
dhowrsana	dužnost	None
dhubato	pljuvati	Nan
dhuftay	udario	Nan
dhufteen	udario	Nan
dhul	zemlja	None
dhuxul	ugalj	None
dhulaka	zemljište	None
dhulalkii	zemlje	None
dhulbahante	zemlje	None
dhulbaisaguna	zemljišta	None
dhulbeereedka	pejzaž	Nan
dhuleed	zemlja	None
dhulgariir	potres	Nan
dhulgariirka	potres	Nan
dhulalka	zemlje	None
dhowr	nekoliko	None
dhuxusha	ugalj	None
diabetes	dijabetes	Nan
difaacaya	braneći	Nan
different	različito	None
digfeer	kopač	Nan
digil	digil	Nan
digilmirifle	digilmirifle	Nan
digir	pasulj	Nan
digirta	pasulj	Nan
digital	digitalni	None
digniin	upozorenje	Nan
digo	probaviti	Nan
dihine	dihine	Nan
dii	c	None
diid	odbačeni	Nan
diidana	odbaci	Nan
diiday	odbačeni	Nan
difaacay	branio	Nan
difaaca	odbrana	None
didsaday	okrenut	None
diday	oštar	Nan
diakonia	đakonija	Nan
dib	nazad	None
dibad	napolje	Nan
dibada	prekomorski	Nan
dibadda	napolju	Nan
dibadiisa	napolju	Nan
dibedda	napolju	Nan
di	biti	None
dibeddaba	napolju	Nan
dibi	vola	Nan
dibna	opet	None
dibnahayga	oko	None
dibu	vola	Nan
dibuga	tele	Nan
dibugu	bik	Nan
dibuheshiisiinta	pomirenje	Nan
dibeddu	napolju	Nan
eryada	juriti	Nan
eryaday	potjerano	Nan
eryay	otpušteno	Nan
galiyo	staviti	None
galka	u	None
galkacyo	galona	Nan
galleyda	kukuruz	None
galmaax	galon	Nan
galmoodka	seksa	Nan
galo	u	None
galow	ući	None
gambia	gambija	Nan
ganac	trgovanje	Nan
ganacasade	trgovac	Nan
ganacsade	trgovac	Nan
ganacsan	trgovano	Nan
ganacsatada	trgovci	None
ganacsato	trgovci	None
galiyey	infuzija	Nan
ganacsi	posao	None
galiyaan	staviti	None
galinsoor	umetanje	Nan
galbeedkana	zapad	None
galbeedkenya	zapadu	None
galbeedku	zapad	None
galbeedna	zapad	None
galdogob	porcelan	Nan
galeen	u	None
galeeyda	moja	None
galeyda	kukuruz	None
galgaduud	kupina	Nan
galguduud	puzeti	Nan
gali	uđi	Nan
galin	staviti	None
galinayo	ubačeno	Nan
galinaysaa	ubačeno	Nan
galine	galine	Nan
galisay	ubačeno	Nan
ganacsiga	posao	None
ganacu	trgovanje	Nan
gandi	pravilo	None
garbihiisa	njegovim	None
gardhaale	kontroverzni	Nan
gardheere	izmišljen	Nan
gargaar	pomoć	None
gargaaray	potpomognut	Nan
gargaarka	olakšanje	Nan
gariis	promuklih	Nan
garjante	garjante	Nan
garoomada	aerodromi	Nan
garoomaha	mladoženja	Nan
garoon	stadion	None
garoonka	stadion	None
garoonkaan	ovom	None
garoowe	garowe	Nan
garowe	ti	None
garbahaarey	uz	None
garbaha	ramena	Nan
garatay	ti	None
garasho	shvatiti	None
ganey	razumjeti	None
gar	gar	Nan
garaacay	tukli	Nan
garaaco	otkucaja	Nan
garaad	intelekt	Nan
garaadka	intelekt	Nan
garab	rame	Nan
galbeedka	zapad	None
garabsocday	u	None
garadag	čuven	Nan
garadba	razumiju	Nan
garan	znam	None
garanayn	znala	None
garanayo	znam	None
garansiiyo	pomoć	None
garashada	percepcija	Nan
garad	ti	None
galbeeditoobiya	zapadna	None
galbeed	zapad	None
galbe	zapad	None
gabayle	pjesnik	None
gabayo	pjesma	None
gabdhaha	devojke	Nan
gabdhahooda	kćeri	None
gabdhihii	kćeri	None
gabdhood	kćeri	None
gabdhoodna	kćeri	None
gabeyre	pjesnik	None
gabi	potpunosti	None
gabiahaanba	ove	None
gabiley	gorila	Nan
gabownimadii	starosti	None
gabyaa	pjesnik	None
gabyaagii	pjesnik	None
gacal	draga	None
gabaygu	pjesma	None
gabaygii	pjesnik	None
gabayga	pjesma	None
gabayadiisa	pjesme	None
gaarsiinta	dostava	Nan
gaarsiisan	doseg	Nan
gaarsiiyey	preneo	Nan
gaarsiyeyna	preneo	Nan
gaashaaman	štit	None
gaashaan	štit	None
gaashaanbuurta	savez	None
gacan	ruka	None
gaashaandhiga	odbrana	None
gaashaanle	pukovnika	Nan
gabadh	kćerka	None
gabadha	djevojka	None
gabadhii	djevojka	None
gabanka	izjava	Nan
gabar	devojka	Nan
gabay	pjesma	None
gaashaanka	štit	None
garre	garre	Nan
gacanka	zaljev	Nan
gacanta	ruka	None
galaa	ulazi	None
galaal	folder	Nan
galaan	uđi	Nan
galab	poslijepodne	Nan
galabsan	ovo	None
galabtaas	ovo	None
galadaystay	nestao	None
galaddiisu	njegovo	None
galay	u	None
galayda	kukuruz	None
galaydh	kukuruz	None
galaye	uđi	Nan
galayno	nas	None
galayr	galona	Nan
galbaday	poslijepodne	Nan
gala	uđi	Nan
gal	zapisnik	Nan
gaheyrkuliyada	geologija	Nan
gaheyr	gaheyr	Nan
gacantiisa	ruka	None
gacmaha	ruke	Nan
gacmeedyo	ruke	Nan
gacmood	ruke	Nan
gadaal	kasnije	None
gadaashiiye	iza	None
gadabuursi	odustani	Nan
gacansiiyo	pomoć	None
gadabuursiga	na	None
gaday	kupio	Nan
gadaye	stolice	Nan
gadiid	prodati	None
gadiidka	prevoz	Nan
gadisan	krevet	Nan
gado	nasljedstvo	Nan
gaduud	crveno	Nan
gadabuursigu	dvorištu	Nan
gaaro	doseg	Nan
garsoor	sudija	None
garsoorka	sudija	None
goa	goa	Nan
goaan	odluku	None
goaankanna	odluka	None
goaansaday	odlučili	None
goaansadeen	odlučili	None
goan	komad	Nan
goay	goay	Nan
gob	gob	Nan
gobalada	regija	None
gobaleedka	regionalnom	Nan
gobalka	region	None
gobanimo	nezavisnost	None
gobanimodoonka	gobannoodon	Nan
gobol	region	None
gobola	regija	None
go	idi	Nan
gobolada	regija	None
gmsk	gmsk	Nan
glay	glay	Nan
geography	geografija	None
georges	georges	Nan
geri	roštilj	Nan
geyiga	kod	None
geysatay	počinio	Nan
geystey	počinio	Nan
ghazi	organizovati	Nan
gidaar	dom	None
gidir	dom	None
giinbaarta	udisati	Nan
giriig	grčki	None
giriiga	grčki	None
giriigga	grčki	None
giriigii	grčki	None
giscard	giscard	Nan
global	globalno	Nan
goboladan	krajevima	None
goboladii	regijama	Nan
goboleed	regionalnom	Nan
godka	pecina	Nan
godod	boginja	None
goeen	rez	Nan
goii	goii	Nan
goin	ući	None
golaha	vijeće	None
goleey	gole	Nan
golihii	vijeće	None
golis	golis	Nan
gollaha	vijeće	None
gololeey	soba	None
goo	rez	Nan
goob	lokaciju	Nan
goobaha	lokacije	None
goobanimo	krug	None
godey	bogu	None
godeey	bože	None
goday	hvala	Nan
godan	šuplje	Nan
goboleedka	regionalnom	Nan
gobolka	region	None
gobolkaan	prostorima	None
gobolkan	prostorima	None
gobolkani	prostorima	None
gobolkasta	državi	None
gobolkii	regija	None
gens	gens	Nan
gobolku	država	None
gobolladii	regija	None
gobolo	regija	None
gobonidoon	gobonidoon	Nan
gobonimo	nezavisnost	None
gobonnimada	suverenitet	None
gobroon	goron	Nan
god	rupa	None
gobollada	regija	None
generation	generacija	None
generalka	cjelini	None
general	opšte	None
gaystay	počinio	Nan
gbanaadir	popularan	None
gebi	totalno	Nan
gedisan	distalno	Nan
gedo	podrezati	Nan
gedoshabeelaha	traktor	Nan
geed	drvo	None
geedaha	drveće	Nan
geeddi	procesa	None
geedi	drvo	None
geedka	biljka	None
geedkii	drvo	None
geedo	bilje	None
geel	deva	Nan
geela	deva	Nan
gaysay	isporučeno	Nan
gaysatay	postignut	Nan
gayiga	gej	Nan
gawracii	klanje	Nan
gartada	to	None
gartay	shvatio	Nan
garto	prepoznati	Nan
garyaqaan	advokat	Nan
garçon	vijenac	None
gashaa	ući	None
gashaandhiga	štit	None
geelii	deva	Nan
gashay	ušao	None
gates	kapije	Nan
gateyba	kapija	None
gato	kupiti	Nan
gauda	dahnu	Nan
gaule	gaule	Nan
gaulle	galele	Nan
gaussian	gaussian	Nan
gashiyo	kosa	None
garsoore	sudija	None
geeliisii	deva	Nan
geella	deva	Nan
geeyo	donesi	Nan
gelaya	ulazak	None
geledi	geled	Nan
geli	se	None
gelin	staviti	None
gelinta	umetanje	Nan
gelisay	ubačeno	Nan
geliya	u	None
geliyaan	staviti	None
geliyay	ubačeno	Nan
geliyeen	staviti	None
geliyo	ubačeno	Nan
gelle	galija	Nan
gelyo	sjenila	Nan
gen	gen	None
geeyey	isporučeno	Nan
geeyay	isporučeno	Nan
geeyaa	donesi	Nan
geesteen	nas	None
geelle	deva	Nan
geelo	deva	Nan
geelu	deva	Nan
geeri	smrt	None
geerida	smrt	None
geeridii	smrt	None
geerisa	smrt	None
geelka	deva	Nan
geeriyooday	umro	None
geeriyoodey	umro	None
geeriyootay	pokojnik	Nan
gees	ivica	None
geesi	engleski	None
geesinimo	hrabrost	None
geesiyaashii	heroji	Nan
geeska	ugao	None
geeriyoodeen	su	None
dheeraasamaale	dugo	None
gaarkiisa	njegovo	None
gaarin	pristup	None
fara	početi	Nan
faraaciinta	svoje	None
faraana	ime	None
farabadan	mnogi	None
farac	seme	Nan
faragelin	se	None
farah	daleko	None
faraha	prstiju	Nan
faransiis	francuski	None
faransiisk	francuski	None
faransiiska	francuski	None
faransiisku	francuski	None
faras	konj	None
faraska	konj	None
faraskii	konj	None
far	daleko	None
farasku	konj	None
faqiiq	klauzula	Nan
faqi	uska	Nan
falanqayno	diskusija	Nan
falastiin	palestina	Nan
falastiiniyiintu	palestinci	Nan
fale	crijep	Nan
faleedka	crijep	Nan
falidda	uzgoj	None
falka	akt	None
falkaab	akcija	None
fanaan	umjetnik	None
fanaanad	ventilator	Nan
fanaaniinta	umetnici	Nan
fanansuwela	fancy	Nan
fanka	umjetnost	None
faqashta	nesvijest	Nan
faqay	šapne	Nan
faqiih	faqih	Nan
farax	srećna	Nan
faraxsan	srećna	Nan
faraxsanahay	srećna	Nan
farshaxanka	umjetnost	None
farta	prst	Nan
farxad	sreća	Nan
farxeen	se	None
farxiyo	zadovoljstvo	Nan
fasax	otići	Nan
fashilmay	uspio	None
fasir	interpretirati	Nan
fasirtada	interpretacija	Nan
faso	proći	None
father	otac	None
feb	feb	Nan
febayaa	zarazni	Nan
febraayo	februaru	None
february	februar	None
farshaxan	umjetnost	None
farsamo	tehničke	None
farsamada	tehnologija	None
farraaciintii	vodi	None
faray	daleko	None
farayso	usmjereni	Nan
farcanmeen	seme	Nan
fardaha	konji	None
fardo	konji	None
fariin	poruka	None
fariistay	penzionisan	Nan
falalka	akcije	None
fariisto	sjedni	Nan
farmaajo	sir	None
farnnsiisku	farnishness	Nan
farnsiiku	smrzavanje	Nan
farnsiiska	francuski	None
farnsiisku	francuski	None
faro	prst	Nan
farqi	razlika	None
farlibaax	letjeti	Nan
falal	akcije	None
falaha	proizvođač	None
falaa	to	None
f	f	Nan
faadir	oproštaj	Nan
faadumo	tok	None
faafay	širenje	None
faafinta	širenje	None
faafiyeen	distribuiran	Nan
faafiyey	propagirali	Nan
faago	oproštaj	Nan
faah	detalji	Nan
faahfaahsan	detaljno	Nan
faaiidada	prednost	None
faaiido	dobitak	Nan
faaloota	komentar	Nan
faano	slava	Nan
faanoole	boksera	Nan
eyl	eyl	Nan
ey	ej	Nan
external	eksterni	Nan
express	izraziti	None
eryey	otpušteno	Nan
es	es	Nan
esperanto	esperanto	Nan
estoniya	estonija	None
et	et	None
ethiopa	ethiopa	Nan
ethiopia	etiopija	Nan
faanto	hvalisanje	Nan
ethopia	etopija	Nan
etoobiya	etiopija	Nan
europe	europa	Nan
european	evropski	None
ex	ex	Nan
example	primjer	None
exchange	razmjena	None
explorer	istraživač	None
ethopiakenya	ethopiakenya	Nan
federaal	savezni	Nan
faarax	sisati	Nan
faatikaan	kontekstu	None
fadligeeda	njena	None
fahamka	razumevanje	Nan
fahamno	razumiju	Nan
fahmaan	razumiju	Nan
fahmay	shvatio	Nan
fahmeen	shvatio	Nan
fahmeyna	nas	None
fahmeynaa	razumijemo	Nan
fahmi	razumiju	Nan
fahmin	ne	None
fahmo	razumiju	Nan
faisal	faisal	Nan
fakaday	pobegao	Nan
fakerayey	zamišljen	Nan
fal	djeluju	None
fadliga	milost	Nan
fadlan	te	None
fadhiyey	sat	None
fadhiyay	sjedio	Nan
faatikanaka	autogram	Nan
faatikanka	taktike	Nan
faca	iskopati	Nan
faculty	fakultet	None
facween	između	None
fadal	fad	Nan
fadhida	sjedeći	Nan
faarisiyiinta	farizeji	Nan
fadhido	sjedni	Nan
fadhiisimo	se	None
fadhiistay	sjesti	Nan
fadhiisto	sjedni	Nan
fadhino	sjedni	Nan
fadhiso	sjedni	Nan
fadhiya	sjedeći	Nan
fadhiyaa	sjedeći	Nan
fadhiisan	sjedni	Nan
gaarka	privatni	None
federaalka	savezni	Nan
fekaray	misao	None
fuula	na	None
fuulay	se	None
fuuli	se	None
g	g	Nan
ga	će	None
gaab	kratko	None
gaabaha	šorc	Nan
gaaban	kratko	None
gaabiyaa	sporo	None
gaabiyo	sporo	None
gaacuur	jelen	Nan
gaadha	doseže	Nan
gaadhaa	doseže	Nan
gaadhay	posegnula	Nan
gaadhaya	posezanje	Nan
future	budućnost	None
gaadhayaan	posegnuti	Nan
fursadaha	mogućnosti	None
furqaan	brazda	Nan
fudud	jednostavno	None
fududaanta	jednostavnost	Nan
fududeeyay	olakšano	Nan
fulay	kukavički	Nan
fuley	kašalj	Nan
full	pun	None
fura	otkriti	Nan
furaat	ključ	None
furaha	ključ	None
furan	otvorena	None
furay	otvorio	Nan
furayaasha	ključeve	Nan
furayo	otključava	Nan
fureen	cvijet	None
furo	otvorena	None
fursad	prilika	None
gaadhayo	posegnuti	Nan
gaadhaysaa	ruku	None
gaadheen	posegnula	Nan
gaandi	banda	Nan
gaar	privatni	None
gaara	doseg	Nan
gaaraa	doseže	Nan
gaaraayo	posezanje	Nan
gaarane	ruku	None
gaaray	posegnula	Nan
gaaraya	doseg	Nan
gaarayaan	doseg	Nan
gaarayo	posezanje	Nan
gaareen	posegnula	Nan
gaareeso	ruku	None
gaarey	posegnula	Nan
gaareysa	posezanje	Nan
gaari	vozilo	Nan
gaalo	nevernici	Nan
gaalkacyo	nevernici	Nan
gaalkacayo	nevjernik	Nan
gaalkaan	ovaj	None
gaadhin	nije	None
gaadho	doseg	Nan
gaadhsiinayeen	prenijeti	Nan
gaadhsiinlahayd	ruku	None
gaadhsiisanayd	posegnula	Nan
gaadhsiisnayd	posegnula	Nan
gaadhsiiya	prenijeti	Nan
from	od	None
gaadhsiiyaan	prenijeti	Nan
gaadiid	prevoz	Nan
gaadiidka	saobraćaja	None
gaagaaban	ukratko	None
gaajo	glad	Nan
gaal	nevjernik	Nan
gaalada	nevernici	Nan
gaaljecel	onesviješten	Nan
gaadhsiiyey	preneo	Nan
friesland	friesland	Nan
frequency	frekvencija	None
free	besplatno	Nan
fiidshe	sranje	Nan
fiil	utikač	Nan
fiiq	oštar	Nan
fiiri	pogledaj	Nan
fiirino	gore	None
fiiriyo	pogledaj	Nan
fiiro	pogledaj	Nan
fikrad	ideja	None
fikrada	misao	None
fiktoriya	misao	None
filaan	odjednom	Nan
filaanka	blic	Nan
filaayaa	očekivano	Nan
filan	dosta	None
filayo	očekivano	Nan
fiidow	veče	Nan
fiid	večeri	None
fiicanna	dobro	None
fiican	dobro	None
femmes	femmes	Nan
ferde	ferde	Nan
feysal	datoteka	None
ficil	akcija	None
ficilku	akcija	None
fiday	širenje	None
fideen	raširiti	Nan
fileyn	neočekivano	Nan
fidin	širenje	None
fidinta	istezanje	None
fiditaankii	širenje	None
fidiyey	ispružen	Nan
fido	fido	Nan
fidsan	stan	Nan
fidsantahay	stan	Nan
field	polje	None
fidinka	širenje	None
feerfeer	boksera	Nan
fille	obezglavljen	Nan
filmada	filmova	None
fool	lice	None
foolka	lice	None
foolmaroodi	bjelokosti	Nan
foore	se	None
for	za	None
forces	snage	None
forgotten	zanemaren	Nan
form	forma	None
four	četiri	None
franchwadnkan	ovu	None
fransiiska	francuskoj	None
fransiisku	francisco	None
français	français	Nan
françois	françois	Nan
frasiiska	trenje	None
foodhida	plače	Nan
fogfog	daleko	None
fogeyn	udaljenosti	None
fogeeyaan	skloniti	Nan
filmaha	filmova	None
finland	finska	None
finnishakana	finci	Nan
fiqi	teologija	Nan
fiqiga	teologija	Nan
fircoon	aktivan	None
firefox	firefox	None
film	film	None
firfircoon	aktivan	None
firkoodi	raštrkati	Nan
first	prvo	None
fog	daleko	None
fogaa	daleko	None
fogaadaa	izbegavajte	Nan
fogaado	se	None
fogaayeene	su	None
firfircooni	aktivan	None
يوسف	يوسف	Nan
