$	$	Nan
naftu	iho	Nan
naga	àwa	Nan
nagaaday	farada	Nan
nageeye	ẹrun igi pẹlẹbẹ	Nan
nagiba	nọmba	Nan
naginimada	ire-inu	Nan
nagornokarabakh	usornokarabakh	Nan
nagu	si wa	Nan
naguma	bẹni awa	Nan
nahay	a wa	Nan
nahaye	haha	Nan
nahey	nahey	Nan
nairobi	nàìjíríà	None
najaashi	ṣaja	Nan
nala	pelu wa	Nan
naftooda	awọn funrararẹ	Nan
nalaga	lati ọdọ wa	Nan
naftiisa	iho	Nan
naftay	funrarami	Nan
nacas	aṣiwère	Nan
nacay	korira	Nan
nacayb	korira	Nan
nadar	nadar	Nan
nadarkana	o ma binu	Nan
nadarkaygii	àwọn ẹ̀jẹ́ mi	Nan
nadarkii	rosary	Nan
nadarkiisii	rẹ	None
nadii	wa	Nan
nadiif	mọ	Nan
nadiifsan	mọ	Nan
nadray	binu	Nan
naf	ọkàn	Nan
nafta	ọkàn	Nan
naftana	funrarami	Nan
naftii	iho	Nan
nalagu	pelu wa	Nan
naloo	a wa	Nan
nambiya	nambar	Nan
naxariistaha	alaanu	Nan
naxariistee	jẹ oninurere	Nan
naxariistii	aanu	None
naxariisto	aanu	None
naxwaha	èdè grámà	Nan
naxwe	èdè grámà	Nan
nayjeeriya	ibanujẹ	Nan
nayroobi	dakẹ	Nan
ne	jẹ	Nan
nearby	nitosi	None
nebal	ọmọ	None
nebi	woli	Nan
nebiga	woli naa	Nan
nebigu	woli naa	Nan
nebinimda	nebinimda	Nan
naxariista	aanu	None
naxariis	aanu	None
naxaawiga	bugbamu	Nan
nato	adaru	Nan
nancy	nancy	Nan
naqay	iyin	Nan
nasab	sinmi	Nan
nasabka	atẹgun	Nan
nasabkii	ayanmọ	Nan
nasahnaa	sinmi	Nan
nasiib	orire daada	Nan
nabiyullaahi	nabilahulhihi	Nan
nasir	ti imu	Nan
nasri	nasri	Nan
nataashi	gba	None
natiijada	esi ni	Nan
nation	orílẹ-èdè	Nan
national	orilẹ-ede	Nan
nationlink	orilẹ-ède	Nan
nations	awọn orilẹ-ede	Nan
nasoo	kọja siwaju	Nan
necbaa	korira	Nan
nabiyadii	awọn woli	Nan
nabigii	woli naa	Nan
muuqaallada	awọn aworan	Nan
muuqanayey	ifarahan	Nan
muuqata	han	Nan
muuqatay	han	Nan
muuqato	han	Nan
muuqda	han	Nan
muuqdaan	han	Nan
muuqday	han	Nan
muuse	lati mu ṣẹ	Nan
muusig	orin	Nan
muwaadiniinta	ara ilu	Nan
muxamadna	muhammad	Nan
muxamadun	muhammed	Nan
muxamed	muhammed	Nan
muxamedna	muhammad	Nan
muuqaalka	hihan	Nan
muxammed	muhammad	Nan
muumin	muumin	Nan
muujiyeen	ti ṣalaye	Nan
mustafa	mustafa	Nan
mustaqbalka	ojo	None
mustaxiil	itumọ	Nan
musuq	ibajẹ	Nan
musveni	musveni	Nan
mutaystay	tọsi o	Nan
mutaystayee	o tọ si o	Nan
muujinaya	fifihan	None
muujinayaa	fihan	None
muujinayo	fifihan	None
muujinaysa	fifihan	None
muujinaysaa	fihan	None
muujisay	han	Nan
muujiyaa	han	Nan
muujiyaha	oluyaworan	Nan
muujiyey	han	Nan
muxudiin	muxdinin	Nan
muxumad	ikini	Nan
muxumed	muxumed	Nan
nabada	alafia	Nan
nabadda	alafia	Nan
nabaddayn	pẹlẹ o	Nan
nabadgalyadiisa	rẹ	None
nabadgalyadiisana	rẹ	None
nabadgalyo	o dabọ	Nan
nabadgelyada	aabo	Nan
nabadgelyadiisa	rẹ	None
nabadgelyo	o dabọ	Nan
nabadoon	pẹlẹ o	Nan
nabadoonka	pẹlẹ o	Nan
nabi	nabi	Nan
nabiga	woli naa	Nan
nabigeeniina	ojise wa	Nan
nabigeennii	ojise wa	Nan
nabad	alaafia	None
naasiruddiin	o jẹ onibajẹ	Nan
naasahablood	awọn opolo	Nan
naasaha	ọyan	Nan
muxumud	muhumud	Nan
muxuu	kini	Nan
muxyadiin	muhdiinin	Nan
mxaad	kẹta	None
na	pẹlu	Nan
naa	paapaa	None
naacaw	igbe	Nan
nabinimada	ojise	Nan
naad	ọgọ	Nan
naagta	obinrin naa	Nan
naanaysaa	inagije	Nan
naanaysi	inagije	Nan
naanaysta	inagije	Nan
naar	naar	Nan
naarta	náà	None
naasa	igbaya	Nan
naag	obinrin	Nan
necebyahay	mo korira re	Nan
nederlaan	dutch	Nan
nederland	awọn nẹdalandi naa	Nan
noqoneysa	lati jẹ	Nan
noqoshadii	padà	Nan
noqoshadiisa	rẹ	None
noqotaa	di	Nan
noqotay	di	Nan
noqotayna	o si di	Nan
noqotey	ti di	Nan
noqoto	jẹ	Nan
noqoy	jẹ	Nan
north	ariwa	Nan
norway	norway	Nan
norwey	ni norway	Nan
not	kii ṣe	Nan
nov	aramada	Nan
november	oṣu kọkanla	Nan
noqonaysa	lati jẹ	Nan
nqoto	nito	Nan
noqonayaa	di	Nan
noqon	jẹ	Nan
nooli	wa laaye	Nan
nooluhu	ngbe	Nan
noolyahay	laaye	Nan
noolyihiin	laaye	Nan
nooshahay	wa laaye	Nan
noqatay	ti di	Nan
noqdaa	di	Nan
noqdaan	jẹ	Nan
noqday	di	Nan
noqdee	jẹ	Nan
noqdeen	ti di	Nan
noqdey	ti di	Nan
noqdo	jẹ	Nan
noqnoqda	tun	Nan
noqo	jẹ	Nan
noqonaayo	jẹ	Nan
nso	nitosi	None
nsoafrika	afirika	Nan
nsoamerika	amẹrika	Nan
o	o	Nan
obama	obama	Nan
ocean	okun	Nan
october	oṣupa	Nan
octwaxaa	oct	Nan
oday	atijọ	Nan
odayaal	àwọn alàgbà	Nan
odayaasha	awọn alagba	Nan
odayaashii	awọn alagba	Nan
odayga	arugbo	Nan
odaygii	atijọ	Nan
odeyga	alàgbà	Nan
odeygii	awọn ti o ti kọja	Nan
odhan	sọ	None
odhanaya	asọye	Nan
nuux	ẹran	Nan
nuurka	ina	Nan
nuuraaya	itanna	Nan
nuur	ina	Nan
nsodjibouti	tuntunodjibouti	Nan
nsoeritrea	awọn diẹ	Nan
nsoethiopia	nitosi	None
nsofora	ojúlùmọ̀	None
nsojesu	atẹle	Nan
nsorussia	nsorussia	Nan
nsosekriste	bíṣọ́ọ̀bù	Nan
noole	laaye	Nan
nsosomalia	nearsomalia	Nan
nugaaleed	sugaleed	Nan
number	nọmba	Nan
nur	nur	Nan
nuri	nuri	Nan
nuuc	oriṣi	Nan
nuun	nu	None
nuunka	awọn nuke	Nan
nugaal	muyan	Nan
noolaha	ẹkọ oniye	Nan
noolaashaha	ngbe	Nan
noolaanooyaan	wa laaye	Nan
nimaan	okunrin	None
nimada	ọkọ	Nan
niman	okunrin	None
nimanka	okunrin	None
nimankii	awọn ọkunrin	Nan
nimanyahow	eyin	None
nimca	oore-ofe	Nan
nimcada	oore-ofe	Nan
nimcooyin	oore-ofe	Nan
nin	ọkunrin	Nan
ninba	eyikeyi	Nan
ninka	ọkunrin na	Nan
ninkaa	ọkunrin na	Nan
ninkaan	ọkunrin yii	Nan
ninkaani	ọkunrin yii	Nan
niisa	ikunku	Nan
niil	nil	Nan
nihon	nihon	Nan
niger	niger	Nan
neef	ìmí	Nan
neefka	ìmí	Nan
neh	neh	Nan
nelson	nelson	Nan
net	àwọn	Nan
network	nẹtiwọọki	Nan
networks	awọn nẹtiwọki	Nan
ninkaas	ọkunrin yẹn	Nan
new	tuntun	None
newspaper	iwe iroyin	Nan
nfd	nfd	Nan
nibiga	nira	Nan
nicolas	nicolas	Nan
nidaam	eto	Nan
nidaamka	eto	Nan
nidaamkii	awọn eto	Nan
news	awọn iroyin	Nan
mustacmarad	ojo	None
ninkan	ọkunrin yii	Nan
ninki	ilọpo meji	Nan
noloshooda	aye won	Nan
noo	àwa	Nan
nooc	too	Nan
nooca	oriṣi	Nan
noocan	irú	Nan
noocyada	awọn oriṣi	Nan
noocyadeeda	rẹ	None
nooga	àwa	Nan
noogu	fun	None
nool	laaye	Nan
noolaa	gbé	None
noolaadaan	wa laaye	Nan
noolaado	laaye	Nan
noolaan	wa laaye	Nan
noolaanooyaa	laaye	Nan
noloshiisii	rẹ	None
noloshiisa	rẹ	None
nolosha	igbesi aye	Nan
nololeedkii	ti igbesi aye	Nan
ninkii	ọkunrin na	Nan
ninna	kankan	None
ninnimo	agba	None
nirig	nirig	Nan
nisaar	fifẹ	Nan
nk	idite	Nan
nl	nl	Nan
ninkase	sibẹsibẹ	Nan
nnk	nnk	Nan
no	rárá	Nan
noa	áì	Nan
nobad	rárá	Nan
nofeembar	oṣu kọkanla	Nan
nolol	igbesi aye	Nan
nololeed	ti igbesi aye	Nan
nololeedka	igbesi aye	Nan
nnkh	nnkh	Nan
mussolini	mussolini	Nan
muslinka	muslim	Nan
muslin	muslin	Nan
maysara	mọ	Nan
mayso	ko	None
md	md	Nan
medicine	òògùn	Nan
mediina	agbedemeji	Nan
meel	ibi	Nan
meela	e dupe	Nan
meelaha	àwọn ibò	Nan
meele	e dupe	Nan
meeleeyaha	fi	None
meelihii	awọn aye	Nan
meelo	àwọn ibò	Nan
meeqa	elo ni	Nan
meesha	ibi	Nan
meeshaan	nibi	Nan
maysan	kiise	Nan
meeshaas	ní	None
mayo	mayo	Nan
mayl	maili	Nan
maxkamad	kootu	Nan
maxkamada	kootu	Nan
maxkamadaha	awọn kootu	Nan
maxkamaduhii	awọn kootu	Nan
maxkamaduhu	awọn kootu	Nan
maxmed	maxmed	Nan
maxmiyadda	kootu	Nan
maxsuulkii	esi ni	Nan
maxéd	max	None
may	le	None
maydh	wẹ	Nan
maydka	ara	Nan
mayeelan	maṣe	Nan
mayeelayo	ko	None
maygaag	boya	Nan
maynee	ki	None
meeshan	ibi yii	Nan
meeshay	aaye mi	Nan
meeshii	ibi	Nan
midabka	awọ	Nan
midawga	apapọ	Nan
midawgaas	idapo yẹn	Nan
midawgii	apapọ	Nan
midda	oun	None
middelburg	middelburg	Nan
middi	ibid	Nan
mideeyaan	iparapọ	Nan
mideeyay	isọdọkan	Nan
mideeyo	iparapọ	Nan
mideysan	isọdọkan	Nan
midha	eso	Nan
midig	ni ọtun	Nan
midka	oun	None
midkii	oun	None
midab	awọ	Nan
midaan	eyi	Nan
mida	ọkan	Nan
mid	ọkan	Nan
meeshuu	nibikibi ti	Nan
meeyadii	ibi	Nan
meheriyey	emi	Nan
meksiko	meksiko	None
melateri	ologun	Nan
melez	melez	Nan
mengista	mengista	Nan
maxed	maxed	Nan
mesopotamia	mesopotamia	Nan
mi	emi	Nan
micnaha	itumo	None
micnaheeda	ọna	Nan
micnaheedu	itumo	None
micnihiisu	itumo	None
micno	itumo	None
microsoft	microsoft	Nan
meters	awọn mita	Nan
maxay	kini	Nan
maxamuude	max	None
maxamuud	mahmoud	Nan
masaajid	mọṣalaṣi	Nan
masaajida	mọṣalaṣi	Nan
masaajiddada	mọṣalaṣi	Nan
masaajidka	mosalasi naa	Nan
masaajidkii	mọṣalaṣi	Nan
masaajido	mọṣalaṣi	Nan
masaakiinta	talaka	None
masaayda	owe	Nan
masagada	oka	Nan
masagawaay	ko	None
masalle	masala	Nan
masar	masar	Nan
masarayuu	masaruuu	Nan
maseyr	owú	Nan
mash	mash	Nan
masaafo	jinna	Nan
masaafada	jinna	Nan
maryeenta	wíwọ	Nan
maryan	màríà	Nan
marta	ni akoko yi	Nan
martabada	okiki	Nan
martay	lọ	Nan
martgelinta	aalejò	Nan
marti	àlejò	Nan
martida	awon alejo	Nan
martigelis	aalejò	Nan
mashquul	nṣiṣe lọwọ	Nan
martiqaad	ifiwepe	Nan
marwaan	nigbakugba	Nan
marwo	iyaafin	Nan
marx	odo	Nan
marxalad	kan	None
marxaladihii	ipele	None
marxuum	kú	Nan
maryam	màríà	Nan
marto	maranti	Nan
midkiin	ọkan ninu nyin	Nan
mashruuc	kan	None
masiix	kristi	Nan
matalan	fun	None
matter	ọrọ	Nan
mauritania	mauritania	Nan
maxaa	kini	Nan
maxaad	kini	Nan
maxaakiimta	adajọ	Nan
maxaan	kini?	Nan
maxaas	kini	Nan
maxamad	kootu	Nan
maxamadow	maxima	Nan
maxamed	maxamed	Nan
maxamedaay	? o? ù?	Nan
maxamedow	mohamed	Nan
maxammed	maxammed	Nan
maxamud	maxamud	Nan
matabaan	eebi	Nan
mataan	ibeji	None
masuuliyaddii	ojuse	None
masuuliyad	ojuse	None
masiixiga	onigbagb.	Nan
masiixiyad	kristiẹniti	Nan
masiixiyiintu	awọn kristeni	Nan
masjid	mọṣalaṣi	Nan
masjidka	mọṣalaṣi	Nan
masjidul	mọṣalaṣi	Nan
maskax	lokan	Nan
mashruuca	ise agbese na	Nan
maskaxda	lokan	Nan
maslax	maslah	Nan
maslaxad	fun	None
masno	imo	Nan
masraxa	ipele	None
massagada	ifọwọra	Nan
massare	masseuse	Nan
masuul	lodidi	Nan
maskaxdii	lokan	Nan
odhane	gbogbo ibi	Nan
midkod	boya	Nan
midnimada	isokan	Nan
mudanahay	a yẹ	Nan
mudane	sir	Nan
mudar	abẹrẹ	Nan
mudda	asiko	Nan
muddad	asiko	Nan
muddadii	asiko	Nan
muddo	asiko	Nan
mudhalib	mutibib	Nan
mudo	asiko	Nan
mudrik	mudrik	Nan
mudug	mudug	Nan
mudulood	squats	Nan
mufti	mufti	Nan
mug	iwọn didun	Nan
mugdi	dudu	Nan
mudan	tọsi	Nan
mugga	iwọn didun	Nan
mudaharaado	ifihan	Nan
mudadii	asiko	Nan
moxamed	mohamed	Nan
moxamud	mohammed	Nan
mozilla	mozilla	None
mp	mp	Nan
mr	mr	Nan
mualif	abidi	None
mucaarad	àtakò	Nan
mucaaradadiyå	náà	None
mucaaradka	àtakò	Nan
mucaaradku	àtakò	Nan
mucaaridka	àtakò	Nan
mucjisa	iyanu	Nan
mucjiso	iyanu	Nan
mudada	asiko	Nan
mudadi	abẹrẹ	Nan
mudaharaadka	awọn ifihan	Nan
muhammed	muamu	Nan
muhiim	pataki	Nan
muhiima	pataki	Nan
murusade	iparun	Nan
musaanbiiq	ayanmọ	Nan
musanbiig	olorin	Nan
musdalifa	muslimifa	Nan
muse	imuse	Nan
musha	sanwo	Nan
mushaar	sanwo	Nan
musharaxa	oludije	Nan
musharaxnimada	oludije	Nan
muslim	muslim	Nan
muslimay	gba	None
muslimiin	muslim	Nan
muslimiinta	awọn musulumi	Nan
muslimka	muslim	Nan
muslimku	awọn muslim	Nan
murtida	awọn iṣan	Nan
murti	murti	Nan
mursal	mursal	Nan
murra	pa	Nan
muhiimada	pataki	Nan
muhiimka	pataki	Nan
muhiimsan	pataki	Nan
mujaaahidka	mujahid	Nan
mujaahidiinta	awọn mujahideen	Nan
mujaahidiintii	awọn mujahideen	Nan
mujaddidka	si mosalasi	Nan
mowliid	tẹ si apakan	Nan
mukhtaar	mukhtaar	Nan
munaasibada	ayeye	Nan
munaasibadaasi	lori ayeye naa	Nan
muqawim	muqwim	Nan
muqbil	akan	Nan
muqdisho	mogadishu	Nan
muqdishu	mogadishu	Nan
muran	ariyanjiyan	Nan
mukulaal	o nran	Nan
movement	ronu	Nan
most	julọ	Nan
moskow	ẹṣoki	Nan
milatari	ologun	Nan
milatariga	ologun	Nan
milateri	ologun	Nan
milateriba	ologun	Nan
milateriga	ologun	Nan
milaterigu	ologun	Nan
militari	ologun	Nan
militariga	ologun	Nan
milkiilaha	to	None
millateriga	ologun	Nan
milyan	million	Nan
min	min	Nan
mina	mina	Nan
minaaradii	ile-iṣọ	Nan
mindhaa	boya	Nan
miiska	tabili	None
miisaanka	iwuwo	Nan
miisaan	iwuwo	Nan
miiroon	micron	Nan
midnimadii	isokan	Nan
midnimo	isokan	Nan
midoobay	isọdọkan	Nan
midoobaywaxa	apapọ	Nan
midoobeen	isọdọkan	Nan
midoobidii	apapọ	Nan
midoobo	apapọ	Nan
miracas	eyi ni	Nan
midow	apapọ	Nan
midowgaasi	idapo yẹn	Nan
midtahay	ti o ba wa	Nan
midyihiin	isọdọkan	Nan
miigagii	ọkọ mi	Nan
miiggan	miiggan	Nan
miilaadiga	otutu	None
miimka	gbe	None
midowga	apapọ	Nan
midna	kò si	Nan
miraha	awọn irugbin	Nan
mirfle	yi pada	Nan
moobiilada	awọn foonu alagbeka	Nan
mood	njagun	Nan
moodaa	o dabi pe	Nan
moodaaye	asiko	Nan
mooday	ro	None
moodey	ronu	Nan
mooge	agba	None
moomaahee	kini?	Nan
moos	banas	Nan
mooska	banas	Nan
mooyaane	ayafi ti	Nan
mooyaanehaddaba	ayafi ti dajudaju	Nan
mooyee	ayafi ti	Nan
mooyi	ayafi ti	Nan
more	diẹ sii	Nan
montenegro	montenegro	Nan
monako	monsoon	Nan
mohamud	mohamud	Nan
mohamed	mohamed	Nan
mirifle	yi pada	Nan
miroodka	eso	Nan
mirro	yiyi	Nan
mise	tabi	None
miskiga	talaka	None
misna	mána	Nan
mitterrand	mitterrand	Nan
mire	ẹru	Nan
miyaa	se beeni?	Nan
miyi	t’olofin	Nan
miyiga	igberiko	None
miyuu	se beeni?	Nan
mobile	alagbeka	Nan
mobiles	mobiles	Nan
module	module	Nan
mogadisho	mogadishu	Nan
miyaan	ṣé mo lè?	Nan
marshey	marshey	Nan
odhanjiray	wi	Nan
odiweyn	tobi	Nan
qofkaste	gbogbo eniyan	Nan
qofkii	fun	None
qofku	eniyan	Nan
qofna	enikeni	Nan
qolo	idile	Nan
qoob	jó	Nan
qoomido	banujẹ	Nan
qoomiyado	ibanuje	Nan
qoonedhangaloowbeydaaniyo	familyonedborg	Nan
qoor	ọrùn	Nan
qoqobnaan	ìyàraẹniṣọtọ	Nan
qora	kikọ	Nan
qoraa	onkọwe	Nan
qoraaga	onkọwe	Nan
qoraagii	onkọwe	Nan
qofkasta	gbogbo eniyan	Nan
qoraal	kikọ	Nan
qofkale	elomiran	Nan
qofba	fun	None
qiyaasay	wọn	None
qiyaasi	fojuinu	Nan
qiyaaso	fojuinu	Nan
qiyaasta	doseji	Nan
qiyaastii	feleto	Nan
qiyidaaq	idalare	Nan
qm	qm	Nan
qod	ma wà	Nan
qodaal	ma wà	Nan
qoday	gbẹ́	Nan
qodiddii	ìgbín	Nan
qodin	ma wà	Nan
qodob	nkan	None
qodobka	nkan	None
qof	eniyan	Nan
qofka	eniyan naa	Nan
qoraalada	awọn ọrọ	Nan
qoraaladii	awọn ọrọ	Nan
qoraalka	ọrọ	Nan
qorituurkii	atijọ	Nan
qorituurkuna	oorun	Nan
qoro	kọ	Nan
qorshahan	ninu ero yii	Nan
qorshe	gbero	Nan
qoryo	igi	Nan
qoryooley	onigbese igi	Nan
qosol	rerin	Nan
qoto	ijinle	Nan
qowmiyada	omo ilu	Nan
qoys	idile	Nan
qoyska	idile	Nan
qoyskii	ẹbi	Nan
qubbi	iwẹ	Nan
qubo	tú	None
qorista	kikọ	Nan
qorigii	ibon	Nan
qorida	kikọ	Nan
qori	kọ	Nan
qoraalkaan	yi ọrọ	Nan
qoraalkan	arokọ yi	Nan
qoraalkii	ọrọ	Nan
qoraalo	awọn ọrọ	Nan
qoraan	kọ ọ	Nan
qoraha	onkọwe	Nan
qoran	kọ	Nan
qiyaasaa	wọn	None
qorax	oorun	Nan
qoraxeey	sun	None
qoraxey	sun	None
qoray	kọ	Nan
qore	onkọwe	Nan
qoreen	kọ	Nan
qoremaxamed	kọ mohammed	Nan
qorey	kọ	Nan
qoraxda	oorun	Nan
qubrista	iwẹ	Nan
qiyaasa	ìwọn	Nan
qiyaame	ajinde	Nan
qaybkamida	apakan	Nan
qaybo	awọn ẹya	Nan
qaybood	awọn apakan	Nan
qaybqaateen	kopa	Nan
qaybsaday	pin	Nan
qaybsantaa	pipin	Nan
qaybsantahay	pin	Nan
qaybsha	onipin	None
qaybta	apakan	Nan
qaybtan	abala	None
qaybtii	apakan naa	Nan
qayka	ninu igbo	Nan
qayraadkiisa	rẹ	None
qeebaha	awọn ẹya	Nan
qeebiyay	ṣàpèjúwe	Nan
qaybiyaa	awọn kaakiri	Nan
qeebood	awọn ẹya	Nan
qaybin	kaakiri	Nan
qaybaha	awọn apakan	Nan
qasaare	olofo	Nan
qasali	oje	Nan
qasbaa	ọranyan	Nan
qasbay	agbara	None
qasim	dapọ	Nan
qassem	rudurudu	Nan
qatar	qatar	Nan
qawmiyada	omo ilu	Nan
qaxay	sá lọ	Nan
qaxii	sisilo	Nan
qaxoontiga	asasala	Nan
qaxooti	asasala	Nan
qaxootiga	asasala	Nan
qayawoowgii	ni atijo	Nan
qayb	apakan	Nan
qaybgasho	lati lọ	Nan
qeebsama	ti pin	Nan
qeebsanaa	pin	Nan
qeexayey	apejuwe	Nan
qiimo	iye	Nan
qiiq	ẹfin	Nan
qilaafeen	kọ	Nan
qilaafsan	gba	None
qir	itewogba	Nan
qirayaa	gba	None
qireen	gba	None
qirista	itewogba	Nan
qiritaanka	ijewo	Nan
qiritaanku	ijewo	Nan
qisadaan	ninu itan yii	Nan
qisadan	itan yii	Nan
qisadii	itan	Nan
qisooyin	awọn itan	Nan
qiyaamaha	itan-akọọlẹ	Nan
qiimayn	iṣiro	Nan
qiimaha	iye	Nan
qibladeedii	iriri	Nan
qiblada	awọn qiblah	Nan
qeexaysaa	rẹ	None
qeeyb	apakan	Nan
qeyb	apakan	Nan
qeybaha	awọn ẹya	Nan
qeybisa	pinpin	Nan
qeybiya	kaakiri	Nan
qeybiyaa	awọn kaakiri	Nan
qiyaas	ìwọn	Nan
qeybiyey	pin	Nan
qeybood	awọn ẹya	Nan
qeybsaday	pin	Nan
qeybsan	pin	Nan
qeybta	apakan naa	Nan
qeybteeda	rẹ	None
qeyliye	o pariwo	Nan
qibdhiya	kigbe	Nan
qeybiyo	ipin	None
qubrus	kírúsì	Nan
qudaarta	ẹfọ	Nan
qudha	nikan	Nan
raqiisanyihiin	din	None
raran	haran	Nan
rash	ise ina	Nan
rashid	wa	Nan
rashiid	sling	Nan
raskambooni	awọn aworan	Nan
rasmi	osise	Nan
rasmiga	osise	Nan
rasuul	aposteli	Nan
rasuulka	apọsteli	Nan
rasuulkeennii	ojise wa	Nan
rasuulkii	apọsteli	Nan
rasuulkiisa	apọsteli	Nan
rasuulku	aposteli	Nan
rasuululaah	aposteli	Nan
raqiis	olowo poku	Nan
rate	oṣuwọn	Nan
raq	raq	Nan
rammadaan	ẹbẹ yi	Nan
raggii	awọn ọkunrin	Nan
raggiisiiye	rẹ	None
ragii	okunrin	None
ragow	okunrin	None
raiisalwasaare	adari igbimọ ijọba	Nan
raiisul	rudurudu	Nan
raisul	raisul	Nan
raisulwasare	raisulwasare	Nan
rajab	webs	Nan
rajada	ireti	Nan
rajaynayaa	mo nireti	Nan
rajeynayaa	lero ti o	Nan
rajiimkii	aṣojú	Nan
rajo	ireti	Nan
ramadaan	slam	Nan
ranges	awọn sakani	Nan
rati	rati	Nan
raxay	pa	Nan
raxmaan	rere	None
reerkiisa	ebi	None
reerkiisii	ebi	None
reerkooda	wọn	None
reernimada	atunbi	Nan
reero	ìdílé	Nan
regime	ijọba	Nan
region	ẹkùn	Nan
regions	awọn ẹkun ni	Nan
register	forukọsilẹ	Nan
release	itusilẹ	Nan
repubblica	repubblica	Nan
republic	olominira	Nan
rer	r	Nan
resolution	ipinnu	Nan
ri	ri	Nan
reerkiina	idile	Nan
reerka	idile	Nan
reergalbeedku	ìwọ oòrùn	Nan
reeraha	idile	Nan
rayaale	rayale	Nan
rayaan	ture	Nan
rayidka	alagbada	Nan
raysal	igbala	Nan
rc	rc	Nan
realtime	akoko gidi	Nan
recognition	idanimọ	Nan
ragga	okunrin	None
ree	ta	Nan
reebaana	fun	None
reebay	rara	Nan
reebban	ayafi	Nan
reebka	aṣẹ	Nan
reebo	ayafi	Nan
reer	idile	Nan
reera	idile	Nan
reeb	aṣẹ	Nan
ragaadisay	rẹ	None
raga	awon	Nan
rag	okunrin	None
qurxoon	lẹwa	Nan
qusa	bi won ninu	Nan
qusay	fiyesi	Nan
qusayi	tutu	Nan
quudhsadaye	o gàn	Nan
quudhsi	ẹgan	Nan
quudiyaah	akọbi	Nan
ra	ra	None
raaca	tẹle	Nan
raacaan	tẹle	Nan
raacay	tẹle	Nan
raacdey	tẹle	Nan
raaceen	tẹle	Nan
raacin	atẹle	Nan
raacineysaa	afikun	Nan
qurxan	lẹwa	Nan
quruxsan	lẹwa	Nan
quruxna	lẹwa	Nan
quruxda	ẹwa	Nan
qudus	mimọ	Nan
qumaatiga	auto	Nan
qura	nikan	Nan
quraan	kuran	Nan
quraanka	awọn koran	Nan
quraankiisa	rẹ	None
quraysh	quraysh	Nan
raaciyey	fi	None
qurayshtu	qurays	Nan
qurbac	idoti	Nan
qurbaha	odi	Nan
qurbajoogga	àwæn ará il.	Nan
qureysh	ounjẹ aarọ	Nan
qureysheed	a cook	Nan
qureyshtu	ọsan	Nan
qurux	lẹwa	Nan
qurba	rúbọ	Nan
qarsoon	farapamọ	Nan
raaco	tẹle	Nan
raacsanyahay	gba	None
raba	pin	Nan
rabaa	kekere	None
rabaan	fẹ	Nan
rabay	fẹ	Nan
rabbi	rabbi	Nan
rabbigiis	ehoro	Nan
rabiic	rabi	Nan
rabin	idaji	None
rabitaanka	ifẹ	Nan
rabo	ayanmọ	Nan
rabtay	fẹ	Nan
rada	rada	Nan
radio	redio	Nan
radius	ologbo	Nan
rafaadkii	awọn ijiya	Nan
raaxo	itunu	Nan
raaxeestaan	gbadun	Nan
raaxaysto	gbadun	Nan
raaxaystaan	gbadun	Nan
raad	kakiri	None
raadi	fun	None
raadiyo	redio	Nan
raadkaan	ipa yii	Nan
raadkii	kakiri	None
raadraaca	ipasẹ	Nan
raage	rirọ	Nan
raacsan	ọmọlẹyìn	Nan
raagge	lọra	Nan
raahibka	itunu	Nan
raali	binu	Nan
raalli	jowo	Nan
raascaseyr	apo apo	Nan
raashin	ounje	Nan
raaskambooni	kalokalo	Nan
raaxaysta	gbadun ara re	Nan
raahib	rp	Nan
qarsoodiya	aṣiri	Nan
qarsoodi	aṣiri	Nan
qarshe	ipari	Nan
part	apakan	Nan
parts	awọn ẹya	Nan
party	ẹgbẹ	Nan
paul	poul	Nan
period	asiko	Nan
peru	peru	Nan
petit	kekere	None
phone	foonu	Nan
phones	awọn foonu	Nan
photos	awọn fọto	Nan
political	oselu	Nan
pompidou	pompidou	Nan
port	ibudo	Nan
possible	ṣeeṣe	Nan
power	agbara	None
parliamentary	ile igbimọ aṣofin	Nan
price	owo	Nan
paris	paris	Nan
packet	soso	Nan
organized	ṣeto	Nan
orgi	org	Nan
orod	sáré	Nan
orodada	nṣiṣẹ	Nan
oromo	awon oromodie	Nan
osman	osman	Nan
osoble	agbelẹrọ	Nan
ossetia	ẹla	Nan
ostariya	australia	None
ot	àí	Nan
other	omiiran	Nan
outlook	iwoye	Nan
overview	akopọ	Nan
ow	ow	Nan
p	p	Nan
pakistaan	pakistan	Nan
primary	jc	Nan
private	ikọkọ	Nan
prof	ọjọgbọn	Nan
qaadan	mu	Nan
qaadanay	mu	Nan
qaadanaya	mu	Nan
qaadanaysaa	gba	None
qaadaneynaa	yoo	None
qaadanno	mu	Nan
qaadano	mu	Nan
qaadashada	mu	Nan
qaadataa	gba	None
qaadataan	mu	Nan
qaadatay	mu	Nan
qaadatey	mu	Nan
qaaday	mu	Nan
qaadaya	rù	Nan
qaadayaan	rù	Nan
qaadaan	gbe	None
qaadaa	gbejade	Nan
qaada	gbe	None
qaad	mu	Nan
professor	alamọdaju	Nan
protocol	ilana	None
provide	pese	Nan
province	igberiko	None
psu	psu	Nan
public	gbangba	Nan
punltand	punltand	Nan
org	org	Nan
puntland	puntland	Nan
qaab	apẹrẹ	Nan
qaababka	awọn ẹya	Nan
qaabiil	idile	Nan
qaabisho	gba	None
qaabka	apẹrẹ	Nan
qaabkan	ni ọna yii	Nan
qaabkii	apẹrẹ	Nan
puławy	puławy	Nan
oren	aja	Nan
ordayey	sáré	Nan
orday	sáré	Nan
oggolaa	gba	None
ognahay	a mọ	Nan
ogol	gba	None
ogolaaday	gba	None
ogolaan	gba	None
ogolaanaya	gbigba	Nan
ogolyahay	gba	None
ogosto	oṣu kẹjọ	Nan
ogsoon	jẹ mọ	Nan
ogsoonoow	jẹ mọ	Nan
ogtahay	se o mo	Nan
ogyahay	mọ	Nan
oktobar	oṣu kẹwa	Nan
oktober	oktober	Nan
oktoobar	oṣu kẹwa	Nan
ogeyn	mọ	Nan
ogayd	mọ	Nan
ogalaa	gba	None
ogadenya	gbigba	Nan
odoyaashii	àwọn alàgbà	Nan
of	ti	Nan
offer	ìfilọ	Nan
official	osise	Nan
og	àti	Nan
oga	àgbà	Nan
ogaadaan	mọ	Nan
olalihii	ipolongo	Nan
ogaaday	awari	None
ogaadey	awari	None
ogaado	ṣewadi	Nan
ogaal	mọọmọ	Nan
ogaato	ṣewadi	Nan
ogaayeen	mọ	Nan
ogaden	ṣaaju	Nan
ogadenia	o dabọ	Nan
ogaadeen	iwari	Nan
qaadayo	rù	Nan
olol	ina	Nan
ololeeyey	oluṣeto	Nan
ookorreeye	akorin	Nan
ool	ool	Nan
oon	ongbẹ	Nan
oona	ongbẹ	Nan
ooryeheer	àgbà	Nan
oow	beeni	Nan
ooy	sunkún	Nan
ooyaayoo	nsokun	Nan
operate	ṣiṣẹ	Nan
operators	awọn oniṣẹ	Nan
optional	iyan	None
or	tabi	None
oradadawaxa	lori iyara	Nan
oran	awọn ọran	Nan
oranjiray	ọsan	Nan
oohinta	nsokun	Nan
oohin	kigbe	Nan
oogista	ibanirojọ	Nan
oogaan	ade	Nan
ololihii	ipolongo	Nan
olombikada	olimpiiki	Nan
omaar	o dabọ	Nan
omar	odo	Nan
on	oun	None
one	ọkan	Nan
online	lori ayelujara	Nan
olole	ipago	Nan
only	nikan	Nan
oo	ati	Nan
ood	ood	Nan
ooda	ibori	None
oodhan	o dara	Nan
oodwayne	oodwayne	Nan
oofin	mu ṣẹ	Nan
ooga	ooga	Nan
ontorodeegaan	lori ayelujara	Nan
odhankaro	iwaju	Nan
qaadaysa	rù	Nan
qaade	olugbala	Nan
qadiimi	atijọ	Nan
qadiimiga	atijọ	Nan
qadiimisan	atijọ	Nan
qadiimka	atijọ	Nan
qadiimsan	atijọ	Nan
qafaashay	ẹlẹwọn	Nan
qalaad	alailẹgbẹ	Nan
qalaafe	olukọni	Nan
qalaaye	agbaye	None
qalab	èlò	None
qalabka	awọn ohun elo	Nan
qalabkoodi	wọn	None
qalad	aṣiṣe	Nan
qalalaase	rudurudu	Nan
qalbi	obi	Nan
qadiim	atijọ	Nan
qalbiga	okan	Nan
qadeeyey	ọsan	Nan
qadaro	iye	Nan
qabsadeen	ti tẹdo	Nan
qabsadeenwaxa	ti di mu	Nan
qabsado	yẹ	Nan
qabsashada	iṣẹ	Nan
qabsatay	ti tẹdo	Nan
qabtaa	ṣe	Nan
qabtaan	wọn	None
qabtay	waye	Nan
qabteen	di i mu	Nan
qabtey	waye	Nan
qabto	dimu	Nan
qadaafi	gadi	Nan
qadar	iye	Nan
qadarka	oye	Nan
qadarkaas	iye yẹn	Nan
qaddarka	oye	Nan
qalbigiisa	okan re	Nan
qalbigu	okan	Nan
qaldan	ko	None
qardho	kan	None
qare	elegede	Nan
qargistan	eyi	Nan
qariirada	maapu	None
qarin	tọju	Nan
qarinayaan	fipamọ	Nan
qarisay	fipamọ	Nan
qarni	iran	Nan
qarniga	iran	Nan
qarnigan	iran yii	Nan
qarnigii	orundun	Nan
qarniyadii	sehin	Nan
qarniyo	sehin	Nan
qarnka	iran	Nan
qarsado	farapamọ	Nan
qardaawi	dáàbò	Nan
qarannimada	t’orilẹ-ede	Nan
qaranku	orílẹ-èdè	Nan
qarankan	ni orilẹ-ede yii	Nan
qalday	ṣìnà	Nan
qaleel	gbẹ	Nan
qalin	kan	None
qamadi	alikama	Nan
qamadiga	alikama	Nan
qanacsanyihiin	itelorun	Nan
qandala	agberaga	Nan
qabsaday	gba	None
qaraar	kikoro	Nan
qaraha	elegede	Nan
qaramada	awọn orilẹ-ede	Nan
qarameynayay	ti n ja	Nan
qaran	orílẹ-èdè	Nan
qaranf	orílẹ-èdè	Nan
qaranimada	t’orilẹ-ede	Nan
qaranka	orílẹ-èdè	Nan
qarad	bugbamu	Nan
qabrigiisa	rẹ	None
qabrigii	sàréè	Nan
qabriga	sàréè	Nan
qaangaar	agba	None
qaanuunka	ofin	None
qaar	diẹ ninu	Nan
qaarad	kọntinia	Nan
qaarada	kọntinia	Nan
qaaradaha	awọn aye	Nan
qaaradda	kọntinia	Nan
qaaradood	awọn aye	Nan
qaarba	si ọkan miiran	Nan
qaarda	diẹ ninu	Nan
qaarkale	awọn miiran	Nan
qaarkamida	diẹ ninu	Nan
qaarkood	diẹ ninu	Nan
qaarkoodna	wọn	None
qaarna	awọn miiran	Nan
qaamuusyada	itumo	None
qaamuuskan	iwe atumọ yii	Nan
qaamuuska	iwe itumọ	Nan
qaamuus	iwe afọwọkọ	Nan
qaadeen	mu	Nan
qaadey	mu	Nan
qaadi	yẹ	Nan
qaadidda	yiyọ	Nan
qaadiga	adajọ	Nan
qaadiriyada	awọn adajọ	Nan
qaadku	ẹyọ	Nan
qaas	pàtó	Nan
qaadno	gba	None
qaadtay	mu	Nan
qaadye	apanirun	Nan
qaali	gbowolori	Nan
qaalib	ololufe	Nan
qaaliga	ololufe	Nan
qaalin	ololufe	Nan
qaalisan	gbowolori	Nan
qaado	gba	None
qaadday	mu	Nan
qaasim	pataki	Nan
qaataa	gba	None
qabay	iyawo	None
qabeelo	ẹya	Nan
qabeen	ní	None
qabey	iyawo	None
qabiil	idile	Nan
qabiilada	awọn ẹya	Nan
qabiiladaoogoozoo	qab counciloogoozoo	Nan
qabiilka	ẹya	Nan
qabiilo	ẹya	Nan
qabiilooyin	ẹya	Nan
qabo	ni	Nan
qaboow	tutu	Nan
qaboowdahay	o ti wa ni itura	Nan
qabow	tutu	Nan
qabridahare	ibojì	None
qabaw	tutu	Nan
qabatimay	afẹsodi	Nan
qabashadiisuna	mu yaworan	Nan
qabankarin	le	None
qaataan	mu	Nan
qaatay	mu	Nan
qaateen	gba	None
qaatey	gba	None
qaato	mu	Nan
qaba	àrùn	None
qabaa	ronu	Nan
qaata	olugba	Nan
qabaailada	awọn ẹya	Nan
qabaailkii	awọn ẹya	Nan
qabaal	ibùjẹ ẹran	Nan
qabaan	ni	Nan
qaban	ṣe	Nan
qabanayaa	n ṣe	Nan
qabanayaan	n ṣe	Nan
qabane	dimu	Nan
qabaailka	awọn ẹya	Nan
marsada	lọ nipasẹ	Nan
marqudha	aago	Nan
marooko	erin	Nan
kooxda	ẹgbẹ naa	Nan
kooxdii	ẹgbẹ naa	Nan
kooxo	awọn ẹgbẹ	Nan
kor	loke	Nan
koraaye	gbogbo ibi	Nan
koray	dàgbà	Nan
koraysaaye	kiise	Nan
kordhaha	pọ si	Nan
kordhi	pọ si	Nan
kordhinta	itẹsiwaju	Nan
kordhiyay	pọ si	Nan
kordhiyey	gbooro	Nan
kordhiyo	awọn amugbooro	Nan
kordhoban	pọ si	Nan
kordufan	pọ si	Nan
kooxaha	awọn ẹgbẹ	Nan
kore	ewe	None
koox	ẹgbẹ	Nan
kooshin	dajudaju	Nan
koofureed	guusu	None
koofurgalbeed	guusu	None
koofurta	guusu	None
koonfur	guusu	None
koonfurba	guusu	None
koonfurbari	guusu	None
koonfureed	guusu	None
koonfureedka	guusu	None
koonfureedna	guusu	None
koonfurta	guusu	None
koonfurtu	guusu	None
koonfurtuna	guusu	None
koontaroolla	iṣakoso	Nan
kooraha	awon ologbo	Nan
koosar	dajudaju	Nan
koowaad	akoko	Nan
korkeeda	rẹ	None
korkiisa	rẹ	None
korkooda	wọn	None
kugu	iwo	Nan
kugula	si ọ	Nan
kuguulaysatay	olubori	Nan
kuhadalaan	pàdé e	Nan
kuhadlaan	pàdé e	Nan
kuhanynta	tingling	Nan
kuhaysa	iwo	Nan
kujiraan	pẹlu	Nan
kujiray	to	None
kula	o dabọ	Nan
kulahaa	rí ẹ	Nan
kulahayd	o wa nibẹ	Nan
kulan	ipade	Nan
kulana	wo o	Nan
kulansiine	pàdé e	Nan
kufsi	ifipabanilopo	Nan
kufaa	ojo	None
kudhintay	ku	None
kudhaw	sunmọ	Nan
kormerin	lati ibere	Nan
korneel	kan	None
korneyl	dagba	Nan
korodhsanayn	ko	None
korontada	ina	Nan
koronto	ina	Nan
kororsi	awọn olukọni	Nan
koofur	guusu	None
korreeye	ga	Nan
kow	kọọkan	Nan
kowaad	akọkọ	Nan
ku	iwo	Nan
kubada	bọọlu	Nan
kubadda	bọọlu	Nan
kudhaqan	loju	Nan
kudhaqanto	adaṣe	Nan
korreeyetrololololololololololoibfhgidfgdufhgsdghdfbgdjbgdsjbgjsdbgjsbgjdfsklgkdsjfbgdfskbgdskjlbglkdfjbgkldfbgkdfbgkldsfbgskldfbgksldgblkdfsbglksdgbksdggggggggggb	topfetgloftfgggggffgggdfggbbkdlkkgbkklgkkggkkgfkggkkgfkgsgfggsggkggkkgfkgsgfggsggkggklgddggklgdggklgdggglgggklggdgggkglgggglgggglgggglggdlgggglggdlggggdggggggggglggglggglggglgglgglgglgglgglgglgglgglgglgglgglglglgglgglglgglglggts	Nan
kulayl	gbona	Nan
koofil	ijanilaya	Nan
kooda	wọn	None
kiristaan	awọn kristeni	Nan
kiristanka	awọn kristeni	Nan
kiristanku	rẹ	None
kismaayo	kismayo	Nan
kismaayobaydhabo	kismayoyou	Nan
kitaab	kan	None
kitaabka	iwe	Nan
kitaabkan	iwe yi	Nan
kitaabkii	iwe	Nan
klm	klm	Nan
km	km	Nan
kmg	kmg	Nan
knaan	kannan	Nan
knights	awọn ọbẹ	Nan
known	mo	Nan
kirishtaan	kristiẹni	Nan
koban	kobanu	Nan
kingdom	ijọba	Nan
kinaana	o ni	Nan
khuseyma	wulo	Nan
ki	nitorinaa ṣe	Nan
kibirka	igberaga	Nan
kibis	burẹdi	Nan
kibroo	agberaga	Nan
kici	dide	Nan
kii	k	Nan
kiiba	bọtini	Nan
kiikii	ki	None
kiimikaad	kẹmika	Nan
kiin	ọkan	Nan
kiina	olorun mi	Nan
kiinya	kinda	Nan
kilaab	kan	None
kililka	apa	Nan
king	ọba	Nan
kobash	idagba	Nan
kobcinta	afikun	Nan
kohay	kohay	Nan
koobantahay	lopin	Nan
koobantahy	lopin	Nan
koobanyahay	lopin	Nan
koobay	akopọ	Nan
koobaya	akopọ	Nan
koobayo	dakọ	Nan
koobayso	ṣoki	Nan
koobi	ẹda	Nan
koobkii	ago	Nan
koobmaa	murasilẹ	Nan
koobnaa	lopin	Nan
koobnaan	lakotan	Nan
koobnaayeen	ni opin	Nan
koobnayd	lopin	Nan
koobo	ife	Nan
kooban	lakotan	Nan
koobaadmarkii	rẹ	None
koobaad	akọkọ	Nan
koob	ife	Nan
kol	kól.	Nan
kolayga	apeere	Nan
koleyga	bọọlu inu agbọn	Nan
kolkaas	lẹhinna	Nan
kolkii	lẹẹkan	Nan
kolkuu	nigbawo	Nan
kollay	ani	Nan
koofi	ijanilaya	Nan
kolombiya	choroid	Nan
kolse	okùn	Nan
kolyga	kolyga	Nan
kombuyuutarka	kọmputa naa	Nan
komoros	comoros	Nan
konfur	tunto	Nan
kong	kong	None
kongo	kondomu	Nan
kolonbiya	ileto	Nan
kulaylkiiye	igbona	Nan
kuleel	gbona	Nan
kuleelka	gbona	Nan
laakiin	ṣugbọn	Nan
laakiinse	ṣugbọn	Nan
laakin	ṣugbọn	Nan
laalaaba	mejeeji	Nan
laalaayey	fun	None
laami	ale	Nan
laamiga	tarmac	Nan
laamka	ẹhin mọto	Nan
laan	ẹka	Nan
laanta	ẹka	Nan
laas	ọlẹ	Nan
laascaanood	pẹlu awọn wọnyi	Nan
laasgeel	rọ̀ mọ́	Nan
laashin	ẹka	Nan
laasqoray	dakọ	Nan
laah	lah	Nan
laasqorey	dakọ	Nan
laafyaha	egungun	Nan
laabteen	sẹhin	Nan
kuyaalla	se o	Nan
kuyaalo	yika	Nan
kuyihiin	se o	Nan
kuyimi	lati wa	Nan
kwazulunatal	alayeye	Nan
l	l	Nan
la	pẹlu	Nan
laa	kuro patapata	Nan
laaan	ẹka	Nan
laaana	lẹẹkansi	Nan
laaaneede	egba	None
laaanta	nibe	None
laaasaasay	lẹhinna	Nan
laabneyne	a nlo pada	Nan
laabtay	sẹhin	Nan
laadin	tapa	Nan
laasqpray	lasiqpray	Nan
laatiiniga	latini	None
laatiinka	latini	None
labaduba	awon mejeji	Nan
labashaqlanaha	adaakọ	Nan
labka	akọ	Nan
labo	meji	Nan
lacag	owo	Nan
lacagaha	awọn sisanwo	Nan
lacago	owo	Nan
lacagta	owo	Nan
lacagtaas	owo yen	Nan
lacagtan	owo yii	Nan
lacagtasi	owo yen	Nan
lacagteedii	owo re	Nan
lacagtii	ni owo	Nan
lacata	owo	Nan
ladaawdo	ṣe itọju	Nan
labadooda	awon mejeji	Nan
labadiisii	mejeeji	Nan
labadiisa	mejeeji	Nan
labadiiba	awon mejeji	Nan
laayay	pa	Nan
lab	lab	Nan
laba	meji	Nan
labaad	ikeji	Nan
labaadna	ikeji	Nan
labaatan	ogun	None
labaatanaad	ogun	None
kuyaala	yika re	Nan
labaatankii	ogun	None
labada	mejeeji	Nan
labadaa	mejeeji	Nan
labadaas	awọn meji	Nan
labadaasi	awon meji na	Nan
labadaba	mejeeji	Nan
labadan	awon meji	Nan
labadii	awọn meji	Nan
labad	mejeeji	Nan
kuyaal	ninu	Nan
kuxigeenka	igbakeji	Nan
kuwooda	wọn	None
kumanyaalkii	awọn ẹgbẹẹgbẹrun	Nan
kumaray	pọ	Nan
kumbuyuutar	kọmputa	Nan
kumbuyuutarada	awọn kọmputa	Nan
kumbuyuutarka	lori kọmputa	Nan
kumeel	fun	None
kumeelgaar	fun	None
kumeelgaarka	ni adele	Nan
kumurmay	nko mo	Nan
kun	iwo	Nan
kuna	kuna	Nan
kunool	wa laaye	Nan
kunoolyihiin	gbe	None
kuqoran	ṣe akojọ	Nan
kur	tun	Nan
kumanyaal	ẹgbẹẹgbẹrun	Nan
kumanaan	ẹgbẹẹgbẹrun	Nan
kuman	àjọ who	Nan
kumalahan	ko	None
kuleelkeeda	gbona	Nan
kuleh	gbona	Nan
kuliyada	kọlẹji	Nan
kuliyda	gbogbo	Nan
kulligood	gbogbo won	Nan
kulliyada	kọlẹji	Nan
kulliyadda	ni kọlẹji	Nan
kurdiska	awọn kurdi	Nan
kulma	pàdé	Nan
kulmeen	pàdé	Nan
kulmiye	akopọ	Nan
kulmo	pàdé	Nan
kulul	gbona	Nan
kulushahay	gbona	Nan
kuma	ati	Nan
kumaankun	ori	None
kulmay	pàdé	Nan
khuduub	adirẹsi	Nan
kurdistan	kurdistan	Nan
kusheetik	geometric	Nan
kuuriya	korea	Nan
kuusoow	kaabọ	Nan
kuusow	ṣuṣan	Nan
kuwa	awon na	Nan
kuwaa	awon na	Nan
kuwaaa	awon na	Nan
kuwaar	nibi	Nan
kuwaas	awon na	Nan
kuwaasi	awon na	Nan
kuwaasoo	àjọ who	Nan
kuwada	iwo	Nan
kuwait	kuwait	Nan
kuwan	iwọnyi	Nan
kuwii	awon na	Nan
kuwo	wọn	None
kuuma	ko	None
kuul	ileke	Nan
kuugu	si ọ	Nan
kuubaan	kuubu	Nan
kusii	wọle	Nan
kusoo	kọja siwaju	Nan
kusooduulay	ibẹ	Nan
kutaal	awọn ọwọn	Nan
kutaala	kọja siwaju	Nan
kutaalaa	o wa nibi	Nan
kutaalay	awọn ọbọ	Nan
kursiga	ijoko	Nan
kutaallo	awon tirela	Nan
kutubo	owuro kutukutu	Nan
kutubta	kutukutu	Nan
kutubtii	pẹ	Nan
kutubtiisa	ninu iwe re	Nan
kututbtii	kutukutu	Nan
kuu	fun	None
kuuba	kuba	Nan
kutub	ọrọ	Nan
khubdadii	fun	None
khubaro	awọn amoye	Nan
khubaraduna	ati awọn amoye	Nan
kadibna	ati igba yen	Nan
kadin	kaadi	Nan
kafadood	senti	Nan
kaftan	kan	None
kaga	fojuinu	Nan
kagsoo	fi	None
kahadhay	binu	Nan
kahelay	rẹ	None
kahor	ṣaaju	Nan
kaimd	kaimd	Nan
kajira	kuro patapata	Nan
kajirin	maṣe duro rara	Nan
kakoobantahay	eka	None
kakoobanyahy	eka	None
kal	kal	Nan
kadib	lẹhin	Nan
kala	yato si	Nan
kadhiseen	idilọwọ	Nan
kadhacay	iyẹn ṣẹlẹ	Nan
kacaydhinaca	ni akoko yi	Nan
kacaye	ọlọtẹ	Nan
kacbada	irukerudo	Nan
kacbadda	rogbodiyan	None
kacbadiinnii	igbega re	Nan
kacdoon	iṣọtẹ	Nan
kacdoonka	iṣọtẹ	Nan
kacdoonkii	rogbodiyan	None
kadabkii	ilekun	Nan
kadagaalami	rẹ	None
kadanbaysay	laipẹ	Nan
kadanbeeyay	laipẹ	Nan
kaday	nira	Nan
kaddib	lẹhin	Nan
kadhacady	ni akoko yi	Nan
kadhashay	o padanu	Nan
kalabaxaan	pin	Nan
kalana	omiiran	Nan
kalandar	kalẹnda	Nan
kalluunka	ẹja	Nan
kalmada	ọrọ	Nan
kalmadduu	rẹ	None
kalo	pẹlẹ o	Nan
kaloo	tun	Nan
kalsiduu	o ti jinde	Nan
kalsooni	igboya	Nan
kalsooniduu	igbekele re	Nan
kaluunka	ẹja	Nan
kalyaha	àrùn	None
kama	dipo	Nan
kambodiya	ẹṣẹ	Nan
kamid	laarin	None
kamida	aworan	Nan
kamidtahay	ti o ba wa	Nan
kalluun	ẹja	Nan
kaliyata	nikan	Nan
kaliya	kan	None
kalinimada	ipalọlọ	Nan
kalandarka	kalẹnda	Nan
kalanderka	kalẹnda	Nan
kalasaaraha	kilasika	Nan
kalasaaridda	isọdi	Nan
kalawareeg	yika	Nan
kalayihiin	yatọ	Nan
kale	omiiran	Nan
kacay	dide	Nan
kaleba	tun	Nan
kalena	omiiran	Nan
kalgacayl	ifẹ	Nan
kali	nikan	Nan
kaligaa	nikan	Nan
kaligii	nikan	Nan
kaligiii	nikan	Nan
kalimada	náà	None
kalee	omiiran	Nan
kacab	nira	Nan
kacaankii	iyika	Nan
kacaanka	iyika	Nan
jubbada	jubeli	Nan
juli	oṣu keje	Nan
july	oṣu keje	Nan
julywaxaa	oṣu keje	Nan
jumhūriyyat	jumhūriyyat	Nan
june	juni	Nan
junna	junna	Nan
juqraafi	ilẹ	None
juqraafiga	ilẹ	None
juquraafi	ilẹ	None
juun	juun	Nan
k	k	Nan
ka	a	Nan
kaa	iwo	Nan
kaafka	rekọja	Nan
jubba	jubba	Nan
jubadda	aṣọ	Nan
jsl	jsl	Nan
jsiirada	js	Nan
joogayna	ni	Nan
joogeen	wa	Nan
joogeene	nibi ti a ba wa	Nan
joogey	wa	Nan
joogga	gíga	Nan
joogno	dúró	None
joogo	lọwọlọwọ	Nan
kaaga	rẹ	None
joogsanmaanta	didùn	Nan
joogtaa	nibe	None
joogtada	loorekoore	Nan
joogtay	wa	Nan
joogto	loorekoore	Nan
joorjiya	iwe irohin	Nan
joqof	jockof	Nan
jowhar	jowhar	Nan
joogta	dúró	None
kamidyahay	jẹ	Nan
kaah	bẹẹni	Nan
kaahin	idaduro	Nan
kabaal	lefa	Nan
kabad	bọọlu	Nan
kabadan	ju lọ	Nan
kabaha	awọn bata	Nan
kabataane	bàtà	Nan
kabaxay	osi	Nan
kabaxsan	rekọja	Nan
kabaxsanida	sisilo	Nan
kabel	kabel	Nan
kabexeen	fo	Nan
kabo	awọn bata	Nan
kabsuuma	siwaju ati siwaju sii	Nan
kabtay	gbigba	Nan
kaca	dide	Nan
kacaan	iyika	Nan
kab	bata	Nan
kaatooliga	katoliki naa	Nan
kaasoo	àjọ who	Nan
kaasi	ti o jẹ	Nan
kaakici	se diedie	Nan
kaalin	ipa	Nan
kaalinta	ipa	Nan
kaalintii	ipa naa	Nan
kaalmada	iranlowo	Nan
kaalmadii	egba	None
kaalmeeye	oluranlọwọ	Nan
kaaha	itu	None
kaalmo	iranlowo	Nan
kaam	àgọ́	None
kaar	kaadi	Nan
kaaraan	le	None
kaariye	oludari	Nan
kaarkuba	gbenagbena	Nan
kaas	ewo	Nan
kaashanayaan	ifọwọsowọpọ	Nan
kaalo	kọja siwaju	Nan
ladareemay	irungbọn	Nan
kamiruun	kamẹra naa	Nan
kamman	aworan aworan	Nan
keenye	sọtọ	Nan
keli	nikan	Nan
keliga	nikan	Nan
keligiis	nikan	Nan
keliya	nikan	Nan
kennedy	keniyan	Nan
kenya	ọmọ	None
kexeeyey	iwakọ	Nan
key	bọtini	Nan
keying	keying	Nan
khaalid	aṣiṣe	Nan
khaalida	aṣiṣe	Nan
khaas	pataki	Nan
khaasatan	ni pataki	Nan
khaatumkii	awọn khaatum	Nan
keentay	ṣẹlẹ	Nan
khabiir	ohun iwé	Nan
keeno	mu	Nan
keeneen	mu	Nan
kay	kay	Nan
kayaro	ẹyẹ	Nan
kaydka	ọja	Nan
kaydsan	ti o fipamọ	Nan
kayimi	kọja siwaju	Nan
kaymaha	igbo	Nan
kaymo	igbo	Nan
kaynaan	fipamọ	Nan
kaysaha	náà	None
kbps	kọjá	None
kediye	kaabọ	Nan
keebka	ni fireemu	Nan
keena	mu wa	Nan
keenadiid	mu	Nan
keenay	mu	Nan
keeni	mu	Nan
khad	inki	Nan
khadiija	khadija	Nan
khadiijo	chuckle	Nan
khayrka	awọn ti o dara	Nan
khayrkiisa	oore re	Nan
kheeraadkaan	orisun	None
kheyraad	orisun	None
kheyraadka	orisun	None
kheyre	o dara	Nan
khibrad	iriri	Nan
khilaaf	ariyanjiyan	Nan
khilaafaa	gba	None
khilaafeen	gba	None
khilaafka	ariyanjiyan	Nan
khilaafsan	aiṣedeede	Nan
khiyaamay	tan	Nan
khiyaamo	ẹtan	Nan
khubarada	awọn amoye	Nan
khayriyada	orisun	None
khayraadka	orisun	None
khayr	o dara	Nan
khatar	lewu	Nan
khadka	laini	Nan
khahin	ko	None
khal	kikan	Nan
khaladaad	awọn aṣiṣe	Nan
khalaf	crunch	Nan
khaliif	kalifa	Nan
khaliifkii	kalifa	Nan
kaxiga	t’okan	Nan
khaliijka	kikan	Nan
khalqay	daru	None
khalqigu	rudurudu	Nan
khamiis	ọjọbọ	Nan
khamiista	ni ọjọbọ	Nan
khasaaray	wasted	Nan
khasab	agbara	None
khasbay	agbara	None
khaliil	kalifa	Nan
kaxaystay	yo kuro	Nan
kawsaday	yorawonkuro	Nan
kawayn	agbalagba	Nan
karayn	le	None
karee	ipara	Nan
kari	afikun	Nan
kariimka	ipara naa	Nan
karim	karim	Nan
karin	diẹ sii	Nan
karinwayadii	awọn n se	Nan
kariyey	jinna	Nan
karkabadii	ikeji	Nan
karl	karili	Nan
karnaa	le	None
karno	le	None
karo	figagbaga	Nan
kartaa	le	None
kartaan	le	None
karanle	ìfinipamọ	Nan
karale	carle	Nan
karaan	le	None
karaamiyo	mimọ	Nan
kan	a	Nan
kana	iwo	Nan
kanaal	ikanni	Nan
kanaalka	ikanni	Nan
kanada	canada	Nan
kaneeco	efon	Nan
kani	eyi	Nan
karti	agbara	None
kaniisad	ijo	Nan
kaniisadda	ijo	Nan
kaniisaddii	ijo	Nan
kaqaatay	yo lati	Nan
kara	lọ	Nan
karaa	le	None
karaadsaday	beere	Nan
karaamadii	mimọ	Nan
kaniisada	ijo	Nan
kamma	kamima	Nan
kartid	le	None
kartoonka	paali	Nan
kastoo	botilẹjẹpe	Nan
kastuu	pelu	Nan
katagay	osi	Nan
katahay	kate	Nan
katalaaniyawadanka	ede	None
katalin	ayase	Nan
katalinaayay	ayase	Nan
katalinaysaykadib	lẹhin	Nan
katalinjiratay	idilọwọ	Nan
katalinjirtay	idilọwọ	Nan
katay	kùkùté	Nan
katirsan	atẹle naa	Nan
katirsanayd	lati	Nan
katurjumayaa	abumọ	Nan
kaw	lati wa	Nan
kasto	ohun gbogbo	Nan
kaste	ohunkohun ti	Nan
kastana	lonakona	Nan
kastaba	sibẹsibẹ	Nan
karuur	ọkọ ayọkẹlẹ	Nan
karuurka	awọn ilosoke	Nan
kas	kásì	Nan
kasakhstan	lati kabakhstan	Nan
kasbaday	mina	Nan
kashiisaba	wọn	None
kasi	bẹẹkọ	Nan
karto	le	None
kasii	tọjú ẹ	Nan
kasoobaxa	sise	None
kasoojeeda	idakeji	Nan
kasoojeeday	lati	Nan
kasoojeedeen	lati ibo	Nan
kasooo	ya sọtọ	Nan
kasta	kọọkan	Nan
kastaa	kọọkan	Nan
kasoo	lati	Nan
ladilay	pa	Nan
ladin	tapa	Nan
ladnaa	dara	Nan
magaaladda	ilu	Nan
magaaladii	ilu	Nan
magaaladiisii	rẹ	None
magaaladu	ilu	Nan
magaalamadaxda	olú ìlú	Nan
magaalawga	ilu	Nan
magaalda	ilu	Nan
magaalo	ilu	Nan
magaalomadaxda	olú ìlú	Nan
magaaloobay	ilu	Nan
magaalooyin	awọn ilu	Nan
magaalooyinka	awọn ilu	Nan
magaalooyinkan	ninu awọn ilu wọnyi	Nan
magaalooyinkii	awọn ilu	Nan
magaaloyinka	awọn ilu	Nan
magaaladani	ilu yii	Nan
magaalyooyinka	awọn ilu	Nan
magaaladan	ni ilu yii	Nan
magaaladaan	ni ilu yii	Nan
madhaafto	fipamọ	Nan
madhab	madhab	Nan
madhabta	ẹkọ	Nan
madheedh	ofo	Nan
madigaan	ni akoko yi	Nan
madigan	madigan	Nan
madiina	medina	Nan
madina	madina	Nan
madoobaa	dudu	Nan
madoobayd	dudu	Nan
madoobe	dudu	Nan
madow	dudu	Nan
magaaalo	awọn ilu	Nan
magaala	ilu	Nan
magaalada	ilu	Nan
magaaladaasi	ilu	Nan
magac	orukọ	Nan
magaca	orukọ	Nan
magacaaba	orukọ	Nan
magaloyinka	awọn orukọ ti awọn ilu	Nan
magan	ojutu	Nan
magazine	iwe irohin	Nan
magool	biinu	Nan
magoolka	ohun ija	Nan
magtii	biinu	Nan
magtiinnu	rẹ	None
magubte	opidan	Nan
mahad	o ṣeun	Nan
mahadaay	ọna asopọ	Nan
mahaday	baba	Nan
mahadnaq	o ṣeun	Nan
mahadnaqayaa	e dupe	Nan
mahathir	mahathir	Nan
mahdi	o ṣeun	Nan
magalo	ilu	Nan
magaladan	ilu yii	Nan
magalada	ilu	Nan
magacyo	awọn orukọ	Nan
magacaabaa	orukọ	Nan
magacaabay	ti a npè ni	Nan
magacaabi	lorukọ o	Nan
magacaabida	yiyan	Nan
magacaabo	orukọ	Nan
magacaabobetyeeniyaoo	nambetyiniyaoo	Nan
magacaas	oruko	None
madaxweynihii	ààrẹ	Nan
magacan	orukọ yi	Nan
magacdaray	ti o lorukọ	Nan
magaceeda	oruko	None
magaciisa	oruko	None
magaciisaawaxa	oruko	None
magacley	ti a npè ni	Nan
magacyada	awọn orukọ	Nan
magacyadaas	awọn orukọ wọnyi	Nan
magacbaxay	ti a npè ni	Nan
madaxweyneyaashii	awọn alaṣẹ	Nan
madaxweynenimada	ààrẹ	Nan
madaxweyne	alakoso	Nan
macnaheedu	itumo	None
macnahoodu	itumo	None
macnayaalka	itumo	None
macneeyeen	dani	None
macneheedu	itumo	None
macneyn	tumọ	Nan
macnihiisa	itumo	None
macnihiisane	itumo	None
macnihiisu	itumo	None
macno	ori	None
macquul	mogbonwa	Nan
mad	aṣiwere	Nan
madaafiic	ohun ija	Nan
madaama	bi o ti ri	Nan
madaarka	papa	None
macnaha	itumo	None
macna	itumo	None
macluumaad	alaye	Nan
maclin	olukọ	Nan
maaweeliska	idanilaraya	Nan
maay	maay	Nan
maayo	nko ni	Nan
macaamiisha	awon onibara	Nan
macaan	adun	Nan
macaanaaye	ajẹtífù	Nan
macaanka	atọgbẹ	Nan
madadaalada	idanilaraya	Nan
macad	macadadi	Nan
macalimiinta	olukọ	Nan
macalimiintii	awọn olukọ	Nan
macalin	olukọ	Nan
macallimiinta	olukọ	Nan
macallin	olukọ	Nan
macalmiin	olukọ	Nan
machadka	institute	Nan
macalim	olukọ	Nan
mahiigaan	ni akoko yi	Nan
madagaskar	ara madagascar	Nan
madaw	dudu	Nan
madaxtooyadu	ọṣọ	Nan
madaxtooyo	ọṣọ	Nan
madaxwaynaha	alakoso	Nan
madaxwaynanimada	ààrẹ	Nan
madaxwaynayaasha	awọn alaṣẹ	Nan
madaxwayne	alakoso	Nan
madaxwaynew	alakoso	Nan
madaxwaynihii	ààrẹ	Nan
madaxweeynaha	ààrẹ	Nan
madaxweeynihii	ààrẹ	Nan
madaxwene	alakoso	Nan
madaxweyna	alakoso	Nan
madaxweynaha	alakoso	Nan
madaxweynahaasi	alakoso yẹn	Nan
madaxweynahii	ààrẹ	Nan
madaxtooyada	ọṣọ	Nan
madaxtinimada	ààrẹ	Nan
madaxii	ori	None
madaxdiin	awọn ọga iṣẹ	Nan
madawi	dudu	Nan
madawwaxa	dudu	Nan
madax	ori	None
madaxa	ori	None
madaxbanaan	olominira	Nan
madaxbanaani	olominira	Nan
madaxbanaanida	ominira	Nan
madar	aṣiwere	Nan
madaxbanaanidii	ominira	Nan
madaxbannaani	olominira	Nan
madaxbannaanidii	ominira	Nan
madaxda	awọn adari	Nan
madaxdaas	awon olori na	Nan
madaxdeena	olórí wa	Nan
madaxdhaqameedkii	ọga ile-iwe	Nan
madaxdii	awọn olori	Nan
madaxbannaan	olominira	Nan
maatarka	akọni	Nan
maj	maj	Nan
majeerteen	se won ko?	Nan
mari	bi won ninu	Nan
mariam	mariam	Nan
mariino	marina	Nan
marin	fi	None
marinayaay	marina	Nan
marine	omi	None
marinka	fi	None
marino	igbafẹfẹ	Nan
mariyeen	fi	None
mariyey	fi	None
marka	nigbawo	Nan
markaa	lẹhinna	Nan
markaad	nigba ti o ba	Nan
markaan	ni akoko yi	Nan
markaana	ati	Nan
mareykanku	ara ilu amẹrika	Nan
markaas	lẹhinna	Nan
mareykanka	ilẹ	None
mareeyaha	oluṣakoso	Nan
maraykanka	ilẹ	None
maraykanku	amẹrika	Nan
maraykankuna	ilẹ	None
marayo	nipasẹ	Nan
maraysa	palolo	Nan
marayso	ti n lọ	Nan
marba	lẹẹkansi	Nan
march	irin-ajo	Nan
mareeg	circuit	Nan
mareekanka	amẹrika	Nan
mareen	fi	None
mareer	akọ-ẹṣin	Nan
mareerey	ti kọja	Nan
mareergur	mareergur	Nan
mareexaan	sùn	Nan
mareeykanka	ilẹ	None
markaasaa	lẹhinna	Nan
markaasay	ati igba yen	Nan
markaasey	lẹhinna	Nan
markiiba	lẹsẹkẹsẹ	Nan
markiidanbe	lẹẹkan si	Nan
markiisa	rẹ	None
markooda	tiwon	Nan
markuu	nigbati o	Nan
marlabaad	ni akoko keji	Nan
marmarka	lẹẹkọọkan	Nan
marna	rara	Nan
marnaba	rara	Nan
maro	aṣọ	Nan
maroidjeex	maroidjeex	Nan
maromacawis	maromacawis	Nan
maroodi	erin	Nan
maroodiga	erin	Nan
maroodigii	erin	Nan
markii	nigbawo	Nan
marki	ni akoko yi	Nan
markey	ni akoko yi	Nan
markes	awọn ami	Nan
markaasi	lẹhinna	Nan
markaasna	lẹhinna	Nan
markaasneh	lẹhinna	Nan
markaasu	lẹhinna	Nan
markaasuu	lẹhinna	Nan
markab	ọkọ oju-omi	Nan
markale	lẹẹkansi	Nan
marayaanna	ko	None
markan	ni akoko yi	Nan
markasta	nigbakugba	Nan
markasto	nigbagbogbo	Nan
markay	nigbawo	Nan
markaynu	nigba ti a	Nan
markeeda	lori awọn oniwe-ara	Nan
markeedi	rẹ	None
markeey	akoko mi	Nan
markana	ni akoko yi	Nan
marayaa	nipasẹ	Nan
maray	koja	Nan
mararka	míràn	None
malaysiya	aisan	Nan
maldiif	sibi	Nan
maleegayeen	wọn	None
maleenaa	ro	None
maleeshiyada	awọn ologun	Nan
maleeyeen	ronu	Nan
maleh	ko	None
mali	ọjọ	Nan
maloo	rárá	Nan
malta	malta	Nan
maltisku	maltis	Nan
mamaaliikta	se o mo	Nan
mana	ṣugbọn	Nan
manchester	manchester	Nan
mandab	mandab	Nan
malaysia	malaysia	None
malaynayaa	sawon	Nan
malaheyn	ma ronu	Nan
malahan	ko	None
major	pataki	Nan
maka	fun	None
makaahiil	oúnjẹ	None
makedonia	makedonia	None
makhaayad	ile-ounjẹ	Nan
makhsuum	makhsuum	Nan
makka	makka	Nan
mandaqada	ni ekun	Nan
makordhaha	oluṣe	Nan
malaaig	angẹli	Nan
malaaigta	awọn angẹli	Nan
malaaq	angẹli	Nan
malaaqa	awọn clover	Nan
malaawi	angẹli	Nan
malaayga	ọkọ mi	Nan
malaha	boya beeko	Nan
maktabada	ni ile ikawe	Nan
majaajiliiste	apanilerin	Nan
mandeela	o ti lọ	Nan
mandheera	mandheera	Nan
maqlayso	gbọ	Nan
maqli	gbọ	Nan
maqlo	gbọ	Nan
maqnaa	isansa	Nan
mar	lẹẹkan	Nan
mara	mọ	Nan
maraa	mọ	Nan
maraakiibta	sowo	Nan
maraakiibtiisa	rẹ	None
maraan	lọ nipasẹ	Nan
maraaxil	irin-ajo	Nan
maraayaan	gbaa koja	Nan
maraayo	ko	None
marana	maána	Nan
marar	igba miiran	Nan
maqlay	gbo	Nan
maqlaan	gbọ ti o	Nan
maqcad	nkan	None
maqashay	gbo	Nan
maneestay	ọgbọn ipa	Nan
mange	mange	Nan
manger	ibùjẹ ẹran	Nan
mangistu	mangistu	Nan
mangooliyakadib	mangoolgirl	Nan
mangooliyiintu	mangoes	Nan
manhajka	eko	None
mandela	mandela	Nan
manneystay	ṣẹ	Nan
manta	gbagbe	Nan
many	lọpọlọpọ	Nan
mao	mao	Nan
maqaalada	nkan	None
maqac	gbọ	Nan
maqal	gbọ	Nan
maqan	sonu	Nan
mansuur	mánà	Nan
richard	richard	None
maasuqa	ibajẹ	Nan
maarso	kẹta	None
layiraahdo	ti a pe	Nan
layli	ere idaraya	Nan
layn	laini	Nan
layna	lana	Nan
laysku	jo	None
laysu	asẹ ni	Nan
laysugu	ila	Nan
le	le	None
league	ajumọṣe	Nan
leaguesyl	lejumọyl	Nan
leedahay	ni	Nan
leedahaye	lei	Nan
leedihiyo	awọn aworan efe	Nan
leefay	fẹẹrẹ	Nan
leegada	iwọn	Nan
layidhaahdaa	an	None
leelkase	ibi yoowu	Nan
layeen	sage	Nan
laydin	iwo	Nan
lasoo	wá	Nan
lasoomaray	tẹle	Nan
lasoonoqdeen	ti mọ	Nan
lawada	pin	Nan
lawareegay	gba	None
lawareegeen	wọn	None
lawyacaddo	lati fipamọ	Nan
laxamiiste	onimọ-ẹrọ	Nan
laxda	agutan	Nan
laxidhay	ni pipade	Nan
lay	dubulẹ	Nan
layaabka	iyalẹnu	Nan
layaableh	iyanu	Nan
layaqaanaha	oluṣeto	Nan
laydh	itanna	Nan
laydiray	ranṣẹ si ọ	Nan
leenahay	ni	Nan
leeuwarden	louwarden	Nan
leexatay	yà	Nan
leysku	iṣiro	Nan
libaan	kan	None
libaax	kan	None
libaaxa	kiniun	Nan
libaaxyada	awọn kiniun	Nan
liban	ṣẹgun	Nan
libiya	lepa	Nan
library	ile ikawe	Nan
libya	libya	Nan
lid	ko	None
lihi	lihi	Nan
lihiba	lihiba	Nan
lii	lii	Nan
liibaan	ṣaṣeyọri	Nan
liibiya	libya	Nan
leydiga	onigun mẹta	Nan
ley	ley	Nan
lewis	lewis	Nan
level	ipele	None
leexday	yà	Nan
leexiyo	tẹ	Nan
leeyaay	daduro	Nan
leeyahay	sọ	None
leeyahaymadaxtooyo	ominiramadaxtooyo	Nan
leeyahy	bawo ni o ṣe jẹ?	Nan
leeyhiin	ni	Nan
lasocotada	le	None
leeyihiin	ni	Nan
leh	pẹlu	Nan
lehe	bawo	Nan
leheed	ní	None
lehna	pẹlu	Nan
lehwaxa	pẹlu	Nan
leone	leone	Nan
lesotho	lesotho	Nan
legislative	isofin	Nan
lasiiyo	fifun	Nan
lasheegay	mẹnuba	Nan
lasheegaa	eniyan yii	Nan
lagayaabo	o ṣee	Nan
lagu	sí	Nan
lagugu	iwo	Nan
lagula	pẹlu	Nan
laguma	kiise	Nan
lagumagacaabijiray	so	None
laguna	lagna	Nan
laguqiyaasaa	ti o jẹ	Nan
lagusiidaayo	ifitonileti	None
lagusoo	rẹ	None
laguu	si ọ	Nan
laha	ni	Nan
lahaa	ní	None
lahaan	ni	Nan
lahaanshaha	nini	Nan
lagasoo	lati	Nan
lagaqadan	kọsẹ	Nan
lagana	lati	Nan
lagama	kii ṣe	Nan
laeego	wo ke o	Nan
laf	eegun	Nan
lafaha	egungun	Nan
lafalaha	egungun	Nan
lafdhabar	ọpa ẹhin	Nan
lafdhabarta	eegun	Nan
lafoole	eegun	Nan
lahaayeen	ní	None
lafweyn	ṣe alayeye	Nan
laga	lati	Nan
lagaa	rẹ	None
lagaba	egba	None
lagaga	lati	Nan
lagahayn	laisi	Nan
lagala	wọn	None
lagalay	lati	Nan
lag	aisun	Nan
liide	wa laaye	Nan
lahab	apọju	Nan
lahayaa	lori	Nan
lala	pẹlu	Nan
lama	rárá	Nan
lamana	rárá	Nan
lamid	jọra	Nan
lamidawday	ikan	None
lamy	lamy	Nan
lana	lana	Nan
lanka	lanka	None
laos	laos	Nan
laqabto	yẹ	Nan
laqwi	gbe	None
large	tobi	Nan
larumaysanyahay	a pe wa	Nan
lasameeyo	lati se	Nan
lasameynayaa	ti ṣe	Nan
lakin	ṣugbọn awọn	Nan
lakiin	ṣugbọn	Nan
lakala	lol	Nan
lajoogo	pelu wa	Nan
lahayd	ní	None
lahayeen	ní	None
lahayn	rárá	Nan
laheed	ní	None
laheen	kò sí	Nan
lahelo	wa	Nan
laheyd	ní	None
lahan	rárá	Nan
laheyn	ní	None
lahjada	iledìí	Nan
lahjadaha	awọn iledìí	Nan
lahjadda	iledìí	Nan
lahjado	iledìí	Nan
laisku	awọn lasers	Nan
lajira	pẹlu	Nan
lajnado	pẹlu	Nan
lahirgaliyay	imuse	Nan
maastricht	maastricht	Nan
liinta	osan	Nan
limited	lopin	Nan
maalintii	nigba ọjọ	Nan
maalintuu	rẹ	None
maaliyada	seeti	Nan
maalkeeda	rẹ	None
maalmaha	àwọn ọjọ́	Nan
maalmeede	ojoojumo	Nan
maalmihii	awọn ọjọ	Nan
maalmo	àwọn ọjọ́	Nan
maalmood	àwọn ọjọ́	Nan
maalqabeen	ọlọrọ	Nan
maalta	ọjọ	Nan
maamul	iṣakoso	Nan
maamula	ti ṣakoso	Nan
maamuladii	awọn alase	Nan
maamulaha	oluṣakoso	Nan
maalintani	oni yi	Nan
maamulayeen	ti ṣakoso	Nan
maalintaas	ọjọ́ yẹn	Nan
maalinle	ojoojumo	Nan
maa	gboju	Nan
maadaama	niwon	Nan
maaha	kii ṣe	Nan
maahan	kii ṣe	Nan
maahane	awón kó	Nan
maahee	ayafi ti	Nan
maahmaahda	.we	Nan
maajo	ọjọ	Nan
maakhir	bẹẹkọ	Nan
maal	ọrọ	Nan
maala	o kere ju	Nan
maali	ọjọ	Nan
maalik	ọjọ	Nan
maalin	ọjọ	Nan
maalinba	ojoojumo	Nan
maalinta	ọjọ	Nan
maamulayey	ti ṣakoso	Nan
maamulayo	ti a nṣakoso	Nan
maamulayso	ṣakoso	Nan
maansooyinka	awọn ọga	Nan
maanta	loni	Nan
maantaba	loni	Nan
maantana	loni	Nan
maaraynta	iṣakoso	Nan
maareeyaha	oluṣakoso	Nan
maareeyayaasha	awọn alakoso	Nan
maareeye	oluṣakoso	Nan
maariyatul	emi	Nan
maarmaan	pataki	Nan
maarmaanka	pataki	Nan
maarmay	ko	None
maarmayo	ko	None
maaroodi	maroodi	Nan
maars	maili	Nan
maansoole	ewi	Nan
maansoolayaashii	awọn arabara	Nan
maanso	maṣe gbagbe	Nan
maanshaa	tẹ bọtini	Nan
maamuli	ṣakoso	Nan
maamulidda	iṣakoso	Nan
maamulka	iṣakoso	Nan
maamulkaas	iṣakoso	Nan
maamulkii	iṣakoso	Nan
maamulkiisa	rẹ	None
maamulo	ṣakoso	Nan
ma	boya	Nan
maamusho	ṣakoso	Nan
maandeeq	mánà	Nan
maandhaafkii	iṣoro naa	Nan
maanka	lokan	Nan
maankii	lokan	Nan
maansada	mánà	Nan
maansadan	oni yi	Nan
maansadii	fipamọ	Nan
maan	lokan	Nan
m	m	Nan
luuqeeyso	sọ	None
luuqadaha	ede	None
loo	gbẹyin	Nan
loodoortay	yan	None
looga	láti	Nan
loogana	ja	Nan
loogu	fun	None
looka	wọle	Nan
lookhiyaameeyey	tẹ bọtini	Nan
loola	laya	Nan
looma	kii ṣe	Nan
loomagacaabaycismaan	wọn	None
loona	lonakona	Nan
looqaybinkaraa	le	None
lootaxaabay	samisi	Nan
looyaqaan	mọ	Nan
looyaqaana	ti a pe	Nan
london	london	Nan
loda	ṣẹda	Nan
locking	titiipa	Nan
lock	tiipa	Nan
link	ọna asopọ	Nan
linkiga	ọna asopọ	Nan
links	awọn ọna asopọ	Nan
linuks	linuks	Nan
linux	àlẹmọ	Nan
lis	atokọ	Nan
list	atokọ	Nan
looyaqaanay	mọ	Nan
lix	mefa	Nan
lixaadlehna	ẹkẹfa	Nan
lixda	mefa	Nan
lixdankii	ọgọta	Nan
lixle	ọgọta	Nan
lknse	ṣugbọn	Nan
lo	lo o	Nan
location	ipo	None
lixaad	kẹfa	Nan
liiska	atokọ	Nan
looyaqaano	mọ bi	Nan
looyaqaany	wọn	None
luqada	ede	None
luqadaha	ede	None
luqadda	ede	None
luqado	ede	None
luqadood	ede	None
luqadooda	tiwọn	None
luqeedaka	ede	None
luqmaan	ede	None
luud	loti	Nan
luuliyo	oṣu keje	Nan
luulyo	oṣu keje	Nan
luulyokii	oṣu keje	Nan
luuq	ede	None
luuqada	ede	None
luuqadaa	ede	None
luqad	ede	None
luntay	sọnu	Nan
lumin	lati sọnu	Nan
lumay	sọnu	Nan
looyaqano	wọn	None
lord	oluwa	Nan
lordi	ogun	None
lower	kere	Nan
lowska	ẹran	Nan
lublin	lublin	Nan
lubnaan	lẹ́bánónì	Nan
looyaqaanonikobolis	mọ bi cyborg	Nan
lug	ẹsẹ	None
lughaya	esè	Nan
lugohooda	ese won	Nan
lugood	esè	Nan
lugta	ẹsẹ	None
lugtii	ẹsẹ	None
lugu	lougou	Nan
luksemburg	luksemburg	Nan
lugaha	esè	Nan
joogay	ni	Nan
richman	olówó	Nan
rideen	fi	None
warsangali	leti	Nan
warsangeli	alaye	Nan
warshada	ile ise	Nan
warshadaha	ile ise	Nan
warshadda	ile ise	Nan
warshadii	ile ise	Nan
warshado	ile-iṣelọpọ	Nan
warsheekh	warsheekh	Nan
warshiikh	ile-iṣelọpọ	Nan
waryeele	akoroyin	Nan
was	wà	Nan
wasaarada	iṣẹ́ òjíṣẹ́	Nan
wasaaradaha	awọn iṣẹ ijọba	Nan
wasaaradda	iṣẹ́ òjíṣẹ́	Nan
wasaaraha	òjíṣẹ́	Nan
warsame	warame	Nan
wasaarayaashii	awọn minisita	Nan
warqado	awọn lẹta	Nan
warmuhu	ọkọ	Nan
wareegi	iyipo	Nan
wareegii	yika	Nan
wareegsan	yika	Nan
wareegtay	yika	Nan
wareejin	gbigbe	Nan
wareejiyay	gbe	None
wareejiyey	gbe	None
warfaa	alaye	Nan
warfaafinta	alaye	Nan
wargaade	akede	Nan
wargayska	iwe iroyin	Nan
wargaysyada	iwe iroyin	Nan
wargeyska	iwe iroyin	Nan
wariyay	royin	Nan
wariye	onirohin	Nan
warqad	leta	Nan
wasaare	òjíṣẹ́	Nan
wasaarihii	òjíṣẹ	Nan
wasaarihiisa	rẹ	None
waxaana	ati awa	Nan
waxaanan	ati awa	Nan
waxaanay	ati awọn	Nan
waxaanu	àwa	Nan
waxaanuu	oun	None
waxaas	iyẹn yẹn	Nan
waxaasa	ti o jẹ	Nan
waxaase	oun	None
waxaay	rẹ	None
waxad	iwo	Nan
waxaliilka	isọdọmọ	Nan
waxan	nkan	None
waxana	ati	Nan
waxanaa	eyi ni	Nan
waxannu	a ni	Nan
waxaan	àwa	Nan
waxaad	iwo	Nan
waxaa	rẹ	None
waxa	kini	Nan
wasakheeyey	ẹlẹgbin	Nan
wasaq	ẹlẹgbin	Nan
wasarada	minisita	Nan
wasi	leta	Nan
wasiir	òjíṣẹ́	Nan
wasiirada	minisita	Nan
wasiirka	òjíṣẹ́	Nan
wareegeen	yika	Nan
wasiirkii	òjíṣẹ́	Nan
wata	omiiran	Nan
watay	lọwọlọwọ	Nan
watch	wo	Nan
wato	ti o jẹ	Nan
watto	kutukutu	Nan
waw	waw	Nan
wax	nkan	None
wasiiro	minisita	Nan
waxanu	eyi	Nan
wareegay	yika	Nan
wareega	yika	Nan
walwaal	dààmú	Nan
wan	wan	Nan
wanaag	o dara	Nan
wanaaga	daradara	Nan
wanaagga	awọn ti o dara	Nan
wanaagii	awọn ti o dara	Nan
wanaagsan	o dara	Nan
wanaagsana	o dara	Nan
wanaagsanaa	o dara	Nan
wanaagsanaantaas	oore yii	Nan
wanaagsani	o dara	Nan
wanaagsantahay	o dara	Nan
wanaagyaalku	irisi	None
wanaagyadeena	ire	None
wane	ewo	Nan
walow	botilẹjẹpe	Nan
wanwanaagsan	o dara	Nan
wallee	ìrìn	Nan
waliid	tun	Nan
walaalnimo	arakunrin	Nan
walaalo	awọn arakunrin	Nan
walaalow	arakunrin	Nan
walaaltinimo	arakunrin	Nan
walaashma	arabinrin	Nan
walaiba	ohunkohun ti	Nan
walalkiis	rẹ	None
walanwal	wallanwal	Nan
walba	kọọkan	Nan
walbaa	ni gbogbo igba	Nan
walbana	lonakona	Nan
walbo	ohun gbogbo	Nan
wali	tun	Nan
waliba	pelu	Nan
waligiinee	nu	None
waljamaaca	aibalẹ	Nan
waqiis	akoko apakan	Nan
waqooyi	si ariwa	Nan
waqooyiga	ni ariwa	Nan
waranka	rẹ	None
wararka	awọn iroyin	Nan
waray	bawo	Nan
waraye	awọn iroyin	Nan
warbaahin	media	Nan
warbaahinta	media	Nan
warbixin	alaye	Nan
warbixinta	ijabọ	Nan
warbixintii	ijabọ naa	Nan
warbixintiisa	rẹ	None
warcelinta	esi	Nan
wardheer	oluṣọ	Nan
wardheere	ṣọra	Nan
wardhiigleey	elegbogi	Nan
wardhiigley	wardhiigley	Nan
waran	ọkọ	Nan
waramay	royin	Nan
waraaqdii	lẹta naa	Nan
waraaqda	lẹta naa	Nan
waqoyi	wa si okan	Nan
waqti	aago	Nan
waqtiga	aago	Nan
waqtigaa	ni asiko	Nan
waqtigaas	nigba yen	Nan
waqtigan	ni akoko yi	Nan
waqtigii	ni akoko	Nan
wareegan	ninu iyipo yii	Nan
waqtigu	akoko naa	Nan
waqtiyadii	awọn akoko	Nan
waqtiyo	awọn akoko	Nan
war	awọn iroyin	Nan
waraabbintaadii	rẹ	None
waraabin	agbe	Nan
waraabinta	agbe	Nan
waraabiyee	rẹ	None
waqtiyada	míràn	None
waxar	kekere	None
waxay	wọn	None
waxayna	wọn	None
weriyey	onirohin	Nan
west	iwọ oorun	Nan
wexey	sọ	None
wey	nla	Nan
weyddiiyey	rẹ	None
weydiinta	béèrè	Nan
weydiisanayaa	mo beere	Nan
weydiiso	béèrè	Nan
weydiiyey	rẹ	None
weyn	nla	Nan
weyna	nla	Nan
weynaa	nla	Nan
weynaadeen	wọn	None
weynaado	jẹ nla	Nan
weyne	nla	Nan
werintii	iroyin	Nan
weyneyd	nla	Nan
werinta	ijabọ	Nan
werin	igbohunsafefe	Nan
wehel	pẹlú	Nan
weheliye	ẹlẹgbẹ	Nan
wehliye	ẹlẹgbẹ	Nan
wejiga	ojú	Nan
wejigeeda	rẹ	None
weli	sibẹsibẹ	Nan
weliba	tun	Nan
weligayo	lailai	Nan
weligeed	lailai	Nan
weligood	lailai	Nan
well	daradara	Nan
wels	àwọn wels	Nan
wenlake	wenlake	Nan
wenniger	wenniger	Nan
were	lo	Nan
werinaayo	ijabọ	Nan
weyneyn	nla	Nan
weyneynta	igberaga	Nan
weyni	nla	Nan
wikipediaha	wikipediaha	Nan
wikiteknoolojida	imọ-ẹrọ	Nan
wikiwiki	wikiwiki	Nan
will	yoo	None
windows	windows	Nan
wireless	alailowaya	Nan
with	pẹlu	Nan
wixii	ohunkohun ti	Nan
woo	woo	None
woowga	iro ohun	Nan
woqooyi	si ariwa	Nan
woqooyibari	apa ariwa	Nan
woqooyiga	si ariwa	Nan
woqooyigalbeeda	ni ariwa iwọ-oorun	Nan
world	agbaye	None
wikipedia	wikipedia	Nan
wiki	wiki	Nan
wiilwaal	awọn ọmọkunrin	Nan
wiilkuu	rẹ	None
weyninka	titobi	Nan
weynta	titobi	Nan
when	nigbawo	Nan
where	nibo	Nan
which	ewo	Nan
whose	tani	Nan
wiil	ọmọkunrin	Nan
wegenxile	wegenxile	Nan
wiilal	ọmọ	None
wiilashooda	wọn	None
wiilka	ọmọ	None
wiilkan	ọmọkunrin yii	Nan
wiilkii	ọmọ	None
wiilkiina	ọmọ	None
wiilkiisa	rẹ	None
wiilkiisii	rẹ	None
wiilasha	awọn ọmọkunrin	Nan
weeyn	nla	Nan
weeye	ti o jẹ	Nan
weeyaane	se beeni	Nan
waxsiin	pese	Nan
waxsoo	diẹ ninu	Nan
waxsoosaarka	gbóògì	Nan
waxuu	oun	None
waxuuna	o ṣe	Nan
waxyaabaha	ohun	Nan
waxyaabihii	ohun	Nan
waxyaabo	ohun	Nan
waxyaalaha	ohun	Nan
waxyar	kekere	None
waxyoonay	atilẹyin	Nan
way	ọna	Nan
wayaaye	igbagbe	Nan
wayday	le	None
waydiin	maṣe beere	Nan
waxse	ohunkohun	Nan
waxow	ohun	Nan
waxoow	diẹ ninu	Nan
waxoona	nkan	None
waxaynu	àwa	Nan
waxba	ohunkohun	Nan
waxbarashada	eko	None
waxbarashadiisa	eko	None
waxbarashadiisii	eko	None
waxbarasho	eko	None
waxee	kini	Nan
waydiisato	o beere	Nan
waxeena	ohun wa	Nan
waxey	wọn	None
waxeyna	ati awọn	Nan
waxgaradka	oye	Nan
waxii	ohunkohun ti	Nan
waxka	ohun	Nan
waxna	ohunkohun	Nan
waxoo	nkan	None
waxeey	wọn	None
walaalkiisna	rẹ	None
waydiiyay	beere	Nan
wayga	wo	Nan
weeba	webbing	Nan
weecdaa	yipada	None
weel	gba	None
weelashiina	ati lẹhin naa iwọ	Nan
ween	ween	Nan
weeninkeeda	titobi re	Nan
weer	ikosile	Nan
weerar	kọlu	Nan
weeraradaas	ku	None
weeraray	kọlu	Nan
weerarka	kọlu	Nan
weerarkii	kọlu	Nan
weeraro	ku	None
weerta	igbo	Nan
weey	fokii	Nan
wee	ati	Nan
websitka	oju opo wẹẹbu	Nan
website	aaye ayelujara	Nan
webiga	odo	Nan
wayl	ọna	Nan
wayn	nla	Nan
wayna	yoo	None
waynaa	nla	Nan
waynaha	titobi	Nan
waynayd	o jẹ nla	Nan
waynayn	nla	Nan
waydinkii	béèrè	Nan
wayne	nla	Nan
ways	awọn ọna	Nan
waysadii	awọn ọna	Nan
wayska	awọn ọna	Nan
waysu	maṣe	Nan
waziirkii	òjíṣẹ	Nan
web	wẹẹbu	Nan
webi	odo	Nan
waynwaxa	nla	Nan
walaalkiis	rẹ	None
walaalkii	arakunrin	Nan
walaalkay	buroda mi	Nan
uruguay	urugue	Nan
uruka	awọn anfani	Nan
urur	agbari	Nan
ururada	ajo	None
ururka	agbari	Nan
ururkii	agbari	Nan
ururo	ẹgbẹ	Nan
us	àwa	Nan
usa	amú	Nan
usaama	o han ni	Nan
usaraysa	ailorukọ	Nan
usbuuca	fun	None
usbuuceed	sẹsẹ	Nan
usc	usc	Nan
use	lo	Nan
urdun	orun	Nan
used	ti lo	Nan
ur	ur	Nan
unugyada	ẹyin	Nan
ummukhalthum	ummukhalthum	Nan
umts	umts	Nan
umukalthum	umukalthum	Nan
un	un	Nan
una	aimọ	Nan
unaxariistee	fun	None
unbaa	kaabọ	Nan
union	apapọ	Nan
united	isọdọkan	Nan
university	yunifasiti	Nan
unlock	ṣii	Nan
unnaxariisto	inudidun	Nan
unug	sẹẹli	Nan
unugga	ẹyọkan	Nan
unuggu	ẹyọkan	Nan
unugyo	ẹyin	Nan
user	olumulo	Nan
uses	nlo	Nan
usii	tọju	Nan
uyaala	iro ohun	Nan
uyaalka	ọpá	Nan
v	v	Nan
valéry	itanna	Nan
varies	yatọ	Nan
venezuela	venezuela	None
vepfrancii	vepfrancii	Nan
vepitalii	vepitalii	Nan
vepročinma	vepročinma	Nan
vepvenäma	vepvenäma	Nan
vergleich	vergleich	Nan
voice	ohun	Nan
vol	folti	Nan
w	w	Nan
wa	wa	Nan
uxiiso	gbadun	Nan
uusan	kò ṣe bẹ	Nan
uuraysatay	lóyún	Nan
uur	oyun	Nan
using	lilo	Nan
usoo	àwa	Nan
ustaad	kẹta	None
ustaaz	marun	Nan
usually	nigbagbogbo	Nan
usuuroobi	kaabọ	Nan
utaaganaha	utaaganaha	Nan
ummukalthum	ummukalthum	Nan
utrecht	utrecht	Nan
uuga	forge	Nan
uugu	ipalọlọ	Nan
uuman	nya si	Nan
uumanka	ọriniinitutu	Nan
uun	kan	None
uuna	ni ife	Nan
uunkanna	eyi	Nan
uu	tirẹ	Nan
ummu	ọmọ	None
ummaddan	orilẹ-ede yii	Nan
ummadda	orílẹ-èdè	Nan
typically	melo	None
u	u	Nan
ubad	ọmọ	None
ubadan	pelu pelu	Nan
ubadka	ọmọ	None
ubax	ododo	None
ubaxu	ododo	None
ucusub	niu yoki	Nan
uday	uday	Nan
uddaayey	arakunrin	Nan
udgoon	oorun aladun	Nan
udgoonaa	didin	Nan
udgoonka	oorun aladun	Nan
udheer	ṣafikun	Nan
udub	fun	None
tvga	tvga	Nan
tv	tẹlifisiọnu	Nan
tuxmo	tucks	Nan
tuwaaxid	lati wa	Nan
tuu	jabọ	Nan
tuug	olè	Nan
tuugo	olè	Nan
tuulada	abule	Nan
tuuladii	abule	Nan
tuulo	kan	None
tuulooyin	abule	Nan
udubdhexaad	aringbungbun si o	Nan
tuulooyinka	abule	Nan
tuur	jabọ	Nan
tuuray	simẹnti	Nan
tuurayaan	sisọ kuro	Nan
tuurayn	simẹnti	Nan
tuure	simẹnti	Nan
tuuro	simẹnti	Nan
tuuryare	ọgbẹ	Nan
tuuniisiya	iwadi	None
waa	oun	None
udug	lofinda	Nan
uga	awọn	Nan
ujeedadoodu	wọn	None
ujeeddadiisu	idi	Nan
ujeeddo	idi	Nan
ukala	ijosin	None
ukrain	ito	Nan
ul	ọpá	Nan
ula	awọn	Nan
ulajeedadaydu	idi mi	Nan
ulasoo	olas	Nan
uma	kii ṣe	Nan
umada	orílẹ-èdè	Nan
umadda	orílẹ-èdè	Nan
ummad	orílẹ-èdè	Nan
ummada	orílẹ-èdè	Nan
ummadaha	awọn orilẹ-ede	Nan
ujeedadiisa	rẹ	None
ujeedada	idi	Nan
uguwayn	pataki	Nan
uguna	guna	Nan
ugaadha	ọdẹ	Nan
ugaandha	agboorun naa	Nan
ugaarka	ọdẹ	Nan
ugaarta	ọdẹ	Nan
ugaas	olórí	Nan
ugaaska	olórí	Nan
ugama	ko	None
ufakaday	sọnu	Nan
ugana	gorilla	Nan
ugandheeska	nipasẹ ọna	Nan
ugasoo	lati eyi	Nan
ugu	fifa soke	Nan
ugudhaw	pada	Nan
ugudheer	gunjulo	Nan
uguhoraysay	eyi tio gbeyin	Nan
ugumaydhigin	fun	None
ugandha	iya naa	Nan
wow	iro ohun	Nan
waaba	owurọ	Nan
waabari	owurọ	Nan
wadaniga	omo ilu	Nan
wadaniyeed	olufẹ orilẹ-ede	Nan
wadaniyiin	olufẹ orilẹ-ede	Nan
wadanka	orílẹ èdè	Nan
wadankaa	ni orilẹ-ede yẹn	Nan
wadankaan	ni orilẹ-ede yii	Nan
wadankaas	ni orilẹ-ede yẹn	Nan
wadankaasi	orilẹ-ede yẹn	Nan
wadankan	ni orilẹ-ede yii	Nan
wadankani	orilẹ-ede yii	Nan
wadankanlaakiin	ṣugbọn ni orilẹ-ede yii	Nan
wadankii	orílẹ èdè	Nan
wadanku	orílẹ èdè	Nan
wadanmada	omo ilu	Nan
wadarta	lapapọ	Nan
wadani	obi	Nan
wadata	ipese	Nan
wadan	orilẹ-ede	Nan
wadamo	awọn orilẹ-ede	Nan
wadaagaa	pin	Nan
wadaagaan	pin	Nan
wadaagan	pin	Nan
wadaagsano	lati pin	Nan
wadaagta	awọn ẹlẹgbẹ	Nan
wadaagtaa	pin	Nan
wadaagtaane	alabaṣiṣẹpọ yii	Nan
wadaan	wakọ	Nan
wadada	loju ọna	Nan
wadahadal	ijiroro	Nan
wadahadalo	awọn ijiroro	Nan
wadajir	papọ	Nan
wadajirka	papọ	Nan
wadama	idama	Nan
wadamada	awọn orilẹ-ede	Nan
wadamu	wadamu	Nan
waday	tesiwaju	Nan
wadda	ewo	Nan
waddada	loju ọna	Nan
wakhtigaas	ni igba na	Nan
wakhtigaasi	ni igba na	Nan
wakhtigan	ni akoko yi	Nan
wakhtigii	akoko naa	Nan
wakhtigiisii	rẹ	None
wakiil	aṣoju	Nan
wakiilada	awọn aṣoju	Nan
wakiilka	aṣoju	Nan
wal	wal	Nan
walaal	arakunrin	Nan
walaalaha	awọn arakunrin	Nan
walaalaheed	rẹ	None
walaalahooda	wọn	None
walaaleeyaan	arakunrin	Nan
walaalkaa	rẹ	None
wakhtigaa	ni igba na	Nan
wakhtiga	akoko naa	Nan
wakhti	aago	Nan
wakaalada	ibẹwẹ	Nan
waddamada	awọn orilẹ-ede	Nan
waddan	orilẹ-ede	Nan
waddanka	orílẹ èdè	Nan
waddankiisa	rẹ	None
waddo	kan	None
wade	wá	Nan
wadeen	darí	Nan
wadaaga	pinpin	Nan
wadnaha	okan	Nan
wadooyinka	ni opopona	Nan
wafdi	aṣoju	Nan
wahab	wá	Nan
wajeer	jade	Nan
waji	oju	Nan
wajib	dandan	None
wajiis	oju	Nan
wado	wakọ	Nan
wadaadkii	àlùfáà	Nan
wadaadka	alufaa	Nan
wadaad	aguntan	Nan
waalba	boya	Nan
waalid	awọn obi	Nan
waamid	fiwepe	Nan
waamo	rárá	Nan
waan	yoo	None
waana	ati pe o jẹ	Nan
waanada	iyanju	Nan
waannu	yoo	None
waano	iyanju	Nan
waar	wá	Nan
waariyoo	eons	Nan
waarku	aṣiwere	Nan
waasidan	gbooro	Nan
waasoo	ewo	Nan
waasuge	gbooro	Nan
waalaalow	jowo	Nan
waakaas	lẹhinna	Nan
waakaa	ti o jẹ	Nan
waajibnimada	ojuse	None
waabeeye	owurọ	Nan
waaberi	owurọ	Nan
waad	iwo	Nan
waadi	wá	Nan
waadigii	ko	None
waadna	ti o ba wa	Nan
waafajiyaa	orisirisi	None
waataan	ni akoko yi	Nan
waafaqsan	accordingly	Nan
waaga	aṣiwere	Nan
waagaas	ni igba na	Nan
waagii	ọjọ	Nan
waagu	owurọ	Nan
waajib	iṣẹ	Nan
waajibaadkeeda	rẹ	None
waajibka	ojuse	None
waafi	to	None
waabarei	owurọ	Nan
waataas	akoko yẹn	Nan
waaween	agbalagba	Nan
wabiga	odo	Nan
wabiyaal	odo	Nan
wabiyada	odo	Nan
wacad	ẹ̀jẹ́	Nan
wacan	o dara	Nan
wacays	pe	Nan
wacbuudhan	rere	None
wacdi	waasu	Nan
wacdiga	waasu	Nan
wacdiyow	oniwaasu	Nan
waceys	pe	Nan
waceysle	oluṣeto	Nan
wacyigelinta	imo	Nan
wada	papọ	Nan
wadaa	wakọ	Nan
wabi	odo	Nan
wabarka	iroyin	Nan
wabar	wæn	Nan
waayo	fun	None
waaweyn	tobi	Nan
waaweynaa	nla	Nan
waaweyneyd	nla	Nan
waax	eka	None
waaxaa	jẹ	Nan
waaxda	eka	None
waayadaas	li ọjọ wọnyẹn	Nan
waawayn	agbalagba	Nan
waayadii	ni atijo	Nan
waaye	wọn	None
waayeel	alàgbà	Nan
waayeen	le	None
waayey	farasin	Nan
waayihii	awọn akoko	Nan
waayitaanka	pipadanu	Nan
waaylahayad	awọn baba-nla wa	Nan
waayay	sọnu	Nan
tutorial	ibaṣepọ	Nan
woxoo	kini	Nan
wsaare	olugbohunsafefe	Nan
yaaley	ta ni	Nan
yaalla	wa	Nan
yaallaa	wa	Nan
yaalley	wa	Nan
yaallo	wa	Nan
yaalo	ní	None
yaan	oni yi	Nan
yaanyada	tomati	Nan
yaaqshiid	se o mo	Nan
yaasha	ìdí	Nan
yaasiin	yasin	Nan
yabaal	fun	None
yabar	kaabọ	Nan
yabaroow	e dupe	Nan
yabarow	yaborow	Nan
yaaleen	wọn	None
yacqoob	yi soke	Nan
yaale	rere	None
yaalaan	wa	Nan
xusseen	ṣe akiyesi	Nan
xusuus	iranti	Nan
y	y	Nan
ya	rẹ	None
yaa	àjọ who	Nan
yaab	iyalẹnu	Nan
yaabaa	boya	Nan
yaabaha	awọn iyanu	Nan
yaabay	yanilenu	Nan
yaabeen	yà	Nan
yaabo	boya	Nan
yaaceen	sare	Nan
yaal	wa	Nan
yaala	wa	Nan
yaalaa	nibe	None
yaalay	wà nibẹ	Nan
yacquub	ati jakobu	Nan
yada	tànkálẹ	Nan
yadii	gbooro	Nan
yaraan	aipe	Nan
yaraantiisii	rẹ	None
yaraatee	rara	Nan
yarayd	kekere	None
yare	ede	None
yarixunkaas	elegun na	Nan
yaroo	yahoo	Nan
yartahay	kekere	None
yaryahay	kekere	None
yaryar	kekere	None
yaryaryihiina	kekere	None
yasid	ẹgan	Nan
yaso	wá	Nan
yaxye	jòhánù	Nan
yeber	arabinrin	Nan
yaraa	aburo	Nan
yar	diẹ	Nan
yaqaano	mọ	Nan
yaqaanno	mọ	Nan
yaduna	àgbàlá	Nan
yahanad	eṣu	Nan
yahay	jẹ	Nan
yahaye	yahaye	Nan
yahayna	jẹ	Nan
yahey	bẹẹni	Nan
yahuuda	awọn ju	Nan
xuso	mẹnuba	Nan
yahuudda	awọn ju	Nan
yaman	yaman	Nan
yamen	yamen	Nan
yaqaan	mọ	Nan
yaqaanaa	mọ	Nan
yaqaanay	mọ	Nan
yaqaaneen	mọ	Nan
yaqaannay	mọ	Nan
yamaan	ya	Nan
yeedhay	ti a pe	Nan
xusnay	mẹnuba	Nan
xuska	ìrántí	Nan
xudur	okun	Nan
xuduud	aala	None
xuduuda	ààlà	Nan
xuduudaha	aala	None
xuduudka	ààlà	Nan
xuduudo	aala	None
xujeyda	ariyanjiyan mi	Nan
xukumada	awọn alaṣẹ	Nan
xukumay	lẹjọ	Nan
xukumayay	adajo	Nan
xukumayey	adajo	Nan
xukumi	lẹjọ	Nan
xukumina	da	None
xukumo	awọn idajọ	Nan
xukun	idajọ	Nan
xubnihii	ọmọ	None
xukunka	idajọ	Nan
xubnaha	ọmọ	None
xorta	ọfẹ	Nan
xoraynta	ominira	Nan
xoreeyay	ominira	Nan
xoreynta	ominira	Nan
xoriyad	ominira	Nan
xoriyada	ominira	Nan
xornimada	ominira	Nan
xornimadda	ominira	Nan
xornimadii	ominira	Nan
xornimadiisa	ominira	Nan
xornimadooda	ominira won	Nan
xornimadoodii	ominira won	Nan
xornimo	ominira	Nan
xoroobeen	ṣeto ọfẹ	Nan
xoroowday	ọfẹ	Nan
xorriyaadka	ominira	Nan
xubin	ọmọ	None
xukunkii	idajọ	Nan
xukunto	lẹjọ	Nan
xukuumad	ijọba	Nan
xuquuqda	awọn ẹtọ	Nan
xuquuqdii	awọn ẹtọ	Nan
xuquuqdooda	wọn	None
xuquuqul	awọn ẹtọ	Nan
xurnima	ominira	Nan
xuruufta	awọn lẹta	Nan
xusan	mẹnuba	Nan
xusay	ṣe akiyesi	Nan
xusayna	nmẹnuba	Nan
xusaysaa	nṣe iranti	Nan
xuseen	ṣe akiyesi	Nan
xuseenow	rẹ	None
xusen	mẹnuba	Nan
xusi	ranti	Nan
xusid	mẹnuba	Nan
xuquuq	awọn ẹtọ	Nan
xun	buburu	Nan
xumuy	buburu	Nan
xumo	buburu	Nan
xukuumada	ijọba	Nan
xukuumadda	ijọba	Nan
xukuumaddii	ijọba	Nan
xukuumaddiisii	rẹ	None
xukuumaddu	ijọba	Nan
xukuumadihii	awọn ijọba	Nan
xukuumadii	ijọba	Nan
xuskooda	wọn	None
xulafaddii	awọn ọrẹ	Nan
xulka	ẹgbẹ naa	Nan
xulufo	awọn ọrẹ	Nan
xumaa	buburu	Nan
xumaaday	binu	Nan
xumaan	ibi	Nan
xumaanta	ibi	Nan
xumi	buburu	Nan
xulafadiisii	rẹ	None
yeedho	pe	Nan
yeel	se o	Nan
yeelaha	oluṣe	Nan
العلامة	العلامة	Nan
القرآن	القرآن	Nan
القرن	ققننن.	Nan
الكتب	كتكتكت.	Nan
اللغة	غةغةغةغةغة	Nan
الله	ههههه	Nan
المد	ددد	Nan
المكتبة	المكتبكت	Nan
المنتخب	المنمب	Nan
النبي	النبي	Nan
النسائي	النسائي	Nan
بسم	.sa	Nan
بعد	wò	Nan
تخريج	تخريج	Nan
ثم	.sa	Nan
العربية	العربية	Nan
حروف	روف	Nan
العراق	العراق	Nan
الصالحات	الصالحات	Nan
أعلم	.لم	Nan
أن	.ن	Nan
أنا	نا	Nan
أنه	هه	Nan
ابن	ببب..	Nan
الأئمة	أئأئةة	Nan
الترغيب	الترغيب	Nan
الحديث	حدحدث	Nan
الرحيم	الرحيم	Nan
الرد	ددددد	Nan
الردُّ	دُّدُّدُّدُّدُّ	Nan
الرشيد	ششششددد	Nan
الساكنة	الساكنة	Nan
السلام	السلام	Nan
الشيخ	ششخ	Nan
الصومال‎	الصومال	Nan
حكم	.sa	Nan
داود	اود	Nan
ربيع	ربيع	Nan
لا	اا.	Nan
للبخاري	للبخاري	Nan
للمنذري	للمنذري	Nan
لن	نr.	Nan
لها	ههه	Nan
ما	ogun	None
مثل	ثثث	Nan
مخطوطات	مخطوطات	Nan
مقديشو	amقد	Nan
مهدي	هدهد.	Nan
مُجدّدُ	lọ	Nan
هذا	.ut	Nan
هو	.l	Nan
والموضوعة	والموضوعة	Nan
وسلم	وسلم	Nan
كتب	كتب	Nan
كتاباً	ًاباً	Nan
كتاب	obara	Nan
قال	ال	Nan
رحمه	رحمه	Nan
رسالة	رسالة	Nan
رسول	رسول	Nan
شيخ	يخ	Nan
ص	ص	Nan
صفة	صفة	Nan
صلاة	لاة	Nan
أشهد	أشهد	Nan
صلى	ىلى	Nan
عبد	عبد	Nan
عدا	.ut	Nan
علمي	علمي	Nan
على	ىلى	Nan
عليه	ليه	Nan
فقه	فقه	Nan
فهرس	رس	Nan
ضعيف	يف	Nan
أحمد	مد	Nan
أحكام	.ام	Nan
أحاديث	اديث	Nan
yidhaahdaa	pé	None
yidhaahdaan	sọ	None
yidhaahdo	sọ	None
yidhi	wi	Nan
yihii	ti o jẹ	Nan
yihiin	jẹ	Nan
yihin	eyi	Nan
yiil	wa	Nan
yimaada	lati wa	Nan
yimaadaan	wá	Nan
yimaadeen	ti wa	Nan
yimaado	wa	Nan
yimi	kọja siwaju	Nan
yimid	wa	Nan
yimiday	dé	None
yemen	yemen	Nan
yeesho	ni	Nan
yeesheen	ni	Nan
yeeshee	sibẹsibẹ	Nan
yeelan	ni	Nan
yeelatay	ṣe	Nan
yeelato	lati ni	Nan
yeelay	nitori	Nan
yeeleen	ṣe	Nan
yeeli	se o	Nan
yeelo	se o	Nan
yiqiin	ṣeeṣe	Nan
yeera	kọja siwaju	Nan
yeeray	taratara	Nan
yeeri	irù	Nan
yeero	pe	Nan
yeertay	taratara	Nan
yeesha	ni	Nan
yeeshaan	ni	Nan
yeeshay	ni	Nan
yeeraa	pe	Nan
xorayneed	sílẹ̀	None
yir	yir	Nan
yiraah	wi	Nan
yusuf	yusuf	Nan
yuu	yuuu	Nan
yuusf	jósẹ́fù	Nan
yuusuf	jósẹ́fù	Nan
zanzibar	yoo	None
zaylac	zaylac	Nan
zeilac	zeilac	Nan
zenawi	zenawi	Nan
zoppe	zoppe	Nan
zubeyr	ibi-afẹde	Nan
|	|	Nan
´	?	Nan
´ka	a	Nan
´siyo	rara	Nan
أبي	أبي	Nan
yurubwaana	yuroopu	Nan
yurubta	yuroopu	Nan
yurubiyaanka	ara ilu yuroopu	Nan
yurubcismaaniyiintu	ara ilu yuroopu	Nan
yiraahdaa	pé	None
yiraahdaan	sọ	None
yiraahdeen	nwọn wipe	Nan
yiraahdo	sọ	None
yiraaho	sọ	None
yiri	jọra	Nan
yoonis	yonis	Nan
yiraa	sọ	None
yoorada	yoo	None
youth	ọdọ	Nan
yugandha	uganda	Nan
yuhuuda	ju	Nan
yuhuudiyah	juu	Nan
yuhuudu	juu	Nan
yunusba	ebi	None
yurub	yuroopu	Nan
york	york	None
xorayday	idẹkùn	Nan
xor	ọfẹ	Nan
xoosh	ẹgbọn	Nan
xamsa	elile	Nan
xamuud	ẹru	Nan
xamuulka	ẹru	Nan
xan	olofofo	Nan
xanaanada	ile-ẹkọ jẹle-ẹkọ	Nan
xanaaneeyo	wọn	None
xanaaqay	binu	Nan
xanafiga	inu	Nan
xanbaarsan	rù	Nan
xanta	olofofo	Nan
xanuun	irora	Nan
xanuunsaday	jiya	Nan
xanuunsan	aisan	Nan
xaq	ni ọtun	Nan
xaqa	ooto	Nan
xamarweyne	hamarweyne	Nan
xaqiijinteeda	rẹ	None
xamarka	gomu	Nan
xamare	ẹiyẹle	Nan
xajin	di mu	Nan
xajineyso	tẹsiwaju ninu iṣe	Nan
xajka	fun	None
xajkii	arìnrìn-àjò	Nan
xakiim	ologbon	Nan
xakumi	ṣàkóso	Nan
xal	ojutu	Nan
xalaasha	t’olofin	Nan
xalane	halala	Nan
xali	yanju	Nan
xaliimo	arabinrin	Nan
xalin	yanju	Nan
xalliyaan	yanju o	Nan
xamar	xamar	Nan
xamardaye	awọn aṣọ atẹrin	Nan
xamarjajab	xperience	Nan
xaqiiqa	o daju	Nan
xaqiiqada	o daju	Nan
xaqiiqda	o daju	Nan
xarun	aarin	Nan
xarunta	aarin	Nan
xaruntii	aarin	Nan
xaruunta	aarin	Nan
xasan	imọran naa	Nan
xasar	orílẹ èdè	Nan
xasilooni	iduroṣinṣin	Nan
xasiloonida	iduroṣinṣin	Nan
xassan	dakẹrọrọ	Nan
xasuuq	ipakupa	Nan
xasuuqa	ipaeyarun	Nan
xasuuqan	ipaniyan yii	Nan
xasuuqay	ipakupa	Nan
xasuuqday	ipaniyan	Nan
xasuus	iranti	Nan
xarumo	ohun elo	Nan
xarumaha	awọn ile-iṣẹ	Nan
xarrago	yangan	Nan
xariir	siliki	Nan
xaqiiqo	o daju	Nan
xaradh	ifiweranṣẹ	Nan
xaradheere	tẹ bọtini	Nan
xaraf	leta	Nan
xarafka	abidi	None
xarafkiisa	rẹ	None
xarafle	leta	Nan
xaji	tẹsiwaju ninu iṣe	Nan
xarafluhuna	awọn lẹta	Nan
xarakada	ìṣe	Nan
xarakadu	akitiyan	Nan
xaramkii	gidigidi	None
xarardheere	iyara	Nan
xarfaha	awọn lẹta	Nan
xarfahan	awọn lẹta wọnyi	Nan
xariiqay	ya	Nan
xarafyada	awọn lẹta	Nan
xajarulaswadka	ise ina	Nan
xaggeeda	fún un	Nan
xaggee	nibo	Nan
xaafadda	ni adugbo	Nan
xaafadii	adugbo	Nan
xaafadood	ìgberiko	Nan
xaafidiin	rẹ	None
xaafiiska	ọfiisi	Nan
xaaji	mura si	Nan
xaal	majemu	Nan
xaalada	ipo	None
xaaladaha	ipo	None
xaaladda	ipo	None
xaaladdu	ipo	None
xaaladihii	awọn ayidayida	Nan
xaaraam	arufin	Nan
xaarith	haarith	Nan
xaas	iyawo	None
xaafadaha	ni adugbo	Nan
xaafada	ni adugbo	Nan
xaafad	adugbo	Nan
xaadirka	lọwọlọwọ	Nan
wuqooyi	ariwa	Nan
wuu	oun	None
wuuna	ati on	Nan
wuuxuna	yoo	None
wuxaa	oun	None
wuxu	oun	None
wuxuna	o buru	Nan
xaashi	dì	None
wuxuu	oun	None
wuxuuo	heo	Nan
ww	ww	Nan
wwii	wwii	Nan
wxa	igun apa	Nan
wxaa	ti o jẹ	Nan
x	x	Nan
xaad	irun	Nan
wuxuuna	oun	None
xasuusan	ranti	Nan
xaaskii	iyawo	None
xaasuubka	idan	Nan
xaduud	ààlà	Nan
xafidka	ṣọ	Nan
xafiis	ọfiisi	Nan
xafiiska	ọfiisi	Nan
xafiisyada	awọn ọfiisi	Nan
xafiisyadii	awọn ọfiisi	Nan
xafiisyo	awọn ọfiisi	Nan
xafladan	ni ayẹyẹ yii	Nan
xag	igun	Nan
xaga	sí	Nan
xagaa	igba ooru	Nan
xagaagii	ni igba ooru	Nan
xagaas	ní	None
xagga	lati	Nan
xaggaaga	si ọ	Nan
xadka	to	None
xadiiskan	hadisi yii	Nan
xadiiska	aditi	Nan
xadhig	okun	Nan
xaasuubkiisa	iyawo	None
xaawo	lagun	Nan
xaayow	tẹ bọtini	Nan
xabaal	kan	None
xabad	àyà	Nan
xabasha	lẹ pọ	Nan
xabashida	sin	Nan
xaaskiisii	iyawo	None
xabsi	ninu tubu	Nan
xabsigii	ẹwọn	Nan
xad	to	None
xadaarad	ọlaju	Nan
xadaaradahii	awọn ọlaju	Nan
xaddaaradda	ninu ọgba	Nan
xaddiiska	oye	Nan
xadgudbay	ti reje	Nan
xabsiga	ninu tubu	Nan
woxoona	lonakona	Nan
xasuustaa	o ranti	Nan
xasuustiisana	rẹ	None
xiran	ni pipade	Nan
xiray	paade	Nan
xiraye	asopo	Nan
xirfad	olorijori	Nan
xirfada	oojọ	Nan
xiri	paade	Nan
xiriir	kan	None
xiriira	ti o ni ibatan	Nan
xiriiraan	ibasọrọ	Nan
xiriiri	kan	None
xiriiriyaha	awọn olubasọrọ	Nan
xiriirka	ẹbí	Nan
xiriirto	kan	None
xirnaa	ni pipade	Nan
xirneen	dake enu re	Nan
xir	paade	Nan
xirnimo	bíbo	Nan
xingalool	tingling	Nan
xilliyo	awọn akoko	Nan
xiligan	ni akoko yi	Nan
xiligii	ni asiko	Nan
xiligiimuraadkii	ni awọn akoko	Nan
xiliyada	awọn akoko	Nan
xiliyadii	awọn akoko	Nan
xiliyo	awọn akoko	Nan
xilka	ojuse	None
xilkaas	ipo	None
xilkeeda	rẹ	None
xilli	akoko	Nan
xilligaa	ni igba na	Nan
xilligaas	ni igba na	Nan
xilligaasi	ni igba na	Nan
xilligan	ni akoko yi	Nan
xilligii	akoko	Nan
ximyar	ọmọ	None
xirsi	arabinrin	Nan
xirta	paade	Nan
xirtaa	dake enu re	Nan
xooga	idojukọ	Nan
xoogaa	diẹ ninu	Nan
xoogag	awọn ipa	Nan
xoogan	lagbara	Nan
xoogana	lagbara	Nan
xoogaysteen	lagbara	Nan
xoogga	okun	Nan
xoojinta	isọdọkan	Nan
xoola	agbo	Nan
xoolaha	ohun ọ̀sin	Nan
xoolaheeda	rẹ	None
xoolaley	oluṣọ-agutan	Nan
xoolihii	awon eranko	Nan
xoolo	ohun ọ̀sin	Nan
xooluhuna	àwọn ohun ọ̀sìn	Nan
xoog	okun	Nan
xogo	alaye	Nan
xoghayaha	akọwe	Nan
xoghaya	akọwe	Nan
xirtaan	rẹ	None
xisaab	mathimatiki	None
xisaabaadka	awọn iroyin	Nan
xisaabin	ṣe iṣiro	Nan
xisaabta	mathimatiki	None
xisaabtan	iṣiro	Nan
xisbi	ẹgbẹ	Nan
xiligaasoo	ni igba na	Nan
xisbiga	ajọ naa	Nan
xisbigiisa	rẹ	None
xisbiyada	awọn ẹgbẹ	Nan
xisbiyo	awọn ẹgbẹ	Nan
xishoon	itiju	Nan
xitaa	ani	Nan
xkhayre	ẹlẹṣin	Nan
xog	alaye	Nan
xisbigii	ajọ naa	Nan
xiligaasi	ni igba na	Nan
xiligaas	ni igba na	Nan
xiligaa	ni igba na	Nan
xeeran	yika	Nan
xeerar	ofin	None
xeerarka	ofin	None
xeerarkeeda	rẹ	None
xeerka	ofin	None
xeraale	ogun	None
xerada	àgọ́	None
xero	àgọ́	None
xh	xh	Nan
xhks	xhks	Nan
xidh	paade	Nan
xidha	paade	Nan
xidhaayey	tiipa	Nan
xidhay	paade	Nan
xidhiidh	kan	None
xeer	ofin	None
xeelliga	ni o tọ	Nan
xeeldheeri	ilana	None
xeeldheer	ni ọgbọn	Nan
xasuusto	ranti	Nan
xataa	ani	Nan
xawaadle	isare	None
xawaaladaha	awọn gbigbe ọja	Nan
xawaannada	ni awọn iyara	Nan
xawda	iyara	Nan
xayaawaanaadka	ẹranko	Nan
xidhiidha	ti o ni ibatan	Nan
xayawaan	ẹranko	Nan
xayle	ọra	Nan
xds	xds	Nan
xeeb	eti okun	Nan
xeebaha	awọn eti okun	Nan
xeebeed	etikun	Nan
xeebta	eti okun	Nan
xeel	ọgbọn	Nan
xayawaanaadka	ẹranko	Nan
xasuustaan	ranti	Nan
xidhiidhka	ibaraẹnisọrọ	Nan
xidhiidhno	awọn olubasọrọ	Nan
xigto	awọn ibatan	Nan
xiiirto	fa irun	Nan
xiiray	fá	Nan
xiiseyneysid	nife	Nan
xiiso	awon	Nan
xijaaz	xijaaz	Nan
xijrootay	boju	Nan
xikmad	ọgbọn	Nan
xil	ojuse	None
xilagan	ni akoko yi	Nan
xilal	ojuse	None
xildhibaan	mp	Nan
xilgii	akoko naa	Nan
xili	asiko	Nan
xiliga	akoko	Nan
xigtay	itele	Nan
xigtaa	t’okan	Nan
xigta	itele	Nan
xigo	itele	Nan
xidhiidho	awọn olubasọrọ	Nan
xidhka	wọ	Nan
xidhkii	awọn	Nan
xidhnaan	dake enu re	Nan
xidhnaantii	dake enu re	Nan
xidho	rẹ	None
xidid	gbongbo	None
xidhiidhkaasi	ibatan yẹn	Nan
xifdin	lati toju	Nan
xigaa	itele	Nan
xigaan	t’okan	Nan
xigay	itele	Nan
xigeen	igbakeji	Nan
xigeenka	igbakeji	Nan
xigeenkii	alabojuto	Nan
xigmadda	ọgbọn	Nan
xiga	itele	Nan
tuso	ṣafihan	Nan
tusaayo	fihan	None
tusaan	wọn	None
shacbigu	ita	Nan
shaciga	ofin	None
shadoor	awọn gbagede	Nan
shahaadada	ìyí	Nan
shahaadataynku	iwe-ẹri	Nan
shahaado	ìyí	Nan
shahiirsanadii	awọn alaigbede	Nan
shaki	aniani	Nan
shalaanbood	oriire	None
shalay	lana	Nan
shan	inu mimu	Nan
shanaad	ikarun	Nan
shanaadwaxaana	ikarun	Nan
shanfarood	marun-marun	Nan
shanta	marun	Nan
shacbigii	ita	Nan
shantaan	awọn marun wọnyi	Nan
shacbigana	awon eniyan	Nan
shacbi	ita	Nan
shabac	shabab	Nan
shabahdaa	iyẹn	Nan
shabakad	oju opo wẹẹbu	Nan
shabakada	wẹẹbu	Nan
shabeel	ẹyẹ	Nan
shabeelaha	awọn amotekun	Nan
shabeellaha	awọn amotekun	Nan
shabeelle	shabelle	Nan
shabele	leéléle	Nan
shabelle	shabelle	Nan
shacab	alagbada	Nan
shacabka	awon eniyan	Nan
shacabkii	ita	Nan
shacabkooda	eniyan won	Nan
shacabku	ita	Nan
shacbiga	ita	Nan
shantaasi	iyẹn	Nan
shaqaalaha	oṣiṣẹ	Nan
shaqaale	oṣiṣẹ	Nan
shaqeynaya	ṣiṣẹ	Nan
shaqeynayay	ṣiṣẹ	Nan
shaqeysata	ṣiṣẹ	Nan
shaqo	iṣẹ	Nan
shaqooyinka	awọn iṣẹ	Nan
shaqsi	ẹnikọọkan	Nan
shaqsiyaad	olúkúlùkù	Nan
shaqsiyaadka	olúkúlùkù	Nan
sharaf	ọlá	Nan
sharafkii	ọlá	Nan
sharafta	iyì	Nan
sharaxday	se alaye	Nan
sharci	ofin	None
sharciga	ofin	None
sharcigaa	ofin	None
shaqeeyo	ṣiṣẹ	Nan
shaqeeyey	ṣiṣẹ	Nan
shaqeeyeen	ṣiṣẹ	Nan
shaqeeyay	ṣiṣẹ	Nan
shaqaalihii	awọn oṣiṣẹ	Nan
shaqaaq	rudurudu	Nan
shaqada	nibi ise	Nan
shaqadii	iṣẹ	Nan
shaqadiisa	rẹ	None
shaqal	ẹ̀jẹ́	Nan
shaqalka	ẹbọ	Nan
shabaabka	àwọn	Nan
shaqayn	iṣẹ	Nan
shaqaysay	ṣiṣẹ	Nan
shaqeen	ṣiṣẹ	Nan
shaqeesa	iho	Nan
shaqeesaa	ṣiṣẹ	Nan
shaqeeya	ṣiṣẹ	Nan
shaqeeyaa	ṣiṣẹ	Nan
shaqeeyaan	iṣẹ	Nan
shaqaynta	ṣiṣẹ	Nan
sharcigu	ofin	None
shaati	seeti	Nan
shaam	shaam	Nan
saxaarada	atẹ	Nan
saxaaro	otita	Nan
saxaraa	otita	Nan
saxaraha	feces	Nan
saxda	tọ	Nan
saxeexday	fowo si	Nan
saxeexdeen	fowo si	Nan
saxiixday	fowo si	Nan
saxiixdeen	fowo si	Nan
saxo	tọ	Nan
saxons	saxons	Nan
say	sọ	None
sayid	ọga	Nan
sayidka	ọlọrun	Nan
sayidku	ọga	Nan
saxaafadda	ninu atẹjade	Nan
saylac	sọ	None
saxaafada	ninu atẹjade	Nan
sax	tọ	Nan
sarkaalkii	ọgágun	Nan
sarkozy	sarkozy	Nan
sarreeye	ga	Nan
sasha	sasha	Nan
sasiiliya	oniyebiye	Nan
saudi	saudi	Nan
sawaaxiliga	swahili	None
sawir	aworan	Nan
sawirada	awọn aworan	Nan
sawiran	ya aworan	Nan
sawiray	ya aworan	Nan
sawiraya	iyaworan	Nan
sawirka	aworan	Nan
sawirmaan	fa	Nan
sawirro	awọn aworan	Nan
saxaabi	atunse	None
saylada	ọjà	Nan
saylici	ọga	Nan
saynis	sayensi	Nan
senator	igbimọ	Nan
sep	sep	Nan
serbia	serbia	Nan
servant	iranṣẹ	Nan
service	iṣẹ	Nan
services	awọn iṣẹ	Nan
several	lọpọlọpọ	Nan
seyfi	sefi	Nan
seynab	saynab	Nan
sgaas	siga	Nan
sh	sh	Nan
shaac	ṣalaye	Nan
shaafici	oju iwe	Nan
shaah	tii	Nan
shaahii	tii	Nan
seexday	sùn	Nan
seexan	sun	None
seegaaya	padanu	Nan
sedex	mẹta	Nan
sayniska	sayensi	Nan
schleicher	oloye	None
school	ile-iwe	Nan
schoolership	ikowe	Nan
schoolka	ile-iwe	Nan
schools	awọn ile-iwe	Nan
scw	scw	Nan
shaarub	apo-irun	Nan
sdarbi	oun	None
sebteembar	oṣu kẹsan	Nan
sebtembar	oṣu kẹsan	Nan
second	ikeji	Nan
secondary	atẹle	Nan
section	apakan	Nan
security	aabo	Nan
sede	ẹda	Nan
sdwo	bẹwò	Nan
sharciya	t’olofin	Nan
sharciyada	ofin	None
sharciyeed	t’olofin	Nan
shinema	tàn	Nan
shingaani	awọn idena	Nan
shiniile	alagidi	Nan
shir	apejọ	Nan
shirakadahani	awọn ile-iṣẹ wọnyi	Nan
shirarkii	awọn apejọ	Nan
shirdahan	fun	None
shire	shire	Nan
shirkaa	ile asofin ijoba	Nan
shirkaas	nibi ipade na	Nan
shirkad	ile-iṣẹ	Nan
shirkada	ile-iṣẹ	Nan
shirkadaha	awọn ile-iṣẹ	Nan
shirkadahaas	awọn ile-iṣẹ wọnyẹn	Nan
shirkadahan	awọn ile-iṣẹ wọnyi	Nan
shineemo	sinima	Nan
shirkadahani	awọn ile-iṣẹ wọnyi	Nan
shimbiruhu	àwọn ẹyẹ	Nan
shimbiraha	àwọn ẹyẹ	Nan
shige	ibaamu	Nan
shiikh	sheikh	Nan
shiikha	shiikha	Nan
shiikhu	shiikhu	Nan
shiinaha	ṣaina	Nan
shiinuhu	ṣaina	Nan
shiiq	shiiq	Nan
shiiqaal	fokii	Nan
shiiraar	kanfasi	Nan
shil	ijamba	Nan
shilaabo	kaabọ	Nan
shilin	shillings	Nan
shilinka	owo re	Nan
shilling	shilling	Nan
shimbir	eye	Nan
shimbiro	àwọn ẹyẹ	Nan
shirkadda	ile-iṣẹ	Nan
shirkado	awọn ile-iṣẹ	Nan
shirkadood	awọn ile-iṣẹ	Nan
siday	bi	Nan
sidda	bi	Nan
side	ẹgbẹ	Nan
sidee	bawo	Nan
sideed	mẹjọ	Nan
sideedaad	ikẹjọ	Nan
sideedan	mẹjọ wọnyi	Nan
sideedii	awọn mẹjọ	Nan
sideetameeyadii	awọn eighties	Nan
sidey	gbe	None
sidi	fẹran	Nan
sidii	bi	Nan
sidiisii	gẹgẹ bi tirẹ	Nan
sido	gbe	None
sidoo	pelu	Nan
sidatan	bi	Nan
sidan	ni ọna yi	Nan
sidae	bawo	Nan
sidaasi	accordingly	Nan
shirkan	ipade yii	Nan
shirki	jogun	None
shirkii	agun	Nan
shiro	ipalọlọ	Nan
shirqool	iditẹ	Nan
shirweynahan	ni apejọ yii	Nan
shisheeye	ajeji	Nan
shift	yi lọ yi bọ	Nan
shuceyb	padanu	Nan
siad	ti	Nan
siciid	le	None
sida	bi	Nan
sidaa	nitorinaa	Nan
sidaad	bawo	Nan
sidaan	ni ọna yi	Nan
sidaas	nitorinaa	Nan
si	sí	Nan
shido	tan-an	Nan
shiday	tan-an	Nan
shidaalka	epo	Nan
shayga	ohun naa	Nan
shcali	fun	None
sheeg	sọ	None
sheega	sọ	None
sheegaa	nperare	Nan
sheegaan	sọ	None
sheegaas	itẹnumọ	Nan
sheeganaya	beere	Nan
sheegay	ṣalaye	Nan
sheegaya	nmẹnuba	Nan
sheegayaa	nmẹnuba	Nan
sheegayaan	sọ	None
sheegayo	nmẹnuba	Nan
sheegeen	ṣalaye	Nan
sheegey	so	None
shaydaan	satan	Nan
shaybah	shayba	Nan
shay	nnkan	Nan
shaxda	tabili	None
sharciyeynaayey	abẹ	Nan
sharciyo	ofin	None
shardi	majemu	Nan
shardiga	majemu	Nan
shareecada	sharia	Nan
sharif	sharif	Nan
shariif	sharif	Nan
sheegganaa	beere	Nan
shariifka	awọn sheriff	Nan
sharkiisa	rẹ	None
sharkiisaba	rẹ	None
sharmaarke	ko	None
sharmaarkeعبد	asọye عبد	Nan
sharmake	yanyan	Nan
shatt	fọ	Nan
shax	tabili	None
shariifku	pẹpẹ	Nan
sarkaal	oṣiṣẹ	Nan
sheegganayd	so	None
sheegi	sọ	None
sheekhu	itan	Nan
sheekhulislaam	sheikhulislam	Nan
sheeko	itan	Nan
sheekooyinka	awọn itan	Nan
sheekooyinkii	awọn itan	Nan
sheikh	sheikh	Nan
shekh	shekh	Nan
sheyba	sheaba	Nan
sheydaankii	eṣu	Nan
shibane	shiban	Nan
shibil	ijamba	Nan
shibilka	ijamba	Nan
shibis	awọn apejọ	Nan
shicibka	ita	Nan
shidaal	epo	Nan
sheekhii	itan	Nan
sheekheena	itan wa	Nan
sheekhaal	itan	Nan
sheekha	onirohin	Nan
sheegin	lai mẹnuba	Nan
sheegnay	mẹnuba	Nan
sheegnaya	nmẹnuba	Nan
sheegnayba	ment	Nan
sheego	sọ	None
sheegsheegta	beere	Nan
sheegta	beere	Nan
sheeggayga	ibeere mi	Nan
sheegtaa	nperare	Nan
sheegtada	beere	Nan
sheegtay	so	None
sheegto	beere	Nan
sheekada	itan	Nan
sheekayn	itan	Nan
sheekayno	iwiregbe	Nan
sheekh	sheikh	Nan
sheegtaan	beere	Nan
sarifo	paṣipaarọ	Nan
sarfiga	paṣipaarọ	Nan
sareysa	ga	Nan
saara	yọ	None
saaraa	kuro	Nan
saaraan	kuro	Nan
saaran	loju	Nan
saaray	gbe	None
saarayso	rara	Nan
saareen	ṣọfọ	Nan
saarey	ti own	Nan
saari	yọ	None
saarida	iyọkuro	Nan
saarka	ọja	Nan
saarkeeda	lórí i rẹ	Nan
saarkooda	wọn	None
saarnaa	loju	Nan
saaro	kuro	Nan
saar	yọ	None
saartaa	gbe	None
saanmarino	shaman	Nan
saan	eyi	Nan
saabsan	nipa	Nan
saabsanaa	nipa	Nan
saacad	wakati	Nan
saacada	wakati	Nan
saacadaha	wakati	Nan
saadka	eekaderi	Nan
saaiidi	ati	Nan
saalax	mo tọrọ gafara	Nan
saamaxday	dariji	Nan
saamaxeen	dariji	Nan
saamaynta	awọn ipa	Nan
saamaysay	fowo	Nan
saambiya	oniyebiye	Nan
saami	o yẹ	Nan
saamo	ọja	Nan
saanad	ọdun	Nan
saartay	gbe	None
saas	nitorinaa	Nan
saaxiib	ọ̀rẹ́	Nan
sabtida	satide	Nan
sabtiga	lojo satide	Nan
sac	maalu	Nan
sacad	ahere	Nan
sacaridalaxdageelka	fifọ	Nan
saciid	itọ	Nan
sacuudi	orilẹ-ede saudi	Nan
sacuudiga	ẹni mimọ	Nan
sadaam	saddam	Nan
sadaan	s	Nan
sadam	sadam	Nan
sadamna	sadna	Nan
sadaqada	aanu	None
sadaqo	aanu	None
sadax	mẹta	Nan
sabti	satide	Nan
sabriye	ẹlẹṣẹ	Nan
saboolsan	talaka	None
sabool	talaka	None
saaxiibka	ọ̀rẹ́	Nan
saaxiibtinimo	ore	Nan
saaxiibtinnimo	ore	Nan
saaxiil	oluṣeto	Nan
saaxil	oluṣeto	Nan
sab	nitori	Nan
saba	aiṣedeede	Nan
sa	ṣeto	Nan
sabab	idi	Nan
sababay	ṣẹlẹ	Nan
sababeen	ṣẹlẹ	Nan
sababta	idi	Nan
sababtay	ṣẹlẹ	Nan
sababto	awọn okunfa	Nan
sababtoo	nitori	Nan
sablaale	yiyọ	Nan
sababaha	awọn idi	Nan
s	s	Nan
ruwanda	omi	None
ruuxna	kankan	None
roma	róòmù	Nan
romaankuba	pomegranate	Nan
roman	róòmù	Nan
romania	romania	Nan
romanku	róòmù	Nan
rome	chrome	Nan
roob	ojo	None
roobab	ojoriro	Nan
roobka	ojo	None
roobkana	ojo	None
roobku	ojo	None
rooble	oṣumare	Nan
roobleh	oṣumare	Nan
roof	orule	Nan
rooma	pomegranate	Nan
rogrogan	yiyi	Nan
rogaye	yiyi	Nan
rogay	yipada	None
roelof	eegun	Nan
ridey	ọkọ ofurufu	Nan
rido	bẹrẹ	Nan
rigliga	rig	Nan
rinjiga	kun	Nan
river	odo	Nan
riyaale	àlá	Nan
riyada	àlá	Nan
roomaaniyiinta	awọn ara ilu romania	Nan
riyadaas	àlá yẹn	Nan
riyadoodii	wọn	None
riyaha	awọn ewurẹ	Nan
riyo	àlá	Nan
roaming	ririnirin	Nan
robust	logan	Nan
rodes	awọn iyipo	Nan
rodolfo	poundolfo	Nan
riyadii	àlá	Nan
sadaxaad	kẹta	None
roomaanka	lomunu lẹ	Nan
roon	o dara	Nan
rumeysan	gbagbọ	Nan
rumeysey	gbaagbo	Nan
run	ooto	Nan
runta	ooto	Nan
runtii	nitootọ	Nan
runtiisa	ooto	Nan
ruqiya	arekereke	Nan
ruqiyo	awọn itanran	Nan
rususha	wọn	None
rusushii	ó	None
ruug	tougher	Nan
ruush	ara ilu rọsia	Nan
ruushka	ara ilu rọsia	Nan
ruux	ẹmi	Nan
ruuxii	ẹmi naa	Nan
rumeyn	gbaagbo	Nan
rumeeyo	gbaagbo	Nan
rumeeyay	gbagbọ	Nan
rumeeyana	gba	None
roone	roon	Nan
rooraaye	ririnirin	Nan
rootiga	burẹdi	Nan
rotterdam	iyipo	Nan
rpp	rpp	Nan
rugta	ile agbon	Nan
rukuucda	awọn iwe-ara	Nan
roomaanku	romania	Nan
rumawdo	rumawdo	Nan
rumaynta	onigbagbọ	Nan
rumayntooda	wọn	None
rumayntu	onigbagbọ	Nan
rumaynu	a gbagbo	Nan
rumaysan	gbagbọ	Nan
rumaysanyahay	gba	None
rumayso	gbaagbo	Nan
rumaynayo	gbaagbo	Nan
sidookele	tun	Nan
sadaxaadna	kẹta	None
saddax	mẹta	Nan
sameeyo	ṣe	Nan
sameyn	ṣe	Nan
sameysa	ṣe	Nan
sameyso	se o	Nan
sameystay	ṣe	Nan
samidiyo	fidio	Nan
samir	ṣe suuru	Nan
samo	ri	Nan
samow	pẹlẹ o	Nan
samroon	sambar	Nan
samsamka	awọn sams	Nan
samyn	ṣe	Nan
san	mọ	Nan
sanaag	sag	Nan
sanad	ọdun	Nan
sameeyey	ṣe	Nan
sanadadii	ọdun	Nan
sameeyeen	ṣe	Nan
sameeyawaa	ṣe iyẹn	Nan
samaawiga	awọn ọrun	Nan
samada	ọrun	Nan
samaron	ọgbọn	Nan
samaroon	ọrun	Nan
samaroonku	awọn ọrun	Nan
samatalis	samatalis	Nan
samatar	idalaba	Nan
samayn	ṣe	Nan
samaynaya	n ṣe	Nan
samaysan	ṣe	Nan
samaysay	ṣe	Nan
samaysiga	ibiyi	Nan
sameenta	ṣe	Nan
sameeya	ṣe	Nan
sameeyaan	ṣe	Nan
sameeyay	ṣe	Nan
sanadahan	ni awọn ọdun wọnyi	Nan
sanadihii	ọdun	Nan
sanadii	ọdun	Nan
sannadkii	ọdun	Nan
sannadku	ọdun	Nan
sano	ọdun	Nan
sapienza	sapienza	Nan
saqiireen	ni ọsan	Nan
saraakiil	awọn olori	Nan
saraakiisha	awọn oṣiṣẹ	Nan
saraakiishii	awọn olori	Nan
saraar	ààfin	Nan
saransoor	saransoor	Nan
sardiiniya	sardius	Nan
sare	ga	Nan
sareeya	ga	Nan
sareeyo	ga	Nan
sarena	ga	Nan
sannadkaasna	ni ọdun yẹn	Nan
sannadkaas	ni ọdun yẹn	Nan
sannadihii	ọdun	Nan
sannadahan	ni awọn ọdun wọnyi	Nan
sanadka	ọdun	Nan
sanadkaa	ni ọdun yẹn	Nan
sanadkaana	odun yi	Nan
sanadkaas	ni ọdun yẹn	Nan
sanadkan	odun yi	Nan
sanadki	lododun	Nan
sanadkii	ọdun	Nan
samaale	sam	Nan
sanadkiiba	ni ọdọọdun	Nan
sanadku	ọdun	Nan
sanado	ọdun	Nan
sanadood	ọdun	Nan
sanca	sanca	Nan
sand	iyanrin	Nan
sandkii	ọdun	Nan
sanka	imu	Nan
sanadkooda	wọn	None
salma	salma	Nan
salka	ipilẹ	Nan
saliim	salim	Nan
safraan	irin-ajo	Nan
safray	ajo	None
safraya	irin-ajo	Nan
safri	irin-ajo	Nan
sagaal	mẹsan	Nan
sagaalaad	ẹkẹsan	Nan
sagaaliyotobnaad	ogun	None
sagaalkooda	wọn	None
sahal	rọrun	Nan
sahashay	ija ebora	Nan
sahlan	rọrun	Nan
sahra	sarara	Nan
saint	mimọ	Nan
sakada	ọla	Nan
sakariye	skru	Nan
safiya	owurọ	Nan
safiirkii	aṣojú	Nan
safiirka	aṣoju	Nan
safarrada	ajo	None
saddaxda	awọn mẹta	Nan
saddex	mẹta	Nan
saddexaad	kẹta	None
saddexda	mẹta	Nan
saddexdooduba	gbogbo awọn mẹtẹẹta	Nan
sadex	mẹta	Nan
sadexaad	kẹta	None
sakiin	felefele abẹfẹlẹ	Nan
sadexda	awọn mẹta	Nan
sadqeeyay	ti o jowo	Nan
safaarada	ifiweranṣẹ	Nan
safaaradaha	awọn ọffisi	Nan
safar	ajo	None
safarka	irin-ajo	Nan
safarkii	irin-ajo	Nan
safarkiisii	rẹ	None
sadexdii	awọn mẹta	Nan
sadaxda	awọn mẹta	Nan
sako	ifiranṣẹ	Nan
sal	salọ	Nan
salbalaadhan	eyi	Nan
saldanad	ọdun	Nan
saldanada	tiwa	Nan
saldanadda	awọn ọwọn	Nan
saldanadii	baba wa	Nan
saldanado	ọdun	Nan
saldhig	mimọ	Nan
saldhiga	mimọ	Nan
saldhigga	ni ipilẹ	Nan
saldhigyo	awọn ipilẹ	Nan
saleebaan	konge	Nan
saleemaan	wọn	None
salfiyo	iyọ	Nan
saliid	epo	Nan
saliida	epo	Nan
salaysanyahay	ti wa ni ipilẹ	Nan
salaysan	orisun	None
salal	saladi	Nan
salafusaalixa	kí	None
salaad	àdúrà	Nan
salaadda	àdúrà	Nan
salaaddu	àdúrà	Nan
salaadeed	àdúrà	Nan
salaadood	àdúrà	Nan
salaam	pẹlẹ o	Nan
salaama	pẹlẹ o	Nan
saksonku	rẹ	None
salaan	pẹlẹ o	Nan
salaanee	pẹlẹ o	Nan
salaanka	akaba	Nan
salaannee	kí	None
salaaxudiin	kí	None
salad	saladi	Nan
salafiyiinta	awọn salafists	Nan
salafka	saffron	Nan
salaancarrabey	salisecarrabey	Nan
siduu	accordingly	Nan
sierra	sierra	Nan
sifaadkiisa	awọn eroja	Nan
tansaaniya	tanzania	Nan
taqaan	se o mo	Nan
taqaano	se o mo	Nan
taqasusay	alagbara	Nan
taqasustay	amọja ni	Nan
tara	mẹsan	Nan
taraawiil	trailer	Nan
tarayn	ọrọ asan	Nan
tarbiyada	ajọbi	Nan
tarbiyeesan	dabaru	Nan
tareen	ọkọ oju-irin	Nan
tari	ikọaláìdúró	Nan
tarjamada	ogbufọ	Nan
tartamaayey	idije	Nan
tartami	dije	Nan
tani	àjọ who	Nan
tartanka	idije	Nan
tan	eyi	Nan
tamar	agbara	None
taliyaaniga	ilu italia	Nan
taliyaanigu	ara italia naa	Nan
taliyaanu	adarí	Nan
taliyaha	adarí	Nan
taliye	kan	None
taliyeen	nimoran	Nan
taliyihii	gomina	None
taliyo	ṣàkóso	Nan
talo	imọran	Nan
talyaani	ilu italia	Nan
talyaaniga	ilu italia	Nan
talyaanigasyl	ilu italia	Nan
talyaanigu	ilu italia	Nan
talyaaniguna	ilu italia	Nan
talyaniga	ilu italia	Nan
tamarta	agbara	None
tartankii	idije	Nan
tashaday	gbimọran	Nan
tashik	ilọkuro	Nan
teelteel	lorekore	Nan
tegay	lọ	Nan
tegey	lọ	Nan
tegeysaan	o nlo	Nan
tegi	kuro patapata	Nan
tegin	kuro patapata	Nan
telcom	telcom	Nan
teleefonada	lori tẹlifoonu	Nan
telefoion	tẹlifoonu	Nan
telefoon	tẹlifoonu	Nan
telefoonada	awọn foonu	Nan
terre	terre	Nan
testify	jẹri	Nan
textalign	textalign	Nan
tfgda	tfgda	Nan
teedsan	pẹlú	Nan
teeda	rẹ	None
technology	imọ-ẹrọ	Nan
tech	tekinoloji	Nan
tashteen	tashing	Nan
tasi	tasi	Nan
tawraad	bibeli	None
tawreet	e dupe	Nan
taxaabaan	wọn	None
taxane	jara	Nan
taxnaa	jara	Nan
taliyaani	balogun	Nan
tay	tay	Nan
taymiya	sọ	None
tayo	didara	Nan
ta´shilin	irin-ajo	Nan
tchad	tchad	Nan
tdma	tdma	Nan
tebin	itumọ	Nan
tebiyey	royin	Nan
tayada	didara	Nan
taliskii	ofin	None
taliska	pipaṣẹ	Nan
talisa	rẹ	None
taasaa	o n niyen	Nan
taasi	iyẹn	Nan
taasina	iyẹn	Nan
taasna	iyen	None
taasoo	ewo	Nan
taaxane	ọlọrọ	Nan
taba	taba	Nan
tababarada	idanileko	Nan
tababaran	oṣiṣẹ	Nan
tababare	olukọ	Nan
tababarka	idanileko	Nan
tabo	iranran	Nan
tacliin	eko	None
tacliinta	omowe	Nan
tada	gbe	None
taas	iyẹn	Nan
taarikhda	itan	Nan
taarikh	itan	Nan
taariiqyahano	òpìtàn	Nan
taan	eyi	Nan
taangiyada	awọn tanki	Nan
taar	ọjọ	Nan
taariikh	itan	Nan
taariikhda	itan	Nan
taariikhdadhaqanka	omi	None
taariikhdii	itan	Nan
tafiirmaan	kuro patapata	Nan
taariikhdu	itan	Nan
taariikhi	itan	Nan
taariikhiga	itan	Nan
taariikho	awọn ọjọ	Nan
taariikhood	awọn ọjọ	Nan
taariikhyahan	akẹkọ itan-akọọlẹ	Nan
taariikhyahanada	òpìtàn	Nan
taariiqyahanka	itan	Nan
taariikheed	itan	Nan
th	th	Nan
tafsiirka	itumọ	Nan
tagaa	lọ	Nan
talaabadan	igbesẹ yii	Nan
talaabo	igbesẹ	Nan
talaadada	lojo tuside	Nan
talaado	ọjọru	Nan
talada	imọran	Nan
taladana	imọran	Nan
taladii	imọran	Nan
taladu	imọran	Nan
talagalay	fun	None
talayaaniga	ilu italia	Nan
taleefoonada	awọn tẹlifoonu	Nan
taleex	tẹlifoonu	Nan
tali	àjọ who	Nan
talin	imoran	Nan
talis	pipaṣẹ	Nan
talaabada	igbesẹ	Nan
tala	imọran	Nan
tajwiidka	ninu torah	Nan
tahliil	iledìí	Nan
tagaan	lọ	Nan
tagay	lọ	Nan
tagaya	lọ	Nan
tage	lati lọ	Nan
tageen	lọ	Nan
tagey	lọ	Nan
tagin	má lọ	Nan
taga	ferese	Nan
tagisteeduna	rẹ	None
tagsiile	takisi	Nan
tagtada	samisi	Nan
tagteen	lọ	Nan
tagto	lọ	Nan
tahay	o ti wa	Nan
tahaye	ibanujẹ	Nan
tahayna	ti o ba wa	Nan
tago	lọ	Nan
taamyeeloo	ibaamu	Nan
that	iyẹn	Nan
their	wọn	None
tolayoo	tọki	Nan
tolkayoo	tositi	Nan
tooda	tositi	Nan
toogasho	gbon	Nan
toona	bẹẹni	Nan
tooreyda	chowder	Nan
toori	so	None
toos	taara	Nan
toosa	jii dide	Nan
toosan	taara	Nan
toosanaha	taara	Nan
toose	taara	Nan
toosoo	jii dide	Nan
top	oke	Nan
toqoshi	sí	Nan
tol	tol	Nan
towfiiq	towfiiq	Nan
togwajaale	le	None
togga	odo	Nan
tobankii	awọn mẹwa	Nan
tobnaad	kẹwa	Nan
toc	àá	Nan
todabaadka	ọsẹ	Nan
today	loni	Nan
toddoba	meje	Nan
toddobo	meje	Nan
todoba	meje	Nan
todobaad	ọsẹ	Nan
todobaadka	ọsẹ	Nan
todobada	awọn meje	Nan
todobo	meje	Nan
togagga	awọn ṣiṣan	Nan
togdheer	togdheer	Nan
togdheersanaag	jẹ mọ	Nan
togo	lati lọ	Nan
town	ilu	Nan
towxiidka	iṣaro	Nan
training	idanileko	Nan
turjumaha	onitumọ naa	Nan
turjume	onitumọ	Nan
turjumey	itumọ	Nan
turkey	tọki	Nan
turki	tọki	Nan
turkida	tọki	Nan
turkiga	tọki	Nan
turkigamaadaama	nitori tọki	Nan
turkigawaxa	tọki	Nan
turkigu	tọki	Nan
turkish	tọki	Nan
turkiya	tọki	Nan
turkki	turkki	Nan
turkumaanka	turku	Nan
tusaale	fun	None
tunisya	tunesya	Nan
tunisiya	ran leti	Nan
tunisia	tunisia	Nan
tunis	tune	Nan
transmission	gbigbe	Nan
transnistria	transnistria	Nan
tu	tu	Nan
tubane	tubane	Nan
tubayoo	iyipada	Nan
tubeec	tubeec	Nan
tukado	gbadura	Nan
tobanka	mẹwa	Nan
tukan	ngbadura	Nan
tukanayo	ngbadura	Nan
tukelalmimurcood	tukelalmimurcood	Nan
tukuhu	ajile	Nan
tuldo	tuldo	Nan
tuluddiiye	olukọni	Nan
tumay	iṣuu	Nan
tuni	rannileti	Nan
tukanaya	ngbadura	Nan
toban	mẹwa	Nan
to	sí	Nan
tixraacyada	awọn itọkasi	Nan
tiirsada	le	None
tiirsan	igbẹkẹle	Nan
tiirsanaa	igbẹkẹle	Nan
tiirsantahay	igbẹkẹle	Nan
tiirsanyahay	le	None
tijaaradii	adanwo	Nan
tijaareeyo	ìrora	Nan
tijaaro	warìri	Nan
tikrit	tiketi	Nan
tilaami	tilami	Nan
tilmaamaa	n ṣe idanimọ	Nan
tilmaamaan	tọka si	Nan
tilmaaman	itọkasi	Nan
tilmaamay	se afihan	Nan
tilmaamayo	ntoka	None
tiirka	ọwọn	Nan
tiirarkaasina	awọn wọnyi ọwọn	Nan
tiirarka	àwọn ọwọ̀n	Nan
tiirar	awọn ọwọn	Nan
there	ní	None
these	iwọnyi	Nan
they	wọn	None
this	eyi	Nan
through	nipasẹ	Nan
throughout	jakejado	Nan
ti	ti	Nan
tilmaameen	se afihan	Nan
tidhaah	pé	None
tignolajiyada	imọ-ẹrọ	Nan
tigreega	tikẹti	Nan
tihiin	ti o ba wa	Nan
tii	tii	Nan
tiil	alẹmọ	Nan
tiille	tiille	Nan
tiir	ẹka	Nan
tidhi	sọ	None
the	awọn	Nan
tilmaami	tọka si	Nan
tilmaanayba	tọka si	Nan
tiriyey	ka	Nan
tiriyo	ka	Nan
tiro	nọmba	Nan
tirokoob	eeka	Nan
tirsan	ọmọ	None
tirsana	wọn	None
tirsanaa	wà	Nan
tirsanaan	ka	Nan
tix	jc	Nan
tixda	atokọ	Nan
tixdan	ṣakiyesi	Nan
tixdii	ronu	Nan
tixdiisa	rẹ	None
tixihiisa	rẹ	None
tixraac	itọkasi	Nan
tiriyay	ka	Nan
tirin	ka	Nan
tiri	ka	Nan
tiran	alẹmọ	Nan
timaadada	kọja siwaju	Nan
timaaddo	lati wa	Nan
timacade	lọ	Nan
time	aago	Nan
times	awọn akoko	Nan
timi	kọja siwaju	Nan
timid	dé	None
tilmaamo	ilana	None
timide	kọja siwaju	Nan
timo	irun	Nan
timocade	timocade	Nan
tinta	irun	Nan
tira	nira	Nan
tirad	nọmba	Nan
tirada	nọmba	Nan
tirakoob	eeka	Nan
timirta	ọpẹ	Nan
riday	fisile	Nan
taamaayee	e dupe	Nan
taalla	wa	Nan
socotada	ajo	None
socotay	tesiwaju	Nan
socoto	ti nlọ lọwọ	Nan
soddon	ọgbọn	Nan
software	sọfitiwia	Nan
softwareku	sọfitiwia	Nan
sogüt	sogüt	Nan
soka	gún	None
sokeeyay	ṣọ	Nan
sokeeye	ara ilu	Nan
sokow	yàtò	None
soltelco	soltelco	Nan
somaaliland	ara ilu somaliland	Nan
somaaliya	somalia	Nan
somaaliyeed	arakunrin	Nan
socota	atẹle	Nan
somailand	ara ilu somaliland	Nan
socono	awa nlo	Nan
socon	ririn	Nan
socda	atẹle	Nan
socdaa	ti nlọ lọwọ	Nan
socdaal	irin-ajo	Nan
socdaale	ajo	None
socdaalka	iṣilọ	Nan
socdaan	ririn	Nan
socdaanba	ti nlọ lọwọ	Nan
socday	lọ	Nan
socdaydhaqaalaha	ọrọ-aje	Nan
socdeen	rin	Nan
socdey	tesiwaju	Nan
socdeyna	ririn	Nan
socdo	ririn	Nan
soco	tẹsiwaju	Nan
socodka	ririn	Nan
soconno	ririn	Nan
somali	arabinrin	Nan
somalia	somalia	Nan
somalialand	ni somalialand	Nan
soogelitaankii	ipadade	Nan
soojeedinta	igbejade	Nan
sool	sool	Nan
soomaaiya	yara	Nan
soomaal	arakunrin	Nan
soomaali	gẹẹsi	Nan
soomaalia	ni somalia	Nan
soomaalida	the	None
soomaalidii	awọn	Nan
soomaalidu	eniyan eniyan	Nan
soomaaliga	ede	None
soomaaligalbeed	ojo	None
soomaaliland	ni ilu somaliland	Nan
soomaaliya	somalia	Nan
soomaaliyakiinya	ko	None
soogalistii	soogalistii	Nan
soodhaafanay	gba	None
soo	wá	Nan
sonkorta	ṣuga	Nan
somalida	eniyan eniyan	Nan
somalidu	arabinrin	Nan
somaliga	ede	None
somalilada	ninu	Nan
somalilanad	ede	None
somaliland	ni ilu somaliland	Nan
somalilandintaas	ti o jẹ	Nan
so	ni ife	Nan
somalilandna	ni ilu somaliland	Nan
somaliwayn	arabinrin	Nan
somaliya	somalia	Nan
somaliyeed	arabinrin	Nan
somaray	tẹ bọtini	Nan
some	diẹ ninu	Nan
somlialnd	somlialnd	Nan
somtel	somi	Nan
somalinimada	ọmọ-ogun	Nan
snmta	snmta	Nan
snmlooma	snmlooma	Nan
snm	snm	Nan
siiyaymagaca	fun	None
siiyeen	wọn	None
siiyey	fifun	Nan
siiyo	fifun	Nan
silanyo	siloon	Nan
silic	ijiya	Nan
sim	sim	Nan
siman	dogba	Nan
simantahay	dogba	Nan
simanyihiin	dogba	Nan
simbaabwi	se diedie	Nan
simo	idogba	Nan
sinaan	dọgbadọgba	Nan
sinaanta	dọgbadọgba	Nan
sinigaal	erofo	None
siiyaycalan	fifun	Nan
siiyay	fifun	Nan
siiya	ajọbi	Nan
siisay	fún	Nan
sifeynta	iṣapẹẹrẹ	Nan
sifiican	daradara	Nan
sifoobay	ti tunṣe	Nan
signal	ifihan	Nan
signals	agbara	None
sii	fifun	Nan
siiba	ni pataki	Nan
sir	sir	Nan
siid	itusilẹ	Nan
siidaynta	itusilẹ	Nan
siilaanyo	awon sions	Nan
siin	fifun	Nan
siinayo	fifun	Nan
siinjiray	fifun	Nan
siirada	abuku	Nan
siisa	sí	Nan
siidaayey	asonu	Nan
soomaaliyana	ni somalia	Nan
sirasmi	sirsmi	Nan
sirdoonyaasha	oloye	None
siyaasi	oloselu	Nan
siyaasiga	oselu	Nan
siyaasiinta	oloselu	Nan
siyaasiyiin	oloselu	Nan
siyaasiyiinta	oloselu	Nan
siyaasiyiintan	awọn oloselu wọnyi	Nan
siyaasiyiinytii	awọn oloselu	Nan
siyad	siad	Nan
siyasadeed	oselu	Nan
skandinafia	scinainafia	Nan
slitaz	slitaz	Nan
smaller	kere	Nan
smart	gbọn	Nan
sms	sms	Nan
snaciidamada	awọn ejò naa	Nan
siyaasadii	imulo	Nan
siyaasadeed	oselu	Nan
siyaasaddeed	oselu	Nan
siyaasadda	oselu	Nan
siri	nira	Nan
sirta	asiri	Nan
sisiiliya	cilia	Nan
sisinta	sesame	Nan
sitay	joko	Nan
siticmaalaa	lo o	Nan
sitoosa	sẹsẹ	Nan
sirdoonka	oloye	None
siwaaqroon	ni ọna yi	Nan
sixadeeda	rẹ	None
siyaa	lori	Nan
siyaad	siad	Nan
siyaadna	diẹ sii	Nan
siyaaraadka	oselu	Nan
siyaasad	eto imulo	Nan
siyaasada	oselu	Nan
siweyn	fifẹ	Nan
taalo	dúró	None
soomaaliyeed	ede	None
soomaaliyeey	ko	None
suuq	ọjà	Nan
suuqa	ọjà	Nan
suuqyada	awọn ọja	Nan
suurada	sura	Nan
suuradda	irí	Nan
suurado	ṣeeṣe	Nan
suuratu	sura	Nan
suuratul	ṣeeṣe	Nan
suuratulfiil	suuratulfil	Nan
suuriya	ará síríà	Nan
suurogal	ṣeeṣe	Nan
suurto	ṣeeṣe	Nan
suways	suways	Nan
suwees	suwees	Nan
swasiland	switzerland	Nan
suugaanyahankii	litireso	Nan
sweden	sweden	Nan
suugaanyahan	litireso yi	Nan
suugaantiisa	litireso re	Nan
supports	atilẹyin	Nan
suqa	nkan	None
surinam	arakunrin ọkọ mi	Nan
sus	sus	Nan
suu	su	Nan
suuban	ìró	None
suubanaa	o jẹ otitọ	Nan
suubban	o dabọ	Nan
suubiye	yọọda	Nan
suudaan	surah	Nan
suudaanitoobiya	gbajumọ	Nan
suufi	sufi	Nan
suugaan	litireso	Nan
suugaanta	litireso	Nan
suugaantii	litireso	Nan
suugaantu	litireso	Nan
switching	yi pada	Nan
switzerland	switzerland	Nan
swt	swt	Nan
taageerayaasha	awọn olufowosi	Nan
taageero	atilẹyin	Nan
taageersan	atilẹyin	Nan
taageersanaa	atilẹyin	Nan
taagi	iduroṣinṣin	Nan
taagnaa	dúró	None
taajir	ọlọrọ	Nan
taajirsan	ọlọrọ	Nan
taaka	egba	None
taako	sí	Nan
taal	wa	Nan
taala	wa	Nan
taalaa	ti o ba wa	Nan
taalada	ere	Nan
taale	loni	Nan
taageerayaal	awọn olufowosi	Nan
taageerada	atilẹyin	Nan
taageera	atilẹyin	Nan
taagay	tẹre	Nan
sxb	sxb	Nan
syc	syc	Nan
syl	syl	Nan
syria	aranmo	Nan
system	eto	Nan
systems	awọn ọna šiše	Nan
sénégal	àwo	Nan
superka	superka	Nan
t	t	Nan
taa	loni	Nan
taaban	fọwọkan	Nan
taaboo	fọwọkan	Nan
taad	taad	Nan
taagan	dúró	None
taagantahay	duro	Nan
taaganyahay	duro	Nan
ta	rẹ	None
super	dara julọ	Nan
suntan	majele	Nan
sunta	majele	Nan
soonku	yara	Nan
soosocota	n bọ	Nan
sooyaalka	itan	Nan
sos	ibọsẹ	Nan
soviet	rosia	Nan
sri	sri	Nan
ssdf	ssdf	Nan
st	st.	Nan
stadium	papa-iṣere	Nan
standard	boṣewa	Nan
standards	awọn ajohunše	Nan
state	ipinle	Nan
states	awọn ipinlẹ	Nan
station	ibudo	Nan
stockholm	ọja iṣura	Nan
soonkood	ãwẹ	Nan
soonka	ãwẹ	Nan
soona	yara	Nan
soon	laipẹ	Nan
soomali	gẹẹsi	Nan
soomalida	awọn sare	Nan
soomalidu	yara	Nan
soomaliga	awọn	Nan
soomalimaad	kọja siwaju	Nan
soomaliya	somalia	Nan
soomaliyadii	awọn	Nan
strom	strom	Nan
soomaliyeed	arabinrin	Nan
soomanaado	yara	Nan
soomanahay	yara	Nan
soomane	yara	Nan
soomaray	yara	Nan
soomidda	ãwẹ	Nan
soomman	yara	Nan
soommani	yara	Nan
sooman	yara	Nan
soomaaliyeeed	arabinrin	Nan
stronger	ni okun	Nan
su	wọn	None
sugnaakii	duro de	Nan
sugulle	oluduro	Nan
suhra	suhra	Nan
suldaan	sultan	Nan
suldaanka	rẹ	None
suldaankii	awọn sultan	Nan
suliman	suliman	Nan
sultan	sultan	Nan
sumada	aami	Nan
sumerianku	sumerianku	Nan
sun	oorun	Nan
suna	orukọ	Nan
sunday	sunday	Nan
sunnada	sunna	Nan
sunni	sunni	Nan
sugnaaday	ni	Nan
sugnaa	duro de	Nan
sugeysey	ti nduro	Nan
sugaysa	nduro	Nan
suaal	ibeere	Nan
suaalo	awọn ibeere	Nan
subac	subac	Nan
subag	bota	Nan
subax	owurọ	Nan
subayr	ọra	Nan
subscriber	alabapin	Nan
style=fontsize	ara = fontsize	Nan
subsystem	subsystem	Nan
such	iru	Nan
sucuudiga	orilẹ-ede saudi	Nan
sudan	sudan	Nan
sudhan	idorikodo	Nan
sugaal	duro de	Nan
sugan	daju	Nan
sugay	duro de	Nan
subxaanahu	awọn arole	Nan
يسوع	يسوع	Nan
joogaba	hihan	Nan
joogaan	dúró	None
cilmi	sayensi	Nan
cilmiga	awọn sáyẹnsì	Nan
cilmina	mi imo	Nan
cilmiyada	awọn sáyẹnsì	Nan
cilmiyeedka	sayensi	Nan
cilmu	cilmu	Nan
cimilada	ojo	None
cimiladeeda	afefe re	Nan
cimillada	awọn iran	Nan
cimilo	ojo	None
cimraan	awọn ọjọ-ori	Nan
cinwaanka	adirẹsi	Nan
ciqaab	iya	Nan
cir	àá	Nan
ciraaq	iraaki	Nan
cilmaaniya	sọ	None
ciraaqka	ni iraq	Nan
ciisuhu	ifasimu	Nan
ciisaha	jesu	None
ciidamadee	rẹ	None
ciidamadii	ogun	None
ciidamadiisa	rẹ	None
ciidamadu	ogun	None
ciidamdii	ogun	None
ciidamo	ogun	None
ciidan	ogun	None
ciidangale	ogun	None
ciidanka	ogun	None
ciidankii	ogun	None
ciidankiisii	rẹ	None
ciidanku	ogun	None
ciidda	ile	Nan
ciil	ibinu	Nan
ciimadii	mimọ	Nan
ciise	jesu	None
cirid	gomu	Nan
cirifka	awọn ọrun	Nan
ciriiri	dín	Nan
ckariin	ekeji	None
claahi	olorun	Nan
clahi	clahi	Nan
clinton	clintoni	Nan
cllahi	ọlọrun	Nan
clle	ẹyẹ	Nan
cllhi	cllhi	Nan
cod	ohun	Nan
codec	kodẹki	Nan
codecs	awọn kodẹki	Nan
codka	ohun	Nan
codsaday	beere	Nan
codsanayaan	bibeere	Nan
codsi	beere	Nan
codsiga	ohun elo	Nan
ckariim	aga timutimu	Nan
ciyaarta	eré	Nan
ciyaaro	awọn ere	Nan
ciyaarihii	awọn ere	Nan
ciriiriga	ifakalẹ	Nan
cirka	awọn ọrun	Nan
cirro	bia	Nan
cishaba	kasun layọ o	Nan
cismaan	wa laaye	Nan
cismaaniya	commendable	Nan
cismaaniyiinta	awọn pentecostals	Nan
ciidamada	ogun	None
cismaaniyiintu	kristiẹni	Nan
cities	awọn ilu	Nan
civil	ara ilu	Nan
ciyaalka	ọmọ	None
ciyaar	eré	Nan
ciyaaraa	ìtàgé	Nan
ciyaaraha	awọn ere	Nan
ciyaaray	dun	None
cismaniyada	ipanilaya	Nan
codsigaas	ni ibeere naa	Nan
ciida	eid	Nan
cigalxasan	tesiwaju	Nan
ceelal	daradara	Nan
ceelasha	kanga	Nan
ceelbuur	kanga	Nan
ceelcad	daradara	Nan
ceeldheer	kanga	Nan
ceelgaal	daradara	Nan
ceelhuur	kanga	Nan
ceelka	kanga	Nan
ceelkii	kanga	Nan
ceelku	kanga	Nan
ceerigaabo	aṣu	Nan
ceerigabo	o bibajẹ	Nan
ceeryaamo	owusu	Nan
celi	tun	Nan
celin	atunwi	Nan
ceelaayo	ainitiju	Nan
celisa	daduro	Nan
ceel	daradara	Nan
ccc	ccc	Nan
casuumay	pe	Nan
casuura	fiwepe	Nan
cawaale	kan	None
cawil	grẹy	Nan
cawo	jẹ	Nan
caws	koriko	Nan
cay	egan	Nan
cayaar	mu ṣiṣẹ	Nan
cayaaraha	eré ìdárayá	Nan
caydiid	egan	Nan
cayiman	pàtó	Nan
cayimey	pàtó	Nan
cayn	irú	Nan
caynaba	ti eyikeyi iru	Nan
caynabo	chuckles	Nan
ceeb	itiju	Nan
celiya	fa seyin	Nan
celiyay	waye	Nan
celiyo	tun	Nan
cida	àjọ who	Nan
cidamada	ninu aginju	Nan
cidda	àjọ who	Nan
ciddii	àjọ who	Nan
cidhifyada	igun	Nan
cidi	cidi	Nan
cidii	àjọ who	Nan
cidina	enikeni	Nan
cidla	dahoro	Nan
cidlo	dawa	Nan
cidluu	dawa	Nan
cidna	enikeni	Nan
ciel	ciel	Nan
cigaal	siga	Nan
cigaaljpg|maxamed	smaljpg | maxamed	Nan
cid	ẹnikẹni	Nan
cibaarada	jọsin	Nan
cibaado	iwa-bi-ọlọrun	Nan
cibaadada	jọsin	Nan
cell	sẹẹli	Nan
cells	ẹyin	Nan
cellular	cellular	Nan
celmi	fa seyin	Nan
center	aarin	Nan
centre	aarin	Nan
cerulli	cerulli	Nan
ciid	iyanrin	Nan
channel	ikanni	Nan
charles	awọn ẹru	Nan
chavez	chavez	Nan
chemistry	kemistri	Nan
chirac	chirac	Nan
christian	kristiẹni	Nan
christos	keresimesi	Nan
church	ijo	Nan
channels	awọn ikanni	Nan
col	agbè	Nan
colaad	agbalejo	Nan
colaada	rogbodiyan	None
daahir	mimọ	Nan
daain	gba	None
daakhiliga	t’ile	Nan
daalash	agboorun	Nan
daalicii	rirẹ	Nan
daalin	rirẹ	Nan
daallo	ti re	Nan
daalo	ti re	Nan
daalye	ti re	Nan
daaqad	kan	None
daaqadaha	windows	Nan
daaqadkasta	ni eyikeyi window	Nan
daaqiliga	àgbegbe	Nan
daar	yiyi	Nan
daaraha	awọn ile	Nan
daahfurayay	ifihan	Nan
daardaari	ailopin	Nan
daahay	pẹ	Nan
daafta	olugbeja	Nan
d	o	Nan
da	ati	Nan
daa	ki	None
daab	tẹjade	Nan
daabacaada	tẹjade	Nan
daabacdo	tejede	Nan
daabicin	lati jade	Nan
daacad	ooto	Nan
daacadda	iyi	Nan
daaci	kikoro	Nan
daad	omi	None
daadagine	da	None
daadagno	omi	None
daadhey	omi	None
daafaha	kọja	Nan
daaha	ipele	None
daarood	orule	Nan
daaroodafka	ferese	Nan
daaroode	ile naa	Nan
dabadeed	lẹhin	Nan
dabadeede	nigbamii	Nan
dabadeedna	ati igba yen	Nan
dabadiisii	rẹ	None
dabadood	wọn	None
dabaq	ilẹ	None
dabaqa	pakà	Nan
dabaqadda	kilasi naa	Nan
dabarre	iparun	Nan
dabayaaqadii	pẹ	Nan
dabayloobey	afẹ́fẹ́ ń fẹ́	Nan
dabcigiyo	dajudaju	Nan
dabeecad	ihuwasi	Nan
dabeecada	iseda	Nan
dabeecaddiisa	rẹ	None
dabada	iru	Nan
dabaasho	odo	Nan
dabaal	ayeye	Nan
daba	tẹle	Nan
daaroodka	àgbo	Nan
daarta	ile naa	Nan
daas	tin	Nan
daauud	ariwo	Nan
daawad	wo	Nan
daawada	òògùn	Nan
daawado	wo	Nan
cyimi	cyimi	Nan
daawanayay	wiwo	Nan
daawo	imularada	Nan
daayay	tu silẹ	Nan
daaye	o dabọ	Nan
daayey	ọfẹ	Nan
daayin	awọn	Nan
daayo	itusilẹ	Nan
dab	ina	Nan
daaweeyey	tọju	Nan
cwahaab	idahun	Nan
cutub	orí	Nan
cuthmaaniyiintii	awọn ẹgbẹ	Nan
countries	awọn orilẹ-ede	Nan
country	orilẹ-ede	Nan
course	dajudaju	Nan
coverage	agbegbe	Nan
cqaadir	ìgbéraga	None
crashiid	jagunjagun	Nan
craxmaan	ifẹ	Nan
craxman	oniranu	Nan
crd	crd	Nan
crisaaq	idotin	Nan
cs	cs	Nan
csw	csw	Nan
cubeyd	cubeyd	Nan
cudur	aarun	Nan
cudurka	arun	None
could	le	None
cost	iye owo	Nan
cosoble	cosoble	Nan
core	mojuto	Nan
colba	colba	Nan
colenel	colenel	Nan
colkayagii	ota wa	Nan
college	kọlẹji	Nan
colombia	agba	None
colow	colow	Nan
colspan=	colspan =	Nan
cufanka	ọpọ	Nan
communication	ibaraẹnisọrọ	Nan
computers	awọn kọmputa	Nan
conditions	ipo	None
congo	congo	Nan
congress	apejọ alapejọ	Nan
congresska	apejọ alapejọ	Nan
conoco	konso	Nan
coofey	igbomikana	Nan
computer	kọmputa	Nan
casumay	pe	Nan
culays	walẹ	Nan
culimadii	awọn ọjọgbọn	Nan
cunteeyo	onje	None
cunto	oúnjẹ	None
curadka	akọbi	Nan
curatay	akọbi	Nan
curious	iyanilenu	Nan
curiya	arọ	None
cuseyr	tuntun	None
cusmaan	tẹ bọtini	Nan
cusmaaniyiinta	aini ile	Nan
cusmaankii	tuntun	None
cusman	cusman	Nan
cusri	cusri	Nan
customer	alabara	Nan
cusub	tuntun	None
cusubi	tuntun	None
cuntada	oúnjẹ	None
cuno	jẹ	Nan
cunin	ko	None
cunid	lati jẹ	Nan
culimadu	awọn ọjọgbọn	Nan
culimo	awọn ọjọgbọn	Nan
culumaaudiinka	awọn ọjọgbọn ọlọgbọn	Nan
culumada	awọn ọjọgbọn	Nan
culus	wuwo	Nan
culusoow	jẹ eru	Nan
culuumta	sayensi	Nan
culimada	awọn ọjọgbọn	Nan
culuunta	awọn ọjọgbọn	Nan
cumar	omar	Nan
cun	jẹ	Nan
cunaan	jẹ	Nan
cunay	jẹun	Nan
cune	jẹ	Nan
cuneen	jẹun	Nan
cuni	njẹ	Nan
cumaan	oman	Nan
casriyeesanwaxeena	ni ilu wa igbalode	Nan
casriyeesan	fun	None
casriyadii	awọn igbalode	Nan
caasimada	olu	Nan
caasimadaha	olú	Nan
caasimadda	olu	Nan
caasimadiisa	olu-ilu re	Nan
caato	tinrin	Nan
caawa	alẹ́ alẹ́	Nan
caawin	egba	None
caawinaayaan	ṣe iranlọwọ	Nan
caawisayba	iranwo	Nan
caawiyey	iranwo	Nan
caawiyo	egba	None
cabaar	kan	None
cabaas	cabaret	Nan
cabbaas	awọn kebulu	Nan
cabbay	mu	Nan
caasimad	olu	Nan
cabbeen	mu	Nan
caashaqa	ni ife	Nan
caasha	ni ife	Nan
caalin	imoran	Nan
caalmaka	eda eniyan	Nan
caalmka	agbaye	None
caamul	kamẹra	Nan
caan	olokiki	Nan
caana	wara	Nan
caanaha	wara	Nan
caanbaxday	jẹ gbajumọ	Nan
caanka	olokiki	Nan
caano	wara	Nan
caansan	gbajumọ	Nan
caansana	olokiki	Nan
caansanaa	olokiki	Nan
caaqil	ologbon	Nan
caas	olu	Nan
caashaq	ni ife	Nan
cabdalla	abdalla	Nan
cabdalle	abdalle	Nan
cabdi	mu	Nan
cabdullaahi	abdullah	Nan
cabdullahi	abdullah	Nan
cabdulle	abdulle	Nan
cabdulmalik	cabalmalik	Nan
cabdulmuncim	cabdulmuncim	Nan
cabdulqaadir	arara	Nan
cabdulraxmaan	awon ore mi	Nan
cabduqaadir	ifakalẹ	Nan
cabduraxmaan	nkorin	Nan
cabid	lati mu	Nan
cabir	ìwọn	Nan
cabirka	iwọn	Nan
cabitaanka	inu mimu	Nan
cable	okun	Nan
cabsada	bẹru	Nan
cabdule	cabdule	Nan
cabdulahi	cabalhihi	Nan
cabdulaahi	kafe	Nan
cabdmudhalib	alliance	Nan
cabdicasiis	idẹruba	Nan
cabdilaahi	abdulahi	Nan
cabdillaahi	abdullah	Nan
cabdillahi	abdulahi	Nan
cabdille	cabdille	Nan
cabdimanaaf	awọn iyẹwu	Nan
cabdimudhalib	cabdimudhalib	Nan
caalimudiin	omowe	Nan
cabdinaasir	afẹsodi	Nan
cabdirashid	cabrarashid	Nan
cabdirashiid	ìwọn	Nan
cabdiraxmaan	lati se alaye	Nan
cabdiraxman	cabdirahman	Nan
cabdirisaaq	ìwọn	Nan
cabdisalaan	wọn	None
cabdixaaji	jẹ o	Nan
cabdiqaasim	cabhyqaasim	Nan
caalimkii	omowe	Nan
caalim	omowe	Nan
caalamku	agbaye	None
but	ṣugbọn	Nan
butaan	iyin	Nan
buu	oun	None
buuciya	alaidun	Nan
buug	iwe	Nan
buuga	iwe	Nan
buugaagta	awọn iwe	Nan
buugga	iwe	Nan
buuhoodle	ajigbese	Nan
buulo	itẹ-ẹiyẹ	Nan
buuloburde	bulldozer	Nan
buuloburte	puppy	Nan
buundo	afara	Nan
buuq	ariwo	Nan
buur	kan	None
busra	iyẹfun	Nan
buskoon	kekere	None
businessman	oníṣòwò	Nan
bushaaranaynaa	a bukun	Nan
burburiyay	parun	Nan
burburiyeen	parun	Nan
burburiyey	parun	Nan
burburka	iparun	Nan
burburkii	awọn collapse	Nan
burburku	iparun	Nan
burburtay	wó lulẹ	Nan
buuraha	awọn oke-nla	Nan
burco	burco	Nan
burma	burma	Nan
buro	iṣuu	Nan
bursadeen	ọdẹ	Nan
burtinle	burtinle	Nan
burton	ajekii	Nan
burundi	burundi	Nan
bush	igbo	Nan
burkina	awon boga mi	Nan
cabsi	bẹru	Nan
buurdhuubo	gomu	Nan
buuro	awọn oke-nla	Nan
caadalad	ko	None
caadi	deede	Nan
caadiga	deede	Nan
caado	ihuwasi	Nan
caafimaad	ilera	Nan
caafimaadka	ilera	Nan
caag	ṣiṣu	Nan
caaggan	eiyan yi	Nan
caaid	egba	None
caajis	alaidun	Nan
caalami	kariaye	Nan
caalamiga	kariaye	Nan
caalamiya	kariaye	Nan
caalamka	agbaye	None
caalamkka	kariaye	Nan
caad	aṣa	Nan
caabudwaaq	jọsin	Nan
caabudo	jọsin	Nan
caabudistiisa	rẹ	None
buurta	náà	None
buurweyn	isanraju	Nan
buuxa	kun	Nan
buuxaan	kun	Nan
buuxda	kun	Nan
buuxin	fọwọsi	Nan
buuxinaya	àgbáye	Nan
buuriga	taba	Nan
buuxsadaye	o ti kun	Nan
c	c	Nan
caabbi	atako	Nan
caabinta	atako	Nan
caabuda	jọsin	Nan
caabudaa	jọsin	Nan
caabudaan	jọsin	Nan
caabudi	jọsin	Nan
by	nipasẹ	Nan
dabiici	iseda	Nan
cabsida	bẹru	Nan
cad	ko	None
caraba	awọn ara larubawa	Nan
carabi	ede	None
carabiga	ede	None
carabigu	ede	None
carabiya	ni arabia	Nan
carabka	ahọn	Nan
carabkana	ede	None
carabta	awọn ara larubawa	Nan
carabtii	ni ọsan	Nan
carabtu	lárúbáwá	None
carabعبد	عبد arabí	Nan
carabعبدالله	carab عبدالله	Nan
carafaat	carafaat	Nan
cararay	sá lọ	Nan
carareen	sá lọ	Nan
carab	ede	None
carartay	sá lọ	Nan
caraaye	ibanujẹ	Nan
car	ọkọ ayọkẹlẹ	Nan
cambaha	awọn ihuwasi	Nan
camiran	arami	Nan
campaign	ipolongo	Nan
camuud	iyanrin	Nan
can	ní	None
canbaha	àjara	Nan
canfar	aarun naa	Nan
canfartu	tutu	Nan
cape	iho	Nan
captain	balogun	Nan
caqabadna	ipenija	Nan
caqiidada	ẹkọ	Nan
caqli	ologbon	Nan
caqliga	ọgbọn	Nan
caqligu	kannaa	Nan
caraale	caramel	Nan
carbeed	ede	None
carbta	ahọn	Nan
card	kaadi	Nan
cas	pupa	None
case	ọran	Nan
casharadan	ninu ẹkọ yii	Nan
casharka	ẹkọ naa	Nan
casharkii	ẹkọ naa	Nan
casho	fun	None
cashocado	fun	None
casi	pupa	None
casiis	pupa	None
casimada	ni irọlẹ	Nan
casir	imudojuiwọn	Nan
casmara	pupa	None
casri	igbalode	Nan
casriga	igbalode	Nan
casrigan	ni igba ode oni	Nan
caruurtooda	wọn	None
caruurtiisa	rẹ	None
caruurtii	awon omo	Nan
caruurta	ọmọ	None
carif	carp	Nan
cariif	fẹẹrẹ fẹẹrẹ	Nan
caroone	caroton	Nan
carqaladaynkaro	idilọwọ	Nan
carrabey	ogbi	Nan
carro	ile	Nan
carruur	ọmọ	None
camar	kaakiri	Nan
carruureede	ọmọ	None
carruurtiisa	rẹ	None
carruurtiisu	rẹ	None
cars	oko	None
carta	carta	Nan
cartan	kẹkẹ-ẹru	Nan
carte	kẹkẹ-ẹru	Nan
caruur	ọmọ	None
carruurta	ọmọ	None
camaloow	agba	None
camalladiisa	rẹ	None
camallada	awọn iṣẹ	Nan
caddaalad	ododo	None
caddaatay	di mimọ	Nan
caddayn	ẹri	Nan
caddaynaya	fi	None
caddaynta	ẹri	Nan
cadde	fi	None
caddeeyay	safihan	Nan
caddoow	di mimọ	Nan
cade	di mimọ	Nan
cadeeyay	safihan	Nan
cadexamar	di mimọ	Nan
cadi	funfun	Nan
cadmeed	cadet	Nan
cadnaa	o han ni	Nan
cadnaan	igboya	Nan
cadceedu	oorun	Nan
cadceed	oorun	Nan
cadcad	ko	None
cadaymaa	ẹri	Nan
cadaa	funfun	Nan
cadaada	funmorawon	Nan
cadaadis	inilara	Nan
cadaado	ko	None
cadaalada	ododo	None
cadaaladda	ododo	None
cadaalda	ododo	None
cadoo	cad	Nan
cadaan	funfun	Nan
cadaatay	safihan	Nan
cadaawe	agbalejo	Nan
cadal	lofinda	Nan
cadale	adair	Nan
cadami	cadmium	Nan
cadan	funfun	Nan
cadawga	ọtá	Nan
cadaanka	alawo funfun	Nan
cabudhiyaan	idẹruba	Nan
cadoow	ọtá	Nan
cadowgiin	rẹ	None
calan	asia	Nan
calanka	asia	Nan
calankaba	asia	Nan
calanku	asia	Nan
calanle	asia	Nan
calasoow	ṣayẹwo	Nan
calasow	asia	Nan
calayhi	owurọ	Nan
cali	cali	Nan
caliaxmed	kaliaxmed	Nan
called	ti a pe	Nan
calool	ikun	Nan
caluula	alaanu	Nan
camaamad	mnu	Nan
camal	awọn iṣẹ	Nan
calaamooyinkaas	awọn ami wọnyi	Nan
calaamooyin	awọn ami	Nan
calaamka	ami naa	Nan
calaamdaha	awọn aami aisan	Nan
cadrad	lofinda	Nan
cafaan	idariji	Nan
cafariga	idariji	Nan
cafarigaluqada	idariji	Nan
cafimaad	ilera	Nan
caga	ẹsẹ	None
cagaaran	ewe	None
cadow	ọtá	Nan
cagaarka	ọya	Nan
cagta	ẹsẹ	None
cairo	ibinu	Nan
cajalad	teepu	Nan
cajiib	iyanu	Nan
calaa	ibinu	Nan
calaamad	kan	None
calaamd	kan	None
cago	ẹsẹ	None
burburintii	iparun	Nan
dabiiciga	iseda	Nan
dable	dable	Nan
dhacan	iṣẹlẹ yii	Nan
dhacana	ṣẹlẹ	Nan
dhacay	ṣẹlẹ	Nan
dhacaye	ṣẹlẹ	Nan
dhacayey	a ti ṣẹlẹ	Nan
dhacayeye	iṣẹlẹ	Nan
dhacda	waye	Nan
dhacdaa	ṣẹlẹ	Nan
dhacday	ṣẹlẹ	Nan
dhacdo	ìṣẹlẹ	Nan
dhacdooyin	iṣẹlẹ	Nan
dhacdooyinka	iṣẹlẹ	Nan
dhaceen	ṣubu	Nan
dhaco	ṣẹlẹ	Nan
dhadigana	obinrin naa	Nan
dhacaan	ṣẹlẹ	Nan
dhadigna	obinrin	Nan
dhacaa	ṣẹlẹ	Nan
dhac	ole jija	Nan
dhaanto	jó	Nan
dhaar	ibura	Nan
dhaarannaye	mo bura	Nan
dhaarsho	ibura	Nan
dhaarta	ibura	Nan
dhaawac	ipalara	Nan
dhaawacmay	farapa	Nan
dhaaxaan	rekoja	Nan
dhab	ojulowo	Nan
dhabar	sẹhin	Nan
dhabarka	awọn pada	Nan
dhabbada	opopona	Nan
dhabeeyaan	ṣe	Nan
dhabnimadeeda	awọn oniwe-ododo	Nan
dhabta	gidi	Nan
dhaca	ṣẹlẹ	Nan
dhafaruur	scab	Nan
dhagan	fẹẹrẹ	Nan
dhaganyahay	fẹẹrẹ	Nan
dhalashadiisii	ibi re	Nan
dhalashadiisu	ọjọ ibi	Nan
dhalasho	ibi	Nan
dhalashooyin	ojo	None
dhalatay	bi	Nan
dhalay	bíbí	Nan
dhalaye	yo	Nan
dhaleen	ọmọ-ọmọ	Nan
dhaliil	ṣofintoto	Nan
dhaliilaha	alariwisi	Nan
dhalin	so	None
dhalinaya	okunfa	Nan
dhalinyar	ọdọ	Nan
dhalinyara	ọdọ	Nan
dhalinyarada	ọdọ	Nan
dhalashadii	ojo	None
dhalashada	ibi	Nan
dhalanteede	akọbi	Nan
dhalan	bi	Nan
dhagar	tan	Nan
dhagaweyne	àkúnwọsílẹ̀	Nan
dhagax	okuta	Nan
dhagaxa	náà	None
dhagaxaasi	náà	None
dhagaxawoqooyiga	apata ariwa	Nan
dhagaxbuur	dojuijako	Nan
dhaameen	ti pari	Nan
dhagaxii	náà	None
dhaha	sọ	None
dhahaa	sọ	None
dhahar	sọ	None
dhaheen	nwọn wipe	Nan
dhaho	sọ	None
dhakhso	yara	Nan
dhal	so	None
dhagaysto	gbọ	Nan
dhalinyaradii	ọmọ	None
dhaalib	suuru	Nan
dhaafsado	kọjá	None
degmadan	ni agbegbe yii	Nan
degmadda	agbegbe	Nan
degmadu	agbegbe	Nan
degmo	agbegbe	Nan
degmooyinka	awọn agbegbe	Nan
degno	lati yanju	Nan
dego	fokan bale	Nan
degoo	kọja siwaju	Nan
degree	ìyí	Nan
degtaa	fokan bale	Nan
degtaan	fokan bale	Nan
degtay	sokale	Nan
degto	fokan bale	Nan
dejintii	awọn eto	Nan
dejiyay	gba	None
degmadaan	ni agbegbe yii	Nan
dejiyey	farabalẹ	Nan
degmada	agbegbe	Nan
degganaa	gbé	None
deganaa	gbé	None
deganaana	farabalẹ	Nan
degay	gbe	None
degayare	irungbọn	Nan
degaye	olugbe	Nan
degdeg	iyara	Nan
degeen	farabalẹ	Nan
degen	fokan bale	Nan
degenaa	ti	Nan
degenaan	farabalẹ	Nan
degenaansho	lati tunu	Nan
degeneen	nibẹ ni	Nan
degenyihiin	gbé	None
degey	farabalẹ	Nan
deggan	idurosinsin	Nan
degi	lati tunu	Nan
dekad	ibudo	Nan
dekada	ibudo	Nan
dekadda	ibudo	Nan
development	idagbasoke	None
devices	awọn ẹrọ	Nan
deyey	ted	Nan
deyiba	idojuti	Nan
dfkmg	dfkmg	Nan
dhaabad	ṣubu	Nan
dhaabadeeyaan	se o	Nan
dhaadashada	iṣi	Nan
dhaadheer	ga	Nan
dhaaf	rekoja	Nan
dhaafay	ti o ti kọja	Nan
dhaafayn	rekoja	Nan
dhaafaysaa	gba	None
dhaafi	rekoja	Nan
dhaafo	rekoja	Nan
destaing	destata	Nan
designed	ti a ṣe	Nan
derivative	itọsẹ	Nan
derisna	aládùúgbò	Nan
dekadiiba	ibudo	Nan
dekeda	ibudo	Nan
dekedda	ibudo	Nan
dekeeya	farabalẹ	Nan
delhi	maṣe	Nan
dembi	ẹṣẹ	Nan
dembiga	ẹṣẹ	Nan
dhaaftay	kọjá	None
democratic	tiwantiwa	Nan
denmark	fi	None
depending	fehin ti	Nan
deputato	atokọ	Nan
derejada	ìyí	Nan
derejo	ipo	None
deris	aládùúgbò	Nan
deriska	aladugbo	Nan
den	den	Nan
dhalinyaro	ọdọ	Nan
dhalisay	lo jeki	Nan
dhaliyey	lo jeki	Nan
dhaw	sunmọ	Nan
dhawaadaan	laipẹ	Nan
dhawaado	laipẹ	Nan
dhawaan	laipẹ	Nan
dhawaaqaa	ṣalaye	Nan
dhawaaqaan	ìró	None
dhawaaqay	ṣalaye	Nan
dhawaaqday	ṣalaye	Nan
dhawaaqida	ìpolongo	None
dhawaaqidda	ìpolongo	None
dhawaaqo	ìró	None
dhawaaqtada	awọn ohun	Nan
dhawdahay	sunmọ	Nan
dhaweeyay	tewogba	Nan
dhawr	tọjú ẹ	Nan
dhasida	jó	Nan
dhawre	ṣọ	Nan
dhashtay	bi	Nan
dhashaywaxaanuu	a ti bi ni	Nan
dhaqmay	ṣe	Nan
dhaqmaysayna	a ti anesitetiki	Nan
dhaqmo	iṣe	Nan
dhaqso	yara	Nan
dhaqtar	kan	None
dhar	aṣọ	Nan
dharaar	ọjọ	Nan
dharaaraba	ni aro	Nan
dhararka	aṣọ	Nan
dharka	aṣọ	Nan
dharkeenleey	aṣọ wa	Nan
dharkoodii	wọn	None
dhasahy	laipẹ	Nan
dhashaa	a bi	Nan
dhashay	bi	Nan
dhasheen	ni a bi	Nan
dhax	ajogun	Nan
dhaxal	ogún	Nan
dhaxalaa	jogun	None
dhaxmaro	jogun	None
dhay	wọṣọ	Nan
dhaygag	stare	Nan
dhaymo	wíwọ	Nan
dhaytubaako	agbalejo	Nan
dhebaandhebiye	adena	Nan
dhebi	tẹ	Nan
dheceen	ṣubu	Nan
dheddig	obinrin	Nan
dheddiga	obinrin	Nan
dheddigga	fun	None
dheecaan	yo kuro	Nan
dheer	gun	None
dheeraa	gun	None
dheeraad	diẹ sii	Nan
dhaxmaraa	ifesi	Nan
dhaxlay	jogun	None
dhaxeysay	agbedemeji	Nan
dhaxeysaa	ni aarin	Nan
dhaxalgalka	ogún	Nan
dhaxalka	ogún	Nan
dhaxalkeeda	rẹ	None
dhaxanta	tutu	Nan
dhaxaye	bu	None
dhaxaysa	laarin	None
dhaxaysaa	laarin	None
dhaqmaan	iṣe	Nan
dhaxaysay	laarin	None
dhaxe	ni aarin	Nan
dhaxeesay	laarin	None
dhaxeeya	laarin	None
dhaxeeyaa	laarin	None
dhaxeeyeen	laarin	None
dhaxeeyey	laarin	None
dhaxeysa	ni aarin	Nan
dhaxda	ni aarin	Nan
dhaqma	iṣe	Nan
dhaqidda	fifọ	Nan
dhaqdo	wẹ	Nan
dhameystay	ti pari	Nan
dhami	gbogbo	Nan
dhamiba	rara	Nan
dhammaa	gbogbo e	Nan
dhammaadkii	ipari	Nan
dhammaan	gbogbo	Nan
dhammaantiis	rẹ	None
dhammaantood	gbogbo won	Nan
dhammanteen	gbogbo wa	Nan
dhammeeyeen	ti pari	Nan
dhan	gbogbo	Nan
dhanaan	ekan	Nan
dhanee	kaabọ	Nan
dhanka	ni ẹgbẹ	Nan
dhankaas	ko	None
dhameeyay	ti pari	Nan
dhameeyaan	rẹ	None
dhameestirnociidanka	ilana	None
dhamaystirane	pari	Nan
dhallinyaradu	odo	Nan
dhallinyaro	odo	Nan
dhamaadaa	pari	Nan
dhamaadaan	ipari	Nan
dhamaaday	pari	Nan
dhamaadka	ipari	Nan
dhamaadkii	ipari	Nan
dhankooda	wọn	None
dhamaado	ipari	Nan
dhamaan	gbogbo	Nan
dhamaantiis	rẹ	None
dhamaantood	gbogbo won	Nan
dhamaatay	o ti pari	Nan
dhamaha	ẹsẹ	None
dhamaystay	pari	Nan
dhamaystiran	pari	Nan
dhamaag	ipari	Nan
degan	dakẹrọrọ	Nan
dhanna	rara	Nan
dhantahay	ti pari	Nan
dhaqane	iṣe	Nan
dhaqanka	atọwọdọwọ	Nan
dhaqankooda	wọn	None
dhaqankoodu	wọn	None
dhaqanta	adaṣe	Nan
dhaqashada	fifọ	Nan
dhaqatada	awon darandaran	Nan
dhaqato	wẹ	Nan
dhaqay	fo	Nan
dhaqdhaaaqyadii	akitiyan	Nan
dhaqdhaqaaq	ronu	Nan
dhaqdhaqaaqa	ronu	Nan
dhaqdhaqaaqii	ronu	Nan
dhaqdhaqaaqyadii	akitiyan	Nan
dhaqdhaqaaqyo	akitiyan	Nan
dhaqan	atọwọdọwọ	Nan
dhaqamo	awọn asa	Nan
dhaqameed	ibile	None
dhaqaaqyo	awọn agbeka	Nan
dhanyahay	pari	Nan
dhaq	wẹ	Nan
dhaqaalaba	ti ọrọ-aje	Nan
dhaqaalaha	aje	None
dhaqaalaha´	aje´	Nan
dhaqaale	aje	None
dhaqaalha	aje	None
dhanoo	gbogbo	Nan
dhaqaalihii	aje	None
dhaqaalihiisuna	rẹ	None
dhaqaalo	aje	None
dhaqaaloheeda	rẹ	None
dhaqaalohiisa	rẹ	None
dhaqaaq	gbe	None
dhaqaaqay	ṣí	Nan
dhaqaaqo	gbe	None
dhaqaalihiisa	rẹ	None
degaanka	agbegbe	Nan
degaanada	agbegbe	Nan
degaan	ibugbe	Nan
dakhalka	owo oya	Nan
dal	dal	Nan
dalab	beere	Nan
dalad	kan	None
dalaga	irugbin na	Nan
dalagyada	awọn irugbin	Nan
dalagyo	awọn irugbin	Nan
dalaka	ilẹ	None
dalal	awọn orilẹ-ede	Nan
dalalka	awọn orilẹ-ede	Nan
dalandoole	aladun	Nan
daleeyay	ti re	Nan
daliil	ẹri	Nan
daljirka	ó	None
dalka	orílẹ èdè	Nan
dakano	igba ikẹhin	Nan
dalkaas	ni orilẹ-ede yẹn	Nan
dajiyaa	fisile	Nan
dahsoon	ailorukọ	Nan
daganyihiin	gbé	None
dagay	yanju	Nan
dagi	fokan bale	Nan
dagmada	agbegbe	Nan
dagmo	kan	None
dagmooyinka	awọn agbegbe	Nan
dago	dago	Nan
dagta	lọ silẹ	Nan
dagtaa	farabalẹ	Nan
dagto	farabalẹ	Nan
dahab	wúrà	Nan
dahabka	wúrà	Nan
dahay	o dara	Nan
dahaye	fipamọ	Nan
dahir	mimọ	Nan
dain	dain	Nan
dalkayagu	orilẹ-ede wa	Nan
dalkeeda	rẹ	None
dalkeena	orilẹ-ede wa	Nan
damal	idido	Nan
dambana	nigbamii	Nan
dambayntii	eyi tio gbeyin	Nan
dambe	nigbamii	Nan
dambeba	nigbamii	Nan
dambeeya	ikeji	Nan
dambeeyay	laipẹ	Nan
dambeeyey	eyi tio gbeyin	Nan
dambeeyo	kẹhin	Nan
dambeyntiina	lakotan	Nan
dambeysay	kẹhin	Nan
dambeysey	eyi tio gbeyin	Nan
dambidhaafe	idariji	Nan
damceen	ifẹ	Nan
dameer	kẹtẹkẹtẹ	Nan
damacii	ifẹkufẹ	Nan
damaca	ifẹ	Nan
damac	ifẹ	Nan
dalxiiso	oniriajo	Nan
dalkii	ilẹ	None
dalkiisa	rẹ	None
dalkjirka	arìnrìn-àjò	Nan
dalkjirkan	orilẹ-ede yii	Nan
dalkooda	won orilẹ-ede	Nan
dalku	ile-ile	Nan
dalmar	dalmar	Nan
daganayn	riru	Nan
dalool	iho	Nan
dalxiisaan	ajo	None
dalxiisayaasha	ajo	None
dalxiise	oniriajo	Nan
dalxiiseyaasha	ajo	None
dalxiisi	irin-ajo	Nan
dalxiiska	irin-ajo	Nan
dalxiiskeeda	rẹ	None
dalxiis	irin-ajo	Nan
daganaayeen	gbe	None
dagan	dakẹrọrọ	Nan
dagalki	rogbodiyan	None
dadaalka	akitiyan	Nan
dadaalo	akitiyan	Nan
dadaaloosa	akitiyan	Nan
dadaashaane	jẹ alãpọn	Nan
dadab	ilekun	Nan
dadaka	eniyan	Nan
dadbadani	ogunlọgọ	Nan
dadee	duro de	Nan
dadeedu	silẹ	Nan
dadi	ti nhu	Nan
dadiisu	adun	Nan
dadka	eniyan	Nan
dadkaa	eniyan	Nan
dadkaan	awọn eniyan wọnyi	Nan
dadkaas	awon eniyan wonyen	Nan
dadaali	akitiyan	Nan
dadaaleen	tiraka	Nan
dadaalaayay	tiraka	Nan
dadaalaan	jẹ alãpọn	Nan
daboolida	ideri	Nan
dabqaxa	pakà	Nan
dabuubtaan	fi	None
dabuubtiyo	murasilẹ	Nan
dacal	kan	None
dacallada	pẹtẹlẹ	Nan
dacar	aran	Nan
dadkaasi	awon eniyan wonyen	Nan
dacas	daas	Nan
dacda	ko	None
daciifa	irẹwẹsi	Nan
dacwad	ẹjọ	Nan
dacwada	ẹjọ	Nan
dad	eniyan	Nan
dada	ibaamu	Nan
dadaal	akitiyan	Nan
dacay	denti	Nan
damiin	beeli	Nan
dadkaba	eniyan	Nan
dadkani	awọn eniyan wọnyi	Nan
dagaalamayay	ija	Nan
dagaalamayeen	won ja	Nan
dagaalamey	ja	Nan
dagaalka	ogun	None
dagaalkaas	ogun	None
dagaalkani	ogun	None
dagaalkii	ogun	None
dagaalku	ogun	None
dagaallada	ogun	None
dagaallo	ogun	None
dagaalo	ogun	None
dagaalwaxaa	ogun	None
dagaan	lati ibi	Nan
dagal	ja	Nan
dagalka	ogun	None
dagaalamay	ja	Nan
dagaaladii	ogun	None
dagaaladaas	ogun	None
dagaalada	ogun	None
dadkeeda	rẹ	None
dadkeedii	rẹ	None
dadkeedu	rẹ	None
dadkii	awon eniyan	Nan
dadkiina	rẹ	None
dadkiisa	rẹ	None
dadkiisii	rẹ	None
dadkana	eniyan	Nan
dadkoo	eniyan	Nan
dadkuna	eniyan	Nan
dadlka	awon eniyan	Nan
dadow	eniyan	Nan
dadweynaha	ita	Nan
dadx	arakunrin	Nan
daga	lati	Nan
dagaal	ogun	None
dadku	eniyan	Nan
dabka	ina	Nan
damiir	ẹ̀rí-ọkàn	Nan
dan	ọmọ	None
dawlad	ijọba	Nan
dawlada	ijọba	Nan
dawladaasi	ijoba yẹn	Nan
dawladaasii	ijoba yẹn	Nan
dawladaha	awọn ijọba	Nan
dawladanwaxa	ijọba yii	Nan
dawladda	ijọba	Nan
dawladdii	ijọba	Nan
dawladeed	ijọba	Nan
dawladi	ijọba	Nan
dawladihii	awọn ijọba	Nan
dawladii	ijọba	Nan
dawladnimo	ijọba	Nan
dawlado	awọn ijọba	Nan
dawladood	awọn ijọba	Nan
dawgii	akata	Nan
dawladu	ijọba	Nan
dawgalaye	isọdọtun	Nan
dawaldu	wakọ	Nan
darti	nitori pe	Nan
dartiina	nitorinaa	Nan
dartiis	nitori re	Nan
darto	drained	Nan
daruufo	awọn ayidayida	Nan
daruuriga	iwulo	None
daruuro	awọsanma	Nan
darxuma	iwuri	Nan
darxumo	laanu	Nan
daryeel	itọju	Nan
dasnnee	dasnnee	Nan
dastuur	t’olofin	Nan
dastuurka	t’olofin	Nan
data	data	Nan
daud	ariwo	Nan
dawga	ẹṣin	Nan
dawliskii	ijọba	Nan
dawr	dawr	Nan
dayaan	oba	None
deegaanka	ayika	Nan
deegaannada	awọn ileto	Nan
deegaano	ayika	Nan
deegta	pẹ	Nan
deelqaaf	irikuri	Nan
deeq	ẹbun	Nan
deeqeen	ti o jowo	Nan
deeqsi	oninurere	Nan
deeqsiiyo	ṣetọrẹ	Nan
deero	agbọnrin	Nan
deerow	oorun	Nan
deetana	itele	Nan
deexda	oorun	Nan
dega	silẹ	Nan
degaa	fokan bale	Nan
deegaanada	awọn ileto	Nan
deegaan	ayika	Nan
december	december	Nan
dec	pinnu	Nan
dayactir	tunṣe	Nan
dayar	ekeji	None
dayax	osupa	Nan
dayaxa	osupa	Nan
dayay	gbiyanju	Nan
daydka	àgbàlá	Nan
daye	agbaye	None
dartey	fi	None
dayeen	ted	Nan
dayeynahay	mo fẹ	Nan
dayn	gbese	None
dayniile	gbese	None
dayo	daradara	Nan
dayrka	àgbàlá	Nan
de	lati wa	Nan
debate	ijiroro	Nan
dayey	aro	Nan
darteed	nitori pe	Nan
dartay	fi	None
darsoomaa	tẹ bọtini	Nan
danishka	pólándì	Nan
danjiraha	aṣoju	Nan
danjire	aṣoju	Nan
danta	rẹ	None
dao	dao	Nan
daomeesha	daomeesha	Nan
dar	ṣafikun	Nan
daraa	iwadi	None
daraaddeed	nitorinaa	Nan
daraadeed	nitorinaa	Nan
daraan	dapọ	Nan
daraawiish	darwiish	Nan
daraawiishi	wa fun:	Nan
daraawiishta	darwiishta	Nan
darafyada	awọn opin	Nan
dangorayo	orgo	Nan
daneysa	ti awọn anfani	Nan
danbi	ilufin	Nan
danbeysayisla	maṣe pẹ	Nan
danaynayn	ko	None
danbana	buroda mi	Nan
danbayna	lẹhinna	Nan
danbayntii	lakotan	Nan
danbaysa	leyin naa	Nan
danbaysay	eyi tio gbeyin	Nan
danbaysta	ipari	Nan
darajo	ipo	None
danbe	nigbamii	Nan
danbeeyay	eyi tio gbeyin	Nan
danbeeyey	eyi tio gbeyin	Nan
danbeeyo	kẹhin	Nan
danbena	tiwa	Nan
danbeyay	sile	None
danbeyntii	ni ipari	Nan
danbeysay	kẹhin	Nan
danbeesay	nigbamii	Nan
damqaday	farapa	Nan
daran	àìdá	Nan
darane	awọn ilu	Nan
dareenka	ori	None
dareenku	rilara	Nan
dariiq	kan	None
dariiqada	ọna	Nan
dariishad	ferese	Nan
darin	kọlu	Nan
daris	aládùúgbò	Nan
dariska	aladugbo	Nan
daristay	aládùúgbò	Nan
darka	idotin	Nan
daro	afikun	Nan
darood	omi	None
darro	odi	Nan
darsado	kọ ẹkọ	Nan
darsamaan	pẹlu kọọkan miiran	Nan
dareen	ori	None
dareemi	rilara	Nan
dareemeen	ro	None
dareemaysaa	rilara	Nan
daray	fi	None
darayaaye	jowo	Nan
darayey	fi	None
darayga	tuntun	None
darbad	kan	None
darbadaaley	tẹ bọtini	Nan
darbadna	ani diẹ sii	Nan
darandoorriga	ninu afefe	Nan
darbane	faa silẹ	Nan
darbiga	ogiri naa	Nan
darbigeed	ogiri naa	Nan
darbiyada	odi	Nan
dardaanay	awon tions	Nan
dardaaran	yoo	None
dardaarmay	dari	Nan
dareemay	ro	None
darbi	opopona	Nan
burburinta	iparun	Nan
burburay	wó lulẹ	Nan
burbur	iparun	Nan
allow	gba	None
allowing	gbigba	Nan
allows	gba	None
almadkhali	almskhali	Nan
almajid	ọmọ	None
almunawara	yigi	Nan
alnour	ikannu	Nan
alpine	alpine	Nan
alqaacida	al-qaeda	Nan
alshabaab	al shabab	Nan
alshabab	alshabab	Nan
also	tun	Nan
alustaad	rẹ	None
alwaadici	ara ilu	Nan
alxalabi	algebra	Nan
allena	ọlọrun	Nan
alxamraa	alurinmorin	Nan
allee	allee	Nan
allaylehe	ni alẹ ana	Nan
alislām	alislām	Nan
aljabarti	algebra	Nan
aljazeera	algebra	Nan
aljaziira	algebra	Nan
aljeeriya	algebra	Nan
all	gbogbo	Nan
alla	bawo	Nan
allaa	lailai	Nan
allaaba	rara	Nan
allaah	ọlọrun	Nan
allaahu	pẹlu ogo lati ọdọ ọlọrun	Nan
allah	ọlọrun	Nan
allaha	pẹlu ogo lati ọdọ ọlọrun	Nan
allahaa	ọlọrun	Nan
allahu	ọlọrun	Nan
alle	ọlọrun	Nan
am	emi	Nan
ama	tabi	None
amaan	lailewu	Nan
aminsanyihiin	o ti wa ni ailewu	Nan
amir	amiri	Nan
aml	amin	Nan
ammaan	iyin	Nan
ammaanadana	iyin	Nan
ammaanadii	iyin	Nan
ammaanadiisa	rẹ	None
amnesty	itusilẹ	Nan
amniga	aabo	Nan
amoud	amoud	Nan
amray	paṣẹ	Nan
amxaari	amọṣa	Nan
an	á	Nan
anaa	a wa	Nan
anaadoolee	wa nibi	Nan
amiirka	ọmọ	None
amiir	ọmọ	None
amiin	ration	Nan
american	ara ilu amẹrika	Nan
amaandarada	aabo	Nan
amaani	lailewu	Nan
amaanka	aabo	Nan
amaanku	aabo	Nan
amaanta	iyin	Nan
amaba	tabi	None
amagaalooyinka	ti awọn ilu	Nan
alislaax	iwa	Nan
amar	paṣẹ	Nan
amaradiisana	rẹ	None
amarkiis	rẹ	None
amase	tabi	None
ambaradooriyadii	ọkọ alaisan	Nan
ameerika	amẹrika	Nan
ameerikada	ara ilu amẹrika	Nan
america	america	Nan
amarada	awọn aṣẹ	Nan
anad	anad	Nan
align=right	mö = ọtun	Nan
alifay	abidi	None
ahmiyada	pataki	Nan
ahn	ah	Nan
ahna	ati	Nan
ahoo	ahoo	Nan
ahtiirarka	awọn aworan	Nan
ahwaxay	oun	None
ahyad	ahya	Nan
ahyd	ahyd	Nan
aid	iranlowo	Nan
air	ategun	Nan
airlines	oko	None
airport	papa	None
airways	atẹgun	Nan
ajaanibta	àlejò	Nan
ajar	ajar	Nan
ahmiyad	pataki	Nan
ajnabi	àjèjì	Nan
ahmed	ahmed	Nan
ahluxaddiiska	awọn idogba	Nan
ahay	emi ni	Nan
ahayd	wà	Nan
ahayde	emi	Nan
ahaydkadib	jẹ nigbamii	Nan
ahayee	jẹ o	Nan
ahayn	ko	None
ahba	bẹẹni	Nan
ahcafariga	ẹbẹ	Nan
ahe	ahem	Nan
aheed	ti itoju	Nan
aheyd	wà	Nan
aheyn	jẹ	Nan
ahi	jẹ	Nan
ahina	bẹẹni	Nan
ahlu	ah	Nan
ahluxaddiisku	ti awọn oniwe-lodi	Nan
ajuuraan	idiyele	Nan
ak	itan	Nan
akhlaaqda	ihuwasi	Nan
albaabka	ilekun	Nan
albaani	ilekun	Nan
albaaniya	ni albania	Nan
albakr	albakr	Nan
albania	albania	Nan
albaqrahaayada	ẹnu-ọna	Nan
alcallaama	alikama	Nan
aldalanj	aldalanj	Nan
alfaatex	alfaatex	Nan
alfaatixoo	alfa	Nan
algorithm	alugoridimu	Nan
algorithms	awọn alugoridimu	Nan
alhilaali	agbelẹrọ	Nan
ali	ali	Nan
alif	alif	Nan
alazhar	awọn ibugbe	Nan
alalbaani	ẹlẹgbin	Nan
alaha	haha	Nan
alaabtiisii	rẹ	None
akhlaaqdii	iwa	Nan
akhri	ka	Nan
akhrin	ka	Nan
akhrinducaysiilaah	akhrinducayslaaah	Nan
akhrinta	kika	Nan
akhrisan	ka	Nan
akhriska	kika	Nan
alifka	ahbidi	Nan
akhriso	ka o	Nan
akhriyaan	ka o	Nan
akhriyay	ka	Nan
akhriyo	ka	Nan
akr	akojo oja	Nan
al	al	Nan
ala	silẹ	Nan
alaabta	awọn ọja	Nan
akhristo	ka o	Nan
anagaa	àwa	Nan
anagoo	nipasẹ wa	Nan
anagu	àwa	Nan
arkayninba	yio	None
arkayo	ríran	Nan
arkaysaa	ṣe o ri	Nan
arkeen	rí	Nan
arkey	arkey	Nan
arki	wo	Nan
arko	ti ri	Nan
arkoon	yio	None
arlada	lórí ilẹ̀ ayé	Nan
arligiina	rẹ	None
aroor	owurọ	Nan
arrimaha	awọn ọran	Nan
arrimahaas	fun	None
arrimo	awọn ọran	Nan
arrin	ọrọ	Nan
arkay	ti ri	Nan
arrinkaa	fun	None
arkaan	wo	Nan
arjantiina	iyawo	None
arif	arif	Nan
ariga	ewurẹ	Nan
arima	oro	Nan
arimaha	awọn ọran	Nan
arimahaa	awọn ọran wọnyi	Nan
arimahaas	fun	None
arimo	awọn ọran	Nan
arimood	awọn ọran	Nan
arin	àárín	None
arinkaas	fun	None
arinta	oro naa	Nan
arintaa	fun	None
arintaas	fun	None
arintaasi	o n niyen	Nan
arintan	atejade yii	Nan
arkaa	rí	Nan
arrinkaan	fun	None
arrinkaas	fun	None
arrinkii	ọrọ naa	Nan
asalka	oti	Nan
asalkooda	wọn	None
asalkoodii	wọn	None
asalkoodu	wọn	None
asaxaabtu	ọrẹ	Nan
asc	gòke	Nan
aserbiijaan	tẹ bọtini	Nan
asharaaf	ẹlẹtan	Nan
ashhadu	eeru	Nan
ashyaada	ohun	Nan
asiga	emi	Nan
askar	jagunjagun	Nan
askari	jagunjagun	Nan
askarta	awọn ọmọ-ogun	Nan
askax	jagunjagun	Nan
asal	oti	Nan
asagoo	nipasẹ	Nan
asagana	kan	None
asaga	rẹ	None
arrinku	ọrọ naa	Nan
arrintaa	fun	None
arrintaan	ninu ọran yii	Nan
arrintaas	fun	None
arrintan	ninu atejade yii	Nan
arrintii	ọrọ naa	Nan
arrintu	ọrọ naa	Nan
ari	dide	Nan
arwa	arwa	Nan
arxan	arínifín	Nan
arxanka	ìgbéraga	None
as	bi	Nan
asaasay	ipilẹ	Nan
asaaseen	mulẹ	Nan
asaasidii	awọn ipilẹ	Nan
asad	agbọnrin	Nan
arwaaq	igi	Nan
argagixisa	onijagidijagan	Nan
argagaxa	ẹrù	Nan
areas	awọn agbegbe	Nan
application	ohun elo	Nan
april	kẹrin	None
aqaan	mo mo	Nan
aqal	ilé	None
aqalgalay	gba	None
aqalka	ile naa	Nan
aqbalay	gba	None
aqlabiyad	poju	Nan
aqlabiyada	poju	Nan
aqliyad	poju	Nan
aqoon	imo	Nan
aqoone	imo	Nan
aqoonsadaan	wọn	None
aqoonsadayafka	awọn idamo	Nan
aqoonsado	ṣe idanimọ	Nan
any	àwa	Nan
antiilis	antiilis	Nan
antenna	eriali	Nan
ansaxa	wiwulo	Nan
anan	nibi	Nan
anbaqaaday	gba	None
anbaxaxeen	wọn	None
anbieter	anbieter	Nan
and	ati	Nan
andocootay	andocootay	Nan
andorra	andorra	Nan
aqoonsan	mọ	Nan
anfac	wulo	Nan
aniga	emi	Nan
anigaa	emi	Nan
anigoo	emi	Nan
anigu	emi	Nan
anna	mánà	Nan
annaga	àwa	Nan
anoo	anoo	Nan
angola	má lọ	Nan
ahana	rárá	Nan
aqoonsanayn	aimọ	Nan
aqoonsato	ṣe idanimọ	Nan
aragti	yii	Nan
aragtid	ṣe o ri	Nan
aragtida	yii	Nan
aragto	wo	Nan
arbaco	ọjọru	Nan
ardada	omo ile	Nan
ardaqal	irungbọn	Nan
arday	ọmọ	None
ardayda	omo ile	Nan
ardaydiisii	rẹ	None
ardaygii	ọmọ	None
ardoqalna	bẹni	Nan
ardul	ardul	Nan
arduqalwaxa	ariwo	Nan
are	jẹ	Nan
aragtay	ti ri	Nan
aragtaa	ṣe o ri	Nan
aragnimo	iriri	Nan
arag	wo	Nan
aqoonsi	idanimọ	Nan
aqoonta	imo	Nan
aqoontiisa	rẹ	None
aqoontoodu	won imo	Nan
aqoonyahan	omowe	Nan
aqoonyahanad	awọn ọjọgbọn	Nan
aqoonyahano	awọn ọjọgbọn	Nan
aqoonsatay	mọ	Nan
aqrinayaa	ka	Nan
aqrineysaa	ka o	Nan
aqrinta	kika	Nan
aqriyey	ka	Nan
aqriyo	lati ka	Nan
ar	ar	Nan
arab	arab	Nan
arabsiyo	olukuluuku ara wa	Nan
aqrinayo	kika	Nan
ahan	kiise	Nan
ahada	orukọ	Nan
ahaayeen	wà	Nan
abaarta	ogbele	Nan
abaartii	ogbele	Nan
ababa	t’okan	Nan
ababuleen	paarẹ	Nan
abd	abd	Nan
abdalle	abdalle	Nan
abdi	abd	Nan
abdirahman	ọ̀rẹ́	Nan
abdirashid	abdrashid	Nan
abdul	awọn abdul	Nan
abdulkarim	abdulkarim	Nan
abdullah	abdullah	Nan
abdullahi	awon ore mi	Nan
abdulle	abdulle	Nan
abdulrahman	awọn abdulrahman	Nan
abaarso	ifọkansi	Nan
abdulsalam	abdulsalam	Nan
abaaro	dabaru	Nan
abaalmariyo	awọn ere	Nan
aasaasy	ipile	Nan
aasan	sinmi	Nan
aasanyahay	sin	Nan
aasay	sin	Nan
aasaynaa	lati sin	Nan
aasiya	esia	None
aasiyamaanta	ailagbara	Nan
aasiyo	ifẹ	Nan
aay	wọn	None
aayadaha	ẹsẹ	None
aayadda	ẹsẹ	None
ab	ab	Nan
abaabul	se koriya	Nan
abaabulay	ṣeto	Nan
abaal	ère	Nan
abaar	ogbele	Nan
abeba	labalaba	None
abgaal	sibi	Nan
abii	abbl.	Nan
abu	ohun	Nan
abul	gbalaye	Nan
abuu	ṣẹda	Nan
abuubakar	eleda	Nan
abuubakari	eleda	Nan
abuukar	eleda	Nan
abuuraa	ṣẹda	Nan
abuurantay	ṣẹda	Nan
abuuray	ṣẹda	Nan
abuurey	ṣẹda	Nan
abuuro	ṣẹda	Nan
abuurtay	ṣẹda	Nan
abwaan	olorin	Nan
abwaanada	awọn ewi	Nan
abwaanka	adirẹsi	Nan
abtiyaashiis	idile	Nan
abtirsiinyada	idile	Nan
abtirsadaan	idile	Nan
abtirsada	idile	Nan
abiidhaalib	alliance	Nan
abiikar	o kere ju	Nan
abil	abil	Nan
abkhazia	abkhazia	Nan
abokar	ọ̀rẹ́	Nan
abokor	ọ̀rẹ́	Nan
abooreey	ejo	Nan
aasaastay	ipilẹ	Nan
abraha	abras	Nan
abroone	aburo	Nan
absame	àìní	None
abshir	aburu	Nan
absuge	ipalọlọ	Nan
abti	aburo	Nan
abtigiis	aburo baba re	Nan
abtirisiinyihiisu	ainiye	Nan
abriil	kẹrin	None
aasaaskii	ipile	Nan
aasaaska	ipile	Nan
aasaasihii	oludasile	Nan
aad	iwo	Nan
aada	lọ	Nan
aadam	ọmọ	None
aadamka	eda eniyan	Nan
aadamuhu	ìran ènìyàn	Nan
aadan	iwo	Nan
aadanaha	eda eniyan	Nan
aadanuhu	eda eniyan	Nan
aaday	lọ	Nan
aaden	o lọ	Nan
aadey	lọ	Nan
aadka	pupọ	Nan
aadna	lọ	Nan
aado	lati lọ	Nan
aafo	a aawọ	Nan
aabihiisna	rẹ	None
aabihiis	rẹ	None
aabihiina	baba mi	Nan
aabihii	baba	Nan
+	+	Nan
<i>	<i>	Nan
<i><i>	<i><i>	Nan
<wareega	<wareega	Nan
=	=	Nan
==	==	Nan
===xoriyadii	=== ominira	Nan
aagga	agbegbe	Nan
a	a	Nan
aaayadda	ẹsẹ	None
aabaha	baba	Nan
aabahayo	baba wa	Nan
aabbe	baba	Nan
aabbihii	rẹ	None
aabbihiis	rẹ	None
aabe	baba	Nan
aa	a	Nan
abwaankii	olorin	Nan
aaggii	agbegbe	Nan
aakhiraba	ni ọrun	Nan
aannu	àwa	Nan
aanu	aanu	None
aanuu	laisi	Nan
aar	aar	Nan
aargoosi	ẹsan	Nan
aas	isinku	Nan
aasaar	isinku	Nan
aasaarta	isinku	Nan
aasaartan	ipilẹ yii	Nan
aasaasaha	oludasile	Nan
aasaasay	ipilẹ	Nan
aasaasayaasha	awọn oludasilẹ	Nan
aasaasayaashii	awọn oludasilẹ	Nan
aasaasi	ipilẹ	Nan
aasaasiga	ipilẹ	Nan
aannaan	ko	None
aanay	ko	None
aanan	ko	None
aan	kii ṣe	Nan
aakhirana	ni ọrun	Nan
aakhiro	ni ọrun	Nan
aakhiroba	aarọ	Nan
aalacimraan	wọn	None
aalo	kan	None
aamdiga	ijewo	Nan
aamin	gbekele	Nan
aakhiraa	ni ọrun	Nan
aaminaan	gbagbọ	Nan
aamino	gbagbọ	Nan
aaminsan	gbagbọ	Nan
aaminsanyahay	gba	None
aaminsanyihiin	gbagbọ	Nan
aamisan	gbaagbo	Nan
aammiin	gbẹkẹle mi	Nan
aamus	dake	Nan
aamini	igbẹkẹle	Nan
aslam	aslam	Nan
abwaanku	olorin	Nan
abwaano	ohun	Nan
afraadwaana	kẹrin	None
afrah	afrah	Nan
afrax	kẹrin	None
africa	afirika	Nan
african	afirika	Nan
afrika	afirika	Nan
afrikaba	ni afirika	Nan
afrikada	ni afirika	Nan
afrikakadib	afirika	Nan
afroaasiya	ẹyẹ	Nan
afsomaliga	ni èdè yorùbá	Nan
afsoomaali	somalidè gẹẹsi	Nan
afsoomaaliga	ede	None
afsoomaaligu	ede	None
afsoomali	somalidè gẹẹsi	Nan
afmadow	fun	None
afsoomaliga	ede	None
afkiisuna	rẹ	None
afjaro	ipari	Nan
afdhere	fifọ	Nan
affaransiis	afirika	Nan
afgaanistaan	afiganisitani	Nan
afgambi	iyipo	Nan
afgambigii	awọn coup	Nan
afganistan	afiganisitani	Nan
afgaranwaa	gba	None
afgobaadsi	ifasita	Nan
afgooye	olutapa	Nan
afgoye	le	None
afhayeenka	agbọrọsọ	Nan
afikada	ede	None
afingiriis	gẹẹsi	Nan
afisbaanish	ede	None
afjaray	ipari	Nan
afka	ẹnu	Nan
aftahan	aroko yii	Nan
after	lẹhin	Nan
aftigree	aftigree	Nan
ahaaday	jẹ	Nan
ahaadee	jẹ o	Nan
ahaado	jẹ	Nan
ahaan	jẹ	Nan
ahaana	ati pe o jẹ	Nan
ahaanba	egba	None
ahaanjirtay	iyẹn	Nan
ahaanna	ati pe o jẹ	Nan
ahaanshaha	jije	None
ahaantii	ni pato	Nan
ahaataye	si ọ	Nan
ahaatee	sibẹsibẹ	Nan
ahaato	jẹ	Nan
ahaay	wà	Nan
ahaaye	naye	Nan
ahaa	wà	Nan
aha	rárá	Nan
ah	ah	Nan
agtiisa	lẹgbẹẹ ẹ	Nan
afturki	afturki	Nan
afurayo	owurọ	Nan
ag	ag	Nan
aga	lọ	Nan
agaasimaha	oludari	Nan
agaasime	oludari	Nan
agaasimihii	oludari	Nan
afdheer	mẹrin	Nan
agagaarka	yika	Nan
agasimihii	oludari	Nan
agoon	alainibaba	Nan
agoontii	alainibaba	Nan
agoonyar	rogbodiyan	None
agoosto	oṣu kẹjọ	Nan
agrario	agrario	Nan
agteeda	lẹgbẹẹ ẹ	Nan
agagaarkeeda	rẹ	None
afcarabi	fun	None
afartii	awọn mẹrin	Nan
afartankii	ogoji	Nan
adduunka	ileaye	Nan
adduunkan	ninu aye yii	Nan
adduunku	ileaye	Nan
adduunyada	agbaye	None
adduunyadu	agbaye	None
adeeg	iṣẹ	Nan
adeega	iṣẹ	Nan
adeegayooda	wọn	None
adeegsadaa	nlo	Nan
adeegsadaan	lo	Nan
adeegsado	ti lo	Nan
adeegsan	lo	Nan
adeegsatay	ti lo	Nan
adeegsiga	lo	Nan
adeegtana	iṣẹ	Nan
adduun	aye yii	Nan
addoonku	ìránṣẹ́	Nan
addoonkiisa	rẹ	None
addoonkii	ìránṣẹ́	Nan
account	akọọlẹ	Nan
ad	ipolowo	Nan
adaa	iwo	Nan
adaan	eyi	Nan
adag	lile	Nan
adal	ododo	None
adam	ènìyàn	Nan
adeegyada	awọn iṣẹ	Nan
adan	adan	Nan
addaa	si ọ	Nan
addis	afẹsodi	Nan
addoomada	ẹrú	Nan
addoomadiisa	rẹ	None
addoomo	ẹrú	Nan
addoon	ìránṣẹ́	Nan
addoonka	iranṣẹ	Nan
add	ṣafikun	Nan
abwaannada	awọn ewi	Nan
adeegyadii	awọn iṣẹ	Nan
adeegyo	awọn iṣẹ	Nan
adna	adna	Nan
adoo	rẹ	None
adoomada	ẹrú	Nan
adoon	laisi ado	Nan
aduu	dan	Nan
aduunka	ileaye	Nan
aduunyada	ileaye	Nan
af	le	None
afaf	ede	None
afafka	ede	None
afar	mẹrin	Nan
afaraad	kẹrin	None
afaraadna	kẹrin	None
afarta	awọn mẹrin	Nan
afartaas	awọn mẹrin	Nan
administartion	abojuto	Nan
adkeynta	fẹẹrẹ	Nan
adkaysan	farada	Nan
adkaade	asegun	Nan
adeer	aburo	Nan
adeerka	aburo	Nan
adeerkii	aburo	Nan
adeerkiis	aburo baba re	Nan
adeerkood	arakunrin baba mi	Nan
adeerradii	aburo	Nan
aden	aden	Nan
adeegyadooda	wọn	None
adhiga	agutan	Nan
adiga	iwo	Nan
adigaa	iwo	Nan
adigoo	rẹ	None
adigu	iwo	Nan
adiinoo	fun	None
adkaaaday	ṣẹgun	Nan
adkaaday	ṣẹgun	Nan
adi	lati jẹ	Nan
asluubta	ibawi naa	Nan
asna	asna	Nan
assaid	kọja siwaju	Nan
beelihii	awọn agbegbe	Nan
beelo	sọnu	Nan
beelood	awọn agbegbe	Nan
beelweynta	agbegbe	Nan
been	èké	Nan
beenawday	parọ	Nan
beeni	sẹ	Nan
beeniyana	sẹ	Nan
beeniyeen	sẹ	Nan
beenta	irọ	Nan
beentana	má parq	Nan
beer	kan	None
beera	gbìn	Nan
beeraha	ogbin	Nan
beeraleey	agbẹ	Nan
beelahakan	ninu awọn agbegbe wọnyi	Nan
beerato	ohun ọgbin	Nan
beelahaas	awon agbegbe wonyi	Nan
beel	agbegbe	Nan
baytulaxam	ogbon	Nan
bbc	abbl.	Nan
be	jẹ	Nan
bebad	irù	Nan
bed	ibusun	Nan
beddelo	yipada	None
bedelaan	yipada	None
bedelay	yipada	None
bedeli	yi pada	Nan
bedelin	yipada	None
bedka	aaye	Nan
beebeen	sọnu	Nan
beedkeediiduqaydii	igba mi	Nan
beegan	konge	Nan
beegsaday	ìfọkànsí	Nan
beelaha	awọn agbegbe	Nan
beeray	gbin	None
beereed	béèrè	Nan
beero	gbìn	Nan
bern	bern	Nan
besha	besha	Nan
between	laarin	None
bey	bey	Nan
beytkiisa	rẹ	None
biblia	biblia	Nan
bidcada	awọn ẹṣẹ	Nan
bidco	bidco	Nan
bidix	osi	Nan
biir	oti sekengberi	Nan
biira	oti sekengberi	Nan
biiray	darapo	None
biirey	darapo	None
biiro	opolo	Nan
biirtay	darapo	None
bermer	ata	Nan
berigii	nigbamii	Nan
berberaburao	ọla	Nan
berbera	ọpọtọ	Nan
beeroley	agbẹ	Nan
beerta	ninu ọgba	Nan
beerto	gbingbin	Nan
beesha	agbegbe	Nan
beeshu	irungbọn	Nan
beeyay	m	Nan
being	jije	None
bayoolojiga	isedale	Nan
belarus	belarus	None
belfast	belfast	Nan
belgium	belgium	None
beljim	belijiomu	Nan
belkooda	wọn	None
belo	belo	Nan
benin	ibujoko	None
benito	benito	Nan
beledweyne	bẹtẹli	Nan
bayolojigu	isedale	Nan
bayoloji	isedale	Nan
bayna	ọna	Nan
barrow	agba	None
barsane	barina	Nan
barta	koko	Nan
bartaan	kọ ẹkọ	Nan
bartamaha	ni aarin	Nan
bartamihii	ni aarin	Nan
bartan	bayi	None
bartay	kọ ẹkọ	Nan
bartey	bakan	Nan
barto	kọ ẹkọ	Nan
barwaaqa	aisiki	Nan
barwaaqo	aisiki	Nan
baryaya	gbangba	Nan
baryayaa	gbadura	Nan
baryey	bẹbẹ	Nan
barre	agba	None
barooyosoomaaliya	profaili	Nan
baroordiiqda	ṣọfọ	Nan
baroordiiqa	ṣọfọ	Nan
barina	osi	Nan
barisoomaaliya	indoctrination	Nan
barista	nkọ́ni	Nan
baritish	alaigbede	Nan
barkaan	idaji	None
barkaanle	oluranlọwọ	Nan
barkada	adagun-odo	Nan
baryi	lati ṣagbe	Nan
barlamaankadfkmg	alafia	Nan
barlamanka	rẹ	None
barlaskooni	biriki	Nan
barliin	agbọnrin	Nan
barnaamijka	eto	Nan
barnaamijkan	ninu eto yii	Nan
barnaamijyada	awọn eto	Nan
baro	kọ ẹkọ	Nan
barlamaankiyo	ile igbimọ aṣofin	Nan
bik	bi	Nan
basaas	kan	None
based	orisun	None
baxiira	dake enu re	Nan
baxo	ewé	None
baxrayn	sọ	None
baxsaday	sa asala	Nan
baxsadeen	sa asala	Nan
baxsan	ita	Nan
baxsanida	sa asala	Nan
baxshay	san	Nan
bay	bay	Nan
baybalka	bibeli	None
baybalku	bibeli	None
baydhaba	yi pada	Nan
baydhabo	wa soke	Nan
baydhabotan	ni ọna yi	Nan
baylah	alailewu	Nan
baxeen	wọn	None
baxdo	jade	Nan
baxday	jade	Nan
baxdaa	jade	Nan
baseey	mimọ	Nan
bashiir	onigbese	Nan
bashir	basari	Nan
bataatiga	poteto	Nan
batalaale	ọrẹ	Nan
batay	pọ si	Nan
bateen	isodipupo	Nan
base	mimọ	Nan
batroolka	ilẹ	None
baw	baw	Nan
baxa	jade	Nan
baxaa	ewé	None
baxaan	jade	Nan
baxay	jade	Nan
baxayaa	ewé	None
baxda	jade	Nan
batuuta	parọ	Nan
bariiska	iresi	Nan
bikra	wundia	Nan
bilaa	laisi	Nan
boorin	lati be	Nan
boorinta	iyanju	Nan
boosaaso	bosaso	Nan
boosaha	ifiweranṣẹ	Nan
booskii	ibi	Nan
booskiisii	rẹ	None
boqol	ọgọrun	Nan
boqolkii	ọgọrun	Nan
boqolkiiba	ogorun	Nan
boqolsoon	ọgọrun	Nan
boqor	kan	None
boqorad	ayaba	Nan
boqoraddii	ayaba	Nan
boqorka	ọba	Nan
boqorkayow	ọba mi	Nan
boorame	elegede	Nan
boqorkii	ọba	Nan
boorama	elegede	Nan
booqdayaasha	àlejò	Nan
bombeelmada	ajonirun	Nan
boob	ìkógun	Nan
bood	fo	Nan
boodhari	lilọ	Nan
booliiska	awon olopa	Nan
booliska	awon olopa	Nan
boon	agbon	Nan
boondheere	fun	None
booqan	ṣàbẹwò	Nan
booqanaya	àbẹwò	Nan
booqashada	ibewo	None
booqashadeydi	ibewo	None
booqdaa	ṣàbẹwò	Nan
booqdaan	bẹwò	Nan
booqday	ṣàbẹwò	Nan
booqdo	ṣàbẹwò	Nan
boqornimada	ijọba	Nan
boqortooyada	ijọba	Nan
boqortooyadii	ijọba	Nan
bukhaari	ibori	None
bukhari	bukhari	Nan
bulgaariya	bulgaria	Nan
bulgaria	bulgaria	Nan
bullaxaar	omi	None
bulleted	ibọn	Nan
bulshada	agbegbe	Nan
bulshadabawaayo	ko	None
bulshadeennu	agbegbe wa	Nan
bulshadii	adugbo	Nan
bulsho	lawujọ	Nan
bun	bun	Nan
buq	ariwo	Nan
bur	iyẹfun	Nan
buraan	iṣuu	Nan
buka	ṣàìsàn	Nan
buhoodle	oluraja	Nan
budh	buddhudu	Nan
buaale	ẹtu	Nan
boqortooyadu	ijọba	Nan
boqortooyo	ijọba	Nan
boqray	ọba	Nan
borama	borama	Nan
borogaramyo	olutayo	Nan
bortaqiiska	ilu pọtugali	Nan
borwa	lati wa	Nan
bollywood	boluti	Nan
bosniya	ibanujẹ	Nan
botswana	botswana	Nan
brdm	brdm	Nan
britain	britain	None
britan	ọla	Nan
britanwaxa	ọla	Nan
british	oloogun	Nan
btr	btr	Nan
botha	botha	Nan
bolkaniskaee	tẹ bọtini	Nan
bolis	eegun	Nan
boliifia	biliifia	Nan
billaabo	láti ìbẹ̀rẹ̀	Nan
biloobo	alakoko	Nan
bilood	awọn oṣu	Nan
bilow	bẹrẹ	Nan
bilowday	bẹrẹ	Nan
bilowgii	láti ìbẹ̀rẹ̀	Nan
bilsho	bilsho	Nan
bilwaday	dide	Nan
bin	atẹle	Nan
bini	ènìyàn	Nan
biniaadamka	ọmọ	None
biniaadanka	eda eniyan	Nan
bintu	bintu	Nan
binu	binu	Nan
bir	irin	Nan
bill	owo	Nan
bile	ẹyẹ	Nan
bilay	osù	Nan
bilawgii	láti ìbẹ̀rẹ̀	Nan
bilaabaan	bẹrẹ	Nan
bilaabata	bẹrẹ	Nan
bilaabatay	bẹrẹ	Nan
bilaabato	bẹrẹ	Nan
bilaabay	bẹrẹ	Nan
bilaabayaa	bẹrẹ	Nan
bilaabeen	bẹrẹ	Nan
biritishka	ara ilu gẹẹsi	Nan
bilaabidda	ipilẹṣẹ	Nan
bilaabo	lati	Nan
bilaal	medal	Nan
bilaawday	bẹrẹ	Nan
biladao	medal	Nan
bilaha	awọn oṣu	Nan
bilawday	bẹrẹ	Nan
bilawga	ibere	Nan
bilaabmay	bẹrẹ	Nan
bil	osù	Nan
birmingham	birmingham	Nan
bisha	osù	Nan
bmp	bmp	Nan
bni	bni	Nan
bog	oju iwe	Nan
boga	oju iwe	Nan
bogaadin	ikini	Nan
bogaan	iwe yi	Nan
bogan	bogan	Nan
bogga	oju iwe	Nan
boggan	iwe yi	Nan
bohol	arekereke	Nan
boire	bore	Nan
bois	ariwo	Nan
boland	oorun	Nan
bold	igboya	Nan
bole	bole	None
biyo	omi	None
biyihii	omi	None
biyaha	omi	None
bixiyey	pese	Nan
bishii	osù	Nan
bishiisa	rẹ	None
bishuna	bishuna	Nan
bisinka	bis	Nan
bisiqa	biceps	Nan
bisiqley	bisiqley	Nan
bislaado	pọn	Nan
birta	irin	Nan
bislaanaayo	pọn	Nan
bixin	jade	Nan
bixinta	ipese	Nan
bixisaa	pese	Nan
bixisay	san	Nan
bixiya	pese	Nan
bixiyaan	pese	Nan
bixiyay	pese	Nan
bixi	jade	Nan
dheeraada	diẹ sii	Nan
bariise	iresi	Nan
bariire	ọkà baali	Nan
baa	jẹ	Nan
baabal	farasin	Nan
baabii	kuro	Nan
baabulmandab	ọkọ ayọkẹlẹ	Nan
baabuur	ọkọ ayọkẹlẹ	Nan
baabuurta	oko	None
baad	iwo	Nan
baadi	aṣiṣe	Nan
baadicadde	arekereke	Nan
baadiye	aṣawakiri	Nan
baahan	nilo	Nan
baahday	nilo	Nan
baahi	nilo	Nan
baahiayay	si	Nan
baahida	nilo	Nan
ba	kii ṣe	Nan
baahintaasi	igbohunsafefe	Nan
b	b?	Nan
azc	azc	Nan
ayeey	igbesi aye	Nan
ayey	ọna	Nan
ayeyna	wọn	None
ayna	wọn	None
aynaan	ko	None
aynaanshe	oun	None
aynu	ki	None
ayoo	fẹẹrẹ	Nan
aysan	ko	None
aysanna	bẹni	Nan
ayuu	oun	None
ayuub	heb	Nan
ayuun	dun	None
ayuuna	o ṣe	Nan
ayuuu	oun	None
aṣṣūmāl	anūmālāl	Nan
baahna	ko	None
baahnaa	nilo	Nan
baal	iye	Nan
baarlamaanka	ile igbimọ aṣofin	Nan
baarliin	baluu	Nan
baarri	iteriba	Nan
baaruude	wundia	Nan
baasifik	ṣiṣu	Nan
baath	ẹrẹ	Nan
baaxad	dopin	Nan
baaxada	iwọn	Nan
baaxadda	iwọn	Nan
baaxadiisu	dopin	Nan
baay	bay	Nan
baayacmushtar	ọjà	Nan
baayasiid	isowo	Nan
baaz	buz	Nan
babaayga	baba mi	Nan
baarlamaan	ile igbimọ aṣofin	Nan
baaritaan	iwadii	Nan
baaris	iwadii	Nan
baariis	ẹlẹgba	Nan
baalakan	iyẹ	Nan
baallacad	gbooro	Nan
baalle	baluu	Nan
baan	banki	Nan
baanka	banki	Nan
baannu	a ni	Nan
baanu	binu	Nan
ayeen	wọn	None
baaq	pe	Nan
baaqan	ku	None
baaqayeen	won npe	Nan
baaqaysay	n pe	Nan
baar	wa	Nan
baardheere	adugbo	Nan
baargaal	idunadura	Nan
baari	baari	Nan
baaqa	ipe	Nan
ayee	ayeye	Nan
aydinaan	ted	Nan
aydhiyooliyadda	kadara	None
avv	avv	Nan
aw	aw	Nan
awal	awl	Nan
awaxaana	ṣe o mọ	Nan
awdadl	awdadl	Nan
awdal	awdal	Nan
awdalxiligaasoo	akoko yẹn	Nan
awdigil	kan	None
awdigilwuxuu	le	None
aweys	ilọpo meji	Nan
awgeed	nitori re	Nan
awliyada	awon tions	Nan
awmuuse	ṣẹ	Nan
awood	agbara	None
awooda	agbara	None
average	aropin	Nan
avenue	ona	Nan
available	wa	Nan
authentication	ìfàṣẹsí	Nan
assembly	apejọ	Nan
astaamaha	awọn aami aisan	Nan
astaamo	awọn aami aisan	Nan
astaan	aami	Nan
astaannta	apẹẹrẹ	Nan
astaanta	aami	Nan
asturaa	binu	Nan
awoodaha	agbara	None
asxaabtii	ọrẹ	Nan
at	ni	Nan
atlaantik	ede	None
atom	ọgbọn	Nan
attaxiyaadka	awọn imọ-jinlẹ	Nan
audio	ohun	Nan
august	ogo	Nan
australia	ilu oyinbo	Nan
asxaabtiisa	rẹ	None
babac	na ọwọ soke	Nan
awooday	anfani	Nan
awoodeedu	rẹ	None
ayaa	awọn	Nan
ayaad	iwo	Nan
ayaamo	àwọn ọjọ́	Nan
ayaan	emi	Nan
ayaana	ati pe iyẹn	Nan
ayaanle	mint	Nan
ayaanu	yoo	None
ayaay	wọn	None
ayada	rẹ	None
ayadoo	pẹlu	Nan
ayaga	wọn	None
ayagoo	wọn	None
ayan	ko	None
ayay	wọn	None
aybakar	nimọran	Nan
aya	ẹsẹ	None
ay	wọn	None
axmedعبدالله	axmed عبدالله	Nan
axmed	àá	Nan
awoodii	agbara	None
awoodoodiiwaxayna	wọn	None
awoow	agba	None
awoowe	agba	None
awoowgiis	baba baba re	Nan
awoowgiisii	baba baba re	Nan
awqaafta	ọgbọn	Nan
awoodda	agbara	None
awsamaale	fun	None
axaaddiista	imulẹ	Nan
axaadiista	aditi	Nan
axad	ọjọ sundee	Nan
axdiga	majẹmu	Nan
axdigii	majẹmu	Nan
axkaamta	ko	None
axmad	majẹmu	Nan
axaaaddiistuba	aditi	Nan
bariis	iresi	Nan
babayga	baba mi	Nan
bacadle	sẹhin	Nan
bandhigo	ṣafihan	Nan
bandhigtay	gbekalẹ	Nan
bangiga	banki	Nan
bangigu	banki	Nan
bangladesh	onigbọwọ	Nan
bani	ènìyàn	Nan
baniaadamka	eda eniyan	Nan
banii	banii	Nan
bank	banki	Nan
banka	banki	Nan
banna	si ilodi	Nan
bannaan	aaye	Nan
bannaanayd	òfo	Nan
baqaa	bẹru	Nan
baqay	bẹru	Nan
bandhigeen	gbekalẹ	Nan
baqaya	bẹru	Nan
bandhigay	gbekalẹ	Nan
banadir	ṣọwọn	Nan
baledweyn	tobi	Nan
balila	ọkà baali	Nan
ballaadhaan	gbooro	Nan
ballaadhan	gbooro	Nan
ballaaran	gbooro	Nan
ballaariyeen	gbooro	Nan
ballan	ṣèlérí	Nan
ballanta	ipinnu lati pade	Nan
balqiisa	balikoni	Nan
balse	ṣugbọn	Nan
bamkii	fifa soke	Nan
banaadir	banki	Nan
banaan	ṣ&#39;ofo	Nan
banaanideeda	ita	Nan
banaanka	ita	Nan
bandarbayla	idagba	Nan
baqdaad	eru	Nan
bar	pẹpẹ	Nan
bara	esi	Nan
baray	kọ	Nan
barayaal	awọn olukọni	Nan
barayoo	kikọ ẹkọ	Nan
barbaaray	dide	Nan
barbaarin	atunwe	Nan
barbaarinta	awọn igbega	Nan
barbaariyo	ntọjú	Nan
barbaraawi	barbaraw	Nan
barde	agba	None
bare	oluko	Nan
bareen	iwadi	None
bari	ki	None
baridiisa	rẹ	None
bariga	ila-oorun	Nan
bariidka	iresi	Nan
barax	ẹlẹgba	Nan
barawe	afarawe	Nan
barasiil	iresi	Nan
barasho	kikọ ẹkọ	Nan
baraako	ibukun	Nan
baraalan	flared	Nan
baraan	kọ	Nan
baraarug	imo	Nan
baraawe	owe	Nan
baracaatika	iyọkuro	Nan
barack	baraki	Nan
balcad	baluu	Nan
baraf	yinyin	Nan
barakaat	se o mo	Nan
barakacii	iyọkuro	Nan
baran	kọ ẹkọ	Nan
barano	ká	None
barashada	kikọ ẹkọ	Nan
barashadiisa	eko	None
barashadiisii	eko	None
baraguay	ibukun	Nan
balantii	ileri	Nan
balanqaadyadii	awọn ileri	Nan
balanqaaday	ti ṣèlérí	Nan
badantahay	lọpọlọpọ	Nan
badanyahay	ọpọlọpọ	Nan
badanyihiin	lọpọlọpọ	Nan
badashay	yipada	None
badaye	poju	Nan
badbaaday	ni igbala	Nan
badbaadayso	wa ni fipamọ	Nan
badbaadid	fipamọ	Nan
badbaadinta	fifipamọ	Nan
badbaadiyey	ti o ti fipamọ	Nan
badbaadiyo	fipamọ	Nan
badda	okun	Nan
baddacas	baddacas	Nan
baddii	okun	Nan
badh	idaji	None
badanna	pupo	Nan
badankoodu	wọn	None
badankooda	wọn	None
badankood	wọn	None
bachelor	oye	Nan
bad	buburu	Nan
bada	fifun	Nan
badacas	eegun-omi	Nan
badal	yipada	None
badalay	yipada	None
badaleen	yipada	None
badhaadhe	ni agbedemeji si	Nan
badalin	yipada	None
badan	lọpọlọpọ	Nan
badana	nigbagbogbo	Nan
badanaa	nigbagbogbo	Nan
badanaayey	wà nigbagbogbo	Nan
badane	pupo	Nan
badani	lọpọlọpọ	Nan
badanina	wọn	None
badalo	yipada	None
bacaadka	iyanrin	Nan
badhan	bọtini	Nan
badhtamaha	ni aarin	Nan
bahdil	itiju	Nan
bahdood	alaini	None
bahoobayxafladan	ṣe bukumaaki iṣẹlẹ yii	Nan
bakaaraha	bakaaro	Nan
baki	dudu	Nan
bakistaan	ni pakistan	Nan
bakool	bakool	Nan
bakoolgalgaduudnugaal	lilu	Nan
bakr	alagbẹdẹ	Nan
bal	wo	Nan
balaadhan	gbooro	Nan
balaaran	tobi	Nan
balaarintii	imugboroosi	Nan
balad	apari	Nan
baladhaan	yi fo	Nan
bahda	mate	Nan
bahal	ẹranko	Nan
bahabar	onigun	Nan
bah	bah	Nan
badhtamihii	ni aarin	Nan
badiba	okeene	Nan
badiyaa	nigbagbogbo	Nan
badka	okun	Nan
badmareen	omi	None
badn	buburu	Nan
badnaa	lọpọlọpọ	Nan
badhigtay	ti o ti fipamọ	Nan
badnayd	jẹ lọpọlọpọ	Nan
badnayn	po	None
badneyn	po	None
badno	diẹ sii	Nan
badood	òkun	Nan
badwaynta	okun	Nan
badweynta	òkun	Nan
baghdad	abidi	None
badnaydna	lọpọlọpọ	Nan
joogaanba	jẹ	Nan
dheeraadka	afikun	Nan
dheere	gun	None
helaynin	ko	None
helayo	wa	Nan
helaysaa	gba	None
heleen	ri	Nan
heleysa	gba	None
heli	wa	Nan
helin	wa	Nan
helitaanka	wiwa	Nan
heliwaa	wa	Nan
helno	wa	Nan
helo	wa	Nan
helsinki	àṣíborí	Nan
herar	herar	Nan
herbert	herbert	Nan
herer	nibi	Nan
helaye	wa	Nan
heshay	gba	None
helayaa	wa	Nan
helay	ri	Nan
heesaa	kọrin	Nan
heesaan	kọrin	Nan
heesaha	awọn orin	Nan
heesanin	kọrin	Nan
heesayaan	kọrin	Nan
heesihii	awọn orin	Nan
heeso	kọrin	Nan
heesta	orin naa	Nan
heestaan	orin yi	Nan
heestay	kọrin	Nan
heestii	orin naa	Nan
heesto	kọrin	Nan
height	gíga	Nan
helaa	wa	Nan
helaan	wa	Nan
helaya	gba	None
heshid	wa	Nan
heshiis	àdéhùn	Nan
heshiiska	àdéhùn	Nan
hijrada	ijira	Nan
hijriga	ijira	Nan
hijrigu	ijira	Nan
hijriyada	ijira	Nan
hilibka	eran	Nan
hilibku	eran	Nan
hillary	hillary	Nan
hilowle	pẹlẹ o	Nan
hindi	hindi	Nan
hindida	ẹhin	Nan
hindiya	hindi	Nan
hindu	hindu	Nan
hingaada	akọtọ	Nan
hingaadda	akọtọ	Nan
hiraab	apọju	Nan
hiiraan	ifọrọwanilẹnuwo	Nan
hiil	bawo	Nan
high	ga	Nan
hiddo	ogún	Nan
heshiiskii	adehun naa	Nan
heshiiso	laja	Nan
heshiisyo	awọn adehun	Nan
heshiiyeen	gba	None
hesho	wa	Nan
heshowali	laja	Nan
heyada	igigirisẹ	Nan
heesa	kọrin	Nan
heyn	dimu	Nan
heystayna	ni	Nan
heysto	ni	Nan
hibaaqeey	hobbled	Nan
hibada	ẹbun naa	Nan
hibo	ẹbun	Nan
hibrahim	hibrahim	Nan
hiddaha	atọwọdọwọ	Nan
heysta	ni	Nan
hiraabe	iwiregbe	Nan
hees	orin	Nan
heerka	ipele	None
hawd	iṣu	Nan
haween	obinrin	Nan
haweenaydii	obinrin naa	Nan
haweenka	obinrin	Nan
haweenkii	obinrin	Nan
haweenku	obinrin	Nan
hawiyaha	air kondisona	Nan
hawiye	dara	Nan
hawl	iṣẹ-ṣiṣe	Nan
hawlaha	akitiyan	Nan
hawo	fò	Nan
hawood	igi adágún	Nan
hawshaas	fun	None
hawshii	iṣẹ-ṣiṣe	Nan
hay	koriko	Nan
hawayga	omije	Nan
haya	iyalo	Nan
hawaii	hawaii	None
haw	hagbo	Nan
hargeisa	hargaisa	Nan
hargesa	hargesa	Nan
hargeysa	ilé	None
hariin	igbogunti	Nan
harimacadka	ariwo naa	Nan
harraad	oungbe	Nan
harti	harti	Nan
hartigu	ẹyẹ	Nan
has	ní	None
hasan	hasan	Nan
hase	sibẹsibẹ	Nan
haseyeeshee	sibẹsibẹ	Nan
hashiisii	olofofo re	Nan
hassan	hassan	Nan
have	ni	Nan
hawada	ninu afefe	Nan
hayaa	dimu	Nan
hayaan	dimu	Nan
hayada	ibẹwẹ	Nan
haysateen	ní	None
haysato	ni	Nan
haysay	tọju	Nan
hayso	tọjú ẹ	Nan
haysta	gba	None
haystaan	ni	Nan
haystay	ní	None
haystee	tọjú ẹ	Nan
haysteen	ní	None
haysto	ni	Nan
hdms	hdms	Nan
he	oun	None
hebel	ọmọ	None
heeganaa	a wa ni imurasilẹ	Nan
heer	ipele	None
haysatay	ní	None
haysata	ni	Nan
haysan	ni	Nan
haysaan	ni	Nan
hayadaha	awọn ile ibẹwẹ	Nan
hayadda	ara	Nan
hayay	tọju	Nan
haybadoofdii	iperegede	Nan
hayd	bẹẹni	Nan
hayeen	ni	Nan
hayeeshee	sibẹsibẹ	Nan
heersare	iperegede	Nan
hayey	tọju	Nan
hayin	rekọja	Nan
hayn	tọju	Nan
haynin	tọjú ẹ	Nan
hayo	dimu	Nan
hays	ni	Nan
haysa	idaduro	Nan
haysaa	ni	Nan
hayeyguddoomiyaha	gomina	None
hirayo	yawo	Nan
hireey	bẹwẹ	Nan
hirgelinteeda	awọn oniwe-imuse	Nan
hormaro	imudarasi	Nan
hormarsan	ti ni ilọsiwaju	Nan
hormood	onitẹsiwaju	Nan
hormoon	homonu	Nan
hormuudka	awọn ṣaaju	Nan
horraantii	sẹyìn	Nan
horrayntii	akoko	Nan
horraysay	akoko	Nan
horreeya	akoko	Nan
horreeyay	akọkọ	Nan
horreeyey	akọkọ	Nan
horreyey	ṣaju	Nan
horreysa	akoko	Nan
horsed	ẹlẹṣin	Nan
horseed	yori	None
hormar	ilọsiwaju	Nan
horseedaan	darí	Nan
horm	ilosiwaju	Nan
horjoogsan	idiwọ	Nan
horeeysay	akoko	Nan
horeeyso	akoko	Nan
horena	tẹlẹ	Nan
horey	sẹyìn	Nan
horeyay	ti tẹlẹ	Nan
horeysay	akoko	Nan
horeysey	sẹyìn	Nan
horjeed	ilodi si	Nan
horjeeda	idakeji	Nan
horjeeday	tako	Nan
horjeedeen	tako	Nan
horjeeedo	si ilodi	Nan
horjeesatay	tako	Nan
horjeestay	tako	Nan
horjeesteen	tako	Nan
horkeentay	niwaju	None
horseeday	darí	Nan
hortagay	idilọwọ	Nan
hortageen	koju	Nan
howlo	akitiyan	Nan
howlwadaag	alabaṣepọ	Nan
hoyatay	iya mi	Nan
hoyga	koseemani	Nan
hoyisay	gbalejo	Nan
hoyn	koseemani	Nan
httpsowikipediaorgwikidigiliyomirifle	httpsowikipediaorgwikidigiliyomirifle	Nan
httpwwwfreewebscominawarfaa	httpwwwfreewebscominawarfaa	Nan
httpwwwfreewebscominawarfaaindexhtm	httpwwwfreewebscominawarfaaindexhtm	Nan
httpwwwyoutubecomwatchv=lzyegdtes	httpwwwyoutubecomwatchv = lzyegdtes	Nan
huang	huang	Nan
hub	awọn ohun ija	Nan
hubaal	daju	Nan
hubaysan	ni ihamọra	Nan
hubiyey	ṣayẹwo	Nan
howlgal	isẹ	Nan
howlaha	akitiyan	Nan
however	sibẹsibẹ	Nan
how	bawo	Nan
hortago	ṣe idiwọ	Nan
hortii	akoko	Nan
hortiisa	rẹ	None
horumar	ilọsiwaju	Nan
horumarinta	idagbasoke	None
horumarka	ilọsiwaju	Nan
horumartay	idagbasoke	None
horeeyo	akoko	Nan
horuu	huu	Nan
horyimid	rẹ	None
hospital	ile-iwosan	Nan
hospitaller	iwosan	None
hoteel	hotẹẹli	Nan
hoteelada	awọn hotẹẹli	Nan
hotel	hotẹẹli	Nan
hotelada	awọn hotẹẹli	Nan
horyaal	ajumọṣe	Nan
horeeyey	sẹyìn	Nan
horeeye	akọkọ	Nan
horeeyay	akoko	Nan
hogaamiyayaal	awọn adari	Nan
hogaamiye	kan	None
hogaamiyihii	oludari	Nan
hogaamiyihiis	rẹ	None
hogaan	oludari	Nan
hogaanka	oludari	Nan
hogaankii	oludari	Nan
hoggaaminaayo	nyorisi	Nan
hoggaamiyihii	oludari	Nan
hoggaanka	oludari	Nan
hogol	hogol	Nan
hohey	hohey	Nan
hohob	hohob	Nan
holand	gẹẹsi	Nan
holland	gẹẹsi	Nan
hogaamiyaha	oludari	Nan
hogaamiya	yori	None
hogaaminayey	darí	Nan
hogaaminayeen	darí	Nan
hirgeliyo	agbara	None
hirka	ṣiṣan	Nan
hiroshima	hiroshima	Nan
history	itan	Nan
hivga	hivga	Nan
hiyiga	awọn ifisere	Nan
hlibka	ọmọ	None
home	ile	Nan
hobalada	folti	Nan
hobolada	ariyanjiyan	Nan
hobyo	hobyo	Nan
hodan	ọlọrọ	Nan
hoddaye	olowo	Nan
hogaaminaayey	yori	None
hogaaminaya	yori	None
hogaaminayay	yori	None
hobolad	rababa	Nan
hargaysi	tutu	Nan
hona	hona	Nan
hoo	hoo	Nan
hooyadood	wọn	None
hooyay	iya	Nan
hooyeen	iya	Nan
hooyey	iya	Nan
hooyo	iya	Nan
hor	ṣaaju	Nan
horaa	tẹlẹ	Nan
horaantii	sẹyìn	Nan
horay	sẹyìn	Nan
horaysay	akoko	Nan
hordhac	ifihan	Nan
hordhaca	ifihan	Nan
hore	sẹyìn	Nan
horeba	tẹlẹ	Nan
horeeya	akoko	Nan
hooyadiis	ìyá r.	Nan
hooyadii	iya naa	Nan
hooyada	iya naa	Nan
hooy	koseemani	Nan
hooggiinee	egbé	None
hooreysa	ni ilọsiwaju	Nan
hoos	silẹ	Nan
hoosaad	ipin	None
hoosdhaban	kekere	None
hoose	ni isalẹ	Nan
hoosedhexe	agbedemeji	Nan
hong	hong	Nan
hooseeya	kekere	None
hoosta	ni isalẹ	Nan
hoostaga	labẹ	Nan
hoostagaan	tẹriba	Nan
hoosteeda	labẹ	Nan
hoostiis	labẹ	Nan
hoostiisa	labẹ	Nan
hooteelka	ni hotẹẹli	Nan
hooseshabeelaha	oluṣakoso	Nan
hargaysa	ilé	None
hargaha	awọ ara	Nan
hareeyey	doti	Nan
guryahoodii	wọn	None
guryihii	awọn ile	Nan
guryo	awọn ile	Nan
guryohoodii	wọn	None
guto	se o	Nan
guubaabiyey	ji	Nan
guud	gbogboogbo	Nan
guude	ṣii silẹ	Nan
guudkeeda	lori dada	Nan
guul	aṣeyọri	Nan
guulaysatay	aṣeyọri	Nan
guulaystay	aṣeyọri	Nan
guuldaraystay	kuna	Nan
guuleed	ṣẹgun	Nan
guuleestay	bori	Nan
guryaha	awọn ile	Nan
guuleyso	lati wa ni aṣeyọri	Nan
gurmadeenitoobiya	oju-ile	Nan
gurigiisa	rẹ	None
gumeestihii	awọn oluṣafihan	Nan
gumeestiyaashii	awọn oluṣafihan	Nan
gumeysi	amunisin	Nan
gumeysiga	amunisin	Nan
gumeysigii	amunisin	Nan
gumeystaha	ogun	None
gumeystihii	ogun	None
gumeysto	afọwọsi	Nan
guray	grẹy	Nan
gureey	gba	None
gurey	bajẹ	Nan
guri	ilé	None
guriceel	iyẹwu	Nan
guriga	ni ile	Nan
gurigii	ile naa	Nan
gurigiisii	rẹ	None
guuleystay	aṣeyọri	Nan
guuleysto	jẹ aṣeyọri	Nan
guulihii	awọn aṣeyọri	Nan
guursatay	iyawo	None
guurtida	awọn alagba	Nan
guusha	aṣeyọri	Nan
guyana	ṣalaye	Nan
gyastayn	tunṣe	Nan
göteborg	göteborg	Nan
h	ẹ	Nan
ha	wọn	None
haa	bẹẹni	Nan
haadaan	bẹẹni	Nan
haadku	hárá	Nan
haag	ni ọtun	Nan
haagu	osi	Nan
haajiray	iṣilọ	Nan
haajirtay	iṣilọ	Nan
guursado	igbeyawo	None
guursadey	ṣe ìgbéyàwó	Nan
guursadaye	iyawo	None
guursaday	iyawo	None
guullahay	aṣeyọri	Nan
guulo	aṣeyọri	Nan
guulside	ṣẹgun	Nan
guulwadayaasha	bori	Nan
guulwade	olubori	Nan
guur	fẹ	Nan
guuraaga	gbigbe	Nan
gumeestayaasha	awọn oluṣafihan	Nan
guuraan	gbe	None
guure	gbe	None
guureen	gbe	None
guurey	ṣí	Nan
guuriyaha	iyawo	None
guurka	igbeyawo	None
guuro	gbe	None
guursadaan	fẹ	Nan
guuray	ṣí	Nan
gumeestay	goth	Nan
gumeesiga	ileto	Nan
gumeesanin	yípo	Nan
gowracay	pa	Nan
gowracayn	pipa	Nan
gowraco	pipa	Nan
goysay	ge	Nan
gpp	gpp	Nan
gprs	gprs	Nan
grand	agba	None
graziani	graziani	Nan
groningen	groningen	Nan
groups	awọn ẹgbẹ	Nan
gsare	fo	Nan
gsm	gsm	Nan
gsmka	gsumm	Nan
gu	gu	Nan
gubay	jó	Nan
gowrac	pipa	Nan
government	ijọba	Nan
gorgor	idì	Nan
gorfayna	gorfayna	Nan
goobtain	ibi yii	Nan
goobtan	ni ibi yii	Nan
goobtani	ni ibi yii	Nan
goobtii	ipo	None
goobweyn	ipo	None
googoayey	ke kuro	Nan
gooni	lọtọ	Nan
gud	kọla	Nan
goor	aago	Nan
goorta	nigbawo	Nan
goortii	nigbawo	Nan
goortuu	nigbati o	Nan
goosha	ibi-afẹde	Nan
goostay	kórè	Nan
gooyo	ge	Nan
goray	goray	Nan
goorba	nigbagbogbo	Nan
haan	haan	Nan
guda	ikan	None
gudaha	inu	Nan
gugii	omi	None
guilliani	guilliani	Nan
guinea	guinea	None
guluf	guluf	Nan
gumaaday	gbin	None
gumaysan	yípo	Nan
gumaysiga	amunisin	Nan
gumaysigii	amunisin	Nan
gumaysta	amunisin	Nan
gumaystaha	amunisin	Nan
gumaystay	yípo	Nan
gumaystayaasha	amunisin	Nan
gumaystayaashii	amunisin	Nan
gumaystayaashu	amunisin	Nan
gumaystihii	amunisin	Nan
guga	omi	None
guduud	pupa	None
gudoonsiiyaya	donating	Nan
gudoomiyihii	gomina	None
gudaheeda	laarin	None
gudanno	kọla	Nan
gudbay	koja	Nan
gudbey	koja	Nan
gudbin	tọka	Nan
gudbo	rekoja	Nan
guddidii	ọkọ	Nan
gudabaarsan	yika	Nan
guddiga	igbimo	Nan
guddoomiyihii	gomina	None
guddoonsaday	gba	None
gudiga	igbimo	Nan
gudihiisa	inu	Nan
gudo	kọlà	Nan
gudoomiyaha	alaga	Nan
gudoomiye	alaga	Nan
guddoomiyaha	gomina	None
hubka	awọn ohun ija	Nan
haare	haare	Nan
haashim	haashimu	Nan
halgankii	ijakadi	None
halhays	arosọ	Nan
halis	lewu	Nan
halka	nigba ti	Nan
halkaa	ní	None
halkaan	nibi	Nan
halkaana	ní	None
halkaas	ní	None
halkaasi	ní	None
halkaasna	lati ibẹ	Nan
halkaasoo	nibo	Nan
halkan	nibi	Nan
halkanna	nibi ati nibẹ	Nan
halkay	nibo	Nan
halkii	dipo	Nan
halgankaas	ijakadi	None
halkiisii	dipo	Nan
halganka	ijakadi	None
halgame	kan	None
haji	ajo	None
haka	nitorinaa	Nan
hakad	sinmi	Nan
hal	ọkan	Nan
halaad	parun	Nan
halaag	parun	Nan
halac	halal	Nan
haldoor	haldoor	Nan
haldoorka	haldard	Nan
half	idaji	None
halfrate	idaji	None
halgamaa	ijakadi	None
halgamaayaashii	ajafitafita	Nan
halgamay	ti tiraka	Nan
halgamayaashaasi	awon tiraka	Nan
halgan	ijakadi	None
halmar	lẹẹkan	Nan
halqabsadeen	wọn	None
halyeey	arosọ	Nan
hantida	ohun-ini	Nan
hantiwadaaga	ọrọ ajumọṣe	Nan
hanto	ijanu	Nan
hanuun	itọsọna	Nan
hanuuniye	àṣìṣe	Nan
hanuunka	itọsọna	Nan
har	titi	Nan
harag	awọ	Nan
harar	ọra	Nan
haray	ku	None
haraye	o digba	Nan
hareen	ku	None
hareeraha	yika	Nan
hareereheeda	rẹ	None
hareereysan	agbegbe	Nan
hanti	ọrọ	Nan
hanoolaato	lati fẹ	Nan
hannaan	ilana	None
handsets	imudani	Nan
halyey	arosọ	Nan
hamashka	akùn	Nan
hamdan	hamani	Nan
hamiyayey	tàn	Nan
hamzada	o ṣeeṣe	Nan
hamzo	hawin	Nan
hana	ṣe idiwọ	Nan
haile	ewu	Nan
hanaaqaadeen	idaamu	Nan
hanaqaad	ma dagba	Nan
hanaqaaday	náà	None
hanaqaadeen	ti pọ	Nan
hanaqaadkii	awọn igbega	Nan
hanato	ọra	Nan
hanbalyo	oriire	None
handset	foonu	Nan
hanan	fa seyin	Nan
hagistiisu	rẹ	None
hagayay	itọsọna	Nan
hagari	hag	Nan
hablood	awon odomobirin	Nan
haboon	yẹ	Nan
habsamiya	dan	Nan
had	ní	None
hada	to	None
hadaad	ti o ba	Nan
hadaaftimo	ifọkansi	Nan
hadaan	ti kii ba ri bee	Nan
hadaba	nitorinaa	Nan
hadad	iwo	Nan
hadal	sọrọ	Nan
hadaladii	awọn alaye	Nan
hadalka	ọrọ	Nan
hadalkana	ọrọ naa	Nan
hadalkii	náà	None
hablaha	awon odomobirin	Nan
habkii	ọna	Nan
habka	ọna	Nan
habeenkii	ni oru	Nan
haatan	bayi	None
haatuf	haatuf	Nan
haayo	tọju	Nan
hab	ọna	Nan
haba	haba	Nan
habaabay	ṣiṣan	Nan
hababka	awọn ọna	Nan
hadalkiisa	rẹ	None
habar	arabinrin	Nan
habarjeclo	kaabọ	Nan
habartii	bayi	None
habaysan	ṣeto	Nan
habboon	bojumu	Nan
habdhiska	eto aifọkanbalẹ	Nan
habeen	alẹ	Nan
habeenkeeda	rẹ	None
habargidir	kaabọ	Nan
haaruun	haroon	Nan
hadana	sibẹsibẹ	Nan
hadasho	sọrọ	Nan
hadla	sọrọ	Nan
hadlaa	soro	Nan
hadlaan	sọrọ	Nan
hadlay	sọrọ	Nan
hadlaya	nsoro	Nan
hadlayaayey	nsoro	Nan
hadlayana	nsoro	Nan
hadlayo	nsoro	Nan
hadli	sọrọ	Nan
hadlid	sọrọ	Nan
hadlin	sọ	None
hadlo	sọrọ	Nan
hadraawi	aditi	Nan
haduu	ní	None
hagar	haggard	Nan
hadiye	gbe	None
hadii	ti o ba ti	Nan
hadhwanaag	alẹ́	Nan
hadhay	osi	Nan
haday	ti o ba ti	Nan
hadayn	rárá	Nan
hadba	eyikeyi ti o ba wa akọkọ	Nan
hadda	bayi	None
haddaa	ti o ba ti bẹ	Nan
haddaad	ti o ba	Nan
haddaan	ti kii ba ri bee	Nan
hadane	lonakona	Nan
haddaba	bayi	None
hadday	ti o ba ti	Nan
haddii	ti o ba ti	Nan
haddiise	ti o ba ti bẹ	Nan
hadduu	ti o ba ti	Nan
hadduusan	ti kii ba ri bee	Nan
hadeer	bayi	None
hadey	ti o ba ti	Nan
haddana	lẹẹkansi	Nan
goobta	ipo	None
hubkuu	rẹ	None
hubsaday	fidani	Nan
iyaguna	ariwo	Nan
iyana	paapaa	None
iyo	ati	Nan
iyoama	bẹẹni	Nan
iyoturkigawaxaanuu	ati awọn itan ti	Nan
j	j	Nan
jaad	jaad	Nan
jaadjaad	sipeli	Nan
jaadka	asin	Nan
jaahiligii	alaigbede	Nan
jaajuus	ṣe amí	Nan
jaale	odo	Nan
jaaliyadaha	awọn ẹgbẹ	Nan
jaalle	odo	Nan
jaamac	yunifasiti	Nan
iyagu	wọn	None
jaamaca	yunifasiti	Nan
iyagoon	canon	Nan
iyagana	awọn idiwọn	Nan
itoopiya	eré ìdárayá	Nan
itopiyanka	itu	None
its	rẹ	None
iuyo	ariwo	Nan
iwm	abbl.	Nan
iyaba	iya	Nan
iyada	rẹ	None
iyadana	ìyá mi	Nan
iyadii	rẹ	None
iyadoo	pẹlu	Nan
iyadoon	rẹ	None
iyadu	iya	Nan
iyaduna	idile mi	Nan
iyaga	wọn	None
iyagaa	wọn	None
iyagoo	wọn	None
jaamacad	yunifasiti	Nan
jaamacada	yunifasiti	Nan
jaamacadaha	egbelegbe	Nan
jabouti	japanese	Nan
jabriil	kẹrin	None
jabtay	fifọ	Nan
jabuuti	ilu djibouti	Nan
jabuuticiisaha	itankalẹ	Nan
jabuutiwaxaa	ni djibouti	Nan
jabuutti	jabuutti	Nan
jacayl	ni ife	Nan
jacaylka	ni ife	Nan
jaceyl	ni ife	Nan
jacfar	ni ife	Nan
jaciir	epo igi	Nan
jacques	jacques	Nan
jagada	ipo	None
jago	itọsọna	Nan
jabkaas	awon egugun na	Nan
jabiyey	bu	None
jabhado	dida egungun	Nan
jabhadii	dida egungun	Nan
jaamacadda	yunifasiti	Nan
jaamacadii	yunifasiti	Nan
jaamacado	egbelegbe	Nan
jaamacadu	yunifasiti	Nan
jaamcada	yunifasiti	Nan
jaamow	bẹẹni	Nan
jaantuska	aworan	Nan
itoobiyana	etiopia	Nan
jab	dida egungun	Nan
jabaanlaakiin	fifọ	Nan
jaban	fifọ	Nan
jabay	fifọ	Nan
jabhad	jija	Nan
jabhada	dida egungun	Nan
jabhadda	ija	Nan
jabhaddii	ni ihamọra	Nan
jabaan	fifọ	Nan
jahannamo	apaadi	Nan
itoobiyaereteriya	ara etiopia	Nan
itoobiyaan	ara etiopia	Nan
ismaandhaafkooda	wọn	None
ismaciil	iṣimaeli	Nan
ismacil	ipo	None
ismail	imeeli	Nan
isna	sọ	None
isniin	ọjọ mọndee	Nan
iso	lati wa	Nan
israaca	jọ	Nan
israaiil	israaiil	Nan
israailaye	ayeraye	Nan
israel	israeli	Nan
israil	israil	Nan
isreebreeb	iyege	Nan
isse	ise agbese	Nan
issisalaamya	itan naa	Nan
ismaan	tẹ bọtini	Nan
isssssssslam	isssssssslam	Nan
ismaamulo	iho	Nan
ismaamulgoboleedka	timole	Nan
islam	islamu	Nan
islamarkaana	kan	None
islamarkaasna	kan	None
islamdu	islam	Nan
islamic	islamu	Nan
islamka	islam	Nan
island	erekusu	Nan
isleeg	dọgba	Nan
isleegta	awọn idogba	Nan
islii	arinrin	Nan
islofaakiya	alailoye	Nan
islofeeniya	schizophrenia	Nan
isloveeniya	isloveenia	Nan
isma	kiise	Nan
ismaaciil	iṣimaeli	Nan
ismaamulka	iho	Nan
istaagay	duro	Nan
istaagey	duro	Nan
istaagi	dide	Nan
istiraajiyada	ogbon	Nan
isu	awọn funrararẹ	Nan
isufahmeen	wọn	None
isugu	kanna	Nan
isuma	nko mo	Nan
iswiidhan	sweden	Nan
iswiisarland	switzerland	Nan
iswiizerlaan	swingers	Nan
iswisarland	switzerland	Nan
isxaaq	ti isaaki	Nan
it	rẹ	None
itaaliya	ilu italia	Nan
italiana	italiana	Nan
item	nkan	None
itoobiya	etiopia	Nan
istiraaji	ṣọra	Nan
isticmalka	lo	Nan
isticmalaa	nlo	Nan
isticmaasho	lo	Nan
istaago	duro	Nan
istabta	tatuu	Nan
istanbuul	aigbagbọ	Nan
istandharka	biinu	Nan
istarliin	gbooro	Nan
isticmaal	lo	Nan
isticmaalaa	nlo	Nan
itoobiyaanka	ethiopian	Nan
isticmaalaan	lo	Nan
isticmaalay	ti lo	Nan
isticmaalayaasha	awọn olumulo	Nan
isticmaalayo	lilo	Nan
isticmaali	lo	Nan
isticmaalka	lo	Nan
isticmaalo	lo	Nan
isticmaarka	lo	Nan
isticmaalaha	olumulo	Nan
jakarta	àpò	Nan
jama	eniyan	Nan
jamaal	awon eniyan	Nan
jiita	iṣẹju marun	Nan
jiitaan	fa	Nan
jijeele	ẹlẹtan	Nan
jilaa	oṣere	Nan
jilaamasrax	jilaamasrax	Nan
jili	bili	Nan
jilib	orokun	Nan
jilibkiisa	orokun re	Nan
jilicsan	rirọ	Nan
jimcaale	ni ife	Nan
jimcale	lori gbogbo re	Nan
jimce	ọjọru	Nan
jimcihii	ni ọjọ jimọ	Nan
jimco	ọjọru	Nan
jinka	rẹ	None
jiir	eku	Nan
jiq	ẹyẹ	Nan
jiinow	wà lójúfò	Nan
jiilashii	iru-ọmọ	Nan
jidkaas	iyẹn ọna	Nan
jidkan	ni ọna yi	Nan
jidkii	ọna	Nan
jidle	ọrọ	Nan
jifadiisa	rẹ	None
jigjiga	jigsaw	Nan
jihaad	jija	Nan
jihaaday	dari	Nan
jihaadka	jija	Nan
jiho	ipinle	Nan
jiidaas	ni agbegbe yii	Nan
jiidasho	ifamọra	Nan
jiido	fa	Nan
jiilaal	otutu	None
jiilasha	iran	Nan
jiilkii	iran	Nan
jir	atijọ	Nan
jira	duro	Nan
jiraa	o wa	Nan
jirney	a wà	Nan
jiro	wa	Nan
jirsaday	wa ni	Nan
jirta	wa	Nan
jirtaa	o wa	Nan
jirtay	wa	Nan
jirteen	wa	Nan
jirtey	wa	Nan
jirto	wa	Nan
jirtowax	o wa	Nan
johannesburg	johannesburg	Nan
johnston	johnston	Nan
joog	dúró	None
jooga	ninu	Nan
joogaa	nibi	Nan
jirkii	ara	Nan
jirka	ara	Nan
jiritaankeeda	aye re	Nan
jiritaanka	iwalaaye	Nan
jiraan	ní	None
jiraba	ni pato	Nan
jirae	ní	None
jirataaa	nibẹ ti o wa	Nan
jiray	wa	Nan
jiraye	wa	Nan
jiraysoomaaliya	somalia	Nan
jidka	ọna	Nan
jireen	ti	Nan
jireenan	ti	Nan
jireenka	iwalaaye	Nan
jireenwaxee	ti	Nan
jirey	wa	Nan
jiri	lo	Nan
jirin	rárá	Nan
jirinhaddaba	rara	Nan
jireena	ti wa	Nan
jideeyey	tọju	Nan
jideeyay	tọju	Nan
jid	kan	None
jareen	ke kuro	Nan
jareer	agba	None
jariiban	agbọnrin	Nan
jarmaankakuwaas	odo	Nan
jarmal	jẹmánì	Nan
jarmalka	jẹmánì	Nan
jaro	ge	Nan
jasiira	erekusu	Nan
jasiirad	kan	None
jasiirada	erekusu	Nan
jasiiradaha	erekusu	Nan
jasiirado	erekusu	Nan
jasiiradood	erekusu	Nan
jawaabay	dahùn	Nan
jawaabeen	dahùn	Nan
jaray	ke kuro	Nan
jaraaidka	iwe iroyin	Nan
janno	paradise	Nan
jannada	ọrun	Nan
jamaame	ogunlọgọ	Nan
jamac	ọpọ	Nan
jamacada	ọpọ	Nan
jamal	jamal	Nan
jameecada	agun	Nan
jameeco	ijọ	Nan
jamhuriyada	olominira	Nan
jawaabey	si dahun pe	Nan
jamhuriyadda	olominira	Nan
jamhuuriyad	olominira	Nan
jamhuuriyada	olominira	Nan
jamhuuriyadda	olominira	Nan
janaayo	oṣu kini	Nan
janaraal	gbogboogbo	Nan
jannaale	ọrun	Nan
jannaayo	oṣu kini	Nan
jamhuuriya	olominira	Nan
islaax	agbo	Nan
jawaabo	awọn idahun	Nan
jawi	ayika	Nan
jeelle	jelly	Nan
jeer	awọn akoko	Nan
jeerin	konge	Nan
jeex	yiya	Nan
jeexwaxaana	yiya ati yiya	Nan
jen	gba	None
jenaraal	gbogboogbo	Nan
jenaraalkii	gbogboogbo	Nan
jeneraal	gbogboogbo	Nan
jeneral	gbogboogbo	Nan
jesus	jesu	None
jibaaran	square	Nan
jibiyay	bu	None
jibriil	gébúrẹ́lì	Nan
jicib	sí	Nan
jeedo	yiyi	Nan
jeediyo	awọn aba	Nan
jeediyeen	daba	Nan
jeediyay	daba	Nan
jawiga	bugbamu	Nan
jaziirada	erekusu	Nan
je	lọ	Nan
jebiyey	bu	None
jecel	ni ife	Nan
jecelyahay	fẹràn	Nan
jecelyihiin	ni ife	Nan
jawhar	akoko naa	Nan
jeclaa	fẹràn	Nan
jeclayn	ikorira	Nan
jeclaystay	fẹràn	Nan
jeeda	yipada	None
jeedaa	ntokasi	Nan
jeedaan	yi pada	Nan
jeeday	yipada	None
jeediyana	yiyi	Nan
jeclaan	ni ife	Nan
islaanimo	aigbagbọ	Nan
islaan	itu	None
islaamu	ikan	None
ilbaxnimadii	ọlaju	Nan
ilka	ehin	Nan
ilkaha	eyin	None
illaa	sí	Nan
ilma	ọmọ	None
ilmada	omije	Nan
ilmadu	omije	Nan
ilmo	ọmọ	None
ilmohooda	wọn	None
ilo	lo	Nan
ilyaas	omije	Nan
imaaday	dé	None
imaadeen	dé	None
imaam	imam	Nan
imaamka	imam	Nan
ilbaxnimada	ọlaju	Nan
imaamkii	imam	Nan
ilaha	orisun	None
ilaawaan	gbagbe	Nan
ilaaha	ọlọrun naa	Nan
ilaahay	ọlọrun	Nan
ilaahayna	ọlọrun	Nan
ilaaheey	olorun mi	Nan
ilaahey	olorun mi	Nan
ilaahyo	oriṣa	Nan
ilaalada	awọn oluṣọ	Nan
ilaali	ṣọra	Nan
ilaalin	dáàbò	Nan
ilaalinta	aabo	Nan
ilaaliya	ṣọ	Nan
ilaaliyaha	ṣọ	Nan
ilaaliyo	ni idaabobo	Nan
ilaalo	ṣọ	Nan
ilaashado	wo mi	Nan
ilah	bẹẹni	Nan
imaamu	ibaamu	Nan
imaan	lati wa	Nan
imaaraatka	imo	Nan
inaad	sí	Nan
inaadan	ko	None
inaan	sí	Nan
inaanu	ko	None
inaga	àwa	Nan
inana	ìyá	Nan
inay	sí	Nan
inaynu	ki	None
inaysan	ko	None
inbadan	diẹ sii	Nan
included	to	None
including	pẹlu	Nan
indha	oju	Nan
indhabuur	afọju	Nan
indhaha	oju	Nan
ina	ina	Nan
in	ninu	Nan
important	pataki	Nan
immam	imam	Nan
imaarad	magbowo	Nan
imaatay	dé	None
imagekaahinjpg|daahir	imagekaahinjpg | mimọ	Nan
imagekontulan	imagekontulan	Nan
imagem	oju inu mi	Nan
imagemadaxwaynahaygajpg|siilaanyo	aworan ti mygojpg |	Nan
imagemogadishusjpg|	imagemogadishusjpg |	Nan
ilaah	ọlọrun	Nan
imagetuurjpg|cabdiraxman	imagetuurjpg | cabdiraxman	Nan
iman	wá	Nan
imanaysa	o bọ	Nan
imbaradooriyado	awọn ibaraẹnisọrọ	Nan
imei	imeii	Nan
imid	wá	Nan
imika	bayi	None
iminka	bayi	None
imagexamarcadejpg|	imagexamarcadejpg |	Nan
ilaa	sí	Nan
ila	laini	Nan
il	oju	Nan
ianaynu	ki	None
iaygoo	si mi	Nan
ibin	jọsin	Nan
ibn	abinibi	Nan
ibnu	fi	None
ibraahiim	ere idaraya	Nan
ibraahim	ko	None
ibraahin	sọ	None
ibrahim	ibrahim	Nan
ictiraaf	idanimọ	Nan
ictiraafsanyahay	gba	None
idaacada	ibudo	Nan
idaacadaha	redio ibudo	Nan
idaha	ibi isere naa	Nan
identity	idanimọ	Nan
ialahayna	ki	None
iadoo	wá sọdọ mi	Nan
i	emi	Nan
huud	ibori	None
hudheello	hotẹẹli	Nan
hudhudkii	ààfin	Nan
hungaria	ebi	None
huraan	kan	None
huray	fẹẹrẹ	Nan
hurda	sùn	Nan
hurdada	sun	None
idhi	sọ	None
hurdadii	sun	None
hureen	wó lulẹ	Nan
hurin	iyara	Nan
hurre	afiwe	Nan
hurumarka	ilọsiwaju	Nan
huruud	odo	Nan
huseen	huseen	Nan
hussein	hussein	Nan
hurdo	sun	None
indheergarad	ologbon	Nan
idiin	fun	None
idin	iwo	Nan
iibsadaan	ra	None
iibsaday	rà	Nan
iibso	ra	None
iidow	àse	Nan
iiga	si mi	Nan
iigu	fun	None
iikeeneen	gbe	None
iima	bẹẹni	Nan
iimaan	igbagbọ	Nan
iimaanka	igbagbọ	Nan
iimaankuna	igbagbọ	Nan
iiraan	iran	Nan
iisoo	si mi	Nan
ikhyaartii	aṣayan	Nan
ikwadoor	atilẹyin	Nan
iibiyo	ta	Nan
iibiyey	ti ta	Nan
iibin	ta	Nan
iibgayn	ta	Nan
idinka	iwo	Nan
idinkaa	iwo	Nan
idinkana	iwo na	Nan
idinkaysu	fun	None
idinla	rẹ	None
idiris	jẹ	Nan
idlaaday	ti pari	Nan
idil	gbogbo e	Nan
iesus	jesu	None
ifka	ifka	Nan
iftin	òdòdó	Nan
iga	lati lọ	Nan
igad	goad	Nan
igu	emi	Nan
ihi	emi	Nan
ii	ii	Nan
if	ti o ba ti	Nan
hubo	daju	Nan
indho	oju	Nan
india	india	Nan
isbania	ile-ile	Nan
isbayn	iho	Nan
isbeheysi	akọtọ	Nan
isbheysigii	ara-iwosan	Nan
isbitaal	ile-iwosan	Nan
isbitaalada	iwosan	None
isbitaalka	iwosan	None
isboorti	eré ìdárayá	Nan
isdaba	ọkọọkan	Nan
isdullayn	gbárale	Nan
isga	saha	Nan
isgaadhsiinta	ibaraẹnisọrọ	Nan
isgaadhsiintu	ibaraẹnisọrọ	Nan
isgaarsiinta	ibaraẹnisọrọ	Nan
isha	oju	Nan
isbadalka	yipada	None
ishkin	hashkin	Nan
isbadalin	yipada	None
isbadalada	awọn ayipada	Nan
irmaan	pátá	Nan
irridka	ilekun	Nan
irridkaa	ni ọna yi	Nan
irsaaqa	ra	None
is	jẹ	Nan
isa	to	None
isaaq	tẹ bọtini	Nan
isaaqu	fun	None
isaga	rẹ	None
isagoo	nini	Nan
isagu	oun	None
isanimo	isansa	Nan
isaxaaq	sùn	Nan
isbadal	yipada	None
isbadala	yipada	None
isbadaladii	awọn ayipada	Nan
isi	ori	None
isjiiraya	gbọn	Nan
iska	ategun	Nan
islaamay	gba	None
islaamcarabi	tẹ bọtini	Nan
islaameen	ṣe	Nan
islaami	islam	Nan
islaamiga	islam	Nan
islaamiya	tẹ bọtini	Nan
islaamiyiinta	islamists	Nan
islaamka	islam	Nan
islaamkaayuu	onigbagbọ ni musulumi	Nan
islaamku	islam	Nan
islaamkuna	islam	Nan
islaamnimada	ẹsin islamu	Nan
islaamnimadiisa	rẹ	None
islaamnimo	islam	Nan
islaamoow	pẹlẹ o	Nan
islaama	kanna	Nan
islaam	islam	Nan
isla	ikan	None
iskuxigxiga	ọkọọkan	Nan
iskaashi	ifọwọsowọpọ	Nan
iskaashiga	ifowosowopo	Nan
iskaga	kuro patapata	Nan
iskama	kò ṣe bẹ	Nan
iskoolada	awọn ile-iwe	Nan
isku	kanna	Nan
iskudar	ṣafikun	Nan
iritareeya	sa lo	Nan
iskudayay	gbiyanju	Nan
iskula	ikan	None
iskuqabashada	rogbodiyan	None
iskusoo	ju silẹ	Nan
iskuulada	awọn ile-iwe	Nan
iskuulka	ni ileiwe	Nan
iskuulo	awọn ile-iwe	Nan
iskuxidhka	nẹtiwọki	Nan
iskugu	fi	None
irir	irun	Nan
iri	igara	Nan
iraq	iraq	Nan
ingriisugu	gẹẹsi	Nan
initiated	ipilẹṣẹ	Nan
injiil	ihinrere	None
injineer	ẹnjinia	Nan
inka	inki	Nan
inkasta	botilẹjẹpe	Nan
inkastoo	botilẹjẹpe	Nan
inkastoon	ibawi	Nan
inna	ìyá	Nan
innagaa	àwa	Nan
innoo	fun	None
innooga	tcnu	Nan
innoogu	fun	None
inoo	fun	None
inoogu	fun	None
ingriisla	gẹẹsi	Nan
ingriisku	ede	None
ingriiska	gẹẹsi	Nan
ingriis	gẹẹsi	Nan
indonesia	ara ilu indonia	Nan
indonesian	ara ilu indonesian	Nan
indoniishiya	indonesian	Nan
indoor	inu ile	Nan
indoors	ninu ile	Nan
indunisiya	indonesian	Nan
ineey	sí	Nan
inqilaab	lilọ	Nan
iney	sí	Nan
information	alaye	Nan
ing	lori	Nan
ingiriis	gẹẹsi	Nan
ingiriisiga	ede	None
ingiriiska	ede	None
ingiriisku	ede	None
ingirisku	ede	None
ineysan	ko	None
indhuhu	oju	Nan
inqilaabeen	ti won ti di	Nan
inqilaabkaasna	ati pepejọ yẹn	Nan
internetka	lori intanẹẹti	Nan
intey	intey	Nan
intii	nigba ti	Nan
intiisa	isimi na	Nan
into	sinu	Nan
intooda	wọn	None
intuba	gbogbo ibi	Nan
intuu	oun	None
inu	inu	Nan
inuu	sí	Nan
inuusan	ko	None
inxiraaf	profuse	Nan
iqtiyaar	iyan	None
iraan	iran	Nan
iran	iran	Nan
internet	intanẹẹti	Nan
international	kariaye	Nan
interference	kikọlu	Nan
interface	wiwo	Nan
inqilaabkii	awọn coup	Nan
insaanka	ọmọ	None
insaykalobeedhiya	encyclopedia	Nan
insha	insha	Nan
insuliinka	hisulini	Nan
inta	nigba ti	Nan
intaa	ni afikun	Nan
inqilaabka	ninu coup	Nan
intaad	iwo	Nan
intaas	iyẹn	Nan
intaasi	iyẹn	Nan
intaasoo	accordingly	Nan
intaba	mejeeji	Nan
intay	wọn	None
inteeda	wọn	None
inteedii	isimi na	Nan
intaan	eyi	Nan
goobo	circle	Nan
goobihii	ipo	None
goobeede	osunwon	Nan
doorkii	ipa	Nan
dooro	yan	None
doorroone	pelu	Nan
doorsamaye	ko	None
doorsan	yan	None
doorshaane	yan	None
doortaa	yan	None
doortay	yàn	Nan
doorteen	yàn	Nan
doorto	yan	None
dooxa	afonifoji	Nan
dooxada	afonifoji	Nan
dooxadii	ninu afonifoji	Nan
doqon	omugo	Nan
doqonniimo	aṣiwere	Nan
doorka	ipa	Nan
dorraato	titaja	Nan
dooriyee	ṣẹgun	Nan
doorashooyinkii	awọn idibo	Nan
doono	yoo	None
doonta	omi	None
doontaa	wá	Nan
doonto	yoo	None
doonyaha	kekere	None
door	ipa	Nan
dooranayay	yiyan	Nan
dooranayeen	yiyan	Nan
doorashada	yiyan	Nan
doorashadaas	yiyan yẹn	Nan
doorashadan	aṣayan yi	Nan
doorashadii	idibo	Nan
doorasho	idibo	Nan
doorashooyin	awọn idibo	Nan
doorashooyinka	awọn idibo	Nan
doorin	yan	None
dowlad	ijọba	Nan
dowlada	ijọba	Nan
dowladaha	awọn ijọba	Nan
duduwan	ololufe	Nan
dufowdoo	rẹ	None
dug	gbe	None
dugsi	ile-iwe	Nan
dugsiga	ni ileiwe	Nan
dugsigii	ile-iwe	Nan
dugsiyada	awọn ile-iwe	Nan
dugsiyo	awọn ile-iwe	Nan
dugulka	ile-iwe	Nan
duhur	ọsan	Nan
duhurkii	ni ọsan	Nan
dukaan	ṣọọbu	Nan
dul	lori	Nan
dulka	awọn dada	Nan
dulli	itiju	Nan
duco	ibukun	Nan
duceeyo	gbadura	Nan
ducaynaa	a gbadura	Nan
ducada	àdúrà	Nan
dowladahaas	awọn ijọba wọnyẹn	Nan
dowladda	ijọba	Nan
dowladdii	ijọba	Nan
dowladeed	ijọba	Nan
dowladihii	awọn ijọba	Nan
dowladii	ijọba	Nan
dowlado	awọn ijọba	Nan
doonno	yoo	None
dowladood	awọn ijọba	Nan
dowr	dowr	Nan
dr	dr	Nan
drs	drs	Nan
du	du	None
dubad	onigun mẹrin	Nan
dubai	ile iwowe	Nan
ducaadda	ibukun	Nan
download	ṣe igbasilẹ	Nan
dulliga	idojuti	Nan
doonnaaye	yoo	None
doonistii	ifẹ	Nan
diyaaradaha	ọkọ ofurufu	Nan
diyaaradeed	okoofurufu	Nan
diyaaradii	ọkọ ofurufu	Nan
diyaaradood	ọkọ ofurufu	Nan
diyaaraduhu	ọkọ ofurufu	Nan
diyaarintii	igbaradi	Nan
diyaariyay	gbaradi	Nan
diyaariyey	gbaradi	Nan
diyaarka	ṣetan	Nan
diyaradaha	ọkọ ofurufu	Nan
djacday	derubami	Nan
djibouti	tuntun	None
do	ṣe	Nan
doc	doc	Nan
doh	ṣe	Nan
diyaarada	ọkọ ofurufu	Nan
dola	dola	Nan
diyaar	ṣetan	Nan
dit	ọnà	Nan
diri	lati farada	Nan
dirir	aáwọ̀	Nan
dirirayaashii	awọn jagunjagun	Nan
dirirka	ìja	Nan
diriro	aáwọ̀	Nan
dirirtii	ja	Nan
diriyo	aáwọ̀	Nan
dirkii	firanṣẹ	Nan
dirsaday	firanṣẹ	Nan
disc	disiki	Nan
diseembar	oṣu kejila	Nan
distoori	iparun	Nan
distoorkii	t’olofin	Nan
distributed	pin	Nan
distuurka	orileede	None
dix	dix	Nan
dominika	dominican	Nan
doob	dob	Nan
doobcadale	omiiran	Nan
doona	wá	Nan
doonaa	yoo	None
doonaan	yoo	None
doonaayey	fẹ	Nan
doonan	wá	Nan
doonay	fẹ	Nan
doonaya	fẹ	Nan
doonayaa	fẹ	Nan
doonayeen	fẹ	Nan
doonayo	fẹ	Nan
dooneen	wá	Nan
dooneyid	o fẹ	Nan
dooneysaa	o fẹ	Nan
doonin	wá	Nan
dooninna	ẹ wá	Nan
doon	omi	None
doolow	isunki	Nan
doolo	ble	Nan
doollo	iwukara	Nan
doobi	ṣe	Nan
dooc	doc	Nan
dood	ijiroro	Nan
dooda	ijiroro	Nan
doodaan	ariyanjiyan yii	Nan
dooday	ariyanjiyan	Nan
doodayaan	jiyàn	Nan
doonka	kekere	None
doodday	ariyanjiyan	Nan
doodi	ijiroro	Nan
doodo	ijiroro	Nan
doofaar	ẹlẹdẹ	Nan
doog	eweko	Nan
dooga	koriko	Nan
doogsin	lati ṣe irẹwẹsi	Nan
doojey	lọ	Nan
doodeen	jiyan	Nan
dulmiga	inilara	Nan
dulmiya	inilara	Nan
dulqaad	ṣe suuru	Nan
eegayeen	nwa	None
eegayo	n wo	Nan
eegno	wo	Nan
eego	wo	Nan
eegto	wo	Nan
een	bẹẹni	Nan
eersadaye	pẹlu ogo lati ọdọ ọlọrun	Nan
eesan	nigbamii	Nan
eey	aja	Nan
eeysan	aja	Nan
eg	apẹẹrẹ	Nan
egyihiin	o jọ	Nan
eheed	ti o jẹ	Nan
eheen	ti o jẹ	Nan
eheyd	ti o jẹ	Nan
eegay	wò	Nan
eight	mẹjọ	Nan
eegaayey	nwa	None
eeerland	ilẹ	None
education	eko	None
ee	bẹẹni	Nan
eebbaa	sọ	None
eebbaana	bẹẹni	Nan
eebbaha	ori	None
eebbahay	baba mi	Nan
eebbana	rárá	Nan
eebbe	ọlọrun	Nan
eebbow	wa	Nan
eebe	ọlọrun	Nan
eed	jẹbi	Nan
eedaysay	onimo	Nan
eedeeyay	onimo	Nan
eedeeyey	onimo	Nan
eedeyay	onimo	Nan
eeg	wo	Nan
ekaa	nipa	Nan
el	el	Nan
elarab	elarab	Nan
erayada	awọn ọrọ	Nan
eraydan	ọrọ yii	Nan
erayga	náà	None
eraygan	ọrọ yii	Nan
erega	ere	Nan
eretereya	eré	Nan
ereteriya	elere idaraya	Nan
eretrie	eretrie	Nan
erey	kan	None
ereyada	awọn ọrọ	Nan
ereyga	ọrọ	Nan
ereygaasi	ọrọ yẹn	Nan
ergo	ergo	Nan
eriga	eriga	Nan
erigavo	erigavo	Nan
eray	ọrọ	Nan
eratiya	ọrọ	Nan
erataria	erataria	Nan
eratareya	ọrọ yii	Nan
elektrooniga	ẹrọ itanna	Nan
elements	awọn eroja	Nan
elmi	elmi	Nan
email	imeeli	Nan
emailkiisa	rẹ	None
embedded	ifibọ	Nan
en	yo	Nan
economy	aje	None
eng	gẹẹsi	Nan
engineering	ẹnjinia	Nan
engineerku	ẹnjinia	Nan
engiriiska	ede	None
england	gẹẹsi	Nan
english	gẹẹsi	Nan
equipment	èlò	None
eraga	ọrọ	Nan
engineer	ẹnjinia	Nan
ebekargaab	paapaa	None
ebbow	ebbow	Nan
eau	éú	Nan
dunuub	wrinkle	Nan
duq	atijọ	Nan
duqa	arabinrin	Nan
duqayn	ibọn	Nan
duqeeyay	gbamu	Nan
duqsan	atijọ	Nan
duqsansoomaalida	irungbọn	Nan
duqsanwaxyaabaha	nkan	None
duray	abẹrẹ	Nan
durba	tẹlẹ	Nan
durbaan	ilu	Nan
durbadiiba	tẹlẹ	Nan
durdur	kan	None
durdurkii	ṣiṣan	Nan
during	lakoko	Nan
dunidda	ileaye	Nan
dunidana	ileaye	Nan
dunidalaakiin	agbaye	None
dunida	ileaye	Nan
dulqaadaan	ṣe suuru	Nan
dultaagi	duro na	Nan
dulucda	akori	Nan
dulugle	apanilerin	Nan
dumaal	arabinrin	Nan
dumar	obinrin	Nan
dumarka	obinrin	Nan
durkoo	ohunkohun ti	Nan
dumarkii	obinrin	Nan
dumey	dumey	Nan
dumin	danu	Nan
duminayaa	wó	Nan
dumis	iwolulẹ	Nan
dumiyo	parun	Nan
dun	adun	Nan
duni	agbaye	None
dumay	wó lulẹ	Nan
dirgen	dirgen	Nan
duruufaheeda	rẹ	None
duryaad	ikuuku	Nan
duullaankii	awọn ayabo	Nan
duumaa	tẹ bọtini	Nan
duunyo	ẹranko	Nan
duur	egan	Nan
duurgalay	boju	Nan
duurka	oko	None
duwan	yatọ	Nan
duwanaa	ti yatọ	Nan
duwanyahay	ti yatọ	Nan
dvdx	dvdx	Nan
e	é	Nan
each	kọọkan	Nan
east	ila-oorun	Nan
eastleigh	ila-oorun	Nan
eastliegh	ila-oorun	Nan
duulka	ọkọ ofurufu	Nan
duuliyihii	awaoko na	Nan
duuliye	awaoko	Nan
duulay	fò	Nan
dusha	dada	Nan
dusheeda	lórí i rẹ	Nan
duub	yipo	Nan
duuban	ti o gbasilẹ	Nan
duubay	ti o gbasilẹ	Nan
duubi	gbigbasilẹ	Nan
duud	igbo	Nan
duruufihii	awọn ayidayida	Nan
duudka	ninu egan	Nan
duufaan	iji	Nan
duug	atijọ	Nan
duugey	sin	Nan
duugmay	ti bajẹ	Nan
duugta	ifọwọra	Nan
duul	fò	Nan
duulaan	kogun ja	Nan
duudsiiyey	wó	Nan
direy	firanṣẹ	Nan
dirayoo	firanṣẹ	Nan
dirayay	fifiranṣẹ	Nan
dhinacakale´shilinka	ti a ba tun wo lo	Nan
dhinacba	gbe	None
dhinaceeda	rẹ	None
dhinacyada	awọn ẹgbẹ	Nan
dhinacyo	awọn ẹgbẹ	Nan
dhinicii	awọn ọna ẹgbẹ	Nan
dhintay	kú	Nan
dhinteen	ti kú	Nan
dhintey	kú	Nan
dhinto	kú	Nan
dhir	parsley	Nan
dhiraandhirinta	itupale	Nan
dhiraha	eweko	Nan
dhirindhireed	ewe	None
dhirirka	gíga	Nan
dhinacakale	ti a ba tun wo lo	Nan
dhirirkeeda	gigun re	Nan
dhinaca	ni ẹgbẹ	Nan
dhimatay	kú	Nan
dhiigii	ẹ̀jẹ̀	Nan
dhiilka	awon tions	Nan
dhiillo	aṣẹwo	Nan
dhiiragalin	gba	None
dhiiri	gba	None
dhiirigelin	gba	None
dhiirigelisay	iwuri	Nan
dhiirri	gba	None
dhikanyee	sọ	None
dhiman	kú	Nan
dhimanayey	ku	None
dhimane	kíkú	Nan
dhimashadiisii	iku	None
dhimasho	iku	None
dhimashooyin	iku	None
dhinac	ẹgbẹ	Nan
dhirta	eweko	Nan
dhirtu	eweko	Nan
dhis	kọ	Nan
dhisteen	itumọ	Nan
dhixine	rẹ	None
dhoho	sọ	None
dhooble	rẹrin	Nan
dhoobo	pẹtẹ	Nan
dhoof	ta asia	Nan
dhoofin	okeere	None
dhoofiska	okeere	None
dhoofista	okeere	None
dhoofiyaa	okeere	None
dhoofiyo	okeere	None
dhool	rẹrin	Nan
dhoore	agbọnrin	Nan
dhow	sunmọ	Nan
dhowaaneynaa	a n bọ laipẹ	Nan
dhistay	itumọ	Nan
dhiso	kọ	Nan
dhisnayd	itumọ	Nan
dhisnaa	itumọ	Nan
dhisaan	kọ	Nan
dhisaayeen	ni won nko	Nan
dhisan	ti eleto	Nan
dhisay	itumọ	Nan
dhiseen	wọn	None
dhisida	ile	Nan
dhisin	kọ	Nan
dhiigga	ẹ̀jẹ̀	Nan
dhisitaan	kọ ni ṣisẹ n tẹle	Nan
dhiska	ikole	Nan
dhismaha	ikole	Nan
dhismayaal	awọn ile	Nan
dhismayaasha	awọn ile	Nan
dhisme	kan	None
dhismihii	ile	Nan
dhismo	ikole	Nan
dhisitaankii	ikole	Nan
dhiig	ẹ̀jẹ̀	Nan
dhiibid	tẹriba	Nan
dhiibi	tẹriba	Nan
dhexdeeda	laarin	None
dhexdhexaad	didoju	Nan
dhexdhexaadinta	ilaja	Nan
dhexdiisa	laarin	None
dhexdooda	wọn	None
dhexe	aringbungbun	Nan
dhexeeya	laarin	None
dhexeysa	ni aarin	Nan
dhexmara	lọ nipasẹ	Nan
dhexmaray	idilọwọ	Nan
dhextaala	láàárín	Nan
dhib	wahala	Nan
dhibaatada	iṣoro naa	Nan
dhibaatadii	iṣoro naa	Nan
dhibaato	kan	None
dhexda	ni aarin	Nan
dhexaysa	ni aarin	Nan
dhexadka	ni aarin	Nan
dhexaad	didoju	Nan
dheereeyo	gíga	Nan
dheereshiinehaabiilhabane	oloomi	Nan
dheereyn	itẹsiwaju	Nan
dheereynayaa	pẹ	Nan
dheerka	ni afikun	Nan
dheg	eti	Nan
dhegaha	etí	Nan
dhibaatooyin	awọn iṣoro	Nan
dhegan	di	Nan
dhegtay	eti	Nan
dheh	sọ	None
dheheen	nwọn wipe	Nan
dherer	gigun	Nan
dhererkiisu	gigun	Nan
dhererkoodu	wọn	None
dhex	ni aarin	Nan
dhegen	ọpá	Nan
dhowdahay	sunmọ	Nan
dhibaatooyinka	awọn iṣoro	Nan
dhibay	dojuru	Nan
dhigeen	gbe	None
dhigeendhulka	awọn sugbọn	Nan
dhigey	gbe	None
dhigi	ṣe	Nan
dhigin	fi	None
dhignaa	gba	None
dhigo	ṣeto	Nan
dhigtan	ni akoko yi	Nan
dhigtay	gbe	None
dhigteen	gbe	None
dhigto	gbesile	Nan
dhihi	sọ	None
dhiib	fun	None
dhiibay	jowo	Nan
dhiibayaa	gbigbe si lori	Nan
dhigaysa	fi	None
dhigayo	gbe	None
dhigaye	lori	Nan
dhigaya	fi	None
dhibi	wahala	Nan
dhibina	rẹ	None
dhibka	iṣoro naa	Nan
dhibkii	iṣoro naa	Nan
dhiblaawe	aibikita	Nan
dhibta	iṣoro naa	Nan
dhici	ṣubu	Nan
dhibaatooyinkii	awọn iṣoro	Nan
dhicin	ṣubu	Nan
dhicisoobay	miscarlot	Nan
dhiga	fi	None
dhigaa	ṣeto	Nan
dhigaan	fi	None
dhigan	gbesile	Nan
dhigateene	rẹ	None
dhigay	ṣeto	Nan
dhicine	pari	Nan
ertariya	eretria	Nan
dhowna	sunmọ	Nan
dhowree	dáàbò	Nan
diinle	deinle	Nan
diinsoor	dynsoor	Nan
diinta	ẹsin	Nan
diintaas	esin na	Nan
diintan	ẹsin yii	Nan
diintana	igbagbọ yii	Nan
diinteena	ẹsin wa	Nan
diintiisa	rẹ	None
diintooda	wọn	None
diintoodii	wọn	None
diintu	ẹsin	Nan
diintuna	imi	Nan
diiqsan	irẹwẹsi	Nan
diir	peeli	Nan
diiraabay	igbona	Nan
diinka	ẹsin	Nan
diiran	loworo	Nan
diiniga	ẹsin	Nan
diine	ounjẹ	Nan
diide	kọ	Nan
diideen	kọ	Nan
diidey	kọ	Nan
diidmada	temi	Nan
diido	yipada	None
diidoo	kọ	Nan
diidye	kọ	Nan
diif	diphẹ	Nan
diifta	diphtheria	Nan
diimaha	awọn ẹsin	Nan
diimeedka	awọn ẹlẹsin	Nan
diimo	awọn ẹsin	Nan
diimood	igbagbọ	Nan
diimuqraadiga	tiwantiwa	Nan
diin	ẹsin	Nan
diini	diini	Nan
diiray	pee	Nan
diiriye	dapo	Nan
diirka	peeli	Nan
dimuqaraadiga	tiwantiwa	Nan
dimuqraadiga	tiwantiwa	Nan
dimuqraadiyada	tiwantiwa	Nan
dimuqraadiyadda	tiwantiwa	Nan
dimuquraadi	tiwantiwa	Nan
dimuquraadiya	tiwantiwa	Nan
dimuquraadiyada	tiwantiwa	Nan
dininig	dininig	Nan
dir	firanṣẹ	Nan
diraa	firanṣẹ	Nan
diraac	ipẹtẹ	Nan
diraacoode	wọn	None
diraan	firanṣẹ	Nan
diran	deran	Nan
diray	firanṣẹ	Nan
dimoqaraadiyadda	tiwantiwa	Nan
dimishiq	tiwantiwa	Nan
dilo	pa	Nan
dillapress	dillapress	Nan
diirki	peeli	Nan
diiro	idojukọ	Nan
diirsado	dara ya	Nan
dil	paniyan	Nan
dila	oniṣowo	Nan
dilaa	pa	Nan
dilaan	pa a	Nan
diiddo	kọ	Nan
dilay	pa	Nan
dileen	pa	Nan
diley	pa	Nan
dilkii	paniyan	Nan
dilkiisa	rẹ	None
dilku	paniyan	Nan
dilla	gbin	None
dillaaco	dojuijako	Nan
dilaye	oniṣowo	Nan
diidday	kọ	Nan
diidayaana	sẹ	Nan
diidayaa	kọ	Nan
dhulkan	ilẹ	None
dhulkeeda	rẹ	None
dhulkii	ayé	Nan
dhulkiisaa	rẹ	None
dhulku	ayé	Nan
dhulwaynaha	oluile	Nan
dhunkaal	ifẹnukonu	Nan
dhuraye	isosileomi	Nan
dhuub	tinrin	Nan
dhuumasho	tọju kuro	Nan
dhuunta	ọfun	Nan
dhuurta	igbó	Nan
dhuusamareeb	ọganjọ oru	Nan
dhuux	ọra	Nan
dhuwan	tọju	Nan
dhulkaas	ilẹ	None
dhulkaan	ile aye yi	Nan
dhulkaa	ayé	Nan
dhulka	ayé	Nan
dhowrsada	rẹ	None
dhowrsan	ni idaabobo	Nan
dhowrsana	rẹ	None
dhubato	tutọ	Nan
dhuftay	lù	Nan
dhufteen	lù	Nan
dhul	ile aye	Nan
dhuxul	eedu	Nan
dhulaka	ilẹ	None
dhulalkii	ilẹ	None
dhulbahante	kan	None
dhulbaisaguna	ilẹ	None
dhulbeereedka	awọn ala-ilẹ	Nan
dhuleed	ile aye	Nan
dhulgariir	ìṣẹlẹ	Nan
dhulgariirka	ìṣẹlẹ	Nan
dhulalka	ilẹ	None
dhowr	lọpọlọpọ	Nan
dhuxusha	eedu	Nan
diabetes	atọgbẹ	Nan
difaacaya	gbeja	Nan
different	yatọ	Nan
digfeer	digger	Nan
digil	iwo	Nan
digilmirifle	digilmirifle	Nan
digir	awọn ewa	Nan
digirta	awọn ewa	Nan
digital	oni-nọmba	Nan
digniin	ikilọ	Nan
digo	digest	Nan
dihine	dihine	Nan
dii	c	Nan
diid	kọ	Nan
diidana	kọ o	Nan
diiday	kọ	Nan
difaacay	gbeja	Nan
difaaca	olugbeja	Nan
didsaday	yà	Nan
diday	didasilẹ	Nan
diakonia	deaconess	Nan
dib	sẹhin	Nan
dibad	jade	Nan
dibada	okeokun	Nan
dibadda	ita	Nan
dibadiisa	ita	Nan
dibedda	ita	Nan
di	lati jẹ	Nan
dibeddaba	awọn gbagede	Nan
dibi	akọmalu	Nan
dibna	lẹẹkansi	Nan
dibnahayga	oju mi	Nan
dibu	akọmalu	Nan
dibuga	ọmọ	None
dibugu	akọmalu	Nan
dibuheshiisiinta	ilaja	Nan
dibeddu	ita	Nan
eryada	lepa	Nan
eryaday	lepa	Nan
eryay	kuro	Nan
galiyo	fi	None
galka	ninu	Nan
galkacyo	ládugbó	Nan
galleyda	agbado	None
galmaax	galonu	Nan
galmoodka	nini ibalopọ	Nan
galo	sinu	Nan
galow	wọle	Nan
gambia	gambáà	Nan
ganac	iṣowo	Nan
ganacasade	oniṣowo	Nan
ganacsade	oniṣowo	Nan
ganacsan	taja	Nan
ganacsatada	àwọn oníṣòwò	Nan
ganacsato	oniṣòwo	Nan
galiyey	idapo	Nan
ganacsi	iṣowo	Nan
galiyaan	fi	None
galinsoor	fi	None
galbeedkana	si iwo-oorun	Nan
galbeedkenya	ni oorun	Nan
galbeedku	iwọ oorun	Nan
galbeedna	si iwo-oorun	Nan
galdogob	tanganran	Nan
galeen	sinu	Nan
galeeyda	ere giga mi	Nan
galeyda	agbado	None
galgaduud	dudu	Nan
galguduud	ko	None
gali	tẹ	Nan
galin	fi	None
galinayo	fi	None
galinaysaa	fi	None
galine	agbọnrin	Nan
galisay	fi	None
ganacsiga	iṣowo	Nan
ganacu	iṣowo	Nan
gandi	ṣàkóso	Nan
garbihiisa	rẹ	None
gardhaale	ariyanjiyan	Nan
gardheere	arosọ	Nan
gargaar	egba	None
gargaaray	ṣe iranlọwọ	Nan
gargaarka	iderun	Nan
gariis	fẹẹrẹ	Nan
garjante	garjante	Nan
garoomada	papa	None
garoomaha	iyawo	None
garoon	papa-iṣere	Nan
garoonka	papa-iṣere	Nan
garoonkaan	papa	None
garoowe	garoowe	Nan
garowe	e dupe	Nan
garbahaarey	ejika si ejika	Nan
garbaha	ejika	Nan
garatay	se o mo	Nan
garasho	mọ	Nan
ganey	lati ni oye	Nan
gar	gar	Nan
garaacay	lu	Nan
garaaco	lu	Nan
garaad	ọgbọn	Nan
garaadka	ọgbọn	Nan
garab	ejika	Nan
galbeedka	si iwo-oorun	Nan
garabsocday	de pelu	Nan
garadag	olokiki	Nan
garadba	loye	Nan
garan	mọ	Nan
garanayn	ko	None
garanayo	mọ	Nan
garansiiyo	egba	None
garashada	iwoye	Nan
garad	se o mo	Nan
galbeeditoobiya	iwọ-oorun iwọ-oorun etiopia	Nan
galbeed	iwọ oorun	Nan
galbe	iwọ oorun	Nan
gabayle	ewi	Nan
gabayo	ewi	Nan
gabdhaha	awon odomobirin	Nan
gabdhahooda	wọn	None
gabdhihii	awọn ọmọbinrin	Nan
gabdhood	awọn ọmọbinrin	Nan
gabdhoodna	wọn	None
gabeyre	ewi	Nan
gabi	patapata	Nan
gabiahaanba	gbogbo awọn wọnyi	Nan
gabiley	gorilla	Nan
gabownimadii	ní	None
gabyaa	ewi	Nan
gabyaagii	ewi	Nan
gacal	ololufe	Nan
gabaygu	ewi	Nan
gabaygii	ewi	Nan
gabayga	ewi	Nan
gabayadiisa	rẹ	None
gaarsiinta	ifijiṣẹ	Nan
gaarsiisan	de ọdọ	Nan
gaarsiiyey	mu lọ	Nan
gaarsiyeyna	mu lọ	Nan
gaashaaman	asà	Nan
gaashaan	asà	Nan
gaashaanbuurta	awọn alliance	Nan
gacan	ọwọ	Nan
gaashaandhiga	olugbeja	Nan
gaashaanle	kan	None
gabadh	ọmọbinrin	Nan
gabadha	omobinrin	Nan
gabadhii	omobinrin	Nan
gabanka	alaye	Nan
gabar	ọmọbinrin	Nan
gabay	orin	Nan
gaashaanka	asà	Nan
garre	aṣọ	Nan
gacanka	awọn ọgbun	Nan
gacanta	ọwọ	Nan
galaa	ti nwọ	Nan
galaal	folda	Nan
galaan	tẹ	Nan
galab	ni ọsan	Nan
galabsan	ni osan yii	Nan
galabtaas	ni osan yii	Nan
galadaystay	ti lọ	Nan
galaddiisu	rẹ	None
galay	sinu	Nan
galayda	agbado	None
galaydh	agbado	None
galaye	tẹ	Nan
galayno	àwa	Nan
galayr	ládugbó	Nan
galbaday	ni ọsan	Nan
gala	tẹ	Nan
gal	wọle	Nan
gaheyrkuliyada	ilẹ	None
gaheyr	gaheyr	Nan
gacantiisa	rẹ	None
gacmaha	ọwọ	Nan
gacmeedyo	ọwọ	Nan
gacmood	ọwọ	Nan
gadaal	nigbamii	Nan
gadaashiiye	sile	None
gadabuursi	ṣe afẹyinti	Nan
gacansiiyo	egba	None
gadabuursiga	lori ẹhin	Nan
gaday	rà	Nan
gadaye	awọn ijoko	Nan
gadiid	lati ta	Nan
gadiidka	irinna	Nan
gadisan	ibusun	Nan
gado	ogún	Nan
gaduud	pupa	None
gadabuursigu	ehinkunle	Nan
gaaro	de ọdọ	Nan
garsoor	lẹjọ	Nan
garsoorka	adajọ	Nan
goa	goa	Nan
goaan	ipinnu	Nan
goaankanna	ipinnu yii	Nan
goaansaday	pinnu	Nan
goaansadeen	pinnu	Nan
goan	nkan	None
goay	goay	Nan
gob	gob	Nan
gobalada	awọn ẹkun ni	Nan
gobaleedka	agbegbe	Nan
gobalka	ẹkùn	Nan
gobanimo	ominira	Nan
gobanimodoonka	gobannoodon	Nan
gobol	ẹkùn	Nan
gobola	awọn ẹkun ni	Nan
go	lọ	Nan
gobolada	awọn ẹkun ni	Nan
gmsk	gmsk	Nan
glay	glay	Nan
geography	ilẹ	None
georges	georges	Nan
geri	wuwo	Nan
geyiga	ni ile	Nan
geysatay	ti ṣe	Nan
geystey	ti ṣe	Nan
ghazi	ṣeto	Nan
gidaar	ile	Nan
gidir	ile	Nan
giinbaarta	ifasimu	Nan
giriig	griki	Nan
giriiga	griki	Nan
giriigga	griki	Nan
giriigii	griki	Nan
giscard	giscard	Nan
global	kariaye	Nan
goboladan	ninu awọn ẹkun ni	Nan
goboladii	awọn ẹkun ni	Nan
goboleed	agbegbe	Nan
godka	iho apata	Nan
godod	oriṣa	Nan
goeen	ge	Nan
goii	goii	Nan
goin	goin	Nan
golaha	igbimọ	Nan
goleey	gole	Nan
golihii	igbimọ naa	Nan
golis	golis	Nan
gollaha	igbimọ	Nan
gololeey	yara mi	Nan
goo	ge	Nan
goob	ipo	None
goobaha	ipo	None
goobanimo	circle	Nan
godey	adupe lowo olorun	Nan
godeey	ọlọrun	Nan
goday	o ṣeun	Nan
godan	ṣofo	Nan
goboleedka	agbegbe	Nan
gobolka	ẹkùn	Nan
gobolkaan	ni agbegbe yii	Nan
gobolkan	ni agbegbe yii	Nan
gobolkani	ni agbegbe yii	Nan
gobolkasta	ni eyikeyi ipinle	Nan
gobolkii	ekun	Nan
gens	gens	Nan
gobolku	ipinle	Nan
gobolladii	awọn ẹkun ni	Nan
gobolo	awọn ẹkun ni	Nan
gobonidoon	gobonidoon	Nan
gobonimo	ominira	Nan
gobonnimada	ọba aláṣẹ	Nan
gobroon	goron	Nan
god	iho	Nan
gobollada	awọn ẹkun ni	Nan
generation	iran	Nan
generalka	lori gbogbo re	Nan
general	gbogboogbo	Nan
gaystay	ti ṣe	Nan
gbanaadir	gan gbajumo	Nan
gebi	patapata	Nan
gedisan	ijinna	Nan
gedo	gige	Nan
gedoshabeelaha	tirakito	Nan
geed	igi	Nan
geedaha	igi	Nan
geeddi	ilana	None
geedi	igi	Nan
geedka	ohun ọgbin	Nan
geedkii	igi	Nan
geedo	ewe	None
geel	ràkúnmí	Nan
geela	ràkúnmí	Nan
gaysay	jišẹ	Nan
gaysatay	waye	Nan
gayiga	onibaje	Nan
gawracii	pipa	Nan
gartada	mọ o	Nan
gartay	loye	Nan
garto	da	None
garyaqaan	agbẹjọro	Nan
garçon	àṣá	Nan
gashaa	wọle	Nan
gashaandhiga	asà	Nan
geelii	ràkúnmí	Nan
gashay	ti tẹ	Nan
gates	awọn ẹnubode	Nan
gateyba	ẹnu ọna	Nan
gato	ra	None
gauda	mimi gulegule	Nan
gaule	gaule	Nan
gaulle	àlàfo	Nan
gaussian	gausisiani	Nan
gashiyo	irun	Nan
garsoore	lẹjọ	Nan
geeliisii	ràkúnmí	Nan
geella	ràkúnmí	Nan
geeyo	mu wa	Nan
gelaya	ti nwọ	Nan
geledi	jò	Nan
geli	wo ile	Nan
gelin	fi	None
gelinta	fi	None
gelisay	fi	None
geliya	ninu	Nan
geliyaan	fi	None
geliyay	fi	None
geliyeen	fi	None
geliyo	fi	None
gelle	galle	Nan
gelyo	awọn iboji	Nan
gen	ji	Nan
geeyey	jišẹ	Nan
geeyay	jišẹ	Nan
geeyaa	mu wa	Nan
geesteen	si wa	Nan
geelle	ràkúnmí	Nan
geelo	ràkúnmí	Nan
geelu	ràkúnmí	Nan
geeri	iku	None
geerida	iku	None
geeridii	iku	None
geerisa	iku	None
geelka	ràkúnmí	Nan
geeriyooday	kú	Nan
geeriyoodey	kú	Nan
geeriyootay	kú	Nan
gees	eti	Nan
geesi	gẹẹsi	Nan
geesinimo	igboya	Nan
geesiyaashii	awọn alagbara	Nan
geeska	igun	Nan
geeriyoodeen	ku	None
dheeraasamaale	gun	None
gaarkiisa	rẹ	None
gaarin	iraye si	Nan
fara	lati bẹrẹ	Nan
faraaciinta	tirẹ	Nan
faraana	oruko	None
farabadan	lọpọlọpọ	Nan
farac	irugbin	Nan
faragelin	dabaru	Nan
farah	jinna	Nan
faraha	awọn ika ọwọ	Nan
faransiis	faranse	None
faransiisk	faranse	None
faransiiska	faranse	None
faransiisku	faranse	None
faras	kan	None
faraska	ẹṣin	Nan
faraskii	ẹṣin	Nan
far	jinna	Nan
farasku	rẹ	None
faqiiq	gbolohun ọrọ	Nan
faqi	dín	Nan
falanqayno	jiroro	Nan
falastiin	palestine	Nan
falastiiniyiintu	palestinians	Nan
fale	alẹmọ	Nan
faleedka	alẹmọ	Nan
falidda	ogbin	Nan
falka	iṣe	Nan
falkaab	ìṣe	Nan
fanaan	olorin	Nan
fanaanad	àìpẹ	Nan
fanaaniinta	awọn oṣere	Nan
fanansuwela	olutayo	Nan
fanka	aworan	Nan
faqashta	daku	Nan
faqay	pariwo	Nan
faqiih	faqih	Nan
farax	dun	None
faraxsan	dun	None
faraxsanahay	dun	None
farshaxanka	aworan	Nan
farta	ika	Nan
farxad	idunnu	Nan
farxeen	yọ	None
farxiyo	idunnu	Nan
fasax	lọ	Nan
fashilmay	kuna	Nan
fasir	tumọ	Nan
fasirtada	itumọ	Nan
faso	lati kọja	Nan
father	baba	Nan
feb	feb	Nan
febayaa	leè	None
febraayo	ni kínní	Nan
february	oṣu kínní	Nan
farshaxan	aworan	Nan
farsamo	imọ ẹrọ	Nan
farsamada	imọ-ẹrọ	Nan
farraaciintii	dari	Nan
faray	jinna	Nan
farayso	dari	Nan
farcanmeen	irugbin	Nan
fardaha	ẹṣin	Nan
fardo	ẹṣin	Nan
fariin	ifiranṣẹ	Nan
fariistay	fẹyìntì	Nan
falalka	awọn iṣẹ	Nan
fariisto	joko	Nan
farmaajo	warankasi	Nan
farnnsiisku	farnishness	Nan
farnsiiku	didi	Nan
farnsiiska	faranse	None
farnsiisku	faranse	None
faro	ika	Nan
farqi	iyato	None
farlibaax	fò	Nan
falal	awọn iṣẹ	Nan
falaha	oluṣe	Nan
falaa	se o	Nan
f	f	Nan
faadir	o ṣeeṣe	Nan
faadumo	ṣiṣàn	Nan
faafay	tànkálẹ	Nan
faafinta	itankale	Nan
faafiyeen	tuka	Nan
faafiyey	tan	Nan
faago	o ṣeeṣe	Nan
faah	awọn alaye	Nan
faahfaahsan	alaye	Nan
faaiidada	anfani	Nan
faaiido	jere	Nan
faaloota	asọye	Nan
faano	ogo	Nan
faanoole	ẹlẹṣẹ	Nan
eyl	eyl	Nan
ey	ey	Nan
external	ita	Nan
express	han	Nan
eryey	kuro	Nan
es	es	Nan
esperanto	esperanto	Nan
estoniya	estonia	Nan
et	àti	Nan
ethiopa	ethiopa	Nan
ethiopia	ethiopia	Nan
faanto	iṣogo	Nan
ethopia	ethopia	Nan
etoobiya	etiopia	Nan
europe	yuroopu	Nan
european	oyinbo	Nan
ex	mofi	Nan
example	apẹẹrẹ	Nan
exchange	paṣipaarọ	Nan
explorer	aṣawakiri	Nan
ethopiakenya	ethopiakenya	Nan
federaal	federal	Nan
faarax	muyan	Nan
faatikaan	ni yi o tọ	Nan
fadligeeda	rẹ	None
fahamka	oye	Nan
fahamno	loye	Nan
fahmaan	loye	Nan
fahmay	loye	Nan
fahmeen	loye	Nan
fahmeyna	loye wa	Nan
fahmeynaa	a ye	Nan
fahmi	loye	Nan
fahmin	ko	None
fahmo	loye	Nan
faisal	faisal	Nan
fakaday	sa asala	Nan
fakerayey	foju inu	Nan
fal	iṣe	Nan
fadliga	oore-ofe	Nan
fadlan	jowo	Nan
fadhiyey	joko	Nan
fadhiyay	ti joko	Nan
faatikanaka	autograph	Nan
faatikanka	ilana	None
faca	fa	Nan
faculty	olukọ	Nan
facween	facween	Nan
fadal	faagun	Nan
fadhida	joko	Nan
faarisiyiinta	àwọn farisí	Nan
fadhido	joko	Nan
fadhiisimo	di	Nan
fadhiistay	jókòó	Nan
fadhiisto	joko	Nan
fadhino	joko	Nan
fadhiso	joko	Nan
fadhiya	joko	Nan
fadhiyaa	joko	Nan
fadhiisan	joko	Nan
gaarka	ikọkọ	Nan
federaalka	federal	Nan
fekaray	ronu	Nan
fuula	gun	None
fuulay	gun	None
fuuli	gun	None
g	g	Nan
ga	yoo	None
gaab	kukuru	Nan
gaabaha	owo kukuru	Nan
gaaban	kukuru	Nan
gaabiyaa	lọra	Nan
gaabiyo	lọra	Nan
gaacuur	agbọnrin	Nan
gaadha	de ọdọ	Nan
gaadhaa	de ọdọ	Nan
gaadhay	de ọdọ	Nan
gaadhaya	de ọdọ	Nan
future	ojo	None
gaadhayaan	lati de odo	Nan
fursadaha	awọn aye	Nan
furqaan	furrow	Nan
fudud	o rọrun	Nan
fududaanta	ayedero	Nan
fududeeyay	irọrun	Nan
fulay	cowardly	Nan
fuley	ikọaláìdúró	Nan
full	kun	Nan
fura	ṣii	Nan
furaat	bọtini	Nan
furaha	bọtini	Nan
furan	ṣii	Nan
furay	ṣí	Nan
furayaasha	awọn bọtini	Nan
furayo	ṣiṣi silẹ	Nan
fureen	òdòdó	Nan
furo	ṣii	Nan
fursad	aye	Nan
gaadhayo	lati de odo	Nan
gaadhaysaa	de ọdọ	Nan
gaadheen	de ọdọ	Nan
gaandi	egbe	None
gaar	ikọkọ	Nan
gaara	de ọdọ	Nan
gaaraa	de ọdọ	Nan
gaaraayo	de ọdọ	Nan
gaarane	de ọdọ	Nan
gaaray	de ọdọ	Nan
gaaraya	de ọdọ	Nan
gaarayaan	de ọdọ	Nan
gaarayo	de ọdọ	Nan
gaareen	de ọdọ	Nan
gaareeso	de ọdọ	Nan
gaarey	de ọdọ	Nan
gaareysa	de ọdọ	Nan
gaari	ọkọ	Nan
gaalo	alaigbagbọ	Nan
gaalkacyo	alaigbagbọ	Nan
gaalkacayo	alaigbagbọ	Nan
gaalkaan	alaigbagbọ yii	Nan
gaadhin	dé	None
gaadho	de ọdọ	Nan
gaadhsiinayeen	fihan	None
gaadhsiinlahayd	de ọdọ	Nan
gaadhsiisanayd	de ọdọ	Nan
gaadhsiisnayd	de ọdọ	Nan
gaadhsiiya	fihan	None
from	lati	Nan
gaadhsiiyaan	fihan	None
gaadiid	irinna	Nan
gaadiidka	ijabọ	Nan
gaagaaban	ni soki	Nan
gaajo	ebi	None
gaal	alaigbagbọ	Nan
gaalada	awọn alaigbagbọ	Nan
gaaljecel	suuru	Nan
gaadhsiiyey	mu lọ	Nan
friesland	didin	Nan
frequency	igbohunsafẹfẹ	Nan
free	ọfẹ	Nan
fiidshe	ọmu	Nan
fiil	pulọọgi	Nan
fiiq	didasilẹ	Nan
fiiri	wo	Nan
fiirino	wa	Nan
fiiriyo	wo	Nan
fiiro	wo	Nan
fikrad	imọran	Nan
fikrada	ronu	Nan
fiktoriya	ronu	Nan
filaan	lojiji	Nan
filaanka	filasi	Nan
filaayaa	o ti ṣe yẹ	Nan
filan	to	None
filayo	o ti ṣe yẹ	Nan
fiidow	irọlẹ	Nan
fiid	irọlẹ	Nan
fiicanna	o dara	Nan
fiican	o dara	Nan
femmes	obinrin	Nan
ferde	ferde	None
feysal	faili	Nan
ficil	ìṣe	Nan
ficilku	ìṣe	Nan
fiday	tànkálẹ	Nan
fideen	tan kaakiri	Nan
fileyn	airotẹlẹ	Nan
fidin	tànkálẹ	Nan
fidinta	nínàá	Nan
fiditaankii	itankale	Nan
fidiyey	nà	Nan
fido	fido	Nan
fidsan	alapin	Nan
fidsantahay	alapin	Nan
field	pápá	Nan
fidinka	tànkálẹ	Nan
feerfeer	ẹlẹṣẹ	Nan
fille	beheaded	Nan
filmada	sinima	Nan
fool	oju	Nan
foolka	oju	Nan
foolmaroodi	ehin-erin	Nan
foore	tẹriba	Nan
for	fun	None
forces	awọn ipa	Nan
forgotten	igbagbe	Nan
form	fọọmu	Nan
four	mẹrin	Nan
franchwadnkan	faranse	None
fransiiska	faranse	None
fransiisku	francisco	Nan
français	faranse	None
françois	faranse	None
frasiiska	ikọlu	Nan
foodhida	igbe	Nan
fogfog	jinna	Nan
fogeyn	awọn ijinna	Nan
fogeeyaan	fi	None
filmaha	sinima	Nan
finland	finland	Nan
finnishakana	awọn ara ilu finn	Nan
fiqi	eko	None
fiqiga	eko	None
fircoon	lọwọ	Nan
firefox	firefox	Nan
film	fiimu	Nan
firfircoon	lọwọ	Nan
firkoodi	tuka	Nan
first	akoko	Nan
fog	jinna	Nan
fogaa	jinna	Nan
fogaadaa	fun	None
fogaado	fun	None
fogaayeene	wọn	None
firfircooni	lọwọ	Nan
يوسف	سفسفسفسف	Nan
