$	$	Nan
naftu	tự	None
naga	ta	None
nagaaday	đựng	None
nageeye	tung	None
nagiba	số	None
naginimada	thành	None
nagornokarabakh	usornokarabakh	Nan
nagu	tôi	None
naguma	cũng	None
nahay	là	None
nahaye	haha	Nan
nahey	không	None
nairobi	nairobi	None
najaashi	bộ	None
nala	tôi	None
naftooda	tôi	None
nalaga	tôi	None
naftiisa	ấy	None
naftay	tôi	None
nacas	kẻ	None
nacay	ghét	Nan
nacayb	ghét	Nan
nadar	nadar	Nan
nadarkana	xin	None
nadarkaygii	tôi	None
nadarkii	hạt	None
nadarkiisii	ấy	None
nadii	tìm	None
nadiif	dẹp	None
nadiifsan	dẹp	None
nadray	tiếc	None
naf	hồn	None
nafta	hồn	None
naftana	tôi	None
naftii	ấy	None
nalagu	tôi	None
naloo	là	None
nambiya	nam	None
naxariistaha	từ	None
naxariistee	tử	None
naxariistii	hại	None
naxariisto	ẩn	None
naxwaha	pháp	None
naxwe	pháp	None
nayjeeriya	muộn	None
nayroobi	tĩnh	None
ne	là	None
nearby	đó	None
nebal	vân	None
nebi	tri	None
nebiga	tri	None
nebigu	tri	None
nebinimda	nebinimda	Nan
naxariista	hại	None
naxariis	hại	None
naxaawiga	khí quyển	Nan
nato	nato	Nan
nancy	nancy	None
naqay	ngợi	None
nasab	ngơi	None
nasabka	hô	None
nasabkii	phận	None
nasahnaa	ngơi	None
nasiib	mắn	None
nabiyullaahi	naveahulhihi	Nan
nasir	mũi	None
nasri	mũi	None
nataashi	nhận	Nan
natiijada	kết	None
nation	gia	None
national	gia	None
nationlink	gia	None
nations	gia	None
nasoo	nào	None
necbaa	ghét	Nan
nabiyadii	tri	None
nabigii	tri	None
muuqaallada	ảnh	None
muuqanayey	hiện	None
muuqata	hiện	None
muuqatay	hiện	None
muuqato	hiện	None
muuqda	hiện	None
muuqdaan	hiện	None
muuqday	hiện	None
muuse	đủ	None
muusig	nhạc	None
muwaadiniinta	dân	None
muxamadna	muhammad	None
muxamadun	muhammed	Nan
muxamed	muhammed	Nan
muxamedna	muhammad	None
muuqaalka	hiện	None
muxammed	muhammad	None
muumin	muumin	Nan
muujiyeen	tỏ	None
mustafa	mù	None
mustaqbalka	lai	None
mustaxiil	nghĩa	None
musuq	nhũng	None
musveni	musveni	Nan
mutaystay	đáng	None
mutaystayee	với	None
muujinaya	hiển thị	Nan
muujinayaa	trình	None
muujinayo	hiển thị	Nan
muujinaysa	hiển thị	Nan
muujinaysaa	trình	None
muujisay	xem	None
muujiyaa	tiết	None
muujiyaha	họa	None
muujiyey	xem	None
muxudiin	muxdinin	Nan
muxumad	khen	None
muxumed	muxumed	Nan
nabada	thanh	None
nabadda	thanh	None
nabaddayn	chào	None
nabadgalyadiisa	ấy	None
nabadgalyadiisana	ấy	None
nabadgalyo	biệt	None
nabadgelyada	toàn	None
nabadgelyadiisa	ấy	None
nabadgelyo	biệt	None
nabadoon	chào	None
nabadoonka	chào	None
nabi	nabi	Nan
nabiga	tri	None
nabigeeniina	ta	None
nabigeennii	ta	None
nabad	thanh	None
naasiruddiin	cảm	None
naasahablood	não	None
naasaha	ngực	None
muxumud	muhumud	Nan
muxuu	gì	None
muxyadiin	muhdiinin	Nan
mxaad	ba	None
na	với	None
naa	quá	None
naacaw	khóc	None
nabinimada	tri	None
naad	bộ	None
naagta	người	None
naanaysaa	tên	None
naanaysi	tên	None
naanaysta	tên	None
naar	naar	Nan
naarta	ngọn	None
naasa	hoa	None
naag	bà	None
necebyahay	tôi	None
nederlaan	lan	None
nederland	lan	None
noqoneysa	được	None
noqoshadii	trở về	Nan
noqoshadiisa	ấy	None
noqotaa	thành	None
noqotay	thành	None
noqotayna	thành	None
noqotey	thành	None
noqoto	là	None
noqoy	là	None
north	bắc	None
norway	uy	None
norwey	ở	None
not	phải	None
nov	thuyết	None
november	tháng	None
noqonaysa	được	None
nqoto	nito	Nan
noqonayaa	thành	None
noqon	là	None
nooli	trực	None
nooluhu	sống	None
noolyahay	sót	None
noolyihiin	sót	None
nooshahay	trực	None
noqatay	thành	None
noqdaa	thành	None
noqdaan	là	None
noqday	thành	None
noqdee	là	None
noqdeen	thành	None
noqdey	thành	None
noqdo	là	None
noqnoqda	lại	None
noqo	là	None
noqonaayo	là	None
nso	gần	None
nsoafrika	châu	None
nsoamerika	mỹ	None
o	o	Nan
obama	obama	None
ocean	dương	None
october	tháng	None
octwaxaa	tám	None
oday	cũ	None
odayaal	tuổi	None
odayaasha	tuổi	None
odayaashii	tuổi	None
odayga	già	None
odaygii	già	None
odeyga	già	None
odeygii	quá	None
odhan	không	None
odhanaya	luận	None
nuux	hạt	None
nuurka	sáng	None
nuuraaya	sáng	None
nuur	sáng	None
nsodjibouti	mới	None
nsoeritrea	vài	None
nsoethiopia	gần	None
nsofora	quen	None
nsojesu	theo	None
nsorussia	nến	None
nsosekriste	mục	None
noole	sót	None
nsosomalia	cận	None
nugaaleed	đường	None
number	số	None
nur	dưỡng	None
nuri	nuri	Nan
nuuc	kiểu	None
nuun	nu	Nan
nuunka	nuke	Nan
nugaal	mút	None
noolaha	học	None
noolaashaha	sống	None
noolaanooyaan	sống	None
nimaan	ông	None
nimada	chồng	None
niman	ông	None
nimanka	ông	None
nimankii	ông	None
nimanyahow	các	None
nimca	sủng	None
nimcada	sủng	None
nimcooyin	sủng	None
nin	ông	None
ninba	ai	None
ninka	ông	None
ninkaa	ông	None
ninkaan	này	None
ninkaani	này	None
niisa	tay	None
niil	không	None
nihon	vô	None
niger	niger	Nan
neef	thở	None
neefka	thở	None
neh	không	None
nelson	nelson	None
net	lưới	None
network	mạng	Nan
networks	mạng	Nan
ninkaas	đó	None
new	mới	None
newspaper	chí	None
nfd	nfd	Nan
nibiga	quá	None
nicolas	nicolas	None
nidaam	hệ	None
nidaamka	hệ	None
nidaamkii	hệ	None
news	tức	None
mustacmarad	lai	None
ninkan	này	None
ninki	đôi	None
noloshooda	họ	None
noo	ta	None
nooc	xếp	None
nooca	kiểu	None
noocan	này	None
noocyada	loại	None
noocyadeeda	của	None
nooga	ta	None
noogu	tôi	None
nool	sót	None
noolaa	sống	None
noolaadaan	trực	None
noolaado	sót	None
noolaan	trực	None
noolaanooyaa	sót	None
noloshiisii	ấy	None
noloshiisa	ấy	None
nolosha	sống	None
nololeedkii	sống	None
ninkii	ông	None
ninna	ai	None
ninnimo	ca	None
nirig	nirig	Nan
nisaar	rộng	None
nk	mưu	None
nl	nl	Nan
ninkase	nhiên	None
nnk	nnk	Nan
no	không	None
noa	noa	Nan
nobad	quý	None
nofeembar	tháng	None
nolol	sống	None
nololeed	sống	None
nololeedka	sống	None
nnkh	nnkh	Nan
mussolini	trai	None
muslinka	hồi	None
muslin	muslin	Nan
maysara	biết rôi	Nan
mayso	không	None
md	md	Nan
medicine	thuốc	None
mediina	trung	None
meel	điểm	None
meela	ơn	None
meelaha	nơi	None
meele	ơn	None
meeleeyaha	chỗ	None
meelihii	điểm	None
meelo	nơi	None
meeqa	nhiêu	None
meesha	đo	None
meeshaan	đây	None
maysan	phải	None
meeshaas	đó	None
mayo	mayo	Nan
mayl	dặm	None
maxkamad	tòa	None
maxkamada	tòa	None
maxkamadaha	tòa	None
maxkamaduhii	tòa	None
maxkamaduhu	tòa	None
maxmed	đa	None
maxmiyadda	tòa	None
maxsuulkii	kết	None
maxéd	đa	None
may	thể	None
maydh	rửa	None
maydka	thể	None
mayeelan	đừng	None
mayeelayo	không	None
maygaag	có	None
maynee	không	None
meeshan	này	None
meeshay	tôi	None
meeshii	đo	None
midabka	màu	None
midawga	hiệp	None
midawgaas	đó	None
midawgii	hiệp	None
midda	một	None
middelburg	middelburg	Nan
middi	ibid	Nan
mideeyaan	kết	None
mideeyay	kết	None
mideeyo	kết	None
mideysan	kết	None
midha	trái	None
midig	đúng	None
midka	một	None
midkii	một	None
midab	màu	None
midaan	này	None
mida	một	None
mid	một	None
meeshuu	nào	None
meeyadii	điểm	None
meheriyey	tôi	None
meksiko	mexico	Nan
melateri	quân	None
melez	melez	Nan
mengista	mengista	Nan
maxed	đa	None
mesopotamia	hà	None
mi	tôi	None
micnaha	nghĩa	None
micnaheeda	nghĩa	None
micnaheedu	nghĩa	None
micnihiisu	nghĩa	None
micno	nghĩa	None
microsoft	microsoft	None
meters	mét	None
maxay	gì	None
maxamuude	đa	None
maxamuud	mohamud	Nan
masaajid	hồi	None
masaajida	hồi	None
masaajiddada	hồi	None
masaajidka	hồi	None
masaajidkii	hồi	None
masaajido	hồi	None
masaakiinta	nghèo	None
masaayda	ngôn	None
masagada	miến	None
masagawaay	không	None
masalle	masala	Nan
masar	nề	None
masarayuu	masaruuu	Nan
maseyr	tị	None
mash	ngâm	Nan
masaafo	cách	None
masaafada	cách	None
maryeenta	áo	None
maryan	mary	None
marta	này	None
martabada	tiếng	None
martay	còn	None
martgelinta	khách	None
marti	mời	None
martida	khách	None
martigelis	khách	None
mashquul	bận	None
martiqaad	mời	None
marwaan	nào	None
marwo	bà	None
marx	marx	None
marxalad	khấu	None
marxaladihii	đoạn	None
marxuum	chết	None
maryam	mary	None
marto	marat	None
midkiin	các	None
mashruuc	dự	None
masiix	christ	None
matalan	dụ	None
matter	đề	None
mauritania	mauritania	Nan
maxaa	gì	None
maxaad	gì?	Nan
maxaakiimta	phán	None
maxaan	gì?	Nan
maxaas	gì	None
maxamad	tòa	None
maxamadow	đại	None
maxamed	đa	None
maxamedaay	là	None
maxamedow	mohamed	Nan
maxammed	biếm	None
maxamud	maxamud	Nan
matabaan	nôn	None
mataan	đôi	None
masuuliyaddii	nhiệm	None
masuuliyad	nhiệm	None
masiixiga	hữu	None
masiixiyad	kitô	None
masiixiyiintu	hữu	None
masjid	hồi	None
masjidka	hồi	None
masjidul	hồi	None
maskax	trí	None
mashruuca	dự	None
maskaxda	trí	None
maslax	masishima	Nan
maslaxad	nhuận	None
masno	hiểu	None
masraxa	khấu	None
massagada	xa	None
massare	xa	None
masuul	nhiệm	None
maskaxdii	trí	None
odhane	hơn	None
midkod	hoặc	None
midnimada	kết	None
mudanahay	đáng	None
mudane	quý	None
mudar	mũi	None
mudda	đoạn	None
muddad	đoạn	None
muddadii	đoạn	None
muddo	đoạn	None
mudhalib	biến	None
mudo	đoạn	None
mudrik	mudrik	Nan
mudug	bùn	None
mudulood	ngồi	None
mufti	mufti	Nan
mug	âm	None
mugdi	tối	Nan
mudan	đáng	None
mugga	âm	None
mudaharaado	trình	None
mudadii	đoạn	None
moxamed	mohamed	Nan
moxamud	mohammed	None
mozilla	mozilla	Nan
mp	mp	None
mr	ông	None
mualif	caliph	Nan
mucaarad	đối	None
mucaaradadiyå	quân	None
mucaaradka	đối	None
mucaaradku	đối	None
mucaaridka	đối	None
mucjisa	lạ	None
mucjiso	lạ	None
mudada	đoạn	None
mudadi	mũi	None
mudaharaadka	tình	None
muhammed	lầm	None
muhiim	trọng	None
muhiima	trọng	None
murusade	nói	None
musaanbiiq	phận	None
musanbiig	nhạc	None
musdalifa	muslimifa	Nan
muse	hiện	None
musha	trả	None
mushaar	trả	None
musharaxa	viên	None
musharaxnimada	viên	None
muslim	hồi	None
muslimay	hôn	None
muslimiin	hồi	None
muslimiinta	hồi	None
muslimka	hồi	None
muslimku	hồi	None
murtida	tường	None
murti	murti	Nan
mursal	ca	None
murra	chuột	None
muhiimada	nghĩa	None
muhiimka	trọng	None
muhiimsan	trọng	None
mujaaahidka	mujahid	Nan
mujaahidiinta	hồi	None
mujaahidiintii	hồi	None
mujaddidka	hồi	None
mowliid	vào	None
mukhtaar	mukhtaar	Nan
munaasibada	dịp	None
munaasibadaasi	đó	None
muqawim	muqwim	Nan
muqbil	cua	None
muqdisho	mogadishu	Nan
muqdishu	mogadishu	Nan
muran	cãi	None
mukulaal	mèo	None
movement	trào	None
most	lớn	None
moskow	moskow	Nan
milatari	quân	None
milatariga	quân	None
milateri	quân	None
milateriba	quân	None
milateriga	quân	None
milaterigu	quân	None
militari	quân	None
militariga	quân	None
milkiilaha	hữu	None
millateriga	quân	None
milyan	triệu	None
min	thiểu	None
mina	được	None
minaaradii	tháp	None
mindhaa	có	None
miiska	bàn	None
miisaanka	nặng	None
miisaan	nặng	None
miiroon	micron	Nan
midnimadii	kết	None
midnimo	kết	None
midoobay	kết	None
midoobaywaxa	hiệp	None
midoobeen	kết	None
midoobidii	hiệp	None
midoobo	nhập	None
miracas	là	None
midow	hiệp	None
midowgaasi	đó	None
midtahay	là	None
midyihiin	kết	None
miigagii	tôi	None
miiggan	miiggan	Nan
miilaadiga	đông	None
miimka	mika	Nan
midowga	hiệp	None
midna	ai	None
miraha	hạt	None
mirfle	qua	None
moobiilada	động	None
mood	trang	None
moodaa	như	None
moodaaye	trang	None
mooday	nghĩ	None
moodey	nghĩ	None
mooge	trùm	None
moomaahee	gì?	Nan
moos	chuối	None
mooska	chuối	None
mooyaane	khi	None
mooyaanehaddaba	chắc	None
mooyee	khi	None
mooyi	khi	None
more	hơn	None
montenegro	montlahoma	Nan
monako	mùa	None
mohamud	mohamud	Nan
mohamed	mohamed	Nan
mirifle	qua	None
miroodka	trái	None
mirro	lăn	None
mise	là	None
miskiga	nghèo	None
misna	misna	Nan
mitterrand	mitterrand	Nan
mire	bùn	None
miyaa	là	None
miyi	siêu	None
miyiga	nông	None
miyuu	là	None
mobile	động	None
mobiles	động	None
module	mô-đun	Nan
mogadisho	mogadishu	Nan
miyaan	sẽ	None
marshey	lầy	None
odhanjiray	nói	None
odiweyn	lớn	None
qofkaste	người	None
qofkii	người	None
qofku	người	None
qofna	ai	None
qolo	hội	None
qoob	nhảy	None
qoomido	tiếc	None
qoomiyado	tiếc	None
qoonedhangaloowbeydaaniyo	gia	None
qoor	cái	None
qoqobnaan	ly	None
qora	viết	None
qoraa	giả	None
qoraaga	giả	None
qoraagii	giả	None
qofkasta	người	None
qoraal	viết	None
qofkale	khác	None
qofba	người	None
qiyaasay	đo	None
qiyaasi	tưởng tượng	Nan
qiyaaso	tưởng tượng	Nan
qiyaasta	liều	None
qiyaastii	khoảng	None
qiyidaaq	biện	None
qm	qm	Nan
qod	đào	None
qodaal	đào	None
qoday	lên	None
qodiddii	lên	None
qodin	đào	None
qodob	báo	None
qodobka	báo	None
qof	người	None
qofka	người	None
qoraalada	văn	None
qoraaladii	văn	None
qoraalka	văn	None
qorituurkii	già	None
qorituurkuna	trời	None
qoro	viết	None
qorshahan	này	None
qorshe	kế	None
qoryo	gỗ	None
qoryooley	rừng	None
qosol	cười	None
qoto	sâu	None
qowmiyada	tộc	None
qoys	gia	None
qoyska	gia	None
qoyskii	gia	None
qubbi	tắm	None
qubo	đổ	None
qorista	viết	None
qorigii	súng	None
qorida	viết	None
qori	viết	None
qoraalkaan	này	None
qoraalkan	này	None
qoraalkii	văn	None
qoraalo	văn	None
qoraan	viết	None
qoraha	giả	None
qoran	văn	None
qiyaasaa	đo	None
qorax	trời	None
qoraxeey	nắng	None
qoraxey	nắng	None
qoray	viết	None
qore	giả	None
qoreen	văn	None
qoremaxamed	mohammed	None
qorey	văn	None
qoraxda	trời	None
qubrista	tắm	None
qiyaasa	đo	None
qiyaame	sinh	None
qaybkamida	phần	None
qaybo	phận	None
qaybood	phần	None
qaybqaateen	gia	None
qaybsaday	chia	None
qaybsantaa	chia	None
qaybsantahay	chia	None
qaybsha	cách	None
qaybta	phần	None
qaybtan	này	None
qaybtii	phần	None
qayka	rừng	None
qayraadkiisa	của	None
qeebaha	phận	None
qeebiyay	tả	None
qaybiyaa	phối	None
qeebood	phận	None
qaybin	phát	None
qaybaha	phần	None
qasaare	cuộc	None
qasali	ép	None
qasbaa	phục	None
qasbay	ép	None
qasim	pha	None
qassem	lẫn	None
qatar	qatar	None
qawmiyada	tộc	None
qaxay	trốn	None
qaxii	tán	None
qaxoontiga	nạn	None
qaxooti	nạn	None
qaxootiga	nạn	None
qayawoowgii	quá	None
qayb	phần	None
qaybgasho	tham	None
qeebsama	chia	None
qeebsanaa	chia	None
qeexayey	tả	None
qiimo	trị	None
qiiq	khói	None
qilaafeen	chối	None
qilaafsan	ý	None
qir	nhìn	None
qirayaa	thừa	None
qireen	thừa	None
qirista	nhìn	None
qiritaanka	tội	None
qiritaanku	tội	None
qisadaan	này	None
qisadan	này	None
qisadii	chuyện	None
qisooyin	chuyện	None
qiyaamaha	viễn tưởng	Nan
qiimayn	giá	None
qiimaha	trị	None
qibladeedii	nghiệm	None
qiblada	bay	None
qeexaysaa	tả	None
qeeyb	phần	None
qeyb	phần	None
qeybaha	phận	None
qeybisa	chia	None
qeybiya	phát	None
qeybiyaa	phối	None
qiyaas	đo	None
qeybiyey	phối	None
qeybood	phận	None
qeybsaday	chia	None
qeybsan	chia	None
qeybta	phần	None
qeybteeda	của	None
qeyliye	lên	None
qibdhiya	kêu	None
qeybiyo	phận	None
qubrus	síp	None
qudaarta	rau	None
qudha	có	None
raqiisanyihiin	hơn	None
raran	haran	Nan
rash	hoa	None
rashid	tìm	None
rashiid	lên	None
raskambooni	ảnh	None
rasmi	thức	None
rasmiga	thức	None
rasuul	đồ	None
rasuulka	đồ	None
rasuulkeennii	tôi	None
rasuulkii	đồ	None
rasuulkiisa	đồ	None
rasuulku	đồ	None
rasuululaah	đồ	None
raqiis	rẻ	None
rate	lệ	None
raq	raq	Nan
rammadaan	này	None
raggii	ông	None
raggiisiiye	ấy	None
ragii	ông	None
ragow	ông	None
raiisalwasaare	tướng	None
raiisul	chịu	None
raisul	khô	None
raisulwasare	khô	None
rajab	mạng	Nan
rajada	vọng	None
rajaynayaa	vọng	None
rajeynayaa	vọng	None
rajiimkii	sứ	None
rajo	mong	Nan
ramadaan	sập	None
ranges	dãy	None
rati	chuột	None
raxay	giết	None
raxmaan	tốt	None
reerkiisa	ấy	None
reerkiisii	ấy	None
reerkooda	họ	None
reernimada	sinh	None
reero	gia	None
regime	độ	None
region	vực	None
regions	vùng	None
register	ký	None
release	phóng	None
repubblica	repubblica	Nan
republic	hòa	None
rer	rer	Nan
resolution	giải	None
ri	tìm	None
reerkiina	gia	None
reerka	gia	None
reergalbeedku	tây	None
reeraha	gia	None
rayaale	rayale	Nan
rayaan	ture	Nan
rayidka	dân	None
raysal	đuối	None
rc	rc	Nan
realtime	thực	None
recognition	công	None
ragga	ông	None
ree	bán	None
reebaana	cấm	None
reebay	trừ	None
reebban	lệ	None
reebka	lệnh	None
reebo	trừ	None
reer	gia	None
reera	gia	None
reeb	lệnh	None
ragaadisay	méo	None
raga	lưới	None
rag	ông	None
qurxoon	đẹp	None
qusa	chà	None
qusay	lo	None
qusayi	lạnh	Nan
quudhsadaye	thường	None
quudhsi	thường	None
quudiyaah	cả	None
ra	mua	None
raaca	theo	None
raacaan	theo	None
raacay	sau	None
raacdey	sau	None
raaceen	sau	None
raacin	theo	None
raacineysaa	thêm	None
qurxan	đẹp	None
quruxsan	đẹp	None
quruxna	đẹp	None
quruxda	đẹp	None
qudus	thánh	None
qumaatiga	tự động	Nan
qura	có	None
quraan	koran	None
quraanka	koran	None
quraankiisa	ấy	None
quraysh	quraysh	Nan
raaciyey	thêm	None
qurayshtu	qurays	Nan
qurbac	rác	None
qurbaha	ngoài	None
qurbajoogga	cư	None
qureysh	sáng	None
qureysheed	tuộc	None
qureyshtu	ăn	None
qurux	đẹp	None
qurba	bán	None
qarsoon	ẩn	None
raaco	theo	None
raacsanyahay	ý	None
raba	chia	None
rabaa	muốn	None
rabaan	muốn	None
rabay	muốn	None
rabbi	giáo sĩ	Nan
rabbigiis	thỏ	None
rabiic	rabiic	Nan
rabin	nửa	None
rabitaanka	khát	None
rabo	phận	None
rabtay	muốn	None
rada	rada	Nan
radio	đài	None
radius	kính	None
rafaadkii	khổ	None
raaxo	mái	None
raaxeestaan	thức	None
raaxaysto	thức	None
raaxaystaan	thức	None
raad	vết	None
raadi	tìm	None
raadiyo	đài	None
raadkaan	này	None
raadkii	vết	None
raadraaca	dõi	None
raage	chùng	Nan
raacsan	dõi	None
raagge	chậm	None
raahibka	mái	None
raali	tiếc	None
raalli	lòng	None
raascaseyr	vợt	Nan
raashin	ăn	None
raaskambooni	hoa	None
raaxaysta	mình	None
raahib	rap	None
qarsoodiya	mật	None
qarsoodi	mật	None
qarshe	thúc	None
part	phần	None
parts	phận	None
party	tiệc	None
paul	paul	None
period	đoạn	None
peru	peru	None
petit	nhắn	None
phone	thoại	None
phones	thoại	None
photos	ảnh	None
political	trị	None
pompidou	pompidou	Nan
port	cảng	None
possible	thi	None
power	quyền	None
parliamentary	viện	None
price	bán	None
paris	paris	Nan
packet	gói	None
organized	chức	None
orgi	cực	None
orod	chạy	None
orodada	chạy	None
oromo	gà	None
osman	osman	Nan
osoble	osoble	Nan
ossetia	ossetia	None
ostariya	châu	None
ot	không	None
other	khác	None
outlook	điểm	None
overview	tổng	None
ow	nợ	None
p	p	Nan
pakistaan	pakistan	None
primary	cấp	None
private	tư	None
prof	tin	None
qaadan	lấy	None
qaadanay	lấy	None
qaadanaya	lấy	None
qaadanaysaa	nhận	Nan
qaadaneynaa	lấy	None
qaadanno	lấy	None
qaadano	lấy	None
qaadashada	lấy	None
qaadataa	nhận	Nan
qaadataan	lấy	None
qaadatay	lấy	None
qaadatey	lấy	None
qaaday	lấy	None
qaadaya	chở	None
qaadayaan	chở	None
qaadaan	mang	None
qaadaa	mang	None
qaada	mang	None
qaad	lấy	None
professor	sư	None
protocol	thức	None
provide	cấp	None
province	tỉnh	None
psu	psu	Nan
public	cộng	None
punltand	chữ	None
org	cực	None
puntland	phố	None
qaab	dạng	None
qaababka	trưng	None
qaabiil	gia	None
qaabisho	rồi	None
qaabka	dạng	None
qaabkan	này	None
qaabkii	dạng	None
puławy	khăn	None
oren	chó	None
ordayey	chạy	None
orday	chạy	None
oggolaa	ý	None
ognahay	tôi	None
ogol	phép	None
ogolaaday	ý	None
ogolaan	ý	None
ogolaanaya	ý	None
ogolyahay	phép	None
ogosto	tám	None
ogsoon	cảnh	None
ogsoonoow	cảnh	None
ogtahay	bạn biết	Nan
ogyahay	biết	Nan
oktobar	tháng	None
oktober	tháng	None
oktoobar	tháng	None
ogeyn	biết rôi	Nan
ogayd	biết	Nan
ogalaa	phép	None
ogadenya	thừa	None
odoyaashii	tuổi	None
of	của	None
offer	phục	None
official	thức	None
og	og	Nan
oga	cấp	None
ogaadaan	biết rôi	Nan
olalihii	dịch	None
ogaaday	hiện	None
ogaadey	hiện	None
ogaado	tìm	None
ogaal	ý	None
ogaato	tìm	None
ogaayeen	biết	Nan
ogaden	trước	None
ogadenia	biệt	None
ogaadeen	phá	None
qaadayo	chở	None
olol	ngọn	None
ololeeyey	động	None
ookorreeye	vòng	None
ool	ool	Nan
oon	nước	None
oona	nước	None
ooryeheer	cấp	None
oow	ồ vâng	Nan
ooy	lóc	None
ooyaayoo	khóc	None
operate	vận	None
operators	thác	None
optional	bắt	None
or	là	None
oradadawaxa	trốn	None
oran	đề	None
oranjiray	cam	None
oohinta	khóc	None
oohin	khóc	None
oogista	truy tố	Nan
oogaan	miện	None
ololihii	dịch	None
olombikada	hội	None
omaar	biệt	None
omar	trẻ	None
on	ta	None
one	một	None
online	trực	None
olole	trại	None
only	có	None
oo	và	None
ood	tốt	None
ooda	xe	None
oodhan	rồi	None
oodwayne	oodwayne	Nan
oofin	thành	None
ooga	ooga	Nan
ontorodeegaan	trực	None
odhankaro	trận	None
qaadaysa	chở	None
qaade	tầm	None
qadiimi	xưa	None
qadiimiga	các	None
qadiimisan	xưa	None
qadiimka	các	None
qadiimsan	xưa	None
qafaashay	tù	None
qalaad	lạ	None
qalaafe	sư	None
qalaaye	tục	None
qalab	thiết	None
qalabka	liệu	None
qalabkoodi	họ	None
qalad	lỗi	Nan
qalalaase	xáo	None
qalbi	tim	None
qadiim	xưa	None
qalbiga	tim	None
qadeeyey	trưa	None
qadaro	tiền	None
qabsadeen	chiếm	None
qabsadeenwaxa	giữ	None
qabsado	kịp	None
qabsashada	nghiệp	None
qabsatay	chiếm	None
qabtaa	làm	None
qabtaan	chúng	None
qabtay	chức	None
qabteen	ông	None
qabtey	chức	None
qabto	giữ	None
qadaafi	gaddafi	Nan
qadar	tiền	None
qadarka	số	None
qadarkaas	đó	None
qaddarka	số	None
qalbigiisa	ấy	None
qalbigu	tim	None
qaldan	lầm	None
qardho	khắc	None
qare	hấu	None
qargistan	này	None
qariirada	đồ	None
qarin	giấu	None
qarinayaan	giấu	None
qarisay	giấu	None
qarni	hệ	None
qarniga	hệ	None
qarnigan	này	None
qarnigii	kỷ	None
qarniyadii	kỉ	None
qarniyo	kỉ	None
qarnka	hệ	None
qarsado	ẩn	None
qardaawi	vệ	None
qarannimada	tộc	None
qaranku	gia	None
qarankan	này	None
qalday	lầm	None
qaleel	khô	None
qalin	chì	None
qamadi	mì	None
qamadiga	mì	None
qanacsanyihiin	lòng	None
qandala	ngạo	None
qabsaday	giữ	None
qaraar	đắng	None
qaraha	hấu	None
qaramada	gia	None
qarameynayay	hoành	None
qaran	gia	None
qaranf	gia	None
qaranimada	tộc	None
qaranka	gia	None
qarad	nổ	None
qabrigiisa	ta	None
qabrigii	mộ	None
qabriga	mộ	None
qaangaar	lớn	None
qaanuunka	luật	None
qaar	số	None
qaarad	lục	None
qaarada	lục	None
qaaradaha	lục	None
qaaradda	lục	None
qaaradood	lục	None
qaarba	cho nhau	Nan
qaarda	số	None
qaarkale	khác	None
qaarkamida	số	None
qaarkood	số	None
qaarkoodna	họ	None
qaarna	khác	None
qaamuusyada	điển	None
qaamuuskan	này	None
qaamuuska	điển	None
qaamuus	giải	None
qaadeen	lấy	None
qaadey	lấy	None
qaadi	lấy	None
qaadidda	bỏ	None
qaadiga	phán	None
qaadiriyada	tòa	None
qaadku	khí	Nan
qaas	riêng	None
qaadno	lấy	None
qaadtay	lấy	None
qaadye	hỏng	None
qaali	đắt	None
qaalib	thưa	None
qaaliga	thưa	None
qaalin	thưa	None
qaalisan	đắt	None
qaado	lấy	None
qaadday	lấy	None
qaasim	biệt	None
qaataa	nhận	Nan
qabay	cưới	None
qabeelo	lạc	None
qabeen	có	None
qabey	cưới	None
qabiil	hội	None
qabiilada	lạc	None
qabiiladaoogoozoo	qabiiladaoogoozoo	Nan
qabiilka	lạc	None
qabiilo	lạc	None
qabiilooyin	lạc	None
qabo	có	None
qaboow	mẻ	None
qaboowdahay	tuyệt	None
qabow	mẻ	None
qabridahare	nghĩa	None
qabaw	lạnh	Nan
qabatimay	nghiện	None
qabashadiisuna	ấy	None
qabankarin	đó	None
qaataan	lấy	None
qaatay	lấy	None
qaateen	nuôi	None
qaatey	nuôi	None
qaato	lấy	None
qaba	nhiễm	None
qabaa	nghĩ	None
qaata	người	None
qabaailada	lạc	None
qabaailkii	lạc	None
qabaal	ăn	None
qabaan	có	None
qaban	làm	None
qabanayaa	làm	None
qabanayaan	làm	None
qabane	giữ	None
qabaailka	lạc	None
marsada	qua	None
marqudha	gian	None
marooko	voi	None
kooxda	nhóm	None
kooxdii	nhóm	None
kooxo	nhóm	None
kor	trên	None
koraaye	hơn	None
koray	lên	None
koraysaaye	phải	None
kordhaha	tăng	None
kordhi	tăng	None
kordhinta	rộng	None
kordhiyay	tăng	None
kordhiyey	hệ	None
kordhiyo	rộng	None
kordhoban	tăng	None
kordufan	tăng	None
kooxaha	nhóm	None
kore	lá	None
koox	nhóm	None
kooshin	học	None
koofureed	nam	None
koofurgalbeed	nam	None
koofurta	nam	None
koonfur	nam	None
koonfurba	nam	None
koonfurbari	nam	None
koonfureed	nam	None
koonfureedka	nam	None
koonfureedna	nam	None
koonfurta	nam	None
koonfurtu	nam	None
koonfurtuna	nam	None
koontaroolla	khiển	None
kooraha	diệc	None
koosar	học	None
koowaad	tiên	None
korkeeda	trên	None
korkiisa	trên	None
korkooda	họ	None
kugu	bạn	Nan
kugula	với	None
kuguulaysatay	thắng	None
kuhadalaan	gặp	None
kuhadlaan	gặp	None
kuhanynta	ran	None
kuhaysa	bạn	Nan
kujiraan	cả	None
kujiray	gồm	None
kula	trọng	None
kulahaa	gặp	None
kulahayd	đó	None
kulan	gỡ	None
kulana	dõi	None
kulansiine	gặp	None
kufsi	dâm	None
kufaa	nộ	None
kudhintay	chết	None
kudhaw	đây	None
kormerin	lại	None
korneel	tá	None
korneyl	lên	None
korodhsanayn	tăng	None
korontada	điện lực	Nan
koronto	điện lực	Nan
kororsi	dẫn	None
koofur	nam	None
korreeye	cao	Nan
kow	mỗi	None
kowaad	tiên	None
ku	bạn	Nan
kubada	bóng	None
kubadda	bóng	None
kudhaqan	trên	None
kudhaqanto	thực	None
korreeyetrololololololololololoibfhgidfgdufhgsdghdfbgdjbgdsjbgjsdbgjsbgjdfsklgkdsjfbgdfskbgdskjlbglkdfjbgkldfbgkdfbgkldsfbgskldfbgksldgblkdfsbglksdgbksdggggggggggb	ngày	None
kulayl	nóng	None
koofil	mũ	None
kooda	chúng	None
kiristaan	hữu	None
kiristanka	hữu	None
kiristanku	của	None
kismaayo	kismayo	Nan
kismaayobaydhabo	kismayoyou	Nan
kitaab	sách	None
kitaabka	sách	None
kitaabkan	này	None
kitaabkii	sách	None
klm	klm	Nan
km	km	None
kmg	kmg	Nan
knaan	kannan	Nan
knights	hiệp	None
known	được	None
kirishtaan	christian	None
koban	koban	Nan
kingdom	vương	None
kinaana	có	None
khuseyma	dụng	None
ki	cũng	None
kibirka	hào	None
kibis	mỳ	None
kibroo	ngạo	None
kici	dậy	None
kii	k	None
kiiba	khóa	None
kiikii	ki	None
kiimikaad	chất	None
kiin	một	None
kiina	tôi	None
kiinya	tử	None
kilaab	bộ	None
kililka	nách	None
king	vua	None
kobash	phát	None
kobcinta	giàu	None
kohay	kohay	Nan
koobantahay	chế	None
koobantahy	chế	None
koobanyahay	chế	None
koobay	tắt	None
koobaya	tắt	None
koobayo	chép	None
koobayso	tắt	None
koobi	sao	None
koobkii	cốc	None
koobmaa	đẹp	None
koobnaa	chế	None
koobnaan	lược	None
koobnaayeen	chế	None
koobnayd	chế	None
koobo	cốc	None
kooban	lược	None
koobaadmarkii	trước	None
koobaad	tiên	None
koob	cốc	None
kol	tá	None
kolayga	rổ	None
koleyga	rổ	None
kolkaas	đó	None
kolkii	lần	None
kolkuu	nào	None
kollay	cũng	None
koofi	mũ	None
kolombiya	đệm	None
kolse	bần	None
kolyga	kolyga	Nan
kombuyuutarka	máy	None
komoros	comoros	Nan
konfur	cấu hình	Nan
kong	kong	None
kongo	su	None
kolonbiya	thuộc	None
kulaylkiiye	sưởi	None
kuleel	nóng	None
kuleelka	nóng	None
laakiin	nhưng	None
laakiinse	nhưng	None
laakin	nhưng	None
laalaaba	hai	None
laalaayey	chỉ	None
laami	hẻm	None
laamiga	nhựa	None
laamka	thân cây	Nan
laan	nhánh	None
laanta	nhánh	None
laas	gái	None
laascaanood	những	None
laasgeel	vào	None
laashin	nhánh	None
laasqoray	chép	None
laah	hả	Nan
laasqorey	chép	None
laafyaha	xương	None
laabteen	lại	None
kuyaalla	phải	None
kuyaalo	quanh	None
kuyihiin	phải	None
kuyimi	đến	None
kwazulunatal	rỡ	None
l	tôi	None
la	với	None
laa	khác	None
laaan	nhánh	None
laaana	nữa	None
laaaneede	rồi	None
laaanta	có	None
laaasaasay	đó	None
laabneyne	lại	None
laabtay	lại	None
laadin	đá	None
laasqpray	lasiqpray	Nan
laatiiniga	latin	Nan
laatiinka	latin	Nan
labaduba	hai	None
labashaqlanaha	lặp	None
labka	giới	None
labo	hai	None
lacag	bạc	None
lacagaha	toán	None
lacago	bạc	None
lacagta	bạc	None
lacagtaas	đó	None
lacagtan	này	None
lacagtasi	đó	None
lacagteedii	ấy	None
lacagtii	tiền	None
lacata	bạc	None
ladaawdo	trị	None
labadooda	hai	None
labadiisii	hai	None
labadiisa	hai	None
labadiiba	hai	None
laayay	giết	None
lab	nghiệm	None
laba	hai	None
labaad	hai	None
labaadna	hai	None
labaatan	mươi	None
labaatanaad	mươi	None
kuyaala	quanh	None
labaatankii	mươi	None
labada	hai	None
labadaa	hai	None
labadaas	hai	None
labadaasi	đó	None
labadaba	hai	None
labadan	này	None
labadii	hai	None
labad	hai	None
kuyaal	trong	None
kuxigeenka	phó	None
kuwooda	họ	None
kumanyaalkii	ngàn	None
kumaray	thịnh	None
kumbuyuutar	vi	None
kumbuyuutarada	máy	None
kumbuyuutarka	máy	None
kumeel	thời	None
kumeelgaar	thời	None
kumeelgaarka	thời	None
kumurmay	không	None
kun	bạn	Nan
kuna	bại	None
kunool	trực	None
kunoolyihiin	sống	None
kuqoran	kê	None
kur	chỉnh	None
kumanyaal	ngàn	None
kumanaan	ngàn	None
kuman	who	Nan
kumalahan	cầu	None
kuleelkeeda	nóng	None
kuleh	nóng	None
kuliyada	học	None
kuliyda	cả	None
kulligood	họ	None
kulliyada	học	None
kulliyadda	học	None
kurdiska	kurd	None
kulma	gặp	None
kulmeen	gặp	None
kulmiye	lũy	None
kulmo	gặp	None
kulul	nóng	None
kulushahay	nóng	None
kuma	và	None
kumaankun	đầu	None
kulmay	gặp	None
khuduub	chỉ	None
kurdistan	kurd	None
kusheetik	học	None
kuuriya	hàn quốc	Nan
kuusoow	mừng	None
kuusow	mặt	None
kuwa	đó	None
kuwaa	đó	None
kuwaaa	đó	None
kuwaar	đây	None
kuwaas	đó	None
kuwaasi	đó	None
kuwaasoo	who	Nan
kuwada	bạn	Nan
kuwait	cô-oét	Nan
kuwan	những	None
kuwii	đó	None
kuwo	họ	None
kuuma	phải	None
kuul	hạt	None
kuugu	với	None
kuubaan	phương	None
kusii	vào	None
kusoo	nào	None
kusooduulay	đó	None
kutaal	cột	None
kutaala	nào	None
kutaalaa	đây	None
kutaalay	khỉ	None
kursiga	ghế	None
kutaallo	rơ	None
kutubo	sớm	None
kutubta	sớm	None
kutubtii	muộn	None
kutubtiisa	ấy	None
kututbtii	sớm	None
kuu	cho bạn	Nan
kuuba	cuba	Nan
kutub	văn	None
khubdadii	dụ	None
khubaro	gia	None
khubaraduna	gia	None
kadibna	đó	None
kadin	thẻ	None
kafadood	xu	None
kaftan	đùa	None
kaga	tưởng tượng	Nan
kagsoo	mình	None
kahadhay	tiếc	None
kahelay	rồi	None
kahor	trước	None
kaimd	cầu	None
kajira	khác	None
kajirin	đợi	None
kakoobantahay	tạp	None
kakoobanyahy	tạp	None
kal	kal	Nan
kadib	sau	None
kala	biệt	None
kadhiseen	vỡ	None
kadhacay	xảy	None
kacaydhinaca	này	None
kacaye	loạn	None
kacbada	loạn	None
kacbadda	dậy	None
kacbadiinnii	của	None
kacdoon	dậy	None
kacdoonka	loạn	None
kacdoonkii	dậy	None
kadabkii	cửa	None
kadagaalami	lắng	None
kadanbaysay	ngắn	None
kadanbeeyay	đây	None
kaday	quá	None
kaddib	sau	None
kadhacady	này	None
kadhashay	thua	None
kalabaxaan	tách	None
kalana	khác	None
kalandar	lịch	None
kalluunka	cá	Nan
kalmada	từ	None
kalmadduu	ấy	None
kalo	chào	None
kaloo	thế	None
kalsiduu	dưỡng	None
kalsooni	tin	None
kalsooniduu	ấy	None
kaluunka	cá	Nan
kalyaha	thận	None
kama	thế	None
kambodiya	trang	None
kamid	giữa	None
kamida	ảnh	None
kamidtahay	là	None
kalluun	cá	Nan
kaliyata	mình	None
kaliya	chỉ	None
kalinimada	cô	None
kalandarka	lịch	None
kalanderka	lịch	None
kalasaaraha	loại	None
kalasaaridda	loại	None
kalawareeg	lưu hành	Nan
kalayihiin	khác	None
kale	khác	None
kacay	sinh	None
kaleba	thế	None
kalena	khác	None
kalgacayl	cảm	None
kali	mình	None
kaligaa	mình	None
kaligii	mình	None
kaligiii	mình	None
kalimada	từ	None
kalee	khác	None
kacab	quá	None
kacaankii	cách	None
kacaanka	cách	None
jubbada	tưng	None
juli	tháng	None
july	tháng	None
julywaxaa	tháng	None
jumhūriyyat	jumhūriyyat	Nan
june	sáu	None
junna	junna	Nan
juqraafi	môn	None
juqraafiga	môn	None
juquraafi	môn	None
juun	juun	Nan
k	k	None
ka	một	None
kaa	bạn	Nan
kaafka	ngoài	None
jubba	jubba	Nan
jubadda	ngoài	None
jsl	jsl	Nan
jsiirada	js	Nan
joogayna	tại	None
joogeen	mặt	None
joogeene	đây	None
joogey	mặt	None
joogga	chiều	None
joogno	lại	None
joogo	tại	None
kaaga	từ	None
joogsanmaanta	diện	None
joogtaa	lanhung	Nan
joogtada	đổi	None
joogtay	mặt	None
joogto	đổi	None
joorjiya	chí	None
joqof	jockof	Nan
jowhar	jowhar	Nan
joogta	lại	None
kamidyahay	thuộc	None
kaah	kah	Nan
kaahin	trễ	None
kabaal	bẩy	None
kabad	tủ	None
kabadan	hơn	None
kabaha	giày	None
kabataane	giày	None
kabaxay	trái	None
kabaxsan	ngoài	None
kabaxsanida	tán	None
kabel	hiệu	None
kabexeen	nhảy	None
kabo	giày	None
kabsuuma	nữa	None
kabtay	phục	None
kaca	lên	None
kacaan	cách	None
kab	giày	None
kaatooliga	công	None
kaasoo	who	Nan
kaasi	là	None
kaakici	lại	None
kaalin	trò	None
kaalinta	trò	None
kaalintii	trò	None
kaalmada	trợ	None
kaalmadii	giúp	None
kaalmeeye	đỡ	None
kaaha	xạ	None
kaalmo	trợ	None
kaam	trại	None
kaar	thẻ	None
kaaraan	thể	None
kaariye	nhạc	None
kaarkuba	mộc	None
kaas	mà	None
kaashanayaan	hợp	None
kaalo	nào	None
ladareemay	râu	None
kamiruun	ảnh	None
kamman	ảnh	None
keenye	giao	Nan
keli	mình	None
keliga	mình	None
keligiis	mình	None
keliya	có	None
kennedy	cũi	None
kenya	kenya	Nan
kexeeyey	đẩy	None
key	khóa	None
keying	phím	None
khaalid	lầm	None
khaalida	lầm	None
khaas	biệt	None
khaasatan	biệt	None
khaatumkii	khaatum	Nan
keentay	gây	None
khabiir	gia	None
keeno	đến	None
keeneen	lại	None
kay	kay	None
kayaro	kêu	None
kaydka	phần	None
kaydsan	trữ	None
kayimi	nào	None
kaymaha	rừng	None
kaymo	rừng	None
kaynaan	kiệm	None
kaysaha	choi	None
kbps	kbps	Nan
kediye	mừng	None
keebka	tủ	None
keena	mang	None
keenadiid	đến	None
keenay	lại	None
keeni	đến	None
khad	mực	None
khadiija	khadija	Nan
khadiijo	thầm	None
khayrka	tốt	None
khayrkiisa	ấy	None
kheeraadkaan	này	None
kheyraad	nguyên	None
kheyraadka	nguyên	None
kheyre	tốt	None
khibrad	nghiệm	None
khilaaf	cãi	None
khilaafaa	ý	None
khilaafeen	ý	None
khilaafka	chấp	None
khilaafsan	quán	None
khiyaamay	lừa	None
khiyaamo	dối	None
khubarada	gia	None
khayriyada	nguyên	None
khayraadka	nguyên	None
khayr	tốt	None
khatar	hiểm	None
khadka	dòng	None
khahin	lầm	None
khal	giấm	None
khaladaad	lỗi	Nan
khalaf	giòn	None
khaliif	caliph	Nan
khaliifkii	caliph	Nan
kaxiga	theo	None
khaliijka	giấm	None
khalqay	méo	None
khalqigu	loạn	None
khamiis	năm	None
khamiista	năm	None
khasaaray	phí	None
khasab	bắt	None
khasbay	ép	None
khaliil	caliph	Nan
kaxaystay	đi	None
kawsaday	tiền	None
kawayn	hơn	None
karayn	thể	None
karee	kem	None
kari	sung	None
kariimka	kem	None
karim	karim	None
karin	hơn	None
karinwayadii	bếp	None
kariyey	chín	None
karkabadii	hai	None
karl	karl	Nan
karnaa	thể	None
karno	thể	None
karo	đột	None
kartaa	thể	None
kartaan	thể	None
karanle	ly	None
karale	carle	Nan
karaan	thể	None
karaamiyo	tích	None
kan	một	None
kana	bạn	Nan
kanaal	kênh	None
kanaalka	kênh	None
kanada	canada	None
kaneeco	muỗi	None
kani	này	None
karti	năng	None
kaniisad	nhà thờ	Nan
kaniisadda	nhà thờ	Nan
kaniisaddii	nhà thờ	Nan
kaqaatay	từ	None
kara	ngọc	None
karaa	thể	None
karaadsaday	cầu	None
karaamadii	tích	None
kaniisada	nhà thờ	Nan
kamma	chướng	None
kartid	thể	None
kartoonka	tông	None
kastoo	nhiên	None
kastuu	dù	None
katagay	trái	None
katahay	kate	None
katalaaniyawadanka	người	None
katalin	xúc	None
katalinaayay	xúc	None
katalinaysaykadib	sau	None
katalinjiratay	đoạn	None
katalinjirtay	đoạn	None
katay	gốc	None
katirsan	đây	None
katirsanayd	từ	None
katurjumayaa	đại	None
kaw	đến	None
kasto	điều	None
kaste	gì	None
kastana	nữa	None
kastaba	nhiên	None
karuur	hơi	None
karuurka	tăng	None
kas	kas	Nan
kasakhstan	từ	None
kasbaday	được	None
kashiisaba	họ	None
kasi	này	None
karto	thể	None
kasii	giữ	None
kasoobaxa	lên	None
kasoojeeda	đối	None
kasoojeeday	từ	None
kasoojeedeen	đâu	None
kasooo	cô	None
kasta	mỗi	None
kastaa	mỗi	None
kasoo	từ	None
ladilay	giết	None
ladin	đá	None
ladnaa	khỏe	None
magaaladda	phố	None
magaaladii	phố	None
magaaladiisii	ấy	None
magaaladu	phố	None
magaalamadaxda	thủ	None
magaalawga	phố	None
magaalda	phố	None
magaalo	phố	None
magaalomadaxda	thủ	None
magaaloobay	phố	None
magaalooyin	phố	None
magaalooyinka	phố	None
magaalooyinkan	này	None
magaalooyinkii	phố	None
magaaloyinka	phố	None
magaaladani	này	None
magaalyooyinka	phố	None
magaaladan	này	None
magaaladaan	này	None
madhaafto	kiệm	None
madhab	kiếp	None
madhabta	giáo lý	Nan
madheedh	trống	None
madigaan	này	None
madigan	điên	None
madiina	phố	None
madina	madina	Nan
madoobaa	đen	None
madoobayd	tối	Nan
madoobe	đen	None
madow	đen	None
magaaalo	phố	None
magaala	phố	None
magaalada	phố	None
magaaladaasi	phố	None
magac	tên	None
magaca	tên	None
magacaaba	tên	None
magaloyinka	phố	None
magan	pháp	None
magazine	chí	None
magool	bù	None
magoolka	dược	None
magtii	bù	None
magtiinnu	của	None
magubte	thuật	None
mahad	ơn	None
mahadaay	kết	None
mahaday	cha	None
mahadnaq	ơn	None
mahadnaqayaa	ơn	None
mahathir	ca	None
mahdi	ơn	None
magalo	phố	None
magaladan	này	None
magalada	phố	None
magacyo	tên	None
magacaabaa	tên	None
magacaabay	tên	None
magacaabi	tên	None
magacaabida	đề	None
magacaabo	tên	None
magacaabobetyeeniyaoo	namebetyiniyaoo	Nan
magacaas	đó	None
madaxweynihii	tổng	None
magacan	này	None
magacdaray	tên	None
magaceeda	ấy	None
magaciisa	ấy	None
magaciisaawaxa	là	None
magacley	tên	None
magacyada	tên	None
magacyadaas	này	None
magacbaxay	tên	None
madaxweyneyaashii	tịch	None
madaxweynenimada	tổng	None
madaxweyne	tịch	None
macnaheedu	nghĩa	None
macnahoodu	chung	None
macnayaalka	nghĩa	None
macneeyeen	có	None
macneheedu	nghĩa	None
macneyn	là	None
macnihiisa	của	None
macnihiisane	nghĩa	None
macnihiisu	nghĩa	None
macno	quan	None
macquul	hợp	None
mad	điên	None
madaafiic	pháo	None
madaama	là	None
madaarka	bay	None
macnaha	nghĩa	None
macna	nghĩa	None
macluumaad	tin	None
maclin	viên	None
maaweeliska	trí	None
maay	maay	Nan
maayo	không	None
macaamiisha	hàng	None
macaan	ngọt	None
macaanaaye	từ	None
macaanka	đường	None
madadaalada	trí	None
macad	macad	Nan
macalimiinta	viên	None
macalimiintii	viên	None
macalin	viên	None
macallimiinta	viên	None
macallin	viên	None
macalmiin	viên	None
machadka	viện	None
macalim	viên	None
mahiigaan	này	None
madagaskar	của	None
madaw	đen	None
madaxtooyadu	trí	None
madaxtooyo	trí	None
madaxwaynaha	tịch	None
madaxwaynanimada	tổng	None
madaxwaynayaasha	tịch	None
madaxwayne	tịch	None
madaxwaynew	tịch	None
madaxwaynihii	tổng	None
madaxweeynaha	tổng	None
madaxweeynihii	tổng	None
madaxwene	tịch	None
madaxweyna	tịch	None
madaxweynaha	tịch	None
madaxweynahaasi	đó	None
madaxweynahii	tổng	None
madaxtooyada	trí	None
madaxtinimada	tịch	None
madaxii	đầu	None
madaxdiin	chủ	None
madawi	đen	None
madawwaxa	đen	None
madax	đầu	None
madaxa	đầu	None
madaxbanaan	độc	None
madaxbanaani	độc	None
madaxbanaanida	độc	None
madar	điên	None
madaxbanaanidii	độc	None
madaxbannaani	độc	None
madaxbannaanidii	độc	None
madaxda	đạo	None
madaxdaas	đạo	None
madaxdeena	tôi	None
madaxdhaqameedkii	hiệu	None
madaxdii	trưởng	Nan
madaxbannaan	độc	None
maatarka	matron	Nan
maj	ngành	None
majeerteen	không	None
mari	chà	None
mariam	mariam	Nan
mariino	thuyền	None
marin	văn	None
marinayaay	thuyền	None
marine	biển	None
marinka	văn	None
marino	marino	None
mariyeen	xát	None
mariyey	xát	None
marka	nào	None
markaa	đó	None
markaad	khi	None
markaan	này	None
markaana	và	None
mareykanku	mỹ	None
markaas	đó	None
mareykanka	hoa	None
mareeyaha	đốc	None
maraykanka	hoa	None
maraykanku	mỹ	None
maraykankuna	hoa	None
marayo	qua	None
maraysa	động	None
marayso	qua	None
marba	nữa	None
march	ba	None
mareeg	mạch	None
mareekanka	mỹ	None
mareen	văn	None
mareer	ngựa	None
mareerey	diễu	None
mareergur	mareergur	Nan
mareexaan	dài	None
mareeykanka	hoa	None
markaasaa	đó	None
markaasay	đó	None
markaasey	đó	None
markiiba	ngay	None
markiidanbe	nữa	None
markiisa	ấy	None
markooda	họ	None
markuu	ta	None
marlabaad	hai	None
marmarka	thoảng	None
marna	giờ	None
marnaba	giờ	None
maro	vải	None
maroidjeex	maroidjeex	Nan
maromacawis	maromacawis	Nan
maroodi	voi	None
maroodiga	voi	None
maroodigii	voi	None
markii	nào	None
marki	này	None
markey	này	None
markes	dấu	None
markaasi	đó	None
markaasna	đó	None
markaasneh	đó	None
markaasu	đó	None
markaasuu	đó	None
markab	tàu	None
markale	nữa	None
marayaanna	nào	None
markan	này	None
markasta	nào	None
markasto	luôn luôn	Nan
markay	nào	None
markaynu	ta	None
markeeda	tự	None
markeedi	ấy	None
markeey	tôi	None
markana	này	None
marayaa	qua	None
maray	qua	None
mararka	khi	None
malaysiya	rét	None
maldiif	thìa	None
maleegayeen	đã	None
maleenaa	rằng	None
maleeshiyada	quân	None
maleeyeen	nghĩ	None
maleh	không	None
mali	ngày	None
maloo	không	None
malta	malta	None
maltisku	nha	None
mamaaliikta	bạn biết	Nan
mana	nhưng	None
manchester	manchester	None
mandab	mandab	Nan
malaysia	malaysia	None
malaynayaa	sử	None
malaheyn	nghĩ	None
malahan	tại	None
major	chính	None
maka	cho	Nan
makaahiil	hàng	None
makedonia	ma-rốc	Nan
makhaayad	hàng	None
makhsuum	makhsuum	Nan
makka	makka	Nan
mandaqada	vực	None
makordhaha	xuất	None
malaaig	thần	None
malaaigta	thần	None
malaaq	thần	None
malaaqa	lá	None
malaawi	thần	None
malaayga	tôi	None
malaha	không	None
maktabada	viện	None
majaajiliiste	hài	None
mandeela	mất	None
mandheera	mandheera	Nan
maqlayso	nghe	None
maqli	nghe	None
maqlo	nghe	None
maqnaa	mặt	None
mar	lần	None
mara	đến	None
maraa	biết rôi	Nan
maraakiibta	hàng	None
maraakiibtiisa	ấy	None
maraan	qua	None
maraaxil	ba	None
maraayaan	qua	None
maraayo	nào	None
marana	marana	Nan
marar	khác	None
maqlay	nghe	None
maqlaan	đi	None
maqcad	báo	None
maqashay	nghe	None
maneestay	mai	None
mange	mange	Nan
manger	cỏ	None
mangistu	mangistu	Nan
mangooliyakadib	mangoolgirl	Nan
mangooliyiintu	xoài	Nan
manhajka	dục	None
mandela	mandela	None
manneystay	thành	None
manta	quên	None
many	nhiều	None
mao	mao	None
maqaalada	viết	None
maqac	nghe	None
maqal	nghe	None
maqan	thiếu	None
mansuur	manna	Nan
richard	giàu	None
maasuqa	nhũng	None
maarso	ba	None
layiraahdo	là	None
layli	dục	None
layn	hàng	None
layna	lana	Nan
laysku	rỉ	None
laysu	liếm	Nan
laysugu	hàng	None
le	thể	None
league	đoàn	None
leaguesyl	giải	None
leedahay	có	None
leedahaye	hề	None
leedihiyo	hoạt	None
leefay	liếm	Nan
leegada	cỡ	None
layidhaahdaa	là	None
leelkase	đề	None
layeen	hiền	None
laydin	bạn	Nan
lasoo	đến	None
lasoomaray	sau	None
lasoonoqdeen	với	None
lawada	sẻ	None
lawareegay	tịch	None
lawareegeen	lẫn	None
lawyacaddo	kiệm	None
laxamiiste	học	None
laxda	cừu	None
laxidhay	cửa	None
lay	nằm	None
layaabka	nhiên	None
layaableh	vời	None
layaqaanaha	thuỷ	None
laydh	sáng	None
laydiray	gửi	None
leenahay	có	None
leeuwarden	chờ	None
leexatay	đi	None
leysku	phép	None
libaan	chanh	None
libaax	tử	None
libaaxa	tử	None
libaaxyada	tử	None
liban	lợi	None
libiya	đuổi	None
library	viện	None
libya	libya	None
lid	lại	None
lihi	lihi	Nan
lihiba	cấm	None
lii	lii	Nan
liibaan	công	None
liibiya	libya	None
leydiga	chữ	None
ley	ley	Nan
lewis	dục	None
level	độ	None
leexday	đi	None
leexiyo	cong	None
leeyaay	cô	None
leeyahay	nói	None
leeyahaymadaxtooyo	leeyahaymadaxtooyo	Nan
leeyahy	thế	None
leeyhiin	có	None
lasocotada	sát	None
leeyihiin	có	None
leh	với	None
lehe	sao	None
leheed	có	None
lehna	với	None
lehwaxa	với	None
leone	leone	Nan
lesotho	lesoto	Nan
legislative	pháp	None
lasiiyo	được	None
lasheegay	cập	None
lasheegaa	này	None
lagayaabo	năng	None
lagu	đến	None
lagugu	bạn	Nan
lagula	với	None
laguma	phải	None
lagumagacaabijiray	định	None
laguna	lagna	Nan
laguqiyaasaa	là	None
lagusiidaayo	báo	None
lagusoo	từ	None
laguu	với	None
laha	có	None
lahaa	có	None
lahaan	có	None
lahaanshaha	hữu	None
lagasoo	từ	None
lagaqadan	kiêng	None
lagana	từ	None
lagama	phải	None
laeego	chưng	None
laf	xương	None
lafaha	xương	None
lafalaha	xương	None
lafdhabar	sống	None
lafdhabarta	sống	None
lafoole	xương	None
lahaayeen	có	None
lafweyn	đường	None
laga	từ	None
lagaa	từ	None
lagaba	rồi	None
lagaga	từ	None
lagahayn	có	None
lagala	họ	None
lagalay	từ	None
lag	lỗi	Nan
liide	vào	None
lahab	túng	None
lahayaa	ing	Nan
lala	với	None
lama	không	None
lamana	không	None
lamid	giống	Nan
lamidawday	giống nhau	Nan
lamy	lamy	Nan
lana	qua	None
lanka	lanka	None
laos	lào	None
laqabto	kịp	None
laqwi	nuốt	None
large	lớn	None
larumaysanyahay	gọi	None
lasameeyo	đó	None
lasameynayaa	xong	None
lakin	nhưng	None
lakiin	nhưng	None
lakala	lớn	None
lajoogo	tôi	None
lahayd	có	None
lahayeen	có	None
lahayn	không	None
laheed	có	None
laheen	có	None
lahelo	sẵn	None
laheyd	có	None
lahan	không	None
laheyn	có	None
lahjada	ngữ	None
lahjadaha	ngữ	None
lahjadda	ngữ	None
lahjado	ngữ	None
laisku	laser	None
lajira	với	None
lajnado	với	None
lahirgaliyay	hiện	None
maastricht	maastricht	None
liinta	quýt	None
limited	chế	None
maalintii	ngày	None
maalintuu	ấy	None
maaliyada	áo	None
maalkeeda	của	None
maalmaha	ngày	None
maalmeede	ngày	None
maalmihii	ngày	None
maalmo	ngày	None
maalmood	ngày	None
maalqabeen	có	None
maalta	ngày	None
maamul	quản	None
maamula	quản	None
maamuladii	năng	None
maamulaha	quản	None
maalintani	này	None
maamulayeen	quản	None
maalintaas	đó	None
maalinle	ngày	None
maa	phỏng	None
maadaama	từ	None
maaha	phải	None
maahan	phải	None
maahane	phải	None
maahee	khi	None
maahmaahda	ngữ	None
maajo	ngày	None
maakhir	phải	None
maal	có	None
maala	nhất	None
maali	ngày	None
maalik	ngày	None
maalin	ngày	None
maalinba	ngày	None
maalinta	ngày	None
maamulayey	quản	None
maamulayo	quản	None
maamulayso	trị	None
maansooyinka	xây	None
maanta	nay	None
maantaba	nay	None
maantana	nay	None
maaraynta	quản	None
maareeyaha	quản	None
maareeyayaasha	quản	None
maareeye	đốc	None
maariyatul	dị	None
maarmaan	yếu	None
maarmaanka	thiết	None
maarmay	không	None
maarmayo	không	None
maaroodi	maroodi	Nan
maars	maars	Nan
maansoole	bài	None
maansoolayaashii	thầy	None
maanso	tâm	None
maanshaa	phát	None
maamuli	quản	None
maamulidda	quản	None
maamulka	quản	None
maamulkaas	chính	None
maamulkii	chính	None
maamulkiisa	ấy	None
maamulo	trị	None
ma	hoặc	None
maamusho	trị	None
maandeeq	manna	Nan
maandhaafkii	lưỡng	None
maanka	trí	None
maankii	trí	None
maansada	manna	Nan
maansadan	này	None
maansadii	kiệm	None
maan	trí	None
m	m	Nan
luuqeeyso	nói	None
luuqadaha	ngữ	None
loo	dụng	None
loodoortay	chọn	None
looga	looga	Nan
loogana	đánh nhau	Nan
loogu	cho	Nan
looka	nhập	None
lookhiyaameeyey	phát	None
loola	thức	None
looma	phải	None
loomagacaabaycismaan	tên	None
loona	sao	None
looqaybinkaraa	thành	None
lootaxaabay	thẻ	None
looyaqaan	đến	None
looyaqaana	là	None
london	london	None
loda	nên	None
locking	khóa	None
lock	khóa	None
link	kết	None
linkiga	kết	None
links	kết	None
linuks	linuks	Nan
linux	linux	None
lis	sách	None
list	sách	None
looyaqaanay	đến	None
lix	sáu	None
lixaadlehna	sáu	None
lixda	sáu	None
lixdankii	mươi	None
lixle	mươi	None
lknse	nhưng	None
lo	dụng	None
location	trí	None
lixaad	sáu	None
liiska	sách	None
looyaqaano	như	None
looyaqaany	họ	None
luqada	ngữ	None
luqadaha	ngữ	None
luqadda	ngữ	None
luqado	ngữ	None
luqadood	ngữ	None
luqadooda	họ	None
luqeedaka	ngữ	None
luqmaan	ngữ	None
luud	nhiều	None
luuliyo	tháng	None
luulyo	tháng	None
luulyokii	tháng	None
luuq	ngữ	None
luuqada	ngữ	None
luuqadaa	ngữ	None
luqad	ngữ	None
luntay	đi	None
lumin	mất	None
lumay	đi	None
looyaqano	là	None
lord	tể	None
lordi	xe	None
lower	hơn	None
lowska	hạt	None
lublin	lublin	Nan
lubnaan	lebanon	None
looyaqaanonikobolis	là	None
lug	chân	None
lughaya	chân	None
lugohooda	họ	None
lugood	chân	None
lugta	chân	None
lugtii	chân	None
lugu	lougou	Nan
luksemburg	luksemburg	Nan
lugaha	chân	None
joogay	tại	None
richman	có	None
rideen	đi	None
warsangali	báo	None
warsangeli	báo	None
warshada	máy	None
warshadaha	nghiệp	None
warshadda	máy	None
warshadii	máy	None
warshado	máy	None
warsheekh	năm	None
warshiikh	máy	None
waryeele	báo	None
was	là	None
wasaarada	bộ	None
wasaaradaha	bộ	None
wasaaradda	bộ	None
wasaaraha	sư	None
warsame	tranh	None
wasaarayaashii	bộ	None
warqado	thư	None
warmuhu	giáo	Nan
wareegi	tròn	None
wareegii	tròn	None
wareegsan	tròn	None
wareegtay	tròn	None
wareejin	khoản	None
wareejiyay	nhượng	None
wareejiyey	nhượng	None
warfaa	tin	None
warfaafinta	tin	None
wargaade	xuất	None
wargayska	báo	None
wargaysyada	báo	None
wargeyska	chí	None
wariyay	cáo	None
wariye	viên	None
warqad	thư	None
wasaare	sư	None
wasaarihii	bộ	None
wasaarihiisa	ấy	None
waxaana	ta	None
waxaanan	ta	None
waxaanay	họ	None
waxaanu	tôi	None
waxaanuu	ta	None
waxaas	đó	None
waxaasa	là	None
waxaase	là	None
waxaay	nó	Nan
waxad	bạn	Nan
waxaliilka	nuôi	None
waxan	này	None
waxana	và	None
waxanaa	là	None
waxannu	có	None
waxaan	tôi	None
waxaad	bạn	Nan
waxaa	nó	Nan
waxa	gì	None
wasakheeyey	nhiễm	None
wasaq	nhiễm	None
wasarada	bộ	None
wasi	thư	None
wasiir	sư	None
wasiirada	bộ	None
wasiirka	sư	None
wareegeen	tròn	None
wasiirkii	sư	None
wata	khác	None
watay	tại	None
watch	tay	None
wato	là	None
watto	sớm	None
waw	thương	None
wax	đó	None
wasiiro	bộ	None
waxanu	này	None
wareegay	tròn	None
wareega	tròn	None
walwaal	lo	None
wan	wan	None
wanaag	tốt	None
wanaaga	tốt	None
wanaagga	tốt	None
wanaagii	tốt	None
wanaagsan	tốt	None
wanaagsana	tốt	None
wanaagsanaa	tốt	None
wanaagsanaantaas	này	None
wanaagsani	tốt	None
wanaagsantahay	tốt	None
wanaagyaalku	đức	None
wanaagyadeena	ta	None
wane	mà	None
walow	nhiên	None
wanwanaagsan	tốt	None
wallee	wallee	Nan
waliid	vẫn	None
walaalnimo	em	None
walaalo	em	None
walaalow	trai	None
walaaltinimo	em	None
walaashma	gái	None
walaiba	gì	None
walalkiis	ấy	None
walanwal	wallanwal	Nan
walba	mỗi	None
walbaa	lần	None
walbana	sao	None
walbo	điều	None
wali	vẫn	None
waliba	cũng	None
waligiinee	tâm	None
waljamaaca	lo	None
waqiis	gian	None
waqooyi	bắc	None
waqooyiga	bắc	None
waranka	của	None
wararka	tức	None
waray	sao	None
waraye	tức	None
warbaahin	thông	None
warbaahinta	thông	None
warbixin	tin	None
warbixinta	cáo	None
warbixintii	cáo	None
warbixintiisa	ấy	None
warcelinta	hồi	None
wardheer	ngục	None
wardheere	chừng	None
wardhiigleey	wardenigley	Nan
wardhiigley	phườnghiigley	Nan
waran	thương	None
waramay	cáo	None
waraaqdii	thư	None
waraaqda	thư	None
waqoyi	nghĩ	None
waqti	gian	None
waqtiga	gian	None
waqtigaa	giờ	None
waqtigaas	đó	None
waqtigan	này	None
waqtigii	thời	None
wareegan	này	None
waqtigu	gian	None
waqtiyadii	lần	None
waqtiyo	lần	None
war	tức	None
waraabbintaadii	của	None
waraabin	nước	None
waraabinta	nước	None
waraabiyee	nước	None
waqtiyada	khi	None
waxar	trẻ	None
waxay	họ	None
waxayna	họ	None
weriyey	viên	None
west	tây	None
wexey	nói	None
wey	quá	None
weyddiiyey	ấy	None
weydiinta	hỏi	Nan
weydiisanayaa	tôi	None
weydiiso	hỏi	Nan
weydiiyey	ấy	None
weyn	quá	None
weyna	quá	None
weynaa	quá	None
weynaadeen	lên	None
weynaado	vời	None
weyne	quá	None
werintii	tức	None
weyneyd	quá	None
werinta	cáo	None
werin	sóng	None
wehel	với	None
weheliye	đồng	None
wehliye	đồng	None
wejiga	mặt	None
wejigeeda	ấy	None
weli	chưa	None
weliba	thế	None
weligayo	mãi	None
weligeed	giờ	None
weligood	giờ	None
well	tốt	None
wels	sói	None
wenlake	wenlake	Nan
wenniger	wenniger	Nan
were	dụng	None
werinaayo	cáo	None
weyneyn	quá	None
weyneynta	đại	None
weyni	quá	None
wikipediaha	wikipediaha	Nan
wikiteknoolojida	công	None
wikiwiki	wikiwiki	Nan
will	sẽ	None
windows	sổ	None
wireless	dây	None
with	với	None
wixii	gì	None
woo	woo	Nan
woowga	ồ	Nan
woqooyi	bắc	None
woqooyibari	bắc	None
woqooyiga	bắc	None
woqooyigalbeeda	bắc	None
world	giới	None
wikipedia	wikipedia	Nan
wiki	wiki	None
wiilwaal	bé	None
wiilkuu	ấy	None
weyninka	đại	None
weynta	đại	None
when	nào	None
where	đâu	None
which	mà	None
whose	ai	None
wiil	trai	None
wegenxile	wegenxile	Nan
wiilal	trai	None
wiilashooda	họ	None
wiilka	bé	None
wiilkan	này	None
wiilkii	bé	None
wiilkiina	bé	None
wiilkiisa	ấy	None
wiilkiisii	ấy	None
wiilasha	bé	None
weeyn	quá	None
weeye	là	None
weeyaane	là	None
waxsiin	cấp	None
waxsoo	số	None
waxsoosaarka	xuất	None
waxuu	ta	None
waxuuna	làm	None
waxyaabaha	thứ	None
waxyaabihii	thứ	None
waxyaabo	thứ	None
waxyaalaha	thứ	None
waxyar	chút	None
waxyoonay	cảm	None
way	đường	None
wayaaye	quên	None
wayday	thể	None
waydiin	đừng	None
waxse	gì	None
waxow	thứ	None
waxoow	số	None
waxoona	đó	None
waxaynu	tôi	None
waxba	gì	None
waxbarashada	dục	None
waxbarashadiisa	ta	None
waxbarashadiisii	ta	None
waxbarasho	dục	None
waxee	gì	None
waydiisato	bạn hỏi	Nan
waxeena	tôi	None
waxey	họ	None
waxeyna	làm	None
waxgaradka	hiểu	None
waxii	gì	None
waxka	điều	None
waxna	gì	None
waxoo	đó	None
waxeey	họ	None
walaalkiisna	ấy	None
waydiiyay	cầu	None
wayga	nhìn	None
weeba	lên	None
weecdaa	đi	None
weel	hàng	None
weelashiina	rồi	None
ween	ween	Nan
weeninkeeda	ấy	None
weer	hiện	None
weerar	công	None
weeraradaas	công	None
weeraray	công	None
weerarka	công	None
weerarkii	công	None
weeraro	công	None
weerta	dại	None
weey	tiệt	None
wee	và	None
websitka	trang	None
website	trang	None
webiga	sông	None
wayl	đường	None
wayn	quá	None
wayna	sẽ	None
waynaa	quá	None
waynaha	đại	None
waynayd	tuyệt	None
waynayn	lớn	None
waydinkii	hỏi	Nan
wayne	quá	None
ways	cách	None
waysadii	đường	None
wayska	đường	None
waysu	đừng	None
waziirkii	bộ	None
web	web	Nan
webi	sông	None
waynwaxa	quá	None
walaalkiis	ấy	None
walaalkii	trai	None
walaalkay	tôi	None
uruguay	uruguay	None
uruka	ích	None
urur	quan	None
ururada	chức	None
ururka	quan	None
ururkii	quan	None
ururo	hội	None
us	ta	None
usa	hoa	None
usaama	chắc	None
usaraysa	ngũ	None
usbuuca	tuần	None
usbuuceed	tuần	None
usc	usc	Nan
use	dụng	None
urdun	mùi	None
used	dụng	None
ur	bạn	Nan
unugyada	bào	None
ummukhalthum	ummukhalthum	Nan
umts	ừm	Nan
umukalthum	umukalthum	Nan
un	un	None
una	una	Nan
unaxariistee	tôi	None
unbaa	mừng	None
union	hiệp	None
united	kết	None
university	học	None
unlock	khóa	None
unnaxariisto	vui	None
unug	bào	None
unugga	đơn vị	Nan
unuggu	đơn vị	Nan
unugyo	bào	None
user	dụng	None
uses	dụng	None
usii	giữ	None
uyaala	ồ	Nan
uyaalka	gậy	None
v	v	None
valéry	cảm	None
varies	khác	None
venezuela	venezuela	Nan
vepfrancii	vepfrancii	Nan
vepitalii	vepitalii	Nan
vepročinma	vepročinma	Nan
vepvenäma	vepvenäma	Nan
vergleich	vergleich	Nan
voice	nói	None
vol	quyển	Nan
w	w	None
wa	sẵn	None
uxiiso	thức	None
uusan	không	None
uuraysatay	niệm	None
uur	thai	None
using	dụng	None
usoo	ta	None
ustaad	ba	None
ustaaz	năm	None
usually	thường	None
usuuroobi	mừng	None
utaaganaha	utaaganaha	Nan
ummukalthum	ummukalthum	Nan
utrecht	học	None
uuga	giả	None
uugu	tê	None
uuman	nước	None
uumanka	ẩm	None
uun	chỉ	None
uuna	quý	None
uunkanna	này	None
uu	ấy	None
ummu	trẻ	None
ummaddan	này	None
ummadda	gia	None
typically	thường	None
u	bạn	Nan
ubad	trẻ	None
ubadan	nữa	None
ubadka	bé	None
ubax	hoa	None
ubaxu	hoa	None
ucusub	newyork	Nan
uday	mai	None
uddaayey	chàng	None
udgoon	thơm	None
udgoonaa	ngửi	None
udgoonka	thơm	None
udheer	vào	None
udub	đích	None
tvga	tvga	Nan
tv	truyền hình	Nan
tuxmo	tucks	Nan
tuwaaxid	đến	None
tuu	phi	Nan
tuug	trộm	None
tuugo	trộm	None
tuulada	làng	None
tuuladii	làng	None
tuulo	làng	None
tuulooyin	làng	None
udubdhexaad	của	None
tuulooyinka	làng	None
tuur	phi	Nan
tuuray	viên	None
tuurayaan	đi	None
tuurayn	đúc	None
tuure	viên	None
tuuro	viên	None
tuuryare	thương	None
tuuniisiya	học	None
waa	là	None
udug	thơm	None
uga	các	None
ujeedadoodu	họ	None
ujeeddadiisu	đích	None
ujeeddo	đích	None
ukala	nguyện	None
ukrain	tiểu	None
ul	gậy	None
ula	các	None
ulajeedadaydu	tôi	None
ulasoo	liu	None
uma	phải	None
umada	gia	None
umadda	gia	None
ummad	gia	None
ummada	gia	None
ummadaha	gia	None
ujeedadiisa	ấy	None
ujeedada	đích	None
uguwayn	chính	None
uguna	ngừ	None
ugaadha	bắn	None
ugaandha	cái	None
ugaarka	bắn	None
ugaarta	bắn	None
ugaas	trưởng	Nan
ugaaska	trưởng	Nan
ugama	không	None
ufakaday	đi	None
ugana	đột	None
ugandheeska	trứng	None
ugasoo	đây	None
ugu	bơm	None
ugudhaw	lại	None
ugudheer	nhất	None
uguhoraysay	cùng	None
ugumaydhigin	với	None
ugandha	mẹ	None
wow	ồ	Nan
waaba	bình minh	Nan
waabari	bình minh	Nan
wadaniga	nước	None
wadaniyeed	nước	None
wadaniyiin	nước	None
wadanka	gia	None
wadankaa	đó	None
wadankaan	này	None
wadankaas	đó	None
wadankaasi	đó	None
wadankan	này	None
wadankani	này	None
wadankanlaakiin	này	None
wadankii	gia	None
wadanku	gia	None
wadanmada	nước	None
wadarta	bộ	None
wadani	cha	None
wadata	cấp	None
wadan	gia	None
wadamo	gia	None
wadaagaa	sẻ	None
wadaagaan	sẻ	None
wadaagan	sẻ	None
wadaagsano	sẻ	None
wadaagta	đồng	None
wadaagtaa	sẻ	None
wadaagtaane	này	None
wadaan	xe	None
wadada	đường	None
wadahadal	luận	None
wadahadalo	chuyện	None
wadajir	với	None
wadajirka	với	None
wadama	idama	Nan
wadamada	gia	None
wadamu	wadamu	Nan
waday	tục	None
wadda	mà	None
waddada	đường	None
wakhtigaas	đó	None
wakhtigaasi	đó	None
wakhtigan	này	None
wakhtigii	gian	None
wakhtigiisii	ấy	None
wakiil	quyền	None
wakiilada	đại	None
wakiilka	đặc	None
wal	wal	Nan
walaal	trai	None
walaalaha	em	None
walaalaheed	ấy	None
walaalahooda	họ	None
walaaleeyaan	trai	None
walaalkaa	của	None
wakhtigaa	đó	None
wakhtiga	gian	None
wakhti	gian	None
wakaalada	đại	None
waddamada	gia	None
waddan	gia	None
waddanka	gia	None
waddankiisa	ấy	None
waddo	đường	None
wade	lội	None
wadeen	dẫn	None
wadaaga	sẻ	None
wadnaha	tim	None
wadooyinka	phố	None
wafdi	đoàn	None
wahab	đến	None
wajeer	ngoài	None
waji	mặt	None
wajib	bắt	None
wajiis	mặt	None
wado	xe	None
wadaadkii	mục	None
wadaadka	thầy	None
wadaad	sư	None
waalba	hoặc	None
waalid	mẹ	None
waamid	gọi	None
waamo	không	None
waan	sẽ	None
waana	là	None
waanada	hào	None
waannu	sẽ	None
waano	hào	None
waar	đến	None
waariyoo	các	None
waarku	ngu	None
waasidan	hơn	None
waasoo	mà	None
waasuge	lớn	None
waalaalow	lòng	None
waakaas	đó	None
waakaa	là	None
waajibnimada	nhiệm	None
waabeeye	bình minh	Nan
waaberi	bình minh	Nan
waad	bạn	Nan
waadi	tìm	None
waadigii	lầm	None
waadna	là	None
waafajiyaa	để	None
waataan	này	None
waafaqsan	hợp	None
waaga	cuồng	None
waagaas	đó	None
waagii	ngày	None
waagu	bình minh	Nan
waajib	nhiệm	None
waajibaadkeeda	của	None
waajibka	nhiệm	None
waafi	đủ	None
waabarei	sáng	None
waataas	đó	None
waaween	hơn	None
wabiga	sông	None
wabiyaal	sông	None
wabiyada	sông	None
wacad	thề	None
wacan	tốt	None
wacays	gọi	None
wacbuudhan	tốt	None
wacdi	thuyết	None
wacdiga	rao	None
wacdiyow	thuyết	None
waceys	gọi	None
waceysle	thuật	None
wacyigelinta	thức	None
wada	với	None
wadaa	xe	None
wabi	sông	None
wabarka	tức	None
wabar	wbab	Nan
waayo	cho	Nan
waaweyn	lớn	None
waaweynaa	quá	None
waaweyneyd	quá	None
waax	ban	None
waaxaa	ban	None
waaxda	ban	None
waayadaas	đó	None
waawayn	lớn	None
waayadii	quá	None
waaye	họ	None
waayeel	anh	None
waayeen	thể	None
waayey	mất	None
waayihii	lần	None
waayitaanka	mất	None
waaylahayad	ta	None
waayay	đi	None
tutorial	dẫn	None
woxoo	gì	None
wsaare	viên	None
yaaley	đó	None
yaalla	sẵn	None
yaallaa	sẵn	None
yaalley	nằm	None
yaallo	sẵn	None
yaalo	đó	None
yaan	này	None
yaanyada	chua	None
yaaqshiid	bạn biết	Nan
yaasha	yasa	Nan
yaasiin	yasin	Nan
yabaal	dụ	None
yabar	mừng	None
yabaroow	ơn	None
yabarow	yabarow	Nan
yaaleen	làm	None
yacqoob	lên	None
yaale	tốt	None
yaalaan	sẵn	None
xusseen	ý	None
xusuus	ức	None
y	y	None
ya	nó	Nan
yaa	who	Nan
yaab	nhiên	None
yaabaa	có	None
yaabaha	quan	None
yaabay	tự	None
yaabeen	ngạc	None
yaabo	có	None
yaaceen	vàng	None
yaal	nằm	None
yaala	nằm	None
yaalaa	lanhung	Nan
yaalay	đó	None
yacquub	jacob	None
yada	lan	None
yadii	yada	Nan
yaraan	hụt	None
yaraantiisii	ấy	None
yaraatee	nhất	None
yarayd	nhỏ	None
yare	ngữ	None
yarixunkaas	đó	None
yaroo	yahoo	Nan
yartahay	nhỏ	None
yaryahay	nhỏ	None
yaryar	nhỏ	None
yaryaryihiina	tôi	None
yasid	thường	None
yaso	tìm	None
yaxye	john	Nan
yeber	yeber	Nan
yaraa	hơn	None
yar	ít	None
yaqaano	quen	None
yaqaanno	đến	None
yaduna	sân	None
yahanad	quỷ	None
yahay	là	None
yahaye	vâng	Nan
yahayna	là	None
yahey	vâng	Nan
yahuuda	thái	None
xuso	đến	None
yahuudda	thái	None
yaman	yaman	Nan
yamen	yamen	Nan
yaqaan	đến	None
yaqaanaa	biết	Nan
yaqaanay	đến	None
yaqaaneen	đến	None
yaqaannay	đến	None
yamaan	ya	None
yeedhay	là	None
xusnay	cập	None
xuska	hồi	None
xudur	dây	None
xuduud	giới	None
xuduuda	giới	None
xuduudaha	giới	None
xuduudka	giới	None
xuduudo	giới	None
xujeyda	tôi	None
xukumada	quyền	None
xukumay	giá	None
xukumayay	giá	None
xukumayey	giá	None
xukumi	phán	None
xukumina	tôi	None
xukumo	bản án	Nan
xukun	xét	None
xubnihii	viên	None
xukunka	xét	None
xubnaha	viên	None
xorta	phí	None
xoraynta	phóng	None
xoreeyay	phóng	None
xoreynta	phóng	None
xoriyad	do	None
xoriyada	do	None
xornimada	độc	None
xornimadda	độc	None
xornimadii	độc	None
xornimadiisa	độc	None
xornimadooda	họ	None
xornimadoodii	họ	None
xornimo	độc	None
xoroobeen	phí	None
xoroowday	phí	None
xorriyaadka	do	None
xubin	viên	None
xukunkii	xét	None
xukunto	phán	None
xukuumad	quyền	None
xuquuqda	quyền	None
xuquuqdii	quyền	None
xuquuqdooda	họ	None
xuquuqul	quyền	None
xurnima	do	None
xuruufta	thư	None
xusan	cập	None
xusay	ý	None
xusayna	cập	None
xusaysaa	niệm	None
xuseen	ý	None
xuseenow	nhớ	None
xusen	cập	None
xusi	lại	None
xusid	đến	None
xuquuq	quyền	None
xun	xấu	None
xumuy	xấu	None
xumo	xấu	None
xukuumada	quyền	None
xukuumadda	quyền	None
xukuumaddii	quyền	None
xukuumaddiisii	ấy	None
xukuumaddu	quyền	None
xukuumadihii	phủ	None
xukuumadii	quyền	None
xuskooda	họ	None
xulafaddii	đồng	None
xulka	đội hình	Nan
xulufo	đồng	None
xumaa	xấu	None
xumaaday	tiếc	None
xumaan	ác	None
xumaanta	ác	None
xumi	xấu	None
xulafadiisii	ấy	None
yeedho	gọi	None
yeel	đi	None
yeelaha	làm	None
العلامة	anh	None
القرآن	anh	None
القرن	anh	None
الكتب	anh	None
اللغة	anh	None
الله	anh	None
المد	anh	None
المكتبة	nha	None
المنتخب	nha	None
النبي	anh	None
النسائي	việt	None
بسم	.	Nan
بعد	hồi	None
تخريج	خججج	Nan
ثم	.	Nan
العربية	anh	None
حروف	حروف	Nan
العراق	anh	None
الصالحات	việt	None
أعلم	.	Nan
أن	.	Nan
أنا	أنا	Nan
أنه	هنه	Nan
ابن	thiệu	None
الأئمة	việt	None
الترغيب	anh	None
الحديث	việt	None
الرحيم	việt	None
الرد	việt	None
الردُّ	việt	None
الرشيد	việt	None
الساكنة	việt	None
السلام	việt	None
الشيخ	anh	None
الصومال‎	việt	None
حكم	.	Nan
داود	sinh	None
ربيع	ảnh	None
لا	chơi	None
للبخاري	tử	None
للمنذري	tử	None
لن	chơi	None
لها	chơi	None
ما	ما	Nan
مثل	مثل	Nan
مخطوطات	để	None
مقديشو	مديشو	Nan
مهدي	nay	None
مُجدّدُ	theo	None
هذا	.	Nan
هو	.	Nan
والموضوعة	والموضوعة	Nan
وسلم	nay	None
كتب	كتب	Nan
كتاباً	ًببً	Nan
كتاب	hồi	None
قال	là	None
رحمه	nay	None
رسالة	nay	None
رسول	nay	None
شيخ	شيخ	Nan
ص	ص	Nan
صفة	صفة	Nan
صلاة	nay	None
أشهد	أش	Nan
صلى	ى	Nan
عبد	عبد	Nan
عدا	.	Nan
علمي	علمي	Nan
على	ى	Nan
عليه	عليه	Nan
فقه	فقه	Nan
فهرس	فهرس	Nan
ضعيف	ضعيف	Nan
أحمد	nay	None
أحكام	.	Nan
أحاديث	nay	None
yidhaahdaa	nói	None
yidhaahdaan	nói	None
yidhaahdo	nói	None
yidhi	nói	None
yihii	là	None
yihiin	tôi	None
yihin	này	None
yiil	có	None
yimaada	đến	None
yimaadaan	đến	None
yimaadeen	đến	None
yimaado	đến	None
yimi	nào	None
yimid	đến	None
yimiday	đến	None
yemen	yemen	None
yeesho	có	None
yeesheen	có	None
yeeshee	nhiên	None
yeelan	có	None
yeelatay	làm	None
yeelato	có	None
yeelay	vì	None
yeeleen	làm	None
yeeli	đi	None
yeelo	đi	None
yiqiin	thi	None
yeera	nào	None
yeeray	triệu	None
yeeri	râu	None
yeero	gọi	None
yeertay	triệu	None
yeesha	có	None
yeeshaan	có	None
yeeshay	có	None
yeeraa	gọi	None
xorayneed	ấy	None
yir	vâng	Nan
yiraah	nói	None
yusuf	yusuf	Nan
yuu	yuuu	Nan
yuusf	giuse	None
yuusuf	giuse	None
zanzibar	sẽ	None
zaylac	zaylac	Nan
zeilac	zeilac	Nan
zenawi	zenawi	Nan
zoppe	zoppe	Nan
zubeyr	tiêu	None
|	|	Nan
´	&#39;	Nan
´ka	một	None
´siyo	không	None
أبي	أبي	Nan
yurubwaana	châu	None
yurubta	châu	None
yurubiyaanka	châu	None
yurubcismaaniyiintu	châu	None
yiraahdaa	nói	None
yiraahdaan	nói	None
yiraahdeen	rằng	None
yiraahdo	nói	None
yiraaho	nói	None
yiri	giống	Nan
yoonis	yonis	Nan
yiraa	nói	None
yoorada	sẽ	None
youth	niên	None
yugandha	nhật bản	Nan
yuhuuda	thái	None
yuhuudiyah	thái	None
yuhuudu	thái	None
yunusba	đói	None
yurub	châu	None
york	york	None
xorayday	kẹt	None
xor	phí	None
xoosh	ngứa	None
xamsa	băm	None
xamuud	hàng	None
xamuulka	hàng	None
xan	mach	None
xanaanada	mẫu giáo	Nan
xanaaneeyo	họ	None
xanaaqay	bội	None
xanafiga	dày	None
xanbaarsan	chở	None
xanta	mach	None
xanuun	đau	None
xanuunsaday	đựng	None
xanuunsan	sẽ	None
xaq	đúng	None
xaqa	thật	None
xamarweyne	ở	None
xaqiijinteeda	để	None
xamarka	su	None
xamare	câu	None
xajin	chặt	None
xajineyso	kịp	None
xajka	hương	None
xajkii	hương	None
xakiim	ngoan	None
xakumi	quyền	None
xal	pháp	None
xalaasha	pháp	None
xalane	halala	Nan
xali	rối	None
xaliimo	ấy	None
xalin	rối	None
xalliyaan	giải	None
xamar	xamar	Nan
xamardaye	thảm	None
xamarjajab	nghiệm	None
xaqiiqa	thực	None
xaqiiqada	thực	None
xaqiiqda	thực	None
xarun	tâm	None
xarunta	tâm	None
xaruntii	tâm	None
xaruunta	tâm	None
xasan	ý	None
xasar	gia	None
xasilooni	định	None
xasiloonida	định	None
xassan	tĩnh	None
xasuuq	sát	None
xasuuqa	chủng	None
xasuuqan	này	None
xasuuqay	sát	None
xasuuqday	sát	None
xasuus	ức	None
xarumo	chất	None
xarumaha	tâm	None
xarrago	lịch	None
xariir	lụa	None
xaqiiqo	thực	None
xaradh	bài	None
xaradheere	phát	None
xaraf	thư	None
xarafka	cái	None
xarafkiisa	ấy	None
xarafle	thư	None
xaji	kịp	None
xarafluhuna	thư	None
xarakada	động	None
xarakadu	động	None
xaramkii	niềm	None
xarardheere	dây	None
xarfaha	thư	None
xarfahan	này	None
xariiqay	vẽ	None
xarafyada	thư	None
xajarulaswadka	hoa	None
xaggeeda	ấy	None
xaggee	đâu	None
xaafadda	phố	None
xaafadii	cận	None
xaafadood	ngoại	None
xaafidiin	của	None
xaafiiska	phòng	None
xaaji	lên	None
xaal	trạng	None
xaalada	huống	None
xaaladaha	kiện	None
xaaladda	tình	None
xaaladdu	huống	None
xaaladihii	cảnh	None
xaaraam	pháp	None
xaarith	haarith	Nan
xaas	vợ	None
xaafadaha	phố	None
xaafada	phố	None
xaafad	cận	None
xaadirka	tại	None
wuqooyi	bắc	None
wuu	ta	None
wuuna	ấy	None
wuuxuna	sẽ	None
wuxaa	là	None
wuxu	ta	None
wuxuna	tệ	None
xaashi	tấm	None
wuxuu	ta	None
wuxuuo	heo	None
ww	tuần	None
wwii	wwii	Nan
wxa	bên	None
wxaa	là	None
x	x	Nan
xaad	tóc	Nan
wuxuuna	ta	None
xasuusan	lại	None
xaaskii	vợ	None
xaasuubka	thuật	None
xaduud	giới	None
xafidka	bảo vệ	Nan
xafiis	phòng	None
xafiiska	phòng	None
xafiisyada	phòng	None
xafiisyadii	phòng	None
xafiisyo	phòng	None
xafladan	này	None
xag	góc	None
xaga	phía	None
xagaa	hè	None
xagaagii	hè	None
xagaas	đó	None
xagga	từ	None
xaggaaga	với	None
xadka	giới	None
xadiiskan	này	None
xadiiska	hói	Nan
xadhig	thừng	None
xaasuubkiisa	ấy	None
xaawo	hôi	None
xaayow	phát	None
xabaal	mộ	None
xabad	ngực	None
xabasha	dán	None
xabashida	chôn	None
xaaskiisii	ấy	None
xabsi	tù	None
xabsigii	tù	None
xad	giới	None
xadaarad	văn	None
xadaaradahii	mèo	None
xaddaaradda	vườn	None
xaddiiska	số	None
xadgudbay	dụng	None
xabsiga	tù	None
woxoona	sao	None
xasuustaa	nhớ	None
xasuustiisana	ấy	None
xiran	cửa	None
xiray	tắt	None
xiraye	nối	None
xirfad	năng	None
xirfada	nghiệp	None
xiri	tắt	None
xiriir	xúc	None
xiriira	quan	None
xiriiraan	giao tiếp	Nan
xiriiri	xúc	None
xiriiriyaha	lạc	None
xiriirka	hệ	None
xiriirto	xúc	None
xirnaa	cửa	None
xirneen	miệng	None
xir	tắt	None
xirnimo	kín	None
xingalool	ran	None
xilliyo	mùa	None
xiligan	này	None
xiligii	giờ	None
xiligiimuraadkii	đại	None
xiliyada	mùa	None
xiliyadii	mùa	None
xiliyo	lần	None
xilka	nhiệm	None
xilkaas	đó	None
xilkeeda	ấy	None
xilli	mùa	None
xilligaa	đó	None
xilligaas	đó	None
xilligaasi	đó	None
xilligan	này	None
xilligii	mùa	None
ximyar	trẻ	None
xirsi	ấy	None
xirta	tắt	None
xirtaa	miệng	None
xooga	điểm	None
xoogaa	số	None
xoogag	lực lượng	Nan
xoogan	mạnh	None
xoogana	mạnh	None
xoogaysteen	mạnh	None
xoogga	mạnh	None
xoojinta	nhất	None
xoola	đàn	None
xoolaha	nuôi	None
xoolaheeda	ấy	None
xoolaley	súc	None
xoolihii	động	None
xoolo	nuôi	None
xooluhuna	nuôi	None
xoog	mạnh	None
xogo	tin	None
xoghayaha	ký	None
xoghaya	ký	None
xirtaan	mặc	None
xisaab	học	None
xisaabaadka	khoản	None
xisaabin	toán	None
xisaabta	học	None
xisaabtan	trình	None
xisbi	tiệc	None
xiligaasoo	đó	None
xisbiga	tiệc	None
xisbigiisa	ấy	None
xisbiyada	tùng	None
xisbiyo	tùng	None
xishoon	hổ	None
xitaa	cũng	None
xkhayre	lái	None
xog	tin	None
xisbigii	tiệc	None
xiligaasi	đó	None
xiligaas	đó	None
xiligaa	đó	None
xeeran	quanh	None
xeerar	tắc	None
xeerarka	tắc	None
xeerarkeeda	của	None
xeerka	tắc	None
xeraale	trại	None
xerada	trại	None
xero	trại	None
xh	xh	Nan
xhks	xhks	Nan
xidh	tắt	None
xidha	tắt	None
xidhaayey	tắt	None
xidhay	tắt	None
xidhiidh	xúc	None
xeer	định	None
xeelliga	cảnh	None
xeeldheeri	thuật	None
xeeldheer	thuật	None
xasuusto	lại	None
xataa	cũng	None
xawaadle	tốc	None
xawaaladaha	kiều hối	Nan
xawaannada	độ	None
xawda	độ	None
xayaawaanaadka	động	None
xidhiidha	quan	None
xayawaan	động	None
xayle	mập	None
xds	xds	Nan
xeeb	biển	None
xeebaha	biển	None
xeebeed	biển	None
xeebta	biển	None
xeel	khéo	None
xayawaanaadka	động	None
xasuustaan	lại	None
xidhiidhka	giao tiếp	Nan
xidhiidhno	lạc	None
xigto	người	None
xiiirto	râu	None
xiiray	cạo	None
xiiseyneysid	thú	None
xiiso	dẫn	None
xijaaz	xijaaz	Nan
xijrootay	mày	None
xikmad	ngoan	None
xil	nhiệm	None
xilagan	này	None
xilal	nhiệm	None
xildhibaan	mp	None
xilgii	gian	None
xili	đoạn	None
xiliga	mùa	None
xigtay	kế	None
xigtaa	theo	None
xigta	kế	None
xigo	kế	None
xidhiidho	lạc	None
xidhka	mặc	None
xidhkii	các	None
xidhnaan	miệng	None
xidhnaantii	miệng	None
xidho	mặc	None
xidid	gốc	None
xidhiidhkaasi	đó	None
xifdin	giữ	None
xigaa	kế	None
xigaan	theo	None
xigay	kế	None
xigeen	xa	None
xigeenka	xa	None
xigeenkii	úy	None
xigmadda	ngoan	None
xiga	kế	None
tuso	chỉ	None
tusaayo	ý	None
tusaan	đi	None
shacbigu	cộng	None
shaciga	luật	None
shadoor	trời	None
shahaadada	độ	None
shahaadataynku	chứng nhận	Nan
shahaado	độ	None
shahiirsanadii	rợ	None
shaki	nghi ngờ	Nan
shalaanbood	mừng	None
shalay	qua	None
shan	uống	None
shanaad	năm	None
shanaadwaxaana	năm	None
shanfarood	năm	None
shanta	năm	None
shacbigii	cộng	None
shantaan	này	None
shacbigana	dân	None
shacbi	cộng	None
shabac	shabab	Nan
shabahdaa	đó	None
shabakad	web	Nan
shabakada	trang	None
shabeel	hổ	None
shabeelaha	hổ	None
shabeellaha	hổ	None
shabeelle	shabelle	Nan
shabele	shabele	Nan
shabelle	shabelle	Nan
shacab	dân	None
shacabka	dân	None
shacabkii	cộng	None
shacabkooda	họ	None
shacabku	cộng	None
shacbiga	cộng	None
shantaasi	đó	None
shaqaalaha	viên	None
shaqaale	viên	None
shaqeynaya	việc	None
shaqeynayay	việc	None
shaqeysata	việc	None
shaqo	việc	None
shaqooyinka	làm	None
shaqsi	cá nhân	Nan
shaqsiyaad	cá nhân	Nan
shaqsiyaadka	cá nhân	Nan
sharaf	kính	None
sharafkii	kính	None
sharafta	phẩm	None
sharaxday	giải	None
sharci	luật	None
sharciga	luật	None
sharcigaa	luật	None
shaqeeyo	việc	None
shaqeeyey	việc	None
shaqeeyeen	việc	None
shaqeeyay	việc	None
shaqaalihii	công	None
shaqaaq	xáo	None
shaqada	việc	None
shaqadii	việc	None
shaqadiisa	ta	None
shaqal	âm	None
shaqalka	âm	None
shabaabka	mạng	Nan
shaqayn	việc	None
shaqaysay	việc	None
shaqeen	việc	None
shaqeesa	tự	None
shaqeesaa	làm	None
shaqeeya	việc	None
shaqeeyaa	làm	None
shaqeeyaan	việc	None
shaqaynta	việc	None
sharcigu	luật	None
shaati	áo	None
shaam	shaam	Nan
saxaarada	mâm	None
saxaaro	đẩu	None
saxaraa	đẩu	None
saxaraha	phân	Nan
saxda	chính	None
saxeexday	ký	None
saxeexdeen	ký	None
saxiixday	ký	None
saxiixdeen	ký	None
saxo	chính	None
saxons	saxophone	Nan
say	nói	None
sayid	thầy	None
sayidka	chúa	None
sayidku	thầy	None
saxaafadda	chí	None
saylac	nói	None
saxaafada	chí	None
sax	chính	None
sarkaalkii	quan	None
sarkozy	sarkozy	Nan
sarreeye	cao	Nan
sasha	sasha	Nan
sasiiliya	sapphire	Nan
saudi	saudi	None
sawaaxiliga	tiếng	None
sawir	chụp	None
sawirada	ảnh	None
sawiran	hình	Nan
sawiray	ảnh	None
sawiraya	vẽ	None
sawirka	ảnh	None
sawirmaan	tranh	None
sawirro	ảnh	None
saxaabi	chính	None
saylada	trường	None
saylici	thầy	None
saynis	học	None
senator	nghị	None
sep	kín	None
serbia	serbia	None
servant	hầu	None
service	dịch	None
services	dịch	None
several	số	None
seyfi	sefi	Nan
seynab	zaynab	Nan
sgaas	gà	None
sh	sh	Nan
shaac	báo	None
shaafici	trang	None
shaah	trà	None
shaahii	trà	None
seexday	ngủ	None
seexan	ngủ	None
seegaaya	cô	None
sedex	ba	None
sayniska	học	None
schleicher	sinh	None
school	học	None
schoolership	sinh	None
schoolka	học	None
schools	học	None
scw	scw	Nan
shaarub	ria	Nan
sdarbi	một	None
sebteembar	chín	None
sebtembar	chín	None
second	hai	None
secondary	hai	None
section	phần	None
security	vệ	None
sede	sao	None
sdwo	thăm	None
sharciya	pháp	None
sharciyada	pháp	None
sharciyeed	pháp	None
shinema	sáng	None
shingaani	cản	None
shiniile	sấu	None
shir	nghị	None
shirakadahani	này	None
shirarkii	nghị	None
shirdahan	này	None
shire	shire	Nan
shirkaa	nghị	None
shirkaas	đó	None
shirkad	ty	None
shirkada	ty	None
shirkadaha	ty	None
shirkadahaas	đó	None
shirkadahan	này	None
shineemo	phim	None
shirkadahani	này	None
shimbiruhu	chim	None
shimbiraha	chim	None
shige	hợp	None
shiikh	gia	None
shiikha	shiikha	Nan
shiikhu	shiikhu	Nan
shiinaha	trung	None
shiinuhu	trung	None
shiiq	shiiq	Nan
shiiqaal	tiệt	None
shiiraar	dầu	None
shil	nạn	None
shilaabo	mừng	None
shilin	shilling	Nan
shilinka	của	None
shilling	run	None
shimbir	chim	None
shimbiro	chim	None
shirkadda	ty	None
shirkado	ty	None
shirkadood	ty	None
siday	như	None
sidda	như	None
side	bên	None
sidee	sao	None
sideed	tám	None
sideedaad	tám	None
sideedan	này	None
sideedii	tám	None
sideetameeyadii	mươi	None
sidey	mang	None
sidi	giống	Nan
sidii	như	None
sidiisii	ấy	None
sido	mang	None
sidoo	cũng	None
sidatan	như	None
sidan	này	None
sidae	sao	None
sidaasi	hợp	None
shirkan	này	None
shirki	định	None
shirkii	chúng	None
shiro	lặng	None
shirqool	mưu	None
shirweynahan	này	None
shisheeye	ngoại	None
shift	ca	None
shuceyb	cô	None
siad	đẩy	None
siciid	thể	None
sida	như	None
sidaa	thế	None
sidaad	sao	None
sidaan	này	None
sidaas	thế	None
si	đến	None
shido	bật	None
shiday	lên	None
shidaalka	liệu	None
shayga	đối	None
shcali	dụ	None
sheeg	nói	None
sheega	nói	None
sheegaa	thường	None
sheegaan	nói	None
sheegaas	quả quyết	Nan
sheeganaya	cầu	None
sheegay	nêu	None
sheegaya	cập	None
sheegayaa	cập	None
sheegayaan	nói	None
sheegayo	cập	None
sheegeen	nêu	None
sheegey	thường	None
shaydaan	satan	Nan
shaybah	shaybah	Nan
shay	vật	Nan
shaxda	bàn	None
sharciyeynaayey	pháp	None
sharciyo	tắc	None
shardi	trạng	None
shardiga	trạng	None
shareecada	sharia	Nan
sharif	nét	None
shariif	sharif	Nan
sheegganaa	cầu	None
shariifka	sát	None
sharkiisa	ấy	None
sharkiisaba	ấy	None
sharmaarke	ác	None
sharmaarkeعبد	luận	None
sharmake	sharmake	Nan
shatt	shatt	Nan
shax	bàn	None
shariifku	kệ	None
sarkaal	phòng	None
sheegganayd	thường	None
sheegi	nói	None
sheekhu	chuyện	None
sheekhulislaam	sheikhulislam	Nan
sheeko	chuyện	None
sheekooyinka	chuyện	None
sheekooyinkii	chuyện	None
sheikh	sheikh	Nan
shekh	ấy	None
sheyba	sheaba	Nan
sheydaankii	quỷ	None
shibane	shiban	Nan
shibil	nạn	None
shibilka	nạn	None
shibis	nghị	None
shicibka	cộng	None
shidaal	liệu	None
sheekhii	chuyện	None
sheekheena	ta	None
sheekhaal	chuyện	None
sheekha	chuyện	None
sheegin	chưa	None
sheegnay	cập	None
sheegnaya	cập	None
sheegnayba	thần	None
sheego	nói	None
sheegsheegta	cầu	None
sheegta	cầu	None
sheeggayga	tôi	None
sheegtaa	thường	None
sheegtada	cầu	None
sheegtay	thường	None
sheegto	cầu	None
sheekada	chuyện	None
sheekayn	chuyện	None
sheekayno	chuyện	None
sheekh	sheikh	Nan
sheegtaan	cầu	None
sarifo	đổi	None
sarfiga	đổi	None
sareysa	cao	Nan
saara	tẩy	None
saaraa	bỏ	None
saaraan	bỏ	None
saaran	trên	None
saaray	dập tăt	Nan
saarayso	trừ	None
saareen	thở	None
saarey	qua	None
saari	tẩy	None
saarida	trừ	None
saarka	phẩm	None
saarkeeda	đó	None
saarkooda	họ	None
saarnaa	trên	None
saaro	bỏ	None
saar	tẩy	None
saartaa	trên	None
saanmarino	sư	None
saan	này	None
saabsan	khoảng	None
saabsanaa	khoảng	None
saacad	giờ	None
saacada	giờ	None
saacadaha	giờ	None
saadka	cần	None
saaiidi	và	None
saalax	xin	None
saamaxday	ân	None
saamaxeen	ân	None
saamaynta	ứng	None
saamaysay	hưởng	None
saambiya	sapphire	Nan
saami	lệ	None
saamo	phần	None
saanad	năm	None
saartay	dập tăt	Nan
saas	thế	None
saaxiib	bạn	Nan
sabtida	bảy	None
sabtiga	bảy	None
sac	bò	None
sacad	lều	None
sacaridalaxdageelka	đập	Nan
saciid	bọt	None
sacuudi	rập	None
sacuudiga	thần	None
sadaam	buồn	None
sadaan	s	Nan
sadam	buồn	None
sadamna	buồn	None
sadaqada	thiện	None
sadaqo	thiện	None
sadax	ba	None
sabti	bảy	None
sabriye	hoại	None
saboolsan	nghèo	None
sabool	nghèo	None
saaxiibka	bạn	Nan
saaxiibtinimo	nghị	None
saaxiibtinnimo	nghị	None
saaxiil	thuật	None
saaxil	thuật	None
sab	do	None
saba	quán	None
sa	bộ	None
sabab	do	None
sababay	gây	None
sababeen	gây	None
sababta	sao	None
sababtay	gây	None
sababto	nguyên	None
sababtoo	vì	None
sablaale	trượt	None
sababaha	do	None
s	s	Nan
ruwanda	nước	None
ruuxna	ai	None
roma	roma	Nan
romaankuba	lựu	None
roman	roman	Nan
romania	rumani	None
romanku	roman	Nan
rome	chrome	None
roob	mưa	None
roobab	mưa	None
roobka	mưa	None
roobkana	mưa	None
roobku	mưa	None
rooble	cầu	None
roobleh	cầu	None
roof	mái	None
rooma	lựu	None
rogrogan	xoắn	None
rogaye	xoắn	None
rogay	ngược	None
roelof	gầm	Nan
ridey	bay	None
rido	đầu	None
rigliga	khoan	None
rinjiga	sơn	None
river	sông	None
riyaale	mơ	None
riyada	mơ	None
roomaaniyiinta	mã	None
riyadaas	ấy	None
riyadoodii	họ	None
riyaha	dê	None
riyo	mơ	None
roaming	vùng	None
robust	mẽ	None
rodes	ngựa	None
rodolfo	poundolfo	Nan
riyadii	mơ	None
sadaxaad	ba	None
roomaanka	mã	None
roon	tốt	None
rumeysan	tin	None
rumeysey	đi	None
run	thật	None
runta	thật	None
runtii	thật	None
runtiisa	thật	None
ruqiya	hỏng	None
ruqiyo	ảo tưởng	Nan
rususha	rắc	None
rusushii	lái	None
ruug	hơn	None
ruush	nga	None
ruushka	nga	None
ruux	thần	None
ruuxii	thần	None
rumeyn	đi	None
rumeeyo	đi	None
rumeeyay	tin	None
rumeeyana	đi	None
roone	roon	Nan
rooraaye	vùng	None
rootiga	mỳ	None
rotterdam	rotondon	Nan
rpp	rpp	Nan
rugta	ong	None
rukuucda	chế	None
roomaanku	rumani	None
rumawdo	rumawdo	Nan
rumaynta	tin	None
rumayntooda	họ	None
rumayntu	tin	None
rumaynu	tin	None
rumaysan	tin	None
rumaysanyahay	tin	None
rumayso	đi	None
rumaynayo	đi	None
sidookele	thế	None
sadaxaadna	ba	None
saddax	ba	None
sameeyo	làm	None
sameyn	làm	None
sameysa	làm	None
sameyso	đi	None
sameystay	hiện	None
samidiyo	video	Nan
samir	nhẫn	None
samo	tìm	None
samow	chào	None
samroon	sambar	Nan
samsamka	sams	Nan
samyn	làm	None
san	biết rôi	Nan
sanaag	chảy	None
sanad	năm	None
sameeyey	làm	None
sanadadii	năm	None
sameeyeen	làm	None
sameeyawaa	không	None
samaawiga	trời	None
samada	đường	None
samaron	có	None
samaroon	trời	None
samaroonku	trời	None
samatalis	sinh	None
samatar	luật	None
samayn	làm	None
samaynaya	làm	None
samaysan	hiện	None
samaysay	làm	None
samaysiga	thành	None
sameenta	làm	None
sameeya	làm	None
sameeyaan	làm	None
sameeyay	làm	None
sanadahan	này	None
sanadihii	năm	None
sanadii	năm	None
sannadkii	năm	None
sannadku	năm	None
sano	năm	None
sapienza	sapienza	Nan
saqiireen	trưa	None
saraakiil	quan	None
saraakiisha	chức	None
saraakiishii	quan	None
saraar	cung	None
saransoor	saransoor	Nan
sardiiniya	cá mòi	Nan
sare	cao	Nan
sareeya	cao	Nan
sareeyo	cao	Nan
sarena	cao	Nan
sannadkaasna	đó	None
sannadkaas	đó	None
sannadihii	năm	None
sannadahan	này	None
sanadka	năm	None
sanadkaa	đó	None
sanadkaana	nay	None
sanadkaas	đó	None
sanadkan	nay	None
sanadki	năm	None
sanadkii	năm	None
samaale	sam	Nan
sanadkiiba	năm	None
sanadku	năm	None
sanado	năm	None
sanadood	năm	None
sanca	sanca	Nan
sand	cát	Nan
sandkii	năm	None
sanka	mũi	None
sanadkooda	họ	None
salma	salma	Nan
salka	cơ sở	Nan
saliim	salim	Nan
safraan	lịch	None
safray	lịch	None
safraya	lịch	None
safri	lịch	None
sagaal	chín	None
sagaalaad	chín	None
sagaaliyotobnaad	kỷ	None
sagaalkooda	họ	None
sahal	dàng	None
sahashay	ám	None
sahlan	dàng	None
sahra	rông	None
saint	thánh	None
sakada	đây	None
sakariye	vít	None
safiya	sáng	None
safiirkii	sứ	None
safiirka	sứ	None
safarrada	đi	None
saddaxda	ba	None
saddex	ba	None
saddexaad	ba	None
saddexda	ba	None
saddexdooduba	ba	None
sadex	ba	None
sadexaad	ba	None
sakiin	cạo	None
sadexda	ba	None
sadqeeyay	tặng	None
safaarada	quán	None
safaaradaha	quán	None
safar	đi	None
safarka	trình	None
safarkii	trình	None
safarkiisii	ấy	None
sadexdii	ba	None
sadaxda	ba	None
sako	điệp	None
sal	muối	None
salbalaadhan	này	None
saldanad	năm	None
saldanada	tôi	None
saldanadda	cột	None
saldanadii	tôi	None
saldanado	năm	None
saldhig	cứ	None
saldhiga	cứ	None
saldhigga	ở	None
saldhigyo	cứ	None
saleebaan	cond	Nan
saleemaan	họ	None
salfiyo	muối	None
saliid	dầu	None
saliida	dầu	None
salaysanyahay	trên	None
salaysan	trên	None
salal	lương	None
salafusaalixa	chào	None
salaad	nguyện	None
salaadda	nguyện	None
salaaddu	nguyện	None
salaadeed	nguyện	None
salaadood	nguyện	None
salaam	chào	None
salaama	chào	None
saksonku	gửi	None
salaan	chào	None
salaanee	chào	None
salaanka	thang	None
salaannee	chào	None
salaaxudiin	nghiêm	None
salad	lách	None
salafiyiinta	rong	None
salafka	safa	Nan
salaancarrabey	salutecarrabey	Nan
siduu	hợp	None
sierra	sierra	None
sifaadkiisa	thuộc	None
tansaaniya	tanzania	None
taqaan	bạn biết	Nan
taqaano	bạn biết	Nan
taqasusay	môn	None
taqasustay	chuyên	None
tara	chín	None
taraawiil	tắt	None
tarayn	vô	None
tarbiyada	nuôi	None
tarbiyeesan	phẳng	None
tareen	xe	None
tari	ho	Nan
tarjamada	dịch	None
tartamaayey	tranh	None
tartami	đua	None
tani	who	Nan
tartanka	thi	None
tan	này	None
tamar	năng	None
taliyaaniga	ý	None
taliyaanigu	ý	None
taliyaanu	thước	None
taliyaha	thước	None
taliye	trị	None
taliyeen	khuyên	None
taliyihii	đốc	None
taliyo	định	None
talo	bảo	None
talyaani	ý	None
talyaaniga	ý	None
talyaanigasyl	ý	None
talyaanigu	ý	None
talyaaniguna	ý	None
talyaniga	ý	None
tamarta	năng	None
tartankii	thi	None
tashaday	ý	None
tashik	khởi	None
teelteel	định	None
tegay	còn	None
tegey	còn	None
tegeysaan	đi	None
tegi	khác	None
tegin	khác	None
telcom	thông	None
teleefonada	thoại	None
telefoion	thoại	None
telefoon	thoại	None
telefoonada	thoại	None
terre	terre	Nan
testify	làm	None
textalign	văn	None
tfgda	tfgda	Nan
teedsan	theo	None
teeda	ấy	None
technology	công	None
tech	công	None
tashteen	xé	None
tasi	tasi	Nan
tawraad	tình	None
tawreet	ơn	None
taxaabaan	kẹt	None
taxane	loạt	None
taxnaa	loạt	None
taliyaani	huy	None
tay	tay	None
taymiya	thuần	None
tayo	chất	None
ta´shilin	lịch	None
tchad	tchad	None
tdma	tdma	Nan
tebin	dịch	None
tebiyey	cáo	None
tayada	chất	None
taliskii	tắc	None
taliska	huy	None
talisa	ấy	None
taasaa	là	None
taasi	đó	None
taasina	đó	None
taasna	rằng	None
taasoo	mà	None
taaxane	có	None
taba	lá	None
tababarada	tạo	None
tababaran	tạo	None
tababare	viên	None
tababarka	tạo	None
tabo	nơi	None
tacliin	dục	None
tacliinta	thuật	None
tada	nâng	None
taas	đó	None
taarikhda	sử	None
taarikh	sử	None
taariiqyahano	học	None
taan	này	None
taangiyada	tăng	None
taar	ngày	None
taariikh	sử	None
taariikhda	sử	None
taariikhdadhaqanka	lụt	None
taariikhdii	sử	None
tafiirmaan	khác	None
taariikhdu	sử	None
taariikhi	sử	None
taariikhiga	sử	None
taariikho	ngày	None
taariikhood	ngày	None
taariikhyahan	học	None
taariikhyahanada	học	None
taariiqyahanka	sử	None
taariikheed	sử	None
th	tự	None
tafsiirka	dịch	None
tagaa	đi	None
talaabadan	này	None
talaabo	bươc	Nan
talaadada	ba	None
talaado	ba	None
talada	bảo	None
taladana	bảo	None
taladii	bảo	None
taladu	bảo	None
talagalay	cho	Nan
talayaaniga	ý	None
taleefoonada	thoại	None
taleex	thoại	None
tali	who	Nan
talin	vấn	None
talis	huy	None
talaabada	bươc	Nan
tala	bảo	None
tajwiidka	ở	None
tahliil	ngữ	None
tagaan	đi	None
tagay	còn	None
tagaya	xa	None
tage	đi	None
tageen	còn	None
tagey	còn	None
tagin	không	None
taga	sổ	None
tagisteeduna	ấy	None
tagsiile	xi	None
tagtada	nhãn	None
tagteen	còn	None
tagto	đi	None
tahay	là	None
tahaye	nản	None
tahayna	là	None
tago	đi	None
taamyeeloo	hợp	None
that	đó	None
their	chúng	None
tolayoo	tây	None
tolkayoo	nướng	None
tooda	nướng	None
toogasho	chụp	None
toona	đúng	None
tooreyda	đũa	Nan
toori	thực	None
toos	thắn	None
toosa	dậy	None
toosan	thẳng	None
toosanaha	thắn	None
toose	giản	None
toosoo	dậy	None
top	đầu	None
toqoshi	quăng	None
tol	đựng	None
towfiiq	towfiiq	Nan
togwajaale	tiện	None
togga	sông	None
tobankii	mười	Nan
tobnaad	thứ	None
toc	toc	Nan
todabaadka	tuần	None
today	nay	None
toddoba	bảy	None
toddobo	bảy	None
todoba	bảy	None
todobaad	tuần	None
todobaadka	tuần	None
todobada	bảy	None
todobo	bảy	None
togagga	suối	None
togdheer	togdheer	Nan
togdheersanaag	thật	None
togo	đi	None
town	trấn	None
towxiidka	thiền	None
training	tạo	None
turjumaha	dịch	None
turjume	dịch	None
turjumey	dịch	None
turkey	tây	None
turki	tây	None
turkida	tây	None
turkiga	tây	None
turkigamaadaama	tây	None
turkigawaxa	tây	None
turkigu	tây	None
turkish	nhĩ	None
turkiya	tây	None
turkki	turkki	Nan
turkumaanka	nhĩ	None
tusaale	dụ	None
tunisya	điệu	None
tunisiya	lại	None
tunisia	tunisia	Nan
tunis	chỉnh	None
transmission	lây	None
transnistria	gia	None
tu	tu	Nan
tubane	củ	None
tubayoo	đổi	None
tubeec	ống	None
tukado	nguyện	None
tobanka	mười	Nan
tukan	nguyện	None
tukanayo	nguyện	None
tukelalmimurcood	tukelalmimurcood	Nan
tukuhu	bón	None
tuldo	tulip	None
tuluddiiye	sư	None
tumay	u	None
tuni	nhở	None
tukanaya	nguyện	None
toban	mười	Nan
to	đến	None
tixraacyada	thiệu	None
tiirsada	vào	None
tiirsan	thuộc	None
tiirsanaa	thuộc	None
tiirsantahay	thuộc	None
tiirsanyahay	vào	None
tijaaradii	nghiệm	None
tijaareeyo	van	None
tijaaro	sợ	None
tikrit	vé	None
tilaami	rô	None
tilmaamaa	định	None
tilmaamaan	chỉ	None
tilmaaman	chỉ	None
tilmaamay	chỉ	None
tilmaamayo	chỉ	None
tiirka	cột	None
tiirarkaasina	cột	None
tiirarka	cột	None
tiirar	cột	None
there	đó	None
these	những	None
they	họ	None
this	này	None
through	qua	None
throughout	khắp	None
ti	của	None
tilmaameen	chỉ	None
tidhaah	nói	None
tignolajiyada	công	None
tigreega	vé	None
tihiin	là	None
tii	trà	None
tiil	ngói	None
tiille	tiille	Nan
tiir	cột	None
tidhi	nói	None
the	các	None
tilmaami	chỉ	None
tilmaanayba	chỉ	None
tiriyey	tính	Nan
tiriyo	đếm	None
tiro	số	None
tirokoob	kê	None
tirsan	viên	None
tirsana	chúng	None
tirsanaa	là	None
tirsanaan	đếm	None
tix	xem	None
tixda	sách	None
tixdan	xét	None
tixdii	xét	None
tixdiisa	ấy	None
tixihiisa	ấy	None
tixraac	khảo	None
tiriyay	tính	Nan
tirin	đếm	None
tiri	đếm	None
tiran	ngói	None
timaadada	nào	None
timaaddo	đến	None
timacade	đi	None
time	gian	None
times	lần	None
timi	nào	None
timid	đến	None
tilmaamo	dẫn	None
timide	nào	None
timo	tóc	Nan
timocade	công	None
tinta	tóc	Nan
tira	quá	None
tirad	số	None
tirada	số	None
tirakoob	kê	None
timirta	tay	None
riday	xuống	None
taamaayee	ơn	None
taalla	sẵn	None
socotada	khách	None
socotay	tục	None
socoto	đang diễn ra	Nan
soddon	mươi	None
software	mềm	None
softwareku	mềm	None
sogüt	sogüt	Nan
soka	khoan	None
sokeeyay	vệ	None
sokeeye	sự	None
sokow	ngoài	None
soltelco	soltelco	Nan
somaaliland	somaliland	Nan
somaaliya	somalia	Nan
somaaliyeed	tiếng	None
socota	theo	None
somailand	somaliland	Nan
socono	đi	None
socon	dạo	None
socda	theo	None
socdaa	đang diễn ra	Nan
socdaal	lịch	None
socdaale	khách	None
socdaalka	cư	None
socdaan	dạo	None
socdaanba	đang diễn ra	Nan
socday	đi	None
socdaydhaqaalaha	hội	None
socdeen	bộ	None
socdey	tục	None
socdeyna	dạo	None
socdo	đang diễn ra	Nan
soco	đi	None
socodka	dạo	None
soconno	dạo	None
somali	tiếng	None
somalia	somalia	Nan
somalialand	ở	None
soogelitaankii	hiện	None
soojeedinta	trình	None
sool	sool	Nan
soomaaiya	nhanh	None
soomaal	tiếng	None
soomaali	anh	None
soomaalia	ở	None
soomaalida	người	None
soomaalidii	các	None
soomaalidu	người	None
soomaaliga	anh	None
soomaaligalbeed	lai	None
soomaaliland	ở	None
soomaaliya	somalia	Nan
soomaaliyakiinya	không	None
soogalistii	soogalistii	Nan
soodhaafanay	đón	None
soo	đến	None
sonkorta	đường	None
somalida	người	None
somalidu	tiếng	None
somaliga	anh	None
somalilada	trong	None
somalilanad	anh	None
somaliland	ở	None
somalilandintaas	là	None
so	quý	None
somalilandna	ở	None
somaliwayn	tiếng	None
somaliya	somalia	Nan
somaliyeed	tiếng	None
somaray	đó	None
some	số	None
somlialnd	đó	None
somtel	đó	None
somalinimada	yêu	None
snmta	snmta	Nan
snmlooma	snmlooma	Nan
snm	snm	Nan
siiyaymagaca	tên	None
siiyeen	họ	None
siiyey	được	None
siiyo	đưa	None
silanyo	siloon	Nan
silic	khổ	None
sim	sim	Nan
siman	bằng	None
simantahay	bằng	None
simanyihiin	bằng	None
simbaabwi	lại	None
simo	đồng	None
sinaan	đẳng	None
sinaanta	đẳng	None
sinigaal	tích	None
siiyaycalan	đưa	None
siiyay	được	None
siiya	giống	Nan
siisay	đã	None
sifeynta	máu	None
sifiican	tốt	None
sifoobay	chế	None
signal	hiệu	None
signals	hiệu	None
sii	đưa	None
siiba	biệt	None
sir	quý	None
siid	phóng	None
siidaynta	phát	None
siilaanyo	tử	None
siin	đưa	None
siinayo	cho	Nan
siinjiray	được	None
siirada	ing	Nan
siisa	quăng	None
siidaayey	đi	None
soomaaliyana	ở	None
sirasmi	thưa	None
sirdoonyaasha	thông	None
siyaasi	gia	None
siyaasiga	trị	None
siyaasiinta	gia	None
siyaasiyiin	gia	None
siyaasiyiinta	gia	None
siyaasiyiintan	này	None
siyaasiyiinytii	gia	None
siyad	siad	Nan
siyasadeed	trị	None
skandinafia	scandinafia	Nan
slitaz	slitaz	Nan
smaller	hơn	None
smart	thông	None
sms	nhắn	None
snaciidamada	rắn	None
siyaasadii	sách	None
siyaasadeed	trị	None
siyaasaddeed	trị	None
siyaasadda	trị	None
siri	khăn	None
sirta	mật	None
sisiiliya	lông	None
sisinta	vừng	None
sitay	ngồi	None
siticmaalaa	dụng	None
sitoosa	tuần	None
sirdoonka	thông	None
siwaaqroon	này	None
sixadeeda	mươi	None
siyaa	ing	Nan
siyaad	siad	Nan
siyaadna	hơn	None
siyaaraadka	trị	None
siyaasad	sách	None
siyaasada	trị	None
siweyn	rãi	None
taalo	đứng	None
soomaaliyeed	anh	None
soomaaliyeey	không	None
suuq	trường	None
suuqa	trường	None
suuqyada	chợ	None
suurada	sura	Nan
suuradda	dung	None
suurado	thi	None
suuratu	sura	Nan
suuratul	thi	None
suuratulfiil	suuratulfil	Nan
suuriya	syria	None
suurogal	thi	None
suurto	thi	None
suways	tốc	None
suwees	suwees	Nan
swasiland	thụy sĩ	Nan
suugaanyahankii	chương	None
sweden	điển	None
suugaanyahan	này	None
suugaantiisa	ấy	None
supports	trợ	None
suqa	nói	None
surinam	tôi	None
sus	sus	Nan
suu	su	None
suuban	thanh	None
suubanaa	đúng	None
suubban	biệt	None
suubiye	phép	None
suudaan	surah	Nan
suudaanitoobiya	sao	None
suufi	sufi	Nan
suugaan	chương	None
suugaanta	chương	None
suugaantii	chương	None
suugaantu	chương	None
switching	đổi	None
switzerland	thụy sĩ	Nan
swt	swt	Nan
taageerayaasha	ủng	None
taageero	ủng	None
taageersan	trợ	None
taageersanaa	trợ	None
taagi	chắc	None
taagnaa	đứng	None
taajir	có	None
taajirsan	có	None
taaka	giúp	None
taako	quăng	None
taal	sẵn	None
taala	sẵn	None
taalaa	là	None
taalada	bức tượng	Nan
taale	nay	None
taageerayaal	ủng	None
taageerada	ủng	None
taageera	ủng	None
taagay	lên	None
sxb	sxb	Nan
syc	đạp	None
syl	gió	None
syria	syria	None
system	hệ	None
systems	hệ	None
sénégal	dịch	None
superka	siêu	None
t	t	Nan
taa	nay	None
taaban	chạm	None
taaboo	chạm	None
taad	taad	Nan
taagan	đứng	None
taagantahay	trực	None
taaganyahay	trực	None
ta	ấy	None
super	siêu	None
suntan	độc	None
sunta	độc	None
soonku	nhanh	None
soosocota	sắp	None
sooyaalka	sử	None
sos	vớ	None
soviet	xô	None
sri	sri	None
ssdf	ssdf	Nan
st	thứ	None
stadium	động	None
standard	chuẩn	None
standards	chuẩn	None
state	bang	None
states	thái	None
station	tàu	None
stockholm	x-tốc-khôm	Nan
soonkood	chay	None
soonka	chay	None
soona	nhanh	None
soon	sớm	None
soomali	anh	None
soomalida	chay	None
soomalidu	nhanh	None
soomaliga	các	None
soomalimaad	nào	None
soomaliya	somalia	Nan
soomaliyadii	các	None
strom	strom	Nan
soomaliyeed	tiếng	None
soomanaado	nhanh	None
soomanahay	nhanh	None
soomane	nhanh	None
soomaray	nhanh	None
soomidda	chay	None
soomman	nhanh	None
soommani	nhanh	None
sooman	nhanh	None
soomaaliyeeed	tiếng	None
stronger	cường	None
su	họ	None
sugnaakii	đợi	None
sugulle	nam	None
suhra	suhra	Nan
suldaan	sultan	Nan
suldaanka	của	None
suldaankii	sultan	Nan
suliman	suliman	Nan
sultan	sultan	Nan
sumada	biểu tượng	Nan
sumerianku	số	None
sun	trời	None
suna	tên	None
sunday	chủ	None
sunnada	sunnah	Nan
sunni	sunni	None
sugnaaday	là	None
sugnaa	đợi	None
sugeysey	đợi	None
sugaysa	đợi	None
suaal	câu	None
suaalo	câu	None
subac	subac	Nan
subag	bơ	None
subax	sáng	None
subayr	mập	None
subscriber	kí	None
style=fontsize	chữ	None
subsystem	hệ	None
such	là	None
sucuudiga	rập	None
sudan	sudan	Nan
sudhan	treo	None
sugaal	đợi	None
sugan	rồi	None
sugay	đợi	None
subxaanahu	định	None
يسوع	يسوع	Nan
joogaba	nhìn	None
joogaan	lại	None
cilmi	học	None
cilmiga	học	None
cilmina	tôi	None
cilmiyada	học	None
cilmiyeedka	học	None
cilmu	mùi	None
cimilada	tiết	None
cimiladeeda	của	None
cimillada	hệ	None
cimilo	tiết	None
cimraan	tuổi	None
cinwaanka	chỉ	None
ciqaab	phạt	None
cir	gan	None
ciraaq	irac	Nan
cilmaaniya	báo	None
ciraaqka	iraq	None
ciisuhu	vào	None
ciisaha	giêsu	None
ciidamadee	của	None
ciidamadii	quân	None
ciidamadiisa	ấy	None
ciidamadu	quân	None
ciidamdii	quân	None
ciidamo	quân	None
ciidan	quân	None
ciidangale	quân	None
ciidanka	quân	None
ciidankii	quân	None
ciidankiisii	ấy	None
ciidanku	quân	None
ciidda	đất	None
ciil	phiền toái	Nan
ciimadii	thánh	None
ciise	giêsu	None
cirid	su	None
cirifka	trời	None
ciriiri	hẹp	None
ckariin	cai	None
claahi	ngạt	None
clahi	clahi	Nan
clinton	clinton	None
cllahi	trời	None
clle	clle	Nan
cllhi	cllhi	Nan
cod	nói	None
codec	mã	None
codecs	mã	None
codka	nói	None
codsaday	cầu	None
codsanayaan	cầu	None
codsi	cầu	None
codsiga	dụng	None
ckariim	gối	None
ciyaarta	chơi	None
ciyaaro	chơi	None
ciyaarihii	chơi	None
ciriiriga	nghẽn	None
cirka	trời	None
cirro	nhạt	None
cishaba	ngon	None
cismaan	trực	None
cismaaniya	ngợi	None
cismaaniyiinta	tuần	None
ciidamada	quân	None
cismaaniyiintu	chúa	None
cities	phố	None
civil	sự	None
ciyaalka	trẻ	None
ciyaar	chơi	None
ciyaaraa	vở	None
ciyaaraha	chơi	None
ciyaaray	chơi	None
cismaniyada	tục	None
codsigaas	đó	None
ciida	eid	None
cigalxasan	tục	None
ceelal	tốt	None
ceelasha	giếng	None
ceelbuur	giếng	None
ceelcad	tốt	None
ceeldheer	giếng	None
ceelgaal	tốt	None
ceelhuur	giếng	None
ceelka	giếng	None
ceelkii	giếng	None
ceelku	giếng	None
ceerigaabo	mù	None
ceerigabo	mù	None
ceeryaamo	mù	None
celi	lại	None
celin	lại	None
ceelaayo	hổ	None
celisa	chế	None
ceel	tốt	None
ccc	ccc	None
casuumay	mời	None
casuura	gọi	None
cawaale	cái	None
cawil	xám	None
cawo	nhai	Nan
caws	cỏ	None
cay	xúc	None
cayaar	chơi	None
cayaaraha	thao	None
caydiid	xúc	None
cayiman	định	None
cayimey	định	None
cayn	bụng	None
caynaba	nào	None
caynabo	khích	None
ceeb	hổ	None
celiya	lại	None
celiyay	lại	None
celiyo	lại	None
cida	who	Nan
cidamada	trong	None
cidda	who	Nan
ciddii	who	Nan
cidhifyada	cạnh	None
cidi	cidi	Nan
cidii	who	Nan
cidina	ai	None
cidla	vắng	None
cidlo	cô	None
cidluu	cô	None
cidna	ai	None
ciel	ciel	Nan
cigaal	lá	None
cigaaljpg|maxamed	đa	None
cid	ai	None
cibaarada	cúng	None
cibaado	kính	None
cibaadada	cúng	None
cell	bào	None
cells	bào	None
cellular	động	None
celmi	lại	None
center	tâm	None
centre	tâm	None
cerulli	cốc	None
ciid	cát	Nan
channel	kênh	None
charles	ngựa	None
chavez	chavez	Nan
chemistry	học	None
chirac	chirac	None
christian	christian	None
christos	christos	Nan
church	nhà thờ	Nan
channels	kênh	None
col	col	Nan
colaad	hostile	Nan
colaada	đột	None
daahir	chất	None
daain	daain	Nan
daakhiliga	nước	None
daalash	ô	Nan
daalicii	mỏi	None
daalin	mỏi	None
daallo	sức	None
daalo	sức	None
daalye	sức	None
daaqad	sổ	None
daaqadaha	sổ	None
daaqadkasta	sổ	None
daaqiliga	cỏ	None
daar	xoay	None
daaraha	tòa	None
daahfurayay	xuất	None
daardaari	chấp	None
daahay	muộn	None
daafta	vệ	None
d	d	None
da	và	None
daa	thôi	None
daab	in	Nan
daabacaada	in	Nan
daabacdo	in	Nan
daabicin	xuất	None
daacad	thà	None
daacadda	thực	None
daaci	đắng	None
daad	lụt	None
daadagine	đổ	None
daadagno	ngập	None
daadhey	ngập	None
daafaha	qua	None
daaha	lớp	None
daarood	mái	None
daaroodafka	sổ	None
daaroode	ngôi nhà	Nan
dabadeed	sau	None
dabadeede	sau	None
dabadeedna	đó	None
dabadiisii	ấy	None
dabadood	họ	None
dabaq	sàn	None
dabaqa	tầng	None
dabaqadda	lớp	None
dabarre	trừ	None
dabayaaqadii	muộn	None
dabayloobey	thổi	None
dabcigiyo	nhiên	None
dabeecad	vi	None
dabeecada	nhiên	None
dabeecaddiisa	ấy	None
dabada	đuôi	None
dabaasho	lội	None
dabaal	mừng	None
daba	theo	None
daaroodka	rào	None
daarta	ngôi nhà	Nan
daas	tin	None
daauud	daud	Nan
daawad	tay	None
daawada	thuốc	None
daawado	tay	None
cyimi	cyimi	Nan
daawanayay	xem	None
daawo	khỏi	None
daayay	phát	None
daaye	biệt	None
daayey	phí	None
daayin	các	None
daayo	phóng	None
dab	ngọn	None
daaweeyey	trị	None
cwahaab	lời	None
cutub	chương	None
cuthmaaniyiintii	phái	None
countries	gia	None
country	gia	None
course	học	None
coverage	sóng	None
cqaadir	căng	None
crashiid	crashiid	Nan
craxmaan	khát	None
craxman	craxman	Nan
crd	crd	Nan
crisaaq	xộn	None
cs	cs	Nan
csw	csw	Nan
cubeyd	khối	None
cudur	bệnh	None
cudurka	tật	None
could	thể	None
cost	cả	None
cosoble	trụ	None
core	lõi	None
colba	colba	Nan
colenel	colenel	Nan
colkayagii	ta	None
college	học	None
colombia	colombia	None
colow	màu	None
colspan=	colspan =	Nan
cufanka	khối	None
communication	giao tiếp	Nan
computers	máy	None
conditions	kiện	None
congo	congo	None
congress	nghị	None
congresska	nghị	None
conoco	conoco	Nan
coofey	coofey	Nan
computer	vi	None
casumay	mời	None
culays	trọng	None
culimadii	giả	None
cunteeyo	ăn	None
cunto	ăn	None
curadka	lòng	None
curatay	lòng	None
curious	mò	None
curiya	què	Nan
cuseyr	hơn	None
cusmaan	phát	None
cusmaaniyiinta	cư	None
cusmaankii	mới	None
cusman	cusman	Nan
cusri	cusri	Nan
customer	hàng	None
cusub	mới	None
cusubi	mới	None
cuntada	ăn	None
cuno	ăn	None
cunin	ăn	None
cunid	ăn	None
culimadu	giả	None
culimo	giả	None
culumaaudiinka	tôn	None
culumada	giả	None
culus	nặng	None
culusoow	nặng	None
culuumta	học	None
culimada	giả	None
culuunta	giả	None
cumar	ôi	None
cun	ăn	None
cunaan	ăn	None
cunay	ăn	None
cune	ăn	None
cuneen	ăn	None
cuni	ăn	None
cumaan	ô-man	Nan
casriyeesanwaxeena	ta	None
casriyeesan	cập	None
casriyadii	đại	None
caasimada	thủ	None
caasimadaha	thủ	None
caasimadda	thủ	None
caasimadiisa	ấy	None
caato	gầy	None
caawa	nay	None
caawin	giúp	None
caawinaayaan	trợ	None
caawisayba	giúp	None
caawiyey	giúp	None
caawiyo	giúp	None
cabaar	lúc	None
cabaas	rượu	None
cabbaas	cáp	None
cabbay	uống	None
caasimad	thủ	None
cabbeen	uống	None
caashaqa	quý	None
caasha	quý	None
caalin	vấn	None
caalmaka	người	None
caalmka	giới	None
caamul	cam	None
caan	danh	None
caana	sữa	None
caanaha	sữa	None
caanbaxday	tiếng	None
caanka	danh	None
caano	sữa	None
caansan	biến	None
caansana	danh	None
caansanaa	danh	None
caaqil	ngoan	None
caas	thủ	None
caashaq	quý	None
cabdalla	cabdalla	Nan
cabdalle	cabdalle	Nan
cabdi	uống	None
cabdullaahi	abdullah	Nan
cabdullahi	abdullah	Nan
cabdulle	bụng	None
cabdulmalik	cabalmalik	Nan
cabdulmuncim	cabdulmuncim	Nan
cabdulqaadir	lùn	None
cabdulraxmaan	của	None
cabduqaadir	nghẽn	None
cabduraxmaan	hát	None
cabid	uống	None
cabir	lệ	None
cabirka	thước	None
cabitaanka	uống	None
cable	cáp	None
cabsada	sợ	None
cabdule	lồng	None
cabdulahi	cabalhihi	Nan
cabdulaahi	phê	None
cabdmudhalib	liên	None
cabdicasiis	sợ	None
cabdilaahi	abdulahi	Nan
cabdillaahi	abdullah	Nan
cabdillahi	cabdillahi	Nan
cabdille	cáp	None
cabdimanaaf	buồng	None
cabdimudhalib	cabdimudhalib	Nan
caalimudiin	giả	None
cabdinaasir	nghiện	None
cabdirashid	cabrarashid	Nan
cabdirashiid	đo	None
cabdiraxmaan	giải	None
cabdiraxman	cabdirahman	Nan
cabdirisaaq	đo	None
cabdisalaan	sợ	None
cabdixaaji	thể	None
cabdiqaasim	cabhyqaasim	Nan
caalimkii	giả	None
caalim	giả	None
caalamku	trụ	None
but	nhưng	None
butaan	ngợi	None
buu	ta	None
buuciya	dưỡng	None
buug	sách	None
buuga	sách	None
buugaagta	sách	None
buugga	sách	None
buuhoodle	còi	Nan
buulo	tổ	Nan
buuloburde	ủi	None
buuloburte	yêu	None
buundo	cầu	None
buuq	ào	None
buur	ngọn	None
busra	mì	None
buskoon	trên	None
businessman	doanh	None
bushaaranaynaa	lành	None
burburiyay	hủy	None
burburiyeen	hủy	None
burburiyey	hủy	None
burburka	hủy	None
burburkii	đổ	None
burburku	hủy	None
burburtay	đổ	None
buuraha	núi	Nan
burco	cục	None
burma	burma	None
buro	u	None
bursadeen	bắn	None
burtinle	burtinle	Nan
burton	burton	Nan
burundi	burundi	None
bush	bụi cây	Nan
burkina	tôi	None
cabsi	sợ	None
buurdhuubo	lợi	None
buuro	núi	Nan
caadalad	lầm	None
caadi	thường	None
caadiga	thường	None
caado	quen	None
caafimaad	khỏe	None
caafimaadka	khỏe	None
caag	nhựa	None
caaggan	này	None
caaid	giúp	None
caajis	nhàm chán	Nan
caalami	quốc tế	Nan
caalamiga	quốc tế	Nan
caalamiya	quốc tế	Nan
caalamka	trụ	None
caalamkka	quốc tế	Nan
caad	quán	None
caabudwaaq	cúng	None
caabudo	cúng	None
caabudistiisa	ấy	None
buurta	ngọn	None
buurweyn	phì	None
buuxa	đầy	None
buuxaan	đầy	None
buuxda	đầy	None
buuxin	điền	None
buuxinaya	đầy	None
buuriga	lá	None
buuxsadaye	đầy	None
c	c	Nan
caabbi	cản	None
caabinta	cản	None
caabuda	cúng	None
caabudaa	cúng	None
caabudaan	cúng	None
caabudi	cúng	None
by	bởi	None
dabiici	nhiên	None
cabsida	sợ	None
cad	thoáng	None
caraba	rập	None
carabi	rập	None
carabiga	rập	None
carabigu	rập	None
carabiya	rập	None
carabka	lưỡi	None
carabkana	rập	None
carabta	rập	None
carabtii	trưa	None
carabtu	rập	None
carabعبد	rập	None
carabعبدالله	carab عبدالله	Nan
carafaat	carahaat	Nan
cararay	trốn	None
carareen	trốn	None
carab	rập	None
carartay	trốn	None
caraaye	bội	None
car	hơi	None
cambaha	phong	None
camiran	camiran	Nan
campaign	dịch	None
camuud	cát	Nan
can	đó	None
canbaha	leo	None
canfar	cúm	None
canfartu	lạnh	Nan
cape	choàng	None
captain	đội trưởng	Nan
caqabadna	thách	None
caqiidada	giáo lý	Nan
caqli	ngoan	None
caqliga	tuệ	None
caqligu	hợp	None
caraale	caramen	Nan
carbeed	rập	None
carbta	lưỡi	None
card	thẻ	None
cas	đỏ	None
case	hợp	None
casharadan	này	None
casharka	học	None
casharkii	học	None
casho	bữa	None
cashocado	bữa	None
casi	đỏ	None
casiis	đỏ	None
casimada	buổi	None
casir	cập	None
casmara	đỏ	None
casri	đại	None
casriga	đại	None
casrigan	đại	None
caruurtooda	họ	None
caruurtiisa	ấy	None
caruurtii	trẻ	None
caruurta	trẻ	None
carif	chép	None
cariif	tạp	None
caroone	caroton	Nan
carqaladaynkaro	vỡ	None
carrabey	tiếng	None
carro	đất	None
carruur	trẻ	None
camar	camar	Nan
carruureede	trẻ	None
carruurtiisa	ấy	None
carruurtiisu	ấy	None
cars	hơi	None
carta	carta	Nan
cartan	đẩy	None
carte	đẩy	None
caruur	trẻ	None
carruurta	trẻ	None
camaloow	bạc	None
camalladiisa	ấy	None
camallada	làm	None
caddaalad	bằng	None
caddaatay	ràng	None
caddayn	cớ	None
caddaynaya	đó	None
caddaynta	bằng	None
cadde	chứng minh	Nan
caddeeyay	đã	None
caddoow	ràng	None
cade	ràng	None
cadeeyay	đã	None
cadexamar	ràng	None
cadi	trắng	None
cadmeed	viên	None
cadnaa	chắc	None
cadnaan	nhịp	Nan
cadceedu	trời	None
cadceed	trời	None
cadcad	thoáng	None
cadaymaa	cớ	None
cadaa	trắng	None
cadaada	nén	None
cadaadis	áp	None
cadaado	thoáng	None
cadaalada	bằng	None
cadaaladda	bằng	None
cadaalda	bằng	None
cadoo	bộ	None
cadaan	trắng	None
cadaatay	đã	None
cadaawe	hostile	Nan
cadal	hoa	None
cadale	tình	None
cadami	cadmium	Nan
cadan	trắng	None
cadawga	thù	None
cadaanka	trắng	None
cabudhiyaan	dọa	None
cadoow	thù	None
cadowgiin	của	None
calan	cờ	None
calanka	cờ	None
calankaba	cờ	None
calanku	cờ	None
calanle	cờ	None
calasoow	kiểm	None
calasow	cờ	None
calayhi	sáng	None
cali	cali	Nan
caliaxmed	caliaxmed	Nan
called	là	None
calool	bụng	None
caluula	tâm	None
camaamad	kết	None
camal	thư	None
calaamooyinkaas	này	None
calaamooyin	hiệu	None
calaamka	hiệu	None
calaamdaha	triệu	None
cadrad	hoa	None
cafaan	ân	None
cafariga	thứ	None
cafarigaluqada	thứ	None
cafimaad	khỏe	None
caga	trần	None
cagaaran	lá	None
cadow	thù	None
cagaarka	xanh	None
cagta	chân	None
cairo	nộ	None
cajalad	băng	None
cajiib	vời	None
calaa	nộ	None
calaamad	hiệu	None
calaamd	hiệu	None
cago	chân	None
burburintii	diệt	None
dabiiciga	nhiên	None
dable	thi	None
dhacan	này	None
dhacana	xảy	None
dhacay	xảy	None
dhacaye	xảy	None
dhacayey	đã	None
dhacayeye	cố	None
dhacda	xảy	None
dhacdaa	xảy	None
dhacday	xảy	None
dhacdo	cố	None
dhacdooyin	kiện	None
dhacdooyinka	kiện	None
dhaceen	rơi	None
dhaco	xảy	None
dhadigana	người	None
dhacaan	xảy	None
dhadigna	cái	None
dhacaa	xảy	None
dhac	cướp	None
dhaanto	nhảy	None
dhaar	tuyên	None
dhaarannaye	thề	None
dhaarsho	tuyên	None
dhaarta	tuyên	None
dhaawac	tật	None
dhaawacmay	thương	None
dhaaxaan	qua	None
dhab	hãng	None
dhabar	lại	None
dhabarka	sau	None
dhabbada	đường	None
dhabeeyaan	biểu diễn	Nan
dhabnimadeeda	của	None
dhabta	thực	None
dhaca	xảy	None
dhafaruur	sát	None
dhagan	chẽ	None
dhaganyahay	chẽ	None
dhalashadiisii	ấy	None
dhalashadiisu	ấy	None
dhalasho	sinh	None
dhalashooyin	sinh	None
dhalatay	sinh	None
dhalay	xin	None
dhalaye	chảy	None
dhaleen	cháu	None
dhaliil	trích	None
dhaliilaha	phê	None
dhalin	suất	None
dhalinaya	hoạt	None
dhalinyar	niên	None
dhalinyara	niên	None
dhalinyarada	niên	None
dhalashadii	sinh	None
dhalashada	sinh	None
dhalanteede	sinh	None
dhalan	sinh	None
dhagar	dối	None
dhagaweyne	tràn ra	Nan
dhagax	sỏi	None
dhagaxa	đá	None
dhagaxaasi	đá	None
dhagaxawoqooyiga	bắc	None
dhagaxbuur	nứt	None
dhaameen	thúc	None
dhagaxii	đá	None
dhaha	nói	None
dhahaa	nói	None
dhahar	nói	None
dhaheen	rằng	None
dhaho	nói	None
dhakhso	nhanh	None
dhal	suất	None
dhagaysto	nghe	None
dhalinyaradii	trẻ	None
dhaalib	nhạt	None
dhaafsado	chết	None
degmadan	này	None
degmadda	huyện	None
degmadu	huyện	None
degmo	huyện	None
degmooyinka	huyện	None
degno	sống	None
dego	định	None
degoo	nào	None
degree	độ	None
degtaa	định	None
degtaan	định	None
degtay	xuống	None
degto	định	None
dejintii	cài	None
dejiyay	chứa	None
degmadaan	này	None
dejiyey	cư	None
degmada	huyện	None
degganaa	ở	None
deganaa	ở	None
deganaana	tĩnh	None
degay	cánh	None
degayare	râu	None
degaye	dân	None
degdeg	cấp	None
degeen	cư	None
degen	định	None
degenaa	được	None
degenaan	tĩnh	None
degenaansho	tĩnh	None
degeneen	tại	None
degenyihiin	tại	None
degey	cư	None
deggan	định	None
degi	tĩnh	None
dekad	cảng	None
dekada	cảng	None
dekadda	cảng	None
development	phát	None
devices	thiết	None
deyey	gấu	None
deyiba	hổ	None
dfkmg	dfkmg	Nan
dhaabad	ngã	Nan
dhaabadeeyaan	đi	None
dhaadashada	triều	None
dhaadheer	cao	Nan
dhaaf	qua	None
dhaafay	quá	None
dhaafayn	qua	None
dhaafaysaa	qua	None
dhaafi	qua	None
dhaafo	qua	None
destaing	mệnh	None
designed	kế	None
derivative	sinh	None
derisna	xóm	None
dekadiiba	cảng	None
dekeda	cảng	None
dekedda	cảng	None
dekeeya	tĩnh	None
delhi	đừng	None
dembi	tội	None
dembiga	tội	None
dhaaftay	qua	None
democratic	chủ	None
denmark	mạch	None
depending	tùy	None
deputato	sách	None
derejada	độ	None
derejo	cấp	None
deris	xóm	None
deriska	xóm	None
den	chối	None
dhalinyaro	niên	None
dhalisay	hoạt	None
dhaliyey	hoạt	None
dhaw	đóng	Nan
dhawaadaan	đây	None
dhawaado	sớm	None
dhawaan	đây	None
dhawaaqaa	bố	None
dhawaaqaan	thanh	None
dhawaaqay	báo	None
dhawaaqday	báo	None
dhawaaqida	âm	None
dhawaaqidda	âm	None
dhawaaqo	thanh	None
dhawaaqtada	thanh	None
dhawdahay	đây	None
dhaweeyay	nghênh	None
dhawr	giữ	None
dhasida	nhảy	None
dhawre	bảo vệ	Nan
dhashtay	sinh	None
dhashaywaxaanuu	sinh	None
dhaqmay	động	None
dhaqmaysayna	đã	None
dhaqmo	động	None
dhaqso	nhanh	None
dhaqtar	bác	None
dhar	áo	None
dharaar	ngày	None
dharaaraba	sáng	None
dhararka	vải	None
dharka	áo	None
dharkeenleey	ta	None
dharkoodii	họ	None
dhasahy	đây	None
dhashaa	sinh	None
dhashay	sinh	None
dhasheen	sinh	None
dhax	di	None
dhaxal	sản	None
dhaxalaa	kế	None
dhaxmaro	hưởng	None
dhay	lên	None
dhaygag	nhìn	None
dhaymo	mặc	None
dhaytubaako	hostile	Nan
dhebaandhebiye	vác	None
dhebi	chuột	None
dheceen	rơi	None
dheddig	cái	None
dheddiga	nữ	Nan
dheddigga	dành	None
dheecaan	phóng	None
dheer	dài	None
dheeraa	dài	None
dheeraad	hơn	None
dhaxmaraa	thiệp	None
dhaxlay	hưởng	None
dhaxeysay	gian	None
dhaxeysaa	giữa	None
dhaxalgalka	sản	None
dhaxalka	sản	None
dhaxalkeeda	ấy	None
dhaxanta	lạnh	Nan
dhaxaye	vỡ	None
dhaxaysa	giữa	None
dhaxaysaa	giữa	None
dhaqmaan	động	None
dhaxaysay	họ	None
dhaxe	giữa	None
dhaxeesay	họ	None
dhaxeeya	họ	None
dhaxeeyaa	giữa	None
dhaxeeyeen	họ	None
dhaxeeyey	họ	None
dhaxeysa	giữa	None
dhaxda	giữa	None
dhaqma	động	None
dhaqidda	rửa	None
dhaqdo	rửa	None
dhameystay	thúc	None
dhami	cả	None
dhamiba	cả	None
dhammaa	bộ	None
dhammaadkii	thúc	None
dhammaan	cả	None
dhammaantiis	cả	None
dhammaantood	họ	None
dhammanteen	ta	None
dhammeeyeen	thúc	None
dhan	cả	None
dhanaan	chua	None
dhanee	mừng	None
dhanka	bên	None
dhankaas	lại	None
dhameeyay	thúc	None
dhameeyaan	thành	None
dhameestirnociidanka	trình	None
dhamaystirane	thành	None
dhallinyaradu	trẻ	None
dhallinyaro	trẻ	None
dhamaadaa	thúc	None
dhamaadaan	thúc	None
dhamaaday	thúc	None
dhamaadka	thúc	None
dhamaadkii	thúc	None
dhankooda	họ	None
dhamaado	thúc	None
dhamaan	cả	None
dhamaantiis	cả	None
dhamaantood	họ	None
dhamaatay	hết	None
dhamaha	chân	None
dhamaystay	thành	None
dhamaystiran	thành	None
dhamaag	thúc	None
degan	tĩnh	None
dhanna	cả	None
dhantahay	tất	None
dhaqane	động	None
dhaqanka	truyền thống	Nan
dhaqankooda	họ	None
dhaqankoodu	họ	None
dhaqanta	thực	None
dhaqashada	rửa	None
dhaqatada	mục	None
dhaqato	rửa	None
dhaqay	sạch	None
dhaqdhaaaqyadii	động	None
dhaqdhaqaaq	trào	None
dhaqdhaqaaqa	trào	None
dhaqdhaqaaqii	trào	None
dhaqdhaqaaqyadii	động	None
dhaqdhaqaaqyo	động	None
dhaqan	truyền thống	Nan
dhaqamo	văn	None
dhaqameed	thông	None
dhaqaaqyo	chuyển	None
dhanyahay	thành	None
dhaq	rửa	None
dhaqaalaba	kinh tế	Nan
dhaqaalaha	tê	None
dhaqaalaha´	tê	None
dhaqaale	thuộc	None
dhaqaalha	tê	None
dhanoo	cả	None
dhaqaalihii	nền kinh tế	Nan
dhaqaalihiisuna	ấy	None
dhaqaalo	tê	None
dhaqaaloheeda	của	None
dhaqaalohiisa	ấy	None
dhaqaaq	chuyển	None
dhaqaaqay	chuyển	None
dhaqaaqo	chuyển	None
dhaqaalihiisa	ấy	None
degaanka	phương	None
degaanada	phương	None
degaan	trú	None
dakhalka	nhập	None
dal	dal	Nan
dalab	cầu	None
dalad	cái	None
dalaga	mùa	None
dalagyada	mùa	None
dalagyo	mùa	None
dalaka	đất	None
dalal	gia	None
dalalka	gia	None
dalandoole	bún	None
daleeyay	sức	None
daliil	cớ	None
daljirka	lái	None
dalka	gia	None
dakano	cuối	None
dalkaas	đó	None
dajiyaa	xuống	None
dahsoon	danh	None
daganyihiin	ở	None
dagay	cư	None
dagi	định	None
dagmada	huyện	None
dagmo	huyện	None
dagmooyinka	huyện	None
dago	đầm	None
dagta	xuống	None
dagtaa	tĩnh	None
dagto	tĩnh	None
dahab	vàng	None
dahabka	vàng	None
dahay	rồi	None
dahaye	giấu	None
dahir	chất	None
dain	chết	None
dalkayagu	tôi	None
dalkeeda	ấy	None
dalkeena	tôi	None
damal	đập	Nan
dambana	sau	None
dambayntii	cùng	None
dambe	sau	None
dambeba	sau	None
dambeeya	sau	None
dambeeyay	đây	None
dambeeyey	cùng	None
dambeeyo	cùng	None
dambeyntiina	cùng	None
dambeysay	cùng	None
dambeysey	cùng	None
dambidhaafe	ân	None
damceen	khát	None
dameer	lừa	None
damacii	muốn	None
damaca	khát	None
damac	khát	None
dalxiiso	lịch	None
dalkii	đất	None
dalkiisa	ấy	None
dalkjirka	hương	None
dalkjirkan	này	None
dalkooda	họ	None
dalku	hương	None
dalmar	dalmar	Nan
daganayn	định	None
dalool	lỗ	None
dalxiisaan	lịch	None
dalxiisayaasha	lịch	None
dalxiise	lịch	None
dalxiiseyaasha	lịch	None
dalxiisi	lịch	None
dalxiiska	lịch	None
dalxiiskeeda	của	None
dalxiis	lịch	None
daganaayeen	giải	None
dagan	tĩnh	None
dagalki	đột	None
dadaalka	nỗ	None
dadaalo	nỗ	None
dadaaloosa	nỗ	None
dadaashaane	cù	None
dadab	cửa	None
dadaka	người	None
dadbadani	đông	None
dadee	đợi	None
dadeedu	xuống	None
dadi	ngon	None
dadiisu	ngon	None
dadka	người	None
dadkaa	người	None
dadkaan	này	None
dadkaas	đó	None
dadaali	gắng	None
dadaaleen	phấn đấu	Nan
dadaalaayay	phấn đấu	Nan
dadaalaan	cù	None
daboolida	che	None
dabqaxa	tầng	None
dabuubtaan	gói	None
dabuubtiyo	đẹp	None
dacal	thang	None
dacallada	bằng	None
dacar	sâu	None
dadkaasi	đó	None
dacas	daas	Nan
dacda	sai	None
daciifa	yếu	None
dacwad	kiện	None
dacwada	kiện	None
dad	người	None
dada	hợp	None
dadaal	gắng	None
dacay	lõm	None
damiin	lãnh	None
dadkaba	người	None
dadkani	này	None
dagaalamayay	trận	None
dagaalamayeen	đã	None
dagaalamey	chiến	None
dagaalka	tranh	None
dagaalkaas	đó	None
dagaalkani	này	None
dagaalkii	tranh	None
dagaalku	tranh	None
dagaallada	tranh	None
dagaallo	tranh	None
dagaalo	chiến	None
dagaalwaxaa	tranh	None
dagaan	đây	None
dagal	đánh nhau	Nan
dagalka	tranh	None
dagaalamay	chiến	None
dagaaladii	tranh	None
dagaaladaas	này	None
dagaalada	tranh	None
dadkeeda	của	None
dadkeedii	ấy	None
dadkeedu	ấy	None
dadkii	dân	None
dadkiina	của	None
dadkiisa	ấy	None
dadkiisii	ấy	None
dadkana	người	None
dadkoo	người	None
dadkuna	người	None
dadlka	dân	None
dadow	người	None
dadweynaha	cộng	None
dadx	chàng	None
daga	từ	None
dagaal	tranh	None
dadku	người	None
dabka	ngọn	None
damiir	tâm	None
dan	trai	None
dawlad	quyền	None
dawlada	quyền	None
dawladaasi	đó	None
dawladaasii	đó	None
dawladaha	phủ	None
dawladanwaxa	này	None
dawladda	quyền	None
dawladdii	quyền	None
dawladeed	quyền	None
dawladi	quyền	None
dawladihii	phủ	None
dawladii	quyền	None
dawladnimo	quyền	None
dawlado	phủ	None
dawladood	phủ	None
dawgii	cáo	None
dawladu	quyền	None
dawgalaye	tạo	None
dawaldu	xe	None
darti	vì	None
dartiina	thế	None
dartiis	vì	None
darto	nước	None
daruufo	cảnh	None
daruuriga	thiết	None
daruuro	mây	None
darxuma	vụng	None
darxumo	may	None
daryeel	tâm	None
dasnnee	dasnnee	Nan
dastuur	chức	None
dastuurka	pháp	None
data	liệu	None
daud	daud	Nan
dawga	ngựa	None
dawliskii	quyền	None
dawr	dawr	Nan
dayaan	đại	None
deegaanka	trường	None
deegaannada	thuộc	None
deegaano	trường	None
deegta	muộn	None
deelqaaf	liệu	None
deeq	góp	None
deeqeen	tặng	None
deeqsi	phóng	None
deeqsiiyo	tặng	None
deero	nai	None
deerow	sunrow	Nan
deetana	kế	None
deexda	trời	None
dega	xuống	None
degaa	định	None
deegaanada	thuộc	None
deegaan	trường	None
december	hai	None
dec	hai	None
dayactir	sửa	None
dayar	cai	None
dayax	trăng	None
dayaxa	trăng	None
dayay	thử	None
daydka	sân	None
daye	giới	None
dartey	đặt nó	Nan
dayeen	gấu	None
dayeynahay	tâm	None
dayn	nợ	None
dayniile	nợ	None
dayo	tốt	None
dayrka	sân	None
de	đến	None
debate	luận	None
dayey	nhuộm	None
darteed	vì	None
dartay	thêm	None
darsoomaa	phát	None
danishka	bóng	None
danjiraha	sứ	None
danjire	sứ	None
danta	ấy	None
dao	dao	None
daomeesha	daomeesha	Nan
dar	vào	None
daraa	học	None
daraaddeed	thế	None
daraadeed	thế	None
daraan	pha	None
daraawiish	yêu	None
daraawiishi	tìm	None
daraawiishta	darwiishta	Nan
darafyada	thúc	None
dangorayo	đi	None
daneysa	lãi	None
danbi	ác	None
danbeysayisla	muộn	None
danaynayn	tâm	None
danbana	tôi	None
danbayna	đó	None
danbayntii	cùng	None
danbaysa	này	None
danbaysay	cùng	None
danbaysta	thúc	None
darajo	cấp	None
danbe	sau	None
danbeeyay	cùng	None
danbeeyey	cùng	None
danbeeyo	cùng	None
danbena	tôi	None
danbeyay	sau	None
danbeyntii	cùng	None
danbeysay	cùng	None
danbeesay	sau	None
damqaday	đau	None
daran	dữ	None
darane	phố	None
dareenka	quan	None
dareenku	cảm	None
dariiq	cách	None
dariiqada	đường	None
dariishad	sổ	None
darin	smite	Nan
daris	xóm	None
dariska	xóm	None
daristay	xóm	None
darka	xộn	None
daro	vào	None
darood	nước	None
darro	cực	None
darsado	học	None
darsamaan	với	None
dareen	quan	None
dareemi	cảm	None
dareemeen	cảm	None
dareemaysaa	cảm	None
daray	thêm	None
darayaaye	lòng	None
darayey	thêm	None
darayga	sinh	None
darbad	súng	None
darbadaaley	phát	None
darbadna	hơn	None
darandoorriga	không	None
darbane	xuống	None
darbiga	tường	None
darbigeed	tường	None
darbiyada	tường	None
dardaanay	tions	Nan
dardaaran	sẽ	None
dardaarmay	đạo	None
dareemay	cảm	None
darbi	phố	None
burburinta	hoại	None
burburay	đổ	None
burbur	hủy	None
allow	phép	None
allowing	phép	None
allows	phép	None
almadkhali	almskhali	Nan
almajid	tử	None
almunawara	hôn	None
alnour	alnour	Nan
alpine	núi cao	Nan
alqaacida	al	None
alshabaab	al	None
alshabab	alshabab	Nan
also	thế	None
alustaad	yêu	None
alwaadici	dân	None
alxalabi	học	None
allena	trời	None
alxamraa	hàn	Nan
allee	hoan	None
allaylehe	qua	None
alislām	alislām	Nan
aljabarti	học	None
aljazeera	học	None
aljaziira	học	None
aljeeriya	học	None
all	cả	None
alla	sao	None
allaa	giờ	None
allaaba	cả	None
allaah	trời	None
allaahu	lòng	None
allah	trời	None
allaha	lòng	None
allahaa	trời	None
allahu	trời	None
alle	trời	None
am	là	None
ama	là	None
amaan	toàn	None
aminsanyihiin	rồi	None
amir	kế	None
aml	aml	Nan
ammaan	ngợi	None
ammaanadana	ngợi	None
ammaanadii	ngợi	None
ammaanadiisa	ấy	None
amnesty	ân	None
amniga	vệ	None
amoud	tiếng	None
amray	huy	None
amxaari	amharic	Nan
an	một	None
anaa	là	None
anaadoolee	đây	None
amiirka	tử	None
amiir	tử	None
amiin	phần	None
american	mỹ	None
amaandarada	vệ	None
amaani	toàn	None
amaanka	vệ	None
amaanku	vệ	None
amaanta	ngợi	None
amaba	là	None
amagaalooyinka	phố	None
alislaax	đức	None
amar	hàng	None
amaradiisana	ông	None
amarkiis	ấy	None
amase	là	None
ambaradooriyadii	thương	None
ameerika	mỹ	None
ameerikada	mỹ	None
america	mỹ	None
amarada	lệnh	None
anad	anad	Nan
align=right	đúng	None
alifay	cái	None
ahmiyada	nghĩa	None
ahn	ah	Nan
ahna	và	None
ahoo	ồ	Nan
ahtiirarka	ảnh	None
ahwaxay	là	None
ahyad	ya	None
ahyd	ahyd	Nan
aid	trợ	None
air	không	None
airlines	không	None
airport	bay	None
airways	không	None
ajaanibta	ngoài	None
ajar	ajar	Nan
ahmiyad	nghĩa	None
ajnabi	lạ	None
ahmed	ahmed	Nan
ahluxaddiiska	trình	None
ahay	là	None
ahayd	là	None
ahayde	tôi	None
ahaydkadib	trễ	None
ahayee	thể	None
ahayn	phải	None
ahba	đúng	None
ahcafariga	xin	None
ahe	ôi	None
aheed	ahed	Nan
aheyd	là	None
aheyn	là	None
ahi	là	None
ahina	vâng	Nan
ahlu	ah	Nan
ahluxaddiisku	của	None
ajuuraan	sạc điện	Nan
ak	chuyện	None
akhlaaqda	vi	None
albaabka	cửa	None
albaani	cửa	None
albaaniya	albania	None
albakr	albakr	Nan
albania	alaska	None
albaqrahaayada	cửa	None
alcallaama	mì	None
aldalanj	aldalanj	Nan
alfaatex	alfaatex	Nan
alfaatixoo	alpha	Nan
algorithm	toán	None
algorithms	toán	None
alhilaali	tay	None
ali	ali	None
alif	alif	Nan
alazhar	vương	None
alalbaani	bẩn	None
alaha	haha	Nan
alaabtiisii	ấy	None
akhlaaqdii	đức	None
akhri	đọc	None
akhrin	đọc	None
akhrinducaysiilaah	akhrinducayslaaah	Nan
akhrinta	hiểu	None
akhrisan	đọc	None
akhriska	hiểu	None
alifka	cái	None
akhriso	đọc	None
akhriyaan	đọc	None
akhriyay	đọc	None
akhriyo	đọc	None
akr	kho	None
al	al	None
ala	xuống	None
alaabta	phẩm	None
akhristo	đọc	None
anagaa	tôi	None
anagoo	tôi	None
anagu	tôi	None
arkayninba	nhìn	None
arkayo	nhìn	None
arkaysaa	bạn thấy	Nan
arkeen	cưa	None
arkey	arkey	Nan
arki	xem	None
arko	xem	None
arkoon	nhìn	None
arlada	đất	None
arligiina	của	None
aroor	sáng	None
arrimaha	đề	None
arrimahaas	này	None
arrimo	đề	None
arrin	đề	None
arkay	xem	None
arrinkaa	đó	None
arkaan	xem	None
arjantiina	tôi	None
arif	arif	Nan
ariga	dê	None
arima	đề	None
arimaha	đề	None
arimahaa	này	None
arimahaas	này	None
arimo	đề	None
arimood	đề	None
arin	giữa	None
arinkaas	đó	None
arinta	đề	None
arintaa	đó	None
arintaas	đó	None
arintaasi	là	None
arintan	này	None
arkaa	nhìn	None
arrinkaan	này	None
arrinkaas	đó	None
arrinkii	đề	None
asalka	gốc	None
asalkooda	họ	None
asalkoodii	họ	None
asalkoodu	họ	None
asaxaabtu	bạn bè	Nan
asc	dần	None
aserbiijaan	phát	None
asharaaf	bội	None
ashhadu	tro	None
ashyaada	thứ	None
asiga	tôi	None
askar	lính	None
askari	lính	None
askarta	lính	None
askax	lính	None
asal	gốc	None
asagoo	bởi	None
asagana	thời	None
asaga	ta	None
arrinku	đề	None
arrintaa	đó	None
arrintaan	này	None
arrintaas	đó	None
arrintan	này	None
arrintii	đề	None
arrintu	đề	None
ari	mượn	None
arwa	arwa	Nan
arxan	lỗ	None
arxanka	căng	None
as	như	None
asaasay	thành	None
asaaseen	thành	None
asaasidii	tảng	None
asad	cóc	Nan
arwaaq	gỗ	None
argagixisa	bố	None
argagaxa	loạn	None
areas	vực	None
application	dụng	None
april	tư	None
aqaan	tôi	None
aqal	ở	None
aqalgalay	nuôi	None
aqalka	ngôi nhà	Nan
aqbalay	chấp	None
aqlabiyad	đông	None
aqlabiyada	đông	None
aqliyad	đông	None
aqoon	hiểu	None
aqoone	hiểu	None
aqoonsadaan	họ	None
aqoonsadayafka	danh	None
aqoonsado	nhận ra	Nan
any	ta	None
antiilis	trùng	None
antenna	ăng	None
ansaxa	hiệu	None
anan	đây	None
anbaqaaday	nuôi	None
anbaxaxeen	ngoài	None
anbieter	anbieter	Nan
and	và	None
andocootay	andocootay	Nan
andorra	andorra	None
aqoonsan	công	None
anfac	ích	None
aniga	tôi	None
anigaa	tôi	None
anigoo	tôi	None
anigu	tôi	None
anna	anna	None
annaga	ta	None
anoo	anoo	Nan
angola	đi	None
ahana	không	None
aqoonsanayn	tình	None
aqoonsato	nhận ra	Nan
aragti	thuyết	None
aragtid	bạn thấy	Nan
aragtida	thuyết	None
aragto	xem	None
arbaco	tư	None
ardada	viên	None
ardaqal	râu	None
arday	viên	None
ardayda	viên	None
ardaydiisii	ấy	None
ardaygii	viên	None
ardoqalna	không	None
ardul	ardul	Nan
arduqalwaxa	ồn	None
are	tôi	None
aragtay	xem	None
aragtaa	bạn thấy	Nan
aragnimo	nghiệm	None
arag	xem	None
aqoonsi	công	None
aqoonta	hiểu	None
aqoontiisa	ấy	None
aqoontoodu	họ	None
aqoonyahan	giả	None
aqoonyahanad	giả	None
aqoonyahano	giả	None
aqoonsatay	công	None
aqrinayaa	đọc	None
aqrineysaa	đọc	None
aqrinta	hiểu	None
aqriyey	đọc	None
aqriyo	đọc	None
ar	ar	Nan
arab	rập	None
arabsiyo	lẫn	None
aqrinayo	hiểu	None
ahan	phải	None
ahada	tên	None
ahaayeen	là	None
abaarta	hán	None
abaartii	hán	None
ababa	theo	None
ababuleen	bỏ	None
abd	abd	Nan
abdalle	abdalle	Nan
abdi	abd	Nan
abdirahman	bạn	Nan
abdirashid	abdrashid	Nan
abdul	abdul	None
abdulkarim	abdulkarim	Nan
abdullah	abdullah	Nan
abdullahi	tôi	None
abdulle	abdulle	Nan
abdulrahman	người	None
abaarso	đích	None
abdulsalam	bụng	None
abaaro	ốc	None
abaalmariyo	thưởng	None
aasaasy	tảng	None
aasan	ngơi	None
aasanyahay	cất	None
aasay	cất	None
aasaynaa	chôn	None
aasiya	á	None
aasiyamaanta	động	None
aasiyo	mến	None
aay	aay	Nan
aayadaha	câu	None
aayadda	thơ	Nan
ab	ab	Nan
abaabul	động	None
abaabulay	chức	None
abaal	thưởng	None
abaar	hán	None
abeba	bướm	None
abgaal	thìa	None
abii	vân	None
abu	điều	None
abul	abul	Nan
abuu	nên	None
abuubakar	tạo	None
abuubakari	tạo	None
abuukar	tạo	None
abuuraa	tạo	None
abuurantay	tạo	None
abuuray	tạo	None
abuurey	tạo	None
abuuro	nên	None
abuurtay	tạo	None
abwaan	họa	None
abwaanada	nhà thơ	Nan
abwaanka	chỉ	None
abtiyaashiis	tiên	None
abtirsiinyada	hệ	None
abtirsadaan	hệ	None
abtirsada	hệ	None
abiidhaalib	liên	None
abiikar	nhất	None
abil	abil	Nan
abkhazia	abkhazia	None
abokar	bạn	Nan
abokor	bạn	Nan
abooreey	rắn	None
aasaastay	thành	None
abraha	mòn	None
abroone	bỏ	None
absame	mặt	None
abshir	abshir	Nan
absuge	mặt	None
abti	chú	None
abtigiis	ta	None
abtirisiinyihiisu	số	None
abriil	tháng	None
aasaaskii	tảng	None
aasaaska	tảng	None
aasaasihii	sáng	None
aad	bạn	Nan
aada	đi	None
aadam	loại	None
aadamka	người	None
aadamuhu	người	None
aadan	bạn	Nan
aadanaha	người	None
aadanuhu	người	None
aaday	đi	None
aaden	đến	None
aadey	còn	None
aadka	rất	None
aadna	đi	None
aado	đi	None
aafo	hoảng	None
aabihiisna	ấy	None
aabihiis	ấy	None
aabihiina	tôi	None
aabihii	cha	None
+	+	Nan
<i>	<i>	Nan
<i><i>	<i><i>	Nan
<wareega	<wareega	Nan
=	= =	Nan
==	==	Nan
===xoriyadii	do	None
aagga	vực	None
a	một	None
aaayadda	thơ	Nan
aabaha	cha	None
aabahayo	tôi	None
aabbe	bố	None
aabbihii	ấy	None
aabbihiis	ấy	None
aabe	bố	None
aa	một	None
abwaankii	nghệ sĩ	Nan
aaggii	vực	None
aakhiraba	đây	None
aannu	ta	None
aanu	hại	None
aanuu	có	None
aar	aar	Nan
aargoosi	thù	None
aas	an	None
aasaar	an	None
aasaarta	an	None
aasaartan	này	None
aasaasaha	sáng	None
aasaasay	thành	None
aasaasayaasha	sáng	None
aasaasayaashii	sáng	None
aasaasi	căn	None
aasaasiga	căn	None
aannaan	có	None
aanay	không	None
aanan	không	None
aan	phải	None
aakhirana	đây	None
aakhiro	đây	None
aakhiroba	này	None
aalacimraan	đi	None
aalo	công	None
aamdiga	tội	None
aamin	tin	None
aakhiraa	đây	None
aaminaan	tin	None
aamino	tin	None
aaminsan	tin	None
aaminsanyahay	đi	None
aaminsanyihiin	tin	None
aamisan	đi	None
aammiin	đi	None
aamus	lặng	None
aamini	cậy	None
aslam	aslam	Nan
abwaanku	họa	None
abwaano	thứ	None
afraadwaana	tư	None
afrah	afrah	Nan
afrax	tư	None
africa	châu	None
african	châu	None
afrika	châu	None
afrikaba	châu	None
afrikada	châu	None
afrikakadib	châu	None
afroaasiya	ngữ	None
afsomaliga	ở	None
afsoomaali	ngữ	None
afsoomaaliga	anh	None
afsoomaaligu	anh	None
afsoomali	ngữ	None
afmadow	dụ	None
afsoomaliga	anh	None
afkiisuna	ấy	None
afjaro	thúc	None
afdhere	hỏng	None
affaransiis	châu	None
afgaanistaan	afghanistan	None
afgambi	chính	None
afgambigii	chính	None
afganistan	afghanistan	None
afgaranwaa	ý	None
afgobaadsi	bắt	None
afgooye	bắt	None
afgoye	tiện	None
afhayeenka	loa	None
afikada	ngữ	None
afingiriis	anh	None
afisbaanish	nha	None
afjaray	thúc	None
afka	mồm	Nan
aftahan	này	None
after	sau	None
aftigree	dư	None
ahaaday	là	None
ahaadee	thể	None
ahaado	là	None
ahaan	là	None
ahaana	là	None
ahaanba	rồi	None
ahaanjirtay	là	None
ahaanna	là	None
ahaanshaha	được	None
ahaantii	thực	None
ahaataye	với	None
ahaatee	chưa	None
ahaato	là	None
ahaay	là	None
ahaaye	naye	Nan
ahaa	là	None
aha	không	None
ah	ah	Nan
agtiisa	ấy	None
afturki	dư	None
afurayo	sáng	None
ag	ag	None
aga	đi	None
agaasimaha	đốc	None
agaasime	đốc	None
agaasimihii	đốc	None
afdheer	bốn	None
agagaarka	quanh	None
agasimihii	đốc	None
agoon	côi	None
agoontii	côi	None
agoonyar	cách	None
agoosto	tám	None
agrario	agrario	Nan
agteeda	ấy	None
agagaarkeeda	cô	None
afcarabi	dụ	None
afartii	bốn	None
afartankii	mươi	None
adduunka	giới	None
adduunkan	này	None
adduunku	giới	None
adduunyada	giới	None
adduunyadu	giới	None
adeeg	dịch	None
adeega	dịch	None
adeegayooda	họ	None
adeegsadaa	dụng	None
adeegsadaan	dụng	None
adeegsado	dụng	None
adeegsan	dụng	None
adeegsatay	dụng	None
adeegsiga	dụng	None
adeegtana	dịch	None
adduun	này	None
addoonku	hầu	None
addoonkiisa	ấy	None
addoonkii	hầu	None
account	khoản	None
ad	cáo	None
adaa	bạn	Nan
adaan	này	None
adag	cứng	None
adal	tình	None
adam	loại	None
adeegyada	dịch	None
adan	dơi	None
addaa	với	None
addis	nghiện	None
addoomada	lệ	None
addoomadiisa	ấy	None
addoomo	lệ	None
addoon	hầu	None
addoonka	hầu	None
add	vào	None
abwaannada	nhà thơ	Nan
adeegyadii	dịch	None
adeegyo	dịch	None
adna	adna	Nan
adoo	bởi	None
adoomada	lệ	None
adoon	cáo	None
aduu	trơn	None
aduunka	giới	None
aduunyada	giới	None
af	tiện	None
afaf	ngữ	None
afafka	ngữ	None
afar	bốn	None
afaraad	tư	None
afaraadna	tư	None
afarta	bốn	None
afartaas	bốn	None
administartion	điều	None
adkeynta	chặt	None
adkaysan	đựng	None
adkaade	phục	None
adeer	chú	None
adeerka	chú	None
adeerkii	chú	None
adeerkiis	ta	None
adeerkood	họ	None
adeerradii	chú	None
aden	aden	Nan
adeegyadooda	họ	None
adhiga	cừu	None
adiga	bạn	Nan
adigaa	bạn	Nan
adigoo	bởi	None
adigu	bạn	Nan
adiinoo	cho bạn	Nan
adkaaaday	bại	None
adkaaday	thế	None
adi	được	None
asluubta	luật	None
asna	asna	Nan
assaid	nào	None
beelihii	đồng	None
beelo	đi	None
beelood	đồng	None
beelweynta	đồng	None
been	sai	None
beenawday	dối	None
beeni	phủ	None
beeniyana	phủ	None
beeniyeen	định	None
beenta	dối	None
beentana	không	None
beer	vực	None
beera	gieo	None
beeraha	nghiệp	None
beeraleey	phu	None
beelahakan	này	None
beerato	cây	Nan
beelahaas	đó	None
beel	đồng	None
baytulaxam	khiếu	None
bbc	vân	None
be	là	None
bebad	râu	None
bed	giường	None
beddelo	đổi	None
bedelaan	đổi	None
bedelay	đổi	None
bedeli	đổi	None
bedelin	đổi	None
bedka	gian	None
beebeen	đi	None
beedkeediiduqaydii	tôi	None
beegan	hợp	None
beegsaday	tiêu	None
beelaha	đồng	None
beeray	trồng	None
beereed	hỏi	Nan
beero	gieo	None
bern	bern	Nan
besha	besha	Nan
between	giữa	None
bey	bey	Nan
beytkiisa	ấy	None
biblia	yếm	None
bidcada	dị	None
bidco	thầu	Nan
bidix	trái	None
biir	bia	None
biira	bia	None
biiray	gia	None
biirey	gia	None
biiro	não	None
biirtay	gia	None
bermer	bermer	Nan
berigii	sau	None
berberaburao	mai	None
berbera	sung	None
beeroley	phu	None
beerta	vườn	None
beerto	trồng	None
beesha	đồng	None
beeshu	râu	None
beeyay	m	Nan
being	được	None
bayoolojiga	học	None
belarus	belarus	Nan
belfast	tin	None
belgium	bỉ	None
beljim	bỉ	None
belkooda	họ	None
belo	belo	Nan
benin	ghế	None
benito	benito	None
beledweyne	beledweyne	Nan
bayolojigu	học	None
bayoloji	học	None
bayna	đường	None
barrow	barrow	Nan
barsane	baran	Nan
barta	điểm	None
bartaan	học	None
bartamaha	giữa	None
bartamihii	giữa	None
bartan	này	None
bartay	học	None
bartey	đó	None
barto	học	None
barwaaqa	thịnh	None
barwaaqo	thịnh	None
baryaya	khai	None
baryayaa	nguyện	None
baryey	nỉ	None
barre	barre	Nan
barooyosoomaaliya	hồ	None
baroordiiqda	chế	None
baroordiiqa	chế	None
barina	trái	None
barisoomaaliya	truyền giáo	Nan
barista	bài	None
baritish	baritish	Nan
barkaan	nửa	None
barkaanle	đỡ	None
barkada	bơi	None
baryi	xin	None
barlamaankadfkmg	hòa	None
barlamanka	của	None
barlaskooni	barricone	Nan
barliin	barlin	Nan
barnaamijka	trình	None
barnaamijkan	này	None
barnaamijyada	trình	None
baro	học	None
barlamaankiyo	hội	None
bik	bi	Nan
basaas	viên	None
based	trên	None
baxiira	miệng	None
baxo	lá	None
baxrayn	thuần	None
baxsaday	thoát	None
baxsadeen	thoát	None
baxsan	ngoài	None
baxsanida	trốn	None
baxshay	toán	None
bay	vịnh	None
baybalka	thánh	None
baybalku	thánh	None
baydhaba	lại	None
baydhabo	lên	None
baydhabotan	này	None
baylah	thương	None
baxeen	ngoài	None
baxdo	cút	None
baxday	ngoài	None
baxdaa	cút	None
baseey	cứ	None
bashiir	sản	None
bashir	bashir	Nan
bataatiga	tây	None
batalaale	bạn bè	Nan
batay	tăng	None
bateen	lên	None
base	cứ	None
batroolka	dầu	None
baw	baw	Nan
baxa	ngoài	None
baxaa	lá	None
baxaan	ngoài	None
baxay	ngoài	None
baxayaa	lá	None
baxda	ngoài	None
batuuta	dối	None
bariiska	cơm	None
bikra	trinh	None
bilaa	có	None
boorin	đốc	None
boorinta	hào	None
boosaaso	anh	None
boosaha	bài	None
booskii	đo	None
booskiisii	ấy	None
boqol	trăm	None
boqolkii	trăm	None
boqolkiiba	trăm	None
boqolsoon	trăm	None
boqor	vua	None
boqorad	hoàng	None
boqoraddii	hoàng	None
boqorka	vua	None
boqorkayow	tôi	None
boorame	bí	None
boqorkii	vua	None
boorama	bí	None
booqdayaasha	khách	None
bombeelmada	bom	None
boob	cướp	None
bood	nhảy	None
boodhari	xoắn	None
booliiska	sát	None
booliska	sát	None
boon	lợi	None
boondheere	tìm	None
booqan	thăm	None
booqanaya	thăm	None
booqashada	thăm	None
booqashadeydi	tôi	None
booqdaa	thăm	None
booqdaan	thăm	None
booqday	thăm	None
booqdo	thăm	None
boqornimada	vuong quoc	Nan
boqortooyada	vuong quoc	Nan
boqortooyadii	vuong quoc	Nan
bukhaari	xe	None
bukhari	bukhari	Nan
bulgaariya	bulgaria	None
bulgaria	bulgaria	None
bullaxaar	thải	None
bulleted	dòng	None
bulshada	đồng	None
bulshadabawaayo	đồng	None
bulshadeennu	tôi	None
bulshadii	đồng	None
bulsho	hội	None
bun	bún	None
buq	ù	Nan
bur	mì	None
buraan	u	None
buka	ốm	None
buhoodle	mua	None
budh	phật	None
buaale	xô	None
boqortooyadu	vuong quoc	Nan
boqortooyo	vương	None
boqray	vua	None
borama	borama	Nan
borogaramyo	viên	None
bortaqiiska	nha	None
borwa	đến	None
bollywood	ép	None
bosniya	muộn	None
botswana	botswana	None
brdm	brdm	Nan
britain	anh	None
britan	mai	None
britanwaxa	mai	None
british	anh	None
btr	btr	None
botha	hai	None
bolkaniskaee	phát	None
bolis	bolus	Nan
boliifia	biliifia	Nan
billaabo	đầu	None
biloobo	bộ	None
bilood	tháng	None
bilow	đầu	None
bilowday	đầu	None
bilowgii	đầu	None
bilsho	song	None
bilwaday	hoa	None
bin	theo	None
bini	loại	None
biniaadamka	loại	None
biniaadanka	của	None
bintu	bintu	Nan
binu	tiếc	None
bir	là	None
bill	hóa đơn	Nan
bile	mật	None
bilay	tháng	None
bilawgii	đầu	None
bilaabaan	đầu	None
bilaabata	đầu	None
bilaabatay	đầu	None
bilaabato	đầu	None
bilaabay	đầu	None
bilaabayaa	đầu	None
bilaabeen	đầu	None
biritishka	anh	None
bilaabidda	đầu	None
bilaabo	từ	None
bilaal	chương	None
bilaawday	đầu	None
biladao	chương	None
bilaha	tháng	None
bilawday	đầu	None
bilawga	đầu	None
bilaabmay	đầu	None
bil	tháng	None
birmingham	dương	None
bisha	tháng	None
bmp	bmp	Nan
bni	bni	Nan
bog	trang	None
boga	trang	None
bogaadin	khen	None
bogaan	này	None
bogan	bogan	Nan
bogga	trang	None
boggan	này	None
bohol	miệng	None
boire	khoang	None
bois	bois	Nan
boland	boland	Nan
bold	cảm	None
bole	thân cây	Nan
biyo	nước	None
biyihii	nước	None
biyaha	nước	None
bixiyey	cấp	None
bishii	tháng	None
bishiisa	ấy	None
bishuna	bishuna	Nan
bisinka	bis	Nan
bisiqa	tay	None
bisiqley	bisiqley	Nan
bislaado	chín	None
birta	là	None
bislaanaayo	chín	None
bixin	ngoài	None
bixinta	khoản	None
bixisaa	cấp	None
bixisay	toán	None
bixiya	cấp	None
bixiyaan	cấp	None
bixiyay	cấp	None
bixi	ngoài	None
dheeraada	hơn	None
bariise	cơm	None
bariire	mạch	None
baa	là	None
baabal	mất	None
baabii	khỏi	None
baabulmandab	xe	None
baabuur	hơi	None
baabuurta	hơi	None
baad	bạn	Nan
baadi	lỗi	Nan
baadicadde	bội	None
baadiye	hiểm	None
baahan	cầu	None
baahday	thiết	None
baahi	cầu	None
baahiayay	tiết	None
baahida	cầu	None
ba	phải	None
baahintaasi	sóng	None
b	b	Nan
azc	azc	Nan
ayeey	sống	None
ayey	đường	None
ayeyna	họ	None
ayna	họ	None
aynaan	không	None
aynaanshe	là	None
aynu	hãy	Nan
ayoo	sáng	None
aysan	không	None
aysanna	không	None
ayuu	ta	None
ayuub	heb	Nan
ayuun	mừng	None
ayuuna	làm	None
ayuuu	ta	None
aṣṣūmāl	anūmālāl	Nan
baahna	cần	None
baahnaa	thiết	None
baal	vũ	None
baarlamaanka	hội	None
baarliin	bay	None
baarri	sự	None
baaruude	trinh	None
baasifik	nhựa	None
baath	baath	Nan
baaxad	vi	None
baaxada	thước	None
baaxadda	thước	None
baaxadiisu	vi	None
baay	vịnh	None
baayacmushtar	hàng	None
baayasiid	bán	None
baaz	buz	Nan
babaayga	tôi	None
baarlamaan	hội	None
baaritaan	điều	None
baaris	nghiên cứu	Nan
baariis	liệt	None
baalakan	cánh	None
baallacad	rộng	None
baalle	vở	None
baan	hàng	None
baanka	hàng	None
baannu	có	None
baanu	tiếc	None
ayeen	họ	None
baaq	gọi	None
baaqan	lại	None
baaqayeen	gọi	None
baaqaysay	gọi	None
baar	tìm	None
baardheere	xe	None
baargaal	cả	None
baari	baari	Nan
baaqa	gọi	None
ayee	dịp	None
aydinaan	gấu	None
aydhiyooliyadda	mệnh	None
avv	avv	Nan
aw	ôi	None
awal	sao	None
awaxaana	có	None
awdadl	awdadl	Nan
awdal	awdal	Nan
awdalxiligaasoo	đó	None
awdigil	ngươi	None
awdigilwuxuu	được	None
aweys	đôi	None
awgeed	vì	None
awliyada	tions	Nan
awmuuse	thành	None
awood	quyền	None
awooda	năng	None
average	cộng	None
avenue	đại	None
available	sẵn	None
authentication	thực	None
assembly	hợp	None
astaamaha	triệu	None
astaamo	triệu	None
astaan	biểu tượng	Nan
astaannta	trưng	None
astaanta	biểu tượng	Nan
asturaa	tiếc	None
awoodaha	quyền	None
asxaabtii	bạn bè	Nan
at	tại	None
atlaantik	dương	None
atom	tử	None
attaxiyaadka	thuyết	None
audio	thanh	None
august	tám	None
australia	châu	None
asxaabtiisa	ông	None
babac	lên	None
awooday	thể	None
awoodeedu	của	None
ayaa	các	None
ayaad	bạn	Nan
ayaamo	ngày	None
ayaan	tôi	None
ayaana	là	None
ayaanle	hà	None
ayaanu	sẽ	None
ayaay	họ	None
ayada	ấy	None
ayadoo	với	None
ayaga	họ	None
ayagoo	họ	None
ayan	không	None
ayay	họ	None
aybakar	vấn	None
aya	thơ	Nan
ay	họ	None
axmedعبدالله	trặc	None
axmed	rìu	None
awoodii	năng	None
awoodoodiiwaxayna	họ	None
awoow	nội	None
awoowe	nội	None
awoowgiis	ấy	None
awoowgiisii	ấy	None
awqaafta	định	None
awoodda	quyền	None
awsamaale	dụ	None
axaaddiista	quật	None
axaadiista	hói	Nan
axad	chủ	None
axdiga	khế	None
axdigii	khế	None
axkaamta	lại	None
axmad	khế	None
axaaaddiistuba	hói	Nan
bariis	cơm	None
babayga	tôi	None
bacadle	sau	None
bandhigo	bày	None
bandhigtay	bày	None
bangiga	hàng	None
bangigu	hàng	None
bangladesh	bangladesh	Nan
bani	loại	None
baniaadamka	người	None
banii	banii	Nan
bank	hàng	None
banka	hàng	None
banna	lại	None
bannaan	gian	None
bannaanayd	trống	None
baqaa	hãi	None
baqay	hãi	None
bandhigeen	bày	None
baqaya	sợ	None
bandhigay	bày	None
banadir	hiếm	None
baledweyn	lớn	None
balila	mạch	None
ballaadhaan	rộng	None
ballaadhan	lớn	None
ballaaran	rộng	None
ballaariyeen	rộng	None
ballan	hứa	None
ballanta	cuộc	None
balqiisa	công	None
balse	nhưng	None
bamkii	bơm	None
banaadir	banadir	Nan
banaan	trống	None
banaanideeda	ngoài	None
banaanka	ngoài	None
bandarbayla	nghiêm	None
baqdaad	hành lý	Nan
bar	ba	None
bara	năm	None
baray	dạy	None
barayaal	dục	None
barayoo	học	None
barbaaray	lên	None
barbaarin	nuôi	None
barbaarinta	dục	None
barbaariyo	dục	None
barbaraawi	barbaraw	Nan
barde	barre	Nan
bare	dẫn	None
bareen	học	None
bari	để	None
baridiisa	ấy	None
bariga	đông	None
bariidka	cơm	None
barax	liệt	None
barawe	bắt	None
barasiil	cơm	None
barasho	học	None
baraako	phúc	None
baraalan	lên	None
baraan	dạy	None
baraarug	thức	None
baraawe	ngữ	None
baracaatika	chuyển	None
barack	barack	None
balcad	bay	None
baraf	tuyết	None
barakaat	bạn biết	Nan
barakacii	chuyển	None
baran	học	None
barano	học	None
barashada	học	None
barashadiisa	ấy	None
barashadiisii	ấy	None
baraguay	lành	None
balantii	hứa	None
balanqaadyadii	hứa	None
balanqaaday	hứa	None
badantahay	nhiều	None
badanyahay	nhiều	None
badanyihiin	nhiều	None
badashay	đổi	None
badaye	đông	None
badbaaday	được	None
badbaadayso	được	None
badbaadid	kiệm	None
badbaadinta	kiệm	None
badbaadiyey	đã	None
badbaadiyo	lưu nó	Nan
badda	biển	None
baddacas	xấu	None
baddii	biển	None
badh	nửa	None
badanna	nhiều	None
badankoodu	họ	None
badankooda	họ	None
badankood	họ	None
bachelor	cử nhân	Nan
bad	xấu	None
bada	cho	Nan
badacas	biển	None
badal	đổi	None
badalay	đổi	None
badaleen	đổi	None
badhaadhe	chừng	None
badalin	đổi	None
badan	nhiều	None
badana	xuyên	None
badanaa	thường	None
badanaayey	xuyên	None
badane	nhiều	None
badani	nhiều	None
badanina	họ	None
badalo	đổi	None
bacaadka	cát	Nan
badhan	nút	None
badhtamaha	giữa	None
bahdil	hổ	None
bahdood	thiếu	None
bahoobayxafladan	này	None
bakaaraha	bakaaro	Nan
baki	đen	None
bakistaan	pakistan	None
bakool	bánh	Nan
bakoolgalgaduudnugaal	sốt	None
bakr	mì	None
bal	xem	None
balaadhan	rộng	None
balaaran	lớn	None
balaarintii	rộng	None
balad	hói	Nan
baladhaan	này	None
bahda	đời	None
bahal	thú	None
bahabar	cắt	None
bah	bah	Nan
badhtamihii	giữa	None
badiba	hết	None
badiyaa	thường	None
badka	biển	None
badmareen	thuyền	None
badn	xấu	None
badnaa	nhiều	None
badhigtay	đã	None
badnayd	phong	None
badnayn	nhiều	None
badneyn	nhiều	None
badno	hơn	None
badood	biển	None
badwaynta	dương	None
badweynta	dương	None
baghdad	bàn	None
badnaydna	dào	None
joogaanba	tôi	None
dheeraadka	vào	None
dheere	dài	None
helaynin	tìm	None
helayo	tìm	None
helaysaa	lấy	None
heleen	tìm	None
heleysa	nhận	Nan
heli	tìm	None
helin	tìm	None
helitaanka	dụng	None
heliwaa	sẵn	None
helno	tìm	None
helo	tìm	None
helsinki	helmsinki	Nan
herar	herar	Nan
herbert	herbert	None
herer	ấy	None
helaye	tìm	None
heshay	nhận	Nan
helayaa	sẵn	None
helay	tìm	None
heesaa	hát	None
heesaan	hát	None
heesaha	nhưng	None
heesanin	hát	None
heesayaan	hát	None
heesihii	nhưng	None
heeso	hát	None
heesta	hát	None
heestaan	này	None
heestay	hát	None
heestii	hát	None
heesto	hát	None
height	chiều	None
helaa	tìm	None
helaan	tìm	None
helaya	nhận	Nan
heshid	tìm	None
heshiis	đồng	None
heshiiska	đồng	None
hijrada	cư	None
hijriga	cư	None
hijrigu	cư	None
hijriyada	cư	None
hilibka	thịt	None
hilibku	thịt	None
hillary	đồi	None
hilowle	chào	None
hindi	tiếng	None
hindida	lại	None
hindiya	tiếng	None
hindu	hindu	None
hingaada	tả	None
hingaadda	tả	None
hiraab	túng	None
hiiraan	hira	Nan
hiil	chào	None
high	cao	Nan
hiddo	tài	None
heshiiskii	đồng	None
heshiiso	giải	None
heshiisyo	điều	None
heshiiyeen	ý	None
hesho	tìm	None
heshowali	giải	None
heyada	chân	None
heesa	hát	None
heyn	giữ	None
heystayna	có	None
heysto	có	None
hibaaqeey	nhắc	None
hibada	món	None
hibo	năng	None
hibrahim	hibrahim	Nan
hiddaha	truyền thống	Nan
heysta	có	None
hiraabe	chuyện	None
hees	hát	None
heerka	độ	None
hawd	diều	None
haween	bà	None
haweenaydii	người	None
haweenka	bà	None
haweenkii	bà	None
haweenku	bà	None
hawiyaha	hòa	None
hawiye	thỏa	None
hawl	bài	None
hawlaha	động	None
hawo	bay	None
hawood	rong	None
hawshaas	đó	None
hawshii	nhiệm	None
hay	hay	None
hawayga	mắt	None
haya	thuê	None
hawaii	hawaii	Nan
haw	diều	None
hargeisa	hargaisa	Nan
hargesa	hargesa	Nan
hargeysa	hangeisa	Nan
hariin	ráp	None
harimacadka	loạn	None
harraad	khát	None
harti	harti	Nan
hartigu	rùa	None
has	có	None
hasan	hasan	Nan
hase	nhiên	None
haseyeeshee	nhiên	None
hashiisii	ấy	None
hassan	tạp	None
have	có	None
hawada	không	None
hayaa	giữ	None
hayaan	giữ	None
hayada	đại	None
haysateen	có	None
haysato	có	None
haysay	giữ	None
hayso	giữ	None
haysta	hữu	None
haystaan	có	None
haystay	có	None
haystee	giữ	None
haysteen	có	None
haysto	có	None
hdms	hdms	Nan
he	ta	None
hebel	thỏ	None
heeganaa	chờ	None
heer	độ	None
haysatay	có	None
haysata	có	None
haysan	có	None
haysaan	có	None
hayadaha	quan	None
hayadda	thân hình	Nan
hayay	giữ	None
haybadoofdii	xuất	None
hayd	đúng	None
hayeen	có	None
hayeeshee	nhiên	None
heersare	xuất	None
hayey	giữ	None
hayin	ngoài	None
hayn	giữ	None
haynin	giữ	None
hayo	giữ	None
hays	có	None
haysa	giữ	None
haysaa	có	None
hayeyguddoomiyaha	đốc	None
hirayo	mượn	None
hireey	chào	None
hirgelinteeda	của	None
hormaro	tiến	None
hormarsan	nâng	None
hormood	tiến	None
hormoon	môn	None
hormuudka	tiền	None
horraantii	hơn	None
horrayntii	tiên	None
horraysay	tiên	None
horreeya	tiên	None
horreeyay	tiên	None
horreeyey	tiên	None
horreyey	trước	None
horreysa	tiên	None
horsed	ngựa	None
horseed	đầu	None
hormar	phát	None
horseedaan	chì	None
horm	nâng	None
horjoogsan	cản	None
horeeysay	tiên	None
horeeyso	tiên	None
horena	sàng	None
horey	hơn	None
horeyay	trước	None
horeysay	tiên	None
horeysey	hơn	None
horjeed	trái	None
horjeeda	đối	None
horjeeday	đối	None
horjeedeen	đối	None
horjeeedo	lại	None
horjeesatay	đối	None
horjeestay	đối	None
horjeesteen	đối	None
horkeentay	ấy	None
horseeday	dẫn	None
hortagay	chặn	None
hortageen	mặt	None
howlo	động	None
howlwadaag	sự	None
hoyatay	tôi	None
hoyga	ẩn	None
hoyisay	nộp	None
hoyn	ẩn	None
httpsowikipediaorgwikidigiliyomirifle	httpsowikipediaorgwikidigiliyomirifle	Nan
httpwwwfreewebscominawarfaa	httpwwwfreewebscominawarfaa	Nan
httpwwwfreewebscominawarfaaindexhtm	httpwwwfreewebscominawarfaaindexhtm	Nan
httpwwwyoutubecomwatchv=lzyegdtes	httpwwwyoutubecomwatchv = lzyegdtes	Nan
huang	huang	Nan
hub	vũ	None
hubaal	rồi	None
hubaysan	trang	None
hubiyey	kiểm	None
howlgal	động	None
howlaha	động	None
however	nhiên	None
how	sao	None
hortago	chặn	None
hortii	tiên	None
hortiisa	ấy	None
horumar	phát	None
horumarinta	phát	None
horumarka	phát	None
horumartay	phát	None
horeeyo	tiên	None
horuu	huu	Nan
horyimid	trước	None
hospital	viện	None
hospitaller	khách	None
hoteel	sạn	None
hoteelada	sạn	None
hotel	sạn	None
hotelada	sạn	None
horyaal	đoàn	None
horeeyey	hơn	None
horeeye	tiên	None
horeeyay	tiên	None
hogaamiyayaal	đạo	None
hogaamiye	đạo	None
hogaamiyihii	đạo	None
hogaamiyihiis	của	None
hogaan	đạo	None
hogaanka	đầu	None
hogaankii	đạo	None
hoggaaminaayo	dẫn	None
hoggaamiyihii	đạo	None
hoggaanka	đạo	None
hogol	hogol	Nan
hohey	hohey	Nan
hohob	hohob	Nan
holand	lan	None
holland	lan	None
hogaamiyaha	đạo	None
hogaamiya	đầu	None
hogaaminayey	dẫn	None
hogaaminayeen	dẫn	None
hirgeliyo	thi	None
hirka	triều	None
hiroshima	hiroshima	None
history	sử	None
hivga	hivga	Nan
hiyiga	sở thích	Nan
hlibka	bê	Nan
home	chủ	None
hobalada	quyển	Nan
hobolada	holocausts	Nan
hobyo	hobyo	Nan
hodan	có	None
hoddaye	có	None
hogaaminaayey	đầu	None
hogaaminaya	đầu	None
hogaaminayay	đầu	None
hobolad	lượn	None
hargaysi	lạnh	Nan
hona	hona	Nan
hoo	hoo	Nan
hooyadood	họ	None
hooyay	mẹ	None
hooyeen	mẹ	None
hooyey	mẹ	None
hooyo	mẹ	None
hor	trước	None
horaa	sàng	None
horaantii	hơn	None
horay	hơn	None
horaysay	tiên	None
hordhac	thiệu	None
hordhaca	thiệu	None
hore	hơn	None
horeba	sàng	None
horeeya	tiên	None
hooyadiis	ta	None
hooyadii	mẹ	None
hooyada	mẹ	None
hooy	ẩn	None
hooggiinee	khốn	None
hooreysa	trình	None
hoos	xuống	None
hoosaad	phụ	Nan
hoosdhaban	thấp	None
hoose	phía	None
hoosedhexe	giữa	None
hong	hồng	Nan
hooseeya	thấp	None
hoosta	phía	None
hoostaga	dưới	Nan
hoostagaan	phục	None
hoosteeda	dưới	Nan
hoostiis	dưới	Nan
hoostiisa	dưới	Nan
hooteelka	sạn	None
hooseshabeelaha	cấp	None
hargaysa	hangeisa	Nan
hargaha	da	None
hareeyey	vây	None
guryahoodii	họ	None
guryihii	cửa	None
guryo	cửa	None
guryohoodii	họ	None
guto	đi	None
guubaabiyey	kích	None
guud	chung	None
guude	trói	None
guudkeeda	mặt	None
guul	công	None
guulaysatay	công	None
guulaystay	công	None
guuldaraystay	bại	None
guuleed	phục	None
guuleestay	thắng	None
guryaha	cửa	None
guuleyso	công	None
gurmadeenitoobiya	chủ	None
gurigiisa	ấy	None
gumeestihii	dân	None
gumeestiyaashii	dân	None
gumeysi	dân	None
gumeysiga	dân	None
gumeysigii	dân	None
gumeystaha	tá	None
gumeystihii	tá	None
gumeysto	thuộc	None
guray	xám	None
gureey	xuống	None
gurey	tay	None
guri	ở	None
guriceel	guriel	Nan
guriga	ở	None
gurigii	ngôi nhà	Nan
gurigiisii	ấy	None
guuleystay	công	None
guuleysto	công	None
guulihii	tựu	None
guursatay	cưới	None
guurtida	viện	None
guusha	công	None
guyana	báo	None
gyastayn	chữa	None
göteborg	göteborg	Nan
h	h	Nan
ha	họ	None
haa	đúng	None
haadaan	đúng	None
haadku	ôm	None
haag	đúng	None
haagu	trái	None
haajiray	cư	None
haajirtay	cư	None
guursado	hôn	None
guursadey	hôn	None
guursadaye	hôn	None
guursaday	cưới	None
guullahay	công	None
guulo	công	None
guulside	bại	None
guulwadayaasha	thắng	None
guulwade	thắng	None
guur	hôn	None
guuraaga	chuyển	None
gumeestayaasha	dân	None
guuraan	chuyển	None
guure	chuyển	None
guureen	chuyển	None
guurey	chuyển	None
guuriyaha	vợ	None
guurka	hôn	None
guuro	chuyển	None
guursadaan	hôn	None
guuray	chuyển	None
gumeestay	goth	Nan
gumeesiga	thuộc	None
gumeesanin	thuộc	None
gowracay	sát	None
gowracayn	sát	None
gowraco	sát	None
goysay	cắt	None
gpp	gpp	Nan
gprs	gprs	Nan
grand	lớn	None
graziani	graziani	Nan
groningen	groningen	Nan
groups	nhóm	None
gsare	nhảy	None
gsm	gsm	Nan
gsmka	gsumm	Nan
gu	gu	None
gubay	cháy	None
gowrac	sát	None
government	quyền	None
gorgor	ưng	None
gorfayna	gorfayna	Nan
goobtain	này	None
goobtan	này	None
goobtani	này	None
goobtii	trí	None
goobweyn	trí	None
googoayey	cắt	None
gooni	rời	None
gud	đầu	None
goor	gian	None
goorta	nào	None
goortii	nào	None
goortuu	ta	None
goosha	thắng	None
goostay	thu hoạch	Nan
gooyo	cắt	None
goray	goray	Nan
goorba	luôn luôn	Nan
haan	haan	Nan
guda	giống nhau	Nan
gudaha	trong	None
gugii	này	None
guilliani	guilliani	Nan
guinea	lang	None
guluf	guluf	Nan
gumaaday	nứt	None
gumaysan	thuộc	None
gumaysiga	dân	None
gumaysigii	dân	None
gumaysta	dân	None
gumaystaha	dân	None
gumaystay	thuộc	None
gumaystayaasha	dân	None
gumaystayaashii	dân	None
gumaystayaashu	dân	None
gumaystihii	thuộc	None
guga	xuân	None
guduud	đỏ	None
gudoonsiiyaya	góp	None
gudoomiyihii	đốc	None
gudaheeda	trong	None
gudanno	đầu	None
gudbay	qua	None
gudbey	qua	None
gudbin	khảo	None
gudbo	qua	None
guddidii	bảng	None
gudabaarsan	tròn	None
guddiga	ban	None
guddoomiyihii	đốc	None
guddoonsaday	nhận	Nan
gudiga	ban	None
gudihiisa	trong	None
gudo	đầu	None
gudoomiyaha	tịch	None
gudoomiye	tịch	None
guddoomiyaha	đốc	None
hubka	vũ	None
haare	haare	Nan
haashim	haashim	Nan
halgankii	tranh	None
halhays	thoại	None
halis	hiểm	None
halka	khi	None
halkaa	đó	None
halkaan	đây	None
halkaana	đó	None
halkaas	đó	None
halkaasi	đó	None
halkaasna	đó	None
halkaasoo	đâu	None
halkan	đây	None
halkanna	đó	None
halkay	đâu	None
halkii	thế	None
halgankaas	đó	None
halkiisii	thế	None
halganka	tranh	None
halgame	người	None
haji	hương	None
haka	thế	None
hakad	ngừng	None
hal	một	None
halaad	hoại	None
halaag	hoại	None
halac	halal	Nan
haldoor	sổ	None
haldoorka	đạo	None
half	nửa	None
halfrate	nửa	None
halgamaa	tranh	None
halgamaayaashii	động	None
halgamay	lộn	None
halgamayaashaasi	tranh	None
halgan	tranh	None
halmar	lần	None
halqabsadeen	làm	None
halyeey	thoại	None
hantida	sản	None
hantiwadaaga	hội	None
hanto	thác	None
hanuun	dẫn	None
hanuuniye	tinh	None
hanuunka	dẫn	None
har	khi	None
harag	da	None
harar	mập	None
haray	lại	None
haraye	biệt	None
hareen	lại	None
hareeraha	quanh	None
hareereheeda	cô	None
hareereysan	quanh	None
hanti	có	None
hanoolaato	ước	Nan
hannaan	trình	None
handsets	tay	None
halyey	thoại	None
hamashka	võng	None
hamdan	hamdan	Nan
hamiyayey	dỗ	None
hamzada	biệt	None
hamzo	hồ	None
hana	chặn	None
haile	đá	None
hanaaqaadeen	rối	None
hanaqaad	phát	None
hanaqaaday	trẻ	None
hanaqaadeen	mạnh	None
hanaqaadkii	dục	None
hanato	mập	None
hanbalyo	mừng	None
handset	tay	None
hanan	lại	None
hagistiisu	ấy	None
hagayay	dẫn	None
hagari	mặc	None
hablood	gái	None
haboon	hợp	None
habsamiya	trơn	None
had	có	None
hada	gồm	None
hadaad	nếu	None
hadaaftimo	đích	None
hadaan	không	None
hadaba	thế	None
hadad	bạn	Nan
hadal	chuyện	None
hadaladii	lệnh	None
hadalka	phát	None
hadalkana	phát	None
hadalkii	từ	None
hablaha	gái	None
habkii	cách	None
habka	pháp	None
habeenkii	đêm	None
haatan	nay	None
haatuf	haatuf	Nan
haayo	giữ	None
hab	pháp	None
haba	haba	Nan
habaabay	lầm	None
hababka	pháp	None
hadalkiisa	ấy	None
habar	cô	None
habarjeclo	mừng	None
habartii	giờ	None
habaysan	chức	None
habboon	hợp	None
habdhiska	thần	None
habeen	đêm	None
habeenkeeda	ấy	None
habargidir	mừng	None
haaruun	haroon	Nan
hadana	nhiên	None
hadasho	chuyện	None
hadla	nói	None
hadlaa	nói	None
hadlaan	nói	None
hadlay	nói	None
hadlaya	nói	None
hadlayaayey	nói	None
hadlayana	nói	None
hadlayo	nói	None
hadli	nói	None
hadlid	chuyện	None
hadlin	nói	None
hadlo	nói	None
hadraawi	hói	Nan
haduu	ấy	None
hagar	xao	None
hadiye	nuốt	None
hadii	nếu	None
hadhwanaag	hôn	None
hadhay	trái	None
haday	nếu	None
hadayn	không	None
hadba	trước	None
hadda	nay	None
haddaa	nếu	None
haddaad	nếu	None
haddaan	không	None
hadane	sao	None
haddaba	nay	None
hadday	nếu	None
haddii	nếu	None
haddiise	nếu	None
hadduu	anh	None
hadduusan	không	None
hadeer	nay	None
hadey	nếu	None
haddana	nữa	None
goobta	trí	None
hubkuu	ấy	None
hubsaday	tâm	None
iyaguna	nổ	None
iyana	cũng	None
iyo	và	None
iyoama	đúng	None
iyoturkigawaxaanuu	của	None
j	j	None
jaad	jaad	Nan
jaadjaad	vần	None
jaadka	chuột	None
jaahiligii	dốt	None
jaajuus	điệp	None
jaale	vàng	None
jaaliyadaha	hội	None
jaalle	vàng	None
jaamac	học	None
iyagu	họ	None
jaamaca	học	None
iyagoon	điển	None
iyagana	chế	None
itoopiya	trí	None
itopiyanka	tán	None
its	là	None
iuyo	ồn	None
iwm	vân	None
iyaba	mẹ	None
iyada	ấy	None
iyadana	tôi	None
iyadii	ấy	None
iyadoo	với	None
iyadoon	có	None
iyadu	mẹ	None
iyaduna	tôi	None
iyaga	họ	None
iyagaa	họ	None
iyagoo	họ	None
jaamacad	học	None
jaamacada	học	None
jaamacadaha	học	None
jabouti	tiếng	None
jabriil	tháng	None
jabtay	hỏng	None
jabuuti	djibouti	None
jabuuticiisaha	tiến	None
jabuutiwaxaa	djibouti	None
jabuutti	jabuutti	Nan
jacayl	quý	None
jacaylka	quý	None
jaceyl	quý	None
jacfar	quý	None
jaciir	vỏ	None
jacques	thảo	None
jagada	chức	None
jago	dẫn	None
jabkaas	xương	None
jabiyey	vỡ	None
jabhado	xương	None
jabhadii	xương	None
jaamacadda	học	None
jaamacadii	học	None
jaamacado	học	None
jaamacadu	học	None
jaamcada	học	None
jaamow	vâng	Nan
jaantuska	đồ	None
itoobiyana	ê-díp-tô	Nan
jab	xương	None
jabaanlaakiin	hỏng	None
jaban	hỏng	None
jabay	hỏng	None
jabhad	chiến	None
jabhada	xương	None
jabhadda	trận	None
jabhaddii	trang	None
jabaan	hỏng	None
jahannamo	ngục	None
itoobiyaereteriya	ê-ti-ô	Nan
itoobiyaan	người	None
ismaandhaafkooda	họ	None
ismaciil	ismail	Nan
ismacil	chức	None
ismail	tử	None
isna	nói	None
isniin	hai	None
iso	đến	None
israaca	cùng	None
israaiil	israaiil	Nan
israailaye	cửu	None
israel	người	None
israil	sắt	None
isreebreeb	kiện	None
isse	dự	None
issisalaamya	chuyện	None
ismaan	phát	None
isssssssslam	giờ	None
ismaamulo	tự	None
ismaamulgoboleedka	sọ	None
islam	hồi	None
islamarkaana	thời	None
islamarkaasna	thời	None
islamdu	hồi	None
islamic	hồi	None
islamka	hồi	None
island	đảo	None
isleeg	bằng	None
isleegta	trình	None
islii	đông	None
islofaakiya	liệt	None
islofeeniya	liệt	None
isloveeniya	đồng	None
isma	phải	None
ismaaciil	ismael	Nan
ismaamulka	tôi	None
istaagay	lại	None
istaagey	lại	None
istaagi	lên	None
istiraajiyada	lược	None
isu	tôi	None
isufahmeen	cùng	None
isugu	tự	None
isuma	không	None
iswiidhan	điển	None
iswiisarland	thụy sĩ	Nan
iswiizerlaan	xích đu	Nan
iswisarland	thụy sĩ	Nan
isxaaq	isaac	None
it	nó	Nan
itaaliya	ý	None
italiana	ý	None
item	mục	None
itoobiya	ê-díp-tô	Nan
istiraaji	thận	None
isticmalka	dụng	None
isticmalaa	dụng	None
isticmaasho	dụng	None
istaago	lại	None
istabta	xăm	None
istanbuul	thuẫn	None
istandharka	bù	None
istarliin	ghẻ	None
isticmaal	dụng	None
isticmaalaa	dụng	None
itoobiyaanka	ethiopian	Nan
isticmaalaan	dụng	None
isticmaalay	dụng	None
isticmaalayaasha	dùng	None
isticmaalayo	dụng	None
isticmaali	dụng	None
isticmaalka	dụng	None
isticmaalo	dụng	None
isticmaarka	dụng	None
isticmaalaha	dùng	None
jakarta	túi	None
jama	người	None
jamaal	dân	None
jiita	phút	None
jiitaan	kéo	None
jijeele	đảo	None
jilaa	viên	None
jilaamasrax	jilaamasrax	Nan
jili	ớt	None
jilib	gối	None
jilibkiisa	anh	None
jilicsan	mại	None
jimcaale	yêu	None
jimcale	bộ	None
jimce	sáu	None
jimcihii	sáu	None
jimco	sáu	None
jinka	của	None
jiir	chuột	None
jiq	kêu	None
jiinow	tỉnh	None
jiilashii	duệ	None
jidkaas	đó	None
jidkan	này	None
jidkii	cách	None
jidle	may	None
jifadiisa	ấy	None
jigjiga	ghép	None
jihaad	chiến	None
jihaaday	đạo	None
jihaadka	chiến	None
jiho	bang	None
jiidaas	này	None
jiidasho	hút	None
jiido	kéo	None
jiilaal	đông	None
jiilasha	hệ	None
jiilkii	hệ	None
jir	cũ	None
jira	đợi	None
jiraa	có	None
jirney	đã	None
jiro	hữu	None
jirsaday	lượt	Nan
jirta	tại	None
jirtaa	có	None
jirtay	tại	None
jirteen	hữu	None
jirtey	tại	None
jirto	hữu	None
jirtowax	có	None
johannesburg	johannesburg	None
johnston	johnston	None
joog	lại	None
jooga	trong	None
joogaa	đây	None
jirkii	thể	None
jirka	thân hình	Nan
jiritaankeeda	của	None
jiritaanka	tại	None
jiraan	đó	None
jiraba	thực	None
jirae	đó	None
jirataaa	rồi	None
jiray	tại	None
jiraye	hữu	None
jiraysoomaaliya	somalia	Nan
jidka	cách	None
jireen	được	None
jireenan	được	None
jireenka	tại	None
jireenwaxee	được	None
jirey	hữu	None
jiri	dụng	None
jirin	không	None
jirinhaddaba	cả	None
jireena	đó	None
jideeyey	giữ	None
jideeyay	giữ	None
jid	cách	None
jareen	cắt	None
jareer	ngoại	None
jariiban	ngữ	None
jarmaankakuwaas	trẻ	None
jarmal	đức	None
jarmalka	đức	None
jaro	cắt	None
jasiira	đảo	None
jasiirad	đảo	None
jasiirada	đảo	None
jasiiradaha	đảo	None
jasiirado	đảo	None
jasiiradood	đảo	None
jawaabay	lời	None
jawaabeen	lời	None
jaray	cắt	None
jaraaidka	báo	None
janno	đường	None
jannada	đường	None
jamaame	đàn	None
jamac	nhiều	None
jamacada	nhiều	None
jamal	nhiễu	None
jameecada	chúng	None
jameeco	chúng	None
jamhuriyada	hòa	None
jawaabey	lời	None
jamhuriyadda	hòa	None
jamhuuriyad	hòa	None
jamhuuriyada	hòa	None
jamhuuriyadda	hòa	None
janaayo	giêng	None
janaraal	chung	None
jannaale	một	None
jannaayo	giêng	None
jamhuuriya	hòa	None
islaax	lại	None
jawaabo	lời	None
jawi	trường	None
jeelle	thạch	None
jeer	lần	None
jeerin	trùng	None
jeex	mắt	None
jeexwaxaana	mắt	None
jen	đến	None
jenaraal	chung	None
jenaraalkii	chung	None
jeneraal	tướng	None
jeneral	chung	None
jesus	chúa	None
jibaaran	trường	None
jibiyay	vỡ	None
jibriil	gabriel	None
jicib	quăng	None
jeedo	xoay	None
jeediyo	xuất	None
jeediyeen	nghị	None
jeediyay	nghị	None
jawiga	khí quyển	Nan
jaziirada	đảo	None
je	đi	None
jebiyey	vỡ	None
jecel	quý	None
jecelyahay	yêu	None
jecelyihiin	quý	None
jawhar	gian	None
jeclaa	yêu	None
jeclayn	không	None
jeclaystay	yêu	None
jeeda	đi	None
jeedaa	đến	None
jeedaan	lại	None
jeeday	lại	None
jeediyana	xoay	None
jeclaan	quý	None
islaanimo	thần	None
islaan	hôn	None
islaamu	giống nhau	Nan
ilbaxnimadii	văn	None
ilka	răng	None
ilkaha	răng	None
illaa	đến	None
ilma	trẻ	None
ilmada	mắt	None
ilmadu	mắt	None
ilmo	trẻ	None
ilmohooda	họ	None
ilo	dụng	None
ilyaas	mắt	None
imaaday	đến	None
imaadeen	đến	None
imaam	tôi	None
imaamka	tôi	None
ilbaxnimada	văn	None
imaamkii	tôi	None
ilaha	nguồn	None
ilaawaan	đi	None
ilaaha	chúa	None
ilaahay	trời	None
ilaahayna	trời	None
ilaaheey	tôi	None
ilaahey	tôi	None
ilaahyo	thần	None
ilaalada	lính	None
ilaali	chừng	None
ilaalin	vệ	None
ilaalinta	vệ	None
ilaaliya	bảo vệ	Nan
ilaaliyaha	bảo vệ	Nan
ilaaliyo	vệ	None
ilaalo	bảo vệ	Nan
ilaashado	tôi	None
ilah	đúng	None
imaamu	hợp	None
imaan	đến	None
imaaraatka	thức	None
inaad	đến	None
inaadan	không	None
inaan	đến	None
inaanu	để	None
inaga	ta	None
inana	mẹ	None
inay	đến	None
inaynu	nên	None
inaysan	để	None
inbadan	hơn	None
included	gồm	None
including	cả	None
indha	mắt	None
indhabuur	mắt	None
indhaha	mắt	None
ina	sáng	None
in	trong	None
important	trọng	None
immam	tôi	None
imaarad	dư	None
imaatay	đến	None
imagekaahinjpg|daahir	tinh	None
imagekontulan	ảnh	None
imagem	tôi	None
imagemadaxwaynahaygajpg|siilaanyo	của	None
imagemogadishusjpg|	fantemogadishusjpg |	Nan
ilaah	trời	None
imagetuurjpg|cabdiraxman	fantetuurjpg | cabdiraxman	Nan
iman	đến	None
imanaysa	đến	None
imbaradooriyado	thông	None
imei	imei	Nan
imid	đến	None
imika	nay	None
iminka	nay	None
imagexamarcadejpg|	hình ảnhxamarcadejpg |	Nan
ilaa	đến	None
ila	hàng	None
il	mắt	None
ianaynu	hãy	Nan
iaygoo	tôi	None
ibin	cúng	None
ibn	ibn	Nan
ibnu	giấu	None
ibraahiim	câu	None
ibraahim	không	None
ibraahin	nói	None
ibrahim	ibrahim	Nan
ictiraaf	công	None
ictiraafsanyahay	thừa	None
idaacada	ga	None
idaacadaha	thanh	None
idaha	cảnh	None
identity	danh	None
ialahayna	tôi	None
iadoo	tôi	None
i	tôi	None
huud	xe	None
hudheello	sạn	None
hudhudkii	cung	None
hungaria	đói	None
huraan	cú	None
huray	khàn	Nan
hurda	ngủ	None
hurdada	ngủ	None
idhi	nói	None
hurdadii	ngủ	None
hureen	hỏng	None
hurin	cấp	None
hurre	chiếu	None
hurumarka	phát	None
huruud	vàng	None
huseen	trấu	None
hussein	hussein	None
hurdo	ngủ	None
indheergarad	tuệ	None
idiin	cho bạn	Nan
idin	bạn	Nan
iibsadaan	mua	None
iibsaday	mua	None
iibso	mua	None
iidow	tiệc	None
iiga	tôi	None
iigu	tôi	None
iikeeneen	đến	None
iima	đúng	None
iimaan	tin	None
iimaanka	tin	None
iimaankuna	tin	None
iiraan	iran	None
iisoo	tôi	None
ikhyaartii	chọn	None
ikwadoor	ủng	None
iibiyo	bán	None
iibiyey	bán	None
iibin	bán	None
iibgayn	bán	None
idinka	bạn	Nan
idinkaa	bạn	Nan
idinkana	cũng	None
idinkaysu	mình	None
idinla	với	None
idiris	nhai	Nan
idlaaday	thúc	None
idil	bộ	None
iesus	iesus	Nan
ifka	ifka	Nan
iftin	hoa	None
iga	đi	None
igad	dê	None
igu	tôi	None
ihi	tôi	None
ii	ii	Nan
if	nếu	None
hubo	rồi	None
indho	mắt	None
india	độ	None
isbania	hương	None
isbayn	tự	None
isbeheysi	tả	None
isbheysigii	bệnh	None
isbitaal	viện	None
isbitaalada	viện	None
isbitaalka	viện	None
isboorti	thao	None
isdaba	nối	None
isdullayn	thuộc	None
isga	saha	Nan
isgaadhsiinta	giao tiếp	Nan
isgaadhsiintu	giao tiếp	Nan
isgaarsiinta	giao tiếp	Nan
isha	mắt	None
isbadalka	đổi	None
ishkin	băm	None
isbadalin	đổi	None
isbadalada	đổi	None
irmaan	dai	None
irridka	cửa	None
irridkaa	này	None
irsaaqa	mua	None
is	là	None
isa	đủ	None
isaaq	phát	None
isaaqu	thưởng	None
isaga	ta	None
isagoo	có	None
isagu	ta	None
isanimo	mặt	None
isaxaaq	còi	Nan
isbadal	đổi	None
isbadala	đổi	None
isbadaladii	đổi	None
isi	đầu	None
isjiiraya	run	None
iska	không	None
islaamay	hôn	None
islaamcarabi	phát	None
islaameen	làm	None
islaami	hồi	None
islaamiga	hồi	None
islaamiya	phát	None
islaamiyiinta	hồi	None
islaamka	hồi	None
islaamkaayuu	hồi	None
islaamku	hồi	None
islaamkuna	hồi	None
islaamnimada	hồi	None
islaamnimadiisa	ấy	None
islaamnimo	hồi	None
islaamoow	chào	None
islaama	tự	None
islaam	hồi	None
isla	giống nhau	Nan
iskuxigxiga	tự	None
iskaashi	hợp	None
iskaashiga	hợp	None
iskaga	khác	None
iskama	tại	None
iskoolada	học	None
isku	tự	None
iskudar	vào	None
iritareeya	trốn	None
iskudayay	thử	None
iskula	giống nhau	Nan
iskuqabashada	đột	None
iskusoo	thả	None
iskuulada	học	None
iskuulka	trường	None
iskuulo	học	None
iskuxidhka	nối	None
iskugu	cùng	None
irir	tóc	Nan
iri	quá	None
iraq	iraq	None
ingriisugu	anh	None
initiated	xướng	None
injiil	âm	None
injineer	sư	None
inka	mực	None
inkasta	nhiên	None
inkastoo	nhiên	None
inkastoon	duyệt	None
inna	mẹ	None
innagaa	ta	None
innoo	tôi	None
innooga	mạnh	None
innoogu	tôi	None
inoo	tôi	None
inoogu	tôi	None
ingriisla	anh	None
ingriisku	anh	None
ingriiska	anh	None
ingriis	anh	None
indonesia	indonesia	None
indonesian	indonesia	None
indoniishiya	indonesia	None
indoor	trong	None
indoors	trong	None
indunisiya	indonesia	None
ineey	đến	None
inqilaab	xoắn	None
iney	đến	None
information	tin	None
ing	ing	Nan
ingiriis	anh	None
ingiriisiga	anh	None
ingiriiska	anh	None
ingiriisku	anh	None
ingirisku	anh	None
ineysan	không	None
indhuhu	mắt	None
inqilaabeen	thành	None
inqilaabkaasna	đó	None
internetka	trên	None
intey	intey	Nan
intii	khi	None
intiisa	lại	None
into	vào	None
intooda	họ	None
intuba	hơn	None
intuu	ta	None
inu	trong	None
inuu	đến	None
inuusan	không	None
inxiraaf	thạo	None
iqtiyaar	bắt	None
iraan	iran	None
iran	hệ	None
internet	internet	Nan
international	quốc tế	Nan
interference	thiệp	None
interface	diện	None
inqilaabkii	chính	None
insaanka	loại	None
insaykalobeedhiya	thư	None
insha	insha	Nan
insuliinka	insulin	None
inta	khi	None
intaa	ngoài	None
inqilaabka	chính	None
intaad	bạn	Nan
intaas	đó	None
intaasi	đó	None
intaasoo	hợp	None
intaba	hai	None
intay	họ	None
inteeda	họ	None
inteedii	lại	None
intaan	này	None
goobo	tròn	None
goobihii	điểm	None
goobeede	bán	None
doorkii	trò	None
dooro	chọn	None
doorroone	là	None
doorsamaye	mở	None
doorsan	chọn	None
doorshaane	chọn	None
doortaa	chọn	None
doortay	chọn	None
doorteen	chọn	None
doorto	chọn	None
dooxa	lũng	None
dooxada	lũng	None
dooxadii	lũng	None
doqon	nghếch	None
doqonniimo	dại	None
doorka	trò	None
dorraato	giá	None
dooriyee	lợi	None
doorashooyinkii	bầu	None
doono	sẽ	None
doonta	thuyền	None
doontaa	tìm	None
doonto	sẽ	None
doonyaha	thuyền	None
door	trò	None
dooranayay	bầu	None
dooranayeen	chọn	None
doorashada	chọn	None
doorashadaas	đó	None
doorashadan	này	None
doorashadii	bầu	None
doorasho	bầu	None
doorashooyin	bầu	None
doorashooyinka	bầu	None
doorin	chọn	None
dowlad	quyền	None
dowlada	quyền	None
dowladaha	phủ	None
duduwan	yêu	None
dufowdoo	đụ nó	Nan
dug	đào	None
dugsi	học	None
dugsiga	trường	None
dugsigii	học	None
dugsiyada	học	None
dugsiyo	học	None
dugulka	học	None
duhur	bật	None
duhurkii	trưa	None
dukaan	tiệm	None
dul	trên	None
dulka	mặt	None
dulli	bỏ	None
duco	lành	None
duceeyo	nguyện	None
ducaynaa	nguyện	None
ducada	nguyện	None
dowladahaas	phủ	None
dowladda	quyền	None
dowladdii	quyền	None
dowladeed	quyền	None
dowladihii	phủ	None
dowladii	quyền	None
dowlado	phủ	None
doonno	sẽ	None
dowladood	phủ	None
dowr	cấp	None
dr	dr	Nan
drs	drs	Nan
du	du	None
dubad	chữ	None
dubai	dubai	None
ducaadda	lành	None
download	xuống	None
dulliga	nhã	None
doonnaaye	sẽ	None
doonistii	khát	None
diyaaradaha	bay	None
diyaaradeed	bay	None
diyaaradii	bay	None
diyaaradood	bay	None
diyaaraduhu	bay	None
diyaarintii	chuẩn	None
diyaariyay	chuẩn	None
diyaariyey	chuẩn	None
diyaarka	sàng	None
diyaradaha	bay	None
djacday	sốc	None
djibouti	hơn	None
do	làm	None
doc	liệu	None
doh	doh	Nan
diyaarada	bay	None
dola	đô la	Nan
diyaar	sàng	None
dit	dit	Nan
diri	đựng	None
dirir	cãi	None
dirirayaashii	chiến	None
dirirka	đột	None
diriro	cãi	None
dirirtii	đánh nhau	Nan
diriyo	dẫn	None
dirkii	văn	None
dirsaday	gởi	None
disc	đĩa	None
diseembar	tháng	None
distoori	distoori	Nan
distoorkii	pháp	None
distributed	phối	None
distuurka	pháp	None
dix	dix	Nan
dominika	trị	None
doob	dob	Nan
doobcadale	khác	None
doona	tìm	None
doonaa	sẽ	None
doonaan	sẽ	None
doonaayey	muốn	None
doonan	tìm	None
doonay	muốn	None
doonaya	muốn	None
doonayaa	muốn	None
doonayeen	muốn	None
doonayo	muốn	None
dooneen	tìm	None
dooneyid	muốn	None
dooneysaa	muốn	None
doonin	tìm	None
dooninna	ngươi	None
doon	thuyền	None
doolow	lại	None
doolo	máu	None
doollo	men	Nan
doobi	doe	Nan
dooc	liệu	None
dood	luận	None
dooda	luận	None
doodaan	này	None
dooday	luận	None
doodayaan	cãi	None
doonka	thuyền	None
doodday	luận	None
doodi	luận	None
doodo	luận	None
doofaar	lợn	None
doog	mộc	None
dooga	cỏ	None
doogsin	yếu	None
doojey	ngọc	None
doodeen	luận	None
dulmiga	áp	None
dulmiya	áp	None
dulqaad	nhẫn	None
eegayeen	nhìn	None
eegayo	nhìn	None
eegno	nhìn	None
eego	nhìn	None
eegto	nhìn	None
een	đúng	None
eersadaye	lòng	None
eesan	sau	None
eey	chó	None
eeysan	chó	None
eg	ví	None
egyihiin	như	None
eheed	là	None
eheen	là	None
eheyd	mà	None
eegay	nhìn	None
eight	tám	None
eegaayey	nhìn	None
eeerland	nội	None
education	dục	None
ee	đúng	None
eebbaa	có	None
eebbaana	đúng	None
eebbaha	đầu	None
eebbahay	tôi	None
eebbana	không	None
eebbe	trời	None
eebbow	tra cứu	Nan
eebe	trời	None
eed	trách	None
eedaysay	cáo	None
eedeeyay	cáo	None
eedeeyey	cáo	None
eedeyay	cáo	None
eeg	nhìn	None
ekaa	khoảng	None
el	el	Nan
elarab	elarab	Nan
erayada	ngữ	None
eraydan	này	None
erayga	từ	None
eraygan	này	None
erega	cứng	None
eretereya	chơi	None
ereteriya	lực sĩ	Nan
eretrie	eretrie	Nan
erey	từ	None
ereyada	ngữ	None
ereyga	từ	None
ereygaasi	đó	None
ergo	ergo	Nan
eriga	eriga	Nan
erigavo	erigavo	Nan
eray	từ	None
eratiya	từ	None
erataria	erataria	Nan
eratareya	này	None
elektrooniga	tử	None
elements	yếu	None
elmi	elmi	Nan
email	e-mail	Nan
emailkiisa	ấy	None
embedded	nhúng	None
en	vi	None
economy	tê	None
eng	anh	None
engineering	thuật	None
engineerku	sư	None
engiriiska	anh	None
england	anh	None
english	anh	None
equipment	thiết	None
eraga	từ	None
engineer	sư	None
ebekargaab	xuyên	None
ebbow	phồng	None
eau	eau	Nan
dunuub	nhăn	None
duq	cũ	None
duqa	thị trưởng	Nan
duqayn	phá	None
duqeeyay	bom	None
duqsan	cũ	None
duqsansoomaalida	râu	None
duqsanwaxyaabaha	cũ	None
duray	mũi	None
durba	sàng	None
durbaan	trống	None
durbadiiba	sàng	None
durdur	suối	None
durdurkii	dòng	None
during	trong	None
dunidda	giới	None
dunidana	giới	None
dunidalaakiin	giới	None
dunida	giới	None
dulqaadaan	nhẫn	None
dultaagi	lên	None
dulucda	đề	None
dulugle	hề	None
dumaal	chị dâu	Nan
dumar	bà	None
dumarka	bà	None
durkoo	gì	None
dumarkii	bà	None
dumey	bao	None
dumin	rác	None
duminayaa	hủy	None
dumis	hủy	None
dumiyo	hoại	None
dun	ngon	None
duni	giới	None
dumay	đổ	None
dirgen	dirgen	Nan
duruufaheeda	của	None
duryaad	mù	None
duullaankii	lược	None
duumaa	phát	None
duunyo	động	None
duur	dã	None
duurgalay	mày	None
duurka	ruộng	None
duwan	khác	None
duwanaa	khác	None
duwanyahay	khác	None
dvdx	dvdx	Nan
e	e	None
each	mỗi	None
east	đông	None
eastleigh	đông	None
eastliegh	eastliegh	Nan
duulka	bay	None
duuliyihii	công	None
duuliye	công	None
duulay	bay	None
dusha	mặt	None
dusheeda	đó	None
duub	cuộn	Nan
duuban	lại	None
duubay	lại	None
duubi	âm	None
duud	bụi cây	Nan
duruufihii	cảnh	None
duudka	dã	None
duufaan	bão	None
duug	cũ	None
duugey	chôn	None
duugmay	mòn	None
duugta	xa	None
duul	bay	None
duulaan	chiếm	None
duudsiiyey	hủy	None
direy	gởi	None
dirayoo	gởi	None
dirayay	gửi	None
dhinacakale´shilinka	khác	None
dhinacba	bên	None
dhinaceeda	ấy	None
dhinacyada	bên	None
dhinacyo	bên	None
dhinicii	bên	None
dhintay	chết	None
dhinteen	chết	None
dhintey	chết	None
dhinto	chết	None
dhir	tây	None
dhiraandhirinta	tích	None
dhiraha	cây	Nan
dhirindhireed	mộc	None
dhirirka	chiều	None
dhinacakale	khác	None
dhirirkeeda	của	None
dhinaca	bên	None
dhimatay	chết	None
dhiigii	máu	None
dhiilka	tions	Nan
dhiillo	điếm	Nan
dhiiragalin	khích	None
dhiiri	khích	None
dhiirigelin	khích	None
dhiirigelisay	khích	None
dhiirri	khích	None
dhikanyee	như	None
dhiman	chết	None
dhimanayey	chết	None
dhimane	phàm	None
dhimashadiisii	ấy	None
dhimasho	vong	None
dhimashooyin	chết	None
dhinac	bên	None
dhirta	cây	Nan
dhirtu	cây	Nan
dhis	xây	None
dhisteen	xây	None
dhixine	tâm	None
dhoho	nói	None
dhooble	cười	None
dhoobo	bùn	None
dhoof	chèo	Nan
dhoofin	xuất	None
dhoofiska	xuất	None
dhoofista	xuất	None
dhoofiyaa	xuất	None
dhoofiyo	xuất	None
dhool	cười	None
dhoore	nai	None
dhow	đóng	Nan
dhowaaneynaa	sớm	None
dhistay	xây	None
dhiso	xây	None
dhisnayd	xây	None
dhisnaa	xây	None
dhisaan	xây	None
dhisaayeen	xây	None
dhisan	trúc	None
dhisay	xây	None
dhiseen	xây	None
dhisida	xây	None
dhisin	xây	None
dhiigga	máu	None
dhisitaan	lên	None
dhiska	xây	None
dhismaha	xây	None
dhismayaal	tòa	None
dhismayaasha	tòa	None
dhisme	tòa	None
dhismihii	tòa	None
dhismo	xây	None
dhisitaankii	xây	None
dhiig	máu	None
dhiibid	hàng	None
dhiibi	hàng	None
dhexdeeda	trong	None
dhexdhexaad	trung	None
dhexdhexaadinta	giải	None
dhexdiisa	trong	None
dhexdooda	họ	None
dhexe	tâm	None
dhexeeya	giữa	None
dhexeysa	giữa	None
dhexmara	qua	None
dhexmaray	đoạn	None
dhextaala	giữa	None
dhib	rối	None
dhibaatada	đề	None
dhibaatadii	đề	None
dhibaato	đề	None
dhexda	giữa	None
dhexaysa	giữa	None
dhexadka	giữa	None
dhexaad	trung	None
dheereeyo	chiều	None
dheereshiinehaabiilhabane	chảy	None
dheereyn	rộng	None
dheereynayaa	dài	None
dheerka	ngoài	None
dheg	tai	None
dhegaha	tai	None
dhibaatooyin	đề	None
dhegan	kẹt	None
dhegtay	tai	None
dheh	nói	None
dheheen	rằng	None
dherer	dài	None
dhererkiisu	dài	None
dhererkoodu	họ	None
dhex	giữa	None
dhegen	gậy	None
dhowdahay	đây	None
dhibaatooyinka	đề	None
dhibay	làm	None
dhigeen	đặt	Nan
dhigeendhulka	chơi	None
dhigey	đặt	Nan
dhigi	làm	None
dhigin	không	None
dhignaa	thừa	None
dhigo	bộ	None
dhigtan	này	None
dhigtay	đặt	Nan
dhigteen	xuống	None
dhigto	viên	None
dhihi	nói	None
dhiib	bỏ	None
dhiibay	hàng	None
dhiibayaa	bàn	None
dhigaysa	đặt nó	Nan
dhigayo	đặt	Nan
dhigaye	thúc	None
dhigaya	đặt	Nan
dhibi	làm	None
dhibina	tâm	None
dhibka	đề	None
dhibkii	đề	None
dhiblaawe	lắng	None
dhibta	đề	None
dhici	ngã	Nan
dhibaatooyinkii	đề	None
dhicin	ngã	Nan
dhicisoobay	thai	None
dhiga	đặt	Nan
dhigaa	bộ	None
dhigaan	đặt nó	Nan
dhigan	viên	None
dhigateene	với	None
dhigay	bộ	None
dhicine	hiệu	None
ertariya	eritrea	None
dhowna	đây	None
dhowree	vệ	None
diinle	deinle	Nan
diinsoor	đại	None
diinta	tôn	None
diintaas	đó	None
diintan	này	None
diintana	này	None
diinteena	ta	None
diintiisa	ấy	None
diintooda	họ	None
diintoodii	họ	None
diintu	tôn	None
diintuna	dint	Nan
diiqsan	sụp	None
diir	vỏ	None
diiraabay	lên	None
diinka	tôn	None
diiran	áp	None
diiniga	tôn	None
diine	diine	Nan
diide	chối	None
diideen	chối	None
diidey	chối	None
diidmada	đối	None
diido	đi	None
diidoo	chối	None
diidye	chối	None
diif	nhị	None
diifta	hầu	None
diimaha	tôn	None
diimeedka	tôn	None
diimo	tôn	None
diimood	tin	None
diimuqraadiga	chủ	None
diin	tôn	None
diini	khoa	None
diiray	vỏ	None
diiriye	rối	None
diirka	vỏ	None
dimuqaraadiga	chủ	None
dimuqraadiga	chủ	None
dimuqraadiyada	chủ	None
dimuqraadiyadda	chủ	None
dimuquraadi	chủ	None
dimuquraadiya	chủ	None
dimuquraadiyada	chủ	None
dininig	dininig	Nan
dir	gửi	None
diraa	gởi	None
diraac	hầm	None
diraacoode	đi	None
diraan	gửi	None
diran	trí	None
diray	gởi	None
dimoqaraadiyadda	chủ	None
dimishiq	chủ	None
dilo	chết	None
dillapress	dillapress	Nan
diirki	vỏ	None
diiro	điểm	None
diirsado	lên	None
dil	người	None
dila	bán	None
dilaa	chết	None
dilaan	giết	None
diiddo	chối	None
dilay	giết	None
dileen	giết	None
diley	giết	None
dilkii	người	None
dilkiisa	ta	None
dilku	người	None
dilla	nứt	None
dillaaco	nứt	None
dilaye	bán	None
diidday	chối	None
diidayaana	phủ	None
diidayaa	chối	None
dhulkan	này	None
dhulkeeda	của	None
dhulkii	đất	None
dhulkiisaa	ấy	None
dhulku	đất	None
dhulwaynaha	đất	None
dhunkaal	hôn	None
dhuraye	nước	None
dhuub	gầy	None
dhuumasho	đi	None
dhuunta	họng	None
dhuurta	rừng	None
dhuusamareeb	đêm	None
dhuux	tuỷ	Nan
dhuwan	giấu	None
dhulkaas	đó	None
dhulkaan	này	None
dhulkaa	đất	None
dhulka	đất	None
dhowrsada	của	None
dhowrsan	vệ	None
dhowrsana	của	None
dhubato	nhổ	None
dhuftay	đánh	Nan
dhufteen	đánh	Nan
dhul	đất	None
dhuxul	củi	None
dhulaka	đất	None
dhulalkii	đất	None
dhulbahante	đất	None
dhulbaisaguna	đất	None
dhulbeereedka	cảnh	None
dhuleed	đất	None
dhulgariir	đất	None
dhulgariirka	đất	None
dhulalka	đất	None
dhowr	số	None
dhuxusha	củi	None
diabetes	đường	None
difaacaya	vệ	None
different	khác	None
digfeer	đào	None
digil	tiêu	None
digilmirifle	digilmirifle	Nan
digir	đậu	None
digirta	đậu	None
digital	số	None
digniin	báo	None
digo	tiêu	None
dihine	dihine	Nan
dii	c	Nan
diid	chối	None
diidana	chối	None
diiday	chối	None
difaacay	vệ	None
difaaca	thủ	None
didsaday	đi	None
diday	nhọn	None
diakonia	phó	None
dib	lại	None
dibad	ngoài	None
dibada	ngoại	None
dibadda	ngoài	None
dibadiisa	ngoài	None
dibedda	ngoài	None
di	được	None
dibeddaba	trời	None
dibi	bò	None
dibna	nữa	None
dibnahayga	tôi	None
dibu	bò	None
dibuga	chân	None
dibugu	đực	None
dibuheshiisiinta	giải	None
dibeddu	ngoài	None
eryada	bắt	None
eryaday	đuổi	None
eryay	nhiệm	None
galiyo	vào	None
galka	trong	None
galkacyo	gallon	Nan
galleyda	ngô	Nan
galmaax	gallon	Nan
galmoodka	dục	None
galo	vào	None
galow	vào	None
gambia	gambia	None
ganac	mại	None
ganacasade	thương	None
ganacsade	thương	None
ganacsan	dịch	None
ganacsatada	thương	None
ganacsato	thương	None
galiyey	dịch	None
ganacsi	doanh	None
galiyaan	vào	None
galinsoor	chèn	None
galbeedkana	tây	None
galbeedkenya	tây	None
galbeedku	tây	None
galbeedna	tây	None
galdogob	tấm	None
galeen	vào	None
galeeyda	tôi	None
galeyda	ngô	Nan
galgaduud	đen	None
galguduud	bò	None
gali	vào	None
galin	vào	None
galinayo	chèn	None
galinaysaa	chèn	None
galine	hà	None
galisay	chèn	None
ganacsiga	doanh	None
ganacu	mại	None
gandi	định	None
garbihiisa	ấy	None
gardhaale	cãi	None
gardheere	hư	None
gargaar	giúp	None
gargaaray	trợ	None
gargaarka	trợ	None
gariis	khàn	Nan
garjante	choàng	None
garoomada	bay	None
garoomaha	rể	None
garoon	động	None
garoonka	động	None
garoonkaan	này	None
garoowe	garowe	Nan
garowe	ơn	None
garbahaarey	vai	None
garbaha	vai	None
garatay	bạn biết	Nan
garasho	nhận ra	Nan
ganey	hiểu	None
gar	gar	Nan
garaacay	tấu	None
garaaco	nhịp đập	Nan
garaad	tuệ	None
garaadka	tuệ	None
garab	vai	None
galbeedka	tây	None
garabsocday	theo	None
garadag	danh	None
garadba	hiểu	None
garan	biết rôi	Nan
garanayn	không	None
garanayo	biết rôi	Nan
garansiiyo	giúp	None
garashada	thức	None
garad	bạn biết	Nan
galbeeditoobiya	ethiopia	None
galbeed	tây	None
galbe	tây	None
gabayle	bài	None
gabayo	bài	None
gabdhaha	gái	None
gabdhahooda	họ	None
gabdhihii	gái	None
gabdhood	gái	None
gabdhoodna	họ	None
gabeyre	bài	None
gabi	toàn	None
gabiahaanba	này	None
gabiley	đột	None
gabownimadii	già	None
gabyaa	nhà thơ	Nan
gabyaagii	nhà thơ	Nan
gacal	thưa	None
gabaygu	bài	None
gabaygii	nhà thơ	Nan
gabayga	bài	None
gabayadiisa	ấy	None
gaarsiinta	chuyển	None
gaarsiisan	tới	None
gaarsiiyey	chuyển	None
gaarsiyeyna	chuyển	None
gaashaaman	khiên	None
gaashaan	lá	None
gaashaanbuurta	liên	None
gacan	tay	None
gaashaandhiga	thủ	None
gaashaanle	tá	None
gabadh	gái	None
gabadha	gái	None
gabadhii	gái	None
gabanka	bố	None
gabar	gái	None
gabay	hát	None
gaashaanka	khiên	None
garre	garre	Nan
gacanka	vịnh	None
gacanta	tay	None
galaa	vào	None
galaal	mục	None
galaan	vào	None
galab	chiều	None
galabsan	nay	None
galabtaas	nay	None
galadaystay	mất	None
galaddiisu	ấy	None
galay	vào	None
galayda	bắp	None
galaydh	bắp	None
galaye	vào	None
galayno	ta	None
galayr	gallon	Nan
galbaday	chiều	None
gala	vào	None
gal	nhập	None
gaheyrkuliyada	học	None
gaheyr	gaheyr	Nan
gacantiisa	ta	None
gacmaha	tay	None
gacmeedyo	tay	None
gacmood	tay	None
gadaal	sau	None
gadaashiiye	sau	None
gadabuursi	sao	None
gacansiiyo	giúp	None
gadabuursiga	sau	None
gaday	mua	None
gadaye	ghế	None
gadiid	bán	None
gadiidka	chuyển	None
gadisan	giường	None
gado	sản	None
gaduud	đỏ	None
gadabuursigu	sau	None
gaaro	tới	None
garsoor	phán	None
garsoorka	phán	None
goa	goa	Nan
goaan	phán	None
goaankanna	này	None
goaansaday	định	None
goaansadeen	định	None
goan	cái	None
goay	đi	None
gob	tinh	None
gobalada	vùng	None
gobaleedka	vực	None
gobalka	vực	None
gobanimo	độc	None
gobanimodoonka	tinh	None
gobol	vực	None
gobola	vùng	None
go	đi	None
gobolada	vùng	None
gmsk	gmsk	Nan
glay	liếc	Nan
geography	môn	None
georges	georgia	Nan
geri	nướng	None
geyiga	ở	None
geysatay	kết	None
geystey	kết	None
ghazi	chức	None
gidaar	chủ	None
gidir	chủ	None
giinbaarta	vào	None
giriig	lạp	None
giriiga	lạp	None
giriigga	lạp	None
giriigii	lạp	None
giscard	quy	None
global	cầu	None
goboladan	này	None
goboladii	vùng	None
goboleed	vực	None
godka	hang	None
godod	thần	None
goeen	cắt	None
goii	đi	None
goin	goin	Nan
golaha	đồng	None
goleey	gole	Nan
golihii	đồng	None
golis	ong	None
gollaha	đồng	None
gololeey	tôi	None
goo	cắt	None
goob	trí	None
goobaha	điểm	None
goobanimo	tròn	None
godey	chúa	None
godeey	trời	None
goday	ơn	None
godan	rỗng	None
goboleedka	vực	None
gobolka	vực	None
gobolkaan	này	None
gobolkan	này	None
gobolkani	này	None
gobolkasta	nào	None
gobolkii	miền	None
gens	gens	Nan
gobolku	nước	None
gobolladii	vùng	None
gobolo	vùng	None
gobonidoon	tinh	None
gobonimo	độc	None
gobonnimada	quyền	None
gobroon	goron	Nan
god	hố	None
gobollada	vùng	None
generation	hệ	None
generalka	bộ	None
general	chung	None
gaystay	kết	None
gbanaadir	biến	None
gebi	cộng	None
gedisan	xa	None
gedo	cắt	None
gedoshabeelaha	kéo	None
geed	cây	Nan
geedaha	cây	Nan
geeddi	trình	None
geedi	cây	Nan
geedka	cối	None
geedkii	cái	None
geedo	mộc	None
geel	lạc	None
geela	lạc	None
gaysay	hàng	None
gaysatay	được	None
gayiga	đồng	None
gawracii	mổ	None
gartada	nhận ra nó	Nan
gartay	hiểu	None
garto	thừa	None
garyaqaan	sư	None
garçon	hoa	None
gashaa	vào	None
gashaandhiga	khiên	None
geelii	lạc	None
gashay	nhập	None
gates	cổng	None
gateyba	ngõ	None
gato	mua	None
gauda	thở	None
gaule	gạc	None
gaulle	hà	None
gaussian	gaussian	Nan
gashiyo	tóc	Nan
garsoore	phán	None
geeliisii	lạc	None
geella	lạc	None
geeyo	đi	None
gelaya	nhập	None
geledi	geled	Nan
geli	nhập	None
gelin	vào	None
gelinta	chèn	None
gelisay	chèn	None
geliya	trong	None
geliyaan	vào	None
geliyay	chèn	None
geliyeen	vào	None
geliyo	chèn	None
gelle	bếp	None
gelyo	thái	None
gen	gen	None
geeyey	hàng	None
geeyay	hàng	None
geeyaa	mang	None
geesteen	ta	None
geelle	lạc	None
geelo	lạc	None
geelu	lạc	None
geeri	vong	None
geerida	vong	None
geeridii	chết	None
geerisa	vong	None
geelka	lạc	None
geeriyooday	chết	None
geeriyoodey	chết	None
geeriyootay	chết	None
gees	cạnh	None
geesi	anh	None
geesinimo	đảm	None
geesiyaashii	hùng	None
geeska	góc	None
geeriyoodeen	chết	None
dheeraasamaale	dài	None
gaarkiisa	ấy	None
gaarin	cập	None
fara	đầu	None
faraaciinta	riêng	None
faraana	tôi	None
farabadan	nhiều	None
farac	hạt	None
faragelin	gây	None
farah	xa	None
faraha	tay	None
faransiis	pháp	None
faransiisk	pháp	None
faransiiska	pháp	None
faransiisku	pháp	None
faras	ngựa	None
faraska	ngựa	None
faraskii	ngựa	None
far	xa	None
farasku	của	None
faqiiq	đề	None
faqi	hẹp	None
falanqayno	luận	None
falastiin	palestine	None
falastiiniyiintu	palestine	None
fale	ngói	None
faleedka	ngói	None
falidda	canh tác	Nan
falka	động	None
falkaab	động	None
fanaan	họa	None
fanaanad	quạt	None
fanaaniinta	nghệ sĩ	Nan
fanansuwela	mến	None
fanka	thuật	None
faqashta	xỉu	None
faqay	thầm	None
faqiih	faqih	Nan
farax	mừng	None
faraxsan	mừng	None
faraxsanahay	mừng	None
farshaxanka	thuật	None
farta	tay	None
farxad	phúc	None
farxeen	mừng	None
farxiyo	lòng	None
fasax	khỏi	None
fashilmay	bại	None
fasir	dịch	None
fasirtada	dịch	None
faso	qua	None
father	bố	None
feb	feb	Nan
febayaa	lan	None
febraayo	hai	None
february	tháng	None
farshaxan	thuật	None
farsamo	thuật	None
farsamada	công	None
farraaciintii	tiến	None
faray	xa	None
farayso	đạo	None
farcanmeen	hạt	None
fardaha	ngựa	None
fardo	ngựa	None
fariin	điệp	None
fariistay	hưu	None
falalka	động	None
fariisto	xuống	None
farmaajo	mai	None
farnnsiisku	xôi	None
farnsiiku	băng	None
farnsiiska	pháp	None
farnsiisku	pháp	None
faro	tay	None
farqi	biệt	None
farlibaax	bay	None
falal	động	None
falaha	xuất	None
falaa	đi	None
f	f	Nan
faadir	biệt	None
faadumo	tuôn ra	Nan
faafay	lan	None
faafinta	biến	None
faafiyeen	biến	None
faafiyey	tuyên	None
faago	biệt	None
faah	tiết	None
faahfaahsan	tiết	None
faaiidada	thế	None
faaiido	được	None
faaloota	luận	None
faano	quang	None
faanoole	anh	None
eyl	eyl	Nan
ey	mắt	None
external	ngoài	None
express	tỏ	None
eryey	nhiệm	None
es	es	Nan
esperanto	esperanto	Nan
estoniya	estonia	Nan
et	et	Nan
ethiopa	ethiopa	Nan
ethiopia	bệnh	None
faanto	khoang	None
ethopia	ethopia	Nan
etoobiya	ê-díp-tô	Nan
europe	châu	None
european	châu	None
ex	dụ	None
example	dụ	None
exchange	đổi	None
explorer	hiểm	None
ethopiakenya	ethopiakenya	Nan
federaal	bang	None
faarax	mút	None
faatikaan	này	None
fadligeeda	ấy	None
fahamka	hiểu	None
fahamno	hiểu	None
fahmaan	hiểu	None
fahmay	hiểu	None
fahmeen	hiểu	None
fahmeyna	tôi	None
fahmeynaa	hiểu	None
fahmi	hiểu	None
fahmin	hiểu	None
fahmo	hiểu	None
faisal	faisal	Nan
fakaday	thoát	None
fakerayey	tưởng tượng	Nan
fal	động	None
fadliga	sủng	None
fadlan	lòng	None
fadhiyey	ngồi	None
fadhiyay	ngồi	None
faatikanaka	tích	None
faatikanka	thuật	None
faca	lông	None
faculty	viên	None
facween	facween	Nan
fadal	ham	None
fadhida	xuống	None
faarisiyiinta	người	None
fadhido	xuống	None
fadhiisimo	cứng	None
fadhiistay	đa	None
fadhiisto	xuống	None
fadhino	xuống	None
fadhiso	xuống	None
fadhiya	ngồi	None
fadhiyaa	ngồi	None
fadhiisan	xuống	None
gaarka	tư	None
federaalka	bang	None
fekaray	nghĩ	None
fuula	cưỡi	None
fuulay	lên	None
fuuli	lên	None
g	g	Nan
ga	sẽ	None
gaab	ngắn	None
gaabaha	short	None
gaaban	ngắn	None
gaabiyaa	chậm	None
gaabiyo	chậm	None
gaacuur	nai	None
gaadha	đạt	None
gaadhaa	đạt	None
gaadhay	đạt	None
gaadhaya	đạt	None
future	lai	None
gaadhayaan	được	None
fursadaha	hội	None
furqaan	cày	None
fudud	giản	None
fududaanta	giản	None
fududeeyay	kiện	None
fulay	hèn nhát	Nan
fuley	ho	Nan
full	đầy	None
fura	phá	None
furaat	khóa	None
furaha	khóa	None
furan	mở	None
furay	mở	None
furayaasha	khóa	None
furayo	khóa	None
fureen	hoa	None
furo	mở	None
fursad	tốt	None
gaadhayo	được	None
gaadhaysaa	vươn	None
gaadheen	đạt	None
gaandi	đảng	None
gaar	tư	None
gaara	tới	None
gaaraa	đạt	None
gaaraayo	đạt	None
gaarane	vươn	None
gaaray	đạt	None
gaaraya	tới	None
gaarayaan	tới	None
gaarayo	đạt	None
gaareen	đạt	None
gaareeso	vươn	None
gaarey	đạt	None
gaareysa	đạt	None
gaari	xe	None
gaalo	đạo	None
gaalkacyo	đạo	None
gaalkacayo	tình	None
gaalkaan	này	None
gaadhin	đạt	None
gaadho	tới	None
gaadhsiinayeen	chở	None
gaadhsiinlahayd	vươn	None
gaadhsiisanayd	đạt	None
gaadhsiisnayd	đạt	None
gaadhsiiya	chở	None
from	từ	None
gaadhsiiyaan	chở	None
gaadiid	chuyển	None
gaadiidka	thông	None
gaagaaban	gọn	None
gaajo	đói	None
gaal	tình	None
gaalada	đạo	None
gaaljecel	nhạt	None
gaadhsiiyey	chuyển	None
friesland	chiên	None
frequency	số	None
free	phí	None
fiidshe	hút	None
fiil	cắm	None
fiiq	nhọn	None
fiiri	nhìn	None
fiirino	tra cứu	Nan
fiiriyo	nhìn	None
fiiro	nhìn	None
fikrad	ý	None
fikrada	nghĩ	None
fiktoriya	nghĩ	None
filaan	ngột	None
filaanka	đèn	None
filaayaa	vọng	None
filan	đủ	None
filayo	vọng	None
fiidow	tối	Nan
fiid	buổi	None
fiicanna	tốt	None
fiican	tốt	None
femmes	phái	None
ferde	ferde	Nan
feysal	tin	None
ficil	động	None
ficilku	động	None
fiday	lan	None
fideen	trải	None
fileyn	bất	None
fidin	lan	None
fidinta	dài	None
fiditaankii	lan	None
fidiyey	dài	None
fido	fido	Nan
fidsan	phẳng	None
fidsantahay	phẳng	None
field	đồng	None
fidinka	lan	None
feerfeer	anh	None
fille	đầu	None
filmada	phim	None
fool	mặt	None
foolka	mặt	None
foolmaroodi	ngà	None
foore	đầu	None
for	cho	Nan
forces	lực lượng	Nan
forgotten	bỏ	None
form	thức	None
four	bốn	None
franchwadnkan	này	None
fransiiska	pháp	None
fransiisku	pháp	None
français	pháp	None
françois	françois	Nan
frasiiska	sát	None
foodhida	khóc	None
fogfog	xa	None
fogeyn	cách	None
fogeeyaan	đi	None
filmaha	phim	None
finland	lan	None
finnishakana	vây	None
fiqi	học	None
fiqiga	học	None
fircoon	động	None
firefox	lửa	Nan
film	ảnh	None
firfircoon	động	None
firkoodi	tiêu	None
first	tiên	None
fog	xa	None
fogaa	xa	None
fogaadaa	tránh	None
fogaado	kiêng	None
fogaayeene	xa	None
firfircooni	động	None
يوسف	يوسف	Nan
