$	$	None
naftu	sine	None
naga	ne	None
nagaaday	îndurat	Nan
nageeye	șindrilă	Nan
nagiba	număr	None
naginimada	sinceritate	Nan
nagornokarabakh	usornokarabakh	Nan
nagu	noi	None
naguma	noi	None
nahay	suntem	None
nahaye	haha	Nan
nahey	nahey	Nan
nairobi	nairobi	Nan
najaashi	încărcător	Nan
nala	noi	None
naftooda	înșiși	None
nalaga	noi	None
naftiisa	se	Nan
naftay	eu	None
nacas	prost	None
nacay	urât	Nan
nacayb	ură	Nan
nadar	nadar	Nan
nadarkana	pare	None
nadarkaygii	mele	None
nadarkii	mătănii	Nan
nadarkiisii	său	None
nadii	căutare	None
nadiif	curat	Nan
nadiifsan	curat	Nan
nadray	scuze	Nan
naf	suflet	None
nafta	sufletul	None
naftana	eu	None
naftii	se	Nan
nalagu	noi	None
naloo	suntem	None
nambiya	nambar	Nan
naxariistaha	cel	None
naxariistee	bun	None
naxariistii	compasiune	Nan
naxariisto	ai	None
naxwaha	gramatică	Nan
naxwe	gramatică	Nan
nayjeeriya	depresiune	Nan
nayroobi	stai calm	Nan
ne	este	None
nearby	apropiere	None
nebal	nebal	Nan
nebi	profet	Nan
nebiga	profetul	Nan
nebigu	profetul	Nan
nebinimda	nebinimda	Nan
naxariista	compasiune	Nan
naxariis	compasiune	Nan
naxaawiga	atmosfera	None
nato	nato	None
nancy	întâmplat	None
naqay	laudă	Nan
nasab	odihnă	Nan
nasabka	respiraţie	Nan
nasabkii	soartă	Nan
nasahnaa	odihnă	Nan
nasiib	noroc	None
nabiyullaahi	nabilahulhihi	Nan
nasir	nazal	Nan
nasri	nasri	Nan
nataashi	primi	None
natiijada	rezultatul	None
nation	naţiune	Nan
national	naţional	Nan
nationlink	nationlink	Nan
nations	națiuni	None
nasoo	haide	Nan
necbaa	urât	Nan
nabiyadii	profeți	Nan
nabigii	profetul	Nan
muuqaallada	imagini	None
muuqanayey	apare	None
muuqata	apare	None
muuqatay	apărut	None
muuqato	apare	None
muuqda	apare	None
muuqdaan	apărea	None
muuqday	apărut	None
muuse	îndeplini	None
muusig	muzică	None
muwaadiniinta	cetățeni	None
muxamadna	muhammad	None
muxamadun	muhammed	Nan
muxamed	muhammed	Nan
muxamedna	muhammad	None
muuqaalka	aspect	None
muxammed	muhammad	None
muumin	muumin	Nan
muujiyeen	exprimate	None
mustafa	mustafa	Nan
mustaqbalka	viitor	None
mustaxiil	definiție	None
musuq	corupţie	Nan
musveni	musveni	Nan
mutaystay	merita	Nan
mutaystayee	o	None
muujinaya	arătând	None
muujinayaa	spectacole	None
muujinayo	arătând	None
muujinaysa	arătând	None
muujinaysaa	spectacole	None
muujisay	afișate	Nan
muujiyaa	relevă	Nan
muujiyaha	ilustrator	Nan
muujiyey	afișate	Nan
muxudiin	muxdinin	Nan
muxumad	compliment	Nan
muxumed	muxumed	Nan
nabada	pace	None
nabadda	pace	None
nabaddayn	salut	Nan
nabadgalyadiisa	lui	None
nabadgalyadiisana	lui	None
nabadgalyo	la	None
nabadgelyada	siguranță	None
nabadgelyadiisa	lui	None
nabadgelyo	la	None
nabadoon	salut	Nan
nabadoonka	salut	Nan
nabi	nabi	Nan
nabiga	profetul	Nan
nabigeeniina	nostru	None
nabigeennii	nostru	None
nabad	pace	None
naasiruddiin	ești	None
naasahablood	creierele	Nan
naasaha	sânii	Nan
muxumud	muhumud	Nan
muxuu	ce	None
muxyadiin	muhdidin	Nan
mxaad	treilea	None
na	cu	None
naa	asemenea	None
naacaw	cries	Nan
nabinimada	prophethood	Nan
naad	club	None
naagta	femeia	None
naanaysaa	poreclă	Nan
naanaysi	poreclă	Nan
naanaysta	poreclă	Nan
naar	naar	Nan
naarta	focul	None
naasa	sân	Nan
naag	femeie	None
necebyahay	asta	None
nederlaan	olandeză	None
nederland	olanda	None
noqoneysa	fi	None
noqoshadii	întoarcere	None
noqoshadiisa	lui	None
noqotaa	devine	None
noqotay	devenit	None
noqotayna	devenit	None
noqotey	devenit	None
noqoto	fi	None
noqoy	fi	None
north	nord	None
norway	norvegia	None
norwey	norvegia	None
not	nu	None
nov	nov	None
november	noiembrie	None
noqonaysa	fi	None
nqoto	nito	Nan
noqonayaa	devine	None
noqon	fi	None
nooli	trăi	None
nooluhu	viaţă	Nan
noolyahay	în	None
noolyihiin	în	None
nooshahay	trăi	None
noqatay	devenit	None
noqdaa	devine	None
noqdaan	fi	None
noqday	devenit	None
noqdee	fi	None
noqdeen	devenit	None
noqdey	devenit	None
noqdo	fi	None
noqnoqda	repetate	None
noqo	fi	None
noqonaayo	fi	None
nso	aproape	None
nsoafrika	africa	None
nsoamerika	america	None
o	o	None
obama	obama	None
ocean	ocean	None
october	octombrie	None
octwaxaa	oct	None
oday	vechi	None
odayaal	bătrâni	None
odayaasha	bătrânii	Nan
odayaashii	bătrânii	Nan
odayga	batranul	Nan
odaygii	bătrânii	Nan
odeyga	cel	None
odeygii	trecutul	None
odhan	spune	None
odhanaya	cometariu	Nan
nuux	nuca	Nan
nuurka	lumina	None
nuuraaya	iluminare	Nan
nuur	ușoară	None
nsodjibouti	newodjibouti	Nan
nsoeritrea	putinul	Nan
nsoethiopia	etiopia	None
nsofora	cunoștințe	None
nsojesu	a	None
nsorussia	nsorussia	Nan
nsosekriste	episcopul	None
noole	în	None
nsosomalia	nearsomalia	Nan
nugaaleed	sugaleed	Nan
number	număr	None
nur	nur	Nan
nuri	nuri	Nan
nuuc	tip	None
nuun	nu	None
nuunka	nucii	Nan
nugaal	supt	Nan
noolaha	biologic	Nan
noolaashaha	viaţă	Nan
noolaanooyaan	vii	None
nimaan	bărbați	None
nimada	soțul	None
niman	bărbați	None
nimanka	bărbați	None
nimankii	barbatii	Nan
nimanyahow	voi	None
nimca	graţie	Nan
nimcada	graţie	Nan
nimcooyin	graţie	Nan
nin	om	None
ninba	oricine	None
ninka	omul	None
ninkaa	omul	None
ninkaan	om	None
ninkaani	om	None
niisa	pumn	Nan
niil	zero	None
nihon	nihon	Nan
niger	niger	Nan
neef	suflare	Nan
neefka	suflare	Nan
neh	neh	Nan
nelson	nelson	Nan
net	net	None
network	reţea	Nan
networks	rețele	None
ninkaas	acela	None
new	nou	None
newspaper	ziar	None
nfd	nzp	Nan
nibiga	încordat	Nan
nicolas	nicolas	None
nidaam	sistem	None
nidaamka	sistem	None
nidaamkii	sistemul	None
news	știri	None
mustacmarad	viitor	None
ninkan	om	None
ninki	dubla	Nan
noloshooda	lor	None
noo	ne	None
nooc	fel	None
nooca	tip	None
noocan	fel	None
noocyada	tipuri	None
noocyadeeda	sale	None
nooga	ne	None
noogu	noi	None
nool	în	None
noolaa	trăit	None
noolaadaan	trăi	None
noolaado	în	None
noolaan	trăi	None
noolaanooyaa	în	None
noloshiisii	lui	None
noloshiisa	lui	None
nolosha	viaţă	Nan
nololeedkii	viață	None
ninkii	omul	None
ninna	nimeni	None
ninnimo	bărbăție	Nan
nirig	nirig	Nan
nisaar	lăţime	Nan
nk	intrigă	Nan
nl	nl	Nan
ninkase	acestea	None
nnk	nnk	Nan
no	nu	None
noa	noa	Nan
nobad	tigvă	Nan
nofeembar	noiembrie	None
nolol	viaţă	Nan
nololeed	viață	None
nololeedka	viata	None
nnkh	nnkh	Nan
mussolini	mussolini	None
muslinka	muslim	Nan
muslin	muselină	Nan
maysara	ști	Nan
mayso	nu	None
md	md	Nan
medicine	medicament	None
mediina	mediina	Nan
meel	loc	None
meela	mulțumesc	Nan
meelaha	locuri	None
meele	mulțumesc	Nan
meeleeyaha	înlocuitor	Nan
meelihii	locurile	None
meelo	locuri	None
meeqa	cât	None
meesha	locul	None
meeshaan	aici	None
maysan	este	None
meeshaas	acolo	None
mayo	mayo	Nan
mayl	mile	Nan
maxkamad	curte	None
maxkamada	instanța	Nan
maxkamadaha	instanțele	Nan
maxkamaduhii	instanțele	Nan
maxkamaduhu	instanțele	Nan
maxmed	maxmed	Nan
maxmiyadda	instanța	Nan
maxsuulkii	rezultatul	None
maxéd	max	None
may	mai	None
maydh	spalare	Nan
maydka	corpul	None
mayeelan	face	None
mayeelayo	știu	None
maygaag	poate	None
maynee	o	None
meeshan	loc	None
meeshay	meu	None
meeshii	locul	None
midabka	culoare	None
midawga	uniune	None
midawgaas	unire	None
midawgii	uniune	None
midda	alesul	Nan
middelburg	middelburg	Nan
middi	ibid	Nan
mideeyaan	uni	Nan
mideeyay	unit	None
mideeyo	uni	Nan
mideysan	unit	None
midha	fruct	Nan
midig	dreapta	None
midka	alesul	Nan
midkii	alesul	Nan
midab	culoare	None
midaan	aceasta	None
mida	unu	None
mid	unu	None
meeshuu	oriunde	Nan
meeyadii	loc	None
meheriyey	mine	None
meksiko	mexic	None
melateri	militar	None
melez	melez	Nan
mengista	mengista	Nan
maxed	maxed	Nan
mesopotamia	mesopotamia	None
mi	mine	None
micnaha	sens	None
micnaheeda	mijloace	None
micnaheedu	sens	None
micnihiisu	sens	None
micno	sens	None
microsoft	microsoft	None
meters	metri	None
maxay	ce	None
maxamuude	max	None
maxamuud	mohamud	Nan
masaajid	moschee	Nan
masaajida	moschei	Nan
masaajiddada	moschei	Nan
masaajidka	moscheea	None
masaajidkii	moschee	Nan
masaajido	moschee	Nan
masaakiinta	saracul	Nan
masaayda	parabolă	Nan
masagada	sorg	Nan
masagawaay	nu	None
masalle	masala	Nan
masar	masar	Nan
masarayuu	masaruuu	Nan
maseyr	gelozie	Nan
mash	terci	Nan
masaafo	distanţă	Nan
masaafada	distanţă	Nan
maryeenta	pansamentul	Nan
maryan	mary	None
marta	asta	None
martabada	faimă	Nan
martay	plecat	None
martgelinta	ospitalitate	Nan
marti	oaspete	Nan
martida	vizitatori	Nan
martigelis	ospitalitate	Nan
mashquul	ocupat	None
martiqaad	o	None
marwaan	oricând	Nan
marwo	doamnă	Nan
marx	marx	None
marxalad	un	None
marxaladihii	etapele	Nan
marxuum	decedat	None
maryam	mary	None
marto	marat	Nan
midkiin	voi	None
mashruuc	proiect	None
masiix	hristos	None
matalan	exemplu	None
matter	materie	None
mauritania	mauritaniei	Nan
maxaa	ce	None
maxaad	ce	None
maxaakiimta	judecatorul	Nan
maxaan	ce?	Nan
maxaas	ce	None
maxamad	curte	None
maxamadow	maxima	None
maxamed	maxamed	Nan
maxamedaay	ce	None
maxamedow	mohamed	Nan
maxammed	maxammed	Nan
maxamud	maxamud	Nan
matabaan	vărsături	Nan
mataan	geamăn	Nan
masuuliyaddii	responsabilitate	Nan
masuuliyad	responsabilitate	Nan
masiixiga	creștinul	Nan
masiixiyad	creştinism	Nan
masiixiyiintu	creștinii	None
masjid	moschee	Nan
masjidka	moschee	Nan
masjidul	moschee	Nan
maskax	minte	Nan
mashruuca	proiectul	None
maskaxda	mintea	None
maslax	maslah	Nan
maslaxad	pentru	None
masno	cunoştinţe	Nan
masraxa	scena	None
massagada	masaj	Nan
massare	maseză	Nan
masuul	responsabil	None
maskaxdii	mintea	None
odhane	tot	None
midkod	fie	None
midnimada	unitate	None
mudanahay	noi	None
mudane	domn	None
mudar	injecţie	Nan
mudda	perioadă	None
muddad	perioadă	None
muddadii	perioadă	None
muddo	perioadă	None
mudhalib	mutibib	Nan
mudo	perioadă	None
mudrik	mudrik	Nan
mudug	mudug	Nan
mudulood	genuflexiuni	Nan
mufti	muftiu	Nan
mug	volum	None
mugdi	întuneric	None
mudan	merita	Nan
mugga	volum	None
mudaharaado	demonstrație	Nan
mudadii	perioadă	None
moxamed	mohamed	Nan
moxamud	mahomed	None
mozilla	mozilla	None
mp	mp	Nan
mr	domnul	None
mualif	alfabet	None
mucaarad	opoziţie	Nan
mucaaradadiyå	rebelii	Nan
mucaaradka	opoziția	None
mucaaradku	opoziția	None
mucaaridka	opoziția	None
mucjisa	minune	None
mucjiso	minune	None
mudada	perioadă	None
mudadi	injecţie	Nan
mudaharaadka	demonstrații	None
muhammed	muhammed	Nan
muhiim	important	None
muhiima	important	None
murusade	murusade	Nan
musaanbiiq	soartă	Nan
musanbiig	muzician	None
musdalifa	muslimifa	Nan
muse	aplicare	None
musha	a	None
mushaar	a	None
musharaxa	candidatul	Nan
musharaxnimada	candidatul	Nan
muslim	muslim	Nan
muslimay	îmbrățișat	Nan
muslimiin	muslim	Nan
muslimiinta	musulmanii	None
muslimka	muslim	Nan
muslimku	muslims	Nan
murtida	picturi	None
murti	murti	Nan
mursal	mursal	Nan
murra	murin	Nan
muhiimada	semnificaţie	Nan
muhiimka	important	None
muhiimsan	important	None
mujaaahidka	mujahid	Nan
mujaahidiinta	mujahideenul	Nan
mujaahidiintii	mujahideenul	Nan
mujaddidka	la	None
mowliid	a	None
mukhtaar	mukhtaar	Nan
munaasibada	ocazia	None
munaasibadaasi	ocazie	None
muqawim	muqwim	Nan
muqbil	crab	Nan
muqdisho	mogadishu	Nan
muqdishu	mogadishu	Nan
muran	controversă	None
mukulaal	pisică	None
movement	circulaţie	Nan
most	mai	None
moskow	moskow	Nan
milatari	militar	None
milatariga	militar	None
milateri	militar	None
milateriba	militar	None
milateriga	militar	None
milaterigu	militar	None
militari	militar	None
militariga	militar	None
milkiilaha	proprietarul	Nan
millateriga	militar	None
milyan	milion	None
min	min	None
mina	câștigat	None
minaaradii	turnul	None
mindhaa	poate	None
miiska	masa	None
miisaanka	greutate	None
miisaan	greutate	None
miiroon	micron	Nan
midnimadii	unitate	None
midnimo	unitate	None
midoobay	unit	None
midoobaywaxa	uniune	None
midoobeen	unit	None
midoobidii	uniune	None
midoobo	fuziune	Nan
miracas	este	None
midow	uniune	None
midowgaasi	unire	None
midtahay	tu	None
midyihiin	unit	None
miigagii	meu	None
miiggan	miiggan	Nan
miilaadiga	iarna	None
miimka	mika	Nan
midowga	uniune	None
midna	unul	None
miraha	semințe	Nan
mirfle	rostogoli	Nan
moobiilada	mobile	None
mood	modă	None
moodaa	pare	None
moodaaye	modă	None
mooday	crezut	None
moodey	gând	Nan
mooge	moge	Nan
moomaahee	ce?	Nan
moos	banane	Nan
mooska	banane	Nan
mooyaane	nu	None
mooyaanehaddaba	desigur	None
mooyee	nu	None
mooyi	nu	None
more	mult	None
montenegro	muntenegru	None
monako	muson	Nan
mohamud	mohamud	Nan
mohamed	mohamed	Nan
mirifle	rostogoli	Nan
miroodka	fruct	Nan
mirro	rulare	Nan
mise	sau	None
miskiga	saracul	Nan
misna	misna	Nan
mitterrand	mitterand	Nan
mire	noroi	Nan
miyaa	este?	Nan
miyi	sublim	Nan
miyiga	rural	None
miyuu	este?	Nan
mobile	mobil	Nan
mobiles	mobile	None
module	modul	None
mogadisho	mogadishu	Nan
miyaan	trebuie?	Nan
marshey	marshey	Nan
odhanjiray	spus	None
odiweyn	mare	None
qofkaste	lumea	None
qofkii	de	None
qofku	persoană	Nan
qofna	nimeni	None
qolo	clan	Nan
qoob	dans	None
qoomido	regret	Nan
qoomiyado	regretă	Nan
qoonedhangaloowbeydaaniyo	familyonedborg	Nan
qoor	gât	None
qoqobnaan	izolare	Nan
qora	scris	None
qoraa	autor	None
qoraaga	autor	None
qoraagii	autorul	None
qofkasta	lumea	None
qoraal	scris	None
qofkale	altcineva	Nan
qofba	de	None
qiyaasay	măsurat	Nan
qiyaasi	imagina	Nan
qiyaaso	imagina	Nan
qiyaasta	dozare	Nan
qiyaastii	aproximativ	None
qiyidaaq	justificare	Nan
qm	qm	Nan
qod	săpa	Nan
qodaal	săpa	Nan
qoday	dezgropat	Nan
qodiddii	excavare	Nan
qodin	săpa	Nan
qodob	articol	None
qodobka	articol	None
qof	persoană	Nan
qofka	persoana	None
qoraalada	texte	None
qoraaladii	texte	None
qoraalka	text	None
qorituurkii	bătrânii	Nan
qorituurkuna	soarele	None
qoro	scrie	None
qorshahan	plan	None
qorshe	plan	None
qoryo	lemn	None
qoryooley	pădure	None
qosol	râsete	Nan
qoto	adâncime	None
qowmiyada	etnie	None
qoys	familie	None
qoyska	familie	None
qoyskii	familia	None
qubbi	baie	None
qubo	turna	Nan
qorista	scris	None
qorigii	arma	Nan
qorida	scris	None
qori	scrie	None
qoraalkaan	text	None
qoraalkan	articol	None
qoraalkii	text	None
qoraalo	texte	None
qoraan	scrie	None
qoraha	autor	None
qoran	scris	None
qiyaasaa	măsurat	Nan
qorax	soare	None
qoraxeey	însorit	Nan
qoraxey	însorit	Nan
qoray	scris	None
qore	autor	None
qoreen	scris	None
qoremaxamed	de	None
qorey	scris	None
qoraxda	soarele	None
qubrista	baia	None
qiyaasa	măsura	None
qiyaame	înviere	Nan
qaybkamida	parte	None
qaybo	părți	None
qaybood	secțiuni	None
qaybqaateen	participat	None
qaybsaday	împărțit	None
qaybsantaa	divide	Nan
qaybsantahay	împărțit	None
qaybsha	un	None
qaybta	secțiune	None
qaybtan	aceasta	None
qaybtii	partea	None
qayka	pădure	None
qayraadkiisa	sale	None
qeebaha	părți	None
qeebiyay	descris	None
qaybiyaa	distribuie	Nan
qeebood	părți	None
qaybin	distribui	Nan
qaybaha	secțiuni	None
qasaare	pierde	None
qasali	suc	Nan
qasbaa	convingătoare	Nan
qasbay	forţat	Nan
qasim	amesteca	Nan
qassem	confuzie	None
qatar	qatar	Nan
qawmiyada	etnie	None
qaxay	fugit	None
qaxii	evacuare	Nan
qaxoontiga	refugiatul	Nan
qaxooti	refugiat	None
qaxootiga	refugiați	None
qayawoowgii	trecut	None
qayb	parte	None
qaybgasho	la	None
qeebsama	împărțit	None
qeebsanaa	împărțit	None
qeexayey	descriind	Nan
qiimo	valoare	None
qiiq	fum	Nan
qilaafeen	respins	None
qilaafsan	afirmat	None
qir	confirmare	Nan
qirayaa	recunoscut	None
qireen	recunoscut	None
qirista	confirmare	Nan
qiritaanka	mărturisire	Nan
qiritaanku	mărturisire	Nan
qisadaan	poveste	None
qisadan	poveste	None
qisadii	poveste	None
qisooyin	povestiri	None
qiyaamaha	fictiune	Nan
qiimayn	evaluare	None
qiimaha	valoare	None
qibladeedii	experienţă	Nan
qiblada	qiblah-ul	Nan
qeexaysaa	descrie	None
qeeyb	parte	None
qeyb	parte	None
qeybaha	părți	None
qeybisa	despărțitor	Nan
qeybiya	distribui	Nan
qeybiyaa	distribuie	Nan
qiyaas	măsura	None
qeybiyey	distribuite	Nan
qeybood	părți	None
qeybsaday	împărțit	None
qeybsan	împărțit	None
qeybta	partea	None
qeybteeda	sa	None
qeyliye	un	None
qibdhiya	strigăt	Nan
qeybiyo	diviziuni	None
qubrus	cipru	None
qudaarta	legume	None
qudha	numai	None
raqiisanyihiin	mai	None
raran	haran	Nan
rash	de	None
rashid	găsi	None
rashiid	praştie	Nan
raskambooni	poze	None
rasmi	oficial	None
rasmiga	oficial	None
rasuul	apostol	Nan
rasuulka	apostolul	Nan
rasuulkeennii	nostru	None
rasuulkii	apostolul	Nan
rasuulkiisa	apostolul	Nan
rasuulku	apostol	Nan
rasuululaah	apostol	Nan
raqiis	ieftin	Nan
rate	rată	None
raq	raq	Nan
rammadaan	această	None
raggii	barbatii	Nan
raggiisiiye	lui	None
ragii	bărbați	None
ragow	bărbați	None
raiisalwasaare	ministru	None
raiisul	disconfort	Nan
raisul	raisul	Nan
raisulwasare	raisulwasare	Nan
rajab	pânze	Nan
rajada	speranta	Nan
rajaynayaa	sper	Nan
rajeynayaa	tu	None
rajiimkii	ambasadorul	Nan
rajo	speranţă	Nan
ramadaan	șlem	Nan
ranges	intervale	Nan
rati	rati	Nan
raxay	ucide	None
raxmaan	bunătate	Nan
reerkiisa	lui	None
reerkiisii	lui	None
reerkooda	lor	None
reernimada	renaştere	Nan
reero	gospodărie	Nan
regime	regim	None
region	regiune	None
regions	regiuni	None
register	inregistreaza-te	Nan
release	eliberare	None
repubblica	repubblica	Nan
republic	republică	None
rer	rer	Nan
resolution	rezoluţie	Nan
ri	găsite	None
reerkiina	familie	None
reerka	familie	None
reergalbeedku	vestul	None
reeraha	familie	None
rayaale	rayale	Nan
rayaan	turii	Nan
rayidka	civili	None
raysal	raysal	Nan
rc	rc	Nan
realtime	real	None
recognition	recunoaştere	Nan
ragga	bărbați	None
ree	vinde	Nan
reebaana	interzice-l	Nan
reebay	exclus	Nan
reebban	exceptia	Nan
reebka	ordin	None
reebo	cu	None
reer	familie	None
reera	familie	None
reeb	ordin	None
ragaadisay	a	None
raga	plase	Nan
rag	bărbați	None
qurxoon	frumoasa	None
qusa	freca	Nan
qusay	îngrijorat	Nan
qusayi	rece	None
quudhsadaye	disprețuiți	Nan
quudhsi	dispreţ	Nan
quudiyaah	bătrân	None
ra	cumpără	Nan
raaca	urma	None
raacaan	urma	None
raacay	urmat	None
raacdey	urmat	None
raaceen	urmat	None
raacin	a	None
raacineysaa	add	Nan
qurxan	frumoasa	None
quruxsan	frumoasa	None
quruxna	frumoasa	None
quruxda	frumuseţe	Nan
qudus	sfânt	None
qumaatiga	auto	None
qura	numai	None
quraan	coran	None
quraanka	coranul	None
quraankiisa	său	None
quraysh	quraysh	Nan
raaciyey	adăugat	None
qurayshtu	qurays	Nan
qurbac	gunoi	Nan
qurbaha	in	None
qurbajoogga	diaspora	None
qureysh	mic	None
qureysheed	o	None
qureyshtu	prânzul	Nan
qurux	frumoasa	None
qurba	ofertă	Nan
qarsoon	ascuns	None
raaco	urma	None
raacsanyahay	acord	None
raba	împărțit	None
rabaa	vreau	None
rabaan	vrei	Nan
rabay	dorit	None
rabbi	rabin	Nan
rabbigiis	iepurele	Nan
rabiic	rabiic	Nan
rabin	jumătate	None
rabitaanka	dorință	None
rabo	soartă	Nan
rabtay	dorit	None
rada	rada	Nan
radio	radio	None
radius	rază	None
rafaadkii	suferinta	Nan
raaxo	confort	Nan
raaxeestaan	bucura	None
raaxaysto	bucura	None
raaxaystaan	bucura	None
raad	urmă	None
raadi	caută-l	Nan
raadiyo	radio	None
raadkaan	efect	None
raadkii	urma	None
raadraaca	urmărire	Nan
raage	moale	None
raacsan	adepți	Nan
raagge	încet	None
raahibka	confort	Nan
raali	scuze	Nan
raalli	vă	None
raascaseyr	racketcaserr	Nan
raashin	mancarea	Nan
raaskambooni	capitalizare	Nan
raaxaysta	bine	None
raahib	rap	None
qarsoodiya	confidenţial	Nan
qarsoodi	secret	None
qarshe	sfarsit	Nan
part	parte	None
parts	părți	None
party	parte	None
paul	paul	Nan
period	perioadă	None
peru	peru	None
petit	petit	Nan
phone	telefon	None
phones	telefoane	Nan
photos	fotografii	None
political	politic	None
pompidou	pompidou	Nan
port	port	None
possible	posibil	None
power	putere	None
parliamentary	parlamentar	None
price	preț	None
paris	paris	None
packet	pachet	Nan
organized	organizat	None
orgi	org	Nan
orod	alerga	Nan
orodada	alergare	Nan
oromo	pui	Nan
osman	osman	None
osoble	osoble	Nan
ossetia	osetia	Nan
ostariya	australia	None
ot	ot	Nan
other	alte	None
outlook	perspectivă	None
overview	generală	None
ow	au	None
p	p	None
pakistaan	pakistan	None
primary	primar	None
private	privat	None
prof	prof	None
qaadan	lua	None
qaadanay	luat	None
qaadanaya	luarea	None
qaadanaysaa	ia	None
qaadaneynaa	lua	None
qaadanno	lua	None
qaadano	lua	None
qaadashada	luarea	None
qaadataa	ia	None
qaadataan	lua	None
qaadatay	luat	None
qaadatey	luat	None
qaaday	luat	None
qaadaya	transport	None
qaadayaan	transport	None
qaadaan	transporta	Nan
qaadaa	poartă	None
qaada	transporta	Nan
qaad	lua	None
professor	profesor	None
protocol	protocol	None
provide	furniza	Nan
province	provincie	None
psu	psu	Nan
public	public	None
punltand	punltand	Nan
org	org	Nan
puntland	puntland	Nan
qaab	formă	None
qaababka	caracteristici	None
qaabiil	familie	None
qaabisho	ia-l	Nan
qaabka	formă	None
qaabkan	mod	None
qaabkii	formă	None
puławy	puławy	Nan
oren	câine	None
ordayey	alerga	Nan
orday	alergare	Nan
oggolaa	acord	None
ognahay	noi	None
ogol	permis	None
ogolaaday	acord	None
ogolaan	acord	None
ogolaanaya	acord	None
ogolyahay	permis	None
ogosto	august	None
ogsoon	conștient	None
ogsoonoow	conștient	None
ogtahay	tu	None
ogyahay	știe	None
oktobar	octombrie	None
oktober	oktober	Nan
oktoobar	octombrie	None
ogeyn	ști	Nan
ogayd	știut	None
ogalaa	permis	None
ogadenya	admiterea	Nan
odoyaashii	bătrâni	None
of	de	None
offer	oferi	None
official	oficial	None
og	og	Nan
oga	senior	Nan
ogaadaan	ști	Nan
olalihii	campania	None
ogaaday	descoperit	None
ogaadey	descoperit	None
ogaado	afla	None
ogaal	bună	None
ogaato	afla	None
ogaayeen	știut	None
ogaden	de	None
ogadenia	la	None
ogaadeen	descoperi	Nan
qaadayo	transport	None
olol	flacără	Nan
ololeeyey	a	None
ookorreeye	cravată	Nan
ool	ool	Nan
oon	însetat	Nan
oona	însetat	Nan
ooryeheer	senior	Nan
oow	da	None
ooy	plâns	Nan
ooyaayoo	plâns	Nan
operate	a	None
operators	operatori	Nan
optional	facultativ	Nan
or	sau	None
oradadawaxa	pe	None
oran	probleme	None
oranjiray	portocale	Nan
oohinta	plâns	Nan
oohin	strigăt	Nan
oogista	acuzarea	Nan
oogaan	coroană	None
ololihii	campanie	None
olombikada	olimpice	None
omaar	la	None
omar	tineri	None
on	el	None
one	unu	None
online	net	None
olole	camping	Nan
only	numai	None
oo	și	None
ood	ood	Nan
ooda	capotă	Nan
oodhan	regula	None
oodwayne	oodwayne	Nan
oofin	îndeplini	None
ooga	ooga	Nan
ontorodeegaan	net	None
odhankaro	fronturi	Nan
qaadaysa	transport	None
qaade	colector	Nan
qadiimi	vechi	None
qadiimiga	vechi	None
qadiimisan	vechi	None
qadiimka	vechi	None
qadiimsan	vechi	None
qafaashay	captiv	Nan
qalaad	exotic	Nan
qalaafe	tutore	Nan
qalaaye	lumesc	Nan
qalab	echipament	Nan
qalabka	materiale	None
qalabkoodi	lor	None
qalad	eroare	None
qalalaase	tulburare	Nan
qalbi	inimă	None
qadiim	vechi	None
qalbiga	inima	None
qadeeyey	de	None
qadaro	cantitate	None
qabsadeen	ocupat	None
qabsadeenwaxa	stăpânire	None
qabsado	urmă	None
qabsashada	ocupaţie	Nan
qabsatay	ocupat	None
qabtaa	face	None
qabtaan	le	None
qabtay	loc	None
qabteen	ținut	None
qabtey	loc	None
qabto	așteptare	Nan
qadaafi	gaddafi	Nan
qadar	cantitate	None
qadarka	cantitatea	None
qadarkaas	respectivă	None
qaddarka	cantitatea	None
qalbigiisa	lui	None
qalbigu	inima	None
qaldan	gresit	Nan
qardho	sculptura	None
qare	pepene	Nan
qargistan	acest	None
qariirada	hartă	None
qarin	ascunde	None
qarinayaan	ascuns	None
qarisay	ascuns	None
qarni	generaţie	Nan
qarniga	generaţie	Nan
qarnigan	generație	None
qarnigii	secol	None
qarniyadii	secole	None
qarniyo	secole	None
qarnka	generaţie	Nan
qarsado	ascuns	None
qardaawi	proteja	None
qarannimada	naţionalism	Nan
qaranku	naţiune	Nan
qarankan	națiune	None
qalday	eroare	None
qaleel	uscat	None
qalin	un	None
qamadi	grâu	None
qamadiga	grâu	None
qanacsanyihiin	satisfăcut	Nan
qandala	arogant	Nan
qabsaday	confiscat	Nan
qaraar	amărăciune	Nan
qaraha	pepene	Nan
qaramada	națiuni	None
qarameynayay	făcea	None
qaran	naţiune	Nan
qaranf	naţiune	Nan
qaranimada	naţionalism	Nan
qaranka	naţiune	Nan
qarad	explozie	Nan
qabrigiisa	său	None
qabrigii	mormântul	None
qabriga	mormânt	None
qaangaar	adult	None
qaanuunka	legea	None
qaar	niste	Nan
qaarad	continent	None
qaarada	continent	None
qaaradaha	continente	None
qaaradda	continent	None
qaaradood	continente	None
qaarba	unul	None
qaarda	niste	Nan
qaarkale	alții	None
qaarkamida	niste	Nan
qaarkood	niste	Nan
qaarkoodna	ei	None
qaarna	alții	None
qaamuusyada	dicționare	Nan
qaamuuskan	dicționar	None
qaamuuska	dictionarul	Nan
qaamuus	glosar	Nan
qaadeen	luat	None
qaadey	luat	None
qaadi	captură	Nan
qaadidda	îndepărtare	Nan
qaadiga	magistrat	Nan
qaadiriyada	magistrați	Nan
qaadku	qat	Nan
qaas	specific	None
qaadno	ia-l	Nan
qaadtay	luat	None
qaadye	jefuitor	Nan
qaali	scump	Nan
qaalib	dragă	Nan
qaaliga	dragă	Nan
qaalin	dragă	Nan
qaalisan	scump	Nan
qaado	ia-l	Nan
qaadday	luat	None
qaasim	specific	None
qaataa	ia	None
qabay	căsătorit	None
qabeelo	triburi	None
qabeen	avut	None
qabey	căsătorit	None
qabiil	clan	Nan
qabiilada	triburile	None
qabiiladaoogoozoo	qabiiladaoogoozoo	Nan
qabiilka	tribul	None
qabiilo	triburi	None
qabiilooyin	triburi	None
qabo	avea	None
qaboow	rece	None
qaboowdahay	tare	None
qabow	rece	None
qabridahare	cimitirul	None
qabaw	rece	None
qabatimay	dependenta	Nan
qabashadiisuna	lui	None
qabankarin	face	None
qaataan	lua	None
qaatay	luat	None
qaateen	adoptat	None
qaatey	adoptat	None
qaato	lua	None
qaba	infectat	Nan
qabaa	gândi	Nan
qaata	destinatar	Nan
qabaailada	triburile	None
qabaailkii	triburile	None
qabaal	o	None
qabaan	avea	None
qaban	do	None
qabanayaa	face	None
qabanayaan	face	None
qabane	deținător	Nan
qabaailka	triburile	None
marsada	prin	None
marqudha	timp	None
marooko	elefant	Nan
kooxda	grupul	None
kooxdii	grupul	None
kooxo	grupuri	None
kor	sus	None
koraaye	tot	None
koray	maturizat	Nan
koraysaaye	este	None
kordhaha	crește	None
kordhi	crește	None
kordhinta	extensie	Nan
kordhiyay	crescut	None
kordhiyey	extins	None
kordhiyo	extensiile	Nan
kordhoban	crescut	None
kordufan	crescut	None
kooxaha	grupuri	None
kore	verde	None
koox	grup	None
kooshin	curs	None
koofureed	sud	None
koofurgalbeed	sud-vest	Nan
koofurta	sud	None
koonfur	sud	None
koonfurba	sud	None
koonfurbari	sud-vest	Nan
koonfureed	sud	None
koonfureedka	sudul	None
koonfureedna	sud	None
koonfurta	sud	None
koonfurtu	sudul	None
koonfurtuna	sudul	None
koontaroolla	control	None
kooraha	heronii	Nan
koosar	curs	None
koowaad	primul	None
korkeeda	lui	None
korkiisa	lui	None
korkooda	lor	None
kugu	tu	None
kugula	tine	None
kuguulaysatay	câştigător	Nan
kuhadalaan	întâlnesc	None
kuhadlaan	întâlnesc	None
kuhanynta	furnicături	Nan
kuhaysa	tu	None
kujiraan	inclusiv	None
kujiray	inclus	None
kula	grijă	None
kulahaa	văd	None
kulahayd	acolo	None
kulan	întâlnire	None
kulana	privesc	None
kulansiine	întâlnesc	None
kufsi	viol	Nan
kufaa	se dezlănțuie	Nan
kudhintay	murit	None
kudhaw	de	None
kormerin	nou	None
korneel	un	None
korneyl	creștere	None
korodhsanayn	crescut	None
korontada	electricitate	None
koronto	electricitate	None
kororsi	tutoriale	Nan
koofur	sud	None
korreeye	înalt	None
kow	fiecare	None
kowaad	primul	None
ku	tu	None
kubada	mingea	None
kubadda	mingea	None
kudhaqan	pe	None
kudhaqanto	practică	None
korreeyetrololololololololololoibfhgidfgdufhgsdghdfbgdjbgdsjbgjsdbgjsbgjdfsklgkdsjfbgdfskbgdskjlbglkdfjbgkldfbgkdfbgkldsfbgskldfbgksldgblkdfsbglksdgbksdggggggggggb	topfetgloftfgggggffgggdfggbbkdlkkgbkklgkkggkkgfkggkkgfkgsgfggsggkggkkgfkgsgfggsggkggklgddggklgdggklgdggglgggklggdgggkglgggglgggglgggglggdlgggglggdlggggdggggggggglggglggglggglgglgglgglgglgglgglgglgglgglgglgglglglgglgglglgglglggts	Nan
kulayl	fierbinte	None
koofil	o	None
kooda	lor	None
kiristaan	creștinii	None
kiristanka	creștinii	None
kiristanku	tău	None
kismaayo	kismayo	Nan
kismaayobaydhabo	kismayoyou	Nan
kitaab	carte	None
kitaabka	cartea	None
kitaabkan	carte	None
kitaabkii	cartea	None
klm	klm	Nan
km	km	None
kmg	kmg	Nan
knaan	kannan	Nan
knights	cavaleri	Nan
known	cunoscut	None
kirishtaan	creştin	Nan
koban	koban	Nan
kingdom	regat	None
kinaana	ai	None
khuseyma	aplicabil	Nan
ki	și	None
kibirka	mândrie	Nan
kibis	pâine	Nan
kibroo	arogant	Nan
kici	scoală-te	Nan
kii	k	None
kiiba	cheia	Nan
kiikii	ki	Nan
kiimikaad	chimic	None
kiin	unu	None
kiina	dumnezeule	Nan
kiinya	oarecum	None
kilaab	club	None
kililka	axila	Nan
king	rege	None
kobash	creştere	Nan
kobcinta	îmbogăţire	Nan
kohay	kohay	Nan
koobantahay	limitat	None
koobantahy	limitat	None
koobanyahay	limitat	None
koobay	rezumate	Nan
koobaya	totalizare	Nan
koobayo	copiat	Nan
koobayso	rezuma	Nan
koobi	copie	None
koobkii	cupa	None
koobmaa	împachetări	Nan
koobnaa	limitat	None
koobnaan	rezumat	Nan
koobnaayeen	limitate	None
koobnayd	limitat	None
koobo	ceașcă	Nan
kooban	rezumat	Nan
koobaadmarkii	primul	None
koobaad	primul	None
koob	ceașcă	Nan
kol	col.	Nan
kolayga	coş	Nan
koleyga	baschet	None
kolkaas	apoi	None
kolkii	data	None
kolkuu	cand	None
kollay	chiar	None
koofi	pălărie	Nan
kolombiya	coroida	Nan
kolse	plută	Nan
kolyga	kolyga	Nan
kombuyuutarka	calculatorul	Nan
komoros	comore	Nan
konfur	configureaza	Nan
kong	kong	None
kongo	prezervativ	Nan
kolonbiya	colonie	None
kulaylkiiye	încălzitor	Nan
kuleel	fierbinte	None
kuleelka	fierbinte	None
laakiin	dar	None
laakiinse	dar	None
laakin	dar	None
laalaaba	ambii	None
laalaayey	suspendat	None
laami	alee	Nan
laamiga	asfalt	Nan
laamka	trompă	Nan
laan	ramură	None
laanta	ramură	None
laas	fată	None
laascaanood	acestea	None
laasgeel	de	None
laashin	ramură	None
laasqoray	copiat	Nan
laah	lah	Nan
laasqorey	copiat	Nan
laafyaha	oase	Nan
laabteen	înapoi	None
kuyaalla	tu	None
kuyaalo	jurul	None
kuyihiin	tu	None
kuyimi	veni	None
kwazulunatal	splendid	Nan
l	l	None
la	cu	None
laa	aici	None
laaan	ramură	None
laaana	nou	None
laaaneede	absolut	None
laaanta	tine	None
laaasaasay	apoi	None
laabneyne	înapoi	None
laabtay	înapoi	None
laadin	lovitură	None
laasqpray	lasiqpray	Nan
laatiiniga	latin	None
laatiinka	latin	None
labaduba	amândoi	None
labashaqlanaha	dublare	Nan
labka	masculin	None
labo	două	None
lacag	bani	None
lacagaha	plăți	Nan
lacago	bani	None
lacagta	bani	None
lacagtaas	banii	None
lacagtan	bani	None
lacagtasi	banii	None
lacagteedii	ei	None
lacagtii	banii	None
lacata	bani	None
ladaawdo	tratat	None
labadooda	amândoi	None
labadiisii	ambii	None
labadiisa	ambii	None
labadiiba	amândoi	None
laayay	ucis	None
lab	laborator	None
laba	două	None
labaad	doilea	None
labaadna	doilea	None
labaatan	douăzeci	None
labaatanaad	douăzeci	None
kuyaala	jurul	None
labaatankii	douăzeci	None
labada	ambii	None
labadaa	ambii	None
labadaas	doi	None
labadaasi	doi	None
labadaba	ambii	None
labadan	doua	None
labadii	doi	None
labad	ambii	None
kuyaal	în	None
kuxigeenka	adjunctul	Nan
kuwooda	ei	None
kumanyaalkii	miile	Nan
kumaray	inflorit	Nan
kumbuyuutar	calculator	None
kumbuyuutarada	calculatoare	None
kumbuyuutarka	computer	None
kumeel	temporar	None
kumeelgaar	temporar	None
kumeelgaarka	în	None
kumurmay	știu	None
kun	tu	None
kuna	fail	Nan
kunool	trăi	None
kunoolyihiin	trăiești	Nan
kuqoran	enumerate	Nan
kur	bute	Nan
kumanyaal	mii	None
kumanaan	mii	None
kuman	oms	Nan
kumalahan	necesar	None
kuleelkeeda	fierbinte	None
kuleh	fierbinte	None
kuliyada	colegiu	Nan
kuliyda	toate	None
kulligood	toti	Nan
kulliyada	colegiu	Nan
kulliyadda	în	None
kurdiska	kurzii	Nan
kulma	intalneste-te	Nan
kulmeen	întâlnit	None
kulmiye	cumulativ	Nan
kulmo	întâlni	None
kulul	fierbinte	None
kulushahay	fierbinte	None
kuma	și	None
kumaankun	capul	None
kulmay	întâlnit	None
khuduub	abordare	None
kurdistan	kurdistan	Nan
kusheetik	geometric	Nan
kuuriya	coreea	None
kuusoow	venit	None
kuusow	roși	Nan
kuwa	acestea	None
kuwaa	acestea	None
kuwaaa	acestea	None
kuwaar	aici	None
kuwaas	acestea	None
kuwaasi	acestea	None
kuwaasoo	oms	Nan
kuwada	tu	None
kuwait	kuweit	Nan
kuwan	aceste	None
kuwii	acestea	None
kuwo	lor	None
kuuma	tu	None
kuul	de	None
kuugu	tine	None
kuubaan	cub	Nan
kusii	intra	None
kusoo	haide	Nan
kusooduulay	care	None
kutaal	coloane	None
kutaala	haide	Nan
kutaalaa	aici	None
kutaalay	maimuta	Nan
kursiga	scaun	None
kutaallo	remorci	Nan
kutubo	devreme	None
kutubta	timp	None
kutubtii	târziu	None
kutubtiisa	sa	None
kututbtii	timp	None
kuu	dumneavoastră	None
kuuba	cuba	None
kutub	text	None
khubdadii	exemplu	None
khubaro	experți	Nan
khubaraduna	și	None
kadibna	apoi	None
kadin	card	Nan
kafadood	cenți	Nan
kaftan	o	None
kaga	imagina	Nan
kagsoo	pace	None
kahadhay	scuze	Nan
kahelay	l-am gasit	Nan
kahor	de	None
kaimd	kaimd	Nan
kajira	aici	None
kajirin	niciodată	None
kakoobantahay	complex	None
kakoobanyahy	complex	None
kal	kal	Nan
kadib	după	None
kala	separat	None
kadhiseen	perturbat	Nan
kadhacay	asta	None
kacaydhinaca	asta	None
kacaye	rebel	Nan
kacbada	răscoală	Nan
kacbadda	răscoala	None
kacbadiinnii	ta	None
kacdoon	revoltă	None
kacdoonka	rebeliune	Nan
kacdoonkii	răscoala	None
kadabkii	usa	Nan
kadagaalami	face	None
kadanbaysay	scurt	None
kadanbeeyay	timp	None
kaday	încordat	Nan
kaddib	după	None
kadhacady	asta	None
kadhashay	pierdut	None
kalabaxaan	despică	Nan
kalana	alte	None
kalandar	calendar	Nan
kalluunka	peşte	Nan
kalmada	cuvânt	None
kalmadduu	lui	None
kalo	salut	Nan
kaloo	asemenea	None
kalsiduu	crescut	None
kalsooni	încredere	None
kalsooniduu	lui	None
kaluunka	peşte	Nan
kalyaha	rinichi	Nan
kama	schimb	None
kambodiya	camuflaj	Nan
kamid	printre	None
kamida	imagine	None
kamidtahay	tu	None
kalluun	peşte	Nan
kaliyata	singur	None
kaliya	doar	None
kalinimada	singurătate	Nan
kalandarka	calendar	Nan
kalanderka	calendarul	None
kalasaaraha	clasificator	Nan
kalasaaridda	clasificare	None
kalawareeg	circula	Nan
kalayihiin	diferite	None
kale	alte	None
kacay	apărea	None
kaleba	asemenea	None
kalena	alt	None
kalgacayl	afecţiune	Nan
kali	singur	None
kaligaa	singur	None
kaligii	singur	None
kaligiii	singur	None
kalimada	cuvantul	Nan
kalee	alt	None
kacab	încordat	Nan
kacaankii	revoluţie	Nan
kacaanka	revoluţie	Nan
jubbada	jubileu	Nan
juli	iulie	None
july	iulie	None
julywaxaa	iulie	None
jumhūriyyat	jumhūriyyat	Nan
june	iunie	None
junna	junna	Nan
juqraafi	geografie	None
juqraafiga	geografie	None
juquraafi	geografie	None
juun	juun	Nan
k	k	None
ka	a	None
kaa	tu	None
kaafka	dincolo	None
jubba	jubba	Nan
jubadda	palton	Nan
jsl	jsl	Nan
jsiirada	js	Nan
joogayna	la	None
joogeen	suntem	None
joogeene	iată-ne	Nan
joogey	prezent	None
joogga	înălţime	Nan
joogno	stau	None
joogo	prezent	None
kaaga	tine	None
joogsanmaanta	stagnare	Nan
joogtaa	acolo	None
joogtada	constant	None
joogtay	prezent	None
joogto	constant	None
joorjiya	jurnal	None
joqof	jockof	Nan
jowhar	jowhar	Nan
joogta	stau	None
kamidyahay	apartine	Nan
kaah	kah	Nan
kaahin	întârziere	Nan
kabaal	pârghie	Nan
kabad	dulap	Nan
kabadan	decât	None
kabaha	pantofi	Nan
kabataane	potcovire	Nan
kabaxay	stânga	None
kabaxsan	dincolo	None
kabaxsanida	evacuare	Nan
kabel	kabel	Nan
kabexeen	ocolire	Nan
kabo	pantofi	Nan
kabsuuma	mult	None
kabtay	recuperare	Nan
kaca	creştere	Nan
kacaan	revoluţie	Nan
kab	pantof	Nan
kaatooliga	catolic	None
kaasoo	oms	Nan
kaasi	este	None
kaakici	incetineste	Nan
kaalin	rol	None
kaalinta	rol	None
kaalintii	rolul	None
kaalmada	asistenţă	Nan
kaalmadii	ajutor	None
kaalmeeye	ajutor	None
kaaha	radiație	None
kaalmo	asistenţă	Nan
kaam	tabără	Nan
kaar	card	Nan
kaaraan	sa	None
kaariye	conductor	Nan
kaarkuba	dulgher	Nan
kaas	care	None
kaashanayaan	coopera	Nan
kaalo	haide	Nan
ladareemay	bărbos	Nan
kamiruun	camera	None
kamman	imagine	None
keenye	alocate	Nan
keli	singur	None
keliga	singur	None
keligiis	singur	None
keliya	numai	None
kennedy	kennedy	Nan
kenya	kenyan	Nan
kexeeyey	condus	None
key	cheie	None
keying	keying	Nan
khaalid	greşeală	Nan
khaalida	greşeală	Nan
khaas	special	None
khaasatan	ales	None
khaatumkii	khaatum	Nan
keentay	cauzate	None
khabiir	un	None
keeno	aduce	None
keeneen	adus	None
kay	kay	Nan
kayaro	trăncăneală	Nan
kaydka	stoc	Nan
kaydsan	stocate	Nan
kayimi	haide	Nan
kaymaha	păduri	None
kaymo	pădure	None
kaynaan	salvați	Nan
kaysaha	jocul	None
kbps	kbps	Nan
kediye	venit	None
keebka	in	None
keena	adu-l	Nan
keenadiid	aduce	None
keenay	adus	None
keeni	aduce	None
khad	cerneală	Nan
khadiija	khadija	Nan
khadiijo	chicoteală	Nan
khayrka	binele	Nan
khayrkiisa	lui	None
kheeraadkaan	resurse	None
kheyraad	resurse	None
kheyraadka	resurse	None
kheyre	bun	None
khibrad	experienţă	Nan
khilaaf	controversă	None
khilaafaa	acord	None
khilaafeen	afirmat	None
khilaafka	disputa	None
khilaafsan	nepotrivit	Nan
khiyaamay	înșelat	Nan
khiyaamo	înşelăciune	Nan
khubarada	experți	Nan
khayriyada	resurse	None
khayraadka	resurse	None
khayr	bun	None
khatar	periculos	None
khadka	linia	None
khahin	gresit	Nan
khal	oţet	Nan
khaladaad	erori	None
khalaf	ronțăit	Nan
khaliif	calif	Nan
khaliifkii	calif	Nan
kaxiga	urmatorul	Nan
khaliijka	oțetul	Nan
khalqay	deformat	Nan
khalqigu	tulburarea	Nan
khamiis	joi	Nan
khamiista	joia	Nan
khasaaray	pierdut	None
khasab	obligatoriu	None
khasbay	forţat	Nan
khaliil	calif	Nan
kaxaystay	departe	None
kawsaday	retrase	Nan
kawayn	in	None
karayn	sa	None
karee	cremă	Nan
kari	supliment	Nan
kariimka	crema	Nan
karim	karim	Nan
karin	mult	None
karinwayadii	bucătarii	Nan
kariyey	gătit	Nan
karkabadii	doilea	None
karl	karl	None
karnaa	putem	None
karno	sa	None
karo	ciocnire	Nan
kartaa	sa	None
kartaan	poti	Nan
karanle	carantină	Nan
karale	carle	Nan
karaan	sa	None
karaamiyo	caravană	Nan
kan	a	None
kana	tu	None
kanaal	canal	None
kanaalka	canalul	None
kanada	canada	None
kaneeco	ţânţar	Nan
kani	acest	None
karti	abilitate	Nan
kaniisad	biserică	None
kaniisadda	biserica	None
kaniisaddii	biserica	None
kaqaatay	la	None
kara	pisa	Nan
karaa	sa	None
karaadsaday	întrebă	Nan
karaamadii	taina	Nan
kaniisada	biserica	None
kamma	kamma	Nan
kartid	poti	Nan
kartoonka	carton	Nan
kastoo	deşi	Nan
kastuu	ciuda	None
katagay	stânga	None
katahay	kate	Nan
katalaaniyawadanka	catalanii	Nan
katalin	catalizator	Nan
katalinaayay	catalizator	Nan
katalinaysaykadib	după	None
katalinjiratay	întrerupt	Nan
katalinjirtay	întrerupt	Nan
katay	ciot	Nan
katirsan	următoarele	None
katirsanayd	din	None
katurjumayaa	exagerat	Nan
kaw	veni	None
kasto	tot	None
kaste	de	None
kastana	oricum	None
kastaba	caz	None
karuur	mașină	None
karuurka	cresterea	Nan
kas	kaș	Nan
kasakhstan	din	None
kasbaday	câștigat	None
kashiisaba	lor	None
kasi	nu	None
karto	sa	None
kasii	păstrează-l	Nan
kasoobaxa	a	None
kasoojeeda	opusul	Nan
kasoojeeday	din	None
kasoojeedeen	unde	None
kasooo	izola	Nan
kasta	fiecare	None
kastaa	fiecare	None
kasoo	din	None
ladilay	ucis	None
ladin	lovitură	None
ladnaa	amenda	Nan
magaaladda	orașul	None
magaaladii	orașul	None
magaaladiisii	său	None
magaaladu	orașul	None
magaalamadaxda	capitala	None
magaalawga	orașul	None
magaalda	orașul	None
magaalo	oraș	None
magaalomadaxda	capitala	None
magaaloobay	oraș	None
magaalooyin	orase	Nan
magaalooyinka	orase	Nan
magaalooyinkan	orașe	None
magaalooyinkii	orase	Nan
magaaloyinka	orase	Nan
magaaladani	acest	None
magaalyooyinka	orase	Nan
magaaladan	acest	None
magaaladaan	acest	None
madhaafto	salvați	Nan
madhab	madhab	Nan
madhabta	doctrină	None
madheedh	gol	None
madigaan	asta	None
madigan	madigan	Nan
madiina	medina	None
madina	madina	Nan
madoobaa	negru	None
madoobayd	întuneric	None
madoobe	negru	None
madow	negru	None
magaaalo	orase	Nan
magaala	oraș	None
magaalada	oraș	None
magaaladaasi	orașul	None
magac	nume	None
magaca	numele	None
magacaaba	nume	None
magaloyinka	orașe	None
magan	soluţie	Nan
magazine	revistă	None
magool	compensare	Nan
magoolka	muniţie	Nan
magtii	compensare	Nan
magtiinnu	ta	None
magubte	magician	Nan
mahad	mulțumiri	Nan
mahadaay	linkay	Nan
mahaday	tata	Nan
mahadnaq	mulțumiri	Nan
mahadnaqayaa	mulțumesc	Nan
mahathir	mahathir	Nan
mahdi	mulțumiri	Nan
magalo	oraș	None
magaladan	acest	None
magalada	orașul	None
magacyo	numele	None
magacaabaa	numele	None
magacaabay	numit	None
magacaabi	numeste	Nan
magacaabida	numire	Nan
magacaabo	nume	None
magacaabobetyeeniyaoo	nambetyiniyaoo	Nan
magacaas	nume	None
madaxweynihii	presedintele	Nan
magacan	nume	None
magacdaray	numit	None
magaceeda	ei	None
magaciisa	lui	None
magaciisaawaxa	este	None
magacley	numit	None
magacyada	numele	None
magacyadaas	nume	None
magacbaxay	numit	None
madaxweyneyaashii	președinții	Nan
madaxweynenimada	președinția	None
madaxweyne	președintele	None
macnaheedu	sens	None
macnahoodu	lor	None
macnayaalka	sensuri	None
macneeyeen	sens	None
macneheedu	sens	None
macneyn	rău	None
macnihiisa	sau	None
macnihiisane	sens	None
macnihiisu	sens	None
macno	sens	None
macquul	logic	Nan
mad	nebun	Nan
madaafiic	artilerie	None
madaama	este	None
madaarka	aeroport	None
macnaha	sens	None
macna	sens	None
macluumaad	informație	None
maclin	profesor	None
maaweeliska	divertisment	Nan
maay	maay	Nan
maayo	să	None
macaamiisha	clienți	None
macaan	dulce	None
macaanaaye	adjectiv	None
macaanka	diabet	Nan
madadaalada	divertisment	Nan
macad	macad	Nan
macalimiinta	profesori	None
macalimiintii	profesorii	Nan
macalin	profesor	None
macallimiinta	profesori	None
macallin	profesor	None
macalmiin	profesori	None
machadka	institut	Nan
macalim	profesor	None
mahiigaan	asta	None
madagaskar	corpul	None
madaw	negru	None
madaxtooyadu	decor	Nan
madaxtooyo	decorativ	Nan
madaxwaynaha	președintele	None
madaxwaynanimada	președinția	None
madaxwaynayaasha	președinți	Nan
madaxwayne	președintele	None
madaxwaynew	președintele	None
madaxwaynihii	presedintele	Nan
madaxweeynaha	presedintele	Nan
madaxweeynihii	presedintele	Nan
madaxwene	președintele	None
madaxweyna	președintele	None
madaxweynaha	președintele	None
madaxweynahaasi	președinte	None
madaxweynahii	presedintele	Nan
madaxtooyada	decor	Nan
madaxtinimada	președinția	None
madaxii	capul	None
madaxdiin	sefi	Nan
madawi	negru	None
madawwaxa	ticăloșie	Nan
madax	cap	None
madaxa	cap	None
madaxbanaan	independent	None
madaxbanaani	independent	None
madaxbanaanida	independenţă	Nan
madar	madar	Nan
madaxbanaanidii	independenţă	Nan
madaxbannaani	independent	None
madaxbannaanidii	independenţă	Nan
madaxda	liderii	None
madaxdaas	lideri	None
madaxdeena	nostru	None
madaxdhaqameedkii	directorul	None
madaxdii	șefii	Nan
madaxbannaan	independent	None
maatarka	matroană	Nan
maj	maj	Nan
majeerteen	nu	None
mari	freca	Nan
mariam	mariam	Nan
mariino	marina	None
marin	trecere	None
marinayaay	marina	None
marine	marin	None
marinka	trecere	None
marino	marino	None
mariyeen	o	None
mariyey	o	None
marka	cand	None
markaa	apoi	None
markaad	tu	None
markaan	asta	None
markaana	și	None
mareykanku	american	None
markaas	apoi	None
mareykanka	unite	None
mareeyaha	administrator	Nan
maraykanka	unite	None
maraykanku	america	None
maraykankuna	unite	None
marayo	prin	None
maraysa	pasiv	None
marayso	prin	None
marba	nou	None
march	martie	None
mareeg	circuit	None
mareekanka	america	None
mareen	trecere	None
mareer	iapă	Nan
mareerey	mărșăluit	Nan
mareergur	mareergur	Nan
mareexaan	suspin	Nan
mareeykanka	unite	None
markaasaa	apoi	None
markaasay	apoi	None
markaasey	apoi	None
markiiba	imediat	None
markiidanbe	nou	None
markiisa	său	None
markooda	lor	None
markuu	el	None
marlabaad	oară	None
marmarka	ocazional	None
marna	nu	None
marnaba	nu	None
maro	pânză	None
maroidjeex	maroidjeex	Nan
maromacawis	maromacawis	Nan
maroodi	elefant	Nan
maroodiga	elefantul	Nan
maroodigii	elefantul	Nan
markii	cand	None
marki	asta	None
markey	moment	None
markes	markes	Nan
markaasi	apoi	None
markaasna	apoi	None
markaasneh	apoi	None
markaasu	apoi	None
markaasuu	apoi	None
markab	navă	None
markale	nou	None
marayaanna	caz	None
markan	asta	None
markasta	oricând	Nan
markasto	mereu	None
markay	cand	None
markaynu	noi	None
markeeda	propriu	None
markeedi	ei	None
markeey	meu	None
markana	asta	None
marayaa	prin	None
maray	trecut	None
mararka	câteodată	None
malaysiya	malarie	Nan
maldiif	linguriţă	Nan
maleegayeen	ghiceau	Nan
maleenaa	ne-am gandit	Nan
maleeshiyada	miliția	Nan
maleeyeen	gând	Nan
maleh	ești	None
mali	zi	None
maloo	nu	None
malta	malta	None
maltisku	maltis	Nan
mamaaliikta	tu	None
mana	dar	None
manchester	manchester	Nan
mandab	mandab	Nan
malaysia	malaezia	Nan
malaynayaa	presupune	None
malaheyn	nu	None
malahan	exista	None
major	major	None
maka	pentru	None
makaahiil	restaurant	None
makedonia	macedonia	None
makhaayad	restaurant	None
makhsuum	makhsuum	Nan
makka	meca	Nan
mandaqada	regiunea	None
makordhaha	fabricantul	Nan
malaaig	înger	Nan
malaaigta	îngeri	Nan
malaaq	înger	Nan
malaaqa	trifoiul	Nan
malaawi	înger	Nan
malaayga	meu	None
malaha	nu	None
maktabada	bibliotecă	None
majaajiliiste	un	None
mandeela	dispărut	None
mandheera	mandheera	Nan
maqlayso	asculta	Nan
maqli	auzi	Nan
maqlo	auzi	Nan
maqnaa	absent	Nan
mar	data	None
mara	cunoscut	None
maraa	ști	Nan
maraakiibta	livrare	Nan
maraakiibtiisa	sale	None
maraan	prin	None
maraaxil	martie	None
maraayaan	prin	None
maraayo	caz	None
marana	marana	Nan
marar	data	None
maqlay	auzit	None
maqlaan	asculta	Nan
maqcad	articol	None
maqashay	auzit	None
maneestay	maneestay	Nan
mange	raie	Nan
manger	iesle	Nan
mangistu	mangistu	Nan
mangooliyakadib	mangoolgirl	Nan
mangooliyiintu	mango	Nan
manhajka	curriculum	Nan
mandela	mandela	Nan
manneystay	îndeplinit	Nan
manta	a	None
many	mulți	None
mao	mao	Nan
maqaalada	articole	None
maqac	auzi	Nan
maqal	auzi	Nan
maqan	dispărut	None
mansuur	mană	Nan
richard	richard	None
maasuqa	corupţie	Nan
maarso	martie	None
layiraahdo	denumit	None
layli	exercițiu	Nan
layn	linia	None
layna	lanei	Nan
laysku	spărtură	Nan
laysu	lins	Nan
laysugu	aliniat	Nan
le	sa	None
league	ligă	Nan
leaguesyl	leaguesyl	Nan
leedahay	avea	None
leedahaye	un	None
leedihiyo	desene	None
leefay	linge	Nan
leegada	marimea	Nan
layidhaahdaa	asa	None
leelkase	nu	None
layeen	salvie	Nan
laydin	tu	None
lasoo	veni	None
lasoomaray	urmat	None
lasoonoqdeen	cunoscute	None
lawada	impartit	Nan
lawareegay	confiscate	Nan
lawareegeen	erau	None
lawyacaddo	salva	None
laxamiiste	un	None
laxda	oaie	Nan
laxidhay	închis	None
lay	lay	Nan
layaabka	surprinzător	None
layaableh	minunat	Nan
layaqaanaha	vrăjitorul	Nan
laydh	luminat	Nan
laydiray	trimis	None
leenahay	avea	None
leeuwarden	louwarden	Nan
leexatay	întors	None
leysku	calcul	None
libaan	o	None
libaax	leu	None
libaaxa	leul	None
libaaxyada	leii	Nan
liban	victorie	None
libiya	urmărire	Nan
library	bibliotecă	None
libya	libia	None
lid	dimpotriva	Nan
lihi	lihi	Nan
lihiba	lihiba	Nan
lii	lii	Nan
liibaan	a	None
liibiya	libia	None
leydiga	dreptunghi	Nan
ley	ley	Nan
lewis	lewis	None
level	nivel	None
leexday	întors	None
leexiyo	îndoire	Nan
leeyaay	singuratic	Nan
leeyahay	spune	None
leeyahaymadaxtooyo	leeyahaymadaxtooyo	Nan
leeyahy	cum	None
leeyhiin	avea	None
lasocotada	urmare	None
leeyihiin	avea	None
leh	cu	None
lehe	cum	None
leheed	are	None
lehna	cu	None
lehwaxa	cu	None
leone	leone	Nan
lesotho	lesotho	Nan
legislative	legislativ	None
lasiiyo	dat	None
lasheegay	menționat	None
lasheegaa	această	None
lagayaabo	eventual	None
lagu	la	None
lagugu	tu	None
lagula	cu	None
laguma	este	None
lagumagacaabijiray	nespecificat	Nan
laguna	asc	Nan
laguqiyaasaa	este	None
lagusiidaayo	sunteți înștiințat	Nan
lagusoo	tine	None
laguu	tine	None
laha	avea	None
lahaa	avut	None
lahaan	avea	None
lahaanshaha	proprietate	None
lagasoo	din	None
lagaqadan	abinere	Nan
lagana	din	None
lagama	nu	None
laeego	atenție	None
laf	os	None
lafaha	oase	Nan
lafalaha	oase	Nan
lafdhabar	coloană	None
lafdhabarta	șira spinării	Nan
lafoole	os	None
lahaayeen	avut	None
lafweyn	elaborat	None
laga	din	None
lagaa	tine	None
lagaba	absolut	None
lagaga	din	None
lagahayn	nu	None
lagala	ei	None
lagalay	din	None
lag	întârziere	Nan
liide	departe	None
lahab	șontâcăi	Nan
lahayaa	ing	Nan
lala	cu	None
lama	nu	None
lamana	nu	None
lamid	asemănător	None
lamidawday	fel	None
lamy	lamy	Nan
lana	ieri	None
lanka	lanka	None
laos	laos	Nan
laqabto	urmă	None
laqwi	a	None
large	mare	None
larumaysanyahay	suntem	None
lasameeyo	facă	None
lasameynayaa	gata	None
lakin	cu	None
lakiin	dar	None
lakala	laugh out loud	Nan
lajoogo	noi	None
lahayd	avut	None
lahayeen	avut	None
lahayn	nu	None
laheed	avut	None
laheen	nici	None
lahelo	disponibil	None
laheyd	avut	None
lahan	nu	None
laheyn	avut	None
lahjada	dialect	None
lahjadaha	dialecte	None
lahjadda	dialect	None
lahjado	dialect	None
laisku	lasere	Nan
lajira	cu	None
lajnado	cu	None
lahirgaliyay	aplicare	None
maastricht	maastricht	Nan
liinta	citrice	Nan
limited	limitat	None
maalintii	zilei	None
maalintuu	lui	None
maaliyada	cămaşă	Nan
maalkeeda	sa	None
maalmaha	zi	None
maalmeede	zilnic	None
maalmihii	zilele	None
maalmo	zi	None
maalmood	zi	None
maalqabeen	bogat	None
maalta	zi	None
maamul	administrare	None
maamula	reușit	None
maamuladii	autoritatile	Nan
maamulaha	managerul	Nan
maalintani	zi	None
maamulayeen	reușit	None
maalintaas	zi	None
maalinle	zilnic	None
maa	ghici	Nan
maadaama	cand	None
maaha	este	None
maahan	este	None
maahane	sunt	None
maahee	nu	None
maahmaahda	proverbul	Nan
maajo	zi	None
maakhir	asa	None
maal	bogatie	Nan
maala	macar	Nan
maali	zi	None
maalik	zi	None
maalin	zi	None
maalinba	zilnic	None
maalinta	ziua	None
maamulayey	reușit	None
maamulayo	administrată	Nan
maamulayso	administra	Nan
maansooyinka	zidari	Nan
maanta	azi	None
maantaba	azi	None
maantana	azi	None
maaraynta	administrare	None
maareeyaha	managerul	Nan
maareeyayaasha	manageri	Nan
maareeye	administrator	Nan
maariyatul	erezie	Nan
maarmaan	esenţial	Nan
maarmaanka	necesar	None
maarmay	nu	None
maarmayo	nu	None
maaroodi	maroodi	Nan
maars	maars	Nan
maansoole	poet	None
maansoolayaashii	călugării	None
maanso	te	None
maanshaa	butonul redare	Nan
maamuli	administra	Nan
maamulidda	administrare	None
maamulka	administrare	None
maamulkaas	administrare	None
maamulkii	administrare	None
maamulkiisa	lui	None
maamulo	administra	Nan
ma	fie	None
maamusho	administra	Nan
maandeeq	mană	Nan
maandhaafkii	dilema	Nan
maanka	minte	Nan
maankii	minte	Nan
maansada	mană	Nan
maansadan	zi	None
maansadii	salvați	Nan
maan	minte	Nan
m	m	None
luuqeeyso	vorbi	None
luuqadaha	limbi	None
loo	aplicat	None
loodoortay	selectat	Nan
looga	looga	Nan
loogana	luptă	None
loogu	pentru	None
looka	buturuga	Nan
lookhiyaameeyey	butonul redare	Nan
loola	contestate	Nan
looma	nu	None
loomagacaabaycismaan	numiți	None
loona	oricum	None
looqaybinkaraa	în	None
lootaxaabay	tagged	Nan
looyaqaan	cunoscut	None
looyaqaana	denumit	None
london	londra	None
loda	crea	None
locking	blocare	Nan
lock	lacăt	Nan
link	legătură	None
linkiga	legătură	None
links	link-uri	Nan
linuks	linuks	Nan
linux	linux	None
lis	listă	None
list	listă	None
looyaqaanay	cunoscut	None
lix	şase	Nan
lixaadlehna	rând	None
lixda	şase	Nan
lixdankii	şaizeci	Nan
lixle	şaizeci	Nan
lknse	dar	None
lo	foloseste-l	Nan
location	locație	Nan
lixaad	şaselea	Nan
liiska	listă	None
looyaqaano	ca	None
looyaqaany	ei	None
luqada	limba	None
luqadaha	limbi	None
luqadda	limba	None
luqado	limbi	None
luqadood	limbi	None
luqadooda	limbă	None
luqeedaka	limba	None
luqmaan	limba	None
luud	lot	Nan
luuliyo	iulie	None
luulyo	iulie	None
luulyokii	iulie	None
luuq	limba	None
luuqada	limba	None
luuqadaa	limba	None
luqad	limba	None
luntay	pierdut	None
lumin	pierdut	None
lumay	pierdut	None
looyaqano	chemat	None
lord	lord	None
lordi	camion	Nan
lower	inferior	None
lowska	nuca	Nan
lublin	lublin	Nan
lubnaan	liban	Nan
looyaqaanonikobolis	de	None
lug	picior	None
lughaya	picioare	None
lugohooda	lor	None
lugood	picioare	None
lugta	picior	None
lugtii	picior	None
lugu	lougou	Nan
luksemburg	luksemburg	Nan
lugaha	picioare	None
joogay	la	None
richman	richman	Nan
rideen	pune	None
warsangali	notifica	Nan
warsangeli	informa	Nan
warshada	fabrică	None
warshadaha	industrie	None
warshadda	fabrică	None
warshadii	fabrică	None
warshado	fabrici	None
warsheekh	warsheekh	Nan
warshiikh	fabrici	None
waryeele	gazetar	Nan
was	fost	None
wasaarada	minister	None
wasaaradaha	ministere	Nan
wasaaradda	minister	None
wasaaraha	ministru	None
warsame	warsame	Nan
wasaarayaashii	miniștrii	None
warqado	scrisori	None
warmuhu	sulița	Nan
wareegi	de	None
wareegii	rundă	Nan
wareegsan	rundă	Nan
wareegtay	încercuită	Nan
wareejin	transfer	None
wareejiyay	transferat	Nan
wareejiyey	transferat	Nan
warfaa	informație	None
warfaafinta	informație	None
wargaade	informator	Nan
wargayska	ziarul	None
wargaysyada	presă	None
wargeyska	ziar	None
wariyay	raportat	None
wariye	reporter	Nan
warqad	scrisoare	None
wasaare	ministru	None
wasaarihii	ministerul	None
wasaarihiisa	său	None
waxaana	noi	None
waxaanan	noi	None
waxaanay	ei	None
waxaanu	noi	None
waxaanuu	el	None
waxaas	lucru	None
waxaasa	este	None
waxaase	este	None
waxaay	aceasta	None
waxad	tu	None
waxaliilka	adopţie	Nan
waxan	lucru	None
waxana	și	None
waxanaa	este	None
waxannu	avem	None
waxaan	noi	None
waxaad	tu	None
waxaa	aceasta	None
waxa	ce	None
wasakheeyey	poluate	Nan
wasaq	poluare	None
wasarada	miniștri	None
wasi	scrisoare	None
wasiir	ministru	None
wasiirada	miniștri	None
wasiirka	ministru	None
wareegeen	încercuită	Nan
wasiirkii	ministru	None
wata	alt	None
watay	prezent	None
watch	ceas	None
wato	este	None
watto	timp	None
waw	waw	Nan
wax	ceva	None
wasiiro	miniștri	None
waxanu	acest	None
wareegay	încercuită	Nan
wareega	rundă	Nan
walwaal	vă	None
wan	spălăcit	Nan
wanaag	bun	None
wanaaga	bine	None
wanaagga	binele	Nan
wanaagii	binele	Nan
wanaagsan	bun	None
wanaagsana	bun	None
wanaagsanaa	bun	None
wanaagsanaantaas	această	None
wanaagsani	bun	None
wanaagsantahay	bun	None
wanaagyaalku	virtuțile	Nan
wanaagyadeena	nostru	None
wane	care	None
walow	deşi	Nan
wanwanaagsan	bun	None
wallee	wallee	Nan
waliid	încă	None
walaalnimo	fraternitate	Nan
walaalo	frați	None
walaalow	frate	None
walaaltinimo	fraternitate	Nan
walaashma	soră	None
walaiba	de	None
walalkiis	său	None
walanwal	wallanwal	Nan
walba	fiecare	None
walbaa	data	None
walbana	oricum	None
walbo	tot	None
wali	încă	None
waliba	asemenea	None
waligiinee	nu	None
waljamaaca	anxietate	Nan
waqiis	de	None
waqooyi	nord	None
waqooyiga	nord	None
waranka	ta	None
wararka	știri	None
waray	cum	None
waraye	știri	None
warbaahin	mass-media	Nan
warbaahinta	mass-media	Nan
warbixin	informație	None
warbixinta	raport	None
warbixintii	raportul	None
warbixintiisa	său	None
warcelinta	părere	None
wardheer	director	None
wardheere	ai	None
wardhiigleey	wardenigley	Nan
wardhiigley	wardhiigley	Nan
waran	suliţă	Nan
waramay	raportat	None
waraaqdii	scrisoarea	None
waraaqda	scrisoarea	None
waqoyi	în	None
waqti	timp	None
waqtiga	timp	None
waqtigaa	timp	None
waqtigaas	atunci	None
waqtigan	asta	None
waqtigii	timp	None
wareegan	ciclu	None
waqtigu	timpul	None
waqtiyadii	ori	None
waqtiyo	ori	None
war	știri	None
waraabbintaadii	ta	None
waraabin	udare	Nan
waraabinta	udare	Nan
waraabiyee	apă-l	Nan
waqtiyada	câteodată	None
waxar	copil	None
waxay	ei	None
waxayna	ei	None
weriyey	reporter	Nan
west	vest	None
wexey	spus	None
wey	grozav	Nan
weyddiiyey	l-am intrebat	Nan
weydiinta	cer	None
weydiisanayaa	întreb	Nan
weydiiso	cere	None
weydiiyey	l-am intrebat	Nan
weyn	grozav	Nan
weyna	grozav	Nan
weynaa	grozav	Nan
weynaadeen	crescut	None
weynaado	fii	None
weyne	grozav	Nan
werintii	stirile	Nan
weyneyd	grozav	Nan
werinta	raportare	Nan
werin	difuzare	Nan
wehel	cu	None
weheliye	companion	Nan
wehliye	companion	Nan
wejiga	fata	None
wejigeeda	ei	None
weli	inca	Nan
weliba	asemenea	None
weligayo	totdeauna	None
weligeed	vreodată	None
weligood	vreodată	None
well	bine	None
wels	wels	Nan
wenlake	wenlake	Nan
wenniger	wenniger	Nan
were	utilizare	None
werinaayo	raport	None
weyneyn	grozav	Nan
weyneynta	mărire	Nan
weyni	grozav	Nan
wikipediaha	wikipediaha	Nan
wikiteknoolojida	tehnologie	None
wikiwiki	wikiwiki	Nan
will	voi	None
windows	ferestre	None
wireless	fir	None
with	cu	None
wixii	de	None
woo	peți	Nan
woowga	wow	Nan
woqooyi	nord	None
woqooyibari	nord-vest	Nan
woqooyiga	nord	None
woqooyigalbeeda	în	None
world	lume	None
wikipedia	wikipedia	None
wiki	wiki	None
wiilwaal	băieți	None
wiilkuu	său	None
weyninka	măreţie	Nan
weynta	măreţie	Nan
when	cand	None
where	unde	None
which	care	None
whose	a	None
wiil	băiat	None
wegenxile	wegenxile	Nan
wiilal	fii	None
wiilashooda	lor	None
wiilka	băiatul	Nan
wiilkan	asta	None
wiilkii	băiatul	Nan
wiilkiina	băiatul	Nan
wiilkiisa	său	None
wiilkiisii	său	None
wiilasha	băieți	None
weeyn	grozav	Nan
weeye	este	None
weeyaane	este	None
waxsiin	furniza	Nan
waxsoo	niste	Nan
waxsoosaarka	producere	Nan
waxuu	el	None
waxuuna	face	None
waxyaabaha	lucruri	None
waxyaabihii	lucruri	None
waxyaabo	lucruri	None
waxyaalaha	lucruri	None
waxyar	putin	None
waxyoonay	inspirat	None
way	cale	None
wayaaye	uitare	Nan
wayday	putea	None
waydiin	nu	None
waxse	nimic	None
waxow	lucruri	None
waxoow	niste	Nan
waxoona	ceva	None
waxaynu	noi	None
waxba	nimic	None
waxbarashada	educaţie	Nan
waxbarashadiisa	lui	None
waxbarashadiisii	lui	None
waxbarasho	educaţie	Nan
waxee	ce	None
waydiisato	tu	None
waxeena	nostru	None
waxey	ei	None
waxeyna	ei	None
waxgaradka	înţelegere	Nan
waxii	de	None
waxka	lucru	None
waxna	nimic	None
waxoo	ceva	None
waxeey	ei	None
walaalkiisna	său	None
waydiiyay	întrebă	Nan
wayga	uite	Nan
weeba	chingi	Nan
weecdaa	întoarce	None
weel	recipient	Nan
weelashiina	tu	None
ween	se gândi	Nan
weeninkeeda	ei	None
weer	expresie	None
weerar	atac	None
weeraradaas	atacuri	None
weeraray	atacat	None
weerarka	atac	None
weerarkii	atacul	None
weeraro	atacurile	None
weerta	buruiană	Nan
weey	la	None
wee	și	None
websitka	web	None
website	website	None
webiga	raul	Nan
wayl	cale	None
wayn	grozav	Nan
wayna	vor	None
waynaa	grozav	Nan
waynaha	măreţie	Nan
waynayd	fost	None
waynayn	mare	None
waydinkii	cere	None
wayne	grozav	Nan
ways	moduri	None
waysadii	căile	None
wayska	căile	None
waysu	face	None
waziirkii	ministerul	None
web	web	None
webi	raul	Nan
waynwaxa	grozav	Nan
walaalkiis	său	None
walaalkii	frate	None
walaalkay	meu	None
uruguay	uruguay	Nan
uruka	beneficii	Nan
urur	organizare	None
ururada	organizații	None
ururka	organizare	None
ururkii	organizare	None
ururo	asociere	Nan
us	ne	None
usa	americii	None
usaama	evident	None
usaraysa	contingent	Nan
usbuuca	săptămână	None
usbuuceed	săptămânal	Nan
usc	usc	Nan
use	utilizare	None
urdun	miros	Nan
used	folosit	None
ur	ur	Nan
unugyada	celulele	None
ummukhalthum	ummukhalthum	Nan
umts	umts	Nan
umukalthum	umukalthum	Nan
un	onu	None
una	una	None
unaxariistee	mine	None
unbaa	venit	None
union	uniune	None
united	unit	None
university	universitate	None
unlock	deblocare	Nan
unnaxariisto	nefericit	Nan
unug	celulă	None
unugga	unitatea	None
unuggu	unitatea	None
unugyo	celulele	None
user	utilizator	None
uses	utilizări	Nan
usii	a	None
uyaala	wow	Nan
uyaalka	bastoane	Nan
v	v	None
valéry	valvery	Nan
varies	variază	None
venezuela	venezuela	None
vepfrancii	vepfrancii	Nan
vepitalii	vepitalii	Nan
vepročinma	vepročinma	Nan
vepvenäma	vepvenäma	Nan
vergleich	vergleich	Nan
voice	voce	None
vol	vol	None
w	w	Nan
wa	disponibil	None
uxiiso	bucura	None
uusan	nu	None
uuraysatay	conceput	None
uur	sarcină	None
using	utilizând	None
usoo	ne	None
ustaad	treilea	None
ustaaz	cinci	None
usually	obicei	None
usuuroobi	venit	None
utaaganaha	utaaganaha	Nan
ummukalthum	ummukalthum	Nan
utrecht	utrecht	Nan
uuga	forja	Nan
uugu	amorţeală	Nan
uuman	aburi	Nan
uumanka	umiditate	None
uun	doar	None
uuna	dragoste	None
uunkanna	aceasta	None
uu	lui	None
ummu	copii	None
ummaddan	neam	None
ummadda	naţiune	Nan
typically	tipic	None
u	u	None
ubad	copil	None
ubadan	mult	None
ubadka	bebelus	Nan
ubax	flori	None
ubaxu	a	None
ucusub	york	None
uday	uday	Nan
uddaayey	omule	Nan
udgoon	aromă	Nan
udgoonaa	mirositor	Nan
udgoonka	aromă	Nan
udheer	adăuga	Nan
udub	scopul	None
tvga	tvga	Nan
tv	televizor	Nan
tuxmo	inveleste	Nan
tuwaaxid	veni	None
tuu	arunca	Nan
tuug	hoţ	Nan
tuugo	hoți	Nan
tuulada	sat	None
tuuladii	satul	None
tuulo	sat	None
tuulooyin	sate	None
udubdhexaad	ea	None
tuulooyinka	sate	None
tuur	arunca	Nan
tuuray	cast	Nan
tuurayaan	aruncând	Nan
tuurayn	piesă	None
tuure	cast	Nan
tuuro	cast	Nan
tuuryare	traumatic	Nan
tuuniisiya	studiu	None
waa	este	None
udug	aromă	Nan
uga		None
ujeedadoodu	lor	None
ujeeddadiisu	scop	None
ujeeddo	scop	None
ukala	capelă	Nan
ukrain	urină	Nan
ul	băț	Nan
ula		None
ulajeedadaydu	meu	None
ulasoo	olas	Nan
uma	nu	None
umada	naţiune	Nan
umadda	naţiune	Nan
ummad	naţiune	Nan
ummada	naţiune	Nan
ummadaha	națiuni	None
ujeedadiisa	lui	None
ujeedada	scop	None
uguwayn	major	None
uguna	guna	Nan
ugaadha	vânătoare	None
ugaandha	umbrela	Nan
ugaarka	vânătoare	None
ugaarta	vânătoare	None
ugaas	şef	Nan
ugaaska	seful	Nan
ugama	nu	None
ufakaday	pierdut	None
ugana	gorilă	Nan
ugandheeska	ovar	Nan
ugasoo	această	None
ugu	pompa	Nan
ugudhaw	întoarce-te	Nan
ugudheer	lungă	None
uguhoraysay	ultimul	None
ugumaydhigin	spus	None
ugandha	mama	None
wow	wow	Nan
waaba	zi	None
waabari	zi	None
wadaniga	patriotism	Nan
wadaniyeed	patriotic	Nan
wadaniyiin	patriotic	Nan
wadanka	tara	Nan
wadankaa	respectivă	None
wadankaan	aceasta	None
wadankaas	respectivă	None
wadankaasi	țară	None
wadankan	aceasta	None
wadankani	țară	None
wadankanlaakiin	țară	None
wadankii	tara	Nan
wadanku	tara	Nan
wadanmada	patriotism	Nan
wadarta	total	None
wadani	paternitate	Nan
wadata	livra	Nan
wadan	țară	None
wadamo	țări	None
wadaagaa	acțiune	None
wadaagaan	acțiune	None
wadaagan	impartit	Nan
wadaagsano	a	None
wadaagta	însoțitoare	Nan
wadaagtaa	acțiune	None
wadaagtaane	partener	None
wadaan	conduce	None
wadada	drum	None
wadahadal	discuţie	Nan
wadahadalo	tratative	Nan
wadajir	împreună	None
wadajirka	împreună	None
wadama	idama	Nan
wadamada	țări	None
wadamu	wadamu	Nan
waday	continuat	None
wadda	care	None
waddada	drum	None
wakhtigaas	atunci	None
wakhtigaasi	atunci	None
wakhtigan	asta	None
wakhtigii	timpul	None
wakhtigiisii	lui	None
wakiil	împuternicit	Nan
wakiilada	agenţi	Nan
wakiilka	agent	None
wal	wal	Nan
walaal	frate	None
walaalaha	frați	None
walaalaheed	ei	None
walaalahooda	lor	None
walaaleeyaan	frate	None
walaalkaa	fratele	None
wakhtigaa	atunci	None
wakhtiga	timpul	None
wakhti	timp	None
wakaalada	agenţie	Nan
waddamada	țări	None
waddan	țară	None
waddanka	tara	Nan
waddankiisa	lui	None
waddo	drum	None
wade	apă	None
wadeen	led	Nan
wadaaga	partajarea	Nan
wadnaha	inima	None
wadooyinka	pe	None
wafdi	delegație	Nan
wahab	veni	None
wajeer	afară	None
waji	față	None
wajib	obligatoriu	None
wajiis	față	None
wado	conduce	None
wadaadkii	preotul	None
wadaadka	preot	None
wadaad	pastor	Nan
waalba	fie	None
waalid	părinţi	Nan
waamid	a	None
waamo	nu	None
waan	voi	None
waana	e	None
waanada	îndemnare	Nan
waannu	vom	None
waano	îndemnare	Nan
waar	veni	None
waariyoo	eoni	Nan
waarku	prost	None
waasidan	larg	None
waasoo	care	None
waasuge	larg	None
waalaalow	vă	None
waakaas	apoi	None
waakaa	este	None
waajibnimada	treaba	Nan
waabeeye	zi	None
waaberi	zi	None
waad	tu	None
waadi	căuta	None
waadigii	gresit	Nan
waadna	tu	None
waafajiyaa	a	None
waataan	asta	None
waafaqsan	în	None
waaga	nebunie	Nan
waagaas	atunci	None
waagii	ziua	None
waagu	zi	None
waajib	datorie	Nan
waajibaadkeeda	sale	None
waajibka	treaba	Nan
waafi	destul	None
waabarei	dimineaţă	Nan
waataas	timp	None
waaween	in	None
wabiga	raul	Nan
wabiyaal	râuri	None
wabiyada	râuri	None
wacad	jurămintelor	Nan
wacan	bun	None
wacays	apel	None
wacbuudhan	bune	None
wacdi	predica	Nan
wacdiga	predicare	Nan
wacdiyow	predicator	Nan
waceys	apel	None
waceysle	vrăjitor	Nan
wacyigelinta	conștientizare	Nan
wada	împreună	None
wadaa	conduce	None
wabi	râu	None
wabarka	stirile	Nan
wabar	wbab	Nan
waayo	pentru	None
waaweyn	mare	None
waaweynaa	grozav	Nan
waaweyneyd	grozav	Nan
waax	departament	Nan
waaxaa	este	None
waaxda	departament	Nan
waayadaas	zile	None
waawayn	adulți	None
waayadii	trecut	None
waaye	sunt	None
waayeel	mare	None
waayeen	putut	None
waayey	dispărea	Nan
waayihii	ori	None
waayitaanka	disparitia	Nan
waaylahayad	bunicii nostri	Nan
waayay	pierdut	None
tutorial	tutorial	Nan
woxoo	ce	None
wsaare	emițător	Nan
yaaley	acolo	None
yaalla	disponibil	None
yaallaa	disponibil	None
yaalley	situat	None
yaallo	disponibil	None
yaalo	acolo	None
yaan	zi	None
yaanyada	roșii	None
yaaqshiid	tu	None
yaasha	yasa	Nan
yaasiin	yasin	Nan
yabaal	exemplu	None
yabar	venit	None
yabaroow	mulțumesc	Nan
yabarow	yabarow	Nan
yaaleen	facut	None
yacqoob	tare	None
yaale	bune	None
yaalaan	disponibile	None
xusseen	remarcat	None
xusuus	memorie	None
y	y	None
ya	aceasta	None
yaa	oms	Nan
yaab	surprinde	Nan
yaabaa	poate	None
yaabaha	minuni	None
yaabay	se întreba	Nan
yaabeen	uimit	Nan
yaabo	probabil	None
yaaceen	s-au grabit	Nan
yaal	situat	None
yaala	situat	None
yaalaa	acolo	None
yaalay	acolo	None
yacquub	iacob	None
yada	răspândire	None
yadii	bla	Nan
yaraan	deficienta	Nan
yaraantiisii	lui	None
yaraatee	macar	Nan
yarayd	mic	None
yare	limba	None
yarixunkaas	acela	None
yaroo	yahoo	None
yartahay	mic	None
yaryahay	mic	None
yaryar	mic	None
yaryaryihiina	mici	None
yasid	dispreţui	Nan
yaso	căuta	None
yaxye	ioan	None
yeber	yeber	Nan
yaraa	mai	None
yar	mic	None
yaqaano	familiar	Nan
yaqaanno	cunoscut	None
yaduna	curte	None
yahanad	demon	Nan
yahay	este	None
yahaye	yahaye	Nan
yahayna	este	None
yahey	da	None
yahuuda	evreii	None
xuso	mențiune	None
yahuudda	evreii	None
yaman	yaman	Nan
yamen	yamen	Nan
yaqaan	cunoscut	None
yaqaanaa	știe	None
yaqaanay	cunoscut	None
yaqaaneen	cunoscut	None
yaqaannay	cunoscut	None
yamaan	ya	Nan
yeedhay	denumit	None
xusnay	menționat	None
xuska	amintire	Nan
xudur	cordon	Nan
xuduud	graniță	None
xuduuda	granita	Nan
xuduudaha	frontiere	Nan
xuduudka	granita	Nan
xuduudo	frontiere	Nan
xujeyda	meu	None
xukumada	autoritățile	None
xukumay	judecat	Nan
xukumayay	judecând	Nan
xukumayey	judecând	Nan
xukumi	judecător	Nan
xukumina	nu	None
xukumo	judecăți	Nan
xukun	hotărâre	None
xubnihii	membrii	None
xukunka	hotărâre	None
xubnaha	membrii	None
xorta	liber	None
xoraynta	eliberare	None
xoreeyay	eliberat	None
xoreynta	eliberare	None
xoriyad	libertate	None
xoriyada	libertate	None
xornimada	independenţă	Nan
xornimadda	independenţă	Nan
xornimadii	independenţă	Nan
xornimadiisa	independenţă	Nan
xornimadooda	lor	None
xornimadoodii	lor	None
xornimo	independenţă	Nan
xoroobeen	elibera	None
xoroowday	liber	None
xorriyaadka	libertate	None
xubin	membru	None
xukunkii	hotărâre	None
xukunto	judecător	Nan
xukuumad	guvern	None
xuquuqda	drepturile	None
xuquuqdii	drepturile	None
xuquuqdooda	lor	None
xuquuqul	drepturile	None
xurnima	libertate	None
xuruufta	scrisori	None
xusan	menționat	None
xusay	remarcat	None
xusayna	menționează	None
xusaysaa	comemorează	Nan
xuseen	remarcat	None
xuseenow	asta	None
xusen	menționat	None
xusi	tine	None
xusid	mențiune	None
xuquuq	drepturile	None
xun	rău	None
xumuy	rău	None
xumo	rău	None
xukuumada	guvern	None
xukuumadda	guvern	None
xukuumaddii	guvern	None
xukuumaddiisii	său	None
xukuumaddu	guvern	None
xukuumadihii	guvernele	None
xukuumadii	guvern	None
xuskooda	lor	None
xulafaddii	aliați	None
xulka	echipa	None
xulufo	aliați	None
xumaa	rău	None
xumaaday	scuze	Nan
xumaan	rău	None
xumaanta	rău	None
xumi	rău	None
xulafadiisii	săi	None
yeedho	apel	None
yeel	fă-o	Nan
yeelaha	făcătorul	Nan
العلامة	العلامة	Nan
القرآن	القرآن	Nan
القرن	القرن	Nan
الكتب	الكتب	Nan
اللغة	اللغة	Nan
الله	الله	Nan
المد	المد	Nan
المكتبة	المكتبة	Nan
المنتخب	المنتخب	Nan
النبي	النبي	Nan
النسائي	النسائي	Nan
بسم	.م	Nan
بعد	بعد	Nan
تخريج	تخريج	Nan
ثم	.م	Nan
العربية	العربية	Nan
حروف	حروف	Nan
العراق	العراق	Nan
الصالحات	الصالحات	Nan
أعلم	.لم	Nan
أن	.ن	Nan
أنا	أنا	Nan
أنه	هنه	Nan
ابن	ابن	Nan
الأئمة	الأئمة	Nan
الترغيب	الترغيب	Nan
الحديث	الحديث	Nan
الرحيم	الرحيم	Nan
الرد	الرد	Nan
الردُّ	الرد	Nan
الرشيد	الرشيد	Nan
الساكنة	الساكنة	Nan
السلام	السلام	Nan
الشيخ	الشيخ	Nan
الصومال‎	الصومال	Nan
حكم	.م	Nan
داود	داود	Nan
ربيع	ربيع	Nan
لا	لا	Nan
للبخاري	للبخاري	Nan
للمنذري	للمنذري	Nan
لن	لن	Nan
لها	لها	Nan
ما	ما	Nan
مثل	مثل	Nan
مخطوطات	مخطوطات	Nan
مقديشو	مقديشو	Nan
مهدي	مهدي	Nan
مُجدّدُ	مجدد	Nan
هذا	.ا	Nan
هو	.و	Nan
والموضوعة	والموضوعة	Nan
وسلم	وسلم	Nan
كتب	كتب	Nan
كتاباً	ابا	Nan
كتاب	باب	Nan
قال	قال	Nan
رحمه	رحمه	Nan
رسالة	رسالة	Nan
رسول	رسول	Nan
شيخ	شيخ	Nan
ص	ص	Nan
صفة	صفة	Nan
صلاة	ةلاة	Nan
أشهد	أشهد	Nan
صلى	ىلى	Nan
عبد	عبد	Nan
عدا	.ا	Nan
علمي	علمي	Nan
على	ىلى	Nan
عليه	عليه	Nan
فقه	فقه	Nan
فهرس	فهرس	Nan
ضعيف	ضعيف	Nan
أحمد	دمد	Nan
أحكام	.ام	Nan
أحاديث	ثاديث	Nan
yidhaahdaa	spune	None
yidhaahdaan	spune	None
yidhaahdo	spune	None
yidhi	spus	None
yihii	este	None
yihiin	sunteți	Nan
yihin	acest	None
yiil	fost	None
yimaada	veni	None
yimaadaan	veni	None
yimaadeen	venit	None
yimaado	vine	None
yimi	haide	Nan
yimid	venit	None
yimiday	sosit	None
yemen	yemenul	Nan
yeesho	avea	None
yeesheen	avea	None
yeeshee	caz	None
yeelan	avea	None
yeelatay	făcut	None
yeelato	avea	None
yeelay	deoarece	None
yeeleen	făcut	None
yeeli	fă-o	Nan
yeelo	fă-o	Nan
yiqiin	posibil	None
yeera	haide	Nan
yeeray	convocat	Nan
yeeri	barbă	Nan
yeero	apel	None
yeertay	convocat	Nan
yeesha	avea	None
yeeshaan	avea	None
yeeshay	avea	None
yeeraa	apel	None
xorayneed	s-o elibereze	Nan
yir	yir	Nan
yiraah	spus	None
yusuf	yusuf	Nan
yuu	yuuu	Nan
yuusf	joseph	None
yuusuf	joseph	None
zanzibar	vei	None
zaylac	zaylac	Nan
zeilac	zeilac	Nan
zenawi	zenawi	Nan
zoppe	zoppe	Nan
zubeyr	ţintă	Nan
|	|	Nan
´	&#39;	Nan
´ka	a	None
´siyo	nu	None
أبي	أبي	Nan
yurubwaana	europa	None
yurubta	europa	None
yurubiyaanka	europenii	Nan
yurubcismaaniyiintu	europenii	Nan
yiraahdaa	spune	None
yiraahdaan	spune	None
yiraahdeen	zis	None
yiraahdo	spune	None
yiraaho	spune	None
yiri	asemănător	None
yoonis	yonis	Nan
yiraa	spune	None
yoorada	voi	None
youth	tineret	None
yugandha	uganda	Nan
yuhuuda	evreii	None
yuhuudiyah	evreiesc	None
yuhuudu	evreii	None
yunusba	foame	Nan
yurub	europa	None
york	york	None
xorayday	prins	None
xor	liber	None
xoosh	mâncărime	Nan
xamsa	hașiș	Nan
xamuud	încărcătură	Nan
xamuulka	încărcătură	Nan
xan	bârfă	Nan
xanaanada	grădiniţă	Nan
xanaaneeyo	ele	None
xanaaqay	furios	Nan
xanafiga	gastric	Nan
xanbaarsan	transport	None
xanta	bârfă	Nan
xanuun	durere	Nan
xanuunsaday	suferit	None
xanuunsan	bolnav	None
xaq	dreapta	None
xaqa	adevarul	Nan
xamarweyne	în	None
xaqiijinteeda	o	None
xamarka	gingia	Nan
xamare	porumbel	Nan
xajin	prindere	Nan
xajineyso	continuă	None
xajka	pentru	None
xajkii	pelerinul	Nan
xakiim	înţelept	Nan
xakumi	guvernare	None
xal	soluţie	Nan
xalaasha	legal	None
xalane	halala	Nan
xali	rezolva	None
xaliimo	ei	None
xalin	rezolva	None
xalliyaan	rezolv-o	Nan
xamar	xamar	Nan
xamardaye	covoare	Nan
xamarjajab	xperience	Nan
xaqiiqa	fapt	None
xaqiiqada	fapt	None
xaqiiqda	fapt	None
xarun	centru	None
xarunta	centrul	None
xaruntii	centrul	None
xaruunta	centrul	None
xasan	ideea	None
xasar	tara	Nan
xasilooni	stabilitate	None
xasiloonida	stabilitate	None
xassan	liniște	Nan
xasuuq	masacru	Nan
xasuuqa	genocid	Nan
xasuuqan	acest	None
xasuuqay	masacru	Nan
xasuuqday	masacrat	Nan
xasuus	memorie	None
xarumo	facilităţi	Nan
xarumaha	centre	None
xarrago	elegant	Nan
xariir	mătase	None
xaqiiqo	fapt	None
xaradh	post	None
xaradheere	butonul redare	Nan
xaraf	scrisoare	None
xarafka	alfabet	None
xarafkiisa	lui	None
xarafle	scrisoare	None
xaji	continuă	None
xarafluhuna	scrisorile	Nan
xarakada	activitate	None
xarakadu	activități	None
xaramkii	pasiunea	None
xarardheere	de	None
xarfaha	scrisori	None
xarfahan	scrisori	None
xariiqay	desenat	Nan
xarafyada	scrisori	None
xajarulaswadka	de	None
xaggeeda	ea	None
xaggee	unde	None
xaafadda	cartier	None
xaafadii	cartierul	None
xaafadood	suburbii	Nan
xaafidiin	tău	None
xaafiiska	birou	Nan
xaaji	așa	None
xaal	condiție	None
xaalada	situatia	Nan
xaaladaha	condiţii	Nan
xaaladda	situatie	Nan
xaaladdu	situatia	Nan
xaaladihii	împrejurări	Nan
xaaraam	nelegitim	Nan
xaarith	haarith	Nan
xaas	soție	None
xaafadaha	cartiere	None
xaafada	cartier	None
xaafad	cartier	None
xaadirka	prezentul	Nan
wuqooyi	nord	None
wuu	el	None
wuuna	el	None
wuuxuna	va	None
wuxaa	este	None
wuxu	el	None
wuxuna	este	None
xaashi	foaie	Nan
wuxuu	el	None
wuxuuo	heo	Nan
ww	ww	Nan
wwii	mondial	None
wxa	bara	None
wxaa	este	None
x	x	None
xaad	păr	None
wuxuuna	el	None
xasuusan	tine	None
xaaskii	soție	None
xaasuubka	magia	Nan
xaduud	frontieră	None
xafidka	pază	Nan
xafiis	birou	Nan
xafiiska	birou	Nan
xafiisyada	birouri	Nan
xafiisyadii	birouri	Nan
xafiisyo	birouri	Nan
xafladan	această	None
xag	unghi	None
xaga	spre	None
xagaa	vară	None
xagaagii	vara	None
xagaas	acolo	None
xagga	din	None
xaggaaga	tine	None
xadka	limita	None
xadiiskan	acest	None
xadiiska	hadith	Nan
xadhig	frânghie	Nan
xaasuubkiisa	lui	None
xaawo	sudoare	Nan
xaayow	butonul redare	Nan
xabaal	mormânt	None
xabad	cufăr	Nan
xabasha	lipici	Nan
xabashida	îngropa	Nan
xaaskiisii	lui	None
xabsi	in	None
xabsigii	inchisoarea	Nan
xad	limită	None
xadaarad	civilizaţie	Nan
xadaaradahii	civilizațiile	Nan
xaddaaradda	in	None
xaddiiska	cantitatea	None
xadgudbay	abuzat	Nan
xabsiga	in	None
woxoona	oricum	None
xasuustaa	iti amintesti	Nan
xasuustiisana	el	None
xiran	închis	None
xiray	închide	None
xiraye	conector	Nan
xirfad	abilitate	Nan
xirfada	profesie	Nan
xiri	închide	None
xiriir	lua	None
xiriira	de	None
xiriiraan	comunica	Nan
xiriiri	lua	None
xiriiriyaha	contactul	None
xiriirka	relaţii	Nan
xiriirto	lua	None
xirnaa	închis	None
xirneen	taci	Nan
xir	închide	None
xirnimo	închidere	Nan
xingalool	furnicături	Nan
xilliyo	sezoane	Nan
xiligan	moment	None
xiligii	timp	None
xiligiimuraadkii	vremuri	None
xiliyada	anotimpurile	Nan
xiliyadii	anotimpurile	Nan
xiliyo	ori	None
xilka	responsabilitate	Nan
xilkaas	poziție	None
xilkeeda	ei	None
xilli	sezon	None
xilligaa	atunci	None
xilligaas	atunci	None
xilligaasi	atunci	None
xilligan	moment	None
xilligii	anotimpul	Nan
ximyar	copil	None
xirsi	ei	None
xirta	închide	None
xirtaa	taci	Nan
xooga	concentra	Nan
xoogaa	niste	Nan
xoogag	forţele	Nan
xoogan	puternic	None
xoogana	puternic	None
xoogaysteen	puternic	None
xoogga	putere	None
xoojinta	consolidare	Nan
xoola	cirezi	Nan
xoolaha	șeptel	Nan
xoolaheeda	ei	None
xoolaley	păstori	Nan
xoolihii	animalele	None
xoolo	șeptel	Nan
xooluhuna	animalele	None
xoog	putere	None
xogo	informație	None
xoghayaha	secretar	None
xoghaya	secretar	None
xirtaan	poarta-l	Nan
xisaab	matematică	None
xisaabaadka	conturi	Nan
xisaabin	calculati	Nan
xisaabta	matematică	None
xisaabtan	responsabilitate	Nan
xisbi	parte	None
xiligaasoo	atunci	None
xisbiga	petrecerea	Nan
xisbigiisa	lui	None
xisbiyada	petreceri	Nan
xisbiyo	petreceri	Nan
xishoon	rușine	Nan
xitaa	chiar	None
xkhayre	călăreț	Nan
xog	informație	None
xisbigii	petrecerea	Nan
xiligaasi	atunci	None
xiligaas	atunci	None
xiligaa	atunci	None
xeeran	jurul	None
xeerar	norme	None
xeerarka	norme	None
xeerarkeeda	sale	None
xeerka	regula	None
xeraale	vilegiaturist	Nan
xerada	tabără	Nan
xero	tabără	Nan
xh	xh	Nan
xhks	xhks	Nan
xidh	închide	None
xidha	închide	None
xidhaayey	oprirea	Nan
xidhay	închide	None
xidhiidh	lua	None
xeer	regula	None
xeelliga	contextul	None
xeeldheeri	tactică	Nan
xeeldheer	în	None
xasuusto	tine	None
xataa	chiar	None
xawaadle	accelerator	Nan
xawaaladaha	remiterilor	Nan
xawaannada	viteze	None
xawda	viteză	None
xayaawaanaadka	animale	None
xidhiidha	de	None
xayawaan	animal	None
xayle	gras	Nan
xds	xds	Nan
xeeb	plajă	Nan
xeebaha	plaje	Nan
xeebeed	coastă	None
xeebta	plaja	Nan
xeel	tact	Nan
xayawaanaadka	animale	None
xasuustaan	tine	None
xidhiidhka	comunicare	None
xidhiidhno	contacte	Nan
xigto	rude	Nan
xiiirto	bărbierit	Nan
xiiray	ras	Nan
xiiseyneysid	interesat	None
xiiso	interesant	None
xijaaz	xijaaz	Nan
xijrootay	se încruntă	Nan
xikmad	înţelepciune	Nan
xil	responsabilitate	Nan
xilagan	asta	None
xilal	responsabilități	Nan
xildhibaan	mp	Nan
xilgii	timpul	None
xili	perioadă	None
xiliga	anotimpul	Nan
xigtay	→	None
xigtaa	urmatorul	Nan
xigta	→	None
xigo	→	None
xidhiidho	contacte	Nan
xidhka	purta	None
xidhkii		None
xidhnaan	taci	Nan
xidhnaantii	taci	Nan
xidho	poarta-l	Nan
xidid	rădăcină	Nan
xidhiidhkaasi	respectivă	None
xifdin	păstra	None
xigaa	→	None
xigaan	urmatorul	Nan
xigay	→	None
xigeen	viciu	Nan
xigeenka	viciu	Nan
xigeenkii	locotenent	Nan
xigmadda	înţelepciune	Nan
xiga	→	None
tuso	spectacol	None
tusaayo	implică	None
tusaan	arată-le	Nan
shacbigu	publicul	None
shaciga	legea	None
shadoor	liber	None
shahaadada	grad	None
shahaadataynku	certificare	Nan
shahaado	grad	None
shahiirsanadii	barbarii	Nan
shaki	îndoială	None
shalaanbood	felicitări	Nan
shalay	ieri	None
shan	băut	Nan
shanaad	cincilea	None
shanaadwaxaana	cincilea	None
shanfarood	cinci	None
shanta	cinci	None
shacbigii	publicul	None
shantaan	cinci	None
shacbigana	oamenii	None
shacbi	publicul	None
shabac	shabab	Nan
shabahdaa	acea	None
shabakad	web	None
shabakada	internetul	None
shabeel	tigru	None
shabeelaha	tigrul	None
shabeellaha	tigrul	None
shabeelle	shabelle	Nan
shabele	shabele	Nan
shabelle	shabelle	Nan
shacab	civili	None
shacabka	oamenii	None
shacabkii	publicul	None
shacabkooda	lor	None
shacabku	publicul	None
shacbiga	publicul	None
shantaasi	acea	None
shaqaalaha	angajați	None
shaqaale	angajat	None
shaqeynaya	lucru	None
shaqeynayay	lucru	None
shaqeysata	lucru	None
shaqo	muncă	None
shaqooyinka	munca	None
shaqsi	individual	None
shaqsiyaad	fizice	None
shaqsiyaadka	fizice	None
sharaf	onora	Nan
sharafkii	onora	Nan
sharafta	demnitate	Nan
sharaxday	explicat	None
sharci	lege	None
sharciga	legea	None
sharcigaa	legea	None
shaqeeyo	lucru	None
shaqeeyey	lucrat	None
shaqeeyeen	lucrat	None
shaqeeyay	lucrat	None
shaqaalihii	muncitorii	None
shaqaaq	tulburare	Nan
shaqada	munca	None
shaqadii	munca	None
shaqadiisa	lui	None
shaqal	vocală	None
shaqalka	vocala	Nan
shabaabka	plasa	Nan
shaqayn	muncă	None
shaqaysay	lucrat	None
shaqeen	lucrat	None
shaqeesa	sine	None
shaqeesaa	lucrări	None
shaqeeya	lucru	None
shaqeeyaa	lucrări	None
shaqeeyaan	muncă	None
shaqaynta	lucru	None
sharcigu	legea	None
shaati	cămaşă	Nan
shaam	shaam	Nan
saxaarada	tavă	Nan
saxaaro	scaun	None
saxaraa	scaun	None
saxaraha	fecale	Nan
saxda	corect	None
saxeexday	semnat	None
saxeexdeen	semnat	None
saxiixday	semnat	None
saxiixdeen	semnat	None
saxo	corect	None
saxons	saxoni	Nan
say	spune	None
sayid	maestru	None
sayidka	lordul	Nan
sayidku	maestru	None
saxaafadda	presă	None
saylac	spune	None
saxaafada	presă	None
sax	corect	None
sarkaalkii	politistul	Nan
sarkozy	sarkozy	Nan
sarreeye	înalt	None
sasha	sasha	Nan
sasiiliya	safir	Nan
saudi	arabia	None
sawaaxiliga	swahili	Nan
sawir	fotografie	None
sawirada	poze	None
sawiran	fotografiată	Nan
sawiray	fotografiată	Nan
sawiraya	desen	None
sawirka	imagine	None
sawirmaan	a	None
sawirro	poze	None
saxaabi	corect	None
saylada	piața	None
saylici	maestru	None
saynis	ştiinţă	Nan
senator	senator	None
sep	sep	Nan
serbia	serbia	None
servant	servitor	Nan
service	serviciu	None
services	servicii	None
several	mulți	None
seyfi	sefi	Nan
seynab	zaynab	Nan
sgaas	trabuc	Nan
sh	sh	Nan
shaac	declarat	None
shaafici	pagină	None
shaah	ceai	None
shaahii	ceai	None
seexday	dormit	Nan
seexan	dormi	Nan
seegaaya	domnișoară	Nan
sedex	trei	None
sayniska	ştiinţă	Nan
schleicher	schleicher	Nan
school	şcoală	Nan
schoolership	schoolership	Nan
schoolka	şcoală	Nan
schools	școli	None
scw	scw	Nan
shaarub	mustață	Nan
sdarbi	alesul	Nan
sebteembar	septembrie	None
sebtembar	septembrie	None
second	doilea	None
secondary	secundar	None
section	secțiune	None
security	securitate	None
sede	copie	None
sdwo	vizita	None
sharciya	legal	None
sharciyada	legii	None
sharciyeed	legal	None
shinema	strălucire	None
shingaani	bariere	Nan
shiniile	aligator	Nan
shir	conferinţă	Nan
shirakadahani	companii	None
shirarkii	conferințe	None
shirdahan	aceste	None
shire	shire	Nan
shirkaa	congres	None
shirkaas	întâlnire	None
shirkad	companie	None
shirkada	companie	None
shirkadaha	companii	None
shirkadahaas	companii	None
shirkadahan	companii	None
shineemo	cinema	None
shirkadahani	companii	None
shimbiruhu	păsări	None
shimbiraha	păsări	None
shige	potrivi	Nan
shiikh	sheikh	Nan
shiikha	shiikha	Nan
shiikhu	shiikhu	Nan
shiinaha	china	None
shiinuhu	china	None
shiiq	shiiq	Nan
shiiqaal	la	None
shiiraar	pânză	None
shil	accident	None
shilaabo	venit	None
shilin	șilingi	Nan
shilinka	banii	None
shilling	şiling	Nan
shimbir	pasăre	None
shimbiro	păsări	None
shirkadda	companie	None
shirkado	companii	None
shirkadood	companii	None
siday	de	None
sidda	de	None
side	latură	Nan
sidee	cum	None
sideed	opt	None
sideedaad	opta	None
sideedan	opt	None
sideedii	opt	None
sideetameeyadii	anii	None
sidey	transporta	Nan
sidi	ca	None
sidii	de	None
sidiisii	lui	None
sido	transporta	Nan
sidoo	asemenea	None
sidatan	de	None
sidan	aici	None
sidae	cum	None
sidaasi	în	None
shirkan	aceasta	None
shirki	atribuit	None
shirkii	adunarea	None
shiro	tăcere	Nan
shirqool	conspiraţie	Nan
shirweynahan	această	None
shisheeye	străin	None
shift	schimb	None
shuceyb	domnișoară	Nan
siad	apăsați	Nan
siciid	sa	None
sida	de	None
sidaa	de	None
sidaad	cum	None
sidaan	aici	None
sidaas	de	None
si	la	None
shido	aprinde	Nan
shiday	pornit	None
shidaalka	combustibil	None
shayga	obiectul	None
shcali	exemplu	None
sheeg	spune	None
sheega	spune	None
sheegaa	creanțe	Nan
sheegaan	spune	None
sheegaas	afirmaţie	Nan
sheeganaya	revendicare	Nan
sheegay	stabilit	None
sheegaya	menționează	None
sheegayaa	menționează	None
sheegayaan	spune	None
sheegayo	menționează	None
sheegeen	stabilit	None
sheegey	revendicat	Nan
shaydaan	satana	Nan
shaybah	shaybah	Nan
shay	obiect	None
shaxda	masa	None
sharciyeynaayey	legitim	Nan
sharciyo	norme	None
shardi	condiție	None
shardiga	condiție	None
shareecada	sharia	Nan
sharif	sharif	Nan
shariif	sharif	Nan
sheegganaa	revendicare	Nan
shariifka	șeriful	Nan
sharkiisa	lui	None
sharkiisaba	lui	None
sharmaarke	vede	None
sharmaarkeعبد	comentariu عبد	Nan
sharmake	sharmake	Nan
shatt	shatt	Nan
shax	masa	None
shariifku	raft	Nan
sarkaal	ofiţer	Nan
sheegganayd	revendicat	Nan
sheegi	spune	None
sheekhu	poveste	None
sheekhulislaam	sheikhulislam	Nan
sheeko	poveste	None
sheekooyinka	povestiri	None
sheekooyinkii	povestile	Nan
sheikh	seic	Nan
shekh	shekh	Nan
sheyba	sheaba	Nan
sheydaankii	diavolul	Nan
shibane	shiban	Nan
shibil	accident	None
shibilka	accident	None
shibis	conferințe	None
shicibka	publicul	None
shidaal	combustibil	None
sheekhii	poveste	None
sheekheena	noastră	None
sheekhaal	poveste	None
sheekha	narator	Nan
sheegin	despre	None
sheegnay	menționat	None
sheegnaya	menționează	None
sheegnayba	ment	Nan
sheego	spune	None
sheegsheegta	revendicare	Nan
sheegta	revendicare	Nan
sheeggayga	mea	None
sheegtaa	creanțe	Nan
sheegtada	revendicare	Nan
sheegtay	revendicat	Nan
sheegto	revendicare	Nan
sheekada	poveste	None
sheekayn	poveste	None
sheekayno	conversație	Nan
sheekh	seic	Nan
sheegtaan	revendicare	Nan
sarifo	schimb	None
sarfiga	alfabetul	None
sareysa	înalt	None
saara	elimina	Nan
saaraa	îndepărtat	None
saaraan	îndepărtat	None
saaran	pe	None
saaray	scoate	None
saarayso	exclus	Nan
saareen	regretat	Nan
saarey	omis	Nan
saari	elimina	Nan
saarida	excludere	Nan
saarka	produs	None
saarkeeda	el	None
saarkooda	lor	None
saarnaa	pe	None
saaro	îndepărtat	None
saar	elimina	Nan
saartaa	pe	None
saanmarino	șaman	Nan
saan	acest	None
saabsan	despre	None
saabsanaa	despre	None
saacad	ora	None
saacada	ora	None
saacadaha	ore	None
saadka	logistică	Nan
saaiidi	și	None
saalax	scuzati-ma	Nan
saamaxday	amnistiat	Nan
saamaxeen	amnistiat	Nan
saamaynta	efecte	None
saamaysay	afectat	None
saambiya	safirul	Nan
saami	proporţie	Nan
saamo	stoc	Nan
saanad	ani	None
saartay	scoate	None
saas	de	None
saaxiib	prieten	None
sabtida	sâmbătă	Nan
sabtiga	sambata	Nan
sac	vacă	Nan
sacad	colibă	Nan
sacaridalaxdageelka	calcavură	Nan
saciid	salivă	Nan
sacuudi	arabia	None
sacuudiga	sfantul	Nan
sadaam	saddam	Nan
sadaan	s	None
sadam	sadam	Nan
sadamna	sadna	Nan
sadaqada	caritate	None
sadaqo	caritate	None
sadax	trei	None
sabti	sâmbătă	Nan
sabriye	paloș	Nan
saboolsan	sărac	None
sabool	sărac	None
saaxiibka	prieten	None
saaxiibtinimo	prietenie	None
saaxiibtinnimo	prietenie	None
saaxiil	vrăjitor	Nan
saaxil	vrăjitor	Nan
sab	cauza	None
saba	nepotrivit	Nan
sa	stabilit	None
sabab	motiv	None
sababay	cauzate	None
sababeen	cauzate	None
sababta	ce	None
sababtay	cauzate	None
sababto	cauze	None
sababtoo	deoarece	None
sablaale	cursor	Nan
sababaha	motivele	None
s	s	None
ruwanda	apă	None
ruuxna	nimeni	None
roma	romi	None
romaankuba	românul	Nan
roman	român	None
romania	românia	None
romanku	român	None
rome	crom	Nan
roob	ploaie	None
roobab	precipitare	Nan
roobka	ploaie	None
roobkana	și	None
roobku	ploaie	None
rooble	curcubeu	Nan
roobleh	curcubeu	Nan
roof	acoperiş	Nan
rooma	o	None
rogrogan	răsucit	Nan
rogaye	răsucit	Nan
rogay	inversat	Nan
roelof	roelof	Nan
ridey	zbor	None
rido	incepe	Nan
rigliga	instalație	Nan
rinjiga	a	None
river	râu	None
riyaale	vis	None
riyada	vis	None
roomaaniyiinta	românii	None
riyadaas	vis	None
riyadoodii	lor	None
riyaha	caprele	Nan
riyo	vis	None
roaming	roaming	Nan
robust	robust	Nan
rodes	rodes	Nan
rodolfo	poundolfo	Nan
riyadii	vis	None
sadaxaad	treilea	None
roomaanka	romanii	None
roon	bun	None
rumeysan	crede	None
rumeysey	crede	None
run	adevărat	None
runta	adevarul	Nan
runtii	intr-adevar	Nan
runtiisa	adevăr	None
ruqiya	îndărătnic	Nan
ruqiyo	iluzii	Nan
rususha	presăra	Nan
rusushii	călărețul	Nan
ruug	dure	None
ruush	rusă	None
ruushka	rusă	None
ruux	spirit	None
ruuxii	spiritul	None
rumeyn	crede	None
rumeeyo	crede	None
rumeeyay	crezut	None
rumeeyana	crede-mă	Nan
roone	roon	Nan
rooraaye	roaming	Nan
rootiga	pâine	Nan
rotterdam	rotterdam	Nan
rpp	rpp	Nan
rugta	stup	Nan
rukuucda	brevete	Nan
roomaanku	română	None
rumawdo	rumawdo	Nan
rumaynta	credincios	Nan
rumayntooda	lor	None
rumayntu	credincios	Nan
rumaynu	credem	Nan
rumaysan	crede	None
rumaysanyahay	tine	None
rumayso	crede	None
rumaynayo	crede	None
sidookele	asemenea	None
sadaxaadna	treilea	None
saddax	trei	None
sameeyo	do	None
sameyn	do	None
sameysa	do	None
sameyso	fă-o	Nan
sameystay	făcut	None
samidiyo	video	None
samir	fii	None
samo	găsite	None
samow	salut	Nan
samroon	sambar	Nan
samsamka	sams	Nan
samyn	do	None
san	ști	Nan
sanaag	a	None
sanad	an	None
sameeyey	făcut	None
sanadadii	ani	None
sameeyeen	făcut	None
sameeyawaa	asta	None
samaawiga	cerul	None
samada	cer	None
samaron	theron	Nan
samaroon	cer	None
samaroonku	cerul	None
samatalis	samatalis	Nan
samatar	propoziție	Nan
samayn	do	None
samaynaya	face	None
samaysan	făcut	None
samaysay	făcut	None
samaysiga	formare	None
sameenta	face	None
sameeya	do	None
sameeyaan	do	None
sameeyay	făcut	None
sanadahan	ani	None
sanadihii	ani	None
sanadii	an	None
sannadkii	an	None
sannadku	an	None
sano	ani	None
sapienza	sapienza	Nan
saqiireen	la	None
saraakiil	ofiţerii	Nan
saraakiisha	oficialii	Nan
saraakiishii	ofiţerii	Nan
saraar	palatul	None
saransoor	saransoor	Nan
sardiiniya	sardonix	Nan
sare	înalt	None
sareeya	înalt	None
sareeyo	înalt	None
sarena	înalt	None
sannadkaasna	an	None
sannadkaas	an	None
sannadihii	ani	None
sannadahan	ani	None
sanadka	an	None
sanadkaa	an	None
sanadkaana	acesta	None
sanadkaas	an	None
sanadkan	acesta	None
sanadki	anual	None
sanadkii	an	None
samaale	sam	Nan
sanadkiiba	an	None
sanadku	an	None
sanado	ani	None
sanadood	ani	None
sanca	sanca	Nan
sand	nisip	None
sandkii	anul	None
sanka	nas	Nan
sanadkooda	lor	None
salma	salma	Nan
salka	baza	None
saliim	salim	Nan
safraan	voiaj	Nan
safray	călătorit	None
safraya	călător	Nan
safri	voiaj	Nan
sagaal	nouă	None
sagaalaad	al	None
sagaaliyotobnaad	al	None
sagaalkooda	lor	None
sahal	uşor	Nan
sahashay	bântuit	Nan
sahlan	uşor	Nan
sahra	sarara	Nan
saint	sfânt	None
sakada	continuare	None
sakariye	screwed	Nan
safiya	dimineaţă	Nan
safiirkii	ambasadorul	Nan
safiirka	ambasador	Nan
safarrada	excursii	Nan
saddaxda	trei	None
saddex	trei	None
saddexaad	treilea	None
saddexda	trei	None
saddexdooduba	trei	None
sadex	trei	None
sadexaad	treilea	None
sakiin	de	None
sadexda	trei	None
sadqeeyay	donat	Nan
safaarada	ambasadă	Nan
safaaradaha	ambasade	Nan
safar	excursie	Nan
safarka	calatoria	Nan
safarkii	calatoria	Nan
safarkiisii	lui	None
sadexdii	trei	None
sadaxda	trei	None
sako	mesaj	None
sal	sal	Nan
salbalaadhan	acest	None
saldanad	ani	None
saldanada	nostru	None
saldanadda	coloane	None
saldanadii	nostru	None
saldanado	ani	None
saldhig	baza	None
saldhiga	baza	None
saldhigga	baza	None
saldhigyo	baze	None
saleebaan	cond	Nan
saleemaan	le	None
salfiyo	sare	None
saliid	ulei	None
saliida	ulei	None
salaysanyahay	bazat	None
salaysan	bazat	None
salal	salal	Nan
salafusaalixa	salutari	Nan
salaad	rugăciune	Nan
salaadda	rugăciune	Nan
salaaddu	rugăciune	Nan
salaadeed	rugăciune	Nan
salaadood	rugăciuni	Nan
salaam	salut	Nan
salaama	salut	Nan
saksonku	îți	None
salaan	salut	Nan
salaanee	salut	Nan
salaanka	scară	None
salaannee	te	None
salaaxudiin	salut	Nan
salad	salată	Nan
salafiyiinta	salafistii	Nan
salafka	șofranul	Nan
salaancarrabey	salutecarrabey	Nan
siduu	în	None
sierra	sierra	Nan
sifaadkiisa	atribute	Nan
tansaaniya	tanzania	Nan
taqaan	tu	None
taqaano	tu	None
taqasusay	specializare	Nan
taqasustay	in	None
tara	nouă	None
taraawiil	remorcă	Nan
tarayn	prostii	Nan
tarbiyada	reproducere	Nan
tarbiyeesan	aplatizată	Nan
tareen	tren	None
tari	tuse	Nan
tarjamada	traduceri	None
tartamaayey	concurent	Nan
tartami	concura	Nan
tani	oms	Nan
tartanka	competiție	None
tan	acest	None
tamar	energie	None
taliyaaniga	italiană	None
taliyaanigu	italianul	Nan
taliyaanu	conducatorul	Nan
taliyaha	conducatorul	Nan
taliye	conducător	None
taliyeen	avizat	Nan
taliyihii	guvernatorul	None
taliyo	regulă	None
talo	sfat	Nan
talyaani	italiană	None
talyaaniga	italiană	None
talyaanigasyl	italiană	None
talyaanigu	italiană	None
talyaaniguna	italia	None
talyaniga	italiană	None
tamarta	energie	None
tartankii	competitia	Nan
tashaday	consultat	Nan
tashik	plecare	None
teelteel	periodic	None
tegay	plecat	None
tegey	plecat	None
tegeysaan	tu	None
tegi	aici	None
tegin	aici	None
telcom	telcom	Nan
teleefonada	telefon	None
telefoion	telephoneion	Nan
telefoon	telefon	None
telefoonada	telefoane	Nan
terre	terre	Nan
testify	mărturie	None
textalign	text	None
tfgda	tfgda	Nan
teedsan	lungul	None
teeda	ei	None
technology	tehnologie	None
tech	tech	Nan
tashteen	tashing	Nan
tasi	tasi	Nan
tawraad	neatenție	Nan
tawreet	mulțumesc	Nan
taxaabaan	sunt	None
taxane	serie	None
taxnaa	serie	None
taliyaani	comandantul	None
tay	tay	Nan
taymiya	îmblânzi	Nan
tayo	calitate	None
ta´shilin	călătorii	None
tchad	tchad	Nan
tdma	tdma	Nan
tebin	traduceți	Nan
tebiyey	raportat	None
tayada	calitate	None
taliskii	regula	None
taliska	comanda	None
talisa	lui	None
taasaa	e	None
taasi	acea	None
taasina	acea	None
taasna	asta	None
taasoo	care	None
taaxane	bogat	None
taba	tutun	Nan
tababarada	instruire	Nan
tababaran	dresat	Nan
tababare	antrenor	Nan
tababarka	instruire	Nan
tabo	loc	None
tacliin	educaţie	Nan
tacliinta	universitare	None
tada	ridica	None
taas	acea	None
taarikhda	istorie	None
taarikh	istorie	None
taariiqyahano	istorici	None
taan	acest	None
taangiyada	rezervoare	Nan
taar	data	None
taariikh	istorie	None
taariikhda	istorie	None
taariikhdadhaqanka	istoria	None
taariikhdii	istorie	None
tafiirmaan	aici	None
taariikhdu	istorie	None
taariikhi	istoric	None
taariikhiga	istoric	None
taariikho	datele	None
taariikhood	datele	None
taariikhyahan	istoric	None
taariikhyahanada	istorici	None
taariiqyahanka	istorie	None
taariikheed	istoric	None
th	lea	Nan
tafsiirka	interpretare	None
tagaa	merge	None
talaabadan	pas	None
talaabo	etapa	None
talaadada	marti	Nan
talaado	marţi	Nan
talada	sfat	Nan
taladana	sfat	Nan
taladii	sfat	Nan
taladu	sfat	Nan
talagalay	pentru	None
talayaaniga	italiană	None
taleefoonada	telefoane	Nan
taleex	telefon	None
tali	oms	Nan
talin	sfat	Nan
talis	comanda	None
talaabada	etapa	None
tala	sfat	Nan
tajwiidka	tora	None
tahliil	dialect	None
tagaan	merge	None
tagay	plecat	None
tagaya	departe	None
tage	merge	None
tageen	plecat	None
tagey	plecat	None
tagin	merge	None
taga	fereastră	Nan
tagisteeduna	ei	None
tagsiile	taxi	None
tagtada	etichetă	Nan
tagteen	plecat	None
tagto	merge	None
tahay	tu	None
tahaye	deprimant	Nan
tahayna	tu	None
tago	merge	None
taamyeeloo	potrivi	Nan
that	acea	None
their	lor	None
tolayoo	curcan	Nan
tolkayoo	paine prajita	Nan
tooda	paine prajita	Nan
toogasho	filmare	Nan
toona	da	None
tooreyda	betisoarele	Nan
toori	fiu	None
toos	direct	None
toosa	trezește-te	Nan
toosan	drept	None
toosanaha	direct	None
toose	simplu	None
toosoo	trezește-te	Nan
top	top	None
toqoshi	arunca	Nan
tol	tol	Nan
towfiiq	towfiiq	Nan
togwajaale	apropo	Nan
togga	raul	Nan
tobankii	zece	None
tobnaad	al	None
toc	cot	Nan
todabaadka	săptămână	None
today	azi	None
toddoba	șapte	None
toddobo	șapte	None
todoba	șapte	None
todobaad	săptămână	None
todobaadka	saptamana	Nan
todobada	șapte	None
todobo	șapte	None
togagga	fluxurile	Nan
togdheer	togdheer	Nan
togdheersanaag	fii	None
togo	merge	None
town	oraș	None
towxiidka	meditaţie	Nan
training	instruire	Nan
turjumaha	traducatorul	Nan
turjume	traducător	Nan
turjumey	tradus	None
turkey	curcan	Nan
turki	curcan	Nan
turkida	curcan	Nan
turkiga	curcan	Nan
turkigamaadaama	că	None
turkigawaxa	curcan	Nan
turkigu	curcan	Nan
turkish	turc	Nan
turkiya	curcan	Nan
turkki	turkki	Nan
turkumaanka	turku	Nan
tusaale	exemplu	None
tunisya	tunesya	Nan
tunisiya	reaminti	Nan
tunisia	tunisia	None
tunis	ton	Nan
transmission	transmitere	None
transnistria	transnistria	None
tu	tu	None
tubane	tubane	Nan
tubayoo	conversie	Nan
tubeec	tubeec	Nan
tukado	ruga	Nan
tobanka	zece	None
tukan	rugăciune	Nan
tukanayo	rugăciune	Nan
tukelalmimurcood	tukelalmimurcood	Nan
tukuhu	îngrăşământ	Nan
tuldo	tuldo	Nan
tuluddiiye	tutore	Nan
tumay	tumoare	Nan
tuni	reamintește	Nan
tukanaya	rugăciune	Nan
toban	zece	None
to	la	None
tixraacyada	referințe	None
tiirsada	ea	None
tiirsan	dependent	Nan
tiirsanaa	dependent	Nan
tiirsantahay	dependent	Nan
tiirsanyahay	tine	None
tijaaradii	experimentul	Nan
tijaareeyo	geme	Nan
tijaaro	tremura	Nan
tikrit	bilet	Nan
tilaami	tilami	Nan
tilmaamaa	identifică	None
tilmaamaan	arăta	None
tilmaaman	indicat	None
tilmaamay	evidențiat	None
tilmaamayo	subliniind	Nan
tiirka	stâlp	Nan
tiirarkaasina	acești	None
tiirarka	piloni	Nan
tiirar	coloane	None
there	acolo	None
these	aceste	None
they	ei	None
this	acest	None
through	prin	None
throughout	lungul	None
ti	de	None
tilmaameen	evidențiat	None
tidhaah	spune	None
tignolajiyada	tehnologie	None
tigreega	biletul	Nan
tihiin	tu	None
tii	ceai	None
tiil	ţiglă	Nan
tiille	tiille	Nan
tiir	coloană	None
tidhi	spus	None
the		None
tilmaami	arăta	None
tilmaanayba	arăta	None
tiriyey	numărat	None
tiriyo	numara	Nan
tiro	număr	None
tirokoob	statistici	None
tirsan	membru	None
tirsana	numara-i	Nan
tirsanaa	fost	None
tirsanaan	numara	Nan
tix	cf.	Nan
tixda	listă	None
tixdan	considerare	None
tixdii	considera	None
tixdiisa	lui	None
tixihiisa	lui	None
tixraac	referinţă	Nan
tiriyay	numărat	None
tirin	numara	Nan
tiri	numara	Nan
tiran	ţiglă	Nan
timaadada	haide	Nan
timaaddo	veni	None
timacade	merge	None
time	timp	None
times	ori	None
timi	haide	Nan
timid	sosit	None
tilmaamo	instrucțiuni	None
timide	haide	Nan
timo	păr	None
timocade	timocade	Nan
tinta	păr	None
tira	încordat	Nan
tirad	număr	None
tirada	număr	None
tirakoob	statistici	None
timirta	palmier	Nan
riday	jos	None
taamaayee	mulțumesc	Nan
taalla	disponibil	None
socotada	călător	Nan
socotay	continuat	None
socoto	de	None
soddon	treizeci	None
software	software-ul	Nan
softwareku	software-ul	Nan
sogüt	sogut	Nan
soka	străpunge	Nan
sokeeyay	păzit	Nan
sokeeye	civil	None
sokow	asta	None
soltelco	soltelco	Nan
somaaliland	somaliland	Nan
somaaliya	somalia	Nan
somaaliyeed	somalez	Nan
socota	a	None
somailand	somaliland	Nan
socono	mergem	Nan
socon	jos	None
socda	a	None
socdaa	de	None
socdaal	călător	Nan
socdaale	călător	Nan
socdaalka	imigrare	Nan
socdaan	jos	None
socdaanba	de	None
socday	merge	None
socdaydhaqaalaha	socio-economic	Nan
socdeen	umblat	Nan
socdey	continuat	None
socdeyna	jos	None
socdo	de	None
soco	continua	None
socodka	jos	None
soconno	jos	None
somali	somali	Nan
somalia	somalia	Nan
somalialand	în	None
soogelitaankii	sosirea	None
soojeedinta	prezentare	None
sool	sool	Nan
soomaaiya	rapid	None
soomaal	somalez	Nan
soomaali	engleză	None
soomaalia	în	None
soomaalida	somalezul	Nan
soomaalidii		None
soomaalidu	somali	Nan
soomaaliga	engleza	None
soomaaligalbeed	viitor	None
soomaaliland	în	None
soomaaliya	somalia	Nan
soomaaliyakiinya	ești	None
soogalistii	soogalistii	Nan
soodhaafanay	suntem	None
soo	veni	None
sonkorta	zahăr	None
somalida	somali	Nan
somalidu	somali	Nan
somaliga	engleza	None
somalilada	în	None
somalilanad	engleza	None
somaliland	în	None
somalilandintaas	este	None
so	dragoste	None
somalilandna	în	None
somaliwayn	somali	Nan
somaliya	somalia	Nan
somaliyeed	somali	Nan
somaray	butonul redare	Nan
some	niste	Nan
somlialnd	somlialnd	Nan
somtel	somtel	Nan
somalinimada	somalihood	Nan
snmta	snmta	Nan
snmlooma	snmlooma	Nan
snm	snm	Nan
siiyaymagaca	numele	None
siiyeen	dat	None
siiyey	dat	None
siiyo	da	None
silanyo	siloon	Nan
silic	suferinţă	Nan
sim	sim	Nan
siman	egal	None
simantahay	egal	None
simanyihiin	egal	None
simbaabwi	incetineste	Nan
simo	echivala	Nan
sinaan	egalitate	None
sinaanta	egalitate	None
sinigaal	sediment	Nan
siiyaycalan	da	None
siiyay	dat	None
siiya	rasă	Nan
siisay	dat	None
sifeynta	dializă	Nan
sifiican	bine	None
sifoobay	rafinat	Nan
signal	semnal	Nan
signals	semnalele	Nan
sii	da	None
siiba	ales	None
sir	domn	None
siid	eliberare	None
siidaynta	eliberarea	None
siilaanyo	sion	Nan
siin	da	None
siinayo	oferindu-	Nan
siinjiray	dat	None
siirada	ings	Nan
siisa	arunca	Nan
siidaayey	aruncată	Nan
soomaaliyana	în	None
sirasmi	sirsmi	Nan
sirdoonyaasha	inteligența	Nan
siyaasi	politician	Nan
siyaasiga	politică	None
siyaasiinta	politicieni	None
siyaasiyiin	politicieni	None
siyaasiyiinta	politicieni	None
siyaasiyiintan	politicieni	None
siyaasiyiinytii	politicienii	Nan
siyad	siad	Nan
siyasadeed	politic	None
skandinafia	scandinafia	Nan
slitaz	slitaz	Nan
smaller	mici	None
smart	inteligent	None
sms	mesaj	None
snaciidamada	șerpii	Nan
siyaasadii	politici	None
siyaasadeed	politic	None
siyaasaddeed	politic	None
siyaasadda	politică	None
siri	dificil	None
sirta	secrete	None
sisiiliya	cili	Nan
sisinta	susan	Nan
sitay	sta	None
siticmaalaa	foloseste-l	Nan
sitoosa	săptămânal	Nan
sirdoonka	inteligență	Nan
siwaaqroon	fel	None
sixadeeda	anii	None
siyaa	ing	Nan
siyaad	siad	Nan
siyaadna	mult	None
siyaaraadka	politică	None
siyaasad	politică	None
siyaasada	politică	None
siweyn	mari	None
taalo	permanent	None
soomaaliyeed	engleza	None
soomaaliyeey	am	None
suuq	piaţă	Nan
suuqa	piața	None
suuqyada	piețe	None
suurada	sură	Nan
suuradda	asemănare	Nan
suurado	posibil	None
suuratu	sură	Nan
suuratul	posibil	None
suuratulfiil	suuratrol	Nan
suuriya	sirian	Nan
suurogal	posibil	None
suurto	posibil	None
suways	suways	Nan
suwees	suwees	Nan
swasiland	elveţia	Nan
suugaanyahankii	literatură	None
sweden	suedia	None
suugaanyahan	literatură	None
suugaantiisa	sa	None
supports	suporturi	Nan
suqa	mente	Nan
surinam	meu	None
sus	sus	None
suu	su	Nan
suuban	sunet	None
suubanaa	corect	None
suubban	la	None
suubiye	permisibil	Nan
suudaan	sură	Nan
suudaanitoobiya	superstar	Nan
suufi	sufi	Nan
suugaan	literatură	None
suugaanta	literatură	None
suugaantii	literatură	None
suugaantu	literatură	None
switching	comutare	Nan
switzerland	elveţia	Nan
swt	swt	Nan
taageerayaasha	suporteri	Nan
taageero	a	None
taageersan	sprijinit	None
taageersanaa	sprijinit	None
taagi	firmă	None
taagnaa	permanent	None
taajir	bogat	None
taajirsan	bogat	None
taaka	ajutor	None
taako	arunca	Nan
taal	disponibil	None
taala	disponibil	None
taalaa	tu	None
taalada	statuie	None
taale	azi	None
taageerayaal	suporteri	Nan
taageerada	a	None
taageera	a	None
taagay	ridicat	None
sxb	sxb	Nan
syc	syc	Nan
syl	syl	Nan
syria	siria	None
system	sistem	None
systems	sisteme	None
sénégal	material	None
superka	superka	Nan
t	t	None
taa	azi	None
taaban	atingere	Nan
taaboo	atingere	Nan
taad	taad	Nan
taagan	permanent	None
taagantahay	permanent	None
taaganyahay	permanent	None
ta	ei	None
super	super	None
suntan	otravă	Nan
sunta	otrăvit	Nan
soonku	rapid	None
soosocota	venind	None
sooyaalka	istorie	None
sos	șosete	Nan
soviet	sovietic	None
sri	sri	None
ssdf	ssdf	Nan
st	sf	None
stadium	stadiu	None
standard	standard	None
standards	standarde	None
state	stat	None
states	statele	None
station	statie	Nan
stockholm	stockholm	None
soonkood	post	None
soonka	post	None
soona	rapid	None
soon	curând	None
soomali	engleză	None
soomalida	post	None
soomalidu	rapid	None
soomaliga		None
soomalimaad	haide	Nan
soomaliya	somalia	Nan
soomaliyadii		None
strom	strom	Nan
soomaliyeed	somali	Nan
soomanaado	rapid	None
soomanahay	rapid	None
soomane	rapid	None
soomaray	rapid	None
soomidda	post	None
soomman	rapid	None
soommani	rapid	None
sooman	rapid	None
soomaaliyeeed	somali	Nan
stronger	întărit	None
su	lor	None
sugnaakii	aștepta	None
sugulle	chelner	Nan
suhra	suhra	Nan
suldaan	sultan	Nan
suldaanka	fiul	None
suldaankii	sultanul	None
suliman	suliman	Nan
sultan	sultan	Nan
sumada	simbol	None
sumerianku	sumerianku	Nan
sun	soare	None
suna	nume	None
sunday	duminică	Nan
sunnada	sunnah	Nan
sunni	sunni	Nan
sugnaaday	este	None
sugnaa	așteptata	Nan
sugeysey	aștepta	None
sugaysa	aşteptare	Nan
suaal	întrebare	Nan
suaalo	întrebări	None
subac	subac	Nan
subag	unt	Nan
subax	dimineaţă	Nan
subayr	gras	Nan
subscriber	abonat	Nan
style=fontsize	style = fonturi	Nan
subsystem	subsistemul	Nan
such	de	None
sucuudiga	arabia	None
sudan	sudan	Nan
sudhan	atârna	Nan
sugaal	aștepta	None
sugan	sigur	None
sugay	aștepta	None
subxaanahu	subjunctivul	Nan
يسوع	يسوع	Nan
joogaba	vizibil	None
joogaan	stau	None
cilmi	științific	None
cilmiga	științele	None
cilmina	mele	None
cilmiyada	științele	None
cilmiyeedka	științific	None
cilmu	cilmu	Nan
cimilada	vremea	None
cimiladeeda	sa	None
cimillada	generațiile	Nan
cimilo	vreme	None
cimraan	veacurile	Nan
cinwaanka	abordare	None
ciqaab	pedeapsă	None
cir	cir	Nan
ciraaq	irak	None
cilmaaniya	informa	Nan
ciraaqka	irak	None
ciisuhu	inhala	Nan
ciisaha	iisus	None
ciidamadee	tale	None
ciidamadii	trupele	None
ciidamadiisa	lui	None
ciidamadu	trupele	None
ciidamdii	trupele	None
ciidamo	trupele	None
ciidan	armată	None
ciidangale	armată	None
ciidanka	armată	None
ciidankii	armata	None
ciidankiisii	lui	None
ciidanku	armata	None
ciidda	sol	None
ciil	supărare	Nan
ciimadii	sfânt	None
ciise	iisus	None
cirid	gumă	Nan
cirifka	cerul	None
ciriiri	îngust	Nan
ckariin	celălalt	None
claahi	claahi	Nan
clahi	clahi	Nan
clinton	clinton	Nan
cllahi	dumnezeu	None
clle	clle	Nan
cllhi	cllhi	Nan
cod	voce	None
codec	codec	Nan
codecs	codec-uri	Nan
codka	voce	None
codsaday	solicitat	Nan
codsanayaan	solicitând	Nan
codsi	cerere	None
codsiga	cerere	None
ckariim	amortiza	Nan
ciyaarta	joc	None
ciyaaro	jocuri	None
ciyaarihii	jocurile	None
ciriiriga	congestionare	Nan
cirka	cerul	None
cirro	palid	Nan
cishaba	bună	None
cismaan	trăi	None
cismaaniya	lăudabil	Nan
cismaaniyiinta	penticostalii	Nan
ciidamada	trupele	None
cismaaniyiintu	creştinii	Nan
cities	orase	Nan
civil	civil	None
ciyaalka	copii	None
ciyaar	joc	None
ciyaaraa	joacă	None
ciyaaraha	jocuri	None
ciyaaray	jucat	None
cismaniyada	secularismul	Nan
codsigaas	cerere	None
ciida	eid	Nan
cigalxasan	continuat	None
ceelal	bine	None
ceelasha	puțuri	Nan
ceelbuur	o	None
ceelcad	bine	None
ceeldheer	fântână	Nan
ceelgaal	bine	None
ceelhuur	o	None
ceelka	fântână	Nan
ceelkii	fântână	Nan
ceelku	fântână	Nan
ceerigaabo	ceata	Nan
ceerigabo	este	None
ceeryaamo	aburi	Nan
celi	repeta	Nan
celin	repetiţie	Nan
ceelaayo	nerușinat	Nan
celisa	reținut	None
ceel	bine	None
ccc	ccc	Nan
casuumay	invitat	None
casuura	a	None
cawaale	o	None
cawil	gri	Nan
cawo	mesteca	Nan
caws	iarbă	Nan
cay	insultă	Nan
cayaar	joaca	Nan
cayaaraha	sport	None
caydiid	insultă	Nan
cayiman	specificate	Nan
cayimey	specificate	Nan
cayn	drăguț	Nan
caynaba	fel	None
caynabo	chicotește	Nan
ceeb	rușine	Nan
celiya	înapoi	None
celiyay	retinut	Nan
celiyo	repeta	Nan
cida	oms	Nan
cidamada	în	None
cidda	oms	Nan
ciddii	oms	Nan
cidhifyada	margini	Nan
cidi	cidi	Nan
cidii	oms	Nan
cidina	nimeni	None
cidla	pustii	Nan
cidlo	singuratic	Nan
cidluu	singuratic	Nan
cidna	nimeni	None
ciel	ciel	Nan
cigaal	ţigară	Nan
cigaaljpg|maxamed	smaljpg | maxamed	Nan
cid	oricine	None
cibaarada	cult	None
cibaado	evlavie	Nan
cibaadada	cult	None
cell	celulă	None
cells	celulele	None
cellular	celular	Nan
celmi	înapoi	None
center	centru	None
centre	centru	None
cerulli	cerulli	Nan
ciid	nisip	None
channel	canal	None
charles	charles	None
chavez	chavez	Nan
chemistry	chimie	None
chirac	chirac	Nan
christian	creştin	Nan
christos	christos	Nan
church	biserică	None
channels	canale	None
col	col	None
colaad	ostil	Nan
colaada	conflict	None
daahir	pur	None
daain	daain	Nan
daakhiliga	intern	None
daalash	umbrelă	Nan
daalicii	oboseală	Nan
daalin	oboseală	Nan
daallo	epuizat	Nan
daalo	epuizat	Nan
daalye	epuizat	Nan
daaqad	fereastra	None
daaqadaha	ferestre	None
daaqadkasta	orice	None
daaqiliga	pășuni	Nan
daar	rândul	None
daaraha	clădiri	None
daahfurayay	producerea	None
daardaari	inacceptabil	Nan
daahay	târziu	None
daafta	apărarea	None
d	d	Nan
da	și	None
daa	sa	None
daab	imprimare	Nan
daabacaada	imprimare	Nan
daabacdo	imprimate	Nan
daabicin	publica	None
daacad	sincer	Nan
daacadda	onestitate	Nan
daaci	amărăciune	Nan
daad	potop	Nan
daadagine	vă	None
daadagno	inundate	Nan
daadhey	inundate	Nan
daafaha	peste	None
daaha	strat	None
daarood	acoperiş	Nan
daaroodafka	fereastră	Nan
daaroode	casa	None
dabadeed	după	None
dabadeede	mai	None
dabadeedna	apoi	None
dabadiisii	lui	None
dabadood	ei	None
dabaq	podea	Nan
dabaqa	podeaua	Nan
dabaqadda	clasa	None
dabarre	eradicarea	Nan
dabayaaqadii	târziu	None
dabayloobey	sufla vantul	Nan
dabcigiyo	desigur	None
dabeecad	comportament	None
dabeecada	natură	None
dabeecaddiisa	lui	None
dabada	coadă	Nan
dabaasho	înot	Nan
dabaal	sărbători	None
daba	urma	None
daaroodka	vii	None
daarta	casa	None
daas	staniu	Nan
daauud	daud	Nan
daawad	ceas	None
daawada	medicament	None
daawado	ceas	None
cyimi	cyimi	Nan
daawanayay	vizionarea	Nan
daawo	vindeca	Nan
daayay	eliberată	None
daaye	la	None
daayey	liber	None
daayin		None
daayo	eliberare	None
dab	foc	None
daaweeyey	tratate	None
cwahaab	răspuns	None
cutub	capitol	None
cuthmaaniyiintii	culte	None
countries	țări	None
country	țară	None
course	curs	None
coverage	acoperire	Nan
cqaadir	aroganţă	Nan
crashiid	crashiid	Nan
craxmaan	implora	Nan
craxman	craxman	Nan
crd	crd	Nan
crisaaq	dezordine	Nan
cs	cs	None
csw	csw	Nan
cubeyd	cubeyd	Nan
cudur	boala	None
cudurka	boala	None
could	putea	None
cost	cost	Nan
cosoble	cosoble	Nan
core	miez	Nan
colba	colba	Nan
colenel	colenel	Nan
colkayagii	nostru	None
college	colegiu	Nan
colombia	columbia	None
colow	colow	Nan
colspan=	colspan =	Nan
cufanka	masa	None
communication	comunicare	None
computers	calculatoare	None
conditions	condiţii	Nan
congo	congo	None
congress	congres	None
congresska	congres	None
conoco	conoco	Nan
coofey	coofey	Nan
computer	calculator	None
casumay	invitat	None
culays	gravitatie	Nan
culimadii	savanți	None
cunteeyo	masă	None
cunto	alimente	None
curadka	născut	None
curatay	născut	None
curious	curios	Nan
curiya	șchiop	Nan
cuseyr	nou	None
cusmaan	butonul redare	Nan
cusmaaniyiinta	adăpost	None
cusmaankii	nou	None
cusman	cusman	Nan
cusri	cusri	Nan
customer	client	None
cusub	nou	None
cusubi	nou	None
cuntada	alimente	None
cuno	mânca	Nan
cunin	a	None
cunid	a	None
culimadu	savanți	None
culimo	savanți	None
culumaaudiinka	savanți	None
culumada	savanți	None
culus	greu	None
culusoow	grea	None
culuumta	ştiinţă	Nan
culimada	savanți	None
culuunta	savanți	None
cumar	omar	Nan
cun	mânca	Nan
cunaan	mânca	Nan
cunay	a	None
cune	mânca	Nan
cuneen	a	None
cuni	mâncând	Nan
cumaan	oman	Nan
casriyeesanwaxeena	modernă	None
casriyeesan	zi	None
casriyadii	modernul	Nan
caasimada	capital	None
caasimadaha	capitale	None
caasimadda	capital	None
caasimadiisa	lui	None
caato	subţire	Nan
caawa	seară	None
caawin	ajutor	None
caawinaayaan	asistă	Nan
caawisayba	ajutat	None
caawiyey	ajutat	None
caawiyo	ajutor	None
cabaar	moment	None
cabaas	cabaret	Nan
cabbaas	cabluri	Nan
cabbay	băută	Nan
caasimad	capital	None
cabbeen	băută	Nan
caashaqa	dragoste	None
caasha	dragoste	None
caalin	sfat	Nan
caalmaka	umane	None
caalmka	lume	None
caamul	camă	Nan
caan	celebru	None
caana	lapte	None
caanaha	lapte	None
caanbaxday	faimos	None
caanka	celebru	None
caano	lapte	None
caansan	popular	None
caansana	celebru	None
caansanaa	celebru	None
caaqil	înţelept	Nan
caas	capital	None
caashaq	dragoste	None
cabdalla	cabdalla	Nan
cabdalle	cabdalle	Nan
cabdi	băutură	Nan
cabdullaahi	abdullah	Nan
cabdullahi	abdullah	Nan
cabdulle	abdulle	Nan
cabdulmalik	cabalmalik	Nan
cabdulmuncim	cabdulmuncim	Nan
cabdulqaadir	nanism	Nan
cabdulraxmaan	prietenii	None
cabduqaadir	congestionare	Nan
cabduraxmaan	psalmodiere	Nan
cabid	băutură	Nan
cabir	scară	None
cabirka	mărimea	None
cabitaanka	băut	Nan
cable	cablu	None
cabsada	frică	Nan
cabdule	cabdule	Nan
cabdulahi	hoț	Nan
cabdulaahi	cafenea	Nan
cabdmudhalib	alianţă	Nan
cabdicasiis	infricosator	Nan
cabdilaahi	abdulahi	Nan
cabdillaahi	abdullah	Nan
cabdillahi	abdulahi	Nan
cabdille	cabdille	Nan
cabdimanaaf	camere	None
cabdimudhalib	cabdimudhalib	Nan
caalimudiin	savant	Nan
cabdinaasir	dependenta	Nan
cabdirashid	cabrarashid	Nan
cabdirashiid	măsura	None
cabdiraxmaan	explica	None
cabdiraxman	cabdirahman	Nan
cabdirisaaq	măsura	None
cabdisalaan	este	None
cabdixaaji	ea	None
cabdiqaasim	cabhyqaasim	Nan
caalimkii	savantul	Nan
caalim	savant	Nan
caalamku	universul	None
but	dar	None
butaan	laudă	Nan
buu	el	None
buuciya	hrănitor	Nan
buug	carte	None
buuga	cartea	None
buugaagta	cărți	None
buugga	cartea	None
buuhoodle	sirenă	Nan
buulo	cuib	Nan
buuloburde	buldozer	Nan
buuloburte	cățeluș	Nan
buundo	pod	None
buuq	zgomotos	Nan
buur	munte	None
busra	făină	Nan
buskoon	pe	None
businessman	afaceri	None
bushaaranaynaa	binecuvântăm	Nan
burburiyay	distrus	None
burburiyeen	distrus	None
burburiyey	distrus	None
burburka	distrugere	None
burburkii	căderea	None
burburku	distrugere	None
burburtay	prăbușit	None
buuraha	munţi	Nan
burco	burco	Nan
burma	birmanez	Nan
buro	tumoare	Nan
bursadeen	hunted	Nan
burtinle	burtinle	Nan
burton	burton	Nan
burundi	burundi	Nan
bush	tufiș	Nan
burkina	burgerii mei	Nan
cabsi	frică	Nan
buurdhuubo	gume	Nan
buuro	munţi	Nan
caadalad	gresit	Nan
caadi	normal	None
caadiga	normal	None
caado	obicei	None
caafimaad	sănătate	None
caafimaadka	sănătate	None
caag	plastic	None
caaggan	acest	None
caaid	ajutor	None
caajis	plictisitor	Nan
caalami	internațional	None
caalamiga	internațional	None
caalamiya	internațional	None
caalamka	universul	None
caalamkka	internațional	None
caad	personalizat	Nan
caabudwaaq	cult	None
caabudo	cult	None
caabudistiisa	lui	None
buurta	muntele	None
buurweyn	obezitate	Nan
buuxa	deplin	None
buuxaan	deplin	None
buuxda	deplin	None
buuxin	a	None
buuxinaya	umplere	Nan
buuriga	tutun	Nan
buuxsadaye	plin	None
c	c	None
caabbi	rezistenţă	Nan
caabinta	rezistenţă	Nan
caabuda	cult	None
caabudaa	cult	None
caabudaan	cult	None
caabudi	cult	None
by	de	None
dabiici	natură	None
cabsida	frică	Nan
cad	clar	None
caraba	arabii	None
carabi	araba	None
carabiga	araba	None
carabigu	araba	None
carabiya	arabia	None
carabka	limbă	None
carabkana	arabă	None
carabta	arabii	None
carabtii	la	None
carabtu	arabic	Nan
carabعبد	arabă	None
carabعبدالله	carabă عبدالله	Nan
carafaat	carafaat	Nan
cararay	fugit	None
carareen	fugit	None
carab	araba	None
carartay	fugit	None
caraaye	frustrat	Nan
car	mașină	None
cambaha	maniere	Nan
camiran	camiran	Nan
campaign	campanie	None
camuud	nisip	None
can	acolo	None
canbaha	vie	None
canfar	gripa	None
canfartu	rece	None
cape	pelerină	Nan
captain	căpitan	None
caqabadna	o	None
caqiidada	doctrină	None
caqli	înţelept	Nan
caqliga	intelect	Nan
caqligu	logică	None
caraale	caramel	Nan
carbeed	araba	None
carbta	limbă	None
card	card	Nan
cas	roșu	None
case	caz	None
casharadan	această	None
casharka	lecția	Nan
casharkii	lecția	Nan
casho	pentru	None
cashocado	pentru	None
casi	roșu	None
casiis	roșu	None
casimada	seara	None
casir	actualizați	Nan
casmara	roșu	None
casri	modern	None
casriga	modern	None
casrigan	moderne	None
caruurtooda	lor	None
caruurtiisa	lui	None
caruurtii	copiii	None
caruurta	copii	None
carif	crap	Nan
cariif	ușoară	None
caroone	caroton	Nan
carqaladaynkaro	perturbat	Nan
carrabey	mut	Nan
carro	sol	None
carruur	copii	None
camar	camar	Nan
carruureede	copii	None
carruurtiisa	lui	None
carruurtiisu	lui	None
cars	autoturisme	Nan
carta	cârța	Nan
cartan	cart	Nan
carte	cart	Nan
caruur	copii	None
carruurta	copii	None
camaloow	jucător	None
camalladiisa	sale	None
camallada	fapte	None
caddaalad	justiţie	Nan
caddaatay	clar	None
caddayn	evidență	None
caddaynaya	asta	None
caddaynta	dovadă	None
cadde	dovedi	None
caddeeyay	demonstrat	None
caddoow	clar	None
cade	clar	None
cadeeyay	demonstrat	None
cadexamar	clar	None
cadi	alb	None
cadmeed	cadet	Nan
cadnaa	evident	None
cadnaan	cadenţă	Nan
cadceedu	soarele	None
cadceed	soarele	None
cadcad	clar	None
cadaymaa	evidență	None
cadaa	alb	None
cadaada	comprimare	Nan
cadaadis	asuprire	Nan
cadaado	clar	None
cadaalada	justiţie	Nan
cadaaladda	justiţie	Nan
cadaalda	justiţie	Nan
cadoo	mitocan	Nan
cadaan	alb	None
cadaatay	demonstrat	None
cadaawe	ostil	Nan
cadal	parfum	Nan
cadale	adair	Nan
cadami	cadmiu	Nan
cadan	alb	None
cadawga	dusmanul	Nan
cadaanka	albe	None
cabudhiyaan	intimida	Nan
cadoow	un	None
cadowgiin	tău	None
calan	steag	None
calanka	steagul	None
calankaba	steag	None
calanku	steagul	None
calanle	steag	None
calasoow	verifică	Nan
calasow	steag	None
calayhi	dimineaţă	Nan
cali	cali	Nan
caliaxmed	caliaxmed	Nan
called	denumit	None
calool	stomac	Nan
caluula	dur	None
camaamad	legătură	None
camal	faptă	Nan
calaamooyinkaas	semne	None
calaamooyin	semne	None
calaamka	semnul	None
calaamdaha	simptome	None
cadrad	parfum	Nan
cafaan	pardon	Nan
cafariga	iertare	Nan
cafarigaluqada	iertare	Nan
cafimaad	sănătate	None
caga	desculț	Nan
cagaaran	verde	None
cadow	dusman	Nan
cagaarka	verdeaţă	Nan
cagta	picior	None
cairo	furie	Nan
cajalad	bandă	Nan
cajiib	minunat	Nan
calaa	indignare	Nan
calaamad	semn	None
calaamd	semn	None
cago	picior	None
burburintii	distrugerea	None
dabiiciga	natură	None
dable	dable	Nan
dhacan	eveniment	None
dhacana	întâmplă	None
dhacay	întâmplat	None
dhacaye	întâmplă	None
dhacayey	întâmpla	None
dhacayeye	incident	None
dhacda	apar	None
dhacdaa	întâmplă	None
dhacday	întâmplat	None
dhacdo	eveniment	None
dhacdooyin	evenimente	None
dhacdooyinka	evenimente	None
dhaceen	căzut	None
dhaco	întâmplă	None
dhadigana	femeia	None
dhacaan	întâmpla	None
dhadigna	femeie	None
dhacaa	întâmplă	None
dhac	jaf	Nan
dhaanto	dans	None
dhaar	jurământ	Nan
dhaarannaye	jur	None
dhaarsho	jurământ	Nan
dhaarta	jurământ	Nan
dhaawac	rănire	Nan
dhaawacmay	rănit	None
dhaaxaan	trece	None
dhab	autentic	None
dhabar	înapoi	None
dhabarka	spate	None
dhabbada	drumul	None
dhabeeyaan	a	None
dhabnimadeeda	sa	None
dhabta	real	None
dhaca	întâmplă	None
dhafaruur	măcel	Nan
dhagan	strâmt	Nan
dhaganyahay	strâmt	Nan
dhalashadiisii	lui	None
dhalashadiisu	de	None
dhalasho	naștere	None
dhalashooyin	de	None
dhalatay	născut	None
dhalay	pe	None
dhalaye	topi	Nan
dhaleen	nepoți	Nan
dhaliil	critica	None
dhaliilaha	criticul	None
dhalin	randament	Nan
dhalinaya	trăgaci	Nan
dhalinyar	tineret	None
dhalinyara	tineret	None
dhalinyarada	tineret	None
dhalashadii	de	None
dhalashada	naștere	None
dhalanteede	naștere	None
dhalan	născut	None
dhagar	înşela	Nan
dhagaweyne	revărsare	Nan
dhagax	piatră	Nan
dhagaxa	piatra	None
dhagaxaasi	piatra	None
dhagaxawoqooyiga	nordică	None
dhagaxbuur	fisuri	Nan
dhaameen	terminat	None
dhagaxii	piatra	None
dhaha	spune	None
dhahaa	spune	None
dhahar	spune	None
dhaheen	zis	None
dhaho	spune	None
dhakhso	rapid	None
dhal	randament	Nan
dhagaysto	asculta	Nan
dhalinyaradii	tineretul	Nan
dhaalib	slab	None
dhaafsado	a	None
degmadan	acest	None
degmadda	district	Nan
degmadu	districtul	None
degmo	district	Nan
degmooyinka	districte	None
degno	stabili	None
dego	stabili	None
degoo	haide	Nan
degree	grad	None
degtaa	stabili	None
degtaan	stabili	None
degtay	coborât	Nan
degto	stabili	None
dejintii	setarea	Nan
dejiyay	cazați	Nan
degmadaan	acest	None
dejiyey	stabilit	None
degmada	district	Nan
degganaa	locuit	None
deganaa	locuit	None
deganaana	calmeaza-te	Nan
degay	a	None
degayare	bărbos	Nan
degaye	rezident	Nan
degdeg	urgenţă	Nan
degeen	stabilit	None
degen	stabili	None
degenaa	fost	None
degenaan	calmeaza-te	Nan
degenaansho	fi	None
degeneen	acomodat	Nan
degenyihiin	locui	Nan
degey	stabilit	None
deggan	grajd	Nan
degi	te	None
dekad	port	None
dekada	port	None
dekadda	port	None
development	dezvoltare	None
devices	dispozitive	None
deyey	ted	Nan
deyiba	jenat	Nan
dfkmg	dfkmg	Nan
dhaabad	toamna	None
dhaabadeeyaan	fă-o	Nan
dhaadashada	mareea	Nan
dhaadheer	înalt	None
dhaaf	trece	None
dhaafay	trecut	None
dhaafayn	trece	None
dhaafaysaa	trece	None
dhaafi	trece	None
dhaafo	trece	None
destaing	destaing	Nan
designed	proiectat	None
derivative	derivat	None
derisna	vecin	Nan
dekadiiba	port	None
dekeda	port	None
dekedda	port	None
dekeeya	calmeaza-te	Nan
delhi	face	None
dembi	păcat	Nan
dembiga	păcat	Nan
dhaaftay	ocolite	Nan
democratic	democratic	None
denmark	danemarca	None
depending	funcție	None
deputato	listă	None
derejada	grad	None
derejo	rang	None
deris	vecin	Nan
deriska	vecini	None
den	bârlog	Nan
dhalinyaro	tineret	None
dhalisay	declanșat	None
dhaliyey	declanșat	None
dhaw	închide	None
dhawaadaan	timp	None
dhawaado	curând	None
dhawaan	recent	None
dhawaaqaa	declară	None
dhawaaqaan	sunet	None
dhawaaqay	declarat	None
dhawaaqday	declarat	None
dhawaaqida	pronunție	Nan
dhawaaqidda	pronunție	Nan
dhawaaqo	sunet	None
dhawaaqtada	sunete	None
dhawdahay	de	None
dhaweeyay	a	None
dhawr	păstrează-l	Nan
dhasida	dans	None
dhawre	pază	Nan
dhashtay	născut	None
dhashaywaxaanuu	născut	None
dhaqmay	acționat	None
dhaqmaysayna	actiona	Nan
dhaqmo	act	None
dhaqso	rapid	None
dhaqtar	doctor	None
dhar	îmbrăcăminte	None
dharaar	zi	None
dharaaraba	dimineața	None
dhararka	fabrica	None
dharka	îmbrăcăminte	None
dharkeenleey	noastre	None
dharkoodii	lor	None
dhasahy	recent	None
dhashaa	este	None
dhashay	născut	None
dhasheen	născut	None
dhax	ereditar	Nan
dhaxal	moştenire	Nan
dhaxalaa	moşteni	Nan
dhaxmaro	mostenit	Nan
dhay	îmbracă-te	Nan
dhaygag	căutătură	Nan
dhaymo	dressing	Nan
dhaytubaako	ostil	Nan
dhebaandhebiye	porter	Nan
dhebi	clic	Nan
dheceen	căzut	None
dheddig	femeie	None
dheddiga	femele	Nan
dheddigga	femei	None
dheecaan	descărcare	Nan
dheer	lung	None
dheeraa	lung	None
dheeraad	mult	None
dhaxmaraa	intervine	Nan
dhaxlay	mostenit	Nan
dhaxeysay	intermediar	Nan
dhaxeysaa	intre	None
dhaxalgalka	moştenire	Nan
dhaxalka	moştenire	Nan
dhaxalkeeda	ei	None
dhaxanta	rece	None
dhaxaye	rupt	Nan
dhaxaysa	între	None
dhaxaysaa	între	None
dhaqmaan	act	None
dhaxaysay	ele	None
dhaxe	intre	None
dhaxeesay	ele	None
dhaxeeya	ele	None
dhaxeeyaa	între	None
dhaxeeyeen	ele	None
dhaxeeyey	ele	None
dhaxeysa	intre	None
dhaxda	mijloc	None
dhaqma	act	None
dhaqidda	spălat	Nan
dhaqdo	spalare	Nan
dhameystay	terminat	None
dhami	toate	None
dhamiba	deloc	None
dhammaa	întregul	None
dhammaadkii	sfarsit	Nan
dhammaan	toate	None
dhammaantiis	totul	None
dhammaantood	toti	Nan
dhammanteen	noi	None
dhammeeyeen	terminat	None
dhan	toate	None
dhanaan	acru	Nan
dhanee	venit	None
dhanka	de	None
dhankaas	dimpotriva	Nan
dhameeyay	terminat	None
dhameeyaan	termină-l	Nan
dhameestirnociidanka	procesul	None
dhamaystirane	complet	None
dhallinyaradu	tineri	None
dhallinyaro	tineri	None
dhamaadaa	capete	None
dhamaadaan	sfârșit	None
dhamaaday	încheiat	None
dhamaadka	sfarsit	Nan
dhamaadkii	sfarsit	Nan
dhankooda	lor	None
dhamaado	sfârșit	None
dhamaan	toate	None
dhamaantiis	totul	None
dhamaantood	toti	Nan
dhamaatay	terminat	None
dhamaha	picioare	None
dhamaystay	efectuat	None
dhamaystiran	complet	None
dhamaag	sfârșit	None
degan	liniște	Nan
dhanna	deloc	None
dhantahay	complet	None
dhaqane	act	None
dhaqanka	tradiţie	Nan
dhaqankooda	lor	None
dhaqankoodu	lor	None
dhaqanta	practică	None
dhaqashada	spălat	Nan
dhaqatada	pastorilor	Nan
dhaqato	spalare	Nan
dhaqay	spălat	Nan
dhaqdhaaaqyadii	activități	None
dhaqdhaqaaq	circulaţie	Nan
dhaqdhaqaaqa	circulaţie	Nan
dhaqdhaqaaqii	circulaţie	Nan
dhaqdhaqaaqyadii	activități	None
dhaqdhaqaaqyo	activități	None
dhaqan	tradiţie	Nan
dhaqamo	culturi	None
dhaqameed	tradiţional	Nan
dhaqaaqyo	mișcări	None
dhanyahay	complet	None
dhaq	spalare	Nan
dhaqaalaba	economic	None
dhaqaalaha	economie	None
dhaqaalaha´	economie	None
dhaqaale	economic	None
dhaqaalha	economie	None
dhanoo	toate	None
dhaqaalihii	economia	None
dhaqaalihiisuna	lui	None
dhaqaalo	economie	None
dhaqaaloheeda	sa	None
dhaqaalohiisa	lui	None
dhaqaaq	mișcare	None
dhaqaaqay	mutat	None
dhaqaaqo	mișcare	None
dhaqaalihiisa	lui	None
degaanka	local	None
degaanada	localnici	None
degaan	şedere	Nan
dakhalka	venit	None
dal	dal	Nan
dalab	cerere	None
dalad	o	None
dalaga	a	None
dalagyada	culturi	None
dalagyo	culturi	None
dalaka	terenuri	None
dalal	țări	None
dalalka	țări	None
dalandoole	taitei	Nan
daleeyay	epuizat	Nan
daliil	evidență	None
daljirka	călărețul	Nan
dalka	tara	Nan
dakano	ultima	None
dalkaas	respectivă	None
dajiyaa	jos	None
dahsoon	anonim	Nan
daganyihiin	locuit	None
dagay	stabilit	None
dagi	stabili	None
dagmada	district	Nan
dagmo	un	None
dagmooyinka	districte	None
dago	sud	None
dagta	coboară	None
dagtaa	calmeaza-te	Nan
dagto	calmeaza-te	Nan
dahab	aur	None
dahabka	aur	None
dahay	regula	None
dahaye	ascuns	None
dahir	pur	None
dain	dain	Nan
dalkayagu	tara noastra	Nan
dalkeeda	ei	None
dalkeena	tara noastra	Nan
damal	baraj	Nan
dambana	mai	None
dambayntii	ultimul	None
dambe	mai	None
dambeba	mai	None
dambeeya	urmă	None
dambeeyay	recent	None
dambeeyey	ultimul	None
dambeeyo	ultimul	None
dambeyntiina	urma	None
dambeysay	ultimul	None
dambeysey	ultimul	None
dambidhaafe	pardon	Nan
damceen	dorință	None
dameer	măgar	Nan
damacii	dorință	None
damaca	dorință	None
damac	dorință	None
dalxiiso	turist	Nan
dalkii	pământul	None
dalkiisa	lui	None
dalkjirka	pelerinul	Nan
dalkjirkan	țară	None
dalkooda	lor	None
dalku	tara natala	Nan
dalmar	dalmar	Nan
daganayn	instabil	Nan
dalool	gaură	None
dalxiisaan	tur	None
dalxiisayaasha	turiști	None
dalxiise	turist	Nan
dalxiiseyaasha	turiști	None
dalxiisi	turism	None
dalxiiska	turism	None
dalxiiskeeda	său	None
dalxiis	turism	None
daganaayeen	locuit	None
dagan	liniște	Nan
dagalki	conflict	None
dadaalka	eforturi	None
dadaalo	eforturi	None
dadaaloosa	eforturi	None
dadaashaane	fii	None
dadab	uşă	Nan
dadaka	oameni	None
dadbadani	o	None
dadee	aștepta	None
dadeedu	jos	None
dadi	delicios	Nan
dadiisu	gustos	Nan
dadka	oameni	None
dadkaa	oameni	None
dadkaan	oameni	None
dadkaas	oameni	None
dadaali	efort	None
dadaaleen	strădanie	Nan
dadaalaayay	strădanie	Nan
dadaalaan	fii	None
daboolida	acoperi	Nan
dabqaxa	podeaua	Nan
dabuubtaan	se înfășoară	Nan
dabuubtiyo	împachetări	Nan
dacal	scara	None
dacallada	câmpia	None
dacar	vierme	Nan
dadkaasi	oameni	None
dacas	daas	Nan
dacda	cea	None
daciifa	slăbi	Nan
dacwad	litigiu	Nan
dacwada	litigiu	Nan
dad	oameni	None
dada	potrivi	Nan
dadaal	efort	None
dacay	de	None
damiin	cauţiune	Nan
dadkaba	oameni	None
dadkani	oameni	None
dagaalamayay	luptă	None
dagaalamayeen	se luptau	Nan
dagaalamey	luptat	None
dagaalka	război	None
dagaalkaas	război	None
dagaalkani	război	None
dagaalkii	razboiul	Nan
dagaalku	razboiul	Nan
dagaallada	războaiele	None
dagaallo	războaie	None
dagaalo	lupte	None
dagaalwaxaa	război	None
dagaan	aici	None
dagal	luptă	None
dagalka	război	None
dagaalamay	luptat	None
dagaaladii	războaiele	None
dagaaladaas	războaie	None
dagaalada	razboiul	Nan
dadkeeda	lui	None
dadkeedii	ei	None
dadkeedu	ei	None
dadkii	oamenii	None
dadkiina	tău	None
dadkiisa	lui	None
dadkiisii	lui	None
dadkana	oameni	None
dadkoo	oameni	None
dadkuna	oameni	None
dadlka	oamenii	None
dadow	oameni	None
dadweynaha	publicul	None
dadx	omule	Nan
daga	din	None
dagaal	război	None
dadku	oameni	None
dabka	foc	None
damiir	conştiinţă	Nan
dan	fiu	None
dawlad	guvern	None
dawlada	guvern	None
dawladaasi	guvern	None
dawladaasii	guvern	None
dawladaha	guvernele	None
dawladanwaxa	guvern	None
dawladda	guvern	None
dawladdii	guvern	None
dawladeed	guvern	None
dawladi	guvern	None
dawladihii	guvernele	None
dawladii	guvern	None
dawladnimo	guvern	None
dawlado	guvernele	None
dawladood	guvernele	None
dawgii	vulpea	None
dawladu	guvern	None
dawgalaye	regenerare	Nan
dawaldu	conduce	None
darti	cauza	None
dartiina	urmare	None
dartiis	lui	None
darto	stors	Nan
daruufo	împrejurări	Nan
daruuriga	necesitate	Nan
daruuro	nori	None
darxuma	incomod	Nan
darxumo	din	None
daryeel	îngrijire	Nan
dasnnee	dasnnee	Nan
dastuur	constituţie	Nan
dastuurka	constitutia	Nan
data	date	None
daud	daud	Nan
dawga	calul	None
dawliskii	guvern	None
dawr	dawr	Nan
dayaan	dinastie	Nan
deegaanka	mediu	None
deegaannada	coloniile	None
deegaano	mediu	None
deegta	târziu	None
deelqaaf	crawlspace	Nan
deeq	donare	Nan
deeqeen	donat	Nan
deeqsi	generos	Nan
deeqsiiyo	donează	Nan
deero	cerb	Nan
deerow	sunrow	Nan
deetana	→	None
deexda	soare	None
dega	jos	None
degaa	stabili	None
deegaanada	coloniile	None
deegaan	mediu	None
december	decembrie	None
dec	dec	None
dayactir	reparație	Nan
dayar	celălalt	None
dayax	lună	None
dayaxa	luna	None
dayay	încercat	None
daydka	curtea	None
daye	lume	None
dartey	pune-l	Nan
dayeen	ted	Nan
dayeynahay	imi pasa	Nan
dayn	creanţă	Nan
dayniile	creanţă	Nan
dayo	bine	None
dayrka	curte	None
de	veni	None
debate	dezbate	Nan
dayey	colorant	Nan
darteed	cauza	None
dartay	adăugat	None
darsoomaa	butonul redare	Nan
danishka	lustrui	Nan
danjiraha	ambasador	Nan
danjire	ambasador	Nan
danta	ei	None
dao	dao	Nan
daomeesha	daomeesha	Nan
dar	adăuga	Nan
daraa	studiu	None
daraaddeed	urmare	None
daraadeed	urmare	None
daraan	amesteca	Nan
daraawiish	darwiish	Nan
daraawiishi	caută:	Nan
daraawiishta	darwiishta	Nan
darafyada	sfarsiturile	Nan
dangorayo	pleacă	None
daneysa	interes	None
danbi	crimă	None
danbeysayisla	nu	None
danaynayn	interesat	None
danbana	meu	None
danbayna	apoi	None
danbayntii	urma	None
danbaysa	târziu	None
danbaysay	ultimul	None
danbaysta	sfarsit	Nan
darajo	rang	None
danbe	mai	None
danbeeyay	ultimul	None
danbeeyey	ultimul	None
danbeeyo	ultimul	None
danbena	nostru	None
danbeyay	spate	None
danbeyntii	la	None
danbeysay	ultimul	None
danbeesay	mai	None
damqaday	rănit	None
daran	sever	None
darane	orase	Nan
dareenka	sens	None
dareenku	sentiment	None
dariiq	departe	None
dariiqada	cale	None
dariishad	fereastră	Nan
darin	lovi	Nan
daris	vecin	Nan
dariska	vecini	None
daristay	vecin	Nan
darka	dezordine	Nan
daro	plus	None
darood	apă	None
darro	negativ	None
darsado	învăța	None
darsamaan	altul	None
dareen	sens	None
dareemi	simți	Nan
dareemeen	simțit	None
dareemaysaa	simte	None
daray	adăugat	None
darayaaye	vă	None
darayey	adăugat	None
darayga	nou	None
darbad	lovitură	None
darbadaaley	butonul redare	Nan
darbadna	mult	None
darandoorriga	aer	None
darbane	jos	None
darbiga	peretele	None
darbigeed	peretele	None
darbiyada	pereți	Nan
dardaanay	ții	Nan
dardaaran	voi	None
dardaarmay	directed	Nan
dareemay	simțit	None
darbi	stradă	None
burburinta	distructiv	Nan
burburay	prăbușit	None
burbur	distrugere	None
allow	permite	None
allowing	permițând	None
allows	permite	None
almadkhali	almskhali	Nan
almajid	discipol	Nan
almunawara	divorț	Nan
alnour	alnour	Nan
alpine	alpin	None
alqaacida	al-qaeda	Nan
alshabaab	al	None
alshabab	alshabab	Nan
also	asemenea	None
alustaad	te	None
alwaadici	cetăţean	Nan
alxalabi	algebră	Nan
allena	dumnezeu	None
alxamraa	sudare	None
allee	allee	Nan
allaylehe	noaptea	None
alislām	alislām	Nan
aljabarti	algebră	Nan
aljazeera	algebră	Nan
aljaziira	algebră	Nan
aljeeriya	algebră	Nan
all	toate	None
alla	cum	None
allaa	vreodată	None
allaaba	deloc	None
allaah	dumnezeu	None
allaahu	dumnezeu	None
allah	dumnezeu	None
allaha	dumnezeu	None
allahaa	dumnezeu	None
allahu	dumnezeu	None
alle	dumnezeu	None
am	a.m	Nan
ama	sau	None
amaan	sigur	None
aminsanyihiin	in	None
amir	amir	Nan
aml	aml	Nan
ammaan	laudă	Nan
ammaanadana	laudă	Nan
ammaanadii	laudă	Nan
ammaanadiisa	lui	None
amnesty	amnistia	Nan
amniga	securitate	None
amoud	amoud	Nan
amray	poruncit	Nan
amxaari	amharică	Nan
an	un	None
anaa	suntem	None
anaadoolee	aici	None
amiirka	printul	Nan
amiir	prinţ	Nan
amiin	raţie	Nan
american	american	None
amaandarada	securitate	None
amaani	sigur	None
amaanka	securitate	None
amaanku	securitate	None
amaanta	laudă	Nan
amaba	sau	None
amagaalooyinka	a	None
alislaax	etic	Nan
amar	ordin	None
amaradiisana	lui	None
amarkiis	lui	None
amase	sau	None
ambaradooriyadii	ambulanta	Nan
ameerika	america	None
ameerikada	american	None
america	america	None
amarada	în	None
anad	reclamă	None
align=right	dreapta	None
alifay	alfabet	None
ahmiyada	semnificaţie	Nan
ahn	ah	Nan
ahna	și	None
ahoo	ahoo	Nan
ahtiirarka	poze	None
ahwaxay	este	None
ahyad	ahya	Nan
ahyd	ahyd	Nan
aid	ajutor	None
air	aer	None
airlines	aeriene	None
airport	aeroport	None
airways	airways	Nan
ajaanibta	străini	None
ajar	întredeschis	Nan
ahmiyad	semnificaţie	Nan
ajnabi	străini	None
ahmed	ahmed	Nan
ahluxaddiiska	ecuatiile	Nan
ahay	sunt	None
ahayd	fost	None
ahayde	mine	None
ahaydkadib	târziu	None
ahayee	ea	None
ahayn	fost	None
ahba	da	None
ahcafariga	apologie	Nan
ahe	hm	Nan
aheed	ahed	Nan
aheyd	fost	None
aheyn	fi	None
ahi	este	None
ahina	da	None
ahlu	ah	Nan
ahluxaddiisku	acesteia	None
ajuuraan	încărca	Nan
ak	poveste	None
akhlaaqda	comportament	None
albaabka	usa	Nan
albaani	uşă	Nan
albaaniya	albania	None
albakr	albakr	Nan
albania	albania	None
albaqrahaayada	soneria	Nan
alcallaama	grâu	None
aldalanj	aldalanj	Nan
alfaatex	alfaatex	Nan
alfaatixoo	alfa	None
algorithm	algoritmul	Nan
algorithms	algoritmi	Nan
alhilaali	manual	None
ali	ali	Nan
alif	alif	Nan
alazhar	tărâmul	None
alalbaani	neplăcut	Nan
alaha	haha	Nan
alaabtiisii	sale	None
akhlaaqdii	moralitate	Nan
akhri	citit	None
akhrin	citit	None
akhrinducaysiilaah	citind	Nan
akhrinta	citind	Nan
akhrisan	citit	None
akhriska	citind	Nan
alifka	alfabetul	None
akhriso	citește	None
akhriyaan	citește	None
akhriyay	citit	None
akhriyo	citit	None
akr	inventar	Nan
al	al	None
ala	jos	None
alaabta	produse	None
akhristo	citește	None
anagaa	noi	None
anagoo	noi	None
anagu	noi	None
arkayninba	vedea	None
arkayo	seeing	Nan
arkaysaa	vezi	None
arkeen	văzut	None
arkey	arkey	Nan
arki	vedea	None
arko	văzut	None
arkoon	vedea	None
arlada	pământ	None
arligiina	ta	None
aroor	dimineaţă	Nan
arrimaha	probleme	None
arrimahaas	probleme	None
arrimo	probleme	None
arrin	materie	None
arkay	văzut	None
arrinkaa	asta	None
arkaan	vedea	None
arjantiina	mele	None
arif	arif	Nan
ariga	capră	Nan
arima	problema	None
arimaha	probleme	None
arimahaa	probleme	None
arimahaas	probleme	None
arimo	probleme	None
arimood	probleme	None
arin	mijlocul	None
arinkaas	asta	None
arinta	problema	None
arintaa	asta	None
arintaas	asta	None
arintaasi	e	None
arintan	problemă	None
arkaa	vede	None
arrinkaan	problemă	None
arrinkaas	asta	None
arrinkii	problema	None
asalka	origine	None
asalkooda	lor	None
asalkoodii	lor	None
asalkoodu	lor	None
asaxaabtu	prieteni	None
asc	asc	Nan
aserbiijaan	butonul redare	Nan
asharaaf	trădare	None
ashhadu	cenușa	Nan
ashyaada	lucruri	None
asiga	mine	None
askar	soldati	Nan
askari	soldat	None
askarta	soldații	None
askax	soldati	Nan
asal	origine	None
asagoo	de	None
asagana	timp	None
asaga	-l	Nan
arrinku	problema	None
arrintaa	asta	None
arrintaan	caz	None
arrintaas	asta	None
arrintan	problemă	None
arrintii	problema	None
arrintu	problema	None
ari	împrumutat	None
arwa	arwa	Nan
arxan	nepoliticos	Nan
arxanka	aroganţă	Nan
as	de	None
asaasay	fondat	None
asaaseen	stabilit	None
asaasidii	fundații	Nan
asad	asad	Nan
arwaaq	lemn	None
argagixisa	teroriști	Nan
argagaxa	panică	Nan
areas	zone	None
application	cerere	None
april	aprilie	None
aqaan	stiu	Nan
aqal	casă	None
aqalgalay	adoptat	None
aqalka	casa	None
aqbalay	admis	Nan
aqlabiyad	majoritate	None
aqlabiyada	majoritate	None
aqliyad	majoritate	None
aqoon	cunoştinţe	Nan
aqoone	cunoştinţe	Nan
aqoonsadaan	recunoaște-i	Nan
aqoonsadayafka	identificatorii	Nan
aqoonsado	recunoaște	None
any	ne	None
antiilis	antiilis	Nan
antenna	antenă	Nan
ansaxa	valabilitate	Nan
anan	aici	None
anbaqaaday	adoptat	None
anbaxaxeen	au	None
anbieter	anbieter	Nan
and	și	None
andocootay	andocootay	Nan
andorra	andorra	None
aqoonsan	recunoscut	None
anfac	util	Nan
aniga	mine	None
anigaa	mine	None
anigoo	mine	None
anigu	mine	None
anna	anna	None
annaga	ne	None
anoo	anoo	Nan
angola	duce	None
ahana	nu	None
aqoonsanayn	necunoștință	Nan
aqoonsato	recunoaște	None
aragti	teorie	None
aragtid	vezi	None
aragtida	teorie	None
aragto	vedea	None
arbaco	miercuri	Nan
ardada	elevi	None
ardaqal	bărbos	Nan
arday	student	None
ardayda	elevi	None
ardaydiisii	săi	None
ardaygii	student	None
ardoqalna	nici	None
ardul	ardul	Nan
arduqalwaxa	zgomotul	Nan
are	sunteți	Nan
aragtay	văzut	None
aragtaa	vezi	None
aragnimo	experienţă	Nan
arag	vedea	None
aqoonsi	recunoaştere	Nan
aqoonta	cunoştinţe	Nan
aqoontiisa	sale	None
aqoontoodu	lor	None
aqoonyahan	savant	Nan
aqoonyahanad	savanți	None
aqoonyahano	savanți	None
aqoonsatay	recunoscut	None
aqrinayaa	citit	None
aqrineysaa	citește	None
aqrinta	citind	Nan
aqriyey	citit	None
aqriyo	a	None
ar	ar	None
arab	arab	None
arabsiyo	fiecare	None
aqrinayo	citind	Nan
ahan	este	None
ahada	nume	None
ahaayeen	fost	None
abaarta	secetă	Nan
abaartii	seceta	Nan
ababa	urmatorul	Nan
ababuleen	abolite	Nan
abd	abd	Nan
abdalle	abdalle	Nan
abdi	abd	Nan
abdirahman	prieten	None
abdirashid	abdrashid	Nan
abdul	abdulul	Nan
abdulkarim	abdulkarim	Nan
abdullah	abdullah	Nan
abdullahi	prietenii	None
abdulle	abdulle	Nan
abdulrahman	abdulrahmanul	Nan
abaarso	scop	None
abdulsalam	abdulsalam	Nan
abaaro	şurub	Nan
abaalmariyo	recompense	Nan
aasaasy	fundație	Nan
aasan	odihnă	Nan
aasanyahay	îngropat	None
aasay	îngropat	None
aasaynaa	a	None
aasiya	asia	None
aasiyamaanta	sa	None
aasiyo	afectuos	Nan
aay	ay	Nan
aayadaha	versete	Nan
aayadda	verset	Nan
ab	ab	None
abaabul	mobiliza	Nan
abaabulay	organizat	None
abaal	recompensă	Nan
abaar	secetă	Nan
abeba	fluture	Nan
abgaal	linguriţă	Nan
abii	etc.	Nan
abu	lucru	None
abul	abul	Nan
abuu	crea	None
abuubakar	creator	None
abuubakari	creator	None
abuukar	creator	None
abuuraa	creează	None
abuurantay	creată	None
abuuray	creată	None
abuurey	creată	None
abuuro	crea	None
abuurtay	creată	None
abwaan	artist	None
abwaanada	poeți	None
abwaanka	abordare	None
abtiyaashiis	origine	None
abtirsiinyada	genealogie	Nan
abtirsadaan	genealogie	Nan
abtirsada	genealogie	Nan
abiidhaalib	alianţă	Nan
abiikar	macar	Nan
abil	abil	Nan
abkhazia	abkhazia	Nan
abokar	prieten	None
abokor	prieten	None
abooreey	şarpe	Nan
aasaastay	fondat	None
abraha	abras	Nan
abroone	abroone	Nan
absame	absame	Nan
abshir	abshir	Nan
absuge	absuge	Nan
abti	unchi	Nan
abtigiis	sau	None
abtirisiinyihiisu	nenumărat	Nan
abriil	aprilie	None
aasaaskii	fundatia	Nan
aasaaska	fundatia	Nan
aasaasihii	fondator	None
aad	tu	None
aada	merge	None
aadam	umanitate	Nan
aadamka	oameni	None
aadamuhu	omenire	Nan
aadan	tu	None
aadanaha	umane	None
aadanuhu	oameni	None
aaday	mers	None
aaden	fost	None
aadey	plecat	None
aadka	foarte	None
aadna	merge	None
aado	merge	None
aafo	criză	None
aabihiisna	lui	None
aabihiis	lui	None
aabihiina	meu	None
aabihii	tatăl	None
+	+	None
<i>	<i>	Nan
<i><i>	<i><i>	Nan
<wareega	<wareega	Nan
=	=	Nan
==	==	Nan
===xoriyadii	libertate	None
aagga	zonă	None
a	a	None
aaayadda	verset	Nan
aabaha	tatăl	None
aabahayo	nostru	None
aabbe	tată	None
aabbihii	lui	None
aabbihiis	lui	None
aabe	tată	None
aa	a	None
abwaankii	artistul	None
aaggii	zona	None
aakhiraba	continuare	None
aannu	ne	None
aanu	compasiune	Nan
aanuu	fără	None
aar	aar	Nan
aargoosi	răzbunare	Nan
aas	înmormântare	Nan
aasaar	înmormântare	Nan
aasaarta	înmormântare	Nan
aasaartan	acest	None
aasaasaha	fondatorul	None
aasaasay	fondat	None
aasaasayaasha	fondatorii	Nan
aasaasayaashii	fondatorii	Nan
aasaasi	bază	None
aasaasiga	bază	None
aannaan	facut	None
aanay	au	None
aanan	am	None
aan	nu	None
aakhirana	continuare	None
aakhiro	continuare	None
aakhiroba	continuare	None
aalacimraan	dus	None
aalo	o	None
aamdiga	mărturisire	Nan
aamin	încredere	None
aakhiraa	continuare	None
aaminaan	crede	None
aamino	crede	None
aaminsan	crede	None
aaminsanyahay	crede-mă	Nan
aaminsanyihiin	crede	None
aamisan	crede	None
aammiin	mine	None
aamus	liniște	Nan
aamini	încredere	None
aslam	aslam	Nan
abwaanku	artist	None
abwaano	lucruri	None
afraadwaana	patrulea	None
afrah	afrah	Nan
afrax	patrulea	None
africa	africa	None
african	african	None
afrika	africa	None
afrikaba	africa	None
afrikada	africa	None
afrikakadib	african	None
afroaasiya	afazie	Nan
afsomaliga	în	None
afsoomaali	limba	None
afsoomaaliga	engleza	None
afsoomaaligu	engleza	None
afsoomali	limba	None
afmadow	exemplu	None
afsoomaliga	engleza	None
afkiisuna	lui	None
afjaro	sfârșit	None
afdhere	rupt	Nan
affaransiis	african	None
afgaanistaan	afganistan	None
afgambi	lovitură	None
afgambigii	cupa	None
afganistan	afganistan	None
afgaranwaa	dezacord	Nan
afgobaadsi	răpire	Nan
afgooye	hoț	Nan
afgoye	apropo	Nan
afhayeenka	vorbitorul	Nan
afikada	limba	None
afingiriis	engleză	None
afisbaanish	spaniolă	None
afjaray	final	None
afka	gură	Nan
aftahan	eseu	None
after	după	None
aftigree	aftigree	Nan
ahaaday	este	None
ahaadee	ea	None
ahaado	fi	None
ahaan	fi	None
ahaana	e	None
ahaanba	absolut	None
ahaanjirtay	fost	None
ahaanna	e	None
ahaanshaha	fiind	None
ahaantii	fapt	None
ahaataye	tine	None
ahaatee	inca	Nan
ahaato	fi	None
ahaay	fost	None
ahaaye	naye	Nan
ahaa	fost	None
aha	nu	None
ah	ah	Nan
agtiisa	el	None
afturki	afturki	Nan
afurayo	dimineaţă	Nan
ag	ag	Nan
aga	merge	None
agaasimaha	regizorul	Nan
agaasime	director	None
agaasimihii	regizorul	Nan
afdheer	patru	None
agagaarka	jurul	None
agasimihii	regizorul	Nan
agoon	orfan	Nan
agoontii	orfanul	Nan
agoonyar	revoluţionar	Nan
agoosto	august	None
agrario	agrario	Nan
agteeda	ea	None
agagaarkeeda	ei	None
afcarabi	exemplu	None
afartii	patru	None
afartankii	patruzeci	None
adduunka	lumea	None
adduunkan	asta	None
adduunku	lumea	None
adduunyada	lumii	None
adduunyadu	lumii	None
adeeg	serviciu	None
adeega	serviciu	None
adeegayooda	lor	None
adeegsadaa	utilizări	Nan
adeegsadaan	utilizare	None
adeegsado	folosit	None
adeegsan	utilizare	None
adeegsatay	folosit	None
adeegsiga	utilizare	None
adeegtana	serviciu	None
adduun	lume	None
addoonku	servitorul	Nan
addoonkiisa	sa	None
addoonkii	servitorul	Nan
account	cont	None
ad	anunț	Nan
adaa	tu	None
adaan	aceasta	None
adag	greu	None
adal	adal	Nan
adam	uman	None
adeegyada	servicii	None
adan	băţ	Nan
addaa	tine	None
addis	addis	Nan
addoomada	sclavi	None
addoomadiisa	sale	None
addoomo	sclavi	None
addoon	un	None
addoonka	servitor	Nan
add	adăuga	Nan
abwaannada	poeți	None
adeegyadii	servicii	None
adeegyo	servicii	None
adna	adna	Nan
adoo	tine	None
adoomada	sclavi	None
adoon	fără	None
aduu	neted	Nan
aduunka	lumea	None
aduunyada	lumea	None
af	apropo	Nan
afaf	limbi	None
afafka	limbi	None
afar	patru	None
afaraad	patrulea	None
afaraadna	patrulea	None
afarta	patru	None
afartaas	patru	None
administartion	a	None
adkeynta	strângere	Nan
adkaysan	îndurat	Nan
adkaade	cuceritorul	Nan
adeer	unchi	Nan
adeerka	unchi	Nan
adeerkii	unchi	Nan
adeerkiis	sau	None
adeerkood	lor	None
adeerradii	unchii	Nan
aden	aden	Nan
adeegyadooda	lor	None
adhiga	oaie	Nan
adiga	tu	None
adigaa	tu	None
adigoo	tine	None
adigu	tu	None
adiinoo	dumneavoastră	None
adkaaaday	învins	None
adkaaday	prevalat	Nan
adi	fi	None
asluubta	disciplina	Nan
asna	asna	Nan
assaid	haide	Nan
beelihii	comunitățile	None
beelo	pierdut	None
beelood	comunitățile	None
beelweynta	comunitate	None
been	fals	Nan
beenawday	mintit	Nan
beeni	nega	Nan
beeniyana	negă-l	Nan
beeniyeen	negat	Nan
beenta	minciuni	Nan
beentana	nu	None
beer	câmp	None
beera	scroafă	Nan
beeraha	agricultură	None
beeraleey	agricultor	Nan
beelahakan	comunități	None
beerato	plantă	Nan
beelahaas	respective	None
beel	comunitate	None
baytulaxam	aptitudine	Nan
bbc	etc.	Nan
be	fi	None
bebad	barbă	Nan
bed	pat	Nan
beddelo	schimbare	None
bedelaan	schimbare	None
bedelay	schimbat	None
bedeli	schimba-l	Nan
bedelin	neschimbat	Nan
bedka	spaţiu	Nan
beebeen	pierdut	None
beedkeediiduqaydii	mele	None
beegan	coincidență	Nan
beegsaday	vizate	Nan
beelaha	comunitățile	None
beeray	plantat	Nan
beereed	cere	None
beero	scroafă	Nan
bern	bern	Nan
besha	besha	Nan
between	între	None
bey	bei	Nan
beytkiisa	lui	None
biblia	biblia	None
bidcada	erezii	Nan
bidco	bidco	Nan
bidix	stânga	None
biir	bere	None
biira	bere	None
biiray	alăturat	None
biirey	alăturat	None
biiro	creier	Nan
biirtay	alăturat	None
bermer	bermer	Nan
berigii	mai	None
berberaburao	mâine	Nan
berbera	smochine	Nan
beeroley	agricultor	Nan
beerta	in	None
beerto	semănat	Nan
beesha	comunitate	None
beeshu	barba	Nan
beeyay	m	None
being	fiind	None
bayoolojiga	biologie	None
belarus	bielorusia	Nan
belfast	belfast	Nan
belgium	belgia	None
beljim	belgian	None
belkooda	lor	None
belo	belo	Nan
benin	bancă	Nan
benito	benito	Nan
beledweyne	beledweyne	Nan
bayolojigu	biologie	None
bayoloji	biologie	None
bayna	cale	None
barrow	roabă	Nan
barsane	barsane	Nan
barta	ideea	None
bartaan	învăța	None
bartamaha	mijloc	None
bartamihii	mijloc	None
bartan	punct	None
bartay	învățat	None
bartey	oarecum	None
barto	învăța	None
barwaaqa	prosperitate	Nan
barwaaqo	prosperitate	Nan
baryaya	deschis	None
baryayaa	ruga	Nan
baryey	implorat	Nan
barre	barre	Nan
barooyosoomaaliya	profil	None
baroordiiqda	doliu	Nan
baroordiiqa	doliu	Nan
barina	stânga	None
barisoomaaliya	îndoctrinare	Nan
barista	învățătură	Nan
baritish	baritish	Nan
barkaan	jumătate	None
barkaanle	ajutor	None
barkada	bazin	None
baryi	a	None
barlamaankadfkmg	păcii	None
barlamanka	tău	None
barlaskooni	barricone	Nan
barliin	barlin	Nan
barnaamijka	program	None
barnaamijkan	program	None
barnaamijyada	programe	None
baro	învăța	None
barlamaankiyo	parlament	None
bik	bi	Nan
basaas	un	None
based	bazat	None
baxiira	taci	Nan
baxo	frunze	None
baxrayn	îmblânzi	Nan
baxsaday	scăpat	None
baxsadeen	scăpat	None
baxsan	afara	None
baxsanida	evadare	Nan
baxshay	plătit	Nan
bay	dafin	Nan
baybalka	biblie	None
baybalku	biblie	None
baydhaba	întoarceți-vă	Nan
baydhabo	apare	None
baydhabotan	aici	None
baylah	vulnerabil	Nan
baxeen	au	None
baxdo	afara	None
baxday	afară	None
baxdaa	afara	None
baseey	baza	None
bashiir	faliment	Nan
bashir	bashir	Nan
bataatiga	cartofi	Nan
batalaale	prieteni	None
batay	crescut	None
bateen	multiplicată	Nan
base	baza	None
batroolka	petrol	None
baw	baw	Nan
baxa	ieși	Nan
baxaa	frunze	None
baxaan	ieși	Nan
baxay	afară	None
baxayaa	frunze	None
baxda	ieși	Nan
batuuta	minciună	Nan
bariiska	orez	Nan
bikra	virgin	Nan
bilaa	fără	None
boorin	a	None
boorinta	îndemnare	Nan
boosaaso	bosaso	Nan
boosaha	post	None
booskii	locul	None
booskiisii	lui	None
boqol	sută	None
boqolkii	sută	None
boqolkiiba	sută	None
boqolsoon	sută	None
boqor	rege	None
boqorad	regină	None
boqoraddii	regina	None
boqorka	regele	None
boqorkayow	meu	None
boorame	dovleac	Nan
boqorkii	regele	None
boorama	dovleac	Nan
booqdayaasha	vizitatori	Nan
bombeelmada	bombardare	Nan
boob	pradă	None
bood	sare	None
boodhari	răsucire	Nan
booliiska	politia	Nan
booliska	politia	Nan
boon	avantaj	None
boondheere	caută	None
booqan	vizita	None
booqanaya	vizita	None
booqashada	vizita	None
booqashadeydi	mea	None
booqdaa	vizita	None
booqdaan	vizita	None
booqday	vizitat	None
booqdo	vizita	None
boqornimada	regatul	None
boqortooyada	regatul	None
boqortooyadii	regatul	None
bukhaari	capotă	Nan
bukhari	bukhari	Nan
bulgaariya	bulgaria	None
bulgaria	bulgaria	None
bullaxaar	canalizare	Nan
bulleted	bulleted	Nan
bulshada	comunitate	None
bulshadabawaayo	comunitate	None
bulshadeennu	comunitatea	None
bulshadii	comunitatea	None
bulsho	social	None
bun	chiflă	Nan
buq	bâzâit	Nan
bur	făină	Nan
buraan	tumoare	Nan
buka	bolnav	None
buhoodle	cumpărător	Nan
budh	buddh	Nan
buaale	dolari	None
boqortooyadu	regatul	None
boqortooyo	regat	None
boqray	rege	None
borama	boorama	Nan
borogaramyo	programatori	Nan
bortaqiiska	portugheză	None
borwa	veni	None
bollywood	bollywood	Nan
bosniya	depresiune	Nan
botswana	botswana	Nan
brdm	brdm	Nan
britain	britanie	None
britan	mâine	Nan
britanwaxa	mâine	Nan
british	britanic	None
btr	btr	Nan
botha	botha	Nan
bolkaniskaee	butonul redare	Nan
bolis	bolus	Nan
boliifia	biliifia	Nan
billaabo	la	None
biloobo	preliminar	Nan
bilood	luni	None
bilow	start	Nan
bilowday	început	None
bilowgii	la	None
bilsho	bilsho	Nan
bilwaday	trandafir	Nan
bin	a	None
bini	uman	None
biniaadamka	omenire	Nan
biniaadanka	ta	None
bintu	bintu	Nan
binu	scuze	Nan
bir	fier	None
bill	factură	Nan
bile	bilă	Nan
bilay	lună	None
bilawgii	la	None
bilaabaan	start	Nan
bilaabata	începe	None
bilaabatay	început	None
bilaabato	începe	None
bilaabay	început	None
bilaabayaa	începe	None
bilaabeen	început	None
biritishka	britanicul	Nan
bilaabidda	inițierea	Nan
bilaabo	din	None
bilaal	medalie	Nan
bilaawday	început	None
biladao	medalie	Nan
bilaha	luni	None
bilawday	început	None
bilawga	inceputul	Nan
bilaabmay	început	None
bil	lună	None
birmingham	birmingham	Nan
bisha	lună	None
bmp	bmp	Nan
bni	bni	Nan
bog	pagină	None
boga	pagină	None
bogaadin	compliment	Nan
bogaan	pagină	None
bogan	bogan	Nan
bogga	pagină	None
boggan	pagină	None
bohol	crater	Nan
boire	boire	Nan
bois	bois	Nan
boland	boland	Nan
bold	îndrăzneţ	Nan
bole	bole	Nan
biyo	apă	None
biyihii	apă	None
biyaha	apă	None
bixiyey	prevăzut	None
bishii	lună	None
bishiisa	lui	None
bishuna	bishuna	Nan
bisinka	bis	Nan
bisiqa	biceps	Nan
bisiqley	bisiqley	Nan
bislaado	copt	Nan
birta	fier	None
bislaanaayo	copt	Nan
bixin	afară	None
bixinta	dispoziţie	Nan
bixisaa	prevede	None
bixisay	plătit	Nan
bixiya	prevăzut	None
bixiyaan	furniza	Nan
bixiyay	prevăzut	None
bixi	ieși	Nan
dheeraada	mult	None
bariise	orez	Nan
bariire	orz	Nan
baa	este	None
baabal	dispărea	Nan
baabii	de	None
baabulmandab	carpool	Nan
baabuur	mașină	None
baabuurta	autoturisme	Nan
baad	tu	None
baadi	eroare	None
baadicadde	trădător	Nan
baadiye	explorator	Nan
baahan	nevoie	None
baahday	necesar	None
baahi	nevoie	None
baahiayay	prezentat	None
baahida	nevoie	None
ba	nu	None
baahintaasi	difuzare	Nan
b	b	None
azc	azc	Nan
ayeey	viaţă	Nan
ayey	cale	None
ayeyna	sunt	None
ayna	lor	None
aynaan	nu	None
aynaanshe	este	None
aynu	hai	Nan
ayoo	strălucire	None
aysan	au	None
aysanna	nici	None
ayuu	el	None
ayuub	evr	Nan
ayuun	fericit	None
ayuuna	facut	None
ayuuu	el	None
aṣṣūmāl	anūmālāl	Nan
baahna	nevoie	None
baahnaa	necesar	None
baal	pană	Nan
baarlamaanka	parlament	None
baarliin	balon	Nan
baarri	curtoazie	Nan
baaruude	virgin	Nan
baasifik	plastic	None
baath	baas	Nan
baaxad	domeniu	None
baaxada	mărimea	None
baaxadda	mărimea	None
baaxadiisu	domeniu	None
baay	dafin	Nan
baayacmushtar	mărfuri	None
baayasiid	comerț	None
baaz	buz	Nan
babaayga	meu	None
baarlamaan	parlament	None
baaritaan	investigație	Nan
baaris	cercetare	None
baariis	paralizie	Nan
baalakan	aripi	None
baallacad	extinsă	None
baalle	balet	Nan
baan	bancă	Nan
baanka	bancă	Nan
baannu	avem	None
baanu	scuze	Nan
ayeen	ei	None
baaq	apel	None
baaqan	rămas	None
baaqayeen	strigau	Nan
baaqaysay	suna	Nan
baar	căutare	None
baardheere	parker	Nan
baargaal	negociere	Nan
baari	baari	Nan
baaqa	apelul	Nan
ayee	ocazie	None
aydinaan	ted	Nan
aydhiyooliyadda	destin	Nan
avv	avv	Nan
aw	aw	Nan
awal	sulă	Nan
awaxaana	tu	None
awdadl	awdadl	Nan
awdal	awdal	Nan
awdalxiligaasoo	timp	None
awdigil	femeie	None
awdigilwuxuu	facă	None
aweys	dubla	Nan
awgeed	lui	None
awliyada	ții	Nan
awmuuse	împlinire	Nan
awood	putere	None
awooda	abilitate	Nan
average	medie	None
avenue	bulevard	Nan
available	disponibil	None
authentication	autentificare	Nan
assembly	asamblare	Nan
astaamaha	simptome	None
astaamo	simptome	None
astaan	simbol	None
astaannta	simbolism	Nan
astaanta	simbol	None
asturaa	scuze	Nan
awoodaha	puteri	None
asxaabtii	prieteni	None
at	la	None
atlaantik	atlantic	None
atom	atom	None
attaxiyaadka	teorii	None
audio	audio	None
august	august	None
australia	australia	None
asxaabtiisa	lui	None
babac	bravo	Nan
awooday	stare	None
awoodeedu	sa	None
ayaa		None
ayaad	tu	None
ayaamo	zi	None
ayaan	eu	None
ayaana	e	None
ayaanle	mentă	Nan
ayaanu	vom	None
ayaay	ei	None
ayada	ei	None
ayadoo	cu	None
ayaga	lor	None
ayagoo	ei	None
ayan	au	None
ayay	ei	None
aybakar	consiliere	Nan
aya	verset	Nan
ay	ei	None
axmedعبدالله	axmed عبدالله	Nan
axmed	axmed	Nan
awoodii	abilitate	Nan
awoodoodiiwaxayna	lor	None
awoow	bunic	Nan
awoowe	bunic	Nan
awoowgiis	lui	None
awoowgiisii	lui	None
awqaafta	teoremă	Nan
awoodda	putere	None
awsamaale	exemplu	None
axaaddiista	exhumare	Nan
axaadiista	hadith	Nan
axad	duminică	Nan
axdiga	legământ	Nan
axdigii	legământul	Nan
axkaamta	dimpotriva	Nan
axmad	legământ	Nan
axaaaddiistuba	hadith	Nan
bariis	orez	Nan
babayga	meu	None
bacadle	înapoi	None
bandhigo	expune	None
bandhigtay	prezentat	None
bangiga	bancă	Nan
bangigu	bancă	Nan
bangladesh	bangladesh	Nan
bani	uman	None
baniaadamka	umane	None
banii	banii	None
bank	bancă	Nan
banka	bancă	Nan
banna	dimpotrivă	None
bannaan	spaţiu	Nan
bannaanayd	gol	None
baqaa	speriat	Nan
baqay	speriat	Nan
bandhigeen	prezentat	None
baqaya	speriat	Nan
bandhigay	prezentat	None
banadir	rar	None
baledweyn	mare	None
balila	orz	Nan
ballaadhaan	extinsă	None
ballaadhan	larg	None
ballaaran	larg	None
ballaariyeen	extinsă	None
ballan	promisiune	Nan
ballanta	programarea	Nan
balqiisa	balcon	Nan
balse	dar	None
bamkii	pompa	Nan
banaadir	banadir	Nan
banaan	vacant	Nan
banaanideeda	afara	None
banaanka	afara	None
bandarbayla	de	None
baqdaad	bagaj	Nan
bar	bar	None
bara	trecut	None
baray	învățat	None
barayaal	educatori	Nan
barayoo	învăţare	Nan
barbaaray	ridicat	None
barbaarin	creștere	None
barbaarinta	copiilor	None
barbaariyo	hrăni	Nan
barbaraawi	barbaraw	Nan
barde	barre	Nan
bare	instructor	Nan
bareen	studiu	None
bari	lasă-l	Nan
baridiisa	sa	None
bariga	est	None
bariidka	orez	Nan
barax	paralizie	Nan
barawe	imitaţie	Nan
barasiil	orez	Nan
barasho	învăţare	Nan
baraako	binecuvântat	Nan
baraalan	evazată	Nan
baraan	preda	None
baraarug	conștientizare	Nan
baraawe	proverbial	Nan
baracaatika	deplasare	None
barack	barack	Nan
balcad	balon	Nan
baraf	zăpadă	None
barakaat	tu	None
barakacii	deplasare	None
baran	învăța	None
barano	să	None
barashada	învăţare	Nan
barashadiisa	lui	None
barashadiisii	lui	None
baraguay	binecuvântare	Nan
balantii	promisiunea	Nan
balanqaadyadii	promisiunile	Nan
balanqaaday	promis	None
badantahay	mulți	None
badanyahay	mulți	None
badanyihiin	mulți	None
badashay	schimbat	None
badaye	majoritate	None
badbaaday	salvat	None
badbaadayso	salvat	None
badbaadid	salvați	Nan
badbaadinta	economisire	Nan
badbaadiyey	salvată	Nan
badbaadiyo	salvați-l	Nan
badda	marea	None
baddacas	baddacas	Nan
baddii	marea	None
badh	jumătate	None
badanna	mult	None
badankoodu	ei	None
badankooda	ei	None
badankood	ei	None
bachelor	burlac	Nan
bad	rău	None
bada	oferindu-	Nan
badacas	mare	None
badal	schimbare	None
badalay	schimbat	None
badaleen	schimbat	None
badhaadhe	drumului	None
badalin	neschimbat	Nan
badan	mulți	None
badana	ori	None
badanaa	obicei	None
badanaayey	deseori	None
badane	mult	None
badani	mulți	None
badanina	ei	None
badalo	schimbare	None
bacaadka	nisip	None
badhan	buton	Nan
badhtamaha	mijloc	None
bahdil	ruşinos	Nan
bahdood	nevoiaș	Nan
bahoobayxafladan	eveniment	None
bakaaraha	bakaaro	Nan
baki	negru	None
bakistaan	pakistan	None
bakool	bakool	Nan
bakoolgalgaduudnugaal	eșalonarea	Nan
bakr	bakr	Nan
bal	vedea	None
balaadhan	larg	None
balaaran	mare	None
balaarintii	expansiunea	None
balad	chel	Nan
baladhaan	această	None
bahda	pereche	None
bahal	fiară	Nan
bahabar	un	None
bah	bah	Nan
badhtamihii	mijloc	None
badiba	ales	None
badiyaa	obicei	None
badka	marea	None
badmareen	navigat	Nan
badn	rău	None
badnaa	mulți	None
badhigtay	salvată	Nan
badnayd	era	None
badnayn	mult	None
badneyn	mult	None
badno	mult	None
badood	mări	None
badwaynta	ocean	None
badweynta	oceanul	None
baghdad	alfabetic	Nan
badnaydna	in	None
joogaanba	sunteți	Nan
dheeraadka	plus	None
dheere	lung	None
helaynin	găsi	None
helayo	găsi	None
helaysaa	primesti	Nan
heleen	găsite	None
heleysa	primire	Nan
heli	găsi	None
helin	găsi	None
helitaanka	disponibilitate	Nan
heliwaa	disponibil	None
helno	găsi	None
helo	găsi	None
helsinki	helmsinki	Nan
herar	herar	Nan
herbert	herbert	None
herer	herer	Nan
helaye	găsi	None
heshay	primit	None
helayaa	disponibil	None
helay	găsite	None
heesaa	cânta	None
heesaan	cânta	None
heesaha	cantecele	Nan
heesanin	cânta	None
heesayaan	cânta	None
heesihii	cantecele	Nan
heeso	cânta	None
heesta	cântecul	None
heestaan	acest	None
heestay	sung	Nan
heestii	cântecul	None
heesto	cânta	None
height	înălţime	Nan
helaa	găsi	None
helaan	găsi	None
helaya	primire	Nan
heshid	găsi	None
heshiis	acord	None
heshiiska	acord	None
hijrada	migrațiune	Nan
hijriga	migrațiune	Nan
hijrigu	migrațiune	Nan
hijriyada	migrațiune	Nan
hilibka	carne	None
hilibku	carne	None
hillary	hillary	Nan
hilowle	salut	Nan
hindi	hindi	Nan
hindida	retrospectiv	Nan
hindiya	hindi	Nan
hindu	hindus	Nan
hingaada	ortografie	None
hingaadda	ortografie	None
hiraab	șontâcăi	Nan
hiiraan	hira	Nan
hiil	hiil	Nan
high	înalt	None
hiddo	moștenire	None
heshiiskii	acordul	None
heshiiso	reconcilia	Nan
heshiisyo	tratate	None
heshiiyeen	acord	None
hesho	găsi	None
heshowali	reconcilia	Nan
heyada	toc	Nan
heesa	cânta	None
heyn	așteptare	Nan
heystayna	avea	None
heysto	avea	None
hibaaqeey	șchiopătînd	Nan
hibada	cadoul	Nan
hibo	talent	None
hibrahim	hibrahim	Nan
hiddaha	tradiţie	Nan
heysta	avea	None
hiraabe	conversație	Nan
hees	cântec	None
heerka	nivel	None
hawd	hawd	Nan
haween	femei	None
haweenaydii	femeia	None
haweenka	femei	None
haweenkii	femei	None
haweenku	femei	None
hawiyaha	aer	None
hawiye	bine	None
hawl	sarcină	None
hawlaha	activități	None
hawo	zbor	None
hawood	hawood	Nan
hawshaas	sarcină	None
hawshii	sarcina	None
hay	fân	Nan
hawayga	lacrimi	None
haya	chirie	Nan
hawaii	hawaii	None
haw	hais	Nan
hargeisa	hargaisa	Nan
hargesa	hargesa	Nan
hargeysa	hargeisa	Nan
hariin	raidul	Nan
harimacadka	agitatia	Nan
harraad	sete	Nan
harti	harti	Nan
hartigu	broasca testoasa	Nan
has	are	None
hasan	hasan	Nan
hase	caz	None
haseyeeshee	caz	None
hashiisii	lui	None
hassan	hassan	Nan
have	avea	None
hawada	aer	None
hayaa	așteptare	Nan
hayaan	așteptare	Nan
hayada	agenţie	Nan
haysateen	avut	None
haysato	avea	None
haysay	ținut	None
hayso	păstrează-l	Nan
haysta	posedat	Nan
haystaan	avea	None
haystay	avut	None
haystee	păstrează-l	Nan
haysteen	avut	None
haysto	avea	None
hdms	hdms	Nan
he	el	None
hebel	hebel	Nan
heeganaa	în	None
heer	nivel	None
haysatay	avut	None
haysata	avea	None
haysan	avea	None
haysaan	avea	None
hayadaha	agentii	Nan
hayadda	corp	None
hayay	ținut	None
haybadoofdii	excelență	Nan
hayd	da	None
hayeen	avea	None
hayeeshee	caz	None
heersare	excelență	Nan
hayey	ținut	None
hayin	dincolo	None
hayn	a	None
haynin	păstrează-l	Nan
hayo	așteptare	Nan
hays	avea	None
haysa	rezistați	Nan
haysaa	avea	None
hayeyguddoomiyaha	guvernatorul	None
hirayo	împrumutate	None
hireey	hiree	Nan
hirgelinteeda	acesteia	None
hormaro	îmbunătăţi	Nan
hormarsan	avansat	None
hormood	progresiv	None
hormoon	hormon	Nan
hormuudka	precursorul	Nan
horraantii	devreme	None
horrayntii	primul	None
horraysay	primul	None
horreeya	primul	None
horreeyay	primul	None
horreeyey	primul	None
horreyey	precedat	None
horreysa	primul	None
horsed	călare	Nan
horseed	conducere	None
hormar	progres	Nan
horseedaan	conduce	None
horm	avans	Nan
horjoogsan	împiedicată steric	Nan
horeeysay	primul	None
horeeyso	primul	None
horena	deja	None
horey	devreme	None
horeyay	anterior	None
horeysay	primul	None
horeysey	devreme	None
horjeed	contrar	None
horjeeda	opusul	Nan
horjeeday	opus	None
horjeedeen	opus	None
horjeeedo	dimpotrivă	None
horjeesatay	opus	None
horjeestay	opus	None
horjeesteen	opus	None
horkeentay	lui	None
horseeday	led	Nan
hortagay	prevenite	Nan
hortageen	confruntat	None
howlo	activități	None
howlwadaag	partener	None
hoyatay	mea	None
hoyga	adăpost	None
hoyisay	depusă	Nan
hoyn	adăpost	None
httpsowikipediaorgwikidigiliyomirifle	httpsowikipediaorgwikidigiliyomirifle	Nan
httpwwwfreewebscominawarfaa	httpwwwfreewebscominawarfaa	Nan
httpwwwfreewebscominawarfaaindexhtm	httpwwwfreewebscominawarfaaindexhtm	Nan
httpwwwyoutubecomwatchv=lzyegdtes	httpwwwyoutubecomwatchv = lzyegdtes	Nan
huang	huang	Nan
hub	arme	None
hubaal	sigur	None
hubaysan	armat	Nan
hubiyey	verificat	Nan
howlgal	operațiune	Nan
howlaha	activități	None
however	caz	None
how	cum	None
hortago	împiedica	None
hortii	primul	None
hortiisa	lui	None
horumar	progres	Nan
horumarinta	dezvoltare	None
horumarka	progres	Nan
horumartay	dezvoltat	None
horeeyo	primul	None
horuu	huu	Nan
horyimid	ta	None
hospital	spital	None
hospitaller	capelan	Nan
hoteel	hotel	None
hoteelada	hoteluri	None
hotel	hotel	None
hotelada	hoteluri	None
horyaal	ligă	Nan
horeeyey	devreme	None
horeeye	primul	None
horeeyay	primul	None
hogaamiyayaal	liderii	None
hogaamiye	lider	None
hogaamiyihii	liderul	None
hogaamiyihiis	său	None
hogaan	conducere	None
hogaanka	conducerea	None
hogaankii	conducere	None
hoggaaminaayo	oportunitati	Nan
hoggaamiyihii	liderul	None
hoggaanka	conducere	None
hogol	hogol	Nan
hohey	hohey	Nan
hohob	hohob	Nan
holand	olanda	None
holland	olanda	None
hogaamiyaha	liderul	None
hogaamiya	conducere	None
hogaaminayey	led	Nan
hogaaminayeen	led	Nan
hirgeliyo	forńate	Nan
hirka	maree	Nan
hiroshima	hiroșima	Nan
history	istorie	None
hivga	hivga	Nan
hiyiga	hobby-ul	Nan
hlibka	vițelul	Nan
home	acasă	None
hobalada	vol	None
hobolada	arderilor	Nan
hobyo	hobyo	Nan
hodan	bogat	None
hoddaye	bogat	None
hogaaminaayey	conducere	None
hogaaminaya	conducere	None
hogaaminayay	conducere	None
hobolad	planare	Nan
hargaysi	rece	None
hona	hona	Nan
hoo	hoo	Nan
hooyadood	lor	None
hooyay	mamă	None
hooyeen	mamă	None
hooyey	mamă	None
hooyo	mamă	None
hor	de	None
horaa	deja	None
horaantii	devreme	None
horay	devreme	None
horaysay	primul	None
hordhac	introducere	None
hordhaca	introducerea	None
hore	devreme	None
horeba	deja	None
horeeya	primul	None
hooyadiis	lui	None
hooyadii	mama	None
hooyada	mama	None
hooy	adăpost	None
hooggiinee	tine	None
hooreysa	in	None
hoos	jos	None
hoosaad	sub	Nan
hoosdhaban	scăzut	None
hoose	jos	None
hoosedhexe	midline	Nan
hong	hong	None
hooseeya	scăzut	None
hoosta	jos	None
hoostaga	sub	Nan
hoostagaan	supus	None
hoosteeda	sub	Nan
hoostiis	sub	Nan
hoostiisa	sub	Nan
hooteelka	hotel	None
hooseshabeelaha	subordonat	Nan
hargaysa	hargeisa	Nan
hargaha	piei	Nan
hareeyey	asediat	Nan
guryahoodii	lor	None
guryihii	case	None
guryo	case	None
guryohoodii	lor	None
guto	fă-o	Nan
guubaabiyey	stimulata	Nan
guud	general	None
guude	dezleaga	Nan
guudkeeda	suprafață	None
guul	succes	None
guulaysatay	succes	None
guulaystay	succes	None
guuldaraystay	eșuat	None
guuleed	ocupat	None
guuleestay	castigat	Nan
guryaha	case	None
guuleyso	succes	None
gurmadeenitoobiya	principala	None
gurigiisa	lui	None
gumeestihii	coloniștii	None
gumeestiyaashii	coloniștii	None
gumeysi	colonialism	Nan
gumeysiga	colonialism	Nan
gumeysigii	colonialism	Nan
gumeystaha	colonelul	Nan
gumeystihii	colonelul	Nan
gumeysto	coloniza	Nan
guray	gri	Nan
gureey	înfuleca	Nan
gurey	spart	Nan
guri	casă	None
guriceel	guriel	Nan
guriga	acasa	Nan
gurigii	casa	None
gurigiisii	lui	None
guuleystay	succes	None
guuleysto	succes	None
guulihii	realizări	None
guursatay	căsătorit	None
guurtida	senatul	None
guusha	succes	None
guyana	declarat	None
gyastayn	repara	Nan
göteborg	göteborg	Nan
h	h	Nan
ha	lor	None
haa	da	None
haadaan	da	None
haadku	îmbrățișări	Nan
haag	dreapta	None
haagu	stânga	None
haajiray	emigrat	None
haajirtay	emigrat	None
guursado	a	None
guursadey	căsătorit	None
guursadaye	căsătorit	None
guursaday	căsătorit	None
guullahay	succes	None
guulo	succes	None
guulside	înfrângere	None
guulwadayaasha	câştigătorii	Nan
guulwade	câştigător	Nan
guur	căsători	Nan
guuraaga	in	None
gumeestayaasha	coloniștii	None
guuraan	a	None
guure	mișcare	None
guureen	mutat	None
guurey	mutat	None
guuriyaha	sotia	Nan
guurka	căsătorie	None
guuro	mișcare	None
guursadaan	căsători	Nan
guuray	mutat	None
gumeestay	got	Nan
gumeesiga	colonia	None
gumeesanin	colonizat	Nan
gowracay	sacrificate	Nan
gowracayn	măcel	Nan
gowraco	măcel	Nan
goysay	a	None
gpp	gpp	Nan
gprs	gprs	Nan
grand	mare	None
graziani	graziani	Nan
groningen	groningen	Nan
groups	grupuri	None
gsare	ocolire	Nan
gsm	gsm	Nan
gsmka	gsumm	Nan
gu	gu	Nan
gubay	ars	None
gowrac	măcel	Nan
government	guvern	None
gorgor	vultur	Nan
gorfayna	gorfayna	Nan
goobtain	loc	None
goobtan	loc	None
goobtani	loc	None
goobtii	locație	Nan
goobweyn	locație	Nan
googoayey	calea	None
gooni	separa	Nan
gud	circumcis	Nan
goor	timp	None
goorta	cand	None
goortii	cand	None
goortuu	el	None
goosha	goluri	None
goostay	recoltate	Nan
gooyo	a	None
goray	goray	Nan
goorba	mereu	None
haan	haan	Nan
guda	fel	None
gudaha	interior	None
gugii	aceasta	None
guilliani	guilliani	Nan
guinea	guineea	Nan
guluf	guluf	Nan
gumaaday	cracked	Nan
gumaysan	colonizat	Nan
gumaysiga	colonialism	Nan
gumaysigii	colonialism	Nan
gumaysta	colonialism	Nan
gumaystaha	colonialist	Nan
gumaystay	colonizat	Nan
gumaystayaasha	coloniști	None
gumaystayaashii	coloniști	None
gumaystayaashu	coloniști	None
gumaystihii	colonial	Nan
guga	primăvară	None
guduud	roșu	None
gudoonsiiyaya	donând	Nan
gudoomiyihii	guvernatorul	None
gudaheeda	în	None
gudanno	circumcis	Nan
gudbay	trecut	None
gudbey	trecut	None
gudbin	trimite	None
gudbo	trece	None
guddidii	bord	Nan
gudabaarsan	rotunjit	Nan
guddiga	comitet	Nan
guddoomiyihii	guvernatorul	None
guddoonsaday	primit	None
gudiga	comitet	Nan
gudihiisa	interior	None
gudo	împrejur	Nan
gudoomiyaha	președintele	None
gudoomiye	preşedinte	Nan
guddoomiyaha	guvernatorul	None
hubka	arme	None
haare	haare	Nan
haashim	haashim	Nan
halgankii	lupta	None
halhays	legendă	None
halis	periculos	None
halka	ce	None
halkaa	acolo	None
halkaan	aici	None
halkaana	acolo	None
halkaas	acolo	None
halkaasi	acolo	None
halkaasna	acolo	None
halkaasoo	unde	None
halkan	aici	None
halkanna	acolo	None
halkay	unde	None
halkii	schimb	None
halgankaas	luptă	None
halkiisii	schimb	None
halganka	lupta	None
halgame	persoana	None
haji	pelerinaj	Nan
haka	de	None
hakad	pauză	Nan
hal	unu	None
halaad	distruge	None
halaag	distruge	None
halac	halal	Nan
haldoor	haldoor	Nan
haldoorka	haldard	Nan
half	jumătate	None
halfrate	halfrate	Nan
halgamaa	lupta	None
halgamaayaashii	activiști	Nan
halgamay	zbuciumat	Nan
halgamayaashaasi	lupte	None
halgan	lupta	None
halmar	data	None
halqabsadeen	facut	None
halyeey	legendă	None
hantida	proprietate	None
hantiwadaaga	socialism	Nan
hanto	cablaje	Nan
hanuun	îndrumare	Nan
hanuuniye	bucluc	Nan
hanuunka	îndrumare	Nan
har	cand	None
harag	piele	None
harar	gras	Nan
haray	rămas	None
haraye	pa	Nan
hareen	rămas	None
hareeraha	jurul	None
hareereheeda	ei	None
hareereysan	înconjurător	None
hanti	bogatie	Nan
hanoolaato	a	None
hannaan	proces	None
handsets	telefoane	Nan
halyey	legendă	None
hamashka	hamac	Nan
hamdan	hamdan	Nan
hamiyayey	momit	Nan
hamzada	bun	None
hamzo	neclar	Nan
hana	împiedica	None
haile	haile	Nan
hanaaqaadeen	nedumerit	Nan
hanaqaad	nu	None
hanaqaaday	copilul	None
hanaqaadeen	înflorit	None
hanaqaadkii	înfloritor	Nan
hanato	gras	Nan
hanbalyo	felicitări	Nan
handset	receptor	Nan
hanan	înapoi	None
hagistiisu	lui	None
hagayay	ghid	None
hagari	hoanghină	Nan
hablood	fete	None
haboon	corespunzătoare	None
habsamiya	neted	Nan
had	avut	None
hada	inclus	None
hadaad	tu	None
hadaaftimo	scop	None
hadaan	nu	None
hadaba	urmare	None
hadad	tu	None
hadal	vorbi	None
hadaladii	declaraţii	Nan
hadalka	vorbire	None
hadalkana	discursul	None
hadalkii	cuvantul	Nan
hablaha	fete	None
habkii	care	None
habka	metodă	None
habeenkii	noaptea	None
haatan	acum	None
haatuf	haatuf	Nan
haayo	a	None
hab	metodă	None
haba	haba	Nan
habaabay	derutant	Nan
hababka	metode	None
hadalkiisa	lui	None
habar	mătuşă	Nan
habarjeclo	venit	None
habartii	acum	None
habaysan	organizat	None
habboon	propriu-zis	Nan
habdhiska	nervos	None
habeen	noapte	None
habeenkeeda	ei	None
habargidir	venit	None
haaruun	haroon	Nan
hadana	caz	None
hadasho	vorbi	None
hadla	vorbi	None
hadlaa	vorbește	None
hadlaan	vorbi	None
hadlay	vorbit	None
hadlaya	vorbitor	Nan
hadlayaayey	vorbitor	Nan
hadlayana	vorbitor	Nan
hadlayo	vorbitor	Nan
hadli	vorbi	None
hadlid	vorbi	None
hadlin	vorbi	None
hadlo	vorbi	None
hadraawi	hadith	Nan
haduu	el	None
hagar	față	None
hadiye	a	None
hadii	dacă	None
hadhwanaag	amurg	None
hadhay	stânga	None
haday	dacă	None
hadayn	nu	None
hadba	primul	None
hadda	acum	None
haddaa	da	None
haddaad	tu	None
haddaan	nu	None
hadane	oricum	None
haddaba	acum	None
hadday	dacă	None
haddii	dacă	None
haddiise	da	None
hadduu	el	None
hadduusan	nu	None
hadeer	acum	None
hadey	dacă	None
haddana	nou	None
goobta	locație	Nan
hubkuu	lui	None
hubsaday	asigurat	None
iyaguna	bum	Nan
iyana	ei	None
iyo	și	None
iyoama	da	None
iyoturkigawaxaanuu	iar	None
j	j	None
jaad	jaad	Nan
jaadjaad	vraja	Nan
jaadka	mouse	Nan
jaahiligii	cel	None
jaajuus	spion	Nan
jaale	galben	None
jaaliyadaha	asociațiile	Nan
jaalle	galben	None
jaamac	universitate	None
iyagu	lor	None
jaamaca	universitate	None
iyagoon	canon	Nan
iyagana	limitări	Nan
itoopiya	agrement	None
itopiyanka	dizolvare	Nan
its	este	None
iuyo	zgomot	Nan
iwm	etc.	Nan
iyaba	mamă	None
iyada	ei	None
iyadana	mea	None
iyadii	ei	None
iyadoo	cu	None
iyadoon	fără	None
iyadu	mamă	None
iyaduna	mea	None
iyaga	lor	None
iyagaa	lor	None
iyagoo	lor	None
jaamacad	universitate	None
jaamacada	universitatea	None
jaamacadaha	universități	None
jabouti	japonez	None
jabriil	aprilie	None
jabtay	rupt	Nan
jabuuti	djibouti	Nan
jabuuticiisaha	evoluţionist	Nan
jabuutiwaxaa	în	None
jabuutti	jabuutti	Nan
jacayl	dragoste	None
jacaylka	dragoste	None
jaceyl	dragoste	None
jacfar	dragoste	None
jaciir	latra	Nan
jacques	jacques	None
jagada	poziţie	Nan
jago	ghid	None
jabkaas	acele	None
jabiyey	rupt	Nan
jabhado	fracturi	Nan
jabhadii	fracturi	Nan
jaamacadda	universitate	None
jaamacadii	universitatea	None
jaamacado	universități	None
jaamacadu	universitate	None
jaamcada	universitate	None
jaamow	da	None
jaantuska	diagramă	Nan
itoobiyana	etiopia	None
jab	fractură	Nan
jabaanlaakiin	rupt	Nan
jaban	rupt	Nan
jabay	rupt	Nan
jabhad	jihad	Nan
jabhada	fracturi	Nan
jabhadda	luptă	None
jabhaddii	armat	Nan
jabaan	rupt	Nan
jahannamo	iad	Nan
itoobiyaereteriya	etiopian	Nan
itoobiyaan	etiopienii	Nan
ismaandhaafkooda	lor	None
ismaciil	ismail	Nan
ismacil	demisiona	Nan
ismail	ismail	Nan
isna	spus	None
isniin	luni	None
iso	veni	None
israaca	împreună	None
israaiil	israaiil	Nan
israailaye	eternitate	Nan
israel	israel	None
israil	israil	Nan
isreebreeb	de	None
isse	proiect	None
issisalaamya	povestea	None
ismaan	butonul redare	Nan
isssssssslam	isssssssslam	Nan
ismaamulo	sine	None
ismaamulgoboleedka	craniul	Nan
islam	islamice	None
islamarkaana	timp	None
islamarkaasna	timp	None
islamdu	islam	None
islamic	islamice	None
islamka	islam	None
island	insulă	None
isleeg	equals	Nan
isleegta	ecuaţiile	Nan
islii	eastleigh	Nan
islofaakiya	schizofrenie	Nan
islofeeniya	schizofrenie	Nan
isloveeniya	isotopia	Nan
isma	este	None
ismaaciil	ismael	Nan
ismaamulka	sinele	Nan
istaagay	oprit	None
istaagey	oprit	None
istaagi	ridica-te	Nan
istiraajiyada	strategii	Nan
isu	înșiși	None
isufahmeen	s-au reunit	Nan
isugu	fel	None
isuma	știu	None
iswiidhan	suedia	None
iswiisarland	elveţia	Nan
iswiizerlaan	swingers	Nan
iswisarland	elveţia	Nan
isxaaq	isaac	None
it	aceasta	None
itaaliya	italia	None
italiana	italiana	None
item	articol	None
itoobiya	etiopia	None
istiraaji	ai	None
isticmalka	utilizare	None
isticmalaa	utilizări	Nan
isticmaasho	utilizare	None
istaago	stop	Nan
istabta	tatuaj	Nan
istanbuul	incoerență	Nan
istandharka	compensare	Nan
istarliin	înstrăinat	Nan
isticmaal	utilizare	None
isticmaalaa	utilizări	Nan
itoobiyaanka	etiopian	Nan
isticmaalaan	utilizare	None
isticmaalay	folosit	None
isticmaalayaasha	utilizatori	None
isticmaalayo	utilizând	None
isticmaali	utilizare	None
isticmaalka	utilizare	None
isticmaalo	utilizare	None
isticmaarka	utilizare	None
isticmaalaha	utilizatorul	Nan
jakarta	sac	Nan
jama	oameni	None
jamaal	oamenii	None
jiita	minute	None
jiitaan	remorcare	Nan
jijeele	înșelător	Nan
jilaa	actor	None
jilaamasrax	jilaamasrax	Nan
jili	bili	Nan
jilib	genunchi	Nan
jilibkiisa	genunchiul	Nan
jilicsan	moale	None
jimcaale	îndrăgostit	None
jimcale	ansamblu	None
jimce	vineri	None
jimcihii	vineri	None
jimco	vineri	None
jinka	ta	None
jiir	şobolan	Nan
jiq	trăncăneală	Nan
jiinow	stai treaz	Nan
jiilashii	urmasi	Nan
jidkaas	fel	None
jidkan	aici	None
jidkii	care	None
jidle	avere	None
jifadiisa	său	None
jigjiga	jigsaw	Nan
jihaad	jihad	Nan
jihaaday	directed	Nan
jihaadka	jihad	Nan
jiho	stat	None
jiidaas	zona	None
jiidasho	atracţie	Nan
jiido	remorcare	Nan
jiilaal	iarnă	None
jiilasha	generații	None
jiilkii	generaţie	Nan
jir	vechi	None
jira	aștepta	None
jiraa	există	None
jirney	eram	Nan
jiro	exista	None
jirsaday	transformă	None
jirta	există	None
jirtaa	există	None
jirtay	existat	None
jirteen	exista	None
jirtey	existat	None
jirto	exista	None
jirtowax	există	None
johannesburg	johannesburg	Nan
johnston	johnston	Nan
joog	stau	None
jooga	în	None
joogaa	aici	None
jirkii	corpul	None
jirka	corp	None
jiritaankeeda	ei	None
jiritaanka	existenţă	Nan
jiraan	acolo	None
jiraba	fapt	None
jirae	acolo	None
jirataaa	te	None
jiray	existat	None
jiraye	exista	None
jiraysoomaaliya	somalia	Nan
jidka	care	None
jireen	fost	None
jireenan	fost	None
jireenka	existenţă	Nan
jireenwaxee	fost	None
jirey	exista	None
jiri	utilizare	None
jirin	nu	None
jirinhaddaba	deloc	None
jireena	acolo	None
jideeyey	ținut	None
jideeyay	ținut	None
jid	departe	None
jareen	calea	None
jareer	bunică	Nan
jariiban	jargon	Nan
jarmaankakuwaas	tineri	None
jarmal	germana	None
jarmalka	germana	None
jaro	a	None
jasiira	insulă	None
jasiirad	insulă	None
jasiirada	insula	None
jasiiradaha	insulele	None
jasiirado	insulele	None
jasiiradood	insulele	None
jawaabay	răspuns	None
jawaabeen	răspuns	None
jaray	calea	None
jaraaidka	ziarul	None
janno	paradis	Nan
jannada	cer	None
jamaame	mulțime	None
jamac	plural	None
jamacada	plural	None
jamal	jamal	Nan
jameecada	adunarea	None
jameeco	congregaţie	Nan
jamhuriyada	republică	None
jawaabey	răspuns	None
jamhuriyadda	republică	None
jamhuuriyad	republică	None
jamhuuriyada	republică	None
jamhuuriyadda	republică	None
janaayo	ianuarie	None
janaraal	general	None
jannaale	ianuarie	None
jannaayo	ianuarie	None
jamhuuriya	republică	None
islaax	plia	Nan
jawaabo	răspunsuri	None
jawi	mediu	None
jeelle	jeleu	Nan
jeer	ori	None
jeerin	dezinfecta	Nan
jeex	rupere	Nan
jeexwaxaana	și	None
jen	la	None
jenaraal	general	None
jenaraalkii	generalul	None
jeneraal	general	None
jeneral	general	None
jesus	iisus	None
jibaaran	pătrat	None
jibiyay	rupt	Nan
jibriil	gabriel	None
jicib	arunca	Nan
jeedo	rândul	None
jeediyo	sugestii	Nan
jeediyeen	sugerat	None
jeediyay	sugerat	None
jawiga	atmosfera	None
jaziirada	insulă	None
je	merge	None
jebiyey	rupt	Nan
jecel	dragoste	None
jecelyahay	iubit	None
jecelyihiin	dragoste	None
jawhar	timpul	None
jeclaa	iubit	None
jeclayn	nu-i plăcea	Nan
jeclaystay	iubit	None
jeeda	întoarce-te	Nan
jeedaa	la	None
jeedaan	întoarceți-vă	Nan
jeeday	întors	None
jeediyana	rândul	None
jeclaan	dragoste	None
islaanimo	ateism	Nan
islaan	divorț	Nan
islaamu	fel	None
ilbaxnimadii	civilizaţie	Nan
ilka	dinte	None
ilkaha	dantură	Nan
illaa	la	None
ilma	copil	None
ilmada	lacrimi	None
ilmadu	lacrimi	None
ilmo	copil	None
ilmohooda	lor	None
ilo	utilizare	None
ilyaas	lacrimi	None
imaaday	sosit	None
imaadeen	sosit	None
imaam	imam	Nan
imaamka	imam	Nan
ilbaxnimada	civilizaţie	Nan
imaamkii	imam	Nan
ilaha	surse	None
ilaawaan	uita	Nan
ilaaha	dumnezeul	None
ilaahay	dumnezeu	None
ilaahayna	dumnezeu	None
ilaaheey	dumnezeule	Nan
ilaahey	dumnezeule	Nan
ilaahyo	zei	None
ilaalada	gărzi	Nan
ilaali	ai	None
ilaalin	proteja	None
ilaalinta	protecţie	Nan
ilaaliya	pază	Nan
ilaaliyaha	pază	Nan
ilaaliyo	protejat	Nan
ilaalo	pază	Nan
ilaashado	mine	None
ilah	da	None
imaamu	potrivi	Nan
imaan	veni	None
imaaraatka	conștientizare	Nan
inaad	la	None
inaadan	o	None
inaan	la	None
inaanu	nu	None
inaga	ne	None
inana	mama	None
inay	la	None
inaynu	trebui	None
inaysan	nu	None
inbadan	mult	None
included	inclus	None
including	inclusiv	None
indha	ochi	None
indhabuur	ochi	None
indhaha	ochi	None
ina	ușoară	None
in	în	None
important	important	None
immam	imam	Nan
imaarad	amator	Nan
imaatay	sosit	None
imagekaahinjpg|daahir	pur	None
imagekontulan	imagekontulan	Nan
imagem	mea	None
imagemadaxwaynahaygajpg|siilaanyo	a	None
imagemogadishusjpg|	imagemogadishusjpg |	Nan
ilaah	dumnezeu	None
imagetuurjpg|cabdiraxman	imagetuurjpg | cabdiraxman	Nan
iman	veni	None
imanaysa	vine	None
imbaradooriyado	telecomunicații	Nan
imei	imei	Nan
imid	veni	None
imika	acum	None
iminka	acum	None
imagexamarcadejpg|	imagexamarcadejpg |	Nan
ilaa	la	None
ila	linia	None
il	ochi	None
ianaynu	hai	Nan
iaygoo	mie	None
ibin	cult	None
ibn	ibn	None
ibnu	ascunde	None
ibraahiim	puzzle	Nan
ibraahim	nu	None
ibraahin	spune	None
ibrahim	ibrahim	Nan
ictiraaf	recunoaştere	Nan
ictiraafsanyahay	recunoscut	None
idaacada	statia	Nan
idaacadaha	radio	None
idaha	scena	None
identity	identitate	None
ialahayna	mine	None
iadoo	mine	None
i	eu	None
huud	capotă	Nan
hudheello	hotel	None
hudhudkii	palatul	None
hungaria	foame	Nan
huraan	o	None
huray	răguşit	Nan
hurda	dormit	Nan
hurdada	dormi	Nan
idhi	spus	None
hurdadii	dormi	Nan
hureen	defalcat	Nan
hurin	urgenţă	Nan
hurre	comparaţie	Nan
hurumarka	progres	Nan
huruud	galben	None
huseen	huseen	Nan
hussein	hussein	Nan
hurdo	dormi	Nan
indheergarad	intelectual	None
idiin	dumneavoastră	None
idin	tu	None
iibsadaan	cumpără	Nan
iibsaday	cumparat	Nan
iibso	cumpar-o	Nan
iidow	sărbătoare	None
iiga	mie	None
iigu	mine	None
iikeeneen	adus	None
iima	da	None
iimaan	credinţă	Nan
iimaanka	credinţă	Nan
iimaankuna	credinţă	Nan
iiraan	iran	None
iisoo	mie	None
ikhyaartii	optiunea	Nan
ikwadoor	a	None
iibiyo	vinde	Nan
iibiyey	vândut	None
iibin	vinde	Nan
iibgayn	vinde	Nan
idinka	tu	None
idinkaa	tu	None
idinkana	fel	None
idinkaysu	voi	None
idinla	tine	None
idiris	mesteca	Nan
idlaaday	terminat	None
idil	întregul	None
iesus	iesus	Nan
ifka	ifka	Nan
iftin	floare	None
iga	merge	None
igad	strămurare	Nan
igu	mine	None
ihi	eu	None
ii	ii	None
if	dacă	None
hubo	sigur	None
indho	ochi	None
india	india	None
isbania	tara natala	Nan
isbayn	sine	None
isbeheysi	ortografie	None
isbheysigii	auto	None
isbitaal	spital	None
isbitaalada	spitale	None
isbitaalka	spital	None
isboorti	sport	None
isdaba	secvenţă	Nan
isdullayn	dependență	Nan
isga	saha	Nan
isgaadhsiinta	comunicare	None
isgaadhsiintu	comunicare	None
isgaarsiinta	comunicare	None
isha	ochi	None
isbadalka	schimbare	None
ishkin	hashkin	Nan
isbadalin	neschimbat	Nan
isbadalada	schimbări	None
irmaan	pantaloni	Nan
irridka	usa	Nan
irridkaa	aici	None
irsaaqa	cumpără	Nan
is	este	None
isa	destul	None
isaaq	butonul redare	Nan
isaaqu	da	None
isaga	-l	Nan
isagoo	având	None
isagu	el	None
isanimo	absență	Nan
isaxaaq	fluier	Nan
isbadal	schimbare	None
isbadala	schimbare	None
isbadaladii	schimbarile	Nan
isi	capul	None
isjiiraya	zguduire	Nan
iska	aer	None
islaamay	îmbrățișat	Nan
islaamcarabi	butonul redare	Nan
islaameen	făcut	None
islaami	islam	None
islaamiga	islam	None
islaamiya	butonul redare	Nan
islaamiyiinta	islamiştii	Nan
islaamka	islam	None
islaamkaayuu	musulman	None
islaamku	islam	None
islaamkuna	islam	None
islaamnimada	islamism	Nan
islaamnimadiisa	său	None
islaamnimo	islam	None
islaamoow	salut	Nan
islaama	fel	None
islaam	islam	None
isla	fel	None
iskuxigxiga	secvența	Nan
iskaashi	coopera	Nan
iskaashiga	cooperare	None
iskaga	aici	None
iskama	exista	None
iskoolada	școli	None
isku	fel	None
iskudar	aduna	Nan
iritareeya	fugi	Nan
iskudayay	încercat	None
iskula	fel	None
iskuqabashada	conflict	None
iskusoo	adormi	Nan
iskuulada	școli	None
iskuulka	la	None
iskuulo	școli	None
iskuxidhka	rețele	None
iskugu	împreună	None
irir	păr	None
iri	încordare	Nan
iraq	irak	None
ingriisugu	engleză	None
initiated	iniţiat	Nan
injiil	evanghelie	Nan
injineer	inginer	None
inka	cerneală	Nan
inkasta	deşi	Nan
inkastoo	deşi	Nan
inkastoon	dezaprobare	Nan
inna	mama	None
innagaa	ne	None
innoo	noi	None
innooga	accentul	None
innoogu	noi	None
inoo	noi	None
inoogu	noi	None
ingriisla	engleză	None
ingriisku	englezii	Nan
ingriiska	engleză	None
ingriis	engleză	None
indonesia	indonezia	None
indonesian	indoneziana	Nan
indoniishiya	indoneziană	Nan
indoor	interior	None
indoors	interior	None
indunisiya	indoneziană	Nan
ineey	la	None
inqilaab	răsucire	Nan
iney	la	None
information	informație	None
ing	ing	Nan
ingiriis	engleză	None
ingiriisiga	engleza	None
ingiriiska	engleza	None
ingiriisku	englezii	Nan
ingirisku	englezii	Nan
ineysan	au	None
indhuhu	ochi	None
inqilaabeen	devenit	None
inqilaabkaasna	stat	None
internetka	internet	None
intey	intey	Nan
intii	ce	None
intiisa	restul	None
into	în	None
intooda	ei	None
intuba	tot	None
intuu	el	None
inu	interior	None
inuu	la	None
inuusan	a	None
inxiraaf	cheltuitor	Nan
iqtiyaar	facultativ	Nan
iraan	iran	None
iran	generaţie	Nan
internet	internet	None
international	internaţional	Nan
interference	amestec	None
interface	interfață	Nan
inqilaabkii	cupa	None
insaanka	omenire	Nan
insaykalobeedhiya	enciclopedie	Nan
insha	insha	Nan
insuliinka	insulină	Nan
inta	ce	None
intaa	plus	None
inqilaabka	stat	None
intaad	tu	None
intaas	acea	None
intaasi	acea	None
intaasoo	în	None
intaba	ambii	None
intay	ei	None
inteeda	ei	None
inteedii	restul	None
intaan	acest	None
goobo	cerc	None
goobihii	locații	None
goobeede	angro	Nan
doorkii	rol	None
dooro	selectați	Nan
doorroone	preferabil	Nan
doorsamaye	deschis	None
doorsan	selectat	Nan
doorshaane	alege	None
doortaa	alege	None
doortay	ales	None
doorteen	ales	None
doorto	alege	None
dooxa	vale	None
dooxada	valea	None
dooxadii	vale	None
doqon	prost	None
doqonniimo	nebunie	Nan
doorka	rol	None
dorraato	licitaţie	Nan
dooriyee	victorie	None
doorashooyinkii	alegerile	None
doono	voi	None
doonta	barcă	Nan
doontaa	căuta	None
doonto	voi	None
doonyaha	barci	Nan
door	rol	None
dooranayay	alegere	Nan
dooranayeen	selectare	Nan
doorashada	alegere	Nan
doorashadaas	acea	None
doorashadan	această	None
doorashadii	alegere	Nan
doorasho	alegere	Nan
doorashooyin	alegerile	None
doorashooyinka	alegerile	None
doorin	alege	None
dowlad	guvern	None
dowlada	guvern	None
dowladaha	guvernele	None
duduwan	iubitele	Nan
dufowdoo	dracu-l	Nan
dug	țâță	Nan
dugsi	şcoală	Nan
dugsiga	la	None
dugsigii	scoala	Nan
dugsiyada	școli	None
dugsiyo	școli	None
dugulka	şcoală	Nan
duhur	amiază	Nan
duhurkii	la	None
dukaan	magazin	None
dul	peste	None
dulka	suprafata	Nan
dulli	ruşine	Nan
duco	o	None
duceeyo	ruga	Nan
ducaynaa	ne	None
ducada	rugăciune	Nan
dowladahaas	respective	None
dowladda	guvern	None
dowladdii	guvern	None
dowladeed	guvern	None
dowladihii	guvernele	None
dowladii	guvern	None
dowlado	guvernele	None
doonno	vom	None
dowladood	guvernele	None
dowr	dowr	Nan
dr	dr	None
drs	drs	Nan
du	du	None
dubad	dreptunghiular	Nan
dubai	dubai	Nan
ducaadda	binecuvântare	Nan
download	descarca	Nan
dulliga	umilitor	Nan
doonnaaye	vom	None
doonistii	dorință	None
diyaaradaha	avioane	None
diyaaradeed	avion	None
diyaaradii	avionul	None
diyaaradood	avioane	None
diyaaraduhu	avioane	None
diyaarintii	preparare	Nan
diyaariyay	pregătit	None
diyaariyey	pregătit	None
diyaarka	gata	None
diyaradaha	avioane	None
djacday	șocat	Nan
djibouti	nou	None
do	do	None
doc	medic	None
doh	doh	Nan
diyaarada	avionul	None
dola	dolar	Nan
diyaar	gata	None
dit	dit	Nan
diri	a	None
dirir	ceartă	Nan
dirirayaashii	razboinicii	Nan
dirirka	ceartă	Nan
diriro	ceartă	Nan
dirirtii	luptă	None
diriyo	citate	None
dirkii	expediere	Nan
dirsaday	trimis	None
disc	disc	None
diseembar	decembrie	None
distoori	distoori	Nan
distoorkii	constitutia	Nan
distributed	distribuite	Nan
distuurka	constitutia	Nan
dix	dix	Nan
dominika	dominicana	Nan
doob	dob	Nan
doobcadale	alt	None
doona	căuta	None
doonaa	voi	None
doonaan	voi	None
doonaayey	dorit	None
doonan	căuta	None
doonay	dorit	None
doonaya	vrei	Nan
doonayaa	vrei	Nan
doonayeen	dorit	None
doonayo	vrei	Nan
dooneen	căutat	None
dooneyid	tu	None
dooneysaa	tu	None
doonin	căuta	None
dooninna	căutați-vă	Nan
doon	barcă	Nan
doolow	se contracta	Nan
doolo	ble	Nan
doollo	drojdie	Nan
doobi	căprioară	Nan
dooc	medic	None
dood	dezbate	Nan
dooda	dezbate	Nan
doodaan	argument	None
dooday	dezbătute	Nan
doodayaan	argumentand	Nan
doonka	barca	None
doodday	dezbătute	Nan
doodi	dezbate	Nan
doodo	dezbate	Nan
doofaar	porc	Nan
doog	iarbă	Nan
dooga	iarbă	Nan
doogsin	a	None
doojey	pisa	Nan
doodeen	susținut	None
dulmiga	asuprire	Nan
dulmiya	asupri	Nan
dulqaad	fii	None
eegayeen	in	None
eegayo	la	None
eegno	uite	Nan
eego	uite	Nan
eegto	uite	Nan
een	da	None
eersadaye	dumnezeu	None
eesan	mai	None
eey	câine	None
eeysan	câine	None
eg	de	None
egyihiin	ca	None
eheed	este	None
eheen	este	None
eheyd	era	None
eegay	privit	None
eight	opt	None
eegaayey	in	None
eeerland	interior	None
education	educaţie	Nan
ee	da	None
eebbaa	da	None
eebbaana	da	None
eebbaha	cap	None
eebbahay	meu	None
eebbana	nu	None
eebbe	dumnezeu	None
eebbow	sus	None
eebe	dumnezeu	None
eed	vină	None
eedaysay	acuzat	None
eedeeyay	acuzat	None
eedeeyey	acuzat	None
eedeyay	acuzat	None
eeg	uite	Nan
ekaa	despre	None
el	el	None
elarab	elarab	Nan
erayada	cuvinte	None
eraydan	cuvânt	None
erayga	cuvantul	Nan
eraygan	cuvânt	None
erega	ridicare	Nan
eretereya	joc	None
ereteriya	atlet	Nan
eretrie	eretrie	Nan
erey	un	None
ereyada	cuvinte	None
ereyga	cuvânt	None
ereygaasi	cuvânt	None
ergo	ergo	Nan
eriga	eriga	Nan
erigavo	erigavo	Nan
eray	cuvânt	None
eratiya	cuvânt	None
erataria	erataria	Nan
eratareya	cuvânt	None
elektrooniga	electronică	None
elements	element	None
elmi	elmi	Nan
email	e-mail	Nan
emailkiisa	lui	None
embedded	încorporat	Nan
en	ro	Nan
economy	economie	None
eng	eng	Nan
engineering	inginerie	Nan
engineerku	inginer	None
engiriiska	engleza	None
england	anglia	None
english	engleză	None
equipment	echipament	Nan
eraga	cuvânt	None
engineer	inginer	None
ebekargaab	des	None
ebbow	ebbow	Nan
eau	eau	Nan
dunuub	rid	Nan
duq	vechi	None
duqa	primar	None
duqayn	bombardament	Nan
duqeeyay	bombardat	Nan
duqsan	vechi	None
duqsansoomaalida	bărbos	Nan
duqsanwaxyaabaha	vechi	None
duray	injecţie	Nan
durba	deja	None
durbaan	tobă	Nan
durbadiiba	deja	None
durdur	un	None
durdurkii	curentul	None
during	parcursul	None
dunidda	lumea	None
dunidana	lumea	None
dunidalaakiin	lumea	None
dunida	lumea	None
dulqaadaan	fii	None
dultaagi	rezistă	Nan
dulucda	temă	None
dulugle	clovn	Nan
dumaal	cumnată	Nan
dumar	femei	None
dumarka	femei	None
durkoo	de	None
dumarkii	femei	None
dumey	dumey	Nan
dumin	depozit	Nan
duminayaa	demolat	Nan
dumis	demolare	Nan
dumiyo	distruge	None
dun	gustos	Nan
duni	lume	None
dumay	prăbușit	None
dirgen	dirgen	Nan
duruufaheeda	sale	None
duryaad	cețos	Nan
duullaankii	invazia	None
duumaa	butonul redare	Nan
duunyo	animal	None
duur	sălbatic	Nan
duurgalay	se încruntă	Nan
duurka	câmp	None
duwan	diferit	None
duwanaa	diferit	None
duwanyahay	diferit	None
dvdx	dvdx	Nan
e	e	None
each	fiecare	None
east	est	None
eastleigh	eastleigh	Nan
eastliegh	eastliegh	Nan
duulka	zbor	None
duuliyihii	pilotul	Nan
duuliye	pilot	Nan
duulay	zburat	Nan
dusha	suprafaţă	Nan
dusheeda	el	None
duub	rulou	Nan
duuban	înregistrate	None
duubay	înregistrate	None
duubi	înregistrare	None
duud	tufiș	Nan
duruufihii	împrejurări	Nan
duudka	în	None
duufaan	o	None
duug	vechi	None
duugey	îngropa	Nan
duugmay	uzat	Nan
duugta	masaj	Nan
duul	a	None
duulaan	a	None
duudsiiyey	demolat	Nan
direy	trimis	None
dirayoo	trimis	None
dirayay	trimitere	Nan
dhinacakale´shilinka	parte	None
dhinacba	altul	None
dhinaceeda	ei	None
dhinacyada	fete	None
dhinacyo	fete	None
dhinicii	lateral	Nan
dhintay	mort	None
dhinteen	morți	None
dhintey	decedat	None
dhinto	moare	None
dhir	pătrunjel	Nan
dhiraandhirinta	analize	None
dhiraha	plante	None
dhirindhireed	ierburi	Nan
dhirirka	înălţime	Nan
dhinacakale	parte	None
dhirirkeeda	sa	None
dhinaca	de	None
dhimatay	mort	None
dhiigii	sânge	None
dhiilka	ții	Nan
dhiillo	prostituată	Nan
dhiiragalin	a	None
dhiiri	a	None
dhiirigelin	a	None
dhiirigelisay	incurajata	Nan
dhiirri	a	None
dhikanyee	asa	None
dhiman	muri	None
dhimanayey	moarte	None
dhimane	muritor	Nan
dhimashadiisii	sa	None
dhimasho	moarte	None
dhimashooyin	decese	Nan
dhinac	latură	Nan
dhirta	plante	None
dhirtu	plante	None
dhis	construi	None
dhisteen	construit	None
dhixine	te	None
dhoho	spune	None
dhooble	zâmbet	Nan
dhoobo	noroi	Nan
dhoof	naviga	Nan
dhoofin	export	None
dhoofiska	exporturi	Nan
dhoofista	exporturi	Nan
dhoofiyaa	exportate	Nan
dhoofiyo	exporturi	Nan
dhool	zâmbet	Nan
dhoore	cerb	Nan
dhow	închide	None
dhowaaneynaa	curând	None
dhistay	construit	None
dhiso	construi	None
dhisnayd	construit	None
dhisnaa	construit	None
dhisaan	construi	None
dhisaayeen	o	None
dhisan	structurate	Nan
dhisay	construit	None
dhiseen	au	None
dhisida	clădire	None
dhisin	construi	None
dhiigga	sânge	None
dhisitaan	construieste	Nan
dhiska	constructie	Nan
dhismaha	constructie	Nan
dhismayaal	clădiri	None
dhismayaasha	clădiri	None
dhisme	clădire	None
dhismihii	clădirea	None
dhismo	constructie	Nan
dhisitaankii	construcția	None
dhiig	sânge	None
dhiibid	predare	None
dhiibi	predare	None
dhexdeeda	în	None
dhexdhexaad	neutru	None
dhexdhexaadinta	mediere	Nan
dhexdiisa	în	None
dhexdooda	ei	None
dhexe	central	None
dhexeeya	între	None
dhexeysa	intre	None
dhexmara	prin	None
dhexmaray	întrerupt	Nan
dhextaala	mijlocul	None
dhib	bucluc	Nan
dhibaatada	problema	None
dhibaatadii	problema	None
dhibaato	problemă	None
dhexda	mijloc	None
dhexaysa	intre	None
dhexadka	mijloc	None
dhexaad	neutru	None
dheereeyo	înălţime	Nan
dheereshiinehaabiilhabane	fluiditate	Nan
dheereyn	extensie	Nan
dheereynayaa	prelungit	Nan
dheerka	plus	None
dheg	ureche	None
dhegaha	urechi	Nan
dhibaatooyin	probleme	None
dhegan	blocat	Nan
dhegtay	ureche	None
dheh	spune	None
dheheen	zis	None
dherer	lungime	None
dhererkiisu	lungime	None
dhererkoodu	lor	None
dhex	mijloc	None
dhegen	băț	Nan
dhowdahay	de	None
dhibaatooyinka	probleme	None
dhibay	deranjat	Nan
dhigeen	stabilite	None
dhigeendhulka	jucăria	Nan
dhigey	stabilite	None
dhigi	fă-o	Nan
dhigin	pune	None
dhignaa	admise	Nan
dhigo	stabilit	None
dhigtan	asta	None
dhigtay	stabilite	None
dhigteen	jos	None
dhigto	parc	None
dhihi	spune	None
dhiib	renunta	Nan
dhiibay	restituite	Nan
dhiibayaa	predându-l	Nan
dhigaysa	pune	None
dhigayo	stabilite	None
dhigaye	peste	None
dhigaya	pune	None
dhibi	deranja	Nan
dhibina	te	None
dhibka	problema	None
dhibkii	problema	None
dhiblaawe	fără	None
dhibta	problema	None
dhici	toamna	None
dhibaatooyinkii	probleme	None
dhicin	toamna	None
dhicisoobay	avort	Nan
dhiga	pune	None
dhigaa	stabilit	None
dhigaan	pune-l	Nan
dhigan	parc	None
dhigateene	acesta	None
dhigay	stabilit	None
dhicine	expira	Nan
ertariya	eritreea	Nan
dhowna	de	None
dhowree	proteja	None
diinle	deinle	Nan
diinsoor	dynsoor	Nan
diinta	religie	None
diintaas	religie	None
diintan	asta	None
diintana	credință	None
diinteena	noastră	None
diintiisa	lui	None
diintooda	lor	None
diintoodii	lor	None
diintu	religia	None
diintuna	ieșitură	Nan
diiqsan	deprimat	Nan
diir	pieliță	Nan
diiraabay	incalzit	Nan
diinka	religie	None
diiran	cald	None
diiniga	religia	None
diine	diine	Nan
diide	refuza	Nan
diideen	respins	None
diidey	respins	None
diidmada	obiecția	Nan
diido	întoarce-te	Nan
diidoo	refuza	Nan
diidye	refuză	None
diif	diph	Nan
diifta	difterie	Nan
diimaha	religii	None
diimeedka	religios	None
diimo	religii	None
diimood	credinţă	Nan
diimuqraadiga	democratic	None
diin	religie	None
diini	decan	Nan
diiray	cojit	Nan
diiriye	confuz	Nan
diirka	pieliță	Nan
dimuqaraadiga	democraţie	Nan
dimuqraadiga	democratic	None
dimuqraadiyada	democraţie	Nan
dimuqraadiyadda	democraţie	Nan
dimuquraadi	democraţie	Nan
dimuquraadiya	democraţie	Nan
dimuquraadiyada	democraţie	Nan
dininig	dininig	Nan
dir	trimite	None
diraa	trimis	None
diraac	tocană	Nan
diraacoode	departe	None
diraan	trimite	None
diran	deranjat	Nan
diray	trimis	None
dimoqaraadiyadda	democraţie	Nan
dimishiq	democraţie	Nan
dilo	ucide	None
dillapress	dillapress	Nan
diirki	pieliță	Nan
diiro	concentra	Nan
diirsado	încălzire	None
dil	crimă	None
dila	comerciant	Nan
dilaa	ucide	None
dilaan	omoara-l	Nan
diiddo	refuza	Nan
dilay	ucis	None
dileen	ucis	None
diley	ucis	None
dilkii	crimă	None
dilkiisa	lui	None
dilku	crimă	None
dilla	cracked	Nan
dillaaco	fisuri	Nan
dilaye	comerciant	Nan
diidday	respins	None
diidayaana	negă-l	Nan
diidayaa	refuză	None
dhulkan	pământ	None
dhulkeeda	său	None
dhulkii	pământul	None
dhulkiisaa	său	None
dhulku	pământul	None
dhulwaynaha	continent	None
dhunkaal	un	None
dhuraye	cascadă	Nan
dhuub	subţire	Nan
dhuumasho	ascunzatoare	Nan
dhuunta	gât	None
dhuurta	padurea	Nan
dhuusamareeb	miezul	None
dhuux	măduvă	Nan
dhuwan	ascunde	None
dhulkaas	aceea	None
dhulkaan	pământ	None
dhulkaa	pământul	None
dhulka	pământul	None
dhowrsada	datoria	None
dhowrsan	protejat	Nan
dhowrsana	datoria	None
dhubato	scuipat	Nan
dhuftay	lovit	None
dhufteen	lovit	None
dhul	pământ	None
dhuxul	cărbune	None
dhulaka	teren	None
dhulalkii	ținuturile	None
dhulbahante	pământ	None
dhulbaisaguna	pământul	None
dhulbeereedka	peisajul	None
dhuleed	pământ	None
dhulgariir	cutremur	None
dhulgariirka	cutremur	None
dhulalka	ținuturile	None
dhowr	mulți	None
dhuxusha	cărbune	None
diabetes	diabet	Nan
difaacaya	apărarea	None
different	diferit	None
digfeer	săpător	Nan
digil	digil	Nan
digilmirifle	digilmirifle	Nan
digir	fasole	Nan
digirta	fasole	Nan
digital	digital	None
digniin	avertizare	Nan
digo	digera	Nan
dihine	dihine	Nan
dii	c	None
diid	respins	None
diidana	respinge-l	Nan
diiday	respins	None
difaacay	apărat	None
difaaca	apărare	None
didsaday	întors	None
diday	ascuțit	Nan
diakonia	diaconeasă	Nan
dib	înapoi	None
dibad	afară	None
dibada	mări	None
dibadda	afara	None
dibadiisa	afara	None
dibedda	afara	None
di	fi	None
dibeddaba	liber	None
dibi	bou	Nan
dibna	nou	None
dibnahayga	meu	None
dibu	bou	Nan
dibuga	vițel	Nan
dibugu	taur	Nan
dibuheshiisiinta	reconciliere	Nan
dibeddu	afara	None
eryada	urmarire	Nan
eryaday	urmărit	None
eryay	respins	None
galiyo	in	None
galka	în	None
galkacyo	galoane	Nan
galleyda	porumb	None
galmaax	galon	Nan
galmoodka	sex	None
galo	în	None
galow	intra	None
gambia	gambia	Nan
ganac	comercial	None
ganacasade	comerciant	Nan
ganacsade	comerciant	Nan
ganacsan	tranzacționate	Nan
ganacsatada	comercianți	Nan
ganacsato	comercianți	Nan
galiyey	infuzie	Nan
ganacsi	afaceri	None
galiyaan	in	None
galinsoor	inserare	Nan
galbeedkana	vest	None
galbeedkenya	vest	None
galbeedku	vest	None
galbeedna	vest	None
galdogob	porţelan	Nan
galeen	în	None
galeeyda	mea	None
galeyda	porumb	None
galgaduud	mure	Nan
galguduud	crawl	Nan
gali	introduce	None
galin	in	None
galinayo	inserat	Nan
galinaysaa	inserat	Nan
galine	galine	Nan
galisay	inserat	Nan
ganacsiga	afaceri	None
ganacu	comercial	None
gandi	regulă	None
garbihiisa	pe	None
gardhaale	controversat	None
gardheere	fictiv	Nan
gargaar	ajutor	None
gargaaray	asistată	Nan
gargaarka	relief	None
gariis	răguşit	Nan
garjante	garjante	Nan
garoomada	aeroporturi	None
garoomaha	mirele	Nan
garoon	stadiu	None
garoonka	stadionul	None
garoonkaan	aeroport	None
garoowe	garowe	Nan
garowe	mulțumesc	Nan
garbahaarey	la	None
garbaha	umeri	Nan
garatay	tu	None
garasho	realize	Nan
ganey	a	None
gar	gar	Nan
garaacay	bate	Nan
garaaco	bătăi	Nan
garaad	intelect	Nan
garaadka	intelect	Nan
garab	umăr	Nan
galbeedka	vest	None
garabsocday	de	None
garadag	celebru	None
garadba	a	None
garan	ști	Nan
garanayn	nu	None
garanayo	ști	Nan
garansiiyo	ajutor	None
garashada	percepţie	Nan
garad	tu	None
galbeeditoobiya	vestul	None
galbeed	vest	None
galbe	vest	None
gabayle	poet	None
gabayo	poem	None
gabdhaha	fete	None
gabdhahooda	lor	None
gabdhihii	fiice	None
gabdhood	fiice	None
gabdhoodna	lor	None
gabeyre	poet	None
gabi	complet	None
gabiahaanba	acestea	None
gabiley	gorilă	Nan
gabownimadii	la	None
gabyaa	poetul	None
gabyaagii	poetul	None
gacal	dragă	Nan
gabaygu	poemul	None
gabaygii	poetul	None
gabayga	poemul	None
gabayadiisa	sale	None
gaarsiinta	livrare	Nan
gaarsiisan	ajunge	None
gaarsiiyey	transportat	Nan
gaarsiyeyna	transportat	Nan
gaashaaman	scutul	None
gaashaan	scut	None
gaashaanbuurta	alianta	Nan
gacan	mână	None
gaashaandhiga	apărare	None
gaashaanle	un	None
gabadh	fiică	None
gabadha	fata	None
gabadhii	fata	None
gabanka	afirmație	Nan
gabar	fată	None
gabay	cântec	None
gaashaanka	scutul	None
garre	garre	Nan
gacanka	golful	None
gacanta	mână	None
galaa	intră	None
galaal	pliant	Nan
galaan	introduce	None
galab	după	None
galabsan	această	None
galabtaas	această	None
galadaystay	dus	None
galaddiisu	lui	None
galay	în	None
galayda	porumb	None
galaydh	porumb	None
galaye	introduce	None
galayno	ne	None
galayr	galoane	Nan
galbaday	după	None
gala	introduce	None
gal	buturuga	Nan
gaheyrkuliyada	geologie	Nan
gaheyr	gaheyr	Nan
gacantiisa	lui	None
gacmaha	mâini	Nan
gacmeedyo	mâini	Nan
gacmood	mâini	Nan
gadaal	mai	None
gadaashiiye	spate	None
gadabuursi	înapoi	None
gacansiiyo	ajutor	None
gadabuursiga	spate	None
gaday	cumparat	Nan
gadaye	scaune	Nan
gadiid	a	None
gadiidka	transport	None
gadisan	pat	Nan
gado	moştenire	Nan
gaduud	roșu	None
gadabuursigu	curtea	None
gaaro	ajunge	None
garsoor	judecător	Nan
garsoorka	judecatorul	Nan
goa	goa	Nan
goaan	decizie	None
goaankanna	decizie	None
goaansaday	hotărât	None
goaansadeen	hotărât	None
goan	bucată	None
goay	goay	Nan
gob	îmbucătură	Nan
gobalada	regiuni	None
gobaleedka	regional	None
gobalka	regiune	None
gobanimo	independenţă	Nan
gobanimodoonka	gobannoodon	Nan
gobol	regiune	None
gobola	regiuni	None
go	merge	None
gobolada	regiuni	None
gmsk	gmsk	Nan
glay	glay	Nan
geography	geografie	None
georges	georges	None
geri	grătar	Nan
geyiga	acasa	Nan
geysatay	comise	None
geystey	comise	None
ghazi	organiza	None
gidaar	acasă	None
gidir	acasă	None
giinbaarta	inhala	Nan
giriig	greacă	None
giriiga	greacă	None
giriigga	greacă	None
giriigii	greacă	None
giscard	giscard	Nan
global	global	None
goboladan	regiuni	None
goboladii	regiunile	None
goboleed	regional	None
godka	pestera	Nan
godod	zeiţă	Nan
goeen	a	None
goii	goii	Nan
goin	intra	None
golaha	consiliu	None
goleey	gole	Nan
golihii	consiliul	None
golis	golis	Nan
gollaha	consiliu	None
gololeey	mea	None
goo	a	None
goob	locație	Nan
goobaha	locații	None
goobanimo	cerc	None
godey	domnului	None
godeey	dumnezeu	None
goday	mulțumiri	Nan
godan	gol	None
goboleedka	regional	None
gobolka	regiune	None
gobolkaan	regiune	None
gobolkan	regiune	None
gobolkani	regiune	None
gobolkasta	stare	None
gobolkii	regiunea	None
gens	gens	Nan
gobolku	statul	None
gobolladii	regiuni	None
gobolo	regiuni	None
gobonidoon	gobonidoon	Nan
gobonimo	independenţă	Nan
gobonnimada	suveranitate	Nan
gobroon	goron	Nan
god	gaură	None
gobollada	regiuni	None
generation	generaţie	Nan
generalka	ansamblu	None
general	general	None
gaystay	comise	None
gbanaadir	popular	None
gebi	totul	None
gedisan	distală	Nan
gedo	tunde	Nan
gedoshabeelaha	tractorul	Nan
geed	copac	Nan
geedaha	copaci	Nan
geeddi	proces	None
geedi	copac	Nan
geedka	planta	Nan
geedkii	copacul	Nan
geedo	ierburi	Nan
geel	cămilă	Nan
geela	cămilă	Nan
gaysay	livrat	Nan
gaysatay	atins	None
gayiga	homosexual	Nan
gawracii	abatorizare	Nan
gartada	realizeaza	Nan
gartay	înțeles	None
garto	recunoaște-l	Nan
garyaqaan	avocat	None
garçon	ghirlanda	Nan
gashaa	intra	None
gashaandhiga	scut	None
geelii	cămila	Nan
gashay	intrat	None
gates	porti	Nan
gateyba	portal	None
gato	cumpără	Nan
gauda	gâfâi	Nan
gaule	gaule	Nan
gaulle	galele	Nan
gaussian	gaussian	Nan
gashiyo	păr	None
garsoore	judecător	Nan
geeliisii	cămilă	Nan
geella	cămilă	Nan
geeyo	adu-l	Nan
gelaya	intrare	None
geledi	geled	Nan
geli	autentificare	Nan
gelin	in	None
gelinta	inserare	Nan
gelisay	inserat	Nan
geliya	în	None
geliyaan	in	None
geliyay	inserat	Nan
geliyeen	in	None
geliyo	inserat	Nan
gelle	galeră	Nan
gelyo	nuanțe	None
gen	gen	None
geeyey	livrat	Nan
geeyay	livrat	Nan
geeyaa	adu-l	Nan
geesteen	impotriva noastra	Nan
geelle	cămilă	Nan
geelo	cămilă	Nan
geelu	cămilă	Nan
geeri	moarte	None
geerida	moarte	None
geeridii	moarte	None
geerisa	moarte	None
geelka	cămilă	Nan
geeriyooday	decedat	None
geeriyoodey	decedat	None
geeriyootay	decedat	None
gees	margine	Nan
geesi	engleză	None
geesinimo	curaj	Nan
geesiyaashii	eroii	Nan
geeska	colţ	Nan
geeriyoodeen	murit	None
dheeraasamaale	lung	None
gaarkiisa	lui	None
gaarin	acces	None
fara	începe	None
faraaciinta	propria	None
faraana	meu	None
farabadan	mulți	None
farac	sămânță	Nan
faragelin	interfera	Nan
farah	departe	None
faraha	degete	Nan
faransiis	franceza	None
faransiisk	franceza	None
faransiiska	franceza	None
faransiisku	franceza	None
faras	cal	None
faraska	calul	None
faraskii	calul	None
far	departe	None
farasku	tău	None
faqiiq	clauză	Nan
faqi	îngust	Nan
falanqayno	discuta	Nan
falastiin	palestina	None
falastiiniyiintu	palestinienii	Nan
fale	ţiglă	Nan
faleedka	ţiglă	Nan
falidda	cultivare	Nan
falka	actul	None
falkaab	acțiune	None
fanaan	artist	None
fanaanad	ventilator	Nan
fanaaniinta	artiști	None
fanansuwela	extravagant	Nan
fanka	artă	None
faqashta	leșin	Nan
faqay	șoptit	Nan
faqiih	faqih	Nan
farax	fericit	None
faraxsan	fericit	None
faraxsanahay	fericit	None
farshaxanka	artă	None
farta	deget	Nan
farxad	fericire	Nan
farxeen	bucurat	None
farxiyo	plăcere	None
fasax	părăsi	Nan
fashilmay	eșuat	None
fasir	interpreta	None
fasirtada	interpretare	None
faso	trece	None
father	tată	None
feb	feb	Nan
febayaa	contagios	Nan
febraayo	februarie	None
february	februarie	None
farshaxan	artă	None
farsamo	tehnic	None
farsamada	tehnologie	None
farraaciintii	conduite	Nan
faray	departe	None
farayso	directed	Nan
farcanmeen	sămânță	Nan
fardaha	cai	None
fardo	cai	None
fariin	mesajul	None
fariistay	retras	None
falalka	acţiuni	Nan
fariisto	așezați-vă	Nan
farmaajo	brânză	Nan
farnnsiisku	farnishness	Nan
farnsiiku	congelare	Nan
farnsiiska	franceza	None
farnsiisku	franceza	None
faro	deget	Nan
farqi	diferență	None
farlibaax	a	None
falal	acţiuni	Nan
falaha	fabricantul	Nan
falaa	fă-o	Nan
f	f	Nan
faadir	bun	None
faadumo	flux	None
faafay	răspândire	None
faafinta	diseminare	Nan
faafiyeen	diseminate	Nan
faafiyey	propagate	Nan
faago	bun	None
faah	detalii	None
faahfaahsan	detaliat	Nan
faaiidada	avantaj	None
faaiido	câştig	Nan
faaloota	cometariu	Nan
faano	glorie	None
faanoole	boxer	Nan
eyl	eyl	Nan
ey	ey	Nan
external	extern	None
express	expres	None
eryey	respins	None
es	es	Nan
esperanto	esperanto	Nan
estoniya	estonia	None
et	et	Nan
ethiopa	ethiopa	Nan
ethiopia	etiopia	None
faanto	fanfaronadă	Nan
ethopia	ethopia	Nan
etoobiya	etiopia	None
europe	europa	None
european	european	None
ex	fără	None
example	exemplu	None
exchange	schimb	None
explorer	explorator	Nan
ethopiakenya	ethopiakenya	Nan
federaal	federal	None
faarax	a	None
faatikaan	context	None
fadligeeda	ei	None
fahamka	înţelegere	Nan
fahamno	a	None
fahmaan	a	None
fahmay	înțeles	None
fahmeen	înțeles	None
fahmeyna	înțelege-ne	Nan
fahmeynaa	înțelegem	Nan
fahmi	a	None
fahmin	nu	None
fahmo	a	None
faisal	faisal	Nan
fakaday	scăpat	None
fakerayey	imaginat	Nan
fal	act	None
fadliga	graţie	Nan
fadlan	vă	None
fadhiyey	sat	None
fadhiyay	statea	Nan
faatikanaka	autograf	Nan
faatikanka	tactică	Nan
faca	potroace	Nan
faculty	facultate	Nan
facween	facween	Nan
fadal	moft	Nan
fadhida	jos	None
faarisiyiinta	fariseii	Nan
fadhido	așezați-vă	Nan
fadhiisimo	îngheţa	Nan
fadhiistay	așezat	None
fadhiisto	așezați-vă	Nan
fadhino	așezați-vă	Nan
fadhiso	așezați-vă	Nan
fadhiya	aşezat	Nan
fadhiyaa	aşezat	Nan
fadhiisan	așezați-vă	Nan
gaarka	privat	None
federaalka	federal	None
fekaray	gând	Nan
fuula	departe	None
fuulay	urcat	None
fuuli	a	None
g	g	None
ga	trebuie	None
gaab	de	None
gaabaha	pantaloni scurti	Nan
gaaban	de	None
gaabiyaa	încet	None
gaabiyo	încet	None
gaacuur	cerb	Nan
gaadha	ajunge	None
gaadhaa	ajunge	None
gaadhay	atins	None
gaadhaya	ajungând	None
future	viitor	None
gaadhayaan	ajunge	None
fursadaha	oportunități	Nan
furqaan	brazdă	Nan
fudud	simplu	None
fududaanta	simplitate	Nan
fududeeyay	înlesnite	Nan
fulay	fricos	Nan
fuley	tuse	Nan
full	deplin	None
fura	descoperi	Nan
furaat	cheia	Nan
furaha	cheia	Nan
furan	deschis	None
furay	deschis	None
furayaasha	chei	Nan
furayo	deblocări	Nan
fureen	floarea	None
furo	deschis	None
fursad	oportunitate	Nan
gaadhayo	ajunge	None
gaadhaysaa	întinde	None
gaadheen	atins	None
gaandi	gasca	Nan
gaar	privat	None
gaara	ajunge	None
gaaraa	ajunge	None
gaaraayo	ajungând	None
gaarane	întinde	None
gaaray	atins	None
gaaraya	ajunge	None
gaarayaan	ajunge	None
gaarayo	ajungând	None
gaareen	atins	None
gaareeso	întinde	None
gaarey	atins	None
gaareysa	ajungând	None
gaari	vehicul	None
gaalo	infideli	Nan
gaalkacyo	infideli	Nan
gaalkacayo	necredincios	Nan
gaalkaan	acest	None
gaadhin	neatins	Nan
gaadho	ajunge	None
gaadhsiinayeen	transmite	None
gaadhsiinlahayd	întinde	None
gaadhsiisanayd	atins	None
gaadhsiisnayd	atins	None
gaadhsiiya	transmite	None
from	din	None
gaadhsiiyaan	transmite	None
gaadiid	transport	None
gaadiidka	trafic	None
gaagaaban	scurt	None
gaajo	foame	Nan
gaal	necredincios	Nan
gaalada	infidelii	Nan
gaaljecel	slab	None
gaadhsiiyey	transportat	Nan
friesland	friesland	Nan
frequency	frecvență	None
free	liber	None
fiidshe	de	None
fiil	priza	Nan
fiiq	ascuțit	Nan
fiiri	uite	Nan
fiirino	sus	None
fiiriyo	uite	Nan
fiiro	uite	Nan
fikrad	idee	None
fikrada	gând	Nan
fiktoriya	gând	Nan
filaan	brusc	None
filaanka	blițul	Nan
filaayaa	așteptat	None
filan	destul	None
filayo	așteptat	None
fiidow	seară	None
fiid	seara	None
fiicanna	bun	None
fiican	bun	None
femmes	femmes	Nan
ferde	ferde	Nan
feysal	fişier	Nan
ficil	acțiune	None
ficilku	acțiune	None
fiday	răspândire	None
fideen	împrăștiat	Nan
fileyn	neașteptat	Nan
fidin	răspândire	None
fidinta	întindere	None
fiditaankii	răspândirea	None
fidiyey	întins	None
fido	fido	Nan
fidsan	apartament	Nan
fidsantahay	apartament	Nan
field	camp	Nan
fidinka	răspândire	None
feerfeer	boxer	Nan
fille	decapitat	Nan
filmada	filme	None
fool	față	None
foolka	față	None
foolmaroodi	fildeş	Nan
foore	închină-te	Nan
for	pentru	None
forces	forţele	Nan
forgotten	uitat	None
form	formă	None
four	patru	None
franchwadnkan	această	None
fransiiska	franța	None
fransiisku	francisco	None
français	français	Nan
françois	françois	None
frasiiska	frecare	None
foodhida	cries	Nan
fogfog	departe	None
fogeyn	distanțe	None
fogeeyaan	pune	None
filmaha	filme	None
finland	finlanda	None
finnishakana	finlandezii	Nan
fiqi	teologie	Nan
fiqiga	teologie	Nan
fircoon	activ	None
firefox	firefox	None
film	film	None
firfircoon	activ	None
firkoodi	împrăștia	Nan
first	primul	None
fog	departe	None
fogaa	departe	None
fogaadaa	evita-l	Nan
fogaado	abtinere	Nan
fogaayeene	departe	None
firfircooni	activ	None
يوسف	يوسف	Nan
