ab	ab	Nan
pund	iwon	Nan
punk	pọnki	Nan
punkt	ojuami	Nan
punkten	ojuami	Nan
punkter	awọn aaye	Nan
purple	elese	Nan
puls	polusi	Nan
pythagoras	pythagoras	Nan
pär	ileke	Nan
på	loju	Nan
påbörjade	bẹrẹ	Nan
påbörjades	bẹrẹ	Nan
påbörjas	berè	Nan
påföljande	atẹle	Nan
päls	àwáàrí	Nan
puerto	puerto	Nan
pucken	awọn puck	Nan
publik	jepe	Nan
psykologin	oroinuokan	Nan
psykologisk	oroinuokan	Nan
psykologiska	oroinuokan	Nan
psykos	psychosis	Nan
psykosen	psychosis	Nan
psykoser	psychoses	Nan
psykoterapi	ẹkọ-adaṣe	Nan
psykotiska	alamọdaju	Nan
publicera	jade	Nan
publicerad	atejade	Nan
publicerade	atejade	Nan
publicerades	atejade	Nan
publiceras	atejade	Nan
publicerat	atejade	Nan
publiceringen	te	Nan
pågick	lọ	Nan
psykologi	oroinuokan	Nan
pågående	ti nlọ lọwọ	Nan
påminde	ranleti	Nan
påverkat	fowo	Nan
påverkats	fowo	Nan
påvisa	ṣafihan	Nan
q	q	Nan
queen	ayaba	Nan
queens	awọn ayaba	Nan
påverkas	fowo	Nan
rachel	rakeli	Nan
rad	kana	Nan
radie	ologbo	Nan
radikala	ti ipilẹṣẹ	Nan
radikalt	ti ipilẹṣẹ	Nan
radio	redio	Nan
radioaktiva	ohun ipanilara	Nan
rachels	rakeli	Nan
påverkar	kan	None
påverkan	ikolu	Nan
påverkades	fowo	Nan
påminner	rannileti	Nan
påsk	ajinde	Nan
påsken	ajinde	Nan
påstod	so	None
påstådda	esun	Nan
påstående	alaye	Nan
påståenden	nperare	Nan
påstår	awọn ipinlẹ	Nan
påstås	titẹnumọ	Nan
påtagligt	ti samisi	Nan
påtryckningar	titẹ	Nan
påven	pope	Nan
påverka	kan	None
påverkad	fowo	Nan
påverkade	fowo	Nan
pågår	amẹríkà	Nan
psykiskt	ọpọlọ	Nan
psykiska	ariran	Nan
psykisk	oroinuokan	Nan
produceras	produced	None
producerat	produced	None
producerats	produced	None
produkt	ọja	Nan
produkten	ọja	Nan
produkter	awọn ọja	Nan
producerar	producing	Nan
produktion	gbóògì	Nan
produktiv	iṣelọpọ	Nan
professionell	ọjọgbọn	Nan
professionella	ọjọgbọn	Nan
professor	alamọdaju	Nan
professorn	alamọdaju	Nan
profet	woli	Nan
produktionen	gbóògì	Nan
producerades	produced	None
producerade	produced	None
producerad	produced	None
privata	ikọkọ	Nan
privatliv	asiri	Nan
privilegier	awọn anfani	Nan
privilegium	àǹfààní	Nan
problem	iṣoro	Nan
problemen	awọn iṣoro	Nan
problemet	iṣoro naa	Nan
procent	ogorun	Nan
process	ilana	None
processen	ilana	None
processer	ilana	None
producent	aṣelọpọ	Nan
producenten	aṣelọpọ	Nan
producenter	ti onse	Nan
producera	mu jade	Nan
profeten	woli	Nan
profeter	woli	Nan
profil	profaili	Nan
programledare	agbalejo	Nan
protoner	awọn protons	Nan
prov	apẹẹrẹ	Nan
provins	agbegbe	Nan
provinsen	agbegbe	Nan
provinser	agbegbe	Nan
provinserna	agbegbe	Nan
provisoriska	ipese	Nan
prägel	fọwọkan	Nan
präglad	ijuwe	Nan
präglade	ijuwe	Nan
präglades	ti ijuwe	Nan
präglas	ijuwe	Nan
präglats	ijuwe	Nan
präster	àlùfáà	Nan
ps	ps	Nan
protokoll	ilana	None
radioaktivt	ohun ipanilara	Nan
protesterna	awọn ehonu	Nan
protester	awọn ehonu	Nan
programmet	eto naa	Nan
programvara	sọfitiwia	Nan
projekt	ise agbese	Nan
projektet	ise agbese	Nan
prokaryoter	prokaryotes	Nan
promemoria	ami iranti	Nan
propaganda	ete ti	Nan
proportioner	ipin	None
prosa	prose	Nan
protein	amuaradagba	Nan
proteiner	awọn ọlọjẹ	Nan
proteinerna	awọn ọlọjẹ	Nan
proteinet	amuaradagba	Nan
protestanter	alatẹnumọ	Nan
protestantiska	alatẹnumọ	Nan
protesterade	fi	None
privat	ikọkọ	Nan
radion	redio	Nan
ragnar	ragnar	Nan
reglerna	ofin	None
regn	ojo	None
regnar	ojo	None
regnskog	ojo	None
reguljära	deede	Nan
reidar	reidar	Nan
regleras	dari	Nan
reidars	awọn olutọsọna	Nan
reklam	ipolowo	Nan
reklamen	ipolowo	Nan
rekord	igbasilẹ	Nan
rekordet	igbasilẹ	Nan
relaterade	ti o ni ibatan	Nan
relation	ibatan	Nan
reinfeldt	reinfeldt	Nan
reglerar	fiofinsi	Nan
reglera	fiofinsi	Nan
regler	ilana	None
regi	iforukọsilẹ	Nan
regim	ijọba	Nan
regimen	ijọba	Nan
regimer	awọn akoko ijọba	Nan
region	ẹkùn	Nan
regional	agbegbe	Nan
regionala	agbegbe	Nan
regionalt	agbegbe	Nan
regionen	ẹkùn	Nan
regioner	awọn ẹkun ni	Nan
regionerna	awọn ẹkun ni	Nan
regisserad	dari	Nan
regissör	oludari	Nan
regissören	oludari	Nan
registrerade	ti o gbasilẹ	Nan
relationen	ibatan	Nan
reggaen	reggae	None
relationer	awọn ibatan	Nan
relativa	ibatan	Nan
reportrar	awọn onirohin	Nan
representant	aṣoju	Nan
representanter	awọn aṣoju	Nan
representanthuset	awọn aṣoju	Nan
representation	oniduro	Nan
representativ	aṣoju	Nan
reologi	rheology	Nan
representera	aṣoju	Nan
representerar	aṣoju	Nan
representeras	aṣoju	Nan
reptiler	reptiles	Nan
republik	olominira	Nan
republika	republika	Nan
republikanska	oloṣelu ijọba olominira	Nan
representerade	aṣoju	Nan
rené	rené	Nan
renässansen	renesansi	Nan
renässans	renesansi	Nan
relativt	jo	None
releasedatum	tu silẹ	Nan
religion	ẹsin	Nan
religionen	ẹsin	Nan
religionens	ẹsin	Nan
religioner	awọn ẹsin	Nan
religionerna	awọn ẹsin	Nan
religionsfrihet	ẹsin	Nan
religiös	ẹlẹsin	Nan
religiösa	ẹlẹsin	Nan
religiöst	ẹlẹsin	Nan
remmer	remmer	Nan
ren	mọ	Nan
rena	mọ	Nan
rent	odasaka	Nan
relationerna	ẹbí	Nan
reggae	reggae	None
regeringstid	jọba	Nan
regeringsmakten	ijọba	Nan
rasade	wó lulẹ	Nan
rasen	ajọbi	Nan
raser	meya-ije	Nan
rasism	ẹlẹyamẹya	Nan
rastafari	rastafari	Nan
rastafarianer	rastafarianer	Nan
ras	ije	None
rastafarianerna	isinmi faria jẹ	Nan
reagans	reagan	Nan
reagera	fesi	Nan
reagerar	fesi	Nan
reaktion	ifura	Nan
reaktionen	ifura	Nan
reaktioner	awọn aati	Nan
reagan	reagan	Nan
rapporterar	awọn ijabọ	Nan
rapporterade	royin	Nan
rapporter	awọn ijabọ	Nan
raid	raidi	Nan
rainbow	bowgùṣàn	Nan
rak	taara	Nan
raka	taara	Nan
rakt	taara	Nan
ramadan	ramadan	None
ramel	fireemu	Nan
ramels	awọn rameli	Nan
ramen	ilana	None
rammstein	rammstein	Nan
rankas	ipo	None
rankning	ipo	None
rankningar	ipo	None
rapport	ijabọ	Nan
rapporten	ijabọ	Nan
reaktionerna	awọn aati	Nan
reaktorer	awọn ololufẹ	Nan
reaktorn	riakito	Nan
realiteten	rere	None
reformer	awọn atunṣe	Nan
regel	ṣàkóso	Nan
regelbunden	deede	Nan
regelbundet	nigbagbogbo	Nan
regelbundna	deede	Nan
regeln	ṣàkóso	Nan
regent	regent	Nan
regenter	awọn ololufẹ	Nan
regerade	ṣàkóso	Nan
regerande	ṣàkóso	Nan
regering	ijọba	Nan
regeringar	awọn ijọba	Nan
regeringen	ijọba	Nan
regeringens	ijọba	Nan
regeringschef	ijọba	Nan
reformationen	atunformatione	Nan
rafael	rafael	Nan
reform	atunṣe	Nan
referenser	awọn itọkasi	Nan
rebecca	rebeka	Nan
recensioner	agbeyewo	Nan
receptorer	awọn olugba	Nan
red	ed	Nan
reda	wa	Nan
redaktör	olootu	Nan
redan	tẹlẹ	Nan
rede	itẹ-ẹiyẹ	Nan
rederiet	kekere	None
redo	ṣetan	Nan
redovisas	royin	Nan
redskap	jia	Nan
reducera	din	None
reduktion	idinku	Nan
referens	itọkasi	Nan
refererar	tọka	Nan
pristagare	laureate	Nan
prisma	ẹṣẹ	Nan
priset	owo	Nan
personerna	eniyan	Nan
personlig	ti ara ẹni	Nan
personliga	ti ara ẹni	Nan
personligen	tikalararẹ	Nan
personlighet	eniyan	Nan
personlighetsstörning	eniyan	Nan
personer	eniyan	Nan
personlighetsstörningar	ihuwasi eniyan	Nan
persons	eniyan	Nan
perspektiv	irisi	None
persson	persson	Nan
peru	perú	Nan
peruanska	ara ilu peruvian	Nan
pest	kokoro	Nan
personligt	tikalararẹ	Nan
personens	eniyan	Nan
personen	eniyan	Nan
personalen	oṣiṣẹ	Nan
perioden	akoko	Nan
perioder	awọn akoko	Nan
periodiska	igbakọọkan	Nan
periodvis	lorekore	Nan
permanent	titilai	Nan
permanenta	titilai	Nan
pernilla	pernilla	Nan
perro	perro	Nan
perry	perry	Nan
persbrandt	persbrandt	Nan
perserna	páṣíà	Nan
persien	páṣíà	Nan
persiska	páṣíà	Nan
person	eniyan	Nan
personal	oṣiṣẹ	Nan
pesten	aarun	Nan
period	asiko	Nan
peter	pétérù	Nan
petersburg	petersburg	Nan
pilatus	pilatu	Nan
pink	pupa	None
pippi	ẹyẹ	Nan
pippin	pippin	Nan
pirate	ajalelokun	Nan
piratpartiet	piratpartiet	Nan
pierre	gun	None
pitt	ibi iyege	Nan
pjäsen	nkan	None
pjäser	awọn ẹlẹgẹ	Nan
place	ibi	Nan
placera	ibi	Nan
placerad	gbe	None
placerade	gbe	None
pjäs	mu ṣiṣẹ	Nan
picture	aworan	Nan
picchu	picchu	Nan
picasso	picasso	Nan
petra	petra	Nan
petroleum	epo	Nan
petrus	pétérù	Nan
petter	petter	Nan
pettersson	pettersson	Nan
pga	nitori	Nan
ph	ara	Nan
phil	phil	Nan
philadelphia	philadelphia	Nan
philip	fílípì	Nan
philips	f’iri	Nan
phoebe	phoebe	Nan
phoenix	phoenix	Nan
pi	pi	Nan
piano	duru	Nan
peters	peters	Nan
performance	iṣe	Nan
perfekt	pipe	Nan
per	fun	None
parlamentsvalet	ile igbimọ aṣofin	Nan
parten	ẹgbẹ	Nan
parter	awọn ẹgbẹ	Nan
parterna	awọn ẹgbẹ	Nan
parti	ẹgbẹ	Nan
partido	partidos	Nan
parlamentets	ile igbimọ aṣofin	Nan
partier	ipin	None
partiet	ẹgbẹ	Nan
partiets	ẹgbẹ	Nan
partiklar	patikulu	Nan
partiledare	oludari ẹgbẹ	Nan
partner	alabaṣepọ	Nan
partnern	alabaṣepọ	Nan
partierna	ipin	None
parlamentet	ile	Nan
parlamenten	awọn ile igbimọ ijọba	Nan
parlamentariska	ile igbimọ aṣofin	Nan
pappa	baba	Nan
papper	iwe	Nan
par	tọkọtaya	Nan
paradiset	paradise	Nan
paraguay	paraguay	Nan
parallella	pọgba	Nan
parallellt	pọgba	Nan
parentes	akomo	Nan
paret	meji	Nan
paris	paris	Nan
park	gbesile	Nan
parken	gbesile	Nan
parker	ogba	Nan
parlament	ile igbimọ aṣofin	Nan
parlamentarisk	ile igbimọ aṣofin	Nan
pass	ṣe kọja	Nan
passa	ibaamu	Nan
passade	ọfẹ	Nan
passagerare	ero-ọkọ	Nan
paz	paz	Nan
pc	pc	Nan
peang	agbara	None
pearl	ewa	Nan
peka	ojuami	Nan
pekar	ojuami	Nan
pekat	ṣe idanimọ	Nan
peking	peking	Nan
pelle	pellets	Nan
pendeltåg	apaara	Nan
pengar	owo	Nan
pengarna	ni owo	Nan
penis	kòfẹ	Nan
pennsylvania	pennsilin	Nan
people	eniyan	Nan
paus	sinmi	Nan
placerades	gbe	None
paulus	pọ́ọ̀lù	Nan
paul	pọ́ọ̀lù	Nan
passagerarna	ajo	None
passande	o dara	Nan
passar	jije	None
passera	ṣe kọja	Nan
passerade	koja	Nan
passerar	rekoja	Nan
passiv	palolo	Nan
pastor	aguntan	Nan
pastoral	aguntan	Nan
patent	itọsi	Nan
patienten	alaisan	Nan
patienter	alaisan	Nan
patrick	patrick	Nan
patrik	patrik	Nan
patterson	patterson	Nan
paulo	paulo	Nan
placerar	gbigbe	Nan
placeras	gbe	None
placering	idoko-owo	Nan
poster	awọn ohun	Nan
postumt	ifiweranṣẹ	Nan
potatis	ọdunkun	Nan
potential	agbara	None
potentiellt	agbara	None
potter	amokoko	Nan
posten	meeli naa	Nan
povel	agbọnrin	Nan
prag	prague	Nan
praktiken	adaṣe	Nan
praktisk	ilowo	Nan
praktiska	ilowo	Nan
praktiskt	oba	None
prata	sọrọ	Nan
poäng	ojuami	Nan
post	meeli	Nan
positivt	daadaa	Nan
positiva	rere	None
populäraste	nitosi	None
populärkultur	gbajumọ	Nan
populärkulturen	aṣa aṣa	Nan
populärmusik	gbajumọ	Nan
populärt	gbajumọ	Nan
port	ibudo	Nan
porto	ifiweranṣẹ	Nan
porträtt	aworan	Nan
portugal	ilu pọtugali	Nan
portugals	kekere	None
portugisiska	ilu pọtugali	Nan
position	ipo	None
positionen	ipo	None
positioner	ipo	None
positiv	rere	None
pratar	sọrọ	Nan
praxis	adaṣe	Nan
precis	kan	None
premier	awọn ere	Nan
preussen	prussia	Nan
preventivmedel	contraceptive	Nan
primitiva	alakọbẹrẹ	Nan
primtal	nomba	Nan
primära	jc	Nan
prince	ọmọ	None
princip	opo	Nan
principen	opo	Nan
principer	awọn ipilẹṣẹ	Nan
prins	ọmọ	None
prinsen	olori	Nan
prinsessan	princess	Nan
pris	ẹbun	Nan
priser	awọn idiyele	Nan
priserna	awọn idiyele	Nan
prestigefyllda	olokiki	Nan
populära	gbajumọ	Nan
pressen	tẹ	Nan
press	tẹ	Nan
premiär	afihan	Nan
premiären	afihan	Nan
premiärminister	adari igbimọ ijọba	Nan
premiärministern	nomba	Nan
preparat	igbaradi	Nan
presenterade	gbekalẹ	Nan
presenterades	gbekalẹ	Nan
presenterar	mu wa	Nan
presenteras	gbekalẹ	Nan
president	alakoso	Nan
presidenten	alakoso	Nan
presidentens	alakoso	Nan
presidenter	awọn alaṣẹ	Nan
presidentvalet	ajé	Nan
presley	presley	Nan
pressas	fisinuirindigbindigbin	Nan
republiken	olominira	Nan
populär	gbajumo	Nan
populationen	olugbe	Nan
platons	plato	Nan
plats	ibi	Nan
platsen	ibi	Nan
platser	àwọn ibò	Nan
platt	alapin	Nan
platta	awo	None
platon	plato	Nan
plattan	awo	None
platån	pẹtẹlẹ	Nan
player	player	Nan
playstation	ibi ere idaraya	Nan
plikt	iṣẹ	Nan
plikter	awọn iṣẹ	Nan
plocka	mu	Nan
plattform	pẹpẹ	Nan
platina	pilatnomu	Nan
plasma	pilasima	Nan
planeternas	aye orun	Nan
plan	gbero	Nan
planen	ọfin	Nan
planer	awọn ero	Nan
planerad	ngbero	None
planerade	ngbero	None
planerar	awọn ero	Nan
planeras	ngbero	None
planerat	ngbero	None
planering	gbimọ	Nan
planerna	awọn ero	Nan
planet	ile aye	Nan
planeten	ile aye	Nan
planetens	ile aye	Nan
planeter	aye orun	Nan
planeterna	aye orun	Nan
plural	ọpọ	Nan
plus	pẹlu	Nan
pluto	pluto	Nan
plötsligt	lojiji	Nan
politik	eto imulo	Nan
politiken	eto imulo	Nan
politiker	oselu	Nan
politisk	oselu	Nan
politiska	oselu	Nan
politiskt	iṣelu	Nan
polska	pólándì	Nan
pommern	panini	Nan
pompejus	pompey	Nan
ponny	poni	Nan
pontus	pẹtẹlẹ	Nan
pop	agbejade	Nan
popsångare	olorin pop	Nan
popularitet	gbaye-gbale	Nan
population	olugbe	Nan
poliser	ọlọpa	Nan
populationer	olugbe	Nan
polisens	ọlọpa	Nan
polis	ọlọpa	Nan
poe	po	None
poes	poe	Nan
poesi	oríkì	None
poet	akewi	Nan
poeten	ewi	Nan
poeter	awọn ewi	Nan
point	ojuami	Nan
pojkar	awọn ọmọkunrin	Nan
pojkarna	awọn ọmọkunrin	Nan
pojke	ọmọkunrin	Nan
pojkvän	ọrẹkunrin	Nan
polacker	awọn ọpá	Nan
polen	polandii	Nan
polens	okun	Nan
policy	eto imulo	Nan
polisen	ọlọpa	Nan
panthera	panthera	Nan
republikens	olominira	Nan
resa	ajo	None
senaste	tuntun	None
senaten	alagba	Nan
senator	igbimọ	Nan
sent	pẹ	Nan
sentida	laipẹ	Nan
separat	lọtọ	Nan
senast	kẹhin	Nan
separata	lọtọ	Nan
september	oṣu kẹsan	Nan
ser	woni	Nan
serber	tẹtẹ	Nan
serbien	serbia	Nan
serbiens	serbia	Nan
serbisk	serbian	Nan
separerade	yà	Nan
senare	nigbamii	Nan
sena	pẹ	Nan
sen	pẹ	Nan
sekel	orundun	Nan
sekelskiftet	tan ti awọn orundun	Nan
sekreterare	akọwe	Nan
sekt	abala	None
sekter	awọn ẹgbẹ	Nan
sektion	apakan	Nan
sektorn	eka	None
sekulär	alailesin	Nan
sekulära	alailesin	Nan
sekunder	-aaya	Nan
sekvens	ọkọọkan	Nan
selassie	awotẹlẹ	Nan
selma	selma	Nan
semifinal	ologbele-ik	Nan
semifinalen	ologbele-ik	Nan
serbiska	tẹtẹ	Nan
segrar	aamieye	Nan
serie	jara	Nan
seriens	jara	Nan
shakespeares	sekisipia	Nan
sharia	sharia	Nan
sheen	sheen	Nan
sibirien	siberian	Nan
sicilien	aṣa	Nan
sida	oju iwe	Nan
shakespeare	sekisipia	Nan
sidan	oju iwe	Nan
sidor	awọn ẹgbẹ	Nan
sidorna	awọn ẹgbẹ	Nan
sierra	sierra	Nan
siffra	eeya	Nan
siffran	eeya	Nan
siffror	isiro	Nan
side	apa	Nan
shahen	shah	Nan
sfären	ayika	Nan
sexuellt	ibalopọ	Nan
serier	jara	Nan
serotonin	serotonin	Nan
serveras	yoo	None
service	iṣẹ	Nan
servrar	awọn olupin	Nan
ses	jẹ	Nan
seth	ṣeto	Nan
sett	ti ri	Nan
setts	šakiyesi	Nan
sevärdheter	oniriajo awọn ifalọkan	Nan
sex	mefa	Nan
sexton	mẹrindilogun	Nan
sexualitet	ibalopọ	Nan
sexuell	ibalopọ	Nan
sexuella	ibalopọ	Nan
serien	jara	Nan
seglade	omi	None
segern	ṣẹgun	Nan
seger	ṣẹgun	Nan
sandy	ni iyanrin	Nan
sankt	st.	Nan
sankta	mimọ	Nan
sann	tueótọ	Nan
sanna	ooto	Nan
sanning	ooto	Nan
sand	iyanrin	Nan
sanningen	ooto	Nan
sannolikt	seese	Nan
sanskrit	sanskrit	Nan
sant	ooto	Nan
santa	santa	None
santiago	santiago	Nan
sapiens	sapiens	Nan
sannolikhet	iṣeeṣe	Nan
san	san	Nan
samväldet	ibaṣepọ	Nan
samverkar	co	Nan
sammanhängande	atakoko	Nan
sammanlagt	lapapọ	Nan
sammansatt	eroja	Nan
sammansatta	eroja	Nan
sammansättning	tiwqn	Nan
samoa	samoa	Nan
samspel	ohun kikọ silẹ	Nan
samt	ati	Nan
samtal	pe	Nan
samtida	imusin	None
samtidigt	kan	None
samtliga	gbogbo	Nan
samtycke	ase	Nan
samuel	sámúẹ́lì	Nan
samverkan	ifowosowopo	Nan
sara	sara	Nan
sarah	sárà	Nan
sarajevo	sarajevo	Nan
satan	eṣu	Nan
schweiziska	switzerland	Nan
science	irokuro	Nan
scientologikyrkan	ijinle sayensi	Nan
scott	iṣiọla	Nan
screen	waworan	Nan
se	wo	Nan
sean	ifa	Nan
sebastian	sebastian	Nan
sed	aṣa	Nan
sedan	lẹhinna	Nan
sedd	ti ri	Nan
seden	aṣa	Nan
seder	atẹle	Nan
sedermera	atẹle	Nan
sedlar	owo	Nan
schweiz	switzerland	Nan
siffrorna	isiro	Nan
schwarzenegger	schwarzenegger	Nan
schack	chess	Nan
satanism	satanism	Nan
sats	gbolohun ọrọ	Nan
satsa	nawo	Nan
satsade	tẹtẹ	Nan
satsningar	awọn tẹtẹ	Nan
satt	joko	Nan
satte	joko	Nan
sattes	fi	None
saturnus	satẹlaiti	Nan
saudiarabien	saudi arebia	Nan
sauron	sauron	Nan
sawyer	oluwara	Nan
scen	ibi isẹlẹ	Nan
scenen	ipele	None
scener	awọn iwoye	Nan
schizofreni	schizophrenia	Nan
sammanhanget	o tọ	Nan
sig	sí	Nan
signaler	agbara	None
skalv	mì	Nan
skalvet	mì	Nan
skandinavien	scandinavia	Nan
skandinaviska	scandinavian	Nan
skapa	ṣẹda	Nan
skapad	ti ṣẹda	Nan
skall	yoo	None
skapade	ṣẹda	Nan
skapande	ẹda	Nan
skapandet	ẹda	Nan
skapar	ṣẹda	Nan
skapare	eleda	Nan
skapas	ṣẹda	Nan
skapat	apẹrẹ	Nan
skapades	ṣẹda	Nan
skalet	ikarahun	Nan
skalan	ìwọn	Nan
skala	ìwọn	Nan
sk	sk	Nan
ska	yẹ	Nan
skabb	scabies	Nan
skada	bibajẹ	Nan
skadad	bajẹ	Nan
skadade	bajẹ	Nan
skadades	farapa	Nan
skadan	bibajẹ	Nan
skadas	bajẹ	Nan
skadliga	deleterious	Nan
skador	bibajẹ	Nan
skadorna	bibajẹ	Nan
skaffa	gba	None
skaffade	pese	Nan
skal	ikarahun	Nan
skapats	ṣẹda	Nan
sjöss	okun	Nan
skapelse	ẹda	Nan
skarp	didasilẹ	Nan
skiftande	iyipada	Nan
skikt	ipele	None
skilda	yatọ	Nan
skilde	kọsilẹ	Nan
skildes	yà	Nan
skildrar	ṣafihan	Nan
skicklig	ti oye	Nan
skildras	ṣafihan	Nan
skilja	ṣe iyatọ	Nan
skiljas	yà	Nan
skiljer	yatọ	Nan
skiljs	yà	Nan
skillnad	iyato	None
skillnaden	iyato	None
skildringar	awọn ifihan	Nan
skickas	firanṣẹ	Nan
skickar	firanṣẹ	Nan
skickades	firanṣẹ	Nan
skarsgård	skarsgård	Nan
skatt	owo-ori	Nan
skatter	ori	None
ske	ṣẹlẹ	Nan
skedde	wà	Nan
skede	alakoso	Nan
skelett	egungun	Nan
skepp	ọkọ	Nan
skeppen	omi	None
skeppet	ọkọ oju-omi	Nan
sker	ṣe	Nan
skett	ṣẹlẹ	Nan
skick	majemu	Nan
skicka	firanṣẹ	Nan
skickade	firanṣẹ	Nan
skara	ogunlọgọ	Nan
sjönk	dinku	Nan
sjöng	kọrin	Nan
sjön	adagun	Nan
sir	sir	Nan
sist	kẹhin	Nan
sista	kẹhin	Nan
siste	kẹhin	Nan
sistnämnda	kẹhin	Nan
site	aaye	Nan
sinne	lokan	Nan
sitt	tirẹ	Nan
sittande	joko	Nan
sitter	joko	Nan
situation	ipo	None
situationen	ipo	None
situationer	ipo	None
siv	siv	Nan
sitta	joko	Nan
singlarna	awọn ẹlẹgbẹ	Nan
singlar	awọn ẹyọkan	Nan
singer	akorin	Nan
signifikant	pataki	Nan
sikt	igba	Nan
silver	fadaka	Nan
simmons	simmons	Nan
simning	odo	Nan
simon	símónì	Nan
simpson	simpson	Nan
simpsons	simpsons	Nan
sin	rẹ	None
sina	wọn	None
sinatra	sinatra	Nan
singapore	ẹrin	Nan
singapores	orílẹ̀	None
singel	ẹyọkan	Nan
singeln	ẹyọkan	Nan
sixx	mefa	Nan
sju	meje	Nan
sjuk	aisan	Nan
sjuka	aisan	Nan
självstyrande	adase	Nan
självstyre	ijọba ara ẹni	Nan
självständig	olominira	Nan
självständiga	olominira	Nan
självständighet	ijọba ara ẹni	Nan
självständigheten	ominira	Nan
självständigt	ominira	Nan
självt	iho	Nan
sjätte	kẹfa	Nan
sjö	adagun	Nan
sjöar	adagun-odo	Nan
sjöarna	adagun-odo	Nan
sjöfart	sowo	Nan
sjöfarten	sowo	Nan
sjögren	sjögren	Nan
självmord	igbẹmi ara ẹni	Nan
sigmund	sigmund	Nan
självklart	dajudaju	Nan
själva	awọn funrararẹ	Nan
sjukdom	aisan	Nan
sjukdomar	arun	None
sjukhus	ile-iwosan	Nan
sjukhuset	ile-iwosan	Nan
sjukvård	itọju ilera	Nan
sjunde	keje	Nan
sjunga	kọrin	Nan
sjunger	kọrin	Nan
sjunka	rì	Nan
sjunkande	ja bo	Nan
sjunker	aworan	Nan
sjunkit	sun	None
själ	ọkàn	Nan
själen	ọkàn	Nan
själv	iho	Nan
självbiografi	iwe itan	Nan
sammanhang	o tọ	Nan
sammanfattning	akopọ	Nan
sammanfaller	pekinjọpọ	Nan
robin	robin	Nan
robinson	robinson	None
rockband	apata iye	Nan
rocken	aṣọ	Nan
rockgrupper	awọn ẹgbẹ apata	Nan
rocksångare	olorin apata	Nan
roberts	roberts	Nan
rod	ọpá	Nan
roland	roland	Nan
roll	ipa	Nan
rollen	ipa	Nan
roller	olulana	Nan
rollfigur	ohun kikọ	Nan
rollfigurer	ohun kikọ	Nan
roger	roger	Nan
roberto	roberto	Nan
robert	robert	Nan
robbie	robbie	Nan
ringar	oruka	Nan
ringde	ti a pe	Nan
ringen	òrùka	Nan
rinner	ós	Nan
ris	iresi	Nan
risk	eewu	Nan
risken	eewu	Nan
risker	awọn ewu	Nan
riskerar	eewu	Nan
rita	fa	Nan
ritualer	awọn irubo	Nan
rivalitet	orogun	Nan
river	yiya	Nan
rna	rna	None
rob	jale	Nan
rolling	yipo	Nan
ringa	pe	Nan
rom	gypsy	Nan
roman	aramada	Nan
ron	dide	Nan
ronaldinho	ronaldinho	Nan
ronaldo	ronaldo	Nan
ronden	yika	Nan
ronja	ronja	Nan
roosevelt	roosevelt	Nan
romulus	romu	Nan
rorsman	oluranlowo	Nan
rose	dide	Nan
rosenberg	rosenberg	Nan
rotation	iyipo	Nan
roterande	yiyi	Nan
roterar	yiyi	Nan
rousseau	rousseau	Nan
rosa	pupa	None
romska	romani	Nan
roms	rom	Nan
romerskkatolska	roman katoliki	Nan
romance	fifehan	Nan
romanen	aramada	Nan
romaner	iwe	Nan
romani	romani	Nan
romantiken	fifehan	Nan
romantikens	ti alefi ife han	Nan
romantiska	ti alefi ife han	Nan
romarna	róòmù	Nan
romarriket	ilẹ̀ ọba róòmù	Nan
romeo	romeo	Nan
romer	adun	Nan
romerna	róòmù	Nan
romersk	roman	Nan
romerska	roman	Nan
romerske	roman	Nan
roma	roma	None
ring	òrùka	Nan
riktningen	itọsọna	Nan
riktningar	awọn itọsọna	Nan
resultera	esi	Nan
resulterade	yorisi	Nan
resulterar	awọn esi	Nan
resulterat	yorisi	Nan
resurs	awọn olu .ewadi	Nan
resurser	orisun	None
resultatet	esi	Nan
retorik	aroye	Nan
retoriska	aroye	Nan
revir	agbegbe	Nan
revolution	iyika	Nan
revolutionen	iyika	Nan
revolutionens	iyika	Nan
revolutionär	rogbodiyan	None
retoriken	aroye	Nan
resultaten	awọn esi	Nan
resultat	awọn esi	Nan
resterande	ku	None
resan	ajo	None
resande	ajo	None
research	iwadi	None
reser	irin-ajo	Nan
residensstad	county	Nan
resolution	ipinnu	Nan
resor	ajo	None
respekt	ọwọ	Nan
respektive	oniwun	Nan
rest	aloku	Nan
restaurang	ile-ounjẹ	Nan
restauranger	onje	None
reste	ajo	None
resten	sinmi	Nan
rester	awọn iṣẹku	Nan
revolutionära	rogbodiyan	None
revs	wó	Nan
reza	reza	Nan
rhen	rhine	Nan
riksförbundet	ẹgbẹ ti orilẹ-ede	Nan
rikskansler	oloyefe	Nan
riksrådet	ikọkọ	Nan
riksväg	opopona	Nan
rikt	lọpọlọpọ	Nan
riktad	dari	Nan
riktade	dari	Nan
riktar	ibi-afẹde	Nan
riktas	dari	Nan
riktat	dari	Nan
riktig	tueótọ	Nan
riktiga	gidi	Nan
riktigt	looto	Nan
riktlinjer	awọn itọsona	Nan
riktning	itọsọna	Nan
riksdagsvalet	idibo ti ile igbimọ aṣofin	Nan
rovdjur	apanirun	Nan
riksdagens	ile igbimọ aṣofin	Nan
riksdag	ile igbimọ aṣofin	Nan
rice	iresi	Nan
richard	richard	None
richards	richards	Nan
richmond	richmond	Nan
rico	rico	Nan
riddare	ọbẹ	Nan
rik	ọlọrọ	Nan
rika	ọlọrọ	Nan
rikare	ni oro	Nan
rikaste	richest	Nan
rike	ijọba	Nan
rikedom	ọrọ	Nan
riken	awọn ijọba	Nan
riket	ijọba	Nan
rikets	reich	Nan
riksdagen	ile igbimọ aṣofin	Nan
rowling	titọ	Nan
roy	roy	Nan
rubiks	rubiks	Nan
sade	wipe,	Nan
sades	wi	Nan
saga	alo iwin	Nan
sagan	itan	Nan
sagor	fun	None
sagt	wi	Nan
saddam	saddam	Nan
sahara	sahara	Nan
saint	saint	Nan
sak	ohun	Nan
saken	ọrọ	Nan
saker	ohun	Nan
saknade	sonu	Nan
saknades	sonu	Nan
sahlin	sahlin	Nan
sachsen	saxony	Nan
sabbath	iwe iwọle	Nan
saab	saab	Nan
rörelsen	ronu	Nan
rörelsens	ronu	Nan
rörelser	awọn agbeka	Nan
rörelserna	awọn agbeka	Nan
rörlighet	arinbo	Nan
röst	ohun	Nan
rösta	dibo	Nan
röstade	dibo	Nan
rösten	ohun	Nan
röster	ibo	Nan
rösterna	simẹnti	Nan
rösträtt	dibo	Nan
rött	ran	Nan
rötter	wá	Nan
sa	wi	Nan
saknar	aito	Nan
saknas	sonu	Nan
sakrament	sakaramenti	Nan
sakta	laiyara	Nan
samhällets	awujọ	Nan
samisk	sami	Nan
samiska	sami	Nan
samla	kó	Nan
samlade	gbà	Nan
samlades	jọ	Nan
samlag	ọrọ	Nan
samlar	apejo	Nan
samlat	gbà	Nan
samlats	gbà	Nan
samling	gbigba	Nan
samlingar	awọn ikojọpọ	Nan
samlingsalbum	awọn iṣiro	Nan
samma	kanna	Nan
samman	papọ	Nan
samhället	awujọ	Nan
rörelse	ronu	Nan
samhällen	awọn agbegbe	Nan
samfundet	agbegbe	Nan
salt	iyo	Nan
salvador	salvado	Nan
sam	co	Nan
samarbeta	ifọwọsowọpọ	Nan
samarbetade	ti ṣiṣẹpọ	Nan
samarbetar	ifọwọsowọpọ	Nan
samarbetat	ti ṣiṣẹpọ	Nan
samarbete	ifowosowopo	Nan
samarbeten	co	Nan
samarbetet	co	Nan
samband	ìbáṣepọ	Nan
sambandet	ìbáṣepọ	Nan
same	kanna	Nan
samerna	awọn sami	Nan
samfund	awujọ	Nan
samhälle	awujọ	Nan
republiker	awọn olominira	Nan
rörde	fọwọkan	Nan
röra	gbe	None
rwanda	rwanda	Nan
ryan	ryan	None
rybak	rybak	Nan
rygg	sẹhin	Nan
ryggen	sẹhin	Nan
rykte	orukọ	Nan
russell	rùn	Nan
rykten	agbasọ	Nan
rymmer	dimu	Nan
rysk	ara ilu rọsia	Nan
ryska	ara ilu rọsia	Nan
ryssland	rọ́ṣíà	Nan
rysslands	ara ilu rọsia	Nan
rytmiska	olorinrin	Nan
rymden	aaye	Nan
rush	adie	Nan
ruset	oti mimu	Nan
runtom	yika	Nan
rubrik	akọle	Nan
rudolf	rudolf	Nan
rugby	rugby	Nan
ruiner	dabaru	Nan
rum	yara	Nan
rummet	yara naa	Nan
rumänien	romania	Nan
rumänska	romania	Nan
run	ṣiṣe	Nan
runda	yika	Nan
running	nṣiṣẹ	Nan
runor	ranes	Nan
runorna	ranes	Nan
runstenar	rune	Nan
runt	yika	Nan
räcker	to	None
räckte	fi	None
rädd	bẹru	Nan
rädda	fipamọ	Nan
rådande	lọwọlọwọ	Nan
rådde	ṣẹgun	Nan
råder	jẹ	Nan
rådet	igbimọ naa	Nan
rådets	igbimọ	Nan
rådgivare	onimọnran	Nan
rådhus	gbongan ilu	Nan
råkar	ṣẹlẹ si	Nan
råolja	epo robi	Nan
råvaror	aise	Nan
röd	ran	Nan
röda	pupa	None
röka	ẹfin	Nan
rökning	mimu siga	Nan
rör	paipu	Nan
råd	imọran	Nan
rörande	nipa	Nan
rättvisa	idajo	None
rättigheterna	awọn ẹtọ	Nan
räddade	gbà là	Nan
räddar	gbà là	Nan
rädsla	bẹru	Nan
räkna	ka	Nan
räknade	iṣiro	Nan
räknar	kika	Nan
räknas	iṣiro	Nan
räknat	iṣiro	Nan
rätt	ọtun	Nan
rätta	tọ	Nan
rättegång	iwadii	Nan
rättegången	iwadii	Nan
rätten	ni ọtun	Nan
rätter	awopọ	Nan
rättigheter	awọn ẹtọ	Nan
rättsliga	t’olofin	Nan
skillnader	awọn iyatọ	Nan
pamela	pamela	Nan
palme	palme	Nan
miguel	miguel	Nan
mikael	mikael	Nan
mike	ji	Nan
mil	mil	Nan
milan	malan	Nan
milano	milano	Nan
mig	emi	Nan
mild	onirẹlẹ	Nan
mildare	milder	Nan
miley	maili	Nan
militär	ologun	Nan
militära	ologun	Nan
militären	ologun	Nan
militärer	iranṣẹ	Nan
milda	onirẹlẹ	Nan
midsommar	agbedemeji	Nan
microsoft	microsoft	Nan
mick	mic	Nan
metod	ọna	Nan
metoden	ọna	Nan
metoder	awọn ọna	Nan
metro	agbegbe	Nan
mexico	meksiko	None
mexikanska	meksiko	None
mexiko	meksiko	None
meyer	meyer	Nan
mfl	et al	Nan
miami	miami	Nan
michael	mikaeli	Nan
michail	michail	Nan
michel	bọlá	Nan
michelle	bọlá	Nan
michigan	michigan	Nan
militärt	ologun	Nan
metionin	methionine	Nan
miljard	bilionu	Nan
miljon	million	Nan
miniatyr|px|en	kekere	None
miniatyr|px|ett	kekere	None
minister	òjíṣẹ́	Nan
ministerrådet	awọn minisita	Nan
ministrar	minisita	Nan
minne	iranti	Nan
miniatyr|px|den	kekere	None
minnen	ìrántí	Nan
minns	ranti	Nan
minoritet	ẹlẹgbẹ	Nan
minoriteten	ẹlẹgbẹ	Nan
minoriteter	kekere	None
minoritetsspråk	ẹlẹgbẹ	Nan
minska	din	None
minnet	iranti	Nan
miniatyr|karta	maapu	None
miniatyr|en	kekere	None
miniatyr|	kekere	None
miljoner	million	Nan
miljontals	miliọnu	Nan
miljö	ayika	Nan
miljöer	awọn agbegbe	Nan
miljön	ayika	Nan
miljöproblem	awọn iṣoro ayika	Nan
miller	ologbon	Nan
milt	rọra	Nan
min	temi	Nan
mina	t’emi	Nan
mind	okan	Nan
mindre	ti o kere	Nan
mineral	alumọni	Nan
mineraler	ohun alumọni	Nan
miniatyr	kekere	None
miljarder	ẹgbaagbeje	Nan
meter	mita	Nan
metan	gaasi	Nan
metallica	metallica	Nan
medlemsstater	ọmọ	None
medlemsstaterna	ọmọ	None
medlemsstaternas	ọmọ	None
medverka	tiwon	Nan
medverkade	irawo	Nan
medverkan	ikopa	Nan
medlemsstat	ọmọ	None
medverkar	lowo	Nan
medvetande	mimọ	Nan
medveten	mọ	Nan
medvetet	mọọmọ	Nan
medvetna	mimọ	Nan
mekaniska	darí	Nan
mekka	mekka	Nan
medverkat	kopa	Nan
medlemskap	ẹgbẹ	Nan
medlemmarna	ọmọ	None
medlemmar	ọmọ	None
medför	entails	Nan
medföra	esi	Nan
medförde	yorisi	Nan
medfört	yorisi	Nan
media	media	Nan
medicin	òògùn	Nan
mediciner	awọn oogun	Nan
medicinering	oogun	Nan
medicinsk	egbogi	Nan
medicinska	egbogi	Nan
medicinskt	ti oogun	Nan
medier	media	Nan
mediet	alabọde	Nan
medina	medina	Nan
medlem	ọmọ	None
melankoli	melancholy	Nan
melker	melker	Nan
mellan	laarin	None
mellanfot	metatarsus	Nan
mera	diẹ sii	Nan
mercurys	makiuri	Nan
merkurius	makiuri	Nan
merparten	julọ	Nan
merry	ikini	Nan
mesopotamien	mesopotamien	Nan
messi	messi	Nan
messias	mèsáyà	Nan
mest	julọ	Nan
mesta	julọ	Nan
mestadels	okeene	Nan
metabolism	agbara	None
metaforer	awọn afiwera	Nan
metall	irin	Nan
metaller	awọn irin	Nan
mer	diẹ sii	Nan
minskad	dinku	Nan
mentala	ọpọlọ	Nan
meningar	awọn gbolohun ọrọ	Nan
mellankrigstiden	ogun	None
mellanrum	alafo	Nan
mellanöstern	ila-oorun	Nan
mellersta	àárín	None
melodier	awọn orin aladun	Nan
melodifestivalen	melodifestivalen	Nan
memoarer	awọn iwe iranti	Nan
memorial	ìrántí	Nan
men	ṣugbọn	Nan
menade	túmọ	Nan
menar	tumọ	Nan
menas	ti wa ni túmọ	Nan
menat	túmọ	Nan
mengele	mengele	Nan
mening	gbolohun ọrọ	Nan
mental	ọpọlọ	Nan
medelålder	ori	None
minskade	dinku	Nan
minskat	dinku	Nan
motorvägarna	opopona	Nan
motorvägen	opopona	Nan
motsats	itansan	Nan
motsatsen	idakeji	Nan
motsatt	idakeji	Nan
motsatta	idakeji	Nan
motorvägar	opopona	Nan
motsatte	tako	Nan
motståndare	alatako	Nan
motståndaren	alatako	Nan
motståndarna	alatako	Nan
motståndet	alatako	Nan
motståndsrörelsen	atako	Nan
motsvarande	ibaramu	Nan
motstånd	atako	Nan
motorväg	opopona	Nan
motors	moto	Nan
motor	ẹnjinia	Nan
mord	paniyan	Nan
morden	paniyan	Nan
mordet	paniyan	Nan
morgan	morgan	None
morgon	owurọ	Nan
morgonen	owurọ	Nan
morris	morris	Nan
moseboken	jẹnẹsisi	Nan
moses	mósè	Nan
moskva	ilu moscow	Nan
mot	lodi si	Nan
motion	ere idaraya	Nan
motiv	awọn ero	Nan
motiveringen	awọn aaye	Nan
motivet	koko	Nan
motsvarar	ibaramu	Nan
moraliskt	iwa	Nan
motsvarighet	deede	Nan
mottagande	gba	None
munnen	ẹnu	Nan
mur	ogiri	Nan
muren	ogiri	Nan
murray	murray	Nan
muse	ile ọnọ	Nan
museer	awọn musiọmu	Nan
mun	ẹnu	Nan
museet	musiọmu	Nan
music	orin	Nan
musik	orin	Nan
musikalen	gaju ni	Nan
musikalisk	gaju ni	Nan
musikaliska	gaju ni	Nan
musikaliskt	gaan	Nan
museum	musiọmu	Nan
mullusfiskar	ẹja pẹtẹlẹ	Nan
muhammeds	mohammed	Nan
muhammed	muamu	Nan
mottagare	olugba	Nan
mottagaren	olugba	Nan
mottagarens	olugba	Nan
motto	gbolohun ọrọ	Nan
mottog	gba	None
motverka	tako	Nan
mountain	oke	Nan
movie	fiimu	Nan
mozart	mozart	Nan
mozarts	mozart	Nan
moçambique	moçambique	Nan
mr	mr	Nan
ms	m	Nan
mtv	mtv	Nan
muhammad	muhammad	Nan
motsättningar	atako	Nan
moraliska	iwa	Nan
moralisk	iwa	Nan
moral	iwa	Nan
misstänkt	fura si	Nan
misstänkta	awọn fura	Nan
mitt	temi	Nan
mitten	àárín	None
mix	dapọ	Nan
mjölk	wara	Nan
misstag	aṣiṣe	Nan
mm	mm	Nan
mod	ìgboyà	Nan
mode	njagun	Nan
modell	awoṣe	Nan
modellen	awoṣe	Nan
modeller	awọn awoṣe	Nan
moder	iya	Nan
moberg	moberg	Nan
missnöjet	discontinu	Nan
missnöje	ainitẹlọrun	Nan
misslyckats	kuna	Nan
minskning	idinku	Nan
minst	o kere ju	Nan
minsta	o kere ju	Nan
minut	iseju	Nan
minuter	iṣẹju	Nan
miss	sọnu	Nan
missbruk	ilokulo	Nan
missförstånd	ede-aiyede	Nan
misshandel	kọlu	Nan
mission	ise	Nan
missionärer	awọn iṣẹ apinfunni	Nan
misslyckade	kuna	Nan
misslyckades	kuna	Nan
misslyckande	ikuna	Nan
misslyckas	kuna	Nan
moderata	iwọntunwọnsi	Nan
moderaterna	modẹmu	Nan
modern	igbalode	Nan
moderna	igbalode	Nan
monica	monica	Nan
monicas	monica	Nan
monografi	ẹyọkan	Nan
monopol	anikanjọpọn	Nan
monoteism	monotheism	Nan
monoteistiska	monotheistic	Nan
monroe	monroe	Nan
monster	aderubaniyan	Nan
montana	montana	Nan
monte	monte	Nan
montenegro	montenegro	Nan
monument	arabara	Nan
moore	moore	Nan
mor	iya	Nan
mora	mora	Nan
mongoliet	mongolia	Nan
minskar	dinku	Nan
monetära	owo	Nan
monarki	olú ọba	Nan
modernare	diẹ igbalode	Nan
modernismen	imulẹmimimọ	Nan
modernistiska	alamọde	Nan
modernt	igbalode	Nan
modersmål	ìyá	Nan
modet	igboya	Nan
modo	modo	Nan
mohammed	mohammed	Nan
moldavien	moludofa	Nan
molekyler	molikula	Nan
moln	awọsanma	Nan
mona	mona	Nan
monaco	monaco	Nan
monark	ọba	Nan
monarken	ọba	Nan
monarkin	olú ọba	Nan
medeltidens	awọn ọjọ-ori	Nan
medeltiden	ori	None
medeltida	igba atijọ	Nan
lät	dun	None
lätt	rọrun	Nan
lätta	ina	Nan
lättare	fẹẹrẹ	Nan
låg	kekere	None
låga	kekere	None
läste	ka	Nan
lågt	kekere	None
låna	yawo	Nan
lånat	yawo	Nan
lång	gun	None
långa	gun	None
långbåge	gun	None
långfilm	ẹya	Nan
lån	awin	Nan
läst	ka	Nan
läsning	kika	Nan
läses	ka	Nan
läns	county	Nan
lär	kọ ẹkọ	Nan
lära	kọ	Nan
läran	ẹkọ	Nan
lärare	olukọ	Nan
lärda	awọn ọjọgbọn	Nan
lärde	kọ ẹkọ	Nan
lärjungar	ọmọ	None
läror	awọn ẹkọ	Nan
lärt	kọ ẹkọ	Nan
läs	ka	Nan
läsa	ka	Nan
läsare	onkawe	Nan
läsaren	oluka	Nan
läser	ka	Nan
långhårig	irun gigun	Nan
länkar	ọna asopọ	Nan
långsamma	lọra	Nan
långsamt	laiyara	Nan
löper	sáré	Nan
lördagen	satide	Nan
lösa	yanju	Nan
lösas	yanju	Nan
löser	solves	Nan
lösning	ojutu	Nan
löpande	lọwọlọwọ	Nan
lösningar	awọn solusan	Nan
lösningsmedel	epo	Nan
löst	loosely	Nan
löstes	tuwonka	Nan
mabel	mabel	Nan
machu	machu	Nan
madagaskar	madagascar	Nan
lösningen	ojutu	Nan
lönneberga	lönneberga	Nan
löner	owo iṣẹ	Nan
lön	ekunwo	Nan
långt	jinna	Nan
långtgående	agbara	None
långvarig	pẹ	Nan
långvariga	gigun	Nan
långvarigt	gun	None
låt	ki	None
låta	ìró	None
låtar	awọn orin	Nan
låtarna	awọn orin	Nan
låten	orin	Nan
låter	awọn ohun	Nan
låtit	alaga	Nan
låtskrivare	akọrin	Nan
löfte	ṣèlérí	Nan
löften	awọn ileri	Nan
långsammare	laiyara	Nan
länk	ọna asopọ	Nan
längtan	npongbe	Nan
längsta	gunjulo	Nan
luxemburg	luxembourg	Nan
lycka	idunnu	Nan
lyckade	aṣeyọri	Nan
lyckades	ti ṣakoso	Nan
lyckan	idunnu	Nan
lyckas	ṣaṣeyọri	Nan
lutning	ifa ọkan	Nan
lyckats	ṣaṣeyọri	Nan
lyfta	gbe	None
lyfter	gbe	None
lyrik	awọn orin	Nan
lysande	o wuyi	Nan
lyssna	gbọ	Nan
lyssnade	tẹtisi	Nan
lyder	ṣègbọràn	Nan
lutherska	onilu	Nan
luthers	luther	None
luther	luther	None
ludwig	ludwig	Nan
luft	ategun	Nan
luften	ategun	Nan
lugn	dakẹrọrọ	Nan
lugna	tunu	Nan
lukas	lúùkù	Nan
luleå	luleå	Nan
luminositet	itanna	Nan
lundell	lundell	Nan
lundgren	lundgren	Nan
lunds	lund	Nan
lunginflammation	àìsàn òtútù àyà	Nan
lungorna	ẹdọforo	Nan
lupus	lupus	Nan
lust	ifẹ	Nan
lyssnar	gbọ	Nan
läge	ipo	None
lägenhet	iyẹwu	Nan
läger	àgọ́	None
lämningar	ku	None
lämplig	o dara	Nan
lämpliga	o dara	Nan
lämpligt	o dara	Nan
län	county	Nan
länder	awọn orilẹ-ede	Nan
länderna	awọn orilẹ-ede	Nan
ländernas	awọn ipinlẹ	Nan
länders	awọn orilẹ-ede	Nan
längd	gigun	Nan
längden	gigun	Nan
länge	gun	None
längre	gun	None
längs	pẹlú	Nan
längst	si iwaju	Nan
lämnat	osi	Nan
madeira	madeira	None
lämnas	osi	Nan
lämnades	osi	Nan
läget	ipo	None
lägga	dubulẹ	Nan
läggas	fi	None
lägger	afikun	Nan
läggs	fi	None
lägre	kere	Nan
lägret	àgọ́	None
lägst	ni asuwon ti	Nan
lägsta	ni asuwon ti	Nan
läkare	dokita	Nan
läkaren	dokita	Nan
läkemedel	oogun	Nan
läkemedelsverket	mpa	Nan
lämna	lọ	Nan
lämnade	nlọ	Nan
lämnar	ewé	None
madeleine	madeleine	Nan
madonna	aṣiwere	Nan
madrid	ilu madrid	Nan
massachusetts	massachusetts	Nan
massakern	igbala	Nan
massan	ọpọ	Nan
massiv	lowo	Nan
massiva	lowo	Nan
massmedia	ibi-media	Nan
massa	ko	None
massor	lọpọlọpọ	Nan
mat	oúnjẹ	None
match	baramu	Nan
matchen	baramu	Nan
matcher	ibaamu	Nan
matcherna	ibaamu	Nan
matematik	mathimatiki	None
master	ọga	Nan
maskiner	awọn ẹrọ	Nan
mary	mary	Nan
marxistiska	marxist	Nan
marknad	ọjà	Nan
marknaden	ọjà	Nan
marknader	awọn ọja	Nan
marknadsekonomi	ọjà	Nan
markus	markus	Nan
marley	marley	Nan
marleys	awọn marleys	Nan
marocko	ilu morocco	Nan
mars	kẹta	None
marshall	marshall	Nan
martin	martin	Nan
marx	maaki	Nan
marxism	marxism	Nan
marxismen	marxism	Nan
marxistisk	marxist	Nan
matematiken	mathimatiki	None
matematiker	onitumọ	Nan
matematisk	iṣiro	Nan
matematiska	iṣiro	Nan
medborgare	orilẹ-ede	Nan
medborgarna	ara ilu	Nan
medborgarskap	ara ilu	Nan
medborgerliga	ilu	Nan
meddelade	kede	Nan
meddelande	ifiranṣẹ	Nan
meddelanden	awọn ifiranṣẹ	Nan
medel	aropin	Nan
medelhavet	mẹditarenia	Nan
medelhavsklimat	afefe mẹditarenia	Nan
medelhavsområdet	mẹditarenia	Nan
medelklassen	arin arin	Nan
medellivslängd	ireti	Nan
medeltemperaturen	otutu	None
medeltid	awọn ọjọ-ori	Nan
medarbetare	alabaṣiṣẹpọ	Nan
marklund	marklund	Nan
medan	nigba ti	Nan
maya	mayan	Nan
maten	ounje	Nan
materia	ọrọ	Nan
material	ohun elo	Nan
materialet	ohun elo	Nan
materiella	ohun elo	Nan
matrix	matrix	Nan
mats	mats	Nan
matt	ṣigọgọ	Nan
matteus	mátíù	Nan
matteusevangeliet	mátíù	Nan
matthew	mátíù	Nan
mattias	mattias	Nan
mattis	mattis	Nan
maurice	maurice	Nan
max	max	None
med	pẹlu	Nan
musiken	orin	Nan
markerar	tọka	Nan
markera	samisi	Nan
makedonien	makedonia	None
makedonska	makedonia	None
makt	agbara	None
makten	agbara	None
maktens	awọn ologun	Nan
makter	agbara	None
make	ọkọ	Nan
malaysia	malaysia	None
malin	malin	Nan
malmö	malmö	Nan
malmös	malmö	Nan
malta	malta	Nan
mamma	iya	Nan
man	ọmọ	None
malcolm	malcolm	Nan
makadam	macadam	Nan
majs	agbado	None
majoriteten	poju	Nan
maffia	agbajo eniyan	Nan
maffian	agbajo eniyan	Nan
magdalena	magdalena	Nan
magic	idan	Nan
magnetfält	oofa aaye	Nan
magnetiska	oofa	Nan
magnitud	titobi	Nan
magnus	magnus	Nan
magnusson	magnusson	Nan
mahatma	mahatma	None
maiden	iranṣẹbinrin	Nan
maidens	omidan	Nan
main	akọkọ	Nan
maj	karun	None
majoritet	poju	Nan
manager	oluṣakoso	Nan
manchester	ẹlẹṣẹ	Nan
mandat	ase	Nan
mandatperiod	igba	Nan
marcus	makosi	Nan
margaret	margaret	Nan
maria	arabinrin	Nan
marie	marie	Nan
mariette	mariette	Nan
marijuana	taba lile	Nan
marilyn	arabinrin	Nan
marina	omi	None
marinen	ọgagun	Nan
marino	marino	Nan
mario	mario	Nan
marissa	marissa	Nan
mark	ilẹ	None
markant	pataki	Nan
marken	ilẹ	None
marco	ọkọ ofurufu	Nan
markerade	yan	None
maos	maos	Nan
manuskript	iwe afọwọkọ	Nan
mandelas	mandela	Nan
mando	pipaṣẹ	Nan
manhattan	manhattan	Nan
mani	arabinrin	Nan
maniska	manic	Nan
mankell	mankell	Nan
manlig	akọ	Nan
manliga	akọ	Nan
mannen	aworan	Nan
mannens	ọkunrin	Nan
mans	akọ	Nan
manson	manson	Nan
manteln	jaketi	Nan
manuel	manuel	Nan
manus	iwe afọwọkọ	Nan
mao	ie	Nan
palmes	ọpẹ	Nan
musikens	orin	Nan
musikstil	orin orin	Nan
odens	iho	Nan
odlade	gbin	None
odlas	gbin	None
odling	aṣa	Nan
oecd	oecd	Nan
oerhörd	tobi pupo	Nan
oden	iho	Nan
oerhört	lalailopinpin	Nan
off	pipa	Nan
offensiven	ibinu	Nan
offentlig	gbangba	Nan
offentliga	gbangba	Nan
offentligt	gbangba	Nan
offer	olufaragba	Nan
of	ti	Nan
ockuperat	ti tẹdo	Nan
ockuperades	ti tẹdo	Nan
ockuperade	ti tẹdo	Nan
objekten	awọn ohun	Nan
objektet	nnkan	Nan
obligatorisk	agbara	None
obligatoriskt	dandan	None
observationer	awọn akiyesi	Nan
observatörer	awọn alafojusi	Nan
observera	akiyesi	Nan
observeras	šakiyesi	Nan
oc	oc	Nan
oceanen	okun	Nan
och	ati	Nan
ocheller	tabi	None
också	tun	Nan
ockupation	iṣẹ	Nan
ockupationen	iṣẹ	Nan
office	ọfiisi	Nan
objekt	nnkan	Nan
officerare	awọn olori	Nan
officiell	osise	Nan
oliver	olifi	Nan
olja	epo	Nan
olle	olle	Nan
ollonet	glans	Nan
olof	olof	Nan
olsson	olsson	Nan
olika	oniruru	Nan
olycka	ijamba	Nan
olyckor	awọn ijamba	Nan
olympia	olympia	Nan
olympiastadion	olimiastadion	Nan
olympiska	olimpiiki	Nan
om	ti o ba ti	Nan
ombord	wa ninu ọkọ	Nan
olyckan	ijamba	Nan
olagligt	ni ilodi si	Nan
ola	ola	Nan
okänt	aimọ	Nan
officiella	osise	Nan
officiellt	ifowosi	Nan
offren	olufaragba	Nan
offret	njiya	Nan
offside	ita	Nan
ofta	nigbagbogbo	Nan
oftare	fe e je gbogbo igba	Nan
oftast	nigbagbogbo	Nan
oförmåga	ailagbara	Nan
ogillade	kuro	Nan
oklart	koyewa	Nan
oktober	oṣu kẹwa	Nan
oktoberrevolutionen	iyika october	Nan
okänd	aimọ	Nan
okända	aimọ	Nan
official	osise	Nan
oberoende	ominira	Nan
obelix	obeli	Nan
obamas	oba	None
nämnde	mẹnuba	Nan
nämner	nmẹnuba	Nan
nämns	mẹnuba	Nan
nämnts	mẹnuba	Nan
när	nigbawo	Nan
nära	nitosi	None
nämnda	wi	Nan
närhet	agbegbe	Nan
näringsliv	idawọlẹ	Nan
näringslivet	iṣowo	Nan
närliggande	nitosi	None
närma	sunmọ	Nan
närmade	sọkún	Nan
närmar	n approaching	Nan
näring	ounjẹ	Nan
nämnas	mẹnuba	Nan
nämligen	eyun	Nan
nyval	tuntun	None
nummer	nọmba	Nan
nutid	lọwọlọwọ	Nan
nutida	imusin	None
nuvarande	lọwọlọwọ	Nan
ny	tuntun	None
nya	tuntun	None
nyare	tuntun	None
nybildade	tuntun	None
nye	tuntun	None
nyfödda	tuntun	None
nyheten	awọn iroyin	Nan
nyheter	awọn iroyin	Nan
nyligen	laipẹ	Nan
nytt	tuntun	None
nytta	anfani	Nan
närmare	sunmọ	Nan
närmast	nitosi	None
närmaste	n bọ	Nan
närstående	ti o ni ibatan	Nan
något	nkan	None
några	kan	None
når	de ọdọ	Nan
nås	wiwọle	Nan
nått	de ọdọ	Nan
nöd	nilo	Nan
nödvändig	pataki	Nan
nödvändiga	pataki	Nan
nödvändigt	pataki	Nan
nödvändigtvis	dandan	None
nöjd	itelorun	Nan
o	o	Nan
oavgjort	tai	Nan
oavsett	laibikita	Nan
obama	oba	None
någorlunda	iṣẹtọ	Nan
omedelbar	lẹsẹkẹsẹ	Nan
någonting	ohunkohun ti	Nan
någonsin	lailai	Nan
närvarande	lọwọlọwọ	Nan
närvaro	niwaju	None
näsan	imu	Nan
näst	ikeji	Nan
nästa	itele	Nan
nästan	fẹẹrẹ	Nan
nät	wẹẹbu	Nan
nätet	apapọ	Nan
nätverk	nẹtiwọọki	Nan
nätvingar	neuroptera	Nan
nå	de ọdọ	Nan
nåd	oore	Nan
nådde	de ọdọ	Nan
nåddes	ti de	Nan
någon	ẹnikan	Nan
någonstans	ibikan	Nan
numera	lasiko	Nan
omedelbart	lẹsẹkẹsẹ	Nan
omfattade	to	None
oroligheter	rogbodiyan	None
orsak	fa	Nan
orsaka	fa	Nan
orsakad	ṣẹlẹ	Nan
orsakade	ṣẹlẹ	Nan
orsakar	fa	Nan
orolig	àìníyàn	Nan
orsakas	ṣẹlẹ	Nan
orsaken	fa	Nan
orsaker	awọn okunfa	Nan
orsakerna	awọn okunfa	Nan
ort	ilu	Nan
orten	asegbeyin	Nan
orter	ṣabẹwo	Nan
orsakat	ṣẹlẹ	Nan
oro	ibakcdun	Nan
ormar	ejo	Nan
orkester	olutoju	Nan
organisationens	agbari	Nan
organisationer	ajo	None
organisera	ṣeto	Nan
organiserad	ṣeto	Nan
organiserade	ṣeto	Nan
organiseras	ṣeto	Nan
organiserat	ṣeto	Nan
organisk	organic	Nan
organiska	organic	Nan
organism	oni-iye	Nan
organismen	oni-iye	Nan
organismer	oganisimu	Nan
orgasm	oofa	Nan
origin	atilẹba	Nan
original	atilẹba	Nan
ortodoxa	àtijọ	Nan
organisationen	agbari	Nan
os	os	Nan
oskar	oskar	Nan
oväntat	lairotẹlẹ	Nan
own	tirẹ	Nan
oxenstierna	oxenstierna	Nan
oxford	oxford	Nan
ozzy	ewi	Nan
oändligt	ailopin	Nan
ovanstående	loke	Nan
pablo	pablo	Nan
pakistan	pakistan	Nan
palats	ààfin	Nan
palestina	palestine	Nan
palestinier	palestini	Nan
palestinsk	palestini	Nan
palestinska	palestine	Nan
page	oju iwe	Nan
ovanpå	oke	Nan
ovanligt	dani	None
ovanliga	ṣọwọn	Nan
oslo	oslo	Nan
osmanerna	ottomans	Nan
osmanska	ilu ottoman	Nan
oss	u.s	Nan
ost	warankasi	Nan
osv	ati be be lo	Nan
osäker	aidaniloju	Nan
osäkert	aidaniloju	Nan
osäkra	ṣiyemeji	Nan
otaliga	ainiye	Nan
otto	otto	Nan
out	jade	Nan
ovan	loke	Nan
ovanför	loke	Nan
ovanlig	dani	None
oscar	oscar	None
organisation	agbari	Nan
organ	eto ara eniyan	Nan
ordspråk	owe	Nan
område	agbegbe	Nan
områden	awọn agbegbe	Nan
områdena	awọn ẹkun ni	Nan
området	agbegbe	Nan
områdets	agbegbe	Nan
omröstning	dibo	Nan
omnämns	mẹnuba	Nan
omröstningen	dibo	Nan
omslaget	ideri	Nan
omstritt	ariyanjiyan	Nan
omständigheter	awọn ayidayida	Nan
omtvistat	ariyanjiyan	Nan
omvandlar	awọn iyipada	Nan
omvandlas	yipada	None
omskärelse	kọlà	Nan
omloppsbanor	orbital	Nan
omloppsbana	orbitin	Nan
omkringliggande	agbegbe	Nan
omfattande	sanlalu	Nan
omfattar	ni ninu	Nan
omfattas	ti bo	Nan
omfattning	iye	Nan
omger	yika	Nan
omges	yika	Nan
omgivande	ibaramu	Nan
omgiven	yika	Nan
omgivning	ayika	Nan
omgivningen	agbegbe	Nan
omgående	lẹsẹkẹsẹ	Nan
omgångar	iyipo	Nan
omgången	yika	Nan
omkom	kú	Nan
omkring	nipa	Nan
omvandling	iyipada	Nan
omvända	yiyipada	Nan
omvänt	lọna miiran	Nan
omvärlden	odi	Nan
oralsex	ibalopo roba	Nan
orange	ọsan	Nan
ord	awọn ọrọ	Nan
ordagrant	lọrọ-ọrọ	Nan
ordbok	iwe itumọ	Nan
orden	awọn ọrọ	Nan
ordentligt	bojumu	Nan
ordet	náà	None
ordförande	alakoso	Nan
ordinarie	arinrin	Nan
ordna	seto	Nan
ordnade	obi	Nan
ordnar	ṣètò	Nan
ordning	paṣẹ	Nan
ordningen	ilana	None
oppositionen	àtakò	Nan
omfatta	pẹlu	Nan
opposition	àtakò	Nan
opinion	ero	Nan
omväxlande	bibẹẹkọ	Nan
omöjligt	soro	Nan
on	loju	Nan
onani	baraenisere	Nan
onda	ibi	Nan
ondska	ibi	Nan
ondskan	ibi	Nan
ont	ibi	Nan
ontario	ontario	Nan
open	ṣii	Nan
opera	opera	Nan
operan	opera	Nan
operation	isẹ	Nan
operationer	mosi	Nan
operativsystem	os	Nan
opinionen	ero	Nan
nukleotider	awọn ẹla ara	Nan
nuförtiden	ojo	None
nu	bayi	None
möjlighet	agbara	None
möjligheten	aye	Nan
möjligheterna	awọn aye	Nan
möjligt	ṣeeṣe	Nan
mönster	àpẹẹrẹ	Nan
mördad	paniyan	Nan
möjliggör	mu ṣiṣẹ	Nan
mördade	pa	Nan
mörk	dudu	Nan
mörkare	ṣokunkun	Nan
mörker	okunkun	None
mörkt	dudu	Nan
möta	pàdé	Nan
möte	ipade	Nan
mördades	pa	Nan
möjliggjorde	ṣe o ṣee ṣe	Nan
möjligen	o ṣee	Nan
möjliga	ṣeeṣe	Nan
mån	oṣu mon	Nan
månad	osù	Nan
månaden	osù	Nan
månader	awọn oṣu	Nan
månaderna	awọn oṣu	Nan
månar	osu	Nan
månarna	osu	Nan
måne	osupa	Nan
månen	osupa	Nan
månens	osan	Nan
många	lọpọlọpọ	Nan
mångfald	oniruuru	Nan
måste	gbọdọ	Nan
mått	ìwọn	Nan
möjlig	le	None
möten	awọn ipade	Nan
målvakten	adena	Nan
möter	oju	Nan
mötley	motley	Nan
nation	orílẹ-èdè	Nan
national	orilẹ-ede	Nan
nationalencyklopedin	nationalencyklopedin	Nan
nationalförsamlingen	apejọ ti orilẹ-ede	Nan
nationalism	t’orilẹ-ede	Nan
nationalismen	t’orilẹ-ede	Nan
nathan	nátánì	Nan
nationalister	nationalists	Nan
nationalitet	abínibí-èdè	Nan
nationalpark	papa	None
nationalparker	papa	None
nationell	orilẹ-ede	Nan
nationella	orilẹ-ede	Nan
nationellt	t’orilẹ-ede	Nan
nationalistiska	t’orilẹ-ede	Nan
nash	nash	Nan
nasa	tirẹ	Nan
narkotika	oogun	Nan
möts	pàdé	Nan
mött	pàdé	Nan
mötte	pàdé	Nan
möttes	pàdé	Nan
münchen	munich	Nan
n	n	Nan
nacka	nacka	Nan
nagasaki	nagasaki	Nan
namibia	namibia	None
namn	orukọ	Nan
namnen	awọn orukọ	Nan
namnet	orukọ	Nan
nancy	nancy	Nan
napoleon	napoleon	Nan
napoleons	napoleon	Nan
mötet	ipade	Nan
målvakt	adena	Nan
målningen	lilọ	Nan
målningar	awọn kikun	Nan
mynnar	ṣiṣi	Nan
mynning	ẹnu	Nan
mynt	owó	Nan
myntade	coined	Nan
myntades	ti a coined	Nan
mysterium	ohun ijinlẹ	Nan
myndigheterna	awọn alaṣẹ	Nan
mystiska	aramada	Nan
mytologi	itan aye atijọ	Nan
mytologin	itan aye atijọ	Nan
mytologiska	itan aye atijọ	Nan
mäktiga	alagbara	Nan
mäktigaste	alagbara julọ	Nan
mälaren	mälaren	Nan
myter	arosọ	Nan
myndigheter	awọn ile ibẹwẹ	Nan
myndigheten	aṣẹ	Nan
myndighet	aṣẹ	Nan
musikstilar	awọn ẹya	Nan
musikvideo	pv	Nan
musikvideon	pv	Nan
musikvideor	awọn fidio orin	Nan
muskler	iṣan	Nan
musklerna	iṣan	Nan
muslim	musulumi	Nan
muslimer	musulumi	Nan
muslimerna	musulumi	Nan
muslimsk	musulumi	Nan
muslimska	musulumi	Nan
mussolini	mussolini	Nan
mussolinis	mussolini	Nan
mutationer	awọn iyipada	Nan
mycket	pupọ	Nan
män	okunrin	None
mängd	iye	Nan
mängden	iye	Nan
mängder	oye	Nan
mästarna	ọga	Nan
mäta	ìwọn	Nan
mäter	ìwọn	Nan
mätningar	iwọn	Nan
mäts	wọn	None
mätt	wọn	None
må	rilara	Nan
mål	ibi-afẹde	Nan
måla	kun	Nan
målade	ya	Nan
målare	ayaworan	Nan
målen	awọn ọran	Nan
måleri	kikun	Nan
målet	ibi ti o nlo	Nan
målning	kikun	Nan
mästare	olori	Nan
nationen	orílẹ-èdè	Nan
märta	irora	Nan
märks	aami	Nan
männen	okunrin	None
människa	eniyan	Nan
människan	eniyan	Nan
människans	ènìyàn	Nan
människas	ènìyàn	Nan
människor	eniyan	Nan
människorna	eniyan	Nan
människors	ènìyàn	Nan
mänsklig	ènìyàn	Nan
mänskliga	ènìyàn	Nan
mänskligheten	ọmọ	None
mänsklighetens	ènìyàn	Nan
mänskligt	ènìyàn	Nan
märke	ṣe	Nan
märken	awọn akọmọ	Nan
märktes	aami	Nan
nationens	orílẹ-èdè	Nan
nationer	awọn orilẹ-ede	Nan
nationerna	awọn orilẹ-ede	Nan
nomineringar	awọn yiyan	Nan
nord	ariwa	Nan
nordafrika	ariwa afirika	Nan
nordamerika	amerika	None
nordamerikanska	amerika	None
norden	ariwa	Nan
nominerades	yan	None
nordens	alaigbagbe	Nan
nordisk	nordic	Nan
nordiska	nordic	Nan
nordiskt	nordic	Nan
nordkorea	koria ile larubawa	Nan
nordkoreanska	ariwa koria	Nan
nordkoreas	koria ile larubawa	Nan
nordirland	àríwá ireland	Nan
nominerad	yan	None
noll	odo	Nan
noga	farabalẹ	Nan
nionde	ẹkẹsan	Nan
nirvana	nirvana	Nan
nivå	ipele	None
nivåer	ipele	None
nivån	ipele	None
nixon	nixon	Nan
njurarna	àrùn	None
nku	nku	Nan
nobel	nobel	None
nobelkommittén	nobel	None
nobelpriset	nobel	None
nobelpristagare	nobel	None
nobels	ẹyẹ	Nan
nobelstiftelsen	nobel	None
nog	boya	Nan
nordliga	ariwa	Nan
nordligaste	ariwa	Nan
nordost	àríwá	Nan
nordsjön	ariwa .kun	Nan
norsk	nowejiani	Nan
norska	nowejiani	Nan
norstedt	norstedt	Nan
norstedts	awọn ikojọpọ	Nan
north	ariwa	Nan
notation	akiyesi	Nan
noter	awọn akọsilẹ	Nan
notera	akiyesi	Nan
noterade	akiyesi	Nan
nou	éù	Nan
nova	ko	None
november	oṣu kọkanla	Nan
now	bayi	None
nr	rara	Nan
nsdap	nsdap	Nan
norrut	si ariwa	Nan
nio	mẹsan	Nan
norrmän	nowejiani	Nan
norrland	ariwa	Nan
nordväst	ariwa iwọ-oorun	Nan
nordvästra	ariwa iwọ-oorun	Nan
nordöst	àríwá	Nan
nordöstra	ariwa iwọ-oorun	Nan
norge	norway	Nan
norges	norway	Nan
normal	deede	Nan
normala	deede	Nan
normalt	ni deede	Nan
norman	norman	Nan
normer	awọn ajohunše	Nan
norr	ariwa	Nan
norra	ariwa	Nan
norrköping	norrköping	Nan
norrköpings	norrköping	Nan
norrlands	koriko	Nan
musiker	olorin	Nan
nilsson	ni nilsson	Nan
nikolaj	nikolaj	Nan
nazisterna	nazis	Nan
nazisternas	ara nazi	Nan
nazistiska	ara nazi	Nan
nazityskland	nazi germany	Nan
nazitysklands	nazi germany	Nan
ned	silẹ	Nan
nazismen	ara nazi	Nan
nedan	ni isalẹ	Nan
nederbörden	ojoriro	Nan
nederlag	ṣẹgun	Nan
nederländerna	fiorino	Nan
nederländska	dutch	Nan
nedgång	kọ	Nan
nedre	kere	Nan
nederbörd	ojoriro	Nan
naturvetenskapliga	imọ	Nan
naturtillgångar	awọn ohun alumọni	Nan
naturresurser	awọn ohun alumọni	Nan
nationernas	awọn orilẹ-ede	Nan
nations	orílẹ-èdè	Nan
nato	adaru	Nan
natt	alẹ	Nan
natten	moju	Nan
nattetid	ni oru	Nan
natur	iseda	Nan
natural	adawa	Nan
naturen	iseda	Nan
naturens	iseda	Nan
naturgas	ategun ayebaye	Nan
naturlig	àbínibí	Nan
naturliga	àbínibí	Nan
naturligt	àbínibí	Nan
naturligtvis	dajudaju	Nan
nedsatt	dinku	Nan
nedåt	silẹ	Nan
need	nilo	Nan
negativ	odi	Nan
newport	newport	Nan
newton	newton	Nan
newtons	newton	Nan
nf	nf	Nan
nhl	nhl	Nan
ni	iwo	Nan
nickel	nickel	Nan
nicklas	nicklas	Nan
niclas	niclas	Nan
nietzsche	nietzsche	Nan
nietzsches	nietzsche	Nan
nigeria	nàìjíríà	None
nikki	nikki	Nan
niklas	niklas	Nan
nikola	nikola	Nan
nevada	nevada	Nan
nils	nils	Nan
neutroner	awọn ẹla ara	Nan
neutralitet	ipinya	Nan
negativa	odi	Nan
negativt	odi	Nan
neil	nehe	Nan
nej	rara	Nan
nelson	nelson	Nan
neo	neo	Nan
neologi	ẹkọ nipa imọ-jinlẹ	Nan
nepal	nẹfisi	Nan
neptunus	neptune	None
ner	silẹ	Nan
nere	silẹ	Nan
nervosa	omowe	Nan
nervsystemet	eto aifọkanbalẹ	Nan
neutral	didoju	Nan
neutrala	didoju	Nan
neutralt	didoju	Nan
ludvig	ludvig	Nan
skillnaderna	awọn iyatọ	Nan
skiva	disiki	Nan
utrikespolitiska	eto imulo ajeji	Nan
utropade	kigbe	Nan
utropades	kede	Nan
utrotning	iparun	Nan
utrustning	èlò	None
utrymme	aaye	Nan
utrikespolitiken	eto imulo ajeji	Nan
utsatt	han	Nan
utsattes	tẹriba	Nan
utse	yan	None
utsedd	sọtọ	Nan
utseende	hihan	Nan
utser	yan	None
utses	sọtọ	Nan
utsatta	alailewu	Nan
utrikespolitik	eto imulo ajeji	Nan
utrikesminister	minisita ajeji	Nan
utrikes	ajeji	Nan
utmärker	se apejuwe	Nan
utmärks	ijuwe	Nan
utmärkt	o tayọ	Nan
utnyttja	lo	Nan
utnyttjade	lilo	Nan
utnyttjar	lilo	Nan
utnyttjas	lilo	Nan
utnämndes	ti a npè ni	Nan
utom	ayafi	Nan
utomeuropeiska	okeokun	Nan
utomlands	odi	Nan
utomliggande	aranse	Nan
utomstående	ode	Nan
utredning	iwadii	Nan
utredningen	iwadii	Nan
utskott	igbimo	Nan
utmärkelser	ẹbun	Nan
utsläpp	awọn itujade	Nan
utsträckning	iye	Nan
utvalda	yan	None
utveckla	dagbasoke	None
utvecklad	idagbasoke	None
utvecklade	idagbasoke	None
utvecklades	idagbasoke	None
utvecklandet	idagbasoke	None
uttryckte	ti ṣalaye	Nan
utvecklar	ndagba	Nan
utvecklat	idagbasoke	None
utvecklats	idagbasoke	None
utveckling	idagbasoke	None
utvecklingen	idagbasoke	None
utvidgade	ti fẹ	Nan
utvidgning	gbooro	Nan
utvecklas	dagbasoke	None
uttryckt	ti ṣalaye	Nan
uttryckligen	kiakia	Nan
uttrycket	ikosile	Nan
utställning	ifihan	Nan
utsätts	han	Nan
utsåg	yan	None
utsågs	ti a daruko	Nan
utsöndras	ti fipamọ	Nan
uttal	ìpolongo	None
uttalade	oyè	Nan
uttalande	alaye	Nan
uttalanden	awọn alaye	Nan
uttalas	oyè	Nan
uttalat	oyè	Nan
uttalet	awọn pronunciation	Nan
uttryck	ikosile	Nan
uttrycka	han	Nan
uttrycker	n ṣalaye	Nan
utspelar	ṣeto	Nan
utmärkelsen	eye	Nan
utmärkande	ti iwa	Nan
utmed	pẹlú	Nan
utbrett	tànkálẹ	Nan
utbrott	ìbújáde	Nan
utbröt	parun	Nan
utbud	ibiti	None
utbyggda	ti fẹ	Nan
utbyggnad	idagbasoke	None
utbredning	tànkálẹ	Nan
utbyggt	ti fẹ	Nan
utdelades	funni	Nan
utdöda	parun	Nan
ute	jade	Nan
uteslutande	iyasọtọ	Nan
utformade	akoso	Nan
utformning	iṣeto	Nan
utbyte	paṣipaarọ	Nan
utbredda	ibigbogbo	Nan
utbredd	ibigbogbo	Nan
utbildningen	idanileko	Nan
ursprungligen	ni akọkọ	Nan
ursprungsbefolkning	onile	Nan
ursprungsbefolkningen	onile	Nan
ursäkt	ikewo	Nan
uruguay	urur	Nan
urval	yiyan	Nan
usa	amẹrika	Nan
usama	usama	Nan
usas	amẹrika	Nan
ut	jade	Nan
utan	laisi	Nan
utanför	ita	Nan
utbildad	gboye	Nan
utbildade	gboye	Nan
utbildning	idanileko	Nan
utformningen	agbekalẹ	Nan
utfärdade	ti oniṣowo	Nan
utför	sise	None
utföra	ṣe	Nan
utgör	je	Nan
utgöra	aṣoju	Nan
utgörs	ni ninu	Nan
utifrån	lati	Nan
utkanten	eti	Nan
utkom	atejade	Nan
utkämpades	ja	Nan
utlandet	odi	Nan
utlopp	ijade	Nan
utländsk	ajeji	Nan
utländska	ajeji	Nan
utlänningar	àlejò	Nan
utlösa	okunfa	Nan
utlösning	itusilẹ	Nan
utlöste	lo jeki	Nan
utgåvor	awọn ẹda	Nan
utvinna	jade	Nan
utgåvan	àtúnse	Nan
utgår	paarẹ	Nan
utföras	ošišẹ	Nan
utförd	ošišẹ	Nan
utförda	pa	Nan
utfördes	ošišẹ	Nan
utförs	ošišẹ	Nan
utfört	ošišẹ	Nan
utgavs	ti oniṣowo	Nan
utgick	ti ara ẹni	Nan
utgifter	inawo	Nan
utgiven	satunkọ	Nan
utgivna	ti oniṣowo	Nan
utgivningen	itusilẹ	Nan
utgjorde	wà	Nan
utgjordes	je	Nan
utgångspunkt	ibẹrẹ	Nan
utgåva	àtúnse	Nan
ursprungliga	atilẹba	Nan
utvinns	gba	None
utåt	si ita	Nan
vart	nibo	Nan
varuhus	ile itaja ẹka	Nan
varv	yiyi	Nan
varvid	nibiti	Nan
vasa	vasa	Nan
vasaloppet	vasaloppet	Nan
varsin	kọọkan	Nan
vasas	vasa	Nan
vatten	omi	None
vattendrag	omi	None
vattenkraft	hydroelectric	Nan
vattenånga	omi	None
vattnet	omi	None
vattnets	omi	None
vatikanstaten	ilu vatican	Nan
vars	tani	Nan
varpå	ibẹ	Nan
varor	ẹru	Nan
varierar	yatọ	Nan
varierat	iyatọ	Nan
varifrån	nibo	Nan
varit	ti	Nan
varje	kọọkan	Nan
varken	bẹni	Nan
varm	loworo	Nan
varma	gbona	Nan
varmare	igbona	Nan
varmblod	eje gbona	Nan
varmed	wà pẹlu	Nan
varmt	gbona	Nan
varna	kilọ	Nan
varnade	kilọ	Nan
varning	ikilọ	Nan
vd	alase	Nan
varierande	orisirisi	None
vecka	ọsẹ	Nan
veckor	ọsẹ	Nan
verklighet	otito	Nan
verkligheten	gidi	Nan
verksam	ṣiṣẹ	Nan
verksamhet	isẹ	Nan
verksamheten	iṣowo	Nan
verksamheter	mosi	Nan
verkligen	looto	Nan
verksamma	lọwọ	Nan
verktyg	irinse	Nan
vers	ẹsẹ	None
versaillesfreden	alaafia	None
version	ẹya	Nan
versionen	itusilẹ	Nan
versioner	awọn ẹya	Nan
verkställande	adari	Nan
verkliga	gidi	Nan
verklig	gidi	Nan
verket	ohun ọgbin	Nan
veckorna	ọsẹ	Nan
vegas	vegas	Nan
velat	feran	Nan
vem	àjọ who	Nan
venedig	icede	Nan
venezuela	venezuela	None
venus	ẹṣẹ	Nan
verde	verde	Nan
verk	iṣẹ	Nan
verka	iṣe	Nan
verkade	dabi enipe	Nan
verkan	ipa	Nan
verkar	dabi	Nan
verkat	ṣe	Nan
verken	eweko	Nan
veckan	ọsẹ	Nan
varierade	iyatọ	Nan
variera	yatọ	Nan
variationer	awọn iyatọ	Nan
valet	idibo	Nan
valla	epo-eti	Nan
valley	àfonífojì	Nan
vallhund	oluso-aguntan	Nan
valrörelsen	idibo	Nan
valt	yan	None
valen	awọn idibo	Nan
valuta	owo	Nan
vampyr	fanpaya	Nan
vampyren	fanpaya	Nan
vampyrer	fanpaya	Nan
van	ayokele	Nan
vana	ihuwasi	Nan
vandrar	alarinkiri	Nan
valutan	owo	Nan
valdes	dibo	Nan
valde	yọ	None
valda	yan	None
utökade	gbooro	Nan
utökat	ti fẹ	Nan
utöva	ere idaraya	Nan
utövade	tiraka	Nan
utövar	adaṣe	Nan
utövas	tiraka	Nan
vacker	lẹwa	Nan
vackra	lẹwa	Nan
vad	kini	Nan
vaginalt	obo	Nan
vagn	kẹ̀kẹ́ ẹṣin	Nan
vagnar	àwọn ọkọ̀ kẹ̀kẹ́	Nan
val	yiyan	Nan
valborg	valborg	Nan
vald	yan	None
vanföreställningar	itanjẹ	Nan
vanlig	wọpọ	Nan
vanliga	tẹlẹ	Nan
vanligare	wọpọ	Nan
vardagligt	àjọsọpọ	Nan
vardera	kọọkan	Nan
vare	sí	Nan
varefter	nigba ti	Nan
varelse	ẹda	Nan
varelser	awọn ẹda	Nan
varför	idi	Nan
varg	ikooko	Nan
vargar	ìkookò	Nan
vargen	ikooko	Nan
variant	iyatọ	Nan
varianten	iyatọ	Nan
varianter	awọn iyatọ	Nan
varianterna	awọn iyatọ	Nan
variation	iyatọ	Nan
vardagliga	lojojumo	Nan
utvisning	irekọja	Nan
vardagen	lojojumo	Nan
varar	na	Nan
vanligast	wọpọ	Nan
vanligaste	wọpọ julọ	Nan
vanligen	nigbagbogbo	Nan
vanligt	tẹlẹ	Nan
vanligtvis	nigbagbogbo	Nan
vann	bori	Nan
vanns	bori	Nan
vapen	awọn ọwọ	Nan
vapnen	awọn ohun ija	Nan
vapnet	agbara	None
var	nibo	Nan
vara	jẹ	Nan
varade	pẹ	Nan
varandra	olukuluuku ara wa	Nan
varandras	eachothers	Nan
varav	ewo	Nan
ursprunget	oti	Nan
ursprung	oti	Nan
urskilja	ṣe iyatọ	Nan
uggla	owiwi	Nan
ugglas	ugglas	Nan
uk	uk	Nan
ukraina	yukirenia	Nan
ukrainas	yukirenia	Nan
ukrainska	yukirenia	Nan
ugandas	uganda	Nan
ulf	ulf	Nan
ulrich	ulrich	Nan
ultraviolett	ultraviolet	Nan
umgänge	ajọṣepọ	Nan
und	ati be be lo	Nan
undan	kuro	Nan
undantag	ayafi	Nan
ullevi	ullevi	Nan
uganda	uganda	Nan
uefacupen	uefa cup	Nan
uefa	uefa	Nan
tätort	ilu	Nan
tätorten	agglomeration	Nan
tätorter	agglomerations	Nan
tätt	fẹẹrẹ	Nan
tävla	dije	Nan
tävlade	idije	Nan
tävling	idije	Nan
tävlingar	meya-ije	Nan
tävlingen	idije	Nan
tåg	ọkọ oju-irin	Nan
tågen	awọn ọkọ oju-irin	Nan
tåget	ọkọ oju-irin	Nan
tål	withstand	Nan
u+	éù +	Nan
udda	odd	Nan
undantaget	itusilẹ	Nan
tätbefolkade	gbe	None
under	lakoko	Nan
underarten	subspepes	Nan
undvika	fun	None
undviker	fun	None
unesco	unesco	Nan
unescos	unesco	Nan
ung	odo	Nan
unga	odo	Nan
undre	kere	Nan
ungar	ọmọ	None
ungdom	ọdọ	Nan
ungdomar	ọdọ	Nan
unge	odo	Nan
ungefär	sunmọ	Nan
ungern	họnari	Nan
ungerns	họnari	Nan
ungarna	ọmọ	None
undervisningen	nkọ́ni	Nan
undervisning	nkọ́ni	Nan
undervisade	kọ	Nan
underarter	subspepes	Nan
undergång	iṣubu	Nan
underhåll	itọju	Nan
underhållning	idanilaraya	Nan
underjordiska	ipamo	Nan
underliggande	labẹ	Nan
underlätta	dẹrọ	Nan
underlättar	sise	None
underordnade	ipin	None
undersöka	yẹwo	Nan
undersökning	iwadii	Nan
undersökningar	awọn ijinlẹ	Nan
undersökte	ayewo	Nan
undertecknades	fowo si	Nan
underverk	awọn iyanu	Nan
underart	subspepes	Nan
täta	èdìdì	Nan
tät	sunmọ	Nan
tänkte	ṣayẹwo	Nan
tvister	àríyànjiyàn	Nan
tvkanaler	awọn ikanni tv	Nan
tvprogram	awọn eto tv	Nan
tvserie	ere telifisonu	Nan
tvserien	awọn tv serie	Nan
tvserier	ere telifisonu	Nan
tvingats	agbara	None
tvskådespelare	tvskådespelare	Nan
tvungna	ní	None
tvärtom	ko	None
två	meji	Nan
tvåa	ikeji	Nan
twilight	alẹ́	Nan
ty	fun	None
tvungen	agbara	None
tvingas	agbara	None
tvingades	agbara	None
tvingade	agbara	None
turkiets	tọki	Nan
turkisk	tooki	Nan
turkiska	tooki	Nan
turner	turner	Nan
turnera	ajo	None
turnerade	irin kiri	Nan
turneringen	figagbaga	Nan
turné	ajo	None
turnéer	ajo	None
turnén	ajo	None
tusen	ẹgbẹrun	Nan
tusentals	egbegberun ti	Nan
tv	tv	Nan
tvfilm	movie movie	Nan
tvinga	ipa	Nan
tycker	ronu	Nan
tyckte	ronu	Nan
tycktes	dabi enipe	Nan
tyder	tọka	Nan
tyst	ipalọlọ	Nan
tyvärr	laanu	Nan
täcka	ideri	Nan
täcker	awọn ibora	Nan
täcks	ti bo	Nan
täckt	ti bo	Nan
tämligen	dipo	Nan
tänder	eyin	None
tänderna	eyin	None
tänka	ronu	Nan
tänkande	lerongba	Nan
tänkandet	lerongba	Nan
tänkare	ironu	Nan
tänker	lerongba	Nan
tänkt	ronu	Nan
tyskt	jẹmánì	Nan
ungerska	ara ilu hungary	Nan
tysklands	jẹmánì	Nan
tyske	jẹmánì	Nan
tydlig	ko	None
tydliga	ko	None
tydligt	kedere	Nan
tyngre	wuwo julọ	Nan
typ	oriṣi	Nan
typen	oriṣi	Nan
typer	awọn oriṣi	Nan
typerna	awọn oriṣi	Nan
typisk	aṣoju	Nan
typiska	aṣoju	Nan
typiskt	aṣoju	Nan
tysk	jẹmánì	Nan
tyska	jẹmánì	Nan
tyskar	awọn ara jamani	Nan
tyskarna	awọn ara jamani	Nan
tyskland	jẹmánì	Nan
uniform	aṣọ	Nan
unik	alailẹgbẹ	Nan
unika	alailẹgbẹ	Nan
upproret	rogbodiyan	None
upprustning	isodi titun	Nan
upprätta	fi	None
upprättade	gbaradi	Nan
upprättades	mulẹ	Nan
upprättandet	igbekale	Nan
uppror	iṣọtẹ	Nan
upprättas	mulẹ	Nan
upprätthåller	ntẹnumọ	Nan
uppsala	uppsala	Nan
uppskatta	mọrírì	Nan
uppskattad	mọrírì	Nan
uppskattade	ifoju	Nan
uppskattades	ifoju	Nan
upprätthålla	ṣetọju	Nan
upprepade	tun	Nan
uppnått	pàdé	Nan
uppnås	gba	None
upplysningstiden	alaye akoko	Nan
upplösning	ipinnu	Nan
upplösningen	itu	None
upplöstes	tuwonka	Nan
uppmanade	ti a pe	Nan
uppmaning	pe	Nan
uppmuntrade	iwuri	Nan
uppmärksamhet	akiyesi	Nan
uppmärksammad	ṣe akiyesi	Nan
uppmärksammade	akiyesi	Nan
uppmärksammades	akiyesi	Nan
uppmärksammat	akiyesi	Nan
uppnå	ṣaṣeyọri	Nan
uppnådde	waye	Nan
uppnår	awọn iyọrisi	Nan
uppskattar	awọn iṣiro	Nan
uppskattas	ifoju	Nan
uppskattning	ti siro	Nan
uppskattningar	awọn iṣiro	Nan
upptäckt	awari	None
upptäckte	awari	None
upptäckten	awari	None
upptäckter	awari	None
upptäcktes	ri	Nan
uppvisade	fihan	None
uppvisar	awọn ifihan	Nan
uppvärmning	alapapo	Nan
uppvärmningen	alapapo	Nan
uppväxt	ewe	None
uppåt	sókè	Nan
ur	lati	Nan
uralbergen	awọn oke ural	Nan
uran	kẹmika	Nan
urin	ito	Nan
upptäcks	ri	Nan
upplysningen	itanna	Nan
upptäcker	ṣawari	Nan
uppträder	waye	Nan
uppskattningsvis	ifoju	Nan
uppslagsordet	ọrọ wiwa	Nan
uppslagsverk	encyclopedia	Nan
uppstod	dide	Nan
uppstå	dide	Nan
uppståndelse	aruwo	Nan
uppstår	gbogbo	Nan
uppstått	ṣẹlẹ	Nan
uppsving	igbelaruge	Nan
uppsättning	ṣeto	Nan
upptagen	ti tẹdo	Nan
upptar	wa lori	Nan
uppträda	ìṣe	Nan
uppträdande	imuṣere	Nan
uppträdde	ṣẹlẹ	Nan
upptäcka	iwari	Nan
vet	mọ	Nan
upplysning	alaye	Nan
upplevelser	awọn iriri	Nan
uppdelningen	pipin	Nan
uppdrag	ise	Nan
uppdraget	iṣẹ iyansilẹ	Nan
uppe	sókè	Nan
uppehåll	ojo	None
uppemot	sókè	Nan
uppdelning	pipin	Nan
uppenbarelse	ifihan	Nan
uppfann	ti a se	Nan
uppfanns	ti a se	Nan
uppfatta	loye	Nan
uppfattade	gbọye	Nan
uppfattar	loye	Nan
uppfattas	gbọye	Nan
uppenbarelser	awọn ifihan	Nan
uppdelat	pin	Nan
uppdelade	fifọ	Nan
uppdelad	pin	Nan
unikt	lọtọ	Nan
union	euroopu	Nan
unionen	euroopu	Nan
unionens	euroopu	Nan
universitet	yunifasiti	Nan
universiteten	egbelegbe	Nan
universitetet	yunifasiti	Nan
universum	agbaye	None
universums	agbaye	None
uno	ṣii	Nan
up	sókè	Nan
upp	sókè	Nan
uppbyggd	ti eleto	Nan
uppbyggnad	ikole	Nan
uppbyggt	ti eleto	Nan
uppfattning	iwoye	Nan
uppfattningar	iro	Nan
uppfattningen	iwo	Nan
uppfinnare	olupilẹṣẹ	Nan
upphovsrätten	aṣẹkikọ	Nan
upphörde	dáwọ	Nan
upphört	dawọ duro	Nan
uppkallad	ti a npè ni	Nan
uppkom	dide	Nan
uppkommer	waye	Nan
uppkommit	waye	Nan
uppkomst	oti	Nan
uppkomsten	hihan	Nan
upplaga	àtúnse	Nan
upplagan	àtúnse	Nan
upplagor	awọn itọsọna	Nan
uppleva	iriri	Nan
upplevde	awọn iriri	Nan
upplevelse	iriri	Nan
upphovsrätt	aṣẹkikọ	Nan
upplever	iriri	Nan
upphovsman	onkọwe	Nan
uppgörelse	pinpin okun	Nan
uppfinningar	awọn ipilẹṣẹ	Nan
uppfostran	igbega	Nan
uppfylla	pàdé	Nan
uppfyller	mu ṣẹ	Nan
uppföljare	atele	Nan
uppförande	ihuwasi	Nan
uppfördes	tẹre	Nan
uppgav	ṣalaye	Nan
uppger	ipinle	Nan
uppges	royin	Nan
uppgick	iye	Nan
uppgift	iṣẹ-ṣiṣe	Nan
uppgiften	iṣẹ-ṣiṣe	Nan
uppgifter	awọn iṣẹ-ṣiṣe	Nan
uppgifterna	alaye	Nan
upphov	dide	Nan
turkiet	tọki	Nan
veta	mọ	Nan
vetenskap	sayensi	Nan
än	ju	Nan
ända	ipari	Nan
ändamål	idi	Nan
ände	ipari	Nan
änden	ipari	Nan
ändra	yipada	None
ämnet	koko naa	Nan
ändrade	yipada	None
ändrar	yipada	None
ändras	yipada	None
ändrat	yipada	None
ändringar	awọn ayipada si	Nan
ändå	tun	Nan
änglar	awọn angẹli	Nan
ändrades	yipada	None
ämnena	oludoti	Nan
ämnen	oludoti	Nan
ämne	koko	Nan
ägs	ohun ini	Nan
ägt	mu	Nan
äkta	ojulowo	Nan
äktenskap	igbeyawo	None
äktenskapet	igbeyawo	None
äldre	agbalagba	Nan
äldsta	akọbi	Nan
äldste	alàgbà	Nan
älg	moose	Nan
älgar	moose	Nan
älgen	agbọnrin	Nan
älska	ni ife	Nan
älskade	fẹràn	Nan
älskar	ni ife	Nan
ämbetsmän	awọn olori	Nan
ängssyra	sorrel	Nan
ägnar	awọn ọrọ	Nan
ännu	sibẹsibẹ	Nan
ära	ọlá	Nan
ångest	aibalẹ	Nan
år	ọdun	Nan
åren	ọdun	Nan
årens	ọdun	Nan
året	ọdun	Nan
årets	ọdun	Nan
ån	lati	Nan
århundraden	sehin	Nan
århundradet	orundun	Nan
årig	atijọ	Nan
åriga	kekere	None
åring	ori	None
årlig	lododun	Nan
årliga	lododun	Nan
århundradena	sehin	Nan
åländska	landia	Nan
ålder	ori	None
ålands	landíà	Nan
ärftliga	ajogun	Nan
ärkebiskop	archbishop	Nan
ärkebiskopen	ilu	Nan
äta	jẹ	Nan
äter	jẹ	Nan
ätten	oba	None
ättlingar	iru-ọmọ	Nan
även	tun	Nan
äventyr	ìrìn	Nan
å	loju	Nan
åka	lọ	Nan
åke	ke	Nan
åker	lọ	Nan
åkte	lọ	Nan
åland	landíà	Nan
är	jẹ	Nan
ägnade	lo	Nan
ägna	na	Nan
ägg	ẹyin	Nan
xii	xii	Nan
xiis	xii	Nan
xis	xis	Nan
yngre	aburo	Nan
yngsta	abikẹhin	Nan
yngste	abikẹhin	Nan
xi	xi	Nan
york	york	None
you	iwo	Nan
youtube	youtube	Nan
yta	dada	Nan
ytan	dada	Nan
ytterligare	siwaju	Nan
ytterst	lalailopinpin	Nan
yorks	york	None
x	x	Nan
wright	wright	Nan
world	agbaye	None
wild	egan	Nan
wilde	wilde	Nan
wilhelm	wilhelm	Nan
will	yoo	None
william	william	Nan
williams	williams	Nan
willy	willy	Nan
wilson	wilson	Nan
wind	afẹfẹ	Nan
winnerbäck	winnerbäck	Nan
winston	winston	Nan
without	laisi	Nan
wittenberg	wittenberg	Nan
wolfgang	wolfgang	Nan
works	awọn iṣẹ	Nan
yttersta	logan	Nan
yttre	lode	Nan
z	z	Nan
zach	zaki	Nan
miljoner	million	Nan
mm	mm	Nan
procent	ogorun	Nan
km²	km²	Nan
°c	° c	Nan
£m	m m	Nan
×	×	Nan
à	à	Nan
äga	tirẹ	Nan
ägande	nini	Nan
ägare	oniwun	Nan
ägda	sáré	Nan
ägde	mu	Nan
ägdes	ohun ini	Nan
äger	tirẹ	Nan
meter	mita	Nan
årligen	ododun	Nan
km²	km²	Nan
km	km	Nan
zagreb	zagreb	Nan
zanzibar	zanzibar	Nan
zarathustra	zoroaster	Nan
zeeland	silandia	Nan
zeppelin	zeppelin	Nan
zeus	zeus	Nan
zink	sinkii	Nan
zirkon	zircon	Nan
zlatan	slatan	Nan
zon	agbegbe aago	Nan
zonen	agbegbe aago	Nan
zoner	awọn agbegbe ita	Nan
zuckerberg	zuckerberg	Nan
cm	cm	Nan
kilometer	kilomita	Nan
kmh	km	Nan
wikipedias	wikipedia	Nan
års	ọdun	Nan
årstiderna	awọn akoko	Nan
östtyska	ila-oorun jẹmánì	Nan
östtyskland	ila-oorun jẹmánì	Nan
östtysklands	ila-oorun jẹmánì	Nan
över	lori	Nan
överallt	ibi gbogbo	Nan
överbefälhavare	balogun	Nan
östtimor	gẹẹsi	Nan
överens	gba	None
överensstämmer	baamu	Nan
överföra	gbigbe	Nan
överföras	gbe	None
överföring	gbigbe	Nan
överförs	gbe	None
övergav	kọ silẹ	Nan
överenskommelse	àdéhùn	Nan
östra	ila-oorun	Nan
östman	östman	Nan
östfronten	iha iwaju	Nan
öst	ila-oorun	Nan
östafrika	ila-oorun afirika	Nan
östasien	ila-oorun ila-oorun	Nan
östberg	ostberg	Nan
östberlin	berlin	None
östblocket	bibi ila-oorun	Nan
öster	ila-oorun	Nan
östergötland	östergötland	Nan
österrike	austria	Nan
österrikes	austria	Nan
österrikeungern	ilu ilu họndee	Nan
österrikiska	ara ilu austrian	Nan
östersjön	okun baltic	Nan
österut	ila-oorun	Nan
östeuropa	iha yuroopu	Nan
övergick	koja	Nan
öronen	etí	Nan
övergrepp	ilokulo	Nan
övergå	rekoja	Nan
översättas	itumọ	Nan
översättning	translation	Nan
översättningar	ogbufọ	Nan
översättningen	translation	Nan
översätts	itumọ	Nan
övertala	yiroro	Nan
översvämningar	omi	None
övertalade	yiro	Nan
övertogs	ti ya	Nan
övertyga	parowa	Nan
övervikt	apọju	Nan
övervägande	bori	Nan
övre	loke	Nan
övrig	omiiran	Nan
övertog	mu	Nan
överst	oke	Nan
översikt	akopọ	Nan
översatt	itumọ	Nan
övergång	orilede	Nan
övergången	orilede	Nan
övergår	dapọ	Nan
överhuvudtaget	ohunkohun ti	Nan
överhöghet	eleda	Nan
överleva	ye	Nan
överlevande	to	None
överlevde	ye	Nan
överlever	ye ye	Nan
överlevnad	iwalaaye	Nan
överlevt	ye	Nan
överlägset	tayọ	Nan
övernaturliga	elekewa	Nan
överraskande	iyalẹnu	Nan
övers	transl	Nan
övergripande	gbogboogbo	Nan
öron	etí	Nan
öresund	ohùn	Nan
örebro	örebro	Nan
återkommande	loorekoore	Nan
återkommer	yoo	None
återkomst	padà	Nan
återställa	mu pada	Nan
återstående	ku	None
återstår	ku	None
återkom	padà	Nan
återta	atunkọ	Nan
återvände	padà	Nan
återvänder	padà	Nan
återvänt	padà	Nan
åtgärder	awọn iṣẹ	Nan
åtminstone	o kere ju	Nan
åtskilda	yà	Nan
återvända	padà	Nan
återigen	lẹẹkansi	Nan
återgick	lọ	Nan
återförening	idaraya	Nan
årsåldern	agbalagba	Nan
årtionde	ewadun	Nan
årtionden	ewadun	Nan
ås	àgbọn	Nan
åsikt	ero	Nan
åsikten	iwo	Nan
åsikter	awọn ero	Nan
åskådare	oluwo	Nan
åstadkomma	ṣaṣeyọri	Nan
åt	ni	Nan
åtal	ibanirojọ	Nan
åtalades	tọka	Nan
åter	tun	Nan
återfanns	gba	None
återfinns	ri	Nan
åtskilliga	lọpọlọpọ	Nan
åtta	mẹjọ	Nan
åttonde	ikẹjọ	Nan
ö	erekusu	Nan
öl	oti sekengberi	Nan
öland	öland.	Nan
ölet	oti sekengberi	Nan
ön	erekusu	Nan
öns	erekusu	Nan
önskade	fẹ	Nan
önskan	fẹ	Nan
önskar	fẹ	Nan
önskemål	awọn ibeere	Nan
öppen	ṣii	Nan
öppet	ṣii	Nan
öppna	ṣi	Nan
öppnade	ṣí	Nan
öppnades	ṣí	Nan
öppnat	ṣí	Nan
ökningen	pọ si	Nan
årsdag	aseye	Nan
ökning	pọ si	Nan
ökenråttor	awọn aranmọ kokoro	Nan
öar	erekusu	Nan
öarna	erekusu	Nan
öde	ojuuṣe	Nan
ödleblad	houttuynia cordata	Nan
öga	oju	Nan
ögat	oju	Nan
ögon	oju	Nan
ögonen	awọn oju	Nan
öka	pọ si	Nan
ökad	pọ si	Nan
ökade	pọ si	Nan
ökande	npo si	Nan
ökar	posi	Nan
ökat	pọ si	Nan
öken	aṣálẹ	Nan
öknen	aṣálẹ	Nan
wikipedia	wikipedia	Nan
wien	vienna	Nan
who	àjọ who	Nan
visat	ri	Nan
visats	ṣafihan	Nan
visby	visby	Nan
visdom	ọgbọn	Nan
vision	ìran	Nan
visor	awọn orin	Nan
visas	ti han	Nan
viss	dajudaju	Nan
visserligen	gba	None
visst	dajudaju	Nan
visste	mọ	Nan
vista	vista	Nan
vistas	duro	Nan
vistelse	dúró	None
vissa	diẹ ninu	Nan
visar	fihan	None
visades	ti han	Nan
visade	fihan	None
vinsten	jere	Nan
vinster	awọn ere	Nan
vinter	otutu	None
vintergatan	wara	Nan
vinterkriget	otutu	None
vintern	otutu	None
vinterspelen	otutu	None
vintertid	otutu	None
vintrar	winitutu	Nan
vintrarna	winitutu	Nan
virginia	virginia	Nan
virus	àrùn	None
viruset	arun	None
vis	ọna	Nan
visa	ṣafihan	Nan
vit	funfun	Nan
vinst	èrè	Nan
vita	funfun	Nan
vitt	funfun	Nan
vuxit	dagba	Nan
vuxna	agbalagba	Nan
väckt	mu	Nan
väckte	ji	Nan
väder	ojo	None
vädret	ojo	None
vuxen	agba	None
väg	ọna	Nan
vägarna	awọn ọna	Nan
vägen	ọna	Nan
väger	wọn	None
vägg	ogiri	Nan
vägnät	opopona opopona	Nan
vägnätet	opopona opopona	Nan
vägar	awọn ọna	Nan
vunnit	bori	Nan
vulkanutbrott	iparun	Nan
vulkaniska	onina aruwo	Nan
vittne	ẹlẹri	Nan
vittnen	awọn ẹlẹri	Nan
vladimir	irina	Nan
vm	vm	Nan
voddler	voddler	Nan
vojvodina	vojvodina	Nan
vojvodskap	voivodeship	Nan
vol	v	Nan
voltaire	voltaire	Nan
volvo	volvo	Nan
volym	iwọn didun	Nan
von	von	Nan
vore	yoo	None
vrida	yiyi	Nan
vulkaner	onina	Nan
vitryssland	belarus	None
vinner	aamieye	Nan
vinnaren	olubori	Nan
vinnare	olubori	Nan
vidsträckta	gbooro	Nan
vidta	mu	Nan
vietnam	vietnam	Nan
vietnamesiska	ede	None
vietnamkriget	ogun	None
vietnams	vietnam	Nan
videon	fidio	Nan
viggo	viggo	Nan
vika	agbo	Nan
viken	gulfkun	Nan
viking	viking	Nan
vikingar	vikings	Nan
vikingarna	awọn vikings	Nan
vikingatiden	akoko gigun	Nan
vii	vii	Nan
video	fidio	Nan
vidare	siwaju	Nan
vida	jinna	Nan
vetenskapen	sayensi	Nan
vetenskaplig	sayensi	Nan
vetenskapliga	sayensi	Nan
vetenskapligt	sayensi	Nan
vetenskapsmän	sayensi	Nan
veto	veto	Nan
vhs	vhs	Nan
vi	àwa	Nan
via	nipasẹ	Nan
vice	igbakeji	Nan
vicepresident	igbakeji	Nan
victor	segun	Nan
victoria	iṣẹgun	Nan
victoriasjön	lake victoria	Nan
vid	ni	Nan
vikt	iwuwo	Nan
vikten	iwuwo	Nan
viktig	pataki	Nan
viktiga	pataki	Nan
villor	abule	Nan
vimmerby	vimmerby	Nan
vin	waini	Nan
vincent	vincent	Nan
vinci	vinci	Nan
vind	afẹfẹ	Nan
vindar	efuufu	Nan
vinden	aja	Nan
vindkraft	afẹfẹ	Nan
vindkraftverk	ategun	Nan
vingar	iyẹ	Nan
vinkel	ọrun	Nan
vinkeln	igun	Nan
vinklar	awọn igun	Nan
vinna	ṣẹgun	Nan
villkoren	ipo	None
vägrade	kọ	Nan
villkor	ofin	None
villa	villa	None
viktigare	pataki	Nan
viktigaste	pataki	Nan
viktigt	pataki	Nan
viktor	viktor	Nan
vila	sinmi	Nan
vilar	sinmi	Nan
vilda	egan	Nan
vilhelm	vilhelm	Nan
vilja	yoo	None
viljan	yoo	None
vilka	ewo	Nan
vilkas	tani	Nan
vilken	ewo	Nan
vilket	ewo	Nan
vill	fe	Nan
ville	fẹ	Nan
vägrar	kọ	Nan
väl	daradara	Nan
väldet	ottoman	Nan
växter	eweko	Nan
växterna	eweko	Nan
växthuseffekten	eefin ipa	Nan
växthusgaser	ghg	Nan
våg	igbi	Nan
vågade	da	None
växte	dagba	Nan
vågen	igbi	Nan
vågor	waves	Nan
våld	iwa-ipa	Nan
våldet	iwa-ipa	Nan
våldsam	iwa-ipa	Nan
våldsamma	iwa-ipa	Nan
våningar	ipele	None
våglängder	igbin	Nan
växt	ohun ọgbin	Nan
växjö	växjö	Nan
växer	dagba	Nan
västeuropa	iha yuroopu	Nan
västindien	karibeanu	Nan
västkusten	oorun oorun	Nan
västlig	westerly	Nan
västliga	oorun	Nan
västmakterna	agbara	None
västra	oorun	Nan
västsahara	iwọ-oorun iwọ-oorun	Nan
västtyskland	jẹ́mánì	None
västvärlden	oorun	Nan
väte	hydrogen	Nan
vätet	hydrogen	Nan
vätska	omi	None
växa	dagba	Nan
växande	ndagba	Nan
vår	omi	None
våra	tiwa	Nan
vård	itọju	Nan
våren	omi	None
waterloo	waterloo	Nan
watson	watson	Nan
way	ọna	Nan
wayne	wayne	Nan
we	àwa	Nan
webbkällor	orisun	None
webbplats	aaye ayelujara	Nan
webbplatsen	aaye ayelujara	Nan
webbplatser	awọn oju opo wẹẹbu	Nan
weber	oyin	Nan
welsh	àwæn	Nan
wembley	agbara	None
werner	werner	Nan
west	oorun	Nan
what	kini	Nan
washington	washington	Nan
västerås	västerås	Nan
warszawa	warsaw	Nan
warhol	warhol	Nan
vårt	tiwa	Nan
w	w	Nan
wagner	wagner	Nan
wahlgren	wahlgren	Nan
wailers	wailers	Nan
wales	oyo	Nan
wall	ogiri	Nan
wallace	wallace	Nan
wallander	alagbede	Nan
wallenberg	wallenberg	Nan
wallenstein	wallenstein	Nan
walt	wolii	Nan
walter	walter	Nan
want	fẹ	Nan
war	ogun	None
warner	onilọ	Nan
vete	alikama	Nan
västerut	iwọ oorun	Nan
västerländsk	oorun	Nan
vänster	osi	Nan
vänstern	òsì	Nan
vänsterpartiet	osi	Nan
vänstra	osi	Nan
vänt	nduro	Nan
vänta	duro de	Nan
vänskap	ore	Nan
väntade	duro	Nan
väntar	nduro	Nan
väntas	o ti ṣe yẹ	Nan
väntat	o ti ṣe yẹ	Nan
väpnad	ni ihamọra	Nan
väpnade	ologun	Nan
värd	agbalejo	Nan
väntan	nduro	Nan
vänner	ọrẹ	Nan
vännen	ololufe	Nan
vänder	oju	Nan
väldiga	alagbara	Nan
väldigt	pupọ	Nan
välfärd	ire	None
välgörenhet	aanu	None
välja	yan	None
väljas	yan	None
väljer	yan	None
väljs	yan	None
välkänd	daradara mọ	Nan
välkända	mọ	Nan
välmående	ọlọrọ	Nan
välstånd	alafia	Nan
vän	ore	Nan
vända	yiyi	Nan
vände	yipada	None
värde	iye	Nan
värdefulla	niyelori	Nan
värden	awọn iye	Nan
värderingar	awọn iye	Nan
värnplikt	ologun	Nan
värnpliktiga	awọn iwe aṣẹ	Nan
värre	buru	Nan
värsta	buru	Nan
värt	tọ	Nan
värvade	tọka si	Nan
väsen	lodi	Nan
väsentligt	idaran	Nan
väska	àpò	Nan
väst	iwọ oorun	Nan
västbanken	oorun oorun	Nan
västberlin	berlin	None
väster	oorun	Nan
västerbottens	västerbottens	Nan
västergötland	västergötland	Nan
värmlands	tuntun	None
västerländska	oorun	Nan
värmland	värmland	Nan
värme	igbona	Nan
värdet	iye	Nan
värld	agbaye	None
världen	agbaye	None
världens	ileaye	Nan
världsarv	aye	Nan
världsarvslista	ajogunba aye	Nan
världsbanken	agbaye	None
världsdel	agbègbè	Nan
världshälsoorganisationen	agbaye	None
världskrigen	agbaye	None
världskriget	agbaye	None
världskrigets	agbaye	None
världsliga	alailesin	Nan
världsrekord	agbaye	None
världsturné	agbaye	None
värmestrålningen	igbona igbona	Nan
skilsmässa	yigi	Nan
turkarna	awọn tooki	Nan
turistmål	oniriajo	Nan
stjärna	irawo	Nan
stjärnan	irawo	Nan
stjärnans	irawo	Nan
stjärnor	irawọ	Nan
stjärnornas	alarinrin	Nan
stockholm	ilu stockholm	Nan
stjäla	jale	Nan
stockholms	nkan	None
stoft	eruku	Nan
stol	alaga	Nan
stolpiller	suppository	Nan
stommen	ara	Nan
stop	duro	Nan
stopp	duro	Nan
stod	wà	Nan
stimulerar	safikun	Nan
stimulera	lowo	Nan
stimulans	ayun	Nan
stenar	okuta	Nan
stephen	stefanu	Nan
steve	steve	Nan
steven	steven	Nan
stewart	sitiwoti	Nan
stieg	gbọn	Nan
stift	pin	Nan
stiftelsen	foundation	Nan
stig	ọnà	Nan
stiga	dide	Nan
stigande	nyara	Nan
stiger	nyara	Nan
stilar	awọn aza	Nan
stilen	ara	Nan
stilla	tun	Nan
stoppa	duro	Nan
sten	okuta	Nan
stoppade	duro	Nan
stora	tobi	Nan
strand	eti okun	Nan
stranden	eti okun	Nan
strategiska	ilana	None
stratton	stratton	Nan
strax	kan	None
streck	laini	Nan
straffet	itanran	Nan
stred	ja	Nan
stress	ibi	Nan
stressorer	awọn onigbọwọ	Nan
strid	ogun	None
strida	rogbodiyan	None
stridande	ija	Nan
striden	ogun	None
street	opopona	Nan
straff	itanran	Nan
story	itan	Nan
stortorget	stortorget	Nan
storbritannien	uk	Nan
storbritanniens	uk	Nan
store	fipamọ	Nan
stores	awọn ile itaja	Nan
storhetstid	titobi	Nan
storkors	agbelebu nla	Nan
storlek	iwọn	Nan
storleken	iwọn	Nan
storm	ìjì	Nan
stormakt	agbara	None
stormakter	agbara	None
stormakterna	agbara	None
stormaktstiden	agbara	None
storstäder	ilu nla	Nan
stort	tobi	Nan
stor	nla	Nan
steget	igbesẹ	Nan
steg	igbesẹ	Nan
stefan	stefan	Nan
stammar	awọn igara	Nan
stammarna	awọn igara	Nan
stan	ilu	Nan
stand	duro	Nan
standard	boṣewa	Nan
stanley	stanley	Nan
stam	ẹyà	Nan
stanna	dúró	None
stannar	duro	Nan
stark	lagbara	Nan
starka	lagbara	Nan
starkare	okun sii	Nan
starkast	lágbára	Nan
starkaste	lágbára	Nan
stannade	dúró	None
stallone	stallone	Nan
stalins	stalin	Nan
stalin	sitárá	Nan
staden	ilu	Nan
stadens	ilu	Nan
stadigt	ìdúróṣinṣin	Nan
stadion	papa-iṣere	Nan
stadium	ipele	None
stadsbild	igboro ilu	Nan
stadsdel	agbegbe	Nan
stadsdelar	adugbo	Nan
stadsdelarna	awọn agbegbe	Nan
stadsdelen	adugbo	Nan
stadshus	gbongan ilu	Nan
stadskärna	aarin	Nan
stadskärnan	aarin	Nan
stadsparken	gbesile ilu	Nan
staffan	staffan	Nan
starkt	lagbara	Nan
start	bẹrẹ	Nan
starta	bẹrẹ	Nan
startade	bẹrẹ	Nan
stats	ipinle	Nan
statschef	ori	None
statschefen	ori	None
statskupp	iyipo	Nan
statsmakten	agbara	None
statsminister	adari igbimọ ijọba	Nan
statsministern	nomba	Nan
statsreligion	esin ipinle	Nan
statsskick	ijọba	Nan
statsöverhuvud	ori	None
status	ipo	None
staty	ere	Nan
statyn	ere	Nan
stavning	akọtọ	Nan
stavningen	akọtọ	Nan
statligt	ipinle	Nan
strider	ogun	None
statliga	ti ijọba	Nan
statistiska	eeka	Nan
startades	bẹrẹ	Nan
startar	bẹrẹ	Nan
startat	bẹrẹ	Nan
starten	bẹrẹ	Nan
stat	ipinle	Nan
state	ipinle	Nan
statens	ipinle	Nan
stater	awọn ipinlẹ	Nan
staterna	awọn ipinlẹ	Nan
staternas	awọn ipinlẹ	Nan
states	awọn ipinlẹ	Nan
station	ibudo	Nan
stationen	ibudo	Nan
stationer	awọn ibudo	Nan
statistik	eeka	Nan
statlig	ipinle	Nan
stad	ilu	Nan
striderna	ogun	None
strikt	muna	Nan
stå	duro	Nan
stående	dúró	None
stål	irin	Nan
stålgemenskapen	irin community	Nan
stånd	duro	Nan
ståndpunkt	ipo	None
stätta	tẹẹrẹ	Nan
står	dúró	None
stöd	atilẹyin	Nan
stödde	atilẹyin	Nan
stöder	atilẹyin	Nan
stödet	iranlowo	Nan
stödja	atilẹyin	Nan
stödjer	atilẹyin	Nan
stått	duro	Nan
stärktes	ni okun	Nan
stärkte	olodi	Nan
stärkelse	sitashi	Nan
ställning	ipo	None
ställningar	ipo	None
ställningen	wole	None
ställs	jẹ	Nan
ställt	ṣeto	Nan
stämma	ipade	Nan
stämmer	tọ	Nan
ständerna	awọn ohun-ini	Nan
ständig	titilai	Nan
ständiga	duro	Nan
ständigt	nigbagbogbo	Nan
stänga	sunmọ	Nan
stängdes	ni pipade	Nan
stängt	ni pipade	Nan
stärka	teramo	Nan
stöds	atilẹyin	Nan
stället	dipo	Nan
störningar	ségesège	Nan
störst	julọ	Nan
super	dara julọ	Nan
supportrar	awọn olufowosi	Nan
sur	ekan	Nan
susan	susan	Nan
sushi	sushi	Nan
sutra	sutra	Nan
sundsvalls	sundsvall	Nan
suttit	joko	Nan
suveräna	ọba	Nan
suveränitet	ọba aláṣẹ	Nan
sv	yo	Nan
svag	ailera	Nan
svaga	ailera	Nan
svagare	alailagbara	Nan
suverän	ọba	Nan
sundsvall	sundsvall	Nan
sund	ìró	None
sun	oorun	Nan
största	tobi julo	Nan
störta	bibu	Nan
störtades	tipẹ	Nan
stöter	sáré	Nan
stött	atilẹyin	Nan
stövare	alairi	Nan
substantiv	nọun	Nan
successivt	àṣeyọrí	Nan
succé	aṣeyọri	Nan
sudan	sudan	Nan
sugga	gbìn	Nan
sultanen	sultan	Nan
summa	iye	Nan
summan	aropọ	Nan
summer	ajigbese	Nan
större	pataki	Nan
ställer	silẹ	Nan
ställen	awọn aaye	Nan
ställe	ibi	Nan
strömmar	lọwọlọwọ	Nan
strömmen	lọwọlọwọ	Nan
strömning	ṣiṣan	Nan
strömningar	lọwọlọwọ	Nan
stuart	stuart	Nan
student	ọmọ	None
ström	lọwọlọwọ	Nan
studenter	omo ile	Nan
studera	iwadi	None
studerade	iwadi	None
studerar	iwadi	None
studeras	iwadi	None
studerat	iwadi	None
studie	iwadi	None
studenterna	omo ile	Nan
strålningen	itu	None
strålning	itu	None
strävhårig	irun-pupa	Nan
strikta	muna	Nan
strindberg	strindberg	Nan
strindbergs	strindbergs	Nan
struktur	be	Nan
strukturen	be	Nan
strukturer	awọn ẹya	Nan
sträckan	ipa ọna	Nan
sträcker	gbooro	Nan
sträckor	awọn ipa ọna	Nan
sträckte	nà	Nan
stränder	awọn eti okun	Nan
sträng	okun	Nan
stränga	àìdá	Nan
strävan	ibere	Nan
strävar	tiraka	Nan
studien	iwadi	None
studier	awọn ijinlẹ	Nan
studierna	awọn ijinlẹ	Nan
studiet	iwadi	None
styrelse	ọkọ	Nan
styrelsen	igbimo oludari	Nan
styrelseskick	ijoba	Nan
styret	ilekun nla	Nan
styrka	okun	Nan
styrkan	okun	Nan
styrkor	agbara	None
styrkorna	awọn ipa	Nan
styrs	dari	Nan
städer	awọn ilu	Nan
städerna	ilu	Nan
ställa	fi	None
ställas	gbaradi	Nan
ställde	ṣeto	Nan
ställdes	gbaradi	Nan
styre	ṣàkóso	Nan
stridigheter	àríyànjiyàn	Nan
styrdes	dari	Nan
styras	dari	Nan
studio	ile isise	Nan
studioalbum	album awo-orin	Nan
studioalbumet	album awo-orin	Nan
studion	ile isise	Nan
studios	awọn ile-iṣere	Nan
stulna	ji	Nan
stund	nigba ti	Nan
stundom	nigbami	Nan
stupade	ṣubú	Nan
sture	iduroṣinṣin	Nan
stycke	ìpínrọ̀	Nan
stycken	awọn ege	Nan
styr	iṣakoso	Nan
styra	iriju	Nan
styrande	ṣàkóso	Nan
styrde	ṣàkóso	Nan
stabilitet	iduroṣinṣin	Nan
stabila	idurosinsin	Nan
stabil	idurosinsin	Nan
slutade	ti pari	Nan
slutar	pari	Nan
slutat	gun	None
slutet	ipari	Nan
slutgiltiga	ipari	Nan
slutliga	ipari	Nan
sluta	duro	Nan
slutligen	lakotan	Nan
slutsatsen	pari	Nan
slutsatser	awọn ipinnu	Nan
släkt	idile	Nan
släkten	se ina	Nan
släktet	iwin	Nan
släkting	ibatan	Nan
slutsats	ipari	Nan
slut	ipari	Nan
slovenska	ede	None
slovenien	slovenia	Nan
slag	irú	Nan
slaget	ọgbẹ	Nan
slagit	lu	Nan
slags	too ti	Nan
slavar	ẹrú	Nan
slaveriet	oko-ẹru	Nan
slaviska	slavic	Nan
slidan	obo	Nan
slipknot	isokuso	Nan
slippa	fun	None
slog	lu	Nan
slogs	ja	Nan
slott	ile kasulu	Nan
slottet	ile odi	Nan
slovakien	slovakia	Nan
släktingar	awọn ibatan	Nan
sköttes	ti a ṣiṣe	Nan
släktskap	ibatan	Nan
släppas	tu silẹ	Nan
smguld	smguld	Nan
smith	smith	Nan
smitta	akoran	Nan
smycken	ohun ọṣọ	Nan
smält	yo	Nan
smärta	irora	Nan
smeknamnet	inagije	Nan
små	kekere	None
smålands	smålands	Nan
småningom	di .di.	Nan
snabb	yara	Nan
snabba	yiyara	Nan
snabbare	yara ju	Nan
snabbast	yiyara	Nan
småland	småland	Nan
smeknamn	inagije	Nan
smallwood	kekere	None
smala	dín	Nan
släpper	itusilẹ	Nan
släpps	tu silẹ	Nan
släppt	tu silẹ	Nan
släppte	tu silẹ	Nan
släpptes	tu silẹ	Nan
släppts	tu silẹ	Nan
slå	lu	Nan
slår	lu	Nan
slås	yi pada	Nan
slåss	ja	Nan
slöt	ni pipade	Nan
slöts	k.	Nan
sm	sm	Nan
smak	itọwo	Nan
smaken	adun	Nan
släppa	silẹ	Nan
sköts	gbon	Nan
sköter	ṣakoso	Nan
sköta	mu	Nan
skorpan	erunrun	Nan
skotsk	ara ilu scotland	Nan
skotska	ara ilu scotland	Nan
skott	gbon	Nan
skottland	ilu scotland	Nan
skov	pada sẹhin	Nan
skor	awọn bata	Nan
skrev	kọ	Nan
skrift	kikọ	Nan
skriften	rara.	Nan
skrifter	awọn iwe	Nan
skrifterna	bẹẹkọ	Nan
skriftliga	kọ	Nan
skriva	kọ	Nan
skrevs	oṣu kẹjọ	Nan
skolorna	awọn ile-iwe	Nan
skolor	awọn ile-iwe	Nan
skolgång	ile-iwe	Nan
skivan	disiki	Nan
skivbolag	aami	Nan
skivbolaget	aami	Nan
skivkontrakt	iwe gbigbasilẹ	Nan
skivor	awọn disiki	Nan
skivorna	awọn disiki	Nan
skjuta	iyaworan	Nan
skjuten	gbon	Nan
skjuter	gbon	Nan
skog	igbo	Nan
skogar	igbo	Nan
skogarna	igbo	Nan
skogen	igbó	Nan
skola	ile-iwe	Nan
skolan	ile-iwe	Nan
skrivas	tejede	Nan
skriven	kọ	Nan
skriver	kọ	Nan
skrivet	tun	Nan
skyskrapor	awọn ọkọ ofurufu oju-ọrun	Nan
skäl	idi	Nan
skär	ogbontarigi	Nan
skära	ge	Nan
skärgård	archipelago	Nan
skådespelare	oṣere	Nan
skådespelaren	oṣere	Nan
skådespelarna	awọn oṣere	Nan
skådespelerska	oṣere	Nan
skåne	skåne	Nan
skånes	scania	Nan
skånska	skånska	Nan
skönhet	ẹwa	Nan
skönlitteratur	itan-akọọlẹ	Nan
sköt	gbon	Nan
skyldig	jẹbi	Nan
snabbaste	yiyara	Nan
skyddas	ni idaabobo	Nan
skyddade	ni idaabobo	Nan
skrivit	kọ	Nan
skrivits	kọ	Nan
skrivna	kọ	Nan
skrivs	tejede	Nan
skräck	ibanilẹru	Nan
skuggan	iboji	Nan
skuld	gbese	None
skulden	gbese	None
skulder	gbese	None
skull	nitori	Nan
skulle	yoo	None
skulptur	ere	Nan
sky	ọrun	Nan
skydd	aabo	Nan
skydda	dáàbò	Nan
skyddar	apata	Nan
snabbt	ni kiakia	Nan
snarare	dipo	Nan
snarast	kiakia	Nan
spelen	awọn ere	Nan
spelet	eré	Nan
spelfilmer	sinima	Nan
spelning	oju agbo	Nan
spelningar	fihan	None
spelningen	ṣafihan	Nan
spelats	ti o gbasilẹ	Nan
spets	aba	Nan
spetshundar	aja awọn aja	Nan
spindlar	awọn alamọrin	Nan
spindlingar	cortinarius	Nan
splittrades	pin	Nan
spontant	leralera	Nan
sport	eré ìdárayá	Nan
spetsen	aba	Nan
spelat	dun	None
spelas	dun	None
spelarna	awọn oṣere	Nan
specifik	pàtó	Nan
specifika	pàtó	Nan
specifikt	pataki	Nan
speglar	awọn digi	Nan
spektrum	igbohunsafẹfẹ	Nan
spektrumet	igbohunsafẹfẹ	Nan
spekulationer	awọn asọye	Nan
spel	eré	Nan
spela	mu ṣiṣẹ	Nan
spelad	dun	None
spelade	dun	None
spelades	filimu	Nan
spelar	mu ṣiṣẹ	Nan
spelare	player	Nan
spelaren	player	Nan
sporten	ibudo	Nan
sporter	eré ìdárayá	Nan
spotify	spotify	Nan
spred	tànkálẹ	Nan
språkets	ede	None
språkliga	ede	None
spänner	ibiti	None
spänning	folti	Nan
spänningar	folti	Nan
spänningen	folti	Nan
spår	orin	Nan
spåra	orin	Nan
spåras	tọpinpin	Nan
spåren	awọn ẹka pẹẹpẹẹpẹ	Nan
spårvagnar	awọn ọkọ ayọkẹlẹ	Nan
sr	sr	Nan
sri	sri	Nan
ss	s	Nan
st	st.	Nan
språket	ede	None
speciella	pataki	Nan
språken	ede	None
språk	ede	None
spreds	tànkálẹ	Nan
sprida	tànkálẹ	Nan
spridas	tuka	Nan
spridd	tuka	Nan
spridda	tànkálẹ	Nan
sprider	itankale	Nan
spridit	tànkálẹ	Nan
spridning	afikun	Nan
spridningen	itankale	Nan
sprids	ti nran	Nan
springer	gbalaye	Nan
springsteen	omi	None
springsteens	omi	None
sprit	awọn ẹmi	Nan
spritt	tànkálẹ	Nan
språkbruk	parlance	Nan
svagt	kekere	None
speciell	pataki	Nan
special	afiwe	Nan
socker	ṣuga	Nan
sofia	oorun oorun	Nan
sofie	sofie	Nan
sokrates	socrates	Nan
sol	oorun	Nan
soldat	jagunjagun	Nan
socken	parish	Nan
soldater	ogun	None
solen	oorun	Nan
solens	oorun	Nan
solljus	orun	Nan
soloalbum	adashe	Nan
solsystem	eto oorun	Nan
solsystemet	eto oorun	Nan
soldaterna	jagunjagun	Nan
socialt	lawujọ	Nan
socialistiskt	alaifeiruedaomoenikeji	Nan
socialistiska	alaifeiruedaomoenikeji	Nan
snart	laipẹ	Nan
snitt	ge	Nan
snittet	apakan	Nan
snus	ipalọlọ	Nan
snuset	snus	Nan
snö	yinyin	Nan
social	lawujọ	Nan
sociala	lawujọ	Nan
socialdemokrater	awujọ	Nan
socialdemokraterna	awọn awujọ	Nan
socialdemokratiska	awujọ	Nan
socialism	ọrọ ajumọṣe	Nan
socialismen	ọrọ ajumọṣe	Nan
socialister	sosialisiti	Nan
socialistisk	alaifeiruedaomoenikeji	Nan
solsystemets	oorun	Nan
solvinden	oorun afẹfẹ	Nan
som	bi	Nan
somalia	somalia	Nan
sovjet	rosia	Nan
sovjetisk	rosia	Nan
sovjetiska	rosia	Nan
sovjetunionen	igbimo sofieti	Nan
sovjetunionens	igbimo sofieti	Nan
spaniel	ogun	None
spanien	ilu sibeeni	Nan
spaniens	ilu sibeeni	Nan
spanjorerna	awọn ara ilu sipeeni	Nan
spannmål	awọn woro irugbin	Nan
spansk	ede	None
spanska	ede	None
sparken	gbesile	Nan
sparta	ipamọ	Nan
spears	awọn ọkọ	Nan
sover	sùn	Nan
specialiserade	amọja	Nan
south	guusu	None
sound	ohùn	Nan
somliga	diẹ ninu	Nan
sommar	igba ooru	Nan
sommaren	igba ooru	Nan
sommarspelen	olimpiiki ooru	Nan
sommartid	igba akoko	Nan
somrar	awọn igba ooru	Nan
somrarna	awọn igba ooru	Nan
son	ọmọ	None
sonen	ọmọ	None
sony	sony	Nan
sorg	ibanujẹ	Nan
sorter	orisirisi	None
sorters	iru	Nan
sorts	orisirisi	None
soul	ọkàn	Nan
soundtrack	ohun orin	Nan
turkar	awọn tooki	Nan
svar	esi	Nan
svarar	idahun	Nan
tillämpas	waye	Nan
tillämpningar	awọn ohun elo	Nan
tillät	gba	None
tilläts	gba	None
tillåta	gba	None
tillåtelse	igbanilaaye	Nan
tillämpar	nbere	Nan
tillåter	gba	None
tillåtna	gba	None
tillåts	gba	None
tim	ẹ	Nan
time	aago	Nan
timmar	wakati	Nan
timme	wakati	Nan
tillåtet	gba	None
tillämpa	waye	Nan
tillägg	afikun	Nan
tilly	ṣii	Nan
tillståndet	ipinle	Nan
tillsätts	fi	None
tilltagande	npo si	Nan
tillträdde	mu	Nan
tillträde	iraye si	Nan
tillvaron	iwalaaye	Nan
tillverka	ṣe	Nan
tillverkade	ṣelọpọ	Nan
tillverkar	awọn iṣelọpọ	Nan
tillverkare	olupese	Nan
tillverkas	ṣelọpọ	Nan
tillverkning	iṣelọpọ	Nan
tillverkningen	gbóògì	Nan
tillväxt	idagba	Nan
tillväxten	idagba	Nan
tina	yiyọ	Nan
tillstånd	ipinle	Nan
ting	ohun	Nan
tintin	tintin	Nan
tjänst	iṣẹ	Nan
tjänstemän	awọn oṣiṣẹ	Nan
tjänsten	iṣẹ	Nan
tjänster	awọn iṣẹ	Nan
tobak	taba	Nan
tobias	tobias	Nan
tjänare	iranṣẹ	Nan
tog	mu	Nan
tokyo	tokyo	None
tolerans	ifarada	Nan
tolfte	kejila	Nan
tolka	tumọ	Nan
tolkade	itumọ	Nan
tolkar	onitumọ	Nan
togs	wà	Nan
tjänar	jo&#39;gun	Nan
tjänade	mina	Nan
tjäna	sìn	Nan
tio	mẹwa	Nan
tionde	kẹwa	Nan
tiotusentals	mewa ti egbegberun	Nan
titanic	titanic	Nan
titanics	titaniki	Nan
titel	akọle	Nan
titeln	akọle	Nan
titlar	awọn akọle	Nan
titta	wo	Nan
tittar	nwa	None
tittarna	awọn oluwo	Nan
tjeckien	czech	Nan
tjeckiska	czech	Nan
tjeckoslovakien	czechoslovakia	Nan
tjugo	ogun	None
tingslag	ọpọlọ ting	Nan
tillsammans	papọ	Nan
tills	titi	Nan
tillräckligt	to	None
tidigt	kutukutu	Nan
tidning	iwe iroyin	Nan
tidningar	iwe iroyin	Nan
tidningarna	awọn iwe	Nan
tidningen	iwe iroyin	Nan
tidpunkt	aago	Nan
tidigast	alakoko	Nan
tidpunkten	aago	Nan
tidskrift	iwe irohin	Nan
tidskriften	iwe irohin	Nan
tidskrifter	igbakọọkan	Nan
tidszon	agbegbe aago	Nan
tidszoner	awọn agbegbe akoko	Nan
tidvis	míràn	None
tids	aago	Nan
tidigare	sẹyìn	Nan
tidiga	kutukutu	Nan
tidig	kutukutu	Nan
the	awọn	Nan
theodor	theodor	Nan
theta	areta	Nan
they	wọn	None
thierry	thierry	Nan
thomas	thomas	Nan
thriller	asaragaga	Nan
thåström	àmójú	Nan
tibet	tibet	Nan
tid	aago	Nan
tiden	aago	Nan
tidens	fi	None
tider	awọn akoko	Nan
tiderna	awọn akoko	Nan
tiders	awọn akoko	Nan
tiger	tiger	Nan
tigern	ẹyẹ	Nan
tigrar	ẹyẹ	Nan
till	sí	Nan
tillhandahåller	pese	Nan
tillhör	ohun ini si	Nan
tillhöra	jẹ	Nan
tillhörande	nkan	None
tillhörde	jẹ ti	Nan
tillhörighet	ohun ini	Nan
tillhört	jẹ ti	Nan
tillika	tun awọn	Nan
tillkom	dide	Nan
tillkommer	yoo	None
tillkommit	lati wa	Nan
tillkomst	dide	Nan
tillkännagav	kede	Nan
tillräcklig	to	None
tillräckliga	to	None
tillgången	iraye si	Nan
tolkas	itumọ	Nan
tillgångar	ohun-ìní	Nan
tillgängligt	wa	Nan
tillbaka	sẹhin	Nan
tillbehör	ẹya ẹrọ	Nan
tillbringade	lo	Nan
tillbringar	na	Nan
tilldelades	funni	Nan
tilldelas	funni	Nan
tilldelats	sọtọ	Nan
tillfälle	aye	Nan
tillfällen	awọn ayeye	Nan
tillfället	lọwọlọwọ	Nan
tillfällig	fun	None
tillfälliga	fun	None
tillfälligt	fun	None
tillgänglig	wa	Nan
tillgängliga	wa	Nan
tillgång	iraye si	Nan
thc	thc	Nan
tolkats	itumọ	Nan
tolkiens	tolkien	Nan
trots	pelu	Nan
trotskij	trotskii	Nan
truman	truman	Nan
trummis	onilu	Nan
trummisen	onilu	Nan
trummor	awọn ilu	Nan
trossamfund	awujo esin	Nan
trupp	ẹgbẹ	Nan
trupperna	ogun	None
tryck	tẹjade	Nan
trycket	titẹ	Nan
tryckta	tejede	Nan
trycktes	tejede	Nan
trä	igi	Nan
trupper	ogun	None
trosbekännelsen	igbagbo	Nan
tros	gbagbọ	Nan
tror	ronu	Nan
trianglar	awọn onigun mẹta	Nan
trigonometriska	trigonometric	Nan
trinidad	mẹtalọkan	Nan
tro	gbagbọ	Nan
trodde	ronu	Nan
troende	onigbagbọ	Nan
troligen	boya	Nan
troligt	seese	Nan
troligtvis	beli	Nan
tron	itẹ	Nan
tronen	itẹ	Nan
tronföljare	arọpo si itẹ	Nan
tropisk	tropical	Nan
tropiska	tropical	Nan
tropiskt	tropical	Nan
träd	igi	Nan
triangelns	onigun mẹta	Nan
träda	iparun	Nan
träffa	lu	Nan
tunga	ahọn	Nan
tungt	wuwo	Nan
tunisien	tunisia	Nan
tunn	tinrin	Nan
tunna	agba	None
tunnel	eefin	Nan
tung	wuwo	Nan
tunnelbana	ọkọ-irin alaja-ilẹ	Nan
tunnlar	awọn tunes	Nan
tupac	tupac	Nan
tur	oriire	None
turism	irin-ajo	Nan
turismen	irin-ajo	Nan
turister	ajo	None
tunnelbanan	ọkọ-irin alaja-ilẹ	Nan
tum	inch	Nan
tsunamier	tsunami	Nan
tsunami	tsunami	Nan
träffade	pàdé	Nan
träffades	pàdé	Nan
träffar	awọn esi	Nan
träffas	pàdé	Nan
träffat	pàdé	Nan
tränade	oṣiṣẹ	Nan
tränare	olukọ	Nan
tränaren	olukọ	Nan
tränga	alaye	Nan
tränger	permeates	Nan
träning	ere idaraya	Nan
trådlös	alailowaya	Nan
trött	rẹ	None
tsar	tsar	Nan
tsaren	ọba	Nan
trädde	titẹsi	Nan
triangeln	onigun mẹta	Nan
triangel	onigun mẹta	Nan
trey	trey	Nan
torde	yẹ	Nan
torg	square	Nan
torget	square	Nan
torka	gbẹ	Nan
torn	ile-iṣọ	Nan
tornen	awọn ile-iṣọ	Nan
torbjörn	torbjörn	Nan
tornet	ile-iṣọ	Nan
torra	gbẹ	Nan
torres	awon odo	Nan
torrt	gbẹ	Nan
torsten	torsten	Nan
tortyr	ijiya	Nan
tosh	àá	Nan
toronto	toronto	Nan
torah	torah	Nan
tor	thu	Nan
toppen	oke	Nan
tolkning	itumọ	Nan
tolkningar	awọn itumọ	Nan
tolkningen	itumọ	Nan
tolv	mejila	None
tom	ṣofo	Nan
tomas	tomas	Nan
tomma	ofo	Nan
tomt	idite	Nan
ton	t	Nan
tongivande	gbajugbaja	Nan
tony	tony	Nan
top	oke	Nan
topp	oke	Nan
toppade	gbeko	Nan
toppar	ga ju	Nan
total	lapapọ	Nan
totala	lapapọ	Nan
totalt	lapapọ	Nan
tottenham	tottenham	Nan
transportera	irinna	Nan
transporterar	rù	Nan
transporteras	gbigbe	Nan
tre	mẹta	Nan
tredje	kẹta	None
tredjedel	kẹta	None
tredjedelar	mẹta	Nan
tree	igi	Nan
treenigheten	metalokan	Nan
treenighetsläran	metalokan	Nan
trend	aṣa	Nan
trenden	aṣa	Nan
trettio	ọgbọn	Nan
trettioåriga	ọgbọn ọdun	Nan
tretton	mẹtala	Nan
transporter	irinna	Nan
tolkien	tolkien	Nan
transport	irinna	Nan
transeuropeiska	nọ	Nan
tour	irin-ajo	Nan
toy	ohun isere	Nan
tradition	atọwọdọwọ	Nan
traditionell	ibile	None
traditionella	ibile	None
traditionellt	aṣa	Nan
traditionen	si atọwọdọwọ	Nan
traditioner	aṣa	Nan
traditionerna	aṣa	Nan
trafik	ijabọ	Nan
trafiken	ijabọ	Nan
trafikerade	taja	Nan
trafikerar	ijabọ	Nan
trafikeras	taja	Nan
trakten	agbegbe	Nan
transkription	transcription	Nan
that	iyẹn	Nan
than	ju	Nan
thailand	thailand	Nan
säga	sọ	None
sägas	wi	Nan
säger	pé	None
sägs	bawo	Nan
säker	daju	Nan
säkerhet	aabo	Nan
systrar	arabinrin	Nan
säkerheten	aabo	Nan
säkerhetsråd	aabo	Nan
säkerhetsrådet	aabo	Nan
säkert	nitõtọ	Nan
säkra	ni aabo	Nan
sälja	ta	Nan
säljande	ta	Nan
säkerhetspolitik	aabo	Nan
syster	arabinrin	Nan
systems	awọn ọna ṣiṣe	Nan
systemet	eto	Nan
syns	han	Nan
synsätt	sunmọ	Nan
synsättet	sunmọ	Nan
syntes	fihan	None
synvinkel	igun	Nan
syre	atẹgun	Nan
syret	atẹgun	Nan
syrgas	atẹgun	Nan
syrien	síríà	Nan
syskon	awọn tegbotaburo	Nan
sysselsätter	oṣiṣẹ	Nan
system	eto	Nan
systematik	eto atinuda	Nan
systematiska	eto eto	Nan
systematiskt	eto eto	Nan
säljas	ti ta	Nan
synonymt	bakannaa	Nan
säljer	ta	Nan
sällan	ṣọwọn	Nan
särskilda	pàtó	Nan
särskilt	ni pataki	Nan
säsong	akoko	Nan
säsongen	akoko	Nan
säsongens	ti igba	Nan
säsonger	awọn akoko	Nan
särskild	pataki	Nan
säsongerna	awọn akoko	Nan
sätt	ọna	Nan
sätta	fi	None
sättas	fi	None
sätter	fi	None
sättet	ọna	Nan
sätts	fi	None
säte	ijoko	Nan
särdrag	ẹya	Nan
sänktes	dinku	Nan
sänker	kere	Nan
sällskap	ile-iṣẹ	Nan
sällskapet	awujọ	Nan
sällskapshundar	awọn aja ọsin	Nan
sällsynt	ṣọwọn	Nan
sällsynta	ṣọwọn	Nan
sämre	alaitẹgbẹ	Nan
sämsta	buru	Nan
sända	firanṣẹ	Nan
sändas	gbe	None
sände	firanṣẹ	Nan
sändebud	aṣoju	Nan
sänder	firanṣẹ	Nan
sändes	firanṣẹ	Nan
sänds	gbe	None
sänka	kere	Nan
säljs	ti ta	Nan
synnerligen	ni pataki	Nan
synnerhet	ni pataki	Nan
synligt	han	Nan
svt	svt	Nan
svält	ebi	None
svärd	idà	Nan
svår	nira	Nan
svåra	nira	Nan
svårare	nira	Nan
sveriges	sweden	Nan
svårigheter	iṣoro	Nan
swahili	swahili	None
swan	siwani	Nan
sweden	sweden	Nan
swedish	swedish	Nan
sweet	adun	Nan
swift	swift	Nan
svårt	nira	Nan
sverigedemokraterna	sweden democratic	Nan
sverige	sweden	Nan
svensson	smith	Nan
svart	dudu	Nan
svarta	dudu	Nan
svartån	svartån	Nan
svavel	efin	Nan
svealand	svealand	Nan
sven	ikọsẹ	Nan
svensk	ara ilu sweden	Nan
svenska	ara ilu sweden	Nan
svenskan	ara ilu sweden	Nan
svenskans	ede	None
svenskar	swedes	Nan
svenskarna	ara ilu sweden	Nan
svenske	ara ilu sweden	Nan
svenskspråkiga	ede	None
svenskt	ara ilu sweden	Nan
syd	guusu	None
sydafrika	gusu afrika	Nan
sydafrikanska	south afirika	Nan
sydafrikas	gusu afrika	Nan
symbolen	aami	Nan
symboler	awọn aami	Nan
symboliserar	ṣàpẹẹrẹ	Nan
symbolisk	apẹẹrẹ	Nan
symptom	ami aisan	Nan
symptomen	awọn aami aisan	Nan
symtom	awọn aami aisan	Nan
symtomen	awọn aami aisan	Nan
syn	iriran	Nan
synd	ẹṣẹ	Nan
synder	awọn ẹṣẹ	Nan
syndrom	aarun	Nan
synen	iriran	Nan
synes	dabi ẹnipe	Nan
synliga	han	Nan
symbol	aami	Nan
så	nitorinaa	Nan
syftet	idi	Nan
syfte	idi	Nan
sydamerika	amerika	None
sydeuropa	gusu yuroopu	Nan
sydkorea	south korea	Nan
sydliga	guusu	None
sydligaste	guusu	None
sydost	guusu	None
sydostasien	guusu	None
sydstaterna	gusu awọn amẹrika	Nan
sydväst	guusu	None
sydvästra	guusu	None
sydöst	guusu	None
sydöstra	guusu	None
syfta	ifọkansi	Nan
syftade	ero	Nan
syftar	ero	Nan
syften	awọn idi	Nan
sådan	iru	Nan
sådana	iru	Nan
sådant	iru	Nan
television	tẹlifisiọnu	Nan
tema	akori	Nan
teman	awọn akori	Nan
tempel	tẹmpili	Nan
temperatur	otutu	None
temperaturen	otutu	None
telegram	tẹlifoonu	Nan
temperaturer	otutu	None
templet	tẹmpili	Nan
tendens	iwa	Nan
tendenser	lominu	Nan
tenderar	ṣọ	Nan
tenn	tin	Nan
tennessee	tennessee	Nan
tempererat	otutu	None
telefonen	foonu	Nan
telefon	foonu	Nan
teknologi	imọ-ẹrọ	Nan
teater	itage	Nan
teatern	itage	Nan
teatrar	imiran	Nan
tecken	ami	Nan
tecknade	fowo si	Nan
tecknet	ami	Nan
ted	ted	Nan
teddy	ohun kikọ	Nan
tegel	okuta	Nan
teknik	ilana	None
tekniken	aworan	Nan
tekniker	onimọ-ẹrọ	Nan
teknisk	imọ ẹrọ	Nan
tekniska	imọ-ẹrọ	Nan
tekniskt	imọ ẹrọ	Nan
tennis	tẹnisi	Nan
tennisspelare	tẹnisi	Nan
teologi	eko	None
teologiska	imq ẹkọ	Nan
terrorister	onijagidijagan	Nan
terry	ilẹkun	Nan
terräng	ibigbogbo ile	Nan
tesla	teslas	Nan
teslas	teslas	Nan
test	idanwo	Nan
testamente	majẹmu	Nan
testamentet	majẹmu	Nan
tex	fun	None
texas	texas	Nan
text	ọrọ	Nan
texten	ọrọ	Nan
texter	awọn ọrọ	Nan
texterna	awọn ọrọ	Nan
th	th	Nan
terrorismen	ipanilaya	Nan
team	egbe	None
terrorism	ipanilaya	Nan
territorium	agbegbe	Nan
teoretiker	theorist	Nan
teoretisk	ẹkọ	Nan
teoretiska	ẹkọ	Nan
teoretiskt	ẹkọ	Nan
teori	yii	Nan
teorier	awọn imọ-jinlẹ	Nan
teorin	yii	Nan
termen	igba	Nan
termer	ofin	None
terminologi	imọ-jinlẹ	Nan
terrier	terrier	Nan
territoriella	agbegbe	Nan
territorier	awọn agbegbe	Nan
territorierna	awọn agbegbe	Nan
territoriet	agbegbe	Nan
terror	ẹru	Nan
svarade	dahun	Nan
te	tii	Nan
taubes	awọn taubes	Nan
söder	guusu	None
söderut	guusu	None
södra	guusu	None
söka	wa	Nan
söker	wiwa	Nan
sökt	wa	Nan
såväl	mejeeji	Nan
sökte	wa	Nan
söndagen	ọjọ sundee	Nan
sönder	fifọ	Nan
söner	ọmọ	None
t	t	Nan
ta	mu	Nan
tabell	chart	Nan
sömn	sun	None
såsom	bi	Nan
sår	egbo	None
sångerska	akorin	Nan
såg	saw	Nan
sågs	šakiyesi	Nan
sålda	ti ta	Nan
sålde	ti ta	Nan
såldes	wà	Nan
således	bayi	None
sålt	ti ta	Nan
sålts	ti ta	Nan
sålunda	bayi	None
sång	orin	Nan
sångare	akorin	Nan
sångaren	akorin	Nan
sången	orin naa	Nan
sånger	awọn orin	Nan
sångerna	awọn orin	Nan
tabellen	tabili	None
tacitus	tacitus	Nan
tack	o ṣeun	Nan
tackade	gba	None
talen	awọn nọmba	Nan
talet	nọnba	Nan
talets	orundun	Nan
talman	alakoso	Nan
talmannen	alakoso	Nan
talrika	lọpọlọpọ	Nan
tankar	awọn ero	Nan
tanke	ronu	Nan
tanken	ronu	Nan
tanzania	tanzania	Nan
tappade	sọnu	Nan
tappar	sil.	Nan
tar	gba	None
tas	jẹ	Nan
taube	ibeere	Nan
talat	sọ	None
taylor	taylor	Nan
talas	sọ	None
talar	soro	Nan
tag	nigba ti	Nan
tagen	mu	Nan
taget	aago	Nan
taggar	afi	Nan
tagit	mu	Nan
tagits	mu	Nan
taiwan	taiwan	Nan
taket	orule	Nan
takt	oṣuwọn	Nan
taktik	ilana	None
tala	sọrọ	Nan
talade	sọrọ	Nan
talades	sọ	None
talang	ẹbun	Nan
talanger	ẹbun	Nan
talare	agbọrọsọ	Nan
övriga	awọn ẹlomiran	Nan
lucky	oriire	None
lucas	luku	Nan
dvärg	arara	Nan
dvärgar	dwarves	Nan
dy	rẹ	None
dygn	ọjọ	Nan
dygnet	ọjọ	Nan
dyker	yiyo	Nan
dvs	i.e.	Nan
dylan	dylan	Nan
dynamiska	ìmúdàgba	Nan
dyrare	gbe	None
dyraste	gbowolori ju	Nan
dyrt	gbowolori	Nan
dä	nigbana	Nan
däggdjur	mamma	Nan
dylikt	iru	Nan
dvd	dvd	Nan
duett	duet	Nan
dublin	dublin	Nan
dryck	mu	Nan
drycken	nkanmimu	Nan
drycker	awọn ohun mimu	Nan
drygt	lori	Nan
dräkt	aṣọ	Nan
dröja	aṣọ atẹrin	Nan
dröjde	da	None
dröm	àlá	Nan
drömmar	ala	None
dsmiv	dsmiv	Nan
du	iwo	Nan
dubai	ilu dubai	Nan
dubbel	ilọpo meji	Nan
dubbelt	lemeji	Nan
dubbla	ilọpo meji	Nan
däggdjuren	osin	Nan
drottningen	ayaba	Nan
där	nibo	Nan
därefter	lẹhinna	Nan
dödade	pa	Nan
dödades	pa	Nan
dödar	pa	Nan
dödas	pa	Nan
dödat	pa	Nan
döden	iku	None
dödad	pa	Nan
dödlig	apaniyan	Nan
dödligt	ku	None
dödsfall	iku	None
dödshjälp	euthanasia	Nan
dödsoffer	iku	None
dödsorsaken	iku	None
dödsstraff	ijiya olu	Nan
dödligheten	iku	None
döda	pa	Nan
död	iku	None
dö	kú	Nan
däremot	sibẹsibẹ	Nan
därför	nitorinaa	Nan
däribland	laarin	None
därifrån	ibẹ	Nan
därigenom	nitorina	Nan
därmed	nitorina	Nan
därpå	rẹ	None
därtill	nitorinaa	Nan
därutöver	afikun	Nan
därvid	nitorina	Nan
då	lẹhinna	Nan
dålig	buburu	Nan
dåliga	buburu	Nan
dåtidens	imusin	None
dåvarande	lẹhinna	Nan
därav	rẹ	None
drottning	ayaba	Nan
drogs	ti a bo	Nan
drogmissbruk	oògùn líle	Nan
dominerande	jẹ gaba lori	Nan
dominerar	jẹ gaba lori	Nan
domineras	jẹ gaba lori	Nan
dominerat	jẹ gaba lori	Nan
domkyrka	katidira	Nan
domkyrkan	katidira	Nan
dominerades	jẹ gaba lori	Nan
domstol	kootu	Nan
domstolen	kootu	Nan
don	don	Nan
donald	donald	Nan
donau	awọn danube	Nan
donna	donna	Nan
dop	ìrìbọmi	Nan
domstolar	kootu	Nan
dominerade	jẹ gaba lori	Nan
dominera	jẹ gaba lori	Nan
dominans	kẹwa	Nan
djurgårdens	r&#39;oko r&#39;oko	Nan
djävulen	eṣu	Nan
dna	dna	Nan
dns	dns	Nan
dock	botilẹjẹpe	Nan
dog	kú	Nan
doktor	dokita	Nan
dokument	iwe	Nan
dokumenterade	ti ni akọsilẹ	Nan
dokumentär	itan	Nan
dollar	dola	Nan
dom	idajọ	Nan
domare	adajọ	Nan
domaren	lẹjọ	Nan
domen	idajọ	Nan
dopamin	dopamini	Nan
dos	iwọn lilo	Nan
dotter	ọmọbinrin	Nan
dottern	ọmọbinrin	Nan
drar	fa	Nan
dras	ya	Nan
dream	ala	None
drev	wakọ	Nan
drevs	ogidi	Nan
dricka	mu	Nan
dricker	inu mimu	Nan
drift	isẹ	Nan
driva	wakọ	Nan
drivande	iwakọ	Nan
driver	awakọ	Nan
drivs	sáré	Nan
drog	oogun	Nan
drogen	oogun	Nan
droger	awọn oogun	Nan
draperi	aṣọ-ikele	Nan
dödsstraffet	iku	None
dramer	awọn fiimu	Nan
dramatiska	ìgbésẹ	Nan
downs	si isalẹ	Nan
dr	dr	Nan
dra	fa	Nan
drabbade	fowo	Nan
drabbades	jiya	Nan
drabbar	nyo	Nan
drabbas	fowo	Nan
drabbat	fowo	Nan
drabbats	fowo	Nan
drag	awọn ẹya	Nan
dragit	fẹran	Nan
drama	eré	Nan
dramat	eré	Nan
dramaten	ibamu	Nan
dramatiker	agba	None
dramatiskt	bosipo	Nan
djurgården	djurgården	Nan
dök	imi	Nan
dömd	ijakule	Nan
eller	tabi	None
elton	elton	Nan
elva	mọkanla	Nan
elvis	elvis	Nan
em	em	Nan
emellan	laarin	None
elitserien	elitserien	Nan
emellanåt	lẹẹkọọkan	Nan
emi	emi	Nan
emigrerade	iṣilọ	Nan
emil	emil	Nan
eminem	eminem	Nan
emma	emma	Nan
emmanuel	emmanuel	None
emellertid	sibẹsibẹ	Nan
eliten	gbajumo	Nan
elit	gbajumo	Nan
elisabeth	elisabeti	Nan
elden	ina	Nan
electric	ina	Nan
elektricitet	ina	Nan
elektrisk	itanna	Nan
elektriska	ina	Nan
elektriskt	itanna	Nan
elektromagnetisk	itanna	Nan
elektron	elekitironi	Nan
elektroner	elekitironi	Nan
elektronik	ẹrọ itanna	Nan
element	ano	Nan
eleonora	eleonora	Nan
elever	ọmọ	None
eleverna	ọmọ	None
elin	elin	Nan
emo	emo	Nan
eld	iná	Nan
empati	aanu	None
en	ọkan	Nan
engelsk	gẹẹsi	Nan
engelska	gẹẹsi	Nan
engelskan	gẹẹsi	Nan
engelskans	ede	None
engelske	gẹẹsi	Nan
engelskspråkiga	gẹẹsi	Nan
engels	awọn olukọni	Nan
engelsmännen	gẹẹsi	Nan
englands	england	Nan
english	gẹẹsi	Nan
enhet	ẹyọkan	Nan
enheten	ẹyọkan	Nan
enheter	awọn sipo	Nan
enhetlig	aṣọ	Nan
england	england	Nan
engagerade	igbẹhin	Nan
engagerad	npe	Nan
engagemang	ifaramo	Nan
ena	ọkan	Nan
enade	orilẹ amẹrika	Nan
enades	gba	None
enastående	dayato	Nan
enat	ti iṣọkan	Nan
enbart	daada	Nan
encyclopedia	encyclopedia	Nan
enda	nikan	Nan
endast	nikan	Nan
ende	o wu	Nan
energi	agbara	None
energikälla	agbara	None
energikällor	agbara	None
energin	agbara	None
energy	agbara	None
empire	ottoman	Nan
ekvatorn	olumeta	Nan
ekr	a.d	Nan
ekosystem	ilolupo eda	Nan
edvard	edvard	Nan
edwall	ogiri	Nan
edward	edward	Nan
edwards	awọn akọle	Nan
edwin	edwin	Nan
effekt	ipa	Nan
edmund	edmund	Nan
effekten	ipa	Nan
effekterna	awọn ipa	Nan
effektiv	munadoko	Nan
effektiva	munadoko	Nan
effektivt	munadoko	Nan
efter	lẹhin	Nan
efterfrågan	beere	Nan
effekter	awọn ipa	Nan
edith	edith	Nan
edison	edison	Nan
edgar	edgar	Nan
dömdes	ẹjọ	Nan
döpt	ti a npè ni	Nan
döpte	baptisi	Nan
döptes	ti a npè ni	Nan
dör	kú	Nan
dött	kú	Nan
döttrar	awọn ọmọbinrin	Nan
e	é	Nan
earl	eti	Nan
earth	ile aye	Nan
ebba	ebb	Nan
economic	oro-aje	Nan
ecuador	ecuador	Nan
ed	ibura	Nan
eddie	eddie	Nan
efterföljande	atẹle	Nan
efterföljare	ọmọlẹyìn	Nan
efterhand	ifiweranṣẹ	Nan
efterkrigstiden	postwar	Nan
eiffeltornet	ile iṣọ eiffel	Nan
einstein	einstein	Nan
einsteins	einstein	Nan
ej	kii ṣe	Nan
eker	sọrọ	Nan
eklund	eklund	Nan
ekman	ekman	Nan
ekologi	ẹkọ nipa ayika	Nan
ekologiska	organic	Nan
ekonomi	aje	None
ekonomier	awọn ọrọ-aje	Nan
ekonomin	aje	None
ekonomisk	aje	None
ekonomiska	aje	None
ekonomiskt	ti ọrọ-aje	Nan
egyptiska	ara egipti	Nan
dömande	ofin	None
egyptens	íjíbítì	Nan
egna	tirẹ	Nan
efternamn	orukọ idile	Nan
eftersom	niwon	Nan
efterträdare	agbapo	Nan
efterträddes	ṣaṣeyọri	Nan
eftervärlden	iran iran	Nan
efteråt	náà	None
egen	tirẹ	Nan
egendom	ohun-ini	Nan
egenskap	ohun-ini	Nan
egenskaper	abuda	Nan
egenskaperna	awọn ohun-ini	Nan
egentlig	gidi	Nan
egentliga	gangan	Nan
egentligen	gangan	Nan
eget	tirẹ	Nan
egypten	íjíbítì	Nan
djuret	ẹranko	Nan
djurens	ẹranko	Nan
djuren	ẹranko	Nan
dagbladet	ojoojumo	Nan
dagbok	iwe itosiwe	Nan
dagen	ọjọ	Nan
dagens	loni	Nan
dagliga	ojoojumo	Nan
dagligen	ojoojumọ	Nan
dagars	ọjọ	Nan
dagligt	ojoojumo	Nan
dagsläget	ipo	None
dahlén	dahlén	Nan
dahléns	dahlén	Nan
dalar	afonifoji	Nan
dalarna	dalarna	Nan
dalí	dali	Nan
dags	aago	Nan
dagarna	o	Nan
dagar	àwọn ọjọ́	Nan
dag	ọjọ	Nan
cover	bo	Nan
craig	craig	Nan
crazy	irikuri	Nan
crick	biriki	Nan
cricket	ere kiriketi	Nan
criss	criss	Nan
cruz	cruz	Nan
crüe	krüe	Nan
cupen	ife	Nan
cykel	keke	Nan
cykeln	ọmọ	None
cyklar	waye	Nan
cypern	kírúsì	Nan
cyrus	cyrus	Nan
da	da	None
dam	arabinrin	Nan
county	agbegbe	Nan
damer	tara	None
daniel	dáníẹ́lì	Nan
david	dáfídì	Nan
davis	davis	Nan
day	ọjọ	Nan
de	awọn	Nan
debatt	ijiroro	Nan
debatten	ijiroro	Nan
dave	dave	Nan
debatter	awọn ariyanjiyan	Nan
debutalbum	uncomfortable	Nan
debutalbumet	uncomfortable album	Nan
debuterade	uncomfortable	Nan
december	oṣu kejila	Nan
decennier	ewadun	Nan
decennierna	ewadun	Nan
debut	uncomfortable	Nan
datum	ọjọ	Nan
datorspel	awọn ere kọmputa	Nan
datorn	kọmputa	Nan
danmark	egeskov	Nan
danmarks	egeskov	Nan
danny	dani	None
dans	jó	Nan
dansk	dane	Nan
danska	ede	None
danske	ede	None
dark	dudu	Nan
darwin	darwin	Nan
darwins	darwin	Nan
das	das	Nan
data	data	Nan
dateras	ti akoko	Nan
dator	kọmputa	Nan
datorer	awọn kọmputa	Nan
dancehall	dancehall	Nan
country	orilẹ-ede	Nan
counterstrike	counter idasesile	Nan
costa	idiyele	Nan
chansen	aye	Nan
chaplin	ẹsẹ	None
charles	charles	None
charlie	shalii	Nan
charlotte	charlotte	Nan
chefen	ori	None
chans	aye	Nan
chelsea	chelsea	Nan
chicago	chicago	Nan
chile	chile	Nan
chiles	ede	None
chili	chili	Nan
choice	yiyan	Nan
choklad	ologbo	Nan
chi	.rún	Nan
channel	ikanni	Nan
chandler	chandler	Nan
champagne	sahmpeni	Nan
census	ìkànìyàn	Nan
center	aarin	Nan
centra	awọn ile-iṣẹ	Nan
central	aringbungbun	Nan
centrala	aarin ilu	Nan
centralamerika	aringbungbun america	Nan
centralasien	centralasien	Nan
centralbanken	central bank	Nan
centraleuropa	aarin	Nan
centralort	ijoko	Nan
centralorter	ilu akọkọ	Nan
centralstation	aarin	Nan
centralt	aringbungbun	Nan
centre	aarin	Nan
centrum	aarin	Nan
chokladen	ologbo	Nan
chris	chris	Nan
christer	christer	Nan
christian	kristiẹni	Nan
cobain	cobain	Nan
cocacola	coca-cola	Nan
cohen	cohen	Nan
coldplay	otutu	None
colin	colin	Nan
colombia	ilu columbia	Nan
colombo	colombo	Nan
colorado	agba	None
colosseum	colosseum	Nan
columbia	ẹyẹ	Nan
columbus	akọmọ	Nan
come	wá	Nan
comeback	pada wa	Nan
comet	comet	Nan
cosa	cosa	Nan
club	ọgọ	Nan
decenniet	ewadun	Nan
clinton	clinton	Nan
claude	claude	Nan
christina	christina	Nan
chrusjtjov	khrushchev	Nan
church	ile ijọsin	Nan
churchill	churchill	Nan
cia	bẹẹ	Nan
cirka	nipa	Nan
cirkel	circle	Nan
citat	avvon	Nan
city	ilu	Nan
civil	ara ilu	Nan
civila	ara ilu	Nan
civilbefolkningen	alagbada	Nan
civilisationen	ọlaju	Nan
civilisationer	ọlaju	Nan
claes	awọn ibeere	Nan
cliff	àpáta	Nan
decennium	ewadun	Nan
deep	jin	Nan
define	setumo	Nan
diamond	alumọni	Nan
dianno	dianno	Nan
dickens	dickens	Nan
dickinson	dickinson	Nan
diego	kú	Nan
digerdöden	iku	None
diameter	opin	Nan
digital	oni-nọmba	Nan
diktator	apanirun	Nan
diktatorn	apanirun	Nan
diktatur	ijọba ijọba	Nan
diktaturen	ijọba ijọba	Nan
dikter	oríkì	None
dillinger	dillinger	Nan
dikt	ewi	Nan
diamanter	awọn okuta iyebiye	Nan
diamant	okuta iyebiye	Nan
dialog	ijiroro	Nan
det	awọn	Nan
detalj	alaye	Nan
detaljer	awọn alaye	Nan
detroit	detroit	Nan
detsamma	ikan	None
detta	eyi	Nan
deuterium	deuterium	Nan
development	idagbasoke	None
diabetes	atọgbẹ	Nan
diagnos	ayẹwo	Nan
diagnosen	ayẹwo	Nan
diagnoser	awọn iwadii aisan	Nan
dialekt	isọrọsi	Nan
dialekter	awọn iledìí	Nan
dialekterna	awọn iledìí	Nan
dimensioner	mefa	Nan
din	rẹ	None
dinosaurier	dinosaurs	Nan
dinosaurierna	dinosaurs	Nan
distrikt	agbegbe	Nan
distriktet	agbegbe	Nan
dit	ní	None
ditt	rẹ	None
dittills	titi di asiko yii	Nan
diverse	oniruru	Nan
division	pipin	Nan
divisionen	pipin	Nan
dj	dj	Nan
djup	ijinle	Nan
djupa	jinjin	Nan
djupare	wole	None
djupt	jinjin	Nan
djur	ẹranko	Nan
djurarter	eya	None
distributioner	awọn pinpin	Nan
desto	awọn	Nan
distribution	pinpin	Nan
distinkt	yàtọ	Nan
diplomatiska	oselu ara ilu	Nan
direkt	lesekese	Nan
direkta	taara	Nan
direktör	oludari	Nan
diskar	awọn disiki	Nan
diskografi	itan	Nan
diskriminering	iyasoto	Nan
diskussion	ijiroro	Nan
diskussioner	awọn ijiroro	Nan
diskutera	jiroro	Nan
diskuterades	sísọ	Nan
diskuteras	sísọ	Nan
diskuterats	sísọ	Nan
disney	diseni	Nan
disneys	diseni	Nan
distinkta	yàtọ	Nan
enighet	àdéhùn	Nan
dessutom	tun	Nan
dessa	iwọnyi	Nan
delats	pin	Nan
delen	apakan	Nan
delhi	delhi	None
delning	pinpin	Nan
delningen	ọfin	Nan
dels	ni apakan	Nan
delat	pin	Nan
delstat	ipinle	Nan
delstater	awọn ipinlẹ	Nan
delstaterna	ede	None
delta	kopa	Nan
deltagande	ikopa	Nan
deltagare	alabaṣe	Nan
deltagarna	olukopa	Nan
delstaten	ilẹ	None
delas	fifọ	Nan
delarna	awọn ẹya	Nan
delar	awọn ẹya	Nan
definiera	setumo	Nan
definierade	asọye	Nan
definierar	asọye	Nan
definieras	asọye	Nan
definierat	asọye	Nan
definition	itumo	None
definitionen	asọye	Nan
definitioner	awọn asọye	Nan
definitivt	dajudaju	Nan
deklarerade	ṣalaye	Nan
del	apakan	Nan
dela	pin	Nan
delad	pin	Nan
delade	kan	None
delades	funni	Nan
deltagit	lọ	Nan
deltar	apakan	Nan
deltog	lọ	Nan
delvis	ni apakan	Nan
densiteten	iwuwo	Nan
departement	ijoba	Nan
depolarisering	depolarization	Nan
depp	depp	Nan
depression	ibanujẹ	Nan
depressionen	ibanujẹ	Nan
depressioner	ibanujẹ	Nan
der	der	Nan
deras	wọn	None
derivata	itọsẹ	Nan
derivatan	itọsẹ	Nan
derivator	awọn itọsẹ	Nan
design	apẹrẹ	Nan
desmond	desmond	None
dess	rẹ	None
densitet	iwuwo	Nan
dessförinnan	ṣaaju	Nan
densamma	kanna	Nan
dennes	tirẹ	Nan
dem	wọn	None
demens	iyawere	Nan
demo	demo	Nan
demografi	ibi afọwọya	Nan
demografiska	ibi eeyan	Nan
demokrati	tiwantiwa	Nan
demokratier	tiwantiwa	Nan
demokratin	tiwantiwa	Nan
demokratisk	tiwantiwa	Nan
demokratiska	tiwantiwa	Nan
demokratiskt	tiwantiwa	Nan
demonstrationer	awọn ifihan	Nan
den	awọn	Nan
denna	eyi	Nan
denne	oun	None
dennis	dennis	Nan
cellerna	ẹyin	Nan
enkel	o rọrun	Nan
enkla	rọrun	Nan
folkomröstning	idapada	Nan
folkpartiet	eniyan	Nan
folkrepubliken	eniyan eniyan republic	Nan
folkrikaste	ẹlẹgẹ	Nan
folkräkning	ìkànìyàn	Nan
folkräkningen	ìkànìyàn	Nan
folkmängden	olugbe	Nan
folkslag	awọn eniyan	Nan
folkvalda	dibo	Nan
fontsizes	fontsizes	Nan
football	bọọlu	Nan
force	ipa	Nan
ford	ṣeéṣe	Nan
fordon	ọkọ	Nan
folktro	arosọ	Nan
folkmängd	olugbe	Nan
folkmusik	orin awọn eniyan	Nan
folkmun	gbajumọ	Nan
fns	un	Nan
fokus	idojukọ	Nan
fokusera	idojukọ	Nan
fokuserade	lojutu	Nan
fokuserar	idojukọ	Nan
folk	eniyan	Nan
folke	ṣeke	Nan
folken	awọn eniyan	Nan
folket	eniyan	Nan
folkets	eniyan	Nan
folkgrupper	awọn agbegbe	Nan
folklig	onile	Nan
folkliga	eniyan	Nan
folkmord	ipaeyarun	Nan
folkmordet	ipaeyarun	Nan
form	fọọmu	Nan
fn	u.n.	Nan
format	ọna kika	Nan
formel	agbekalẹ	Nan
fortsatta	siwaju	Nan
fortsatte	tesiwaju	Nan
fortsätta	tẹsiwaju	Nan
fortsätter	tẹsiwaju	Nan
fortsättning	itesiwaju	Nan
fortsättningen	tẹsiwaju	Nan
fortsatt	tesiwaju	Nan
forum	apejọ	Nan
fossila	fosaili	Nan
foster	ọmọ	None
fot	ẹsẹ	None
fotbeklädnad	aṣọ atẹsẹ	Nan
fotboll	bọọlu	Nan
fotbollen	bọọlu	Nan
fossil	fosaili	Nan
fortplantning	atunse	None
fortfarande	tun	Nan
fort	yara	Nan
formell	lodo	None
formella	lodo	None
formellt	lẹsẹsẹ	Nan
formen	fọọmu	Nan
former	awọn fọọmu	Nan
formerna	awọn fọọmu	Nan
forna	tele	None
fornnordiska	norse	Nan
forntida	atijọ	Nan
forsberg	forsberg	Nan
forskare	oniwadi	Nan
forskaren	oniwadi	Nan
forskarna	sayensi	Nan
forskning	iwadii	Nan
forskningen	iwadii	Nan
formatet	ọna kika	Nan
flög	fò	Nan
flöde	ṣiṣan	Nan
flyttat	ṣí	Nan
fjärde	kẹrin	None
fjärdedel	mẹẹdogun	Nan
flagga	asia	Nan
flaggan	asia	Nan
flaggor	awọn asia	Nan
flames	awọn ina	Nan
fjädrar	omi	None
flamländska	flemish	Nan
fler	diẹ sii	Nan
flera	lọpọlọpọ	Nan
flertal	lọpọlọpọ	Nan
flertalet	julọ	Nan
flest	julọ	Nan
flesta	julọ	Nan
flandern	ilẹ	None
fjorton	mẹrinla	Nan
fission	fesi	Nan
fiske	ipeja	Nan
finna	wa	Nan
finnas	jẹ	Nan
finner	nwa	None
finns	jẹ	Nan
finsk	ede	None
finska	ede	None
fira	ayeye	Nan
firade	ṣe ayẹyẹ	Nan
firades	ṣe ayẹyẹ	Nan
firandet	ayeye	Nan
firar	ayẹyẹ	Nan
firas	ṣe ayẹyẹ	Nan
fire	iná	Nan
fisk	ẹja	Nan
fiskar	ẹja	Nan
flicka	ọmọbinrin	Nan
flickan	ọmọbinrin	Nan
flickor	awon odomobirin	Nan
flickvän	ọrẹbinrin	Nan
flygplan	ọkọ ofurufu	Nan
flygplats	papa	None
flygplatsen	papa	None
flygplatser	papa	None
flygvapnet	ategun ategun	Nan
flykt	sa asala	Nan
flyktingar	asasala	Nan
flyr	sá lọ	Nan
flytande	omi	None
flyter	ós	Nan
flytt	gbe	None
flytta	gbe	None
flyttades	ṣí	Nan
flyttar	gbe	None
flyttas	ṣí	Nan
flyger	fò	Nan
fotbollslandslag	egbe	None
flygbolag	oko	None
flyga	fò	Nan
flight	oṣuwọn	Nan
flitigt	aisimi	Nan
flod	odo	Nan
floden	odo	Nan
floder	odo	Nan
floderna	odo	Nan
flora	ododo	None
florens	florence	Nan
florida	ilu florida	Nan
flotta	kekere	None
flottan	ọgagun	Nan
floyd	floyd	Nan
fly	sa asala	Nan
flydde	sa asala	Nan
flyg	ọkọ ofurufu	Nan
flygande	fò	Nan
finländska	ede	None
fotbollsspelare	ẹlẹsẹ ẹlẹsẹ	Nan
fotnoter	awọn iwe afọwọkọ	Nan
fråga	ibeere	Nan
frågade	ibeere	Nan
frågan	ibeere naa	Nan
frågor	awọn ọran	Nan
frågorna	awọn ọran	Nan
från	lati	Nan
främste	ṣaaju	Nan
frånträde	yiyọ kuro	Nan
fröken	sọnu	Nan
fröväxter	irugbin awọn irugbin	Nan
fss	fss	Nan
fuglesang	fuglesang	Nan
fuktiga	ọririn	Nan
fuktigt	ọririn	Nan
frånvaro	isansa	Nan
främsta	jc	Nan
främst	o kun	Nan
främre	iwaju	Nan
fritt	ọfẹ	Nan
fritz	fritz	Nan
frivillig	atinuwa	Nan
frivilliga	atinuwa	Nan
frivilligt	atinuwa	Nan
frodo	frodo	Nan
from	lati	Nan
front	iwaju	Nan
fronten	iwaju	Nan
fru	iyawo	None
frukt	eso	Nan
fruktade	bẹru	Nan
frälsning	igbala	Nan
främja	igbelaruge	Nan
främmande	ajeji	Nan
full	kun	Nan
fritid	asiko ofe	Nan
fulla	kun	Nan
fullständiga	kun	Nan
fyller	àgbáye	Nan
fynd	na ọja	Nan
fynden	nwa	None
fyra	mẹrin	Nan
fyrtio	ogoji	Nan
fysik	fisiksi	Nan
fyllde	kun	Nan
fysikaliska	ti ara	Nan
fysiologi	fisioloji	Nan
fysiologiska	iwulo	None
fysisk	ti ara	Nan
fysiska	ti ara	Nan
fysiskt	nipa ti ara	Nan
fält	pápá	Nan
fysiker	oníṣègùn	Nan
fylla	kun	Nan
futharkens	futhark	Nan
fusionen	apapọ	Nan
fullständigt	ni kikun	Nan
fullt	ni kikun	Nan
fungera	iṣẹ	Nan
fungerade	ṣe	Nan
fungerande	iṣẹ	Nan
fungerar	iṣe	Nan
funktion	ẹya	Nan
funktionella	iṣẹ ṣiṣe	Nan
funktionen	iṣẹ	Nan
funktioner	awọn iṣẹ	Nan
funktionerna	awọn iṣẹ	Nan
funnit	ri	Nan
funnits	ri	Nan
fursten	ọmọ	None
fusion	ifun	Nan
fullständig	kun	Nan
fristående	olominira	Nan
friska	ni ilera	Nan
frisk	ni ilera	Nan
framgångsrik	aṣeyọri	Nan
framgångsrika	aṣeyọri	Nan
framgångsrikt	ni ifijišẹ	Nan
framgår	ko	None
framsteg	ilọsiwaju	Nan
framställa	mu jade	Nan
framgången	aṣeyọri	Nan
framställning	gbóògì	Nan
framstående	aridaju	Nan
framtid	ojo	None
framtida	ojo	None
framtiden	ojo	None
framträdande	oguna	Nan
framträdanden	iṣe	Nan
framställs	gbaradi	Nan
framgångarna	awọn aṣeyọri	Nan
framgångar	awọn aṣeyọri	Nan
framgång	aṣeyọri	Nan
foto	aworan	Nan
fotografier	fọtoyiya	Nan
foton	awọn fọto	Nan
fotosyntesen	photosynthesis	Nan
fragment	apa	Nan
fralagen	fralagen	Nan
fram	iwaju	Nan
framför	ni iwaju	Nan
framföra	lọwọlọwọ	Nan
framförallt	ni pataki	Nan
framförde	ošišẹ	Nan
framfördes	ti ṣalaye	Nan
framförs	ti ṣalaye	Nan
framfört	siwaju	Nan
framförts	siwaju	Nan
framträdde	han	Nan
framträder	dúró	None
framåt	siwaju	Nan
francis	francis	None
fredspris	onipokinni	Nan
fredspriset	àlàáfíà	None
freedom	ominira	Nan
freja	joe	Nan
frekvens	igbohunsafẹfẹ	Nan
freud	freud	Nan
fri	ọfẹ	Nan
fria	ọfẹ	Nan
friedrich	friedrich	Nan
frigörelse	ominira	Nan
frigörs	tu silẹ	Nan
frihet	ominira	Nan
friheten	ominira	Nan
frihetliga	ominira	Nan
friidrott	elere idaraya	Nan
fredsbevarande	alafia	Nan
foten	ẹsẹ	None
fredrik	fredrik	Nan
freden	alafia	Nan
francisco	francisco	Nan
franco	franko	Nan
franklin	franklin	Nan
frankrike	faranse	None
frankrikes	faranse	None
fransk	faranse	None
franska	faranse	None
franske	faranse	None
franskt	faranse	None
fransmännen	faranse	None
franz	franz	Nan
français	faranse	None
fred	alafia	Nan
freddie	freddie	Nan
freddy	freddy	Nan
fredliga	alaafia	None
finlands	finland	Nan
finland	finland	Nan
fingrar	awọn ika ọwọ	Nan
europas	yuroopu	Nan
europe	oyinbo	Nan
european	oyinbo	Nan
europeisk	oyinbo	Nan
europeiska	oyinbo	Nan
européer	ara ilu yuroopu	Nan
europarådet	igbimo ti yuroopu	Nan
européerna	ara ilu yuroopu	Nan
eus	eu	Nan
eva	eva	Nan
evangelierna	ihinrere	None
evangeliska	ihinrere	None
evans	evans	Nan
evenemang	ìṣẹlẹ	Nan
eurovision	eurovision	Nan
europaparlamentet	awọn ipe	Nan
europacupen	european cup	Nan
europa	yuroopu	Nan
etiken	iwa	Nan
etiopien	etiopia	Nan
etiopiska	ara etiopia	Nan
etiska	iwa	Nan
etnicitet	omo ilu	Nan
etnisk	ẹya	Nan
etniska	ẹya	Nan
etniskt	ẹya	Nan
ett	ọkan	Nan
etta	ọkan	Nan
etymologi	ẹkọ ẹkọ ẹkọ	Nan
eu	eu	Nan
euro	euro	None
euron	euro	None
euroområdet	euro	None
eventuell	iṣẹlẹ	Nan
etik	iwa	Nan
eventuella	eyikeyi	Nan
evert	tubo	Nan
existerande	wa	Nan
existerar	wa	Nan
existerat	wa	Nan
exklusiv	iyasọtọ	Nan
expandera	faagun	Nan
expansion	imugboroosi	Nan
existerade	wa	Nan
expansionen	imugboroosi	Nan
expeditionen	ajo	None
expeditioner	ajo	None
experiment	ṣàdánwò	Nan
experimenterade	ṣàdánwò	Nan
experter	awọn amoye	Nan
explosionen	gbuuru	Nan
expedition	ajo	None
existera	wa	Nan
existensen	iwalaaye	Nan
existens	iwalaaye	Nan
everton	everton	Nan
eviga	ayeraye	Nan
evigt	lailai	Nan
evolution	itankalẹ	Nan
evolutionen	itankalẹ	Nan
evolutionsteorin	itankalẹ yii	Nan
ex	mofi	Nan
exakt	gangan	Nan
exakta	gangan	Nan
examen	ìyí	Nan
exempel	apẹẹrẹ	Nan
exempelvis	apẹẹrẹ	Nan
exemplar	ẹda	Nan
exemplet	apẹẹrẹ	Nan
exil	yíyọ	Nan
eventuellt	o ṣee	Nan
etanol	ẹyẹ	Nan
etablerat	mulẹ	Nan
etablerades	mulẹ	Nan
epoken	igbala	Nan
epost	imeeli	Nan
er	rẹ	None
era	akoko	Nan
eran	akoko	Nan
erbjuda	ìfilọ	Nan
epok	igbala	Nan
erbjuder	awọn ipese	Nan
erbjöds	ti a nṣe	Nan
erektion	ere	Nan
erfarenhet	iriri	Nan
erfarenheter	awọn iriri	Nan
erhållit	gba	None
erhöll	gba	None
erbjöd	ti a nṣe	Nan
epicentrum	apọju	Nan
ep	éú	Nan
enzymer	ensaemusi	Nan
enklare	o rorun gan	Nan
enklaste	rọọrun	Nan
enlighet	ibamu	Nan
enligt	gẹgẹ bi	Nan
enorm	tobi	Nan
enorma	tobi pupo	Nan
enormt	tobi	Nan
ens	ani	Nan
ensam	nikan	Nan
ensamma	nikan	Nan
enskild	olukọọkan	Nan
enskilda	ẹnikọọkan	Nan
enskilt	ẹyọkan	Nan
enstaka	nikan	Nan
entertainment	ere idaraya	Nan
eric	eric	Nan
ericsson	ericsson	Nan
erik	erik	Nan
eriksson	eriksson	Nan
ersätts	rọpo	Nan
erövra	ṣẹgun	Nan
erövrade	ṣẹgun	Nan
erövrades	ṣẹgun	Nan
erövring	iṣẹgun	Nan
erövringar	iṣẹgun	Nan
erövringen	iṣẹgun	Nan
estetik	adani	Nan
estetiska	darapupo	Nan
estland	estonia	Nan
estniska	ede	None
et	àti	Nan
etablera	fi	None
etablerad	mulẹ	Nan
etablerade	julọ	Nan
ersättning	rirọpo	Nan
export	okeere	None
ersättare	aropo	Nan
ersatts	rọpo	Nan
eritrea	eritrea	Nan
erkänd	mọ	Nan
erkända	mọ	Nan
erkände	mọ awọn	Nan
erkänna	gba	None
erkännande	idanimọ	Nan
erkänner	ṣe idanimọ	Nan
erkänt	mọ awọn	Nan
ernest	ernest	Nan
ernman	ernman	Nan
ernst	ernst	None
eros	eros	Nan
ersatt	rọpo	Nan
ersatte	rirọpo	Nan
ersattes	rọpo	Nan
ersätta	rọpo	Nan
exporten	okeere	None
express	han	Nan
expressen	fihan	None
femton	meedogun	Nan
fenomen	lasan	Nan
fenomenet	lasan	Nan
feodala	feudal	Nan
ferdinand	ferdinand	Nan
fermentering	bakteria	Nan
femte	karun	None
fernando	fernando	Nan
fester	awọn itọju	Nan
festival	ayẹyẹ	Nan
festivalen	ajọdun	Nan
festivaler	ajọdun	Nan
fett	ọra	Nan
ff	ff	Nan
fest	ẹgbẹ	Nan
feministiska	abo	None
feminister	abo	None
feminismen	abo	None
fci	fci	Nan
fd	f	Nan
feber	ibà	Nan
februari	oṣu kínní	Nan
federal	federal	Nan
federala	federal	Nan
federation	federation	Nan
federationen	igbimọ	Nan
fel	ko	None
felaktig	aiṣe-deede	Nan
felaktiga	aṣiṣe	Nan
felaktigt	ko	None
felix	felix	Nan
fem	marun	Nan
feminism	abo	None
fick	gba	None
fiende	ọtá	Nan
fienden	ọtá	Nan
fiender	awon ota	Nan
filosofer	onimoye	Nan
filosofi	imoye	Nan
filosofin	imoye	Nan
filosofins	imoye	Nan
filosofisk	ori	None
filosofiska	ori	None
fina	dara	Nan
final	ik	Nan
finalen	ipari	Nan
finansiella	owo	Nan
finansiera	isuna	Nan
finansieras	ti ṣe inawo	Nan
finansiering	nina owo	Nan
finanskrisen	idaamu owo	Nan
finger	ika	Nan
filosofen	onimoye	Nan
fc	fc	Nan
filmografi	filmography	Nan
filmer	sinima	Nan
fifa	fifa	Nan
figur	eeya	Nan
figuren	eeya	Nan
figurer	isiro	Nan
figurerna	awọn ọpọtọ	Nan
fiktion	itan-akọọlẹ	Nan
fiktiv	arosọ	Nan
fiktiva	arosọ	Nan
fil	faili	Nan
filip	fílípì	Nan
filippinerna	philippines	Nan
film	fiimu	Nan
filmatiserats	filimu	Nan
filmen	fiimu	Nan
filmens	fiimu	Nan
filmerna	fiimu	Nan
enkelt	rọrun	Nan
fbi	fbi	Nan
fattigdomen	osi	Nan
faktorn	ifosiwewe	Nan
faktum	o daju	Nan
fall	ọran	Nan
falla	ṣubu	Nan
fallen	awọn ọran	Nan
faller	ja bo	Nan
faktorer	awọn okunfa	Nan
fallet	ọran	Nan
falska	èké	Nan
falskt	èké	Nan
familj	idile	Nan
familjen	idile	Nan
familjens	idile	Nan
familjer	idile	Nan
fallit	ṣubú	Nan
faktor	ifosiwewe	Nan
faktiskt	gangan	Nan
faktiska	gangan	Nan
externa	ita	Nan
extra	afikun	Nan
extrem	awọn iwọn	Nan
extrema	awọn iwọn	Nan
extremt	lalailopinpin	Nan
fabriker	ile-iṣelọpọ	Nan
facebook	facebook	Nan
fackföreningar	awọn ẹgbẹ	Nan
facto	facto	Nan
facupen	fa cup	Nan
fader	bàbá	None
fadern	baba	Nan
faderns	baba	Nan
fagocyt	phagocyte	Nan
fakta	ododo	None
familjerna	awọn idile	Nan
fan	gbaga	Nan
fann	ri	Nan
fanns	wà	Nan
faser	ipele	None
fast	ti o wa titi	Nan
fasta	líle	Nan
fastigheter	ile ati ile tita	Nan
fastlandet	oluile	Nan
fastställa	pinnu	Nan
fastställdes	ṣeto	Nan
fastän	biotilejepe	Nan
fat	agba	None
fatta	mu	Nan
fattas	mu	Nan
fattiga	talaka	None
fattigare	talaka	None
fattigaste	talika	None
fattigdom	osi	Nan
fasen	alakoso	Nan
fauna	fauna	Nan
fascistiska	fascist	Nan
fascismen	fascism	Nan
fans	egeb onijakidijagan	Nan
fansen	egeb onijakidijagan	Nan
far	bàbá	None
fara	ijamba	Nan
farbror	aburo	Nan
farfar	agba	None
farlig	lewu	Nan
farliga	lewu	Nan
farligt	lewu	Nan
fars	baba	Nan
fart	iyara	Nan
fartyg	ọkọ	Nan
fartyget	ha	Nan
fas	alakoso	Nan
fascism	fakisi	Nan
fascisterna	fascists	Nan
fältet	pápá	Nan
celler	ẹyin	Nan
cellen	sẹẹli	Nan
arvid	arvid	Nan
asiatiska	esia	None
asien	esia	None
aspekt	abala	None
aspekter	awọn ẹya	Nan
aspergers	asperger	Nan
arvet	julọ	Nan
assistent	olùrànlówó	Nan
assyriska	ara assysíríà	Nan
asterix	asterix	Nan
asteroidbältet	asteroid igbanu	Nan
asteroider	asteroids	Nan
aston	aston	Nan
astrid	astrid	Nan
assisterande	olùrànlówó	Nan
arton	mejidilogun	Nan
artisterna	awọn oṣere	Nan
artister	awọn oṣere	Nan
arrangemang	ètò	Nan
arrangeras	idayatọ	Nan
arresterades	mu	Nan
arsenal	asọgun	Nan
art	eya	None
arten	eya	None
arter	eya	None
arterna	eya	None
arternas	eya	None
arthur	arthur	Nan
artikel	nkan	None
artikeln	nkan	None
artiklar	nkan	None
artist	olorin	Nan
artisten	olorin	Nan
astronomer	aworawo	Nan
arnold	arnold	Nan
astronomi	aworawo	Nan
astronomiska	aworawo	Nan
augusti	oṣu kẹjọ	Nan
auktoritet	aṣẹ	Nan
auktoritära	aṣẹ	Nan
auschwitz	auschwitz	Nan
austin	austin	Nan
australia	ilu oyinbo	Nan
august	ogo	Nan
australian	ilu olominira	Nan
australiens	ilu oyinbo	Nan
australiska	ilu ọstrelia	Nan
autism	autism	Nan
automatiskt	laifọwọyi	Nan
autonom	adase	Nan
autonoma	adase	Nan
australien	australia	None
attackerna	ku	None
attacker	ku	None
attacken	kọlu	Nan
ateism	aigbagbọ	Nan
ateist	alaigbagbọ	Nan
ateister	alaigbagbọ	Nan
aten	gbogbogbo	None
atlanta	atlanta	Nan
atlanten	ede	None
atlas	atlas	Nan
atmosfär	bugbamu	Nan
atmosfären	bugbamu	Nan
atom	ọgbọn	Nan
atombomben	bombu atomiki	Nan
atombomberna	awọn ado-iku atomiki	Nan
atomer	awọn ọta	Nan
atomkärnor	ìgbó	Nan
att	sí	Nan
astronomin	aworawo	Nan
arméns	ogun	None
armén	ogun	None
arméerna	ogun	None
använt	ti lo	Nan
använts	ti lo	Nan
apartheid	eleyameya	Nan
apollo	apollo	Nan
april	kẹrin	None
ar	jẹ	Nan
används	ti lo	Nan
arab	arabawa	Nan
araber	arabawa	Nan
araberna	awọn ara larubawa	Nan
arabisk	arabawa	Nan
arabiska	lárúbáwá	None
arabvärlden	arabawa	Nan
arbeta	iṣẹ	Nan
arabemiraten	uae	Nan
användningsområden	awọn ohun elo	Nan
användningen	lo	Nan
användning	lo	Nan
antoinette	antoinette	Nan
antonio	antonio	Nan
antropogen	anthropogenic	Nan
antyder	fihan	None
anus	anus	Nan
använda	lo	Nan
användande	lilo	Nan
användandet	lo	Nan
användare	olumulo	Nan
användaren	olumulo	Nan
användas	ti lo	Nan
användbar	wulo	Nan
användbara	wulo	Nan
använder	lilo	Nan
användes	ti lo	Nan
arbetade	ṣiṣẹ	Nan
arbetar	ṣiṣẹ	Nan
arbetare	oṣiṣẹ	Nan
arbetarklassen	ṣiṣẹ	Nan
arkeologiska	igba atijọ	Nan
arkitekt	ayaworan	Nan
arkitekten	ayaworan	Nan
arkitekter	awọn ayaworan ile	Nan
arkitektur	faaji	Nan
arkitekturen	faaji	Nan
arkiv	faili	Nan
arlanda	arlanda	Nan
arm	apa	Nan
armar	awọn ọwọ	Nan
armenien	armenia	Nan
armeniska	armenia	Nan
army	ogun	None
armé	ogun	None
arméer	ogun	None
aristoteles	aristotle	Nan
autonomi	ijọba ara ẹni	Nan
aristokratin	ọlaju	Nan
argentina	ilu amẹrika	Nan
arbetat	ṣiṣẹ	Nan
arbete	iṣẹ	Nan
arbeten	awọn iṣẹ	Nan
arbetet	iṣẹ	Nan
arbetsgivare	agbanisiṣẹ	Nan
arbetsgivaren	agbanisiṣẹ	Nan
arbetskraft	laala	Nan
arbetslöshet	alainiṣẹ	Nan
arbetslösheten	alainiṣẹ	Nan
arbetsplats	ibi iṣẹ́	Nan
area	agbegbe	Nan
arean	agbegbe	Nan
arena	gbagede	Nan
arenan	gbagede	Nan
arg	binu	Nan
argument	ariyanjiyan	Nan
antogs	gba	None
av	ti	Nan
avancerad	ti ni ilọsiwaju	Nan
bandmedlemmarna	egbe	None
bank	bank	Nan
banker	bèbe	Nan
banor	awọn ọna	Nan
baptism	baptisti	Nan
bar	pẹpẹ	Nan
bandmedlemmar	egbe	None
bara	nikan	Nan
barbro	barbro	Nan
barcelona	ilu barcelona	Nan
barcelonas	ilu barcelona	Nan
barndom	ewe	None
barnen	ọmọ	None
barnens	ọmọ	None
barack	awọn alaga	Nan
bandets	ẹgbẹ	Nan
bandet	ẹgbẹ	Nan
banden	igbohunsafefe	Nan
bakgrund	lẹhin	Nan
bakom	sile	None
bakterier	arun	None
bakåt	sẹhin	Nan
balans	iwontunws.funfun	Nan
balansen	iwontunws.funfun	Nan
balkan	tan	Nan
balkanhalvön	balkan	Nan
baltikum	balikoni	Nan
baltimore	baltimore	Nan
baltiska	baliki	Nan
bana	ọnà	Nan
banan	ogede	Nan
banbrytande	ọ̀nà	None
band	ẹgbẹ	Nan
barnet	ọmọ	None
baker	beki	Nan
barnets	ọmọ	None
barns	ọmọ	None
bayern	bavaria	Nan
bbc	bbc	Nan
be	béèrè	Nan
beatles	beatles	Nan
bebott	gbé	None
bebyggelse	awọn ile	Nan
bay	bay	Nan
bebyggelsen	awọn ile	Nan
beckham	beckham	Nan
bedrev	o waiye	Nan
bedriva	gbe	None
bedriver	gbejade	Nan
bedrivs	o waiye	Nan
bedöma	ṣe ayẹwo	Nan
beck	ọfin	Nan
batman	batman	Nan
basket	bọọlu inu agbọn	Nan
basisten	alagbẹdẹ	Nan
baron	baron	Nan
barrett	barrett	Nan
barry	barry	Nan
bars	pẹpẹ	Nan
bart	afọwọkọ	Nan
bas	mimọ	Nan
basen	mimọ	Nan
baser	awọn ipilẹ	Nan
baserad	orisun	None
baserade	orisun	None
baserar	mimọ	Nan
baseras	orisun	None
baserat	orisun	None
basis	ipilẹ	Nan
basist	alagbẹdẹ	Nan
barney	barney	Nan
baháí	bahái	Nan
baháulláh	bahá&#39;u&#39;lláh	Nan
bahamas	bahamas	Nan
avrättning	ipaniyan	Nan
avrättningar	awọn ipaniyan	Nan
avrättningen	ipaniyan	Nan
avsaknad	aini	Nan
avsaknaden	aini	Nan
avsattes	idogo	Nan
avrättades	pa	Nan
avsedd	ti a pinnu	Nan
avseende	ọwọ	Nan
avseenden	ọwọ	Nan
avser	tọka	Nan
avses	tọka	Nan
avsett	ti a pinnu	Nan
avsevärt	riro	None
avsedda	ti a pinnu	Nan
avlägsna	yọ	None
avlidna	kú	Nan
avlidit	kú	Nan
avancerade	fafa	Nan
avbrott	idilọwọ	Nan
avbryta	fagile	None
avbröts	paarẹ	Nan
avel	ajọbi	Nan
avfall	egbin	Nan
avgick	ipo	None
avgå	ipo	None
avgör	ipinnu	Nan
avgöra	pinnu	Nan
avgörande	pataki	Nan
avgörs	pinnu	Nan
avhandling	ilana	None
avkomma	ọmọ	None
avled	kú	Nan
avsikt	ero	Nan
avsikten	idi	Nan
avskaffa	fopin	Nan
avskaffade	paarẹ	Nan
avtar	n dinku	Nan
avvikande	ajeji	Nan
avvikelser	ohun ajeji	Nan
avvisade	kọ	Nan
avvisar	kọ	Nan
awards	awọn ẹbun	Nan
axel	ejika	Nan
axelmakterna	àá	Nan
axl	akeke	Nan
azerbajdzjan	azerbaijan	Nan
azidgrupp	ẹgbẹ azide	Nan
b	b?	Nan
babylon	bábílónì	Nan
bad	odo	Nan
bagge	àgbo	Nan
avtalet	àdéhùn	Nan
avalanche	avalanche	Nan
avtal	àdéhùn	Nan
avsätta	gbe	None
avskaffades	paarẹ	Nan
avskaffande	iparun	Nan
avskaffandet	imukuro	Nan
avsluta	ipari	Nan
avslutade	ti pari	Nan
avslutades	pari	Nan
avslutas	pari	Nan
avslutat	ti pari	Nan
avslöjade	fi	None
avsnitt	isele	Nan
avsnitten	awọn apakan	Nan
avsnittet	apakan	Nan
avstå	fun	None
avstånd	jinna	Nan
avståndet	jinna	Nan
avsåg	ti o ni ibatan	Nan
antog	gba	None
antisemitismen	apakokoro	Nan
antisemitism	apakokoro	Nan
albumen	awo-orin	Nan
albumet	awo-orin	Nan
albumets	awo-orin	Nan
alces	alces	Nan
aldrig	rara	Nan
ale	titaniji	Nan
album	awo-orin	Nan
alex	irina	Nan
alexanders	awọn oludari	Nan
alexandra	alexandra	None
alexandria	alexandria	Nan
alf	alf	Nan
alfa	alfa	Nan
alfabet	abidi	None
alexander	alexander	Nan
albert	albert	None
albanska	albania	Nan
albanien	albania	Nan
aktiv	ṣiṣẹ	Nan
aktiva	lọwọ	Nan
aktivitet	ìṣe	Nan
aktiviteten	ìṣe	Nan
aktiviteter	akitiyan	Nan
aktivt	lọwọ	Nan
aktuell	lọwọlọwọ	Nan
aktuella	lọwọlọwọ	Nan
aktuellt	lọwọlọwọ	Nan
aktörer	olukopa	Nan
akut	agba	None
al	al	Nan
alan	alan	Nan
alaska	alaska	Nan
albaner	awọn ara alibani	Nan
alfabetet	abidi	None
aktier	mọlẹbi	Nan
alfabetisk	abidi	None
alger	awọn algiers	Nan
allra	pupọ	Nan
alls	rara	Nan
allsvenskan	allsvenskan	Nan
allt	gbogbo	Nan
alltför	paapaa	None
alltid	nigbagbogbo	Nan
allmänt	gbogbogbo	None
allting	ohun gbogbo	Nan
alltmer	pọ si	Nan
alltsedan	niwon	Nan
alltså	ninu awọn ọrọ miiran	Nan
allvar	isẹ	Nan
allvarlig	to	None
allvarliga	to	None
alltjämt	tun	Nan
allmänna	gbogboogbo	Nan
allmänheten	ita	Nan
allmänhet	gbangba	Nan
algeriet	algeria	Nan
ali	ali	Nan
alice	alice	Nan
alkohol	oti	Nan
alkoholer	ọti-lile	Nan
alla	gbogbo	Nan
allan	allan	Nan
alldeles	ọtun	Nan
allen	allen	Nan
allians	alliance	Nan
alliansen	alẹgbẹ	Nan
allierad	ore	Nan
allierade	apapọ	Nan
allierades	alẹmọ	Nan
allmän	gbogboogbo	Nan
alfred	alfred	Nan
aktiebolag	ile-iṣẹ lopin	Nan
akondroplasi	achondroplasia	Nan
akon	elegbogi	Nan
accepterade	gba	None
accepterar	gba	None
accepterat	gba	None
acdc	acdc	Nan
action	iṣe	Nan
ad	a.d	Nan
accepterad	gba	None
adam	adam	Nan
adeln	awọn ọlọla	Nan
adhd	adhd	Nan
adjektiv	ajẹtífù	Nan
administration	iṣakoso	Nan
administrationen	iṣakoso	Nan
administrativ	isakoso	Nan
adams	adams	Nan
acceptera	gba	None
academy	ile-iwe giga	Nan
ac	ac	Nan
abba	abba	Nan
abbas	abbas	Nan
abbey	aláìgbọràn	Nan
abc	abc	Nan
abort	iṣẹyun	Nan
aborter	abortions	Nan
about	om	Nan
abraham	.búráhámù	Nan
absint	aironu	Nan
absolut	egba	None
absoluta	idi	Nan
absolution	idaṣẹ	Nan
absorberas	gba	None
abstrakta	áljẹbrà	Nan
abu	abu	Nan
administrativa	isakoso	Nan
administrativt	abojuto	Nan
adolf	adágún	Nan
adolfs	adágún	Nan
agnetha	agnetha	Nan
agnosticism	agnostic	Nan
agnostiker	alaigbagbọ	Nan
ahmed	ahmed	Nan
aids	eedi	Nan
aik	-alk	Nan
airlines	awọn ọkọ ofurufu	Nan
airport	papa	None
ajax	ajax	Nan
akademi	ile-iwe giga	Nan
akademien	ile-iwe giga	Nan
akademiens	ile-iwe giga	Nan
akademisk	omowe	Nan
akademiska	omowe	Nan
akc	akc	Nan
agnes	awọn agnes	Nan
allvarligt	isẹ	Nan
aggressiv	ibinu	Nan
agera	iṣe	Nan
adrian	adrian	Nan
advokat	agbẹjọro	Nan
af	éè	Nan
affärer	iṣowo	Nan
afghanistan	afiganisitani	Nan
africa	afirika	Nan
afrika	afirika	Nan
afrikaner	ara ilu afirika	Nan
afrikansk	ara ilu afirika	Nan
afrikanska	ara ilu afirika	Nan
afrikas	afirika	Nan
afrodite	afrodite	Nan
aftonbladet	cnn	Nan
age	ori	None
agent	aṣoju	Nan
agerande	ihuwasi	Nan
alperna	alẹ	Nan
alqaida	al qaeda	Nan
alternativ	omiiran	Nan
anne	arene	Nan
annekterade	atọka	Nan
annika	amy	Nan
annorlunda	yatọ	Nan
anor	idile	Nan
anordnas	pese	Nan
annat	omiiran	Nan
anorektiker	awọn aarọ	Nan
another	omiiran	Nan
anpassa	orisirisi	None
anpassade	ti adani	Nan
anpassat	fara	Nan
anpassning	aṣamubadọgba	Nan
anser	ka	Nan
anorexia	aranra	Nan
annars	bibẹẹkọ	Nan
annan	omiiran	Nan
anna	anna	Nan
anka	pepeye	Nan
anklagade	onimo	Nan
anklagades	onimo	Nan
anklagats	onimo	Nan
anklagelser	ẹsùn	Nan
anknytning	ìbáṣepọ	Nan
ankomst	dide	Nan
anlades	gbe	None
anledning	idi	Nan
anledningar	awọn idi	Nan
anledningarna	awọn idi	Nan
anledningen	idi	Nan
anläggningar	eweko	Nan
anlände	dé	None
anländer	de	Nan
anses	ṣakiyesi	Nan
ansetts	ṣakiyesi	Nan
ansikte	oju	Nan
ansiktet	oju	Nan
antagits	isọdọmọ	Nan
antagligen	boya	Nan
antal	opoiye	Nan
antalet	nọmba	Nan
antar	sawon	Nan
antarktis	antarctica	Nan
antarktiska	ẹran apakokoro	Nan
antas	isọdọmọ	Nan
anteckningar	awọn akọsilẹ	Nan
anthony	anthony	Nan
antika	atijọ	Nan
antiken	ohun atijọ	Nan
antikens	atijọ	Nan
antingen	boya	Nan
antisemitiska	apakokoro	Nan
antagit	gba	None
animerade	ti ere idaraya	Nan
anta	gba	None
ansågs	ti ka	Nan
ansluta	sopọ	Nan
ansluter	sisopọ	Nan
anslutna	ti sopọ	Nan
anslutning	ìbáṣepọ	Nan
anslöt	darapo	None
anspråk	beere	Nan
ansträngningar	akitiyan	Nan
anställd	oṣiṣẹ	Nan
anställda	oṣiṣẹ	Nan
ansvar	ojuse	None
ansvarar	lodidi	Nan
ansvaret	ojuse	None
ansvarig	lodidi	Nan
ansvariga	lodidi	Nan
ansåg	ro	None
ansökte	gbẹyin	Nan
bedöms	o ti ṣe yẹ	Nan
anhöriga	ibatan	Nan
angående	nipa	Nan
aminosyra	amino acid	Nan
aminosyror	amino acids	Nan
ammoniak	amonia	Nan
amsterdam	amsterdam	Nan
amy	amy	Nan
ana	ana	Nan
amfetamin	amphetamine	Nan
analsex	furofita	Nan
analytisk	onínọmbà	Nan
analytiska	onínọmbà	Nan
anarkism	anarchism	Nan
anarkismen	anarchism	Nan
anarkister	anarchists	Nan
anarkistiska	anarchistic	Nan
analys	onínọmbà	Nan
amerikas	amẹrika	Nan
amerikanskt	ara ilu amẹrika	Nan
amerikanske	ara ilu amẹrika	Nan
alternativa	omiiran	Nan
alternativt	tabi	None
aluminium	alumọni	Nan
am	emi	Nan
amazonas	amazon	Nan
ambassad	ifiweranṣẹ	Nan
ambitioner	ambitions	Nan
america	amẹrika	Nan
american	ara ilu amẹrika	Nan
amerika	amẹrika	Nan
amerikanen	ara ilu amẹrika	Nan
amerikaner	ara amẹrika	Nan
amerikanerna	ara amẹrika	Nan
amerikansk	ara ilu amẹrika	Nan
amerikanska	amẹrika	Nan
anatolien	anatolien	Nan
anatomi	anatomi	Nan
anc	anc	None
anda	ẹmi	Nan
anfall	kọlu	Nan
anfalla	kọlu	Nan
anfallet	kọlu	Nan
anfield	anfield	Nan
anföll	kọlu	Nan
ange	tẹ	Nan
angeles	àríwá	Nan
angelina	angelina	Nan
angels	awọn angẹli	Nan
anger	ṣalaye	Nan
anges	jade	Nan
anglosaxiska	anglo-saxon	Nan
angola	angola	Nan
angrepp	kọlu	Nan
angränsande	nitosi	None
andy	andy	Nan
anhängare	awọn olufowosi	Nan
andré	andré	Nan
andres	andres	Nan
andas	simi	Nan
ande	ẹ̀mí	Nan
andel	pin	Nan
andelen	ogorun	Nan
anden	ẹmi	Nan
anderna	andes	Nan
anders	anders	Nan
andersson	andersson	Nan
anderssons	andersson	Nan
andlig	nípa tẹ̀mí	Nan
andliga	nípa tẹ̀mí	Nan
andra	omiiran	Nan
andras	awọn miiran	Nan
andre	ikeji	Nan
andreas	arabinrin	Nan
andrew	andrew	Nan
cellens	sẹẹli	Nan
beethoven	beethoven	Nan
befinna	jẹ	Nan
bra	o dara	Nan
brad	brad	Nan
brand	iná	Nan
branden	ina	Nan
brandenburg	brandenburg	Nan
brasilianska	ara ilu brazil	Nan
boy	ọmọkunrin	Nan
brasilien	ilu brazil	Nan
breaking	bireki	Nan
bred	gbooro	Nan
breda	gbooro	Nan
bredare	fẹẹrẹ	Nan
breddgraden	pọgba	Nan
bredvid	lẹgbẹẹ	Nan
brasiliens	ilu brazil	Nan
boxning	boxing	Nan
bowie	bowie	Nan
botten	isalẹ	Nan
bortgång	iku	None
bortom	rekọja	Nan
bortsett	yà	Nan
bosatt	olugbe	Nan
bosatta	gbe	None
bosatte	yanju	Nan
bosnien	bosnia	Nan
bosnienhercegovina	bosnia herzegovina	Nan
bostad	ibugbe	Nan
bostadsområden	adugbo	Nan
boston	boston	Nan
bostäder	ile	Nan
bosättare	atipo	Nan
bosättningar	awọn ibugbe	Nan
bott	dúró	None
brev	meeli	Nan
borta	kuro	Nan
brevet	lẹta naa	Nan
bridge	afara	Nan
brodern	arakunrin	Nan
bron	afara	Nan
brons	idẹ	Nan
bronsåldern	ọjọ-ori idẹ	Nan
bronx	bronx	Nan
brooke	brooke	Nan
broder	arakunrin	Nan
brooklyn	ilu bẹtẹli	Nan
brother	arakunrin	Nan
brott	ilufin	Nan
brottet	ẹṣẹ	Nan
brottslighet	ilufin	Nan
brottslingar	ọdaràn	Nan
brown	brown	Nan
bror	arakunrin	Nan
broar	afara	Nan
bro	afara	Nan
brittiskt	ara ilu gẹẹsi	Nan
brinnande	sisun	Nan
brinner	jó	Nan
brist	aini	Nan
bristande	aini	Nan
bristen	aini	Nan
brister	nwaye	Nan
brita	ara ilu oyinbo	Nan
britannica	ijọba gẹẹsi	Nan
british	ara ilu gẹẹsi	Nan
britney	britney	Nan
britter	ara ilu gẹẹsi	Nan
britterna	ara ilu gẹẹsi	Nan
brittisk	ara ilu gẹẹsi	Nan
brittiska	ara ilu gẹẹsi	Nan
brittiske	ara ilu gẹẹsi	Nan
brian	brian	Nan
bort	kuro	Nan
borrelia	agbègbè	Nan
born	bibi	Nan
blomstrade	pọ	Nan
blott	nikan	Nan
blue	bulu	Nan
blues	awọn blues	Nan
bly	darí	Nan
bläckpenna	ikọwe	Nan
blommor	ododo	None
blå	bulu	Nan
blått	bulu	Nan
blåvitt	bulu-funfun	Nan
bmi	bmi	Nan
bnp	gdp	Nan
bob	bob	Nan
bobby	ariwo	Nan
blåser	nfẹ	Nan
bloggar	awọn bulọọgi	Nan
blogg	bulọọgi	Nan
blodtrycket	ẹjẹ titẹ	Nan
blandat	dapọ	Nan
blandning	adalu	Nan
blekinge	blekinge	Nan
blev	di	Nan
bli	di	Nan
blind	afoju	Nan
blir	gba	None
blivande	ojo	None
blivit	ti	Nan
block	dina	Nan
blod	ẹjẹ	Nan
blodet	ẹ̀jẹ̀	Nan
blodiga	ẹlẹjẹ	Nan
blodkroppar	awọn sẹẹli ẹjẹ	Nan
blodtryck	ẹjẹ titẹ	Nan
bodde	gbé	None
boende	ibugbe	Nan
bojkott	ikokunrin	Nan
bok	iwe	Nan
bon	iwe adehun	Nan
bonaparte	bonaparte	Nan
bond	mnu	Nan
bonde	epa	None
bonniers	ìde	Nan
book	iwe	Nan
bor	wa laaye	Nan
bord	tabili	None
borde	yẹ	Nan
bordet	tabili	None
borg	fort	Nan
borgen	beeli	Nan
borgerliga	ara ilu	Nan
borgmästare	mayor	Nan
boris	boris	Nan
bomull	owu	Nan
bruce	bruce	Nan
bomber	awọn ado-iku	Nan
bomb	ajalu	Nan
boken	iwe	Nan
bokförlaget	te	Nan
bokstav	leta	Nan
bokstaven	lẹta naa	Nan
bokstäver	awọn lẹta	Nan
bokstäverna	awọn lẹta	Nan
bolag	ile-iṣẹ	Nan
bolaget	ile-iṣẹ	Nan
bolagets	ile-iṣẹ	Nan
bolivia	bolivia	Nan
bolivianska	bolivian	Nan
bolivias	bolivia	Nan
bollen	bọọlu	Nan
bolsjevikerna	bolsheviks	Nan
bolt	boluti	Nan
bomben	gbamu	Nan
blandas	commingle	Nan
bruk	lo	Nan
brukar	nigbagbogbo	Nan
bål	ẹhin mọto	Nan
båt	kekere	None
båtar	kekere	None
båten	kekere	None
böcker	awọn iwe	Nan
böckerna	awọn iwe	Nan
både	mejeeji	Nan
böhmen	bohemia	Nan
bönder	agbe	Nan
bönderna	agbe	Nan
bönor	awọn ewa	Nan
bönorna	awọn ewa	Nan
bör	yẹ	Nan
bördiga	irọyin	Nan
bön	àdúrà	Nan
båda	mejeeji	Nan
bättre	dara julọ	Nan
bäste	ololufe	Nan
byte	yipada	None
byten	baiti	Nan
byter	yipada	None
bytet	yipada	None
byts	yipada	None
bytt	yipada	None
bytte	yipada	None
byttes	yipada	None
byxor	pátá	Nan
bägge	mejeeji	Nan
bär	rù	Nan
bära	wọ	Nan
bärande	rù	Nan
bäst	dara julọ	Nan
bästa	oke	Nan
börja	bẹrẹ	Nan
byta	yipada	None
började	bẹrẹ	Nan
börjar	bẹrẹ	Nan
capitol	olú	Nan
carl	carl	Nan
carlo	carlo	Nan
carlos	carlos	Nan
carlsson	carlsson	Nan
carola	carola	Nan
capita	ori	None
carolina	carolina	Nan
cash	owo	Nan
casino	kasino	Nan
castro	castro	Nan
cd	cd	Nan
cecilia	cecilia	Nan
cell	sẹẹli	Nan
carter	carter	Nan
cant	agbara	None
cannabis	taba lile	Nan
cancer	alakan	Nan
börjat	bẹrẹ	Nan
börje	börje	Nan
ca	ca	Nan
caesar	késárì	Nan
caesars	késárì	Nan
café	kafe	Nan
california	california	Nan
calle	pè	None
cambridge	ilu amọdaju	Nan
camp	àgọ́	None
campus	ogba	Nan
can	le	None
canada	kánádà	None
canadian	ilu ilu kanada	Nan
canaria	canaria	None
början	bẹrẹ	Nan
bysantinska	byzantine	Nan
byrå	igbimọ	Nan
byn	abule	Nan
bröstet	igbaya	Nan
bröt	bu	None
bröts	fifọ	Nan
bud	idu	Nan
budapest	budapest	Nan
buddha	buddha	Nan
bröllopet	igbeyawo	None
buddhas	buddha	Nan
buddhismen	buddhism	Nan
buddhister	ẹlẹsin buddhist	Nan
buddhistiska	ẹlẹsin buddhist	Nan
buddy	ore	Nan
budet	idu	Nan
budget	isuna	Nan
buddhism	buddhism	Nan
bröllop	igbeyawo	None
bröderna	awọn arakunrin	Nan
bröder	awọn arakunrin	Nan
bruket	ọlọ	Nan
brushane	ruff	Nan
brutit	fifọ	Nan
bruttonationalprodukt	gdp	Nan
bryssel	biroseli	Nan
bryta	fọ	Nan
bryter	bireki	Nan
bryts	fifọ	Nan
bränder	ina	Nan
brändes	sisun	Nan
brännvin	ọti oyinbo	Nan
bränsle	epo	Nan
bränslen	epo	Nan
bråk	ida	Nan
bröd	burẹdi	Nan
budgeten	isuna	Nan
budskap	ifiranṣẹ	Nan
budskapet	ifiranṣẹ	Nan
bulgarien	bulgaria	Nan
byggas	idilọwọ	Nan
byggd	itumọ	Nan
byggda	itumọ	Nan
byggde	itumọ	Nan
byggdes	itumọ	Nan
bygger	kọ	Nan
bygget	ikole	Nan
byggnad	ile	Nan
byggnaden	ile	Nan
byggnader	awọn ile	Nan
byggnaderna	awọn ile	Nan
byggnadsverk	awọn iṣẹ ikole	Nan
byggs	itumọ	Nan
byggt	itumọ	Nan
byggts	itumọ	Nan
byggandet	ikole	Nan
brukade	ti lo	Nan
bygga	kọ	Nan
by	abule	Nan
bulgariens	bulgaria	Nan
bulgariska	ede	None
bundna	adehun	Nan
bunny	eyan oyinbo	Nan
burj	burj	Nan
burma	boma	Nan
burr	burr	Nan
burton	burtoni	Nan
burundi	burundi	Nan
bush	bush	Nan
bushadministrationen	isakoso bush	Nan
bushs	bush	Nan
buss	bosi	Nan
bussar	awọn ọkọ akero	Nan
butiker	awọn ile itaja	Nan
byar	abule	Nan
blandade	dapọ	Nan
blandad	dapọ	Nan
blanda	dapọ	Nan
bergen	awọn oke-nla	Nan
berger	berger	Nan
berget	oke	Nan
bergman	bergman	Nan
bergmans	bergman	Nan
bergqvist	bergqvist	Nan
bergarter	awọn apata	Nan
bergskedjan	awọn oke-nla	Nan
berlin	berlin	None
berlinmuren	berlin	None
berlins	berlin	None
bernadotte	bernadotte	Nan
bernhard	bernhard	Nan
bero	gbarale	Nan
bergskedjor	awọn sakani oke	Nan
berg	oke	Nan
beredd	gbaradi	Nan
ber	béèrè	Nan
belönades	funni	Nan
bemärkelse	ori	None
ben	eegun	Nan
benen	esè	Nan
benfica	benfica	Nan
bengt	bengt	Nan
bengtsson	bengtsson	Nan
benny	benny	Nan
bensin	epo	Nan
benämnas	ti a npè ni	Nan
benämning	orukọ	Nan
benämningar	denomination	Nan
benämningen	yiyan	Nan
benämns	gbo	Nan
beordrade	paṣẹ	Nan
berodde	wà	Nan
belägna	sọnu	Nan
beroende	igbẹkẹle	Nan
beror	gbarale	Nan
besegra	ṣẹgun	Nan
besegrade	ṣẹgun	Nan
besegrades	ṣẹgun	Nan
besegrat	ṣẹgun	Nan
besittning	ohun-ini	Nan
besittningar	ohun-ini	Nan
berör	nyo	Nan
beskrev	ṣàpèjúwe	Nan
beskriva	ṣàpèjúwe	Nan
beskrivas	ṣàpèjúwe	Nan
beskriver	ṣafihan	Nan
beskrivit	ṣàpèjúwe	Nan
beskrivits	ṣàpèjúwe	Nan
beskrivning	ijuwe	Nan
beskrevs	ṣàpèjúwe	Nan
berömt	olokiki	Nan
berömda	olokiki	Nan
berömd	olokiki	Nan
bertil	bertil	Nan
beräkna	ṣe iṣiro	Nan
beräknades	iṣiro	Nan
beräknar	awọn iṣiro	Nan
beräknas	iṣiro	Nan
beräkningar	awọn iṣiro	Nan
berätta	sọ	None
berättade	fun	None
berättar	pé	None
berättas	fun	None
berättat	fun	None
berättelse	itan	Nan
berättelsen	itan	Nan
berättelser	awọn itan	Nan
berättelserna	awọn itan	Nan
beroendeframkallande	afẹsodi	Nan
belägg	ẹri	Nan
beläget	wa	Nan
belägen	wa	Nan
begravd	sin	Nan
begravdes	sin	Nan
begravning	isinku	Nan
begrepp	erongba	Nan
begreppen	awọn erongba	Nan
begreppet	awọn erongba	Nan
begick	ti ṣe	Nan
begränsa	to	None
begränsade	lopin	Nan
begränsar	to	None
begränsas	ihamọ	Nan
begränsat	ihamọ	Nan
begränsningar	awọn idiwọn	Nan
begär	béèrè	Nan
begränsad	lopin	Nan
begav	lọ	Nan
befälhavare	balogun	Nan
befälet	pipaṣẹ	Nan
befinner	jẹ	Nan
befintliga	wa	Nan
befogenhet	aṣẹ	Nan
befogenheter	agbara	None
befolkade	gbe	None
befolkning	olugbe	Nan
befolkningen	olugbe	Nan
befolkningens	olugbe	Nan
befolkningstillväxt	idagbasoke	None
befolkningstillväxten	idagbasoke	None
befolkningstäthet	iwuwo olugbe	Nan
befolkningstätheten	iwuwo olugbe	Nan
befolkningsutveckling	awọn ẹkọ nipa ẹkọ eniyan	Nan
befruktning	idapọ	Nan
befäl	pipaṣẹ	Nan
begäran	beere	Nan
begärde	beere	Nan
begå	ṣe	Nan
begår	ṣẹ	Nan
bekant	mọ	Nan
bekostnad	inawo	Nan
bekräftade	timo	Nan
bekräftades	timo	Nan
bekräftar	jẹrisi	Nan
bekräftat	timo	Nan
bekämpa	ija	Nan
belagt	ti a bo	Nan
belgien	bẹljiọmu	Nan
belgiens	bẹljiọmu	Nan
belgiska	belijiomu	Nan
belgrad	belgrade	Nan
bell	belii	Nan
bella	belila	Nan
belopp	iye	Nan
behövs	beere	Nan
beskrivningar	awọn apejuwe	Nan
behöver	nilo	Nan
behövde	nilo	Nan
begått	ti ṣe	Nan
behandla	tọju	Nan
behandlade	tọju	Nan
behandlades	tọju	Nan
behandlar	tọju	Nan
behandlas	tọju	Nan
behandling	itọju	Nan
behandlingar	awọn itọju	Nan
behandlingen	itọju	Nan
behov	aini	Nan
behovet	nilo	Nan
behålla	idaduro	Nan
behåller	idaduro	Nan
behöll	ni idaduro	Nan
behöva	nilo	Nan
behövdes	nilo	Nan
beskrivningen	ijuwe	Nan
beskrivs	ṣàpèjúwe	Nan
beskydd	aabo	Nan
bilda	fọọmu	Nan
bildade	akoso	Nan
bildades	akoso	Nan
bildande	ibiyi	Nan
bildandet	ibiyi	Nan
bildar	fọọmu	Nan
bild	aworan	Nan
bildas	akoso	Nan
bildats	akoso	Nan
bilden	aworan	Nan
bilder	awọn aworan	Nan
bilderna	awọn aworan	Nan
bildning	ibiyi	Nan
bildt	bildt	Nan
bildat	akoso	Nan
bilbo	iṣẹ aṣenọju	Nan
bilar	oko	None
bil	ọkọ ayọkẹlẹ	Nan
bibel	bibeli	None
bibeln	bibeli	None
bibelns	bibeli	None
bibliografi	iwe itan	Nan
bibliotek	ile ikawe	Nan
bibliska	bibeli	None
bidra	tiwon	Nan
bidrag	ilowosi	Nan
bidragande	ilowosi	Nan
bidragen	idapada	Nan
bidraget	ere	Nan
bidragit	tiwon	Nan
bidrar	egba	None
bidrog	tiwon	Nan
big	nla	Nan
bilen	ọkọ ayọkẹlẹ	Nan
billboardlistan	apoti bill	Nan
billiga	olowo poku	Nan
billy	billy	Nan
biskop	bishop	Nan
biskopen	bishop	Nan
bistånd	iranlowo	Nan
bit	bit	Nan
bitar	awọn ege	Nan
biträdande	olùrànlówó	Nan
bitter	kikoro	Nan
bjöd	paṣẹ	Nan
björn	jẹri	Nan
bl	aarin	Nan
bla	bla	Nan
black	dudu	Nan
blad	ewe	None
blanc	òfo	Nan
bland	laarin	None
birmingham	birmingham	Nan
beyoncé	bénesié	Nan
birk	ẹyẹ	Nan
birger	birger	Nan
bilmärke	ami ọkọ ayọkẹlẹ	Nan
binda	dipọ	Nan
bindande	abuda	Nan
binder	dipọ	Nan
binds	adehun	Nan
bioetik	awọn ẹkọ oniye	Nan
biogeografi	biogeography	Nan
biografen	sinima	Nan
biografer	cinima	Nan
biografi	isedale	Nan
biologi	isedale	Nan
biologisk	ẹkọ oniye	Nan
biologiska	ẹkọ oniye	Nan
bipolär	arabinrin	Nan
bipolära	arabinrin	Nan
birgitta	birgitta	Nan
befann	ri	Nan
beväpnade	ni ihamọra	Nan
bevis	ẹri	Nan
bestäms	pinnu	Nan
bestämt	dajudaju	Nan
bestå	ni	Nan
bestående	wa	Nan
beståndsdelar	eroja	Nan
består	ni	Nan
bestämmer	ipinnu	Nan
besättningen	atuko	Nan
besöka	ṣàbẹwò	Nan
besökare	àlejò	Nan
besöker	ṣàbẹwò	Nan
besökt	ṣabẹwo	Nan
besökte	ṣàbẹwò	Nan
bet	bit	Nan
besök	ṣàbẹwò	Nan
bestämmelser	ilana	None
bestämma	pinnu	Nan
bestämdes	pinnu	Nan
beskyddare	alabojuto	Nan
beslut	ipinnu	Nan
beslutade	yanju	Nan
beslutar	pinnu	Nan
beslutat	pinnu	Nan
besluten	awọn ipinnu	Nan
beslutet	ipinnu	Nan
besläktade	ti o ni ibatan	Nan
besläktat	ti o ni ibatan	Nan
beslöt	yanju	Nan
besserwisser	ologbon	Nan
best	dara julọ	Nan
bestod	je	Nan
bestämd	pinnu	Nan
bestämde	pinnu	Nan
beta	beta	Nan
betala	sanwo	Nan
betalade	isanwo	Nan
betalar	sanwo	Nan
betydde	túmọ	Nan
betydelse	itumo	None
betydelsefull	pataki	Nan
betydelsefulla	pataki	Nan
betydelsen	itumo	None
betydelser	itumo	None
betyder	tumọ	Nan
betydligt	riro	None
betyg	ite	Nan
bevara	se itoju	Nan
bevarad	ni ifipamọ	Nan
bevarade	ni ifipamọ	Nan
bevaras	ni ifipamọ	Nan
bevarat	ni ifipamọ	Nan
bevarats	ni ifipamọ	Nan
betydande	akude	Nan
bevisa	fi	None
betyda	tumọ	Nan
betraktas	ṣakiyesi	Nan
betalt	idiyele	Nan
beteckna	apẹẹrẹ	Nan
betecknar	aṣoju	Nan
betecknas	sọtọ	Nan
beteckning	yiyan	Nan
beteckningen	yiyan	Nan
beteende	ihuwasi	Nan
beteenden	ihuwasi	Nan
betonade	underlined	Nan
betonar	awọn iṣọ	Nan
betoning	tcnu	Nan
betrakta	ọwọ	Nan
betraktade	šakiyesi	Nan
betraktades	ṣakiyesi	Nan
betraktar	ka	Nan
betraktats	ṣakiyesi	Nan
lucia	lécia	Nan
fälttåg	ipolongo	Nan
fängelsestraff	ẹwọn	Nan
karta	maapu	None
kartan	maapu	None
kartor	maapu	None
kaspiska	ara ilu caspini	Nan
kasta	jabọ	Nan
kastar	gège	Nan
karriären	iṣẹ	Nan
katalanska	ede	None
katastrofen	ajalu	Nan
katastrofer	ajalu	Nan
kate	kate	Nan
kategori	ẹka	Nan
kategoriasiens	esia	None
kategoribrittiska	britain	None
katalonien	katalonia	Nan
karriär	iṣẹ	Nan
karolinska	karolinska	Nan
karma	karma	Nan
kapitulation	okudori	Nan
kapitulerade	jowo	Nan
kapten	balogun	Nan
karakteristiska	ti iwa	Nan
karaktär	ohun kikọ	Nan
karaktären	ohun kikọ	Nan
karaktärer	ohun kikọ	Nan
karaktäriseras	ijuwe	Nan
kardinal	kadinali	Nan
karibiska	karibeanu	Nan
karin	karin	Nan
karl	charles	None
karlsson	karlsson	Nan
karlstad	phoenix	Nan
karlstads	karlstad	Nan
kategorier	awọn ẹka	Nan
kapitel	orí	Nan
kategorieuropas	ẹka yuroopu	Nan
kategorifödda	ẹka ti a bi	Nan
katt	o nran	Nan
kattdjur	feline	Nan
katten	o nran naa	Nan
katter	ologbo	Nan
kazakstan	kasakisitani	Nan
kedja	pq	Nan
katolska	ẹlẹsin katoliki	Nan
kedjan	pq	Nan
keith	keith	Nan
kejsar	ijọba ọba	Nan
kejsardömet	ọba	Nan
kejsare	olú ọba	Nan
kejsaren	emperor	Nan
kejsarens	emperor	Nan
kedjor	ẹwọn	Nan
katolsk	ẹlẹsin katoliki	Nan
katoliker	ẹlẹsin katoliki	Nan
katolicismen	ẹlẹsin katoliki	Nan
kategorikrigsåret	ogun	None
kategorikvinnor	obinrin ẹka	Nan
kategoriledamöter	ọmọ	None
kategorimusik	orin ẹka	Nan
kategorimän	kategorimän	Nan
kategorin	ẹka	Nan
kategoriorter	risoti ẹka	Nan
kategoripersoner	eniyan ẹka	Nan
kategorirock	ẹya ẹka	Nan
kategorispelare	ẹya ẹka	Nan
kategorisvenska	ẹka swedish	Nan
kategorisvenskar	ẹka swedes	Nan
kategorityska	ẹka jẹmánì	Nan
katekes	katakiki	Nan
katla	katla	Nan
kategorifiktiva	ipinya ẹka	Nan
kapitalistiska	kapitalisimu	Nan
kapitalismens	kapitalisimu	Nan
kapitalismen	kapitalisimu	Nan
jönsson	jönsson	Nan
jönssonligan	jönssonligan	Nan
kaffe	kọfi	Nan
kaffet	kọfi	Nan
kairo	cairo	None
kalender	kalẹnda	Nan
jönköpings	tuntun	None
kalendern	kalẹnda	Nan
kalksten	okuta-ilẹ	Nan
kall	tutu	Nan
kalla	pe	Nan
kallad	ti a pe	Nan
kallade	ti a pe	Nan
kallades	ti a pe	Nan
kalifornien	california	Nan
jönköping	jönköping	Nan
järnvägsnätet	oju irin	Nan
järnvägen	reluwe	Nan
jämföra	afiwe	Nan
jämföras	afiwera	Nan
jämförelse	lafiwe	Nan
jämförelser	lafiwe	Nan
jämförelsevis	afiwera	Nan
jämfört	afiwe	Nan
jämlikhet	dọgbadọgba	Nan
jämna	dan	Nan
jämnt	ipele	None
jämte	pelu	Nan
järn	irin	Nan
järnmalm	irin irin	Nan
järnväg	reluwe	Nan
järnvägar	ọkọ oju-irin	Nan
järnvägarna	ọkọ oju-irin	Nan
kallar	pe	Nan
kallare	otutu	None
kallas	ti a pe	Nan
kallat	ti a pe	Nan
kanalen	ikanni	Nan
kanaler	awọn ikanni	Nan
kanarieöarna	awọn erekusu canary	Nan
kandidat	oludije	Nan
kandidater	oludije	Nan
kanske	boya	Nan
kant	eti	Nan
kantoner	kekere	None
kantonerna	kekere	None
kaos	rudurudu	Nan
kap	cape	None
kapacitet	agbara	None
kapital	olu	Nan
kapitalet	olu	Nan
kapitalism	kapitalisimu	Nan
kanal	ikanni	Nan
kejserliga	ọba	Nan
kanadensiska	ara ilu kanada	Nan
kanada	kánádà	None
kallats	ti a pe	Nan
kallblod	òtútù	Nan
kalle	timole	Nan
kallt	tutu	Nan
kalmar	kalmar	Nan
kammare	iyẹwu	Nan
kammaren	iyẹwu	Nan
kamp	ijakadi	None
kampanil	campanile	Nan
kampanj	ipolongo	Nan
kampanjen	ipolongo	Nan
kampen	ja	Nan
kampf	kampf	Nan
kamprad	kamprad	Nan
kan	le	None
kanadas	ara ilu kanada	Nan
jämför	afiwe	Nan
keltiska	seliketi	Nan
kemikalier	kemikali	Nan
koloni	ileto	Nan
koloniala	amunisin	Nan
kolonialism	amunisin	Nan
kolonialismen	ilodi	Nan
kolonialtiden	amunisin	Nan
kolonier	awọn ileto	Nan
kollektivtrafik	gbangba	Nan
kolonierna	awọn ileto	Nan
koloniserades	yípo	Nan
koloniseringen	ilodi	Nan
kolväten	hydrocarbons	Nan
kom	wa	Nan
koma	kọma	Nan
kombattant	alaja	Nan
kolonin	ileto	Nan
kollektiv	collective	Nan
kollapsade	wó lulẹ	Nan
kollaps	subu	Nan
knyta	tai	Nan
knä	orokun	Nan
knäppupp	ti bọtini	Nan
ko	maalu	Nan
koalition	isokan	Nan
koden	koodu	Nan
koenigsegg	koenigsegg	Nan
koffein	kanilara	Nan
kognitiv	imoye	Nan
kognitiva	imoye	Nan
kokain	kokeni	Nan
kokpunkt	farabale ipari	Nan
kol	eedu	Nan
koldioxid	erogba oloro	Nan
kolhydrater	awọn carbohydrates	Nan
kombination	apapo	Nan
knutsson	knutsson	Nan
kombinationen	apapo	Nan
kombinerad	ni idapo	Nan
kommittén	igbimo	Nan
kommun	agbegbe	Nan
kommunal	idalẹnu ilu	Nan
kommunala	idalẹnu ilu	Nan
kommunen	agbegbe	Nan
kommuner	awọn agbegbe	Nan
kommitté	igbimo	Nan
kommunerna	awọn agbegbe	Nan
kommunicerar	mba sọrọ	Nan
kommunikation	ibaraẹnisọrọ	Nan
kommunikationer	awọn ibaraẹnisọrọ	Nan
kommunism	communism	Nan
kommunismen	communism	Nan
kommunismens	communism	Nan
kommunicera	ibasọrọ	Nan
kommit	wá	Nan
kommissionen	igbimọ	Nan
kommersiellt	ti iṣowo	Nan
kombinerade	ni idapo	Nan
kombineras	ni idapo	Nan
kombinerat	ni idapo	Nan
kometer	awọn ọya	Nan
komiker	apanilerin	Nan
komintern	comintern	Nan
komma	wá	Nan
kommande	n bọ	Nan
kommendör	balogun	Nan
kommentar	asọye	Nan
kommentarer	awọn asọye	Nan
kommenterade	asọye	Nan
kommer	wa	Nan
kommersiell	ti iṣowo	Nan
kommersiella	ti iṣowo	Nan
kombinationer	awọn akojọpọ	Nan
knutpunkt	isunpọ	Nan
knutna	ti sopọ	Nan
knuten	somọ	Nan
kinesisk	ṣaina	Nan
kinesiska	ṣaina	Nan
kings	awọn ọba	Nan
kingston	kingston	Nan
kirsten	kirsten	Nan
kiss	fẹnuko	Nan
kinas	kinikan	Nan
kjell	kjell	Nan
klan	idile	Nan
klar	ko	None
klara	ṣe	Nan
klarade	koja	Nan
klarar	rekoja	Nan
klart	ko	None
kl	ni	Nan
kina	kinikan	Nan
kim	kim	Nan
kilometer	kilomita	Nan
kemisk	kẹmika	Nan
kemiska	kẹmika	Nan
kemiskt	kemistri	Nan
ken	keno	Nan
kennedy	kennedy	Nan
kenneth	kenneth	Nan
kenny	kenny	Nan
kent	ewọ	Nan
kenya	kenya	Nan
keramik	awọn ohun elo amọ	Nan
kevin	kevin	Nan
kids	ọmọ	None
kiev	kiev	Nan
kill	pa	Nan
kille	eniyan	Nan
klass	kilasi	Nan
klassas	classified	Nan
klassen	kilasi	Nan
klasser	awọn kilasi	Nan
klubbar	ọgọ	Nan
klubbarna	ọgọ	Nan
klubben	ọgọ	Nan
klubbens	ọgọ	Nan
klubblag	ologba	Nan
klädd	wọ aṣọ	Nan
kläder	aṣọ	Nan
klädsel	aṣọ	Nan
km	km	Nan
km²	km²	Nan
knapp	bọtini	Nan
knappast	nira	Nan
knappt	nira	Nan
knight	ọbẹ	Nan
knut	sorapo	Nan
klubb	ọgọ	Nan
kemi	kemistri	Nan
klp	klp	Nan
klorofyll	chlorophyll	Nan
klassificera	kilasi	Nan
klassificeras	classified	Nan
klassificering	isọdi	Nan
klassiker	ayebaye	Nan
klassisk	ayebaye	Nan
klassiska	ayebaye	Nan
klassiskt	ayebaye	Nan
klaviatur	keyboard	Nan
klimat	afefe	Nan
klimatet	afefe	Nan
klimatologi	oke-nla	Nan
klippa	ge	Nan
klippiga	apata	Nan
klitoris	iṣọn-alọ	Nan
klockan	agogo	Nan
kloster	monastery	Nan
juventus	juventus	Nan
justice	idajo	None
just	kan	None
intresset	iwulo	None
introducerade	ṣafihan	Nan
introducerades	ṣafihan	Nan
intryck	iwunilori	Nan
inträde	titẹsi	Nan
inträffade	ṣẹlẹ	Nan
intresserade	nife	Nan
inträffar	waye	Nan
intäkterna	awọn owo ti n wọle	Nan
intåg	titẹsi	Nan
inuti	ninu	Nan
invadera	kogun ja	Nan
invaderade	gbogun ti	Nan
invaldes	dibo	Nan
intäkter	owo oya	Nan
intresserad	nife	Nan
intressen	nifesi	Nan
intresse	iwulo	None
interna	ti abẹnu	Nan
international	kariaye	Nan
internationell	kariaye	Nan
internationella	kariaye	Nan
internationellt	kariaye	Nan
internet	intanẹẹti	Nan
interstellära	alakọja	Nan
intervju	ifọrọwanilẹnuwo	Nan
intervjuer	ifọrọwanilẹnuwo	Nan
intet	rárá	Nan
intill	tele	None
intog	mu	Nan
intogs	gba	None
intressant	awon	Nan
intressanta	ifigagbaga	Nan
invandrade	aṣikiri	Nan
interaktion	ibaraenisepo	Nan
invandrare	aṣikiri	Nan
invasion	ikogun	Nan
isbn	isbn	Nan
isen	yinyin	Nan
ishockey	ẹlẹsẹ yinyin	Nan
ishockeyspelare	player hockey	Nan
islam	islam	Nan
islamisk	islamu	Nan
isberg	yinyin	Nan
islamiska	islamu	Nan
islams	islam	Nan
island	iceland	None
isländska	ede	None
iso	ipin	None
isolerad	ti ya sọtọ	Nan
isolerade	ti ya sọtọ	Nan
islamistiska	islamu	Nan
irländska	irish	Nan
irland	orile-ede ireland	Nan
iranska	ara ilu iran	Nan
invasionen	ikogun	Nan
inverkan	ikolu	Nan
investeringar	idoko-owo	Nan
invigdes	ti ṣii	Nan
invigningen	ṣiṣi	Nan
invånare	olùgbé	Nan
invånarna	olugbe	Nan
inåt	ninu	Nan
ip	ip	Nan
irak	iraaki	Nan
irakiska	ara ilu iraaki	Nan
irakkriget	ogun	None
iraks	iraaki	Nan
iran	iran	Nan
irans	trans	Nan
invandring	iṣilọ	Nan
inter	aarin	Nan
intensivt	lekoko	Nan
intensiva	lekoko	Nan
innehav	dani	None
innehåll	akoonu	Nan
innehålla	ni	Nan
innehållande	ti o ni awọn	Nan
innehåller	ni	Nan
innehållet	akoonu	Nan
innehas	waye	Nan
innehöll	ti o ni awọn	Nan
innerstaden	aarin ilu	Nan
inom	laarin	None
inre	ti abẹnu	Nan
inrikes	t’ile	Nan
inriktad	iṣalaye	Nan
inriktade	iṣalaye	Nan
innersta	inu	Nan
innehar	dimu	Nan
innehade	waye	Nan
innefattar	ni ninu	Nan
inleds	ipilẹṣẹ	Nan
inlett	ipilẹṣẹ	Nan
inletts	ipilẹṣẹ	Nan
inlägg	awọn ifiweranṣẹ	Nan
inlärning	kikọ ẹkọ	Nan
innan	ṣaaju	Nan
innanför	inu	Nan
inne	ninu	Nan
innebandy	bọọlu afẹsẹgba	Nan
innebar	túmọ	Nan
inneburit	túmọ	Nan
innebär	ọna	Nan
innebära	ọna	Nan
innebörd	itumo	None
innebörden	itumo	None
inriktning	titete	Nan
inriktningar	amọja	Nan
inrättades	sókè	Nan
insats	fi	None
institutet	ilé-ìwé	Nan
institutioner	awọn ile-iṣẹ	Nan
institutionerna	awọn ile-iṣẹ	Nan
instruktioner	ilana	None
instrument	irinse	Nan
inställning	iwa	Nan
insulin	hisulini	Nan
insåg	ṣẹ	Nan
inta	mu	Nan
intag	gbigbemi	Nan
inte	kii ṣe	Nan
integration	isọdọkan	Nan
integritet	iduroṣinṣin	Nan
intellektuella	ọgbọn	Nan
intensiv	lekoko	Nan
institut	igbekalẹ	Nan
isolering	idabobo	Nan
instiftade	gbekalẹ	Nan
instabil	riru	Nan
insatser	akitiyan	Nan
insekter	kokoro	Nan
inser	mọ	Nan
insikt	oye	Nan
inslag	ano	Nan
inspelad	ti o gbasilẹ	Nan
inspelning	gbigbasilẹ	Nan
inspelningar	awọn gbigbasilẹ	Nan
inspelningarna	awọn gbigbasilẹ	Nan
inspelningen	gbigbasilẹ	Nan
inspiration	awokose	Nan
inspirerad	atilẹyin	Nan
inspirerade	atilẹyin	Nan
inspirerades	atilẹyin	Nan
inspirerat	atilẹyin	Nan
installera	fi	None
isotoper	isotopes	Nan
israel	israeli	Nan
israelisk	ọmọ	None
jordbävning	ìṣẹlẹ	Nan
jordbävningar	awọn iwariri-ilẹ	Nan
jordbävningen	ìṣẹlẹ	Nan
jorden	ile aye	Nan
jordens	ile aye	Nan
jorderosion	ogbara	Nan
jordbruket	ogbin	Nan
jordskorpan	irunrun aye	Nan
jorge	jorge	Nan
josef	jósẹ́fù	Nan
joseph	jósẹ́fù	Nan
josé	josé	Nan
journal	iwe irohin	Nan
journalist	akọrohin	Nan
jordytan	ile dada	Nan
jordbruk	ogbin	Nan
jordanien	jọ́dánì	Nan
jord	ile	Nan
johannes	eṣú	Nan
johans	johans	Nan
johansson	johansson	Nan
johanssons	johansson	Nan
john	john	Nan
johnny	johnny	Nan
johnson	johnson	Nan
joker	joker	Nan
jolie	jolie	Nan
jon	dẹlẹ	Nan
jonas	jona	Nan
jonatan	jonathan	Nan
jonathan	jonathan	Nan
jones	jones	Nan
jonsson	jonsson	Nan
journalisten	akọrohin	Nan
journalister	awon oniroyin	Nan
jr	jr.	Nan
ju	awọn	Nan
julia	julia	Nan
julian	julian	Nan
julie	julie	Nan
julius	julius	Nan
juni	karun	None
junior	junior	Nan
jupiter	jupita	Nan
jupiters	jupita	Nan
juridik	ofin	None
juridisk	t’olofin	Nan
juridiska	t’olofin	Nan
juridiskt	ni t’olofin	Nan
juryn	imomopaniyan	Nan
juryns	imomopaniyan	Nan
jussi	jussi	Nan
juli	oṣu keje	Nan
johann	johann	None
jules	ju	Nan
juldagen	keresimesi ọjọ	Nan
juan	juan	Nan
judar	ju	Nan
judarna	ju	Nan
judarnas	ju	Nan
judas	júdásì	Nan
jude	júù	Nan
judendom	ẹsin juu	Nan
judendomen	ju	Nan
judisk	júù	Nan
judiska	juu	Nan
judy	judy	Nan
jugoslavien	yugoslavia	Nan
jugoslaviska	yugoslav	Nan
jul	keresimesi	Nan
julafton	keresimesi efa	Nan
julen	keresimesi	Nan
kommunister	awọn alagbọrọ	Nan
joey	joey	Nan
joe	joe	Nan
jacksons	onilu	Nan
jacob	jakobu	Nan
jacques	jacques	Nan
jag	emi	Nan
jaga	ọdẹ	Nan
jagar	lepa	Nan
jackson	onilu	Nan
jah	jah	Nan
jakt	ọdẹ	Nan
jakten	ọdẹ	Nan
jamaica	jamaica	None
jamaicanska	ara jamani	Nan
jamaicas	jamaica	None
james	jákọ́bù	Nan
jakob	jakobu	Nan
jackie	jackie	Nan
jack	jaketi	Nan
ja	bẹẹni	Nan
israeliska	ọmọ	None
israels	israeli	Nan
istanbul	ilu istanbul	Nan
istiden	ọdun yinyin	Nan
istället	dipo,	Nan
isär	yato si	Nan
italien	ilu italia	Nan
italiens	ilu italia	Nan
italiensk	ilu italia	Nan
italienska	ilu italia	Nan
iu	na	Nan
ivan	aifanu	Nan
ivar	eéṣárì	Nan
iväg	kuro	Nan
ix	ix	Nan
jan	jan.	Nan
janeiro	janeiro	Nan
januari	oṣu kini	Nan
janukovytj	yanukovych	Nan
jerusalems	jerusalẹmu	Nan
jesu	jesu	None
jesus	jesu	None
jihad	jija	Nan
jim	jimọọ	Nan
jimi	jimi	Nan
jimmy	jimmy	Nan
joachim	joachim	Nan
joakim	joakimu	Nan
joan	joan	Nan
jobb	jóòbù	Nan
jobba	iṣẹ	Nan
jobbade	ṣiṣẹ	Nan
jobbar	iṣẹ	Nan
jobbet	iṣẹ	Nan
jerusalem	jerusalẹmu	Nan
joel	joẹli	Nan
jersey	jẹ́ríà	Nan
jens	awọn ara jens	Nan
japan	japanese	Nan
japanerna	japanese	Nan
japans	japan	Nan
japansk	japanese	Nan
japanska	japanese	Nan
jarl	idẹ	Nan
jason	jason	Nan
java	java	Nan
jazz	jazz	Nan
jean	jean	Nan
jeff	jeff	Nan
jefferson	jefferson	Nan
jehovas	jèhófà	Nan
jennifer	jennifer	Nan
jenny	jenny	Nan
jensen	jensen	Nan
inledningsvis	lakoko	Nan
kommunisterna	komunisonu	Nan
kommunistiska	communist	Nan
landskapet	ala-ilẹ	Nan
landskommun	landkommun	Nan
landslag	egbe	None
landslaget	bọọlu	Nan
landsting	county	Nan
lanka	lanka	None
landskapen	agbegbe	Nan
lanserade	se igbekale	Nan
lanseringen	itusilẹ	Nan
laos	laos	Nan
larry	larry	Nan
lars	lars	Nan
larsson	larsson	Nan
larssons	larsson	Nan
lanserades	se igbekale	Nan
landskap	ala-ilẹ	Nan
landshövding	gomina	None
landsbygden	igberiko	None
lagliga	t’olofin	Nan
lagras	ti o fipamọ	Nan
lagring	ibi ipamọ	Nan
lagstiftande	isofin	Nan
lagstiftning	ofin	None
lagstiftningen	ofin	None
lagt	fi	None
lagts	firanṣẹ	Nan
laila	laila	Nan
lake	adagun	Nan
land	orilẹ-ede	Nan
landet	orilẹ-ede	Nan
landets	rẹ	None
landområden	ilẹ	None
lands	orilẹ-ede	Nan
laryngoskop	laryngoscope	Nan
lagförslag	owo	Nan
lasse	lasse	Nan
lat	ọlẹ	Nan
ledarskap	oludari	Nan
ledda	darí	Nan
ledde	darí	Nan
leddes	koja	Nan
leden	apapọ	Nan
leder	nyorisi	Nan
ledarna	awọn oludari	Nan
ledger	adari	Nan
ledningen	darí	Nan
leds	koja	Nan
lee	lee	Nan
leeds	leeds	Nan
left|px	osi | px	Nan
legat	laini	Nan
ledning	iṣakoso	Nan
ledaren	oludari	Nan
ledare	oludari	Nan
ledande	yori	None
latin	latini	None
latinamerika	amerika	None
latinamerikanska	hisipaniki	Nan
latinet	latini	None
latinets	latini	None
latinska	latini	None
laura	laura	Nan
lava	lava	Nan
lawrence	lawrence	Nan
le	rẹrin	Nan
led	ojuami	Nan
leda	darí	Nan
ledamot	aṣoju	Nan
ledamöter	ọmọ	None
ledamöterna	ọmọ	None
lastbilar	oko	None
lagets	ẹgbẹ	Nan
laget	egbe	None
lagerlöf	lagerlöf	Nan
kännetecken	abuda	Nan
kännetecknas	ijuwe	Nan
känns	rilara	Nan
känsla	rilara	Nan
känslan	ori	None
känslig	kókó	Nan
känner	mọ	Nan
känsliga	kókó	Nan
känt	mọ	Nan
kär	ni ife	Nan
kärlek	ni ife	Nan
kärleken	ife	Nan
kärna	mojuto	Nan
kärnan	mojuto	Nan
känslor	awọn ẹdun	Nan
kännedom	imo	Nan
känna	rilara	Nan
kände	ro	None
kyrka	ile ijọsin	Nan
kyrkan	ile ijọsin	Nan
kyrkans	ile ijọsin	Nan
kyrkliga	ijo	Nan
kyrkor	awọn ile ijọsin	Nan
kyrkorna	awọn ile ijọsin	Nan
kyros	kyro	Nan
källa	orisun	None
källan	orisun	None
källkod	orisun	None
källor	orisun	None
källorna	orisun	None
kämpa	ja	Nan
känd	mọ	Nan
kända	mọ	Nan
kärnkraft	iparun iparun	Nan
kärnkraftverk	ohun ọgbin iparun	Nan
kärnor	ohun kohun	Nan
kärnvapen	iparun	Nan
l	l	Nan
la	la	Nan
laboratorium	yàrá	Nan
ladda	ẹru	Nan
laddade	agbara	None
laddning	idiyele	Nan
lade	fi	None
lades	pin	Nan
ladin	laden	Nan
lag	ofin	None
lagar	ofin	None
lagarna	ofin	None
lagen	ìṣe	Nan
lager	ọja	Nan
lagerkvist	lagerkvist	Nan
kött	eran	Nan
legend	arosọ	Nan
körs	sáré	Nan
köra	wakọ	Nan
köket	onjewiwa	Nan
köln	koko	Nan
kön	ibalopọ	Nan
könen	konu	Nan
könsorgan	jiini	Nan
könsorganen	jiini	Nan
köp	ra	None
köpa	ra	None
köpenhamn	copenhagen	Nan
köpenhamns	copenhagen	Nan
köper	ra	None
köpmän	oniṣòwo	Nan
köpt	ra	None
köpte	rà	Nan
kör	wakọ	Nan
körberg	körberg	Nan
kyrilliska	cyrillic	Nan
legenden	arosọ	Nan
legitimitet	t’olofin	Nan
liter	lita	Nan
litet	kekere	None
litteratur	litireso	Nan
litteraturen	litireso	Nan
litterär	imọwe	Nan
litterära	imọwe	Nan
liten	kekere	None
liv	igbesi aye	Nan
liverpool	liverpool	Nan
liverpools	liverpool	Nan
livet	igbesi aye	Nan
livets	igbesi aye	Nan
livslängd	igba aye	Nan
livsmedel	oúnjẹ	None
livealbum	awo	None
lite	kekere	None
litauen	lithuania	Nan
listorna	awọn akojọ aṣayan	Nan
linjer	awọn ila	Nan
linjerna	awọn ila	Nan
linköping	ọna asopọ	Nan
linköpings	ọna asopọ	Nan
linné	linnaeus	Nan
linux	àlẹmọ	Nan
lisa	lisa	Nan
lisbet	lisbet	Nan
lissabon	lisbon	Nan
lissabonfördraget	adehun lisbon	Nan
list	rinhoho	Nan
lista	atokọ	Nan
listade	ṣe akojọ	Nan
listan	atokọ	Nan
listor	ibi	Nan
livsstil	igbesi aye	Nan
linjen	laini	Nan
livstid	igbesi aye	Nan
ljud	ìró	None
londons	lọndọnu	None
lopp	ije	None
loppet	bi	Nan
lord	oluwa	Nan
loss	tú	None
lost	ti sọnu	Nan
london	lọndọnu	None
lotta	ẹyẹ	Nan
louise	louise	Nan
louisiana	louisiana	Nan
lovade	ti ṣèlérí	Nan
lovat	ti ṣèlérí	Nan
lp	lp	Nan
lsd	lsd	Nan
louis	louis	Nan
lokalt	agbegbe	Nan
lokaler	ohun elo	Nan
lokala	agbegbe	Nan
ljudet	ìró	None
ljung	heather	Nan
ljungström	ljungstrã¶m	Nan
ljus	ina	Nan
ljusare	fẹẹrẹ	Nan
ljuset	ina	Nan
locka	ifamọra	Nan
lockar	curls	Nan
locke	locke	Nan
loggbok	logbook	Nan
logik	kannaa	Nan
logotyp	logo	Nan
lois	lois	Nan
lojalitet	iṣootọ	Nan
lokal	agbegbe	Nan
liza	liza	Nan
linje	laini	Nan
lindh	lindh	Nan
lindgrens	lindgren	Nan
leva	wa laaye	Nan
levande	wa laaye	Nan
levde	ye	Nan
lever	ẹdọ	Nan
levern	ẹdọ	Nan
levnadsstandard	boṣewa ti igbe	Nan
lev	léf	Nan
levnadsstandarden	awọn ajohunše igbe	Nan
lewis	lewis	Nan
lexikon	iwe itumọ	Nan
liam	liam	Nan
libanon	lẹ́bánónì	Nan
liberala	olutayo	Nan
liberaler	awọn ominira	Nan
levt	gbé	None
leukemi	lukimia	Nan
lettland	latvia	None
lett	yorisi	Nan
leipzig	leipzig	Nan
lejon	kiniun	Nan
lejonet	kiniun	Nan
lena	dan	Nan
lenin	lenin	Nan
lenins	lenin	Nan
lennart	lennart	Nan
lennon	lennon	Nan
leo	leo	None
leonard	adẹtẹ	Nan
leonardo	leonardo	Nan
leopold	leopold	Nan
les	les	Nan
let	ki	None
leta	wo	Nan
liberalism	ominira	Nan
liberalismen	ominira	Nan
liberty	ominira	Nan
library	ile-ikawe	Nan
likheter	ibajọra	Nan
liknade	jọra	Nan
liknande	jọra	Nan
liknar	jọra	Nan
liknas	fẹran	Nan
liksom	si be e si	Nan
likt	fẹran	Nan
likväl	sibẹsibẹ	Nan
likör	oti alagbara	Nan
lilla	kekere	None
lima	arabinrin	Nan
lina	laini	Nan
lincoln	lincoln	Nan
linda	afẹfẹ	Nan
lindgren	lindgren	Nan
likhet	ibajọra	Nan
legender	arosọ	Nan
likaså	tun	Nan
lika	dogba	Nan
libyen	libya	Nan
lida	jiya	Nan
lidande	ijiya	Nan
lider	jiya	Nan
lidit	jiya	Nan
liechtenstein	liechtenstein	Nan
life	igbesi aye	Nan
liga	ajumọṣe	Nan
ligacupen	ligacupen	Nan
ligan	ajumọṣe	Nan
ligga	parọ	Nan
liggande	lori	Nan
ligger	ti wa ni be	Nan
light	imọlẹ	Nan
lik	fẹran	Nan
likartade	jọra	Nan
kyla	tutu	Nan
kväve	nitrogen	Nan
kvällen	wakati	Nan
kontroversiell	ariyanjiyan	Nan
kontroversiella	ariyanjiyan	Nan
kontroversiellt	ariyanjiyan	Nan
konung	ọba	Nan
konungarike	ijọba	Nan
konungariket	ijọba	Nan
kontroverser	ariyanjiyan	Nan
konventionella	mora	Nan
konventioner	awọn apejọ	Nan
konvertera	yipada	None
konverterade	yipada	None
kopia	ẹda	Nan
koppar	bàbà	Nan
koppla	sopọ	Nan
konventionen	apejọ	Nan
kontrolleras	dari	Nan
kontrollerar	sọwedowo	Nan
kontrollerade	dari	Nan
kontinent	agbègbè	Nan
kontinentala	continental	Nan
kontinenten	kọntinia	Nan
kontinentens	kọntinia	Nan
kontinenter	awọn aye	Nan
kontinuerlig	lemọlemọfún	Nan
kontinuerligt	loorekoore	Nan
konto	akọọlẹ	Nan
kontor	ọfiisi	Nan
kontrakt	àdéhùn	Nan
kontraktet	àdéhùn	Nan
kontrast	itansan	Nan
kontroll	iṣakoso	Nan
kontrollen	iṣakoso	Nan
kontrollera	ṣàrídájú	Nan
kopplad	pelu	Nan
kontakter	awọn olubasọrọ	Nan
kopplade	ti sopọ	Nan
kopplat	pelu	Nan
kosovo	kosovo	Nan
kosovos	kosovo	Nan
kostade	iye owo	Nan
kostar	awọn idiyele	Nan
kostnaden	idiyele	Nan
kostnader	awọn idiyele	Nan
kosmiska	agba	None
kostnaderna	awọn idiyele	Nan
kr	wo	Nan
kraft	ipa	Nan
kraften	ipa	Nan
krafter	awọn ipa	Nan
kraftfull	alagbara	Nan
kraftig	jafafa	Nan
kostym	aṣọ	Nan
kortare	kikuru	Nan
korta	kukuru	Nan
kort	kukuru	Nan
koppling	ikopa	Nan
kopplingar	idapo	Nan
kopplingen	ikopa	Nan
koprolali	coprolalia	Nan
koranen	kuran	Nan
korea	korea	Nan
koreakriget	ogun	None
koreanska	ara ilu korea	Nan
korn	ọkà	Nan
korrekt	o ti tọ	Nan
korrekta	tọ	Nan
korruption	ibajẹ	Nan
korruptionsindex	ibaje atọka	Nan
kors	rekọja	Nan
korset	rekọja	Nan
kopplas	pelu	Nan
kontakten	kan	None
kontaktade	kan	None
kontakt	kan	None
konflikten	rogbodiyan	None
konflikter	rogbodiyan	None
kong	kọngi	Nan
kongo	kongo	None
kongokinshasa	kongo	None
kongress	ile asofin ijoba	Nan
konflikt	rogbodiyan	None
kongressen	ile asofin ijoba	Nan
konkret	nja	Nan
konkreta	nja	Nan
konkurrens	idije	Nan
konkurrensen	idije	Nan
konkurrerande	idije	Nan
konkurs	onigbese	Nan
kongresspartiet	ile asofin ijoba	Nan
koncept	awọn erongba	Nan
koncentrerade	ogidi	Nan
koncentrerad	ogidi	Nan
kommunistpartiet	ccp	Nan
kommunistpartiets	ccp	Nan
komplett	pari	Nan
komplex	eka	None
komplexa	eka	None
komplext	eka	None
komplicerad	idiju	Nan
komplicerat	idiju	Nan
komplikationer	ilolu	Nan
komponenter	awọn paati	Nan
kompositör	olupilẹṣẹ	Nan
kompositörer	oluṣeto	Nan
kon	konu	Nan
koncentration	fojusi	Nan
koncentrationsläger	ogba fojusi	Nan
konsekvens	nitori	Nan
konsekvenser	awọn abajade	Nan
konsekvenserna	ikolu	Nan
konsekvent	dédé	Nan
konstitutionell	t’olofin	Nan
konstitutionella	t’olofin	Nan
konstitutionen	ofin	None
konstnär	olorin	Nan
konstnären	olorin	Nan
konstnärer	awọn oṣere	Nan
konstnärlig	iṣẹ ọna	Nan
konstnärliga	iṣẹ ọna	Nan
konstruerade	ko	None
konstruktion	ikole	Nan
konstverk	ise ona	Nan
konsubstantiation	ifojusi	Nan
konsul	aṣoju ijọba	Nan
konsumtion	lilo	Nan
konsumtionen	lilo	Nan
konstitution	t’olofin	Nan
kraftiga	lagbara	Nan
konsten	aworan	Nan
konstantinopel	konstantinopel	Nan
konsensus	isokan	Nan
konsert	ere orin	Nan
konserten	ere orin	Nan
konserter	awọn ere orin	Nan
konserterna	awọn ere orin	Nan
konserthus	gbọngan gbọngàn	Nan
konservatism	konsafetifu	Nan
konservatismen	konsafetifu	Nan
konservativ	akiyesi	Nan
konservativa	konsafetifu	Nan
konsolen	ami akọmọ	Nan
konspirationsteorier	iditẹ	Nan
konst	aworan	Nan
konstant	loorekoore	Nan
konstantin	konstantin	Nan
konstaterade	ri	Nan
kraftigare	okun sii	Nan
kraftigt	tọkantọkan	Nan
kraftverk	ile ise ipese ina eletiriki	Nan
kungar	awọn ọba	Nan
kungariket	ijọba	Nan
kungarna	awọn ọba	Nan
kungen	ọba	Nan
kungens	ọba	Nan
kunglig	ọba	Nan
kungamakten	ade	Nan
kungliga	ọba	Nan
kunnat	le	None
kunskap	imo	Nan
kunskapen	imo	Nan
kunskaper	imo	Nan
kupol	éù	Nan
kupp	iyipo	Nan
kunna	ni anfani lati	Nan
kungahuset	ọba	Nan
kungafamiljen	idile ọba	Nan
kung	ọba	Nan
kubanska	kuba	Nan
kubas	kuba	Nan
kuben	kuubu	Nan
kuiperbältet	kuiper igbanu	Nan
kulmen	ipari	Nan
kulminerade	parí	Nan
kultur	aṣa	Nan
kulturarv	ogún	Nan
kulturell	aṣa	Nan
kulturella	aṣa	Nan
kulturellt	aṣa	Nan
kulturen	aṣa	Nan
kulturer	awọn asa	Nan
kunde	le	None
kunder	awon onibara	Nan
kurder	awọn kurdi	Nan
kurderna	awọn kurdi	Nan
kurdisk	kuridi	Nan
kurdiska	kuridi	Nan
kvarteret	dina	Nan
kvartsfinalen	mẹẹdogun-ipari	Nan
kvarvarande	ku	None
kvast	igbomikana	Nan
kvicksilver	quicksilver	Nan
kvinna	obinrin	Nan
kvinnan	obinrin naa	Nan
kvinnans	obinrin	Nan
kvinnlig	obinrin	Nan
kvinnliga	obinrin	Nan
kvinnor	obinrin	Nan
kvinnorna	obinrin	Nan
kvinnornas	obinrin	Nan
kvinnors	obinrin	Nan
kväll	irọlẹ	Nan
kvarter	dina	Nan
kuba	kuba	Nan
kvarstår	ku	None
kvar	osi	Nan
kurdistan	kurdistan	Nan
kurfursten	oludibo	Nan
kuriosa	awọn iwariiri	Nan
kurs	dajudaju	Nan
kurt	kurt	Nan
kusin	ọmọ	None
kust	etikun	Nan
kusten	etikun	Nan
kuster	àgbegbe	Nan
kusterna	àgbegbe	Nan
kustlinje	eti okun	Nan
kuwait	kuwait	Nan
kvadratkilometer	onigun mẹrin	Nan
kvalificerade	iyege	Nan
kvalitet	didara	Nan
kvarstod	ku	None
kommunistisk	ọmọ	None
kub	kuubu	Nan
krönika	akọọlẹ	Nan
kriser	rogbodiyan	None
kristen	kristiẹni	Nan
kristendom	kristiẹniti	Nan
kristendomen	kristiẹni	Nan
kristendomens	kristiẹni	Nan
kristi	kristi	Nan
krisen	rogbodiyan	None
kristian	kristian	Nan
kristinas	kristina	Nan
kristna	awọn kristiani	Nan
kristus	kristi	Nan
krita	chalk	Nan
kriterier	awọn ibeere	Nan
kriterierna	awọn ibeere	Nan
kristiansson	kristiansson	Nan
kris	rogbodiyan	None
kring	yika	Nan
kriminella	ọdaràn	Nan
krav	ibeere	Nan
kraven	nperare	Nan
kravet	beere	Nan
kreativitet	àtinúdá	Nan
krets	circuit	Nan
kretsar	awọn iyika	Nan
kretsen	circuit	Nan
krig	ogun	None
krigare	jagunjagun	Nan
krigen	ogun	None
kriget	ogun	None
krigets	ogun	None
krigsmakt	ologun	Nan
krigsmakten	ogun	None
krigsslutet	ogun	None
kritik	ibaniwi	Nan
kritiken	ibaniwi	Nan
kritiker	alariwisi	Nan
kritikerna	alariwisi	Nan
kronprins	olori ade	Nan
kronprinsen	ade prince	Nan
kronprinsessan	ade princess	Nan
kropp	ara	Nan
kroppar	awọn ara	Nan
kroppen	ara	Nan
kroppens	ara	Nan
krossa	fifun pa	Nan
kryddor	turari	Nan
kräva	nilo	Nan
krävde	beere	Nan
krävdes	ni won beere	Nan
kräver	nilo	Nan
krävs	beere	Nan
krävt	beere	Nan
kronor	wo	Nan
kröntes	ti ade	Nan
kroniska	onibaje	Nan
kronan	ade	Nan
kritiserade	ti ṣofintoto	Nan
kritiserades	ti ṣofintoto	Nan
kritiserar	ṣofintoto	Nan
kritiserat	ti ṣofintoto	Nan
kritiserats	ti ṣofintoto	Nan
kritisk	lominu	Nan
kritiska	lominu	Nan
kritiskt	lominu	Nan
kroatien	kroatia	Nan
kroatiens	croatiani	Nan
kroatiska	croatiani	Nan
kromosom	ajakalẹ	Nan
kromosomer	awọn ajakalẹmu	Nan
kromosomerna	awọn ajakalẹmu	Nan
krona	ade	Nan
kronisk	onibaje	Nan
fängelse	ẹwọn	Nan
inledningen	ifihan	Nan
inleder	berè	Nan
georgier	georgian	Nan
ger	fun	None
germanska	jẹmánì	Nan
ges	fifun	Nan
gestalt	eeya	Nan
gestalter	isiro	Nan
georgien	georgia	None
gett	fifun	Nan
gia	gia	Nan
gick	lọ	Nan
gift	iyawo	None
gifta	iyawo	None
gifte	iyawo	None
gifter	majele	Nan
ghana	gánà	Nan
georges	georges	Nan
george	george	Nan
georg	georgian	Nan
genomsnittlig	aropin	Nan
genomsnittliga	aropin	Nan
genre	oriṣi	Nan
genren	oriṣi	Nan
genrer	awọn ẹya	Nan
gentemot	lodi si	Nan
genus	akọ	Nan
geografi	ilẹ	None
geografisk	àgbègbè	Nan
geografiska	àgbègbè	Nan
geografiskt	àgbègbè	Nan
geologi	ilẹ	None
geologiska	ilẹ	None
geologiskt	ẹkọ nipa ilẹ-aye	Nan
geomorfologi	geomorphology	Nan
giftermål	igbeyawo	None
genomsnittet	aropin	Nan
giftsnokar	elapidae	Nan
gillade	feran	Nan
gjorts	ti a ṣe	Nan
glad	dun	None
glada	dun	None
glas	gilasi	Nan
glenn	glenn	Nan
global	kariaye	Nan
gjort	ṣe	Nan
globala	kariaye	Nan
globe	globe	Nan
globen	lobe	Nan
gloria	halo	Nan
glukos	glukosi	Nan
glädje	ayọ	Nan
glödlampor	isusu	Nan
globalt	kariaye	Nan
gjordes	wà	Nan
gjorde	ṣe	Nan
gjorda	ṣe	Nan
gillar	fẹran	Nan
giovanni	giovanni	Nan
girl	ọmọbinrin	Nan
girls	awon odomobirin	Nan
gisslan	agbalejo	Nan
gitarr	gita	Nan
gitarrist	olorin	Nan
gitarristen	olorin	Nan
givaren	sensọ	Nan
given	fifun	Nan
givet	fifun	Nan
givetvis	dajudaju	Nan
givit	fifun	Nan
givits	fifun	Nan
gjord	ṣe	Nan
gigantiska	omiran	Nan
genomsnitt	aropin	Nan
genomslag	ikolu	Nan
genomgått	koja	Nan
gas	gaasi	Nan
gasen	gaasi	Nan
gata	opopona	Nan
gatan	opopona	Nan
gates	awọn ẹnubode	Nan
gator	ita	Nan
gary	gary	Nan
gatorna	ita	Nan
gavs	fun	None
gaza	gasa	Nan
gazaremsan	gasa rinhoho	Nan
ge	fifun	Nan
gemensam	wọpọ	Nan
gemensamma	wọpọ	Nan
gav	fún	Nan
garvey	garvey	Nan
garanterar	awọn iṣeduro	Nan
garantera	rii daju	Nan
galax	galaxy	Nan
galaxer	àyọyọ	Nan
galilei	galilei	Nan
galileo	galileo	Nan
gallagher	gallagher	Nan
galleri	àwòrán àwòrán	Nan
gallien	gaul	Nan
gamla	atijọ	Nan
gamle	atijọ	Nan
gammal	atijọ	Nan
gammalt	atijọ	Nan
gandalf	gandalf	Nan
gandhi	gandhi	Nan
gandhis	gandhi	Nan
ganska	oyimbo	Nan
gemensamt	wọpọ	Nan
gemenskap	agbegbe	Nan
gemenskapen	agbegbe	Nan
gemenskaperna	awọn agbegbe	Nan
genom	nipasẹ	Nan
genombrott	itusilẹ	Nan
genombrottet	itusilẹ	Nan
genomför	gbe	None
genomföra	se	Nan
genomföras	ošišẹ	Nan
genomförde	ošišẹ	Nan
genomfördes	ti a ṣe	Nan
genomförs	ošišẹ	Nan
genomfört	pari	Nan
genomförts	jade	Nan
genomgick	lọ	Nan
genomgripande	gidi	Nan
genomgående	nipasẹ	Nan
genomgår	faragba	Nan
genetiskt	jiini	Nan
go	lọ	Nan
genetiska	jiini	Nan
genetik	jiini	Nan
gen	gene	Nan
genast	lẹsẹkẹsẹ	Nan
genen	ẹbun	Nan
gener	jiini	Nan
general	gbogbogbo	None
generalen	gbogboogbo	Nan
generalguvernören	gbogbogbo	None
generalsekreterare	gbogbogbo	None
generation	iran	Nan
generationen	iran	Nan
generationer	iran	Nan
generell	gbogboogbo	Nan
generella	gbogboogbo	Nan
generellt	gbogbogbo	None
generna	jiini	Nan
genetisk	jiini	Nan
gaga	gaga	Nan
god	o dara	Nan
godkände	ti a fọwọsi	Nan
gränsen	to	None
gränser	awọn ifilelẹ lọ	Nan
gränserna	ààlà	Nan
gräs	koriko	Nan
gräslök	chive	Nan
grå	grẹy	Nan
gränsar	ààlà	Nan
grön	ewe	None
grönland	gẹẹsi	Nan
grönsaker	ẹfọ	Nan
grönt	ewe	None
grönwall	grönwall	Nan
guatemala	guatemala	Nan
gud	ọlọrun	Nan
gröna	ewe	None
gräns	to	None
gruppspelet	egbe	None
grupperna	awọn ẹgbẹ	Nan
grundat	ipilẹ	Nan
grunden	ipilẹ	Nan
grunder	awọn ipilẹ	Nan
grundlag	t’olofin	Nan
grundlagen	ofin	None
grundläggande	ipilẹ	Nan
grundskolan	kekere	None
grundämne	ano	Nan
grundämnen	awọn eroja	Nan
grundämnet	ipilẹṣẹ	Nan
grupp	ẹgbẹ	Nan
gruppen	ẹgbẹ	Nan
gruppens	ẹgbẹ	Nan
grupper	awọn ẹgbẹ	Nan
grupperingar	awọn ẹgbẹ	Nan
gudar	oriṣa	Nan
grundas	orisun	None
gudarna	oriṣa	Nan
guden	ọlọrun	Nan
gustav	gustav	Nan
gustavs	gustav	Nan
guvernör	gomina	None
guyana	guyana	Nan
gyllene	ti goolu	Nan
gymnasiet	ile-iwe giga	Nan
gustafsson	gustafsson	Nan
gymnasium	ibi idaraya	Nan
gällande	lọwọlọwọ	Nan
gällde	gbẹyin	Nan
gäller	kan	None
gäng	egbe	None
gänget	egbe	None
gärna	fi	None
gälla	wulo	Nan
gustafs	gustaf	Nan
gustaf	gustaf	Nan
gunwer	ìbọn	Nan
gudinnan	oriṣa	Nan
gudom	ibere	Nan
gudomlig	ibawi	Nan
gudomliga	ibawi	Nan
guds	ọlọrun	Nan
guevara	guevara	Nan
guide	itọsọna	Nan
guillou	guillou	Nan
guinea	guinea	None
gul	odo	Nan
gula	odo	Nan
guld	wúrà	Nan
guldbollen	bọọlu goolu	Nan
gunnar	gunnar	Nan
guns	ibon	Nan
gudarnas	oriṣa	Nan
grundarna	awọn oludasilẹ	Nan
grundaren	oludasile	Nan
grundare	oludasile	Nan
grace	oore	Nan
grad	ìyí	Nan
graden	ìyí	Nan
grader	iwọn	Nan
gradvis	di .di.	Nan
grafit	ayaworan	Nan
gott	o dara	Nan
graham	graham	Nan
grammis	giramu	Nan
grammy	arẹmọ	Nan
gran	firí	Nan
grand	agba	None
grande	giga	Nan
grannar	aladugbo	Nan
grammatik	èdè grámà	Nan
gotlands	gotland	Nan
gotland	gotland	Nan
gotiska	gotik	Nan
godkändes	ti a fọwọsi	Nan
godkänna	fi	None
godkännande	ifọwọsi	Nan
godkännas	ti a fọwọsi	Nan
godkänt	ti a fọwọsi	Nan
gods	ẹru	Nan
goebbels	awọn goebbels	Nan
gogh	gogh	Nan
golf	gọọfu	Nan
golvet	ilẹ	None
gom	aafin	Nan
google	google	Nan
gorbatjov	gorbatjov	Nan
gordon	gordon	Nan
got	got	Nan
granne	aládùúgbò	Nan
grannlandet	adugbo	Nan
grannländer	awọn orilẹ-ede aladugbo	Nan
grannländerna	aladugbo	Nan
grenar	awọn ẹka	Nan
grenen	ẹka	Nan
greps	mu	Nan
greve	ka	Nan
griffin	griffin	Nan
griffon	griffon	Nan
grovt	ti o ni inira	Nan
grund	ipilẹ	Nan
grunda	mimọ	Nan
grundad	orisun	None
grundade	ipilẹ	Nan
grundades	ipilẹ	Nan
grundande	ipilẹṣẹ	Nan
grundandet	ipilẹṣẹ	Nan
grundar	ri	Nan
gren	ẹka	Nan
goda	o dara	Nan
greklands	griki	Nan
grekiskans	griki	Nan
granska	atunyẹwo	Nan
granskning	àyẹ̀wò	Nan
grant	fifun	Nan
gratis	ọfẹ	Nan
grav	sàréè	Nan
graven	sàréè	Nan
gravid	loyun	Nan
graviditet	oyun	Nan
graviditeten	oyun	Nan
gravitation	walẹ	Nan
gray	grey	Nan
greker	awọn hellene	Nan
grekerna	awọn hellene	Nan
grekisk	griki	Nan
grekiska	griki	Nan
grekland	griki	Nan
gabriel	gébúrẹ́lì	Nan
führer	onina	Nan
fötts	bi	Nan
fördomar	stereotypes	Nan
fördrag	adehun	Nan
fördragen	awọn adehun	Nan
fördraget	adehun	Nan
fördrevs	tii jade	Nan
före	ṣaaju	Nan
fördes	gbe	None
förebild	awokose	Nan
föredrar	fẹran	Nan
föredrog	fẹran	Nan
förefaller	han	Nan
föregående	ti tẹlẹ	Nan
föregångare	ṣaaju	Nan
föregångaren	ṣaaju	Nan
förebyggande	idena	Nan
fördelningen	pinpin	Nan
fördelning	pinpin	Nan
fördelen	anfani	Nan
förbud	idinamọ	Nan
förbudet	idinamọ	Nan
förbund	majẹmu	Nan
förbundet	ẹgbẹ	Nan
förbundskapten	olukọ	Nan
förbundsrepubliken	federal republic	Nan
förbundsstat	federated	Nan
förbättra	imudarasi	Nan
förbättrade	imudarasi	Nan
förbättringar	ilọsiwaju	Nan
förde	mu	Nan
fördel	anfani	Nan
fördelade	pin	Nan
fördelar	awọn anfani	Nan
fördelas	pin	Nan
förekom	ṣẹlẹ	Nan
förbränning	ijona	Nan
förekomma	waye	Nan
förekommer	lọwọlọwọ	Nan
förespråkare	onigbawi	Nan
föreställa	fojuinu	Nan
föreställande	alaworan	Nan
föreställer	aṣoju	Nan
föreställning	ṣafihan	Nan
föreställningar	awọn iṣe	Nan
förespråkar	onigbawi	Nan
föreställningen	ṣafihan	Nan
företagen	awọn ile-iṣẹ	Nan
företaget	bayi	None
företagets	ile-iṣẹ	Nan
företeelse	lasan	Nan
företeelser	iyalẹnu	Nan
företrädare	awọn aṣoju	Nan
företag	iṣowo	Nan
förespråkade	gbajumọ	Nan
föreslår	o tanmo	Nan
föreslogs	dabaa	Nan
förekommit	ṣẹlẹ	Nan
förekomst	niwaju	None
förekomsten	niwaju	None
föreligger	wa	Nan
föremål	koko	Nan
förena	laja	Nan
förenade	darapọ	Nan
förening	ẹgbẹ	Nan
föreningar	awọn iṣiro	Nan
föreningen	ẹgbẹ	Nan
förenklat	irọrun	Nan
förenta	orilẹ amẹrika	Nan
föreslagit	dabaa	Nan
föreslagits	daba	Nan
föreslog	daba	Nan
förekommande	waye	Nan
förblir	ku	None
förblev	ṣẹku	Nan
förbjöds	gbesele	Nan
fågelhundar	ajá ẹyẹ	Nan
fåglar	àwọn ẹyẹ	Nan
fåglarna	awọn ẹiyẹ	Nan
fåglarnas	àwọn ẹyẹ	Nan
fånga	yẹ	Nan
fångar	awọn ẹlẹwọn	Nan
fågelarter	eya	None
fångenskap	igbekun	Nan
fåtal	diẹ	Nan
fått	gba	None
föda	oúnjẹ	None
född	bi	Nan
födda	bi	Nan
födde	bi	Nan
får	le	None
fågel	eye	Nan
fåfotingar	pauropoda	Nan
få	gba	None
fängelset	ẹwọn	Nan
fängslade	ẹwọn	Nan
fängslades	ẹwọn	Nan
färdas	irin-ajo	Nan
färdig	ti pari	Nan
färdiga	gangan	Nan
färg	awọ	Nan
färgade	awọ	Nan
färgen	awọ	Nan
färger	awọn awọ	Nan
färgerna	awọn awọ	Nan
färre	diẹ	Nan
färöarna	faroe	Nan
fäste	asomọ	Nan
fästning	odi	Nan
föddes	bi	Nan
födelse	ibi	Nan
födelsedag	ojo	None
födelsetal	ibi	Nan
för	fun	None
föra	mu	Nan
föranledde	atunse	None
föras	jẹ	Nan
förband	wíwọ	Nan
förbi	ti o ti kọja	Nan
förbindelse	ìbáṣepọ	Nan
förbindelser	ẹbí	Nan
förbinder	sisopọ	Nan
förbjuda	leewọ	Nan
förbjuden	leewọ	Nan
förbjuder	leewọ	Nan
förbjudet	gbesele	Nan
förbjudna	ewọ	Nan
förbjöd	gbesele	Nan
fönster	ferese	Nan
företräder	aṣoju	Nan
föll	ṣubu	Nan
följs	tẹle	Nan
föder	awọn iṣọn	Nan
föds	bi	Nan
födseln	ibi	Nan
föga	diẹ	Nan
följa	tẹle	Nan
följaktligen	nitorina	Nan
följande	atẹle	Nan
följas	tẹle	Nan
följd	ọkọọkan	Nan
följde	tẹle	Nan
följden	ọkọọkan	Nan
följder	ikolu	Nan
följdes	tẹle	Nan
följer	telẹ	Nan
följeslagare	ẹlẹgbẹ	Nan
följt	tẹle	Nan
författare	onkọwe	Nan
författaren	onkọwe	Nan
författarna	onkọwe	Nan
försvarsmakten	olugbeja	Nan
försvarsminister	aabo	Nan
försvinna	farasin	Nan
försvinner	farasin	Nan
försvunnit	sọnu	Nan
försäkra	rii daju	Nan
försvarsmakt	ologun	Nan
försäljning	tita	Nan
försämrades	idinku	Nan
försök	igbiyanju	Nan
försöka	gbidanwo	Nan
försöken	awọn adanwo	Nan
försöker	ngbiyanju	Nan
försökt	gbiyanju	Nan
försäljningen	awọn tita	Nan
försvarets	olugbeja	Nan
försvaret	olugbeja	Nan
försvarare	olugbeja	Nan
förstnämnda	akoko	Nan
förstod	loye	Nan
förstärka	teramo	Nan
förstå	loye	Nan
förståelse	oye	Nan
förståelsen	oye	Nan
förstår	loye	Nan
förstås	dajudaju	Nan
förstöra	run	Nan
förstördes	parun	Nan
förstörelse	iparun	Nan
försvann	parẹ	Nan
försvar	olugbeja	Nan
försvara	gbeja	Nan
försvarade	gbeja	Nan
försökte	gbiyanju	Nan
försörja	atilẹyin	Nan
försörjde	atilẹyin	Nan
försörjning	ipese	Nan
föräldrar	awọn obi	Nan
föräldrarna	awọn obi	Nan
förälskad	ni ife	Nan
förändra	yipada	None
förändrade	yipada	None
förändrades	yipada	None
förändras	yipada	None
förändrats	yipada	None
förändring	yipada	None
förändringar	awọn ayipada	Nan
förändringarna	awọn ayipada	Nan
förändringen	yipada	None
förödande	iparun	Nan
fötter	ẹsẹ	None
fötterna	ẹsẹ	None
förväxlas	dapo	Nan
förste	akoko	Nan
förväxla	adaru	Nan
förväntas	o ti ṣe yẹ	Nan
fört	pre	Nan
förteckning	atokọ	Nan
förtjust	ifẹ	Nan
förtroende	gbekele	Nan
förtryck	inilara	Nan
förts	gbe	None
förut	ṣaaju	Nan
förutom	ayafi	Nan
förutsätter	nilo	Nan
förutsättning	pese	Nan
förutsättningar	ipo	None
förutsättningarna	ipo	None
förvaltning	iṣakoso	Nan
förvaras	ti o fipamọ	Nan
förväntade	o ti ṣe yẹ	Nan
förväntningar	awọn ireti	Nan
gärning	iṣe	Nan
förstaplatsen	aaye akọkọ	Nan
först	akoko	Nan
förhållandevis	jo	None
förhåller	ibatan	Nan
förhöjd	igbega	Nan
förintelsen	iparun	Nan
förklara	ṣàlàyé	Nan
förklarade	se alaye	Nan
förhållandet	ipin	None
förklarades	ṣalaye	Nan
förklarat	se alaye	Nan
förklaring	alaye	Nan
förklaringar	awọn alaye	Nan
förklaringen	alaye	Nan
förknippad	nkan	None
förknippade	nkan	None
förklaras	se alaye	Nan
förhållandena	ipo	None
förhållanden	ipo	None
förhållande	ibatan	Nan
författarskap	onkọwe	Nan
författning	t’olofin	Nan
författningen	ofin	None
förfäder	awọn baba	Nan
förföljelse	inunibini	Nan
förföljelser	inunibini	Nan
förgäves	lasan	Nan
förhandla	duna	Nan
förhandlingar	idunadura	Nan
förhandlingarna	idunadura	Nan
förhindra	ṣe idiwọ	Nan
förhindrar	ṣe idiwọ	Nan
förhistoria	prehistory	Nan
förhistorisk	prehistoric	Nan
förhärskande	bori	Nan
förknippas	nkan	None
förkortas	kikuru	Nan
förkortat	agekuru	Nan
förkortning	kikuru	Nan
förmågor	ipa	Nan
förmån	anfani	Nan
förmögenhet	ọrọ	Nan
förnuft	ori	None
förnuftet	ori	None
förorter	ìgberiko	Nan
förr	ṣaaju	Nan
förra	kẹhin	Nan
förrän	ṣaaju	Nan
förs	jade	Nan
församling	apejọ	Nan
församlingar	awọn apejọ	Nan
församlingen	apejọ	Nan
förslag	awọn aba	Nan
förslaget	igbero	Nan
förmågan	agbara	None
första	akoko	Nan
förmåga	agbara	None
förmedla	onilaja	Nan
förkortningar	awọn abbre	Nan
förlag	awọn olutẹjade	Nan
förlaget	atejade	Nan
förlopp	dajudaju	Nan
förlora	padanu	Nan
förlorade	sọnu	Nan
förlorades	sọnu	Nan
förlorar	ipadanu	Nan
förlorat	sọnu	Nan
förlust	ipadanu	Nan
förlusten	ipadanu	Nan
förluster	ipadanu	Nan
förlusterna	adanu	Nan
förlängning	itẹsiwaju	Nan
förlängningen	itẹsiwaju	Nan
förmodligen	boya	Nan
inledning	ifihan	Nan
gärningar	ṣiṣẹ	Nan
gäst	àlejò	Nan
hårt	lile	Nan
höftledsgrop	acetabulum	Nan
hög	ga	Nan
höga	ga	Nan
höger	ọtun	Nan
högkvarter	olú	Nan
håret	irun	Nan
höglandet	awọn ilu giga	Nan
högre	ga	Nan
högskola	kọlẹji	Nan
högskolan	imọ	Nan
högskolor	awọn ile-iwe giga	Nan
högst	ga julọ	Nan
högsta	ga julọ	Nan
högra	ni ọtun	Nan
hårdvara	ohun elo	Nan
hårdrocken	apata lile	Nan
hårdrock	irin	Nan
hål	iho	Nan
hålet	iho	Nan
håll	dimu	Nan
hålla	tọju	Nan
hållas	jẹ	Nan
håller	dani	None
hållet	itọsọna	Nan
hållit	dúró	None
hållning	iduro	Nan
hålls	waye	Nan
hår	irun	Nan
hård	lile	Nan
hårda	lile	Nan
hårdare	gba	None
hårdast	nira julọ	Nan
högste	olórí	Nan
håkansson	håkansson	Nan
högt	ga	Nan
högtider	awọn isinmi	Nan
iberiska	ara ilu iberian	Nan
ibland	nigbami	Nan
ibm	ibm	Nan
ibn	abinibi	Nan
ibrahimović	ibrahimović	Nan
icd	icd	Nan
ian	àwọn n	Nan
icke	kii ṣe	Nan
idag	loni	Nan
ideal	bojumu	Nan
identifiera	ṣe idanimọ	Nan
identifierade	ṣe idanimọ	Nan
identisk	aami	Nan
identitet	idanimọ	Nan
ida	ida	Nan
i	ninu	Nan
hösten	ewe	None
höst	ṣubu	Nan
högtryck	ga titẹ	Nan
höja	gbe	None
höjd	gíga	Nan
höjder	giga	Nan
höjdes	pọ si	Nan
höjdpunkt	tente oke	Nan
höjer	posi	Nan
höll	ṣe adani	Nan
hölls	wà	Nan
hör	gbọ	Nan
höra	gbọ	Nan
hörde	gbo	Nan
hörn	igun	Nan
hörs	ti gbọ	Nan
hört	gbo	Nan
högtid	àse	Nan
håkan	håkan	Nan
hävdat	tẹriba	Nan
hävdar	nipe	Nan
huvudstaden	olú ìlú	Nan
huvudstäder	olú	Nan
huvudvärk	orififo	Nan
huxley	huxley	Nan
hyllade	bu	None
hyllning	oriyin	Nan
huvudstad	olu	Nan
hypotes	idawọle	Nan
hypoteser	awọn idawọle	Nan
hyser	abo	None
häcklöpning	àṣekára	Nan
hälft	idaji	None
hälften	idaji	None
hällristning	kekere	None
hypotesen	idawọle	Nan
huvudsakligen	o kun	Nan
huvudsakliga	akọkọ	Nan
huvudsak	idaran	Nan
husen	awọn ile	Nan
huset	ilé	None
hushåll	ìdílé	Nan
huskvarna	huskvarna	Nan
hussein	hussein	Nan
hustru	iyawo	None
hustrun	iyawo	None
huvud	ori	None
huvudartikel	nkan	None
huvuddelen	olopobobo naa	Nan
huvudet	ori	None
huvudkontor	ile olori ise patapata	Nan
huvudort	olu	Nan
huvudperson	oseere pataki	Nan
huvudrollen	kikopa	Nan
hälsa	ilera	Nan
hämnd	ẹsan	Nan
hämta	gba	None
hämtade	gbaa lati ayelujara	Nan
här	nibi	Nan
härifrån	lati ibi	Nan
härkomst	oti	Nan
härledas	ti ari	Nan
härrör	ti ari	Nan
härskare	adarí	Nan
härstamma	pilẹṣẹ	Nan
härstammar	ti ari	Nan
härstamning	ìlà	None
häst	.r.	Nan
hästar	ẹṣin	Nan
hästen	ẹṣin	Nan
hästens	ẹṣin	Nan
hävda	beere	Nan
hävdade	jiyan	Nan
hänvisning	itọkasi	Nan
ideologi	arojinle	Nan
hänvisar	tọka	Nan
hänvisa	tọka	Nan
hämtar	awọn igbapada	Nan
hämtat	gba	None
hända	ṣẹlẹ	Nan
hände	ṣẹlẹ	Nan
händelse	ìṣẹlẹ	Nan
händelsehorisonten	ipade ọna	Nan
händelsen	ìṣẹlẹ	Nan
händelser	iṣẹlẹ	Nan
händelserna	iṣẹlẹ	Nan
händer	ṣẹlẹ	Nan
händerna	ọwọ	Nan
hänga	idorikodo	Nan
hänger	apo	Nan
hänsyn	ọwọ	Nan
hänt	ṣẹlẹ	Nan
hänvisade	tọka	Nan
hus	ile	Nan
ideologier	arojinle	Nan
ideologiska	arojinle	Nan
influerad	nfa	Nan
influerat	nfa	Nan
inflytande	ipa	Nan
inflytandet	ipa	Nan
inflytelserika	gbajugbaja	Nan
information	alaye	Nan
influenser	ipa	Nan
informationen	alaye	Nan
infrastrukturen	amayederun	Nan
infödda	abinibi	Nan
inför	niwaju	None
införa	ṣafihan	Nan
införande	ifihan	Nan
införandet	ifihan	Nan
infrastruktur	amayederun	Nan
influensavirus	aarun ayọkẹlẹ aarun ayọkẹlẹ	Nan
influensan	aisan	Nan
influensa	aarun ayọkẹlẹ	Nan
indonesiska	indonesian	Nan
industri	ile ise	Nan
industrialiserade	ti iṣelọpọ	Nan
industrialisering	ile-iṣẹ	Nan
industrialiseringen	ile-iṣẹ	Nan
industriell	ile ise	Nan
industriella	ile ise	Nan
industriellt	ile ise	Nan
industrier	awọn ile-iṣẹ	Nan
industrin	ile ise	Nan
infaller	iṣẹlẹ	Nan
infektion	akoran	Nan
infektioner	awọn àkóràn	Nan
inflation	afikun	Nan
inflationen	afikun	Nan
införde	ṣafihan	Nan
indonesien	indonesia	Nan
infördes	ṣafihan	Nan
införts	ṣafihan	Nan
inkluderade	to	None
inkluderar	pẹlu	Nan
inkluderas	to	None
inkluderat	pẹlu	Nan
inklusive	pẹlu	Nan
inkomst	owo oya	Nan
initiativ	ipilẹṣẹ	Nan
inkomster	owo oya	Nan
inkomstkälla	orisun	None
inlandet	ìgbín	Nan
inleda	pilẹṣẹ	Nan
inledande	ni ibẹrẹ	Nan
inledde	ipilẹṣẹ	Nan
inleddes	ipilẹṣẹ	Nan
inkomsterna	owo-wiwọle	Nan
inhemska	abinibi	Nan
inhemsk	t’ile	Nan
ingått	pari	Nan
inga	rárá	Nan
ingen	rara	Nan
ingenjör	ẹnjinia	Nan
ingenting	ohunkohun	Nan
inget	ohunkohun	Nan
ingick	apakan	Nan
ingmar	ingmar	Nan
ingredienser	eroja	Nan
ingrid	ingrid	Nan
ingripa	laja	Nan
ingripande	ilowosi	Nan
ingvar	ingvar	Nan
ingå	apakan	Nan
ingående	igbewọle	Nan
ingår	to	None
infört	ṣafihan	Nan
indoeuropeiska	indo	Nan
individuella	ẹnikọọkan	Nan
individerna	olúkúlùkù	Nan
ihåg	ranti	Nan
iii	iii	Nan
iiis	iiis	Nan
iis	iis	Nan
ikea	ikea	Nan
ikon	aami	Nan
ihop	papọ	Nan
illa	koṣe	Nan
illegala	arufin	Nan
illinois	illinois	Nan
illuminati	itanna	Nan
ilska	ibinu	Nan
image	aworan	Nan
imf	imf	Nan
illegal	arufin	Nan
igång	bẹrẹ	Nan
igenom	nipasẹ	Nan
igen	lẹẹkansi	Nan
ideologiskt	arojinle	Nan
idol	oriṣa	Nan
idrott	eré ìdárayá	Nan
idéer	awọn imọran	Nan
idén	imọran	Nan
ifall	ti o ba ti	Nan
ifk	ifk	Nan
ifråga	ni ibeere	Nan
ifrågasatt	laya	Nan
ifrågasatts	laya	Nan
ifrån	lati	Nan
igelkott	hedgehog	Nan
igelkottar	awọn hedgehogs	Nan
igelkotten	hedgehog	Nan
igelkottens	hedgehog	Nan
immigranter	aṣikiri	Nan
immunförsvar	ma ajesara	Nan
imperiet	ottoman	Nan
imperium	ottoman	Nan
indianer	ilu abinibi	Nan
indianerna	ara ilu inde	Nan
indianska	ara ilu indiani	Nan
indien	india	Nan
indiens	india	Nan
indier	ara ilu indiani	Nan
indierna	ara ilu inde	Nan
indikerar	tọka	Nan
indirekt	aiṣetaara	Nan
indisk	ara ilu indiani	Nan
indiska	ara ilu indiani	Nan
individ	ẹnikọọkan	Nan
individen	ẹnikọọkan	Nan
individens	ẹnikọọkan	Nan
individer	olúkúlùkù	Nan
indiana	indiana	Nan
ideologin	arojinle	Nan
indian	ara ilu indiani	Nan
independence	ominira	Nan
import	gbewọle	Nan
in	ninu	Nan
inblandad	lowo	Nan
inblandade	lowo	Nan
inblandning	ilowosi	Nan
inbördes	pelu ara	Nan
inbördeskrig	ogun	None
inbördeskriget	ogun	None
indelad	pin	Nan
indelade	pin	Nan
indelas	pin	Nan
indelat	pin	Nan
indelning	pipin	Nan
indelningar	ipin	None
indelningen	pipin	Nan
index	atọka	Nan
huruvida	boya	Nan
hur	bawo	Nan
hunnit	ni akoko	Nan
hat	ikorira	Nan
hatar	korira	Nan
hav	okun	Nan
have	ni	Nan
haven	ẹ	Nan
havet	okun	Nan
hastigt	yára	None
havets	okun	Nan
havskattfiskar	anarhichadidae	Nan
havsnivån	omi	None
hawaii	hawaii	None
hawking	yinyin	Nan
hc	hc	Nan
hdmi	hdmi	Nan
havs	omi	None
hastighet	iyara	Nan
hasch	haṣish	Nan
harry	harry	Nan
handlingen	iṣe	Nan
hanen	akọ	Nan
hanhon	arabinrin na	Nan
hann	le	None
hannah	hannah	Nan
hannar	ọkunrin	Nan
hans	tirẹ	Nan
hansson	hansson	Nan
hantera	ṣakoso	Nan
hantverk	ọnà	Nan
hantverkare	oniṣọnà	Nan
har	ní	None
harald	harald	Nan
harris	harris	Nan
harrison	harrison	Nan
he	o.	Nan
handlingar	awọn iṣẹ	Nan
heart	obi	Nan
heaven	ọrun	Nan
hellström	apaadi	Nan
helsingborg	helsingborg	Nan
helsingborgs	helsingborg	Nan
helsingfors	helsinki	Nan
helsingör	elsinore	Nan
helst	pelu	Nan
hells	apaadi	Nan
helt	patapata	Nan
hem	ile	Nan
hemingway	hemingway	Nan
hemland	ile-ile	Nan
hemlandet	ile-ile	Nan
hemlig	aṣiri	Nan
hemliga	aṣiri	Nan
helvetet	apaadi	Nan
hellre	dipo	Nan
heller	boya	Nan
hell	apaadi	Nan
hebreiska	heberu	Nan
hedersdoktor	dokita olola	Nan
hegel	hegel	Nan
heinrich	heinrich	None
heinz	heinz	Nan
hel	gbogbo	Nan
hela	gbogbo	Nan
helena	helena	Nan
helgdagar	awọn isinmi	Nan
helhet	gbogbo	Nan
helig	mimọ	Nan
heliga	mimọ	Nan
helige	mimọ	Nan
heligt	mimọ	Nan
helium	irinse	Nan
heath	athgún	Nan
handling	ìṣe	Nan
handlar	ibaṣowo	Nan
handlande	iṣe	Nan
göta	göta	Nan
götaland	götaland	Nan
göteborg	gothenburg	Nan
göteborgs	gothenburg	Nan
h	wakati	Nan
ha	ni	Nan
gösta	gösta	Nan
haag	awọn hague	Nan
haddock	haddock	Nan
hade	ní	None
haft	ní	None
haile	haile	Nan
haiti	haiti	None
hall	gbongan	Nan
haber	egbe	None
görs	jẹ	Nan
göring	asomọ	Nan
göras	ṣe	Nan
gäster	awon alejo	Nan
gävle	gävle	Nan
gå	lọ	Nan
gång	rìn	None
gången	aago	Nan
gånger	awọn akoko	Nan
gångna	ti o ti kọja	Nan
går	lọ	Nan
gård	àgbàlá	Nan
gården	oko	None
gått	lọ	Nan
gåva	fifẹ	Nan
gör	ki	None
göra	ṣe	Nan
göran	göran	Nan
halland	halland	Nan
halloween	halima	Nan
hallucinationer	awọn ariyanjiyan	Nan
halmstad	halmstad	Nan
hamnat	de ọdọ	Nan
hamnen	ibudo	Nan
hampa	hemp	Nan
han	oun	None
hanar	ọkunrin	Nan
hand	ọwọ	Nan
handboll	bọọlu	Nan
handel	isowo	Nan
handeln	isowo	Nan
handels	isowo	Nan
handelsmän	oniṣòwo	Nan
handelspartner	alabaṣiṣẹpọ iṣowo	Nan
handen	ọwọ	Nan
handla	iṣe	Nan
handlade	wà	Nan
hamnar	omi	None
hemlighet	aṣiri	Nan
hamnade	pari	Nan
hamn	ibudo	Nan
halmstads	halmstad	Nan
hals	ọfun	Nan
halsen	ọfun	Nan
halt	tẹẹrẹ	Nan
halv	idaji	None
halva	idaji	None
halvan	idaji	None
halvklotet	itatẹtẹ	Nan
halvt	idaji	None
halvön	ile larubawa	Nan
hamas	hamas	Nan
hamburg	hamburg	Nan
hamilton	hamilton	Nan
hamlet	hamlet	Nan
hammarby	hammarby	Nan
hamna	ipari	Nan
hemligt	aṣiri	Nan
hemma	ile	Nan
hemmaarena	ile arena	Nan
holm	holm	Nan
homo	jọpọ	Nan
homogen	isokan	Nan
homosexualitet	ilopọ	Nan
homosexuell	fohun	Nan
homosexuella	fohun	Nan
holländska	dutch	Nan
hon	obinrin na	Nan
honom	rẹ	None
honor	obinrin	Nan
hopp	ireti	Nan
hoppa	fo	Nan
hoppade	fo	Nan
hoppades	nireti	Nan
honan	obinrin	Nan
hollywood	agekuru	Nan
holland	gẹẹsi	Nan
hockey	ẹlẹsẹ	Nan
hiv	hiv	Nan
hjalmar	hjalmar	Nan
hjälp	egba	None
hjälpa	egba	None
hjälper	egba	None
hjälpmedel	iranlowo	Nan
hjälpt	iranwo	Nan
hjälpte	iranwo	Nan
hjärna	ọpọlọ	Nan
hjärnan	ọpọlọ	Nan
hjärnans	ọpọlọ	Nan
hjärta	obi	Nan
hjärtat	obi	Nan
hms	hms	Nan
ho	ho	Nan
hoppas	ireti	Nan
hormoner	homonu	Nan
horn	iwo	Nan
hos	ni	Nan
human	ènìyàn	Nan
humanism	ẹda eniyan	Nan
humanismen	ẹda eniyan	Nan
humanistiska	olukọ	Nan
humle	hop	Nan
humor	yẹyẹ	Nan
humör	yẹyẹ	Nan
hund	aja	Nan
hundar	ajá	Nan
hunden	ajá	Nan
hundra	ọgọrun	Nan
hundraser	awọn ajọbi	Nan
hundratal	ọgọrun	Nan
hundratals	ọgọọgọrun	Nan
hundratusentals	ọgọọgọrun ẹgbẹrun	Nan
hugo	hugo	Nan
hittills	titi di akoko yi	Nan
hughes	hughes	Nan
huden	awọ	Nan
hotad	idẹruba	Nan
hotade	idẹruba	Nan
hotar	irokeke	Nan
hotel	hotẹẹli	Nan
hotell	hotẹẹli	Nan
hotellet	hotẹẹli	Nan
hotet	irokeke	Nan
house	ilé	None
houston	houston	Nan
hov	kootu	Nan
hovet	kootu	Nan
hovrätten	ẹbẹbẹ	Nan
how	bawo	Nan
howard	howard	Nan
hud	awọ	Nan
hudfärg	awọ	Nan
gärningsmannen	ẹlẹṣẹ	Nan
hittats	ri	Nan
hittas	wa ni ri	Nan
herrar	okunrin	None
herre	oluwa	Nan
herren	oluwa	Nan
herrens	oluwa	Nan
herrlandskamper	ọgbẹni mr	Nan
herrlandslag	ẹgbẹ bọọlu	Nan
herr	ogbeni	Nan
hertig	duke	Nan
heta	gbona	Nan
heter	ti a pe	Nan
hett	gbona	Nan
hette	ti a npè ni	Nan
hexadecimalt	hexadecimal	Nan
heydrich	heydrich	Nan
het	gbona	Nan
heroin	akọni obinrin	Nan
hermann	hermann	Nan
herman	herman	Nan
hemmaplan	ile	Nan
hemmet	ile	Nan
hemsida	aaye ayelujara	Nan
hendrix	hendrix	Nan
henne	rẹ	None
hennes	rẹ	None
henri	henri	Nan
henrik	henrik	Nan
henriks	henriks	Nan
henry	henry	Nan
hepatit	jedojedo	Nan
herbert	herbert	Nan
hercegovina	herzegovina	Nan
hergé	hergé	Nan
heritage	ajogunba	Nan
high	giga	Nan
himlakroppar	ti ọrun	Nan
himlen	ọrun	Nan
himmel	ọrun	Nan
historik	itan	Nan
historiker	akẹkọ itan-akọọlẹ	Nan
historikern	akẹkọ itan-akọọlẹ	Nan
historisk	itan	Nan
historiska	itan	Nan
historiskt	itan	Nan
history	itan-akọọlẹ	Nan
hit	nibi	Nan
hitler	kọlu	Nan
hitlers	hitila	Nan
hits	deba	Nan
hitta	wa	Nan
hittade	ri	Nan
hittades	ri	Nan
hittar	wa	Nan
historier	awọn itan	Nan
hittat	ri	Nan
historiens	itan	Nan
historia	itan	Nan
himmler	himmler	Nan
himmlers	himmler	Nan
hinder	idiwọ	Nan
hindra	ṣe idiwọ	Nan
hindrade	idilọwọ	Nan
hindrar	ṣe idiwọ	Nan
hindu	arakunrin hinia	Nan
hinduer	arakunrin hinia	Nan
hinduiska	arakunrin hinia	Nan
hinduism	hinduism	Nan
hinduismen	arakunrin hinia	Nan
hinner	ni akoko lati	Nan
hiroshima	hiroshima	Nan
his	tirẹ	Nan
hisingen	hisingen	Nan
historien	itan	Nan
övrigt	omiiran	Nan
