ab	ab	None
pund	rodol	Nan
punk	punk	Nan
punkt	barta	None
punkten	barta	None
punkter	dhibco	Nan
purple	guduud	None
puls	wadnaha	None
pythagoras	pythagoras	Nan
pär	kuusha	Nan
på	dul	None
påbörjade	bilaabay	None
påbörjades	bilaabay	None
påbörjas	bilaw	Nan
påföljande	xiga	None
päls	fur	Nan
puerto	puerto	Nan
pucken	ah	None
publik	dhagaystayaasha	Nan
psykologin	cilmu-nafsiga	Nan
psykologisk	cilmi	None
psykologiska	cilmi	None
psykos	maskaxda	None
psykosen	maskaxda	None
psykoser	psychoses	Nan
psykoterapi	teraabiyada cilminafsiga	Nan
psykotiska	cilmi	None
publicera	daabac	Nan
publicerad	la	None
publicerade	la	None
publicerades	la	None
publiceras	la	None
publicerat	la	None
publiceringen	daabacaadda	Nan
pågick	tegey	None
psykologi	cilmu-nafsiga	Nan
pågående	socda	None
påminde	xasuusiyay	Nan
påverkat	saameeyay	Nan
påverkats	saameeyay	Nan
påvisa	tusid	Nan
q	q	Nan
queen	boqorad	None
queens	boqorada	Nan
påverkas	saameeyay	Nan
rachel	raaxeel	Nan
rad	saf	Nan
radie	radius	None
radikala	ah	None
radikalt	xagjirnimo	Nan
radio	raadiyaha	Nan
radioaktiva	shucaac	Nan
rachels	raaxeel	Nan
påverkar	saameyn	Nan
påverkan	saamaynta	None
påverkades	saameeyay	Nan
påminner	xusuusinayaa	Nan
påsk	ciida	None
påsken	ciida	None
påstod	sheegatay	Nan
påstådda	eedeeyay	None
påstående	bayaan	Nan
påståenden	sheegashada	Nan
påstår	gobolada	None
påstås	eedeeyay	None
påtagligt	muuqata	None
påtryckningar	cadaadis	None
påven	baadari	Nan
påverka	saameyn	Nan
påverkad	saameeyay	Nan
påverkade	saameeyay	Nan
pågår	socda	None
psykiskt	ahaan	None
psykiska	maskaxda	None
psykisk	cilmi	None
produceras	saaray	None
producerat	saaray	None
producerats	saaray	None
produkt	sheyga	Nan
produkten	sheyga	Nan
produkter	waxyaabaha	None
producerar	soo	None
produktion	saar	None
produktiv	leh	None
professionell	leh	None
professionella	leh	None
professor	borofisar	Nan
professorn	borofisar	Nan
profet	nabiga	None
produktionen	saar	None
producerades	saaray	None
producerade	saaray	None
producerad	saaray	None
privata	gaar	None
privatliv	asturnaanta	Nan
privilegier	mudnaanta	Nan
privilegium	mudnaan	Nan
problem	dhibaato	None
problemen	dhibaatooyinka	None
problemet	dhibaatada	None
procent	boqolkiiba	None
process	habka	None
processen	habka	None
processer	socodka	None
producent	soo	None
producenten	soo	None
producenter	soo	None
producera	saar	None
profeten	nabiga	None
profeter	nebi	None
profil	guud	None
programledare	marti-qaade	Nan
protoner	protons	Nan
prov	tusaalaha	Nan
provins	gobol	None
provinsen	gobol	None
provinser	gobolada	None
provinserna	gobolada	None
provisoriska	ah	None
prägel	taabasho	Nan
präglad	lagu	None
präglade	lagu	None
präglades	lagu	None
präglas	lagu	None
präglats	lagu	None
präster	wadaad	None
ps	ps	Nan
protokoll	hab	None
radioaktivt	shucaac	Nan
protesterna	mudaaharaadyo	Nan
protester	mudaaharaadyo	Nan
programmet	barnaamijka	None
programvara	software	None
projekt	mashruuc	None
projektet	mashruuc	None
prokaryoter	prokaryotes	Nan
promemoria	xusuus	None
propaganda	dacaayad	Nan
proportioner	saamiga	Nan
prosa	maahmaah	Nan
protein	borotiin	Nan
proteiner	borotiinada	Nan
proteinerna	borotiinada	Nan
proteinet	borotiin	Nan
protestanter	mudaaharaadayaasha	Nan
protestantiska	protestant	Nan
protesterade	mudaaharaaday	Nan
privat	gaar	None
radion	raadiyaha	Nan
ragnar	ragnar	Nan
reglerna	xeerarka	None
regn	roob	None
regnar	roob	None
regnskog	roob-roobaadka	Nan
reguljära	ah	None
reidar	reidar	Nan
regleras	la	None
reidars	hagayaasha	Nan
reklam	xayeysiinta	Nan
reklamen	xayeysiis	Nan
rekord	duub	None
rekordet	duub	None
relaterade	xiriira	None
relation	xiriirka	None
reinfeldt	reinfeldt	Nan
reglerar	nidaamiyaa	Nan
reglera	nidaaminta	Nan
regler	xeerarka	None
regi	diiwaangelinta	Nan
regim	taliska	None
regimen	taliska	None
regimer	nidaamyada	Nan
region	gobolka	None
regional	goboleed	None
regionala	goboleed	None
regionalt	goboleed	None
regionen	gobolka	None
regioner	gobollada	None
regionerna	gobollada	None
regisserad	toosiyay	Nan
regissör	agaasime	None
regissören	agaasime	None
registrerade	duubay	None
relationen	xiriirka	None
reggaen	reggae	Nan
relationer	cilaaqaadyada	Nan
relativa	qaraabo	Nan
reportrar	wariyaasha	Nan
representant	wakiil	None
representanter	wakiilo	Nan
representanthuset	wakiilo	Nan
representation	metelaad	Nan
representativ	wakiil	None
reologi	cilmu-nafsiga	Nan
representera	matalo	Nan
representerar	matalaya	Nan
representeras	matalay	Nan
reptiler	xamaarato	Nan
republik	jamhuuriyada	None
republika	republika	Nan
republikanska	jamhuuriga	Nan
representerade	matalay	Nan
rené	rené	Nan
renässansen	renaissance	Nan
renässans	renaissance	Nan
relativt	ahaan	None
releasedatum	daayay	None
religion	diinta	None
religionen	diinta	None
religionens	diinta	None
religioner	diimaha	None
religionerna	diimaha	None
religionsfrihet	diinta	None
religiös	diinta	None
religiösa	diinta	None
religiöst	diinta	None
remmer	xusuusin	Nan
ren	ah	None
rena	ah	None
rent	daahir	None
relationerna	xiriirka	None
reggae	reggae	Nan
regeringstid	boqornimada	None
regeringsmakten	dowladda	None
rasade	dumay	None
rasen	nooc	None
raser	jinsi	Nan
rasism	cunsuriyadda	Nan
rastafari	rastafari	Nan
rastafarianer	rastafarianer	Nan
ras	tartan	Nan
rastafarianerna	waa	None
reagans	reagan	Nan
reagera	falcelin	Nan
reagerar	falcelin	Nan
reaktion	falcelin	Nan
reaktionen	falcelin	Nan
reaktioner	ficil	None
reagan	reagan	Nan
rapporterar	warbixinno	Nan
rapporterade	sheegay	None
rapporter	warbixinno	Nan
raid	raid	Nan
rainbow	qaansoroobaad	Nan
rak	toosan	None
raka	toosan	None
rakt	toosan	None
ramadan	ramadaan	None
ramel	jir	None
ramels	faraha	None
ramen	qaab	None
rammstein	rammstein	Nan
rankas	darajooyin	Nan
rankning	darajo	None
rankningar	darajooyin	Nan
rapport	warbixin	None
rapporten	warbixin	None
reaktionerna	ficil	None
reaktorer	reactors	Nan
reaktorn	firfircoonaan	Nan
realiteten	togan	Nan
reformer	u	None
regel	sharci	None
regelbunden	ah	None
regelbundet	ah	None
regelbundna	ah	None
regeln	sharci	None
regent	regent	Nan
regenter	tusale	Nan
regerade	xukumaa	Nan
regerande	xukuma	Nan
regering	dowladda	None
regeringar	dawladaha	None
regeringen	dowlada	None
regeringens	dowlada	None
regeringschef	dowlada	None
reformationen	dib-u-habeyn	Nan
rafael	rafael	Nan
reform	u	None
referenser	tixraacyada	None
rebecca	rebecca	Nan
recensioner	faallooyinka	Nan
receptorer	soo-dhoweeyeyaasha	Nan
red	ed	Nan
reda	hel	Nan
redaktör	tifaftire	Nan
redan	durba	None
rede	buul	Nan
rederiet	shixil	Nan
redo	diyaar	None
redovisas	sheegay	None
redskap	qalabka	None
reducera	yareyn	Nan
reduktion	yareyn	Nan
referens	tixraac	None
refererar	jeedaa	None
pristagare	laureate	Nan
prisma	xabis	Nan
priset	qiimo	None
personerna	dadka	None
personlig	shaqsiyeed	Nan
personliga	shaqsiyeed	Nan
personligen	shaqsiyan	Nan
personlighet	shaqsiyan	Nan
personlighetsstörning	shaqsiyan	Nan
personer	dadka	None
personlighetsstörningar	cilladaha shakhsiyadeed	Nan
persons	qof	None
perspektiv	aragtida	None
persson	persson	Nan
peru	peru	None
peruanska	booska	Nan
pest	cayayaan	Nan
personligt	shaqsiyan	Nan
personens	qof	None
personen	qof	None
personalen	shaqaalaha	None
perioden	mudada	None
perioder	muddooyin	Nan
periodiska	xilliyeed	Nan
periodvis	mar	None
permanent	ah	None
permanenta	ah	None
pernilla	pernilla	Nan
perro	perro	Nan
perry	perry	Nan
persbrandt	persbrandt	Nan
perserna	faaris	Nan
persien	faaris	Nan
persiska	faaris	Nan
person	qof	None
personal	shaqaalaha	None
pesten	daacuun	Nan
period	muddo	None
peter	butros	Nan
petersburg	petersburg	Nan
pilatus	bilaatos	Nan
pink	casaan	Nan
pippi	shimbiraha	None
pippin	pippin	Nan
pirate	burcad badeed	Nan
piratpartiet	piratpartiet	Nan
pierre	deked	Nan
pitt	sicir	Nan
pjäsen	gabal	Nan
pjäser	khiyaamo	None
place	goobta	None
placera	meel	None
placerad	meeleeyay	Nan
placerade	meeleeyay	Nan
pjäs	ciyaar	None
picture	sawir	None
picchu	picchu	Nan
picasso	picasso	Nan
petra	petra	Nan
petroleum	batroolka	None
petrus	butros	Nan
petter	petter	Nan
pettersson	pettersson	Nan
pga	sabab	None
ph	ph	Nan
phil	phil	Nan
philadelphia	philadelphia	Nan
philip	filibos	Nan
philips	foosto	Nan
phoebe	phoebe	Nan
phoenix	phoenix	Nan
pi	pi	Nan
piano	biyaano	Nan
peters	peters	Nan
performance	waxqabadka	Nan
perfekt	ah	None
per	per	Nan
parlamentsvalet	baarlamaanka	None
parten	xisbi	None
parter	xafladaha	Nan
parterna	xisbiyada	None
parti	xaflad	Nan
partido	partidos	Nan
parlamentets	baarlamaanka	None
partier	qaybo	None
partiet	xaflad	Nan
partiets	xisbi	None
partiklar	qurub	Nan
partiledare	xisbiga	None
partner	lammaane	Nan
partnern	lammaane	Nan
partierna	qaybo	None
parlamentet	guri	None
parlamenten	baarlamaannada	Nan
parlamentariska	baarlamaan	None
pappa	aabe	None
papper	warqad	None
par	lammaane	Nan
paradiset	janno	None
paraguay	paraguay	Nan
parallella	ah	None
parallellt	ah	None
parentes	xaashiyaha	Nan
paret	lammaane	Nan
paris	paris	None
park	baarkin	Nan
parken	baarkin	Nan
parker	jardiinooyinka	Nan
parlament	baarlamaanka	None
parlamentarisk	baarlamaanka	None
pass	gudub	Nan
passa	habboon	None
passade	bilaash	Nan
passagerare	rakaab	Nan
paz	paz	Nan
pc	pc	Nan
peang	xoojin	Nan
pearl	luul	Nan
peka	barta	None
pekar	barta	None
pekat	tilmaamay	None
peking	pekin	Nan
pelle	pellets	Nan
pendeltåg	gude	Nan
pengar	lacag	None
pengarna	lacagta	None
penis	guska	Nan
pennsylvania	pennsalinta	Nan
people	dadka	None
paus	joogso	Nan
placerades	meeleeyay	Nan
paulus	bawlos	Nan
paul	bawlos	Nan
passagerarna	rakaabka	Nan
passande	habboon	None
passar	habboon	None
passera	gudub	Nan
passerade	gudbay	None
passerar	gudub	Nan
passiv	ah	None
pastor	wadaad	None
pastoral	dhaqato	None
patent	patent	Nan
patienten	bukaan	Nan
patienter	bukaanka	Nan
patrick	patrick	Nan
patrik	patrik	Nan
patterson	patterson	Nan
paulo	paulo	Nan
placerar	dhigista	Nan
placeras	meeleeyay	Nan
placering	maalgashi	Nan
poster	waxyaabaha	None
postumt	dib	None
potatis	baradhada	Nan
potential	suurtagal	Nan
potentiellt	suurtagal	Nan
potter	dhoobo	None
posten	boostada	Nan
povel	muusig	None
prag	prague	Nan
praktiken	dhaqan	None
praktisk	ah	None
praktiska	ah	None
praktiskt	ahaan	None
prata	hadal	None
poäng	barta	None
post	boostada	Nan
positivt	si	None
positiva	togan	Nan
populäraste	dhow	None
populärkultur	ah	None
populärkulturen	ah	None
populärmusik	ah	None
populärt	ah	None
port	dekeda	None
porto	boostada	Nan
porträtt	sawir	None
portugal	boortaqiiska	Nan
portugals	boodhadhka	Nan
portugisiska	boortaqiiska	Nan
position	booska	Nan
positionen	booska	Nan
positioner	jagooyinka	Nan
positiv	togan	Nan
pratar	hadalka	None
praxis	dhaqan	None
precis	kaliya	None
premier	lacagta	None
preussen	prussia	Nan
preventivmedel	ka	None
primitiva	hore	None
primtal	wasaare	None
primära	ah	None
prince	amiir	None
princip	mabda &#39;	Nan
principen	mabda &#39;	Nan
principer	mabaadi&#39;da	Nan
prins	amiir	None
prinsen	amiir	None
prinsessan	princess	Nan
pris	marin	None
priser	qiimaha	None
priserna	qiimaha	None
prestigefyllda	leh	None
populära	ah	None
pressen	riix	Nan
press	riix	Nan
premiär	bilowga	Nan
premiären	bilowga	Nan
premiärminister	wasaare	None
premiärministern	wasaare	None
preparat	diyaarinta	Nan
presenterade	bandhigay	None
presenterades	bandhigay	None
presenterar	hadiyado	Nan
presenteras	bandhigay	None
president	madaxweynaha	None
presidenten	madaxweynaha	None
presidentens	madaxweynaha	None
presidenter	madaxweynayaasha	Nan
presidentvalet	madaxweynaha	None
presley	presley	Nan
pressas	isku	None
republiken	jamhuuriyadda	None
populär	ah	None
populationen	dadka	None
platons	plato	Nan
plats	meel	None
platsen	meel	None
platser	meelaha	None
platt	fidsan	None
platta	saxanka	Nan
platon	plato	Nan
plattan	saxanka	Nan
platån	plateau	Nan
player	ciyaaryahan	Nan
playstation	cayaaraha	None
plikt	waajib	None
plikter	waajibaadka	Nan
plocka	qaado	None
plattform	madal	Nan
platina	platinum	Nan
plasma	plasma	Nan
planeternas	meerayaasha	Nan
plan	qorshe	None
planen	garoonka	None
planer	qorshayaasha	Nan
planerad	qorsheeyay	Nan
planerade	qorsheeyay	Nan
planerar	qorshayaasha	Nan
planeras	qorsheeyay	Nan
planerat	qorsheeyay	Nan
planering	qorshaynta	Nan
planerna	qorshayaasha	Nan
planet	meeraha	Nan
planeten	meeraha	Nan
planetens	meeraha	Nan
planeter	meerayaasha	Nan
planeterna	meerayaasha	Nan
plural	jamac	None
plus	daro	None
pluto	pluto	Nan
plötsligt	ah	None
politik	siyaasad	None
politiken	siyaasad	None
politiker	siyaasi	None
politisk	siyaasadeed	None
politiska	siyaasadeed	None
politiskt	ahaan	None
polska	polish	Nan
pommern	pommern	Nan
pompejus	pompey	Nan
ponny	pony	Nan
pontus	barkad	Nan
pop	boos	Nan
popsångare	heesaha	None
popularitet	caan	None
population	dadka	None
poliser	booliska	None
populationer	dadka	None
polisens	booliska	None
polis	booliska	None
poe	poe	Nan
poes	poe	Nan
poesi	gabay	None
poet	gabay	None
poeten	gabayaa	Nan
poeter	gabayaaga	Nan
point	barta	None
pojkar	wiilasha	None
pojkarna	wiilasha	None
pojke	wiil	None
pojkvän	saaxiib	None
polacker	doomaha	Nan
polen	booland	Nan
polens	xarig	Nan
policy	siyaasada	None
polisen	booliska	None
panthera	panthera	Nan
republikens	jamhuuriyadda	None
resa	safar	None
senaste	dambeeyay	None
senaten	guurtida	None
senator	senator	None
sent	daahay	None
sentida	dhawaan	None
separat	ah	None
senast	dambeeya	None
separata	ah	None
september	sebtember	Nan
ser	muuqaal	Nan
serber	serb	Nan
serbien	serbia	None
serbiens	serbia	None
serbisk	serbian	Nan
separerade	kala	None
senare	dambe	None
sena	daahay	None
sen	daahay	None
sekel	qarnigii	None
sekelskiftet	qarnigii	None
sekreterare	xoghayaha	None
sekt	dariiqo	Nan
sekter	kooxo	None
sektion	qaybta	None
sektorn	waaxda	None
sekulär	ah	None
sekulära	ah	None
sekunder	ilbidhiqsiyo	Nan
sekvens	isku	None
selassie	selassie	Nan
selma	selma	Nan
semifinal	semi-finalka	Nan
semifinalen	semi-final	Nan
serbiska	serb	Nan
segrar	guuleysto	None
serie	taxanaha	Nan
seriens	taxanaha	Nan
shakespeares	shakespeare	Nan
sharia	shareecada	None
sheen	sheen	Nan
sibirien	siberiya	Nan
sicilien	xun	None
sida	bogga	None
shakespeare	shakespeare	Nan
sidan	bogga	None
sidor	dhinacyada	None
sidorna	dhinacyada	None
sierra	siraa	Nan
siffra	jaantus	Nan
siffran	jaantus	Nan
siffror	tirooyinka	Nan
side	dhinac	None
shahen	shah	Nan
sfären	sphere	Nan
sexuellt	galmada	Nan
serier	taxanaha	Nan
serotonin	serotonin	Nan
serveras	u	None
service	adeeg	None
servrar	server	Nan
ses	noqon	None
seth	seth	Nan
sett	arkay	None
setts	arkay	None
sevärdheter	tago	None
sex	lix	None
sexton	toban	None
sexualitet	galmada	Nan
sexuell	galmo	Nan
sexuella	galmo	Nan
serien	taxanaha	Nan
seglade	safray	None
segern	guuleysto	None
seger	guuleysto	None
sandy	ah	None
sankt	st	None
sankta	qoduus	Nan
sann	rasmi	None
sanna	run	None
sanning	run	None
sand	ciid	None
sanningen	run	None
sannolikt	tahay	None
sanskrit	sanskrit	Nan
sant	run	None
santa	santa	Nan
santiago	santiago	Nan
sapiens	sapiens	Nan
sannolikhet	itimaalka	Nan
san	san	None
samväldet	dhexe	None
samverkar	co	Nan
sammanhängande	isku	None
sammanlagt	wadarta	None
sammansatt	kooban	None
sammansatta	kooban	None
sammansättning	halabuurka	Nan
samoa	samoa	Nan
samspel	dhexgalka	Nan
samt	iyo	None
samtal	wac	Nan
samtida	ah	None
samtidigt	mar	None
samtliga	kasta	None
samtycke	ogolaansho	Nan
samuel	samuu&#39;eel	Nan
samverkan	iskaashi	None
sara	sara	Nan
sarah	saarah	Nan
sarajevo	sarajevo	Nan
satan	ibliis	Nan
schweiziska	swiss	Nan
science	khayaali	Nan
scientologikyrkan	cilmiga	None
scott	scott	Nan
screen	la	None
se	arag	None
sean	sean	Nan
sebastian	sebastian	Nan
sed	caado	None
sedan	markaa	None
sedd	arkay	None
seden	caado	None
seder	xigay	None
sedermera	xigay	None
sedlar	biilasha	Nan
schweiz	switzerland	None
siffrorna	tirooyinka	Nan
schwarzenegger	schwarzenegger	Nan
schack	chess	Nan
satanism	shaydaan	None
sats	jumlada	Nan
satsa	maal	None
satsade	sharad	Nan
satsningar	sharad	Nan
satt	fadhiistay	None
satte	fadhiistay	None
sattes	daray	None
saturnus	saturnus	Nan
saudiarabien	carabiya	None
sauron	sauron	Nan
sawyer	sawir	None
scen	goobta	None
scenen	marxalad	None
scener	muuqaallo	Nan
schizofreni	shisoofrani	Nan
sammanhanget	guud	None
sig	ku	None
signaler	calaamadaha	Nan
skalv	gariir	Nan
skalvet	gariir	Nan
skandinavien	scandinavia	Nan
skandinaviska	scandinavian	Nan
skapa	abuuraan	Nan
skapad	abuuray	None
skall	doonaan	None
skapade	abuuray	None
skapande	leh	None
skapandet	abuurista	Nan
skapar	abuuraa	None
skapare	abuuraha	Nan
skapas	abuuraa	None
skapat	naqshadeeyay	Nan
skapades	abuuray	None
skalet	qolof	Nan
skalan	cabir	None
skala	cabir	None
sk	sk	Nan
ska	in	None
skabb	isnadaamiska	Nan
skada	dhaawac	None
skadad	gaadhay	None
skadade	gaadhay	None
skadades	dhaawacmay	None
skadan	dhaawac	None
skadas	gaadhay	None
skadliga	tirtiray	Nan
skador	dhaawac	None
skadorna	dhaawac	None
skaffa	hel	Nan
skaffade	lasiiyay	Nan
skal	qolof	Nan
skapats	abuuray	None
sjöss	badda	None
skapelse	abuurista	Nan
skarp	fiiqan	Nan
skiftande	beddelaya	Nan
skikt	lakab	Nan
skilda	duwan	None
skilde	furay	None
skildes	kala	None
skildrar	muuqaal	Nan
skicklig	leh	None
skildras	sawiray	None
skilja	kala	None
skiljas	kala	None
skiljer	duwan	None
skiljs	kala	None
skillnad	kala	None
skillnaden	kala	None
skildringar	sawirrada	Nan
skickas	diray	None
skickar	diraa	None
skickades	diray	None
skarsgård	skarsgård	Nan
skatt	cashuurta	Nan
skatter	cashuuraha	Nan
ske	dhici	None
skedde	ahaa	None
skede	marxaladda	Nan
skelett	lafaha	None
skepp	doon	None
skeppen	maraakiibta	None
skeppet	markab	None
sker	sameeyay	None
skett	dhacay	None
skick	xaalad	Nan
skicka	dir	None
skickade	diray	None
skara	badan	None
sjönk	dhacay	None
sjöng	gabyaa	None
sjön	haro	Nan
sir	sir	None
sist	dambeeya	None
sista	dambeeya	None
siste	dambeeya	None
sistnämnda	dambeeya	None
site	goobta	None
sinne	maanka	None
sitt	uu	None
sittande	fadhiya	None
sitter	fadhiyey	None
situation	xaalad	Nan
situationen	xaalad	Nan
situationer	xaaladaha	None
siv	siv	Nan
sitta	fadhiiso	Nan
singlarna	kalgacal	Nan
singlar	kali	None
singer	fanaan	None
signifikant	ah	None
sikt	muddo	None
silver	lacag	None
simmons	simmons	Nan
simning	dabaasha	Nan
simon	simoon	Nan
simpson	simpson	Nan
simpsons	simpsons	Nan
sin	ay	None
sina	iyaga	None
sinatra	sinatra	Nan
singapore	singapore	Nan
singapores	singapore	Nan
singel	hal	None
singeln	hal	None
sixx	lixx	Nan
sju	toddobo	None
sjuk	xanuunsan	None
sjuka	cudur	None
självstyrande	madaxbannaan	None
självstyre	madax-bannaanida	Nan
självständig	banaan	None
självständiga	banaan	None
självständighet	madax-bannaanida	Nan
självständigheten	madaxbanaanida	None
självständigt	madaxbanaan	None
självt	lafteeda	Nan
sjätte	lixaad	None
sjö	haro	Nan
sjöar	harooyinka	Nan
sjöarna	harooyinka	Nan
sjöfart	dhoofinta	Nan
sjöfarten	dhoofinta	Nan
sjögren	sjögren	Nan
självmord	is	None
sigmund	sigmund	Nan
självklart	dabcan	Nan
själva	naftooda	None
sjukdom	cudur	None
sjukdomar	cudurada	Nan
sjukhus	isbitaal	None
sjukhuset	isbitaal	None
sjukvård	caafimaadka	None
sjunde	toddobaad	Nan
sjunga	heesaa	None
sjunger	gabyaa	None
sjunka	waaskada	Nan
sjunkande	dhicid	Nan
sjunker	calan	None
sjunkit	sun	None
själ	nafta	None
själen	nafta	None
själv	naftaada	Nan
självbiografi	sheeko-barasho	Nan
sammanhang	guud	None
sammanfattning	soo	None
sammanfaller	isqaba	Nan
robin	robin	Nan
robinson	robinson	Nan
rockband	weyn	None
rocken	jaakad	Nan
rockgrupper	dhagaxa	None
rocksångare	weyn	None
roberts	roberts	Nan
rod	ul	None
roland	roland	Nan
roll	door	None
rollen	door	None
roller	raaxeeye	Nan
rollfigur	dabeecad	None
rollfigurer	jilayaasha	Nan
roger	roger	Nan
roberto	roberto	Nan
robert	robert	Nan
robbie	robbie	Nan
ringar	fardaha	None
ringde	yaqaan	None
ringen	garaac	Nan
rinner	qulqulka	Nan
ris	bariis	None
risk	khatar	None
risken	khatarta	Nan
risker	khataraha	Nan
riskerar	khatar	None
rita	sawir	None
ritualer	cibaado	None
rivalitet	xafiiltan	Nan
river	jeexdin	Nan
rna	rna	Nan
rob	dhac	None
rolling	duub	None
ringa	wacid	Nan
rom	gypsy	Nan
roman	sheeko	None
ron	kacay	None
ronaldinho	ronaldinho	Nan
ronaldo	ronaldo	Nan
ronden	wareega	None
ronja	ronja	Nan
roosevelt	roosevelt	Nan
romulus	romulus	Nan
rorsman	helmsman	Nan
rose	rose	Nan
rosenberg	rosenberg	Nan
rotation	wareejin	None
roterande	wareeraya	Nan
roterar	wareegaa	Nan
rousseau	rousseau	Nan
rosa	casaan	Nan
romska	romani	Nan
roms	roms	Nan
romerskkatolska	roman	None
romance	jacayl	None
romanen	sheeko	None
romaner	sheekooyin	Nan
romani	romani	Nan
romantiken	jacayl	None
romantikens	jacayl	None
romantiska	jacayl	None
romarna	roomaanka	None
romarriket	roomaanka	None
romeo	romeo	Nan
romer	dhadhan	Nan
romerna	roma	None
romersk	roman	None
romerska	roman	None
romerske	roman	None
roma	roma	None
ring	garaac	Nan
riktningen	jihada	Nan
riktningar	tilmaamaha	Nan
resultera	natiijo	Nan
resulterade	keentay	None
resulterar	natiijooyinka	Nan
resulterat	keentay	None
resurs	kheyraadka	None
resurser	kheyraadka	None
resultatet	natiijo	Nan
retorik	hadal	None
retoriska	erey	None
revir	dhul	None
revolution	kacaan	None
revolutionen	kacaan	None
revolutionens	kacaan	None
revolutionär	kacaan	None
retoriken	hadal	None
resultaten	natiijooyinka	Nan
resultat	natiijooyinka	Nan
resterande	haray	None
resan	safar	None
resande	socotada	None
research	baaris	None
reser	safarka	None
residensstad	degmo	None
resolution	qaraar	None
resor	safarada	Nan
respekt	ixtiraam	Nan
respektive	kala	None
rest	haray	None
restaurang	makhaayad	None
restauranger	maqaayadaha	Nan
reste	safray	None
resten	nasasho	Nan
rester	haraaga	Nan
revolutionära	kacaan	None
revs	dumay	None
reza	reza	Nan
rhen	rhine	Nan
riksförbundet	qaranka	None
rikskansler	chancellor	Nan
riksrådet	ah	None
riksväg	weyn	None
rikt	ah	None
riktad	toosiyay	Nan
riktade	toosiyay	Nan
riktar	bartilmaameed	Nan
riktas	toosiyay	Nan
riktat	toosiyay	Nan
riktig	rasmi	None
riktiga	ah	None
riktigt	runtii	None
riktlinjer	tilmaamaha	Nan
riktning	jihada	Nan
riksdagsvalet	baarlamaanka	None
rovdjur	ugaadhsade	Nan
riksdagens	baarlamaanka	None
riksdag	baarlamaanka	None
rice	bariis	None
richard	richard	None
richards	richards	Nan
richmond	richmond	Nan
rico	rico	Nan
riddare	mindiyo	Nan
rik	taajir	None
rika	ah	None
rikare	taajirsan	None
rikaste	taajirsan	None
rike	boqortooyada	None
rikedom	hanti	None
riken	boqortooyooyinka	Nan
riket	boqortooyada	None
rikets	reich	Nan
riksdagen	baarlamaanka	None
rowling	isku	None
roy	roy	Nan
rubiks	rubiks	Nan
sade	yiri,	Nan
sades	yidhi	None
saga	sheeko	None
sagan	sheeko	None
sagor	sheekooyinka	None
sagt	yidhi	None
saddam	saddam	Nan
sahara	sahara	Nan
saint	saint	None
sak	shay	None
saken	arrinta	Nan
saker	waxyaabaha	None
saknade	maqan	None
saknades	maqan	None
sahlin	sahlin	Nan
sachsen	saxony	Nan
sabbath	tigidhada	Nan
saab	saab	Nan
rörelsen	dhaqdhaqaaq	None
rörelsens	dhaqdhaqaaq	None
rörelser	dhaqdhaqaaqa	None
rörelserna	dhaqdhaqaaqyada	Nan
rörlighet	dhaqdhaqaaqa	None
röst	cod	None
rösta	codee	Nan
röstade	u	None
rösten	cod	None
röster	codad	Nan
rösterna	kabka	Nan
rösträtt	codee	Nan
rött	red	Nan
rötter	xididdada	Nan
sa	yidhi	None
saknar	la&#39;aan	Nan
saknas	maqan	None
sakrament	karaamada	Nan
sakta	ah	None
samhällets	bulshada	None
samisk	sami	Nan
samiska	sami	Nan
samla	ururin	Nan
samlade	ururiyey	Nan
samlades	ururay	Nan
samlag	isbahaysi	Nan
samlar	isu	None
samlat	ururiyey	Nan
samlats	ururiyey	Nan
samling	ururinta	Nan
samlingar	ururinta	Nan
samlingsalbum	isugeynta	Nan
samma	ah	None
samman	wadajir	None
samhället	bulshada	None
rörelse	dhaqdhaqaaq	None
samhällen	bulshooyinka	Nan
samfundet	bulshada	None
salt	cusbo	Nan
salvador	salvador	Nan
sam	co	Nan
samarbeta	iskaashi	None
samarbetade	iskaashi	None
samarbetar	iskaashi	None
samarbetat	iskaashi	None
samarbete	iskaashi	None
samarbeten	co	Nan
samarbetet	co	Nan
samband	isku	None
sambandet	isku	None
same	ah	None
samerna	ah	None
samfund	bulsho	None
samhälle	bulsho	None
republiker	jamhuuriyada	None
rörde	taabtay	Nan
röra	dhaqaaq	None
rwanda	rwanda	Nan
ryan	ryan	Nan
rybak	rybak	Nan
rygg	dib	None
ryggen	dib	None
rykte	sumcad	Nan
russell	ruqse	Nan
rykten	xanta	None
rymmer	qaban	None
rysk	ruush	None
ryska	ruush	None
ryssland	ruushka	None
rysslands	ruush	None
rytmiska	laxanka	Nan
rymden	booska	Nan
rush	deg deg	Nan
ruset	khamriga	Nan
runtom	hareeraha	None
rubrik	cinwaan	Nan
rudolf	rudolf	Nan
rugby	rugby	Nan
ruiner	burburka	None
rum	qol	Nan
rummet	qolka	Nan
rumänien	romania	None
rumänska	roomaania	Nan
run	orod	None
runda	wareega	None
running	ordaya	Nan
runor	runes	Nan
runorna	runes	Nan
runstenar	rune	Nan
runt	hareeraha	None
räcker	filan	None
räckte	dhiibay	None
rädd	cabsi	None
rädda	badbaadin	Nan
rådande	hadda	None
rådde	adkaaday	None
råder	waa	None
rådet	golaha	None
rådets	golaha	None
rådgivare	lataliye	Nan
rådhus	magaalada	None
råkar	dhaca	None
råolja	saliid	None
råvaror	caano	None
röd	red	Nan
röda	casaan	Nan
röka	qiiqa	Nan
rökning	sigaar cabista	Nan
rör	tuubbo	Nan
råd	talo	None
rörande	saabsan	None
rättvisa	cadaaladda	None
rättigheterna	xuquuqda	None
räddade	badbaadiyey	None
räddar	badbaadiyo	None
rädsla	cabsi	None
räkna	tirin	None
räknade	xisaabiyay	Nan
räknar	tirinta	Nan
räknas	xisaabiyay	Nan
räknat	xisaabiyay	Nan
rätt	midig	None
rätta	sax	None
rättegång	maxkamad	None
rättegången	maxkamad	None
rätten	sax	None
rätter	suxuunta	Nan
rättigheter	xuquuqda	None
rättsliga	ah	None
skillnader	kala	None
pamela	pamela	Nan
palme	palme	Nan
miguel	miguel	Nan
mikael	mikael	Nan
mike	moo	Nan
mil	mil	Nan
milan	milan	Nan
milano	milano	Nan
mig	aniga	None
mild	ah	None
mildare	jilicsan	None
miley	miley	Nan
militär	ciidan	None
militära	ciidan	None
militären	ciidan	None
militärer	adeegayaal	Nan
milda	ah	None
midsommar	midsummer	Nan
microsoft	microsoft	None
mick	mic	Nan
metod	habka	None
metoden	habka	None
metoder	hababka	None
metro	metro	Nan
mexico	meksiko	None
mexikanska	meksiko	None
mexiko	meksiko	None
meyer	meyer	Nan
mfl	al	None
miami	miami	Nan
michael	michael	Nan
michail	michail	Nan
michel	michel	Nan
michelle	michelle	Nan
michigan	michigan	Nan
militärt	ciidan	None
metionin	methionine	Nan
miljard	bilyan	Nan
miljon	milyan	None
miniatyr|px|en	en	None
miniatyr|px|ett	mid	None
minister	wasiir	None
ministerrådet	wasiiro	None
ministrar	wasiiro	None
minne	xusuusta	Nan
miniatyr|px|den	the	None
minnen	xasuus	None
minns	xusuusnow	Nan
minoritet	yahay	None
minoriteten	yahay	None
minoriteter	yahay	None
minoritetsspråk	yahay	None
minska	yareyn	Nan
minnet	xusuusta	Nan
miniatyr|karta	|	None
miniatyr|en	a	None
miniatyr|	|	None
miljoner	milyan	None
miljontals	malaayiin	Nan
miljö	deegaanka	None
miljöer	bay&#39;ada	Nan
miljön	deegaanka	None
miljöproblem	deegaanka	None
miller	miller	Nan
milt	jilicsan	None
min	aniga	None
mina	leh	None
mind	maskaxda	None
mindre	yar	None
mineral	macdanta	Nan
mineraler	macdanta	Nan
miniatyr	yar	None
miljarder	balaayiin	Nan
meter	mitir	Nan
metan	methane	Nan
metallica	metallica	Nan
medlemsstater	xubin	None
medlemsstaterna	xubin	None
medlemsstaternas	xubin	None
medverka	tabaruc	Nan
medverkade	xiddig	Nan
medverkan	kaqeybgal	Nan
medlemsstat	xubin	None
medverkar	leh	None
medvetande	miyir	Nan
medveten	soco	None
medvetet	leh	None
medvetna	miyir	Nan
mekaniska	yaqaan	None
mekka	mecca	Nan
medverkat	ka	None
medlemskap	xubinimada	Nan
medlemmarna	xubnaha	None
medlemmar	xubnaha	None
medför	ah	None
medföra	natiijo	Nan
medförde	keentay	None
medfört	keentay	None
media	warbaahinta	None
medicin	daawo	None
mediciner	daroogada	Nan
medicinering	daawo	None
medicinsk	caafimaad	None
medicinska	caafimaad	None
medicinskt	ahaan	None
medier	warbaahinta	None
mediet	ah	None
medina	madiina	None
medlem	xubin	None
melankoli	melancholy	Nan
melker	melker	Nan
mellan	dhexeeya	None
mellanfot	metatarsus	Nan
mera	inbadan	None
mercurys	meerkuriga	Nan
merkurius	meerkuriga	Nan
merparten	badan	None
merry	hambalyo	Nan
mesopotamien	mesopotamien	Nan
messi	messi	Nan
messias	masiixa	Nan
mest	badan	None
mesta	badan	None
mestadels	badan	None
metabolism	kiimikaad	None
metaforer	astaamaha	None
metall	bir	None
metaller	biraha	Nan
mer	inbadan	None
minskad	dhimay	Nan
mentala	maskaxda	None
meningar	weedho	Nan
mellankrigstiden	dhexdooda	None
mellanrum	farqiga	Nan
mellanöstern	bari	None
mellersta	dhexe	None
melodier	heeso	None
melodifestivalen	melodifestivalen	Nan
memoarer	xusuus-qor	Nan
memorial	xuska	None
men	laakiin	None
menade	jeedaa	None
menar	macnaheedu	None
menas	jeedaa	None
menat	jeedaa	None
mengele	mengele	Nan
mening	xukun	None
mental	maskaxda	None
medelålder	ahaan	None
minskade	dhacay	None
minskat	dhimay	Nan
motorvägarna	waaweyn	None
motorvägen	weyn	None
motsats	isbarbar dhig	Nan
motsatsen	soo	None
motsatt	soo	None
motsatta	soo	None
motorvägar	waaweyn	None
motsatte	diidnay	Nan
motståndare	horjeeda	None
motståndaren	kasoo	None
motståndarna	horjeeda	None
motståndet	iska	None
motståndsrörelsen	iska	None
motsvarande	u	None
motstånd	iska	None
motorväg	weyn	None
motors	motors	Nan
motor	matoor	Nan
mord	dil	None
morden	dil	None
mordet	dil	None
morgan	morgan	Nan
morgon	subax	None
morgonen	subax	None
morris	morris	Nan
moseboken	bilowgii	None
moses	muuse	None
moskva	moscow	Nan
mot	soo	None
motion	jimicsi	Nan
motiv	ujeeddooyin	Nan
motiveringen	sababaha	None
motivet	mawduuc	Nan
motsvarar	u	None
moraliskt	ahaan	None
motsvarighet	u	None
mottagande	qaata	None
munnen	afka	None
mur	darbiga	None
muren	darbiga	None
murray	murray	Nan
muse	madxaf	Nan
museer	madxafyada	Nan
mun	afka	None
museet	madxaf	Nan
music	muusig	None
musik	muusig	None
musikalen	muusig	None
musikalisk	muusig	None
musikaliska	muusig	None
musikaliskt	muusig	None
museum	madxaf	Nan
mullusfiskar	kalluun	None
muhammeds	maxamed	None
muhammed	muxammad	Nan
mottagare	qaataha	Nan
mottagaren	qaataha	Nan
mottagarens	qaataha	Nan
motto	ujeeddo	None
mottog	helay	None
motverka	ka	None
mountain	buurta	None
movie	filim	Nan
mozart	mozart	Nan
mozarts	mozart	Nan
moçambique	moçambique	Nan
mr	mudane	None
ms	m	None
mtv	mtv	Nan
muhammad	muxammad	Nan
motsättningar	geesinimo	None
moraliska	akhlaaqda	None
moralisk	akhlaaqda	None
moral	akhlaaqda	None
misstänkt	yahay	None
misstänkta	tuhmanayaal	Nan
mitt	aniga	None
mitten	dhexe	None
mix	isku	None
mjölk	caano	None
misstag	qalad	None
mm	mm	Nan
mod	dulqaad	None
mode	moodada	Nan
modell	moodel	Nan
modellen	moodel	Nan
modeller	moodooyinka	Nan
moder	hooyo	None
moberg	moberg	Nan
missnöjet	qancin	Nan
missnöje	qanacsanaanta	Nan
misslyckats	fashilmay	None
minskning	yareyn	Nan
minst	yaraan	None
minsta	yar	None
minut	daqiiqad	Nan
minuter	daqiiqado	Nan
miss	waayey	None
missbruk	xadgudubka	Nan
missförstånd	fahmid	Nan
misshandel	weerar	None
mission	howlgalka	Nan
missionärer	ergooyinka	Nan
misslyckade	fashilmay	None
misslyckades	fashilmay	None
misslyckande	fashil	Nan
misslyckas	fashil	Nan
moderata	ah	None
moderaterna	dhexdhexaadiya	Nan
modern	ah	None
moderna	ah	None
monica	monica	Nan
monicas	monica	Nan
monografi	hal-abuur	Nan
monopol	hal-adayg	Nan
monoteism	monotheism	Nan
monoteistiska	monotheistic	Nan
monroe	monroe	Nan
monster	daanyeer	Nan
montana	montana	Nan
monte	monte	Nan
montenegro	montenegro	None
monument	taallo	Nan
moore	moore	Nan
mor	hooyo	None
mora	mora	Nan
mongoliet	mongolia	Nan
minskar	yaraynaysa	Nan
monetära	lacag	None
monarki	boqortooyadii	None
modernare	badan	None
modernismen	casriga	None
modernistiska	casriye	Nan
modernt	ah	None
modersmål	hooyo	None
modet	geesinimo	None
modo	modo	Nan
mohammed	maxamed	None
moldavien	mooriya	Nan
molekyler	molecules	Nan
moln	daruur	Nan
mona	mona	Nan
monaco	monaco	Nan
monark	boqortooyada	None
monarken	boqortooyada	None
monarkin	boqortooyadii	None
medeltidens	da	None
medeltiden	da	None
medeltida	dhex-dhexaadin	Nan
lät	dhawaaqa	Nan
lätt	fududaan	Nan
lätta	iftiin	Nan
lättare	fudfudud	Nan
låg	hooseeya	None
låga	hooseeya	None
läste	akhri	None
lågt	hooseeya	None
låna	deynsato	Nan
lånat	amaahday	Nan
lång	dheer	None
långa	dheer	None
långbåge	dhaadheer	None
långfilm	muuqaal	Nan
lån	deyn	Nan
läst	akhri	None
läsning	akhrinta	None
läses	akhri	None
läns	degmo	None
lär	baro	None
lära	baro	None
läran	caqiido	Nan
lärare	macallin	None
lärda	culimada	None
lärde	bartay	None
lärjungar	ardayda	None
läror	caqiidooyinka	Nan
lärt	bartay	None
läs	akhri	None
läsa	akhri	None
läsare	akhriste	Nan
läsaren	akhristaha	Nan
läser	akhriyaa	Nan
långhårig	dheer	None
länkar	iskuxiran	Nan
långsamma	gaabis	Nan
långsamt	ah	None
löper	orod	None
lördagen	sabti	None
lösa	xallin	Nan
lösas	xallin	Nan
löser	furfuran	Nan
lösning	xalka	Nan
löpande	hadda	None
lösningar	xalalka	Nan
lösningsmedel	solvent	Nan
löst	si	None
löstes	diri	None
mabel	mabel	Nan
machu	machu	Nan
madagaskar	madagascar	Nan
lösningen	xalka	Nan
lönneberga	lönneberga	Nan
löner	mushahar	Nan
lön	mushahar	Nan
långt	fog	None
långtgående	hami	Nan
långvarig	dheeraaday	Nan
långvariga	dheer	None
långvarigt	dheer	None
låt	daa	None
låta	cod	None
låtar	heeso	None
låtarna	heeso	None
låten	heesta	None
låter	dhawaaqyada	Nan
låtit	kursi	Nan
låtskrivare	abwaan	None
löfte	qaad	None
löften	ballamaha	Nan
långsammare	ah	None
länk	iskuxiran	Nan
längtan	doonis	Nan
längsta	dheer	None
luxemburg	luxembourg	Nan
lycka	farxad	None
lyckade	guul	None
lyckades	maamulay	Nan
lyckan	farxad	None
lyckas	guuleysto	None
lutning	rabitaan	Nan
lyckats	guuleystay	None
lyfta	u	None
lyfter	wiishashka	Nan
lyrik	heesaha	None
lysande	badan	None
lyssna	dhageyso	Nan
lyssnade	dhagaystay	Nan
lyder	addeec	Nan
lutherska	lutheran	Nan
luthers	luther	Nan
luther	luther	Nan
ludwig	ludwig	Nan
luft	hawo	None
luften	hawo	None
lugn	xasilloon	Nan
lugna	deganaan	Nan
lukas	luukos	Nan
luleå	luleå	Nan
luminositet	iftiin	Nan
lundell	lundell	Nan
lundgren	lundgren	Nan
lunds	lund	Nan
lunginflammation	burunkiito	Nan
lungorna	sambabka	Nan
lupus	lupus	Nan
lust	rabitaan	Nan
lyssnar	dhagaysta	Nan
läge	goobta	None
lägenhet	abaar	None
läger	xero	None
lämningar	hadhaagii	Nan
lämplig	habboon	None
lämpliga	habboon	None
lämpligt	habboon	None
län	degmo	None
länder	wadamada	None
länderna	wadamada	None
ländernas	gobollada	None
länders	wadamada	None
längd	dherer	None
längden	dherer	None
länge	dheer	None
längre	dheer	None
längs	weheliya	Nan
längst	fog	None
lämnat	bidix	None
madeira	madeira	Nan
lämnas	bidix	None
lämnades	bidix	None
läget	booska	Nan
lägga	jiifay	Nan
läggas	daray	None
lägger	ku	None
läggs	daray	None
lägre	hoose	None
lägret	xero	None
lägst	hooseeya	None
lägsta	hooseeya	None
läkare	dhakhtarka	Nan
läkaren	dhakhtar	Nan
läkemedel	daroogada	Nan
läkemedelsverket	mpa	Nan
lämna	bax	Nan
lämnade	bixitaanka	Nan
lämnar	caleemaha	Nan
madeleine	madeleine	Nan
madonna	madonna	Nan
madrid	madrid	Nan
massachusetts	massachusetts	Nan
massakern	dhibaato	None
massan	tiro	None
massiv	ballaaran	None
massiva	ballaaran	None
massmedia	guud	None
massa	saxarka	Nan
massor	badan	None
mat	cuntada	None
match	ciyaar	None
matchen	ciyaar	None
matcher	isbarbardhiga	Nan
matcherna	isbarbardhiga	Nan
matematik	xisaabta	None
master	sayid	None
maskiner	mashiinnada	Nan
mary	maryo	Nan
marxistiska	marxist	Nan
marknad	suuqa	None
marknaden	suuqa	None
marknader	suuqyada	None
marknadsekonomi	suuqa	None
markus	markus	Nan
marley	marley	Nan
marleys	marleys	Nan
marocko	morocco	Nan
mars	maarso	None
marshall	marshall	Nan
martin	martin	Nan
marx	marx	None
marxism	marxism	Nan
marxismen	marxism	Nan
marxistisk	marxist	Nan
matematiken	xisaabta	None
matematiker	xisaabta	None
matematisk	xisaab	None
matematiska	xisaab	None
medborgare	qaran	None
medborgarna	muwaadiniinta	None
medborgarskap	dhalasho	None
medborgerliga	madani	Nan
meddelade	dhawaaqay	None
meddelande	farriin	Nan
meddelanden	farriimaha	Nan
medel	celcelis	Nan
medelhavet	dhexe	None
medelhavsklimat	cimilada	None
medelhavsområdet	dhexe	None
medelklassen	dhexe	None
medellivslängd	filasho	Nan
medeltemperaturen	celceliska heerkulka	Nan
medeltid	da	None
medarbetare	wadaaga	None
marklund	marklund	Nan
medan	halka	None
maya	mayan	Nan
maten	cuntada	None
materia	arrinta	Nan
material	wax	None
materialet	wax	None
materiella	wax	None
matrix	matrix	Nan
mats	mats	Nan
matt	jilicsan	None
matteus	matayos	Nan
matteusevangeliet	matayos	Nan
matthew	matayos	Nan
mattias	mattias	Nan
mattis	mattis	Nan
maurice	maurice	Nan
max	max	Nan
med	leh	None
musiken	muusig	None
markerar	tixraac	None
markera	calaamadee	Nan
makedonien	makedoniya	Nan
makedonska	makedoniya	Nan
makt	awood	None
makten	awood	None
maktens	ciidan	None
makter	awoodaha	None
make	nin	None
malaysia	malaysiya	None
malin	malin	Nan
malmö	malmö	Nan
malmös	malmö	Nan
malta	malta	None
mamma	hooyo	None
man	man	Nan
malcolm	malcolm	Nan
makadam	macadam	Nan
majs	galley	Nan
majoriteten	aqlabiyad	None
maffia	abaabul	None
maffian	abaabul	None
magdalena	magdalena	Nan
magic	sixir	Nan
magnetfält	beerta	None
magnetiska	magnetic	Nan
magnitud	weynaanta	Nan
magnus	magnus	Nan
magnusson	magnusson	Nan
mahatma	mahatma	Nan
maiden	gabadh	None
maidens	dumar	None
main	weyn	None
maj	yaabaa	None
majoritet	aqlabiyad	None
manager	maamulaha	None
manchester	cillad la’aan	Nan
mandat	waajib	None
mandatperiod	muddo	None
marcus	marcus	Nan
margaret	margaret	Nan
maria	guur	None
marie	marie	Nan
mariette	mariette	Nan
marijuana	marijuana	Nan
marilyn	marilyn	Nan
marina	badda	None
marinen	navy	Nan
marino	marino	None
mario	mario	Nan
marissa	marissa	Nan
mark	dhulka	None
markant	ah	None
marken	dhulka	None
marco	marco	Nan
markerade	la	None
maos	maos	Nan
manuskript	qoraal	None
mandelas	mandela	None
mando	amar	None
manhattan	manhattan	Nan
mani	waali	Nan
maniska	manic	Nan
mankell	mankell	Nan
manlig	lab	None
manliga	lab	None
mannen	fanka	None
mannens	nin	None
mans	lab	None
manson	manson	Nan
manteln	jaakad	Nan
manuel	manuel	Nan
manus	qoraal	None
mao	ie	Nan
palmes	calaacal	Nan
musikens	muusig	None
musikstil	musicstyle	Nan
odens	buur	None
odlade	abaabulay	None
odlas	abaabulay	None
odling	dhaqanka	None
oecd	oecd	Nan
oerhörd	weyn	None
oden	buur	None
oerhört	u	None
off	dami	Nan
offensiven	ah	None
offentlig	dadweynaha	None
offentliga	dadweynaha	None
offentligt	ah	None
offer	dhibanayaashu	Nan
of	ee	None
ockuperat	degay	None
ockuperades	degay	None
ockuperade	degay	None
objekten	waxyaabaha	None
objektet	walax	Nan
obligatorisk	ah	None
obligatoriskt	qasab	Nan
observationer	indha	None
observatörer	goobjoogayaasha	Nan
observera	ogeysiis	Nan
observeras	arkay	None
oc	oc	Nan
oceanen	badweynta	None
och	iyo	None
ocheller	iyo	None
också	kale	None
ockupation	shaqo	None
ockupationen	shaqo	None
office	xafiiska	None
objekt	walax	Nan
officerare	saraakiisha	None
officiell	ah	None
oliver	saytuun	Nan
olja	saliid	None
olle	olle	Nan
ollonet	qurxiyo	Nan
olof	olof	Nan
olsson	olsson	Nan
olika	duwan	None
olycka	shil	None
olyckor	shilalka	Nan
olympia	olympia	Nan
olympiastadion	olympiastadion	Nan
olympiska	olombikada	None
om	haddii	None
ombord	saaran	None
olyckan	shil	None
olagligt	ah	None
ola	ola	Nan
okänt	aqoon	None
officiella	ah	None
officiellt	ah	None
offren	dhibanayaashu	Nan
offret	dhibane	Nan
offside	bannaanka	Nan
ofta	jeer	None
oftare	badan	None
oftast	ah	None
oförmåga	awood	None
ogillade	laga	None
oklart	caddayn	None
oktober	oktoobar	None
oktoberrevolutionen	oktoobar	None
okänd	aqoon	None
okända	aqoon	None
official	ah	None
oberoende	madaxbannaan	None
obelix	obelix	Nan
obamas	obama	None
nämnde	xusan	None
nämner	xusan	None
nämns	xusan	None
nämnts	xusan	None
när	goorma	Nan
nära	dhow	None
nämnda	yidhi	None
närhet	agagaarka	None
näringsliv	ganacsi	None
näringslivet	ganacsiga	None
närliggande	dhow	None
närma	u	None
närmade	u	None
närmar	soo	None
näring	nafaqada	Nan
nämnas	xusan	None
nämligen	oo	None
nyval	cusub	None
nummer	tirada	None
nutid	xaadir	Nan
nutida	ah	None
nuvarande	hadda	None
ny	cusub	None
nya	cusub	None
nyare	cusub	None
nybildade	sameeyay	None
nye	cusub	None
nyfödda	dhasho	Nan
nyheten	news	None
nyheter	news	None
nyligen	dhow	None
nytt	cusub	None
nytta	faa iido	Nan
närmare	dhow	None
närmast	dhow	None
närmaste	socda	None
närstående	xiriira	None
något	wax	None
några	yaroo	None
når	gaadho	None
nås	karo	None
nått	gaadhay	None
nöd	baahi	None
nödvändig	yahay	None
nödvändiga	yahay	None
nödvändigt	yahay	None
nödvändigtvis	daruuri	Nan
nöjd	ku	None
o	o	None
oavgjort	xerin	Nan
oavsett	loo	None
obama	obama	None
någorlunda	ah	None
omedelbar	markiiba	None
någonting	kasta	None
någonsin	waligaa	Nan
närvarande	xaadir	Nan
närvaro	joogitaan	Nan
näsan	sanka	None
näst	labaad	None
nästa	xiga	None
nästan	ku	None
nät	shabakadda	Nan
nätet	shabaqa	Nan
nätverk	shabakad	None
nätvingar	neuroptera	Nan
nå	gaadho	None
nåd	nimco	Nan
nådde	gaadhay	None
nåddes	gaadhay	None
någon	qof	None
någonstans	meel	None
numera	maalmahan	Nan
omedelbart	markiiba	None
omfattade	kujira	Nan
oroligheter	darro	None
orsak	sabab	None
orsaka	sabab	None
orsakad	sababay	None
orsakade	sababay	None
orsakar	sabab	None
orolig	walwalsan	Nan
orsakas	sababay	None
orsaken	sabab	None
orsaker	sababa	Nan
orsakerna	sababa	Nan
ort	magaalada	None
orten	dalxiis	None
orter	booqday	None
orsakat	sababay	None
oro	walaac	Nan
ormar	abeesooyin	Nan
orkester	orchestra	Nan
organisationens	urur	None
organisationer	ururada	None
organisera	abaabul	None
organiserad	abaabulan	Nan
organiserade	abaabulan	Nan
organiseras	abaabulan	Nan
organiserat	abaabulan	Nan
organisk	ah	None
organiska	ah	None
organism	noolaha	None
organismen	noolaha	None
organismer	noolaha	None
orgasm	uurjiifka	Nan
origin	ah	None
original	ah	None
ortodoxa	orthodox	Nan
organisationen	urur	None
os	os	Nan
oskar	oskar	Nan
oväntat	ah	None
own	leh	None
oxenstierna	oxenstierna	Nan
oxford	oxford	Nan
ozzy	ozzy	Nan
oändligt	lahayn	None
ovanstående	xusan	None
pablo	pablo	Nan
pakistan	bakistaan	None
palats	qasriga	Nan
palestina	falastiin	None
palestinier	falastiin	None
palestinsk	falastiin	None
palestinska	falastiin	None
page	bogga	None
ovanpå	kor	None
ovanligt	ahayn	None
ovanliga	naadir	Nan
oslo	oslo	Nan
osmanerna	ottomans	Nan
osmanska	ottoman	Nan
oss	mareykanka	None
ost	farmaajo	None
osv	iwm	None
osäker	la	None
osäkert	la	None
osäkra	gelin	None
otaliga	karin	None
otto	otto	Nan
out	banaanka	None
ovan	xusan	None
ovanför	xusan	None
ovanlig	ahayn	None
oscar	oscar	Nan
organisation	urur	None
organ	xubin	None
ordspråk	maahmaah	Nan
område	aag	Nan
områden	aagagga	Nan
områdena	gobollada	None
området	aag	Nan
områdets	aag	Nan
omröstning	codbixinta	Nan
omnämns	xusan	None
omröstningen	codee	Nan
omslaget	dabool	Nan
omstritt	muransan	Nan
omständigheter	duruufaha	Nan
omtvistat	badan	None
omvandlar	beddelaya	Nan
omvandlas	beddelay	Nan
omskärelse	gudniinka	Nan
omloppsbanor	orbital	Nan
omloppsbana	orbit	Nan
omkringliggande	hareeraha	None
omfattande	ballaaran	None
omfattar	kooban	None
omfattas	daboolay	Nan
omfattning	xad	None
omger	wareegsan	None
omges	hareereeyay	Nan
omgivande	deegaanka	None
omgiven	hareereeyay	Nan
omgivning	deegaanka	None
omgivningen	hareeraha	None
omgående	markiiba	None
omgångar	wareeg	Nan
omgången	wareega	None
omkom	dhintay	None
omkring	saabsan	None
omvandling	beddelaad	Nan
omvända	gadaal	None
omvänt	kale	None
omvärlden	dibedda	None
oralsex	afka	None
orange	orange	Nan
ord	ereyada	None
ordagrant	hadalka	None
ordbok	qaamuus	None
orden	ereyada	None
ordentligt	habboon	None
ordet	ereyga	None
ordförande	madaxweynaha	None
ordinarie	ah	None
ordna	diyaarin	Nan
ordnade	waalid	None
ordnar	diyaarin	Nan
ordning	amar	None
ordningen	habka	None
oppositionen	mucaaradka	None
omfatta	dar	None
opposition	mucaaradka	None
opinion	ra&#39;yi	Nan
omväxlande	taa	None
omöjligt	aheyn	None
on	dul	None
onani	naasoodal	Nan
onda	shar	Nan
ondska	shar	Nan
ondskan	shar	Nan
ont	shar	Nan
ontario	ontaariyo	Nan
open	fur	Nan
opera	opera	Nan
operan	opera	Nan
operation	howlgal	None
operationer	hawlgallada	Nan
operativsystem	os	Nan
opinionen	ra&#39;yi	Nan
nukleotider	nucleotides	Nan
nuförtiden	maalmahan	Nan
nu	hadda	None
möjlighet	karti	None
möjligheten	fursad	None
möjligheterna	fursadaha	None
möjligt	suurtagal	Nan
mönster	qaabka	None
mördad	dilay	None
möjliggör	karti	None
mördade	dilay	None
mörk	ah	None
mörkare	ah	None
mörker	gudcurka	Nan
mörkt	ah	None
möta	kulan	None
möte	kulan	None
mördades	dilay	None
möjliggjorde	galisay	None
möjligen	gal	None
möjliga	suurtagal	Nan
mån	isniin	None
månad	bishii	None
månaden	bishii	None
månader	bilood	None
månaderna	bilood	None
månar	bilaha	None
månarna	bilaha	None
måne	dayaxa	None
månen	dayaxa	None
månens	dayax	None
många	badan	None
mångfald	kala	None
måste	waa	None
mått	cabir	None
möjlig	suurtagal	Nan
möten	shirarka	Nan
målvakten	goolhaye	Nan
möter	waji	None
mötley	motley	Nan
nation	qaran	None
national	qaran	None
nationalencyklopedin	nationalencyklopedin	Nan
nationalförsamlingen	qaranka	None
nationalism	qaranimo	Nan
nationalismen	qaranimo	Nan
nathan	naataan	Nan
nationalister	wadaniyiinta	Nan
nationalitet	dhalasho	None
nationalpark	qaran	None
nationalparker	qaranka	None
nationell	qaran	None
nationella	qaran	None
nationellt	ahaan	None
nationalistiska	wadani	None
nash	nash	Nan
nasa	nasa	Nan
narkotika	daroogada	Nan
möts	kulmay	None
mött	kulmay	None
mötte	kulmay	None
möttes	kulmay	None
münchen	munich	Nan
n	n	Nan
nacka	nacka	Nan
nagasaki	nagasaki	Nan
namibia	namibia	Nan
namn	magac	None
namnen	magacyada	None
namnet	magaca	None
nancy	nancy	None
napoleon	napoleon	Nan
napoleons	napoleon	Nan
mötet	kulan	None
målvakt	goolhaye	Nan
målningen	shiidi	Nan
målningar	rinjiyeynta	Nan
mynnar	furitaanka	Nan
mynning	afka	None
mynt	qadaadiic	Nan
myntade	qasbay	None
myntades	qasbay	None
mysterium	qarsoodiga	Nan
myndigheterna	madaxda	None
mystiska	dahsoon	None
mytologi	khuraafaad	Nan
mytologin	khuraafaad	Nan
mytologiska	khuraafaad	Nan
mäktiga	badan	None
mäktigaste	badan	None
mälaren	mälaren	Nan
myter	khuraafaad	Nan
myndigheter	wakaaladaha	Nan
myndigheten	amar	None
myndighet	amar	None
musikstilar	noocyada	None
musikvideo	pv	Nan
musikvideon	pv	Nan
musikvideor	fiidiyowyada muusikada	Nan
muskler	murqaha	Nan
musklerna	murqaha	Nan
muslim	muslim	None
muslimer	muslimiinta	None
muslimerna	muslimiinta	None
muslimsk	muslim	None
muslimska	muslim	None
mussolini	mussolini	None
mussolinis	mussolini	None
mutationer	isbedelada	Nan
mycket	aad	None
män	ragga	None
mängd	qadarka	None
mängden	qadarka	None
mängder	xaddi	Nan
mästarna	sayid	None
mäta	cabir	None
mäter	cabir	None
mätningar	cabiraadaha	Nan
mäts	cabiray	Nan
mätt	cabiray	Nan
må	dareento	Nan
mål	hadaf	Nan
måla	rinjiga	None
målade	rinjiyeeyay	Nan
målare	rinjiye	Nan
målen	kiisaska	Nan
måleri	rinjiyeynta	Nan
målet	hadafka	Nan
målning	rinjiyeynta	Nan
mästare	master	Nan
nationen	qaran	None
märta	xanuun	None
märks	summadaysan	Nan
männen	ragga	None
människa	qof	None
människan	aadanaha	None
människans	aadanaha	None
människas	aadanaha	None
människor	dadka	None
människorna	dadka	None
människors	aadanaha	None
mänsklig	aadanaha	None
mänskliga	aadanaha	None
mänskligheten	aadanaha	None
mänsklighetens	aadanaha	None
mänskligt	aadanaha	None
märke	samee	Nan
märken	magacyada	None
märktes	summadaysan	Nan
nationens	qaran	None
nationer	quruumaha	Nan
nationerna	quruumaha	Nan
nomineringar	magacaabid	Nan
nord	woqooyi	None
nordafrika	afrika	None
nordamerika	ameerika	None
nordamerikanska	ameerika	None
norden	waqooyiga	None
nominerades	magacaabay	None
nordens	nordic	Nan
nordisk	nordic	Nan
nordiska	nordic	Nan
nordiskt	nordic	Nan
nordkorea	waqooyi	None
nordkoreanska	waqooyi	None
nordkoreas	waqooyi	None
nordirland	waqooyiga	None
nominerad	magacaabay	None
noll	eber	Nan
noga	leh	None
nionde	sagaalaad	None
nirvana	nirvana	Nan
nivå	heer	None
nivåer	heerarka	Nan
nivån	heer	None
nixon	nixon	Nan
njurarna	kelyaha	Nan
nku	nku	Nan
nobel	nobel	Nan
nobelkommittén	gudiga	None
nobelpriset	abaal	None
nobelpristagare	abaalmarinta nobel	Nan
nobels	marin	None
nobelstiftelsen	ururka	None
nog	malaha	None
nordliga	woqooyiga	None
nordligaste	waqooyiga	None
nordost	waqooyi-bari	Nan
nordsjön	badda	None
norsk	noorwiijiga	Nan
norska	noorwiijiga	Nan
norstedt	norstedt	Nan
norstedts	collins	Nan
north	woqooyi	None
notation	astaamo	None
noter	qoraalada	None
notera	ogeysiis	Nan
noterade	ogeysiis	Nan
nou	maya	Nan
nova	nova	Nan
november	nofembar	Nan
now	hadda	None
nr	maya	Nan
nsdap	nsdap	Nan
norrut	waqooyi	None
nio	sagaal	None
norrmän	noorwiijiga	Nan
norrland	waqooyiga	None
nordväst	waqooyi-galbeed	Nan
nordvästra	waqooyi-galbeed	Nan
nordöst	waqooyi-bari	Nan
nordöstra	waqooyi-bari	Nan
norge	norwey	None
norges	norwey	None
normal	ah	None
normala	ah	None
normalt	caadiyan	Nan
norman	norman	Nan
normer	heerarka	Nan
norr	waqooyiga	None
norra	woqooyi	None
norrköping	norrköping	Nan
norrköpings	norrköping	Nan
norrlands	norrland	Nan
musiker	muusikiiste	Nan
nilsson	nilsson	Nan
nikolaj	nikolaj	Nan
nazisterna	naasiyiinta	Nan
nazisternas	naasiis	Nan
nazistiska	naasiis	Nan
nazityskland	jarmalka	None
nazitysklands	jarmalka	None
ned	hoos	None
nazismen	naasiis	Nan
nedan	hoosta	None
nederbörden	roobab	None
nederlag	guuldarro	Nan
nederländerna	nederland	None
nederländska	nederlandays	Nan
nedgång	dhac	None
nedre	hoose	None
nederbörd	roobab	None
naturvetenskapliga	sayniska	None
naturtillgångar	ah	None
naturresurser	ah	None
nationernas	ummadaha	None
nations	qaran	None
nato	nato	None
natt	habeen	None
natten	habeen	None
nattetid	habeenkii	None
natur	dabeecadda	Nan
natural	dabiici	None
naturen	dabeecadda	Nan
naturens	dabeecadda	Nan
naturgas	ah	None
naturlig	ah	None
naturliga	ah	None
naturligt	ah	None
naturligtvis	dabcan	Nan
nedsatt	dhimay	Nan
nedåt	hoos	None
need	baahi	None
negativ	diidmo	Nan
newport	newport	Nan
newton	newton	Nan
newtons	newton	Nan
nf	nf	Nan
nhl	nhl	Nan
ni	adiga	None
nickel	nickel	Nan
nicklas	nicklas	Nan
niclas	niclas	Nan
nietzsche	nietzsche	Nan
nietzsches	nietzsche	Nan
nigeria	nigeria	Nan
nikki	nikki	Nan
niklas	niklas	Nan
nikola	nikola	Nan
nevada	nevada	Nan
nils	nils	Nan
neutroner	aasaaska	None
neutralitet	dhexdhexaadnimo	Nan
negativa	diidmo	Nan
negativt	diidmo	Nan
neil	neil	Nan
nej	maya	Nan
nelson	nelson	None
neo	neo	Nan
neologi	cilmiga	None
nepal	nepal	Nan
neptunus	neptune	Nan
ner	hoos	None
nere	hoos	None
nervosa	nervosa	Nan
nervsystemet	nidaamka	None
neutral	dhexdhexaad	None
neutrala	dhexdhexaad	None
neutralt	dhexdhexaad	None
ludvig	ludvig	Nan
skillnaderna	kala	None
skiva	disc	None
utrikespolitiska	dibada	None
utropade	ooyay	Nan
utropades	dhawaaqay	None
utrotning	ciribtirka	Nan
utrustning	qalab	None
utrymme	booska	Nan
utrikespolitiken	dibada	None
utsatt	qaawan	Nan
utsattes	dhigay	None
utse	magacaabid	Nan
utsedd	loo	None
utseende	muuqaal	Nan
utser	magacaabaa	None
utses	loo	None
utsatta	nugul	Nan
utrikespolitik	dibada	None
utrikesminister	dibada	None
utrikes	shisheeye	None
utmärker	sifeeya	Nan
utmärks	lagu	None
utmärkt	fiican	None
utnyttja	isticmaal	None
utnyttjade	loo	None
utnyttjar	adeegsiga	None
utnyttjas	loo	None
utnämndes	magacaabay	None
utom	reebo	None
utomeuropeiska	dibada	None
utomlands	dibedda	None
utomliggande	soo	None
utomstående	baxsan	None
utredning	baaritaan	None
utredningen	baaritaan	None
utskott	gudi	Nan
utmärkelser	abaalmarino	Nan
utsläpp	baxa	None
utsträckning	xad	None
utvalda	la	None
utveckla	horumar	None
utvecklad	horumaray	Nan
utvecklade	horumaray	Nan
utvecklades	horumaray	Nan
utvecklandet	horumarin	Nan
uttryckte	muujiyey	None
utvecklar	horumariye	Nan
utvecklat	horumaray	Nan
utvecklats	horumaray	Nan
utveckling	horumarin	Nan
utvecklingen	horumarin	Nan
utvidgade	ballaariyey	Nan
utvidgning	weyneynta	None
utvecklas	horumar	None
uttryckt	muujiyey	None
uttryckligen	cad	None
uttrycket	muujinta	Nan
utställning	bandhig	Nan
utsätts	qaawan	Nan
utsåg	magacaabay	None
utsågs	magacaabay	None
utsöndras	qarsoon	None
uttal	dhawaaqa	Nan
uttalade	dhawaaqay	None
uttalande	bayaan	Nan
uttalanden	qoraallada	Nan
uttalas	dhawaaqay	None
uttalat	dhawaaqay	None
uttalet	dhawaaqa	Nan
uttryck	muujinta	Nan
uttrycka	muuji	Nan
uttrycker	muujiyaa	None
utspelar	dhigay	None
utmärkelsen	abaalmarin	Nan
utmärkande	ahaan	None
utmed	weheliya	Nan
utbrett	faafitaan	Nan
utbrott	xanuun	None
utbröt	qarxay	Nan
utbud	duwan	None
utbyggda	ballaariyey	Nan
utbyggnad	horumarin	Nan
utbredning	faafitaan	Nan
utbyggt	ballaariyey	Nan
utdelades	abaalmarin	Nan
utdöda	tirtiraa	Nan
ute	banaanka	None
uteslutande	ah	None
utformade	sameeyay	None
utformning	qaabeynta	Nan
utbyte	sarrifka	Nan
utbredda	baahsan	Nan
utbredd	baahsan	Nan
utbildningen	tababarka	None
ursprungligen	ahaan	None
ursprungsbefolkning	ahaan	None
ursprungsbefolkningen	ahaan	None
ursäkt	daar	None
uruguay	urruce	Nan
urval	xulasho	Nan
usa	usa	None
usama	usama	Nan
usas	usa	None
ut	banaanka	None
utan	la’aan	Nan
utanför	banaanka	None
utbildad	bartay	None
utbildade	bartay	None
utbildning	tababarka	None
utformningen	qaabeynta	Nan
utfärdade	saaray	None
utför	fulinaya	Nan
utföra	fulin	Nan
utgör	kooban	None
utgöra	matalo	Nan
utgörs	kooban	None
utifrån	ka	None
utkanten	gees	None
utkom	la	None
utkämpades	la	None
utlandet	dibedda	None
utlopp	banaanka	None
utländsk	shisheeye	None
utländska	shisheeye	None
utlänningar	shisheeyaha	Nan
utlösa	kicin	Nan
utlösning	sii	None
utlöste	kiciyay	Nan
utgåvor	nuqullada	Nan
utvinna	saar	None
utgåvan	daabacaad	Nan
utgår	la	None
utföras	fuliyay	Nan
utförd	fuliyay	Nan
utförda	fuliyay	Nan
utfördes	fuliyay	Nan
utförs	fuliyay	Nan
utfört	fuliyay	Nan
utgavs	saaray	None
utgick	xoreeyay	None
utgifter	kharashka	Nan
utgiven	tafatir	Nan
utgivna	saaray	None
utgivningen	sii	None
utgjorde	ahaa	None
utgjordes	koobnaa	None
utgångspunkt	bilaabo	None
utgåva	daabacaad	Nan
ursprungliga	ah	None
utvinns	soo	None
utåt	dibedda	None
vart	halkee	Nan
varuhus	waaxda	None
varv	leexo	Nan
varvid	dhexdeeda	None
vasa	vasa	Nan
vasaloppet	vasaloppet	Nan
varsin	kasta	None
vasas	vasa	Nan
vatten	biyo	None
vattendrag	biyo	None
vattenkraft	hydroelectric	Nan
vattenånga	biyaha	None
vattnet	biyo	None
vattnets	biyo	None
vatikanstaten	vatican	Nan
vars	yaa	None
varpå	halkaasoo	None
varor	alaabada	Nan
varierar	duwan	None
varierat	duwan	None
varifrån	halkee	Nan
varit	ahaa	None
varje	kasta	None
varken	midna	None
varm	diiran	None
varma	kulul	None
varmare	diirimaad	Nan
varmblod	diiran	None
varmed	joogay	None
varmt	kulul	None
varna	digniin	None
varnade	digniin	None
varning	digniin	None
vd	maamulaha	None
varierande	duwan	None
vecka	toddobaad	Nan
veckor	toddobaadyo	Nan
verklighet	xaqiiqada	None
verkligheten	ah	None
verksam	firfircoon	None
verksamhet	howlgal	None
verksamheten	ganacsiga	None
verksamheter	hawlgallada	Nan
verkligen	runtii	None
verksamma	firfircoon	None
verktyg	qalab	None
vers	aayadda	None
versaillesfreden	nabada	None
version	nooca	None
versionen	sii	None
versioner	noocyo	Nan
verkställande	fulinta	Nan
verkliga	ah	None
verklig	ah	None
verket	dhirta	None
veckorna	toddobaadyo	Nan
vegas	vegas	Nan
velat	jeclaa	None
vem	aduunka	None
venedig	dalxiis	None
venezuela	venezuela	None
venus	venus	Nan
verde	verde	Nan
verk	shaqada	None
verka	fal	None
verkade	muuqday	None
verkan	saamayn	Nan
verkar	u	None
verkat	dhaqmay	None
verken	dhirta	None
veckan	usbuuca	None
varierade	duwan	None
variera	duwan	None
variationer	kala	None
valet	doorashada	None
valla	wax	None
valley	dooxada	None
vallhund	adhiga	None
valrörelsen	doorashada	None
valt	la	None
valen	doorashooyinka	None
valuta	lacag	None
vampyr	vampire	Nan
vampyren	vampire	Nan
vampyrer	vampire	Nan
van	baabuur	None
vana	caado	None
vandrar	warwareega	Nan
valutan	lacag	None
valdes	doortay	None
valde	doortey	Nan
valda	la	None
utökade	kordhiyay	None
utökat	ballaariyey	Nan
utöva	jimicsi	Nan
utövade	dadaalay	Nan
utövar	jimicsi	Nan
utövas	dadaalay	Nan
vacker	badan	None
vackra	badan	None
vad	maxay	None
vaginalt	siilka	Nan
vagn	gaari-wadid	Nan
vagnar	baabuur-waran	Nan
val	doorashada	None
valborg	valborg	Nan
vald	la	None
vanföreställningar	khiyaamo	None
vanlig	ah	None
vanliga	ah	None
vanligare	ah	None
vardagligt	ah	None
vardera	kasta	None
vare	ku	None
varefter	kadib	None
varelse	xayawaan	None
varelser	xayawaan	None
varför	sababta	None
varg	yeey	Nan
vargar	yeey	Nan
vargen	yeey	Nan
variant	duwan	None
varianten	duwan	None
varianter	kala	None
varianterna	kala	None
variation	kala	None
vardagliga	walba	None
utvisning	eryid	Nan
vardagen	walba	None
varar	soconaya	Nan
vanligast	ah	None
vanligaste	badan	None
vanligen	ah	None
vanligt	ah	None
vanligtvis	ah	None
vann	guuleystay	None
vanns	guuleystay	None
vapen	hubka	None
vapnen	hubka	None
vapnet	xoog	None
var	halkee	Nan
vara	noqon	None
varade	dhaafay	None
varandra	kale	None
varandras	eachothers	Nan
varav	taas	None
ursprunget	ahaan	None
ursprung	ahaan	None
urskilja	kala	None
uggla	odayga	None
ugglas	ugglas	Nan
uk	uk	Nan
ukraina	yukreeniyaan	Nan
ukrainas	yukreeniyaan	Nan
ukrainska	yukreeniyaan	Nan
ugandas	ugaandha	None
ulf	ulf	Nan
ulrich	ulrich	Nan
ultraviolett	ultraviolet	Nan
umgänge	galmada	Nan
und	iyo	None
undan	fog	None
undantag	reebo	None
ullevi	ullevi	Nan
uganda	uganda	Nan
uefacupen	uefa cup	Nan
uefa	uefa	Nan
tätort	magaalo	None
tätorten	agglomeration	Nan
tätorter	gorgortanka	Nan
tätt	adkeyn	Nan
tävla	tartami	None
tävlade	tartamay	Nan
tävling	tartan	Nan
tävlingar	jinsi	Nan
tävlingen	tartan	Nan
tåg	tareen	None
tågen	tareenada	Nan
tåget	tareen	None
tål	hor	None
u+	+	None
udda	odd	Nan
undantaget	ka	None
tätbefolkade	badan	None
under	lagu	None
underarten	isu-tagga	Nan
undvika	ilaali	None
undviker	ilaali	None
unesco	unesco	Nan
unescos	unesco	Nan
ung	ah	None
unga	ah	None
undre	hoose	None
ungar	carruurta	None
ungdom	dhalinyarada	None
ungdomar	dhalinyarada	None
unge	ah	None
ungefär	qiyaastii	None
ungern	hangari	Nan
ungerns	hangari	Nan
ungarna	carruurta	None
undervisningen	waxbarista	Nan
undervisning	waxbarista	Nan
undervisade	baray	None
underarter	isu-tagga	Nan
undergång	dhac	None
underhåll	dayactirka	Nan
underhållning	madadaalo	Nan
underjordiska	hoostiisa	None
underliggande	hooseeya	None
underlätta	fududeyn	Nan
underlättar	fududeeyaa	Nan
underordnade	sub	Nan
undersöka	baaraan	Nan
undersökning	baaritaan	None
undersökningar	waxbarasho	None
undersökte	baaro	Nan
undertecknades	saxeexay	Nan
underverk	yaab	None
underart	isu-tagga	Nan
täta	shaabad	Nan
tät	xir	None
tänkte	muujiyey	None
tvister	khilaafaadka	Nan
tvkanaler	kanaalada tv-ga	Nan
tvprogram	barnaamijyada	None
tvserie	tv	None
tvserien	tv	None
tvserier	tv	None
tvingats	qasbay	None
tvskådespelare	tvskådespelare	Nan
tvungna	lahaa	None
tvärtom	ah	None
två	laba	None
tvåa	labaad	None
twilight	fiidkii	Nan
ty	ee	None
tvungen	qasbay	None
tvingas	qasbay	None
tvingades	qasbay	None
tvingade	qasbay	None
turkiets	turkiga	None
turkisk	turkiga	None
turkiska	turkiga	None
turner	turner	Nan
turnera	safar	None
turnerade	dalxiis	None
turneringen	tartan	Nan
turné	safar	None
turnéer	socdaalada	Nan
turnén	safar	None
tusen	kun	None
tusentals	kumanaan	None
tv	tv	None
tvfilm	tv	None
tvinga	xoog	None
tycker	ka	None
tyckte	fikir	Nan
tycktes	muuqday	None
tyder	tilmaamayaa	Nan
tyst	aamusnaan	Nan
tyvärr	daro	None
täcka	dabool	Nan
täcker	daboolida	None
täcks	la	None
täckt	daboolay	Nan
tämligen	halkii	None
tänder	ilkaha	None
tänderna	ilkaha	None
tänka	ka	None
tänkande	fikirka	Nan
tänkandet	fikirka	Nan
tänkare	fikir	Nan
tänker	fikirka	Nan
tänkt	fikir	Nan
tyskt	jarmalka	None
ungerska	hangari	Nan
tysklands	jarmalka	None
tyske	jarmalka	None
tydlig	caddee	Nan
tydliga	caddee	Nan
tydligt	cad	None
tyngre	culus	None
typ	nooca	None
typen	nooca	None
typer	noocyada	None
typerna	noocyada	None
typisk	ah	None
typiska	ah	None
typiskt	ah	None
tysk	jarmalka	None
tyska	jarmalka	None
tyskar	jarmalka	None
tyskarna	jarmalka	None
tyskland	jarmalka	None
uniform	labis	Nan
unik	ah	None
unika	ah	None
upproret	kacdoon	None
upprustning	baxnaaninta	Nan
upprätta	aasaasid	Nan
upprättade	diyaarisay	Nan
upprättades	aasaasay	None
upprättandet	aasaaska	None
uppror	fallaagada	Nan
upprättas	aasaasay	None
upprätthåller	hayaa	None
uppsala	uppsala	Nan
uppskatta	qadarin	Nan
uppskattad	mahadsanid	Nan
uppskattade	qiyaasay	None
uppskattades	qiyaasay	None
upprätthålla	dayactir	None
upprepade	noqnoqda	None
uppnått	kulmay	None
uppnås	helay	None
upplysningstiden	waqtiga	None
upplösning	qaraar	None
upplösningen	kala	None
upplöstes	diri	None
uppmanade	yaqaan	None
uppmaning	wacid	Nan
uppmuntrade	dhiirigaliyay	Nan
uppmärksamhet	feejignaan	Nan
uppmärksammad	ogaaday	None
uppmärksammade	feejignaan	Nan
uppmärksammades	feejignaan	Nan
uppmärksammat	feejignaan	Nan
uppnå	gaadho	None
uppnådde	gaadhay	None
uppnår	gaadhay	None
uppskattar	qiyaasaha	Nan
uppskattas	qiyaasay	None
uppskattning	qiyaas	None
uppskattningar	qiyaasaha	Nan
upptäckt	helay	None
upptäckte	helay	None
upptäckten	daahfurka	Nan
upptäckter	daahfurka	Nan
upptäcktes	ogaaday	None
uppvisade	tusay	Nan
uppvisar	bandhigyo	Nan
uppvärmning	kululaynta	Nan
uppvärmningen	kululaynta	Nan
uppväxt	caruurnimada	Nan
uppåt	kor	None
ur	ka	None
uralbergen	buuraha	None
uran	uranium	Nan
urin	kaadida	Nan
upptäcks	ogaaday	None
upplysningen	iftiin	Nan
upptäcker	ogaansho	Nan
uppträder	dhacdo	None
uppskattningsvis	qiyaasay	None
uppslagsordet	erayga	None
uppslagsverk	encyclopedia	Nan
uppstod	kacay	None
uppstå	kac	Nan
uppståndelse	walaaq	Nan
uppstår	midkastoo	Nan
uppstått	dhacay	None
uppsving	xoojin	Nan
uppsättning	dhigay	None
upptagen	degay	None
upptar	deganaansho	Nan
uppträda	fal	None
uppträdande	waxqabadka	Nan
uppträdde	dhacay	None
upptäcka	ogaan	Nan
vet	ogaada	Nan
upplysning	macluumaad	None
upplevelser	khibradaha	Nan
uppdelningen	kala	None
uppdrag	howlgalka	Nan
uppdraget	meelaynta	Nan
uppe	kor	None
uppehåll	roob	None
uppemot	kor	None
uppdelning	qaybinta	Nan
uppenbarelse	muujintii	Nan
uppfann	abuurtay	None
uppfanns	abuurtay	None
uppfatta	garasho	None
uppfattade	gartay	None
uppfattar	garasho	None
uppfattas	gartay	None
uppenbarelser	muujinta	Nan
uppdelat	qaybsan	Nan
uppdelade	jabay	None
uppdelad	qaybsan	Nan
unikt	ah	None
union	midow	None
unionen	midow	None
unionens	midow	None
universitet	jaamacad	None
universiteten	jaamacadaha	None
universitetet	jaamacadda	None
universum	caalamka	None
universums	caalamka	None
uno	uno	Nan
up	kor	None
upp	kor	None
uppbyggd	qaabaysan	Nan
uppbyggnad	dhismaha	None
uppbyggt	qaabaysan	Nan
uppfattning	aragti	None
uppfattningar	fahamka	None
uppfattningen	arag	None
uppfinnare	soo	None
upphovsrätten	xuquuqda	None
upphörde	joogsaday	Nan
upphört	joojiyay	Nan
uppkallad	magacaabay	None
uppkom	kacay	None
uppkommer	dhacdo	None
uppkommit	horseeday	None
uppkomst	ahaan	None
uppkomsten	muuqaal	Nan
upplaga	daabacaad	Nan
upplagan	daabacaadda	Nan
upplagor	qoraalada	None
uppleva	khibrad	None
upplevde	khibradaha	Nan
upplevelse	khibrad	None
upphovsrätt	xuquuqda	None
upplever	kulma	None
upphovsman	qoraa	None
uppgörelse	dejinta	Nan
uppfinningar	curinta	Nan
uppfostran	barbaarinta	None
uppfylla	kulan	None
uppfyller	fuliyaa	Nan
uppföljare	taxanaha	Nan
uppförande	dhaqan	None
uppfördes	dhisan	None
uppgav	sheegay	None
uppger	gobolka	None
uppges	sheegay	None
uppgick	lacag	None
uppgift	hawl	None
uppgiften	hawl	None
uppgifter	hawlaha	None
uppgifterna	macluumaad	None
upphov	kac	Nan
turkiet	turkiga	None
veta	ogow	Nan
vetenskap	sayniska	None
än	badan	None
ända	dhamaadka	None
ändamål	ujeedo	Nan
ände	dhamaad	Nan
änden	dhamaadka	None
ändra	beddel	Nan
ämnet	mawduuca	Nan
ändrade	bedelay	None
ändrar	beddel	Nan
ändras	bedelay	None
ändrat	bedelay	None
ändringar	isbedelada	Nan
ändå	wali	None
änglar	malaa&#39;igta	Nan
ändrades	bedelay	None
ämnena	walxo	Nan
ämnen	walxo	Nan
ämne	mawduuc	Nan
ägs	leh	None
ägt	qaatay	None
äkta	ah	None
äktenskap	guur	None
äktenskapet	guur	None
äldre	weyn	None
äldsta	da	None
äldste	waayeel	None
älg	moose	Nan
älgar	moose	Nan
älgen	xusul	Nan
älska	jacayl	None
älskade	jecel	None
älskar	jacayl	None
ämbetsmän	saraakiisha	None
ängssyra	sorrel	Nan
ägnar	adeegsi	Nan
ännu	weli	None
ära	sharaf	None
ångest	walaac	Nan
år	sanadka	None
åren	sano	None
årens	sano	None
året	sanadka	None
årets	sanadka	None
ån	ka	None
århundraden	qarniyo	None
århundradet	qarnigii	None
årig	jir	None
åriga	da	None
åring	da	None
årlig	ah	None
årliga	ah	None
århundradena	qarniyo	None
åländska	åland	Nan
ålder	da	None
ålands	.land	Nan
ärftliga	dhaxalka	None
ärkebiskop	wadaadka	None
ärkebiskopen	weyn	None
äta	cun	None
äter	cun	None
ätten	boqortooyadii	None
ättlingar	faracoodii	Nan
även	kale	None
äventyr	tacabur	Nan
å	dul	None
åka	tag	Nan
åke	åke	Nan
åker	tag	Nan
åkte	tegey	None
åland	.land	Nan
är	waa	None
ägnade	qaatay	None
ägna	kharash garee	Nan
ägg	ukun	Nan
xii	xii	Nan
xiis	xii	Nan
xis	xis	Nan
yngre	yar	None
yngsta	yar	None
yngste	yar	None
xi	xi	Nan
york	york	None
you	adiga	None
youtube	youtube	Nan
yta	dusha	None
ytan	dusha	None
ytterligare	ah	None
ytterst	u	None
yorks	york	None
x	x	None
wright	wright	Nan
world	adduunka	None
wild	duur	None
wilde	wilde	Nan
wilhelm	wilhelm	Nan
will	doono	None
william	william	Nan
williams	williams	Nan
willy	willy	Nan
wilson	wilson	Nan
wind	dabayl	Nan
winnerbäck	winnerbäck	Nan
winston	winston	Nan
without	la’aan	Nan
wittenberg	wittenberg	Nan
wolfgang	wolfgang	Nan
works	shaqeynaya	None
yttersta	ugu	None
yttre	banaanka	None
z	z	Nan
zach	zach	Nan
miljoner	milyan	None
mm	mm	Nan
procent	boqolkiiba	None
km²	km²	Nan
°c	c	None
£m	m	None
×	×	Nan
à	à	Nan
äga	leh	None
ägande	lahaansho	Nan
ägare	milkiilaha	None
ägda	orod	None
ägde	qaatay	None
ägdes	leh	None
äger	leh	None
meter	mitir	Nan
årligen	sanadkii	None
km²	km²	Nan
km	km	None
zagreb	zagreb	Nan
zanzibar	zanzibar	None
zarathustra	zoroaster	Nan
zeeland	gaandi	None
zeppelin	zeppelin	Nan
zeus	zeus	Nan
zink	zinc	Nan
zirkon	zircon	Nan
zlatan	zlatan	Nan
zon	aag	Nan
zonen	aag	Nan
zoner	soonaha	Nan
zuckerberg	zuckerberg	Nan
cm	cm	Nan
kilometer	kiiloomitir	Nan
kmh	kmh	Nan
wikipedias	wikipedia	None
års	sano	None
årstiderna	xilliyada	Nan
östtyska	jarmalka	None
östtyskland	jarmalka	None
östtysklands	jarmalka	None
över	dhaaftay	None
överallt	kasta	None
överbefälhavare	taliyaha	None
östtimor	timir	Nan
överens	ogolaaday	None
överensstämmer	u	None
överföra	wareejin	None
överföras	gudbiyo	Nan
överföring	wareejin	None
överförs	gudbiyo	Nan
övergav	tagay	None
överenskommelse	heshiis	None
östra	bari	None
östman	östman	Nan
östfronten	bari	None
öst	bari	None
östafrika	afrika	None
östasien	aasiya	None
östberg	ostberg	Nan
östberlin	bariga	None
östblocket	bariga	None
öster	bari	None
östergötland	östergötland	Nan
österrike	austria	Nan
österrikes	austria	Nan
österrikeungern	austria hangari	Nan
österrikiska	austrian	Nan
östersjön	badda	None
österut	bari	None
östeuropa	bari	None
övergick	gudbay	None
öronen	dhegaha	None
övergrepp	xadgudubka	Nan
övergå	gudub	Nan
översättas	tarjumay	Nan
översättning	turjumaad	Nan
översättningar	tarjumaadaha	Nan
översättningen	turjumaad	Nan
översätts	tarjumay	Nan
övertala	qancin	Nan
översvämningar	daadad	Nan
övertalade	aaminsiiyey	Nan
övertogs	qaatay	None
övertyga	qancin	Nan
övervikt	ah	None
övervägande	ah	None
övre	sare	None
övrig	kale	None
övertog	qaatay	None
överst	kor	None
översikt	guud	None
översatt	tarjumay	Nan
övergång	guur	None
övergången	guur	None
övergår	biiro	None
överhuvudtaget	wixii	None
överhöghet	sarreynta	Nan
överleva	badbaado	Nan
överlevande	badbaaday	None
överlevde	badbaaday	None
överlever	badbaaday	None
överlevnad	badbaado	Nan
överlevt	badbaaday	None
överlägset	ka	None
övernaturliga	ka	None
överraskande	leh	None
övers	transl	Nan
övergripande	ahaan	None
öron	dhegaha	None
öresund	cod	None
örebro	örebro	Nan
återkommande	noqnoqda	None
återkommer	doona	None
återkomst	noqo	None
återställa	celin	None
återstående	haray	None
återstår	hadhay	None
återkom	noqo	None
återta	u	None
återvände	soo	None
återvänder	soo	None
återvänt	soo	None
åtgärder	falalka	None
åtminstone	yaraan	None
åtskilda	kala	None
återvända	noqo	None
återigen	labaad	None
återgick	tegey	None
återförening	isukeen	Nan
årsåldern	waaweyn	None
årtionde	sano	None
årtionden	sano	None
ås	gogosha	Nan
åsikt	ra&#39;yi	Nan
åsikten	arag	None
åsikter	fikradaha	Nan
åskådare	daawade	Nan
åstadkomma	gaadho	None
åt	at	None
åtal	oogista	None
åtalades	tilmaamay	None
åter	re	Nan
återfanns	soo	None
återfinns	helay	None
åtskilliga	ah	None
åtta	sideed	None
åttonde	sideedaad	None
ö	jasiirad	None
öl	biir	None
öland	öland	Nan
ölet	biir	None
ön	jasiirad	None
öns	jasiirad	None
önskade	doonayo	None
önskan	jeclaan	None
önskar	doonayo	None
önskemål	codsiyada	Nan
öppen	fur	Nan
öppet	fur	Nan
öppna	furan	None
öppnade	furay	None
öppnades	furay	None
öppnat	furay	None
ökningen	kordhiyo	None
årsdag	sanad	None
ökning	kordhiyo	None
ökenråttor	jeermiga	Nan
öar	jasiiradaha	None
öarna	jasiiradaha	None
öde	faras	None
ödleblad	houttuynia cordata	Nan
öga	isha	None
ögat	isha	None
ögon	indhaha	None
ögonen	indhaha	None
öka	kordhiyo	None
ökad	kordhay	Nan
ökade	kordhay	Nan
ökande	kordhaya	Nan
ökar	kordhiyaa	Nan
ökat	kordhay	Nan
öken	ah	None
öknen	ah	None
wikipedia	wikipedia	None
wien	vienna	Nan
who	aduunka	None
visat	helay	None
visats	muujiyey	None
visby	visby	Nan
visdom	xikmad	None
vision	aragti	None
visor	heeso	None
visas	muujiyey	None
viss	ah	None
visserligen	qirtay	Nan
visst	xaqiiqdi	Nan
visste	ogaa	Nan
vista	fiisooyinka	Nan
vistas	joogitaan	Nan
vistelse	joog	None
vissa	qaar	None
visar	muujinaya	None
visades	la	None
visade	tusay	Nan
vinsten	kasban	Nan
vinster	faa&#39;iidooyinka	Nan
vinter	jiilaalka	Nan
vintergatan	caano	None
vinterkriget	dagaal	None
vintern	jiilaalka	Nan
vinterspelen	ciyaaraha	None
vintertid	xilliga xagaaga	Nan
vintrar	jiilaalka	Nan
vintrarna	jiilaalka	Nan
virginia	virginia	Nan
virus	fayruus	Nan
viruset	fayruuska	Nan
vis	dariiqa	Nan
visa	show	Nan
vit	caddaan	Nan
vinst	faa&#39;iido	Nan
vita	caddaan	Nan
vitt	caddaan	Nan
vuxit	koray	None
vuxna	waaweyn	None
väckt	keenay	None
väckte	kiciyey	Nan
väder	cimilo	None
vädret	cimilo	None
vuxen	weyn	None
väg	dariiqa	Nan
vägarna	waddooyinka	Nan
vägen	dariiqa	Nan
väger	culeys	Nan
vägg	darbiga	None
vägnät	waddo	None
vägnätet	waddo	None
vägar	siyaabo	Nan
vunnit	guuleystay	None
vulkanutbrott	qarxay	Nan
vulkaniska	foolxanuun	Nan
vittne	marag	Nan
vittnen	markhaatiyaasha	Nan
vladimir	vladimir	Nan
vm	vm	Nan
voddler	voddler	Nan
vojvodina	vojvodina	Nan
vojvodskap	goobaha	None
vol	v	None
voltaire	voltaire	Nan
volvo	volvo	Nan
volym	mugga	None
von	von	Nan
vore	lahaa	None
vrida	leexo	Nan
vulkaner	dababno	Nan
vitryssland	belarus	None
vinner	guuleysto	None
vinnaren	guuleyste	Nan
vinnare	guuleyste	Nan
vidsträckta	ballaarin	Nan
vidta	qaadan	None
vietnam	fiyatnaam	Nan
vietnamesiska	fiyatnaamiis	Nan
vietnamkriget	dagaalkii	None
vietnams	fiyatnaam	Nan
videon	fiidiyow	Nan
viggo	viggo	Nan
vika	laabid	Nan
viken	gacanka	None
viking	viking	Nan
vikingar	vikings	Nan
vikingarna	vikings-ka	Nan
vikingatiden	mudada	None
vii	vii	Nan
video	fiidiyow	Nan
vidare	ah	None
vida	fog	None
vetenskapen	sayniska	None
vetenskaplig	ah	None
vetenskapliga	ah	None
vetenskapligt	ahaan	None
vetenskapsmän	saynisyahano	Nan
veto	veto	Nan
vhs	vhs	Nan
vi	anaga	Nan
via	marayo	None
vice	xigeen	None
vicepresident	kuxigeenka	None
victor	guuleyste	Nan
victoria	guul	None
victoriasjön	harada victoria	Nan
vid	at	None
vikt	culeys	Nan
vikten	culeys	Nan
viktig	ah	None
viktiga	ah	None
villor	tuulooyin	None
vimmerby	vimmerby	Nan
vin	khamri	Nan
vincent	vincent	Nan
vinci	vinci	Nan
vind	dabayl	Nan
vindar	dabayl	Nan
vinden	gaan	Nan
vindkraft	dabayl	Nan
vindkraftverk	mashiinnada dabaysha	Nan
vingar	baalasheeda	Nan
vinkel	xaglo	Nan
vinkeln	xagal	Nan
vinklar	xaglaha	Nan
vinna	guuleysto	None
villkoren	xaaladaha	None
vägrade	diiday	None
villkor	shuruudaha	Nan
villa	villa	Nan
viktigare	ah	None
viktigaste	ah	None
viktigt	ah	None
viktor	viktor	Nan
vila	nasasho	Nan
vilar	nasasho	Nan
vilda	ah	None
vilhelm	vilhelm	Nan
vilja	doonaa	None
viljan	doonaa	None
vilka	taas	None
vilkas	yaa	None
vilken	taas	None
vilket	taas	None
vill	raba	None
ville	rabay	None
vägrar	diidmo	Nan
väl	fiican	None
väldet	boqortooyada	None
växter	dhirta	None
växterna	dhirta	None
växthuseffekten	lagu	None
växthusgaser	ghg	Nan
våg	mowjad	Nan
vågade	dhacay	None
växte	koray	None
vågen	hirarka	Nan
vågor	waaxda	None
våld	rabshad	Nan
våldet	rabshad	Nan
våldsam	leh	None
våldsamma	leh	None
våningar	heerarka	Nan
våglängder	badda	None
växt	dhirta	None
växjö	växjö	Nan
växer	koraan	Nan
västeuropa	yurub	None
västindien	kaaribiyaan	Nan
västkusten	galbeed	None
västlig	westerly	Nan
västliga	galbeedka	None
västmakterna	galbeedka	None
västra	galbeedka	None
västsahara	galbeedka	None
västtyskland	jarmalka	None
västvärlden	galbeedka	None
väte	hydrogen	Nan
vätet	hydrogen	Nan
vätska	dareere	Nan
växa	koraan	Nan
växande	koraya	Nan
vår	guga	None
våra	our	Nan
vård	daryeel	None
våren	guga	None
waterloo	waterloo	Nan
watson	watson	Nan
way	jid	None
wayne	wayne	None
we	anaga	Nan
webbkällor	ilaha	None
webbplats	websaydh	Nan
webbplatsen	websaydh	Nan
webbplatser	websaydhyada	Nan
weber	weber	Nan
welsh	welsh	Nan
wembley	wembley	Nan
werner	werner	Nan
west	galbeedka	None
what	maxay	None
washington	washington	Nan
västerås	västerås	Nan
warszawa	warsaw	Nan
warhol	warhol	Nan
vårt	our	Nan
w	w	None
wagner	wagner	Nan
wahlgren	wahlgren	Nan
wailers	baroorta	Nan
wales	wales	Nan
wall	darbiga	None
wallace	wallace	Nan
wallander	wallander	Nan
wallenberg	wallenberg	Nan
wallenstein	wallenstein	Nan
walt	walt	Nan
walter	walter	Nan
want	raba	None
war	dagaal	None
warner	digniin	None
vete	sarreen	Nan
västerut	galbeed	None
västerländsk	galbeedka	None
vänster	bidix	None
vänstern	bidix	None
vänsterpartiet	bidix	None
vänstra	bidix	None
vänt	sugaya	Nan
vänta	sug	Nan
vänskap	saaxiibtinimo	None
väntade	sugayay	Nan
väntar	sugaya	Nan
väntas	filayay	Nan
väntat	filayay	Nan
väpnad	hubaysan	None
väpnade	hubaysan	None
värd	marti	None
väntan	sugaya	Nan
vänner	asxaabta	Nan
vännen	lover	Nan
vänder	waji	None
väldiga	badan	None
väldigt	aad	None
välfärd	daryeelka	Nan
välgörenhet	sadaqo	None
välja	xulo	Nan
väljas	la	None
väljer	xulo	Nan
väljs	la	None
välkänd	yaqaan	None
välkända	yaqaan	None
välmående	barwaaqo	None
välstånd	fayoobaanta	Nan
vän	saaxiib	None
vända	leexo	Nan
vände	leexday	None
värde	qiimaha	None
värdefulla	leh	None
värden	qiyamka	Nan
värderingar	qiyamka	Nan
värnplikt	ciidanka	None
värnpliktiga	rukhsadaha	Nan
värre	xun	None
värsta	xumaa	None
värt	mudan	None
värvade	xigasho	Nan
väsen	nuxurka	Nan
väsentligt	leh	None
väska	boorso	Nan
väst	galbeed	None
västbanken	galbeed	None
västberlin	galbeedka	None
väster	galbeedka	None
västerbottens	västerbottens	Nan
västergötland	västergötland	Nan
värmlands	cusub	None
västerländska	galbeedka	None
värmland	värmland	Nan
värme	kuleyl	Nan
värdet	qiimaha	None
värld	adduunka	None
världen	adduunka	None
världens	aduunka	None
världsarv	aduunka	None
världsarvslista	aduunka	None
världsbanken	adduunka	None
världsdel	qaaradda	None
världshälsoorganisationen	aduunka	None
världskrigen	adduunka	None
världskriget	adduunka	None
världskrigets	aduunka	None
världsliga	ah	None
världsrekord	adduunka	None
världsturné	adduunka	None
värmestrålningen	shucaac kuleylka	Nan
skilsmässa	furiin	Nan
turkarna	turki	None
turistmål	dalxiis	None
stjärna	xiddig	Nan
stjärnan	xiddig	Nan
stjärnans	xiddig	Nan
stjärnor	xiddigo	Nan
stjärnornas	astaan	None
stockholm	stockholm	None
stjäla	xado	Nan
stockholms	khamriga	Nan
stoft	boodh	Nan
stol	kursi	Nan
stolpiller	suppository	Nan
stommen	jirka	None
stop	jooji	Nan
stopp	jooji	Nan
stod	ahaa	None
stimulerar	kiciya	Nan
stimulera	kicin	Nan
stimulans	wax	None
stenar	dhagxaanta	Nan
stephen	istefanos	Nan
steve	steve	Nan
steven	steven	Nan
stewart	stewart	Nan
stieg	adkeyn	Nan
stift	pin	Nan
stiftelsen	aasaaska	None
stig	dariiqa	Nan
stiga	kac	Nan
stigande	kacaya	Nan
stiger	kacaya	Nan
stilar	qaababka	None
stilen	qaabka	None
stilla	wali	None
stoppa	jooji	Nan
sten	dhagax	None
stoppade	jooji	Nan
stora	weyn	None
strand	xeebta	None
stranden	xeebta	None
strategiska	istiraatiijiyadeed	Nan
stratton	stratton	Nan
strax	kaliya	None
streck	xariiq	Nan
straffet	rigoore	Nan
stred	la	None
stress	xigasho	Nan
stressorer	murugada	Nan
strid	dagaal	None
strida	dhac	None
stridande	dagaal	None
striden	dagaal	None
street	wadada	None
straff	rigoore	Nan
story	sheeko	None
stortorget	stortorget	Nan
storbritannien	uk	Nan
storbritanniens	uk	Nan
store	dukaan	None
stores	dukaamada	Nan
storhetstid	weynaan	Nan
storkors	weyn	None
storlek	cabir	None
storleken	cabir	None
storm	duufaan	None
stormakt	weyn	None
stormakter	awoodaha	None
stormakterna	weyn	None
stormaktstiden	weyn	None
storstäder	waaweyn	None
stort	weyn	None
stor	weyn	None
steget	tallaabo	Nan
steg	tallaabo	Nan
stefan	stefan	Nan
stammar	noocyada	None
stammarna	noocyada	None
stan	magaalada	None
stand	istaag	Nan
standard	heerka	None
stanley	stanley	Nan
stam	qabiil	None
stanna	joog	None
stannar	jooji	Nan
stark	leh	None
starka	leh	None
starkare	badan	None
starkast	badan	None
starkaste	badan	None
stannade	joogtay	None
stallone	caato	None
stalins	stalin	Nan
stalin	stalin	Nan
staden	magaalada	None
stadens	magaalada	None
stadigt	adag	None
stadion	garoon	None
stadium	marxalad	None
stadsbild	magaalada	None
stadsdel	degmo	None
stadsdelar	xaafadaha	None
stadsdelarna	degmooyinka	None
stadsdelen	xaafad	None
stadshus	magaalada	None
stadskärna	xarunta	None
stadskärnan	xarunta	None
stadsparken	magaalada	None
staffan	staffan	Nan
starkt	leh	None
start	bilow	None
starta	bilow	None
startade	bilaabay	None
stats	gobol	None
statschef	dowlada	None
statschefen	dowlada	None
statskupp	afgambi	None
statsmakten	gobolka	None
statsminister	wasaare	None
statsministern	wasaare	None
statsreligion	gobolka	None
statsskick	dowladda	None
statsöverhuvud	dowlada	None
status	xaalad	Nan
staty	taallada	Nan
statyn	taallada	Nan
stavning	higgaadinta	Nan
stavningen	higgaadinta	Nan
statligt	gobol	None
strider	dagaalo	None
statliga	dawladnimo	None
statistiska	tirakoob	None
startades	bilaabay	None
startar	bilow	None
startat	bilaabay	None
starten	bilow	None
stat	gobol	None
state	gobolka	None
statens	gobol	None
stater	gobollada	None
staterna	gobollada	None
staternas	gobollada	None
states	gobolada	None
station	saldhigga	None
stationen	saldhigga	None
stationer	saldhigyada	Nan
statistik	tirakoobka	Nan
statlig	gobolka	None
stad	magaalada	None
striderna	dagaalo	None
strikt	adag	None
stå	istaag	Nan
stående	taagan	None
stål	birta	None
stålgemenskapen	steel steel	Nan
stånd	istaag	Nan
ståndpunkt	booska	Nan
stätta	jilicsan	None
står	taagan	None
stöd	taageero	None
stödde	taageeray	Nan
stöder	taageeraya	Nan
stödet	gargaar	None
stödja	taageero	None
stödjer	taageeraya	Nan
stått	istaagay	None
stärktes	xoojiyay	Nan
stärkte	la	None
stärkelse	istaarij	Nan
ställning	booska	Nan
ställningar	jagooyinka	Nan
ställningen	goolal	Nan
ställs	waa	None
ställt	dhigay	None
stämma	kulan	None
stämmer	sax	None
ständerna	degmooyinka	None
ständig	ah	None
ständiga	istaag	Nan
ständigt	ah	None
stänga	xir	None
stängdes	xidhan	Nan
stängt	xidhan	Nan
stärka	xoojin	Nan
stöds	taageeray	Nan
stället	halkii	None
störningar	cilado	Nan
störst	badan	None
super	super	None
supportrar	taageerayaasha	None
sur	dhanaan	None
susan	susan	Nan
sushi	sushi	Nan
sutra	sutra	Nan
sundsvalls	sundsvall	Nan
suttit	fadhiistay	None
suveräna	boqornimo	Nan
suveränitet	gobanimada	Nan
sv	en	None
svag	ah	None
svaga	ah	None
svagare	ah	None
suverän	boqornimo	Nan
sundsvall	sundsvall	Nan
sund	cod	None
sun	qorrax	Nan
största	weyn	None
störta	afgembi	Nan
störtades	lasaaray	Nan
stöter	orod	None
stött	taageeray	Nan
stövare	harraad	None
substantiv	magac	None
successivt	ah	None
succé	guul	None
sudan	sudan	None
sugga	beero	None
sultanen	suldaan	None
summa	qadarka	None
summan	isugeyn	Nan
summer	buuq	None
större	weyn	None
ställer	hoos	None
ställen	goobaha	None
ställe	meel	None
strömmar	hadda	None
strömmen	hadda	None
strömning	qulqulka	Nan
strömningar	hadda	None
stuart	stuart	Nan
student	arday	None
ström	hada	None
studenter	ardayda	None
studera	waxbarasho	None
studerade	bartay	None
studerar	waxbarasho	None
studeras	bartay	None
studerat	bartay	None
studie	waxbarasho	None
studenterna	ardayda	None
strålningen	shucaac	Nan
strålning	shucaac	Nan
strävhårig	leh	None
strikta	adag	None
strindberg	strindberg	Nan
strindbergs	strindbergs	Nan
struktur	qaab	None
strukturen	qaab	None
strukturer	dhismayaasha	None
sträckan	dariiqa	Nan
sträcker	kordhiyaa	Nan
sträckor	jidadka	Nan
sträckte	fidiyey	None
stränder	xeebaha	None
sträng	xarig	Nan
stränga	daran	None
strävan	raadinta	Nan
strävar	dadaal	None
studien	waxbarasho	None
studier	waxbarasho	None
studierna	waxbarasho	None
studiet	waxbarasho	None
styrelse	gole	Nan
styrelsen	guddiga	None
styrelseskick	dowladnimada	Nan
styret	irridda	Nan
styrka	xoog	None
styrkan	xoog	None
styrkor	xoojinta	None
styrkorna	ciidamada	None
styrs	la	None
städer	magaalooyinka	None
städerna	magaalo	None
ställa	gelin	None
ställas	diyaarisay	Nan
ställde	dhigay	None
ställdes	diyaarisay	Nan
styre	sharci	None
stridigheter	murannada	Nan
styrdes	la	None
styras	la	None
studio	istuudiyaha	Nan
studioalbum	album studio	Nan
studioalbumet	album studio	Nan
studion	istuudiyaha	Nan
studios	istuudiyaha	Nan
stulna	la	None
stund	halka	None
stundom	qaar	None
stupade	dhacday	None
sture	adkeysi	Nan
stycke	sadarka	Nan
stycken	gogo &#39;	Nan
styr	xakamayn	Nan
styra	hagitaan	Nan
styrande	xukumid	Nan
styrde	xukumaa	Nan
stabilitet	xasiloonida	None
stabila	deggan	None
stabil	deggan	None
slutade	dhammaaday	Nan
slutar	dhammaado	Nan
slutat	dheer	None
slutet	dhamaadka	None
slutgiltiga	dambeeya	None
slutliga	dambeeya	None
sluta	jooji	Nan
slutligen	ugu	None
slutsatsen	gabagabeeyey	Nan
slutsatser	gunaanad	Nan
släkt	reerka	None
släkten	dhalid	Nan
släktet	hidde	Nan
släkting	qaraabo	Nan
slutsats	gabagabo	Nan
slut	dambeeya	None
slovenska	slovenian	Nan
slovenien	slovenia	Nan
slag	ah	None
slaget	istaroog	Nan
slagit	garaacay	None
slags	ah	None
slavar	addoomo	None
slaveriet	addoonsiga	Nan
slaviska	slavic	Nan
slidan	siilka	Nan
slipknot	slknot	Nan
slippa	ilaali	None
slog	garaacid	Nan
slogs	la	None
slott	qalcaddii	Nan
slottet	qalcad	Nan
slovakien	slovakia	Nan
släktingar	qaraabada	Nan
sköttes	orday	None
släktskap	xiriirka	None
släppas	daayay	None
smguld	smguld	Nan
smith	smith	Nan
smitta	caabuq	Nan
smycken	dahabka	None
smält	dhalaalay	Nan
smärta	xanuun	None
smeknamnet	naaneys	Nan
små	yar	None
smålands	smålands	Nan
småningom	tartiib tartiib	Nan
snabb	soon	None
snabba	leh	None
snabbare	dhakhso	None
snabbast	dhakhso	None
småland	småland	Nan
smeknamn	naaneys	Nan
smallwood	yar	None
smala	dhuuban	Nan
släpper	sii	None
släpps	daayay	None
släppt	daayay	None
släppte	daayay	None
släpptes	daayay	None
släppts	daayay	None
slå	garaacid	Nan
slår	garaacid	Nan
slås	wareejiyay	None
slåss	la	None
slöt	xidhan	Nan
slöts	shaabadaysan	Nan
sm	sm	Nan
smak	dhadhan	Nan
smaken	dhadhan	Nan
släppa	daadasho	Nan
sköts	toogasho	None
sköter	maamusho	None
sköta	xamili	Nan
skorpan	qolof	Nan
skotsk	scottish	Nan
skotska	scottish	Nan
skott	toogasho	None
skottland	iskodland	Nan
skov	soo	None
skor	kabaha	None
skrev	qoray	None
skrift	qoraal	None
skriften	maya.	Nan
skrifter	qoraallada	Nan
skrifterna	maya	Nan
skriftliga	qoran	None
skriva	qor	Nan
skrevs	ogast	Nan
skolorna	iskuulada	None
skolor	iskuulada	None
skolgång	iskuul dhigashada	Nan
skivan	disc	None
skivbolag	sumad	Nan
skivbolaget	sumad	Nan
skivkontrakt	heshiiska	None
skivor	discs	Nan
skivorna	discs	Nan
skjuta	toogasho	None
skjuten	toogasho	None
skjuter	toogashada	Nan
skog	kaymaha	None
skogar	kaymaha	None
skogarna	kaymaha	None
skogen	kaymaha	None
skola	dugsiga	None
skolan	dugsiga	None
skrivas	daabacan	Nan
skriven	qoran	None
skriver	qor	Nan
skrivet	re	Nan
skyskrapor	jaranjarooyinka	Nan
skäl	sabab	None
skär	feejignaan	Nan
skära	gooyaa	Nan
skärgård	archipelago	Nan
skådespelare	jilaa	None
skådespelaren	jilaa	None
skådespelarna	jilayaasha	Nan
skådespelerska	jilaa	None
skåne	skåne	Nan
skånes	scania	Nan
skånska	skånska	Nan
skönhet	qurux	None
skönlitteratur	ah	None
sköt	toogasho	None
skyldig	dambiile	Nan
snabbaste	dhakhso	None
skyddas	ilaaliyo	None
skyddade	ilaaliyo	None
skrivit	qoran	None
skrivits	qoran	None
skrivna	qoran	None
skrivs	daabacan	Nan
skräck	leh	None
skuggan	hooska	Nan
skuld	deyn	Nan
skulden	deyn	Nan
skulder	deyn	Nan
skull	aawadood	Nan
skulle	lahaa	None
skulptur	farshaxan	None
sky	cirka	None
skydd	ilaalin	None
skydda	ilaali	None
skyddar	gaashaanka	None
snabbt	ah	None
snarare	halkii	None
snarast	ah	None
spelen	ciyaaraha	None
spelet	ciyaarta	None
spelfilmer	filimaan	Nan
spelning	gig	Nan
spelningar	muujinaya	None
spelningen	show	Nan
spelats	duubay	None
spets	caarada	Nan
spetshundar	caarada eyga	Nan
spindlar	caaro	Nan
spindlingar	kortinarius	Nan
splittrades	go	None
spontant	ah	None
sport	isboorti	None
spetsen	caarada	Nan
spelat	ciyaaray	None
spelas	ciyaaray	None
spelarna	ciyaartoy	Nan
specifik	ah	None
specifika	ah	None
specifikt	ahaan	None
speglar	muraayadaha	Nan
spektrum	muuqaal	Nan
spektrumet	muuqaal	Nan
spekulationer	fikradaha	Nan
spel	ciyaarta	None
spela	ciyaar	None
spelad	ciyaaray	None
spelade	ciyaaray	None
spelades	duubay	None
spelar	ciyaar	None
spelare	ciyaaryahan	Nan
spelaren	ciyaaryahan	Nan
sporten	dekeda	None
sporter	isboorti	None
spotify	spotify	Nan
spred	faafitaan	Nan
språkets	af	None
språkliga	afafka	None
spänner	duwan	None
spänning	koronto	None
spänningar	voltages	Nan
spänningen	koronto	None
spår	waddo	None
spåra	waddo	None
spåras	dabagashay	Nan
spåren	jeexdin	Nan
spårvagnar	taraamyada	Nan
sr	sr	Nan
sri	sri	None
ss	ss	Nan
st	st	None
språket	af	None
speciella	ah	None
språken	luqadaha	None
språk	af	None
spreds	faafitaan	Nan
sprida	faafitaan	Nan
spridas	faafin	Nan
spridd	kala	None
spridda	faafitaan	Nan
sprider	faafin	Nan
spridit	faafitaan	Nan
spridning	fiditaan	Nan
spridningen	faafin	Nan
sprids	fidaa	Nan
springer	ordaya	Nan
springsteen	gu&#39;ga	Nan
springsteens	guga	None
sprit	jinniyo	Nan
spritt	faafitaan	Nan
språkbruk	ugaarsiga	Nan
svagt	hooseeya	None
speciell	ah	None
special	isbarbar dhig	Nan
socker	sonkorta	None
sofia	sofia	Nan
sofie	sofie	Nan
sokrates	socrates	Nan
sol	qoraxda	None
soldat	askari	None
socken	kaniisad	None
soldater	ciidamada	None
solen	qorrax	Nan
solens	qoraxda	None
solljus	iftiinka qorraxda	Nan
soloalbum	solo	Nan
solsystem	nidaamka	None
solsystemet	nidaamka	None
soldaterna	askarta	None
socialt	bulsho	None
socialistiskt	hantiwadaag	Nan
socialistiska	hantiwadaag	Nan
snart	dhow	None
snitt	gooyaa	Nan
snittet	qaybta	None
snus	dharbaaxo	Nan
snuset	snus	Nan
snö	baraf	None
social	bulsho	None
sociala	bulsho	None
socialdemokrater	bulsho	None
socialdemokraterna	bulshada	None
socialdemokratiska	hantiwadaag	Nan
socialism	hantiwadaag	Nan
socialismen	hantiwadaag	Nan
socialister	hantiwadaagga	Nan
socialistisk	hantiwadaag	Nan
solsystemets	qoraxda	None
solvinden	dabaysha qorraxda	Nan
som	sida	None
somalia	somalia	None
sovjet	soofiyeeti	Nan
sovjetisk	soofiyeeti	Nan
sovjetiska	soofiyeeti	Nan
sovjetunionen	midowgii sofyeeti	Nan
sovjetunionens	midowgii sofyeeti	Nan
spaniel	spaniel	Nan
spanien	isbaanish	Nan
spaniens	isbaanish	Nan
spanjorerna	isbaanishka	Nan
spannmål	badarka	Nan
spansk	isbaanish	Nan
spanska	isbaanish	Nan
sparken	baarkin	Nan
sparta	badbaadin	Nan
spears	warmo	Nan
sover	hurdo	None
specialiserade	leh	None
south	koonfur	None
sound	cod	None
somliga	qaar	None
sommar	xagaaga	Nan
sommaren	xagaaga	Nan
sommarspelen	olombikada	None
sommartid	xilliga xagaaga	Nan
somrar	xagaaga	Nan
somrarna	xagaaga	Nan
son	wiil	None
sonen	wiil	None
sony	sony	Nan
sorg	murugo	Nan
sorter	noocyo	Nan
sorters	noocyada	None
sorts	kaladuwan	Nan
soul	nafta	None
soundtrack	codka	None
turkar	turki	None
svar	jawaab	Nan
svarar	jawaab	Nan
tillämpas	dalbo	Nan
tillämpningar	codsiyada	Nan
tillät	yahay	None
tilläts	yahay	None
tillåta	ogolaan	None
tillåtelse	ogolaansho	Nan
tillämpar	codsashada	Nan
tillåter	ogolaan	None
tillåtna	ogolyahay	None
tillåts	yahay	None
tim	h	None
time	waqtiga	None
timmar	saacado	Nan
timme	saac	Nan
tillåtet	yahay	None
tillämpa	dalbo	Nan
tillägg	dheer	None
tilly	tilly	Nan
tillståndet	gobolka	None
tillsätts	daray	None
tilltagande	kordhaya	Nan
tillträdde	qaatay	None
tillträde	marin	None
tillvaron	jiritaanka	None
tillverka	saar	None
tillverkade	saaray	None
tillverkar	warshadaha	None
tillverkare	soo	None
tillverkas	saaray	None
tillverkning	saar	None
tillverkningen	saar	None
tillväxt	koritaanka	Nan
tillväxten	koritaanka	Nan
tina	dhalaalid	Nan
tillstånd	gobolka	None
ting	waxyaabaha	None
tintin	tintin	Nan
tjänst	adeeg	None
tjänstemän	saraakiisha	None
tjänsten	adeeg	None
tjänster	adeegyada	None
tobak	tubaakada	Nan
tobias	tobias	Nan
tjänare	addoon	None
tog	qaatay	None
tokyo	tokyo	Nan
tolerans	dulqaad	None
tolfte	tobnaad	None
tolka	tarjunto	Nan
tolkade	tarjumida	Nan
tolkar	turjubaanada	Nan
togs	ahaa	None
tjänar	kasbaday	None
tjänade	kasbaday	None
tjäna	adeeg	None
tio	toban	None
tionde	tobnaad	None
tiotusentals	kun	None
titanic	titanic	Nan
titanics	titanic	Nan
titel	cinwaanka	None
titeln	cinwaanka	None
titlar	cinwaanada	Nan
titta	eegid	Nan
tittar	eegaya	Nan
tittarna	daawadayaasha	Nan
tjeckien	czech	Nan
tjeckiska	czech	Nan
tjeckoslovakien	czechoslovakia	Nan
tjugo	labaatan	None
tingslag	maskaxda	None
tillsammans	wada	None
tills	ilaa	None
tillräckligt	filan	None
tidigt	hore	None
tidning	wargeys	Nan
tidningar	wargeysyada	Nan
tidningarna	waraaqaha	Nan
tidningen	wargeys	Nan
tidpunkt	waqti	None
tidigast	hore	None
tidpunkten	waqti	None
tidskrift	joornaal	Nan
tidskriften	joornaal	Nan
tidskrifter	xilliyeed	Nan
tidszon	aag	Nan
tidszoner	waqtiga	None
tidvis	waqtiyada	None
tids	waqti	None
tidigare	hore	None
tidiga	hore	None
tidig	hore	None
the	the	None
theodor	theodor	Nan
theta	tita	Nan
they	iyaga	None
thierry	thierry	Nan
thomas	thomas	Nan
thriller	sarre	Nan
thåström	thåström	Nan
tibet	tibet	Nan
tid	waqti	None
tiden	waqti	None
tidens	marin	None
tider	jeer	None
tiderna	jeer	None
tiders	jeer	None
tiger	tiger	Nan
tigern	shabeel	None
tigrar	shabeellada	Nan
till	ku	None
tillhandahåller	bixinta	None
tillhör	leh	None
tillhöra	leh	None
tillhörande	xiriira	None
tillhörde	lahaa	None
tillhörighet	lahaansho	Nan
tillhört	lahaa	None
tillika	ah	None
tillkom	imaatinka	Nan
tillkommer	doonaa	None
tillkommit	yimaado	None
tillkomst	imaatinka	Nan
tillkännagav	dhawaaqay	None
tillräcklig	filan	None
tillräckliga	filan	None
tillgången	marin	None
tolkas	tarjumay	Nan
tillgångar	hantida	None
tillgängligt	karo	None
tillbaka	dib	None
tillbehör	qalabka	None
tillbringade	qaatay	None
tillbringar	kharash gareeya	Nan
tilldelades	abaalmarin	Nan
tilldelas	abaalmarin	Nan
tilldelats	loo	None
tillfälle	fursad	None
tillfällen	munaasabadaha	Nan
tillfället	hadda	None
tillfällig	ah	None
tillfälliga	ah	None
tillfälligt	ah	None
tillgänglig	karo	None
tillgängliga	karo	None
tillgång	marin	None
thc	thc	Nan
tolkats	tarjumay	Nan
tolkiens	tolkien	Nan
trots	oo	None
trotskij	trotskii	Nan
truman	truman	Nan
trummis	durbaan	None
trummisen	durbaan	None
trummor	durbaan	None
trossamfund	diinta	None
trupp	kooxda	None
trupperna	ciidamada	None
tryck	daabacan	Nan
trycket	cadaadis	None
tryckta	daabacan	Nan
trycktes	daabacan	Nan
trä	qoryaha	Nan
trupper	ciidamada	None
trosbekännelsen	caqiido	Nan
tros	rumeeyey	Nan
tror	ka	None
trianglar	saddexagal	Nan
trigonometriska	trigonometric	Nan
trinidad	trinidad	Nan
tro	aamin	None
trodde	fikir	Nan
troende	rumaystayaal	Nan
troligen	malaha	None
troligt	tahay	None
troligtvis	garaacid	Nan
tron	carshiga	Nan
tronen	carshiga	Nan
tronföljare	dhaxalka	None
tropisk	kuleylaha	Nan
tropiska	kuleylaha	Nan
tropiskt	kuleylaha	Nan
träd	geed	None
triangelns	saddex	None
träda	jahawareer	Nan
träffa	garaacid	Nan
tunga	carrab	Nan
tungt	culus	None
tunisien	tuniisiya	Nan
tunn	dhuuban	Nan
tunna	foosto	Nan
tunnel	tuneel	Nan
tung	culus	None
tunnelbana	hoostiisa	None
tunnlar	tunelada	Nan
tupac	tupac	Nan
tur	nasiib	None
turism	dalxiiska	None
turismen	dalxiiska	None
turister	dalxiisayaasha	None
tunnelbanan	hoostiisa	None
tum	inji	Nan
tsunamier	tsunamis	Nan
tsunami	tsunami	Nan
träffade	kulmay	None
träffades	kulmay	None
träffar	natiijooyinka	Nan
träffas	kulan	None
träffat	kulmay	None
tränade	tababaran	None
tränare	tababaraha	Nan
tränaren	tababaraha	Nan
tränga	fiiso	Nan
tränger	socdaal	None
träning	jimicsi	Nan
trådlös	wireless	None
trött	daalay	Nan
tsar	tsar	Nan
tsaren	czar	Nan
trädde	gelitaanka	Nan
triangeln	saddex	None
triangel	saddex	None
trey	trey	Nan
torde	in	None
torg	labajibaaran	Nan
torget	labajibaaran	Nan
torka	qalalan	Nan
torn	munaarad	Nan
tornen	munaaradaha	Nan
torbjörn	torbjörn	Nan
tornet	munaarad	Nan
torra	qalalan	Nan
torres	torres	Nan
torrt	qalalan	Nan
torsten	torsten	Nan
tortyr	jirdil	Nan
tosh	tosh	Nan
toronto	toronto	Nan
torah	tawreed	Nan
tor	thu	Nan
toppen	kor	None
tolkning	tarjumaad	Nan
tolkningar	fasiraadaha	Nan
tolkningen	tarjumaad	Nan
tolv	toban	None
tom	faaruq	Nan
tomas	tamaandho	Nan
tomma	madhan	Nan
tomt	shirqool	None
ton	t	None
tongivande	leh	None
tony	tony	Nan
top	kor	None
topp	kor	None
toppade	sare	None
toppar	digaagga	Nan
total	wadarta	None
totala	wadarta	None
totalt	wadarta	None
tottenham	tottenham	Nan
transportera	gaadiid	None
transporterar	xambaarsan	Nan
transporteras	gaadiid	None
tre	saddex	None
tredje	saddexaad	None
tredjedel	saddexaad	None
tredjedelar	meel	None
tree	geed	None
treenigheten	trinity	Nan
treenighetsläran	midnimada	None
trend	isbeddel	Nan
trenden	isbeddel	Nan
trettio	soddon	None
trettioåriga	sano	None
tretton	toban	None
transporter	gaadiid	None
tolkien	tolkien	Nan
transport	gaadiid	None
transeuropeiska	toban	None
tour	safar	None
toy	toy	Nan
tradition	dhaqan	None
traditionell	ahaan	None
traditionella	ahaan	None
traditionellt	ahaan	None
traditionen	ahaan	None
traditioner	caadooyinka	Nan
traditionerna	caadooyinka	Nan
trafik	taraafikada	Nan
trafiken	taraafikada	Nan
trafikerade	tahriibiya	Nan
trafikerar	taraafikada	Nan
trafikeras	tahriibiya	Nan
trakten	aag	Nan
transkription	transcript	Nan
that	taasi	None
than	badan	None
thailand	thailand	Nan
säga	dheh	None
sägas	yidhi	None
säger	yidhi	None
sägs	sidee	None
säker	hubaal	None
säkerhet	amniga	None
systrar	walaalo	None
säkerheten	amniga	None
säkerhetsråd	amniga	None
säkerhetsrådet	amniga	None
säkert	hubaal	None
säkra	aamin	None
sälja	iibin	None
säljande	iibinta	Nan
säkerhetspolitik	amniga	None
syster	walaasha	Nan
systems	nidaamyada	Nan
systemet	nidaam	None
syns	muuqda	None
synsätt	u	None
synsättet	u	None
syntes	tusay	Nan
synvinkel	xagal	Nan
syre	oksijiin	Nan
syret	oksijiin	Nan
syrgas	oksijiin	Nan
syrien	siiriya	Nan
syskon	walaalaha	None
sysselsätter	shaqeeya	None
system	nidaam	None
systematik	nidaamyada	Nan
systematiska	nidaamsan	Nan
systematiskt	nidaamsan	Nan
säljas	iibiyay	Nan
synonymt	ah	None
säljer	iibinta	Nan
sällan	dhif	Nan
särskilda	ah	None
särskilt	ahaan	None
säsong	xilli	None
säsongen	xilli	None
säsongens	xilliyeed	Nan
säsonger	xilliyada	Nan
särskild	ah	None
säsongerna	xilliyada	Nan
sätt	dariiqa	Nan
sätta	gelin	None
sättas	daray	None
sätter	dhigeysa	Nan
sättet	dariiqa	Nan
sätts	daray	None
säte	fadhi	Nan
särdrag	muuqaal	Nan
sänktes	dhimay	Nan
sänker	hoose	None
sällskap	shirkad	None
sällskapet	bulsho	None
sällskapshundar	eeyaha xayawaanka	Nan
sällsynt	naadir	Nan
sällsynta	naadir	Nan
sämre	liita	Nan
sämsta	xumaa	None
sända	dir	None
sändas	gudbiyo	Nan
sände	diray	None
sändebud	ergey	Nan
sänder	diraa	None
sändes	diray	None
sänds	gudbiyo	Nan
sänka	hoose	None
säljs	iibiyay	Nan
synnerligen	ahaan	None
synnerhet	ahaan	None
synligt	muuqda	None
svt	svt	Nan
svält	gaajo	None
svärd	seef	Nan
svår	adag	None
svåra	adag	None
svårare	adag	None
sveriges	sweden	None
svårigheter	dhib	None
swahili	swahili	Nan
swan	swan	Nan
sweden	sweden	None
swedish	iswiidhishka	Nan
sweet	macaan	None
swift	swift	Nan
svårt	adag	None
sverigedemokraterna	ah	None
sverige	sweden	None
svensson	smith	Nan
svart	madow	None
svarta	madow	None
svartån	svartån	Nan
svavel	baaruud	Nan
svealand	svealand	Nan
sven	stag	Nan
svensk	iswidish	Nan
svenska	iswidish	Nan
svenskan	iswidish	Nan
svenskans	afka	None
svenskar	swedes	Nan
svenskarna	iswidish	Nan
svenske	iswidish	Nan
svenskspråkiga	af-iswiidish	Nan
svenskt	iswidish	Nan
syd	koonfur	None
sydafrika	afrika	None
sydafrikanska	afrika	None
sydafrikas	afrika	None
symbolen	astaan	None
symboler	calaamadaha	Nan
symboliserar	ah	None
symbolisk	astaan	None
symptom	calaamad	None
symptomen	calaamadaha	Nan
symtom	calaamadaha	Nan
symtomen	calaamadaha	Nan
syn	arag	None
synd	dembiga	None
synder	dembiyada	Nan
syndrom	syndrome	Nan
synen	arag	None
synes	eg	None
synliga	muuqda	None
symbol	astaan	None
så	sidaas	None
syftet	ujeedo	Nan
syfte	ujeedo	Nan
sydamerika	ameerika	None
sydeuropa	yurub	None
sydkorea	koofureed	None
sydliga	koonfurta	None
sydligaste	koonfurta	None
sydost	koonfur-bari	Nan
sydostasien	aasiya	None
sydstaterna	koonfurta	None
sydväst	galbeed	None
sydvästra	koonfur-galbeed	Nan
sydöst	koonfur-bari	Nan
sydöstra	koonfur-bari	Nan
syfta	ujeedada	None
syftade	ujeedo	Nan
syftar	ujeedo	Nan
syften	ujeedooyin	Nan
sådan	sida	None
sådana	sida	None
sådant	sida	None
television	telefishan	Nan
tema	mawduuc	Nan
teman	mawduucyada	Nan
tempel	macbadka	Nan
temperatur	heerkulka	Nan
temperaturen	heerkulka	Nan
telegram	telegram	Nan
temperaturer	heerkulka	Nan
templet	macbudka	Nan
tendens	dabacsanaanta	Nan
tendenser	isbeddelada	Nan
tenderar	eg	None
tenn	tin	Nan
tennessee	tennessee	Nan
tempererat	heerkulka	Nan
telefonen	taleefanka	Nan
telefon	taleefanka	Nan
teknologi	tikniyoolajiyadda	Nan
teater	tiyaatar	Nan
teatern	tiyaatar	Nan
teatrar	tiyaatarada	Nan
tecken	saxeex	Nan
tecknade	saxeexay	Nan
tecknet	saxeex	Nan
ted	ted	Nan
teddy	teddy	Nan
tegel	leben	Nan
teknik	farsamada	None
tekniken	fanka	None
tekniker	yaqaan	None
teknisk	farsamo	None
tekniska	tikniyoolajiyadda	Nan
tekniskt	farsamo	None
tennis	tennis	Nan
tennisspelare	tennis	Nan
teologi	fiqiga	None
teologiska	fiqi	None
terrorister	argagixisada	Nan
terry	terry	Nan
terräng	dhulbahante	None
tesla	teslas	Nan
teslas	teslas	Nan
test	tijaabad	Nan
testamente	axdiga	None
testamentet	axdiga	None
tex	ahaan	None
texas	texas	Nan
text	qoraal	None
texten	qoraal	None
texter	qoraallada	Nan
texterna	qoraallada	Nan
th	th	None
terrorismen	argagixiso	Nan
team	koox	None
terrorism	argagixiso	Nan
territorium	dhul	None
teoretiker	theorist	Nan
teoretisk	ahaan	None
teoretiska	ahaan	None
teoretiskt	ahaan	None
teori	aragti	None
teorier	aragtiyaha	Nan
teorin	aragti	None
termen	muddo	None
termer	shuruudaha	Nan
terminologi	ereybixin	Nan
terrier	dhuxul	None
territoriella	dhuleed	None
territorier	xuduudaha	None
territorierna	xuduudaha	None
territoriet	dhul	None
terror	argagax	Nan
svarade	jawaabay	None
te	shaah	None
taubes	taubes	Nan
söder	koonfur	None
söderut	koonfureed	None
södra	koonfurta	None
söka	raadin	Nan
söker	raadinta	Nan
sökt	la	None
såväl	labadaba	None
sökte	la	None
söndagen	axad	None
sönder	jabay	None
söner	wiilasha	None
t	t	None
ta	qaadan	None
tabell	shaxda	None
sömn	seexo	Nan
såsom	sida	None
sår	boog	Nan
sångerska	fanaan	None
såg	saw	Nan
sågs	arkay	None
sålda	iibiyay	Nan
sålde	iibiyay	Nan
såldes	ahaa	None
således	sidaas	None
sålt	iibiyay	Nan
sålts	iibiyay	Nan
sålunda	sidaas	None
sång	heeso	None
sångare	fanaan	None
sångaren	fanaan	None
sången	heesta	None
sånger	heeso	None
sångerna	heeso	None
tabellen	miis	Nan
tacitus	tacitus	Nan
tack	mahadsanid	Nan
tackade	aqbalay	None
talen	lambarada	Nan
talet	tirada	None
talets	qarnigii	None
talman	madaxweynaha	None
talmannen	madaxweynaha	None
talrika	badan	None
tankar	fikradaha	Nan
tanke	fikir	Nan
tanken	fikir	Nan
tanzania	tanzania	Nan
tappade	lumay	None
tappar	dhibco	Nan
tar	qaadataa	None
tas	waa	None
taube	taleex	None
talat	hadlay	None
taylor	taylor	Nan
talas	hadlay	None
talar	hadlaya	None
tag	halka	None
tagen	qaatay	None
taget	waqti	None
taggar	sumadaha	Nan
tagit	qaatay	None
tagits	qaatay	None
taiwan	taiwan	Nan
taket	saqafka	Nan
takt	heerka	None
taktik	xeelad	Nan
tala	hadal	None
talade	hadlay	None
talades	hadlay	None
talang	hibo	None
talanger	hibo	None
talare	hadalka	None
övriga	kale	None
lucky	nasiib	None
lucas	lucas	Nan
dvärg	dwarf	Nan
dvärgar	dwarves	Nan
dy	dheecaan	None
dygn	maalin	None
dygnet	maalin	None
dyker	boodbooda	Nan
dvs	i.e.	Nan
dylan	dylan	Nan
dynamiska	firfircoon	None
dyrare	ah	None
dyraste	qaalisan	None
dyrt	ah	None
dä	dadka	None
däggdjur	naasaha	None
dylikt	sida	None
dvd	dvd	Nan
duett	duet	Nan
dublin	dublin	Nan
dryck	cab	Nan
drycken	cabitaan	Nan
drycker	cabitaannada	Nan
drygt	dhaaftay	None
dräkt	dhar	None
dröja	libaax	None
dröjde	dhacay	None
dröm	riyo	None
drömmar	riyooyin	Nan
dsmiv	dsmiv	Nan
du	adiga	None
dubai	dubai	None
dubbel	labanlaab	Nan
dubbelt	jeer	None
dubbla	labanlaab	Nan
däggdjuren	dameeraha	Nan
drottningen	boqoradda	Nan
där	halkee	Nan
därefter	markaa	None
dödade	dilay	None
dödades	dilay	None
dödar	dila	None
dödas	dilay	None
dödat	dilay	None
döden	geeri	None
dödad	dilay	None
dödlig	ah	None
dödligt	ah	None
dödsfall	geeri	None
dödshjälp	xisbiga	None
dödsoffer	dhimashada	Nan
dödsorsaken	sababta	None
dödsstraff	ah	None
dödligheten	dhimashada	Nan
döda	dilo	None
död	geeri	None
dö	dhinto	None
däremot	ha	None
därför	darteed	None
däribland	dhex	None
därifrån	ka	None
därigenom	sidaasaa	Nan
därmed	sidaasaa	Nan
därpå	dul	None
därtill	ku	None
därutöver	dheer	None
därvid	sidaasaa	Nan
då	markaa	None
dålig	xun	None
dåliga	xun	None
dåtidens	ah	None
dåvarande	markaa	None
därav	iyada	None
drottning	boqorad	None
drogs	leh	None
drogmissbruk	daroogada	Nan
dominerande	xukumaa	Nan
dominerar	xukumaa	Nan
domineras	xukumaa	Nan
dominerat	xukumaa	Nan
domkyrka	cathedral	Nan
domkyrkan	cathedral	Nan
dominerades	xukumaa	Nan
domstol	maxkamada	None
domstolen	maxkamada	None
don	deeq	None
donald	donald	Nan
donau	reer	None
donna	donna	Nan
dop	baabtiis	Nan
domstolar	maxkamadaha	None
dominerade	xukumaa	Nan
dominera	xukumaa	Nan
dominans	xakamayn	Nan
djurgårdens	xoolaha	None
djävulen	ibliis	Nan
dna	dna	Nan
dns	dns	Nan
dock	kastoo	None
dog	dhintay	None
doktor	dhakhtarka	Nan
dokument	dokumenti	Nan
dokumenterade	caddeeyay	None
dokumentär	dokumenti	Nan
dollar	dollar	Nan
dom	xukun	None
domare	qaadi	None
domaren	xukumaan	Nan
domen	go&#39;aan	Nan
dopamin	dopamine	Nan
dos	qaadasho	Nan
dotter	gabar	None
dottern	gabar	None
drar	jiid	Nan
dras	sawiray	None
dream	riyo	None
drev	eryay	None
drevs	saaray	None
dricka	cab	Nan
dricker	cabitaanka	None
drift	howlgal	None
driva	wadid	Nan
drivande	wadista	Nan
driver	wadista	Nan
drivs	orod	None
drog	daroogada	Nan
drogen	daroogada	Nan
droger	daroogada	Nan
draperi	daah	Nan
dödsstraffet	dil	None
dramer	riwaayadaha	Nan
dramatiska	riwaayad	Nan
downs	hoos	None
dr	dr	None
dra	jiidid	Nan
drabbade	saameeyay	Nan
drabbades	xanuunsaday	None
drabbar	saamaynaya	Nan
drabbas	saameeyay	Nan
drabbat	saameeyay	Nan
drabbats	saameeyay	Nan
drag	astaamaha	None
dragit	doorbiday	Nan
drama	riwaayadaha	Nan
dramat	riwaayadaha	Nan
dramaten	leh	None
dramatiker	riwaayad	Nan
dramatiskt	ah	None
djurgården	djurgården	Nan
dök	noolay	Nan
dömd	qalalan	Nan
eller	ama	None
elton	elton	Nan
elva	toban	None
elvis	elvis	Nan
em	em	Nan
emellan	dhexeeya	None
elitserien	elitserien	Nan
emellanåt	mar	None
emi	emi	Nan
emigrerade	haajiray	None
emil	emil	Nan
eminem	eminem	Nan
emma	emma	Nan
emmanuel	emmanuel	Nan
emellertid	ha	None
eliten	aqoonyahan	None
elit	aqoonyahan	None
elisabeth	elisabeth	Nan
elden	dab	None
electric	koronto	None
elektricitet	koronto	None
elektrisk	koronto	None
elektriska	koronto	None
elektriskt	ahaan	None
elektromagnetisk	elektromagnetic	Nan
elektron	elektaroonig	Nan
elektroner	elektarooni	Nan
elektronik	elektaroonig	Nan
element	element	Nan
eleonora	eleonora	Nan
elever	ardayda	None
eleverna	ardayda	None
elin	elin	Nan
emo	emo	Nan
eld	dabka	None
empati	naxariis	None
en	mid	None
engelsk	ingiriisiga	None
engelska	ingiriisiga	None
engelskan	ingiriisiga	None
engelskans	ingiriisiga	None
engelske	ingiriisiga	None
engelskspråkiga	ingiriisiga	None
engels	somaliska	Nan
engelsmännen	ingiriisiga	None
englands	ingiriiska	None
english	ingiriisiga	None
enhet	cutub	None
enheten	cutub	None
enheter	cutubyo	Nan
enhetlig	labis	Nan
england	ingiriiska	None
engagerade	u	None
engagerad	ku	None
engagemang	ballanqaad	Nan
ena	mid	None
enade	united	None
enades	ogolaaday	None
enastående	ah	None
enat	mideysan	None
enbart	kali	None
encyclopedia	encyclopedia	Nan
enda	kaliya	None
endast	kaliya	None
ende	saar	None
energi	tamar	None
energikälla	tamar	None
energikällor	tamar	None
energin	tamar	None
energy	tamarta	None
empire	boqortooyada	None
ekvatorn	barbaraha	Nan
ekr	a.d	Nan
ekosystem	deegaanka	None
edvard	edvard	Nan
edwall	tafatir	Nan
edward	edward	Nan
edwards	edwards	Nan
edwin	edwin	Nan
effekt	saamayn	Nan
edmund	edmund	Nan
effekten	saamayn	Nan
effekterna	saamaynta	None
effektiv	ah	None
effektiva	ah	None
effektivt	ah	None
efter	dib	None
efterfrågan	dalbasho	Nan
effekter	saamaynta	None
edith	edith	Nan
edison	edison	Nan
edgar	edgar	Nan
dömdes	xukuntay	Nan
döpt	magacaabay	None
döpte	baabtiisay	Nan
döptes	magacaabay	None
dör	dhinta	Nan
dött	dhintay	None
döttrar	gabdhaha	None
e	e	None
earl	dheg	None
earth	dhulka	None
ebba	ebb	Nan
economic	dhaqaale	None
ecuador	ecuador	Nan
ed	dhaar	None
eddie	eddie	Nan
efterföljande	socda	None
efterföljare	raacsan	None
efterhand	dhajin	Nan
efterkrigstiden	postwar	Nan
eiffeltornet	munaaraddii eiffel	Nan
einstein	einstein	Nan
einsteins	einstein	Nan
ej	aha	None
eker	hadlay	None
eklund	eklund	Nan
ekman	ekman	Nan
ekologi	xoolaha	None
ekologiska	ah	None
ekonomi	dhaqaalaha	None
ekonomier	dhaqaalaha	None
ekonomin	dhaqaalaha	None
ekonomisk	dhaqaale	None
ekonomiska	dhaqaale	None
ekonomiskt	ahaan	None
egyptiska	masriyiintii	Nan
dömande	garsoorka	None
egyptens	masar	None
egna	leh	None
efternamn	awoowe	None
eftersom	ilaa	None
efterträdare	guuleystaha	Nan
efterträddes	guuleystay	None
eftervärlden	farcan	Nan
efteråt	kadib	None
egen	leh	None
egendom	hanti	None
egenskap	hanti	None
egenskaper	astaamaha	None
egenskaperna	guryaha	None
egentlig	ah	None
egentliga	ah	None
egentligen	ahaantii	None
eget	leh	None
egypten	masar	None
djuret	xayawaan	None
djurens	xayawaanka	Nan
djuren	xayawaanka	Nan
dagbladet	kasta	None
dagbok	xusuus	None
dagen	maalin	None
dagens	maanta	None
dagliga	kasta	None
dagligen	walba	None
dagars	maalin	None
dagligt	kasta	None
dagsläget	waqtiga	None
dahlén	dahlén	Nan
dahléns	dahlén	Nan
dalar	dooxooyinka	Nan
dalarna	dalarna	Nan
dalí	dali	Nan
dags	waqti	None
dagarna	d	None
dagar	maalmood	None
dag	maalin	None
cover	dabool	Nan
craig	craig	Nan
crazy	waali	Nan
crick	shiil	Nan
cricket	cricket	Nan
criss	criss	Nan
cruz	cruz	Nan
crüe	crüe	Nan
cupen	koob	None
cykel	baaskiil	Nan
cykeln	wareegga	Nan
cyklar	wareegyada	Nan
cypern	qubrus	None
cyrus	cirfiid	Nan
da	da	None
dam	marwo	None
county	degmo	None
damer	marwada	Nan
daniel	daanyeel	Nan
david	daa’uud	Nan
davis	davis	Nan
day	maalin	None
de	ah	None
debatt	dood	None
debatten	dood	None
dave	dajin	Nan
debatter	doodaha	Nan
debutalbum	horeysay	None
debutalbumet	horeysay	None
debuterade	horeysay	None
december	diseembar	None
decennier	sano	None
decennierna	sano	None
debut	horeysay	None
datum	taariikhda	None
datorspel	kombuyuutarka	None
datorn	kumbuyuutar	None
danmark	danmark	Nan
danmarks	danmark	Nan
danny	danny	Nan
dans	dhaanto	None
dansk	dane	Nan
danska	deenish	Nan
danske	deenish	Nan
dark	madoow	Nan
darwin	darwin	Nan
darwins	darwin	Nan
das	das	Nan
data	xogta	Nan
dateras	taariikhdeeyay	Nan
dator	kumbuyuutar	None
datorer	kumbuyuutaro	Nan
dancehall	dhaanto	None
country	wadan	None
counterstrike	ka	None
costa	costa	Nan
chansen	fursad	None
chaplin	cutubka	Nan
charles	charles	None
charlie	charlie	Nan
charlotte	charlotte	Nan
chefen	madaxa	None
chans	fursad	None
chelsea	chelsea	Nan
chicago	chicago	Nan
chile	chile	Nan
chiles	chile	Nan
chili	chili	Nan
choice	xulasho	Nan
choklad	shukulaato	Nan
chi	chi	Nan
channel	channel	None
chandler	chandler	Nan
champagne	shaambo	Nan
census	tirakoobka	Nan
center	xarunta	None
centra	xarumaha	None
central	dhexe	None
centrala	hoose	None
centralamerika	ameerika	None
centralasien	centralasien	Nan
centralbanken	dhexe	None
centraleuropa	bartamaha	None
centralort	kursi	Nan
centralorter	waaweyn	None
centralstation	bartamaha	None
centralt	dhexda	None
centre	xarunta	None
centrum	xarunta	None
chokladen	shukulaato	Nan
chris	chris	Nan
christer	christer	Nan
christian	kiristaanka	Nan
cobain	cobain	Nan
cocacola	coca-cola	Nan
cohen	cohen	Nan
coldplay	qaboojiye	Nan
colin	colin	Nan
colombia	kolombiya	None
colombo	colombo	Nan
colorado	colorado	Nan
colosseum	colosseum	Nan
columbia	columbia	Nan
columbus	columbus	Nan
come	kaalay	Nan
comeback	noqo	None
comet	comet	Nan
cosa	cosa	Nan
club	naadi	Nan
decenniet	sano	None
clinton	clinton	None
claude	claude	Nan
christina	christina	Nan
chrusjtjov	khrushchev	Nan
church	kaniisad	None
churchill	churchill	Nan
cia	biyaa	Nan
cirka	saabsan	None
cirkel	goobaabin	Nan
citat	xigasho	Nan
city	magaalada	None
civil	ah	None
civila	ah	None
civilbefolkningen	rayid	Nan
civilisationen	ilbaxnimo	Nan
civilisationer	ilbaxnimo	Nan
claes	claes	Nan
cliff	gabiga	Nan
decennium	sano	None
deep	dheer	None
define	qeex	Nan
diamond	dheeman	Nan
dianno	dianno	Nan
dickens	dickens	Nan
dickinson	dickinson	Nan
diego	dhinta	Nan
digerdöden	madow	None
diameter	dhexroor	Nan
digital	ah	None
diktator	taliye	None
diktatorn	taliye	None
diktatur	taliye	None
diktaturen	taliye	None
dikter	gabay	None
dillinger	dillinger	Nan
dikt	gabay	None
diamanter	dheeman	Nan
diamant	dheeman	Nan
dialog	wadahadal	None
det	ah	None
detalj	faahfaahin	Nan
detaljer	faahfaahinta	Nan
detroit	detroit	Nan
detsamma	mid	None
detta	tan	None
deuterium	deuterium	Nan
development	horumarin	Nan
diabetes	sonkorow	Nan
diagnos	cudurka	None
diagnosen	cudurka	None
diagnoser	cudurka	None
dialekt	lahjad	Nan
dialekter	lahjadaha	None
dialekterna	lahjadaha	None
dimensioner	cabirrada	Nan
din	aad	None
dinosaurier	dinosaurs	Nan
dinosaurierna	dinosaurs	Nan
distrikt	degmo	None
distriktet	degmo	None
dit	halkaas	None
ditt	aad	None
dittills	hada	None
diverse	duwan	None
division	qaybinta	Nan
divisionen	qaybinta	Nan
dj	dj	Nan
djup	dheer	None
djupa	dheer	None
djupare	dheer	None
djupt	dheer	None
djur	xayawaan	None
djurarter	noocyada	None
distributioner	qaybinta	Nan
desto	ah	None
distribution	qaybinta	Nan
distinkt	duwan	None
diplomatiska	diblomaasiyadeed	Nan
direkt	markiiba	None
direkta	ah	None
direktör	agaasime	None
diskar	saxannada	Nan
diskografi	riwaayad	Nan
diskriminering	takoorid	Nan
diskussion	dood	None
diskussioner	doodaha	Nan
diskutera	hadal	None
diskuterades	hadlay	None
diskuteras	hadlay	None
diskuterats	hadlay	None
disney	disney	Nan
disneys	disney	Nan
distinkta	duwan	None
enighet	heshiis	None
dessutom	kale	None
dessa	kuwan	None
delats	qaybiyey	Nan
delen	qayb	None
delhi	delhi	None
delning	wadaagista	Nan
delningen	garoonka	None
dels	ahaan	None
delat	la	None
delstat	gobolka	None
delstater	gobolada	None
delstaterna	dayn	None
delta	kaqeybgal	Nan
deltagande	kaqeybgal	Nan
deltagare	kaqeybgale	Nan
deltagarna	kaqeybgalayaasha	Nan
delstaten	dhul	None
delas	jabay	None
delarna	qaybo	None
delar	qaybo	None
definiera	qeex	Nan
definierade	qeexay	Nan
definierar	qeexidda	Nan
definieras	qeexay	Nan
definierat	qeexay	Nan
definition	qeexitaan	Nan
definitionen	qeexay	Nan
definitioner	qeexitaanno	Nan
definitivt	xaqiiqdii	Nan
deklarerade	dhawaaqay	None
del	qayb	None
dela	wadaag	Nan
delad	la	None
delade	ahaan	None
delades	abaalmarin	Nan
deltagit	galay	None
deltar	qayb	None
deltog	galay	None
delvis	ahaan	None
densiteten	cufnaanta	Nan
departement	wasaaradda	None
depolarisering	nabaad-guurinta	Nan
depp	depp	Nan
depression	jab	None
depressionen	jab	None
depressioner	jab	None
der	der	Nan
deras	iyaga	None
derivata	soosaarid	Nan
derivatan	soosaarid	Nan
derivator	sooyaal	Nan
design	naqshadeynta	Nan
desmond	desmond	Nan
dess	ay	None
densitet	cufnaanta	Nan
dessförinnan	kahor	None
densamma	ah	None
dennes	uu	None
dem	iyaga	None
demens	waallida	Nan
demo	demo	Nan
demografi	tirakoobka	Nan
demografiska	tirakoobka	Nan
demokrati	dimuqraadiyadda	None
demokratier	dimuqraadiyada	None
demokratin	ah	None
demokratisk	ah	None
demokratiska	ah	None
demokratiskt	ah	None
demonstrationer	banaanbaxyo	Nan
den	ah	None
denna	tan	None
denne	isagu	None
dennis	dennis	Nan
cellerna	unugyada	None
enkel	fudud	None
enkla	fududaan	Nan
folkomröstning	afti	Nan
folkpartiet	dadka	None
folkrepubliken	jamhuuriyadda	None
folkrikaste	badan	None
folkräkning	tirakoobka	Nan
folkräkningen	tirakoobka	Nan
folkmängden	dadka	None
folkslag	dadyowga	Nan
folkvalda	doortay	None
fontsizes	fontsizes	Nan
football	cagta	None
force	xoog	None
ford	dhaafid	Nan
fordon	gaari	None
folktro	sheeko-dhaqameed	Nan
folkmängd	dadka	None
folkmusik	ah	None
folkmun	ah	None
fns	un	None
fokus	diiradda	Nan
fokusera	diiradda	Nan
fokuserade	saaray	None
fokuserar	diiradda	Nan
folk	dadka	None
folke	folke	Nan
folken	dadyowga	Nan
folket	dadka	None
folkets	dadka	None
folkgrupper	bulshooyinka	Nan
folklig	guri-guri	Nan
folkliga	dad	None
folkmord	xasuuq	None
folkmordet	xasuuq	None
form	foom	Nan
fn	u.n.	Nan
format	qaab	None
formel	qaaciddada	Nan
fortsatta	ah	None
fortsatte	waday	None
fortsätta	sii	None
fortsätter	socdaa	None
fortsättning	sii	None
fortsättningen	sii	None
fortsatt	waday	None
forum	madal	Nan
fossila	fossil	Nan
foster	uurjiifka	Nan
fot	cagta	None
fotbeklädnad	kabaha	None
fotboll	cagta	None
fotbollen	cagta	None
fossil	fossil	Nan
fortplantning	taranka	Nan
fortfarande	wali	None
fort	soon	None
formell	ah	None
formella	ah	None
formellt	ah	None
formen	foom	Nan
former	foomamka	Nan
formerna	foomamka	Nan
forna	hore	None
fornnordiska	norse	Nan
forntida	ah	None
forsberg	forsberg	Nan
forskare	cilmi	None
forskaren	cilmi	None
forskarna	saynisyahano	Nan
forskning	baaris	None
forskningen	baaris	None
formatet	qaab	None
flög	duulay	None
flöde	qulqulka	Nan
flyttat	dhaqaaqay	None
fjärde	afraad	Nan
fjärdedel	rubuc	Nan
flagga	calanka	None
flaggan	calanka	None
flaggor	calamado	Nan
flames	olollayaal	Nan
fjädrar	guga	None
flamländska	xalaal	Nan
fler	inbadan	None
flera	ah	None
flertal	badan	None
flertalet	badan	None
flest	badan	None
flesta	badan	None
flandern	flanders	Nan
fjorton	toban	None
fission	fuuqsanaan	Nan
fiske	kalluumeysiga	Nan
finna	hel	Nan
finnas	noqon	None
finner	helo	None
finns	waa	None
finsk	finnish	Nan
finska	finnish	Nan
fira	dabaaldeg	Nan
firade	u	None
firades	u	None
firandet	dabaaldeg	Nan
firar	dabaaldeg	Nan
firas	u	None
fire	dabka	None
fisk	kalluun	None
fiskar	kalluun	None
flicka	gabadh	None
flickan	gabadh	None
flickor	gabdhaha	None
flickvän	ah	None
flygplan	diyaarad	Nan
flygplats	diyaaradaha	None
flygplatsen	diyaaradaha	None
flygplatser	diyaaradaha	None
flygvapnet	cirka	None
flykt	baxsad	Nan
flyktingar	qaxooti	None
flyr	cararaya	Nan
flytande	dareere	Nan
flyter	qulqulka	Nan
flytt	dhaqaaq	None
flytta	dhaqaaq	None
flyttades	dhaqaaqay	None
flyttar	dhaqaaq	None
flyttas	dhaqaaqay	None
flyger	duusho	Nan
fotbollslandslag	cagta	None
flygbolag	diyaaradda	Nan
flyga	duusho	Nan
flight	heerka	None
flitigt	dadaal	None
flod	wabiga	None
floden	wabiga	None
floder	wabiyada	None
floderna	wabiyada	None
flora	ubax	None
florens	florence	Nan
florida	florida	Nan
flotta	maraakiib	Nan
flottan	navy	Nan
floyd	floyd	Nan
fly	baxsad	Nan
flydde	baxsaday	None
flyg	duulimaad	Nan
flygande	duulaya	Nan
finländska	finnish	Nan
fotbollsspelare	cagta	None
fotnoter	qoraallo	Nan
fråga	su’aal	Nan
frågade	weyddiiyey	None
frågan	su’aasha	Nan
frågor	arrimaha	None
frågorna	arrimaha	None
från	ka	None
främste	horreeya	None
frånträde	bixitaan	Nan
fröken	waayey	None
fröväxter	dhirta	None
fss	fss	Nan
fuglesang	fuglesang	Nan
fuktiga	qoyan	Nan
fuktigt	qoyan	Nan
frånvaro	maqnaansho	Nan
främsta	ah	None
främst	badan	None
främre	hore	None
fritt	ah	None
fritz	fritz	Nan
frivillig	ah	None
frivilliga	ah	None
frivilligt	ah	None
frodo	frodo	Nan
from	ka	None
front	hore	None
fronten	hore	None
fru	naag	None
frukt	miro	Nan
fruktade	baqay	None
frälsning	badbaadada	Nan
främja	dallacsiin	Nan
främmande	shisheeye	None
full	buuxa	None
fritid	ah	None
fulla	buuxa	None
fullständiga	buuxa	None
fyller	buuxinta	Nan
fynd	gorgortan	Nan
fynden	helo	None
fyra	afar	None
fyrtio	afartan	Nan
fysik	fisikiska	Nan
fyllde	buuxsamay	Nan
fysikaliska	jir	None
fysiologi	jirdhiska	Nan
fysiologiska	jir	None
fysisk	jir	None
fysiska	jir	None
fysiskt	ahaan	None
fält	duurka	None
fysiker	fiisikiska	Nan
fylla	buuxi	Nan
futharkens	futhark	Nan
fusionen	midnimo	None
fullständigt	buuxda	None
fullt	buuxda	None
fungera	shaqada	None
fungerade	sameeyey	None
fungerande	shaqeynaya	None
fungerar	falalka	None
funktion	muuqaal	Nan
funktionella	shaqeynaya	None
funktionen	shaqo	None
funktioner	howlaha	None
funktionerna	howlaha	None
funnit	helay	None
funnits	helay	None
fursten	amiir	None
fusion	wajiga	Nan
fullständig	buuxa	None
fristående	banaan	None
friska	leh	None
frisk	leh	None
framgångsrik	guul	None
framgångsrika	guul	None
framgångsrikt	leh	None
framgår	caddee	Nan
framsteg	horumar	None
framställa	saar	None
framgången	guul	None
framställning	saar	None
framstående	hore	None
framtid	mustaqbalka	None
framtida	mustaqbalka	None
framtiden	mustaqbalka	None
framträdande	ah	None
framträdanden	waxqabadka	Nan
framställs	diyaarisay	Nan
framgångarna	guulaha	Nan
framgångar	guulaha	Nan
framgång	guul	None
foto	sawir	None
fotografier	qaade	None
foton	sawiro	Nan
fotosyntesen	sawir-qaadis	Nan
fragment	jajab	Nan
fralagen	fralagen	Nan
fram	hore	None
framför	hore	None
framföra	xaadir	Nan
framförallt	ahaan	None
framförde	fuliyay	Nan
framfördes	muujiyey	None
framförs	muujiyey	None
framfört	hore	None
framförts	hore	None
framträdde	muuqday	None
framträder	taagan	None
framåt	soco	None
francis	francis	Nan
fredspris	marin	None
fredspriset	cunno nabadeed	Nan
freedom	xorriyadda	Nan
freja	joe	Nan
frekvens	jeer	None
freud	freud	Nan
fri	ah	None
fria	ah	None
friedrich	friedrich	Nan
frigörelse	xoreynta	None
frigörs	daayay	None
frihet	xorriyadda	Nan
friheten	xorriyadda	Nan
frihetliga	xorriyadda	Nan
friidrott	fudud	None
fredsbevarande	nabad	None
foten	cagta	None
fredrik	fredrik	Nan
freden	nabad	None
francisco	francisco	Nan
franco	franco	Nan
franklin	franklin	Nan
frankrike	faransiiska	None
frankrikes	faransiiska	None
fransk	faransiiska	None
franska	faransiiska	None
franske	faransiiska	None
franskt	faransiiska	None
fransmännen	faransiiska	None
franz	franz	Nan
français	français	None
fred	nabad	None
freddie	freddie	Nan
freddy	freddy	Nan
fredliga	nabad	None
finlands	finland	None
finland	finland	None
fingrar	faraha	None
europas	yurub	None
europe	yurub	None
european	yurub	None
europeisk	yurub	None
europeiska	yurub	None
européer	yurub	None
europarådet	yurub	None
européerna	yurub	None
eus	eu	Nan
eva	uumi	Nan
evangelierna	injiillada	Nan
evangeliska	wacdiye	Nan
evans	evans	Nan
evenemang	dhacdo	None
eurovision	eurovision	Nan
europaparlamentet	wicitaanada	Nan
europacupen	yurub	None
europa	yurub	None
etiken	anshaxa	Nan
etiopien	itoobiya	None
etiopiska	itoobiyaan	None
etiska	anshaxeed	Nan
etnicitet	qowmiyadeed	Nan
etnisk	qowmiyadeed	Nan
etniska	qowmiyadeed	Nan
etniskt	qowmiyadeed	Nan
ett	mid	None
etta	mid	None
etymologi	etymology	Nan
eu	eu	Nan
euro	euro	Nan
euron	euro	Nan
euroområdet	aagga	None
eventuell	ugu	None
etik	anshaxa	Nan
eventuella	wax	None
evert	rogid	Nan
existerande	jira	None
existerar	jira	None
existerat	jiray	None
exklusiv	ah	None
expandera	fidin	None
expansion	fidinta	None
existerade	jiray	None
expansionen	fidinta	None
expeditionen	socdaal	None
expeditioner	safarada	Nan
experiment	tijaabin	Nan
experimenterade	tijaabiyey	Nan
experter	khubarada	None
explosionen	qarax	Nan
expedition	socdaal	None
existera	jiraan	None
existensen	jiritaanka	None
existens	jiritaanka	None
everton	everton	Nan
eviga	ah	None
evigt	weligiis	Nan
evolution	horumar	None
evolutionen	horumar	None
evolutionsteorin	horumar	None
ex	ex	None
exakt	ah	None
exakta	ah	None
examen	shahaado	None
exempel	tusaale	None
exempelvis	tus.	Nan
exemplar	nuqul	Nan
exemplet	tusaale	None
exil	dibad	None
eventuellt	gal	None
etanol	ethanol	Nan
etablerat	aasaasay	None
etablerades	aasaasay	None
epoken	xoog	None
epost	emayl	Nan
er	aad	None
era	erayada	None
eran	erayada	None
erbjuda	bixin	None
epok	xoog	None
erbjuder	dalabyo	Nan
erbjöds	bandhigay	None
erektion	kacsi	Nan
erfarenhet	khibrad	None
erfarenheter	khibradaha	Nan
erhållit	helay	None
erhöll	helay	None
erbjöd	bandhigay	None
epicentrum	xudunta xudunta	Nan
ep	ep	Nan
enzymer	enzymes	Nan
enklare	fudud	None
enklaste	fudud	None
enlighet	waafaqsan	None
enligt	xigtay	None
enorm	weyn	None
enorma	weyn	None
enormt	weyn	None
ens	xitaa	None
ensam	kali	None
ensamma	kali	None
enskild	shaqsi	None
enskilda	shaqsi	None
enskilt	hal	None
enstaka	hal	None
entertainment	madadaalo	Nan
eric	cunsur	Nan
ericsson	ericsson	Nan
erik	erik	Nan
eriksson	eriksson	Nan
ersätts	bedelay	None
erövra	guuleysta	Nan
erövrade	adkaaday	None
erövrades	adkaaday	None
erövring	guul	None
erövringar	guul	None
erövringen	guul	None
estetik	qurxinta	Nan
estetiska	qurxinta	Nan
estland	estonia	Nan
estniska	estoniyan	Nan
et	iyo	None
etablera	aasaasid	Nan
etablerad	aasaasay	None
etablerade	dhaxalka	None
ersättning	beddelaad	Nan
export	dhoofinta	Nan
ersättare	beddelay	Nan
ersatts	bedelay	None
eritrea	eritrea	Nan
erkänd	yahay	None
erkända	yahay	None
erkände	aqoonsaday	Nan
erkänna	qirto	Nan
erkännande	aqoonsi	None
erkänner	aqoonsan	None
erkänt	aqoonsaday	Nan
ernest	ernest	Nan
ernman	ernman	Nan
ernst	ernst	Nan
eros	eros	Nan
ersatt	bedelay	None
ersatte	badalida	Nan
ersattes	bedelay	None
ersätta	beddelo	None
exporten	dhoofinta	Nan
express	muuji	Nan
expressen	muuji	Nan
femton	toban	None
fenomen	ifafaale	Nan
fenomenet	ifafaale	Nan
feodala	feudal	Nan
ferdinand	ferdinand	Nan
fermentering	halsano	Nan
femte	shanaad	None
fernando	fernando	Nan
fester	daweeyaa	Nan
festival	dabaaldag	Nan
festivalen	dabaaldag	Nan
festivaler	ciidaha	Nan
fett	dufan	Nan
ff	ff	Nan
fest	xaflad	Nan
feministiska	naag	None
feminister	dumarka	None
feminismen	dhedig	Nan
fci	fci	Nan
fd	f	None
feber	qandho	Nan
februari	febraayo	None
federal	federaalka	None
federala	federaalka	None
federation	xiriirka	None
federationen	xiriirka	None
fel	khalad	Nan
felaktig	khaldan	Nan
felaktiga	ah	None
felaktigt	ah	None
felix	felix	Nan
fem	shan	None
feminism	dhedig	Nan
fick	helay	None
fiende	cadowga	Nan
fienden	cadowga	Nan
fiender	cadaawayaasha	Nan
filosofer	falsafadayaasha	Nan
filosofi	falsafada	Nan
filosofin	falsafada	Nan
filosofins	falsafada	Nan
filosofisk	ahaan	None
filosofiska	ahaan	None
fina	ganaax	Nan
final	dhamaadka	None
finalen	dambeeya	None
finansiella	dhaqaale	None
finansiera	dhaqaalaha	None
finansieras	maalgeliyey	Nan
finansiering	maalgelinta	Nan
finanskrisen	dhaqaale	None
finger	farta	None
filosofen	falsafad	Nan
fc	fc	Nan
filmografi	filim	Nan
filmer	filimaan	Nan
fifa	fifa	Nan
figur	jaantus	Nan
figuren	jaantus	Nan
figurer	tirooyinka	Nan
figurerna	sawirro	None
fiktion	ah	None
fiktiv	ah	None
fiktiva	ah	None
fil	feyl	Nan
filip	filiboon	Nan
filippinerna	filibiin	Nan
film	filim	Nan
filmatiserats	duubay	None
filmen	filim	Nan
filmens	filim	Nan
filmerna	filimada	Nan
enkelt	fududaan	Nan
fbi	fbi	Nan
fattigdomen	saboolnimada	Nan
faktorn	factor	Nan
faktum	xaqiiqda	None
fall	kiis	Nan
falla	dhicid	Nan
fallen	kiisaska	Nan
faller	dhicid	Nan
faktorer	arrimaha	None
fallet	kiis	Nan
falska	ah	None
falskt	ah	None
familj	reerka	None
familjen	reerka	None
familjens	reerka	None
familjer	qoysas	Nan
fallit	dhacday	None
faktor	factor	Nan
faktiskt	ahaantii	None
faktiska	ah	None
externa	dibedda	None
extra	ah	None
extrem	ah	None
extrema	ah	None
extremt	u	None
fabriker	warshadaha	None
facebook	facebook	Nan
fackföreningar	ururada	None
facto	facto	Nan
facupen	koobka fa	Nan
fader	aabe	None
fadern	aabe	None
faderns	aabaha	None
fagocyt	phagocyte	Nan
fakta	xaqiiqooyinka	Nan
familjerna	qoysaska	Nan
fan	damm	Nan
fann	helay	None
fanns	ahaa	None
faser	wejiyada	Nan
fast	go&#39;an	Nan
fasta	adag	None
fastigheter	ah	None
fastlandet	weyn	None
fastställa	go&#39;aamiso	Nan
fastställdes	dhigay	None
fastän	oo	None
fat	foosto	Nan
fatta	qaadan	None
fattas	qaatay	None
fattiga	ah	None
fattigare	liita	Nan
fattigaste	ugu	None
fattigdom	saboolnimada	Nan
fasen	marxaladda	Nan
fauna	fauna	Nan
fascistiska	fasiste	Nan
fascismen	fiska	Nan
fans	taageerayaasha	None
fansen	taageerayaasha	None
far	aabe	None
fara	khatar	None
farbror	adeer	None
farfar	awoowe	None
farlig	ah	None
farliga	ah	None
farligt	ah	None
fars	aabaha	None
fart	xawaare	Nan
fartyg	doon	None
fartyget	markab	None
fas	marxaladda	Nan
fascism	faadumo	None
fascisterna	fasixiintii	Nan
fältet	duurka	None
celler	unugyada	None
cellen	qolka	Nan
arvid	arvid	Nan
asiatiska	aasiya	None
asien	aasiya	None
aspekt	dhinac	None
aspekter	dhinacyada	None
aspergers	asperger	Nan
arvet	dhaxalka	None
assistent	kaaliye	Nan
assyriska	reer	None
asterix	asterix	Nan
asteroidbältet	suunka asteroid	Nan
asteroider	asteroids	Nan
aston	aston	Nan
astrid	astrid	Nan
assisterande	kaaliye	Nan
arton	toban	None
artisterna	sameeya	None
artister	fanaaniinta	None
arrangemang	abaabul	None
arrangeras	abaabulay	None
arresterades	qabtay	None
arsenal	arsenal	Nan
art	noocyada	None
arten	noocyada	None
arter	noocyada	None
arterna	noocyada	None
arternas	noocyada	None
arthur	arthur	Nan
artikel	qodobka	None
artikeln	maqaalka	Nan
artiklar	qodobbada	Nan
artist	farshaxan	None
artisten	fanaaniinta	None
astronomer	cilmiga	None
arnold	arnold	Nan
astronomi	cilmiga	None
astronomiska	cilmiga	None
augusti	ogast	Nan
auktoritet	amar	None
auktoritära	leh	None
auschwitz	auschwitz	Nan
austin	austin	Nan
australia	australia	None
august	bilicsan	Nan
australian	ahaan	None
australiens	australia	None
australiska	australiyaan	Nan
autism	autism	Nan
automatiskt	ah	None
autonom	madaxbannaan	None
autonoma	madaxbannaan	None
australien	australia	None
attackerna	weerarada	Nan
attacker	weerarada	Nan
attacken	weerar	None
ateism	diin	None
ateist	diin	None
ateister	laaweyaal	Nan
aten	guud	None
atlanta	atlanta	Nan
atlanten	atlanta	Nan
atlas	atlas	Nan
atmosfär	jawi	None
atmosfären	jawi	None
atom	atom	None
atombomben	ah	None
atombomberna	bambooyinka atomka	Nan
atomer	atom	None
atomkärnor	nuclei	Nan
att	ku	None
astronomin	cilmiga	None
arméns	ciidan	None
armén	ciidan	None
arméerna	ciidammada	Nan
använt	loo	None
använts	loo	None
apartheid	kala	None
apollo	apollo	Nan
april	abriil	None
ar	waa	None
används	loo	None
arab	carab	None
araber	carab	None
araberna	carab	None
arabisk	carab	None
arabiska	carabi	None
arabvärlden	carab	None
arbeta	shaqada	None
arabemiraten	uae	Nan
användningsområden	codsiyada	Nan
användningen	isticmaal	None
användning	isticmaal	None
antoinette	antoinette	Nan
antonio	antonio	Nan
antropogen	anthropogenic	Nan
antyder	tilmaamaysa	Nan
anus	futada	Nan
använda	isticmaal	None
användande	isticmaalka	None
användandet	isticmaal	None
användare	adeegsade	Nan
användaren	adeegsade	Nan
användas	loo	None
användbar	leh	None
användbara	leh	None
använder	isticmaalka	None
användes	loo	None
arbetade	shaqeeyay	None
arbetar	shaqeeya	None
arbetare	shaqaale	None
arbetarklassen	shaqeeya	None
arkeologiska	taariikhyahan	None
arkitekt	naqshadeeye	Nan
arkitekten	naqshadeeye	Nan
arkitekter	naqshadaha	Nan
arkitektur	dhisme	None
arkitekturen	dhisme	None
arkiv	feyl	Nan
arlanda	arlanda	Nan
arm	gacanta	None
armar	hubka	None
armenien	armenia	Nan
armeniska	armeniyaan	Nan
army	ciidan	None
armé	ciidan	None
arméer	ciidammada	Nan
aristoteles	aristotle	Nan
autonomi	madax-bannaanida	Nan
aristokratin	sharaf	None
argentina	argentina	Nan
arbetat	shaqeeyay	None
arbete	shaqada	None
arbeten	shaqooyinka	None
arbetet	shaqada	None
arbetsgivare	loo	None
arbetsgivaren	loo	None
arbetskraft	foosha	Nan
arbetslöshet	shaqo	None
arbetslösheten	shaqo	None
arbetsplats	shaqada	None
area	aag	Nan
arean	aag	Nan
arena	garoon	None
arenan	garoon	None
arg	xanaaqsan	Nan
argument	dood	None
antogs	korsaday	Nan
av	ee	None
avancerad	horumarsan	Nan
bandmedlemmarna	kooxda	None
bank	bangiga	None
banker	bangiyada	Nan
banor	waddooyinka	Nan
baptism	baabti	Nan
bar	bar	None
bandmedlemmar	kooxda	None
bara	kaliya	None
barbro	barbro	Nan
barcelona	barcelona	Nan
barcelonas	barcelona	Nan
barndom	caruurnimada	Nan
barnen	carruurta	None
barnens	carruurta	None
barack	xeryahooda	Nan
bandets	guuto	Nan
bandet	guuto	Nan
banden	guuto	Nan
bakgrund	asalka	None
bakom	gadaal	None
bakterier	bakteeriyada	Nan
bakåt	gadaal	None
balans	dheelitirka	Nan
balansen	dheelitirka	Nan
balkan	laambad	Nan
balkanhalvön	balkan	Nan
baltikum	balfiyo	Nan
baltimore	baltimore	Nan
baltiska	baltigga	Nan
bana	dariiqa	Nan
banan	mooska	None
banbrytande	u	None
band	guuto	Nan
barnet	cunug	Nan
baker	bakhaarka	Nan
barnets	cunug	Nan
barns	cunug	Nan
bayern	bavaria	Nan
bbc	bbc	None
be	weydiiso	None
beatles	beatles	Nan
bebott	deganaan	Nan
bebyggelse	dhismayaasha	None
bay	bay	None
bebyggelsen	dhismayaasha	None
beckham	beckham	Nan
bedrev	sameeyay	None
bedriva	qaado	None
bedriver	xambaarsan	Nan
bedrivs	sameeyay	None
bedöma	qiimee	Nan
beck	garoonka	None
batman	batman	Nan
basket	koleyga	None
basisten	bassist	Nan
baron	baron	Nan
barrett	barrett	Nan
barry	barry	Nan
bars	bar	None
bart	analog	Nan
bas	saldhig	None
basen	saldhig	None
baser	saldhigyada	Nan
baserad	ku	None
baserade	ku	None
baserar	saldhig	None
baseras	ku	None
baserat	ku	None
basis	gundhig	Nan
basist	bassist	Nan
barney	barney	Nan
baháí	bahaa&#39;i	Nan
baháulláh	bahaa&#39;ullah	Nan
bahamas	bahamas	Nan
avrättning	dil	None
avrättningar	ah	None
avrättningen	dil	None
avsaknad	la&#39;aanta	Nan
avsaknaden	la&#39;aanta	Nan
avsattes	dhigaya	None
avrättades	fuliyay	Nan
avsedd	talagalay	None
avseende	ixtiraam	Nan
avseenden	ixtiraam	Nan
avser	jeedaa	None
avses	gudbiyey	Nan
avsett	talagalay	None
avsevärt	weyn	None
avsedda	talagalay	None
avlägsna	saar	None
avlidna	dhintay	None
avlidit	dhinta	Nan
avancerade	casriyeysan	Nan
avbrott	go	None
avbryta	baajin	Nan
avbröts	bakhtiyey	Nan
avel	taranka	Nan
avfall	qashin	Nan
avgick	is	None
avgå	is	None
avgör	go&#39;aamiya	Nan
avgöra	go&#39;aamiso	Nan
avgörande	ah	None
avgörs	go&#39;aamiyay	Nan
avhandling	aragti	None
avkomma	farac	None
avled	dhintay	None
avsikt	ujeedo	Nan
avsikten	ujeedo	Nan
avskaffa	tirtirid	Nan
avskaffade	la	None
avtar	dhac	None
avvikande	ahayn	None
avvikelser	ahayn	None
avvisade	diiday	None
avvisar	diido	None
awards	abaalmarino	Nan
axel	garabka	Nan
axelmakterna	dhidibka	Nan
axl	axl	Nan
azerbajdzjan	azerbaijan	Nan
azidgrupp	kooxda	None
b	b	None
babylon	baabuloon	Nan
bad	dabaasha	Nan
bagge	wan	None
avtalet	heshiis	None
avalanche	avalanche	Nan
avtal	heshiis	None
avsätta	dhinac	None
avskaffades	la	None
avskaffande	joojinta	Nan
avskaffandet	baabi&#39;inta	Nan
avsluta	dhamaadka	None
avslutade	dhammaaday	Nan
avslutades	dhammaystiray	Nan
avslutas	dhammaado	Nan
avslutat	dhammaaday	Nan
avslöjade	qaaday	None
avsnitt	qaybta	None
avsnitten	qaybaha	None
avsnittet	qaybta	None
avstå	diidid	Nan
avstånd	masaafada	None
avståndet	masaafada	None
avsåg	xiriira	None
antog	korsaday	Nan
antisemitismen	ah	None
antisemitism	ah	None
albumen	album	Nan
albumet	album	Nan
albumets	album	Nan
alces	alces	Nan
aldrig	marna	None
ale	ale	Nan
album	album	Nan
alex	alex	Nan
alexanders	alexanders	Nan
alexandra	alexandra	Nan
alexandria	alexandria	Nan
alf	alf	Nan
alfa	alfa	Nan
alfabet	alifbeetada	Nan
alexander	alexander	Nan
albert	albert	Nan
albanska	albaaniyaan	Nan
albanien	albania	None
aktiv	firfircoon	None
aktiva	firfircoon	None
aktivitet	waxqabadka	Nan
aktiviteten	waxqabadka	Nan
aktiviteter	hawlaha	None
aktivt	firfircoon	None
aktuell	hadda	None
aktuella	hadda	None
aktuellt	hadda	None
aktörer	jilayaasha	Nan
akut	ba&#39;an	Nan
al	al	None
alan	alan	Nan
alaska	alaska	Nan
albaner	albaaniyiinta	Nan
alfabetet	alifbeetada	Nan
aktier	saamiyo	Nan
alfabetisk	alifbeetada	Nan
alger	algiers	Nan
allra	aad	None
alls	ahaanba	None
allsvenskan	allsvenskan	Nan
allt	dhamaan	None
alltför	kale	None
alltid	jeer	None
allmänt	ahaan	None
allting	walba	None
alltmer	sii	None
alltsedan	ilaa	None
alltså	dhigo	None
allvar	ah	None
allvarlig	ah	None
allvarliga	ah	None
alltjämt	wali	None
allmänna	guud	None
allmänheten	shacabka	None
allmänhet	dadweynaha	None
algeriet	algeria	Nan
ali	ali	None
alice	alice	Nan
alkohol	khamriga	Nan
alkoholer	khamriga	Nan
alla	dhamaan	None
allan	allan	Nan
alldeles	midig	None
allen	allen	Nan
allians	isbahaysiga	Nan
alliansen	isbahaysiga	Nan
allierad	saaxiibtinimo	None
allierade	isbahaysi	Nan
allierades	isbahaysiga	Nan
allmän	guud	None
alfred	alfred	Nan
aktiebolag	shirkad	None
akondroplasi	achondroplasia	Nan
akon	farmashiye	Nan
accepterade	aqbalay	None
accepterar	aqbal	Nan
accepterat	aqbalay	None
acdc	acdc	Nan
action	ficil	None
ad	a.d	Nan
accepterad	aqbalay	None
adam	aadan	None
adeln	magacyo	None
adhd	adhd	Nan
adjektiv	tilmaam	Nan
administration	maamulka	None
administrationen	maamulka	None
administrativ	maamul	None
adams	aadam	None
acceptera	aqbal	Nan
academy	akadeemiyada	Nan
ac	ac	Nan
abba	abba	Nan
abbas	cabbaas	None
abbey	adeeca	Nan
abc	abc	Nan
abort	soo	None
aborter	soo	None
about	om	Nan
abraham	ibraahim	None
absint	maqan	None
absolut	ahaanba	None
absoluta	ahaanba	None
absolution	saamaxaadda	Nan
absorberas	nuugo	Nan
abstrakta	aan	None
abu	abuu	None
administrativa	maamul	None
administrativt	ahaan	None
adolf	adolf	Nan
adolfs	adolf	Nan
agnetha	agnetha	Nan
agnosticism	agnosticism	Nan
agnostiker	agnostic	Nan
ahmed	axmed	None
aids	aids	Nan
aik	-gtay	Nan
airlines	diyaaradaha	None
airport	diyaaradaha	None
ajax	ajax	Nan
akademi	akadeemiyada	Nan
akademien	akadeemiyada	Nan
akademiens	akadeemiyada	Nan
akademisk	tacliin	None
akademiska	tacliin	None
akc	akc	Nan
agnes	agnes	Nan
allvarligt	ah	None
aggressiv	badan	None
agera	fal	None
adrian	adrian	Nan
advokat	garyaqaan	None
af	af	None
affärer	ganacsiga	None
afghanistan	afgaanistaan	None
africa	afrika	None
afrika	afrika	None
afrikaner	afrikan	Nan
afrikansk	ah	None
afrikanska	ah	None
afrikas	afrika	None
afrodite	afrodite	Nan
aftonbladet	cnn	Nan
age	da	None
agent	wakiilka	None
agerande	dhaqan	None
alperna	alps	Nan
alqaida	al	None
alternativ	kale	None
anne	anne	Nan
annekterade	dib-u-habayn	Nan
annika	amy	Nan
annorlunda	duwan	None
anor	abtirsiinyo	Nan
anordnas	lasiiyay	Nan
annat	kale	None
anorektiker	cuno-cuncun	Nan
another	kale	None
anpassa	is	None
anpassade	habaysan	None
anpassat	qabatimay	None
anpassning	qabsashada	None
anser	tixgelin	Nan
anorexia	anorexia	Nan
annars	kale	None
annan	kale	None
anna	anna	None
anka	digaag	Nan
anklagade	eedeysane	Nan
anklagades	eedeysane	Nan
anklagats	eedeysane	Nan
anklagelser	eedeymaha	Nan
anknytning	isku	None
ankomst	imaanshaha	Nan
anlades	dhigay	None
anledning	sabab	None
anledningar	sababaha	None
anledningarna	sababaha	None
anledningen	sababta	None
anläggningar	dhirta	None
anlände	yimid	None
anländer	yimid	None
anses	tixgelin	Nan
ansetts	tixgelin	Nan
ansikte	waji	None
ansiktet	waji	None
antagits	korsasho	Nan
antagligen	malaha	None
antal	tirada	None
antalet	tirada	None
antar	qaad	None
antarktis	antarctica	Nan
antarktiska	antarctic	Nan
antas	korsasho	Nan
anteckningar	qoraalada	None
anthony	anthony	Nan
antika	jir	None
antiken	hore	None
antikens	ah	None
antingen	midkoodna	Nan
antisemitiska	antisemitic	Nan
antagit	korsaday	Nan
animerade	animated	Nan
anta	korsasho	Nan
ansågs	loo	None
ansluta	xir	None
ansluter	xidhka	None
anslutna	ku	None
anslutning	isku	None
anslöt	biiray	None
anspråk	sheegasho	Nan
ansträngningar	dadaal	None
anställd	shaqaale	None
anställda	shaqaalaha	None
ansvar	mas&#39;uuliyad	Nan
ansvarar	ah	None
ansvaret	mas&#39;uuliyad	Nan
ansvarig	ah	None
ansvariga	ah	None
ansåg	dareemay	None
ansökte	codsatay	Nan
bedöms	filayay	Nan
anhöriga	xigaalkiisa	Nan
angående	saabsan	None
aminosyra	amino acid	Nan
aminosyror	acids amino	Nan
ammoniak	ammonia	Nan
amsterdam	amsterdam	Nan
amy	amy	Nan
ana	ana	Nan
amfetamin	amphetamine	Nan
analsex	falaqsan	Nan
analytisk	falanqayn	Nan
analytiska	falanqayn	Nan
anarkism	xasuuq	None
anarkismen	xasuuq	None
anarkister	kacdoon	None
anarkistiska	jahwareer	Nan
analys	falanqaynta	Nan
amerikas	ameerika	None
amerikanskt	ah	None
amerikanske	ah	None
alternativa	kale	None
alternativt	kale	None
aluminium	aluminium	Nan
am	am	None
amazonas	amazon	Nan
ambassad	safaaradda	Nan
ambitioner	himilooyin	Nan
america	ameerika	None
american	ameerika	None
amerika	ameerika	None
amerikanen	ah	None
amerikaner	mareykan	Nan
amerikanerna	mareykan	Nan
amerikansk	ah	None
amerikanska	us	None
anatolien	anatolien	Nan
anatomi	anatomy	Nan
anc	anc	Nan
anda	ruux	None
anfall	weerar	None
anfalla	weerar	None
anfallet	weerar	None
anfield	anfield	Nan
anföll	weeraray	None
ange	gala	None
angeles	magaalada	None
angelina	angelina	Nan
angels	malaa&#39;igta	Nan
anger	cadee	Nan
anges	banaanka	None
anglosaxiska	anglo-saxon	Nan
angola	angola	None
angrepp	weerar	None
angränsande	xiga	None
andy	andy	Nan
anhängare	taageerayaasha	None
andré	andré	Nan
andres	andres	Nan
andas	neefsasho	Nan
ande	ruuxa	Nan
andel	wadaag	Nan
andelen	boqolkiiba	None
anden	ruux	None
anderna	andes	Nan
anders	anders	Nan
andersson	andersson	Nan
anderssons	andersson	Nan
andlig	ruux	None
andliga	ruux	None
andra	kale	None
andras	kale	None
andre	labaad	None
andreas	andreas	Nan
andrew	andrew	Nan
cellens	qolka	Nan
beethoven	beethoven	Nan
befinna	noqon	None
bra	fiican	None
brad	geesinimo	None
brand	dabka	None
branden	dab	None
brandenburg	brandenburg	Nan
brasilianska	baraasiil	Nan
boy	wiil	None
brasilien	baraasiil	Nan
breaking	jebinta	Nan
bred	ballaaran	None
breda	ballaaran	None
bredare	ballaaran	None
breddgraden	ah	None
bredvid	xiga	None
brasiliens	baraasiil	Nan
boxning	feerka	Nan
bowie	bowie	Nan
botten	hoose	None
bortgång	geeri	None
bortom	baxsan	None
bortsett	dhinac	None
bosatt	degane	Nan
bosatta	deganaanshaha	Nan
bosatte	degay	None
bosnien	boosniya	Nan
bosnienhercegovina	bosnia herzegovina	Nan
bostad	deganaansho	Nan
bostadsområden	xaafadaha	None
boston	boston	Nan
bostäder	guryaha	None
bosättare	degayaasha	Nan
bosättningar	degsiimooyinka	Nan
bott	joogtay	None
brev	boostada	Nan
borta	fog	None
brevet	warqadda	Nan
bridge	buundo	None
brodern	walaal	None
bron	buundo	None
brons	naxaas	Nan
bronsåldern	da&#39;da naxaasida	Nan
bronx	bronx	Nan
brooke	brooke	Nan
broder	walaal	None
brooklyn	brooklyn	Nan
brother	walaal	None
brott	danbi	None
brottet	dambi	Nan
brottslighet	danbi	None
brottslingar	dambiilayaal	Nan
brown	bunni	Nan
bror	walaal	None
broar	buundooyinka	Nan
bro	buundo	None
brittiskt	ingiriiska	None
brinnande	gubasho	Nan
brinner	gubasho	Nan
brist	la&#39;aanta	Nan
bristande	la&#39;aanta	Nan
bristen	la&#39;aanta	Nan
brister	dilaaca	Nan
brita	ingiriiska	None
britannica	britannica	Nan
british	ingiriiska	None
britney	britney	Nan
britter	ingiriiska	None
britterna	ingiriiska	None
brittisk	ingiriiska	None
brittiska	ingiriiska	None
brittiske	ingiriiska	None
brian	brian	Nan
bort	fog	None
borrelia	borrelia	Nan
born	dhashay	None
blomstrade	barwaaqo	None
blott	kaliya	None
blue	buluug	Nan
blues	buluug	Nan
bly	horseed	None
bläckpenna	qalin	None
blommor	ubax	None
blå	buluug	Nan
blått	buluug	Nan
blåvitt	buluug-cad	Nan
bmi	bmi	Nan
bnp	gdp	Nan
bob	bob	Nan
bobby	caajis	None
blåser	afuufa	Nan
bloggar	baloogyada	Nan
blogg	blog	Nan
blodtrycket	dhiig	None
blandat	isku	None
blandning	ah	None
blekinge	dhiigyacab	Nan
blev	noqday	None
bli	noqo	None
blind	indhoole	Nan
blir	helo	None
blivande	mustaqbalka	None
blivit	ahaa	None
block	xannib	Nan
blod	dhiig	None
blodet	dhiig	None
blodiga	dhiiga	Nan
blodkroppar	dhiigga	None
blodtryck	dhiig	None
bodde	noolaa	None
boende	hoy	Nan
bojkott	qaadac	Nan
bok	buug	None
bon	deyn	Nan
bonaparte	bonaparte	Nan
bond	dammaanad	Nan
bonde	beeralleyda	Nan
bonniers	bonniers	Nan
book	buug	None
bor	noolaan	None
bord	miis	Nan
borde	in	None
bordet	miis	Nan
borg	fort	Nan
borgen	damiinasho	Nan
borgerliga	ah	None
borgmästare	magaalada	None
boris	boris	Nan
bomull	suuf	Nan
bruce	bruce	Nan
bomber	bambooyin	Nan
bomb	qarax	Nan
boken	buugga	None
bokförlaget	daabacaadda	Nan
bokstav	warqad	None
bokstaven	warqadda	Nan
bokstäver	xuruuf	Nan
bokstäverna	xuruuf	Nan
bolag	shirkad	None
bolaget	shirkad	None
bolagets	shirkad	None
bolivia	bolivia	Nan
bolivianska	bolivian	Nan
bolivias	bolivia	Nan
bollen	kubad	Nan
bolsjevikerna	bolsheviks	Nan
bolt	xabbad	Nan
bomben	bambo	Nan
blandas	safarka	None
bruk	isticmaal	None
brukar	ah	None
bål	jirridda	Nan
båt	doonta	None
båtar	doomaha	Nan
båten	doontii	Nan
böcker	buugaagta	None
böckerna	buugaagta	None
både	labadaba	None
böhmen	bohemia	Nan
bönder	beeraley	Nan
bönderna	beeraley	Nan
bönor	digir	None
bönorna	digir	None
bör	in	None
bördiga	ah	None
bön	duco	None
båda	labadaba	None
bättre	fiican	None
bäste	gacaliye	Nan
byte	beddel	Nan
byten	byte	Nan
byter	beddel	Nan
bytet	beddel	Nan
byts	bedelay	None
bytt	bedelay	None
bytte	bedelay	None
byttes	bedelay	None
byxor	surwaal	Nan
bägge	labadaba	None
bär	xambaarsan	Nan
bära	xidho	None
bärande	xambaarsan	Nan
bäst	fiican	None
bästa	kor	None
börja	bilow	None
byta	beddel	Nan
började	bilaabay	None
börjar	bilaabmaa	Nan
capitol	caasimad	None
carl	carl	Nan
carlo	carlo	Nan
carlos	carlos	Nan
carlsson	carlsson	Nan
carola	carola	Nan
capita	madaxa	None
carolina	carolina	Nan
cash	lacag	None
casino	khamaarka	Nan
castro	castro	Nan
cd	cd	Nan
cecilia	cecilia	Nan
cell	qolka	Nan
carter	carter	Nan
cant	kariin	Nan
cannabis	xashiishad	Nan
cancer	kansarka	Nan
börjat	bilaabay	None
börje	börje	Nan
ca	ca	Nan
caesar	kaysar	Nan
caesars	kaysar	Nan
café	kafeega	Nan
california	kaliforniya	Nan
calle	wacad	None
cambridge	kaamboonka	Nan
camp	xero	None
campus	kambuyuutar	Nan
can	karaa	None
canada	kanada	None
canadian	kansar	Nan
canaria	canaria	Nan
början	bilaabo	None
bysantinska	byzantin	Nan
byrå	xafiis	None
byn	tuulo	None
bröstet	naas	Nan
bröt	jabsaday	Nan
bröts	jabay	None
bud	dalab	None
budapest	budapest	Nan
buddha	buddha	Nan
bröllopet	aroos	Nan
buddhas	buddha	Nan
buddhismen	buddhism	Nan
buddhister	buddhist	Nan
buddhistiska	buddhist	Nan
buddy	saaxiib	None
budet	dalab	None
budget	miisaaniyad	Nan
buddhism	buddhism	Nan
bröllop	aroos	Nan
bröderna	walaalo	None
bröder	walaalo	None
bruket	dhagxaan	Nan
brushane	ruff	Nan
brutit	jabay	None
bruttonationalprodukt	gdp	Nan
bryssel	brussels	Nan
bryta	jab	None
bryter	jebinta	Nan
bryts	jabay	None
bränder	dab	None
brändes	gubay	None
brännvin	sumcad	Nan
bränsle	shidaal	None
bränslen	shidaal	None
bråk	jajab	Nan
bröd	rooti	Nan
budgeten	miisaaniyad	Nan
budskap	farriin	Nan
budskapet	farriin	Nan
bulgarien	bulgaria	None
byggas	hortagay	None
byggd	dhisan	None
byggda	dhisan	None
byggde	dhisan	None
byggdes	dhisan	None
bygger	dhistaa	Nan
bygget	dhismaha	None
byggnad	dhisme	None
byggnaden	dhismaha	None
byggnader	dhismayaasha	None
byggnaderna	dhismayaasha	None
byggnadsverk	dhismaha	None
byggs	dhisan	None
byggt	dhisan	None
byggts	dhisan	None
byggandet	dhismaha	None
brukade	loo	None
bygga	dhisaan	None
by	tuulo	None
bulgariens	bulgaria	None
bulgariska	bulgaria	None
bundna	xidhay	None
bunny	bunni	Nan
burj	burj	Nan
burma	burma	None
burr	burr	Nan
burton	burton	None
burundi	burundi	None
bush	bush	None
bushadministrationen	bush	None
bushs	bush	None
buss	bas	Nan
bussar	basaska	Nan
butiker	dukaamada	Nan
byar	tuulooyinka	None
blandade	isku	None
blandad	isku	None
blanda	isku	None
bergen	buuraha	None
berger	berger	Nan
berget	buurta	None
bergman	bergman	Nan
bergmans	bergman	Nan
bergqvist	bergqvist	Nan
bergarter	dhagaxyada	Nan
bergskedjan	buuraha	None
berlin	berlin	Nan
berlinmuren	berlin	Nan
berlins	berlin	Nan
bernadotte	bernadotte	Nan
bernhard	bernhard	Nan
bero	tiirsan	None
bergskedjor	buuraha	None
berg	buurta	None
beredd	diyaarisay	Nan
ber	weydiiyaa	Nan
belönades	abaalmarin	Nan
bemärkelse	dareen	None
ben	laf	None
benen	lugaha	None
benfica	benfica	Nan
bengt	bengt	Nan
bengtsson	bengtsson	Nan
benny	benny	Nan
bensin	batrool	Nan
benämnas	magacaabay	None
benämning	magac	None
benämningar	madaahibta	Nan
benämningen	magacaabis	Nan
benämns	yaqaan	None
beordrade	amray	None
berodde	ahaa	None
belägna	tuurid	Nan
beroende	tiirsan	None
beror	tiirsan	None
besegra	guuldarro	Nan
besegrade	adkaaday	None
besegrades	adkaaday	None
besegrat	adkaaday	None
besittning	haysasho	Nan
besittningar	hanti	None
berör	saamaynaya	Nan
beskrev	tilmaamay	None
beskriva	sharrax	Nan
beskrivas	tilmaamay	None
beskriver	faafaahin	Nan
beskrivit	tilmaamay	None
beskrivits	tilmaamay	None
beskrivning	sharraxaad	Nan
beskrevs	tilmaamay	None
berömt	ah	None
berömda	ah	None
berömd	ah	None
bertil	bertil	Nan
beräkna	xisaabiso	Nan
beräknades	xisaabiyay	Nan
beräknar	compute	Nan
beräknas	xisaabiyay	Nan
beräkningar	xisaabinta	Nan
berätta	sheeg	None
berättade	sheegay	None
berättar	yidhi	None
berättas	sheegay	None
berättat	sheegay	None
berättelse	sheeko	None
berättelsen	sheeko	None
berättelser	sheekooyinka	None
berättelserna	sheekooyinka	None
beroendeframkallande	qabatinka	Nan
belägg	caddeyn	Nan
beläget	yaal	None
belägen	yaal	None
begravd	aasay	None
begravdes	aasay	None
begravning	aas	None
begrepp	fikradda	Nan
begreppen	fikradaha	Nan
begreppet	fikradda	Nan
begick	go&#39;an	Nan
begränsa	xad	None
begränsade	xaddidan	Nan
begränsar	xad	None
begränsas	xaddidan	Nan
begränsat	xaddidan	Nan
begränsningar	xaddidaadda	Nan
begär	weydiiyaa	Nan
begränsad	xaddidan	Nan
begav	tegey	None
befälhavare	taliyaha	None
befälet	amar	None
befinner	waa	None
befintliga	jira	None
befogenhet	amar	None
befogenheter	awoodaha	None
befolkade	weyne	None
befolkning	dadka	None
befolkningen	dadka	None
befolkningens	dadka	None
befolkningstillväxt	dadka	None
befolkningstillväxten	dadka	None
befolkningstäthet	dadweynaha	None
befolkningstätheten	dadweynaha	None
befolkningsutveckling	dadka	None
befruktning	bacrinta	Nan
befäl	amar	None
begäran	codsi	None
begärde	codsaday	None
begå	qaad	None
begår	gutaan	Nan
bekant	yaqaan	None
bekostnad	kharash	Nan
bekräftade	xaqiijiyay	Nan
bekräftades	xaqiijiyay	Nan
bekräftar	xaqiijinaya	Nan
bekräftat	xaqiijiyay	Nan
bekämpa	la	None
belagt	leh	None
belgien	beljamka	Nan
belgiens	beljamka	Nan
belgiska	beljamka	Nan
belgrad	belgrade	Nan
bell	dawan	Nan
bella	bella	Nan
belopp	qadarka	None
behövs	yahay	None
beskrivningar	sharraxaadda	Nan
behöver	baahan	None
behövde	yahay	None
begått	go&#39;an	Nan
behandla	dawee	Nan
behandlade	lagu	None
behandlades	lagu	None
behandlar	dawee	Nan
behandlas	lagu	None
behandling	daaweynta	Nan
behandlingar	daaweynta	Nan
behandlingen	daaweynta	Nan
behov	baahi	None
behovet	baahi	None
behålla	hayn	None
behåller	hayn	None
behöll	hayn	None
behöva	baahi	None
behövdes	yahay	None
beskrivningen	sharraxaad	Nan
beskrivs	tilmaamay	None
beskydd	ilaalin	None
bilda	foom	Nan
bildade	sameeyay	None
bildades	sameeyay	None
bildande	sameynta	Nan
bildandet	sameynta	Nan
bildar	foom	Nan
bild	sawir	None
bildas	sameeyay	None
bildats	sameeyay	None
bilden	muuqaal	Nan
bilder	sawirro	None
bilderna	sawirada	None
bildning	sameynta	Nan
bildt	bildt	Nan
bildat	sameeyay	None
bilbo	hiwaayad	Nan
bilar	gawaarida	Nan
bil	baabuur	None
bibel	ah	None
bibeln	baybalka	None
bibelns	baybalka	None
bibliografi	kitaabka	None
bibliotek	maktabad	Nan
bibliska	ah	None
bidra	tabaruc	Nan
bidrag	tabarucaad	Nan
bidragande	tabarucaad	Nan
bidragen	celin	None
bidraget	bixin	None
bidragit	ku	None
bidrar	i	None
bidrog	ku	None
big	weyn	None
bilen	baabuur	None
billboardlistan	bambada	Nan
billiga	ah	None
billy	billy	Nan
biskop	hoggaamiyaha kiniisaddu	Nan
biskopen	hoggaamiyaha kiniisaddu	Nan
bistånd	caawin	None
bit	xoogaa	None
bitar	gogo &#39;	Nan
biträdande	kaaliye	Nan
bitter	qadhaadh	Nan
bjöd	amray	None
björn	adkeysi	Nan
bl	dhex	None
bla	bla	Nan
black	madow	None
blad	caleen	Nan
blanc	madhan	Nan
bland	ah	None
birmingham	birmingham	None
beyoncé	beyoncé	Nan
birk	birk	Nan
birger	birger	Nan
bilmärke	sumadda gawaarida	Nan
binda	xidh	None
bindande	ku	None
binder	xidh	None
binds	xidhay	None
bioetik	biyoolaji	Nan
biogeografi	biogeography	Nan
biografen	shineemo	None
biografer	shineemo	None
biografi	nololeed	None
biologi	bayoolaji	Nan
biologisk	noolaha	None
biologiska	noolaha	None
bipolär	laba-cirifoodka	Nan
bipolära	laba-cirifoodka	Nan
birgitta	birgitta	Nan
befann	helay	None
beväpnade	hubaysan	None
bevis	caddeyn	Nan
bestäms	go&#39;aamiyay	Nan
bestämt	xaqiiqdi	Nan
bestå	kooban	None
bestående	kooban	None
beståndsdelar	maaddooyinka	Nan
består	kooban	None
bestämmer	go&#39;aamiya	Nan
besättningen	shaqaale	None
besöka	booqasho	Nan
besökare	booqdayaasha	None
besöker	booqasho	Nan
besökt	booqasho	Nan
besökte	booqday	None
bet	xoogaa	None
besök	booqasho	Nan
bestämmelser	xeerarka	None
bestämma	go&#39;aamiso	Nan
bestämdes	go&#39;aamiyay	Nan
beskyddare	ilaaliye	Nan
beslut	go’aan	Nan
beslutade	la	None
beslutar	go’aansado	Nan
beslutat	go’aansaday	Nan
besluten	go&#39;aamada	Nan
beslutet	go’aan	Nan
besläktade	xiriira	None
besläktat	xiriira	None
beslöt	la	None
besserwisser	caqliga	None
best	ugufiican	Nan
bestod	koobnaa	None
bestämd	go&#39;aamiyay	Nan
bestämde	go’aansaday	Nan
beta	beta	Nan
betala	bixin	None
betalade	bixinta	None
betalar	bixin	None
betydde	jeedaa	None
betydelse	macnaha	None
betydelsefull	ah	None
betydelsefulla	ah	None
betydelsen	macnaha	None
betydelser	macnaha	None
betyder	macnaheedu	None
betydligt	weyn	None
betyg	fasalka	Nan
bevara	xafido	Nan
bevarad	dhawray	Nan
bevarade	dhawray	Nan
bevaras	dhawray	Nan
bevarat	dhawray	Nan
bevarats	dhawray	Nan
betydande	leh	None
bevisa	caddeyn	Nan
betyda	macnaheedu	None
betraktas	tixgelin	Nan
betalt	dacwad	None
beteckna	magacaabid	Nan
betecknar	matalaya	Nan
betecknas	loo	None
beteckning	magacaabis	Nan
beteckningen	magacaabis	Nan
beteende	dhaqan	None
beteenden	dhaqan	None
betonade	xariiqay	None
betonar	walbahaarka	Nan
betoning	xoojinta	None
betrakta	xiriira	None
betraktade	arkay	None
betraktades	tixgelin	Nan
betraktar	tixgelin	Nan
betraktats	tixgelin	Nan
lucia	lucia	Nan
fälttåg	olole	None
fängelsestraff	xabsi	None
karta	khariidad	Nan
kartan	khariidad	Nan
kartor	khariidadaha	Nan
kaspiska	caspian	Nan
kasta	tuur	None
kastar	tuuraya	Nan
karriären	shaqo	None
katalanska	catalan	Nan
katastrofen	masiibo	Nan
katastrofer	musiibooyinka	Nan
kate	kate	Nan
kategori	qayb	None
kategoriasiens	aasiya	None
kategoribrittiska	ingiriiska	None
katalonien	catalonia	Nan
karriär	shaqo	None
karolinska	karolinska	Nan
karma	karma	Nan
kapitulation	madax-furasho	Nan
kapitulerade	dhiibay	None
kapten	kabtan	Nan
karakteristiska	ahaan	None
karaktär	dabeecad	None
karaktären	dabeecad	None
karaktärer	jilayaasha	Nan
karaktäriseras	lagu	None
kardinal	cardinal	Nan
karibiska	kaaribiyaan	Nan
karin	karin	None
karl	charles	None
karlsson	karlsson	Nan
karlstad	phoenix	Nan
karlstads	karlstad	Nan
kategorier	qaybaha	None
kapitel	cutubka	Nan
kategorieuropas	yurub	None
kategorifödda	dhashay	None
katt	bisad	Nan
kattdjur	feline	Nan
katten	bisadda	Nan
katter	bisadaha	Nan
kazakstan	kazakhstan	Nan
kedja	silsilad	Nan
katolska	kaatoolig	Nan
kedjan	silsilad	Nan
keith	keith	Nan
kejsar	boqortooyada	None
kejsardömet	boqortooyada	None
kejsare	boqor	None
kejsaren	boqor	None
kejsarens	boqor	None
kedjor	silsilado	Nan
katolsk	kaatoolig	Nan
katoliker	kaatoolig	Nan
katolicismen	kaatoolig	Nan
kategorikrigsåret	sanadka	None
kategorikvinnor	qaybta	None
kategoriledamöter	qaybta	None
kategorimusik	nooca	None
kategorimän	kategorimän	Nan
kategorin	qayb	None
kategoriorter	goobaha	None
kategoripersoner	nooca	None
kategorirock	nooca	None
kategorispelare	cayaaraha	None
kategorisvenska	nooca	None
kategorisvenskar	yaqaan	None
kategorityska	jarmalka	None
katekes	karaateeti	Nan
katla	katla	Nan
kategorifiktiva	ah	None
kapitalistiska	raasamaal	Nan
kapitalismens	raasamaal	Nan
kapitalismen	raasamaal	Nan
jönsson	jönsson	Nan
jönssonligan	jönssonligan	Nan
kaffe	kafee	Nan
kaffet	kafee	Nan
kairo	qaahira	Nan
kalender	kalandarka	None
jönköpings	cusub	None
kalendern	kalandarka	None
kalksten	dhagxaan	Nan
kall	qabow	None
kalla	wacid	Nan
kallad	yaqaan	None
kallade	yaqaan	None
kallades	yaqaan	None
kalifornien	kaliforniya	Nan
jönköping	jönköping	Nan
järnvägsnätet	tareenka	Nan
järnvägen	wadada	None
jämföra	isbarbar dhig	Nan
jämföras	isbarbar dhig	Nan
jämförelse	isbarbar dhig	Nan
jämförelser	isbarbar dhig	Nan
jämförelsevis	is	None
jämfört	isbarbar dhig	Nan
jämlikhet	sinnaan	Nan
jämna	jilicsan	None
jämnt	heer	None
jämte	ah	None
järn	bir	None
järnmalm	birta	None
järnväg	wadada	None
järnvägar	jidadka tareenka	Nan
järnvägarna	jidadka tareenka	Nan
kallar	wacid	Nan
kallare	qabow	None
kallas	yaqaan	None
kallat	yaqaan	None
kanalen	kanaal	None
kanaler	kanaalka	None
kanarieöarna	jasiiradaha	None
kandidat	musharrax	Nan
kandidater	murashaxiinta	Nan
kanske	laga	None
kant	gees	None
kantoner	cantons	Nan
kantonerna	cantons	Nan
kaos	fowdo	Nan
kap	cape	None
kapacitet	awood	None
kapital	caasimada	None
kapitalet	caasimada	None
kapitalism	raasamaal	Nan
kanal	kanaal	None
kejserliga	boqortooyadii	None
kanadensiska	kanadiyaan	Nan
kanada	kanada	None
kallats	yaqaan	None
kallblod	qabow	None
kalle	qalfoofka	Nan
kallt	qabow	None
kalmar	kalmar	Nan
kammare	qol	Nan
kammaren	qol	Nan
kamp	halgan	None
kampanil	campanile	Nan
kampanj	olole	None
kampanjen	olole	None
kampen	la	None
kampf	kampf	Nan
kamprad	kamprad	Nan
kan	karaa	None
kanadas	kanadiyaan	Nan
jämför	isbarbar dhig	Nan
keltiska	celtic	Nan
kemikalier	kiimikooyin	Nan
koloni	gumeysiga	None
koloniala	gumeysiga	None
kolonialism	gumeysiga	None
kolonialismen	gumeysiga	None
kolonialtiden	gumeysiga	None
kolonier	gumeystihii	None
kollektivtrafik	dadweynaha	None
kolonierna	gumeystihii	None
koloniserades	gumaysiga	None
koloniseringen	gumeysiga	None
kolväten	hydrocarbons	Nan
kom	yimid	None
koma	kooma	Nan
kombattant	dagaalyahan	Nan
kolonin	gumeysi	None
kollektiv	wadareed	Nan
kollapsade	dumay	None
kollaps	dumin	None
knyta	xerin	Nan
knä	jilibka	Nan
knäppupp	badhamay	Nan
ko	lo&#39;da	Nan
koalition	isbahaysi	Nan
koden	koodh	Nan
koenigsegg	koenigsegg	Nan
koffein	kafeyn	Nan
kognitiv	garashada	None
kognitiva	garashada	None
kokain	kookaha	Nan
kokpunkt	barta	None
kol	dhuxul	None
koldioxid	carbon dioxide	Nan
kolhydrater	karbohaydraytyada	Nan
kombination	darka	None
knutsson	knutsson	Nan
kombinationen	darka	None
kombinerad	darka	None
kommittén	gudi	Nan
kommun	degmo	None
kommunal	degmo	None
kommunala	degmo	None
kommunen	degmo	None
kommuner	degmooyinka	None
kommitté	gudi	Nan
kommunerna	degmooyinka	None
kommunicerar	xiriirka	None
kommunikation	isgaarsiinta	None
kommunikationer	isgaarsiinta	None
kommunism	shuuciyada	Nan
kommunismen	shuuciyada	Nan
kommunismens	shuuciyada	Nan
kommunicera	xiriir	None
kommit	kaalay	Nan
kommissionen	gudiga	None
kommersiellt	ahaan	None
kombinerade	darka	None
kombineras	darka	None
kombinerat	darka	None
kometer	majaajillo	Nan
komiker	majaajillo	Nan
komintern	jawiga	None
komma	kaalay	Nan
kommande	socda	None
kommendör	taliyaha	None
kommentar	faallo	Nan
kommentarer	faallooyinka	Nan
kommenterade	bixiyay	None
kommer	yimaado	None
kommersiell	ganacsi	None
kommersiella	ganacsi	None
kombinationer	isugeynta	Nan
knutpunkt	isgoyska	Nan
knutna	xiran	None
knuten	ku	None
kinesisk	shiine	Nan
kinesiska	shiine	Nan
kings	boqorradii	Nan
kingston	kingston	Nan
kirsten	kirsten	Nan
kiss	dhunkasho	Nan
kinas	kinase	Nan
kjell	kjell	Nan
klan	qabiil	None
klar	caddee	Nan
klara	sameeyay	None
klarade	gudbay	None
klarar	gudub	Nan
klart	caddee	Nan
kl	at	None
kina	kinase	Nan
kim	kim	Nan
kilometer	kiiloomitir	Nan
kemisk	kiimiko	Nan
kemiska	kiimiko	Nan
kemiskt	ahaan	None
ken	ken	Nan
kennedy	kennedy	None
kenneth	kenneth	Nan
kenny	kenny	Nan
kent	kent	Nan
kenya	kenya	None
keramik	dhoobada	Nan
kevin	kevin	Nan
kids	carruurta	None
kiev	kiev	Nan
kill	dil	None
kille	nin	None
klass	fasalka	Nan
klassas	saaray	None
klassen	fasalka	Nan
klasser	fasallo	Nan
klubbar	naadiyada	Nan
klubbarna	naadiyada	Nan
klubben	naadi	Nan
klubbens	naadi	Nan
klubblag	naadi	Nan
klädd	labisan	Nan
kläder	dharka	None
klädsel	labiska	Nan
km	km	None
km²	km²	Nan
knapp	badhanka	Nan
knappast	adag	None
knappt	adag	None
knight	mindiyo	Nan
knut	garabka	Nan
klubb	naadi	Nan
kemi	kiimikada	Nan
klp	klp	Nan
klorofyll	chlorophyll	Nan
klassificera	fasalka	Nan
klassificeras	saaray	None
klassificering	kala	None
klassiker	ah	None
klassisk	ah	None
klassiska	ah	None
klassiskt	ah	None
klaviatur	keyboard	Nan
klimat	cimilada	None
klimatet	cimilada	None
klimatologi	cimilada	None
klippa	gooyaa	Nan
klippiga	weyn	None
klitoris	kintirka	Nan
klockan	gambaleel	Nan
kloster	keniisad	Nan
juventus	juventus	Nan
justice	cadaaladda	None
just	kaliya	None
intresset	dan	None
introducerade	bandhigay	None
introducerades	bandhigay	None
intryck	aragti	None
inträde	gelitaanka	Nan
inträffade	dhacay	None
intresserade	xiiseynaya	Nan
inträffar	dhacdo	None
intäkterna	dakhliyada	Nan
intåg	gelitaanka	Nan
inuti	gudaha	None
invadera	duulaan	None
invaderade	duulay	None
invaldes	doortay	None
intäkter	dakhliga	Nan
intresserad	xiiseynaya	Nan
intressen	danaha	Nan
intresse	dan	None
interna	gudaha	None
international	ah	None
internationell	ah	None
internationella	ah	None
internationellt	ah	None
internet	internetka	None
interstellära	gal	None
intervju	wareysi	Nan
intervjuer	wareysiyo	Nan
intet	maya	Nan
intill	dhaw	None
intog	qaatay	None
intogs	la	None
intressant	leh	None
intressanta	tartamaya	Nan
invandrade	soogalootin	Nan
interaktion	is	None
invandrare	soogalootin	Nan
invasion	duulaan	None
isbn	isbn	Nan
isen	baraf	None
ishockey	ah	None
ishockeyspelare	cayaaryahan hockey	Nan
islam	islaamka	None
islamisk	islaam	None
isberg	barafka	Nan
islamiska	islaam	None
islams	islaamka	None
island	iceland	Nan
isländska	icelandic	Nan
iso	go&#39;doon	Nan
isolerad	go&#39;doon	Nan
isolerade	go&#39;doon	Nan
islamistiska	islaam	None
irländska	irish	Nan
irland	ireland	Nan
iranska	iiraaniyiin	Nan
invasionen	duulaan	None
inverkan	saamaynta	None
investeringar	maalgashiga	Nan
invigdes	furay	None
invigningen	furitaanka	Nan
invånare	deganaan	Nan
invånarna	deganeyaasha	Nan
inåt	gudaha	None
ip	ip	Nan
irak	ciraaq	None
irakiska	ciraaq	None
irakkriget	ciraaq	None
iraks	ciraaq	None
iran	iiraan	None
irans	trans	Nan
invandring	socdaalka	None
inter	dhex	None
intensivt	xoogan	None
intensiva	ah	None
innehav	haysta	None
innehåll	nuxurka	Nan
innehålla	kooban	None
innehållande	kooban	None
innehåller	jira	None
innehållet	nuxurka	Nan
innehas	qabtay	None
innehöll	kooban	None
innerstaden	hoose	None
inom	gudahood	Nan
inre	gudaha	None
inrikes	gudaha	None
inriktad	ku	None
inriktade	ku	None
innersta	gudaha	None
innehar	qaban	None
innehade	qabtay	None
innefattar	kooban	None
inleds	bilaabay	None
inlett	bilaabay	None
inletts	bilaabay	None
inlägg	dhajinta	Nan
inlärning	barashada	None
innan	kahor	None
innanför	gudaha	None
inne	gudaha	None
innebandy	cagta	None
innebar	jeedaa	None
inneburit	jeedaa	None
innebär	macnaheedu	None
innebära	macnaheedu	None
innebörd	macnaha	None
innebörden	macnaha	None
inriktning	is	None
inriktningar	takhasusyo	Nan
inrättades	kor	None
insats	gelin	None
institutet	machadka	None
institutioner	xarumaha	None
institutionerna	xarumaha	None
instruktioner	tilmaamaha	Nan
instrument	qalab	None
inställning	dabeecad	None
insulin	insulin	Nan
insåg	xaqiiqsaday	Nan
inta	qaatay	None
intag	qaadasho	Nan
inte	aha	None
integration	is-dhexgalka	Nan
integritet	daacadnimo	Nan
intellektuella	caaqil	None
intensiv	ah	None
institut	hay&#39;ad	Nan
isolering	dahaarid	Nan
instiftade	aasaasay	None
instabil	aan	None
insatser	dadaal	None
insekter	cayayaanka	Nan
inser	garasho	None
insikt	fahanka	Nan
inslag	element	Nan
inspelad	duubay	None
inspelning	duubista	Nan
inspelningar	duubista	Nan
inspelningarna	duubista	Nan
inspelningen	duubista	Nan
inspiration	dhiirigelin	None
inspirerad	waxyoonay	None
inspirerade	waxyoonay	None
inspirerades	waxyoonay	None
inspirerat	waxyoonay	None
installera	rakibo	Nan
isotoper	go&#39;doomin	Nan
israel	israel	None
israelisk	israa’iil	Nan
jordbävning	dhulgariir	None
jordbävningar	dhulgariirro	Nan
jordbävningen	dhulgariir	None
jorden	dhulka	None
jordens	dhulka	None
jorderosion	guur	None
jordbruket	beeraha	None
jordskorpan	dhul	None
jorge	jorge	Nan
josef	yuusuf	None
joseph	yuusuf	None
josé	josé	Nan
journal	joornaal	Nan
journalist	wariye	None
jordytan	dusha	None
jordbruk	beeraha	None
jordanien	urdun	None
jord	ciid	None
johannes	ayax	Nan
johans	johans	Nan
johansson	johansson	Nan
johanssons	johansson	Nan
john	john	Nan
johnny	johnny	Nan
johnson	johnson	Nan
joker	joker	Nan
jolie	jolie	Nan
jon	ion	Nan
jonas	yoonis	None
jonatan	jonathan	Nan
jonathan	jonathan	Nan
jones	jones	Nan
jonsson	jonsson	Nan
journalisten	wariye	None
journalister	suxufiyiinta	Nan
jr	jr	Nan
ju	the	None
julia	julia	Nan
julian	julian	Nan
julie	julie	Nan
julius	julius	Nan
juni	juun	None
junior	yar	None
jupiter	jupiter	Nan
jupiters	jupiter	Nan
juridik	sharciga	None
juridisk	ah	None
juridiska	ah	None
juridiskt	ah	None
juryn	xeerbeegtida	Nan
juryns	xeerbeegtida	Nan
jussi	jussi	Nan
juli	luulyo	None
johann	johann	Nan
jules	jules	Nan
juldagen	maalinta	None
juan	juan	Nan
judar	yuhuudda	Nan
judarna	yuhuudda	Nan
judarnas	yuhuudda	Nan
judas	yuudas	Nan
jude	yuhuudi	Nan
judendom	yuhuuda	None
judendomen	yuhuudi	Nan
judisk	yuhuudi	Nan
judiska	ah	None
judy	judy	Nan
jugoslavien	yugoslavia	Nan
jugoslaviska	yugoslav	Nan
jul	kirismas	Nan
julafton	habeenka krismaska	Nan
julen	kirismas	Nan
kommunister	shuuciyada	Nan
joey	joey	Nan
joe	joe	Nan
jacksons	jackson	Nan
jacob	yacquub	None
jacques	jacques	None
jag	aniga	None
jaga	ugaarsi	Nan
jagar	eryanaya	Nan
jackson	jackson	Nan
jah	jah	Nan
jakt	ugaarsiga	Nan
jakten	ugaarsi	Nan
jamaica	jamaica	Nan
jamaicanska	jamaican	Nan
jamaicas	jamaica	Nan
james	yacquub	None
jakob	yacquub	None
jackie	jackie	Nan
jack	jaakad	Nan
ja	haa	None
israeliska	israa’iil	Nan
israels	israa&#39;iil	Nan
istanbul	istanbul	Nan
istiden	da&#39;da barafka	Nan
istället	halkii,	Nan
isär	reebo	None
italien	talyaaniga	None
italiens	talyaaniga	None
italiensk	talyaani	None
italienska	talyaani	None
iu	na	None
ivan	ivan	Nan
ivar	ivar	Nan
iväg	fog	None
ix	ix	Nan
jan	jan.	Nan
janeiro	janeiro	Nan
januari	janawari	Nan
janukovytj	yanukovych	Nan
jerusalems	yeruusaalem	Nan
jesu	ciise	None
jesus	ciise	None
jihad	jihaadka	None
jim	jim	Nan
jimi	jimi	Nan
jimmy	jimmy	Nan
joachim	yooachim	Nan
joakim	yooyaaqiim	Nan
joan	joan	Nan
jobb	shaqo	None
jobba	shaqada	None
jobbade	shaqeeyay	None
jobbar	shaqada	None
jobbet	shaqada	None
jerusalem	yeruusaalem	Nan
joel	yoo&#39;eel	Nan
jersey	jeer	None
jens	jens	Nan
japan	jabaaniyaan	Nan
japanerna	jabaaniyaan	Nan
japans	jabaan	None
japansk	jabaaniyaan	Nan
japanska	jabaaniyaan	Nan
jarl	jabl	Nan
jason	jason	Nan
java	java	Nan
jazz	jazz	Nan
jean	jean	Nan
jeff	jeff	Nan
jefferson	jefferson	Nan
jehovas	rabbi	None
jennifer	jennifer	Nan
jenny	jenny	Nan
jensen	jensen	Nan
inledningsvis	hore	None
kommunisterna	shuuciyada	Nan
kommunistiska	wadaag	Nan
landskapet	dhulka	None
landskommun	landkommun	Nan
landslag	qaranka	None
landslaget	cagta	None
landsting	degmo	None
lanka	lanka	None
landskapen	gobolada	None
lanserade	bilaabay	None
lanseringen	sii	None
laos	laos	None
larry	larry	Nan
lars	maansooyinka	None
larsson	larsson	Nan
larssons	larsson	Nan
lanserades	bilaabay	None
landskap	dhulka	None
landshövding	gudoomiye	None
landsbygden	baadiyaha	Nan
lagliga	ah	None
lagras	kaydiyay	Nan
lagring	kaydinta	Nan
lagstiftande	sharci	None
lagstiftning	sharci	None
lagstiftningen	sharci	None
lagt	daray	None
lagts	diray	None
laila	laila	Nan
lake	haro	Nan
land	wadanka	None
landet	wadanka	None
landets	ay	None
landområden	dhul	None
lands	wadanka	None
laryngoskop	laryngoscope	Nan
lagförslag	biil	Nan
lasse	lasse	Nan
lat	caajis	None
ledarskap	hogaaminta	Nan
ledda	hogaamiyay	Nan
ledde	hogaamiyay	Nan
leddes	gudbay	None
leden	wadajirka	None
leder	horseedaa	Nan
ledarna	darawallada	Nan
ledger	hoggaamiye	Nan
ledningen	biyomareenka	Nan
leds	gudbay	None
lee	lee	Nan
leeds	leeds	Nan
left|px	|	None
legat	jiifto	Nan
ledning	maaraynta	None
ledaren	hogaamiye	None
ledare	hogaamiye	None
ledande	hogaaminaya	None
latin	laatiin	Nan
latinamerika	america	None
latinamerikanska	isbaanish	Nan
latinet	laatiin	Nan
latinets	laatiin	Nan
latinska	laatiin	Nan
laura	laura	Nan
lava	lava	Nan
lawrence	lawrence	Nan
le	dhoola cadeyn	Nan
led	barta	None
leda	horseed	None
ledamot	wakiilka	None
ledamöter	xubnaha	None
ledamöterna	xubnaha	None
lastbilar	xamuulka	None
lagets	dhinac	None
laget	koox	None
lagerlöf	lagerlöf	Nan
kännetecken	astaamaha	None
kännetecknas	lagu	None
känns	dareemaa	Nan
känsla	dareen	None
känslan	dareen	None
känslig	ah	None
känner	ogaada	Nan
känsliga	ah	None
känt	yaqaan	None
kär	haya	None
kärlek	jacayl	None
kärleken	jacaylka	None
kärna	xudunta	Nan
kärnan	xudunta	Nan
känslor	shucuurta	Nan
kännedom	aqoon	None
känna	dareento	Nan
kände	dareemay	None
kyrka	kaniisad	None
kyrkan	kaniisad	None
kyrkans	kaniisad	None
kyrkliga	kaniisad	None
kyrkor	kaniisadaha	Nan
kyrkorna	kaniisadaha	Nan
kyros	kyro	Nan
källa	isha	None
källan	isha	None
källkod	isha	None
källor	ilo	None
källorna	ilo	None
kämpa	la	None
känd	yaqaan	None
kända	yaqaan	None
kärnkraft	quwada nukliyeerka	Nan
kärnkraftverk	hubka	None
kärnor	koofiyadaha	Nan
kärnvapen	nukliyeerka	Nan
l	l	None
la	la	None
laboratorium	shaybaar	Nan
ladda	rar	Nan
laddade	eedeeyay	None
laddning	dacwad	None
lade	daray	None
lades	qaybsan	Nan
ladin	liin	Nan
lag	sharciga	None
lagar	shuruucda	Nan
lagarna	shuruucda	Nan
lagen	fal	None
lager	saamiga	Nan
lagerkvist	lagerkvist	Nan
kött	hilib	Nan
legend	halyeey	None
körs	orod	None
köra	wadid	Nan
köket	cunnada	Nan
köln	kologne	Nan
kön	galmada	Nan
könen	koollada	Nan
könsorgan	xubnaha	None
könsorganen	xubnaha	None
köp	iibso	None
köpa	iibso	None
köpenhamn	kobanheegan	Nan
köpenhamns	kobanheegan	Nan
köper	iibso	None
köpmän	ganacsatada	None
köpt	iibsaday	None
köpte	iibsaday	None
kör	wadid	Nan
körberg	körberg	Nan
kyrilliska	cyrillic	Nan
legenden	halyeey	None
legitimitet	ahaanshaha	None
liter	litir	Nan
litet	yar	None
litteratur	suugaanta	None
litteraturen	suugaanta	None
litterär	suugaanta	None
litterära	suugaanta	None
liten	yar	None
liv	nolosha	None
liverpool	liverpool	Nan
liverpools	liverpool	Nan
livet	nolosha	None
livets	nolosha	None
livslängd	qofka	None
livsmedel	cuntada	None
livealbum	nool	None
lite	yar	None
litauen	lithuania	Nan
listorna	menus	Nan
linjer	khadadka	Nan
linjerna	khadadka	Nan
linköping	xidhka	None
linköpings	xidhka	None
linné	linnaeus	Nan
linux	linux	None
lisa	lisa	Nan
lisbet	lisbet	Nan
lissabon	lisbon	Nan
lissabonfördraget	lisbon treaty	Nan
list	xarig	Nan
lista	liiska	None
listade	ku	None
listan	liiska	None
listor	liiska	None
livsstil	nololeed	None
linjen	xariiq	Nan
livstid	nolosha	None
ljud	cod	None
londons	london	None
lopp	tartan	Nan
loppet	dhashay	None
lord	sayidow	Nan
loss	dabacsan	Nan
lost	lumiyay	Nan
london	london	None
lotta	raffle	Nan
louise	louise	Nan
louisiana	louisiana	Nan
lovade	qaaday	None
lovat	qaaday	None
lp	lp	Nan
lsd	lsd	Nan
louis	louis	Nan
lokalt	ah	None
lokaler	tas-hiilaadka	Nan
lokala	ah	None
ljudet	cod	None
ljung	heather	Nan
ljungström	ljungstrã¶m	Nan
ljus	iftiin	Nan
ljusare	iftiin	Nan
ljuset	iftiin	Nan
locka	jiidasho	None
lockar	curls	Nan
locke	locke	Nan
loggbok	logbook	Nan
logik	gal	None
logotyp	logo	Nan
lois	lois	Nan
lojalitet	daacada	Nan
lokal	ah	None
liza	liza	Nan
linje	xariiq	Nan
lindh	lindh	Nan
lindgrens	lindgren	Nan
leva	noolaan	None
levande	noolaan	None
levde	badbaaday	None
lever	beerka	Nan
levern	beerka	Nan
levnadsstandard	nolosha	None
lev	laawiyiintii	Nan
levnadsstandarden	nolosha	None
lewis	lewis	None
lexikon	qaamuus	None
liam	liin	Nan
libanon	lubnaan	None
liberala	xorriyadda	Nan
liberaler	xorriyadda	Nan
levt	noolaa	None
leukemi	dhiigga	None
lettland	latvia	Nan
lett	keentay	None
leipzig	leipzig	Nan
lejon	libaax	None
lejonet	libaax	None
lena	jilicsan	None
lenin	lenin	Nan
lenins	lenin	Nan
lennart	lennart	Nan
lennon	lennon	Nan
leo	leo	Nan
leonard	leonard	Nan
leonardo	leonardo	Nan
leopold	leopold	Nan
les	les	Nan
let	aynu	None
leta	eegid	Nan
liberalism	xorriyadda	Nan
liberalismen	xorriyadda	Nan
liberty	xoriyadda	Nan
library	maktabadda	Nan
likheter	eg	None
liknade	ah	None
liknande	ah	None
liknar	ah	None
liknas	isbarbar dhig	Nan
liksom	kale	None
likt	jecel	None
likväl	ha	None
likör	liqueur	Nan
lilla	yar	None
lima	lima	Nan
lina	xariiq	Nan
lincoln	lincoln	Nan
linda	dabayl	Nan
lindgren	lindgren	Nan
likhet	eg	None
legender	halyeeyada	Nan
likaså	kale	None
lika	isleeg	None
libyen	liibiya	None
lida	silica	Nan
lidande	silica	Nan
lider	silica	Nan
lidit	xanuunsaday	None
liechtenstein	liechtenstein	Nan
life	nolosha	None
liga	horyaal	None
ligacupen	ligacupen	Nan
ligan	horyaal	None
ligga	been	None
liggande	sare	None
ligger	yaal	None
light	iftiimin	Nan
lik	jecel	None
likartade	ah	None
kyla	qabow	None
kväve	nitrogen	Nan
kvällen	saacado	Nan
kontroversiell	muransan	Nan
kontroversiella	muransan	Nan
kontroversiellt	muransan	Nan
konung	boqorka	None
konungarike	boqortooyada	None
konungariket	boqortooyada	None
kontroverser	muran	None
konventionella	ah	None
konventioner	heshiisyada	Nan
konvertera	beddelo	None
konverterade	beddelay	Nan
kopia	nuqul	Nan
koppar	naxaas	Nan
koppla	xir	None
konventionen	shirka	Nan
kontrolleras	la	None
kontrollerar	jeegag	Nan
kontrollerade	la	None
kontinent	qaaradda	None
kontinentala	qaaradaha	None
kontinenten	qaaradda	None
kontinentens	qaaradda	None
kontinenter	qaaradaha	None
kontinuerlig	ah	None
kontinuerligt	ah	None
konto	koonto	Nan
kontor	xafiiska	None
kontrakt	qandaraas	Nan
kontraktet	qandaraas	Nan
kontrast	isbarbar dhig	Nan
kontroll	xakamaynta	Nan
kontrollen	xakamayn	Nan
kontrollera	xaqiiji	Nan
kopplad	isqaba	Nan
kontakter	xiriirada	Nan
kopplade	xiran	None
kopplat	isqaba	Nan
kosovo	kosovo	Nan
kosovos	kosovo	Nan
kostade	qiimaha	None
kostar	kharashyada	Nan
kostnaden	qiimaha	None
kostnader	kharashyada	Nan
kosmiska	cosmic	Nan
kostnaderna	kharashyada	Nan
kr	sek	Nan
kraft	xoog	None
kraften	xoog	None
krafter	ciidamada	None
kraftfull	leh	None
kraftig	leh	None
kostym	suud	Nan
kortare	gaaban	None
korta	gaaban	None
kort	gaaban	None
koppling	iskuxiran	Nan
kopplingar	dhaca	None
kopplingen	iskuxiran	Nan
koprolali	coprolalia	Nan
koranen	quraanka	None
korea	kuuriya	None
koreakriget	kuuriya	None
koreanska	kuuriyaan	Nan
korn	hadhuudh	Nan
korrekt	ah	None
korrekta	sax	None
korruption	musuqmaasuq	Nan
korruptionsindex	tixraaca musuqmaasuqa	Nan
kors	iskutallaabta	Nan
korset	iskutallaabta	Nan
kopplas	isqaba	Nan
kontakten	xiriir	None
kontaktade	soo	None
kontakt	xiriir	None
konflikten	dhac	None
konflikter	isku	None
kong	kong	None
kongo	kongo	None
kongokinshasa	kongo	None
kongress	golaha	None
konflikt	dhac	None
kongressen	golaha	None
konkret	karo	None
konkreta	karo	None
konkurrens	tartan	Nan
konkurrensen	tartan	Nan
konkurrerande	tartamaya	Nan
konkurs	kacsanaan	Nan
kongresspartiet	golaha	None
koncept	fikradaha	Nan
koncentrerade	saaray	None
koncentrerad	saaray	None
kommunistpartiet	ccp	Nan
kommunistpartiets	ccp	Nan
komplett	dhameystiran	Nan
komplex	adag	None
komplexa	adag	None
komplext	adag	None
komplicerad	adag	None
komplicerat	adag	None
komplikationer	dhibaatooyinka	None
komponenter	qaybaha	None
kompositör	curiyay	Nan
kompositörer	curiyayaal	Nan
kon	koollada	Nan
koncentration	feejignaan	Nan
koncentrationsläger	xerada	None
konsekvens	cawaaqib	Nan
konsekvenser	cawaaqibta	Nan
konsekvenserna	saamaynta	None
konsekvent	ah	None
konstitutionell	dastuurka	None
konstitutionella	dastuurka	None
konstitutionen	dastuurka	None
konstnär	fanaaniinta	None
konstnären	fanaaniinta	None
konstnärer	fannaaniinta	Nan
konstnärlig	farshaxanimo	Nan
konstnärliga	farshaxanimo	Nan
konstruerade	dhisay	None
konstruktion	dhismaha	None
konstverk	farshaxanimada	Nan
konsubstantiation	xawaareynta	Nan
konsul	qunsul	Nan
konsumtion	isticmaalka	None
konsumtionen	isticmaalka	None
konstitution	dastuurka	None
kraftiga	leh	None
konsten	fanka	None
konstantinopel	konstantinopel	Nan
konsensus	ogolaansho	Nan
konsert	riwaayad	Nan
konserten	riwaayad	Nan
konserter	riwaayadaha	Nan
konserterna	riwaayadaha	Nan
konserthus	hoolka riwaayadaha	Nan
konservatism	ilaalin	None
konservatismen	ilaalin	None
konservativ	muxaafid	Nan
konservativa	muxaafid	Nan
konsolen	geesinimo	None
konspirationsteorier	shirqool	None
konst	fanka	None
konstant	ah	None
konstantin	konstantin	Nan
konstaterade	helay	None
kraftigare	badan	None
kraftigt	leh	None
kraftverk	koronto	None
kungar	boqorrada	Nan
kungariket	boqortooyada	None
kungarna	boqorrada	Nan
kungen	boqorka	None
kungens	boqorka	None
kunglig	boqornimo	Nan
kungamakten	boqortooyada	None
kungliga	boqornimo	Nan
kunnat	kari	None
kunskap	aqoon	None
kunskapen	aqoon	None
kunskaper	aqoon	None
kupol	xamar	None
kupp	afgambi	None
kunna	awoodaan	Nan
kungahuset	boqortooyada	None
kungafamiljen	boqortooyada	None
kung	boqorka	None
kubanska	kuuban	Nan
kubas	cuba	Nan
kuben	cube	Nan
kuiperbältet	suunka kuiper	Nan
kulmen	soo	None
kulminerade	afjaray	None
kultur	dhaqanka	None
kulturarv	dhaxalka	None
kulturell	dhaqan	None
kulturella	dhaqan	None
kulturellt	dhaqan	None
kulturen	dhaqanka	None
kulturer	dhaqamada	Nan
kunde	kari	None
kunder	macaamiisha	None
kurder	kurdiyiinta	Nan
kurderna	kurdiyiinta	Nan
kurdisk	kurdiyiinta	Nan
kurdiska	kurdiyiinta	Nan
kvarteret	xannib	Nan
kvartsfinalen	dhamaadka	None
kvarvarande	haray	None
kvast	xaaqin	Nan
kvicksilver	quicksilver	Nan
kvinna	naag	None
kvinnan	naagtii	Nan
kvinnans	naag	None
kvinnlig	dhedig	Nan
kvinnliga	dhedig	Nan
kvinnor	haweenka	None
kvinnorna	haweenka	None
kvinnornas	haweenka	None
kvinnors	haweenka	None
kväll	fiidkii	Nan
kvarter	xannib	Nan
kuba	cuba	Nan
kvarstår	hadhay	None
kvar	bidix	None
kurdistan	kurdistan	None
kurfursten	cod	None
kuriosa	cajalado	Nan
kurs	dabcan	Nan
kurt	kurt	Nan
kusin	inaadeer	Nan
kust	xeebta	None
kusten	xeebta	None
kuster	xeebaha	None
kusterna	xeebaha	None
kustlinje	xeebta	None
kuwait	kuweyt	Nan
kvadratkilometer	jibaaran	None
kvalificerade	u	None
kvalitet	tayo	None
kvarstod	haray	None
kommunistisk	shuuciyad	Nan
kub	cube	Nan
krönika	taariikhda	None
kriser	dhibaatooyinka	None
kristen	ah	None
kristendom	masiixiyada	Nan
kristendomen	kiristaanka	Nan
kristendomens	ah	None
kristi	masiixa	Nan
krisen	qalalaase	None
kristian	kristian	Nan
kristinas	kristina	Nan
kristna	masiixiyiinta	Nan
kristus	masiixa	Nan
krita	nabar	Nan
kriterier	shuruudaha	Nan
kriterierna	shuruudaha	Nan
kristiansson	kristiansson	Nan
kris	qalalaase	None
kring	hareeraha	None
kriminella	dambiilayaal	Nan
krav	shuruud	Nan
kraven	sheegashada	Nan
kravet	sheegasho	Nan
kreativitet	hal-abuurnimo	Nan
krets	wareeg	Nan
kretsar	wareegyada	Nan
kretsen	wareeg	Nan
krig	dagaal	None
krigare	dagaalyahan	Nan
krigen	dagaalladii	Nan
kriget	dagaal	None
krigets	dagaal	None
krigsmakt	sida	None
krigsmakten	sida	None
krigsslutet	dagaal	None
kritik	cambaareyn	Nan
kritiken	cambaareyn	Nan
kritiker	dhaliil	None
kritikerna	dhaliil	None
kronprins	boqortooyada	None
kronprinsen	amiir	None
kronprinsessan	taajka princess	Nan
kropp	jirka	None
kroppar	meydadka	Nan
kroppen	jirka	None
kroppens	jirka	None
krossa	burburin	Nan
kryddor	udgoon	None
kräva	baahan	None
krävde	yahay	None
krävdes	baahnaa	None
kräver	baahan	None
krävs	yahay	None
krävt	yahay	None
kronor	sek	Nan
kröntes	saaray	None
kroniska	raaga	Nan
kronan	taaj	Nan
kritiserade	dhaleeceeyay	Nan
kritiserades	dhaleeceeyay	Nan
kritiserar	cambaareyn	Nan
kritiserat	dhaleeceeyay	Nan
kritiserats	dhaleeceeyay	Nan
kritisk	ah	None
kritiska	ah	None
kritiskt	ah	None
kroatien	croatia	Nan
kroatiens	croatian	Nan
kroatiska	croatian	Nan
kromosom	koromosoom	Nan
kromosomer	koromosoomyada	Nan
kromosomerna	koromosoomyada	Nan
krona	boqortooyada	None
kronisk	raaga	Nan
fängelse	xabsi	None
inledningen	hordhac	None
inleder	bilaw	Nan
georgier	joorjiyan	Nan
ger	siinayaa	Nan
germanska	jarmal	None
ges	siiyay	None
gestalt	jaantus	Nan
gestalter	tirooyinka	Nan
georgien	georgia	Nan
gett	siiyay	None
gia	gia	Nan
gick	tegey	None
gift	guursaday	None
gifta	guursaday	None
gifte	guursaday	None
gifter	sunta	None
ghana	gaana	Nan
georges	georges	None
george	george	Nan
georg	joorjiyan	Nan
genomsnittlig	celcelis	Nan
genomsnittliga	celcelis	Nan
genre	nooc	None
genren	nooc	None
genrer	noocyada	None
gentemot	soo	None
genus	jinsi	Nan
geografi	juquraafiga	Nan
geografisk	ahaan	None
geografiska	ahaan	None
geografiskt	ahaan	None
geologi	dhulka	None
geologiska	ahaan	None
geologiskt	ahaan	None
geomorfologi	joomorphology	Nan
giftermål	guur	None
genomsnittet	celcelis	Nan
giftsnokar	elapidae	Nan
gillade	jeclaa	None
gjorts	sameeyay	None
glad	farxad	None
glada	faraxsan	None
glas	galaas	Nan
glenn	glenn	Nan
global	ah	None
gjort	sameeyay	None
globala	ah	None
globe	gobannimo	Nan
globen	lobe	Nan
gloria	halo	Nan
glukos	gulukoos	Nan
glädje	farxad	None
glödlampor	nalalka	Nan
globalt	ah	None
gjordes	ahaa	None
gjorde	sameeyey	None
gjorda	sameeyey	None
gillar	jecel	None
giovanni	giovanni	Nan
girl	gabadh	None
girls	gabdhaha	None
gisslan	la	None
gitarr	gitaarka	Nan
gitarrist	gitaar	Nan
gitarristen	gitaar	Nan
givaren	dareemayaal	Nan
given	siiyay	None
givet	siiyay	None
givetvis	dabcan	Nan
givit	siiyay	None
givits	siiyay	None
gjord	sameeyey	None
gigantiska	weyn	None
genomsnitt	celcelis	Nan
genomslag	saamaynta	None
genomgått	gudbay	None
gas	gaas	Nan
gasen	gaas	Nan
gata	wadada	None
gatan	wadada	None
gates	irdaha	Nan
gator	jidadka	Nan
gary	gary	Nan
gatorna	jidadka	Nan
gavs	siiyay	None
gaza	qasa	Nan
gazaremsan	xariga gaza	Nan
ge	siin	None
gemensam	ah	None
gemensamma	ah	None
gav	siiyay	None
garvey	garvey	Nan
garanterar	qaad	None
garantera	hubiyo	Nan
galax	galaxy	Nan
galaxer	galaxiyada	Nan
galilei	galilei	Nan
galileo	galileo	Nan
gallagher	gallagher	Nan
galleri	maktabadda	Nan
gallien	gaul	Nan
gamla	jir	None
gamle	jir	None
gammal	jir	None
gammalt	jir	None
gandalf	gandalf	Nan
gandhi	gaandi	None
gandhis	gaandi	None
ganska	xad	None
gemensamt	ahaan	None
gemenskap	bulsho	None
gemenskapen	bulsho	None
gemenskaperna	bulshooyinka	Nan
genom	by	None
genombrott	burburin	Nan
genombrottet	burburin	Nan
genomför	qaado	None
genomföra	hirgaliyo	Nan
genomföras	fuliyay	Nan
genomförde	fuliyay	Nan
genomfördes	qabtay	None
genomförs	fuliyay	Nan
genomfört	dhammaystiray	Nan
genomförts	banaanka	None
genomgick	maray	None
genomgripande	dheer	None
genomgående	marayo	None
genomgår	socda	None
genetiskt	ahaan	None
go	tag	Nan
genetiska	hidde	Nan
genetik	hiddo-wadaha	Nan
gen	gene	Nan
genast	markiiba	None
genen	hidde	Nan
gener	hiddo-wadayaasha	Nan
general	guud	None
generalen	guud	None
generalguvernören	guud	None
generalsekreterare	guud	None
generation	jiil	Nan
generationen	jiil	Nan
generationer	jiilalka	Nan
generell	guud	None
generella	guud	None
generellt	ahaan	None
generna	hiddo-wadayaasha	Nan
genetisk	hidde	Nan
gaga	gaga	Nan
god	wanaagsan	None
godkände	ogolaaday	None
gränsen	xad	None
gränser	xadka	None
gränserna	xadka	None
gräs	cawska	Nan
gräslök	chive	Nan
grå	cawlan	Nan
gränsar	xadka	None
grön	cagaar	Nan
grönland	greenland	Nan
grönsaker	khudradda	Nan
grönt	cagaaran	None
grönwall	grönwall	Nan
guatemala	guatemala	Nan
gud	ilaahow	Nan
gröna	cagaaran	None
gräns	xad	None
gruppspelet	heerka	None
grupperna	kooxaha	None
grundat	aasaasay	None
grunden	gundhig	Nan
grunder	saldhigyada	Nan
grundlag	dastuurka	None
grundlagen	dastuurka	None
grundläggande	ah	None
grundskolan	hoose	None
grundämne	element	Nan
grundämnen	ka	None
grundämnet	ah	None
grupp	koox	None
gruppen	koox	None
gruppens	koox	None
grupper	kooxaha	None
grupperingar	kooxaha	None
gudar	ilaahyada	Nan
grundas	ku	None
gudarna	ilaahyada	Nan
guden	ilaah	None
gustav	gustav	Nan
gustavs	gustav	Nan
guvernör	gudoomiye	None
guyana	guyana	None
gyllene	ah	None
gymnasiet	sare	None
gustafsson	gustafsson	Nan
gymnasium	jimicsiga	Nan
gällande	hadda	None
gällde	codsatay	Nan
gäller	khuseeya	Nan
gäng	burcad	Nan
gänget	burcad	Nan
gärna	farxad	None
gälla	ah	None
gustafs	gustaf	Nan
gustaf	gustaf	Nan
gunwer	qori	None
gudinnan	ilaahoow	Nan
gudom	ilaah	None
gudomlig	ah	None
gudomliga	ah	None
guds	ilaah	None
guevara	guevara	Nan
guide	hage	Nan
guillou	guillou	Nan
guinea	guinea	None
gul	ah	None
gula	ah	None
guld	dahab	None
guldbollen	ah	None
gunnar	gunnar	Nan
guns	qoryaha	Nan
gudarnas	ilaahyada	Nan
grundarna	aasaasayaasha	None
grundaren	aasaasaha	None
grundare	aasaasaha	None
grace	nimco	Nan
grad	shahaado	None
graden	shahaado	None
grader	digrii	Nan
gradvis	tartiib tartiib	Nan
grafit	jaantus	Nan
gott	wanaagsan	None
graham	graham	Nan
grammis	grammis	Nan
grammy	naxwaha	None
gran	fir	Nan
grand	awoowe	None
grande	weyn	None
grannar	deriska	None
grammatik	naxwaha	None
gotlands	gotland	Nan
gotland	gotland	Nan
gotiska	gothic	Nan
godkändes	ogolaaday	None
godkänna	oggolaansho	Nan
godkännande	oggolaansho	Nan
godkännas	ogolaaday	None
godkänt	ogolaaday	None
gods	alaabada	Nan
goebbels	goebbels	Nan
gogh	gogh	Nan
golf	golf	Nan
golvet	dabaqa	None
gom	carte	None
google	google	Nan
gorbatjov	gorbatjov	Nan
gordon	gordon	Nan
got	got	Nan
granne	deris	None
grannlandet	deriska	None
grannländer	ah	None
grannländerna	deriska	None
grenar	laamood	Nan
grenen	laanta	None
greps	qabtay	None
greve	tiri	None
griffin	griffin	Nan
griffon	griffon	Nan
grovt	qallafsan	Nan
grund	ah	None
grunda	saldhig	None
grundad	ku	None
grundade	aasaasay	None
grundades	aasaasay	None
grundande	aasaaska	None
grundandet	aasaaska	None
grundar	helay	None
gren	laanta	None
goda	wanaagsan	None
greklands	giriigga	None
grekiskans	giriig	None
granska	u	None
granskning	baaritaan	None
grant	deeqda	Nan
gratis	ah	None
grav	qabriga	None
graven	qabriga	None
gravid	leh	None
graviditet	uur	None
graviditeten	uur	None
gravitation	cufnaanta	Nan
gray	cirro	None
greker	gariigta	Nan
grekerna	gariigta	Nan
grekisk	giriig	None
grekiska	giriig	None
grekland	giriigga	None
gabriel	jibriil	None
führer	fuusto	Nan
fötts	dhashay	None
fördomar	qaldan	None
fördrag	heshiis	None
fördragen	heshiisyada	Nan
fördraget	heshiis	None
fördrevs	eryay	None
före	kahor	None
fördes	wareejiyay	None
förebild	ku	None
föredrar	doorbidaa	Nan
föredrog	doorbiday	Nan
förefaller	muuqdaa	Nan
föregående	hore	None
föregångare	hordhac	None
föregångaren	hordhac	None
förebyggande	ka	None
fördelningen	qaybinta	Nan
fördelning	qaybinta	Nan
fördelen	faa&#39;iido	Nan
förbud	mamnuucid	Nan
förbudet	mamnuucid	Nan
förbund	axdi	Nan
förbundet	ururka	None
förbundskapten	tababaraha	Nan
förbundsrepubliken	federaalka	None
förbundsstat	federaalaya	Nan
förbättra	hagaajin	Nan
förbättrade	hagaajiyay	Nan
förbättringar	horumar	None
förde	keenay	None
fördel	faa&#39;iido	Nan
fördelade	qaybiyey	Nan
fördelar	faa&#39;iidooyinka	Nan
fördelas	qaybiyey	Nan
förekom	dhacay	None
förbränning	gubashada	Nan
förekomma	dhacdo	None
förekommer	xaadir	Nan
förespråkare	u	None
föreställa	qiyaas	None
föreställande	sawirka	None
föreställer	matalaya	Nan
föreställning	show	Nan
föreställningar	riwaayadaha	Nan
förespråkar	dooda	None
föreställningen	show	Nan
företagen	shirkadaha	None
företaget	hadda	None
företagets	shirkad	None
företeelse	ifafaale	Nan
företeelser	ifafaale	Nan
företrädare	wakiilo	Nan
företag	ganacsiga	None
förespråkade	dooday	None
föreslår	soo	None
föreslogs	jeediyay	None
förekommit	dhacay	None
förekomst	joogitaan	Nan
förekomsten	joogitaan	Nan
föreligger	jira	None
föremål	mawduuc	Nan
förena	heshiisiin	Nan
förenade	biiray	None
förening	ururka	None
föreningar	xeryahooda	Nan
föreningen	ururka	None
förenklat	fududeeyay	None
förenta	united	None
föreslagit	jeediyay	None
föreslagits	jeediyay	None
föreslog	jeediyay	None
förekommande	dhacaya	Nan
förblir	hadhay	None
förblev	hadhay	None
förbjöds	mamnuucay	Nan
fågelhundar	shimbiraha	None
fåglar	shimbiraha	None
fåglarna	shimbiraha	None
fåglarnas	shimbiraha	None
fånga	qabasho	Nan
fångar	maxaabiista	Nan
fågelarter	noocyada	None
fångenskap	ahaan	None
fåtal	yar	None
fått	helay	None
föda	cuntada	None
född	dhashay	None
födda	dhashay	None
födde	dhashay	None
får	yaabaa	None
fågel	shimbiraha	None
fåfotingar	pauropoda	Nan
få	hel	Nan
fängelset	xabsi	None
fängslade	xabsi	None
fängslades	xabsi	None
färdas	safarka	None
färdig	dhammaaday	Nan
färdiga	ah	None
färg	midab	None
färgade	leh	None
färgen	midab	None
färger	midabada	Nan
färgerna	midabada	Nan
färre	yar	None
färöarna	faaruuq	Nan
fäste	lifaaq	Nan
fästning	qalcad	Nan
föddes	dhashay	None
födelse	dhalasho	None
födelsedag	dhalasho	None
födelsetal	dhalasho	None
för	ee	None
föra	keen	Nan
föranledde	soo	None
föras	noqon	None
förband	labiska	Nan
förbi	dhaafay	None
förbindelse	isku	None
förbindelser	xiriirka	None
förbinder	xidhka	None
förbjuda	mamnuuc	Nan
förbjuden	mamnuuc	Nan
förbjuder	mamnuucid	Nan
förbjudet	mamnuucay	Nan
förbjudna	reebay	None
förbjöd	mamnuucay	Nan
fönster	daaqad	None
företräder	matalaya	Nan
föll	dhacday	None
följs	raacay	None
föder	dhalmada	Nan
föds	dhashay	None
födseln	dhalasho	None
föga	yar	None
följa	raac	Nan
följaktligen	awgeed	None
följande	socda	None
följas	raacay	None
följd	isku	None
följde	raacay	None
följden	isku	None
följder	saamaynta	None
följdes	raacay	None
följer	socota	None
följeslagare	wehel	None
följt	raacay	None
författare	qoraa	None
författaren	qoraa	None
författarna	qorayaasha	Nan
försvarsmakten	difaaca	None
försvarsminister	difaaca	None
försvinna	baaba&#39;aan	Nan
försvinner	baaba&#39;aan	Nan
försvunnit	libdhay	Nan
försäkra	hubiyo	Nan
försvarsmakt	hubaysan	None
försäljning	iibin	None
försämrades	sii	None
försök	isku	None
försöka	isku	None
försöken	tijaabooyin	Nan
försöker	isku	None
försökt	dayay	None
försäljningen	iibka	Nan
försvarets	difaaca	None
försvaret	difaaca	None
försvarare	difaaca	None
förstnämnda	hore	None
förstod	fahmay	None
förstärka	xoojin	Nan
förstå	faham	Nan
förståelse	fahamka	None
förståelsen	fahamka	None
förstår	fahmay	None
förstås	dabcan	Nan
förstöra	burbur	None
förstördes	burburay	None
förstörelse	halaag	None
försvann	waayey	None
försvar	difaaca	None
försvara	difaaco	Nan
försvarade	difaacay	None
försökte	dayay	None
försörja	taageero	None
försörjde	taageeray	Nan
försörjning	sahay	Nan
föräldrar	waalidiinta	Nan
föräldrarna	waalidiinta	Nan
förälskad	haya	None
förändra	beddel	Nan
förändrade	bedelay	None
förändrades	bedelay	None
förändras	beddel	Nan
förändrats	bedelay	None
förändring	beddel	Nan
förändringar	isbeddelada	Nan
förändringarna	isbeddelada	Nan
förändringen	beddel	Nan
förödande	burburin	Nan
fötter	cagaha	Nan
fötterna	cagaha	Nan
förväxlas	wareersan	Nan
förste	hore	None
förväxla	jahwareer	Nan
förväntas	filayay	Nan
fört	hore	None
förteckning	liiska	None
förtjust	jeclaan	None
förtroende	aamin	None
förtryck	dulmiga	None
förts	wareejiyay	None
förut	kahor	None
förutom	reebo	None
förutsätter	baahan	None
förutsättning	lasiiyay	Nan
förutsättningar	xaaladaha	None
förutsättningarna	xaaladaha	None
förvaltning	maaraynta	None
förvaras	kaydiyay	Nan
förväntade	filayay	Nan
förväntningar	rajooyinka	Nan
gärning	fal	None
förstaplatsen	koowaad	None
först	hore	None
förhållandevis	ahaan	None
förhåller	xiriirka	None
förhöjd	qaaday	None
förintelsen	baabi&#39;inta	Nan
förklara	sharrax	Nan
förklarade	sharxay	Nan
förhållandet	saamiga	Nan
förklarades	dhawaaqay	None
förklarat	sharxay	Nan
förklaring	sharraxaad	Nan
förklaringar	sharaxaada	Nan
förklaringen	baaqa	None
förknippad	xiriira	None
förknippade	xiriira	None
förklaras	sharxay	Nan
förhållandena	xaaladaha	None
förhållanden	xaaladaha	None
förhållande	xiriirka	None
författarskap	qoraa	None
författning	dastuurka	None
författningen	dastuurka	None
förfäder	awooweyaal	Nan
förföljelse	cadaadis	None
förföljelser	cadaadis	None
förgäves	lahayn	None
förhandla	gorgortan	Nan
förhandlingar	gorgortanka	Nan
förhandlingarna	gorgortanka	Nan
förhindra	ka	None
förhindrar	ka	None
förhistoria	prehistory	Nan
förhistorisk	prehistoric	Nan
förhärskande	ah	None
förknippas	xiriira	None
förkortas	gaabiyey	Nan
förkortat	soo	None
förkortning	gaabinta	Nan
förmågor	awooda	None
förmån	faa iido	Nan
förmögenhet	nasiib	None
förnuft	dareen	None
förnuftet	dareen	None
förorter	agagaarkeeda	None
förr	kahor	None
förra	dambeeya	None
förrän	kahor	None
förs	banaanka	None
församling	shirkii	None
församlingar	golayaasha	Nan
församlingen	golaha	None
förslag	soo	None
förslaget	soo	None
förmågan	kartida	Nan
första	hore	None
förmåga	karti	None
förmedla	dhexdhexaadin	Nan
förkortningar	soo	None
förlag	daabacayaasha	Nan
förlaget	daabacaha	Nan
förlopp	dabcan	Nan
förlora	lumiso	Nan
förlorade	lumay	None
förlorades	lumay	None
förlorar	luminta	Nan
förlorat	lumay	None
förlust	khasaaro	Nan
förlusten	khasaaro	Nan
förluster	khasaaro	Nan
förlusterna	khasaare	Nan
förlängning	kordhinta	None
förlängningen	kordhinta	None
förmodligen	malaha	None
inledning	hordhac	None
gärningar	shaqeeya	None
gäst	marti	None
hårt	adag	None
höftledsgrop	acetabulum	Nan
hög	sare	None
höga	sare	None
höger	midig	None
högkvarter	xarunta	None
håret	timo	None
höglandet	sare	None
högre	sare	None
högskola	kulliyad	Nan
högskolan	sayniska	None
högskolor	kuleejyada	Nan
högst	sareeya	None
högsta	sareeya	None
högra	sax	None
hårdvara	qalabka	None
hårdrocken	adag	None
hårdrock	birta	None
hål	dalool	None
hålet	dalool	None
håll	qaban	None
hålla	hayn	None
hållas	noqon	None
håller	haysta	None
hållet	jihada	Nan
hållit	joogtay	None
hållning	qaab	None
hålls	qabtay	None
hår	timo	None
hård	adag	None
hårda	adag	None
hårdare	adag	None
hårdast	adag	None
högste	madax	None
håkansson	håkansson	Nan
högt	sare	None
högtider	ciidaha	Nan
iberiska	iberian	Nan
ibland	qaar	None
ibm	ibm	Nan
ibn	ibnu	None
ibrahimović	ibrahimović	Nan
icd	icd	Nan
ian	nes	Nan
icke	ahayn	None
idag	maanta	None
ideal	habboon	None
identifiera	cadee	Nan
identifierade	tilmaamay	None
identisk	ah	None
identitet	aqoonsiga	Nan
ida	ida	Nan
i	gudaha	None
hösten	dayrta	Nan
höst	dhicid	Nan
högtryck	sareeya	None
höja	qaad	None
höjd	dherer	None
höjder	dhaadheer	None
höjdes	kordhay	Nan
höjdpunkt	ugu	None
höjer	kordhiyaa	Nan
höll	madadaalo	Nan
hölls	ahaa	None
hör	maqal	None
höra	maqal	None
hörde	maqlay	None
hörn	geeska	None
hörs	maqlay	None
hört	maqlay	None
högtid	iid	Nan
håkan	håkan	Nan
hävdat	soo	None
hävdar	sheegashada	Nan
huvudstaden	madaxda	None
huvudstäder	caasimadaha	None
huvudvärk	xanuun	None
huxley	huxley	Nan
hyllade	qirtay	Nan
hyllning	cashuur	Nan
huvudstad	caasimada	None
hypotes	mala-awaal	Nan
hypoteser	fikradaha	Nan
hyser	haynta	Nan
häcklöpning	caqabadaha	Nan
hälft	badh	None
hälften	badh	None
hällristning	dhagax	None
hypotesen	mala-awaal	Nan
huvudsakligen	badan	None
huvudsakliga	weyn	None
huvudsak	leh	None
husen	guryo	None
huset	guri	None
hushåll	reerka	None
huskvarna	huskvarna	Nan
hussein	xussein	Nan
hustru	naag	None
hustrun	naag	None
huvud	madaxa	None
huvudartikel	weyn	None
huvuddelen	badan	None
huvudet	madaxa	None
huvudkontor	madaxa	None
huvudort	caasimada	None
huvudperson	weyn	None
huvudrollen	xiddigta	Nan
hälsa	caafimaadka	None
hämnd	aargudasho	Nan
hämta	soo	None
hämtade	dejiyay	None
här	halkan	None
härifrån	daawo	None
härkomst	ahaan	None
härledas	dhashay	None
härrör	dhashay	None
härskare	taliye	None
härstamma	ahaan	None
härstammar	dhashay	None
härstamning	safka	Nan
häst	hooyo	None
hästar	fardo	None
hästen	faras	None
hästens	faras	None
hävda	sheegasho	Nan
hävdade	dooday	None
hänvisning	tixraac	None
ideologi	fikirka	Nan
hänvisar	jeedaa	None
hänvisa	tixraac	None
hämtar	soo	None
hämtat	soo	None
hända	dhici	None
hände	dhacay	None
händelse	dhacdo	None
händelsehorisonten	dhacdo	None
händelsen	dhacdo	None
händelser	dhacdooyinka	None
händelserna	dhacdooyinka	None
händer	dhacdaa	None
händerna	gacmaha	None
hänga	sudhan	None
hänger	bacda	Nan
hänsyn	xiriira	None
hänt	dhacay	None
hänvisade	gudbiyey	Nan
hus	guri	None
ideologier	fikradaha	Nan
ideologiska	fikirka	Nan
influerad	yeeshay	None
influerat	yeeshay	None
inflytande	saameyn	Nan
inflytandet	saameyn	Nan
inflytelserika	leh	None
information	macluumaad	None
influenser	saameyn	Nan
informationen	macluumaad	None
infrastrukturen	kaabayaasha	Nan
infödda	ah	None
inför	ah	None
införa	baro	None
införande	hordhac	None
införandet	hordhac	None
infrastruktur	kaabayaasha	Nan
influensavirus	fayras hargab	Nan
influensan	hargab	Nan
influensa	hargab	Nan
indonesiska	indooniisiyaan	Nan
industri	warshadaha	None
industrialiserade	warshadeed	Nan
industrialisering	warshadeynta	Nan
industrialiseringen	warshadeynta	Nan
industriell	warshadaha	None
industriella	warshadaha	None
industriellt	warshadaha	None
industrier	warshadaha	None
industrin	warshadaha	None
infaller	dhacdo	None
infektion	caabuq	Nan
infektioner	caabuq	Nan
inflation	sicir barar	Nan
inflationen	sicir barar	Nan
införde	bandhigay	None
indonesien	indonesia	None
infördes	bandhigay	None
införts	bandhigay	None
inkluderade	ahaa	None
inkluderar	dar	None
inkluderas	ahaa	None
inkluderat	yihiin	None
inklusive	yihiin	None
inkomst	dakhliga	Nan
initiativ	dadaal	None
inkomster	dakhliga	Nan
inkomstkälla	isha	None
inlandet	hinterland	Nan
inleda	bilaabid	Nan
inledande	bilowga	Nan
inledde	bilaabay	None
inleddes	bilaabay	None
inkomsterna	dakhliga	Nan
inhemska	dhashay	None
inhemsk	gudaha	None
ingått	gabagabeeyey	Nan
inga	maya	Nan
ingen	maya	Nan
ingenjör	injineer	None
ingenting	waxba	None
inget	waxba	None
ingick	qayb	None
ingmar	ingmar	Nan
ingredienser	maaddooyinka	Nan
ingrid	ingrid	Nan
ingripa	gal	None
ingripande	faragelin	None
ingvar	ingvar	Nan
ingå	qayb	None
ingående	fikrad	None
ingår	ahaa	None
infört	bandhigay	None
indoeuropeiska	indo	Nan
individuella	shaqsi	None
individerna	shaqsiyaadka	None
ihåg	xusuusnow	Nan
iii	iii	Nan
iiis	iiis	Nan
iis	iis	Nan
ikea	ikea	Nan
ikon	astaan	None
ihop	wadajir	None
illa	xun	None
illegala	ah	None
illinois	illinois	Nan
illuminati	illuminati	Nan
ilska	xanaaq	Nan
image	muuqaal	Nan
imf	imf	Nan
illegal	ah	None
igång	bilaabay	None
igenom	marayo	None
igen	labaad	None
ideologiskt	fikirka	Nan
idol	sanam	Nan
idrott	isboorti	None
idéer	fikradaha	Nan
idén	fikrad	None
ifall	hadday	None
ifk	ifk	Nan
ifråga	su’aal	Nan
ifrågasatt	dooday	None
ifrågasatts	dooday	None
ifrån	ka	None
igelkott	hedgehog	Nan
igelkottar	hedgehogs	Nan
igelkotten	hedgehog	Nan
igelkottens	hedgehog	Nan
immigranter	soogalootiga	Nan
immunförsvar	jirka	None
imperiet	boqortooyada	None
imperium	boqortooyada	None
indianer	dhalad	Nan
indianerna	hindi	None
indianska	hindi	None
indien	hindiya	None
indiens	hindiya	None
indier	hindi	None
indierna	hindi	None
indikerar	tilmaamayaa	Nan
indirekt	ahayn	None
indisk	hindi	None
indiska	hindi	None
individ	shaqsi	None
individen	shaqsi	None
individens	shaqsi	None
individer	shaqsiyaadka	None
indiana	indiana	Nan
ideologin	fikirka	Nan
indian	hindi	None
independence	madaxbanaanida	None
import	soo	None
in	gudaha	None
inblandad	leh	None
inblandade	leh	None
inblandning	lahaanshaha	None
inbördes	wadaaga	None
inbördeskrig	sokeeye	None
inbördeskriget	sokeeye	None
indelad	qaybsan	Nan
indelade	qaybsan	Nan
indelas	go	None
indelat	qaybsan	Nan
indelning	qaybinta	Nan
indelningar	kala	None
indelningen	qaybinta	Nan
index	tusmo	Nan
huruvida	in	None
hur	sida	None
hunnit	waqti	None
hat	nacayb	None
hatar	nacayb	None
hav	badda	None
have	leeyihiin	None
haven	aad	None
havet	badda	None
hastigt	ah	None
havets	badda	None
havskattfiskar	anarhichadidae	Nan
havsnivån	badda	None
hawaii	hawaii	None
hawking	karsasho	Nan
hc	hc	Nan
hdmi	hdmi	Nan
havs	badaha	Nan
hastighet	xawaare	Nan
hasch	hashish	Nan
harry	harry	Nan
handlingen	fal	None
hanen	lab	None
hanhon	iyadu	None
hann	kari	None
hannah	hannah	Nan
hannar	lab	None
hans	uu	None
hansson	hansson	Nan
hantera	maamul	None
hantverk	gacanta	None
hantverkare	yaqaan	None
har	leeyahay	None
harald	xaraare	Nan
harris	harris	Nan
harrison	xareed	Nan
he	he	None
handlingar	falalka	None
heart	wadnaha	None
heaven	jannada	None
hellström	hellström	Nan
helsingborg	helsingborg	Nan
helsingborgs	helsingborg	Nan
helsingfors	helsinki	None
helsingör	elsinore	Nan
helst	doorbidayaa	Nan
hells	naarta	None
helt	ahaanba	None
hem	hoyga	None
hemingway	hemingway	Nan
hemland	hooyo	None
hemlandet	hooyo	None
hemlig	sirta	None
hemliga	sirta	None
helvetet	cadaabta	Nan
hellre	halkii	None
heller	midkoodna	Nan
hell	cadaabta	Nan
hebreiska	cibraaniga	Nan
hedersdoktor	sharaf	None
hegel	hegel	Nan
heinrich	heinrich	Nan
heinz	heinz	Nan
hel	dhan	None
hela	dhan	None
helena	helena	Nan
helgdagar	ciidaha	Nan
helhet	dhan	None
helig	qoduus	Nan
heliga	qoduus	Nan
helige	quduus	Nan
heligt	ah	None
helium	hilibka	None
heath	caafimaadka	None
handling	ficil	None
handlar	heshiis	None
handlande	fal	None
göta	göta	Nan
götaland	götaland	Nan
göteborg	gothenburg	Nan
göteborgs	gothenburg	Nan
h	saac	Nan
ha	leeyihiin	None
gösta	gösta	Nan
haag	the	None
haddock	haddock	Nan
hade	lahaa	None
haft	lahaa	None
haile	haile	None
haiti	haiti	Nan
hall	hoolka	Nan
haber	haber	Nan
görs	waa	None
göring	lifaaq	Nan
göras	sameeyay	None
gäster	martida	None
gävle	gävle	Nan
gå	tag	Nan
gång	soco	None
gången	waqti	None
gånger	jeer	None
gångna	dhaafay	None
går	tagaa	None
gård	barxadda	Nan
gården	beer	None
gått	tegey	None
gåva	gift	Nan
gör	sameeya	None
göra	samee	Nan
göran	göran	Nan
halland	halland	Nan
halloween	halbeega	Nan
hallucinationer	hallucinations	Nan
halmstad	halmstad	Nan
hamnat	gaadho	None
hamnen	dekeda	None
hampa	hemp	Nan
han	isagu	None
hanar	lab	None
hand	gacanta	None
handboll	gacanta	None
handel	ganacsiga	None
handeln	ganacsiga	None
handels	ganacsiga	None
handelsmän	ganacsatada	None
handelspartner	ganacsi	None
handen	gacanta	None
handla	fal	None
handlade	ahaa	None
hamnar	dekedaha	Nan
hemlighet	sirta	None
hamnade	dhamaaday	None
hamn	dekeda	None
halmstads	halmstad	Nan
hals	cunaha	Nan
halsen	cunaha	Nan
halt	dabacsan	Nan
halv	badh	None
halva	badh	None
halvan	badh	None
halvklotet	hemisphere	Nan
halvt	badh	None
halvön	jasiiradda	Nan
hamas	hamas	Nan
hamburg	hamburg	Nan
hamilton	xamilton	Nan
hamlet	hamlet	Nan
hammarby	hammarby	Nan
hamna	dhamaadka	None
hemligt	sirta	None
hemma	guriga	None
hemmaarena	guriga	None
holm	holm	Nan
homo	homo	Nan
homogen	isjecel	Nan
homosexualitet	khaniisnimada	Nan
homosexuell	khaniis	Nan
homosexuella	khaniisiinta	Nan
holländska	nederlandays	Nan
hon	iyada	None
honom	isaga	None
honor	dhedig	Nan
hopp	rajo	None
hoppa	bood	None
hoppade	booday	Nan
hoppades	rajeeyay	Nan
honan	dhedig	Nan
hollywood	hollywood	Nan
holland	holland	None
hockey	hockey	Nan
hiv	hiv	Nan
hjalmar	hjalmar	Nan
hjälp	i	None
hjälpa	i	None
hjälper	i	None
hjälpmedel	gargaar	None
hjälpt	caawiyay	Nan
hjälpte	caawiyay	Nan
hjärna	maskaxda	None
hjärnan	maskaxda	None
hjärnans	maskaxda	None
hjärta	wadnaha	None
hjärtat	wadnaha	None
hms	hms	Nan
ho	ho	Nan
hoppas	rajo	None
hormoner	hormoonnada	Nan
horn	gees	None
hos	at	None
human	aadanaha	None
humanism	dadnimo	Nan
humanismen	dadnimo	Nan
humanistiska	kuliyada	None
humle	hop	Nan
humor	qosol	None
humör	qosol	None
hund	eey	None
hundar	eeyaha	Nan
hunden	eeyaha	Nan
hundra	boqol	None
hundraser	xayawaan	None
hundratal	boqol	None
hundratals	boqolaal	Nan
hundratusentals	kun	None
hugo	hugo	Nan
hittills	maanta	None
hughes	hughes	Nan
huden	maqaarka	Nan
hotad	hanjabay	Nan
hotade	hanjabay	Nan
hotar	hanjabaad	Nan
hotel	hudheel	Nan
hotell	hoteel	None
hotellet	hudheel	Nan
hotet	hanjabaad	Nan
house	guri	None
houston	houston	Nan
hov	maxkamada	None
hovet	maxkamada	None
hovrätten	rafcaan	Nan
how	sida	None
howard	howard	Nan
hud	maqaarka	Nan
hudfärg	midab	None
gärningsmannen	dembiile	Nan
hittats	helay	None
hittas	heli	None
herrar	ragga	None
herre	sayidow	Nan
herren	sayidow	Nan
herrens	sayidow	Nan
herrlandskamper	koofi	None
herrlandslag	cagta	None
herr	mudane.	Nan
hertig	duke	Nan
heta	kulul	None
heter	yaqaan	None
hett	kulul	None
hette	magacaabay	None
hexadecimalt	hexadecimal	Nan
heydrich	heydrich	Nan
het	kulul	None
heroin	heroin	Nan
hermann	hermann	Nan
herman	dhaqato	None
hemmaplan	guriga	None
hemmet	guriga	None
hemsida	websaydh	Nan
hendrix	hendrix	Nan
henne	iyada	None
hennes	iyada	None
henri	henri	Nan
henrik	henrik	Nan
henriks	ciise	None
henry	henry	Nan
hepatit	cagaarshow	Nan
herbert	herbert	None
hercegovina	herzegovina	Nan
hergé	hergé	Nan
heritage	dhaxalka	None
high	sare	None
himlakroppar	janno	None
himlen	jannada	None
himmel	cirka	None
historik	taariikhda	None
historiker	taariikhyahan	None
historikern	taariikhyahan	None
historisk	ah	None
historiska	ah	None
historiskt	ah	None
history	taariikh	None
hit	halkan	None
hitler	dhuuni	Nan
hitlers	hitler	Nan
hits	hits	Nan
hitta	hel	Nan
hittade	helay	None
hittades	helay	None
hittar	hel	Nan
historier	sheekooyinka	None
hittat	helay	None
historiens	taariikhda	None
historia	taariikhda	None
himmler	himmler	Nan
himmlers	himmler	Nan
hinder	caqabad	Nan
hindra	ka	None
hindrade	hortagay	None
hindrar	ka	None
hindu	hindo	Nan
hinduer	hindo	Nan
hinduiska	hindo	Nan
hinduism	hinduuga	Nan
hinduismen	hindo	Nan
hinner	in	None
hiroshima	hiroshima	None
his	uu	None
hisingen	hisingen	Nan
historien	taariikhda	None
övrigt	kale	None
