+	+	None
ห้วยขวาง	హువాయ్ ఖ్వాంగ్	Nan
ห้วยทับทัน	హువై థాప్ థాన్	Nan
ห้องน้ำ	ముఖము కడుగుకొని, తలదువ్వుకొని, దుస్తులు ధరించు పద్ధతి	Nan
ห้องสมุด	గ్రంధాలయం	None
ห้าง	స్టోర్	Nan
ห้างฉัตร	చాట్ చేయండి	Nan
ห้างหุ้นส่วนจำกัด	పరిమిత భాగస్వామ్యము	Nan
ฬาพานิช	కమర్షియల్స్	Nan
อก	రొమ్ము	None
อคิลลีส	అకిలెస్	Nan
องคชาต	నాళం	Nan
องคต	సంస్థ	None
องค์กรปกครองส่วนท้องถิ่น	స్థానిక ప్రభుత్వ సంస్థ	Nan
องค์การนิสิต	విద్యార్థి సంస్థ	Nan
องค์การมหาชน	ప్రజా సంస్థ	Nan
องค์การสหประชาชาติ	ఐక్యరాజ్యసమితి	None
องค์บาก	ఓంగ్ బాక్	Nan
อนึ่ง	యాదృచ్ఛికంగా	Nan
อนาลโย	analoy	Nan
อนันตรัย	anantai	Nan
อนันตยะ	anantaya	Nan
อธิบายว่า	అని వివరించండి	Nan
อธิการบดีมหาวิทยาลัยธรรมศาสตร์	తమ్మసత్ విశ్వవిద్యాలయ అధ్యక్షుడు	Nan
ห่วงใย	సంరక్షణ	None
อธิการบดี	ఛాన్సలర్	Nan
อดีตรองนายกรัฐมนตรี	మాజీ ఉప ప్రధాని	Nan
อดีตผู้บัญชาการทหารบก	మాజీ మిలటరీ కమాండర్	Nan
อดีต	మాజీ	None
อดิศักดิ์	adisak	Nan
องอาจ	వాలియంట్	Nan
องค์ประกันหงสา	హాంగ్సా భీమా	Nan
อดีตรองหัวหน้าหน่วยที่	యూనిట్ మాజీ డిప్యూటీ హెడ్	Nan
อนุทิน	డైరీ	Nan
หเตุการณ์	పరిస్థితి	None
หุ่น	తోలుబొమ్మ	Nan
หลักสูตรวิทยาศาสตรมหาบัณฑิต	మాస్టర్ ఆఫ్ సైన్స్ ప్రోగ్రామ్	Nan
หลังจาก	తరువాత	None
หลังสงคราม	యుద్ధం తరువాత	Nan
หลังสงครามโลกครั้งที่	ప్రపంచ యుద్ధం తరువాత	Nan
หลังสงครามโลกครั้งที่สอง	రెండవ ప్రపంచ యుద్ధం తరువాత	Nan
หลังเหตุการณ์	ఈవెంట్ తరువాత	Nan
หลาย	అనేక	None
หลีกภัย	ఎస్కేప్	Nan
หลุมดำจิ๋ว	చిన్న కాల రంధ్రం	Nan
หล่มสัก	లోమ్ సాక్	Nan
หวาย	చెట్టు	None
หอก	ఈటె	Nan
หอประชุมพ่อขุนรามคำแหงมหาราช	రామ్ రామ్‌ఖమ్‌హాంగ్ ది గ్రేట్ ఆడిటోరియం	Nan
หอมรดกไทย	థాయ్ హెరిటేజ్ హాల్	Nan
หอย	షెల్ఫిష్	Nan
หอไอเฟล	పారిస్ నగరం లోని స్తూపం, ఈఫిల్ టవర్	Nan
หัก	ఇక్కడ తీసివేత	Nan
หุตะสิงห์	హుటా సింగ్	Nan
หี	పుస్సీ	Nan
หินไซอัล	పొట్టు రాయి	Nan
หินแกรนิต	గ్రానైట్	Nan
หินเชิร์ต	రాతి చొక్కా	Nan
หินอ่อน	పాలరాయి	Nan
หุ่นยนต์	రోబోట్	Nan
หินปูน	సున్నపురాయి	None
หาดทรายแก้ว	సాయి క్యూ బీచ్	Nan
หาง	తోక	None
หัวใจ	గుండె	None
หัวโขน	మాస్క్	Nan
หัวหิน	హువా హిన్	Nan
หัว	తల	None
หาบเร่	హాకర్	Nan
หลักสูตรภาษาไทย	థాయ్ భాషా కోర్సు	Nan
อนุสรณ์สถาน	మెమోరియల్	None
อปักธงชัย	పాక్ తోంగ్చాయ్	Nan
ออกมาในอะนิเมะเท่านั้น	అనిమేలో మాత్రమే వస్తుంది	Nan
ออกอากาศ	ప్రసార	Nan
ออกอากาศครั้งที่	ప్రసారం చేయబడింది	Nan
ออกอากาศทางช่อง	ప్రసారం	None
ออกัสตัส	ఆగస్టస్	Nan
ออกเป็น	ఇంటు	Nan
ออกแบบตัวละคร	అక్షర రూపకల్పన	Nan
ออนไลน์	ఆన్లైన్	Nan
ออฟ	ఆఫ్	Nan
ออลแบนี	మిత్రరాజ్యాలు	Nan
ออสเตรเลีย	ఆస్ట్రేలియా	None
ออโตทรอพ	ఆటోబొట్	Nan
อะ	ఏం	None
อะซูไรต์	azurite	Nan
อะตอม	అణువు	None
อะนิเมะ	అనిమే	Nan
อะบุราเมะ	aburame	Nan
อัธฮา	athha	Nan
อัตราการว่างงาน	నిరుద్యోగిత రేటు	Nan
อัฒภาค	సెమికోలన్	Nan
อัญมณี	రత్నం	None
อังการา	అంకారా	None
อังกฤษสมัยแองโกล-นอร์มัน	ఆంగ్లో-నార్మన్ ఇంగ్లీష్	Nan
ออกฉายครั้งแรกเมื่อวันที่	మొదట ప్రదర్శించబడింది	Nan
อักษรเกาหลี	కొరియన్ వర్ణమాల	Nan
อักษร	లేఖ	Nan
อะโลน	ఒంటరిగా	None
อะโกนิสต์	ఎగోనిస్ట్	Nan
อะลูมิเนียม	అల్యూమినియం	Nan
อะมาเดอุส	ఆమదెస్	Nan
อะพาไทต์	apatite	Nan
อักษรย่อ	నిర్వచనాల	Nan
อนุสรา	anusara	Nan
ออ	లేదా	None
อสมท	mcot	Nan
อพอลโล่	అపోలో	Nan
อพิมาย	aphimai	Nan
อภัยนุราช	క్షమించు	Nan
อภินันท์	aphinan	Nan
อภิปรัชญา	అధిభౌతిక	Nan
อภิรักษ์	aphirak	Nan
อมฤต	డెడ్	Nan
อมาตยกุล	amatayakun	Nan
อยู่	ఉన్నాయి	None
อยู่วิทยา	ఫిజియాలజీ	Nan
อยู่ห่างออกไปจากชายฝั่ง	తీరానికి దూరంగా	Nan
อยู่แล้ว	ఇప్పటికే	None
อยู่ในเขตอำเภอกุฉินารายณ์	కుచినారాయ్ జిల్లాలో ఉంది	Nan
อย่างต่อเนื่อง	నిరంతరం	None
อย่างแพร่หลาย	విస్తృతంగా	None
อย่างไรก็ตาม	అయితే	None
อร	orn	Nan
อศรีประจันต์	అశ్రీ ప్రచన్	Nan
อวัยวะเพศ	నాళం	Nan
อวัยวะสืบพันธุ์หญิง	ఆడ జననేంద్రియ అవయవాలు	Nan
อวัยวะสืบพันธุ์สตรีด้านนอก	బయట స్త్రీ జననేంద్రియ అవయవాలు	Nan
อวอร์ดส	పురస్కారాలు	None
อลิซ	ఆలిస్	Nan
อสามชุก	సామ్ చుక్	Nan
อลาสก้า	అలాస్కా	None
อรุณี	arunee	Nan
อริยสัจ	నోబెల్ ట్రూత్	Nan
อรัญประเทศ	aranyaprathet	Nan
อรรถพร	athaphon	Nan
อรรถกถา	వ్యాఖ్యానం	None
อรทัย	యువతి	Nan
อลังการ	అందాలు	Nan
อันดับ	రేటింగ్	Nan
หลักสูตรภาษาอังกฤษ	ఇంగ్లీష్ లాంగ్వేజ్ కోర్సు	Nan
หลักสูตรนานาชาติ	అంతర్జాతీయ కోర్సు	Nan
หน้าอก	ఛాతి	Nan
หมวด	సమూహం	None
หมวดหมู่	వర్గం	None
หมวดหมู่กลุ่มดนตรีที่ก่อตั้งในปี	సంగీత సమూహ వర్గం స్థాపించబడింది	Nan
หมวดหมู่กลุ่มดนตรีสัญชาติเกาหลี	కొరియన్ మ్యూజిక్ గ్రూప్ వర్గం	Nan
หมวดหมู่กวีชาวไทย	థాయ్ కవి వర్గం	Nan
หมวดหมู่การฉลองปีใหม่	నూతన సంవత్సర వేడుకల వర్గం	Nan
หมวดหมู่การประท้วงในประเทศไทย	థాయ్‌లాండ్‌లో వర్గం నిరసన	Nan
หมวดหมู่การ์ตูนญี่ปุ่นแนวโชเน็น	వర్గం: జపనీస్ కార్టూన్, షోనెన్ స్టైల్	Nan
หมวดหมู่จุลชีววิทยา	మైక్రోబయాలజీ వర్గం	Nan
หมวดหมู่ชาวไทยที่นับถือศาสนาพุทธ	వర్గం థాయ్ బౌద్ధులు	Nan
หมวดหมู่ชาวไทยที่เกิดในต่างประเทศ	వర్గం థాయ్ ప్రజలు విదేశాలలో జన్మించారు	Nan
หมวดหมู่ดาวเคราะห์ชั้นใน	లోపలి గ్రహం వర్గం	Nan
หมวดหมู่ดาวเคราะห์หิน	ప్లానెట్ స్టోన్ వర్గం	Nan
หมวดหมู่ทหารอากาศชาวไทย	థాయ్ వైమానిక దళం వర్గం	Nan
หมวดหมู่ทหารเรือชาวไทย	థాయ్ నేవీ వర్గం	Nan
หมวดหมู่นักการเมืองไทย	థాయ్ రాజకీయ నాయకుల వర్గం	Nan
หมวดหมู่ประวัติศาสตร์ไทย	థాయ్ చరిత్ర వర్గం	Nan
หมวดหมู่บุคคลที่เกี่ยวข้องกับเหตุการณ์	ఈవెంట్‌కు సంబంధించిన వ్యక్తుల వర్గం	Nan
หมวดหมู่บุคคลจากโรงเรียนมงฟอร์ตวิทยาลัย	మోంట్‌ఫోర్ట్ కళాశాల నుండి వ్యక్తుల వర్గం	Nan
หมวดหมู่บุคคลจากโรงเรียนนายร้อยพระจุลจอมเกล้า	చులాచోమ్క్లావ్ రాయల్ మిలిటరీ అకాడమీ నుండి వర్గాలు	Nan
หมวดหมู่บุคคลจากสถาบันบัณฑิตพัฒนศิลป์	బుండిట్‌పటనసిల్పా ఇనిస్టిట్యూట్ నుండి వచ్చిన వ్యక్తుల వర్గం	Nan
หมวดหมู่บุคคลจากมหาวิทยาลัยอ๊อกซฟอร์ด	ఆక్స్ఫర్డ్ విశ్వవిద్యాలయం నుండి వ్యక్తిగత వర్గం	Nan
หน่วยพันธุกรรม	జన్యు యూనిట్	Nan
หมวดหมู่บุคคลจากมหาวิทยาลัยสุโขทัยธรรมาธิราช	సుఖోతై తమ్మతిరత్ ఓపెన్ విశ్వవిద్యాలయం నుండి వర్గాలు	Nan
หมวดหมู่บุคคลจากจุฬาลงกรณ์มหาวิทยาลัย	చులాలాంగ్ కార్న్ విశ్వవిద్యాలయం నుండి వర్గాలు	Nan
หมวดหมู่บอยแบนด์	బాయ్ బ్యాండ్ వర్గం	Nan
หมวดหมู่บริษัทที่ก่อตั้งในปี	వర్గం కంపెనీ స్థాపించబడింది	Nan
หมวดหมู่บริษัทของไทย	థాయ్ కంపెనీ వర్గం	Nan
หมวดหมู่นายกรัฐมนตรีไทย	వర్గం థాయ్ ప్రధాన మంత్రి	Nan
หมวดหมู่นักร้องไทย	థాయ్ సింగర్ వర్గం	Nan
หมวดหมู่บุคคลจากมหาวิทยาลัยธรรมศาสตร์	తమ్మసత్ విశ్వవిద్యాలయం నుండి వర్గం	Nan
หมวดหมู่ประเภทของภาพยนตร์	సినిమా వర్గం వర్గం	Nan
หน่วยประมวลผลกลาง	సెంట్రల్ ప్రాసెసింగ్ యూనిట్	Nan
หน่วยที่	యూనిట్	Nan
ส่วนหัว	శీర్షిక	None
ส่วนในฤดูฝนน้ำจะท่วมทุกปี	వర్షాకాలంలో ప్రతి సంవత్సరం నీరు ప్రవహిస్తుంది.	Nan
ส่วนใหญ่	అత్యంత	None
ส่วนใหญ่เป็นโรงสีข้าว	వాటిలో ఎక్కువ బియ్యం మిల్లులు.	Nan
ส่องแสง	షైన్	Nan
ส้ม	నారింజ	None
ส้มเช้ง	నారింజ నారింజ	Nan
ส้มโอ	ద్రాక్షపండు	Nan
หงษ์ทอง	హాంగ్ థాంగ్	Nan
หงษ์มานพ	హాంగ్ మనోప్	Nan
หงสกุล	హాంగ్ సాకుల్	Nan
หญ้าทะเล	సముద్రపు గడ్డి	Nan
หญ้าฝรั่น	కుంకుమ	None
หนองคาย	నాంగ్ ఖాయ్	Nan
หนองม่วง	నాంగ్ మువాంగ్	Nan
หนองหาน	నాంగ్ హాన్	Nan
หนองฮี	నాంగ్ హీ	Nan
หน่วยทหารในค่าย	శిబిరంలో సైనిక విభాగం	Nan
หน่วยคำเติม	morpheme	Nan
หน่วยความจำ	మెమరీ	None
หนุ่ม	యువ	Nan
หนุมาน	హనుమాన్	None
หนึ่งธิดา	ఒక కుమార్తె	Nan
หน่วยบัญชาการนาวิกโยธิน	మెరైన్ కార్ప్స్ ప్రధాన కార్యాలయం	Nan
หนึ่ง	ఒకటి	None
หนังสือลามก	అశ్లీల పుస్తకాలు	Nan
หนังสือการ์ตูน	హాస్య పుస్తకం	Nan
หนังสือ	పుస్తకం	None
หนัก	భారీ	None
หนอน	వార్మ్	Nan
หนองแซง	జంగ్	Nan
หนังใหญ่	పెద్ద సినిమా	Nan
หลักสูตรปกติ	సాధారణ కోర్సు	Nan
หมวดหมู่ปรัชญา	తత్వశాస్త్రం వర్గం	Nan
หมวดหมู่พระราชปทินัดดาในรัชกาลที่	వర్గం రాయల్ పాలనలో	Nan
หมอชิต	morchit	Nan
หมากรุกสากล	అంతర్జాతీయ చెస్	Nan
หมายความว่า	మీన్స్	Nan
หมู่	స్వైన్	Nan
หมู่ที่	విలేజ్	Nan
หมู่เกาะเคย์แมน	కేమాన్ దీవులు	Nan
หมู่เกาะแบลีแอริก	బాలేరిక్ దీవులు	Nan
หมู่เกาะโซโลมอน	సోలమన్ దీవులు	Nan
หม่อมราชวงศ์ปรีดิยาธร	ఆర్. ప్రిడియాథోర్న్	Nan
หม่อมหลวงปิ่น	మామ్ పిన్	Nan
หม่อมเจ้าจุฑาวัชร	ప్రిన్స్ జుతావత్చాయ్	Nan
หม่อมเจ้าวัชรวีร์	ప్రిన్స్ వాచారావీ	Nan
หม่อมเจ้าวัชรเรศร	అమ్మ వాచారాచోర్న్	Nan
หม้อข้าวหม้อแกงลิง	నెపెంథిస్	None
หยุ่น	అనువైన	Nan
หรั่ง	లాంగ్	None
หรือ	లేదా	None
หลักสูตรที่เปิดสอน	కోర్సు	Nan
หลักสูตรการจัดการดุษฏีบัณฑิต	డాక్టర్ ఆఫ్ ఫిలాసఫీ ప్రోగ్రామ్ ఇన్ మేనేజ్‌మెంట్	Nan
หลักสี่	laksi	Nan
หลักทรัพย์	సెక్యూరిటీస్	Nan
หลักจริยธรรม	ఎథిక్స్	Nan
หลอดเลือดแดงใหญ่เอออร์ตา	బృహద్ధమని	Nan
หมวดหมู่โรงเรียนบุรุษในประเทศไทย	థాయిలాండ్‌లో పురుషుల పాఠశాల వర్గం	Nan
หลอดอาหาร	అన్నవాహిక	Nan
หลวง	రాజ	None
หรือเรียกว่า	లేదా పిలిచారు	Nan
หรือที่เรียกกันว่า	ఇలా కూడా అనవచ్చు	Nan
หรือที่รู้จักกันในชื่อ	లేదా అంటారు	Nan
หรือชื่อทางการคือ	లేదా అధికారిక పేరు	Nan
หรือการแสดงธงชาติ	లేదా జాతీయ జెండాను చూపిస్తోంది	Nan
หลอก	మిధ్యా	Nan
หมวดหมู่พระราชนัดดาในรัชกาลที่	వర్గం రాయల్ మనవడు	Nan
หมวดหมู่โรงเรียนที่มีอัตราการแข่งขันสูง	అధిక పోటీ రేట్లు ఉన్న పాఠశాలల వర్గం	Nan
หมวดหมู่แนวพระราชดำริ	ఇనిషియేటివ్ వర్గం	Nan
หมวดหมู่พระราชปนัดดาในรัชกาลที่	వర్గం కింగ్ పనాడ్డ పాలనలో	Nan
หมวดหมู่พิธีกรไทย	వర్గం థాయ్ సమర్పకులు	Nan
หมวดหมู่ฟุตบอลในประเทศไทย	థాయ్‌లాండ్‌లో ఫుట్‌బాల్ వర్గం	Nan
หมวดหมู่ภัยธรรมชาติ	ప్రకృతి విపత్తు వర్గం	Nan
หมวดหมู่ภัยพิบัติทางการแพทย์	వైద్య విపత్తు వర్గం	Nan
หมวดหมู่มหาวิทยาลัยธรรมศาสตร์	తమ్మసత్ విశ్వవిద్యాలయ వర్గం	Nan
หมวดหมู่รัชกาลที่	వర్గం పాలన	Nan
หมวดหมู่รัฐคอมมิวนิสต์	కమ్యూనిస్ట్ రాష్ట్ర వర్గం	Nan
หมวดหมู่รัฐมนตรีว่าการกระทรวงการต่างประเทศไทย	థాయ్ విదేశాంగ మంత్రి వర్గం	Nan
หมวดหมู่รัฐวิสาหกิจไทย	వర్గం థాయ్ సంస్థలు	Nan
หมวดหมู่รัฐสิ้นสภาพในทวีปเอเชีย	రాష్ట్రంలోని వర్గం రాష్ట్రం ఆసియాలో ఆగిపోయింది	Nan
หมวดหมู่รัฐและดินแดนที่ก่อตั้งในปี	వర్గం రాష్ట్రం మరియు భూభాగం స్థాపించబడింది	Nan
หมวดหมู่รายการโทรทัศน์ไทย	థాయ్ టెలివిజన్ ప్రోగ్రామ్ వర్గం	Nan
หมวดหมู่ละครโทรทัศน์ไทย	వర్గం థాయ్ టెలివిజన్ డ్రామా	Nan
หมวดหมู่วัฒนธรรมไทย	థాయ్ సంస్కృతి వర్గం	Nan
หมวดหมู่วันสำคัญทางศาสนาที่นับโดยปฏิทินจันทรคติ	చంద్ర క్యాలెండర్ లెక్కించిన ముఖ్యమైన మత దినాల వర్గాలు	Nan
หมวดหมู่ศิลปินสังกัดจีเอ็มเอ็ม	gmm కింద ఆర్టిస్ట్ వర్గం	Nan
หมวดหมู่เพศศึกษา	సెక్స్ ఎడ్యుకేషన్ వర్గం	Nan
หมวดหมู่เครื่องเทศ	మసాలా వర్గం	Nan
หมวดหมู่อวัยวะเพศ	జననేంద్రియ వర్గం	Nan
หมวดหมู่อวัยวะ	అవయవ వర్గం	Nan
หมวดหมู่อดีตอาณานิคมของอังกฤษ	బ్రిటిష్ మాజీ వలసరాజ్యాల వర్గం	Nan
หมวดหมู่อดีตอาณานิคมของสเปน	మాజీ స్పానిష్ వలసరాజ్యాల వర్గం	Nan
หมวดหมู่โรค	వ్యాధి వర్గం	Nan
หมวดหมู่อดีตอาณานิคมของฝรั่งเศส	ఫ్రెంచ్ మాజీ వలసరాజ్యాల వర్గం	Nan
หมวดหมู่สิ้นสุดในคริสต์ศตวรรษที่	వర్గం 19 వ శతాబ్దంలో ముగిసింది.	Nan
หมวดหมู่สิ่งก่อสร้างในพุทธศตวรรษที่	21 వ శతాబ్దంలో భవనాల వర్గం	Nan
หมวดหมู่สัตว์เลื้อยคลาน	సరీసృపాల వర్గం	Nan
หมวดหมู่สัตว์มีแกนสันหลัง	వర్గం వెన్నుపూస అక్షం	Nan
หมวดหมู่สมุนไพร	హెర్బ్ వర్గం	Nan
หมวดหมู่สถาบันอุดมศึกษาในกรุงเทพมหานคร	బ్యాంకాక్‌లోని ఉన్నత విద్యా సంస్థల వర్గాలు	Nan
หมวดหมู่สโมสรในพรีเมียร์ลีก	ప్రీమియర్ లీగ్‌లో క్లబ్ వర్గం	Nan
อันประกอบด้วย	కలిగి	None
อันโตนิโอ	ఆంటోనియో	Nan
อันโตนีโอ	ఆంటోనియో	Nan
อุณหเคมี	thermochemistry	Nan
อุดม	సారవంతమైన	Nan
อุดรธานี	ఉడాన్ తని	Nan
อุตตมะโยธิน	ఉప్పారత్ యోతిన్	Nan
อุตรดิตถ์	uttaradit	Nan
อุทยาน	పార్క్	None
อุทยานประวัติศาสตร์พนมรุ้ง	ఫనోమ్ రంగ్ హిస్టారికల్ పార్క్	Nan
อุทยานประวัติศาสตร์พิมาย	ఫిమై హిస్టారికల్ పార్క్	Nan
อุทยานแห่งชาติคลองตรอน	ఖ్లాంగ్ ట్రోన్ నేషనల్ పార్క్	Nan
อุทยานแห่งชาติดอยภูคา	డోయి ఫు ఖా నేషనల్ పార్క్	Nan
อุทยานแห่งชาติดอยอินทนนท์	డోయి ఇంటానాన్ నేషనల్ పార్క్	Nan
อุทยานแห่งชาติทุ่งแสลงหลวง	తుంగ్ సలాంగ్ లుయాంగ్ నేషనల్ పార్క్	Nan
อุทยานแห่งชาติธารโบกขรณี	బోక్ ఖొరానీ నేషనల్ పార్క్ కంటే	Nan
อุทยานแห่งชาติน้ำตกสี่ขีด	సి ఖిత్ జలపాతం నేషనల్ పార్క్	Nan
อุทยานแห่งชาติน้ำพอง	నామ్ ఫోంగ్ నేషనల్ పార్క్	Nan
อุทยานแห่งชาติภูผาเหล็ก	ఐరన్ మౌంటైన్ నేషనల్ పార్క్	Nan
อุทยานแห่งชาติภูพาน	ఫు ఫాన్ నేషనల్ పార్క్	Nan
อุภัยราศี	రాశిచక్రం క్షమించు	Nan
อุปนิสัย	పాత్ర	None
อุปกรณ์คอมพิวเตอร์	కంప్యూటర్ ఉపకరణాలు	Nan
อุปกรณ์	పరికరాలు	None
อุบล	ఉబోన్	Nan
อุทุมพรพิสัย	ఉతుంఫోన్ ఫిసాయ్	Nan
อุณหภูมิ	ఉష్ణోగ్రత	None
อุทยานแห่งชาติไทรทอง	సాయి థాంగ్ నేషనల్ పార్క్	Nan
อุทยานแห่งชาติหาดนพรัตน์ธาราหมู่เกาะพีพี	నోఫారత్ తారా బీచ్ నేషనల్ పార్క్, ఫై ఫై ఐలాండ్స్	Nan
อุทยานแห่งชาติภูแลนคา	ఫులాంకా నేషనల్ పార్క్	Nan
อุทยานแห่งชาติภูเวียง	ఫు వియాంగ్ నేషనల్ పార్క్	Nan
อุทยานแห่งชาติภูเรือ	ఫు రూయా నేషనల్ పార్క్	Nan
อุทยานแห่งชาติภูสอยดาว	ఫు సోయి దావో నేషనల్ పార్క్	Nan
อุทยานแห่งชาติภูสวนทราย	ఫు సువాన్ సాయి నేషనల్ పార్క్	Nan
อุทยานแห่งชาติเขาหลวง	ఖావో లుయాంగ్ నేషనల్ పార్క్	Nan
อุรุกวัย	ఉరుగ్వే	Nan
อุซึมากิ	ఉజుమకి	Nan
อื่น	మరో	None
อำเภอแม่แจ่ม	మే చైమ్ జిల్లా	Nan
อำเภอแม่แตง	మే తెంగ్ జిల్లా	Nan
อำเภอโนนดินแดง	నాన్ దిన్ డేంగ్ జిల్లా	Nan
อำเภอโนนสุวรรณ	నాన్ సువాన్ జిల్లా	Nan
อิงค์	ఇంక్	Nan
อิงลิช	ఆంగ్ల	None
อิทธิพล	పలుకుబడి	Nan
อิน	లో	None
อินทิรา	ఇందిరా	None
อินฟราเรด	పరారుణ	Nan
อินฮิบิเตอร์	నిరోధకం	Nan
อินุยาฉะ	inuyasha	Nan
อินเซคทิวอรา	inseqtura	Nan
อินเดียน	భారత	None
อินเด็กซ์	ఇండెక్స్	None
อินโดนีเซีย	ఇండోనేషియా	None
อิม	imm	Nan
อือ	అవును!	Nan
อึ๊งภากรณ์	ungphakorn	Nan
อึ	ఒంటి	Nan
อีกด้วย	టూ	Nan
อีกครั้ง	మరోసారి	Nan
อีก	మరింత	None
อุ	o	Nan
อิโนะ	నెను కాదు	Nan
อิหร่าน	ఇరాన్	None
อิสตันบูล	ఇస్తాంబుల్	Nan
อิริโทรมัยซิน	విద్యుద్విశ్లేషణ	Nan
อิรัก	ఇరాక్	None
อิมแพ็ค	impact	Nan
อิมาจิน	imajin	Nan
อิเควทอเรียลกินี	ఈక్వటోరియల్ గినియా	Nan
อำเภอแม่ทะ	మే థా జిల్లా	Nan
อุเทน	uthen	Nan
อู๋	వు	Nan
ฮิโซกะ	hisoka	Nan
ฮิโรชิ	హిరోషి	Nan
ฮีชอล	heechul	Nan
ฮุก	హుక్	Nan
ฮโยยอน	hyoyeon	Nan
ฯพณฯ	ఆయన శ్రేష్ఠత	Nan
เกตส์	గేట్స్	None
เกตุทัต	ketthat	Nan
เกมที่	ఆట	None
เกมบุค	గేమ్	Nan
เกรย์	గ్రే	Nan
เกษตรกรรม	వ్యవసాయ	None
เกษตรวิสัย	కసెట్ విసాయ్	Nan
เกษมศรี	kasemsri	Nan
เกอริง	gering	Nan
เกอไทต์	గోథీ	Nan
เกาหลีใต้	దక్షిణ కొరియా	Nan
เกียรติศักดิ์	గ్లోరీ	Nan
เกียรติประวัติ	ఆనర్	Nan
เกียรติ	గౌరవం	None
เกิดนิมิตร	ఒక దృష్టిని సృష్టించండి	Nan
เกิดจากเชื้อไวรัส	వైరస్ వల్ల వస్తుంది	Nan
เกิดจากการรวมตัวของ	యొక్క విలీనం వలన కలుగుతుంది	Nan
ฮิวงะ	hyuga	Nan
เกิดจากการรวมชิ้นส่วนที่	ఆ భాగాలను కలపడం ద్వారా కలుగుతుంది	Nan
เกิดขึ้นหลังจากมหาวิทยาลัยศรีนครินทรวิโรฒวิทยาเขตต่างๆ	శ్రీనాఖరిన్విరోట్ విశ్వవిద్యాలయం తరువాత సంభవించింది	Nan
เกิด	జన్మించాడు	None
เกาะสุมาตรา	సుమత్రా	Nan
เกาะลูซอน	లుజోన్ ద్వీపం	Nan
เกาะคา	కాయై	Nan
เกาะ	ద్వీపం	None
เกิดขึ้นเมื่อวันที่	సంభవించింది	Nan
อู	ou	Nan
ฮิราโกะ	hirako	Nan
ฮินาตะ	hinata	Nan
อเมริกัน	అమెరికన్	None
อเมริกา	అమెరికా	None
อเมริกาเหนือ	ఉత్తర అమెరికా	Nan
อเล็กซานเดอร์	అలెగ్జాండర్	None
อเล็กซ์	అలెక్స్	Nan
อโลหะ	కాని మెటల్	Nan
อ่อนเพลีย	అలసిన	Nan
อ่าน	చదవండి	Nan
อ่าวลึก	అయో లుయెక్	Nan
อ้างว่า	అని దావా వేయండి	Nan
อ้างว้าง	ఏకాంతమైన	Nan
ฮอกกี้	హాకీ	None
ฮอท	హాట్	Nan
ฮอฟมัน	హాఫ్మన్	Nan
ฮอยเกนส์	hogens	Nan
ฮอร์โมน	హార్మోన్	Nan
ฮอลแลนด์	హాలండ్	Nan
ฮิตเลอร์	హిట్లర్	None
ฮิซานะ	hisana	Nan
ฮิซาชิ	hisashi	Nan
ฮาวาย	హవాయి	None
ฮารุกะ	haruka	Nan
ฮายาโตะ	hayato	Nan
ฮิมาวาริ	himawari	Nan
ฮานอย	హనోయి	Nan
ฮาจิ	hachi	Nan
ฮัมบูร์ก	హాంబర్గ్	Nan
ฮันกึล	హాంగుల్	Nan
ฮักบี้	గుడ్బై	Nan
ฮอว์ค	సీహాక్స్	Nan
ฮอลโลว์	హాలో	Nan
ฮาตาเกะ	hatake	Nan
อำเภอแจ้ห่ม	చాయ్ హోమ్ జిల్లా	Nan
อำเภอเสริมงาม	సోమ్ న్గం జిల్లా	Nan
อำเภอเวียงแก่น	వియాంగ్ కెన్ జిల్లా	Nan
อานโตนิโอ	ఆంటోనియో	Nan
อาบาราอิ	abarai	Nan
อายุ	వయస్సు	None
อารยา	araya	Nan
อาร์	r	Nan
อาร์กอน	ఆర్గాన్	Nan
อาร์คิมิดีส	ఆర్కిమెడిస్	None
อาร์ม	సాయుధం	Nan
อาร์มาดิลโล	కవచకేసి	Nan
อาร์เคด	ఆర్కేడ్	Nan
อาร์เมเนีย	అర్మేనియా	Nan
อาร์เอ็นเอ	rna	Nan
อาร์โนลด์	ఆర్నాల్డ్	Nan
อาวุธคือ	ఆయుధం	Nan
อาวุธประจำกาย	వ్యక్తిగత ఆయుధం	Nan
อาหาร	ఆహార	None
อาเจียน	వాంతి	Nan
อำเภอดอยสะเก็ด	దోయి సాకేత్ జిల్లా	Nan
อำเภอจอมทอง	చోమ్ థాంగ్ జిల్లా	Nan
อำเภอคูเมือง	ఖు ముయాంగ్ జిల్లా	Nan
อำเภอครบุรี	ఖోన్ బురి జిల్లా	Nan
อำเภอขุนหาญ	ఖున్ హాన్ జిల్లా	Nan
อำเภอขุขันธ์	ఖుఖాన్ జిల్లా	Nan
อานุภาพ	శక్తి	None
อำเภอกันทรลักษ์	కాంతరలక్ జిల్లా	Nan
อำเภอกมลาไสย	కమలాసాయి జిల్లా	Nan
อำเภอ	జిల్లా	None
อำนาจอธิปไตย	సార్వభౌమత్వాన్ని	Nan
อำนาจ	శక్తి	None
อาเนีย	అన	Nan
อาเธอร์	ఆర్థర్	Nan
อำเภอกระสัง	క్రాసాంగ్ జిల్లా	Nan
อำเภอด่านขุนทด	డాన్ ఖున్ థాట్ జిల్లా	Nan
อานันทมหิดล	ఆనంద మహీడోల్	Nan
อาทิตย์	వారం	None
อันได้แก่	ఇంక్లూడింగ్	Nan
อัฟกานิสถาน	ఆఫ్గనిస్తాన్	Nan
อัมพร	amporn	Nan
อัมพาต	పక్షవాతం	Nan
อัลบัส	అల్బస్	Nan
อัลบั้ม	ఆల్బమ్	Nan
อัลเดบารัน	రోహిణి	None
อัลเฟรด	ఆల్ఫ్రెడ్	Nan
อัสนี	బోల్ట్	Nan
อาการหวาดระแวง	పారనోయియా	Nan
อากาศ	ఎయిర్	None
อากาศอำนวย	వాతావరణ	None
อากาเป	అగాపే	Nan
อาคามัตสึ	akamatsu	Nan
อาคารส่วนที่	భవనం విభాగం	Nan
อาคารอุบลรัตนราชกัญญา	ఉబోన్రటన రత్చకన్య భవనం	Nan
อาคารเฉลิมพระเกียรติ	చలోమ్ ఫ్రాకియాట్ భవనం	Nan
อาทิ	వంటివి	None
อาดัม	ఆడమ్	Nan
อาณาเขตติดต่อ	సంప్రదింపు ప్రాంతం	Nan
อาณาจักรแพกเจ	పాకే రాజ్యం	Nan
อาณาจักรอยุธยาเริ่มเสื่อมอำนาจลงราวพุทธศตวรรษที่	ఆయుత రాజ్యం శతాబ్దంలో అధికారంలో క్షీణించడం ప్రారంభమైంది.	Nan
อาณาจักรอยุธยาปกครองเขมรเป็นเวลาเกือบปี	ఆయుత రాజ్యం కంబోడియాను దాదాపు ఒక సంవత్సరం పాటు పరిపాలించింది.	Nan
อานนท์	అనన్	Nan
อาณาจักรสุโขทัย	సుఖోథాయ్ రాజ్యం	Nan
อาณาจักร	రాజ్యం	None
อาณัตพล	anataphon	Nan
อาซึกะ	ౌ	Nan
อาจารย์ใหญ่	ప్రధానోపాధ్యాయుడు	Nan
อาจารย์	ప్రొఫెసర్	Nan
อาจหมายถึง	అర్థం కావచ్చు	Nan
อาณาจักรธนบุรี	తోన్బురి రాజ్యం	Nan
อำเภอตะพานหิน	తఫాన్ హిన్ జిల్లా	Nan
อำเภอทับคล้อ	థాప్ ఖ్లో జిల్లా	Nan
อำเภอทุ่งช้าง	తుంగ్ చాంగ్ జిల్లా	Nan
อำเภอศรีเมืองใหม่	సి ముయాంగ్ మాయి జిల్లా	Nan
อำเภอสระโบสถ์	sra చర్చి జిల్లా	Nan
อำเภอสหัสขันธ์	సహత్సాఖాన్ జిల్లా	Nan
อำเภอสองแคว	పాట ఖ్వా	Nan
อำเภอสังขะ	సంఘా జిల్లా	Nan
อำเภอสันป่าตอง	శాన్ పా టోంగ్ జిల్లా	Nan
อำเภอสามพราน	సామ్ ఫ్రాన్ జిల్లా	Nan
อำเภอสารภี	సారాఫీ జిల్లా	Nan
อำเภอสิชล	సిచాన్ జిల్లా	Nan
อำเภอสุไหงโกลก	సుంగై కోలోక్ జిల్లా	Nan
อำเภอหนองกี่	నాంగ్ కీ జిల్లా	Nan
อำเภอห้วยราช	హువై ఎలుక జిల్లా	Nan
อำเภออมก๋อย	ఓంకోయి జిల్లా	Nan
อำเภอเกาะคา	కో ఖా జిల్లా	Nan
อำเภอเขวาสินรินทร์	ఖ్వావో సినారిన్ జిల్లా	Nan
อำเภอเฉลิมพระเกียรติ	చలోమ్ ఫ్రాకియాట్ జిల్లా	Nan
อำเภอเชียงของ	చియాంగ్ ఖోంగ్ జిల్లా	Nan
อำเภอเวียงชัย	వియాంగ్ చాయ్ జిల్లా	Nan
อำเภอเมืองเพชรบุรี	ముయాంగ్ ఫెట్చాబురి జిల్లా	Nan
อำเภอเมืองเชียงใหม่	ముయాంగ్ చియాంగ్ మాయి జిల్లా	Nan
อำเภอเมืองอุตรดิตถ์	ముయాంగ్ ఉత్తరాదిట్ జిల్లా	Nan
อำเภอเมืองสุรินทร์	ముయాంగ్ సురిన్ జిల్లా	Nan
อำเภอเมืองลพบุรี	ముయాంగ్ లోప్ బురి జిల్లా	Nan
อำเภอศรีณรงค์	సి నరోంగ్ జిల్లా	Nan
อำเภอเมืองพิษณุโลก	ముయాంగ్ ఫిట్సానులోక్	Nan
อำเภอเมืองบุรีรัมย์	ముయాంగ్ బురి రామ్ జిల్లా	Nan
อำเภอเมืองนนทบุรี	ముయాంగ్ నోంతబురి జిల్లా	Nan
อำเภอเมืองนครราชสีมา	ముయాంగ్ నాఖోన్ రాట్చసిమా జిల్లా	Nan
อำเภอเมืองกาฬสินธุ์	ముయాంగ్ కలసిన్ జిల్లా	Nan
อำเภอเชียรใหญ่	చియాన్ యాయ్ జిల్లా	Nan
อำเภอเชียงคาน	చియాంగ్ ఖాన్ జిల్లా	Nan
อำเภอเมืองพิจิตร	ముయాంగ్ ఫిచిట్ జిల్లా	Nan
อำเภอลำปลายมาศ	లామ్ ప్లే మాట్ జిల్లా	Nan
อำเภอลาดหลุมแก้ว	లాట్ లమ్ కయో జిల్లా	Nan
อำเภอร่อนพิบูลย์	రాన్ ఫిబన్ జిల్లా	Nan
อำเภอบ้านลาด	లాట్ జిల్లాను నిషేధించండి	Nan
อำเภอบางเสาธง	బ్యాంగ్ సావో థాంగ్ జిల్లా	Nan
อำเภอบางละมุง	బ్యాంగ్ లాముంగ్ జిల్లా	Nan
อำเภอบางพลี	బ్యాంగ్ ఫిలి జిల్లా	Nan
อำเภอบางบ่อ	బ్యాంగ్ బో జిల్లా	Nan
อำเภอบางบัวทอง	బ్యాంగ్ బువా థాంగ్ జిల్లా	Nan
อำเภอบ้านหมี่	బాన్ మి జిల్లా	Nan
อำเภอบัวใหญ่	బువా యాయ్ జిల్లా	Nan
อำเภอน้ำเกลี้ยง	నామ్ క్లియాంగ్ జిల్లా	Nan
อำเภอนาบอน	నా బోన్ జిల్లా	Nan
อำเภอนครชัยศรี	నాఖోన్ చాయ్ సి జిల్లా	Nan
อำเภอท่าวุ้ง	థా వుంగ్ జిల్లా	Nan
อำเภอท่าวังผา	థా వాంగ్ ఫా జిల్లా	Nan
อำเภอท่าตูม	థా తుమ్ జిల్లా	Nan
อำเภอบัวเชด	బుచెట్ జిల్లా	Nan
ส่วนส่งกำลังบำรุง	లాజిస్టిక్స్ విభాగం	Nan
อำเภอปราสาท	ప్రసాత్ జిల్లా	Nan
อำเภอปากพนัง	పాక్ ఫనాంగ్ జిల్లా	Nan
อำเภอราษีไศล	రాసి సలై జిల్లా	Nan
อำเภอรัตนบุรี	రత్తనాబురి జిల్లా	Nan
อำเภอรหัสไปรษณีย์หมายเหตุ	జిల్లా, పోస్ట్‌కోడ్, గమనిక	Nan
อำเภอยางชุมน้อย	యాంగ్ చుమ్ నోయి జిల్లా	Nan
อำเภอภูสิงห์	ఫు సింగ్ జిల్లా	Nan
อำเภอพุทธมณฑล	ఫుట్టమోంటన్ జిల్లా	Nan
อำเภอปากช่อง	పాక్ చోంగ్ జిల్లా	Nan
อำเภอพิปูน	ఫిపున్ జిల్లా	Nan
อำเภอพลับพลาชัย	ఫ్లాప్లా చాయ్ జిల్లా	Nan
อำเภอพระสมุทรเจดีย์	ఫ్రా సముత్ చెడి జిల్లా	Nan
อำเภอพระพรหม	ఫ్రా ఫ్రామ్ జిల్లా	Nan
อำเภอพระประแดง	ఫ్రా ప్రదేంగ్ జిల్లా	Nan
อำเภอฝาง	ఫాంగ్ జిల్లా	Nan
อำเภอปาย	పై జిల్లా	Nan
อำเภอพัฒนานิคม	ఫత్తానా నిఖోమ్ జిల్లా	Nan
เกียวโตะ	క్యోటో	Nan
ส่วนสูง	ఎత్తు	None
ส่วนของผู้ถือหุ้น	వాటాదారుల ఈక్విటీ	Nan
วิลเลียม	విలియం	None
วิลเลี่ยม	విలియం	None
วิวัฒนาการ	పరిణామం	None
วิวัฒน์	రూపొందించబడి	Nan
วิวัฒน์เกียรติ	వివాట్ కియాట్	Nan
วิศว	ఇంజినీరింగ్	None
วิศวกร	ఇంజనీర్	Nan
วิศวกรรมวัสดุ	మెటీరియల్ ఇంజనీరింగ్	Nan
วิศวกรรมสิ่งแวดล้อม	పర్యావరణ ఇంజనీరింగ్	Nan
วิศวกรรมเครื่องกล	మెకానికల్ ఇంజనీరింగ్	Nan
วิศวกรรมไฟฟ้า	ఎలక్ట్రికల్ ఇంజనీరింగ్	Nan
วิสา	wisisa	Nan
วิสูตร	డయాగ్నోస్టిక్	Nan
วิหาร	అభయారణ్యం	Nan
วิเศษ	మేజిక్	Nan
วิเศษแก้ว	మేజిక్ గ్లాస్	Nan
วิโนทัย	vinothai	Nan
ศรีนครินทร์	srinakarin	Nan
ศรายุทธ	sarayuth	Nan
ศรชัย	sornchai	Nan
ศร	బాణం	None
ศ	ప్రొఫెసర్	Nan
ว้าวุ่น	పరధ్యానంలో	Nan
วิลเลจ	విలేజ్	Nan
วุฒิเมธี	wuttimethi	Nan
วีออส	vios	Nan
วีระยุทธ	wirayut	Nan
วีระ	వీర	None
วีรบุรุษ	హీరో	None
วีดีโอเกม	వీడియో గేమ్	Nan
วีดีโอ	వీడియో	Nan
วุฒิสภา	సెనేట్	Nan
ศรีนวล	srinual	Nan
วิลลี่	విల్లీ	Nan
วิบูลย์	గుడ్బై	Nan
วิตามินอี	విటమిన్ ఇ	Nan
วิทยาการคอมพิวเตอร์	కంప్యూటర్ సైన్స్	Nan
วิทยาการระบาด	సాంక్రమిక రోగ విజ్ఞానం	Nan
วิทยาลัยการจัดการเพื่อการพัฒนา	కాలేజ్ ఆఫ్ మేనేజ్‌మెంట్ ఫర్ డెవలప్‌మెంట్	Nan
วิทยาลัยการบริหารรัฐกิจ	కాలేజ్ ఆఫ్ పబ్లిక్ అడ్మినిస్ట్రేషన్	Nan
วิทยาลัยครูสวนสุนันทา	సువాన్ సునంధ ఉపాధ్యాయ కళాశాల	Nan
วิทยาลัยดุริยางคศิลป์	కాలేజ్ ఆఫ్ మ్యూజిక్	Nan
วิทยาลัยนวัตกรรมและการจัดการ	కాలేజ్ ఆఫ్ ఇన్నోవేషన్ అండ్ మేనేజ్‌మెంట్	Nan
วิทยาลัยพยาบาลกองทัพเรือ	నావల్ నర్సింగ్ కళాశాల	Nan
วิทยาลัยพยาบาลบรมราชชนนี	బోరోమరాజోనాని కాలేజ్ ఆఫ్ నర్సింగ్	Nan
วิทยาลัยพาณิชยศาสตร์	కాలేజ్ ఆఫ్ కామర్స్	Nan
วิทยาลัยวิชาการศึกษา	విద్య కళాశాల	Nan
วิทยาลัยเทคนิคธนบุรี	తోన్బురి టెక్నికల్ కాలేజీ	Nan
วิทยาลัยแพทยศาสตร์พระมงกุฎเกล้า	ఫ్రామోంగ్కుట్క్లావ్ కాలేజ్ ఆఫ్ మెడిసిన్	Nan
วิทยาศาสตรมหาบัณฑิต	శాస్త్రవేత్త	None
วิทยาศาสตร์สุขภาพ	ఆరోగ్య శాస్త్రం	Nan
วิทยาศาสตร์และเทคโนโลยี	శాస్త్రీయ మరియు సాంకేతిక విజ్ఞానాలు	Nan
วินเนอร์	విజేత	None
วินัย	క్రమశిక్షణ	None
วินชี	విన్సీ	Nan
วิธีการหาความสัมพันธ์	సంబంధాలను ఎలా కనుగొనాలి	Nan
วิทยุ	రేడియో	None
วิทยาเขตเฉลิมพระเกียรติ	చలోమ్ ఫ్రాకియాట్ క్యాంపస్	Nan
วิมเบิลดัน	వింబుల్డన్	Nan
วิทยาเขตหนองคาย	నాంగ్ ఖాయ్ క్యాంపస్	Nan
วิทยาเขตสุพรรณบุรี	సుఫన్‌బురి క్యాంపస్	Nan
วิทยาเขตสารสนเทศเพชรบุรี	ఫెట్చాబురి ఇన్ఫర్మేషన్ టెక్నాలజీ క్యాంపస్	Nan
วิทยาเขตพิษณุโลก	ఫిట్సానులోక్ క్యాంపస్	Nan
วิทยาเขตนครศรีธรรมราช	నాఖోన్ సి తమ్మరత్ క్యాంపస్	Nan
วิทยาเขตกาญจนบุรี	కాంచనబురి క్యాంపస్	Nan
วิทยาเขต	క్యాంపస్	Nan
วิทยาเขตสุรินทร์	సురిన్ క్యాంపస్	Nan
วิดีโอเกม	వీడియో గేమ్	Nan
ศรีบุญเรือง	శ్రీ బున్రూయాంగ్	Nan
ศรีปาน	శ్రీ పాన్	Nan
ศึกษาศาสตร์	చదువు	None
ศุกลวัฒน์	sukonwat	Nan
ศุภกิจ	supakit	Nan
ศุภณัฐ	suphanat	Nan
ศูนย์	సెంటర్	None
ศูนย์การค้า	షాపింగ్ సెంటర్	Nan
ศูนย์การบินทหารบก	ఆర్మీ ఏవియేషన్ సెంటర్	Nan
ศูนย์การศึกษาแม่ฮ่องสอน	మే హాంగ్ సన్ ఎడ్యుకేషన్ సెంటర్	Nan
ศูนย์คอมพิวเตอร์	కంప్యూటర్ సెంటర్	Nan
ศูนย์ค้าส่ง	టోకు కేంద్రం	Nan
ศูนย์บริการวิชาการ	విద్యా సేవా కేంద్రం	Nan
ศูนย์ภาษา	భాషా కేంద్రం	Nan
ศูนย์รังสิต	రంగ్సిత్ సెంటర్	Nan
ศูนย์ลำปาง	లాంపాంగ్ సెంటర్	Nan
ศูนย์แพทยศาสตรศึกษาชั้นคลินิก	క్లినికల్ మెడిసిన్ ఎడ్యుకేషన్ సెంటర్	Nan
สก	స్క్రూ	Nan
สกว	trf	Nan
สง่าพล	సొగసైన	Nan
สงครามเย็น	ప్రచ్ఛన్న యుద్ధం	Nan
สงครามเกาหลี	కొరియా యుద్ధం	Nan
สงครามอวกาศ	అంతరిక్ష యుద్ధం	Nan
สงครามมหาเอเชียบูรพา	గ్రేట్ ఈస్ట్ ఆసియా యుద్ధం	Nan
สงครามครูเสด	క్రూసేడ్	Nan
ศึกนันทบุเรง	నంతాబురేంగ్ యుద్ధం	Nan
สงคราม	యుద్ధం	None
สกุลเพชรหึง	petcheng	Nan
สกุลหยาดน้ำค้าง	sundew	Nan
สกุล	కుటుంబ	Nan
สกาย	స్కై	Nan
สกอตแลนด์	స్కాట్లాండ్	Nan
สกอ	స్కాట్లాండ్	Nan
สควอโล่	squalo	Nan
ศรีประจวบ	సి ప్రాచువాప్	Nan
ศีรษะ	తల	None
ศิษย์เก่าคณะรัฐศาสตร์	పొలిటికల్ సైన్స్ పూర్వ విద్యార్థుల ఫ్యాకల్టీ	Nan
ศรีมะฆะ	శ్రీ మాఖా	Nan
ศรียาภัย	sriyapai	Nan
ศรีสวัสดิ์	srisawat	Nan
ศรีสำโรง	సి సమ్రాంగ్	Nan
ศรีเมือง	శ్రీ మువాంగ్	Nan
ศรีไพร	శ్రీ ఫ్రే	Nan
ศรเพชร	డైమండ్ బాణం	Nan
ศศิธร	sasithorn	Nan
ศักดิ์ศรี	ప్రతిష్ట	None
ศักย์ไฟฟ้า	విద్యుత్ సామర్థ్యం	Nan
ศัพท์	పదజాలం	Nan
ศาลชั้นต้น	సివిల్ కోర్టు	Nan
ศาลหลักเมือง	సిటీ పిల్లర్ పుణ్యక్షేత్రం	Nan
ศาลเจ้าพ่อหลักเมือง	సిటీ పిల్లర్ పుణ్యక్షేత్రం	Nan
ศาสตราจารย์	ప్రొఫెసర్	Nan
ศาสนา	మతం	None
ศาสนาพราหมณ์ฮินดู	హిందూమతం	None
ศิษย์เก่าคณะมนุษยศาสตร์	హ్యుమానిటీస్ పూర్వ విద్యార్థుల ఫ్యాకల్టీ	Nan
ศิลป์	ఆర్ట్	None
ศิลปินแห่งชาติ	జాతీయ కళాకారుడు	Nan
ศิลปะเชียงแสน	చియాంగ్ సేన్ ఆర్ట్	Nan
ศิลปะเครื่องปั้นดินเผา	కుండల కళ	Nan
ศิลปะเขมร	ఖైమర్ కళ	Nan
ศิษย์เก่าคณะเศรษฐศาสตร์	ఎకనామిక్స్ పూర్వ విద్యార్థుల ఫ్యాకల్టీ	Nan
ศิลปะศรีวิชัย	శ్రీవిజయ కళ	Nan
ศิลปะการแสดง	ప్రదర్శన కళ	Nan
ศิลปะ	ఆర్ట్	None
ศิลปอาชา	ఆర్ట్ ఆర్చా	Nan
ศิริวรรณ	siriwan	Nan
ศาสนาโซโรอัสเตอร์	జోరాస్ట్రియన్	Nan
ศาสนาฮินดู	హిందూమతం	None
ศิลปะลพบุรี	ఆర్ట్ లోప్బురి	Nan
สด	తాజా	None
วิฑูรย์	లాపిస్ లాజులి	Nan
วิชิต	wichit	Nan
วง	లూప్	Nan
วงจรไฟฟ้า	ఎలక్ట్రిక్ సర్క్యూట్	Nan
วงดนตรี	బ్యాండ్	Nan
วงศ์กำแหง	కుటుంబ	Nan
วงศ์ถั่ว	గింజ కుటుంబం	Nan
วงศ์ปลากดทะเล	చేపల కుటుంబం	Nan
วงศ์ปลากะรัง	grouper	Nan
วงศ์ปลายอดม่วง	వాంగ్ ప్లా యోట్ మువాంగ్	Nan
วงศ์ปลาหลังเขียว	ఆకుపచ్చ చేప	Nan
วงศ์ปลาเนื้ออ่อน	మృదువైన చేప	Nan
วงศ์ปลาเสือตอ	పులి చేపల కుటుంబం	Nan
วงศ์พัวพันธ์	వాంగ్‌పువా ఫాన్	Nan
วงศ์วิริยะ	wiriya	Nan
วงศ์เทวัญ	కుటుంబ	Nan
วงศ์แคหางค่าง	వాంగ్ ఖే హాంగ్ కాంగ్	Nan
วงษ์คำเหลา	వాంగ్ ఖామ్ లావో	Nan
วงเงิน	పరిమితి	None
วองโกเล่แฟมิลี	వంగోలా కుటుంబం	Nan
วอก	కోతి	None
วว	dd	Nan
วรัทยา	warutya	Nan
วรรธนพิสิฐกุล	వాటన్ ఫిసిట్కున్	Nan
วรรณสุทธิ์	wansut	Nan
ล้อแม็กซ์อัลลอยขนาด	మిశ్రమం చక్రాల పరిమాణాలు	Nan
วรรณกรรม	సాహిత్యం	None
วนิดา	wanida	Nan
วนอุทยานถ้ำจัน	థామ్ చాన్ ఫారెస్ట్ పార్క్	Nan
วทบ	dd	Nan
วชิรบรรจง	wachirabanjong	Nan
วงแหวน	రింగ్	Nan
วงเวียน	మీదకి	None
วร	wor	Nan
วอชิงตัน	వాషింగ్టన్	None
ล้อม	చుట్టూ	None
ล่าทา	వేటాడు	Nan
ลานจาตุรงคสันนิบาต	క్వార్డ్రాంగెల్	Nan
ลามิวูดีน	lamiwoodine	Nan
ลายน้ำ	వాటర్మార్క్	Nan
ลาว	లావోస్	None
ลาออก	రాజీనామా	None
ลำดับ	ఆర్డర్	Nan
ลำดับพระปฐมวงศ์ในพระบรมราชวงศ์จักรี	చక్రీ రాజవంశంలోని ఆర్డర్ ఆఫ్ ది జెనెసిస్	Nan
ลำดับพระมหากษัตริย์ไทย	ఆర్డర్ ఆఫ్ థాయ్ కింగ్	Nan
ลำตัว	ట్రంక్	Nan
ลำลูกกา	లామ్ లుక్ కా	Nan
ลำลูกกาคลอง	లామ్ లుక్ కా కెనాల్	Nan
ลำไส้เล็ก	చిన్న ప్రేగు	Nan
ลิง	కోతి	None
ลิซท์	లిస్జ్ట్	Nan
ลิปปี	పెదవి సంవత్సరం	Nan
ลิพิด	లిపిడ్	Nan
ลิฟวิ่งมอลล์	లివింగ్ మాల్	Nan
ลูน่า	లూనా	Nan
ลูซิเฟอร์	లూసిఫెర్	Nan
ลูกอัณฑะ	వృషణాలు	None
ลูกอม	మిఠాయి	None
ลูกสาว	కుమార్తె	None
ลูกปัด	పూస	Nan
ล่ำซำ	లంప్	Nan
ลุงบุญมีระลึกชาติ	అంకుల్ బూన్మీ దేశాన్ని గుర్తుచేసుకున్నాడు	Nan
ลี้	li	Nan
ลีเมอร์	లేనివారు	Nan
ลีซอ	lisu	Nan
ลีกคัพ	లీగ్ కప్	Nan
ลิเทียม	లిథియం	Nan
ลิเก	సంగీత జానపద నాటకం	Nan
ลี้สุวรรณ	లి సువాన్	Nan
วิญญาณ	ఆత్మ	Nan
วอลท์	వాల్ట్	Nan
วะสี	నేనా	Nan
วันพฤหัสบดี	గురువారం	Nan
วันพุธ	బుధవారం	Nan
วันมหาสงกรานต์	మహా సాంగ్‌క్రాన్ డే	Nan
วันละ	ఒక రోజు	Nan
วันศุกร์	శుక్రవారం	None
วันสงกรานต์	సాంగ్‌క్రాన్ డే	Nan
วันสำคัญ	ముఖ్యమైన రోజు	Nan
วันสำคัญทางพุทธศาสนา	ముఖ్యమైన బౌద్ధ దినం	Nan
วันหยุดราชการ	ప్రజా సెలవు	Nan
วันอังคาร	మంగళవారం	Nan
วันอาทิตย์	ఆదివారం	None
วันอาสาฬหบูชา	అసన్హా బుచా	Nan
วันเกิด	పుట్టినరోజు	Nan
วันเสาร์	శనివారం	None
วันแรม	డే	None
วัย	ఏజ్డ్	Nan
วัลลิโภดม	walliphodom	Nan
วิชาการคอม	అకడమిక్ కంప్యూటర్	Nan
วิชาการ	విద్యా	None
วิจิตรศิลป์	లలిత కళలు	Nan
วิจัย	పరిశోధన	None
วิคตอเรีย	విక్టోరియా	None
วิกตอร์	విక్టర్	Nan
วันนี้ที่รอคอย	ఈ రోజు వేచి ఉంది	Nan
วาไรตี้	వెరైటీ	Nan
วาเรีย	వారియ	Nan
วาลีน	వాలైన్	Nan
วาลคิรี	వాకైర్	Nan
วารินชำราบ	warinchamrap	Nan
วานูอาตู	వనౌటు	Nan
วัสดุฟิสไซล์	ఫిస్సైల్ పదార్థం	Nan
วาเลนไทน์	వాలెంటైన్స్	Nan
วอล์ค	వల్క్	Nan
วันที่เข้าฉาย	విడుదల తే్ది	Nan
วันที่ขึ้นเครื่องหมาย	సంతకం తేదీ	Nan
วัง	ప్యాలెస్	Nan
วังจันทร์	వాంగ్ చాన్	Nan
วังสระปทุม	sra pathum palace	Nan
วังสะพุง	వాంగ్ సఫుంగ్	Nan
วังหลัง	ప్యాలెస్	Nan
วังหิน	రాతి ప్యాలెస్	Nan
วัชรพล	watcharapol	Nan
วัฒนชัย	watthanachai	Nan
วัฒนธรรม	సంస్కృతి	None
วัฒนวิทูกูร	wattanawitkun	Nan
วัฒนา	wattana	Nan
วัดกลาง	మధ్యస్థ ఆలయం	Nan
วัดป่าเลไลยก์วรวิหาร	వాట్ పా లలై వొరవిహాన్	Nan
วัดพระธาตุดอยสุเทพราชวรวิหาร	వాట్ ఫ్రా దట్ డోయి సుతేప్, రాట్చవొరవిహాన్	Nan
วัดพระฝางสวางคบุรีมุนีนาถ	వాట్ ఫ్రా ఫాంగ్ సంగభూరి మునినాట్	Nan
วัดพระมหาธาตุวรมหาวิหาร	వాట్ ఫ్రా మహాత్ వోరమహవిహార్న్	Nan
วัดพระยืนพุทธบาทยุคล	వాట్ ఫ్రా యుయెన్ ఫుట్టాయఖోన్	Nan
วันชัย	wanchai	Nan
วัน	రోజు	None
วัตสัน	వాట్సన్	Nan
วัตต์	వాట్	None
วัดโพธิ์	వాట్ ఫో	Nan
วัดเจดีย์หลวง	చెడి లుయాంగ్ ఆలయం	Nan
วันที่ออกอากาศชื่อตอนแขกรับเชิญ	ప్రసార తేదీ, ఎపిసోడ్ పేరు, అతిథి ప్రదర్శన	Nan
วัดหน้าพระธาตุ	నా ఫ్రా ఆ ఆలయం	Nan
วัดสุทัศนเทพวรารามราชวรมหาวิหาร	సుతాసన్ థెప్ వారారాం ఆలయం	Nan
วัดสองพี่น้อง	పాట ఫై నాంగ్ ఆలయం	Nan
วัดระฆังโฆสิตาราม	రాఖంగ్‌కోసారం ఆలయం	Nan
วัดพระเชตุพนวิมลมังคลารามราชวรมหาวิหาร	వాట్ ఫ్రా చేతుఫోన్ విమోల్మాంగ్క్లారారం రాట్చవొరమహవిహాన్	Nan
วัดพระศรีรัตนมหาธาตุ	వాట్ ఫ్రా సి రత్తన మహాతత్	Nan
วัดพระลอย	ఫ్రా లోయి ఆలయం	Nan
วัดหนองเพียร	నాంగ్ ఫియాన్ ఆలయం	Nan
สตรอเบอรี่	స్ట్రాబెర్రీ	Nan
สตรีวิทยา	రేడియాలజీ	Nan
สติปัญญา	మేధస్సు	Nan
สารานุกรมไทยฉบับราชบัณฑิตยสถาน	థాయ్ ఎన్సైక్లోపీడియా రాయల్ ఇన్స్టిట్యూట్ ఎడిషన్	Nan
สารีวงษ์	sareewong	Nan
สาวิตรี	సావిత్రి	None
สาเหตุ	కారణం	None
สำนวนเก่า	పాత ఇడియమ్	Nan
สำนักงานขนส่งกรุงเทพมหานครพื้นที่	బ్యాంకాక్ ప్రాంత రవాణా కార్యాలయం	Nan
สำนักงานคณะกรรมการวัฒนธรรมแห่งชาติ	జాతీయ సంస్కృతి కమిషన్ కార్యాలయం	Nan
สำนักงานโครงการพัฒนาแห่งสหประชาชาติ	ఐక్యరాజ్యసమితి అభివృద్ధి కార్యక్రమం కార్యాలయం	Nan
สำนักระบาดวิทยา	బ్యూరో ఆఫ్ ఎపిడెమియాలజీ	Nan
สำนักราชเลขาธิการ	సెక్రటేరియట్	Nan
สำนักวิทยบริการ	విద్యా వనరుల కార్యాలయం	Nan
สำนักหอสมุด	గ్రంధాలయం	None
สำนักหอสมุดกลาง	సెంట్రల్ లైబ్రరీ	Nan
สำรวจ	సర్వే	None
สำราญ	gleefully	Nan
สำหรับ	కోసం	None
สำหรับประเทศไทย	థాయిలాండ్ కోసం	Nan
สินิทธา	zithitha	Nan
สินสมุทร	పాపం సముత్	Nan
สินค้าอุปโภคบริโภค	వినియోగ వస్తువులు	Nan
สินค้าคงเหลือ	జాబితాల	Nan
สิน	సిన్	Nan
สิทธิมนุษยชน	మానవ హక్కులు	Nan
สารานุกรมไทย	థాయ్ ఎన్సైక్లోపీడియా	Nan
สิทธิ	రైట్స్	Nan
สิงหไตรภพ	సింఘా త్రిపాప్	Nan
สิงหาคม	ఆగస్టు	None
สำโรง	samrong	Nan
สำเนียง	యాసను	Nan
สำหรับในปี	సంవత్సరంలో	None
สำหรับใช้เป็นตราหัวหนังสือราชการไทย	థాయ్ ప్రభుత్వ బుక్‌లెట్‌లో ముద్రగా ఉపయోగించడానికి	Nan
สิงโต	సింహం	None
สิปปภาค	జిప్పీ ప్రాంతం	Nan
สารละลาย	పరిష్కారం	None
สารพฤกษเคมี	పైటోకెమిస్ట్రీ	Nan
สาขาวิชาเคมี	కెమిస్ట్రీ విభాగం	Nan
สาขาวิชาเทคโนโลยีชีวภาพ	బయోటెక్నాలజీ ప్రోగ్రామ్	Nan
สาขาวิชาเศรษฐศาสตร์	ఎకనామిక్స్	Nan
สาขาศิลปะสถาปัตยกรรม	ఆర్ట్ ఆర్కిటెక్చర్	Nan
สาขาสมุย	సముయి బ్రాంచ్	Nan
สาขาหัวหิน	హువా హిన్ బ్రాంచ్	Nan
สาครสินธุ์	సకోర్న్ పాపం	Nan
สาทร	sathorn	Nan
สาธารณรัฐประชาชนจีน	పీపుల్స్ రిపబ్లిక్ ఆఫ్ చైనా	Nan
สาธารณรัฐออสเตรีย	రిపబ్లిక్ ఆఫ్ ఆస్ట్రియా	Nan
สาธารณรัฐอินโดนีเซีย	రిపబ్లిక్ ఆఫ్ ఇండోనేషియా	Nan
สาธารณรัฐเช็ก	చెక్ రిపబ్లిక్	Nan
สาธารณรัฐโดมินิกัน	డొమినికన్ రిపబ్లిక్	Nan
สานติวัตร	santiwat	Nan
สามก๊ก	మూడు రాజ్యాలు	Nan
สามชัย	సామ్ చాయ్	Nan
สามชุก	సామ్ చుక్	Nan
สารต้านอนุมูลอิสระ	యాంటీఆక్సిడాంట్లు	Nan
สายเมืองทอง	ముయాంగ్ థాంగ్ లైన్	Nan
สายเดียว	సింగిల్ లైన్	Nan
สายหมอก	పొగమంచు	Nan
สายสีม่วง	పర్పుల్ లైన్	Nan
สายสีน้ำเงิน	బ్లూ లైన్	Nan
สารภี	saraphi	Nan
สายสีชมพู	పింక్ లైన్	Nan
สายรุ้ง	ఇంద్రధనస్సు	Nan
สายรัชกาลที่	చివరి పాలన	Nan
สายการบิน	విమానయాన సంస్థలు	Nan
สามัญ	సాధారణ	None
สามอัศวินในจินตนาการ	మూడు ఫాంటసీ నైట్స్	Nan
สามพราน	sampran	Nan
สายสนั่น	థండర్ లైన్	Nan
สาขาวิชาศิลปอุตสาหกรรม	ఆర్ట్ డిపార్ట్మెంట్	Nan
สิเรียม	sirium	Nan
สิ่งมีชีวิต	జీవించి ఉన్నవి	Nan
สุปรีย์	supri	Nan
สุพจน์	suphot	Nan
สุพล	supon	Nan
สุมณทิพย์	sumonthip	Nan
สุรชาติ	surachat	Nan
สุรพล	surapon	Nan
สุรพันธ์	suraphan	Nan
สุรวุฒิ	surawut	Nan
สุรศักดิ์	surasak	Nan
สุรัสวดี	surasawadee	Nan
สุราษฎร์ธานี	సూరత్ తని	Nan
สุรินทร์	surin	Nan
สุริยัน	suriyan	Nan
สุริโยไท	suriyothai	Nan
สุลต่าน	సుల్తాన్	None
สุวนันท์	suwanan	Nan
สุวรรณรัฐ	suwannarat	Nan
ส่งเสริม	ప్రచారం	None
สไตล์การเล่น	శైలిని ప్లే చేయండి	Nan
สไตรค์	సమ్మె	Nan
สเปน	స్పెయిన్	None
สเตเดี้ยม	స్టేడియం	None
สเตอรอล	స్టెరోల్	Nan
สุนัขจิ้งจอก	నక్క	Nan
สเตราส์	స్ట్రాస్	Nan
สูงจากระดับน้ำทะเลปานกลาง	సగటు సముద్ర మట్టానికి పైన	Nan
สูง	అధిక	None
สุ่น	సన్	None
สุโขทัย	సుఖోతై	Nan
สุเทพ	suthep	Nan
สุวรรณานนท์	suwannanon	Nan
สู่	కు	None
สิ่ง	విషయం	None
สุนทรเวช	sunthornwet	Nan
สุนทร	sunthorn	Nan
สิ่งเสพติด	డ్రగ్	Nan
สิ้นพระชนม์ในรัชกาลที่	పాలనలో మరణించారు	Nan
สี	రంగు	None
สีขาว	తెలుపు రంగు	Nan
สีดำ	నల్ల రంగు	Nan
สีน้ำตาล	బ్రౌన్ కలర్	Nan
สีน้ำเงิน	నీలం	None
สีฟ้า	బ్లూ	Nan
สีม่วง	ఊదా	Nan
สีลม	విండ్మిల్	Nan
สึนะ	tsuna	Nan
สึนะโยชิ	tsunayoshi	Nan
สืบต่อมา	వారసత్వంగా	None
สื่อสารมวลชน	సామూహిక కమ్యూనికేషన్	Nan
สื่อสิ่งพิมพ์	ప్రింట్ మీడియా	Nan
สุกิจ	sukit	Nan
สุขภาพ	ఆరోగ్య	None
สุธี	స్కాలర్	Nan
สุทัศน์	suthat	Nan
สุทัศนะจินดา	sutasachinda	Nan
สุทธิชัย	sutthichai	Nan
สุดารัตน์	sudarat	Nan
สุดสาคร	sudsakorn	Nan
สุนทรภู่	సన్‌థోర్న్ ఫు	Nan
สุดท้ายตายด้วยฝีมือ	చివరగా, నైపుణ్యం ద్వారా మరణిస్తారు.	Nan
สุจาริณี	sucharinee	Nan
สุจริตกุล	sucharitkun	Nan
สุครีพ	sukree	Nan
สุขุมวิท	sukhumvit	Nan
สุขาภิบาล	సానిటరీ	Nan
สุขสวัสดิ์	suksawat	Nan
สุชิน	suchin	Nan
สาขาวิชาวิศวกรรมอิเล็กทรอนิกส์	ఎలక్ట్రానిక్ ఇంజనీరింగ్ ప్రోగ్రామ్	Nan
สาขาวิชาวิศวกรรมอาหาร	ఫుడ్ ఇంజనీరింగ్	Nan
สาขาวิชาวิศวกรรมคอมพิวเตอร์	కంప్యూటర్ ఇంజనీరింగ్ ప్రోగ్రామ్	Nan
สนิม	రస్ట్	Nan
สนเกรวิลเลีย	పైన్ ద్రాక్ష	Nan
สปริงฟิลด์	స్ప్రింగ్ఫీల్డ్	Nan
สปรินเตอร์	స్ప్రింటర్	Nan
สปาร์ค	స్పార్క్	Nan
สพ	స్పెక్	Nan
สภานิติบัญญัติแห่งชาติ	జాతీయ శాసనసభ	Nan
สภาผู้แทนนิสิต	విద్యార్థి ప్రతినిధుల మండలి	Nan
สภาพอากาศ	వాతావరణం	None
สมจิตต์	somchit	Nan
สมจิตร	somchit	Nan
สมชัย	somchai	Nan
สมชาย	somchai	Nan
สมภพ	పుట్టిన	None
สมศรี	somsri	Nan
สมศักดิ์	somsak	Nan
สมัคร	వర్తించు	Nan
สมเด็จพระนางเจ้าสิริกิติ์	రాణి సిరికిట్	Nan
สมเด็จพระนางเจ้ารำไพพรรณี	రాణి రాంభాయ్ బర్ని	Nan
สมเด็จ	రాణి గారు	Nan
สมุทวณิช	samutavanich	Nan
สมาชิกฤดูกาลที่	సీజన్ సభ్యులు	Nan
สมาชิกรับเชิญตอนพิเศษ	ప్రత్యేక ఎపిసోడ్ కోసం సభ్యులను ఆహ్వానించారు	Nan
สนิทวงศ์	సనిత్ వాంగ్	Nan
สมาคมประชาชาติแห่งเอเชียตะวันออกเฉียงใต้	ఆగ్నేయ ఆసియా దేశాల సమైఖ్య	Nan
สมัยสุโขทัย	సుఖోతై కాలం	Nan
สมัยรัชกาลที่	రీన్	Nan
สมัยที่	ఎప్పుడు	None
สมัยก่อนประวัติศาสตร์	చరిత్రపూర్వ కాలం	Nan
สมัยกรุงธนบุรี	తోన్బురి కాలం	Nan
สมัย	కాలం	None
สมัยอาณานิคมฝรั่งเศส	ఫ్రెంచ్ వలసరాజ్యాల కాలం	Nan
สมเด็จพระนางเจ้าฯ	రాణి గారు	Nan
สนามไฟฟ้า	విద్యుత్ క్షేత్రం	Nan
สนามฟุตบอล	ఫుట్బాల్ మైదానంలో	Nan
สตึก	satuek	Nan
สตูดิโอ	స్టూడియో	None
สถานที่ท่องเที่ยวทางธรรมชาติ	సహజ ఆకర్షణలు	Nan
สถานะ	స్థితి	None
สถานีคาราวาน	కారవాన్ స్టేషన్	Nan
สถานีวิทยุโทรทัศน์ไทยทีวีสีช่อง	కలర్ టీవీ ఛానెళ్లతో థాయ్ టెలివిజన్ స్టేషన్లు	Nan
สถานีโทรทัศน์ไทยพีบีเอส	థాయ్ పిబిఎస్ టెలివిజన్ స్టేషన్	Nan
สถาบัน	సంస్థ	None
สถาบันการศึกษา	విద్యా సంస్థ	Nan
สถาบันบัณฑิตพัฒนบริหารศาสตร์	నేషనల్ ఇన్స్టిట్యూట్ ఆఫ్ డెవలప్మెంట్ అడ్మినిస్ట్రేషన్	Nan
สถาบันพระบรมราชชนก	రాయల్ ఇన్స్టిట్యూట్	Nan
สถาบันวิจัยจุฬาภรณ์	చులాభోర్న్ రీసెర్చ్ ఇన్స్టిట్యూట్	Nan
สถาบันวิจัยและพัฒนา	పరిశోధన మరియు అభివృద్ధి సంస్థ	Nan
สถาบันศูนย์และหน่วยงานในมหาวิทยาลัย	విశ్వవిద్యాలయాలలో సంస్థలు, కేంద్రాలు మరియు విభాగాలు	Nan
สถาบันสมทบ	అసోసియేట్ సంస్థ	Nan
สถาบันอาชีวศึกษา	ఒకేషనల్ ఇన్స్టిట్యూట్	Nan
สถาบันอุดมศึกษา	ఉన్నత విద్యా సంస్థ	Nan
สนามชัยเขต	సనమ్ చాయ్ ఖేత్	Nan
สนามกีฬากลาง	సెంట్రల్ స్టేడియం	Nan
สนธิไชย	sonthichai	Nan
สนธิ	జంక్షన్	None
สนธยา	ట్విలైట్	Nan
สธ	sth	Nan
สนามแม่เหล็ก	అయిస్కాంత క్షేత్రం	Nan
สถิติศาสตร์	గణాంకాలు	None
สถาปนิก	వాస్తుశిల్పి	Nan
สถาบันโภชนาการ	ఇన్స్టిట్యూట్ ఆఫ్ న్యూట్రిషన్	Nan
สถาบันเทคโนโลยีราชมงคล	రాజమంగళ ఇన్స్టిట్యూట్ ఆఫ్ టెక్నాలజీ	Nan
สถาบันเทคโนโลยีพระจอมเกล้าเจ้าคุณทหารลาดกระบัง	కింగ్ మోంగ్కుట్ ఇన్స్టిట్యూట్ ఆఫ్ టెక్నాలజీ లాడ్క్రాబాంగ్	Nan
สถาบันเทคโนโลยีพระจอมเกล้า	కింగ్ మోంగ్కుట్ ఇన్స్టిట్యూట్ ఆఫ్ టెక్నాలజీ	Nan
สถาบันเทคโนโลยีนานาชาติสิรินธร	సిరిందోర్న్ ఇంటర్నేషనల్ ఇన్స్టిట్యూట్ ఆఫ్ టెక్నాలజీ	Nan
สถาปัตยกรรมไทย	థాయ్ ఆర్కిటెక్చర్	Nan
สมเด็จพระบรมราชาที่	రాజు	None
สมเด็จพระบรมโอรสาธิราช	క్రౌన్ ప్రిన్స్	Nan
สมเด็จพระบรมโอรสาธิราชฯ	క్రౌన్ ప్రిన్స్	Nan
สะเดา	వేప	None
สัจธรรม	నిజం	None
สัญญา	ఒప్పందం	None
สัญลักษณ์ประจำมหาวิทยาลัย	విశ్వవిద్యాలయ లోగో	Nan
สัดส่วน	నిష్పత్తి	None
สัตว์	జంతు	None
สัตว์มีกระดูกสันหลัง	సకశేరుకాలు	None
สัตว์มีแกนสันหลัง	వెన్నెముక	None
สัตว์เลี้ยงลูกด้วยน้ำนม	క్షీరదాలు	Nan
สัตว์เลื้อยคลาน	సరీసృపాలు	None
สัตว์เลื้อยคลานในอันดับนี้	ఈ హోదాలో సరీసృపాలు	Nan
สัทศาสตร์	ధ్వనిశాస్త్రం	Nan
สันติ	శాంతి	None
สันติสุข	శాంతి	None
สัมผัสนอก	బాహ్య ప్రాస	Nan
สัมพันธ์	సంబంధాలు	None
สัมมา	కుడి	None
สาขาวิชาวิทยาการคอมพิวเตอร์	కంప్యూటర్ సైన్స్ ప్రోగ్రామ్	Nan
สาขาวิชารัฐประศาสนศาสตร์	పబ్లిక్ అడ్మినిస్ట్రేషన్ విభాగం	Nan
สาขาวิชาบริหารธุรกิจ	బిజినెస్ అడ్మినిస్ట్రేషన్ ప్రోగ్రామ్	Nan
สาขาวิชานิติศาสตร์	లా ఫ్యాకల్టీ	Nan
สาขาลำปาง	లాంపాంగ్ బ్రాంచ్	Nan
สาขาย่อย	ఉప శాఖ	Nan
สะล้อ	బ్రేక్	Nan
สาขามนุษยศาสตร์	హ్యుమానిటీస్	Nan
สาขาปราจีนบุรี	ప్రాచిన్‌బురి బ్రాంచ్	Nan
สาขาประจวบคีรีขันธ์	ప్రచువాప్ ఖిరి ఖాన్ బ్రాంచ్	Nan
สาขานิเทศศาสตร์	కమ్యూనికేషన్ ఆర్ట్స్	Nan
สาขานครสวรรค์	నాఖోన్ సావన్ బ్రాంచ్	Nan
สาขานครราชสีมา	నాఖోన్ రాట్చసిమా బ్రాంచ్	Nan
สาขา	శాఖ	None
สาขาพิษณุโลก	ఫిట్సానులోక్ బ్రాంచ్	Nan
สะตอ	సతో	Nan
สะดวก	సులభంగా	None
สอยดาว	అప్పర్ కట్	Nan
สร้าง	సృష్టించడానికి	Nan
สราวุธ	sarawut	Nan
สรรพสินค้า	డిపార్ట్మెంట్ స్టోర్	Nan
สร	సృష్టించు	Nan
สยามพารากอน	సియామ్ పారగాన్	Nan
สยามบรมราชกุมารี	సియామ్	Nan
สลักใจ	ఇంప్రెస్	Nan
สยามดารา	సియామ్ దారా	Nan
สมเด็จพระเจ้าภคินีเธอ	ఆమె రాయల్ హైనెస్	Nan
สมเด็จพระเจ้ากรุงธนบุรี	క్రుంగ్ థోన్ బురి	Nan
สมเด็จพระอนุชาธิราช	సోమదేజ్ అనుచత్తిరత్	Nan
สมเด็จพระศรีนครินทราบรมราชชนนี	హెచ్‌ఆర్‌హెచ్ యువరాణి మహా చక్ర సిరింధోర్న్	Nan
สมเด็จพระรามาธิบดีที่	రాముడు రా	Nan
สมเด็จพระมหิตลาธิเบศร	సోమ్‌డెట్ ఫ్రా మహీడోల్ లాటిబెస్	Nan
สมเด็จพระเจ้าลูกเธอ	ఆమె రాయల్ హైనెస్	Nan
ส่วนต่อขยายบางซื่อท่าพระ	ఎక్స్‌టెన్షన్ బ్యాంగ్ స్యూ థా ఫ్రా	Nan
สวนดุสิตโพล	సువాన్ దుసిట్ పోల్	Nan
สวนสมเด็จพระศรีนครินทร์	సోమ్‌డెట్ ఫ్రా శ్రీనగారింద్ర పార్క్	Nan
สองสาย	రెండు తీగలు	Nan
สหวงษ์	sahawong	Nan
สหราชอาณาจักร	యునైటెడ్ రాజ్యం	Nan
สหรัฐอเมริกา	అమెరికా సంయుక్త	Nan
สหรัฐอาหรับเอมิเรตส์	యునైటెడ్ అరబ్ ఎమిరేట్స్	Nan
สหพันธ์สาธารณรัฐเยอรมนี	ఫెడరల్ రిపబ్లిక్ ఆఫ్ జర్మనీ	Nan
สวนผึ้ง	సువాన్ ఫుయెంగ్	Nan
สส	సీక్రెట్	Nan
สวิตเซอร์แลนด์	స్విట్జర్లాండ్	None
สวัสดีปีใหม่	నూతన సంవత్సర శుభాకాంక్షలు	Nan
สวัสดิ์	sawat	Nan
สวรรคโลก	sawankhalok	Nan
สวรรคตหรือ	కన్నుమూశారు	Nan
สวรรคต	చనిపోయాడు	Nan
สวี	suites	Nan
ลา	లా	None
เก็กโค	chegoe	Nan
เขตจอมทอง	చోమ్ థాంగ్ జిల్లా	Nan
โชอิจิ	షోయిచి	Nan
โชแปง	చోపిన్	Nan
โซน	జోన్	Nan
โซนยอชิแด	అమ్మాయిల తరం	Nan
โซนี่	సోనీ	Nan
โซล	సియోల్	Nan
โซลดิ๊ก	soldick	Nan
โซลโซไซตี้	సోల్ సొసైటీ	Nan
โซเดียม	సోడియం	None
โซเฟีย	సోఫియా	Nan
โดจินชิ	జిన్చి చేయండి	Nan
โดย	ద్వారా	None
โดยคำว่า	పదం ద్వారా	Nan
โดยตรง	నేరుగా	None
โดยทรงพระกรุณาโปรดเกล้าฯ	ఆయన మహిమతో దయతో మంజూరు చేయబడింది	Nan
โดยที่	ఎక్కడ	None
โดยบ่งบอกถึงปริมาณและคุณภาพของสิ่งตีพิมพ์อิเล็กทรอนิกส์ของสถาบัน	ఇన్స్టిట్యూట్ యొక్క ఎలక్ట్రానిక్ ప్రచురణల పరిమాణం మరియు నాణ్యతను సూచించడం ద్వారా	Nan
โดเมกิ	domome	Nan
โดราเอมอนฉบับภาพยนตร์	డోరెమోన్ మూవీ ఎడిషన్	Nan
โดยในวันที่	ద్వారా	None
โดยใช้ทางหลวงแผ่นดินหมายเลข	జాతీయ రహదారి ద్వారా	Nan
โดยใช้ชื่อว่า	పేరు చేత	Nan
โดยเจ้าฟ้าธรรมธิเบศรไชยเชษฐสุริยวงศ์	ప్రిన్స్ తమతిబెట్ శోర్న్‌చాయ్ చెట్చురియావోంగ్ చేత	Nan
โชว์	షో	None
โดยสรุป	క్లుప్తంగా	None
โดยมีพระภิกษุสงฆ์นำเวียนเทียน	ఒక సన్యాసి కొవ్వొత్తి వెలిగించే procession రేగింపుకు నాయకత్వం వహిస్తాడు	Nan
โดยมีตัวอย่างบทพากย์ฉบัง	కవితల ఉదాహరణలతో	Nan
โดยมี	తో	None
โดยปกติแล้ว	సాధారణంగా	None
โดยปกติตามวัดต่าง	సాధారణంగా వివిధ దేవాలయాల ప్రకారం	Nan
โดยปกติ	సాధారణంగా	None
โดยราชบัณฑิตยสถาน	రాయల్ ఇన్స్టిట్యూట్ చేత	Nan
โดเมน	డొమైన్	Nan
โชคดี	అదృష్టం	Nan
โจโจ้	జోజో	Nan
แฮปปี้และชาร์ล	హ్యాపీ మరియు చార్లెస్	Nan
แฮ็ค	హ్యాకింగ్	Nan
โกบอล	ప్రపంచ	None
โกร	పెరుగు	None
โกรกพระ	బీట	Nan
โกลด์	బంగారం	None
โกวิท	kowit	Nan
โกโก้	కోకో	Nan
โขน	మూకీ	Nan
โคกสำโรง	ఖోక్ సమ్రాంగ్	Nan
โคนัน	కోనన్	Nan
โคฟี	కోఫీ	Nan
โครงการ	ప్రాజెక్ట్	None
โครงการก่อสร้าง	నిర్మాణ ప్రాజెక్టు	Nan
โครงการนานาชาติ	అంతర్జాతీయ ప్రాజెక్ట్	Nan
โครงการศิลปินแห่งชาติ	నేషనల్ ఆర్టిస్ట్ ప్రాజెక్ట్	Nan
โครงการเรียนภาษาอังกฤษแบบเข้ม	ఇంటెన్సివ్ ఇంగ్లీష్ లెర్నింగ్ ప్రోగ్రామ్	Nan
โจเซฟ	జోసెఫ్	None
โจจิ	joji	Nan
โฆษิตพิพัฒน์	కోసిత్ ఫిఫాట్	Nan
โฆษะ	గొంతుకతో	Nan
โคโทเน่ที่	వద్ద కోటోన్	Nan
โคแทนเจนต์	cotangent	Nan
โช	చో	Nan
โคเบะ	కొబ్	Nan
โคล้ด	కోడ్	None
โคลอมเบีย	కొలంబియా	None
โคล	కోల్	Nan
โครโมโซม	క్రోమోజోమ్	Nan
โคราช	వెల్లడించింది	None
โครงสร้างภายใน	అంతర్గత నిర్మాణం	Nan
โคเคน	కొకైన్	Nan
แฮปปี้	సంతోషంగా	Nan
โต	పెరిగింది	None
โทน	టోన్	Nan
โฟโตสเฟียร์	ఫోటో గోళాలు	Nan
โมซาร์ท	మొజార్ట్	Nan
โมบิลสูทกันดั้ม	మొబైల్ సూట్ గుండం	Nan
โมรา	చాల్సెడోనీ	Nan
โมร็อกโก	మొరాకో	Nan
โมลิบดีนัม	మాలిబ్డినం	Nan
โมฮัมหมัด	మొహమ్మద్	None
โมเดิร์น	ఆధునిక	None
โมเต็ต	motate	Nan
โมเลกุล	అణువుల	None
โมโคนะ	mokona	Nan
โมโนไซต์	మోనో సైట్	Nan
โยชิโนะ	yoshino	Nan
โยฮันน์	జోహన్	Nan
โยเซฟ	జోసెఫ్	None
โรค	వ్యాధి	None
โรคประจำตัว	పుట్టుకతో వచ్చే వ్యాధి	Nan
โรงเรียนนนทรีวิทยา	నాన్సీ విత్తయా స్కూల్	Nan
โรงเรียนดาราวิทยาลัย	దారా కళాశాల	Nan
โรงเรียนการบิน	విమాన పాఠశాల	Nan
โรงละคร	థియేటర్	None
โรงพยาบาลอุตรดิตถ์	ఉత్తరాదిట్ హాస్పిటల్	Nan
โรงพยาบาลอานันทมหิดล	ఆనందమహిడోల్ హాస్పిటల్	Nan
โฟลเอ็ม	ఫ్లో m.	Nan
โรงพยาบาลรามาธิบดี	రామతిబోడి ఆసుపత్రి	Nan
โรงพยาบาลกรุงเทพ	బ్యాంకాక్ హాస్పిటల్	Nan
โรคไต	కిడ్నీ వ్యాధి	Nan
โรคเกาต์	గౌట్	Nan
โรคุโด	rokudo	Nan
โรคออทิซึม	ఆటిజం	Nan
โรคปอดบวม	న్యుమోనియా	Nan
โรงพยาบาลจุฬาลงกรณ์	కింగ్ చులాలాంగ్ కార్న్ మెమోరియల్ హాస్పిటల్	Nan
โตชิบา	తోషిబా	Nan
โฟลต	ఫ్లోట్	Nan
โพรทิสต์	ప్రోటిస్టా	None
โทนะหงษา	tonahahasa	Nan
โทนี่	టోనీ	Nan
โทบรามัยซิน	tobamaycin	Nan
โทมัส	థామస్	None
โทรจัน	ట్రోజన్	Nan
โทรลล์	మరుగుజ్జు	None
โทริคาบูโตะ	torikabuto	Nan
โทรโข่ง	మెగాఫోన్	Nan
โน	తోబుట్టువుల	Nan
โนบิตะ	nobita	Nan
โนบิตะและอัศวินแดนวิหค	నోబిటా మరియు నైట్	Nan
โนรา	నోరా	Nan
โนะ	డినో	Nan
โนเบล	నోబెల్	None
โบตั๋นกลีบสุดท้าย	చివరి పియోని	Nan
โบราณสถาน	పురావస్తు ప్రదేశం	Nan
โบอิง	బోయింగ్	Nan
โพนพิสัย	ఫోన్ ఫిసాయ్	Nan
โพธิ์ศรี	phosri	Nan
โป๊	నగ్న	Nan
โปเกมอน	పోకీమాన్	Nan
โปรโมชั่น	ప్రమోషన్	Nan
โปรแกรมคอมพิวเตอร์	కంప్యూటర్ ప్రోగ్రామ్	Nan
โพแทสเซียม	పొటాషియం	None
โปรเจกต์พิเศษ	ప్రత్యేక ప్రాజెక్ట్	Nan
โปรตีน	ప్రోటీన్	Nan
โปรตอน	ప్రోటాన్	Nan
โปรดเกล้า	దయచేసి	None
โปงลางสะออน	పొంగ్లాంగ్ సా-ఆన్	Nan
โบแดง	ప్రశంసనీయం	Nan
โบฮีเมีย	బొహేమియా	Nan
โปรเจกต์	ప్రాజెక్ట్	None
โรงเรียนนายเรือ	నావల్ అకాడమీ	Nan
แฮช	హాష్	Nan
แอสซิสต์	అసిస్ట్	Nan
แฟรี่	ఫెయిరీ	Nan
แฟรี่เทล	అద్భుత కథ	Nan
แมกนีเซียม	మెగ్నీషియం	Nan
แมคอินทอช	macintosh	Nan
แมนดาริน	మాండరిన్	Nan
แมนเชสเตอร์	మాంచెస్టర్	Nan
แมว	పిల్లి	None
แมวป่า	అడవి పిల్లి	Nan
แมวลายหินอ่อน	మార్బుల్ టాబ్బీ	Nan
แมวไทย	థాయ్ పిల్లి	Nan
แม็คโคร	makro	Nan
แม่	తల్లి	None
แม่จริม	తల్లి జిమ్	Nan
แม่ชี	సన్యాసినులు	Nan
แม่นาคพระโขนง	మే నాక్ ఫ్రా ఖానోంగ్	Nan
แม่น้ำ	నది	None
แม่น้ำชี	చి నది	Nan
แลมบ์ดา	లాంబ్డా	Nan
แลกเปลี่ยนโดยถือ	పట్టుకోవడం ద్వారా మార్పిడి	Nan
แร็ปเปอร์	రాపర్	Nan
แรงโน้มถ่วง	గ్రావిటీ	Nan
แย้มบุญเรือง	మెరిట్ కోసం ఎంచుకోవడం	Nan
แย้มนาม	పేరు	None
แฟรงค์	ఫ్రాంక్	None
แยกจากคลองบางกอกใหญ่ฝั่งซ้าย	ఎడమ వైపున బ్యాంకాక్ యాయ్ కాలువ నుండి జంక్షన్	Nan
แยกจากคลองบางกอกน้อยฝั่งซ้าย	ఎడమ వైపున బ్యాంకాక్ నోయి కాలువ నుండి	Nan
แยกจากคลองชักพระฝั่งซ้าย	ఎడమ వైపున చక్ ఫ్రా కెనాల్ నుండి వేరు	Nan
แม่ริม	మే రిమ్	Nan
แม่น้ำโขง	మెకాంగ్ నది	Nan
แม่น้ำปิง	పింగ్ నది	Nan
แม่น้ำทะเลสาบสำคัญ	ముఖ్యమైన సరస్సు నది	Nan
แยกจากคลองบางกอกใหญ่ฝั่งขวา	కుడి వైపున బ్యాంకాక్ యాయ్ కాలువ నుండి జంక్షన్	Nan
และ	మరియు	None
แฟมิลีที่ไปพักผ่อนที่เกาะมาเฟีย	కుటుంబం మాఫియా ద్వీపంలో విశ్రాంతి తీసుకోవడానికి వెళుతుంది	Nan
แฟชั่น	ఫ్యాషన్	Nan
แถบ	బార్	None
แทซิทัส	tasitus	Nan
แทน	ప్రాతినిధ్యం	None
แทนเจนต์	టాంజెంట్	Nan
แทยอน	taeyeon	Nan
แทลเลียม	థాలియం	Nan
แท็กซี่	టాక్సీ	Nan
แท็บเล็ต	టాబ్లెట్	Nan
แนท	nat	Nan
แนวความคิดที่	కాన్సెప్ట్	Nan
แนวพระราชดำริ	రాయల్ చొరవ	Nan
แนสแด็ก	nasdaq	Nan
แบคทีเรีย	బాక్టీరియా	None
แบงค์	బ్యాంక్	None
แบทเทิลบรอลเลอร์	యుద్ధం ట్యాంకర్	Nan
แบรนด์แอมบาสเดอร์	బ్రాండ్ అంబాసిడర్	Nan
แบ่งประเทศไทยออกเป็น	థాయిలాండ్‌ను విభజించండి	Nan
แพ้	కోల్పోతారు	Nan
แพะ	మేక	None
แพลทฟอร์ม	వేదిక	None
แพร่	వ్యాప్తి	None
แพน	పాన్	Nan
แพทย์	వైద్యుడు	Nan
แฟนเก่า	మాజీ ప్రేయసి	Nan
แผลไหม้	బర్న్స్	Nan
แผนไพรีพินาศ	కన్సార్టియం ప్రణాళిక	Nan
แผนที่	మ్యాప్	None
แป้ง	పిండి	None
แบ่งได้เป็น	అని విభజించవచ్చు	Nan
แบ่งออกได้เป็น	గా విభజించబడింది	Nan
แบ่งออกเป็น	గా విభజించబడింది	Nan
แผลศักดิ์สิทธิ์	పవిత్ర గాయం	Nan
แอสปาร์แตม	అస్పర్టమే	Nan
และกลายเป็นอู่ข้าวอู่น้ำที่มีชื่อเสียงของไทย	మరియు థాయ్‌లాండ్‌లో ప్రసిద్ధ బ్రెడ్‌బాస్కెట్‌గా మారింది	Nan
และครอบครัว	మరియు కుటుంబం	Nan
แสงสิงแก้ว	సాంగ్ సింగ్కావ్	Nan
แสงเทียน	క్యాండిల్లైట్	Nan
แสตมป์	స్టాంప్	Nan
แสนรัก	లవ్	None
แสนโภศิก	సేన్ ఫోసిక్	Nan
แหลมสิงห์	లామ్ సింగ్	Nan
แหล่งท่องเที่ยว	పర్యాటక ఆకర్షణ	Nan
แหล่งโบราณคดีบ้านเชียง	చియాంగ్ పురావస్తు సైట్ బాన్	Nan
แหวน	రింగ్	Nan
แหวนธรรมดา	సాదా రింగ్	Nan
แหวนมาเล่ริง	మాలే రింగ్	Nan
แห่งบันนัม	బాన్ నామ్	Nan
แห่งสหประชาชาติ	ఐక్యరాజ్యసమితి	None
แองกวิลลา	ఆంగ్విలా	Nan
แองเจิ้ล	ఏంజెల్	Nan
แอซิด	ఆమ్లము	Nan
แอด	చేర్చు	Nan
แอสกี	asci	Nan
แอลจีเรีย	అల్జీరియా	Nan
แอล	l	Nan
แอร์ไลน์	విమానయాన సంస్థలు	Nan
แอมเวย์	amway	Nan
แอมะซอน	అమెజాన్	Nan
แสงทอง	sangthong	Nan
แอฟริกาใต้	దక్షిణ ఆఫ్రికా	Nan
แอนโทนี	ఆంథోనీ	Nan
แอนเนลิดา	annelida	Nan
แอนิเมชัน	యానిమేషన్	None
แอนด์	మరియు	None
แอนดี้	ఆండీ	Nan
แอนดรอยด์	android	Nan
แอฟริกา	ఆఫ్రికా	None
และกัมพูชา	మరియు కంబోడియా	Nan
แสงชูโต	chuto	Nan
แวน	వాన్	None
และคำว่า	మరియు పదం	Nan
และจังหวัดใกล้เคียง	మరియు సమీప ప్రావిన్సులు	Nan
และดุษฎีบัณฑิต	మరియు డాక్టర్ ఆఫ్ ఫిలాసఫీ	Nan
และตามสภาพเศรษฐกิจและสังคม	మరియు ఆర్థిక మరియు సామాజిక పరిస్థితుల ప్రకారం	Nan
และตำแหน่ง	మరియు స్థానం	Nan
และที่สำคัญคือ	మరియు ముఖ్యమైన విషయం	Nan
และธงของต่างประเทศ	మరియు విదేశీ జెండాలు	Nan
และปัจจุบัน	మరియు ప్రస్తుతం	Nan
และพรรคฟุนซินเปค	మరియు ఫన్‌చిన్‌పెక్ పార్టీ	Nan
และรถไฟ	మరియు రైలు	Nan
และรัสเซีย	మరియు రష్యా	Nan
และสหรัฐอเมริกา	మరియు యునైటెడ్ స్టేట్స్	Nan
และสังคม	మరియు సమాజం	Nan
และสังคมศาสตร์	మరియు సాంఘిక శాస్త్రాలు	Nan
และสัตว์	మరియు జంతువులు	Nan
และสโรชา	మరియు సరోచా	Nan
และหลังจากสงครามภายใน	మరియు అంతర్గత యుద్ధం తరువాత	Nan
แล้วเดินเวียนรอบปูชนียสถาน	అప్పుడు అభయారణ్యం చుట్టూ నడిచారు	Nan
และได้ปรากฏตัวตอนภาค	మరియు ఎపిసోడ్లో కనిపించింది	Nan
และในปี	మరియు సంవత్సరంలో	Nan
และโลก	మరియు ప్రపంచం	Nan
และเรียกว่า	మరియు పిలిచారు	Nan
และเมื่อวันที่	మరియు ఆన్	Nan
แสงจันทร์	వెన్నెల	None
และเมืองเก่า	మరియు పాత పట్టణం	Nan
และเป็น	మరియు	None
และเปียโน	మరియు పియానో	Nan
และอเมริกาเหนือ	మరియు ఉత్తర అమెరికా	Nan
และอื่น	మరియు ఇతరులు	Nan
และอำเภอกันทรารมย์	మరియు కాంతరోమ్ జిల్లా	Nan
และออกซิเจน	మరియు ఆక్సిజన్	Nan
และเป็นสมาชิกราชวงศ์	మరియు రాజ కుటుంబంలో సభ్యుడు	Nan
โรงเรียนนายเรืออากาศ	రాయల్ థాయ్ ఎయిర్ ఫోర్స్ అకాడమీ	Nan
โรงเรียนบดินทรเดชา	బోడిందేచా పాఠశాల	Nan
โรงเรียนประชานิเวศน์	ప్రచానివేట్ పాఠశాల	Nan
ไปจนถึง	టు	None
ไปบรรจบแม่น้ำเจ้าพระยา	చావో ఫ్రేయా నదిని కలవడానికి వెళ్ళండి	Nan
ไปรษณีย์กาฬสินธุ์	కలాసిన్ పోస్ట్ ఆఫీస్	Nan
ไปรษณีย์ฉะเชิงเทรา	చాచోఎంగ్సావో పోస్ట్ ఆఫీస్	Nan
ไปรษณีย์นครศรีธรรมราช	నాఖోన్ సి తమ్మరత్ పోస్ట్ ఆఫీస్	Nan
ไปรษณีย์ภูเวียง	ఫు వియాంగ్ పోస్ట్ ఆఫీస్	Nan
ไปรษณีย์ยานนาวา	యన్నావా పోస్ట్ ఆఫీస్	Nan
ไปรษณีย์ร้อยเอ็ด	రోయి ఎట్ పోస్ట్ ఆఫీస్	Nan
ไปรษณีย์สามเสนใน	సామ్సేన్ నాయి పోస్టల్ ఆఫీస్	Nan
ไปรษณีย์หนองหาน	నాంగ్ హాన్ పోస్ట్ ఆఫీస్	Nan
ไปรษณีย์อำนาจเจริญ	అమ్నాట్ చారోన్ పోస్ట్ ఆఫీస్	Nan
ไปรษณีย์อุทุมพรพิสัย	ఉతుంఫోన్ ఫిసాయ్ పోస్ట్ ఆఫీస్	Nan
ไปรษณีย์อุบลราชธานี	ఉబన్ రాట్చథాని పోస్ట్ ఆఫీస్	Nan
ไปรษณีย์เดชอุดม	పోస్ట్ ఆఫీస్	Nan
ไปรษณีย์โพนพิสัย	ఫోన్ ఫిసాయ్ పోస్ట్ ఆఫీస్	Nan
ไผ่แดง	ఎర్ర వెదురు	Nan
ไพฑูรย์	chrysoberyl	Nan
ไม่มีบันทึกว่าใครเป็นคนสร้าง	దీన్ని ఎవరు సృష్టించారో రికార్డులు లేవు.	Nan
ไม่ผ่านเข้ารอบ	అర్హత లేదు	Nan
ไม่บังคับ	ఐచ్ఛికము	Nan
ไม่ทราบข้อมูล	తెలియని సమాచారం	Nan
ไม่ต่ำกว่า	కంటే తక్కువ కాదు	Nan
ไมโครซอฟท์	microsoft	Nan
ไนโตรเจน	నత్రజని	None
ไมอามี่	మయామి	Nan
ไฟร์วอลล์	ఫైర్వాల్	Nan
ไฟนอลแฟนตาซี	ఫైనల్ ఫాంటసీ	Nan
ไฟ	ఫైర్	Nan
ไพศาล	విస్తారమైన	Nan
ไพรวัลย์	praiwan	Nan
ไพรบึง	ఫారెస్ట్	Nan
ไมค์	మైక్	Nan
ไม่มีแขน	చేతులు లేవు	Nan
ไนลอน	నైలాన్	Nan
ไทโรซีน	టైరోసిన్	Nan
ไชโย	బ్రావో!	Nan
ไซน์	సైన్	Nan
ไซโทสเกเลตอน	జైటోస్ గటీలా	Nan
ไซโปรเฮปตาดีน	సిప్రో హెప్టాడిన్	Nan
ไดคลอกซาซิลลิน	డైక్లోక్ సిల్లిన్	Nan
ไดดาโนซีน	dinocene	Nan
ไดอาน่า	డయానా	Nan
ไดโนเสาร์ของโนบิตะ	నోబిటా యొక్క డైనోసార్	Nan
ได้	కలిగి	None
ได้กล่าวว่า	సెడ్	Nan
ได้ดังนี้	ఈ క్రింది విధంగా	Nan
ได้ทูลเกล้าฯ	సమర్పించబడిన	Nan
ได้มีโอกาสสร้างความสัมพันธ์อันดีต่อกัน	ఒకరితో ఒకరు మంచి సంబంధాలు పెంచుకునే అవకాశం ఉంది	Nan
ได้รับ	పొందండి	Nan
ได้รับฉายาว่า	మారుపేరు అందుకున్నారు	Nan
ได้รับรางวัล	అవార్డు పొందండి	Nan
ได้ร่วมกันในภารกิจในด้านต่าง	వివిధ రంగాలలో మిషన్లో కలిసి.	Nan
ไทลื้อ	థాయ్ లూ	Nan
ไทรโลจี	త్రయం	Nan
ไทยานนท์	thaiyanon	Nan
ไทยรามา	థాయ్ రామ	Nan
ไทยพรีเมียร์ลีก	థాయ్ ప్రీమియర్ లీగ్	Nan
ไทยทีวีสีช่อง	థాయ్ కలర్ టీవీ ఛానల్	Nan
ไนท์	నైట్	Nan
ไทย	థాయ్	None
ไต้หวัน	తైవాన్	Nan
ไต	మూత్రపిండాల	Nan
ได้เป็น	ఉండండి	Nan
ได้เคลื่อนไหวตรวจสอบการทำงานของรัฐบาลกัมพูชาอย่างแข็งขัน	కంబోడియా ప్రభుత్వ పనిని పరిశీలించడానికి చురుకుగా కదిలింది	Nan
ได้สู้กับ	తో పోరాడారు	Nan
ได้สำเร็จ	విజయవంతంగా	None
ไท	స్వతంత్ర	None
ไชยา	చయ్యా	Nan
ไม่ว่าจะ	ఉందొ లేదో అని	Nan
ไม่แตกกิ่ง	శాఖలుగా లేదు	Nan
ไอโมบาย	నేను మొబైల్	Nan
ไอโอ	అదిగో	Nan
ไฮยาซินธ์	సువాసన గల పూలచెట్టు	Nan
ไฮเดรนเยีย	hydrangea	Nan
ไฮเปอร์มาร์เก็ต	హైపర్మార్కెట్	Nan
ไฮแจ็ค	హైజాక్	Nan
ไฮโดรเจน	హైడ్రోజన్	Nan
๑๔	14	Nan
๑๕	15	Nan
๑๖	16	Nan
๑๘	18	Nan
๒๑	21	Nan
๒๒	22	Nan
๒๔๕๐	1907	Nan
๒๕๐๒	1962	Nan
๒๕๐๓	1963	Nan
๒๕๒๓	1980	Nan
๙	9	Nan
๖๐	60	Nan
๕	5	Nan
๔๘	48	Nan
๓	3	Nan
๒๘	28	Nan
ไอเอ	ia	Nan
๒๗	27	Nan
๒๕๕๐	2007	Nan
๒๕๔๘	2005	Nan
๒๕๔๗	2004	Nan
๒๕๓๖	2536	Nan
๒๕๓๕	1992	Nan
๒๕๓๔	1991	Nan
๒๕๕๔	2011	Nan
ไม่สามารถทำการเกษตรได้	వ్యవసాయం చేయలేకపోయింది	Nan
ไอร์แลนด์เหนือ	ఉత్తర ఐర్లాండ్	Nan
ไอพอด	ఐపాడ్	None
ไม่ใช่	తోబుట్టువుల	Nan
ไม้	కలప	None
ไม้กวาด	చీపురు	None
ไม้หนีบผ้า	బట్టలు పెగ్	Nan
ไม้ไม่ผลัดใบ	ఎవర్గ్రీన్	Nan
ไรงะ	రీగా	Nan
ไรโบโซม	ribosomes	Nan
ไร่	వ్యవసాయ	None
ไลท์	లైట్	Nan
ไลบร้า	తుల	Nan
ไลฟ์สไตน์	lifstein	Nan
ไลเบรชัน	గ్రంధాలయం	None
ไวชาน่า	waichana	Nan
ไวทยางกูร	vittayangkun	Nan
ไวทยานนท์	waithayanon	Nan
ไวท์สเปล	whitespell	Nan
ไวน์	వైన్	Nan
ไอน์สไตเนียม	ఐనస్టేయినియం	Nan
ไอน์สไตน์	ఐన్స్టీన్	Nan
ไอทีวี	itv	Nan
ไหลจากลาวเข้าสู่ภาคเหนือของกัมพูชาแล้วไหลผ่านเข้าเขตเวียดนาม	లావోస్ నుండి ఉత్తర కంబోడియాలోకి ప్రవహిస్తుంది మరియు తరువాత వియత్నాంలోకి ప్రవహిస్తుంది	Nan
ไหมกัน	కలిసి	None
ไหซอง	పరిహసముచేయు	Nan
ไอริส	ఐరిస్	Nan
ไว้ว่า	సే	Nan
ไวเวิร์น	wvern	Nan
ไวเปอร์	వైపర్	Nan
ไวเซิร์ด	వీస్	Nan
ไวรัสตับอักเสบ	హెపటైటిస్	Nan
ไวรัส	వైరస్	Nan
ไวยากรณ์	వ్యాకరణ	None
ไวโอเลต	వైలెట్	Nan
ไชยวัฒน์	chaiwat	Nan
ไชยยงค์	chaiyong	Nan
ไชยกิตติ	చాయ్ కిట్టి	Nan
โอภาส	ప్రకాశం	None
โอร์มาน	ఒమన్	None
โอวีเอ	స్త్రీ ప్రత్యుత్పత్తి కణములు	Nan
โอสถสภา	osotspa	Nan
โอสถานุเคราะห์	osathanugrah	Nan
โออิชิ	oishi	Nan
โอะกินะวะ	ఒకినావా	Nan
โอเค	అలాగే	None
โอเอกซ์	ఈడ్పు-టాక్ వూని	Nan
โฮม	హోమ్	None
โฮลดิ้ง	పట్టుకొని	None
ใจดี	రకం	None
ใช่	అవును!	Nan
ใช้ขยายความเฉพาะบุคคล	వ్యక్తిగతీకరించడానికి ఉపయోగించండి	Nan
ใช้ชื่อว่า	అనే	None
ใช้เวลา	సమయం తీసుకో	Nan
ใต้	కింద	None
ในช่วงหลัง	తర్వాత	None
ในช่วงสงครามโลกครั้งที่สอง	రెండవ ప్రపంచ యుద్ధ సమయంలో	Nan
ในช่วงสงครามโลกครั้งที่	ప్రపంచ యుద్ధ సమయంలో	Nan
ในช่วงสงครามเย็น	ప్రచ్ఛన్న యుద్ధ సమయంలో	Nan
ในช่วงปี	సంవత్సరంలో	None
ในชิงร้อยชิงล้าน	చింగ్ చింగ్ మిలియన్లో	Nan
โอบามา	ఒబామా	Nan
ในคศ	సంవత్సరంలో	None
ในขณะที่	అయితే	None
ในกาลต่อมา	భవిష్యత్తులో	None
ในการเลือกตั้ง	ఎన్నికల్లో	None
ในการประเมินผลงานวิจัยของสถาบัน	సంస్థ యొక్క పరిశోధన ఫలితాలను అంచనా వేయడంలో	Nan
ในกลุ่ม	సమూహంలో	None
ในกรณีนี้	ఈ సందర్భంలో	Nan
ในคริสต์ศตวรรษที่	19 వ శతాబ్దంలో	Nan
ในช่วงแรก	మొదట్లో	None
โอกาส	క్రీడల్లో అవకాశాలు	Nan
โหมด	మోడ్	None
โรงเรียนปรินส์รอยแยลส์วิทยาลัย	ప్రిన్స్ రాయల్ కాలేజ్	Nan
โรงเรียนพระตำหนักสวนกุหลาบ	సువాన్ కులార్బ్ తమ్నాక్ స్కూల్	Nan
โรงเรียนมัธยมสาธิตวัดพระศรีมหาธาตุ	వాట్ ఫ్రా సి మహాతత్ యొక్క సెకండరీ స్కూల్ ప్రదర్శన	Nan
โรงเรียนมารีวิทย์	మేరీ విట్ స్కూల్	Nan
โรงเรียนยุพราชวิทยาลัย	యుప్పరత్ విట్టయాలై స్కూల్	Nan
โรงเรียนราชินีบน	అప్పర్ క్వీన్ స్కూల్	Nan
โรงเรียนวัฒโนทัยพายัพ	వత్తనోథై పయాప్ స్కూల్	Nan
โรงเรียนศึกษานารี	నరీ స్కూల్ ఆఫ్ ఎడ్యుకేషన్	Nan
โรงเรียนสาธิต	ప్రదర్శన పాఠశాల	Nan
โรงเรียนสาธิตแห่งมหาวิทยาลัยเกษตรศาสตร์	కాసెట్‌సార్ట్ విశ్వవిద్యాలయ ప్రదర్శన పాఠశాల	Nan
โรงเรียนห้องสอนศึกษา	పాఠశాల బోధనా గది	Nan
โรงเรียนเขมะสิริอนุสสรณ์	ఖేమాసిరి అనుసార్న్ స్కూల్	Nan
โรงเรียนเจ้าพระยาวิทยาคม	చావో ఫ్రేయా విత్తయాఖోమ్ స్కూల్	Nan
โรงเรียนเฉลิมพระเกียรติสมเด็จพระศรีนครินทร์	చలోమ్ ఫ్రాకియాట్ సోమ్‌డెట్ ఫ్రా శ్రీనగారింద్ర పాఠశాల	Nan
โรงเรียนเทศบาล	ప్రజా పాఠశాల	Nan
โรงเรียนไตรมิตรวิทยาลัย	ట్రామిట్ విట్టయాలై స్కూల్	Nan
โรงแรม	హోటల్	None
โสภณ	సుందరమైన	Nan
โสน	sesbania	Nan
โสณกุล	sonakul	Nan
โลโซ	loso	Nan
โลงหิน	శవపేటిక	Nan
โลกแอมะซอน	అమెజాన్ వరల్డ్	Nan
โหม่ง	tackles	Nan
โลก	ప్రపంచ	None
โรส	రోజ్	Nan
โรลเลอร์เบลด	రోలర్ బ్లేడ్	Nan
โรมัน	రోమన్	None
โรม	రోమ్	None
โรตารี	రోటరీ	Nan
โรจูโร่	rojero	Nan
โรเจอร์	రోజర్	Nan
ในดาร์ฟูร์	డార్ఫర్‌లో	Nan
ในต่างประเทศ	విదేశాలలో	None
ในทางกลับกัน	మరోవైపు	None
ในอัลบั้ม	ఆల్బమ్‌లో	Nan
ในเกมเดอะซิมส์	సిమ్స్ ఆటలో	Nan
ในเครือ	అనుబంధం	None
ในเดือน	నెలలో	None
ในเดือนมิถุนายน	జూన్ నెలలో	Nan
ในเดือนมีนาคม	మార్చి లో	Nan
ในเบื้องต้น	మొదట్లో	None
ในเรื่อง	ఆ విషయమై	Nan
ในเหตุการณ์	కార్యక్రమంలో	None
ในเอเชียตะวันออกเฉียงใต้	ఆగ్నేయాసియాలో	Nan
ในแฮร์รี่	హ్యారీ	Nan
ในโอกาสครบรอบ	వార్షికోత్సవం సందర్భంగా	Nan
ใบเสมา	పిట్టగోడలు	Nan
ใหญ่	పెద్ద	None
ให้พลเอกเปรม	జనరల్ ప్రేమ్ కోసం	Nan
ให้สมเด็จพระเทพรัตนราชสุดาฯ	హెచ్‌ఆర్‌హెచ్ యువరాణి మహా చక్ర సిరింధోర్న్ కోసం	Nan
ให้เสียงพากย์	వాయిస్ నటన	Nan
ไคเอ็น	kaien	Nan
ไข้หวัดใหญ่สเปน	స్పానిష్ ఫ్లూ	Nan
ไข้หวัดใหญ่สายพันธุ์ใหม่	ఇన్ఫ్లుఎంజా యొక్క కొత్త జాతి	Nan
ไข้สูง	తీవ్ర జ్వరం	Nan
ไข้รากสาดใหญ่	టైఫుస్	Nan
ไข่	గుడ్డు	None
ในอดีตทุ่งกุลาร้องไห้ในฤดูแล้ง	గతంలో, తుంగ్ కులా పొడి కాలంలో ఏడుస్తుంది.	Nan
ไขสันหลัง	కలపతో తయారు	Nan
ไก่	చికెన్	Nan
ไกลกังวล	ఆందోళన	None
ไกรลาศ	krailat	Nan
ไกรทอง	క్రై థాంగ్	Nan
ให้ใช้หลัก	సూత్రాన్ని ఉపయోగించండి	Nan
ให้แก่ประชาชน	ప్రజలకు	None
ไขมัน	కొవ్వు	None
ในอดีต	గతం లో	Nan
ในหนังสือ	పుస్తకంలో	None
ในสหรัฐอเมริกา	యునైటెడ్ స్టేట్స్ లో	Nan
ในพระบาทสมเด็จพระพุทธเลิศหล้านภาลัย	హిజ్ మెజెస్టి కింగ్, ఫ్రా బుద్ధ లెర్త్లా, నాపలై	Nan
ในพระบาทสมเด็จพระพุทธยอดฟ้าจุฬาโลก	రాజు బుద్ధ యోడ్ఫా చులా లోక్ పాలనలో	Nan
ในปีเดียวกันนั้น	అదే సంవత్సరంలో	Nan
ในปีเดียวกัน	అదే సంవత్సరంలో	Nan
ในปีพุทธศักราช	సంవత్సరంలో.	Nan
ในปีพศ	సంవత్సరంలో	None
ในภายหลัง	తర్వాత	None
ในปีนี้	ఈ సంవత్సరం	Nan
ในปี	సంవత్సరంలో	None
ในปลายปี	సంవత్సరం చివరిలో	Nan
ในประเทศญี่ปุ่น	జపాన్ లో	Nan
ในบางฉบับ	కొన్ని ఎడిషన్లలో	Nan
ในทางตรงกันข้าม	దీనికి విరుద్ధంగా	Nan
ในทางดาราศาสตร์	ఖగోళ శాస్త్రంలో	Nan
ในปีที่	సంవత్సరంలో	None
แต่ไม่สำเร็จ	కానీ విజయవంతం కాలేదు	Nan
ในภาษาสันสกฤต	సంస్కృతంలో	None
ในภาษาอิตาลี่	ఇటాలియన్‌లో	Nan
ในสมัยรัชกาลที่	పాలనలో	None
ในสมัยพุทธกาล	ఆధునిక యుగంలో	Nan
ในสมัยก่อน	పాత రోజుల్లో	Nan
ในสมัยกรุงศรีอยุธยา	ఆయుత కాలంలో	Nan
ในฤดูกาล	సీజన్లో	Nan
ในรัฐบาล	ప్రభుత్వంలో	None
ในภาษาอังกฤษ	ఆంగ్లం లో	Nan
ในรัชสมัยพระบาทสมเด็จพระจอมเกล้าเจ้าอยู่หัว	మోంగ్కుట్ రాజు పాలనలో	Nan
ในระหว่างปี	సంవత్సరంలో	None
ในระยะหลัง	ఇటీవల	None
ในระบบสุริยะ	సౌర వ్యవస్థలో	Nan
ในยุคแรก	మొదట్లో	None
ในยุคกลาง	మధ్య యుగంలో	Nan
ในภาษาไทย	థాయ్ భాషలో	Nan
ในระหว่างวันที่	రోజులో	Nan
เขตคลองสาน	ఖ్లాంగ్ శాన్ జిల్లా	Nan
แต่ไม่ประสบความสำเร็จ	కానీ విజయం లేకుండా	Nan
แต่ใน	కానీ లో	Nan
เทริโอ	therio	Nan
เทวดา	దూత	Nan
เทวรูป	విగ్రహం	None
เทศบาล	మున్సిపాలిటీ	Nan
เทศบาลนครขอนแก่น	ఖోన్ కెన్ మునిసిపాలిటీ	Nan
เทศบาลนครนครราชสีมา	నాఖోన్ రాట్చసిమా	Nan
เทศบาลนครนครศรีธรรมราช	నాఖోన్ సి తమ్మరత్	Nan
เทศบาลนครเชียงราย	చియాంగ్ రాయ్ మున్సిపాలిటీ	Nan
เทศบาลนครเชียงใหม่	చియాంగ్ మాయి మునిసిపాలిటీ	Nan
เทศบาลเมืองชัยภูมิ	చైయాఫం మునిసిపాలిటీ	Nan
เทศบาลเมืองบุรีรัมย์	buriram	Nan
เทศบาลเมืองมหาสารคาม	మహా సారాఖం మునిసిపాలిటీ	Nan
เทศบาลเมืองมุกดาหาร	ముక్దాహన్ మునిసిపాలిటీ	Nan
เทศบาลเมืองสกลนคร	సకోన్ నాఖోన్ మునిసిపాలిటీ	Nan
เทศบาลเมืองหนองคาย	నాంగ్ ఖై మునిసిపాలిటీ	Nan
เทศบาลเมืองหนองบัวลำภู	నాంగ్ బువా లాంఫు టౌన్ మునిసిపాలిటీ	Nan
เทศวิศาล	విస్తృత	None
เธอจะอยู่กับฉันตลอดไป	మీరు ఎప్పటికీ నాతో ఉంటారు	Nan
เธอกับฉัน	మీరు నేను	Nan
เธรซ	త్రేస్	Nan
เธคุนุ	మద్దతు	None
เท่านั้น	మాత్రమే	None
เท่ง	teng	Nan
เทพีเธมิส	దేవత	None
เท็นเท็น	టెన్ టెన్	Nan
เทโรศาสน	టెరో ససనా	Nan
เทเบิลเทนนิส	టేబుల్ టెన్నిస్	Nan
เทียนโพธิ์สุวรรณ	థియాన్ ఫో సువాన్	Nan
เทียนเงิน	వెండి కొవ్వొత్తి	Nan
เทียนทอง	బంగారు కొవ్వొత్తులు	Nan
เทิดศักดิ์	ఆనర్	Nan
เท็ดดี้	టెడ్డీ	Nan
เธอยัง	మీరు ఇప్పటికీ	Nan
เทพอาเตน	athen	Nan
เทพหัสดิน	స్వర్గపు దేవుడు	Nan
เดนโอเบลท์	denobelt	Nan
เดย์	డే	None
เดอะซิมส์	సిమ్స్	Nan
เดอะฮาเดส	ది హేడీస్	Nan
เดอะฮาเดสแชปเตอร์	ది హేడీస్ అధ్యాయం	Nan
เดิม	పాత	None
เดิมชื่อ	గతంలో	None
เดิมที	మొదట	None
เดิมเรียกว่า	పూర్వం అని పిలుస్తారు	Nan
เดียวกัน	అదే	None
เดือดทะลุจุดศูนย์	కేంద్రం ద్వారా ఉడకబెట్టడం	Nan
เดือนกุมภาพันธ์	ఫిబ్రవరి	None
เดือนตุลาคม	అక్టోబర్	None
เดือนตุลาคมมีฝนตกชุกที่สุด	అక్టోబర్ వర్షపాతం.	Nan
เดือนธันวาคม	డిసెంబర్	None
เดือนมกราคม	జనవరి	None
เดือนมิถุนายน	జూన్	Nan
เทพมรณะ	డెత్	Nan
เทพพิทักษ์	theppitak	Nan
เทนโจอิน	tenjo-ఇన్	Nan
เทนนิส	టెన్నిస్	None
เทคโนโลยีสารสนเทศ	సమాచార సాంకేతికత	Nan
เทคโนโลยี	సాంకేతికత	Nan
เทพอานูบิส	అనుబిస్	Nan
เทควันโด้	టైక్వాండో	Nan
เถรวาท	సిద్దాంతము	Nan
เต๋อ	టు	None
เต่า	తాబేలు	Nan
เด็กและเยาวชน	పిల్లలు మరియు యువత	Nan
เด็กหญิงอายุ	పాత అమ్మాయి	Nan
เดือนอ้าย	చంద్ర నెల	Nan
เทคนิคอิลลูชั่น	ఇల్యూజన్ టెక్నిక్	Nan
เดนโอ	డెన్ ఓ	Nan
เธอเป็นเพื่อนอาบาราอิ	ఆమె అబరాయ్ స్నేహితురాలు.	Nan
เนย	వెన్న	None
เปิดสอนระดับปริญญาตรี	అండర్ గ్రాడ్యుయేట్ అధ్యయనం కోసం తెరవండి	Nan
เปียงยาง	ప్యోంగ్యాంగ్	Nan
เปียโตร	పియట్రో	Nan
เปียโน	పియానో	Nan
เปโซ	పెసో	Nan
เป็ด	డక్	Nan
เป็น	ఉన్నాయి	None
เป็นขนมของชาวไทยมุสลิม	థాయ్ ముస్లింల డెజర్ట్	Nan
เป็นครั้งแรก	మొదటి సారి	Nan
เป็นงานเขียนในชุด	సమితిలో వ్రాసిన పని	Nan
เป็นต่อ	ఎగైనెస్ట్	Nan
เป็นต้น	మొదలైనవి	Nan
เป็นต้นมา	నుండి	None
เป็นต้นไม้ประจำมหาวิทยาลัย	విశ్వవిద్యాలయం యొక్క చెట్టు	Nan
เป็นบัวในสกุล	జాతికి చెందిన కమలం	Nan
เป็นประธาน	అధ్యక్షుడవుతారు	Nan
เป็นปลาตู้สวยงาม	ఒక అందమైన అక్వేరియం చేప	Nan
เป๊ปซี่	పెప్సి	Nan
เป็นโฮโมโลกัสกับ	తో హోమోలాగస్	Nan
เป็นเวลา	కోసం	None
เป็นเมืองหลวง	రాజధాని	None
เป็นเจ้าเมืองปกครอง	గవర్నర్	None
เป็นเครื่องหมายแสดงว่า	అది ఒక సంకేతం	Nan
เปอร์โตริโก้	ప్యూర్టో రికో	Nan
เป็นอาวุธ	ఆయుధంగా	Nan
เป็นหัวหน้าพรรค	పార్టీ నాయకుడు	Nan
เป็นหนึ่งใน	ఒకటి	None
เป็นสีประจำ	రెగ్యులర్ రంగు	Nan
เป็นวิญญาณเทียมเพศชาย	మగ కృత్రిమ ఆత్మ	Nan
เป็นพ่อของ	యొక్క తండ్రి	Nan
เป็นพระราชโอรสพระองค์เดียวในพระบาทสมเด็จพระปรมินทรมหาภูมิพลอดุลยเดช	రాజు భూమిబోల్ అడుల్యాదేజ్ కుమారుడు	Nan
เป็นอดีตหัวหน้าหน่วยที่	యూనిట్ మాజీ నాయకుడు	Nan
เนกิ	నెగి	Nan
เปอร์เซีย	పర్షియా	None
เปลื้อง	తొలగించాలి	Nan
เนรมิต	కనుగొనడమే	Nan
เนะ	కుడి	None
เนื่องจาก	నుండి	None
เนื่องจากประเทศเหล่านั้นอยู่ในตำแหน่งบนโลกที่ต่างไปจากประเทศไทย	ఎందుకంటే అవి థాయిలాండ్‌కు భిన్నమైన భూమిపై ఉన్నాయి	Nan
เนื้อที่	ప్రాంతం	None
เนื้อที่ประมาณ	సుమారు ప్రాంతం	Nan
เนื้อร้อง	సాహిత్యం	None
เนื้อเรื่องย่อ	సారాంశం	None
เนเธอร์แลนด์	నెదర్లాండ్స్	None
เนโกะ	నెకో	Nan
เน็น	నేన్	Nan
เบจิต้า	bechita	Nan
เบธเลเฮม	బెత్లేహం	Nan
เบนจามิน	బెంజమిన్	Nan
เบรกมา	బ్రేక్	Nan
เบริธ	బెరిత్	Nan
เบลเฟกอล	bellegal	Nan
เปลี่ยนชื่อเป็น	పేరు మార్చబడింది	Nan
เปลวไฟ	ఫ్లేమ్	Nan
เปรู	పెరు	Nan
เปรี้ยว	సోర్	Nan
เปรม	సంతృప్తి	None
เบ็นเท็น	బెన్ 10	Nan
เปล่งพานิช	plengpanich	Nan
เบโทเฟิน	బీతొవెన్	Nan
เบื่ออาหาร	ఆహారం విసుగు	Nan
เบาหวาน	మధుమేహం	None
เบาท์	baut	Nan
เบา	కాంతి	None
เบอร์ลิน	బెర్లిన్	None
เบส	బాస్	Nan
เบื้องหลัง	నేపథ్య	Nan
เพกาซัส	పెగసాస్	Nan
เดนกัชเชอร์	denkucher	Nan
เดชา	dacha	Nan
เคนยา	కెన్యా	Nan
เคมีไฟฟ้า	విద్యుత్	None
เคยสู้กับโกคุเทระ	గోకుదేరాతో పోరాడటానికి ఉపయోగిస్తారు	Nan
เครือข่าย	నెట్‌వర్క్	None
เครื่องขัตติยราชอิสริยาภรณ์อันมีเกียรติคุณรุ่งเรืองยิ่งมหาจักรีบรมราชวงศ์	చక్ర రాజవంశం యొక్క గొప్ప గౌరవాన్ని జ్ఞాపకం చేసుకోవడం	Nan
เครื่องดีด	strum	Nan
เครื่องตี	బీట్ మెషిన్	Nan
เครื่องบิน	విమానాల	Nan
เครื่องปั้นดินเผาและเซรามิค	కుండలు మరియు సిరామిక్స్	Nan
เครื่องยนต์	ఇంజిన్	Nan
เครื่องราชอิสริยาภรณ์	చిహ్నం	None
เครื่องราชอิสริยาภรณ์อันเป็นที่เชิดชูยิ่งช้างเผือก	తెల్ల ఏనుగుచే మహిమపరచబడిన చిహ్నం	Nan
เครื่องราชอิสริยาภรณ์อันเป็นสิริยิ่งรามกีรติ	కిరాతి యొక్క గొప్ప కీర్తి యొక్క చిహ్నం	Nan
เครื่องราชอิสริยาภรณ์อันเป็นโบราณมงคลนพรัตนราชวราภรณ์	ప్రాచీన చిహ్నం	Nan
เครื่องสาย	తీగల వాయిద్యాలు	Nan
เครื่องแต่งกาย	కాస్ట్యూమ్	Nan
เคลลี่	కెల్లీ	Nan
เจเน็ต	జానెట్	Nan
เจี๊ยบ	చిక్	Nan
เจียะแจ	జే జే	Nan
เจสเปอร์	జెస్పెర్	Nan
เจริญ	పెరుగు	None
เจมินี่	జెమిని	Nan
เคน	కెన్	Nan
เจนี่	janie	Nan
เงี้ยว	చుట్టగానుండు	Nan
เงินในบัญชีธนาคาร	బ్యాంకు ఖాతాలో డబ్బు	Nan
เงินทุน	ఫండింగ్	Nan
เงิน	డబ్బు	None
เค้ก	కేక్	None
เคอาร์วาย	kryy	Nan
เจ	j	Nan
เจ็ดเทพโจรสลัด	shichibukai	Nan
เข้าเฝ้า	ప్రేక్షకులను కలిగి ఉండండి	Nan
เข้าชิงไนน์เอ็นเตอร์เทนอวอร์ดส	తొమ్మిది ఎంటర్టైన్మెంట్ అవార్డులకు ఎంపికైంది.	Nan
เขตดุสิต	dusit	Nan
เขตที่	జిల్లా	None
เขตบางกอกใหญ่	బ్యాంకాక్ యాయ్ జిల్లా	Nan
เขตบางซื่อ	బ్యాంగ్ స్యూ జిల్లా	Nan
เขตบางแค	బ్యాంగ్ ఖే	Nan
เขตปทุมวัน	pathumwan	Nan
เขตภาษีเจริญ	ఫాసి చరోయిన్ జిల్లా	Nan
เขตมีนบุรี	మిన్ బురి జిల్లా	Nan
เขตรักษาพันธุ์สัตว์ป่า	వన్యప్రాణుల అభయారణ్యం	Nan
เขตรักษาพันธุ์สัตว์ป่าภูหลวง	ఫు లుయాంగ్ వన్యప్రాణుల అభయారణ్యం	Nan
เขตลาดกระบัง	లాట్ క్రాబాంగ్	Nan
เขตวังทองหลาง	వాంగ్ తోంగ్లాంగ్ జిల్లా	Nan
เขตวัฒนา	వట్టనా జిల్లా	Nan
เขตสวนหลวง	సువాన్ లుయాంగ్ జిల్లా	Nan
เขตสาทร	sathon	Nan
เขตห้วยขวาง	హువాయ్ ఖ్వాంగ్	Nan
เขตเลือกตั้งที่	బోరో	Nan
เข้าฉาย	షో	None
เข่า	మోకాలి	Nan
เข็มอัปสร	నీడిల్	Nan
เข็มศิลปวิทยา	సూది కళలు	Nan
เขื่อนแม่งัดสมบูรณ์ชล	మే న్గాడ్ సోంబూన్ చోన్ డ్యామ్	Nan
เขื่อนลำปาว	లాంపావో ఆనకట్ట	Nan
เข้ารอบ	ఫైనలిస్ట్	Nan
เขื่อนป่าสักชลสิทธิ์	పసక్ చోన్లాసిట్ ఆనకట్ట	Nan
เขี้ยวพิษ	విష కోరలు	Nan
เขียนโดย	వ్రాసిన వారు	Nan
เขียนว่า	అని రాయండి	Nan
เขาทราย	ఖావో సాయి	Nan
เขากล่าวว่า	అతను \ వాడు చెప్పాడు	Nan
เขมนิจ	అశాశ్వతమైన	Nan
เขื่อนกิ่วลม	కియో విండ్ డ్యామ్	Nan
เดธโน้ต	మరణ వాంగ్మూలం	Nan
เจ็บ	గొంతు	None
เจ้าจอม	మాస్టర్	None
เชียงใหม่	చియాంగ్ మాయి	Nan
เชี่ยววงศ์กุล	chiewwongkun	Nan
เชื่อมต่อกับรถไฟฟ้ามหานคร	mrt కి కనెక్ట్ చేయబడింది	Nan
เชื่อมแม่น้ำท่าจีน	థా చిన్ నదిని కనెక్ట్ చేయండి.	Nan
เชื้อชาติ	రేసు	Nan
เชื้อรา	ఫంగస్	Nan
เช็ค	తనిఖీ	None
เช่นกัน	అలాగే	None
เช่นเดียวกัน	అదేవిధంగా	Nan
เช้ามืดวันที่	రోజు డాన్	Nan
เช้าวันรุ่งขึ้น	మరుసటి ఉదయం	Nan
เซกิ	సెకి	Nan
เซน	జెన్	None
เซนทอร์	సెంటార్	Nan
เซบาสเตียน	సెబాస్టియన్	Nan
เซฟ	సేవ్	Nan
เซลล์	సెల్	None
เดคลิเนชัน	decloration	Nan
เณร	neophyte	Nan
เซ็นเซอร์	సెన్సార్	Nan
เซ็นทารา	centara	Nan
เซ็นทรัล	సెంట్రల్	None
เซ็กส์	సెక్స్	None
เชียงราย	చియాంగ్ రాయ్	Nan
เซโรไลเนอร์	seroliner	Nan
เซโรกัชเชอร์	సెరో కుచర్	Nan
เซอวิวาสแตติน	cervivastin	Nan
เซอร์เบีย	సెర్బియా	None
เซอร์วิส	సర్వీస్	None
เซอร์	సర్	None
เซสติโม	సెటో	Nan
เซโรนอส	seronos	Nan
เจ้าของจุกนม	చనుమొన యజమాని	Nan
เชียงยืน	చియాంగ్ యుయెన్	Nan
เชียงดาว	చియాంగ్ దావో	Nan
เจ้าฟ้ากรมพระยานริศรานุวัดติวงศ์	ప్రిన్స్ క్రోమ్ ఫ్రేయా నరిసరాను, తివాంగ్ ఆలయం	Nan
เจ้าฟ้ากรมพระยานริศรานุวัติวงศ์	ప్రిన్స్ క్రోమ్ ఫ్రేయా నరిసారా నువాట్వాంగ్	Nan
เจ้าฟ้าจิตรเจริญ	ప్రిన్స్ జిట్చారోయెన్	Nan
เจ้าฟ้าภาณุรังษีสว่างวงศ์	ప్రిన్స్ ఫానురాంగ్సీసావాంగ్వాంగ్	Nan
เจ้าฟ้ามหาวชิราลงกรณ	ప్రిన్స్ మహా వజీరాలోంగ్ కార్న్	Nan
เจ้าฟ้ามหาวชิรุณหิศ	ప్రిన్స్ మహావాజీరున్హిత్	Nan
เจ้าฟ้ามหิดลอดุลยเดช	ప్రిన్స్ మహీడోల్ అడుల్యాదేజ్	Nan
เจ้าฟ้ามหิดลอดุลเดช	ప్రిన్స్ మహిడోల్ అడుల్యాదేజ్	Nan
เจ้าฟ้าหญิง	ప్రిన్సెస్	Nan
เจ้าฟ้าอุบลรัตนราชกัญญา	ప్రిన్స్ ఉబోన్‌రట్టనరాజకన్య	Nan
เจ้าหนี้การค้า	చెల్లించవలసిన ఖాతాలు	Nan
เจ้าเมือง	గవర్నర్	None
เจ้าเมืองขุขันธ์	ఖుఖాన్ గవర్నర్	Nan
เจ้าโลก	పెత్తనం	None
เฉพาะด้านตะวันออกเฉียงใต้เท่านั้นที่เป็นที่ราบลุ่มแม่น้ำโขง	ఆగ్నేయ వైపు మాత్రమే మీకాంగ్ నది బేసిన్.	Nan
เฉลิม	chalerm	Nan
เฉลิมชัย	chalermchai	Nan
เชียงของ	chiangkhong	Nan
เชียงกลาง	చియాంగ్ క్లాంగ్	Nan
เชิดชัย	కాంక్వెర్	Nan
เชิญยิ้ม	స్మైల్	Nan
เชาวราษฎร์	chaowarat	Nan
เชาวน์	మేధస్సు	Nan
เชียงปุม	చియాంగ్ పమ్	Nan
เชา	చౌ	Nan
เชส	చేజ్	Nan
เฉลียว	పెర్సెప్టివ్	Nan
เฉลิมแสน	chalermsaen	Nan
เฉลิมพล	chalermpol	Nan
เฉลิมพระเกียรติ	గౌరవం	None
เฉลิมชัยเจริญกิจ	చాలెర్మ్‌చాయ్ చారోన్‌కిట్	Nan
เชอร์รี่	చెర్రీ	Nan
เพชร	వజ్రం	None
เพชรบุรี	phetchaburi	Nan
เพชรบูรณ์	phetchabun	Nan
เหล่านี้	ఈ	None
เหล่าสุนทร	laosonthorn	Nan
เห็นภาพลวงตา	భ్రమ చూడండి	Nan
เอก	ప్రధమ	None
เอกชน	ప్రైవేట్	Nan
เอกซ์	x	Nan
เอกราช	స్వాతంత్య్రం	Nan
เอกวาดอร์	ఈక్వడార్	Nan
เอกสิทธิ์	అధికారాన్ని	None
เอจิเซ็น	echizen	Nan
เอชไอวี	hiv	Nan
เอซ	ఏసెస్	Nan
เอตาสีติ	atacati	Nan
เอนจิเนียริ่ง	ఇంజినీరింగ్	None
เอนไซม์	ఎంజైమ్	Nan
เอบีซี	abc	Nan
เอม	ఎయిమ్	Nan
เอเชียแปซิฟิก	ఆసియా పసిఫిక్	Nan
เอเชียเหนือ	ఉత్తర ఆసియా	Nan
เอเชียตะวันตกเฉียงใต้	నైరుతి ఆసియా	Nan
เอเชีย	ఆసియా	None
เอื้อย	యురి	Nan
เอี่ยมสุข	నేను సంతోషంగా ఉన్నాను	Nan
เหล็ก	స్టీల్	None
เอี่ยมยิ่ง	నేను	None
เอสโตเนีย	ఎస్టోనియా	Nan
เอสเอ็ม	sm	Nan
เอสปาด้าตกชั้น	ఎస్పడా బహిష్కరించబడింది	Nan
เอสปาด้า	ఎస్పడ	Nan
เอล	ఎల్	None
เอริค	ఎరిక్	Nan
เออร์โกสเฟียร์	ఏర్గో స్ఫియర్	Nan
เอเชียใต้	దక్షిణ ఆసియా	Nan
เหลือสมาชิก	మిగిలిన సభ్యులు	Nan
เหรียญรัตนาภรณ์	రత్తానపోర్న్ కాయిన్	Nan
เว้นวรรค	స్థలం	None
เศรษฐกิจพอเพียง	తగినంత ఆర్థిక వ్యవస్థ	Nan
เศรษฐบุตร	sethaputra	Nan
เศรษฐศาสตร์จุลภาค	మైక్రోఎకనామిక్స్	Nan
เศรษฐศาสตร์มหภาค	మాక్రో ఎకనామిక్స్	Nan
เสงี่ยม	mannerly	Nan
เสชนะ	గెలుపు	Nan
เสด็จพระราชสมภพ	రాయల్ జననం	Nan
เสนอชื่อเข้าชิงและรับรางวัล	అవార్డును ప్రతిపాదించండి మరియు స్వీకరించండి.	Nan
เสนา	సేన	None
เสนาเมือง	సేన సిటీ	Nan
เสนีวงศ์	సెని వాంగ్	Nan
เสน่ห์	ఆకర్షణ	None
เสมอ	ఎల్లప్పుడూ	None
เสรี	ఉచిత	None
เสรีภาพ	స్వేచ్ఛ	None
เสียง	ధ్వని	None
เหรียญทอง	స్వర్ణ పతకం	Nan
เหรียญกษาปณ์	మింట్	Nan
เหรียญ	పతకాన్ని	Nan
เหตุการณ์สำคัญ	ముఖ్యమైన సంఘటన	Nan
เหตุการณ์	ఈవెంట్	Nan
เหงื่อ	స్వేద	Nan
เหลือง	పసుపు	None
เส้นใย	ఫైబర్	Nan
เส้นพุ่ง	లైన్	Nan
เส้นทแยงมุม	వికర్ణ	Nan
เสื้อครุย	వస్త్రాన్ని	Nan
เสือจากัวร์	జాగ్వార్	Nan
เสียงเสียดแทรก	fricative ధ్వని	Nan
เสียงเปิด	ఓపెన్ సౌండ్	Nan
เส้นโค้ง	కర్వ్	Nan
เว็บไซต์ซีไอเอ	cia వెబ్‌సైట్	Nan
เอเธนส์	ఏథెన్స్	None
เอเอฟซีแชมเปียนส์ลีก	afc ఛాంపియన్స్ లీగ్	Nan
แขวงหลวงพระบาง	లుయాంగ్ ప్రాబాంగ్ సబ్ డిస్ట్రిక్ట్	Nan
แคดเมียม	కాడ్మియం	Nan
แคทแพท	పిల్లి పాట్	Nan
แคน	కేఎన్	Nan
แคนดี้	కాండీ	Nan
แคนเซอร์	కెన్	Nan
แคม	వెబ్ కామ్	Nan
แคมป์เบลล์	కాంప్బెల్	Nan
แคมเปญ	ప్రచారం	None
แคมเล็ก	చిన్న కామ్	Nan
แคมใหญ่	పెద్ద కామ్	Nan
แคร็กเกอร์	నట్క్రాకర్	Nan
แคลคูลัสเชิงปริพันธ์	సమగ్ర కాలిక్యులస్	Nan
แคลคูลัสเชิงอนุพันธ์	అవకలన కాలిక్యులస్	Nan
แคลอรี	కేలరీలు	Nan
แคลิฟอร์เนีย	కాలిఫోర్నియా	None
แคลิฟอร์เนียม	కాలిఫోర్నియా	None
แต่งโดย	స్వరపరిచారు	Nan
แต่งตั้ง	నియమించాలని	Nan
แต่งงาน	వివాహం	None
แตน	హార్నెట్	Nan
แดเนียล	డేనియల్	Nan
แดนสุพรรณ	suphan	Nan
แขวงจำปาสัก	చంపసాక్ ప్రావిన్స్	Nan
แดงทั้งแผ่นดิน	మొత్తం భూమి ఎరుపు	Nan
แจ๊ส	జాజ్	Nan
แจ๊ค	జాక్	None
แจ็ค	జాక్	None
แจ็กสัน	జాక్సన్	None
แจ	జామ్	None
แคว้น	ప్రాంతం	None
แด	దారు	Nan
เอเอฟซี	afc	Nan
แขน	సాయుధం	Nan
แก๊สธรรมชาติ	సహజ వాయువు	Nan
เอ็กซ์โป	ఎక్స్పో	Nan
เอ็กโทเดิร์ม	ecterm	Nan
เอ็กโปรพลาซ่า	ఎక్స్‌పో ప్లాజా	Nan
เอ็ดดูเทนเมนท์	edutainment	Nan
เอ็ดเวิร์ด	ఎడ్వర్డ్	None
เอ็น	స్నాయువు	Nan
เอ็นบีเอ	nba	Nan
เอ็นเตอร์เทนเม้นท์	వినోదం	None
เอ็นเทอร์เทนเมนท์	వినోదం	None
เอ็มม่า	ఎమ్మా	Nan
เอ๋	eh	Nan
เฮติ	హైతీ	Nan
เฮลมุต	హెల్ముట్	Nan
เฮสเตีย	hestia	Nan
เฮอร์เชล	హెర్షెల్	Nan
เฮาส์	హౌస్	None
เฮียวงะ	hyuga	Nan
แก้วบัวสาย	లోటస్ గ్లాస్	Nan
แก้วทอง	బంగారు గాజు	Nan
แก้ว	గ్లాస్	Nan
แก่	కు	None
แกแล็คซี่	గెలాక్సీ	Nan
แกะ	గొర్రె	Nan
แขก	గెస్ట్	Nan
แกสโทรโพดา	gastropoda	Nan
แกลง	klaeng	Nan
แกริซั่น	గారిసన్	Nan
แกรมมี่	గ్రామీ	Nan
แกรนซ์	గ్రాంట్	Nan
แกมเบีย	గాంబియా	Nan
แกง	కూర	None
แกลเลอรี	గ్యాలరీ	Nan
เว็บไซต์ของเกมส์	గేమ్ వెబ్‌సైట్	Nan
เว็บเบราว์เซอร์	వెబ్ బ్రౌజర్	Nan
เว็บสเตอร์	వెబ్స్టర్	Nan
เภสัชกร	ఔషధ	Nan
เภสัชจลนศาสตร์	ఫార్మకోకైనటిక్స్	Nan
เม	మే	None
เมกา	మెగా	Nan
เมฆ	క్లౌడ్	Nan
เมฆออร์ต	ఓర్ట్ మేఘం	Nan
เมจิ	మీజి	Nan
เมตร	m.	Nan
เมทริกซ์	మాట్రిక్స్	Nan
เมทะนี	metani	Nan
เมอร์คิวรี	బుధుడు	None
เมือง	నగరం	None
เมืองทองฯ	మువాంగ్ థాంగ్	Nan
เมืองนครราชสีมา	నాఖోన్ రాట్చసిమా	Nan
เมืองปทุมธานี	పాతుం తని	Nan
เมืองปราจีนบุรี	prachinburi	Nan
เมืองพิจิตร	phichit	Nan
เมื่อประมาณ	ఎప్పుడు	None
เมืองใหญ่ในเขตนี้	ఈ జిల్లాలోని ప్రధాన నగరాలు	Nan
เมืองใหญ่	పెద్ద నగరం	Nan
เมืองโคราช	వెల్లడించింది	None
เมืองเอก	అకే సిటీ	Nan
เมืองเคมบริดจ์	కేంబ్రిడ్జ్ సిటీ	Nan
เฟื่องอารมย์	foudarom	Nan
เมืองหลวงของอาณาจักรเขมร	ఖైమర్ సామ్రాజ్యం యొక్క రాజధాని	Nan
เมืองสุรินทร์	surin	Nan
เมืองสิงห์	సింహుడు	Nan
เมืองสกลนคร	సకోన్ నాఖోన్	Nan
เมืองลำพูน	lamphun	Nan
เมืองยอง	స్టాగ్ సిటీ	Nan
เมืองพิษณุโลก	ఫిట్సనూలోక్	Nan
เมืองหลวง	రాజధాని	None
เมื่อปีพศ	గత సంవత్సరం	Nan
เฟอร์นิเจอร์	ఫర్నిచర్	Nan
เฟรดริก	ఫ్రెడరిక్	None
เพชรพระอุมา	డైమండ్ ఫ్రా ఉమా	Nan
เพชรา	ముసలివాడు	Nan
เพชรเกษม	petchkasem	Nan
เพดานอ่อน	మృదువైన పైకప్పు	Nan
เพทาย	జిర్కోన్కు	Nan
เพพซิน	పెప్సిన్	Nan
เพราะ	ఎందుకంటే	None
เพราะว่า	ఎందుకంటే	None
เพรียะ	పిరియ	Nan
เพลงประกอบภาพยนตร์	సినిమా సౌండ్‌ట్రాక్	Nan
เพลงประจำจังหวัด	ప్రాంతీయ పాట	Nan
เพลงประจำมหาวิทยาลัย	విశ్వవిద్యాలయ పాటలు	Nan
เพลงปิดเรื่อง	కవర్ పాట	Nan
เพลงพระราชนิพนธ์	రాయల్ మ్యూజిక్	Nan
เพลงลูกทุ่ง	దేశీయ సంగీత	Nan
เพลงลูกทุ่งขับร้อง	దేశీయ సంగీత	Nan
เพลงอีแซว	సంగీతం బాధించటం	Nan
เฟย์	ఫే	Nan
เฟนิรามีน	pheniramine	Nan
เพ็ชรทาย	phettha	Nan
เพื่อใช้ร่วมกับตัวชี้วัดอื่น	ఇతర సూచికలతో వాడాలి	Nan
เพื่อเป็นการเผยแผ่พระพุทธศาสนาและประชาสัมพันธ์กิจกรรมทางพระพุทธศาสนาต่าง	బౌద్ధమతాన్ని ప్రచారం చేయడానికి మరియు మతపరమైన కార్యకలాపాలను ప్రోత్సహించడానికి	Nan
เพื่อ	కోసం	None
เฟส	దశ	None
เพียงพอ	చాలు	None
เพศชาย	పురుషుడు	None
เพศ	సెక్స్	None
เพลโต	ప్లేటో	None
เพลย์สเตชัน	ప్లే స్టేషన్	Nan
เพลงเปิดเรื่อง	ఓపెనింగ్ సాంగ్	Nan
เพลงเปิด	ఓపెనింగ్ సాంగ్	Nan
เพิ่มมา	మరింత	None
เมื่อปีพุทธศักราช	బౌద్ధ యుగంలో	Nan
เมื่อวันจันทร์	సోమవారం రోజు	Nan
เมื่อเดือนกันยายน	గత సెప్టెంబర్	Nan
เรื่อง	విషయం	None
เรื่องย่อ	సారాంశం	None
เรื่องสั้น	చిన్న కథ	Nan
เร้กเก้	రెగె	Nan
เลข	సంఖ్య	None
เลขที่	సంఖ్య	None
เลขาธิการสหประชาชาติ	ఐక్యరాజ్యసమితి సెక్రటరీ జనరల్	Nan
เลนส์	లెన్స్	Nan
เลออน	లియోన్	Nan
เลิฟ	లవ్	None
เลือดออกตามไรฟัน	వైటమిన్ లోపంవల్ల కలిగే వ్యాధి	Nan
เลโอ	లియో	Nan
เลโอนาร์โด	లియోనార్డో	Nan
เล็ก	చిన్న	None
เล่ม	పుస్తకం	None
เล่มที่	పుస్తక సంఖ్య	Nan
เวทีทอง	బంగారు దశ	Nan
เว็บ	అంతర్జాలము	Nan
เวโรนา	వరోన	Nan
เวียนเทียนรอบอุโบสถหรือสถูปเจดีย์พุทธสถานต่าง	ప్రార్థనా మందిరం లేదా పగోడా చుట్టూ ప్రదక్షిణలు	Nan
เวียงสา	వియాంగ్ సా	Nan
เวียงสระ	వియాంగ్ సా	Nan
เวิลด์	ప్రపంచం	None
เรือใบ	బోట్	Nan
เวิร์ม	వార్మ్స్	Nan
เวิร์คพอยท์	workpoint	Nan
เวอร์โก้	vergo	Nan
เวอร์ชัน	సంస్కరణ: telugu	Nan
เวสต์	వెస్ట్	None
เวลาประมาณ	అంచనా సమయం	Nan
เวล	వైల్	Nan
เวิร์คพอยท์สตูดิโอ	వర్క్‌పాయింట్ స్టూడియో	Nan
เรือเร็วโจมตี	స్పీడ్ బోట్ దాడి	Nan
เรือสำรวจ	సర్వే ఓడ	Nan
เรือยกพลขึ้นบก	ల్యాండింగ్ షిప్	Nan
เรดวัน	ఎరుపు రోజు	Nan
เรด	రెడ్	None
เรซูเม	పునఃప్రారంభం	Nan
เยื่อหุ้มสมอง	కార్టెక్స్	Nan
เยาวราช	చైనాటౌన్	Nan
เยาวชนอายุ	యువత వయస్సు	Nan
เรย์	రే	None
เยาวชน	యూత్	Nan
เยอรมนี	జర్మనీ	None
เยลโล่	పసుపు	None
เย	యే	None
เม่น	ముళ్ళపంది	Nan
เม็ดขนุน	పనస	Nan
เมื่อเดือนมีนาคม	మార్చి లో	Nan
เยอรมัน	జర్మన్	None
แต่ในปัจจุบัน	కానీ ఇప్పుడు	Nan
เรวดี	శుభవార్త	Nan
เริ่มการผลิตนำเข้า	దిగుమతి ఉత్పత్తిని ప్రారంభించండి	Nan
เรือนนาค	నాగ హౌస్	Nan
เรือตรี	పడవ	None
เรืองศรี	rueangsri	Nan
เรืองรุ่ง	ప్రకాశించే	Nan
เรียะชอาณาจักร	కింగ్డమ్	Nan
เรียวเฮ	రై హై	Nan
เราเตอร์	రూటర్	Nan
เรียวทาโร่	ryotaro	Nan
เรียล	రియల్	None
เรียกว่า	కాల్డ్	Nan
เรียกกันว่า	కాల్డ్	Nan
เริ่มตั้งแต่อาณาจักรอยุธยาได้โจมตีอาณาจักรเขมร	ఖైమర్ రాజ్యంపై ఆయుత రాజ్యం దాడి చేయడం ప్రారంభమైంది.	Nan
เริ่มจากเดือนพฤศจิกายนเมษายน	నవంబర్ నుండి ఏప్రిల్ వరకు	Nan
เริ่มก่อสร้าง	నిర్మాణాన్ని ప్రారంభించండి	Nan
เรียว	సన్నని	None
ព្រះរាជាណាចក្រកម្ពុជា	ព្រះរាជាណាចក្រ កម្ពុជា	Nan
ลัคนา	ప్రాబల్యం	None
ลักษณะสำคัญ	ముఖ్యమైన లక్షణాలు	Nan
ซากดึกดำบรรพ์	శిలాజ	Nan
ซาคุโร่	sakuro	Nan
ซาซางาวะ	sasagawa	Nan
ซานกัลโล	శాన్ గాల్లో	Nan
ซาบุซะ	sabuza	Nan
ซาลาดิน	సలాహుద్దీన్ అయ్యూబీ	Nan
ซาอิ	sayi	Nan
ซาโลมอน	సాలమన్	Nan
ซิกนัส	cignus	Nan
ซิงเกอร์	సింగర్	Nan
ซิงเกิ้ล	సింగిల్స్	Nan
ซิทคอม	సిట్కాం	Nan
ซินเดอเรลล่า	సిండ్రెల్లా	Nan
ซิมไฟลา	simphila	Nan
ซิโนไทย	సినో థాయ్	Nan
ซี	సి	Nan
ซีซี	cc	Nan
ซึ่งมี	ఇది ఉంది	Nan
ซึ่งประกอบด้วย	కలిగి	None
ซึ่ง	ఇది	None
ซึม	కారే	Nan
ซึง	ఏ	Nan
ซีโร่	జీరో	Nan
ซัลเฟต	సల్ఫేట్	Nan
ซีแคนต์	సేకాంట్	Nan
ซีเซียม	సీసియం	None
ซีเจ	cj	Nan
ซีเกมส์	sea గేమ్స్	Nan
ซีสต์	తిత్తులు	Nan
ซีลีเนียม	సెలీనియం	None
ซีรีเบลลัม	serabellum	Nan
ซีเนม่า	సినిమా	None
ซึ่งมีความหมายว่า	ఏమిటంటే	None
ซัลฟาไดอะซีน	sulfadiazine	Nan
ซันไชน์	సూర్యరశ్మి	None
ชื่อนามสกุล	మెదటి పేరు ఇంటి పేరు	Nan
ชื่อภาษาญี่ปุ่น	జపనీస్ పేరు	Nan
ชื่อภาษาอังกฤษ	ఇంగ్లీష్ పేరు	Nan
ชื่อยศภาษาไทย	థాయ్ ర్యాంక్	Nan
ชื่ออัลบั้ม	ఆల్బమ్ పేరు	Nan
ชื่ออื่น	ఇతర పేర్లు	Nan
ชื่อเก่าในวงการ	పరిశ్రమలో పాత పేరు	Nan
ชื่อเดิม	పూర్వపు పేరు	Nan
ชื่อเมือง	నగరం పేరు	Nan
ชื่อเรื่อง	ఈ శీర్షిక	Nan
ชื่อเล่น	మారుపేరు	Nan
ชุดแพนเค้ก	పాన్కేక్ సెట్	Nan
ชุติมา	chutima	Nan
ชุมชนออนไลน์ชาวจังหวัดสกลนคร	సాకోన్ నాఖోన్ ఆన్‌లైన్ సంఘం	Nan
ชุมพลบุรี	చుంఫోన్ బురి	Nan
ชุมแพ	చుమ్ ఫే	Nan
ชุมแสง	చుమ్ సాంగ్	Nan
ซออู้	జో ఓ	Nan
ซอมบี้	జాంబీస్	Nan
ซบที่อกฉัน	నా ఛాతీలో నెస్లే	Nan
ซน	కొంటె	Nan
ซ	సి	Nan
ช้อน	చెంచా	Nan
ซัลฟานิลาไมด์	sulfanilamide	Nan
ช่องเชิงเทิน	పిట్టగోడలు	Nan
ช่วงปี	సంవత్సరం	None
ช็อกโกแลต	చాక్లెట్	Nan
ชไนเดอร์	schneider	Nan
ชโย	బ్రావో	Nan
ชูศักดิ์	chusak	Nan
ชูมันน์	schumann	Nan
ช่อง	ఛానల్	None
ชื่อดัง	ప్రముఖ	None
ซึ่งมีทั้งหมด	ఇది అన్నింటినీ కలిగి ఉంది	Nan
ซึ่งเกิดจากปัจจัยภายนอก	బాహ్య కారకాల వల్ల వస్తుంది	Nan
ดอกอ้อ	రీడ్ ఫ్లవర్	Nan
ดอกไม้	పుష్పం	None
ดอกไม้ประจำจังหวัด	ప్రాంతీయ పువ్వు	Nan
ดอตคอม	డాట్ కామ్	Nan
ดอนเมือง	డాన్ ముయాంగ్	Nan
ดอยอินทนนท์	డోయి ఇంటానాన్	Nan
ดอร์	డోర్	Nan
ดอลลาร์สหรัฐ	మాకు డాలర్	Nan
ดอว์ขิ่นจี	డావిన్ జీ	Nan
ดังนั้น	కాబట్టి	None
ดังเช่น	ఇలా	None
ดัชนีการพัฒนามนุษย์	మానవ పురోగతి సూచిక	Nan
ดัตช์	డచ్	None
ดันแฮม	డన్హమ్	Nan
ดับเบิลยู	w.	Nan
ดา	డా	None
ดาบ	కత్తి	Nan
ดาวอาร์คตุรุส	స్వాతి	None
ดาวศุกร์	శుక్రుడు	None
ดาวยูเรนัส	యురేనస్	Nan
ดาวพุธ	బుధుడు	None
ดาวพฤหัสบดี	బృహస్పతి	None
ดาวคาโนปุส	canapas	Nan
ดอก	పుష్పం	None
ดาวกระจาย	స్టార్-బర్స్ట్	Nan
ดาราศาสตร์รังสีเอ็กซ์	ఎక్స్-రే ఖగోళ శాస్త్రం	Nan
ดาราจักร	గెలాక్సీ	Nan
ดาราคู่แรกของไทย	థాయిలాండ్‌లో మొదటి నక్షత్రం	Nan
ดารากร	నటుడు	None
ดารา	స్టార్	None
ดาบเขี้ยวฟ้าฟื้น	ది స్వోర్డ్ ఆఫ్ రివెంజ్	Nan
ดาราหญิงไทยยอดนิยม	ప్రసిద్ధ థాయ్ మహిళా ప్రముఖులు	Nan
ซึ่งรู้จักกันว่า	ఏది అంటారు	Nan
ดวงอาทิตย์	సూర్యుడు	None
ดราก้อนเควสต์	డ్రాగన్ క్వెస్ట్	Nan
ซึ่งเรียกว่า	ఏది అంటారు	Nan
ซึ่งแท้จริงแล้ว	నిజం	None
ซึ่งได้แก่	ఏవేవి	Nan
ซุง	లాగ్	Nan
ซุน	సన్	None
ซุปเปอร์มาร์เก็ต	సూపర్ మార్కెట్	Nan
ซุปเปอร์เซ็นเตอร์	సూపర్ సెంటర్	Nan
ซู	స్యూ	Nan
ซูจี	suzy	Nan
ซูซูกิ	సుజుకి	Nan
ซูรินาเม	సురినామ్	Nan
ซูเปอร์เซ็นเตอร์	సూపర్ సెంటర్	Nan
ซ่อมแซม	మరమ్మత్తు	Nan
ซ่าหริ่ม	సంతోషంగా ఉండండి	Nan
ซ้าย	ఎడమ	None
ฌอง	జీన్	None
ญ	ది	None
ดราก้อน	డ్రాగన్	Nan
ดรสุชาติ	డాక్టర్ సుచార్ట్	Nan
ดรสาโรช	డాక్టర్ సరోజ్	Nan
ดรนิพนธ์	డాక్టర్ నిపాన్	Nan
ดรทรงศักดิ์	డాక్టర్ సాంగ్సాక్	Nan
ดม	వాసన	None
ดวงพร	ఫార్చ్యూన్	Nan
ดง	త్రష్	Nan
ณัฐวุฒิ	natthawut	Nan
ณัฏฐธิดา	natthida	Nan
ณรงค์	ప్రచారంలో	None
ณภัทร	naphat	Nan
ฐานทัพ	కంటోన్మెంట్	Nan
ฐานข้อมูล	డేటాబేస్	None
ด	m	Nan
ดาวเคราะห์	గ్రహం	None
ชีวสถิติ	బయోస్టాటిస్టిక్స్	Nan
ชีวประวัติ	జీవిత చరిత్ర	Nan
จำนวน	సంఖ్య	None
จำนวนประชากร	జనాభా	None
จำปาเทศ	చంపా	Nan
จำเริญ	ప్రబల	None
จิกะไบต์	jigtes	Nan
จิตรกร	చిత్రకారుడు	None
จิตรกรรม	పెయింటింగ్	Nan
จิตวิทยา	మనస్తత్వశాస్త్రం	Nan
จิตใจ	మనసు	None
จินตหรา	jintara	Nan
จิบูตี	జైబూటీ	Nan
จิบเบอเรลลิน	gibberellin	Nan
จิม	జిమ్	Nan
จิโอวานนี	గియోవన్నీ	Nan
จี	g	Nan
จีนตัวย่อ	సరళీకృత చైనీస్	Nan
จียอน	jiyeon	Nan
จเพชรบูรณ์	phetchabun	Nan
จเพชรบุรี	phetchaburi	Nan
จเชียงใหม่	చియాంగ్ మాయి	Nan
จูเนียร์	జూనియర్	None
จูเซปเป	గియుసేప్	Nan
จูล	శక్తి కొలమానము	Nan
จำกัดมหาชน	లిమిటెడ్	None
จุฬาลงกรณินทรวรางกูร	చులాలాంగ్‌కార్న్ నింతరంగ్రాంగ్‌కున్	Nan
จุดจอมฟ้า	బ్లూ పాయింట్	Nan
จุดกึ่งกลาง	midpoint	Nan
จุกนมสีขุ่น	అపారదర్శక టీట్	Nan
จึงใช้ธาตุหมอกและเมฆาได้	అందువల్ల పొగమంచు మరియు మేఘం యొక్క మూలకాన్ని ఉపయోగించవచ్చు	Nan
จึงเปิดโอกาสให้	అందువల్ల అవకాశం ఇచ్చారు	Nan
จึงทรงพระกรุณาโปรดเกล้า	అందువల్ల దయతో ఆదేశించారు	Nan
จุลจอมเกล้าเจ้าอยู่หัว	రాముడు రా	Nan
จ๊กมก	jumkum	Nan
จำกัด	లిమిటెడ్	None
จารุเสถียร	జారు సతియన్	Nan
จังหวัดเพชรบูรณ์	phetchabun	Nan
จังหวัดเลย	లోయి ప్రావిన్స్	Nan
จังหวัดแพร่	ఫ్రఎ	Nan
จังหาร	junghan	Nan
จัดขึ้นเมื่อ	జరపబడిన	Nan
จัดตั้งขึ้นโดย	ద్వారా స్థాపించబడింది	Nan
จัดอยู่ในภูมิภาค	ఈ ప్రాంతంలో నిర్వహించబడింది	Nan
จัดเมื่อวันที่	జరపబడిన	Nan
จัดโดย	ఏర్పాటు	None
จัน	చాన్	Nan
จันทบุรี	chanthaburi	Nan
จันทร	చంద్రుడు	None
จันทรุปราคา	చంద్రగ్రహణం	Nan
จันทร์	సోమవారం	Nan
จันทร์ภักดี	చాన్ ఫక్ది	Nan
จันทร์เกษ	చాన్ కేట్	Nan
จาก	నుండి	None
จารีตประเพณี	సంప్రదాయం	Nan
จามจุรี	jamjuree	Nan
จาติกวณิช	chatikavanij	Nan
จากโซล	సియోల్ నుండి	Nan
จากเว็บไซต์กระทรวงต่างประเทศ	విదేశీ వ్యవహారాల మంత్రిత్వ శాఖ వెబ్‌సైట్ నుండి	Nan
จากเว็บไซต์กระทรวงการต่างประเทศ	విదేశీ వ్యవహారాల మంత్రిత్వ శాఖ వెబ్‌సైట్ నుండి	Nan
จาวตาลเชื่อม	జావో టాన్ వెల్డ్	Nan
จากเว็บ	వెబ్ నుండి	Nan
จากอัลบั้ม	ఆల్బమ్ నుండి	Nan
จากสารานุกรมบริทานิกา	ఎన్సైక్లోపీడియా బ్రిటానికా నుండి	Nan
จากละครเรื่อง	నాటకం నుండి	Nan
จากละคร	నాటకం నుండి	Nan
จากภาษากรีก	గ్రీకు నుండి	Nan
จากการพิสูจน์อายุโดยคาร์บอน	కార్బన్ ద్వారా వయస్సు రుజువు నుండి	Nan
จากเรื่อง	కథ నుండి	Nan
ชีวมวล	బయోమాస్	Nan
ฉ	f	Nan
ฉบับวณิพก	సంఖ్యల్లో	Nan
ชั้นมหาวชิรมงกุฎ	క్రౌన్ మహా వచిరా క్లాస్	Nan
ชั้นยศ	రాంక్	Nan
ชั้นสูงสุด	అత్యధిక స్థాయి	Nan
ชา	టీ	None
ชากะ	షాక	Nan
ชาคริต	హెచ్చరిక	None
ชาญชัย	chanchai	Nan
ชาตะ	పుట్టండి	Nan
ชาติ	దేశం	Nan
ชาย	పురుషుడు	None
ชาร์ป	వెంటనే	None
ชาร์ล	చార్లెస్	None
ชาร์ลส	చార్లెస్	None
ชาลส์	చార్లెస్	None
ชาลี	చార్లీ	Nan
ชาวนา	రైతు	Nan
ชาวไทย	థాయ్ ప్రజలు	Nan
ชีวนิชพันธ์	జీవ	None
ชีพด็อก	షీప్డాగ్	Nan
ชิโนะ	chino	Nan
ชิลี	చిలీ	Nan
ชิริว	chiryu	Nan
ชินวัตร	shinawatra	Nan
ชั้นประทวน	అంతస్తు	Nan
ชิน	అభిమానం	Nan
ชิซุกะ	shizuka	Nan
ชิงร้อยล้าน	వంద మిలియన్లకు పోటీపడండి	Nan
ชิงร้อย	పోటీ	None
ชิคิกามิ	shikikami	Nan
ชำนิ	chamni	Nan
ชาวไทยภูเขา	కొండ తెగ	Nan
ชิดจันทร์	chidchan	Nan
ฉบับชั่วคราว	తాత్కాలిక సంస్కరణ	Nan
ชั้นที่	అంతస్తు	Nan
ชัยยุทธ	chaiyut	Nan
ฉลอง	జరుపుకుంటారు	None
ฉลองพระชนมายุ	80 వ సంవత్సరం జరుపుకోండి	Nan
ฉันรักคุณ	నేను నిన్ను ప్రేమిస్తున్నాను	Nan
ฉาบ	ప్లాస్టర్	Nan
ฉายเมื่อ	చూపబడింది	Nan
ฉิ่ง	కంచుతాళం	Nan
ฉี่	ఒంటికి	Nan
ชนะ	గెలుపు	Nan
ชนิด	రకం	None
ชนิดของเมฆ	మేఘ రకం	Nan
ชม	వాచ్	Nan
ชมชื่น	అభినందన	Nan
ชมพู	గులాబీ	Nan
ชมพูทวีป	భారతదేశం	None
ชมพู่	గులాబీ ఆపిల్	Nan
ชล	సరస్సులు	None
ชลธารวิทยา	చలోమ్ విట్టయా	Nan
ชัยมงคล	chaimongkol	Nan
ชัยบัญชา	చాయ్ బాంచా	Nan
ชัยนาม	చాయ్ నామ్	Nan
ชัยชนะ	విజయం	None
ชัย	విజయం	None
ชัชพล	chatchapon	Nan
ชั้น	తరగతి	None
ชะอำ	చ-am	Nan
ชะมด	మస్క్	Nan
ชะนี	గిబ్బన్	Nan
ชอบ	వంటి	None
ชวนชื่น	ఆహ్వానిస్తోంది	Nan
ชลิต	chalit	Nan
ชลบุรี	చోన్ బురి	Nan
ชะอวด	చూపించు	Nan
ดาวเคราะห์แคระ	మరగుజ్జు గ్రహం	Nan
ดาวเสาร์	సాటర్న్	Nan
ดำรงค์	wimax	Nan
ทองใหญ่	పెద్ద బంగారం	Nan
ทอม	టామ్	Nan
ทอมสัน	థామ్సన్	Nan
ทอมัส	థామస్	None
ทะเล	సముద్ర	None
ทะเลทราย	ఎడారి	None
ทะเลสาบ	మడుగు	Nan
ทักษะ	నైపుణ్యాలు	Nan
ทัช	టచ్	Nan
ทับ	స్లాష్	Nan
ทัพเรือภาคที่	నావికా విభాగం	Nan
ทัวร์คอนเสิร์ต	కచేరీ పర్యటన	Nan
ทั่วไป	సాధారణ	None
ทั้ง	రెండు	None
ทั้งหมด	అన్ని	None
ทางทิศตะวันออก	తూర్పు	None
ทางทิศตะวันออกติดกับเวียดนาม	తూర్పు సరిహద్దు వియత్నాం.	Nan
ทำให้	మేక్	Nan
ทำหน้าที่	విధి చేయండి	Nan
ทำบุญตักบาตรฯ	మెరిట్ చేయడం మరియు సన్యాసులకు ఆహారాన్ని అందించడం	Nan
ทำนอง	ట్యూన్	Nan
ทำงาน	పని	None
ทาวเวอร์	టవర్	None
ทองแดง	రాగి	None
ทาร์ดิกราดา	tardikrada	Nan
ทางไอทีวี	ఈటీవీలో	Nan
ทางอากาศ	గాలి ద్వారా	Nan
ทางหลวงพิเศษ	ప్రత్యేక రహదారి	Nan
ทางรถไฟ	రైలు	None
ทางน้ำ	నీటి మార్గం	Nan
ทางทิศเหนือติดกับประเทศไทยและลาว	ఉత్తర సరిహద్దులో థాయిలాండ్ మరియు లావోస్ ఉన్నాయి.	Nan
ทานากะ	తనకా	Nan
ทิฆัมพรธีรวงศ์	టికాంపోర్న్ తిరావాంగ్	Nan
ทองเจือ	బంగారం కప్పబడి ఉంది	Nan
ทองหยอด	బంగారు ఆకు	Nan
ทรงคล้ายทรงกลม	గోళాకార	Nan
ทรงถือหุ้นจำนวน	అతని హైనెస్ వాటాలను కలిగి ఉంది	Nan
ทรงผนวช	అతని హైనెస్	Nan
ทรงพระกรุณาโปรดเกล้าโปรดกระหม่อมให้	దయతో నన్ను పవిత్రం చేయండి	Nan
ทรงยี่สิบหน้า	ఇరవై ముఖం	Nan
ทรงลูกบาศก์	క్యూబ్	Nan
ทรงสี่เหลี่ยมขนมเปียกปูน	రాంబస్	Nan
ทรงสี่เหลี่ยมมุมฉาก	దీర్ఘ చతురస్రం	Nan
ทรงห้าหน้า	ఐదు ముఖం	Nan
ทรงได้รับการทูลเกล้าฯ	అతని మెజెస్టి కింగ్ అందుకున్నారు	Nan
ทรัพยากร	వనరు	Nan
ทรัพยากรน้ำ	నీటి వనరులు	Nan
ทรัพย์วิจิตร	సంపద	None
ทรัพย์เพิ่ม	అదనపు ఆస్తులు	Nan
ทรัมเป็ต	ట్రంపెట్	Nan
ทรีทูวัน	త్రీ టు వన్	Nan
ทวารหนัก	అనస్	Nan
ทองผาภูมิ	థాంగ్ ఫా ఫమ్	Nan
ทองประสม	మిశ్రమ బంగారం	Nan
ทองขาว	తెల్ల బంగారం	Nan
ทอง	బంగారం	None
ทหารอากาศ	వాయు సైన్యము	Nan
ทหารหน่วยอาเฟลันดราที่	అఫెలాంద్ర ట్రూప్	Nan
ทองหล่อ	thonglor	Nan
ทหาร	సైనికుడు	Nan
ทศกัณฐ์	tosakan	Nan
ทว่า	కానీ	None
ทวีวัฒน์	thawiwat	Nan
ทวีปเอเชีย	ఆసియా	None
ทวีปอเมริกา	అమెరికా	None
ทวีป	ఖండంలోని	None
ทศพล	tosapon	Nan
ทนายความ	న్యాయవాది	Nan
ทิพย์	thip	Nan
ทิม	టిమ్	Nan
ท่าน้ำนนท์	వాటర్ఫ్రంట్	Nan
ท่ายาง	రబ్బరు ముద్ర	Nan
ท่าศาลา	థా సాలా	Nan
ท่าอากาศยานเลย	లోయి విమానాశ్రయం	Nan
ท่าเรือ	పోర్ట్	None
ท่าไม้ตาย	స్థిరనివాసుల	Nan
ท้องสนามหลวง	సనమ్ లుయాంగ్	Nan
ธกรุงไทย	క్రుంగ్ థాయ్ బ్యాంక్	Nan
ธกส	baac	Nan
ธกสิกรไทย	కాసికార్న్ బ్యాంక్	Nan
ธง	జెండా	None
ธงชัย	thongchai	Nan
ธงชาติ	జాతీయ పతాకం	Nan
ธงธง	జెండా	None
ธนบุรี	thonburi	Nan
ธนพร	thanaporn	Nan
ธนะรัชต์	thanarat	Nan
ธรรมนูญ	చార్టర్	Nan
ธรณีสัณฐานวิทยา	నేల పదనిర్మాణం	Nan
ธรณินทราธิราช	tharawintharathirat	Nan
ธปท	బొట్	Nan
ธนิต	thanit	Nan
ธนาคารไทยพาณิชย์	సియామ్ కమర్షియల్ బ్యాంక్	Nan
ท่านอ้วน	లావు మనిషి	Nan
ธนาคารเพื่อการพัฒนาแห่งเอเชีย	ఆసియా అభివృద్ధి బ్యాంకు	Nan
ธนาคารอิสลามแห่งประเทศไทย	ఇస్లామిక్ బ్యాంక్ ఆఫ్ థాయిలాండ్	Nan
ธนาคารทิสโก้	టిస్కో బ్యాంక్	Nan
ธนาคารทหารไทย	థాయ్ మిలిటరీ బ్యాంక్	Nan
ธนาคารกรุงไทย	క్రుంగ్ థాయ్ బ్యాంక్	Nan
ธนาคารกรุงศรีอยุธยา	బ్యాంక్ ఆఫ్ ఆయుధ్య	Nan
ธนาคาร	బ్యాంకు	None
ธนาคารเกษตร	వ్యవసాయ బ్యాంకు	Nan
ทิฟฟานี่	tiffany	Nan
ท่านอ่อง	వోంగ్	Nan
ท่าชนะ	భంగిమ	None
ทิวานนท์	tiwanon	Nan
ทิศตะวันตก	వెస్ట్	None
ที	t	Nan
ทีบีเอส	tbs	Nan
ทีมชาติไทย	థాయిలాండ్ జాతీయ జట్టు	Nan
ทีมใดที่จำนวนข้อที่ถูกน้อยกว่า	ఏ జట్టు కంటే తక్కువ సంఖ్య ఉంది	Nan
ทีวีอินไซด์	టీవీ లోపల	Nan
ทีโอที	చిన్నపాప	Nan
ที่จ่ายร้อยละ	చెల్లింపు	Nan
ที่นี้	ఇక్కడ	None
ที่ประชาชนชอบมากที่สุด	ఏ వ్యక్తులు ఎక్కువగా ఇష్టపడతారు	Nan
ที่มา	మూల	None
ที่มี	అది ఉంది	Nan
ที่มีชื่อว่า	అనే	None
ที่สำคัญ	కీ	None
ที่หมายถึง	అది ఏంటి అంటే	Nan
ที่อยู่อาศัย	నివాసం	None
ท่องอาณาจักรโฮ่งเหมียว	హాంగ్ మియావో రాజ్యాన్ని పఠించండి	Nan
ทไย	ఎందుకు	None
ทโกมลบุตร	thakomolabutr	Nan
ทเวนตี้	ఇరవై	Nan
ทูล	టూల్	Nan
ทู	టూ	Nan
ท่านอิน	లో	None
ทุ่งใหญ่	తుంగ్ యాయ్	Nan
ทุ่งตะโก	తుంగ్ టాకో	Nan
ทุติยจุลจอมเกล้าวิเศษ	నాళాలు	Nan
ทุกครั้ง	ప్రతిసారి	Nan
ทุก	ప్రతి	None
ที่โดดเด่นคือ	అత్యుత్తమమైనది	Nan
ที่เกิดขึ้น	అది జరిగింది	Nan
ทุ่งสง	థంగ్ సాంగ్	Nan
ทนาย	న్యాయవాది	Nan
ทนงศักดิ์	thanongsak	Nan
ทดลอง	ట్రయల్	Nan
ด้านหน้า	ముందు	None
ด้านหลัง	వెనుక	None
ด้านอ่าวไทย	గల్ఫ్ ఆఫ్ థాయిలాండ్	Nan
ต	o	Nan
ตกรอบที่	తొలగించబడ్డాడు	Nan
ตรงกับวันขึ้น	జత పరచు	Nan
ตรงกับวันที่	మ్యాచ్ తేదీ	Nan
ตระกูล	వంశం	None
ตระกูลนารา	నారా కుటుంబం	Nan
ตระกูลปาร์ค	క్లాన్ పార్క్	Nan
ตระกูลยามานากะ	యమనక కుటుంబం	Nan
ตระกูลอินุซึกะ	ఇనుజుకా కుటుంబం	Nan
ตระกูลเซนจู	సెంజు కుటుంబం	Nan
ตรัง	ట్రాంగ్	Nan
ตรางู	పాము	Nan
ตราด	త్రాత్	Nan
ตรานี้	ఈ ముద్ర	Nan
ตันติเวชกุล	tantivejkul	Nan
ตะวันออกเฉียงเหนือ	ఈశాన్యం	Nan
ตะวันออก	తూర్పు	None
ตะวันทอแสง	సూర్యోదయం	Nan
ตะลุยอวกาศ	స్పేస్ డాబుల్	Nan
ตะละภัฏ	talapat	Nan
ด้านดนตรี	సంగీతం	None
ตะกั่ว	ప్రధాన	None
ตอน	ఎప్పుడు	None
ตลาดโลตัส	లోటస్ మార్కెట్	Nan
ตลาด	సంత	Nan
ตรุษจีน	చైనీయుల నూతన సంవత్సరం	Nan
ตรึงใจ	మోహింపజేయు	Nan
ตราสัญลักษณ์	చిహ్నం	None
ตะกร้อ	కండల	Nan
ตัว	శరీర	None
ด้านการเกษตร	వ్యవసాయ	None
ด้านการกีฬา	క్రీడలు	None
ดำรงตำแหน่ง	ఒక స్థానం పట్టుకోండి	Nan
ดำรงอ่องตระกูล	డామ్రాంగ్ ఓంగ్ వంశం	Nan
ดำเนินสะดวก	డామ్నోయెన్ సాదుక్	Nan
ดิกชันนารี	నిఘంటువు	None
ดิค	డిక్	Nan
ดิจิตอล	డిజిటల్	None
ดิน	మట్టి	None
ดินเซนฮอฟเฟอร์	zenhoffer	Nan
ดินแดน	భూభాగం	None
ดิว	డ్యూ	Nan
ดิวิชั่น	విభజన	None
ดิศ	డిస్క్	None
ดิศกุล	diskul	Nan
ดิสนีย์	డిస్నీ	Nan
ดิสโพรเซียม	dysprosium	Nan
ดี	మంచిది	None
ดีคอนสตรักทิวิสม์	dconrak tavist	Nan
ด้วยเหตุนี้	ఈ కారణంగా	Nan
ด้วย	తో	None
ด็อก	కుక్క	None
ดูแล	సంరక్షణ	None
ดูเร็กซ์	durex	Nan
ดูเพิ่มเติมที่	ఇది కూడ చూడు	Nan
ด้านการต่างประเทศ	విదేశీ వ్యవహారాలు	Nan
ดูเพิ่มเติม	ఇంకా చూడు	Nan
ดุสิต	dusit	Nan
ดีเอ็นเอ	dna	Nan
ดีเวลลอปเม้นท์	అభివృద్ధి	None
ดีเวลลอปเมนท์	అభివృద్ధి	None
ดีบุก	టిన్	Nan
ดีน	డీన్	Nan
ดูที่	అటు చూడు	Nan
ตัวพระ	ప్రవక్త	None
ตัวยักษ์	జెయింట్	Nan
ตัวละคร	పాత్ర	None
ติณสูลานนท์	tinsulanon	Nan
ติอามัต	టియామాట్లతో	Nan
ตี๋ใหญ่	బిగ్ టీ	Nan
ตึก	కట్టడం	Nan
ตุรกี	టర్కీ	None
ตุลาคม	అక్టోబర్	None
ตุ๊กแก	తొండ	Nan
ตูน	కార్టూన్	Nan
ต่อกันด้วยพันธะ	బంధాలతో కొనసాగించండి	Nan
ต่อจาก	నుండి కొనసాగించండి	Nan
ต่อมา	తర్వాత	None
ต่อมาวันที่	తదుపరి తేదీ	Nan
ต่อมาในปี	సంవత్సరం తరువాత	Nan
ต่อมาในรัชกาลที่	తరువాత పాలనలో	Nan
ต่อมาในสมัยกรุงธนบุรีและกรุงรัตนโกสินทร์เขมรตกอยู่ภายใต้การควบคุมของจักรวรรดิสยามอย่างเข้มงวด	తరువాత, తోన్బురి మరియు రత్తనకోసిన్ కాలాలలో, ఖైమర్ సియామీ సామ్రాజ్యంపై కఠినమైన నియంత్రణలో ఉంది.	Nan
ต่าง	వివిధ	None
ต่างๆ	వివిధ	None
ถ้อยคำ	పదాలు	None
ถ้วย	కప్	None
ถึงเดือนกรกฎาคม	జూలైకి	Nan
ถึงกระนั้น	అయితే	None
ถวาย	ఆఫర్	Nan
ถมิตรภาพ	స్నేహం	None
ตำบลไพรขลา	ఫ్రే ఖ్లా సబ్ డిస్ట్రిక్ట్	Nan
ถนนสุขุมวิท	సుఖుమ్విట్ రోడ్	Nan
ถนนประชาธิปก	ప్రజాస్వామ్య రహదారి	Nan
ถนนคนเดิน	నడక వీధి	Nan
ถนน	త్రోవ	Nan
ต้นสกุล	ప్రజాతి	None
ต้นตอจักรวาลวิทยา	కాస్మోలజీ	Nan
ต้น	ప్రారంభంలో	None
ถนนมิตรภาพ	స్నేహ రహదారి	Nan
ตำบลโพนครก	ఫోన్ నాఖోన్ జిల్లా	Nan
ตำบลเมืองบัว	బువా సబ్ డిస్ట్రిక్ట్	Nan
ตำบลสังขะ	sangkha	Nan
ตั้งอยู่ที่	వద్ద ఉంది	Nan
ตั้งงี่สุ่น	టాంగ్ న్జియన్	Nan
ตัวแปร	వేరియబుల్	Nan
ตัวเลขอย่างเป็นทางการ	అధికారిక సంఖ్యలు	Nan
ตัวอย่างเช่น	ఉదాహరణకి	None
ตัวอย่างภาพยนตร์	సినిమా ట్రైలరు	Nan
ตั้งอยู่เลขที่	వద్ద ఉంది	Nan
ตัวอย่างต้นแบบแรก	మొదటి నమూనా ఉదాహరణ	Nan
ตัวอย่างคำบาลี	పాలి ఉదాహరణ	Nan
ตัวอย่าง	ఉదాహరణ	None
ตัวหาร	భాజకం	Nan
ตัวสะกด	స్పెల్లింగ్	Nan
ตัวลิง	monkey	Nan
ตัวละครจากเรื่อง	కథలోని పాత్రలు	Nan
ตัวอย่างคำประพันธ์	నమూనా పద్యం	Nan
จังหวัดเพชรบุรี	ఫెట్చాబురి ప్రావిన్స్	Nan
ตั๊กแตน	మిడత	Nan
ตาคลี	takhli	Nan
ตำบลระแงง	రహంగ్ జిల్లా	Nan
ตำบลยะวึก	యువక్ జిల్లా	Nan
ตำบลบ้านกง	బాన్ కాంగ్ సబ్ డిస్ట్రిక్ట్	Nan
ตำบลนาดี	నాడి సబ్ డిస్ట్రిక్ట్	Nan
ตำบลนางแล	నంగ్లే సబ్ డిస్ట్రిక్ట్	Nan
ตำบลตาเมียง	టా మ్యుంగ్ జిల్లా	Nan
ตา	కంటి	None
ตำบลกังแอน	గ్యాంగ్ ఆన్ జిల్లా	Nan
ตำนานแฝงคำสอน	పురాణ బోధనలు	Nan
ตำนานวายุสลาตัน	తుఫాను యొక్క పురాణం	Nan
ตาราง	పట్టిక	Nan
ตาระวา	tarawa	Nan
ตามตำราพรหมชาติฉบับหลวง	బ్రహ్మ రాజ పాఠ్య పుస్తకం ప్రకారం	Nan
ตามตัวสวมเครื่องประดับต่าง	అతను వేర్వేరు ఆభరణాలు ధరించాడు	Nan
ตำบลกระเทียม	వెల్లుల్లి ఉపవిభాగం	Nan
ธรรมศักดิ์	thammasak	Nan
จังหวัดเชียงใหม่	చియాంగ్ మాయి ప్రావిన్స్	Nan
จังหวัดเชลลา	shella	Nan
การท่องเที่ยว	పర్యాటక	None
การท่าเรือ	పోర్ట్ అథారిటీ	Nan
การบริการ	సర్వీస్	None
การบริหารการพัฒนา	అభివృద్ధి నిర్వహణ	Nan
การบริหารการศึกษา	విద్యా పరిపాలన	Nan
การบริหารจัดการ	మేనేజ్మెంట్	Nan
การบริหารราชการแผ่นดิน	ప్రభుత్వ పరిపాలన	Nan
การบินไทย	థాయ్ ఎయిర్‌వేస్	Nan
การปกครองท้องถิ่น	స్థానిక ప్రభుత్వము	Nan
การปกครองส่วนท้องถิ่น	స్థానిక ప్రభుత్వము	Nan
การปกครองแบ่งออกเป็น	నియమం విభజించబడింది	Nan
การปฏิรูประบบจัดเก็บภาษีเงินได้	ఆదాయపు పన్ను వసూలు వ్యవస్థ యొక్క సంస్కరణ	Nan
การปฏิรูปศาสนา	రీఫార్మేషన్	Nan
การปฏิวัติฝรั่งเศส	ఫ్రెంచ్ విప్లవం	Nan
การปฏิวัติอุตสาหกรรม	పారిశ్రామిక విప్లవం	Nan
การปฏิสนธิ	ఫలదీకరణం	None
การประมง	ఫిషరీస్	Nan
การสั่นพ้อง	అనువాదము	None
การสังคายนาครั้งที่	ది లాస్ట్ ఆర్డర్	Nan
การศึกษา	చదువు	None
การวิเคราะห์	విశ్లేషణ	None
การวิจัย	రీసెర్చ్	None
การละเล่นพื้นบ้าน	జానపద ఆటలు	Nan
การทำป่าไม้	ఫారెస్ట్రీ	Nan
การลดรูป	deforming	Nan
การรักษาพยาบาล	వైద్య చికిత్స	Nan
การระบาดของไข้หวัดใหญ่สายพันธุ์ใหม่	ఇన్ఫ్లుఎంజా యొక్క కొత్త జాతి	Nan
การยึดครองมะละกาของโปรตุเกสในปี	సంవత్సరంలో మేలకాపై పోర్చుగీస్ ఆక్రమణ	Nan
การพูด	మాట్లాడుతూ	Nan
การพัฒนาประชาธิปไตย	ప్రజాస్వామ్య వికాసం	Nan
การพัฒนา	అభివృద్ధి	None
การร่วมเพศทางทวารหนัก	అనల్ ఫకింగ్	Nan
การสำเร็จความใคร่ด้วยตนเอง	హస్త ప్రయోగం	Nan
การทำงานของ	యొక్క పని	Nan
การตั้งถิ่นฐาน	సెటిల్మెంట్	Nan
กัมพูชาประชาธิปไตย	ప్రజాస్వామ్య కంబోడియా	Nan
กัมพูชาเป็นประเทศที่มีป่าไม้อุดมสมบูรณ์มากที่สุดหากเปรียบเทียบกับประเทศเพื่อนบ้าน	పొరుగు దేశాలతో పోల్చినప్పుడు కంబోడియా అత్యధికంగా అడవులున్న దేశం.	Nan
กัมพูชาเป็นอดีตประเทศอาณานิคมของฝรั่งเศสในภูมิภาคเอเชียตะวันออกเฉียงใต้เพียงแค่ประเทศเดียวเท่านั้นที่มีการปกครองด้วยระบอบราชาธิปไตยภายใต้รัฐธรรมนูญ	ఆగ్నేయాసియాలో రాజ్యాంగం ప్రకారం రాచరికం ఉన్న ఏకైక మాజీ ఫ్రెంచ్ వలస దేశం కంబోడియా.	Nan
กัมพูชาเป็นอาณานิคมของฝรั่งเศสมาตั้งแต่พศ	కంబోడియా అప్పటి నుండి ఫ్రెంచ్ కాలనీ.	Nan
กัวเตมาลา	గ్వాటెమాల	Nan
กานซู	గన్సు	Nan
กานต์	kan	Nan
กานา	ఘనా	Nan
กานามัยซิน	కనామైసిన్	Nan
กาบอง	గేబన్	Nan
กาพย์ฉบัง	పురాణ పద్యం	Nan
กาพย์สุรางคนางค์	కవిత	Nan
กาม	ఉల్లాసమైన	Nan
กาย	శరీర	None
การ	ది	None
การกีฬา	క్రీడలు	None
การขัดเกลาทางสังคม	సోషలైజేషన్	Nan
การตอบรับ	అభిప్రాయం	None
การดำเนินการ	ఒక ఆపరేషన్	Nan
การชัก	నిర్భందించటం	Nan
การจูบ	ఒక ముద్దు	Nan
การจัดให้มี	నియమం	None
การจัดอันดับ	ర్యాంకింగ్	Nan
การต่างประเทศ	విదేశీ వ్యవహారాలు	Nan
การจัดการคุณภาพ	నాణ్యత నిర్వహణ	Nan
การค้า	వాణిజ్యం	None
การค้นพบ	ఆవిష్కరణ	Nan
การคลัง	ఫైనాన్స్	Nan
การคมนาคม	రవాణా	None
การขับไล่	తొలగింపు	Nan
การขับถ่าย	విసర్జన	Nan
การจัดการ	నిర్వహణ	None
กัมพูชา	కంబోడియా	None
การสืบพันธุ์	పునరుత్పత్తి	None
การาจ	గ్యారేజ్	Nan
กุหลาบ	గులాబీ	Nan
กุ้ง	రొయ్యలు	Nan
กุ้งต้ม	ఉడికించిన రొయ్యలు	Nan
กูเกิล	google	Nan
ก็คือ	ఉంది	None
ก็ใช้เป็น	గా వాడతారు	Nan
ก่อตั้ง	స్థాపించబడిన	None
ก่อตั้งโดย	స్థాపించారు	None
ก่อนที่	ముందు	None
ก่อนที่จะตกเป็นของฝรั่งเศสในเวลาต่อมา	తరువాత ఫ్రాన్స్ కావడానికి ముందు	Nan
ก่อนหน้านั้น	అంతకు ముందు	Nan
ก้อย	పింకీ	Nan
ก้าน	కొమ్మ	Nan
ก้านกล้วย	అరటి కొమ్మ	Nan
ก๊าซธรรมชาติ	సహజ వాయువు	Nan
ก๎ล	గిఫ్ట్	Nan
ขขขขขขขขขข	బ బ బ బ బ	Nan
ขบวนการอ๊บอ๊บป่วนโลก	భూమి యొక్క కదలిక	Nan
ขนาดใหญ่	పెద్ద పరిమాణం	Nan
ขนาดหน้าตัก	ల్యాప్ పరిమాణం	Nan
ขนอม	khanom	Nan
ขนสัตว์	ఉన్ని	Nan
ขนมไทย	థాయ్ డెజర్ట్	Nan
กุลละวณิชย์	kulalawanit	Nan
ขนมเปียกปูน	రాంబస్	Nan
ขนมปัง	బ్రెడ్	None
ขนมครก	knmcrk	Nan
ขนมกล้วย	అరటి మిఠాయి	Nan
ขนม	మిఠాయి	None
ขณะที่	అయితే	None
ขณะทรงพระเยาว์	అతను చిన్నతనంలోనే	Nan
ขนมปังขิง	బెల్లము	Nan
การสื่อสาร	కమ్యూనికేషన్	Nan
กุลดิลก	kuldilok	Nan
กีฬาแหลมทอง	లామ్ థాంగ్ స్పోర్ట్	Nan
การุณ	కరుణ్	Nan
การเต้นรำ	నృత్యం	None
การเพิ่มสิทธิประโยชน์แก่นักลงทุนต่างประเทศ	విదేశీ పెట్టుబడిదారులకు అధికారాలను పెంచడం	Nan
การเล่น	ఆడటానికి	Nan
การแข่งขัน	పోటీ	None
การแบ่งพื้นที่	విభజన	None
การใช้คำ	పద వినియోగం	Nan
การไฟฟ้าส่วนภูมิภาค	ప్రావిన్షియల్ ఎలక్ట్రిసిటీ అథారిటీ	Nan
การไหว้	గౌరవం	None
การ์ด	కార్డ్	Nan
กาฬสินธุ์	kalasin	Nan
กาเวน	గవేన్	Nan
กาเหว่าที่บางเพลง	కొన్ని పాటల రావెన్	Nan
กำกับการแสดงโดย	దర్శకత్వం వహించినది	Nan
กำกับโดยอภิชาติพงศ์	అఫిచాట్ పాంగ్ దర్శకత్వం వహించారు	Nan
กำมะถัน	సల్ఫర్	None
กำลังจะปรับเปลี่ยนเป็น	మార్చడానికి వెళుతోంది	Nan
กีฬาทางน้ำ	జల క్రీడలు	Nan
กีฬา	క్రీడ	None
กีฏวิทยา	పురుగులను గూర్చిన శాస్త్రము	Nan
กิ๊ก	కిక్	Nan
กิ้งกือ	బహుపాది	Nan
กิ่งแก้ว	kingkaew	Nan
กุดจับ	అచ్చు	Nan
กิโลไบต์	kb	Nan
กิมป์	gimb	Nan
กิจผลิต	ఉత్పత్తి	None
กำแพงแสน	kamphaengsaen	Nan
กำแพงเมืองจีน	గొప్ప గోడ	Nan
กำแพงเพชร	కంపాంగ్ ఫెట్	Nan
กำหนดตามสภาพภูมิศาสตร์	భౌగోళికంగా నిర్ణయించబడుతుంది	Nan
กิโลกรัม	కిలొగ్రామ్	Nan
ขบวนรถสินค้า	రైలు	Nan
กัมปูเชีย	campucia	Nan
กันเอง	స్నేహపూర్వకంగా	Nan
กระดูกต้นแขน	దండ	None
กระดูกฝ่ามือ	అరచేతులు	Nan
กระดูกสะบัก	స్కపుల	Nan
กระดูกสะบ้า	జారిన	Nan
กระทรวงกลาโหม	రక్షణ మంత్రిత్వ శాఖ	Nan
กระทรวงการคลัง	ఆర్థిక మంత్రిత్వ శాఖ	Nan
กระทรวงการต่างประเทศ	విదేశాంగ మంత్రిత్వ శాఖ	Nan
กระทรวงวัฒนธรรม	సాంస్కృతిక మంత్రిత్వ శాఖ	Nan
กระทรวงศึกษาธิการ	విద్యా మంత్రిత్వ శాఖ	Nan
กระทรวงสาธารณสุข	ప్రజారోగ్య మంత్రిత్వ శాఖ	Nan
กระทรวงอุตสาหกรรม	పరిశ్రమల మంత్రిత్వ శాఖ	Nan
กระทรวงเกษตรและสหกรณ์	వ్యవసాయ మరియు సహకార మంత్రిత్వ శాఖ	Nan
กระทรวงเศรษฐการ	ఆర్థిక వ్యవహారాల మంత్రిత్వ శాఖ	Nan
กระทุ่มแบน	చిన్న బుట్ట	Nan
กระนวน	పిచ్	Nan
กระนั้น	ఏదేమైనా	Nan
กระบวนการสร้าง	భవన ప్రక్రియ	Nan
กรัยวิเชียร	kraiwichian	Nan
กรัม	గ్రామ	None
กรับเสภา	krapao	Nan
กรับพวง	బంచ్ ఎంచుకోండి	Nan
กรับ	తీసుకోవడం	None
กระแต	chipmunk	Nan
กระดูกค้อน	సుత్తి ఎముక	Nan
กระเพาะอาหาร	కడుపు	Nan
กระวนกระวาย	ఆత్రుత	Nan
กระรอก	ఉడుత	Nan
กระบี่กระบอง	కత్తులతో పోటీ	Nan
กระบะทราย	ఇసుక పెట్టె	Nan
กระบอง	బ్లాక్జాక్	Nan
กระบวนการสร้างและสลาย	సృష్టించే మరియు విచ్ఛిన్నమయ్యే ప్రక్రియ	Nan
กระหม่อม	తల	None
กรานาดา	గ్రెనడా	Nan
กรอง	వడపోత	Nan
กรมอุตุนิยมวิทยา	వాతావరణ శాఖ	Nan
=	=	None
 °ซ  °ฟ 	° c ° f.	Nan
 ซม	సెం.మీ.	Nan
 −°ซ  °ฟ	- ° c ° f.	Nan
×	×	None
γ	γ	Nan
π	π	None
กกกก	కిలొగ్రామ్	Nan
กกกข	ఖోర్ ఖోర్	Nan
กขขข	ఎబిసి బి	Nan
กขขขขขขข	అ బ అ బ బ అ	Nan
กฎ	పాలన	None
กฎของโคไซน์	కొసైన్ చట్టం	Nan
กฎแห่งกรรม	కర్మ	None
กติกา	నియమాలు	None
กทม	బ్యాంకాక్	Nan
กนู	నైట్	Nan
กรมหลวงสงขลานครินทร์	క్రోమ్ లుయాంగ్ సాంగ్ఖ్లా నకారిన్	Nan
กรมหลวงนราธิวาสราชนครินทร์	క్రోమ్ లుయాంగ్ నరతివత్రత్నచారిన్	Nan
กรมศิลปากร	ఫైన్ ఆర్ట్స్ విభాగం	Nan
กรมรบพิเศษที่	ప్రత్యేక దళాల విభాగం	Nan
กรมทหารราบที่	పదాతిదళ రెజిమెంట్	Nan
กรมควบคุมโรค	వ్యాధి నియంత్రణ విభాగం	Nan
กรรชัย	kanchai	Nan
กรมข่าวทหารอากาศ	వైమానిక దళం వార్తల విభాగం	Nan
กรมขุนอิศเรศรังสรรค์	క్రోమ్ ఖున్ ఇసెట్ రంగ్సన్	Nan
กรณีที่	కేసు	Nan
กมลรัตน์	kamonrat	Nan
กมล	కలువ	Nan
กบฏทหารนอกราชการ	సైనిక తిరుగుబాటు	Nan
กบ	కప్ప	Nan
กรมขุนเพ็ชรบูรณ์อินทราชัย	kromkhunpetchaboon-indachai	Nan
กับนางสุจาริณี	శ్రీమతి సుచారినీతో	Nan
กริม	గ్రిమ్	Nan
กรุง	రాజధాని	None
กองการบินทหารเรือ	నావల్ ఏవియేషన్ డివిజన్	Nan
กองการศึกษา	విద్య యొక్క విభాగం	Nan
กองการเจ้าหน้าที่	సిబ్బంది విభాగం	Nan
กองกำลังกึ่งทหาร	సెమీ మిలిటరీ ఫోర్సెస్	Nan
กองคลัง	ట్రెజరీ	Nan
กองทัพ	సైన్యం	None
กองทัพบกไทย	థాయ్ ఆర్మీ	Nan
กองทัพภาคที่	ఆర్మీ ఆఫ్ ది రీజియన్	Nan
กองทัพเรือ	నేవీ	None
กองทัพเรือไทย	థాయ్ నేవీ	Nan
กองทัพแห่งความชอบธรรม	ధర్మం యొక్క సైన్యం	Nan
กองทัพไทย	థాయ్ సైన్యం	Nan
กองบิน	వాయు సైన్యము	Nan
กองบินปีกหมุนที่	వింగ్ స్పిన్నింగ్ వింగ్	Nan
กองพลทหารม้าที่	అశ్వికదళ బ్రిగేడ్	Nan
กองพันทหารช่างที่	ఇంజనీర్ బ్రిగేడ్	Nan
กอด	కౌగిలింత	Nan
กันอริ	kanori	Nan
กันฟอร์ม	ఫారం	Nan
กันทรลักษ์	kantharalak	Nan
กันตัง	kantang	Nan
กันดั้ม	గుండం	Nan
กังหันชัยพัฒนา	చైపట్టనా టర్బైన్	Nan
กองกลาง	మిడ్ఫీల్డర్	Nan
กะโหลกศีรษะ	స్కల్	Nan
กะเหรี่ยง	karen	Nan
กอล์ฟไมค์	గోల్ఫ్ మైక్	Nan
กอล์ฟ	గోల్ఫ్	None
กอลมเบต์	goreme	Nan
กอร์ดอน	గోర్డాన్	Nan
กอนซาเลซ	గొంజాలెజ్	Nan
กะโหลก	పుర్రె	Nan
กรี	గ్రే	Nan
กว่า	కంటే	None
กวิน	kawin	Nan
กรุงธนบุรี	థోన్ బురి	Nan
กรุงลอนดอน	లండన్	None
กรุงศรีอยุธยา	ayutthaya	Nan
กรุงเทพ	బ్యాంకాక్	Nan
กรุงเทพเชียงใหม่กรุงเทพ	బ్యాంకాక్, చియాంగ్ మాయి, బ్యాంకాక్	Nan
กรุงเทพโพลล์	బ్యాంకాక్ పోల్	Nan
กรุ๊ป	గ్రూప్	None
กลอง	డ్రమ్	Nan
กลองมโหระทึก	పెద్ద డ్రమ్	Nan
กลองยาว	డ్రం	Nan
กลองสองหน้า	రెండు ముఖాల డ్రమ్	Nan
กลอน	పద్యం	None
กลอบูลิน	నిగనిగలాడే	Nan
กลาง	మధ్య	None
กลิ่น	వాసన	None
กลุ่มดาวกล้องจุลทรรศน์	సూక్ష్మదర్శిని యొక్క నక్షత్రరాశులు	Nan
กลุ่มดาวนกทูแคน	టుకాన్	Nan
กวาง	జింక	None
กวม	గ్వామ్	Nan
กล้ามเนื้อ	కండరాల	Nan
กล้องถ่ายภาพ	కెమెరా	None
กล้วยไม้ดาว	స్టార్ ఆర్చిడ్	Nan
กล่าวคือ	చెప్పటడానికి	Nan
กวี	కవి	None
กลูคากอน	glucon	Nan
กลุ่มที่	గుంపు	None
กลุ่มดาวแมลงวัน	జార్	Nan
กลุ่มดาวแมงป่อง	స్కార్పియన్	Nan
กลุ่มดาวเตาหลอม	బ్లాస్ట్ ఫర్నేస్	Nan
กลุ่มดาวเข็มทิศ	కాన్స్టెలేషన్ దిక్సూచి	Nan
กลุ่มดาวสิ่ว	ఉలి	Nan
กลุ่มแสงอุษา	యుసా లైట్ గ్రూప్	Nan
ขม	చేదు	Nan
ขรรค์ชัย	ఖాన్ చాయ్	Nan
ขลุ่ยหลิบ	ఫ్లూట్	Nan
คิด	అనుకుంటున్నాను	Nan
คินนิคุแมน	kinnikuman	Nan
คิมิฮิโระ	kimihiro	Nan
คิระ	kira	Nan
คิเคียว	kikyo	Nan
คีตกวี	కంపోజర్	Nan
คือประมาณ	గురించి	None
คือเพลง	ఒక పాట	Nan
คุณ	మీరు	None
คุณครูจอมเวท	ది మెజీషియన్ టీచర్	Nan
คุณปลื้ม	ఖున్ ప్లూమ్	Nan
คุณหญิงโม	ఎంప్రెస్ మో	Nan
คุณากร	మీరు	None
คุราปิก้า	kurapika	Nan
คุโรซึจิ	kurotsuji	Nan
คุ้มค่า	మంచి విలువ	Nan
คูกิมิยะ	kukimiya	Nan
งาน	పని	None
งดส่งเข้าประกวด	ప్రవేశం లేదు	Nan
ฆ้องวงใหญ่	బిగ్ గాంగ్	Nan
ฆ้อง	గాంగ్	Nan
ฆ	జువాన్	Nan
ค้างคาว	బ్యాట్	Nan
คิชิเนีย	kishinya	Nan
ค่ำแล้ว	డస్క్	Nan
ค่าจีดีพี	gdp	Nan
ค่าความต้านทานตัวที่	ప్రతిఘటన విలువ	Nan
คู่กรรม	భాగస్వామి	Nan
คูเวต	కువైట్	Nan
คูเรียม	curium	Nan
คูคาคุ	kukaku	Nan
ค่าใช้จ่าย	ధర	None
งานอดิเรก	అభిరుచులు	Nan
คิงไลเนอร์	కింగ్ లైనర్	Nan
คิงส์	కింగ్స్	Nan
คาคาชิ	kakashi	Nan
คางาริ	kagari	Nan
คาซัคสถาน	కజాఖ్స్తాన్	Nan
คาถาอัญเชิญ	మైమరపించే	Nan
คาบ	కాలం	None
คาบัคโรเน่	kabakhroone	Nan
คาบูโตะ	kabuto	Nan
คาปูชิโน่	కాపుచినో	Nan
คามิว	kamui	Nan
คาราคุระ	karakura	Nan
คาร์ล	కార్ల్	None
คาวทอง	fishyong	Nan
คาเมนไรเดอร์	కామెన్ రైడర్	Nan
คาโรลัส	carolas	Nan
คำขวัญวันเด็ก	బాలల దినోత్సవం	Nan
คำถามข้อที่	ప్రశ్న సంఖ్య	Nan
คำนวณ	లెక్కించు	Nan
คิง	కింగ్	None
คำแปล	అనువాదం	None
คำเมือง	నగర పదం	Nan
คำอธิบาย	వివరణ	None
คำสุภาพ	మర్యాదపూర్వక పదం	Nan
คำสุดท้ายของวรรคที่	పేరా యొక్క చివరి పదం	Nan
คิงส์คัพ	కింగ్స్ కప్	Nan
คำสร้อย	పద	None
คำศัพท์	పదజాలం	Nan
คำวิลัยศักดิ์	కమ్విలై సాక్	Nan
คำม่วง	ఖామ్ మువాంగ్	Nan
คำมั่นสัญญา	ప్రామిస్	Nan
คำพ้องรูป	మూలాలు	None
คำนาม	మూలాలు	None
คำสรรพนาม	సర్వనామం	Nan
คั่ว	కాల్చిన	Nan
งานเขียน	రైటింగ్స్	Nan
งานโมเสก	మొజాయిక్	Nan
จักรพันธุ์	chakphan	Nan
จักรวาลวิทยา	కాస్మోలజీ	Nan
จังหวัด	ప్రావిన్స్	None
จังหวัดกระบี่	క్రాబీ ప్రావిన్స్	Nan
จังหวัดกาญจนบุรี	kanchanaburi	Nan
จังหวัดกาฬสินธุ์	kalasin	Nan
จังหวัดขอนแก่น	ఖోన్ కెన్ ప్రావిన్స్	Nan
จังหวัดคยองกี	జియోంగ్గి ప్రావిన్స్	Nan
จังหวัดคยองซาง	జియోంగ్సాంగ్ ప్రావిన్స్	Nan
จังหวัดฉะเชิงเทรา	chachoengsao	Nan
จังหวัดชุมพร	చుంఫొన్	Nan
จังหวัดตราด	ట్రాట్ ప్రావిన్స్	Nan
จังหวัดตาก	తక్ ప్రావిన్స్	Nan
จังหวัดนครปฐม	నాఖోన్ పాథోమ్ ప్రావిన్స్	Nan
จังหวัดนครพนม	నాఖోన్ ఫనోమ్ ప్రావిన్స్	Nan
จังหวัดนครสวรรค์	నాఖోన్ సావన్ ప్రావిన్స్	Nan
จังหวัดน่าน	నాన్ ప్రావిన్స్	Nan
จังหวัดอุดรธานี	ఉడాన్ తని ప్రావిన్స్	Nan
จังหวัดหนองบัวลำภู	నాంగ్ బువా లాంఫు ప్రావిన్స్	Nan
จังหวัดสิงห์บุรี	బురి ప్రావిన్స్ పాడండి	Nan
จังหวัดสมุทรสงคราม	సముత్ సాంగ్ఖ్రామ్ ప్రావిన్స్	Nan
จังหวัดสงขลา	songkhla	Nan
จังหวัดลำพูน	lamphun	Nan
จักรพรรดิไททัส	టైటస్ చక్రవర్తి	Nan
จังหวัดราชบุรี	ratchaburi	Nan
จังหวัดยโสธร	yasothon	Nan
จังหวัดมหาสารคาม	మహా సారాఖం ప్రావిన్స్	Nan
จังหวัดพิษณุโลก	ఫిట్సానులోక్ ప్రావిన్స్	Nan
จังหวัดพังงา	ఫాంగ్ న్గా ప్రావిన్స్	Nan
จังหวัดพระนครศรีอยุธยา	ఫ్రా నాఖోన్ సి ఆయుతయ్య	Nan
จังหวัดปัตตานี	పట్టాని ప్రావిన్స్	Nan
จังหวัดระยอง	rayong	Nan
งานเทางามสัมพันธ์	టావో న్గామ్ సంబంధం	Nan
จักรพรรดิเนอร์วา	మోక్ష చక్రం	Nan
จะได้	పొందుతారు	None
งามวงศ์วาน	ngamwongwan	Nan
งู	పాము	Nan
งูอนาคอนดา	అనకొండ	Nan
จดหมายอากาศ	ఎయిర్ మెయిల్	Nan
จตรัง	ట్రాంగ్	Nan
จตุรงค์	chatuchak	Nan
จนกระทั่ง	వరకు	None
จนกระทั่งปี	సంవత్సరం వరకు	Nan
จนกระทั่งเมื่อปี	గత సంవత్సరం వరకు	Nan
จนครปฐม	నాఖోన్ పాథోమ్	Nan
จนมีคำกล่าวว่า	అని చెప్పేవరకు	Nan
จน่าน	mon	Nan
จบุรีรัมย์	buriram	Nan
จมูก	ముక్కు	None
จระเข้และแอลลิเกเตอร์	మొసలి మరియు ఎలిగేటర్	Nan
จรัญญา	charanya	Nan
จริยธรรม	నీతి	None
จะเข้	జితార్	Nan
จะเขียนว่า	చెబుతుంది	None
จะต้องหาตัวแทนลงจากเวที	వేదిక నుండి బయటపడటానికి ఒక ప్రతినిధిని తప్పక కనుగొనాలి	Nan
จอร์เจีย	జార్జియా	None
จอมเทียน	jomtien	Nan
จอมพลเรือ	షిప్ మార్షల్	Nan
จักจั่น	cicada	Nan
จอมพลสฤษดิ์	ఫీల్డ్ మార్షల్ సరిత్	Nan
จอมบึง	వాపు	None
จสุราษฎร์ธานี	సూరత్ తని	Nan
จสตูล	satun	Nan
จลำพูน	lamphun	Nan
จริยา	లేడీ	Nan
จริยศาสตร์	నీతి	None
จอมพลถนอม	చోమ్ ఫోన్ థానోమ్	Nan
คัมภีร์	గ్రంథాలలో	Nan
คัพ	కప్	None
คันธวงศ์	kanthavong	Nan
ข้อมูลโดย	ద్వారా డేటా	Nan
ข้อวิพากษ์วิจารณ์	విమర్శ	None
ข้ามฉาก	సన్నివేశం అంతటా	Nan
ข้าวสาลี	గోధుమ	None
ข้าวหลาม	ఖావో లామ్	Nan
ข้าวเกรียบปากหม้อ	రైస్ క్రాకర్స్	Nan
ข้าวเจ้า	వరి	None
ข้าวโพด	మొక్కజొన్న	Nan
ข้าหลวงกำกับราชการเมืองขุขันธ์คนที่	గవర్నర్, ఖుఖాన్ నగర గవర్నర్	Nan
ฃ	ฃ	Nan
คงยิ่ง	చాలా మటుకు	Nan
คงเจริญ	బహుశా అభివృద్ధి చెందుతుంది	Nan
คณะครุศาสตร์	ఎడ్యుకేషన్ ఫ్యాకల్టీ	Nan
คณะครุศาสตร์อุตสาหกรรม	పారిశ్రామిక విద్య ఫ్యాకల్టీ	Nan
คณะที่	వద్ద ఫ్యాకల్టీ	Nan
คณะบัญชี	అకౌంటెన్సీ ఫ్యాకల్టీ	Nan
คณะปฏิรูปการปกครองแผ่นดิน	విప్లవ కమిటీ	Nan
คณารศ	కనరా	Nan
คณะแพทยศาสตร์โรงพยาบาลรามาธิบดี	మెడిసిన్ ఫ్యాకల్టీ, రామతిబోడి హాస్పిటల్	Nan
คณะแพทยศาสตร์ศิริราชพยาบาล	మెడిసిన్ ఫ్యాకల్టీ సిరిరాజ్ హాస్పిటల్	Nan
คณะเกษตร	వ్యవసాయ అధ్యాపకులు	Nan
คณะสาธารณสุขศาสตร์	ప్రజారోగ్య ఫ్యాకల్టీ	Nan
คณะสหเวชศาสตร์	అలైడ్ హెల్త్ సైన్సెస్ ఫ్యాకల్టీ	Nan
ข้อมูลอื่นๆ	ఇతర సమాచారం	Nan
คณะสถาปัตยกรรมศาสตร์	ఆర్కిటెక్చర్ ఫ్యాకల్టీ	Nan
คณะวิศวกรรมศาสตร์	ఇంజనీరింగ్ ఫ్యాకల్టీ	Nan
คณะวิทยาการจัดการ	మేనేజ్మెంట్ సైన్స్ ఫ్యాకల్టీ	Nan
คณะรัฐมนตรีคณะที่	కేబినెట్	Nan
คณะมนุษย์ศาสตร์และสังคมศาสตร์	హ్యుమానిటీస్ అండ్ సోషల్ సైన్సెస్ ఫ్యాకల్టీ	Nan
คณะพยาบาลศาสตร์	నర్సింగ్ ఫ్యాకల్టీ	Nan
คณะประมง	ఫిషరీస్ ఫ్యాకల్టీ	Nan
คณะศิลปกรรมศาสตร์	ఫైన్ ఆర్ట్స్ ఫ్యాకల్టీ	Nan
คนที่	వ్యక్తి	None
ข้อมูลปี	సంవత్సరం డేటా	Nan
ข้อมูลประเทศเดนมาร์ก	డెన్మార్క్ సమాచారం	Nan
ขวด	సీసా	Nan
ขวัญ	ధైర్యాన్ని	Nan
ขวัญใจช่างภาพ	ప్రియమైన ఫోటోగ్రాఫర్	Nan
ขสมก	మాస్	None
ของ	ఆఫ్	Nan
ของทุกปี	ప్రతి సంవత్సరం	Nan
ของประเทศจีน	చైనా యొక్క	Nan
ของมหาวิทยาลัย	విశ్వవిద్యాలయం	None
ของมัน	దీని	None
ของร่างกาย	శరీరం యొక్క	Nan
ของสมเด็จฮุน	సోమ్‌దేజ్ హున్	Nan
ของสิ่งมีชีวิต	జీవుల యొక్క	Nan
ของสุนทรภู่	సుంథోర్న్ ఫు	Nan
ของเหลว	ద్రవ	None
ของโลก	ప్రపంచంలోని	None
ขอนแก่น	ఖోన్ కెన్	Nan
ขอบคุณที่รักกัน	నన్ను ప్రేమిస్తున్నందుకు ధన్యవాదములు	Nan
ข้อมูลทั่วไป	సాధారణ సమాచారం	Nan
ขุนหาญ	హన్	Nan
ขุขันธิน	ఖాన్ టిన్	Nan
ขึ้นไป	అప్	Nan
ขึ้นเป็น	వరకు	None
ขี้ผึ้ง	మైనపు	Nan
ข้อมูลปรากฏการณ์โลกร้อน	గ్లోబల్ వార్మింగ్ దృగ్విషయం	Nan
ขีดเส้นใต้	అండర్లైన్	Nan
ขิง	అల్లం	None
ขาย	అమ్మకపు	Nan
ขา	కాలు	None
ขั้นที่	దశ	None
ขอให้เด็กสมัยปฏิวัติของข้าพเจ้า	నా విప్లవాత్మక పిల్లలు	Nan
ขอเช็ดน้ำตา	కన్నీళ్లను తుడిచివేద్దాం	Nan
ขิม	సితార	Nan
คนที่ไปช่วยรุ่นที่	తరానికి సహాయం చేసిన వ్యక్తులు	Nan
คนแคระ	మరగుజ్జు	Nan
คนแรก	మొదటి వ్యక్తి	Nan
ความยาวช่วงคลื่น	తరంగ పొడవు	Nan
ความยาวเพลง	పాట పొడవు	Nan
ความรัก	లవ్	None
ความรู้	జ్ఞానం	None
ความสว่าง	ప్రకాశం	None
ความสัมพันธ์กับประเทศไทย	థాయిలాండ్‌తో సంబంధాలు	Nan
ความสัมพันธ์ระหว่างจีนกับอเมริกา	చైనా మరియు అమెరికా మధ్య సంబంధాలు	Nan
ความสูง	ఎత్తు	None
ความส่องสว่าง	ప్రకాశం	None
ความหนาแน่นของประชากร	జన సాంద్రత	Nan
ความหมาย	అర్ధము	None
ความหมายโดยพยัญชนะ	హల్లు అర్థం	Nan
ความเข้มของการส่องสว่าง	ప్రకాశించే తీవ్రత	Nan
ความเข้าใจ	అవగాహన	None
ความเร่ง	త్వరణం	Nan
ความโกรธ	కోపం	None
ความโน้มถ่วง	గురుత్వాకర్షణ	None
คัทลียา	cattleya	Nan
คัญทัพ	ముఖ్యమైన సైన్యం	Nan
คัชชินสกี	kutchinski	Nan
คัง	కాంగ్	Nan
คอสตาริกา	కోస్టా రికా	Nan
คอลลิงวูด	callingwood	Nan
ความยาวคลื่น	తరంగదైర్ఘ్యం	Nan
คอร์ด	తీగ	Nan
คอนเสิร์ตประสานเสียงสามสถาบัน	మూడు ఇన్స్టిట్యూట్స్ కోయిర్ కచేరీ	Nan
คอนเวนชัน	సమావేశాలు	None
คอนสตรัคชั่น	నిర్మాణం	None
คอ	మెడ	None
ควีนซี่	క్వీన్	Nan
ควินโต	quinto	Nan
คอมพิวเตอร์ยุคที่	కంప్యూటర్ యుగం	Nan
ความยาว	పొడవు	None
ความยากจน	పావర్టీ	Nan
ความพอประมาณ	మోడెస్టీ	Nan
คลอง	కాలువ	None
ครูพิเศษจอมป่วน	ట్రోల్ టీచర్	Nan
ครู	గురువు	None
ครุฑ	గరుడ	None
คริสต์ศาสนา	క్రైస్తవ మతం	Nan
คริสตี	క్రిస్టి	Nan
คลองสาน	ఖ్లాంగ్ శాన్	Nan
คริส	క్రిస్	Nan
คราประยูร	prayun	Nan
ครั้งหนึ่ง	ఒక్కసారి	None
ครอบครัว	కుటుంబం	None
ครอคโคไดล์	మొసలి	Nan
คม	పదునైన	Nan
คปค	ఇయర్	None
คราม	ఇండిగో	Nan
จังหวัดเชียงราย	చియాంగ్ రాయ్	Nan
คลองเตย	ఖ్లాంగ్ తోయి	Nan
คลาวิคอร์ด	క్లాస్	Nan
ความฝันอันสูงสุด	అంతిమ కల	Nan
ความบริสุทธิ์	స్వచ్ఛత	Nan
ความนิยม	ప్రజాదరణ	None
ความถี่	తరచుదనం	Nan
ความต่างศักย์	సంభావ్య వ్యత్యాసం	Nan
ความจำ	జ్ఞాపకశక్తి	Nan
คลับ	క్లబ్	None
ความงาม	అందం	None
ควอร์เตอร์	క్వార్టర్	Nan
ควอน	క్వాన్	Nan
คลื่นสึนามิ	సునామీ	None
คลิป	క్లిప్	Nan
คลินิก	క్లినిక్	Nan
คลิก	క్లిక్	Nan
ความกว้าง	వెడల్పు	None
ลักเซมเบิร์ก	లక్సెంబర్గ్	None
ธรรมศาสตร์	తమ్మసత్ విశ్వవిద్యాలయం	Nan
ธานินทร์	thanin	Nan
มณฑลหูหนาน	హునాన్	Nan
มณีวรรณ	maniwan	Nan
มด	చీమల	Nan
มดลูก	గర్భాశయం	None
มต้น	ప్రారంభం	None
มธ	tu	Nan
มธรรมศาสตร์	తమ్మసత్ విశ్వవిద్యాలయం	Nan
มน	రౌండ్	Nan
มนุษย์	మనిషి	None
มนุษย์กลายพันธุ์	ముటాంట్	Nan
มนเรศวร	naresuan	Nan
มปท	nps	Nan
มม	mm	Nan
มมหิดล	మహీడోల్ విశ్వవిద్యాలయం	Nan
มยุรา	నెమలి	None
มลายู	malay	Nan
มวยปล้ำ	కుస్తీ	Nan
มหาวิทยาลัยปทุมธานี	పాతుం తని విశ్వవిద్యాలయం	Nan
มหาวิทยาลัยบูรพา	బురాఫా విశ్వవిద్యాలయం	Nan
มหาวิทยาลัยนเรศวร	నరేసువాన్ విశ్వవిద్యాలయం	Nan
มหาวิทยาลัยทักษิณ	థాక్సిన్ విశ్వవిద్యాలయం	Nan
มหาวิทยาลัยขอนแก่น	ఖోన్ కెన్ విశ్వవిద్యాలయం	Nan
มหาวิทยาลัย	విశ్వవిద్యాలయ	None
มจก	m	Nan
มหาวรรค	మహా బుద్ధ	Nan
มหาปรมาภรณ์ช้างเผือก	మహా పరమపోర్న్ చాంగ్ ఫ్యూక్	Nan
มหาบัณฑิต	మాస్టర్	None
มหาชัย	mahachai	Nan
มหาชน	ప్రజా	None
มหัพภาค	మొత్తం	None
มสงขลานครินทร์	సాంగ్క్లా యువరాజు	Nan
มหาวชิรมงกุฎ	మహావాజీర కిరీటం	Nan
มหาวิทยาลัยพะเยา	ఫయావో విశ్వవిద్యాలయం	Nan
มกราคม	జనవరి	None
ภู่สว่าง	ఫూ సావాంగ్	Nan
ภาพยนตร์ลามก	దుష్ట చిత్రం	Nan
ภาพรวม	అవలోకనం	Nan
ภายหลัง	తరువాత	None
ภายหลังสงคราม	యుద్ధం తరువాత	Nan
ภายใต้ความช่วยเหลือจากกองทุนการเงินระหว่างประเทศ	అంతర్జాతీయ ద్రవ్య నిధి సహాయంతో	Nan
ภายในวงขอบเหรียญเบื้องบนมีข้อความว่า	నాణెం పైభాగంలో ఒక ప్రకటన ఉంది	Nan
ภารกิจ	మిషన్	None
ภาวะเศรษฐกิจของกัมพูชาหลังจากมีการเปลี่ยนแปลงการปกครองจากระบอบสังคมนิยมเป็นระบอบประชาธิปไตย	ప్రజాస్వామ్య సోషలిజం నుండి ప్రజాస్వామ్యంలోకి మారిన తరువాత కంబోడియా యొక్క ఆర్థిక పరిస్థితులు	Nan
ภาษาญี่ปุ่น	జపనీస్	None
ภาษาบาลี	పాలి	Nan
ภาษาสเปน	స్పానిష్ భాష	Nan
ภาษาอังกฤษ	ఆంగ్ల భాష	Nan
ภาษาอีสาน	ఈశాన్య భాష	Nan
ภาษาเกชัว	quechua	Nan
ภาษาเฉพาะอาชีพ	జార్గన్	Nan
ภาษาเบสิก	ప్రాథమిక	None
ภาษาเยอรมัน	జర్మన్	None
ภูเขาน้ำแข็ง	మంచుకొండ	Nan
ภูเขา	పర్వత	None
ภูหลวง	ఫు లుయాంగ్	Nan
ภูมิรัตน์	bhumirat	Nan
ภูมิภาค	ప్రాంతం	None
ภูมิประเทศและภูมิอากาศ	స్థలాకృతి మరియు వాతావరణం	Nan
ม	m	Nan
ภูพาน	ఫు ఫాన్	Nan
ภูกามยาว	ఫు కామ్ యావో	Nan
ภูกระดึง	phukradueng	Nan
ภิรมย์ภักดี	ఫిరోమ్ ఫక్ది	Nan
ภิรมย์	ఆనందము	Nan
ภิญโญ	ఎక్కువగా	Nan
ภาษาโคบอล	కోబాల్	None
ภูธเนศ	bhutanet	Nan
ภาพยนตร์ตอน	ఎపిసోడ్	Nan
มหาวิทยาลัยภูมินทร์พนมเปญ	ఫ్యూమిన్ విశ్వవిద్యాలయం, నమ్ పెన్	Nan
มหาวิทยาลัยมหาสารคาม	మహా సారాఖం విశ్వవిద్యాలయం	Nan
มังกี้	monkey	Nan
มังคุด	mangosteen	Nan
มัจฉานุ	ఈ dōmatcha	Nan
มัชฌิมาปฏิปทา	మధ్య మార్గం	Nan
มัทนะพาธา	ముతనా ఫతా	Nan
มัธยฐาน	సగటు	None
มัธยมศึกษา	మాధ్యమిక విద్య	Nan
มัธยมศึกษาปีที่	గ్రేడ్ 9	Nan
มันติคอร์	manticore	Nan
มัลเจร่า	malera	Nan
มากกว่า	పైగా	Nan
มากที่สุด	అత్యంత	None
มากิ	మాకి	Nan
มาครอส	మక్రోస్స్	Nan
มาจยาร์	mayar	Nan
มาจากภาษาละติน	లాటిన్ నుండి	Nan
มาซากิ	మసకి	Nan
มาลี	మాలి	Nan
มาลากุล	malakul	Nan
มาลัยพร	మలై పోర్న్	Nan
มาร์แชล	మార్షల్	None
มาร์ตินีก	మార్టినిక్	Nan
มาร์ติน	మార్టిన్	None
มะเร็ง	కాన్సర్	None
มาร์ช	మార్ష్	Nan
มาริสา	marisa	Nan
มายน์ส	మైన్స్	Nan
มานี	మణి	None
มาตรา	విభాగం	None
มาตรฐาน	ప్రామాణిక	None
มาดริด	మాడ్రిడ్	Nan
มาริเบล	maribel	Nan
มหาวิทยาลัยมหาจุฬาลงกรณราชวิทยาลัย	మహాచులలోంగ్కోర్న్రాజావిద్యాలయ విశ్వవిద్యాలయం	Nan
มะริด	myeik	Nan
มะขาม	చింతపండు	Nan
มหาวิทยาลัยมหิดล	మహీడోల్ విశ్వవిద్యాలయం	Nan
มหาวิทยาลัยรังสิต	రంగ్సిత్ విశ్వవిద్యాలయం	Nan
มหาวิทยาลัยราชภัฏบ้านสมเด็จเจ้าพระยา	బన్సోమ్‌దేజ్‌చోప్రయ రాజభట్ విశ్వవిద్యాలయం	Nan
มหาวิทยาลัยราชภัฏสงขลา	సాంగ్ఖ్లా రాజభట్ విశ్వవిద్యాలయం	Nan
มหาวิทยาลัยราชภัฏสวนสุนันทา	సువాన్ సునంధ రాజాభట్ విశ్వవిద్యాలయం	Nan
มหาวิทยาลัยราชภัฏอุตรดิตถ์	ఉత్తరాదిత్ రాజాభట్ విశ్వవిద్యాలయం	Nan
มหาวิทยาลัยราชภัฏเทพสตรี	తెప్సత్రి రాజాభట్ విశ్వవిద్యాలయం	Nan
มหาวิทยาลัยราชภัฏเลย	లోయి రాజాభట్ విశ్వవిద్యాలయం	Nan
มหาวิทยาลัยวงษ์ชวลิตกุล	వోంగ్చవాలిట్కున్ విశ్వవిద్యాలయం	Nan
มหาวิทยาลัยศรีนครินทรวิโรฒ	శ్రీనాఖరిన్విరోట్ విశ్వవిద్యాలయం	Nan
มหาวิทยาลัยศรีปทุม	శ్రీపాటం విశ్వవిద్యాలయం	Nan
มหาวิทยาลัยศิลปากร	సిల్పాకార్న్ విశ్వవిద్యాలయం	Nan
มหาวิทยาลัยสุโขทัยธรรมาธิราช	సుఖోతై తమ్మతిరత్ ఓపెన్ విశ్వవిద్యాలయం	Nan
มหาวิทยาลัยอีสาน	ఈశాన్య విశ్వవిద్యాలయం	Nan
มหาวิทยาลัยอุบลราชธานี	ఉబన్ రాట్చానీ విశ్వవిద్యాలయం	Nan
มหาวิทยาลัยอ๊อกซฟอร์ด	ఆక్స్ఫర్డ్ విశ్వవిద్యాలయం	Nan
มหาวิทยาลัยเกษตรศาสตร์	కాసెట్‌సార్ట్ విశ్వవిద్యాలయం	Nan
มอหาดใหญ่	మోర్ హాట్ యాయ్	Nan
มอสส์	మాస్	None
มอส	మాస్	None
มอร์ริส	మోరిస్	Nan
มองโกเลียใน	ఇన్నర్ మంగోలియా	Nan
มหาวิทยาลัยแห่งแรกของประเทศไทย	థాయిలాండ్‌లోని మొదటి విశ్వవిద్యాలయం	Nan
มะม่วงหิมพานต์	జీడి పప్పు	Nan
มหาวิทยาลัยแม่โจ้	మేజో విశ్వవిద్యాలయం	Nan
มหาวิทยาลัยเทคโนโลยีราชมงคลอีสาน	రాజమంగళ టెక్నాలజీ విశ్వవిద్యాలయం ఇసాన్	Nan
มหาวิทยาลัยเทคโนโลยีราชมงคลสุวรรณภูมิ	రాజమంగళ టెక్నాలజీ విశ్వవిద్యాలయం సువర్ణభూమి	Nan
มหาวิทยาลัยเทคโนโลยีราชมงคลธัญบุรี	రాజమంగల టెక్నాలజీ విశ్వవిద్యాలయం తన్యబూరి	Nan
มหาวิทยาลัยเทคโนโลยีราชมงคลตะวันออก	రాజమంగళ టెక్నాలజీ విశ్వవిద్యాలయం తవన్-ఓకె	Nan
มหาวิทยาลัยเทคโนโลยีราชมงคลกรุงเทพ	రాజమంగళ టెక్నాలజీ విశ్వవిద్యాలయం క్రుంగ్తేప్	Nan
มหาวิทยาลัยเทคโนโลยีพระจอมเกล้าพระนครเหนือ	కింగ్ మోంగ్కుట్ యొక్క యూనివర్శిటీ ఆఫ్ టెక్నాలజీ నార్త్ బ్యాంకాక్	Nan
มหาวิทยาลัยเปิด	ఓపెన్ విశ్వవిద్యాలయం	Nan
มาสคาร่า	mascara	Nan
ภาพยนตร์ชุดนี้	ఈ సినిమా సెట్	Nan
ภาพยนตร์	సినిమాలు	None
พาร์ค	పార్క్	None
พาวเวอร์บาย	పవర్ బై	Nan
พาเมล่า	పమేలా	Nan
พิชัย	phichai	Nan
พิชิต	జయించటానికి	Nan
พิณ	మాండొలిన్	Nan
พิธีกรรายการ	హోస్ట్	Nan
พิบูลมังสาหาร	ఫిబున్ మంగ్సాహాన్	Nan
พิพิธภัณฑสถานแห่งชาติ	నేషనల్ మ్యూజియం	Nan
พิพิธภัณฑ์	మ్యూజియం	None
พิม	పిం	Nan
พิมประภา	phimprapa	Nan
พิมพ์เล็ก	చిన్న ముద్రణ	Nan
พิมลวรรณ	phimonwan	Nan
พิรุณ	వర్షం	None
พิสุทธิ์	తెలివైన	Nan
พิออจชา	phioncha	Nan
พุฒตาล	putthan	Nan
พื้นที่มหาวิทยาลัย	విశ్వవిద్యాలయ ప్రాంతం	Nan
พื้นฐานทางเศรษฐกิจ	ఆర్థిక ఆధారం	Nan
พืชไม่มีท่อลำเลียง	పైపులైన్లు లేని మొక్కలు	Nan
พืชที่สำคัญคือ	ముఖ్యమైన మొక్కలు	Nan
พืช	మొక్క	None
พารามีเซียม	పారా	Nan
พึ่งสุนทร	సన్‌థార్న్‌పై ఆధారపడండి	Nan
พี่น้อง	బ్రెథ్రెన్	Nan
พีอีเอ	pia	Nan
พีระศรี	phirasri	Nan
พีระมิด	పిరమిడ్	None
พีท	పీట్	Nan
พิเศษนครกิจ	నాకార్న్‌కిట్ స్పెషల్	Nan
พี่สาวของ	సోదరి	None
พุทธคยา	బోధ గయ	Nan
พารา	పారా	Nan
พากย์เป็น	గా డబ్బింగ్	Nan
พลอากาศเอกหญิง	ఆడ acm	Nan
พลฯ	జనరల్	None
พลังงานคลื่น	తరంగ శక్తి	Nan
พลังงานนิวเคลียร์	అణు విద్యుత్	Nan
พลังงานลม	పవన శక్తి	Nan
พลังงานไฟฟ้า	విద్యుత్ శక్తి	Nan
พลัส	ప్లస్	None
พลาซา	ప్లాజా	Nan
พลาสติก	ప్లాస్టిక్	Nan
พลาสมา	ప్లాస్మా	Nan
พลเรือเอก	అడ్మిరల్	Nan
พลเอกสนธิ	జనరల్ సోంతి	Nan
พวกสัตว์ลำตัวกลม	రౌండ్ శరీర జంతువులు	Nan
พศ	fri	Nan
พอ	చాలు	None
พอตเตอร์	పోటర్	Nan
พอตเตอร์กับเจ้าชายเลือดผสม	పాటర్ అండ్ ది హాఫ్-బ్లడ్ ప్రిన్స్	Nan
พัลซาร์	పల్సర్	Nan
พับลิชชิ่ง	ప్రచురణ	None
พันธเสน	బాండ్	Nan
พันธุ์สุนัข	కుక్కల జాతి	Nan
พันธุ์พืช	మొక్కల జాతులు	Nan
พันธุศาสตร์	జెనెటిక్స్	Nan
พายุ	తుఫాను	None
พันธมิตร	కూటమి	None
พัทยาใต้	దక్షిణ పట్టాయా	Nan
พัทยาเหนือ	ఉత్తర పట్టాయా	Nan
พัฒน์ชัย	phatchai	Nan
พัชรี	phachari	Nan
พอล	పాల్	None
พอยท์	పాయింట్	Nan
พัน	వెయ్యి	None
ภาพยนตร์การ์ตูนไทย	థాయ్ కార్టూన్ చిత్రం	Nan
พุทธนิกายเถรวาท	థెరావాడ బౌద్ధమతం	Nan
พุทธศักราช	బౌద్ధ యుగం	Nan
ฟุตบอล	ఫుట్బాల్	Nan
ฟุตบอลอาเซียนเยาวชน	ఆసియాన్ యూత్ ఫుట్‌బాల్	Nan
ฟุตบอลเอเชียเยาวชน	ఆసియా యూత్ ఫుట్‌బాల్	Nan
ฟู	పూర్తి	Nan
ฟูจิ	ఫుజి	Nan
ฟูลส์	పూర్తి	Nan
ฟ้อน	నృత్యం	None
ฟ้า	బ్లూ	Nan
ฟ้าร้อง	ఉరుములు	Nan
ฟ้าหลัว	సూర్యోదయం	Nan
ภมรมนตรี	బామమోన్ మాంట్రి	Nan
ภักดี	నమ్మకమైన	Nan
ภัณฑิลา	panthila	Nan
ภาคกลาง	మధ్య ప్రాంతం	Nan
ภาคคนแสดง	షో	None
ภาคตะวันตก	పశ్చిమ ప్రాంతం	Nan
ภาคตะวันออกเฉียงเหนือ	ఈశాన్య ప్రాంతం	Nan
ภาพพิมพ์	చిత్రాన్ని ముద్రించండి	Nan
ภาพพาโนรามา	పనోరమా	Nan
ภาพถ่าย	ఫోటో	None
ภาพตรา	ముద్ర చిత్రం	Nan
ภาคใต้ตอนล่าง	దిగువ దక్షిణ ప్రాంతం	Nan
ภาคเหนือ	ఉత్తర	None
ฟุตซอล	ఫుట్సల్	Nan
ภาควิชาเทคโนโลยีอาหาร	ఫుడ్ టెక్నాలజీ విభాగం	Nan
ภาควิชาวิศวกรรมไฟฟ้า	ఎలక్ట్రికల్ ఇంజనీరింగ్ విభాగం	Nan
ภาควิชาวิศวกรรมเครื่องกล	మెకానికల్ ఇంజనీరింగ్ విభాగం	Nan
ภาควิชาฟิสิกส์	భౌతిక శాస్త్ర విభాగం	Nan
ภาควิชาพยาธิวิทยา	పాథాలజీ విభాగం	Nan
ภาควิชาคณิตศาสตร์	గణిత విభాగం	Nan
ภาคพิเศษ	ప్రత్యేక	None
ภาควิชาสูติศาสตร์และนรีเวชวิทยา	ప్రసూతి మరియు గైనకాలజీ విభాగం	Nan
พุทธศตวรรษที่	సెంచరీ బౌద్ధ	Nan
ฟีฟ่าคลับเวิลด์คัพ	ఫిఫా క్లబ్ ప్రపంచ కప్	Nan
ฟิสิกส์อนุภาค	కణ భౌతిక శాస్త్రం	Nan
พุ่มพวง	మహిళ	Nan
พู่กัน	paintbrush	Nan
พ่อขุนรามคำแหง	రామ్ రామ్‌ఖమ్‌హాంగ్	Nan
พ่อขุนศรีอินทราทิตย์	రాజు ఇంటరతిత్	Nan
พ่อมด	విజార్డ్	Nan
พ่ายแพ้ให้กับ	కోల్పోయింది	Nan
พ๎ร	స్వాగతం	None
ฟง	ఫాంగ్	Nan
ฟรานซ์	ఫ్రాంజ్	Nan
ฟรีดริช	ఫ్రెడరిక్	None
ฟรีด้อม	ఉచిత స్నీకింగ్	Nan
ฟรีแวร์	ఫ్రీవేర్	Nan
ฟลายเวท	ఫ్లై వెయిట్ విభాగంలో	Nan
ฟลูวาสแตติน	fluvastin	Nan
ฟอน	వాన్	None
ฟอร์ด	ఫోర్డ్	Nan
ฟอสฟอรัส	భాస్వరం	Nan
ฟิสิกส์ดาราศาสตร์	ఆస్ట్రోఫిజిక్స్	Nan
ฟิวชัน	fusion	Nan
ฟิลิปีโน	పర్షియన్లు	Nan
ฟิลิปปินส์	ఫిలిప్పీన్స్	None
ฟิลิป	ఫిలిప్	None
ฟินแลนด์	ఫిన్లాండ్	Nan
ฟีนิลคีโตนูเรีย	phenylketonuria	Nan
ฟิชเชอร์	ఫిషర్	Nan
ฟาง	ఎండుగడ్డి	Nan
ฟัน	పళ్ళు	None
ฟังไจ	జైమ్ వినండి	Nan
ฟังเพลง	సంగీతం వినండి	Nan
ฟังพระธรรมเทศนา	ఉపన్యాసాలు వినండి	Nan
ฟอสเฟต	ఫాస్ఫేట్	Nan
ฟาน	వాన్	None
มาเก๊า	మాకా	Nan
มาเฟีย	మాఫియా	Nan
มาเรีย	మరియా	Nan
รัฐธรรมนูญแห่งราชอาณาจักรไทย	థాయిలాండ్ రాజ్యం యొక్క రాజ్యాంగం	Nan
รัฐบาลไทย	థాయ్ ప్రభుత్వం	Nan
รัฐบุรุษ	రాజనీతి	None
รัฐประหาร	తిరుగుబాటు	None
รัฐประหารในประเทศไทย	థాయ్‌లాండ్‌లో తిరుగుబాటు	Nan
รัฐมนตรีว่าการกระทรวงคมนาคม	రవాణా మంత్రి	Nan
รัฐวิสาหกิจ	రాష్ట్ర సంస్థ	Nan
รัฐวิสาหกิจไทย	థాయ్ రాష్ట్ర సంస్థలు	Nan
รัฐสภา	పార్లమెంట్	None
รัฐสีมาคุณากรปิยชาติ	రత్తాసిమ కునకోర్న్పియాచాట్	Nan
รัฐอิลลินอยส์	ఇల్లినాయిస్	Nan
รัฐเทกซัส	టెక్సాస్	Nan
รัตนบุรี	rattanaburi	Nan
รัตนาธิเบศร์	rattanathibet	Nan
รับบทโดย	ఆడారు	Nan
รับพระราชทาน	అంగీకరించు	Nan
รัศมี	వ్యాసార్థం	Nan
ราชวงศ์ทิพย์จักราธิวงศ์	రాజ కుటుంబం, చక్రతివాంగ్	Nan
ราชวงศ์ถัง	టాంగ్ రాజవంశం	Nan
ราชวงศ์ชิง	క్వింగ్ రాజవంశం	Nan
ราชวงศ์จิ้นตะวันออก	తూర్పు జిన్ రాజవంశం	Nan
ราชมังคลากีฬาสถาน	రాజమంగళ స్టేడియం	Nan
ราชนาวี	నేవీ	None
รัชดาภิเษก	ratchadaphisek	Nan
ราชตระกูล	రాజ కుటుంబం	Nan
รางวัลโนเบล	నోబెల్ బహుమతి	Nan
รางวัลนาฏราช	రాయల్ డాన్సర్ అవార్డులు	Nan
รางวัลนักร้องไทยสากลชายยอดนิยม	పాపులర్ మేల్ థాయ్ ఇంటర్నేషనల్ సింగర్ అవార్డు	Nan
รางวัลนักร้องยอดเยี่ยม	ఉత్తమ గాయకుడు అవార్డు	Nan
รากแก่น	కోర్ రూట్	Nan
รัสเซล	రస్సెల్	Nan
รางวัลไนน์เอ็นเตอร์เทน	తొమ్మిది వినోద పురస్కారం	Nan
ราชวงศ์บ้านพลูหลวง	రాయల్ హౌస్ ఆఫ్ ప్లు లువాంగ్	Nan
รัชกาลสมเด็จพระจุลจอมเกล้าเจ้าอยู่หัว	రాజు చులాలాంగ్ కార్న్ పాలన	Nan
รังสีแกมมา	గామా కిరణం	Nan
ระดับการกระโดดสูง	అధిక ఎత్తు గెంతడం	Nan
ระดับปริญญาเอก	పీహెచ్‌డీ స్థాయి	Nan
ระดับปริญญาโท	మాస్టర్ డిగ్రీ	Nan
ระดับมัธยมศึกษา	ద్వితీయ స్థాయి	Nan
ระดับอาชีวศึกษา	వృత్తి స్థాయి	Nan
ระนอง	ranong	Nan
ระนาด	జైలోఫోన్	Nan
ระนาดทุ้ม	ఆల్టో జిలోఫోన్	Nan
ระนาดเอก	ఆల్టో	Nan
ระบบ	వ్యవస్థ	None
ระบบกษัตริย์ของกัมพูชา	కంబోడియాన్ రాచరికం	Nan
ระบบรัฐสภา	పార్లమెంటరీ వ్యవస్థ	Nan
ระบบสืบพันธุ์	పునరుత్పత్తి వ్యవస్థ	Nan
ระบบสุริยะ	సౌర వ్యవస్థ	Nan
ระบบโครงกระดูก	అస్థిపంజరం వ్యవస్థ	Nan
ระบบใช้อำนาจเด็ดขาด	సంపూర్ణ శక్తి వ్యవస్థ	Nan
ระยะ	దశ	None
รังสีเอกซ์	ఎక్స్రే	Nan
รังสี	రే	None
รังสิตคลอง	రంగ్సిత్ ఖ్లాంగ్	Nan
รักแห่งสยาม	సియామ్ ప్రేమ	Nan
รักษาสิ่งแวดล้อม	పర్యావరణాన్ని రక్షించండి	Nan
รักษาศีล	సూత్రాలను గమనించండి	Nan
รัชกาลที่	రీన్	Nan
ระโนด	డెడ్	Nan
ระเบียง	బాల్కనీ	Nan
ระหว่างสงครามโลกครั้งที่	ప్రపంచ యుద్ధ సమయంలో	Nan
ระหว่างปี	సంవత్సరంలో	None
ระวิ	మధ్య	None
ระยะเวลาการดำรงตำแหน่ง	సేవా కాలం	Nan
ระยะเวลา	వ్యవధి	Nan
ระเบียบ	ఆర్డర్	Nan
ระดับกระโดดสูง	అధిక ఎత్తు గెంతడం	Nan
ราชวงศ์พระร่วง	ఫ్రా రువాంగ్ రాజవంశం	Nan
ราชวงศ์อู่ทอง	యు-థాంగ్ రాజవంశం	Nan
รูปวรรณยุกต์	టోనల్ రూపం	Nan
รูปสามเหลี่ยมมุมป้าน	త్రిభుజం	None
รูปสี่เหลี่ยมด้านขนาน	సమాంతర చతుర్భుజ	Nan
รูสเวลต์	రూజ్వెల్ట్	Nan
ร็อดฟอร์ม	రాడ్ ఫారం	Nan
ร่วมแสดงกับ	తో ప్రదర్శించండి	Nan
ร้องคู่กับ	పాటు పాడండి	Nan
ร้องร่วมกับ	తో పాడండి	Nan
ร้องโดย	పాడినది	Nan
ร้อยตรี	రెండవ లెఫ్టినెంట్	Nan
ร้านอาหาร	ఒక రెస్టారెంట్	Nan
ฤดูกาล	సీజన్	Nan
ฤดูฝน	వర్షాకాలం	Nan
ฤดูร้อน	వేడి సీజన్	Nan
ล	ది	None
ลงวันที่	నాటి	None
ลพบุรี	లాప్ బురి	Nan
ลักษณะภูมิอากาศ	వాతావరణ	None
ลักษณะทางกายภาพ	భౌతిక లక్షణాలు	Nan
ลักษณะทั่วไป	సాధారణ లక్షణాలు	Nan
ลักษณะ	లుక్	Nan
ละติจูด	అక్షాంశం	Nan
ละครโทรทัศน์	ధారావాహిక కార్యక్రమం	Nan
รูปร่าง	ఆకారం	None
ละครเพลง	సంగీత	None
ละครวิทยุ	రేడియో నాటకం	Nan
ละครชาตรี	ఛత్రి నాటకం	Nan
ละคร	డ్రామా	Nan
ลอร์ด	ప్రభువు	None
ลอยกระทง	లాయ్ క్రాటోంగ్ ఫెస్టివల్	Nan
ลอนดอน	లండన్	None
ละครสั้น	చిన్న నాటకం	Nan
ราชวงศ์หยวน	యువాన్ రాజవంశం	Nan
รูปภาพ	చిత్రం	None
รูดอล์ฟ	రుడోల్ఫ్	Nan
ราชสกุล	టోకెన్లు	Nan
ราชสีมา	ratchasima	Nan
ราชินิกุล	రాణి బంధువులు	Nan
ราบเป็นหน้ากลอง	సాదాసీదాగా ఉండండి	Nan
รามอินทรา	ramintra	Nan
รายการ	జాబితా	None
รายการวันสำคัญทางพุทธศาสนา	ముఖ్యమైన బౌద్ధ తేదీల జాబితా	Nan
รายชื่อ	జాబితా	None
รายชื่อคำในภาษาไทยที่มักเขียนผิด	తరచుగా తప్పుగా వ్రాయబడిన థాయ్ పదాల జాబితా	Nan
รายชื่อภาพยนตร์ไทย	థాయ్ సినిమాల జాబితా	Nan
รายชื่อหุ่นยนต์ใน	లో రోబోట్ల జాబితా	Nan
รายชื่ออธิการบดี	ఛాన్సలర్ల జాబితా	Nan
รายชื่อเพลง	పాటల జాబితా	Nan
รายนามรองอธิการประจำวิทยาเขต	క్యాంపస్‌లో వైస్-ఛాన్సలర్ల పేరు జాబితా	Nan
รายนามอธิการบดี	అధ్యక్షుడి జాబితా	Nan
รายพระนามพระมหากษัตริย์ไทย	థాయ్ రాజుల జాబితా	Nan
รายะนาค	రాయ నాక్	Nan
รุ่งเพชร	రంగ్ పెట్చ్	Nan
รุ่งสว่าง	డాన్	None
รุ่ง	డాన్	None
รุจิพรรณ	rujipan	Nan
รีเนียม	రెనీయమ్	Nan
รีสอร์ท	ఒక రిసార్ట్	Nan
รูทีเนียม	రుథెనీయమ్	Nan
ริเอะ	rie	Nan
ริมแม่น้ำเจ้าพระยา	రివర్సైడ్ చావో ఫ్రేయా నది	Nan
ริน	పోయాలి	Nan
รำพันพิลาป	స్క్రీమ్	Nan
ราศีธนู	ధనుస్సు	Nan
ราวพุทธศตวรรษที่	శతాబ్దం చుట్టూ	Nan
รายได้อื่น	ఇతర ఆదాయం	Nan
ริวซากิ	ryuzaki	Nan
รอบเมือง	పట్టణం చుట్టూ	Nan
รอบที่	రౌండ్	Nan
รอบชิงชนะเลิศระดับประเทศ	జాతీయ ఫైనల్స్	Nan
มีน	min	Nan
มีนบุรี	మిన్ బురి	Nan
มีนวิทยา	minology	Nan
มีนายกรัฐมนตรี	ప్రధానమంత్రి	None
มีประวัติศาสตร์ยาวนาน	సుదీర్ఘ చరిత్ర ఉంది	Nan
มีพรมแดนทางทิศใต้จรดกับอ่าวไทย	దక్షిణాన గల్ఫ్ ఆఫ్ థాయిలాండ్ సరిహద్దులో ఉంది	Nan
มีภูเขาล้อมรอบอยู่	చుట్టూ పర్వతాలు	Nan
มีลักษณะดังนี้	కింది లక్షణాలను కలిగి ఉంది	Nan
มีลักษณะภูมิประเทศคล้ายชามหรืออ่าง	గిన్నె లేదా బేసిన్ వంటి లక్షణాలను కలిగి ఉంది	Nan
มีลาภ	అదృష్టం కలిగి ఉండండి	Nan
มีล่า	వేటాడండి	Nan
มีสูตรการคำนวณหาจำนวนฟัน	దంతాల సంఖ్యను లెక్కించడానికి ఒక సూత్రం ఉంది.	Nan
มีอยู่	ఉనికిలో	None
มีอุณหภูมิเฉลี่ย	సగటు ఉష్ణోగ్రత	Nan
มีอุทยานแห่งชาติสำคัญหลายแห่ง	చాలా ముఖ్యమైన జాతీయ ఉద్యానవనాలు ఉన్నాయి.	Nan
มีเดีย	మీడియా	None
มีโคลซีน	కోల్ దృశ్యంతో	Nan
ยอดนักสืบจิ๋วโคนัน	డిటెక్టివ్ కోనన్	Nan
ยอด	ఉన్నత	Nan
ยศ	ర్యాంక్	Nan
ยกเว้น	తప్ప	None
ย	ది	None
ม้าม	ప్లీహము	None
มีทิวเขาล้อมรอบทางเหนือ	ఉత్తరాన పర్వత శ్రేణులతో	Nan
ม้า	గుర్రం	None
มเชียงใหม่	చియాంగ్ మాయి	Nan
มูลสาร	ఫండమెంటల్స్	Nan
มูลนิธิอานันทมหิดล	ఆనందమహిడోల్ ఫౌండేషన్	Nan
มูลนิธิชัยพัฒนา	చైపట్టనా ఫౌండేషన్	Nan
มู	స్మూత్	Nan
มือ	చెయ్యి	Nan
มโนราห์	manohra	Nan
ยอดเขาสูงที่สุดของกัมพูชาคือ	కంబోడియా యొక్క ఎత్తైన శిఖరం	Nan
มีทั้งสิ้น	అన్ని	None
มีด	ఒక కత్తి	Nan
มาเลเซีย	మలేషియాలో	Nan
มาเลเซียตะวันตก	పశ్చిమ మలేషియా	Nan
มิจิรุ	michiru	Nan
มิตร	ఫ్రెండ్లీ	Nan
มิตรชัย	mitchai	Nan
มิตรเพชรา	ఫ్రెండ్లీ	Nan
มิถุนายน	జూన్	Nan
มินต์	మింట్	Nan
มิลจิ	milji	Nan
มิลตัน	మిల్టన్	Nan
มิลฟีโอเล่	మిల్ఫీ ఓలే	Nan
มิลลิเมตร	mm.	Nan
มิลินทจินดา	milinthinda	Nan
มิล่า	మీలా	Nan
มิว	mew	Nan
มิวฟิลโอเล่	మ్యూల్ ఫిల్ ఓలే	Nan
มิวสิกวีดีโอ	దృశ్య సంగీతం	Nan
มีชื่อเล่นว่า	మారుపేరు	Nan
มีชื่อว่า	అనే	None
มีฉายาว่า	మారుపేరుతో	Nan
มีจำนวน	ఒక సంఖ్య కలిగి	Nan
มีความหมายว่า	అర్థం	None
มีความยาว	పొడవు కలిగి	Nan
มีดาบฟันวิญญาณ	ఆత్మ కత్తితో	Nan
มีข้อความว่า	లేబుల్	Nan
มิโร	మిరో	Nan
มิเตอร์	మీటర్	Nan
มิเชล	మిచెల్	Nan
มิเกล	miguel	Nan
มิฮอว์ค	mihawk	Nan
มิสทีน	mistine	Nan
มีขนาดใหญ่	పెద్ద	None
ยอพระกลิ่น	యోర్ ఫ్రా క్లిన్	Nan
ยัง	కు	None
ยาขับปัสสาวะ	మూత్రవిసర్జన	Nan
ยูโรเพียม	europium	Nan
ยูไนเต็ด	యునైటెడ్	Nan
ย่านตาขาว	యాన్ ఖావో	Nan
รณชัย	ronnachai	Nan
รณภพ	ప్రపంచ	None
รณฤทธิ์	యుద్ధం	None
รถด่วนสายทางช้างเผือก	పాలపుంత ఎక్స్‌ప్రెస్ బస్సు	Nan
รถประจำทางสาย	బస్ లైన్	Nan
รถยนต์อเนกประสงค์	బహుళార్ధసాధక కారు	Nan
รถลาก	రిక్షా	Nan
รถโดยสารประจำทาง	బస్సు	None
รถโดยสารประจำทางสาย	బస్ లైన్	Nan
รถไฟฟ้าชานเมืองสายสีแดงอ่อน	రెడ్ లైట్ శివారు	Nan
รถไฟฟ้ามหานคร	ఎంఆర్టి	Nan
รฟม	r.o.	Nan
รวดเร็ว	ఫాస్ట్	None
รวม	చేర్చడానికి	Nan
รอบคอบ	జాగ్రత్తగా	None
รอบ	చుట్టూ	None
รอญับ	వేచి	Nan
รองเท้า	బూట్లు	Nan
รองประธานสภาคนที่สอง	కౌన్సిల్ రెండవ ఉపాధ్యక్షుడు	Nan
รองประธานรัฐสภาคนที่หนึ่ง	పార్లమెంటు మొదటి ఉపాధ్యక్షుడు	Nan
ยูโด	జూడో	Nan
รอก	రీల్	Nan
รศ	అసోసియేట్	Nan
รวมระยะทางทั้งสิ้น	మొత్తం దూరం	Nan
รวมทั้งสิ้น	సంపూర్ణ మొత్తము	Nan
รวมทั้งประเทศที่ให้ความช่วยเหลืออื่นๆ	ఇతర సహాయం అందించే దేశాలతో సహా	Nan
รวมทั้ง	ఇంక్లూడింగ్	Nan
รวมกับ	కలిపి	None
รหัส	కోడ్	None
ยูริ	యూరి	Nan
ยูฟ่า	uefa	Nan
ยูกิโอ	యుకియో	Nan
ยีน	జన్యు	None
ยิ้มสู้	స్మైల్	Nan
ยิ่งลักษณ์	yingluck	Nan
ยิ่งยง	yingyong	Nan
ยามเย็น	సాయంత్రం	None
ยามาโมโตะ	యమమోటో	Nan
ยืนยง	భరిస్తున్నారు	Nan
ยามาโตะ	యమాటో	Nan
ยาบ้า	యాంఫెటమీన్	Nan
ยานอวกาศ	అంతరిక్ష నౌక	Nan
ยานอนหลับ	నిద్ర మాత్రలు	Nan
ยางามิ	yagami	Nan
ยางธรรมชาติ	సహజ రబ్బరు	Nan
ยาง	రబ్బరు	Nan
ยาปฏิชีวนะ	యాంటిబయాటిక్స్	Nan
พลอสนธิ	పోల్సన్ జంక్షన్	Nan
ยุคกลาง	మధ్య వయస్కులు	Nan
ยุคที่	ఎరా	Nan
ยู	u	Nan
ยุ้ย	అతిశయోక్తి	None
ยุวธิดา	చిన్న కుమార్తె	Nan
ยุทธนาวี	నావికాదళ యుద్ధం	Nan
ยุคใหม่	కొత్త యుగం	Nan
ยุคโลหะ	లోహ యుగం	Nan
ยุคก่อนประวัติศาสตร์	చరిత్రపూర్వ యుగం	Nan
ยุคโบราณ	పురాతన కాలాలు	Nan
ยุคเรเนสซองส์	పునరుజ్జీవన యుగం	Nan
ยุคอาณาจักรเหนือใต้	ఉత్తర మరియు దక్షిణ రాజ్య యుగం	Nan
ยุคอะซึกะ	అసుకా శకం	Nan
ยุคสามก๊ก	మూడు రాజ్యాల యుగం	Nan
ยุคศตวรรษที่	శతాబ్దపు యుగం	Nan
ยุคปัจจุบัน	ఆధునిక కాలంలో	Nan
ยุคเฮอัง	హీయన్ శకం	Nan
ธรรมเมกขสถูป	ధర్మ మక్ స్థూపం	Nan
พลอย	రత్నం	None
พลทหาร	సోల్జర్	Nan
บริเวณรอบทะเลสาบเขมร	ఖైమర్ సరస్సు చుట్టూ	Nan
บริเวณเขตภูเขาทางภาคเหนือ	ఉత్తరాన పర్వత ప్రాంతం	Nan
บรูไน	బ్రూనై	Nan
บลีช	బ్లీచ్	Nan
บลู	బ్లూ	Nan
บลูคอสมอส	బ్లూ కాస్మోస్	Nan
บลูเบอร์รี่	బ్లూబెర్రీ	Nan
บวก	అనుకూల	Nan
บวม	వాపు	None
บวร	దైవ సంబంధమైన	Nan
บอมบ์	బాంబ్	Nan
บอย	బాయ్	Nan
บอยซ์	బాయ్జ్	Nan
บอล	బంతి	None
บอลด์วิน	బాల్డ్విన్	Nan
บอส	బాస్	Nan
บังคลาเทศ	బంగ్లాదేశ్	None
บาคุกันลูกน้องของนากา	నాగకు మద్దతుదారు బకుగన్	Nan
บาคุกันธาตุไฟ	బకుగన్ ఫైర్ ఎలిమెంట్	Nan
บาคคัส	బాచూస్	Nan
บัวใหญ่	బువా యై	Nan
บัวเชด	లోటస్ ఫ్లవర్	Nan
บัวลอย	bualoy	Nan
บริหารธุรกิจ	వ్యాపార పరిపాలన	Nan
บัว	కమలం	Nan
บันทึกความทรงจำ	మెమో	Nan
บันทึกการสร้างโลก	ప్రపంచ రికార్డు	Nan
บันทึก	రికార్డు	None
บัณฑิตวิทยาลัยร่วมด้านพลังงานและสิ่งแวดล้อม	జాయింట్ గ్రాడ్యుయేట్ స్కూల్ ఆఫ్ ఎనర్జీ అండ్ ఎన్విరాన్మెంట్	Nan
บัณฑิต	ఉన్నత విద్యావంతుడు	Nan
บังไค	bangkai	Nan
บันเทิง	వినోదం	None
บางกอกกล๊าส	బ్యాంకాక్ గ్లాస్	Nan
บริสุทธิ์	స్వచ్ఛమైన	Nan
บริพัตร	ఆహార	None
นี่คือ	ఇది	None
นุช	జాయ్	Nan
นเรศ	నేర్స్	Nan
นโยบายทางการทูตของจีน	చైనా యొక్క దౌత్య విధానం	Nan
น็อกซ์	నాక్స్	Nan
น้องครีม	నాంగ్ క్రీమ్	Nan
น้องชาย	తమ్ముడు	None
น้อยมาก	చాల కొన్ని	Nan
น้ำ	నీటి	Nan
น้ำค้าง	బిందు	Nan
น้ำดื่ม	త్రాగు నీరు	Nan
น้ำท่วม	వరద	None
น้ำฝน	రెయిన్వాటర్	Nan
น้ำพอง	గాలితో	Nan
น้ำมะนาว	నిమ్మరసం	Nan
น้ำมัน	ఆయిల్	None
น้ำมันสน	టర్పెంటైన్	Nan
บริบาล	రక్షణ	None
บราเธอร์ส	బ్రదర్స్	None
บราซิเลีย	బ్రెసిలియ	Nan
บรรพชีวินวิทยา	పురాజీవ	Nan
บรรณาธิการ	ఎడిటర్	None
บรมนาถบพิตร	బోరోమ్నాట్ బోఫిట్	Nan
บริวเวอรี่	బ్రేవరీ	Nan
บรมนาถชาติอาชาวศรัย	బోరోమానచట్ అచన్ సాయి	Nan
บทสวดสรภัญญะที่ขึ้นต้นด้วยธรรมมะคือ	ధర్మంతో ప్రారంభమయ్యే సోరపన్య శ్లోకాలు	Nan
บทสวดบาลีที่ขึ้นต้นด้วยอรหัง	అర్హత్‌తో ప్రారంభమయ్యే పాలి శ్లోకం	Nan
บทบาททางการเมือง	రాజకీయ పాత్ర	Nan
บทนมัสการนอบน้อมบูชาพระพุทธเจ้า	లార్డ్ బుద్ధుని వినయపూర్వకమైన ఆరాధన అధ్యాయాలు	Nan
น้ำหนัก	బరువు	None
น้ำยืน	నిలబడి నీరు	Nan
บนบก	భూమి మీద	Nan
นีโอ	నియో	Nan
บางกอกน้อย	బ్యాంకాక్ నోయి	Nan
บางซื่อ	బ్యాంగ్ స్యూ	Nan
บ้านฉาง	బాన్ చాంగ్	Nan
บ้านปราสาท	కోట ఇల్లు	Nan
บ้านผือ	బాన్ ఫ్యూ	Nan
บ้านฝันดอตคอม	బాన్ ఫ్యాన్ కాం	Nan
บ้านลาด	బాన్ లాడ్	Nan
บ้านเขว้า	హౌస్	None
บ้านแพ้ว	హౌస్	None
บ้านโพธิ์	ఫోను నిషేధించండి	Nan
ปจ	ఇయర్	None
ปช	బీచ్	None
ปฏิทินช่อง	ఛానల్ క్యాలెండర్	Nan
ปฏิภาณ	చమత్కారం	Nan
ปตท	ptt	Nan
ปทานุกรม	కోశం	Nan
ปทุมธานี	పాతుం తని	Nan
ปภ	సెక్యూరిటీ	Nan
ปภัสรา	papassara	Nan
ประติมากรรม	శిల్పం	None
ประดิษฐาน	ప్లేస్	None
ประชากรศาสตร์	జనాభా	None
ประชากรประมาณ	అంచనా జనాభా	Nan
ประจำปี	వార్షిక	None
ประจักษ์	మానిఫెస్ట్	Nan
บ่อทอง	చెరువు బంగారం	Nan
ประจวบคีรีขันธ์	ప్రచూప్ ఖిరి ఖాన్	Nan
ประกาศเป็นป่าสงวน	అటవీ సంరక్షణ కేంద్రంగా ప్రకటించారు	Nan
ประกาศิต	డిక్రీ	Nan
ประการที่	సంఖ్య	None
ประกอบไปด้วย	కలిగి ఉన్నది	Nan
ประกอบด้วย	ఉన్నాయి	None
ปม	ముడి	None
ประจวบ	కొట్టుకొని	Nan
บางครั้ง	కొన్నిసార్లు	None
บูมเมอแรง	బూమేరాంగ్	Nan
บุตร	పిల్లల	None
บางปะกอก	బ్యాంగ్ పకోక్	Nan
บางปะหัน	బ్యాంగ్ పహాన్	Nan
บางพลัด	bangplad	Nan
บางส่วน	కొన్ని	None
บางเขน	bangkhen	Nan
บางแสน	bangsaen	Nan
บางใหญ่	బ్యాంగ్ యాయ్	Nan
บานไม่รู้โรย	అమరాంత్	Nan
บารอมิเตอร์	భారమితి	None
บารัก	బరాక్	Nan
บาร์	బార్	None
บาลี	పాలి	Nan
บาอัล	బయలు	Nan
บิน	ఎగురు	Nan
บิล	బిల్లు	None
บิ๊กซี	బిగ్ సి	Nan
บิ๊กซ้งซุปเปอร์สโตร์	బిగ్ సాంగ్ సూపర్ స్టోర్	Nan
บุณยเกตุ	bunyaket	Nan
บุญนาค	మెరిట్	Nan
บุญนะโชติ	bunnachot	Nan
บุญค้ำ	మెరిట్	Nan
บุช	బుష్	Nan
บุคลิกภาพ	వ్యక్తిత్వం	None
บุษบา	పుష్పం	None
บุคคลสำคัญ	ముఖ్యమైన వ్యక్తి	Nan
บี้สุกฤษฎิ์	బీ సుకృత	Nan
บี้	నాసిరకం	Nan
บีฟเค้ก	బీఫ్ కేక్	Nan
บีบี	bb	Nan
บีช	సముద్రపు ఒడ్డు	Nan
บี	b.	Nan
บุคคล	వ్యక్తి	None
ประติมากรรมไทย	థాయ్ శిల్పం	Nan
นิ่มสกุล	నిమ్ సాకుల్	Nan
นิเทศศาสตรบัณฑิต	కళల్లో పట్టభధ్రులు	Nan
นอกจากนี้แล้ว	ఇదికాకుండా	Nan
นอกเหนือจากนี้	అదికాకుండ	Nan
นอนไม่หลับ	నిద్రించలేరు	Nan
นอร์ส	నోర్స్	Nan
นะงะซะกิ	నాగసాకి	Nan
นะโม	నమో	None
นักดนตรี	సంగీతకారుడు	Nan
นักบินของออร์บ	ఆర్బ్ యొక్క పైలట్	Nan
นักบินอวกาศ	ఆస్ట్రోనాట్	Nan
นักปรัชญา	ఫిలాసఫర్స్	Nan
นักพากย์	వాయిస్ యాక్టర్	Nan
นักมวย	బాక్సర్	Nan
นักร้อง	గాయకుడు	None
นักร้องชายไทย	థాయ్ మగ గాయకులు	Nan
นักร้องนักดนตรี	గాయకుడు సంగీతకారుడు	Nan
นักร้องเพลงไทยสากลชาย	అంతర్జాతీయ పురుష థాయ్ గాయకుడు	Nan
นักร้องเสียงหลัก	ప్రధాన గాయకుడు	Nan
นันทนาการ	వినోదం	None
นัดกับนัด	తేదీ	None
นักแสดงรับเชิญ	ఆహ్వానించబడిన నటుడు	Nan
นักแสดงพิธีกร	నటుడు	None
นักแสดง	నటులు	None
นักแต่งเพลง	కంపోజర్	Nan
นอกจากนี้	అదనంగా	None
นักเศรษฐศาสตร์	ఎకనామిస్ట్	Nan
นักเขียนการ์ตูน	కార్టూనిస్ట్	Nan
นักเขียน	రచయిత	None
นักสู้อันดับ	ర్యాంక్ ఫైటర్	Nan
นักศึกษาวิชาทหาร	సైనిక విద్యార్థి	Nan
นักวิทยาศาสตร์	శాస్త్రవేత్త	None
นักวิชาการ	అకడమిక్	Nan
นักเต้นนำ	లీడ్ డాన్సర్	Nan
นันทนาคร	nanthanakorn	Nan
นอกจาก	ఇదికాకుండా	Nan
นวรัตน์	nawarat	Nan
ธารทิพย์	టిప్ కంటే	Nan
ธำมงรค์	thamrong	Nan
ธิติกานต์	thitikan	Nan
ธีม	థీమ్	Nan
ธีระ	తీర	None
ธีรเดช	thiradej	Nan
ธุรกิจ	ఒక వ్యాపారం	Nan
ธุรกิจการบิน	విమానయాన వ్యాపారం	Nan
นก	పక్షి	None
นกกระจอก	పిచుక	Nan
นกกระทา	క్వాయిల్	Nan
นกกระทุง	అడ్డు	None
นกกระเต็น	లకుముకిపిట్ట	Nan
นกขมิ้น	కానరీ	Nan
นกน้อย	చిన్న పక్షి	Nan
นกแก้ว	చిలుక	None
นกแอร์	నోక్ ఎయిర్	Nan
นวนิยาย	నవల	None
นราธิวาส	నరతివాట్	Nan
นราธิป	narathip	Nan
นร	విద్యార్ధి	None
นพดล	nopadon	Nan
นพจินดา	noppachinda	Nan
นวล	దంతపు	Nan
นปช	udd	Nan
นครหลวงเวียงจันทน์	వియంటియాన్ క్యాపిటల్	Nan
นครสวรรค์	నాఖోన్ సావన్	Nan
นครราชสีมา	నాఖోన్ రాట్చసిమా	Nan
นครพนม	నాఖోన్ ఫనోమ్	Nan
นครปฐม	నాఖోన్ పాథోమ్	Nan
นครนิวยอร์ก	న్యూయార్క్ నగరం	Nan
นที	ఉపనది	Nan
นิ่ม	సాఫ్ట్	None
นันทเสน	nantasen	Nan
นับตั้งแต่เริ่มก่อตั้งจนถึงปัจจุบัน	ప్రారంభం నుండి ఇప్పటి వరకు	Nan
นายสวัสดิ์	మిస్టర్ సావత్	Nan
นายสุชาติ	మిస్టర్ సుచార్ట్	Nan
นายสุนทร	మిస్టర్ సుంథోర్న్	Nan
นายแพทย์	వైద్యుడు	Nan
นารูโตะ	నరుటో	Nan
นาวาอากาศเอกหญิง	స్క్వాడ్రన్ లీడర్	Nan
นาฬิกา	గడియారం	None
นาโนเทคโนโลยี	నానోటెక్నాలజీ	Nan
นำกลับมาสร้างใหม่อีกครั้ง	మళ్ళీ సృష్టించడానికి తిరిగి తీసుకువచ్చారు	Nan
นำแสดงโดย	స్టారింగ్	Nan
นำโดย	ద్వారా నాయకత్వం	Nan
นิกาย	శాఖ	None
นิกเกิล	నికెల్	Nan
นิคมพัฒนา	నికోమ్ ఫత్తానా	Nan
นิตยสารชีวจิต	హోమియోపతి పత్రిక	Nan
นิตยสารเอเชียวีก	ఆసియా వీక్ మ్యాగజైన్	Nan
นิตโย	nittayo	Nan
นิฮง	nihong	Nan
นิวเคลียส	కేంద్రకం	Nan
นิวเคลียร์	విడి	None
นิวัฒน์	newwat	Nan
นิวยอร์ก	న్యూయార్క్	None
นิวคลีโอไทด์	న్యూక్లియోటైడ్	Nan
นายสมัคร	దరఖాస్తుదారు	Nan
นิลภิรมย์	nilphirom	Nan
นิรันดร์กุล	nirunkun	Nan
นิรมิต	కల	None
นิยาม	నిర్వచించే	Nan
นิยมจัดขึ้นในเดือน	జనాదరణ నెలలో జరిగింది	Nan
นิยม	ప్రముఖ	None
นิทาน	కథ	None
นิรุกติศาสตร์	శబ్దవ్యుత్పత్తి	Nan
นันทไกร	nantakrai	Nan
นายสมชัย	మిస్టర్ సోమ్‌చాయ్	Nan
นายยงยุทธ	మిస్టర్ యోంగ్యూట్	Nan
นัยนา	కంటి	None
นั่นคือ	అంటే	None
นั่นเอง	అక్కడ	None
นั้น	ఆ	None
นา	ఫీల్డ్	None
นากา	నాగ	None
นากิ	నగి	Nan
นาคหิรัญกนก	నాక్ హిరాంకనోక్	Nan
นางงามจักรวาล	విశ్వ సుందరి	Nan
นางสาวสุวรรณ	మిస్ సువాన్	Nan
นางสุพรรณมัจฉา	శ్రీమతి సుఫాన్ మచ్చా	Nan
นางาโตะ	nagato	Nan
นาดี	nadi	Nan
นาดูน	నా డన్	Nan
นาทวี	nathawi	Nan
นาทาล	నాటాల్	Nan
นาที	నిమిషం	None
นายปรีดี	మిస్టర్ ప్రిది	Nan
นายปรีชา	మిస్టర్ ప్రీచ	Nan
นายประกอบ	మిస్టర్ అసెంబ్లీ	Nan
นายทวี	మిస్టర్ థావీ	Nan
นายดำรง	మిస్టర్ డామ్రాంగ్	Nan
นายณรงค์	మిస్టర్ నరోంగ్	Nan
นายศักดา	sakda	Nan
นายชาญชัย	మిస్టర్ చంచాయ్	Nan
นายชลอ	మిస్టర్ చలో	Nan
นายกำพล	మిస్టర్ కాంపన్	Nan
นายกรัฐมนตรีไทย	థాయ్ ప్రధాని	Nan
นายกรัฐมนตรีของประเทศไทย	థాయ్‌లాండ్ ప్రధాని	Nan
นามิ	నామి	Nan
นานา	అనేక	None
นายชวน	మిస్టర్ చువాన్	Nan
ประตู	తలుపు	Nan
ประตูน้ำ	ఆనకట్ట	None
ประตูเสีย	విరిగిన తలుపు	Nan
พงศ์ศิลป์พิพัฒน์	పోంగ్సిల్ప్ ఫిఫాట్	Nan
พงศ์เรืองรอง	pongrueangrong	Nan
พงษ์พานิช	pongpanich	Nan
พงษ์เพชร	ఫోంగ్ ఫెట్	Nan
พงษ์ไพบูลย์	phongpaibun	Nan
พจนานุกรมออนไลน์	ఆన్‌లైన్ నిఘంటువు	Nan
พญา	సర్ప	Nan
พญามังราย	ఫయా మంగ్రాయ్	Nan
พตท	ప్రాంతం	None
พธม	th	Nan
พนมไพร	ఫనోమ్ ఫ్రేయ్	Nan
พบหลักฐานของมนุษย์ซึ่งมีอายุเก่าแก่ที่สุดถึงห้าแสนปี	మనుషుల సాక్ష్యాలు కనుగొనబడ్డాయి, ఐదు లక్షల సంవత్సరాల వరకు పురాతనమైనవి.	Nan
พยัญชนะ	హల్లు	Nan
พยัญชนะสะกดควบกล้ำ	హల్లులు	None
พยางค์	అక్షరం	None
พยาธิกำเนิด	వ్యాధి జననం	Nan
พยาธิวิทยา	పాథాలజీ	Nan
พรอุดมศักดิ์	phonudomsak	Nan
พรรคเพื่อแผ่นดิน	ఫ్యూ థాయ్ పార్టీ	Nan
พรรคสังคมประชาธิปไตย	సోషల్ డెమోక్రటిక్ పార్టీ	Nan
พรรคสม	సమీకరణ పార్టీ	Nan
พรรคภูมิใจไทย	ఫ్యూయా థాయ్ పార్టీ	Nan
พรรคประชาธรรม	ప్రచతం పార్టీ	Nan
พ	t	Nan
พรรคธรรมาธิปัตย์	తమ్మతిపట్ పార్టీ	Nan
พรรคการเมืองใหม่	కొత్త రాజకీయ పార్టీ	Nan
พรบ	చట్టం	None
พรนารายณ์	narai	Nan
พร	పోర్న్	Nan
พยายามชี้ให้สาธารณชนและนานาชาติ	ప్రజలకు మరియు అంతర్జాతీయంగా ఎత్తి చూపడానికి ప్రయత్నిస్తున్నారు	Nan
พยาบาล	నర్సు	Nan
พรรคชาติไทย	చార్ట్ థాయ్ పార్టీ	Nan
พระคาถาชินบัญชร	మంత్రము చిన్నబాంచన్	Nan
ฝ้าย	పత్తి	None
ฝ่าเท้า	పాదం యొక్క ఏకైక	Nan
ผิวสี	చర్మపు రంగు	Nan
ผี	దెయ్యం	Nan
ผีน่ารัก	అందమైన దెయ్యం	Nan
ผู้กำกับ	దర్శకుడు	None
ผู้จัดการ	నిర్వాహకుడు	Nan
ผู้จัดการทีม	జట్టు మేనేజర్	Nan
ผู้ชนะ	విజేత	None
ผู้ชาย	మనిషి	None
ผู้ช่วยศาสตราจารย์	సహాయ ఆచార్యులు	Nan
ผู้ดำเนินรายการ	మోడరేటర్	Nan
ผู้บริหาร	ఎగ్జిక్యూటివ్	Nan
ผู้ผลิต	తయారీదారు	Nan
ผู้ฝึกสอน	శిక్షణ	None
ผู้พิทักษ์แห่งพิรุณ	ఇబ్బంది యొక్క సంరక్షకుడు	Nan
ผู้พิทักษ์แห่งอรุณ	గార్డియన్ ఆఫ్ ది డాన్	Nan
ผู้ว่าการธนาคารแห่งประเทศไทย	బ్యాంక్ ఆఫ్ థాయిలాండ్ గవర్నర్	Nan
ผู้ว่าราชการจังหวัด	గవర్నర్	None
ฝ่ายบริหาร	మేనేజ్మెంట్	Nan
ฝ่ามือ	తాటి	Nan
ฝูงชนวุ่นวาย	అస్తవ్యస్తమైన గుంపు	Nan
ฝิ่น	నల్లమందు	Nan
ฝอยทอง	దారములు	Nan
ฝ	ది	None
ฝ่าแดนเขาวงกต	చిట్టడవి ద్వారా	Nan
ผ้าอนามัยโซฟี	సోఫీ శానిటరీ నాప్కిన్స్	Nan
ผ่องศรี	phongsri	Nan
ผู้ใหญ่	వయోజన	None
ผู้เล่นชุด	సెట్ ప్లేయర్	Nan
ผู้เล่น	ఆటగాళ్ళు	None
ผู้อำนวยการ	దర్శకుడు	None
ผู้สนับสนุน	మద్దతుదారు	Nan
ผ้าขาวม้า	సింహపుచర్మాన్ని	Nan
ผิวขาว	తెలుపు చర్మం	Nan
พระจันทร์	చంద్రుడు	None
พระชนม์	లైఫ్	Nan
พระยาวิเศษภักดี	ఫ్రేయా వైసెట్‌ఫక్డి	Nan
พระยาสุนทรสงคราม	ఫ్రేయా సుంథోర్న్సోంగ్క్రామ్	Nan
พระยาไกรภักดีศรีนครลำดวน	ఫ్రేయా క్రైఫక్డి శ్రీనాఖోన్ లండువాన్	Nan
พระราชกรณียกิจ	రాయల్ విధులు	Nan
พระราชลัญจกรประจำพระองค์	రాయల్ సీల్	Nan
พระราชวงศ์	రాజ కుటుంబం	Nan
พระราชวรวงศ์เธอ	రాజ కుటుంబం	Nan
พระราชวังดุสิต	దుసిట్ ప్యాలెస్	Nan
พระราชวังเดิม	అసలు ప్యాలెస్	Nan
พระลอ	ఫ్రా లోర్	Nan
พระสมเด็จจิตรลดา	ఫ్రా సోమదేజ్ చిత్రాలడ	Nan
พระสัมมาสัมพุทธเจ้า	లార్డ్ బుద్ధ	Nan
พระองค์เจ้าสิริวัณณวรีนารีรัตน์	హెచ్‌ఆర్‌హెచ్ యువరాణి సిరివన్నవారి వరీరత్	Nan
พระอังสาเบื้องซ้ายประดับเหรียญรัตนาภรณ์	రత్తనపోర్న్ నాణేలతో అలంకరించబడిన ఎడమ వైపున ఉన్న శుభ బుద్ధ తాయెత్తు	Nan
พระอัษฎามหาเจดีย์	ఫ్రా అసదా మహా చెడి	Nan
พระอิศวร	శివ	None
พระอิสริยยศ	రాయల్ టైటిల్	Nan
พลตำรวจเอก	పోలీస్ జనరల్	Nan
พลตรีหญิง	మహిళా వైమానిక దళం	Nan
พลตรี	వాయు సైన్యము	Nan
พฤกษศาสตร์	వృక్షశాస్త్రం	Nan
พริกไทย	పెప్పర్	Nan
พริกหวาน	బెల్ మిరియాలు	Nan
พระยาราม	ఫ్రేయా రామ్	Nan
พริกหยวก	బెల్ మిరియాలు	Nan
พรานกระต่าย	హంటర్	Nan
พระโคตมพุทธเจ้า	బుద్ధ తాయెత్తు	Nan
พระเจ้าหลานเธอ	దేవుడు మీ మేనకోడలు	Nan
พระเจ้าลูกยาเธอ	దేవుని బిడ్డ	Nan
พระเกียรติยศ	ఆనర్	Nan
พระอุโบสถ	బౌద్ధ దేవాలయం	Nan
พราหมณ์	బ్రాహ్మణ	None
พระจันทร์สีรุ้ง	రెయిన్బో మూన్	Nan
พระยาชัยสุนทร	ఫ్రేయా చాయ్ సూన్‌థార్న్	Nan
พระมเหสี	కాన్సోర్ట్	Nan
พระตำหนัก	ప్యాలెస్	Nan
พระที่นั่งจักรพรรดิพิมาน	చక్రవర్తి ఫిమాన్ ప్యాలెస్	Nan
พระที่นั่งดุสิตมหาปราสาท	దుసిత్ మహా ప్రసాత్ సింహాసనం హాల్	Nan
พระที่นั่งบรมพิมาน	బోరోంఫిమాన్ మాన్షన్	Nan
พระธรรมปิฎก	dhammapitaka	Nan
พระธิดา	కుమార్తె	None
พระนคร	రాజధాని	None
พระนาม	పేరు	None
พระนามต้นราชสกุล	మొదటి పేరు	Nan
พระนารายณ์	విష్ణు	None
พระบรมธาตุไชยา	బుద్ధుని శేషాలను	Nan
พระบรมราชชนก	రాయల్ పోషణ	Nan
พระบรมราชินี	క్వీన్	Nan
พระบรมวงศานุวงศ์	రాయల్టీ	Nan
พระบาทสมเด็จพระนั่งเกล้าเจ้าอยู่หัว	కింగ్ నాంగ్ క్లావో	Nan
พระบาทสมเด็จพระปกเกล้าเจ้าอยู่หัว	రాజు ప్రజాదిపోక్	Nan
พระบาทสมเด็จพระปรเมนทรมหาอานันทมหิดล	అతని మెజెస్టి రాజు భూమిబోల్ అడుల్యదేజ్ మహా ఆనందమహిడోల్	Nan
พระมงกุฏเกล้าเจ้าอยู่หัว	రామా iv రాజు	Nan
พระพุทธศาสนา	బౌద్ధమతం	None
พระพุทธบาท	బుద్ధుడి పాదముద్ర	Nan
พระพุทธชินราช	ఫ్రా బుద్ధ చిన్నారత్	Nan
พระพันวัสสาอัยยิกาเจ้า	వెయ్యి మంది బుద్ధులు	Nan
พระพันปีหลวง	మిలీనియం లువాంగ్	Nan
พระยศขณะนั้น	ఆ సమయంలో	Nan
พระพรหมคุณาภรณ์	ఫ్రా ప్రోమ్ ఖునాపోర్న్	Nan
พระประแดง	ఫ్రా ప్రదేంగ్	Nan
พระปกเกล้าเจ้าอยู่หัว	రాజు ప్రజాదిపోక్	Nan
พระบาทสมเด็จพระเจ้าอยู่หัวเสด็จฯ	అతని మెజెస్టి కింగ్	Nan
พระบาทสมเด็จพระเจ้าอยู่หัวอานันทมหิดล	రాజు ఆనంద మహీడోల్	Nan
พระบาทสมเด็จพระเจ้าอยู่หัวภูมิพลอดุลยเดชทรงพระกรุณาโปรดเกล้าฯ	అతని మెజెస్టి రాజు భూమిబోల్ అడుల్యాదేజ్ దయతో సంతోషించాడు	Nan
พระบาทสมเด็จพระพุทธยอดฟ้าจุฬาโลก	ఫ్రా బుద్ధ ఫ్రా యోట్ ఫా, చులాలాంగ్ కార్న్	Nan
พระปรางค์สามยอด	ప్రాంగ్ సామ్ యోట్	Nan
ผลสำรวจ	సర్వే ఫలితాలు	Nan
ผลรวม	సమ్	Nan
ผลผลิตพลอยได้	ద్వారా-ఉత్పత్తులు	Nan
ประเทศเปรู	పెరు	Nan
ประเทศเม็กซิโก	మెక్సికో	None
ประเทศเวียดนาม	వియత్నాం	None
ประเทศแคนาดา	కెనడా	None
ประเทศและดินแดน	దేశాలు మరియు భూభాగాలు	Nan
ประเทศไทย	థాయిలాండ్	None
ประเพณีชักพระ	చక్ ఫ్రా సంప్రదాయం	Nan
ประเภท	వర్గం	None
ประเภทของ	రకం	None
ประเภทรายการแข่งขันชิงรางวัลดีเด่น	అవార్డు వర్గం అత్యుత్తమ పోటీ	Nan
ประโยค	వాక్యం	None
ปรัชญา	తత్వశాస్త్రం	Nan
ปรัชญาตะวันตก	పాశ్చాత్య తత్వశాస్త్రం	Nan
ปรากฏการณ์โลกร้อน	గ్లోబల్ వార్మింగ్	Nan
ปรากฏตัวตอนแรกในตอน	మొదట ఒక ఎపిసోడ్లో కనిపించింది	Nan
ปรากฏตัวในตอน	లో కనిపించింది	Nan
ปราจีนบุรี	ప్రాచిన్ బురి	Nan
ปลาปอมปาดัวร์	పాంపాడౌర్	Nan
ปลาบู่ทอง	గోల్డెన్ గోబీ	Nan
ปลา	చేప	None
ปรีดี	pri	Nan
ปรีดา	డిలైట్	Nan
ปริ๊นซ์	ప్రిన్స్	Nan
ประเทศเนปาล	నేపాల్	None
ปริศนา	పజిల్	Nan
ปริภูมิ	స్థలం	None
ปริญญา	డిగ్రీ	None
ปริญ	మెరీనా	Nan
ปราโมทย์	ఆనందము	Nan
ปราสาทเขาพระวิหาร	ప్రీ విహార్ కోట	Nan
ปราบดาภิเษก	కిరీటం	None
ปริมาณการผลิต	ఉత్పత్తి వాల్యూమ్	Nan
ปลาย	ముగింపు	Nan
ประเทศเกาหลีใต้	దక్షిణ కొరియా	Nan
ประเทศอียิปต์	ఈజిప్ట్	None
ประทีป	దీపం	None
ประธาน	అధ్యక్షుడు	None
ประธานกรรมการ	చైర్మన్	Nan
ประธานศาลฎีกา	సుప్రీంకోర్టు అధ్యక్షుడు	Nan
ประธานสภารัฐสภา	పార్లమెంటు స్పీకర్	Nan
ประธานาธิบดี	అధ్యక్షుడు	None
ประมาณ	గురించి	None
ประมาณคศ	గురించి	None
ประมาณปี	సుమారు ఒక సంవత్సరం	Nan
ประยงค์	prayong	Nan
ประวัติศาสตร์	చరిత్ర	None
ประวัติศาสตร์สเปน	స్పానిష్ చరిత్ర	Nan
ประวัติศาสตร์ไทย	థాయ్ చరిత్ర	Nan
ประสาท	నాడి	Nan
ประสิทธิภาพ	సమర్థత	Nan
ประหยัด	సేవ్	Nan
ประเด็นที่	సమస్య	None
ประเทศสเปน	స్పెయిన్	None
ประเทศสวีเดน	స్వీడన్	None
ประเทศลาว	లావోస్	None
ประเทศราช	రాయల్ దేశం	Nan
ประเทศมาเลเซีย	మలేషియాలో	Nan
ประเทศภูฏาน	భూటాన్	None
ประเทศเกาหลี	కొరియా	None
ประเทศฟินแลนด์	ఫిన్లాండ్	Nan
ประเทศฝรั่งเศส	ఫ్రాన్స్	None
ประเทศนอร์เวย์	నార్వే	Nan
ประเทศทำการค้าขายกับต่างประเทศมากยิ่งขึ้น	విదేశీ దేశాలతో ఎక్కువ వ్యాపారం చేస్తున్న దేశాలు	Nan
ประเทศซูดาน	సుడాన్	Nan
ประเทศกัมพูชา	కంబోడియా	None
ประเทศ	దేశంలో	None
ประเทศพม่า	మయన్మార్	None
ปลายคริสต์ศตวรรษที่	19 వ శతాబ్దం చివరిలో	Nan
ปลาในสกุลนี้เรียกว่า	ఈ జాతిలోని చేపలను అంటారు	Nan
ปลิงทะเล	సముద్ర దోసకాయ	Nan
ปีที่	ఇయర్	None
ปีที่วางจำหน่าย	విడుదల సంవత్సరం	Nan
ปีพุทธศักราช	బౌద్ధ సంవత్సరం	Nan
ปีย์	ఇయర్	None
ปีย์ชนิตว์	piyachit	Nan
ปีเตอร์	పీటర్	None
ปี่กลาง	మిడిల్ బ్యాగ్	Nan
ปืนพก	పిస్టల్	Nan
ปืนพกกึ่งอัตโนมัติ	సెమీ ఆటోమేటిక్ పిస్టల్	Nan
ปืนใหญ่	కానన్	Nan
ปืนใหญ่กลางกระสุนวิถีโค้ง	కానన్ మీడియం పథం వక్రతలు	Nan
ปืนไร้แรงสะท้อนถอยหลัง	రీకోయిల్ గన్	Nan
ปุณณกันต์	punnakan	Nan
ปุตราจายา	putrajaya	Nan
ปุ๋ย	ఎరువులు	None
ปู	పీత	Nan
ป่าชายหาด	బీచ్ ఫారెస్ట్	Nan
ผลประเสริฐ	అద్భుతమైన ఫలితాలు	Nan
ผลงานโฆษณา	ప్రకటనలు	None
ผลงานเพลง	సంగీతం	None
ผลงานหนังสือ	పుస్తక పోర్ట్‌ఫోలియో	Nan
ผลการแข่งขัน	పోటీ ఫలితాలు	Nan
ผล	ఫలితాలు	None
ปีจอโทศก	పిగ్ యొక్క సంవత్సరం	Nan
ผดุง	మద్దతు	None
ป๊อปปี้	గసగసాల	Nan
ป๊อป	పాప్	Nan
ป่าโกงกาง	మడ అడవి	Nan
ป่าเบญจพรรณ	మిశ్రమ అడవి	Nan
ป่าดิบแล้ง	పొడి సతత హరిత అడవి	Nan
ป่าชายเลน	మడ అడవి	Nan
ผจญภัยเกาะมหาสมบัติ	ట్రెజర్ ఐలాండ్ అడ్వెంచర్	Nan
ปีคศ	ఇయర్	None
ปิ่นเกล้า	pinklao	Nan
ปิยะพงษ์	piyapong	Nan
ปัน	వాటా	None
ปัญโญภาส	panopas	Nan
ปัญจาบ	పంజాబ్	None
ปัจจุบันเลิกเขียนแล้ว	ప్రస్తుతం రాయడం లేదు	Nan
ปัจจุบันมีที่นั่งอยู่ในสภาผู้แทนราษฎร	ప్రస్తుతం ప్రతినిధుల సభలో సీటు ఉంది	Nan
ปัจจุบันประเทศไทยมีภาพยนตร์ที่มุ่งสู่ตลาดโลก	ఈ రోజుల్లో, థాయ్‌లాండ్‌లో ప్రపంచ మార్కెట్ వైపు దృష్టి సారించే సినిమాలు ఉన్నాయి.	Nan
ปั้น	అచ్చు	Nan
ปัจจุบันนี้	ఈ రోజుల్లో	Nan
ปักธงชัย	పాక్ థాంగ్ చాయ్	Nan
ปักกิ่ง	పెకింగ్	Nan
ปวีณา	paweena	Nan
ปวันรัตน์	pawanrat	Nan
ปวดข้อ	కీళ్ల నొప్పి	Nan
ปล่อย	విడుదల	None
ปัจจุบัน	ప్రస్తుతం	None
พลศักดิ์	polsak	Nan
ปั๊บ	అకస్మాత్తుగా	None
ปากดี	మంచి నోరు	Nan
ปิปเปอราซิลลิน	పైపర్ అసిలిన్	Nan
ปาเลสไตน์	పాలస్తీనా	Nan
ปาสกาล	పాస్కల్	None
ปาร์ค	పార్క్	None
ปารีส	పారిస్	None
ปาริชาต	parichat	Nan
ปาก	నోటి	Nan
ปาย	పాయ్	Nan
ปานามา	పనామా	Nan
ปาน	కళంకం	Nan
ปากแม่น้ำสิงคโปร์	సింగపూర్ నోరు	Nan
ปากเกร็ด	పాక్ క్రెట్	Nan
ปากีสถาน	పాకిస్థాన్	None
ปากน้ำ	నదివాయి	Nan
ปานแร่	birthmarks	Nan
疾風伝	疾風 伝	Nan
