+	+	None
ห้วยขวาง	huai khwang	Nan
ห้วยทับทัน	huai thap than	Nan
ห้องน้ำ	toilet	Nan
ห้องสมุด	bibliotheek	None
ห้าง	op te slaan	Nan
ห้างฉัตร	hang chat	Nan
ห้างหุ้นส่วนจำกัด	commanditaire vennootschap	Nan
ฬาพานิช	reclame	None
อก	borst	None
อคิลลีส	achilles	Nan
องคชาต	geslachtsdelen	None
องคต	organisatie	None
องค์กรปกครองส่วนท้องถิ่น	lokale overheidsorganisatie	Nan
องค์การนิสิต	studentenorganisatie	Nan
องค์การมหาชน	publieke organisatie	Nan
องค์การสหประชาชาติ	verenigde naties	Nan
องค์บาก	ong bak	Nan
อนึ่ง	overigens	None
อนาลโย	analoy	Nan
อนันตรัย	anantai	Nan
อนันตยะ	anantaya	Nan
อธิบายว่า	leg dat uit	Nan
อธิการบดีมหาวิทยาลัยธรรมศาสตร์	president van thammasat university	Nan
ห่วงใย	zorgzaam	Nan
อธิการบดี	kanselier	Nan
อดีตรองนายกรัฐมนตรี	voormalig vice-premier	Nan
อดีตผู้บัญชาการทหารบก	voormalig militair bevelhebber	Nan
อดีต	voormalig	None
อดิศักดิ์	adisak	Nan
องอาจ	moedig	Nan
องค์ประกันหงสา	hongsa-verzekering	Nan
อดีตรองหัวหน้าหน่วยที่	voormalig plaatsvervangend hoofd van de eenheid	Nan
อนุทิน	dagboek	None
หเตุการณ์	situatie	None
หุ่น	marionet	Nan
หลักสูตรวิทยาศาสตรมหาบัณฑิต	master of science-programma	Nan
หลังจาก	na	None
หลังสงคราม	na de oorlog	Nan
หลังสงครามโลกครั้งที่	na de wereldoorlog	Nan
หลังสงครามโลกครั้งที่สอง	na de tweede wereldoorlog	Nan
หลังเหตุการณ์	na de gebeurtenis	Nan
หลาย	veel	None
หลีกภัย	ontsnappen	None
หลุมดำจิ๋ว	klein zwart gat	Nan
หล่มสัก	lom sak	Nan
หวาย	rotan	Nan
หอก	speer	Nan
หอประชุมพ่อขุนรามคำแหงมหาราช	king ramkhamhaeng the great auditorium	Nan
หอมรดกไทย	thai heritage hall	Nan
หอย	schaaldieren	Nan
หอไอเฟล	eiffeltoren	None
หัก	aftrekken	Nan
หุตะสิงห์	huta sing	Nan
หี	kutje	Nan
หินไซอัล	schalie steen	Nan
หินแกรนิต	graniet	Nan
หินเชิร์ต	stenen overhemd	Nan
หินอ่อน	marmeren	Nan
หุ่นยนต์	robot	Nan
หินปูน	kalksteen	None
หาดทรายแก้ว	sai kaew beach	Nan
หาง	staart	None
หัวใจ	hart	None
หัวโขน	masker	Nan
หัวหิน	hua hin	Nan
หัว	hoofd	None
หาบเร่	venter	Nan
หลักสูตรภาษาไทย	thaise taalcursus	Nan
อนุสรณ์สถาน	gedenkteken	Nan
อปักธงชัย	pak thongchai	Nan
ออกมาในอะนิเมะเท่านั้น	alleen in de anime	Nan
ออกอากาศ	uitzending	None
ออกอากาศครั้งที่	uitgezonden	None
ออกอากาศทางช่อง	uitgezonden op	Nan
ออกัสตัส	augustus	None
ออกเป็น	in	None
ออกแบบตัวละคร	personage ontwerp	Nan
ออนไลน์	online	None
ออฟ	uit	None
ออลแบนี	geallieerden	None
ออสเตรเลีย	australië	None
ออโตทรอพ	autobot	Nan
อะ	wat	None
อะซูไรต์	azuriet	Nan
อะตอม	atoom	Nan
อะนิเมะ	anime	None
อะบุราเมะ	aburame	Nan
อัธฮา	athha	Nan
อัตราการว่างงาน	werkloosheidspercentage	Nan
อัฒภาค	puntkomma	Nan
อัญมณี	edelsteen	Nan
อังการา	ankara	Nan
อังกฤษสมัยแองโกล-นอร์มัน	anglo-normandisch engels	Nan
ออกฉายครั้งแรกเมื่อวันที่	eerst vertoond	Nan
อักษรเกาหลี	koreaans alfabet	Nan
อักษร	brief	None
อะโลน	alleen	None
อะโกนิสต์	agonist	Nan
อะลูมิเนียม	aluminium	None
อะมาเดอุส	amadeus	Nan
อะพาไทต์	apatiet	Nan
อักษรย่อ	afkortingen	Nan
อนุสรา	anusara	Nan
ออ	of	None
อสมท	mcot	Nan
อพอลโล่	apollo	None
อพิมาย	aphimai	Nan
อภัยนุราช	vergeven	Nan
อภินันท์	aphinan	Nan
อภิปรัชญา	metafysica	None
อภิรักษ์	aphirak	Nan
อมฤต	dood	None
อมาตยกุล	amatayakun	Nan
อยู่	zijn	None
อยู่วิทยา	wetenschap	None
อยู่ห่างออกไปจากชายฝั่ง	ver weg van de kust	Nan
อยู่แล้ว	nu al	Nan
อยู่ในเขตอำเภอกุฉินารายณ์	gelegen in het district kuchinarai	Nan
อย่างต่อเนื่อง	doorlopend	Nan
อย่างแพร่หลาย	op grote schaal	Nan
อย่างไรก็ตาม	echter	None
อร	orn	Nan
อศรีประจันต์	asri prachan	Nan
อวัยวะเพศ	geslachtsdelen	None
อวัยวะสืบพันธุ์หญิง	vrouwelijke geslachtsorganen	Nan
อวัยวะสืบพันธุ์สตรีด้านนอก	vrouwelijke geslachtsorganen aan de buitenkant	Nan
อวอร์ดส	awards	None
อลิซ	alice	None
อสามชุก	sam chuk	Nan
อลาสก้า	alaska	None
อรุณี	arunee	Nan
อริยสัจ	edele waarheid	Nan
อรัญประเทศ	aranyaprathet	Nan
อรรถพร	athaphon	Nan
อรรถกถา	commentaar	None
อรทัย	jong meisje	Nan
อลังการ	versiering	Nan
อันดับ	beoordeling	None
หลักสูตรภาษาอังกฤษ	engelse taalcursus	Nan
หลักสูตรนานาชาติ	internationale cursus	Nan
หน้าอก	borst	None
หมวด	groep	None
หมวดหมู่	categorie	None
หมวดหมู่กลุ่มดนตรีที่ก่อตั้งในปี	categorie muziekgroep opgericht in	Nan
หมวดหมู่กลุ่มดนตรีสัญชาติเกาหลี	categorie koreaanse muziekgroep	Nan
หมวดหมู่กวีชาวไทย	thaise dichter categorie	Nan
หมวดหมู่การฉลองปีใหม่	nieuwjaar viering categorie	Nan
หมวดหมู่การประท้วงในประเทศไทย	categorieprotest in thailand	Nan
หมวดหมู่การ์ตูนญี่ปุ่นแนวโชเน็น	categorie: japanse cartoon, shonen-stijl	Nan
หมวดหมู่จุลชีววิทยา	categorie microbiologie	Nan
หมวดหมู่ชาวไทยที่นับถือศาสนาพุทธ	categorie thaise boeddhisten	Nan
หมวดหมู่ชาวไทยที่เกิดในต่างประเทศ	categorie thai geboren in het buitenland	Nan
หมวดหมู่ดาวเคราะห์ชั้นใน	categorie inner planet	Nan
หมวดหมู่ดาวเคราะห์หิน	planet stone categorie	Nan
หมวดหมู่ทหารอากาศชาวไทย	categorie thaise luchtmacht	Nan
หมวดหมู่ทหารเรือชาวไทย	categorie thaise marine	Nan
หมวดหมู่นักการเมืองไทย	categorie van thaise politici	Nan
หมวดหมู่ประวัติศาสตร์ไทย	thaise geschiedeniscategorie	Nan
หมวดหมู่บุคคลที่เกี่ยวข้องกับเหตุการณ์	categorie mensen gerelateerd aan het evenement	Nan
หมวดหมู่บุคคลจากโรงเรียนมงฟอร์ตวิทยาลัย	categorie personen van montfort college	Nan
หมวดหมู่บุคคลจากโรงเรียนนายร้อยพระจุลจอมเกล้า	categorieën van de chulachomklao royal military academy	Nan
หมวดหมู่บุคคลจากสถาบันบัณฑิตพัฒนศิลป์	categorie mensen van het bunditpatanasilpa institute	Nan
หมวดหมู่บุคคลจากมหาวิทยาลัยอ๊อกซฟอร์ด	individuele categorie van oxford university	Nan
หน่วยพันธุกรรม	genetische eenheid	Nan
หมวดหมู่บุคคลจากมหาวิทยาลัยสุโขทัยธรรมาธิราช	categorieën van sukhothai thammathirat open university	Nan
หมวดหมู่บุคคลจากจุฬาลงกรณ์มหาวิทยาลัย	categorieën van chulalongkorn university	Nan
หมวดหมู่บอยแบนด์	boyband categorie	Nan
หมวดหมู่บริษัทที่ก่อตั้งในปี	categorie bedrijf opgericht in	Nan
หมวดหมู่บริษัทของไทย	thaise bedrijfscategorie	Nan
หมวดหมู่นายกรัฐมนตรีไทย	categorie thaise premier	Nan
หมวดหมู่นักร้องไทย	thaise zangerescategorie	Nan
หมวดหมู่บุคคลจากมหาวิทยาลัยธรรมศาสตร์	categorie van thammasat university	Nan
หมวดหมู่ประเภทของภาพยนตร์	categorie van filmcategorie	Nan
หน่วยประมวลผลกลาง	centrale verwerkingseenheid	Nan
หน่วยที่	eenheid	None
ส่วนหัว	koptekst	Nan
ส่วนในฤดูฝนน้ำจะท่วมทุกปี	in het regenseizoen zal het water elk jaar overstromen.	Nan
ส่วนใหญ่	meest	None
ส่วนใหญ่เป็นโรงสีข้าว	de meeste zijn rijstmolens.	Nan
ส่องแสง	schijnen	Nan
ส้ม	oranje	None
ส้มเช้ง	oranje oranje	Nan
ส้มโอ	grapefruit	Nan
หงษ์ทอง	hong thong	Nan
หงษ์มานพ	hong manop	Nan
หงสกุล	hong sakul	Nan
หญ้าทะเล	zee gras	Nan
หญ้าฝรั่น	saffraan	Nan
หนองคาย	nong khai	Nan
หนองม่วง	nong muang	Nan
หนองหาน	nong han	Nan
หนองฮี	nong hee	Nan
หน่วยทหารในค่าย	militaire eenheid in het kamp	Nan
หน่วยคำเติม	morfeem	Nan
หน่วยความจำ	geheugen	None
หนุ่ม	jong	None
หนุมาน	hanuman	Nan
หนึ่งธิดา	een dochter	Nan
หน่วยบัญชาการนาวิกโยธิน	hoofdkwartier van het korps mariniers	Nan
หนึ่ง	een	None
หนังสือลามก	pornografische boeken	Nan
หนังสือการ์ตูน	stripboek	Nan
หนังสือ	boek	None
หนัก	zwaar	None
หนอน	worm	Nan
หนองแซง	zang	None
หนังใหญ่	grote film	Nan
หลักสูตรปกติ	normale cursus	Nan
หมวดหมู่ปรัชญา	categorie filosofie	Nan
หมวดหมู่พระราชปทินัดดาในรัชกาลที่	categorie koninklijke regering in de regering	Nan
หมอชิต	morchit	Nan
หมากรุกสากล	internationaal schaken	Nan
หมายความว่า	middelen	None
หมู่	varkens	None
หมู่ที่	dorp	None
หมู่เกาะเคย์แมน	kaaiman eilanden	Nan
หมู่เกาะแบลีแอริก	de balearen	Nan
หมู่เกาะโซโลมอน	solomon eilanden	Nan
หม่อมราชวงศ์ปรีดิยาธร	r. pridiyathorn	Nan
หม่อมหลวงปิ่น	moeder pin	Nan
หม่อมเจ้าจุฑาวัชร	prins jutawatchai	Nan
หม่อมเจ้าวัชรวีร์	prins watcharawee	Nan
หม่อมเจ้าวัชรเรศร	mam watcharachorn	Nan
หม้อข้าวหม้อแกงลิง	nepenthes	Nan
หยุ่น	flexibel	Nan
หรั่ง	lang	None
หรือ	of	None
หลักสูตรที่เปิดสอน	cursus	Nan
หลักสูตรการจัดการดุษฏีบัณฑิต	doctor of philosophy program in management	Nan
หลักสี่	laksi	Nan
หลักทรัพย์	effecten	Nan
หลักจริยธรรม	ethiek	None
หลอดเลือดแดงใหญ่เอออร์ตา	aorta	Nan
หมวดหมู่โรงเรียนบุรุษในประเทศไทย	heren schoolcategorie in thailand	Nan
หลอดอาหาร	slokdarm	Nan
หลวง	koninklijk	None
หรือเรียกว่า	of belde	Nan
หรือที่เรียกกันว่า	ook gekend als	Nan
หรือที่รู้จักกันในชื่อ	of bekend als	Nan
หรือชื่อทางการคือ	of officiële naam is	Nan
หรือการแสดงธงชาติ	of met de nationale vlag	Nan
หลอก	pseudo	Nan
หมวดหมู่พระราชนัดดาในรัชกาลที่	categorie koninklijke kleinzoon van het bewind	Nan
หมวดหมู่โรงเรียนที่มีอัตราการแข่งขันสูง	categorie scholen met hoge concurrentiepercentages	Nan
หมวดหมู่แนวพระราชดำริ	initiatiefcategorie	Nan
หมวดหมู่พระราชปนัดดาในรัชกาลที่	categorie king panadda tijdens het bewind	Nan
หมวดหมู่พิธีกรไทย	categorie thaise presentatoren	Nan
หมวดหมู่ฟุตบอลในประเทศไทย	voetbalcategorie in thailand	Nan
หมวดหมู่ภัยธรรมชาติ	categorie natuurrampen	Nan
หมวดหมู่ภัยพิบัติทางการแพทย์	categorie medische ramp	Nan
หมวดหมู่มหาวิทยาลัยธรรมศาสตร์	thammasat university categorie	Nan
หมวดหมู่รัชกาลที่	categorie heersen	Nan
หมวดหมู่รัฐคอมมิวนิสต์	communistische staatscategorie	Nan
หมวดหมู่รัฐมนตรีว่าการกระทรวงการต่างประเทศไทย	categorie: thaise minister van buitenlandse zaken	Nan
หมวดหมู่รัฐวิสาหกิจไทย	categorie thaise ondernemingen	Nan
หมวดหมู่รัฐสิ้นสภาพในทวีปเอเชีย	categorie staat van staat stopgezet in azië	Nan
หมวดหมู่รัฐและดินแดนที่ก่อตั้งในปี	categorie staat en gebied opgericht in	Nan
หมวดหมู่รายการโทรทัศน์ไทย	thaise televisieprogramma categorie	Nan
หมวดหมู่ละครโทรทัศน์ไทย	categorie thais televisiedrama	Nan
หมวดหมู่วัฒนธรรมไทย	thaise cultuurcategorie	Nan
หมวดหมู่วันสำคัญทางศาสนาที่นับโดยปฏิทินจันทรคติ	categorieën van belangrijke religieuze dagen geteld door de maankalender	Nan
หมวดหมู่ศิลปินสังกัดจีเอ็มเอ็ม	kunstenaarscategorie onder gmm	Nan
หมวดหมู่เพศศึกษา	categorie seksuele voorlichting	Nan
หมวดหมู่เครื่องเทศ	kruidencategorie	Nan
หมวดหมู่อวัยวะเพศ	genitale categorie	Nan
หมวดหมู่อวัยวะ	orgelcategorie	Nan
หมวดหมู่อดีตอาณานิคมของอังกฤษ	britse voormalige koloniale categorie	Nan
หมวดหมู่อดีตอาณานิคมของสเปน	spaanse voormalige koloniale categorie	Nan
หมวดหมู่โรค	ziektecategorie	Nan
หมวดหมู่อดีตอาณานิคมของฝรั่งเศส	franse voormalige koloniale categorie	Nan
หมวดหมู่สิ้นสุดในคริสต์ศตวรรษที่	categorie eindigde in de 19e eeuw.	Nan
หมวดหมู่สิ่งก่อสร้างในพุทธศตวรรษที่	categorie gebouwen in de 21e eeuw	Nan
หมวดหมู่สัตว์เลื้อยคลาน	reptielencategorie	Nan
หมวดหมู่สัตว์มีแกนสันหลัง	categorie wervelas	Nan
หมวดหมู่สมุนไพร	kruidencategorie	Nan
หมวดหมู่สถาบันอุดมศึกษาในกรุงเทพมหานคร	categorieën instellingen voor hoger onderwijs in bangkok	Nan
หมวดหมู่สโมสรในพรีเมียร์ลีก	clubcategorie in de premier league	Nan
อันประกอบด้วย	bestaande uit	Nan
อันโตนิโอ	antonio	None
อันโตนีโอ	antonio	None
อุณหเคมี	thermochemie	Nan
อุดม	vruchtbaar	None
อุดรธานี	udon thani	Nan
อุตตมะโยธิน	uppharat yothin	Nan
อุตรดิตถ์	uttaradit	Nan
อุทยาน	park	None
อุทยานประวัติศาสตร์พนมรุ้ง	historisch park phanom rung	Nan
อุทยานประวัติศาสตร์พิมาย	historisch park van phimai	Nan
อุทยานแห่งชาติคลองตรอน	nationaal park khlong tron	Nan
อุทยานแห่งชาติดอยภูคา	nationaal park doi phu kha	Nan
อุทยานแห่งชาติดอยอินทนนท์	nationaal park doi inthanon	Nan
อุทยานแห่งชาติทุ่งแสลงหลวง	thung salaeng luang nationaal park	Nan
อุทยานแห่งชาติธารโบกขรณี	dan bok khorani national park	Nan
อุทยานแห่งชาติน้ำตกสี่ขีด	si khit waterfall national park	Nan
อุทยานแห่งชาติน้ำพอง	nam phong national park	Nan
อุทยานแห่งชาติภูผาเหล็ก	nationaal park iron mountain	Nan
อุทยานแห่งชาติภูพาน	nationaal park phu phan	Nan
อุภัยราศี	vergeef de dierenriem	Nan
อุปนิสัย	karakter	None
อุปกรณ์คอมพิวเตอร์	computer accessoires	Nan
อุปกรณ์	apparatuur	None
อุบล	ubon	Nan
อุทุมพรพิสัย	uthumphon phisai	Nan
อุณหภูมิ	temperatuur	None
อุทยานแห่งชาติไทรทอง	nationaal park sai thong	Nan
อุทยานแห่งชาติหาดนพรัตน์ธาราหมู่เกาะพีพี	nationaal park noppharat thara, phi phi-eilanden	Nan
อุทยานแห่งชาติภูแลนคา	nationaal park phulanca	Nan
อุทยานแห่งชาติภูเวียง	nationaal park phu wiang	Nan
อุทยานแห่งชาติภูเรือ	nationaal park phu ruea	Nan
อุทยานแห่งชาติภูสอยดาว	nationaal park phu soi dao	Nan
อุทยานแห่งชาติภูสวนทราย	nationaal park phu suan sai	Nan
อุทยานแห่งชาติเขาหลวง	nationaal park khao luang	Nan
อุรุกวัย	uruguay	None
อุซึมากิ	uzumaki	Nan
อื่น	een ander	Nan
อำเภอแม่แจ่ม	mae chaem district	Nan
อำเภอแม่แตง	mae taeng district	Nan
อำเภอโนนดินแดง	niet-din daeng-district	Nan
อำเภอโนนสุวรรณ	niet-suwan-district	Nan
อิงค์	inc.	Nan
อิงลิช	engels	None
อิทธิพล	invloed	None
อิน	in	None
อินทิรา	indira	Nan
อินฟราเรด	infrarood	Nan
อินฮิบิเตอร์	remmer	Nan
อินุยาฉะ	inuyasha	Nan
อินเซคทิวอรา	inseqtura	Nan
อินเดียน	indisch	Nan
อินเด็กซ์	inhoudsopgave	Nan
อินโดนีเซีย	indonesië	None
อิม	imm	Nan
อือ	ja!	Nan
อึ๊งภากรณ์	ungphakorn	Nan
อึ	shit	Nan
อีกด้วย	te	None
อีกครั้ง	nogmaals	None
อีก	meer	None
อุ	o	None
อิโนะ	ino	Nan
อิหร่าน	iran	None
อิสตันบูล	istanbul	None
อิริโทรมัยซิน	electrolyse	Nan
อิรัก	irak	None
อิมแพ็ค	gevolg	None
อิมาจิน	imajin	Nan
อิเควทอเรียลกินี	equatoriaal-guinea	Nan
อำเภอแม่ทะ	mae tha district	Nan
อุเทน	uthen	Nan
อู๋	wu	Nan
ฮิโซกะ	hisoka	Nan
ฮิโรชิ	hiroshi	Nan
ฮีชอล	heechul	Nan
ฮุก	haak	Nan
ฮโยยอน	hyoyeon	Nan
ฯพณฯ	zijne majesteit	Nan
เกตส์	poorten	None
เกตุทัต	ketthat	Nan
เกมที่	het spel	Nan
เกมบุค	spel	None
เกรย์	grijs	None
เกษตรกรรม	landbouw	None
เกษตรวิสัย	kaset wisai	Nan
เกษมศรี	kasemsri	Nan
เกอริง	gering	None
เกอไทต์	goethe	Nan
เกาหลีใต้	zuid-korea	Nan
เกียรติศักดิ์	heerlijkheid	Nan
เกียรติประวัติ	eer	None
เกียรติ	eer	None
เกิดนิมิตร	creëer een visie	Nan
เกิดจากเชื้อไวรัส	veroorzaakt door een virus	Nan
เกิดจากการรวมตัวของ	veroorzaakt door de oprichting van	Nan
ฮิวงะ	hyuga	Nan
เกิดจากการรวมชิ้นส่วนที่	veroorzaakt door delen die dat combineren	Nan
เกิดขึ้นหลังจากมหาวิทยาลัยศรีนครินทรวิโรฒวิทยาเขตต่างๆ	vond plaats na srinakharinwirot university	Nan
เกิด	was geboren	Nan
เกาะสุมาตรา	sumatra	None
เกาะลูซอน	luzon-eiland	Nan
เกาะคา	kauai	Nan
เกาะ	eiland	None
เกิดขึ้นเมื่อวันที่	vond plaats op	Nan
อู	ou	Nan
ฮิราโกะ	hirako	Nan
ฮินาตะ	hinata	Nan
อเมริกัน	amerikaans	None
อเมริกา	amerika	None
อเมริกาเหนือ	noord amerika	Nan
อเล็กซานเดอร์	alexander	None
อเล็กซ์	alex	None
อโลหะ	niet van metaal	Nan
อ่อนเพลีย	moe	Nan
อ่าน	lezen	None
อ่าวลึก	ao luek	Nan
อ้างว่า	claim dat	Nan
อ้างว้าง	troosteloos	Nan
ฮอกกี้	hockey	Nan
ฮอท	heet	None
ฮอฟมัน	hoffman	Nan
ฮอยเกนส์	hogens	Nan
ฮอร์โมน	hormoon	None
ฮอลแลนด์	holland	None
ฮิตเลอร์	hitler	None
ฮิซานะ	hisana	Nan
ฮิซาชิ	hisashi	Nan
ฮาวาย	hawaii	Nan
ฮารุกะ	haruka	Nan
ฮายาโตะ	hayato	Nan
ฮิมาวาริ	himawari	Nan
ฮานอย	hanoi	Nan
ฮาจิ	hachi	Nan
ฮัมบูร์ก	hamburg	None
ฮันกึล	hangul	Nan
ฮักบี้	vaarwel	Nan
ฮอว์ค	seahawks	Nan
ฮอลโลว์	hol	None
ฮาตาเกะ	hatake	Nan
อำเภอแจ้ห่ม	chae hom district	Nan
อำเภอเสริมงาม	soem ngam district	Nan
อำเภอเวียงแก่น	wiang kaen district	Nan
อานโตนิโอ	antonio	None
อาบาราอิ	abarai	Nan
อายุ	leeftijd	None
อารยา	araya	Nan
อาร์	r	None
อาร์กอน	argon	Nan
อาร์คิมิดีส	archimedes	Nan
อาร์ม	arm	None
อาร์มาดิลโล	gordeldier	Nan
อาร์เคด	arcade	Nan
อาร์เมเนีย	armenië	None
อาร์เอ็นเอ	rna	None
อาร์โนลด์	arnold	None
อาวุธคือ	wapen is	Nan
อาวุธประจำกาย	persoonlijk wapen	Nan
อาหาร	eten	None
อาเจียน	braken	None
อำเภอดอยสะเก็ด	doi saket district	Nan
อำเภอจอมทอง	chom thong district	Nan
อำเภอคูเมือง	khu mueang-district	Nan
อำเภอครบุรี	khon buri-district	Nan
อำเภอขุนหาญ	khun han-district	Nan
อำเภอขุขันธ์	khukhan-district	Nan
อานุภาพ	macht	None
อำเภอกันทรลักษ์	kantharalak district	Nan
อำเภอกมลาไสย	kamalasai district	Nan
อำเภอ	wijk	None
อำนาจอธิปไตย	soevereiniteit	None
อำนาจ	macht	None
อาเนีย	ana	Nan
อาเธอร์	arthur	None
อำเภอกระสัง	krasang district	Nan
อำเภอด่านขุนทด	dan khun thot-district	Nan
อานันทมหิดล	ananda mahidol	Nan
อาทิตย์	week	None
อันได้แก่	inclusief	None
อัฟกานิสถาน	afghanistan	None
อัมพร	amporn	Nan
อัมพาต	verlamming	Nan
อัลบัส	albus	Nan
อัลบั้ม	album	None
อัลเดบารัน	aldebaran	Nan
อัลเฟรด	alfred	None
อัสนี	bout	Nan
อาการหวาดระแวง	paranoia	Nan
อากาศ	lucht	None
อากาศอำนวย	weer	None
อากาเป	agape	Nan
อาคามัตสึ	akamatsu	Nan
อาคารส่วนที่	bouwen sectie	Nan
อาคารอุบลรัตนราชกัญญา	ubonratana ratchakanya-gebouw	Nan
อาคารเฉลิมพระเกียรติ	chaloem phrakiat-gebouw	Nan
อาทิ	zoals	None
อาดัม	adam	None
อาณาเขตติดต่อ	contactgebied	Nan
อาณาจักรแพกเจ	pakae kingdom	Nan
อาณาจักรอยุธยาเริ่มเสื่อมอำนาจลงราวพุทธศตวรรษที่	het ayutthaya-koninkrijk begon in de boeddhistische eeuw te verslechteren.	Nan
อาณาจักรอยุธยาปกครองเขมรเป็นเวลาเกือบปี	het ayutthaya-koninkrijk regeerde bijna een jaar over cambodja.	Nan
อานนท์	anon	Nan
อาณาจักรสุโขทัย	sukhothai kingdom	Nan
อาณาจักร	koninkrijk	None
อาณัตพล	anataphon	Nan
อาซึกะ	asuka	Nan
อาจารย์ใหญ่	schoolhoofd	Nan
อาจารย์	professor	None
อาจหมายถึง	kan betekenen	Nan
อาณาจักรธนบุรี	thonburi kingdom	Nan
อำเภอตะพานหิน	taphan hin district	Nan
อำเภอทับคล้อ	thap khlo district	Nan
อำเภอทุ่งช้าง	thung chang district	Nan
อำเภอศรีเมืองใหม่	si mueang mai district	Nan
อำเภอสระโบสถ์	sra church district	Nan
อำเภอสหัสขันธ์	sahatsakhan district	Nan
อำเภอสองแคว	song khwae	Nan
อำเภอสังขะ	sangkha district	Nan
อำเภอสันป่าตอง	san pa tong district	Nan
อำเภอสามพราน	sam phran district	Nan
อำเภอสารภี	saraphi district	Nan
อำเภอสิชล	sichon district	Nan
อำเภอสุไหงโกลก	sungai kolok district	Nan
อำเภอหนองกี่	nong ki district	Nan
อำเภอห้วยราช	huai rat district	Nan
อำเภออมก๋อย	omkoi district	Nan
อำเภอเกาะคา	ko kha district	Nan
อำเภอเขวาสินรินทร์	khwao sinarin-district	Nan
อำเภอเฉลิมพระเกียรติ	chaloem phrakiat district	Nan
อำเภอเชียงของ	chiang khong-district	Nan
อำเภอเวียงชัย	wiang chai district	Nan
อำเภอเมืองเพชรบุรี	mueang phetchaburi-district	Nan
อำเภอเมืองเชียงใหม่	mueang chiang mai district	Nan
อำเภอเมืองอุตรดิตถ์	mueang uttaradit district	Nan
อำเภอเมืองสุรินทร์	mueang surin district	Nan
อำเภอเมืองลพบุรี	mueang lop buri district	Nan
อำเภอศรีณรงค์	si narong district	Nan
อำเภอเมืองพิษณุโลก	mueang phitsanulok	Nan
อำเภอเมืองบุรีรัมย์	mueang buri ram district	Nan
อำเภอเมืองนนทบุรี	mueang nonthaburi district	Nan
อำเภอเมืองนครราชสีมา	mueang nakhon ratchasima district	Nan
อำเภอเมืองกาฬสินธุ์	mueang kalasin	Nan
อำเภอเชียรใหญ่	chian yai district	Nan
อำเภอเชียงคาน	chiang khan district	Nan
อำเภอเมืองพิจิตร	mueang phichit-district	Nan
อำเภอลำปลายมาศ	lam plai mat district	Nan
อำเภอลาดหลุมแก้ว	lat lum kaeo district	Nan
อำเภอร่อนพิบูลย์	ron phibun-district	Nan
อำเภอบ้านลาด	ban lat district	Nan
อำเภอบางเสาธง	bang sao thong district	Nan
อำเภอบางละมุง	bang lamung district	Nan
อำเภอบางพลี	bang phli-district	Nan
อำเภอบางบ่อ	bang bo district	Nan
อำเภอบางบัวทอง	bang bua thong district	Nan
อำเภอบ้านหมี่	ban mi district	Nan
อำเภอบัวใหญ่	bua yai district	Nan
อำเภอน้ำเกลี้ยง	nam kliang district	Nan
อำเภอนาบอน	na bon district	Nan
อำเภอนครชัยศรี	nakhon chai si district	Nan
อำเภอท่าวุ้ง	tha wung district	Nan
อำเภอท่าวังผา	tha wang pha district	Nan
อำเภอท่าตูม	tha tum district	Nan
อำเภอบัวเชด	buachet district	Nan
ส่วนส่งกำลังบำรุง	logistiek gedeelte	Nan
อำเภอปราสาท	prasat district	Nan
อำเภอปากพนัง	pak phanang-district	Nan
อำเภอราษีไศล	rasi salai-district	Nan
อำเภอรัตนบุรี	rattanaburi district	Nan
อำเภอรหัสไปรษณีย์หมายเหตุ	district, postcode, opmerking	Nan
อำเภอยางชุมน้อย	yang chum noi district	Nan
อำเภอภูสิงห์	phu sing district	Nan
อำเภอพุทธมณฑล	phutthamonthon district	Nan
อำเภอปากช่อง	pak chong-district	Nan
อำเภอพิปูน	phipun district	Nan
อำเภอพลับพลาชัย	phlapphla chai-district	Nan
อำเภอพระสมุทรเจดีย์	district phra samut chedi	Nan
อำเภอพระพรหม	phra phrom district	Nan
อำเภอพระประแดง	phra pradaeng district	Nan
อำเภอฝาง	fang district	Nan
อำเภอปาย	pai district	Nan
อำเภอพัฒนานิคม	phatthana nikhom district	Nan
เกียวโตะ	kyoto	Nan
ส่วนสูง	hoogte	None
ส่วนของผู้ถือหุ้น	eigen vermogen	Nan
วิลเลียม	william	None
วิลเลี่ยม	william	None
วิวัฒนาการ	evolutie	None
วิวัฒน์	evolueren	Nan
วิวัฒน์เกียรติ	wiwat kiat	Nan
วิศว	engineering	Nan
วิศวกร	ingenieur	None
วิศวกรรมวัสดุ	materiaaltechniek	Nan
วิศวกรรมสิ่งแวดล้อม	milieutechniek	Nan
วิศวกรรมเครื่องกล	machinebouw	Nan
วิศวกรรมไฟฟ้า	elektrotechniek	Nan
วิสา	wisisa	Nan
วิสูตร	diagnostisch	Nan
วิหาร	heiligdom	Nan
วิเศษ	magie	Nan
วิเศษแก้ว	magisch glas	Nan
วิโนทัย	vinothai	Nan
ศรีนครินทร์	srinakarin	Nan
ศรายุทธ	sarayuth	Nan
ศรชัย	sornchai	Nan
ศร	pijl	Nan
ศ	prof	None
ว้าวุ่น	afgeleid	None
วิลเลจ	dorp	None
วุฒิเมธี	wuttimethi	Nan
วีออส	vios	Nan
วีระยุทธ	wirayut	Nan
วีระ	veera	Nan
วีรบุรุษ	held	None
วีดีโอเกม	videospel	Nan
วีดีโอ	video	None
วุฒิสภา	senaat	None
ศรีนวล	srinual	Nan
วิลลี่	willy	None
วิบูลย์	vaarwel	Nan
วิตามินอี	vitamine e	Nan
วิทยาการคอมพิวเตอร์	computertechnologie	Nan
วิทยาการระบาด	epidemiologie	Nan
วิทยาลัยการจัดการเพื่อการพัฒนา	college of management for development	Nan
วิทยาลัยการบริหารรัฐกิจ	college van openbaar bestuur	Nan
วิทยาลัยครูสวนสุนันทา	suan sunandha teacher college	Nan
วิทยาลัยดุริยางคศิลป์	college of music	Nan
วิทยาลัยนวัตกรรมและการจัดการ	college van innovatie en management	Nan
วิทยาลัยพยาบาลกองทัพเรือ	naval nursing college	Nan
วิทยาลัยพยาบาลบรมราชชนนี	boromarajonani college of nursing	Nan
วิทยาลัยพาณิชยศาสตร์	college of commerce	Nan
วิทยาลัยวิชาการศึกษา	onderwijscollege	Nan
วิทยาลัยเทคนิคธนบุรี	thonburi technical college	Nan
วิทยาลัยแพทยศาสตร์พระมงกุฎเกล้า	phramongkutklao college of medicine	Nan
วิทยาศาสตรมหาบัณฑิต	master of science	Nan
วิทยาศาสตร์สุขภาพ	gezondheidswetenschap	Nan
วิทยาศาสตร์และเทคโนโลยี	wetenschap en technologie	Nan
วินเนอร์	winnaar	None
วินัย	discipline	None
วินชี	vinci	None
วิธีการหาความสัมพันธ์	hoe relaties te vinden	Nan
วิทยุ	radio	None
วิทยาเขตเฉลิมพระเกียรติ	chaloem phrakiat campus	Nan
วิมเบิลดัน	wimbledon	None
วิทยาเขตหนองคาย	nong khai campus	Nan
วิทยาเขตสุพรรณบุรี	suphanburi campus	Nan
วิทยาเขตสารสนเทศเพชรบุรี	phetchaburi information technology campus	Nan
วิทยาเขตพิษณุโลก	phitsanulok campus	Nan
วิทยาเขตนครศรีธรรมราช	nakhon si thammarat campus	Nan
วิทยาเขตกาญจนบุรี	kanchanaburi campus	Nan
วิทยาเขต	campus	None
วิทยาเขตสุรินทร์	surin campus	Nan
วิดีโอเกม	videospel	Nan
ศรีบุญเรือง	sri bunrueang	Nan
ศรีปาน	sri pan	Nan
ศึกษาศาสตร์	opleiding	None
ศุกลวัฒน์	sukonwat	Nan
ศุภกิจ	supakit	Nan
ศุภณัฐ	suphanat	Nan
ศูนย์	centrum	None
ศูนย์การค้า	winkelcentrum	None
ศูนย์การบินทหารบก	army aviation center	Nan
ศูนย์การศึกษาแม่ฮ่องสอน	mae hong son education center	Nan
ศูนย์คอมพิวเตอร์	computer centrum	Nan
ศูนย์ค้าส่ง	groothandel center	Nan
ศูนย์บริการวิชาการ	academisch servicecentrum	Nan
ศูนย์ภาษา	taal centrum	Nan
ศูนย์รังสิต	rangsit center	Nan
ศูนย์ลำปาง	lampang center	Nan
ศูนย์แพทยศาสตรศึกษาชั้นคลินิก	clinical medicine education center	Nan
สก	schroef	Nan
สกว	trf	Nan
สง่าพล	elegant	Nan
สงครามเย็น	koude oorlog	Nan
สงครามเกาหลี	koreaanse oorlog	Nan
สงครามอวกาศ	ruimteoorlog	Nan
สงครามมหาเอเชียบูรพา	de grote oorlog in oost-azië	Nan
สงครามครูเสด	kruistocht	None
ศึกนันทบุเรง	nanthabureng battle	Nan
สงคราม	oorlog	None
สกุลเพชรหึง	petcheng	Nan
สกุลหยาดน้ำค้าง	zonnedauw	Nan
สกุล	familie	None
สกาย	lucht	None
สกอตแลนด์	schotland	None
สกอ	schotland	None
สควอโล่	squalo	Nan
ศรีประจวบ	si prachuap	Nan
ศีรษะ	hoofd	None
ศิษย์เก่าคณะรัฐศาสตร์	faculteit politieke wetenschappen alumni	Nan
ศรีมะฆะ	sri makha	Nan
ศรียาภัย	sriyapai	Nan
ศรีสวัสดิ์	srisawat	Nan
ศรีสำโรง	si samrong	Nan
ศรีเมือง	sri mueang	Nan
ศรีไพร	sri phrai	Nan
ศรเพชร	diamant pijl	Nan
ศศิธร	sasithorn	Nan
ศักดิ์ศรี	prestige	Nan
ศักย์ไฟฟ้า	elektrisch potentieel	Nan
ศัพท์	terminologie	None
ศาลชั้นต้น	burgerlijke rechtbank	Nan
ศาลหลักเมือง	city pillar shrine	Nan
ศาลเจ้าพ่อหลักเมือง	city pillar shrine	Nan
ศาสตราจารย์	professor	None
ศาสนา	religie	None
ศาสนาพราหมณ์ฮินดู	hindoeïsme	None
ศิษย์เก่าคณะมนุษยศาสตร์	faculteit geesteswetenschappen alumni	Nan
ศิลป์	kunst	None
ศิลปินแห่งชาติ	nationale kunstenaar	Nan
ศิลปะเชียงแสน	chiang saen art	Nan
ศิลปะเครื่องปั้นดินเผา	aardewerk kunst	Nan
ศิลปะเขมร	khmer art	Nan
ศิษย์เก่าคณะเศรษฐศาสตร์	faculteit der economische wetenschappen alumni	Nan
ศิลปะศรีวิชัย	srivijaya art	Nan
ศิลปะการแสดง	uitvoerende kunst	Nan
ศิลปะ	kunst	None
ศิลปอาชา	art archa	Nan
ศิริวรรณ	siriwan	Nan
ศาสนาโซโรอัสเตอร์	zoroastrianism	Nan
ศาสนาฮินดู	hindoeïsme	None
ศิลปะลพบุรี	art lopburi	Nan
สด	vers	None
วิฑูรย์	lapis lazuli	Nan
วิชิต	wichit	Nan
วง	lus	Nan
วงจรไฟฟ้า	elektrisch circuit	Nan
วงดนตรี	band	None
วงศ์กำแหง	familie	None
วงศ์ถั่ว	notenfamilie	Nan
วงศ์ปลากดทะเล	vis familie	Nan
วงศ์ปลากะรัง	tandbaars	Nan
วงศ์ปลายอดม่วง	wong pla yot muang	Nan
วงศ์ปลาหลังเขียว	groene vis	Nan
วงศ์ปลาเนื้ออ่อน	cichlid	Nan
วงศ์ปลาเสือตอ	tiger fish familie	Nan
วงศ์พัวพันธ์	wongpua phan	Nan
วงศ์วิริยะ	wiriya	Nan
วงศ์เทวัญ	familie	None
วงศ์แคหางค่าง	wong khae hang kong	Nan
วงษ์คำเหลา	wong kham lao	Nan
วงเงิน	begrenzing	Nan
วองโกเล่แฟมิลี	vongola family	Nan
วอก	aap	None
วว	dd	Nan
วรัทยา	warutya	Nan
วรรธนพิสิฐกุล	watthon phisitkun	Nan
วรรณสุทธิ์	wannasut	Nan
ล้อแม็กซ์อัลลอยขนาด	lichtmetalen wielmaten	Nan
วรรณกรรม	literatuur	None
วนิดา	wanida	Nan
วนอุทยานถ้ำจัน	tham chan forest park	Nan
วทบ	dd	Nan
วชิรบรรจง	wachirabanjong	Nan
วงแหวน	ring	None
วงเวียน	rotonde	Nan
วร	wor	Nan
วอชิงตัน	washington	None
ล้อม	in de omgeving van	Nan
ล่าทา	jacht	None
ลานจาตุรงคสันนิบาต	vierhoek	Nan
ลามิวูดีน	lamiwoodine	Nan
ลายน้ำ	watermerk	Nan
ลาว	laos	None
ลาออก	ontslag nemen	Nan
ลำดับ	bestellen	Nan
ลำดับพระปฐมวงศ์ในพระบรมราชวงศ์จักรี	orde van de genesis in de chakri-dynastie	Nan
ลำดับพระมหากษัตริย์ไทย	orde van de thaise koning	Nan
ลำตัว	koffer	Nan
ลำลูกกา	lam luk ka	Nan
ลำลูกกาคลอง	lam luk ka-kanaal	Nan
ลำไส้เล็ก	dunne darm	Nan
ลิง	aap	None
ลิซท์	liszt	Nan
ลิปปี	lip jaar	Nan
ลิพิด	lipide	Nan
ลิฟวิ่งมอลล์	living mall	Nan
ลูน่า	luna	Nan
ลูซิเฟอร์	lucifer	Nan
ลูกอัณฑะ	testikels	Nan
ลูกอม	snoep	Nan
ลูกสาว	dochter	None
ลูกปัด	kraal	Nan
ล่ำซำ	lump	Nan
ลุงบุญมีระลึกชาติ	oom boonmee herinnerend natie	Nan
ลี้	li	Nan
ลีเมอร์	lemur	Nan
ลีซอ	lisu	Nan
ลีกคัพ	league cup	Nan
ลิเทียม	lithium	Nan
ลิเก	muzikaal volksdrama	Nan
ลี้สุวรรณ	li suwan	Nan
วิญญาณ	geest	None
วอลท์	walt	None
วะสี	was ik	Nan
วันพฤหัสบดี	donderdag	None
วันพุธ	woensdag	None
วันมหาสงกรานต์	maha songkran-dag	Nan
วันละ	een dag	Nan
วันศุกร์	vrijdag	None
วันสงกรานต์	songkran day	Nan
วันสำคัญ	belangrijke dag	Nan
วันสำคัญทางพุทธศาสนา	belangrijke boeddhistische dag	Nan
วันหยุดราชการ	feestdag	None
วันอังคาร	dinsdag	None
วันอาทิตย์	zondag	None
วันอาสาฬหบูชา	asanha bucha	Nan
วันเกิด	verjaardag	None
วันเสาร์	zaterdag	None
วันแรม	dag	None
วัย	leeftijd	None
วัลลิโภดม	walliphodom	Nan
วิชาการคอม	academische computer	Nan
วิชาการ	academisch	None
วิจิตรศิลป์	beeldende kunst	Nan
วิจัย	onderzoek	None
วิคตอเรีย	victoria	None
วิกตอร์	victor	None
วันนี้ที่รอคอย	wachten vandaag	Nan
วาไรตี้	verscheidenheid	None
วาเรีย	varia	Nan
วาลีน	valine	Nan
วาลคิรี	valkyrie	Nan
วารินชำราบ	warin chamrap	Nan
วานูอาตู	vanuatu	Nan
วัสดุฟิสไซล์	splijtbaar materiaal	Nan
วาเลนไทน์	valentijnsdag	Nan
วอล์ค	wandelen	Nan
วันที่เข้าฉาย	datum van publicatie	Nan
วันที่ขึ้นเครื่องหมาย	datum ondertekenen	Nan
วัง	paleis	None
วังจันทร์	wang chan	Nan
วังสระปทุม	sra pathum-paleis	Nan
วังสะพุง	wang saphung	Nan
วังหลัง	paleis	None
วังหิน	stenen paleis	Nan
วัชรพล	watcharapol	Nan
วัฒนชัย	watthanachai	Nan
วัฒนธรรม	cultuur	None
วัฒนวิทูกูร	wattanawitkun	Nan
วัฒนา	wattana	Nan
วัดกลาง	middelgrote tempel	Nan
วัดป่าเลไลยก์วรวิหาร	wat pa lelai worawihan	Nan
วัดพระธาตุดอยสุเทพราชวรวิหาร	wat phra that doi suthep, ratchaworawihan	Nan
วัดพระฝางสวางคบุรีมุนีนาถ	wat phra fang sangkhaburi muninat	Nan
วัดพระมหาธาตุวรมหาวิหาร	wat phra mahathat woramahaviharn	Nan
วัดพระยืนพุทธบาทยุคล	wat phra yuen phutthayakhon	Nan
วันชัย	wanchai	Nan
วัน	dag	None
วัตสัน	watson	None
วัตต์	watt	Nan
วัดโพธิ์	wat pho	Nan
วัดเจดีย์หลวง	chedi luang-tempel	Nan
วันที่ออกอากาศชื่อตอนแขกรับเชิญ	uitzenddatum, afleveringsnaam, gastoptreden	Nan
วัดหน้าพระธาตุ	na phra that temple	Nan
วัดสุทัศนเทพวรารามราชวรมหาวิหาร	suthasan thep wararam tempel	Nan
วัดสองพี่น้อง	song phi nong-tempel	Nan
วัดระฆังโฆสิตาราม	rakhangkosaram-tempel	Nan
วัดพระเชตุพนวิมลมังคลารามราชวรมหาวิหาร	wat phra chetuphon vimolmangklararam ratchaworamahawihan	Nan
วัดพระศรีรัตนมหาธาตุ	wat phra si rattana mahathat	Nan
วัดพระลอย	phra loi-tempel	Nan
วัดหนองเพียร	nong phian-tempel	Nan
สตรอเบอรี่	aardbei	Nan
สตรีวิทยา	radiologie	Nan
สติปัญญา	intelligentie-	Nan
สารานุกรมไทยฉบับราชบัณฑิตยสถาน	thai encyclopedia royal institute edition	Nan
สารีวงษ์	sareewong	Nan
สาวิตรี	savitri	Nan
สาเหตุ	oorzaak	None
สำนวนเก่า	oud idioom	Nan
สำนักงานขนส่งกรุงเทพมหานครพื้นที่	bangkok area transport office	Nan
สำนักงานคณะกรรมการวัฒนธรรมแห่งชาติ	bureau van de nationale cultuurcommissie	Nan
สำนักงานโครงการพัฒนาแห่งสหประชาชาติ	bureau voor ontwikkeling van de verenigde naties	Nan
สำนักระบาดวิทยา	bureau voor epidemiologie	Nan
สำนักราชเลขาธิการ	secretariaat	Nan
สำนักวิทยบริการ	bureau voor academische middelen	Nan
สำนักหอสมุด	bibliotheek	None
สำนักหอสมุดกลาง	centrale bibliotheek	Nan
สำรวจ	enquête	Nan
สำราญ	vrolijk	Nan
สำหรับ	voor	None
สำหรับประเทศไทย	voor thailand	Nan
สินิทธา	zithitha	Nan
สินสมุทร	sin samut	Nan
สินค้าอุปโภคบริโภค	consumentengoederen	Nan
สินค้าคงเหลือ	voorraden	Nan
สิน	zonde	None
สิทธิมนุษยชน	mensenrechten	None
สารานุกรมไทย	thaise encyclopedie	Nan
สิทธิ	rechten	None
สิงหไตรภพ	singha tripop	Nan
สิงหาคม	augustus	None
สำโรง	samrong	Nan
สำเนียง	accent	None
สำหรับในปี	voor in het jaar	Nan
สำหรับใช้เป็นตราหัวหนังสือราชการไทย	te gebruiken als zegel op het thaise overheidsboekje	Nan
สิงโต	leeuw	None
สิปปภาค	zippy region	Nan
สารละลาย	oplossing	None
สารพฤกษเคมี	fytochemie	Nan
สาขาวิชาเคมี	afdeling chemie	Nan
สาขาวิชาเทคโนโลยีชีวภาพ	biotechnologieprogramma	Nan
สาขาวิชาเศรษฐศาสตร์	economie	None
สาขาศิลปะสถาปัตยกรรม	kunst architectuur	Nan
สาขาสมุย	samui branch	Nan
สาขาหัวหิน	hua hin branch	Nan
สาครสินธุ์	sakorn sin	Nan
สาทร	sathorn	Nan
สาธารณรัฐประชาชนจีน	volksrepubliek china	Nan
สาธารณรัฐออสเตรีย	republiek oostenrijk	Nan
สาธารณรัฐอินโดนีเซีย	republiek indonesië	Nan
สาธารณรัฐเช็ก	tsjechische republiek	Nan
สาธารณรัฐโดมินิกัน	dominicaanse republiek	Nan
สานติวัตร	santiwat	Nan
สามก๊ก	drie koninkrijken	Nan
สามชัย	sam chai	Nan
สามชุก	sam chuk	Nan
สารต้านอนุมูลอิสระ	antioxidanten	Nan
สายเมืองทอง	mueang thong line	Nan
สายเดียว	enkele lijn	Nan
สายหมอก	mist	None
สายสีม่วง	paarse lijn	Nan
สายสีน้ำเงิน	blauwe lijn	Nan
สารภี	saraphi	Nan
สายสีชมพู	roze lijn	Nan
สายรุ้ง	regenboog	Nan
สายรัชกาลที่	laat regeren	Nan
สายการบิน	luchtvaartmaatschappijen	Nan
สามัญ	gewoon	None
สามอัศวินในจินตนาการ	drie fantasieridders	Nan
สามพราน	sampran	Nan
สายสนั่น	donderlijn	Nan
สาขาวิชาศิลปอุตสาหกรรม	kunst afdeling	Nan
สิเรียม	sirium	Nan
สิ่งมีชีวิต	levende wezens	Nan
สุปรีย์	supri	Nan
สุพจน์	suphot	Nan
สุพล	supon	Nan
สุมณทิพย์	sumonthip	Nan
สุรชาติ	surachat	Nan
สุรพล	surapon	Nan
สุรพันธ์	suraphan	Nan
สุรวุฒิ	surawut	Nan
สุรศักดิ์	surasak	Nan
สุรัสวดี	surasawadee	Nan
สุราษฎร์ธานี	surat thani	Nan
สุรินทร์	surin	Nan
สุริยัน	suriyan	Nan
สุริโยไท	suriyothai	Nan
สุลต่าน	sultan	None
สุวนันท์	suwanan	Nan
สุวรรณรัฐ	suwannarat	Nan
ส่งเสริม	promoten	None
สไตล์การเล่น	speel stijl	Nan
สไตรค์	staking	None
สเปน	spanje	None
สเตเดี้ยม	stadion	None
สเตอรอล	sterol	Nan
สุนัขจิ้งจอก	de vos	Nan
สเตราส์	strauss	Nan
สูงจากระดับน้ำทะเลปานกลาง	hoog boven zeeniveau	Nan
สูง	hoog	None
สุ่น	zon	None
สุโขทัย	sukhothai	Nan
สุเทพ	suthep	Nan
สุวรรณานนท์	suwannanon	Nan
สู่	naar	None
สิ่ง	ding	Nan
สุนทรเวช	sunthornwet	Nan
สุนทร	sunthorn	Nan
สิ่งเสพติด	drug	None
สิ้นพระชนม์ในรัชกาลที่	overleden in het bewind van	Nan
สี	kleur	None
สีขาว	witte kleur	Nan
สีดำ	zwarte kleur	Nan
สีน้ำตาล	bruine kleur	Nan
สีน้ำเงิน	blauw	None
สีฟ้า	blauw	None
สีม่วง	purper	Nan
สีลม	windmolen	Nan
สึนะ	tsuna	Nan
สึนะโยชิ	tsunayoshi	Nan
สืบต่อมา	erven	Nan
สื่อสารมวลชน	massa communicatie	Nan
สื่อสิ่งพิมพ์	drukwerk	Nan
สุกิจ	sukit	Nan
สุขภาพ	gezondheid	None
สุธี	geleerde	None
สุทัศน์	suthat	Nan
สุทัศนะจินดา	sutasachinda	Nan
สุทธิชัย	sutthichai	Nan
สุดารัตน์	sudarat	Nan
สุดสาคร	sudsakorn	Nan
สุนทรภู่	sunthorn phu	Nan
สุดท้ายตายด้วยฝีมือ	sterf tenslotte door vaardigheid.	Nan
สุจาริณี	sucharinee	Nan
สุจริตกุล	sucharitkun	Nan
สุครีพ	sukree	Nan
สุขุมวิท	sukhumvit	Nan
สุขาภิบาล	sanitair	Nan
สุขสวัสดิ์	suksawat	Nan
สุชิน	suchin	Nan
สาขาวิชาวิศวกรรมอิเล็กทรอนิกส์	elektronisch engineeringprogramma	Nan
สาขาวิชาวิศวกรรมอาหาร	levensmiddelentechniek	Nan
สาขาวิชาวิศวกรรมคอมพิวเตอร์	computer engineering-programma	Nan
สนิม	roest	Nan
สนเกรวิลเลีย	pijnboomdruiven	Nan
สปริงฟิลด์	springfield	Nan
สปรินเตอร์	sprinter	Nan
สปาร์ค	vonk	Nan
สพ	spec	Nan
สภานิติบัญญัติแห่งชาติ	nationale wetgevende vergadering	Nan
สภาผู้แทนนิสิต	student representative council	Nan
สภาพอากาศ	het weer	Nan
สมจิตต์	somchit	Nan
สมจิตร	somchit	Nan
สมชัย	somchai	Nan
สมชาย	somchai	Nan
สมภพ	geboorte	None
สมศรี	somsri	Nan
สมศักดิ์	somsak	Nan
สมัคร	van toepassing zijn	Nan
สมเด็จพระนางเจ้าสิริกิติ์	koningin sirikit	Nan
สมเด็จพระนางเจ้ารำไพพรรณี	koningin rambhai barni	Nan
สมเด็จ	hare majesteit	Nan
สมุทวณิช	samutavanich	Nan
สมาชิกฤดูกาลที่	seizoenleden	Nan
สมาชิกรับเชิญตอนพิเศษ	leden voor speciale afleveringen uitgenodigd	Nan
สนิทวงศ์	sanit wong	Nan
สมาคมประชาชาติแห่งเอเชียตะวันออกเฉียงใต้	associatie van zuidoost-aziatische landen	Nan
สมัยสุโขทัย	sukhothai-periode	Nan
สมัยรัชกาลที่	regeren	None
สมัยที่	wanneer	None
สมัยก่อนประวัติศาสตร์	prehistorische tijden	Nan
สมัยกรุงธนบุรี	thonburi-periode	Nan
สมัย	periode	None
สมัยอาณานิคมฝรั่งเศส	franse koloniale periode	Nan
สมเด็จพระนางเจ้าฯ	hare majesteit	Nan
สนามไฟฟ้า	elektrisch veld	Nan
สนามฟุตบอล	voetbalveld	Nan
สตึก	satun	Nan
สตูดิโอ	de studio	Nan
สถานที่ท่องเที่ยวทางธรรมชาติ	natuurlijke attracties	Nan
สถานะ	toestand	None
สถานีคาราวาน	caravan station	Nan
สถานีวิทยุโทรทัศน์ไทยทีวีสีช่อง	thaise televisiestations met kleurentelevisiekanalen	Nan
สถานีโทรทัศน์ไทยพีบีเอส	thaise pbs televisiezender	Nan
สถาบัน	instelling	None
สถาบันการศึกษา	onderwijsinstelling	Nan
สถาบันบัณฑิตพัฒนบริหารศาสตร์	nationaal instituut voor ontwikkelingsbeheer	Nan
สถาบันพระบรมราชชนก	koninklijk instituut	Nan
สถาบันวิจัยจุฬาภรณ์	chulabhorn research institute	Nan
สถาบันวิจัยและพัฒนา	onderzoeks- en ontwikkelingsinstituut	Nan
สถาบันศูนย์และหน่วยงานในมหาวิทยาลัย	instellingen, centra en afdelingen van universiteiten	Nan
สถาบันสมทบ	geassocieerde instelling	Nan
สถาบันอาชีวศึกษา	beroepsinstituut	Nan
สถาบันอุดมศึกษา	hoger onderwijs instituut	Nan
สนามชัยเขต	sanam chai khet	Nan
สนามกีฬากลาง	centraal stadion	Nan
สนธิไชย	sonthichai	Nan
สนธิ	knooppunt	None
สนธยา	schemering	Nan
สธ	sth	Nan
สนามแม่เหล็ก	magnetisch veld	Nan
สถิติศาสตร์	statistieken	None
สถาปนิก	architect	None
สถาบันโภชนาการ	instituut voor voeding	Nan
สถาบันเทคโนโลยีราชมงคล	rajamangala institute of technology	Nan
สถาบันเทคโนโลยีพระจอมเกล้าเจ้าคุณทหารลาดกระบัง	king mongkut&#39;s institute of technology ladkrabang	Nan
สถาบันเทคโนโลยีพระจอมเกล้า	king mongkut&#39;s institute of technology	Nan
สถาบันเทคโนโลยีนานาชาติสิรินธร	sirindhorn international institute of technology	Nan
สถาปัตยกรรมไทย	thaise architectuur	Nan
สมเด็จพระบรมราชาที่	de koning	Nan
สมเด็จพระบรมโอรสาธิราช	kroonprins	None
สมเด็จพระบรมโอรสาธิราชฯ	kroonprins	None
สะเดา	neem	Nan
สัจธรรม	waarheid	None
สัญญา	contract	None
สัญลักษณ์ประจำมหาวิทยาลัย	logo van de universiteit	Nan
สัดส่วน	proportie	Nan
สัตว์	dier	None
สัตว์มีกระดูกสันหลัง	gewervelde dieren	Nan
สัตว์มีแกนสันหลัง	wervelkolom	Nan
สัตว์เลี้ยงลูกด้วยน้ำนม	zoogdieren	None
สัตว์เลื้อยคลาน	reptiel	Nan
สัตว์เลื้อยคลานในอันดับนี้	reptielen in deze rang	Nan
สัทศาสตร์	fonetiek	Nan
สันติ	vrede	None
สันติสุข	vrede	None
สัมผัสนอก	extern rijm	Nan
สัมพันธ์	verhoudingen	None
สัมมา	rechtsaf	Nan
สาขาวิชาวิทยาการคอมพิวเตอร์	computerwetenschappelijk programma	Nan
สาขาวิชารัฐประศาสนศาสตร์	ministerie van openbaar bestuur	Nan
สาขาวิชาบริหารธุรกิจ	bedrijfskundig programma	Nan
สาขาวิชานิติศาสตร์	faculteit der rechtsgeleerdheid	Nan
สาขาลำปาง	lampang branch	Nan
สาขาย่อย	subtak	Nan
สะล้อ	rem	Nan
สาขามนุษยศาสตร์	geesteswetenschappen	Nan
สาขาปราจีนบุรี	prachinburi branch	Nan
สาขาประจวบคีรีขันธ์	prachuap khiri khan branch	Nan
สาขานิเทศศาสตร์	communicatie arts	Nan
สาขานครสวรรค์	nakhon sawan branch	Nan
สาขานครราชสีมา	nakhon ratchasima branch	Nan
สาขา	afdeling	None
สาขาพิษณุโลก	phitsanulok branch	Nan
สะตอ	sato	Nan
สะดวก	gemakkelijk	None
สอยดาว	uppercut	Nan
สร้าง	creëren	None
สราวุธ	sarawut	Nan
สรรพสินค้า	warenhuis	Nan
สร	creëer	Nan
สยามพารากอน	siam paragon	Nan
สยามบรมราชกุมารี	siam	Nan
สลักใจ	indruk maken	Nan
สยามดารา	siam dara	Nan
สมเด็จพระเจ้าภคินีเธอ	hare koninklijke hoogheid	Nan
สมเด็จพระเจ้ากรุงธนบุรี	krung thon buri	Nan
สมเด็จพระอนุชาธิราช	somdej anuchatthirat	Nan
สมเด็จพระศรีนครินทราบรมราชชนนี	zkh prinses maha chakri sirindhorn	Nan
สมเด็จพระรามาธิบดีที่	koning rama v	Nan
สมเด็จพระมหิตลาธิเบศร	somdet phra mahidol latibes	Nan
สมเด็จพระเจ้าลูกเธอ	hare koninklijke hoogheid	Nan
ส่วนต่อขยายบางซื่อท่าพระ	verlenging bang sue tha phra	Nan
สวนดุสิตโพล	suan dusit poll	Nan
สวนสมเด็จพระศรีนครินทร์	somdet phra srinagarindra park	Nan
สองสาย	twee draden	Nan
สหวงษ์	sahawong	Nan
สหราชอาณาจักร	verenigd koningkrijk	Nan
สหรัฐอเมริกา	ons.	Nan
สหรัฐอาหรับเอมิเรตส์	verenigde arabische emiraten	Nan
สหพันธ์สาธารณรัฐเยอรมนี	bondsrepubliek duitsland	Nan
สวนผึ้ง	suan phueng	Nan
สส	geheim	None
สวิตเซอร์แลนด์	zwitserland	None
สวัสดีปีใหม่	gelukkig nieuwjaar	Nan
สวัสดิ์	sawat	Nan
สวรรคโลก	sawankhalok	Nan
สวรรคตหรือ	overleden	None
สวรรคต	sterven	None
สวี	suites	Nan
ลา	la	Nan
เก็กโค	checco	Nan
เขตจอมทอง	chom thong district	Nan
โชอิจิ	shoichi	Nan
โชแปง	chopin	Nan
โซน	zone	None
โซนยอชิแด	meiden generatie	Nan
โซนี่	sony	Nan
โซล	seoul	Nan
โซลดิ๊ก	soldick	Nan
โซลโซไซตี้	soul society	Nan
โซเดียม	natrium	None
โซเฟีย	sofia	None
โดจินชิ	doe jinchi	Nan
โดย	door	None
โดยคำว่า	bij het woord	Nan
โดยตรง	direct	None
โดยทรงพระกรุณาโปรดเกล้าฯ	genadig verleend door de koning	Nan
โดยที่	waar	None
โดยบ่งบอกถึงปริมาณและคุณภาพของสิ่งตีพิมพ์อิเล็กทรอนิกส์ของสถาบัน	door de kwantiteit en kwaliteit van de elektronische publicaties van de instelling aan te geven	Nan
โดเมกิ	domome	Nan
โดราเอมอนฉบับภาพยนตร์	doraemon movie edition	Nan
โดยในวันที่	door	None
โดยใช้ทางหลวงแผ่นดินหมายเลข	via de nationale snelweg	Nan
โดยใช้ชื่อว่า	bij naam	Nan
โดยเจ้าฟ้าธรรมธิเบศรไชยเชษฐสุริยวงศ์	door prins thamathibet sornchai chetchuriyawong	Nan
โชว์	laten zien	Nan
โดยสรุป	samengevat	Nan
โดยมีพระภิกษุสงฆ์นำเวียนเทียน	met een monnik die een kaarsverlichte processie leidt	Nan
โดยมีตัวอย่างบทพากย์ฉบัง	met voorbeelden van gedichten	Nan
โดยมี	met	None
โดยปกติแล้ว	normaal gesproken	Nan
โดยปกติตามวัดต่าง	meestal volgens verschillende tempels	Nan
โดยปกติ	normaal gesproken	Nan
โดยราชบัณฑิตยสถาน	door het koninklijk instituut	Nan
โดเมน	domein	None
โชคดี	succes	None
โจโจ้	jojo	Nan
แฮปปี้และชาร์ล	gelukkig en charles	Nan
แฮ็ค	hacken	Nan
โกบอล	globaal	Nan
โกร	toenemen	None
โกรกพระ	spleet	Nan
โกลด์	goud	None
โกวิท	kowit	Nan
โกโก้	cacao	None
โขน	pantomime	Nan
โคกสำโรง	khok samrong	Nan
โคนัน	conan	Nan
โคฟี	kofi	None
โครงการ	project	None
โครงการก่อสร้าง	bouwproject	Nan
โครงการนานาชาติ	internationaal project	Nan
โครงการศิลปินแห่งชาติ	nationaal kunstenaarsproject	Nan
โครงการเรียนภาษาอังกฤษแบบเข้ม	intensief engels leerprogramma	Nan
โจเซฟ	joseph	None
โจจิ	joji	Nan
โฆษิตพิพัฒน์	kosit phiphat	Nan
โฆษะ	vocalisatie	Nan
โคโทเน่ที่	kotone bij	Nan
โคแทนเจนต์	cotangent	Nan
โช	cho	Nan
โคเบะ	kobe	Nan
โคล้ด	code	None
โคลอมเบีย	colombia	None
โคล	cole	Nan
โครโมโซม	chromosoom	Nan
โคราช	korat	Nan
โครงสร้างภายใน	interne structuur	Nan
โคเคน	cocaïne	None
แฮปปี้	gelukkig	None
โต	volwassene	None
โทน	toon	None
โฟโตสเฟียร์	360 ° foto&#39;s	Nan
โมซาร์ท	mozart	Nan
โมบิลสูทกันดั้ม	mobile suit gundam	Nan
โมรา	chalcedoon	Nan
โมร็อกโก	marokkaans	Nan
โมลิบดีนัม	molybdeen	None
โมฮัมหมัด	mohammad	Nan
โมเดิร์น	modern	None
โมเต็ต	motiveren	Nan
โมเลกุล	moleculen	None
โมโคนะ	mokona	Nan
โมโนไซต์	mono-site	Nan
โยชิโนะ	yoshino	Nan
โยฮันน์	johann	None
โยเซฟ	joseph	None
โรค	ziekte	None
โรคประจำตัว	aangeboren ziekte	Nan
โรงเรียนนนทรีวิทยา	nonsi witthaya school	Nan
โรงเรียนดาราวิทยาลัย	dara college	Nan
โรงเรียนการบิน	vliegschool	Nan
โรงละคร	theater	None
โรงพยาบาลอุตรดิตถ์	uttaradit ziekenhuis	Nan
โรงพยาบาลอานันทมหิดล	anandamahidol ziekenhuis	Nan
โฟลเอ็ม	flo m	Nan
โรงพยาบาลรามาธิบดี	ramathibodi-ziekenhuis	Nan
โรงพยาบาลกรุงเทพ	bangkok hospital	Nan
โรคไต	nierziekte	Nan
โรคเกาต์	jicht	None
โรคุโด	rokudo	Nan
โรคออทิซึม	autisme	None
โรคปอดบวม	longontsteking	None
โรงพยาบาลจุฬาลงกรณ์	king chulalongkorn memorial hospital	Nan
โตชิบา	toshiba	Nan
โฟลต	vlotter	Nan
โพรทิสต์	protist	Nan
โทนะหงษา	tonahahasa	Nan
โทนี่	tony	None
โทบรามัยซิน	tobramamcin	Nan
โทมัส	thomas	None
โทรจัน	trojan	Nan
โทรลล์	trol	Nan
โทริคาบูโตะ	torikabuto	Nan
โทรโข่ง	megafoon	Nan
โน	nee	Nan
โนบิตะ	nobita	Nan
โนบิตะและอัศวินแดนวิหค	nobita en de ridder	Nan
โนรา	nora	Nan
โนะ	dino	Nan
โนเบล	nobel	Nan
โบตั๋นกลีบสุดท้าย	de laatste pioen	Nan
โบราณสถาน	archeologische site	Nan
โบอิง	boeing	None
โพนพิสัย	phon phisai	Nan
โพธิ์ศรี	phosri	Nan
โป๊	naakt	None
โปเกมอน	pokemon	Nan
โปรโมชั่น	promotie	None
โปรแกรมคอมพิวเตอร์	computerprogramma	Nan
โพแทสเซียม	kalium	Nan
โปรเจกต์พิเศษ	speciaal project	Nan
โปรตีน	eiwit	None
โปรตอน	proton	Nan
โปรดเกล้า	alstublieft	Nan
โปงลางสะออน	ponglang sa-on	Nan
โบแดง	bewonderenswaardig	Nan
โบฮีเมีย	bohemen	None
โปรเจกต์	project	None
โรงเรียนนายเรือ	marine academy	Nan
แฮช	hash	Nan
แอสซิสต์	helpen	None
แฟรี่	fee	Nan
แฟรี่เทล	sprookje	Nan
แมกนีเซียม	magnesium	Nan
แมคอินทอช	macintosh	Nan
แมนดาริน	mandarijn	Nan
แมนเชสเตอร์	manchester	None
แมว	kat	None
แมวป่า	wilde kat	Nan
แมวลายหินอ่อน	marmeren tabby	Nan
แมวไทย	thaise kat	Nan
แม็คโคร	makro	Nan
แม่	moeder	None
แม่จริม	moeder jim	Nan
แม่ชี	nonnen	Nan
แม่นาคพระโขนง	mae nak phra khanong	Nan
แม่น้ำ	rivier-	Nan
แม่น้ำชี	chi river	Nan
แลมบ์ดา	lambda	Nan
แลกเปลี่ยนโดยถือ	ruilen door vast te houden	Nan
แร็ปเปอร์	rapper	None
แรงโน้มถ่วง	zwaartekracht	None
แย้มบุญเรือง	kiezen voor verdienste	Nan
แย้มนาม	naam	None
แฟรงค์	frank	None
แยกจากคลองบางกอกใหญ่ฝั่งซ้าย	kruising van het bangkok yai-kanaal aan de linkerkant	Nan
แยกจากคลองบางกอกน้อยฝั่งซ้าย	vanaf het bangkok noi-kanaal aan de linkerkant	Nan
แยกจากคลองชักพระฝั่งซ้าย	scheid links van het chak phra-kanaal	Nan
แม่ริม	mae rim	Nan
แม่น้ำโขง	mekong rivier	Nan
แม่น้ำปิง	ping river	Nan
แม่น้ำทะเลสาบสำคัญ	belangrijke rivier van het meer	Nan
แยกจากคลองบางกอกใหญ่ฝั่งขวา	kruising van het bangkok yai-kanaal aan de rechterkant	Nan
และ	en	None
แฟมิลีที่ไปพักผ่อนที่เกาะมาเฟีย	familie gaat rusten op het maffia-eiland	Nan
แฟชั่น	mode	None
แถบ	bar	None
แทซิทัส	tasitus	Nan
แทน	staan voor	Nan
แทนเจนต์	raaklijn	Nan
แทยอน	taeyeon	Nan
แทลเลียม	thallium	Nan
แท็กซี่	taxi	None
แท็บเล็ต	tablet	Nan
แนท	nat	None
แนวความคิดที่	concept	None
แนวพระราชดำริ	koninklijk initiatief	Nan
แนสแด็ก	nasdaq	Nan
แบคทีเรีย	bacteriën	None
แบงค์	bank	None
แบทเทิลบรอลเลอร์	gevechtstanker	Nan
แบรนด์แอมบาสเดอร์	ambassadeur van het merk	Nan
แบ่งประเทศไทยออกเป็น	verdeel thailand in	Nan
แพ้	verliezen	None
แพะ	geit	Nan
แพลทฟอร์ม	platform	None
แพร่	verspreiding	None
แพน	pan	None
แพทย์	arts	None
แฟนเก่า	ex vriendin	Nan
แผลไหม้	brandwonden	Nan
แผนไพรีพินาศ	consortiumplan	Nan
แผนที่	kaart	None
แป้ง	meel	Nan
แบ่งได้เป็น	verdeeld in	Nan
แบ่งออกได้เป็น	verdeeld in	Nan
แบ่งออกเป็น	verdeeld in	Nan
แผลศักดิ์สิทธิ์	heilige wond	Nan
แอสปาร์แตม	aspartaam	Nan
และกลายเป็นอู่ข้าวอู่น้ำที่มีชื่อเสียงของไทย	en werd een beroemde graanschuur in thailand	Nan
และครอบครัว	en familie	Nan
แสงสิงแก้ว	sang singkaew	Nan
แสงเทียน	kaarslicht	Nan
แสตมป์	postzegel	Nan
แสนรัก	liefde	None
แสนโภศิก	saen phosik	Nan
แหลมสิงห์	laem sing	Nan
แหล่งท่องเที่ยว	toeristische attractie	Nan
แหล่งโบราณคดีบ้านเชียง	ban chiang archeologische site	Nan
แหวน	ring	None
แหวนธรรมดา	effen ring	Nan
แหวนมาเล่ริง	malele ring	Nan
แห่งบันนัม	van ban nam	Nan
แห่งสหประชาชาติ	verenigde naties	Nan
แองกวิลลา	anguilla	Nan
แองเจิ้ล	engel	None
แอซิด	zuur	None
แอด	toevoegen	None
แอสกี	asci	Nan
แอลจีเรีย	algerije	None
แอล	l	Nan
แอร์ไลน์	luchtvaartmaatschappijen	Nan
แอมเวย์	amway	Nan
แอมะซอน	amazon	Nan
แสงทอง	sangthong	Nan
แอฟริกาใต้	zuid-afrika	Nan
แอนโทนี	anthony	None
แอนเนลิดา	annelida	Nan
แอนิเมชัน	animatie	Nan
แอนด์	en	None
แอนดี้	andy	None
แอนดรอยด์	android	Nan
แอฟริกา	afrika	None
และกัมพูชา	en cambodja	Nan
แสงชูโต	chuto	Nan
แวน	van	None
และคำว่า	en het woord	Nan
และจังหวัดใกล้เคียง	en nabijgelegen provincies	Nan
และดุษฎีบัณฑิต	en doctor of philosophy	Nan
และตามสภาพเศรษฐกิจและสังคม	en volgens de economische en sociale omstandigheden	Nan
และตำแหน่ง	en positie	Nan
และที่สำคัญคือ	en het belangrijkste is	Nan
และธงของต่างประเทศ	en buitenlandse vlaggen	Nan
และปัจจุบัน	en aanwezig	Nan
และพรรคฟุนซินเปค	en het funchinpec-feest	Nan
และรถไฟ	en trainen	Nan
และรัสเซีย	en rusland	Nan
และสหรัฐอเมริกา	en de verenigde staten	Nan
และสังคม	en de samenleving	Nan
และสังคมศาสตร์	en sociale wetenschappen	Nan
และสัตว์	en dieren	Nan
และสโรชา	en sarocha	Nan
และหลังจากสงครามภายใน	en na de interne oorlog	Nan
แล้วเดินเวียนรอบปูชนียสถาน	daarna liep ik door het heiligdom	Nan
และได้ปรากฏตัวตอนภาค	en verscheen in de aflevering	Nan
และในปี	en in het jaar	Nan
และโลก	en de wereld	Nan
และเรียกว่า	en belde	Nan
และเมื่อวันที่	en verder	Nan
แสงจันทร์	maanlicht	Nan
และเมืองเก่า	en de oude stad	Nan
และเป็น	en is	Nan
และเปียโน	en de piano	Nan
และอเมริกาเหนือ	en noord-amerika	Nan
และอื่น	en anderen	Nan
และอำเภอกันทรารมย์	en kanthararom district	Nan
และออกซิเจน	en zuurstof	Nan
และเป็นสมาชิกราชวงศ์	en is een lid van de koninklijke familie	Nan
โรงเรียนนายเรืออากาศ	royal thai air force academy	Nan
โรงเรียนบดินทรเดชา	bodindecha school	Nan
โรงเรียนประชานิเวศน์	prachaniwet school	Nan
ไปจนถึง	naar	None
ไปบรรจบแม่น้ำเจ้าพระยา	ga naar de chao phraya-rivier	Nan
ไปรษณีย์กาฬสินธุ์	kalasin post office	Nan
ไปรษณีย์ฉะเชิงเทรา	chachoengsao postkantoor	Nan
ไปรษณีย์นครศรีธรรมราช	nakhon si thammarat postkantoor	Nan
ไปรษณีย์ภูเวียง	phu wiang postkantoor	Nan
ไปรษณีย์ยานนาวา	yannawa postkantoor	Nan
ไปรษณีย์ร้อยเอ็ด	roi et postkantoor	Nan
ไปรษณีย์สามเสนใน	samsen nai postal office	Nan
ไปรษณีย์หนองหาน	nong han postkantoor	Nan
ไปรษณีย์อำนาจเจริญ	postkantoor amnat charoen	Nan
ไปรษณีย์อุทุมพรพิสัย	uthumphon phisai postkantoor	Nan
ไปรษณีย์อุบลราชธานี	ubon ratchathani postkantoor	Nan
ไปรษณีย์เดชอุดม	det postkantoor	Nan
ไปรษณีย์โพนพิสัย	phon phisai postkantoor	Nan
ไผ่แดง	rode bamboe	Nan
ไพฑูรย์	chrysoberyl	Nan
ไม่มีบันทึกว่าใครเป็นคนสร้าง	er is geen vermelding van wie het heeft gemaakt.	Nan
ไม่ผ่านเข้ารอบ	niet gekwalificeerd	Nan
ไม่บังคับ	optioneel	Nan
ไม่ทราบข้อมูล	onbekende informatie	Nan
ไม่ต่ำกว่า	niet minder dan	Nan
ไมโครซอฟท์	microsoft	None
ไนโตรเจน	stikstof	Nan
ไมอามี่	miami	None
ไฟร์วอลล์	firewall	Nan
ไฟนอลแฟนตาซี	final fantasy	Nan
ไฟ	brand	None
ไพศาล	expansief	Nan
ไพรวัลย์	praiwan	Nan
ไพรบึง	woud	Nan
ไมค์	mike	None
ไม่มีแขน	geen armen	Nan
ไนลอน	nylon-	Nan
ไทโรซีน	tyrosine	Nan
ไชโย	bravo!	Nan
ไซน์	sinus	None
ไซโทสเกเลตอน	zeitos gateela	Nan
ไซโปรเฮปตาดีน	sipro heptadine	Nan
ไดคลอกซาซิลลิน	daiklok sillin	Nan
ไดดาโนซีน	dinoceen	Nan
ไดอาน่า	diana	None
ไดโนเสาร์ของโนบิตะ	nobita&#39;s dinosaur	Nan
ได้	hebben	None
ได้กล่าวว่า	zei	None
ได้ดังนี้	als volgt	Nan
ได้ทูลเกล้าฯ	gepresenteerd	None
ได้มีโอกาสสร้างความสัมพันธ์อันดีต่อกัน	hebben de mogelijkheid om goede relaties met elkaar op te bouwen	Nan
ได้รับ	krijgen	None
ได้รับฉายาว่า	kreeg de bijnaam	Nan
ได้รับรางวัล	ontvang een prijs	Nan
ได้ร่วมกันในภารกิจในด้านต่าง	samen in de missie op verschillende gebieden.	Nan
ไทลื้อ	thai lue	Nan
ไทรโลจี	trilogie	None
ไทยานนท์	thaiyanon	Nan
ไทยรามา	thaise rama	Nan
ไทยพรีเมียร์ลีก	thaise premier league	Nan
ไทยทีวีสีช่อง	thais kleuren-tv-kanaal	Nan
ไนท์	nacht	None
ไทย	thais	Nan
ไต้หวัน	taiwan	None
ไต	nier	None
ได้เป็น	ga aan de slag	Nan
ได้เคลื่อนไหวตรวจสอบการทำงานของรัฐบาลกัมพูชาอย่างแข็งขัน	is actief verhuisd om het werk van de cambodjaanse regering te inspecteren	Nan
ได้สู้กับ	vochten met	Nan
ได้สำเร็จ	met succes	Nan
ไท	onafhankelijk	None
ไชยา	chaiya	Nan
ไม่ว่าจะ	of	None
ไม่แตกกิ่ง	niet vertakt	Nan
ไอโมบาย	i-mobiel	Nan
ไอโอ	io	Nan
ไฮยาซินธ์	hyacint	Nan
ไฮเดรนเยีย	hortensia	Nan
ไฮเปอร์มาร์เก็ต	hypermarkt	Nan
ไฮแจ็ค	kaping	Nan
ไฮโดรเจน	waterstof	None
๑๔	14	Nan
๑๕	15	Nan
๑๖	16	Nan
๑๘	18	Nan
๒๑	21	Nan
๒๒	22	Nan
๒๔๕๐	1907	Nan
๒๕๐๒	1962	Nan
๒๕๐๓	1963	Nan
๒๕๒๓	1980	Nan
๙	9	Nan
๖๐	60	Nan
๕	5	Nan
๔๘	48	Nan
๓	3	Nan
๒๘	28	Nan
ไอเอ	ia	Nan
๒๗	27	Nan
๒๕๕๐	2007	Nan
๒๕๔๘	2005	Nan
๒๕๔๗	2004	Nan
๒๕๓๖	2536	Nan
๒๕๓๕	1992	Nan
๒๕๓๔	1991	Nan
๒๕๕๔	2011	Nan
ไม่สามารถทำการเกษตรได้	kan niet boeren	Nan
ไอร์แลนด์เหนือ	noord-ierland	Nan
ไอพอด	ipod	Nan
ไม่ใช่	nee	Nan
ไม้	het hout	Nan
ไม้กวาด	bezem	Nan
ไม้หนีบผ้า	wasknijper	Nan
ไม้ไม่ผลัดใบ	groenblijvend	Nan
ไรงะ	riga	None
ไรโบโซม	ribosomen	Nan
ไร่	boerderij	None
ไลท์	licht	None
ไลบร้า	weegschaal	Nan
ไลฟ์สไตน์	lifstein	Nan
ไลเบรชัน	bibliotheek	None
ไวชาน่า	waichana	Nan
ไวทยางกูร	vittayangkun	Nan
ไวทยานนท์	waithayanon	Nan
ไวท์สเปล	whitespell	Nan
ไวน์	wijn	None
ไอน์สไตเนียม	einsteinium	Nan
ไอน์สไตน์	einstein	None
ไอทีวี	itv	Nan
ไหลจากลาวเข้าสู่ภาคเหนือของกัมพูชาแล้วไหลผ่านเข้าเขตเวียดนาม	stroomt van laos naar het noorden van cambodja en stroomt vervolgens naar vietnam	Nan
ไหมกัน	samen	None
ไหซอง	flirt	Nan
ไอริส	iris	Nan
ไว้ว่า	zeggen	None
ไวเวิร์น	wvern	Nan
ไวเปอร์	adder	Nan
ไวเซิร์ด	weiss	Nan
ไวรัสตับอักเสบ	hepatitis	None
ไวรัส	virus	None
ไวยากรณ์	grammatica	None
ไวโอเลต	paars	None
ไชยวัฒน์	chaiwat	Nan
ไชยยงค์	chaiyong	Nan
ไชยกิตติ	chai kitti	Nan
โอภาส	schittering	Nan
โอร์มาน	oman	Nan
โอวีเอ	ova	Nan
โอสถสภา	osotspa	Nan
โอสถานุเคราะห์	osathanugrah	Nan
โออิชิ	oishi	Nan
โอะกินะวะ	okinawa	Nan
โอเค	ok	Nan
โอเอกซ์	boter kaas en eieren	Nan
โฮม	huis	None
โฮลดิ้ง	vasthouden	None
ใจดี	soort	None
ใช่	ja!	Nan
ใช้ขยายความเฉพาะบุคคล	gebruik om te personaliseren	Nan
ใช้ชื่อว่า	genaamd	None
ใช้เวลา	neem de tijd	Nan
ใต้	onder	None
ในช่วงหลัง	later	None
ในช่วงสงครามโลกครั้งที่สอง	tijdens de tweede wereldoorlog	Nan
ในช่วงสงครามโลกครั้งที่	tijdens de wereldoorlog	Nan
ในช่วงสงครามเย็น	tijdens de koude oorlog	Nan
ในช่วงปี	tijdens het jaar	Nan
ในชิงร้อยชิงล้าน	in de ching ching million	Nan
โอบามา	obama	None
ในคศ	in het jaar	Nan
ในขณะที่	terwijl	None
ในกาลต่อมา	in de toekomst	Nan
ในการเลือกตั้ง	bij de verkiezingen	Nan
ในการประเมินผลงานวิจัยของสถาบัน	bij het evalueren van de onderzoeksresultaten van het instituut	Nan
ในกลุ่ม	in groep	Nan
ในกรณีนี้	in dit geval	Nan
ในคริสต์ศตวรรษที่	in de 19de eeuw	Nan
ในช่วงแรก	in het begin	Nan
โอกาส	kans	None
โหมด	modus	Nan
โรงเรียนปรินส์รอยแยลส์วิทยาลัย	prince royal&#39;s college	Nan
โรงเรียนพระตำหนักสวนกุหลาบ	suan kularb tamnak school	Nan
โรงเรียนมัธยมสาธิตวัดพระศรีมหาธาตุ	middelbare school demonstratie van wat phra si mahathat	Nan
โรงเรียนมารีวิทย์	mary wit school	Nan
โรงเรียนยุพราชวิทยาลัย	yupparat wittayalai school	Nan
โรงเรียนราชินีบน	upper queen school	Nan
โรงเรียนวัฒโนทัยพายัพ	watthanothai payap school	Nan
โรงเรียนศึกษานารี	naree school of education	Nan
โรงเรียนสาธิต	demonstratieschool	Nan
โรงเรียนสาธิตแห่งมหาวิทยาลัยเกษตรศาสตร์	kasetsart university demonstration school	Nan
โรงเรียนห้องสอนศึกษา	school lesruimte	Nan
โรงเรียนเขมะสิริอนุสสรณ์	khemasiri anusorn school	Nan
โรงเรียนเจ้าพระยาวิทยาคม	chao phraya witthayakhom school	Nan
โรงเรียนเฉลิมพระเกียรติสมเด็จพระศรีนครินทร์	chaloem phrakiat somdet phra srinagarindra school	Nan
โรงเรียนเทศบาล	openbare school	Nan
โรงเรียนไตรมิตรวิทยาลัย	traimit wittayalai school	Nan
โรงแรม	hotel	None
โสภณ	lief	Nan
โสน	sesbania	Nan
โสณกุล	sonakul	Nan
โลโซ	loso	Nan
โลงหิน	sarcofaag	Nan
โลกแอมะซอน	amazon world	Nan
โหม่ง	pakt aan	Nan
โลก	wereld	None
โรส	roos	None
โรลเลอร์เบลด	rolblad	Nan
โรมัน	roman	None
โรม	rome	None
โรตารี	roterend	Nan
โรจูโร่	rojero	Nan
โรเจอร์	roger	None
ในดาร์ฟูร์	in darfur	Nan
ในต่างประเทศ	in het buitenland	Nan
ในทางกลับกัน	anderzijds	None
ในอัลบั้ม	in het album	Nan
ในเกมเดอะซิมส์	in het sims-spel	Nan
ในเครือ	aangesloten	None
ในเดือน	in de maand	Nan
ในเดือนมิถุนายน	in juni	Nan
ในเดือนมีนาคม	in maart	Nan
ในเบื้องต้น	aanvankelijk	None
ในเรื่อง	met betrekking tot	Nan
ในเหตุการณ์	in het geval	Nan
ในเอเชียตะวันออกเฉียงใต้	in zuidoost-azië	Nan
ในแฮร์รี่	harry	None
ในโอกาสครบรอบ	ter gelegenheid van het jubileum	Nan
ใบเสมา	kantelen	Nan
ใหญ่	groot	None
ให้พลเอกเปรม	voor general prem	Nan
ให้สมเด็จพระเทพรัตนราชสุดาฯ	voor zkh prinses maha chakri sirindhorn	Nan
ให้เสียงพากย์	stemacteren	Nan
ไคเอ็น	kaien	Nan
ไข้หวัดใหญ่สเปน	spaanse griep	Nan
ไข้หวัดใหญ่สายพันธุ์ใหม่	nieuwe griepstam	Nan
ไข้สูง	hoge koorts	Nan
ไข้รากสาดใหญ่	tyfus	Nan
ไข่	ei	None
ในอดีตทุ่งกุลาร้องไห้ในฤดูแล้ง	in het verleden huilde thung kula in het droge seizoen.	Nan
ไขสันหลัง	merg	Nan
ไก่	kip	None
ไกลกังวล	zich zorgen maken	Nan
ไกรลาศ	krailat	Nan
ไกรทอง	krai string	Nan
ให้ใช้หลัก	gebruik het principe	Nan
ให้แก่ประชาชน	aan de mensen	Nan
ไขมัน	vet	None
ในอดีต	in het verleden	Nan
ในหนังสือ	in het boek	Nan
ในสหรัฐอเมริกา	in de verenigde staten	Nan
ในพระบาทสมเด็จพระพุทธเลิศหล้านภาลัย	in zijne majesteit de koning, phra buddha lertlah, napalai	Nan
ในพระบาทสมเด็จพระพุทธยอดฟ้าจุฬาโลก	in de regering van koning boeddha yodfa chula lok	Nan
ในปีเดียวกันนั้น	in datzelfde jaar	Nan
ในปีเดียวกัน	in hetzelfde jaar	Nan
ในปีพุทธศักราช	in het jaar.	Nan
ในปีพศ	in het jaar	Nan
ในภายหลัง	later	None
ในปีนี้	dit jaar	Nan
ในปี	in het jaar	Nan
ในปลายปี	aan het einde van het jaar	Nan
ในประเทศญี่ปุ่น	in japan	Nan
ในบางฉบับ	in sommige edities	Nan
ในทางตรงกันข้าม	integendeel	Nan
ในทางดาราศาสตร์	in de astronomie	Nan
ในปีที่	in het jaar	Nan
แต่ไม่สำเร็จ	maar zonder succes	Nan
ในภาษาสันสกฤต	in het sanskriet	Nan
ในภาษาอิตาลี่	in italiaans	Nan
ในสมัยรัชกาลที่	tijdens het bewind van	Nan
ในสมัยพุทธกาล	in de moderne tijd	Nan
ในสมัยก่อน	vroeger	None
ในสมัยกรุงศรีอยุธยา	in de ayutthaya-periode	Nan
ในฤดูกาล	in het seizoen	Nan
ในรัฐบาล	bij de overheid	Nan
ในภาษาอังกฤษ	in engels	Nan
ในรัชสมัยพระบาทสมเด็จพระจอมเกล้าเจ้าอยู่หัว	tijdens het bewind van koning mongkut	Nan
ในระหว่างปี	tijdens het jaar	Nan
ในระยะหลัง	de laatste tijd	Nan
ในระบบสุริยะ	in het zonnestelsel	Nan
ในยุคแรก	in het begin	Nan
ในยุคกลาง	in de middeleeuwen	Nan
ในภาษาไทย	in het thais	Nan
ในระหว่างวันที่	tijdens de dag	Nan
เขตคลองสาน	khlong san district	Nan
แต่ไม่ประสบความสำเร็จ	maar zonder succes	Nan
แต่ใน	maar in	Nan
เทริโอ	therio	Nan
เทวดา	engel	None
เทวรูป	idool	Nan
เทศบาล	de gemeente	Nan
เทศบาลนครขอนแก่น	khon kaen gemeente	Nan
เทศบาลนครนครราชสีมา	nakhon ratchasima	Nan
เทศบาลนครนครศรีธรรมราช	nakhon si thammarat	Nan
เทศบาลนครเชียงราย	gemeente chiang rai	Nan
เทศบาลนครเชียงใหม่	gemeente chiang mai	Nan
เทศบาลเมืองชัยภูมิ	chaiyaphum gemeente	Nan
เทศบาลเมืองบุรีรัมย์	buriram	Nan
เทศบาลเมืองมหาสารคาม	maha sarakham gemeente	Nan
เทศบาลเมืองมุกดาหาร	mukdahan gemeente	Nan
เทศบาลเมืองสกลนคร	gemeente sakon nakhon	Nan
เทศบาลเมืองหนองคาย	gemeente nong khai	Nan
เทศบาลเมืองหนองบัวลำภู	nong bua lamphu town gemeente	Nan
เทศวิศาล	expansief	Nan
เธอจะอยู่กับฉันตลอดไป	je blijft voor altijd bij me	Nan
เธอกับฉัน	jij en ik	Nan
เธรซ	thrace	Nan
เธคุนุ	ondersteuning	None
เท่านั้น	enkel en alleen	Nan
เท่ง	teng	Nan
เทพีเธมิส	godin	None
เท็นเท็น	tien tien	Nan
เทโรศาสน	tero sasana	Nan
เทเบิลเทนนิส	tafeltennis	Nan
เทียนโพธิ์สุวรรณ	thian pho suwan	Nan
เทียนเงิน	zilveren kaars	Nan
เทียนทอง	gouden kaarsen	Nan
เทิดศักดิ์	eer	None
เท็ดดี้	teddy	Nan
เธอยัง	jij nog steeds	Nan
เทพอาเตน	athen	Nan
เทพหัสดิน	god van de hemel	Nan
เดนโอเบลท์	denobelt	Nan
เดย์	dag	None
เดอะซิมส์	de sims	Nan
เดอะฮาเดส	de hades	Nan
เดอะฮาเดสแชปเตอร์	het hades-hoofdstuk	Nan
เดิม	oud	None
เดิมชื่อ	vroeger	None
เดิมที	oorspronkelijk	None
เดิมเรียกว่า	voorheen bekend als	Nan
เดียวกัน	dezelfde	None
เดือดทะลุจุดศูนย์	koken door het nulpunt	Nan
เดือนกุมภาพันธ์	februari	None
เดือนตุลาคม	oktober	None
เดือนตุลาคมมีฝนตกชุกที่สุด	oktober is het meest regenachtig.	Nan
เดือนธันวาคม	december	None
เดือนมกราคม	januari	None
เดือนมิถุนายน	juni	None
เทพมรณะ	dode god	Nan
เทพพิทักษ์	theppitak	Nan
เทนโจอิน	tenjo-in	Nan
เทนนิส	tennis	Nan
เทคโนโลยีสารสนเทศ	informatie technologie	Nan
เทคโนโลยี	de technologie	Nan
เทพอานูบิส	anubis	None
เทควันโด้	taekwondo	Nan
เถรวาท	leer	None
เต๋อ	naar	None
เต่า	schildpad	None
เด็กและเยาวชน	kinderen en jongeren	Nan
เด็กหญิงอายุ	oud meisje	Nan
เดือนอ้าย	maanmaand	Nan
เทคนิคอิลลูชั่น	illusion technique	Nan
เดนโอ	den o	Nan
เธอเป็นเพื่อนอาบาราอิ	ze is een vriendin van abarai.	Nan
เนย	boter	None
เปิดสอนระดับปริญญาตรี	open voor niet-gegradueerde studie	Nan
เปียงยาง	pyongyang	Nan
เปียโตร	pietro	None
เปียโน	piano	None
เปโซ	peso	Nan
เป็ด	eend	None
เป็น	zijn	None
เป็นขนมของชาวไทยมุสลิม	is een toetje van thaise moslims	Nan
เป็นครั้งแรก	de eerste keer	Nan
เป็นงานเขียนในชุด	is een werk geschreven in een set	Nan
เป็นต่อ	tegen	None
เป็นต้น	enzovoort.	Nan
เป็นต้นมา	sinds	None
เป็นต้นไม้ประจำมหาวิทยาลัย	is een boom van de universiteit	Nan
เป็นบัวในสกุล	is een lotus in het geslacht	Nan
เป็นประธาน	word president	Nan
เป็นปลาตู้สวยงาม	is een prachtige aquariumvis	Nan
เป๊ปซี่	pepsi	Nan
เป็นโฮโมโลกัสกับ	is een homoloog met	Nan
เป็นเวลา	voor	None
เป็นเมืองหลวง	is de hoofdstad	Nan
เป็นเจ้าเมืองปกครอง	gouverneur	None
เป็นเครื่องหมายแสดงว่า	het is een teken dat	Nan
เปอร์โตริโก้	puerto rico	Nan
เป็นอาวุธ	als wapen	Nan
เป็นหัวหน้าพรรค	partijleider	Nan
เป็นหนึ่งใน	is een van	Nan
เป็นสีประจำ	normale kleur	Nan
เป็นวิญญาณเทียมเพศชาย	is een mannelijke kunstmatige geest	Nan
เป็นพ่อของ	is de vader van	Nan
เป็นพระราชโอรสพระองค์เดียวในพระบาทสมเด็จพระปรมินทรมหาภูมิพลอดุลยเดช	is de enige zoon van koning bhumibol adulyadej	Nan
เป็นอดีตหัวหน้าหน่วยที่	is een voormalig leider van de eenheid	Nan
เนกิ	negi	Nan
เปอร์เซีย	perzië	None
เปลื้อง	afstoten	Nan
เนรมิต	uitvinden	Nan
เนะ	rechtsaf	Nan
เนื่องจาก	sinds	None
เนื่องจากประเทศเหล่านั้นอยู่ในตำแหน่งบนโลกที่ต่างไปจากประเทศไทย	omdat ze zich op een andere positie op aarde bevinden dan thailand	Nan
เนื้อที่	oppervlakte	None
เนื้อที่ประมาณ	geschatte oppervlakte	Nan
เนื้อร้อง	teksten	None
เนื้อเรื่องย่อ	overzicht	None
เนเธอร์แลนด์	nederland	None
เนโกะ	neko	Nan
เน็น	nen	Nan
เบจิต้า	bechita	Nan
เบธเลเฮม	bethlehem	Nan
เบนจามิน	benjamin	None
เบรกมา	breken	None
เบริธ	berith	Nan
เบลเฟกอล	bellegal	Nan
เปลี่ยนชื่อเป็น	hernoemd naar	Nan
เปลวไฟ	vlam	Nan
เปรู	peru	None
เปรี้ยว	zuur	None
เปรม	tevreden	None
เบ็นเท็น	ben 10	Nan
เปล่งพานิช	plengpanich	Nan
เบโทเฟิน	beethoven	None
เบื่ออาหาร	verveeld	Nan
เบาหวาน	diabetes	None
เบาท์	baut	Nan
เบา	licht	None
เบอร์ลิน	berlijn	None
เบส	bas	None
เบื้องหลัง	achtergrond	None
เพกาซัส	pegasus	Nan
เดนกัชเชอร์	denkucher	Nan
เดชา	dacha	Nan
เคนยา	kenia	None
เคมีไฟฟ้า	elektrochemie	Nan
เคยสู้กับโกคุเทระ	gebruikt om te vechten met gokudera	Nan
เครือข่าย	het netwerk	Nan
เครื่องขัตติยราชอิสริยาภรณ์อันมีเกียรติคุณรุ่งเรืองยิ่งมหาจักรีบรมราชวงศ์	ter herdenking van de grote eer van de chakri-dynastie	Nan
เครื่องดีด	tokkelen	Nan
เครื่องตี	klop de machine	Nan
เครื่องบิน	vliegtuigen	None
เครื่องปั้นดินเผาและเซรามิค	aardewerk en keramiek	Nan
เครื่องยนต์	motor	None
เครื่องราชอิสริยาภรณ์	insignes	Nan
เครื่องราชอิสริยาภรณ์อันเป็นที่เชิดชูยิ่งช้างเผือก	het insigne dat verheerlijkt wordt door de witte olifant	Nan
เครื่องราชอิสริยาภรณ์อันเป็นสิริยิ่งรามกีรติ	het insigne van de grote glorie van kirati	Nan
เครื่องราชอิสริยาภรณ์อันเป็นโบราณมงคลนพรัตนราชวราภรณ์	oude insignes	Nan
เครื่องสาย	snaarinstrumenten	Nan
เครื่องแต่งกาย	kostuum	Nan
เคลลี่	kelly	None
เจเน็ต	janet	None
เจี๊ยบ	kuiken	Nan
เจียะแจ	jae jae	Nan
เจสเปอร์	jesper	Nan
เจริญ	toenemen	None
เจมินี่	tweeling	None
เคน	ken	None
เจนี่	janie	Nan
เงี้ยว	kronkelig	Nan
เงินในบัญชีธนาคาร	geld op bankrekening	Nan
เงินทุน	financiering	None
เงิน	geld	None
เค้ก	taart	Nan
เคอาร์วาย	kryy	Nan
เจ	j	None
เจ็ดเทพโจรสลัด	shichibukai	Nan
เข้าเฝ้า	heb een publiek	Nan
เข้าชิงไนน์เอ็นเตอร์เทนอวอร์ดส	genomineerd voor nine entertainment awards.	Nan
เขตดุสิต	dusit	Nan
เขตที่	wijk	None
เขตบางกอกใหญ่	bangkok yai district	Nan
เขตบางซื่อ	bang sue district	Nan
เขตบางแค	bang khae	Nan
เขตปทุมวัน	pathumwan	Nan
เขตภาษีเจริญ	district phasi charoen	Nan
เขตมีนบุรี	min buri district	Nan
เขตรักษาพันธุ์สัตว์ป่า	wildreservaat	Nan
เขตรักษาพันธุ์สัตว์ป่าภูหลวง	phu luang wildlife sanctuary	Nan
เขตลาดกระบัง	lat krabang	Nan
เขตวังทองหลาง	wang thonglang district	Nan
เขตวัฒนา	wattana district	Nan
เขตสวนหลวง	suan luang district	Nan
เขตสาทร	sathon	Nan
เขตห้วยขวาง	huai khwang	Nan
เขตเลือกตั้งที่	borough	Nan
เข้าฉาย	laten zien	Nan
เข่า	knie	Nan
เข็มอัปสร	naald	Nan
เข็มศิลปวิทยา	needle arts	Nan
เขื่อนแม่งัดสมบูรณ์ชล	mae ngad somboon chon dam	Nan
เขื่อนลำปาว	lampao dam	Nan
เข้ารอบ	finalist	Nan
เขื่อนป่าสักชลสิทธิ์	pasak chonlasit dam	Nan
เขี้ยวพิษ	giftige giftanden	Nan
เขียนโดย	geschreven door	Nan
เขียนว่า	schrijf dat op	Nan
เขาทราย	khao sai	Nan
เขากล่าวว่า	hij zei	Nan
เขมนิจ	imperious	Nan
เขื่อนกิ่วลม	kio wind dam	Nan
เดธโน้ต	overlijdensbericht	Nan
เจ็บ	zeer	None
เจ้าจอม	meester	None
เชียงใหม่	chiang mai	Nan
เชี่ยววงศ์กุล	chiewwongkun	Nan
เชื่อมต่อกับรถไฟฟ้ามหานคร	verbonden met de mrt	Nan
เชื่อมแม่น้ำท่าจีน	verbind de tha chin-rivier.	Nan
เชื้อชาติ	ras	None
เชื้อรา	de schimmel	Nan
เช็ค	controleren	None
เช่นกัน	ook	None
เช่นเดียวกัน	hetzelfde	None
เช้ามืดวันที่	de dageraad	Nan
เช้าวันรุ่งขึ้น	de volgende ochtend	Nan
เซกิ	seki	Nan
เซน	zen	Nan
เซนทอร์	centaur	Nan
เซบาสเตียน	sebastian	None
เซฟ	sparen	Nan
เซลล์	cel	None
เดคลิเนชัน	decloration	Nan
เณร	neofiet	Nan
เซ็นเซอร์	de sensor	Nan
เซ็นทารา	centara	Nan
เซ็นทรัล	centraal	None
เซ็กส์	seks	None
เชียงราย	chiang rai	Nan
เซโรไลเนอร์	seroliner	Nan
เซโรกัชเชอร์	sero kutcher	Nan
เซอวิวาสแตติน	cervivastin	Nan
เซอร์เบีย	servië	None
เซอร์วิส	onderhoud	None
เซอร์	meneer	None
เซสติโม	seto	Nan
เซโรนอส	seronos	Nan
เจ้าของจุกนม	tepelbezitter	Nan
เชียงยืน	chiang yuen	Nan
เชียงดาว	chiang dao	Nan
เจ้าฟ้ากรมพระยานริศรานุวัดติวงศ์	prince krom phraya narisaranu, tiwong temple	Nan
เจ้าฟ้ากรมพระยานริศรานุวัติวงศ์	prins krom phraya narisara nuwatwong	Nan
เจ้าฟ้าจิตรเจริญ	prins jitcharoen	Nan
เจ้าฟ้าภาณุรังษีสว่างวงศ์	prins phanurangseesawangwong	Nan
เจ้าฟ้ามหาวชิราลงกรณ	prins maha vajiralongkorn	Nan
เจ้าฟ้ามหาวชิรุณหิศ	prins mahawajirunhit	Nan
เจ้าฟ้ามหิดลอดุลยเดช	prins mahidol adulyadej	Nan
เจ้าฟ้ามหิดลอดุลเดช	prins mahidol adulyadej	Nan
เจ้าฟ้าหญิง	prinses	None
เจ้าฟ้าอุบลรัตนราชกัญญา	chaofa ubonratana rajaganya	Nan
เจ้าหนี้การค้า	crediteuren	Nan
เจ้าเมือง	gouverneur	None
เจ้าเมืองขุขันธ์	gouverneur van khukhan	Nan
เจ้าโลก	hegemonie	None
เฉพาะด้านตะวันออกเฉียงใต้เท่านั้นที่เป็นที่ราบลุ่มแม่น้ำโขง	alleen de zuidoostkant is het stroomgebied van de mekong.	Nan
เฉลิม	chalerm	Nan
เฉลิมชัย	chalermchai	Nan
เชียงของ	chiangkhong	Nan
เชียงกลาง	chiang klang	Nan
เชิดชัย	veroveren	None
เชิญยิ้ม	glimlach	Nan
เชาวราษฎร์	chaowarat	Nan
เชาวน์	intelligentie-	Nan
เชียงปุม	chiang pum	Nan
เชา	chow	Nan
เชส	jacht	None
เฉลียว	opmerkzaam	Nan
เฉลิมแสน	chalermsaen	Nan
เฉลิมพล	chalermpol	Nan
เฉลิมพระเกียรติ	eer	None
เฉลิมชัยเจริญกิจ	chalermchai charoenkit	Nan
เชอร์รี่	kers	Nan
เพชร	diamant	None
เพชรบุรี	phetchaburi	Nan
เพชรบูรณ์	phetchabun	Nan
เหล่านี้	deze	None
เหล่าสุนทร	laosonthorn	Nan
เห็นภาพลวงตา	zie de illusie	Nan
เอก	eerste	None
เอกชน	privaat	Nan
เอกซ์	x	None
เอกราช	onafhankelijkheid	None
เอกวาดอร์	ecuador	None
เอกสิทธิ์	voorrecht	Nan
เอจิเซ็น	echizen	Nan
เอชไอวี	hiv	None
เอซ	azen	Nan
เอตาสีติ	atacati	Nan
เอนจิเนียริ่ง	engineering	Nan
เอนไซม์	enzym	Nan
เอบีซี	abc	None
เอม	doel	None
เอเชียแปซิฟิก	aziatisch-pacifisch	Nan
เอเชียเหนือ	noord-azië	Nan
เอเชียตะวันตกเฉียงใต้	zuidwest-azië	Nan
เอเชีย	azië	None
เอื้อย	uri	Nan
เอี่ยมสุข	ik ben blij	Nan
เหล็ก	staal	None
เอี่ยมยิ่ง	ik ben	Nan
เอสโตเนีย	estland	None
เอสเอ็ม	sm	Nan
เอสปาด้าตกชั้น	espada degradeerde	Nan
เอสปาด้า	espada	Nan
เอล	el	None
เอริค	eric	None
เออร์โกสเฟียร์	ergosfeer	Nan
เอเชียใต้	zuid azie	Nan
เหลือสมาชิก	resterende leden	Nan
เหรียญรัตนาภรณ์	rattanaporn munt	Nan
เว้นวรรค	ruimte	None
เศรษฐกิจพอเพียง	duurzame economie	Nan
เศรษฐบุตร	sethaputra	Nan
เศรษฐศาสตร์จุลภาค	micro-economie	Nan
เศรษฐศาสตร์มหภาค	macro-economie	Nan
เสงี่ยม	netjes	Nan
เสชนะ	winnen	None
เสด็จพระราชสมภพ	koninklijke geboorte	Nan
เสนอชื่อเข้าชิงและรับรางวัล	nomineer en ontvang onderscheidingen.	Nan
เสนา	sena	Nan
เสนาเมือง	sena city	Nan
เสนีวงศ์	seni wong	Nan
เสน่ห์	charme	Nan
เสมอ	altijd	None
เสรี	vrij	None
เสรีภาพ	vrijheid	None
เสียง	geluid	None
เหรียญทอง	gouden medaille	Nan
เหรียญกษาปณ์	munt	None
เหรียญ	medaille	None
เหตุการณ์สำคัญ	belangrijke gebeurtenis	Nan
เหตุการณ์	evenement	None
เหงื่อ	zweet	Nan
เหลือง	geel	None
เส้นใย	vezel	Nan
เส้นพุ่ง	lijn	None
เส้นทแยงมุม	diagonaal	Nan
เสื้อครุย	gewaad	Nan
เสือจากัวร์	jaguar	Nan
เสียงเสียดแทรก	fricatief geluid	Nan
เสียงเปิด	open geluid	Nan
เส้นโค้ง	kromme	Nan
เว็บไซต์ซีไอเอ	cia-website	Nan
เอเธนส์	athene	None
เอเอฟซีแชมเปียนส์ลีก	afc champions league	Nan
แขวงหลวงพระบาง	luang prabang kantonrechter	Nan
แคดเมียม	cadmium	Nan
แคทแพท	cat pat	Nan
แคน	caen	Nan
แคนดี้	snoep	Nan
แคนเซอร์	kanker	None
แคม	webcams	Nan
แคมป์เบลล์	campbell	Nan
แคมเปญ	de campagne	Nan
แคมเล็ก	kleine cam	Nan
แคมใหญ่	grote camera	Nan
แคร็กเกอร์	notenkraker	Nan
แคลคูลัสเชิงปริพันธ์	integrale calculus	Nan
แคลคูลัสเชิงอนุพันธ์	differentiaalrekening	Nan
แคลอรี	calorieën	Nan
แคลิฟอร์เนีย	californië	None
แคลิฟอร์เนียม	californië	None
แต่งโดย	samengesteld door	Nan
แต่งตั้ง	aanstellen	Nan
แต่งงาน	trouwen	None
แตน	horzel	Nan
แดเนียล	daniel	None
แดนสุพรรณ	suphan	Nan
แขวงจำปาสัก	provincie champasak	Nan
แดงทั้งแผ่นดิน	hele aarde rood	Nan
แจ๊ส	jazz	None
แจ๊ค	jack	None
แจ็ค	jack	None
แจ็กสัน	jackson	None
แจ	jam	None
แคว้น	regio	None
แด	dae	Nan
เอเอฟซี	afc	None
แขน	arm	None
แก๊สธรรมชาติ	natuurlijk gas	Nan
เอ็กซ์โป	expo	Nan
เอ็กโทเดิร์ม	ecterm	Nan
เอ็กโปรพลาซ่า	expo plaza	Nan
เอ็ดดูเทนเมนท์	edutainment	Nan
เอ็ดเวิร์ด	edward	Nan
เอ็น	ligament	Nan
เอ็นบีเอ	nba	None
เอ็นเตอร์เทนเม้นท์	entertainment	None
เอ็นเทอร์เทนเมนท์	entertainment	None
เอ็มม่า	emma	None
เอ๋	eh	Nan
เฮติ	haïti	None
เฮลมุต	helmut	Nan
เฮสเตีย	hestia	Nan
เฮอร์เชล	herschel	Nan
เฮาส์	huis	None
เฮียวงะ	hyuga	Nan
แก้วบัวสาย	lotus glas	Nan
แก้วทอง	goud glas	Nan
แก้ว	glas	None
แก่	naar	None
แกแล็คซี่	heelal	None
แกะ	schapen	None
แขก	gast	Nan
แกสโทรโพดา	gastropoda	Nan
แกลง	klaeng	Nan
แกริซั่น	garnizoen	Nan
แกรมมี่	grammy	None
แกรนซ์	verlenen	None
แกมเบีย	gambia	Nan
แกง	kerrie	Nan
แกลเลอรี	galerij	None
เว็บไซต์ของเกมส์	game website	Nan
เว็บเบราว์เซอร์	webbrowser	Nan
เว็บสเตอร์	webster	Nan
เภสัชกร	apotheker	Nan
เภสัชจลนศาสตร์	farmacokinetiek	Nan
เม	mei	None
เมกา	mega	Nan
เมฆ	wolk	Nan
เมฆออร์ต	oort wolk	Nan
เมจิ	meiji	Nan
เมตร	m.	Nan
เมทริกซ์	matrix	Nan
เมทะนี	metani	Nan
เมอร์คิวรี	kwik	None
เมือง	stad	None
เมืองทองฯ	muang thong	Nan
เมืองนครราชสีมา	nakhon ratchasima	Nan
เมืองปทุมธานี	pathum thani	Nan
เมืองปราจีนบุรี	prachinburi	Nan
เมืองพิจิตร	phichit	Nan
เมื่อประมาณ	wanneer	None
เมืองใหญ่ในเขตนี้	grote steden in deze wijk	Nan
เมืองใหญ่	grote stad	Nan
เมืองโคราช	korat	Nan
เมืองเอก	ake city	Nan
เมืองเคมบริดจ์	cambridge city	Nan
เฟื่องอารมย์	foud	Nan
เมืองหลวงของอาณาจักรเขมร	hoofdstad van het khmer-rijk	Nan
เมืองสุรินทร์	surin	Nan
เมืองสิงห์	singha	Nan
เมืองสกลนคร	sakon nakhon	Nan
เมืองลำพูน	lamphun	Nan
เมืองยอง	stag stad	Nan
เมืองพิษณุโลก	phitsanulok	Nan
เมืองหลวง	hoofdstad	None
เมื่อปีพศ	vorig jaar	Nan
เฟอร์นิเจอร์	meubilair	Nan
เฟรดริก	frederick	Nan
เพชรพระอุมา	diamond phra uma	Nan
เพชรา	oude man	Nan
เพชรเกษม	petchkasem	Nan
เพดานอ่อน	zacht plafond	Nan
เพทาย	zirkoon	Nan
เพพซิน	pepsine	Nan
เพราะ	omdat	None
เพราะว่า	omdat	None
เพรียะ	piriya	Nan
เพลงประกอบภาพยนตร์	film soundtrack	Nan
เพลงประจำจังหวัด	provinciaal lied	Nan
เพลงประจำมหาวิทยาลัย	universitaire liedjes	Nan
เพลงปิดเรื่อง	cover	None
เพลงพระราชนิพนธ์	koninklijke muziek	Nan
เพลงลูกทุ่ง	country muziek	Nan
เพลงลูกทุ่งขับร้อง	country muziek	Nan
เพลงอีแซว	muziek plaagt	Nan
เฟย์	fay	Nan
เฟนิรามีน	feniramine	Nan
เพ็ชรทาย	phettha	Nan
เพื่อใช้ร่วมกับตัวชี้วัดอื่น	te gebruiken met andere indicatoren	Nan
เพื่อเป็นการเผยแผ่พระพุทธศาสนาและประชาสัมพันธ์กิจกรรมทางพระพุทธศาสนาต่าง	om het boeddhisme te verspreiden en religieuze activiteiten te promoten	Nan
เพื่อ	voor	None
เฟส	fase	None
เพียงพอ	genoeg	None
เพศชาย	mannetje	None
เพศ	seks	None
เพลโต	plato	Nan
เพลย์สเตชัน	speel station	Nan
เพลงเปิดเรื่อง	openingslied	Nan
เพลงเปิด	openingslied	Nan
เพิ่มมา	meer	None
เมื่อปีพุทธศักราช	in het jaar boeddhistisch tijdperk	Nan
เมื่อวันจันทร์	op maandag	Nan
เมื่อเดือนกันยายน	afgelopen september	Nan
เรื่อง	onderwerpen	None
เรื่องย่อ	overzicht	None
เรื่องสั้น	kort verhaal	Nan
เร้กเก้	reggae	Nan
เลข	aantal	None
เลขที่	aantal	None
เลขาธิการสหประชาชาติ	secretaris-generaal van de verenigde naties	Nan
เลนส์	de lens	Nan
เลออน	leon	None
เลิฟ	liefde	None
เลือดออกตามไรฟัน	scheurbuik	Nan
เลโอ	leo	None
เลโอนาร์โด	leonardo	None
เล็ก	klein	None
เล่ม	boek	None
เล่มที่	boek nummer	Nan
เวทีทอง	gouden podium	Nan
เว็บ	het web	Nan
เวโรนา	verona	None
เวียนเทียนรอบอุโบสถหรือสถูปเจดีย์พุทธสถานต่าง	rond de kapel of pagode	Nan
เวียงสา	wiang sa	Nan
เวียงสระ	wiang sa	Nan
เวิลด์	de wereld	Nan
เรือใบ	zeilboot	Nan
เวิร์ม	wormen	Nan
เวิร์คพอยท์	werkpunt	Nan
เวอร์โก้	vergo	Nan
เวอร์ชัน	versie	None
เวสต์	west	None
เวลาประมาณ	geschatte tijd	Nan
เวล	vail	Nan
เวิร์คพอยท์สตูดิโอ	workpoint studio	Nan
เรือเร็วโจมตี	aanval op een speedboot	Nan
เรือสำรวจ	survey schip	Nan
เรือยกพลขึ้นบก	landend schip	Nan
เรดวัน	rode dag	Nan
เรด	rood	None
เรซูเม	hervatten	Nan
เยื่อหุ้มสมอง	cortex	None
เยาวราช	chinatown	None
เยาวชนอายุ	jeugdleeftijd	Nan
เรย์	straal	None
เยาวชน	jeugd	None
เยอรมนี	duitsland	None
เยลโล่	geel	None
เย	gij	None
เม่น	stekelvarken	Nan
เม็ดขนุน	jackfruit	Nan
เมื่อเดือนมีนาคม	in maart	Nan
เยอรมัน	duitse	None
แต่ในปัจจุบัน	maar nu	Nan
เรวดี	goed nieuws	Nan
เริ่มการผลิตนำเข้า	start importproductie	Nan
เรือนนาค	naga house	Nan
เรือตรี	boot	None
เรืองศรี	rueangsri	Nan
เรืองรุ่ง	gloeiend	Nan
เรียะชอาณาจักร	koninkrijk	None
เรียวเฮ	rye hye	Nan
เราเตอร์	router	Nan
เรียวทาโร่	ryotaro	Nan
เรียล	echt	None
เรียกว่า	belde	Nan
เรียกกันว่า	belde	Nan
เริ่มตั้งแต่อาณาจักรอยุธยาได้โจมตีอาณาจักรเขมร	te beginnen met het ayutthaya-koninkrijk dat het khmer-koninkrijk aanvalt.	Nan
เริ่มจากเดือนพฤศจิกายนเมษายน	van november tot april	Nan
เริ่มก่อสร้าง	begin met bouwen	Nan
เรียว	slank	Nan
ព្រះរាជាណាចក្រកម្ពុជា	ព្រះរាជាណាចក្រ កម្ពុជា	Nan
ลัคนา	ascendant	Nan
ลักษณะสำคัญ	belangrijke kenmerken	Nan
ซากดึกดำบรรพ์	fossiel	Nan
ซาคุโร่	sakuro	Nan
ซาซางาวะ	sasagawa	Nan
ซานกัลโล	san gallo	Nan
ซาบุซะ	sabuza	Nan
ซาลาดิน	saladin	Nan
ซาอิ	sayi	Nan
ซาโลมอน	salomon	Nan
ซิกนัส	cignus	Nan
ซิงเกอร์	zanger	None
ซิงเกิ้ล	singles	None
ซิทคอม	sitcom	Nan
ซินเดอเรลล่า	assepoester	Nan
ซิมไฟลา	simphila	Nan
ซิโนไทย	sino thai	Nan
ซี	c	None
ซีซี	cc	Nan
ซึ่งมี	welke heeft	Nan
ซึ่งประกอบด้วย	bestaande uit	Nan
ซึ่ง	welke	None
ซึม	sijpelen	Nan
ซึง	welke	None
ซีโร่	nul	None
ซัลเฟต	sulfaat	Nan
ซีแคนต์	secant	Nan
ซีเซียม	cesium	Nan
ซีเจ	cj	Nan
ซีเกมส์	zee spellen	Nan
ซีสต์	cysten	Nan
ซีลีเนียม	selenium	Nan
ซีรีเบลลัม	serabellum	Nan
ซีเนม่า	bioscoop	None
ซึ่งมีความหมายว่า	wat betekent	Nan
ซัลฟาไดอะซีน	sulfadiazine	Nan
ซันไชน์	zonneschijn	Nan
ชื่อนามสกุล	voornaam achternaam	Nan
ชื่อภาษาญี่ปุ่น	japanse naam	Nan
ชื่อภาษาอังกฤษ	engelse naam	Nan
ชื่อยศภาษาไทย	thaise rang	Nan
ชื่ออัลบั้ม	albumnaam	Nan
ชื่ออื่น	andere namen	Nan
ชื่อเก่าในวงการ	oude naam in de branche	Nan
ชื่อเดิม	oude naam	Nan
ชื่อเมือง	stads naam	Nan
ชื่อเรื่อง	de titel	Nan
ชื่อเล่น	bijnaam	None
ชุดแพนเค้ก	pannenkoekenset	Nan
ชุติมา	chutima	Nan
ชุมชนออนไลน์ชาวจังหวัดสกลนคร	sakon nakhon online gemeenschap	Nan
ชุมพลบุรี	chumphon buri	Nan
ชุมแพ	chum phae	Nan
ชุมแสง	chum saeng	Nan
ซออู้	zo o	Nan
ซอมบี้	zombies	Nan
ซบที่อกฉัน	nestel me in mijn borst	Nan
ซน	ondeugend	Nan
ซ	c	None
ช้อน	lepel	Nan
ซัลฟานิลาไมด์	sulfanilamide	Nan
ช่องเชิงเทิน	kantelen	Nan
ช่วงปี	jaarperiode	Nan
ช็อกโกแลต	chocola	Nan
ชไนเดอร์	schneider	Nan
ชโย	bravo	Nan
ชูศักดิ์	chusak	Nan
ชูมันน์	schumann	Nan
ช่อง	kanaal	None
ชื่อดัง	beroemd	None
ซึ่งมีทั้งหมด	die heeft alles	Nan
ซึ่งเกิดจากปัจจัยภายนอก	veroorzaakt door externe factoren	Nan
ดอกอ้อ	reed bloem	Nan
ดอกไม้	bloem	None
ดอกไม้ประจำจังหวัด	provinciale bloem	Nan
ดอตคอม	puntcom	Nan
ดอนเมือง	don mueang	Nan
ดอยอินทนนท์	doi inthanon	Nan
ดอร์	deur	None
ดอลลาร์สหรัฐ	us dollar	Nan
ดอว์ขิ่นจี	dawin ji	Nan
ดังนั้น	zo	None
ดังเช่น	leuk vinden	Nan
ดัชนีการพัฒนามนุษย์	index voor menselijke ontwikkeling	Nan
ดัตช์	nederlands	None
ดันแฮม	dunham	Nan
ดับเบิลยู	w.	Nan
ดา	da	None
ดาบ	zwaard	None
ดาวอาร์คตุรุส	arcturus	Nan
ดาวศุกร์	venus	None
ดาวยูเรนัส	uranus	Nan
ดาวพุธ	kwik	None
ดาวพฤหัสบดี	jupiter	None
ดาวคาโนปุส	canapas	Nan
ดอก	bloem	None
ดาวกระจาย	starburst	Nan
ดาราศาสตร์รังสีเอ็กซ์	x-ray astronomie	Nan
ดาราจักร	heelal	None
ดาราคู่แรกของไทย	de eerste ster in thailand	Nan
ดารากร	acteur	None
ดารา	ster	None
ดาบเขี้ยวฟ้าฟื้น	the sword of revenge	Nan
ดาราหญิงไทยยอดนิยม	populaire thaise vrouwelijke beroemdheden	Nan
ซึ่งรู้จักกันว่า	dat staat bekend als	Nan
ดวงอาทิตย์	de zon	Nan
ดราก้อนเควสต์	dragon quest	Nan
ซึ่งเรียกว่า	wat genoemd wordt als	Nan
ซึ่งแท้จริงแล้ว	in werkelijkheid	Nan
ซึ่งได้แก่	welke zijn	Nan
ซุง	logboek	None
ซุน	zon	None
ซุปเปอร์มาร์เก็ต	supermarkt	None
ซุปเปอร์เซ็นเตอร์	super center	Nan
ซู	sue	Nan
ซูจี	suzy	Nan
ซูซูกิ	suzuki	Nan
ซูรินาเม	suriname	Nan
ซูเปอร์เซ็นเตอร์	super center	Nan
ซ่อมแซม	reparatie	Nan
ซ่าหริ่ม	wees vrolijk	Nan
ซ้าย	links	None
ฌอง	jean	None
ญ	de	None
ดราก้อน	draak	None
ดรสุชาติ	dr. suchart	Nan
ดรสาโรช	dr saroj	Nan
ดรนิพนธ์	dr. nipon	Nan
ดรทรงศักดิ์	dr songsak	Nan
ดม	geur	None
ดวงพร	fortuin	Nan
ดง	lijster	Nan
ณัฐวุฒิ	natthawut	Nan
ณัฏฐธิดา	natthida	Nan
ณรงค์	campagne	None
ณภัทร	naphat	Nan
ฐานทัพ	kantonnering	Nan
ฐานข้อมูล	de databank	Nan
ด	m	None
ดาวเคราะห์	planeet	None
ชีวสถิติ	biostatistiek	Nan
ชีวประวัติ	biografie	None
จำนวน	aantal	None
จำนวนประชากร	bevolking	None
จำปาเทศ	champa	Nan
จำเริญ	voorspoedig	Nan
จิกะไบต์	jigtes	Nan
จิตรกร	schilder	None
จิตรกรรม	schilderen	None
จิตวิทยา	psychologie	None
จิตใจ	geest	None
จินตหรา	jintara	Nan
จิบูตี	djibouti	Nan
จิบเบอเรลลิน	gibberellin	Nan
จิม	jim	None
จิโอวานนี	giovanni	None
จี	ji	Nan
จีนตัวย่อ	vereenvoudigd chinees	Nan
จียอน	jiyeon	Nan
จเพชรบูรณ์	phetchabun	Nan
จเพชรบุรี	phetchaburi	Nan
จเชียงใหม่	chiang mai	Nan
จูเนียร์	junior	None
จูเซปเป	giuseppe	Nan
จูล	joule	Nan
จำกัดมหาชน	beperkt	Nan
จุฬาลงกรณินทรวรางกูร	chulalongkorn nintharangrangkun	Nan
จุดจอมฟ้า	blauwe punt	Nan
จุดกึ่งกลาง	middelpunt	None
จุกนมสีขุ่น	ondoorzichtige speen	Nan
จึงใช้ธาตุหมอกและเมฆาได้	daarom kan het element mist en wolk worden gebruikt	Nan
จึงเปิดโอกาสให้	daarom de gelegenheid gegeven	Nan
จึงทรงพระกรุณาโปรดเกล้า	daarom genadig geordend	Nan
จุลจอมเกล้าเจ้าอยู่หัว	koning rama v	Nan
จ๊กมก	jumkum	Nan
จำกัด	ltd.	Nan
จารุเสถียร	jaru sathien	Nan
จังหวัดเพชรบูรณ์	phetchabun	Nan
จังหวัดเลย	provincie loei	Nan
จังหวัดแพร่	phrae	Nan
จังหาร	junghan	Nan
จัดขึ้นเมื่อ	hield vast	Nan
จัดตั้งขึ้นโดย	opgericht door	Nan
จัดอยู่ในภูมิภาค	georganiseerd in de regio	Nan
จัดเมื่อวันที่	hield vast	Nan
จัดโดย	geregeld door	Nan
จัน	chan	None
จันทบุรี	chanthaburi	Nan
จันทร	maan	None
จันทรุปราคา	maansverduistering	Nan
จันทร์	maandag	None
จันทร์ภักดี	chan phakdi	Nan
จันทร์เกษ	chan ket	Nan
จาก	van	None
จารีตประเพณี	traditie	None
จามจุรี	jamjuree	Nan
จาติกวณิช	chatikavanij	Nan
จากโซล	uit seoul	Nan
จากเว็บไซต์กระทรวงต่างประเทศ	van de website van het ministerie van buitenlandse zaken	Nan
จากเว็บไซต์กระทรวงการต่างประเทศ	van de website van het ministerie van buitenlandse zaken	Nan
จาวตาลเชื่อม	jao tan weld	Nan
จากเว็บ	van internet	Nan
จากอัลบั้ม	van het album	Nan
จากสารานุกรมบริทานิกา	uit de encyclopaedia britannica	Nan
จากละครเรื่อง	van het drama	Nan
จากละคร	van het drama	Nan
จากภาษากรีก	van grieks	Nan
จากการพิสูจน์อายุโดยคาร์บอน	van het bewijs van leeftijd door koolstof	Nan
จากเรื่อง	uit het verhaal	Nan
ชีวมวล	biomassa	Nan
ฉ	f	None
ฉบับวณิพก	cijfers	None
ชั้นมหาวชิรมงกุฎ	crown maha wachira klasse	Nan
ชั้นยศ	rang	None
ชั้นสูงสุด	hoogste niveau	Nan
ชา	thee	None
ชากะ	shaka	Nan
ชาคริต	alert	Nan
ชาญชัย	chanchai	Nan
ชาตะ	geboren zijn	Nan
ชาติ	natie	None
ชาย	mannetje	None
ชาร์ป	scherp	None
ชาร์ล	charles	None
ชาร์ลส	charles	None
ชาลส์	charles	None
ชาลี	charlie	None
ชาวนา	boer	None
ชาวไทย	thaise mensen	Nan
ชีวนิชพันธ์	biologisch	None
ชีพด็อก	herdershond	Nan
ชิโนะ	chino	Nan
ชิลี	chili	None
ชิริว	chiryu	Nan
ชินวัตร	shinawatra	Nan
ชั้นประทวน	verdieping	None
ชิน	gebruikelijk	None
ชิซุกะ	shizuka	Nan
ชิงร้อยล้าน	strijd om honderd miljoen	Nan
ชิงร้อย	concurreren	Nan
ชิคิกามิ	shikikami	Nan
ชำนิ	chamni	Nan
ชาวไทยภูเขา	hill stam	Nan
ชิดจันทร์	chidchan	Nan
ฉบับชั่วคราว	tijdelijke versie	Nan
ชั้นที่	verdieping	None
ชัยยุทธ	chaiyut	Nan
ฉลอง	vieren	None
ฉลองพระชนมายุ	vier het 80ste jaar	Nan
ฉันรักคุณ	ik hou van je	Nan
ฉาบ	gips	Nan
ฉายเมื่อ	getoond op	Nan
ฉิ่ง	bekken	None
ฉี่	plas	Nan
ชนะ	winnen	None
ชนิด	type	None
ชนิดของเมฆ	cloud type	Nan
ชม	kijk maar	Nan
ชมชื่น	compliment	Nan
ชมพู	roze	None
ชมพูทวีป	india	None
ชมพู่	roze appel	Nan
ชล	meren	None
ชลธารวิทยา	chaloem wittaya	Nan
ชัยมงคล	chaimongkol	Nan
ชัยบัญชา	chai bancha	Nan
ชัยนาม	chai nam	Nan
ชัยชนะ	zege	Nan
ชัย	zege	Nan
ชัชพล	chatchapon	Nan
ชั้น	klasse	None
ชะอำ	cha-am	Nan
ชะมด	muskus	Nan
ชะนี	gibbon	Nan
ชอบ	leuk vinden	Nan
ชวนชื่น	uitnodigend	Nan
ชลิต	chalit	Nan
ชลบุรี	chon buri	Nan
ชะอวด	opschepper	Nan
ดาวเคราะห์แคระ	dwergplaneet	Nan
ดาวเสาร์	saturnus	None
ดำรงค์	wimax	Nan
ทองใหญ่	groot goud	Nan
ทอม	tom	None
ทอมสัน	thomson	Nan
ทอมัส	thomas	None
ทะเล	zee	None
ทะเลทราย	woestijn	None
ทะเลสาบ	lagune	Nan
ทักษะ	de vaardigheden	Nan
ทัช	raak aan	Nan
ทับ	schuine streep	Nan
ทัพเรือภาคที่	naval department	Nan
ทัวร์คอนเสิร์ต	tournee	None
ทั่วไป	algemeen	None
ทั้ง	beide	None
ทั้งหมด	allemaal	None
ทางทิศตะวันออก	oosten	None
ทางทิศตะวันออกติดกับเวียดนาม	het oosten grenst aan vietnam.	Nan
ทำให้	maken	None
ทำหน้าที่	doe de plicht	Nan
ทำบุญตักบาตรฯ	verdienen en voedsel aanbieden aan monniken	Nan
ทำนอง	afstemmen	Nan
ทำงาน	werk	None
ทาวเวอร์	de toren	Nan
ทองแดง	koper	None
ทาร์ดิกราดา	tardikrada	Nan
ทางไอทีวี	op itv	Nan
ทางอากาศ	per vliegtuig	Nan
ทางหลวงพิเศษ	speciale snelweg	Nan
ทางรถไฟ	de trein	Nan
ทางน้ำ	waterweg	Nan
ทางทิศเหนือติดกับประเทศไทยและลาว	het noorden wordt begrensd door thailand en laos.	Nan
ทานากะ	tanaka	Nan
ทิฆัมพรธีรวงศ์	tikamporn thirawong	Nan
ทองเจือ	goud geregen	Nan
ทองหยอด	gouden blad	Nan
ทรงคล้ายทรงกลม	bolvormig	Nan
ทรงถือหุ้นจำนวน	zijne hoogheid heeft aandelen in	Nan
ทรงผนวช	zijne hoogheid	Nan
ทรงพระกรุณาโปรดเกล้าโปรดกระหม่อมให้	wijd me genadig toe	Nan
ทรงยี่สิบหน้า	twintig gezichten	Nan
ทรงลูกบาศก์	kubus	Nan
ทรงสี่เหลี่ยมขนมเปียกปูน	ruit	Nan
ทรงสี่เหลี่ยมมุมฉาก	rechthoek	Nan
ทรงห้าหน้า	vijf gezichten	Nan
ทรงได้รับการทูลเกล้าฯ	kreeg zijne majesteit de koning	Nan
ทรัพยากร	bron	None
ทรัพยากรน้ำ	watervoorraden	Nan
ทรัพย์วิจิตร	rijkdom	None
ทรัพย์เพิ่ม	extra activa	Nan
ทรัมเป็ต	trompet	Nan
ทรีทูวัน	drie tegen één	Nan
ทวารหนัก	anus	None
ทองผาภูมิ	string pha phum	Nan
ทองประสม	gemengd goud	Nan
ทองขาว	wit goud	Nan
ทอง	goud	None
ทหารอากาศ	luchtmacht	None
ทหารหน่วยอาเฟลันดราที่	de aphelandra troop	Nan
ทองหล่อ	thonglor	Nan
ทหาร	soldaat	None
ทศกัณฐ์	tosakan	Nan
ทว่า	maar	None
ทวีวัฒน์	thawiwat	Nan
ทวีปเอเชีย	azië	None
ทวีปอเมริกา	amerika	None
ทวีป	continent	None
ทศพล	tosapon	Nan
ทนายความ	advocaat	None
ทิพย์	thip	Nan
ทิม	tim	None
ท่าน้ำนนท์	aan het water	Nan
ท่ายาง	rubberen stempel	Nan
ท่าศาลา	tha sala	Nan
ท่าอากาศยานเลย	luchthaven loei	Nan
ท่าเรือ	haven	None
ท่าไม้ตาย	kolonist	Nan
ท้องสนามหลวง	sanam luang	Nan
ธกรุงไทย	krung thai bank	Nan
ธกส	baac	Nan
ธกสิกรไทย	kasikorn bank	Nan
ธง	vlag	None
ธงชัย	thongchai	Nan
ธงชาติ	nationale vlag	Nan
ธงธง	vlag	None
ธนบุรี	thonburi	Nan
ธนพร	thanaporn	Nan
ธนะรัชต์	thanarat	Nan
ธรรมนูญ	handvest	None
ธรณีสัณฐานวิทยา	bodemmorfologie	Nan
ธรณินทราธิราช	tharawintharathirat	Nan
ธปท	bot	None
ธนิต	thanit	Nan
ธนาคารไทยพาณิชย์	siam commerciële bank	Nan
ท่านอ้วน	dikke man	Nan
ธนาคารเพื่อการพัฒนาแห่งเอเชีย	aziatische ontwikkelingsbank	Nan
ธนาคารอิสลามแห่งประเทศไทย	islamitische bank van thailand	Nan
ธนาคารทิสโก้	tisco bank	Nan
ธนาคารทหารไทย	thaise militaire bank	Nan
ธนาคารกรุงไทย	krung thai bank	Nan
ธนาคารกรุงศรีอยุธยา	bank van ayudhya	Nan
ธนาคาร	bank	None
ธนาคารเกษตร	landbouwbank	Nan
ทิฟฟานี่	tiffany	Nan
ท่านอ่อง	ong	Nan
ท่าชนะ	houding	None
ทิวานนท์	tiwanon	Nan
ทิศตะวันตก	west	None
ที	t	None
ทีบีเอส	tbs	Nan
ทีมชาติไทย	nationaal team van thailand	Nan
ทีมใดที่จำนวนข้อที่ถูกน้อยกว่า	welk team heeft het laagste aantal dan	Nan
ทีวีอินไซด์	tv binnen	Nan
ทีโอที	tot	None
ที่จ่ายร้อยละ	dat loont een percentage	Nan
ที่นี้	hier	None
ที่ประชาชนชอบมากที่สุด	welke mensen het leukst vinden	Nan
ที่มา	bron	None
ที่มี	dat heeft	Nan
ที่มีชื่อว่า	genaamd	None
ที่สำคัญ	de sleutel	Nan
ที่หมายถึง	dat betekent	Nan
ที่อยู่อาศัย	residentie	None
ท่องอาณาจักรโฮ่งเหมียว	reciteer het koninkrijk hong miao	Nan
ทไย	waarom	None
ทโกมลบุตร	thakomolabutr	Nan
ทเวนตี้	twintig	None
ทูล	gereedschap	Nan
ทู	te	None
ท่านอิน	in	None
ทุ่งใหญ่	thung yai	Nan
ทุ่งตะโก	thung tako	Nan
ทุติยจุลจอมเกล้าวิเศษ	schepen	None
ทุกครั้ง	elke keer	Nan
ทุก	elk	None
ที่โดดเด่นคือ	het uitstekende is	Nan
ที่เกิดขึ้น	dat gebeurde	Nan
ทุ่งสง	thung song	Nan
ทนาย	advocaat	None
ทนงศักดิ์	thanongsak	Nan
ทดลอง	proef	Nan
ด้านหน้า	voorkant	None
ด้านหลัง	de rug	Nan
ด้านอ่าวไทย	golfzijde	Nan
ต	o	None
ตกรอบที่	uitgeschakeld	None
ตรงกับวันขึ้น	match up	Nan
ตรงกับวันที่	wedstrijddatum	Nan
ตระกูล	clan	Nan
ตระกูลนารา	nara familie	Nan
ตระกูลปาร์ค	clan park	Nan
ตระกูลยามานากะ	yamanaka family	Nan
ตระกูลอินุซึกะ	inuzuka familie	Nan
ตระกูลเซนจู	senju familie	Nan
ตรัง	trang	Nan
ตรางู	slang	None
ตราด	trat	Nan
ตรานี้	dit zegel	Nan
ตันติเวชกุล	tantivejkul	Nan
ตะวันออกเฉียงเหนือ	noordoost	Nan
ตะวันออก	oosten	None
ตะวันทอแสง	zonsopkomst	Nan
ตะลุยอวกาศ	space dabble	Nan
ตะละภัฏ	talapat	Nan
ด้านดนตรี	muziek	None
ตะกั่ว	lood	Nan
ตอน	wanneer	None
ตลาดโลตัส	lotus markt	Nan
ตลาด	markt	None
ตรุษจีน	chinees nieuwjaar	Nan
ตรึงใจ	fascineren	Nan
ตราสัญลักษณ์	embleem	None
ตะกร้อ	uiteinde van een loop	Nan
ตัว	lichaam	None
ด้านการเกษตร	agrarisch	Nan
ด้านการกีฬา	sport	None
ดำรงตำแหน่ง	houd een positie	Nan
ดำรงอ่องตระกูล	damrong ong clan	Nan
ดำเนินสะดวก	damnoen saduak	Nan
ดิกชันนารี	woordenboek	Nan
ดิค	dick	None
ดิจิตอล	digitaal	None
ดิน	bodem	None
ดินเซนฮอฟเฟอร์	zen hoffer	Nan
ดินแดน	gebied	None
ดิว	dauw	Nan
ดิวิชั่น	afdeling	None
ดิศ	schijf	None
ดิศกุล	diskul	Nan
ดิสนีย์	disney	None
ดิสโพรเซียม	dysprosium	Nan
ดี	goed	None
ดีคอนสตรักทิวิสม์	dconrak tavist	Nan
ด้วยเหตุนี้	om deze reden	Nan
ด้วย	met	None
ด็อก	hond	None
ดูแล	zorg	None
ดูเร็กซ์	durex	Nan
ดูเพิ่มเติมที่	zie ook	Nan
ด้านการต่างประเทศ	buitenlandse zaken	Nan
ดูเพิ่มเติม	bekijk meer	Nan
ดุสิต	dusit	Nan
ดีเอ็นเอ	dna	None
ดีเวลลอปเม้นท์	ontwikkeling	None
ดีเวลลอปเมนท์	ontwikkeling	None
ดีบุก	blik	Nan
ดีน	decaan	Nan
ดูที่	kijk naar	Nan
ตัวพระ	hoofdrolspeler	Nan
ตัวยักษ์	reusachtig	Nan
ตัวละคร	het personage	Nan
ติณสูลานนท์	tinsulanon	Nan
ติอามัต	tiamat	Nan
ตี๋ใหญ่	grote tee	Nan
ตึก	gebouw	None
ตุรกี	kalkoen	Nan
ตุลาคม	oktober	None
ตุ๊กแก	gekko	Nan
ตูน	tekenfilm	Nan
ต่อกันด้วยพันธะ	ga verder met obligaties	Nan
ต่อจาก	ga verder vanaf	Nan
ต่อมา	later	None
ต่อมาวันที่	volgende datum	Nan
ต่อมาในปี	later in het jaar	Nan
ต่อมาในรัชกาลที่	later in de regering	Nan
ต่อมาในสมัยกรุงธนบุรีและกรุงรัตนโกสินทร์เขมรตกอยู่ภายใต้การควบคุมของจักรวรรดิสยามอย่างเข้มงวด	later, in de thonburi en rattanakosin periodes, stond de khmer onder strikte controle van het siamese rijk.	Nan
ต่าง	anders	None
ต่างๆ	verschillende	None
ถ้อยคำ	woorden	None
ถ้วย	kop	None
ถึงเดือนกรกฎาคม	tot juli	Nan
ถึงกระนั้น	niettemin	None
ถวาย	aanbod	None
ถมิตรภาพ	vriendschap	None
ตำบลไพรขลา	phrai khala kantonrechter	Nan
ถนนสุขุมวิท	sukhumvit road	Nan
ถนนประชาธิปก	democracy road	Nan
ถนนคนเดิน	lopende straat	Nan
ถนน	weg	None
ต้นสกุล	geslacht	None
ต้นตอจักรวาลวิทยา	kosmologie	Nan
ต้น	begin	None
ถนนมิตรภาพ	vriendschapsweg	Nan
ตำบลโพนครก	phon nakhon district	Nan
ตำบลเมืองบัว	bua kantonrechter	Nan
ตำบลสังขะ	sangkha	Nan
ตั้งอยู่ที่	gevestigd in	Nan
ตั้งงี่สุ่น	tang ngeon	Nan
ตัวแปร	variabel	Nan
ตัวเลขอย่างเป็นทางการ	officiële nummers	Nan
ตัวอย่างเช่น	bijvoorbeeld	None
ตัวอย่างภาพยนตร์	filmtrailer	Nan
ตั้งอยู่เลขที่	gevestigd in	Nan
ตัวอย่างต้นแบบแรก	voorbeeld eerste prototype	Nan
ตัวอย่างคำบาลี	pali voorbeeld	Nan
ตัวอย่าง	voorbeeld	None
ตัวหาร	deler	Nan
ตัวสะกด	spelling	None
ตัวลิง	aap	None
ตัวละครจากเรื่อง	de personages uit het verhaal	Nan
ตัวอย่างคำประพันธ์	voorbeeldvers	Nan
จังหวัดเพชรบุรี	provincie phetchaburi	Nan
ตั๊กแตน	sprinkhaan	Nan
ตาคลี	takhli	Nan
ตำบลระแงง	rahang district	Nan
ตำบลยะวึก	yuwak district	Nan
ตำบลบ้านกง	ban kong kantonrechter	Nan
ตำบลนาดี	nadi kantonrechter	Nan
ตำบลนางแล	nanglae kantonrechter	Nan
ตำบลตาเมียง	ta myung district	Nan
ตา	oog	None
ตำบลกังแอน	gang ann district	Nan
ตำนานแฝงคำสอน	legendarische leringen	Nan
ตำนานวายุสลาตัน	de legende van een storm	Nan
ตาราง	tafel	None
ตาระวา	tarawa	Nan
ตามตำราพรหมชาติฉบับหลวง	volgens het koninklijke leerboek van brahma	Nan
ตามตัวสวมเครื่องประดับต่าง	omdat hij verschillende sieraden droeg	Nan
ตำบลกระเทียม	knoflook subdistrict	Nan
ธรรมศักดิ์	thammasak	Nan
จังหวัดเชียงใหม่	provincie chiang mai	Nan
จังหวัดเชลลา	shella	Nan
การท่องเที่ยว	toerisme	None
การท่าเรือ	havenmeester	Nan
การบริการ	onderhoud	None
การบริหารการพัฒนา	ontwikkelingsmanagement	Nan
การบริหารการศึกษา	onderwijsadministratie	Nan
การบริหารจัดการ	beheer	None
การบริหารราชการแผ่นดิน	overheidsadministratie	Nan
การบินไทย	thai airways	Nan
การปกครองท้องถิ่น	plaatselijke overheid	Nan
การปกครองส่วนท้องถิ่น	plaatselijke overheid	Nan
การปกครองแบ่งออกเป็น	de regel is onderverdeeld in	Nan
การปฏิรูประบบจัดเก็บภาษีเงินได้	hervorming van het systeem voor de inning van inkomstenbelasting	Nan
การปฏิรูปศาสนา	hervorming	None
การปฏิวัติฝรั่งเศส	franse revolutie	Nan
การปฏิวัติอุตสาหกรรม	industriële revolutie	Nan
การปฏิสนธิ	bevruchting	None
การประมง	visserij	None
การสั่นพ้อง	resonantie	Nan
การสังคายนาครั้งที่	de laatste bestelling	Nan
การศึกษา	de opleiding	Nan
การวิเคราะห์	de analyse	Nan
การวิจัย	onderzoek	None
การละเล่นพื้นบ้าน	folk spelletjes	Nan
การทำป่าไม้	bosbouw	None
การลดรูป	vervorming	Nan
การรักษาพยาบาล	medische behandeling	Nan
การระบาดของไข้หวัดใหญ่สายพันธุ์ใหม่	de nieuwe soort influenza	Nan
การยึดครองมะละกาของโปรตุเกสในปี	portugese bezetting van melaka in het jaar	Nan
การพูด	spreken	None
การพัฒนาประชาธิปไตย	democratische ontwikkeling	Nan
การพัฒนา	de ontwikkeling	Nan
การร่วมเพศทางทวารหนัก	anaal neuken	Nan
การสำเร็จความใคร่ด้วยตนเอง	masturbatie	None
การทำงานของ	het werk van	Nan
การตั้งถิ่นฐาน	nederzetting	None
กัมพูชาประชาธิปไตย	democratisch cambodja	Nan
กัมพูชาเป็นประเทศที่มีป่าไม้อุดมสมบูรณ์มากที่สุดหากเปรียบเทียบกับประเทศเพื่อนบ้าน	cambodja is het land met de meeste bossen in vergelijking met de buurlanden.	Nan
กัมพูชาเป็นอดีตประเทศอาณานิคมของฝรั่งเศสในภูมิภาคเอเชียตะวันออกเฉียงใต้เพียงแค่ประเทศเดียวเท่านั้นที่มีการปกครองด้วยระบอบราชาธิปไตยภายใต้รัฐธรรมนูญ	cambodja is het enige voormalige franse koloniale land in zuidoost-azië met een monarchie onder de grondwet.	Nan
กัมพูชาเป็นอาณานิคมของฝรั่งเศสมาตั้งแต่พศ	cambodja is sindsdien een franse kolonie.	Nan
กัวเตมาลา	guatemala	None
กานซู	gansu	Nan
กานต์	kan	None
กานา	ghana	None
กานามัยซิน	kanamycin	Nan
กาบอง	gabon	Nan
กาพย์ฉบัง	episch gedicht	Nan
กาพย์สุรางคนางค์	gedicht	None
กาม	baldadig	Nan
กาย	lichaam	None
การ	de	None
การกีฬา	sport	None
การขัดเกลาทางสังคม	socialisatie	Nan
การตอบรับ	feedback	Nan
การดำเนินการ	een operatie	Nan
การชัก	beslaglegging	Nan
การจูบ	een kus	Nan
การจัดให้มี	arrangement	Nan
การจัดอันดับ	rangschikking	Nan
การต่างประเทศ	buitenlandse zaken	Nan
การจัดการคุณภาพ	kwaliteitsmanagement	Nan
การค้า	de handel	Nan
การค้นพบ	de vondst	Nan
การคลัง	financiën	None
การคมนาคม	transport	None
การขับไล่	uitzetting	Nan
การขับถ่าย	excretie	Nan
การจัดการ	het management	Nan
กัมพูชา	cambodja	None
การสืบพันธุ์	reproductie	Nan
การาจ	garage	Nan
กุหลาบ	roos	None
กุ้ง	garnalen	Nan
กุ้งต้ม	gekookte garnalen	Nan
กูเกิล	google	None
ก็คือ	is	None
ก็ใช้เป็น	gebruikt als	Nan
ก่อตั้ง	gesticht	None
ก่อตั้งโดย	opgericht door	Nan
ก่อนที่	voordat	None
ก่อนที่จะตกเป็นของฝรั่งเศสในเวลาต่อมา	voordat ik later frankrijk werd	Nan
ก่อนหน้านั้น	daarvoor	None
ก้อย	pinky	Nan
ก้าน	stengel	Nan
ก้านกล้วย	banaanstengel	Nan
ก๊าซธรรมชาติ	natuurlijk gas	Nan
ก๎ล	geschenk	Nan
ขขขขขขขขขข	b b b b b b b b	Nan
ขบวนการอ๊บอ๊บป่วนโลก	de beweging van de aarde	Nan
ขนาดใหญ่	grote maat	Nan
ขนาดหน้าตัก	grootte schoot	Nan
ขนอม	khanom	Nan
ขนสัตว์	wol	None
ขนมไทย	thais dessert	Nan
กุลละวณิชย์	kulalawanit	Nan
ขนมเปียกปูน	ruit	Nan
ขนมปัง	brood	None
ขนมครก	knmcrk	Nan
ขนมกล้วย	banana candy	Nan
ขนม	snoep	Nan
ขณะที่	terwijl	None
ขณะทรงพระเยาว์	terwijl hij jong was	Nan
ขนมปังขิง	peperkoek	Nan
การสื่อสาร	communicatie	None
กุลดิลก	kuldilok	Nan
กีฬาแหลมทอง	laem string sport	Nan
การุณ	karun	Nan
การเต้นรำ	de dans	Nan
การเพิ่มสิทธิประโยชน์แก่นักลงทุนต่างประเทศ	voorrechten voor buitenlandse investeerders vergroten	Nan
การเล่น	spelen	None
การแข่งขัน	de competitie	Nan
การแบ่งพื้นที่	partitie	Nan
การใช้คำ	woordgebruik	Nan
การไฟฟ้าส่วนภูมิภาค	provinciaal electriciteitsbedrijf	Nan
การไหว้	respect	None
การ์ด	kaart	None
กาฬสินธุ์	kalasin	Nan
กาเวน	gawain	Nan
กาเหว่าที่บางเพลง	the raven of some songs	Nan
กำกับการแสดงโดย	geregisseerd door	Nan
กำกับโดยอภิชาติพงศ์	geregisseerd door aphichat pong	Nan
กำมะถัน	zwavel	Nan
กำลังจะปรับเปลี่ยนเป็น	gaat veranderen	Nan
กีฬาทางน้ำ	watersport	Nan
กีฬา	sport	None
กีฏวิทยา	entomologie	Nan
กิ๊ก	kik	Nan
กิ้งกือ	duizendpoot	Nan
กิ่งแก้ว	kingkaew	Nan
กุดจับ	gietvorm	Nan
กิโลไบต์	kb	Nan
กิมป์	gimb	Nan
กิจผลิต	productie	None
กำแพงแสน	kamphaengsaen	Nan
กำแพงเมืองจีน	de grote muur	Nan
กำแพงเพชร	kamphaeng phet	Nan
กำหนดตามสภาพภูมิศาสตร์	bepaald door geografie	Nan
กิโลกรัม	kg	None
ขบวนรถสินค้า	trein	None
กัมปูเชีย	kampuchia	Nan
กันเอง	vriendelijk	Nan
กระดูกต้นแขน	opperarmbeen	Nan
กระดูกฝ่ามือ	palmen	Nan
กระดูกสะบัก	schouderblad	Nan
กระดูกสะบ้า	knieschijf	Nan
กระทรวงกลาโหม	ministerie van defensie	Nan
กระทรวงการคลัง	ministerie van financiën	Nan
กระทรวงการต่างประเทศ	ministerie van buitenlandse zaken	Nan
กระทรวงวัฒนธรรม	ministerie van cultuur	Nan
กระทรวงศึกษาธิการ	ministerie van onderwijs	Nan
กระทรวงสาธารณสุข	ministerie van volksgezondheid	Nan
กระทรวงอุตสาหกรรม	ministerie van industrie	Nan
กระทรวงเกษตรและสหกรณ์	ministerie van landbouw en coöperaties	Nan
กระทรวงเศรษฐการ	ministerie van economische zaken	Nan
กระทุ่มแบน	klein mandje	Nan
กระนวน	pitch	Nan
กระนั้น	niettemin	None
กระบวนการสร้าง	bouwproces	Nan
กรัยวิเชียร	kraiwichian	Nan
กรัม	gram	Nan
กรับเสภา	krapao	Nan
กรับพวง	kies een bos	Nan
กรับ	oppakken	Nan
กระแต	eekhoorn	Nan
กระดูกค้อน	hamerbot	Nan
กระเพาะอาหาร	maag	None
กระวนกระวาย	angstig	Nan
กระรอก	eekhoorn	Nan
กระบี่กระบอง	wedstrijd met zwaarden	Nan
กระบะทราย	zandbak	Nan
กระบอง	blackjack	Nan
กระบวนการสร้างและสลาย	proces van creëren en uiteenvallen	Nan
กระหม่อม	hoofd	None
กรานาดา	granada	None
กรอง	filter	Nan
กรมอุตุนิยมวิทยา	meteorologische afdeling	Nan
=	=	None
 °ซ  °ฟ 	° c ° f	Nan
 ซม	cm	Nan
 −°ซ  °ฟ	- ° c ° f	Nan
×	×	None
γ	γ	Nan
π	π	Nan
กกกก	kg	None
กกกข	khor khor	Nan
กขขข	abc b	Nan
กขขขขขขข	a b a b b b a	Nan
กฎ	regel	None
กฎของโคไซน์	cosinuswet	Nan
กฎแห่งกรรม	karma	Nan
กติกา	reglement	Nan
กทม	bangkok	Nan
กนู	ridder	None
กรมหลวงสงขลานครินทร์	krom luang songkhla nakarin	Nan
กรมหลวงนราธิวาสราชนครินทร์	krom luang narathiwatratchanakharin	Nan
กรมศิลปากร	afdeling schone kunsten	Nan
กรมรบพิเศษที่	special forces department	Nan
กรมทหารราบที่	infanterie regiment	Nan
กรมควบคุมโรค	afdeling ziektebestrijding	Nan
กรรชัย	kanchai	Nan
กรมข่าวทหารอากาศ	afdeling van de air force news	Nan
กรมขุนอิศเรศรังสรรค์	krom khun iset rangsan	Nan
กรณีที่	de zaak	Nan
กมลรัตน์	kamonrat	Nan
กมล	lelie	Nan
กบฏทหารนอกราชการ	militaire opstand	Nan
กบ	kikker	Nan
กรมขุนเพ็ชรบูรณ์อินทราชัย	kromkhunpetchaboon-indachai	Nan
กับนางสุจาริณี	met mevrouw sucharinee	Nan
กริม	grimm	Nan
กรุง	hoofdstad	None
กองการบินทหารเรือ	naval aviation division	Nan
กองการศึกษา	afdeling onderwijs	Nan
กองการเจ้าหน้าที่	afdeling personeel	Nan
กองกำลังกึ่งทหาร	semi-militaire strijdkrachten	Nan
กองคลัง	financiële divisie	Nan
กองทัพ	het leger	Nan
กองทัพบกไทย	thais leger	Nan
กองทัพภาคที่	leger van de regio	Nan
กองทัพเรือ	marine	None
กองทัพเรือไทย	thaise marine	Nan
กองทัพแห่งความชอบธรรม	leger van gerechtigheid	Nan
กองทัพไทย	thais leger	Nan
กองบิน	luchtmacht	None
กองบินปีกหมุนที่	wing spinning wing	Nan
กองพลทหารม้าที่	de cavaleriebrigade	Nan
กองพันทหารช่างที่	de engineer brigade	Nan
กอด	knuffel	Nan
กันอริ	kanori	Nan
กันฟอร์ม	het formulier	Nan
กันทรลักษ์	kantharalak	Nan
กันตัง	kantang	Nan
กันดั้ม	gundam	Nan
กังหันชัยพัฒนา	chaipattana-turbine	Nan
กองกลาง	middenvelder	Nan
กะโหลกศีรษะ	schedel	None
กะเหรี่ยง	karen	None
กอล์ฟไมค์	golf microfoon	Nan
กอล์ฟ	golf	None
กอลมเบต์	goreme	Nan
กอร์ดอน	gordon	None
กอนซาเลซ	gonzalez	Nan
กะโหลก	schedel	None
กรี	grijs	None
กว่า	dan	None
กวิน	kawin	Nan
กรุงธนบุรี	thon buri	Nan
กรุงลอนดอน	londen	None
กรุงศรีอยุธยา	ayutthaya	Nan
กรุงเทพ	bangkok	Nan
กรุงเทพเชียงใหม่กรุงเทพ	bangkok, chiang mai, bangkok	Nan
กรุงเทพโพลล์	bangkok poll	Nan
กรุ๊ป	groep	None
กลอง	trommel	Nan
กลองมโหระทึก	grote trom	Nan
กลองยาว	trommel	Nan
กลองสองหน้า	dubbelzijdige trommel	Nan
กลอน	vers	None
กลอบูลิน	glanzend	Nan
กลาง	midden-	Nan
กลิ่น	geur	None
กลุ่มดาวกล้องจุลทรรศน์	sterrenbeelden van microscopen	Nan
กลุ่มดาวนกทูแคน	toekan	Nan
กวาง	herten	Nan
กวม	guam	Nan
กล้ามเนื้อ	spier	None
กล้องถ่ายภาพ	camera	None
กล้วยไม้ดาว	ster orchidee	Nan
กล่าวคือ	het is te zeggen	Nan
กวี	dichter	None
กลูคากอน	glucon	Nan
กลุ่มที่	de groep	Nan
กลุ่มดาวแมลงวัน	vliegen	None
กลุ่มดาวแมงป่อง	schorpioen	Nan
กลุ่มดาวเตาหลอม	hoogoven	Nan
กลุ่มดาวเข็มทิศ	sterrenbeeld kompas	Nan
กลุ่มดาวสิ่ว	beitel	Nan
กลุ่มแสงอุษา	usa light group	Nan
ขม	bitter	Nan
ขรรค์ชัย	khan chai	Nan
ขลุ่ยหลิบ	fluit	Nan
คิด	denken	None
คินนิคุแมน	kinnikuman	Nan
คิมิฮิโระ	kimihiro	Nan
คิระ	kira	Nan
คิเคียว	kikyo	Nan
คีตกวี	componist	None
คือประมาณ	gaat over	Nan
คือเพลง	is een lied	Nan
คุณ	u	None
คุณครูจอมเวท	the magician teacher	Nan
คุณปลื้ม	khun pluem	Nan
คุณหญิงโม	keizerin mo	Nan
คุณากร	u	None
คุราปิก้า	kurapika	Nan
คุโรซึจิ	kurotsuji	Nan
คุ้มค่า	goede waarde	Nan
คูกิมิยะ	kukimiya	Nan
งาน	werk	None
งดส่งเข้าประกวด	geen toegang	Nan
ฆ้องวงใหญ่	grote gong	Nan
ฆ้อง	gong	Nan
ฆ	juan	None
ค้างคาว	knuppel	Nan
คิชิเนีย	kishinya	Nan
ค่ำแล้ว	schemer	Nan
ค่าจีดีพี	bbp	None
ค่าความต้านทานตัวที่	de weerstandswaarde die	Nan
คู่กรรม	partner	None
คูเวต	koeweit	None
คูเรียม	curium	Nan
คูคาคุ	kuku	Nan
ค่าใช้จ่าย	de kosten	Nan
งานอดิเรก	hobby&#39;s	Nan
คิงไลเนอร์	kingliner	Nan
คิงส์	koningen	None
คาคาชิ	kakashi	Nan
คางาริ	kagari	Nan
คาซัคสถาน	kazachstan	None
คาถาอัญเชิญ	bezwering	Nan
คาบ	periode	None
คาบัคโรเน่	kabakhroone	Nan
คาบูโตะ	kabuto	Nan
คาปูชิโน่	cappuccino	Nan
คามิว	kamui	Nan
คาราคุระ	karakura	Nan
คาร์ล	carl	None
คาวทอง	fishyong	Nan
คาเมนไรเดอร์	kamen rider	Nan
คาโรลัส	carolas	Nan
คำขวัญวันเด็ก	kinderdag slogan	Nan
คำถามข้อที่	vraag nummer	Nan
คำนวณ	berekenen	None
คิง	koning	None
คำแปล	vertaling	None
คำเมือง	stad woord	Nan
คำอธิบาย	omschrijving	None
คำสุภาพ	beleefd woord	Nan
คำสุดท้ายของวรรคที่	het laatste woord van de paragraaf	Nan
คิงส์คัพ	king&#39;s cup	Nan
คำสร้อย	woord	None
คำศัพท์	woordenschat	Nan
คำวิลัยศักดิ์	kamwilai sak	Nan
คำม่วง	kham muang	Nan
คำมั่นสัญญา	belofte	None
คำพ้องรูป	synoniemen	None
คำนาม	zelfstandig naamwoord	Nan
คำสรรพนาม	voornaamwoord	Nan
คั่ว	gebraden	Nan
งานเขียน	geschriften	Nan
งานโมเสก	mozaïek	Nan
จักรพันธุ์	chakphan	Nan
จักรวาลวิทยา	kosmologie	Nan
จังหวัด	provincie	None
จังหวัดกระบี่	provincie krabi	Nan
จังหวัดกาญจนบุรี	kanchanaburi	Nan
จังหวัดกาฬสินธุ์	kalasin	Nan
จังหวัดขอนแก่น	provincie khon kaen	Nan
จังหวัดคยองกี	provincie gyeonggi	Nan
จังหวัดคยองซาง	gyeongsang provincie	Nan
จังหวัดฉะเชิงเทรา	chachoengsao	Nan
จังหวัดชุมพร	chumphon	Nan
จังหวัดตราด	provincie trat	Nan
จังหวัดตาก	tak provincie	Nan
จังหวัดนครปฐม	provincie nakhon pathom	Nan
จังหวัดนครพนม	provincie nakhon phanom	Nan
จังหวัดนครสวรรค์	provincie nakhon sawan	Nan
จังหวัดน่าน	provincie nan	Nan
จังหวัดอุดรธานี	provincie udon thani	Nan
จังหวัดหนองบัวลำภู	provincie nong bua lamphu	Nan
จังหวัดสิงห์บุรี	sing buri provincie	Nan
จังหวัดสมุทรสงคราม	provincie samut songkhram	Nan
จังหวัดสงขลา	songkhla	Nan
จังหวัดลำพูน	lamphun	Nan
จักรพรรดิไททัส	keizer titus	Nan
จังหวัดราชบุรี	ratchaburi	Nan
จังหวัดยโสธร	yasothon	Nan
จังหวัดมหาสารคาม	maha sarakham provincie	Nan
จังหวัดพิษณุโลก	provincie phitsanulok	Nan
จังหวัดพังงา	provincie phang nga	Nan
จังหวัดพระนครศรีอยุธยา	phra nakhon si ayutthaya	Nan
จังหวัดปัตตานี	provincie pattani	Nan
จังหวัดระยอง	rayong	Nan
งานเทางามสัมพันธ์	tao ngam-relatie	Nan
จักรพรรดิเนอร์วา	keizer nirvana	Nan
จะได้	zal krijgen	Nan
งามวงศ์วาน	ngamwongwan	Nan
งู	slang	None
งูอนาคอนดา	anaconda	Nan
จดหมายอากาศ	luchtpost	Nan
จตรัง	trang	Nan
จตุรงค์	chatuchak	Nan
จนกระทั่ง	tot	None
จนกระทั่งปี	tot het jaar	Nan
จนกระทั่งเมื่อปี	tot vorig jaar	Nan
จนครปฐม	nakhon pathom	Nan
จนมีคำกล่าวว่า	totdat dat werd gezegd	Nan
จน่าน	ma	None
จบุรีรัมย์	buriram	Nan
จมูก	neus-	Nan
จระเข้และแอลลิเกเตอร์	krokodil en alligator	Nan
จรัญญา	charanya	Nan
จริยธรรม	ethiek	None
จะเข้	citer	Nan
จะเขียนว่า	wil zeggen	Nan
จะต้องหาตัวแทนลงจากเวที	moet een vertegenwoordiger vinden om van het podium af te komen	Nan
จอร์เจีย	georgië	None
จอมเทียน	jomtien	Nan
จอมพลเรือ	ship marshal	Nan
จักจั่น	cicade	Nan
จอมพลสฤษดิ์	veldmaarschalk sarit	Nan
จอมบึง	gezwollen	Nan
จสุราษฎร์ธานี	surat thani	Nan
จสตูล	satun	Nan
จลำพูน	lamphun	Nan
จริยา	dame	None
จริยศาสตร์	ethiek	None
จอมพลถนอม	chom phon thanom	Nan
คัมภีร์	schrift	None
คัพ	kop	None
คันธวงศ์	kanthavong	Nan
ข้อมูลโดย	gegevens door	Nan
ข้อวิพากษ์วิจารณ์	kritiek	None
ข้ามฉาก	over de scène	Nan
ข้าวสาลี	tarwe	None
ข้าวหลาม	khao lam	Nan
ข้าวเกรียบปากหม้อ	rijstwafels	Nan
ข้าวเจ้า	rijstveld	Nan
ข้าวโพด	maïs	None
ข้าหลวงกำกับราชการเมืองขุขันธ์คนที่	gouverneur, gouverneur van de stad khukhan	Nan
ฃ	ฃ	Nan
คงยิ่ง	zeer waarschijnlijk	Nan
คงเจริญ	waarschijnlijk voorspoedig	Nan
คณะครุศาสตร์	faculteit onderwijs	Nan
คณะครุศาสตร์อุตสาหกรรม	faculteit industrieel onderwijs	Nan
คณะที่	faculteit bij	Nan
คณะบัญชี	faculteit accountancy	Nan
คณะปฏิรูปการปกครองแผ่นดิน	revolutionaire commissie	Nan
คณารศ	kanara	Nan
คณะแพทยศาสตร์โรงพยาบาลรามาธิบดี	faculteit geneeskunde, ramathibodi hospital	Nan
คณะแพทยศาสตร์ศิริราชพยาบาล	faculteit geneeskunde siriraj hospital	Nan
คณะเกษตร	faculteit van landbouw	Nan
คณะสาธารณสุขศาสตร์	faculteit volksgezondheid	Nan
คณะสหเวชศาสตร์	faculteit van allied health sciences	Nan
ข้อมูลอื่นๆ	andere informatie	Nan
คณะสถาปัตยกรรมศาสตร์	faculteit architectuur	Nan
คณะวิศวกรรมศาสตร์	faculteit ingenieurswetenschappen	Nan
คณะวิทยาการจัดการ	faculteit der managementwetenschappen	Nan
คณะรัฐมนตรีคณะที่	kabinet	None
คณะมนุษย์ศาสตร์และสังคมศาสตร์	faculteit der geesteswetenschappen en sociale wetenschappen	Nan
คณะพยาบาลศาสตร์	faculteit verpleegkunde	Nan
คณะประมง	faculteit visserij	Nan
คณะศิลปกรรมศาสตร์	kunstacademie	Nan
คนที่	de mensen	Nan
ข้อมูลปี	jaargegevens	Nan
ข้อมูลประเทศเดนมาร์ก	denemarken informatie	Nan
ขวด	fles	None
ขวัญ	moreel	None
ขวัญใจช่างภาพ	geliefde fotograaf	Nan
ขสมก	massa	None
ของ	van	None
ของทุกปี	elk jaar	Nan
ของประเทศจีน	van porselein	Nan
ของมหาวิทยาลัย	van de universiteit	Nan
ของมัน	haar	None
ของร่างกาย	van lichaam	Nan
ของสมเด็จฮุน	van somdej hun	Nan
ของสิ่งมีชีวิต	van levende wezens	Nan
ของสุนทรภู่	van sunthorn phu	Nan
ของเหลว	vloeistof	None
ของโลก	van de wereld	Nan
ขอนแก่น	khon kaen	Nan
ขอบคุณที่รักกัน	bedankt dat je van me houdt	Nan
ข้อมูลทั่วไป	algemene informatie	Nan
ขุนหาญ	han	Nan
ขุขันธิน	khan tin	Nan
ขึ้นไป	omhoog	None
ขึ้นเป็น	tot	None
ขี้ผึ้ง	was-	Nan
ข้อมูลปรากฏการณ์โลกร้อน	opwarming van de aarde fenomeen	Nan
ขีดเส้นใต้	onderstrepen	Nan
ขิง	gember	Nan
ขาย	verkopen	None
ขา	been	None
ขั้นที่	stap	None
ขอให้เด็กสมัยปฏิวัติของข้าพเจ้า	mogen mijn revolutionaire kinderen	Nan
ขอเช็ดน้ำตา	laten we de tranen wegvegen	Nan
ขิม	hakkebord	Nan
คนที่ไปช่วยรุ่นที่	de mensen die de generatie hebben geholpen	Nan
คนแคระ	dwerg	None
คนแรก	eerste persoon	Nan
ความยาวช่วงคลื่น	golflengte	None
ความยาวเพลง	nummer lengte	Nan
ความรัก	liefde	None
ความรู้	de kennis	Nan
ความสว่าง	helderheid	None
ความสัมพันธ์กับประเทศไทย	betrekkingen met thailand	Nan
ความสัมพันธ์ระหว่างจีนกับอเมริกา	betrekkingen tussen china en amerika	Nan
ความสูง	de hoogte	Nan
ความส่องสว่าง	helderheid	None
ความหนาแน่นของประชากร	bevolkingsdichtheid	None
ความหมาย	de betekenis	Nan
ความหมายโดยพยัญชนะ	medeklinker betekenis	Nan
ความเข้มของการส่องสว่าง	lichtintensiteit	Nan
ความเข้าใจ	begrip	None
ความเร่ง	versnelling	Nan
ความโกรธ	woede	None
ความโน้มถ่วง	zwaartekracht	None
คัทลียา	cattleya	Nan
คัญทัพ	belangrijk leger	Nan
คัชชินสกี	kutchinski	Nan
คัง	kang	Nan
คอสตาริกา	costa rica	Nan
คอลลิงวูด	callingwood	Nan
ความยาวคลื่น	golflengte	None
คอร์ด	akkoord	None
คอนเสิร์ตประสานเสียงสามสถาบัน	three institutes choir concert	Nan
คอนเวนชัน	conventies	Nan
คอนสตรัคชั่น	bouw	None
คอ	nek	None
ควีนซี่	koningin	None
ควินโต	quinto	Nan
คอมพิวเตอร์ยุคที่	computer tijdperk	Nan
ความยาว	de lengte	Nan
ความยากจน	armoede	None
ความพอประมาณ	bescheidenheid	Nan
คลอง	kanaal	None
ครูพิเศษจอมป่วน	troll leraar	Nan
ครู	leraar	None
ครุฑ	garuda	Nan
คริสต์ศาสนา	christendom	None
คริสตี	christi	Nan
คลองสาน	khlong san	Nan
คริส	chris	None
คราประยูร	prayun	Nan
ครั้งหนึ่ง	een keer	Nan
ครอบครัว	familie	None
ครอคโคไดล์	krokodil	Nan
คม	scherp	None
คปค	jaar	None
คราม	indigo	Nan
จังหวัดเชียงราย	chiang rai	Nan
คลองเตย	khlong toei	Nan
คลาวิคอร์ด	klasse	None
ความฝันอันสูงสุด	de ultieme droom	Nan
ความบริสุทธิ์	zuiverheid	Nan
ความนิยม	populariteit	None
ความถี่	frequentie	None
ความต่างศักย์	potentieel verschil	Nan
ความจำ	de herinnering	Nan
คลับ	club	None
ความงาม	de schoonheid	Nan
ควอร์เตอร์	kwartaal	None
ควอน	kwon	Nan
คลื่นสึนามิ	tsunami	None
คลิป	klem	Nan
คลินิก	kliniek	None
คลิก	klik	Nan
ความกว้าง	breedte	None
ลักเซมเบิร์ก	luxemburg	None
ธรรมศาสตร์	thammasat university	Nan
ธานินทร์	thanin	Nan
มณฑลหูหนาน	hunan	Nan
มณีวรรณ	maniwan	Nan
มด	mier	Nan
มดลูก	baarmoeder	None
มต้น	beginnen	None
มธ	tu	None
มธรรมศาสตร์	thammasat university	Nan
มน	ronde	None
มนุษย์	mens	None
มนุษย์กลายพันธุ์	mutant	Nan
มนเรศวร	naresuan	Nan
มปท	nps	Nan
มม	mm	None
มมหิดล	mahidol university	Nan
มยุรา	pauw	Nan
มลายู	maleis	Nan
มวยปล้ำ	worstelen	Nan
มหาวิทยาลัยปทุมธานี	pathum thani universiteit	Nan
มหาวิทยาลัยบูรพา	burapha university	Nan
มหาวิทยาลัยนเรศวร	naresuan universiteit	Nan
มหาวิทยาลัยทักษิณ	thaksin university	Nan
มหาวิทยาลัยขอนแก่น	khon kaen universiteit	Nan
มหาวิทยาลัย	universiteit	None
มจก	m	None
มหาวรรค	maha boeddha	Nan
มหาปรมาภรณ์ช้างเผือก	maha paramaporn chang phueak	Nan
มหาบัณฑิต	meester	None
มหาชัย	mahachai	Nan
มหาชน	openbaar	None
มหัพภาค	algemeen	None
มสงขลานครินทร์	prins van songkla	Nan
มหาวชิรมงกุฎ	mahavajira crown	Nan
มหาวิทยาลัยพะเยา	phayao universiteit	Nan
มกราคม	januari	None
ภู่สว่าง	phoo sawang	Nan
ภาพยนตร์ลามก	nare films	Nan
ภาพรวม	overzicht	None
ภายหลัง	na	None
ภายหลังสงคราม	na de oorlog	Nan
ภายใต้ความช่วยเหลือจากกองทุนการเงินระหว่างประเทศ	met hulp van het internationaal monetair fonds	Nan
ภายในวงขอบเหรียญเบื้องบนมีข้อความว่า	in de bovenkant van de medaille staat een verklaring dat	Nan
ภารกิจ	missie	None
ภาวะเศรษฐกิจของกัมพูชาหลังจากมีการเปลี่ยนแปลงการปกครองจากระบอบสังคมนิยมเป็นระบอบประชาธิปไตย	economische omstandigheden in cambodja na de regeringswisseling van een socialistische democratie.	Nan
ภาษาญี่ปุ่น	japans	Nan
ภาษาบาลี	pali	Nan
ภาษาสเปน	spaanse taal	Nan
ภาษาอังกฤษ	de engelse taal	Nan
ภาษาอีสาน	noordoost-taal	Nan
ภาษาเกชัว	quechua	Nan
ภาษาเฉพาะอาชีพ	jargon	Nan
ภาษาเบสิก	basic	Nan
ภาษาเยอรมัน	duitse	None
ภูเขาน้ำแข็ง	ijsberg	None
ภูเขา	berg	None
ภูหลวง	phu luang	Nan
ภูมิรัตน์	bhumirat	Nan
ภูมิภาค	regio	None
ภูมิประเทศและภูมิอากาศ	topografie en klimaat	Nan
ม	m	None
ภูพาน	phu phan	Nan
ภูกามยาว	phu kam yao	Nan
ภูกระดึง	phukradueng	Nan
ภิรมย์ภักดี	phirom phakdi	Nan
ภิรมย์	aangenaam	Nan
ภิญโญ	meer en meer	Nan
ภาษาโคบอล	cobol	Nan
ภูธเนศ	bhutanet	Nan
ภาพยนตร์ตอน	aflevering	None
มหาวิทยาลัยภูมินทร์พนมเปญ	phumin university, phnom penh	Nan
มหาวิทยาลัยมหาสารคาม	maha sarakham university	Nan
มังกี้	aap	None
มังคุด	mangosteen	Nan
มัจฉานุ	matcha	Nan
มัชฌิมาปฏิปทา	middelste pad	Nan
มัทนะพาธา	muthana phatha	Nan
มัธยฐาน	mediaan-	Nan
มัธยมศึกษา	voortgezet onderwijs	Nan
มัธยมศึกษาปีที่	rang	None
มันติคอร์	manticore	Nan
มัลเจร่า	malera	Nan
มากกว่า	over-	Nan
มากที่สุด	het meest	Nan
มากิ	maki	Nan
มาครอส	macross	Nan
มาจยาร์	mayar	Nan
มาจากภาษาละติน	uit het latijn	Nan
มาซากิ	masaki	Nan
มาลี	mali	Nan
มาลากุล	malakul	Nan
มาลัยพร	malai porno	Nan
มาร์แชล	marshall	None
มาร์ตินีก	martinique	Nan
มาร์ติน	martin	None
มะเร็ง	kanker	None
มาร์ช	moeras	Nan
มาริสา	marisa	Nan
มายน์ส	mijnen	None
มานี	mani	Nan
มาตรา	sectie	None
มาตรฐาน	standaard-	Nan
มาดริด	madrid	None
มาริเบล	maribel	Nan
มหาวิทยาลัยมหาจุฬาลงกรณราชวิทยาลัย	mahachulalongkornrajavidyalaya universiteit	Nan
มะริด	myeik	Nan
มะขาม	tamarinde	Nan
มหาวิทยาลัยมหิดล	mahidol university	Nan
มหาวิทยาลัยรังสิต	rangsit university	Nan
มหาวิทยาลัยราชภัฏบ้านสมเด็จเจ้าพระยา	bansomdejchaopraya rajabhat university	Nan
มหาวิทยาลัยราชภัฏสงขลา	songkhla rajabhat university	Nan
มหาวิทยาลัยราชภัฏสวนสุนันทา	suan sunandha rajabhat university	Nan
มหาวิทยาลัยราชภัฏอุตรดิตถ์	uttaradit rajabhat university	Nan
มหาวิทยาลัยราชภัฏเทพสตรี	thepsatri rajabhat university	Nan
มหาวิทยาลัยราชภัฏเลย	loei rajabhat university	Nan
มหาวิทยาลัยวงษ์ชวลิตกุล	wongchawalitkun universiteit	Nan
มหาวิทยาลัยศรีนครินทรวิโรฒ	srinakharinwirot university	Nan
มหาวิทยาลัยศรีปทุม	sripatum university	Nan
มหาวิทยาลัยศิลปากร	silpakorn university	Nan
มหาวิทยาลัยสุโขทัยธรรมาธิราช	sukhothai thammathirat open universiteit	Nan
มหาวิทยาลัยอีสาน	noordoostelijke universiteit	Nan
มหาวิทยาลัยอุบลราชธานี	ubon ratchathani university	Nan
มหาวิทยาลัยอ๊อกซฟอร์ด	universiteit van oxford	Nan
มหาวิทยาลัยเกษตรศาสตร์	kasetsart university	Nan
มอหาดใหญ่	mor hat yai	Nan
มอสส์	mos	Nan
มอส	mos	Nan
มอร์ริส	morris	None
มองโกเลียใน	binnen-mongolië	Nan
มหาวิทยาลัยแห่งแรกของประเทศไทย	de eerste universiteit van thailand	Nan
มะม่วงหิมพานต์	cashewnoot	Nan
มหาวิทยาลัยแม่โจ้	maejo university	Nan
มหาวิทยาลัยเทคโนโลยีราชมงคลอีสาน	rajamangala university of technology isan	Nan
มหาวิทยาลัยเทคโนโลยีราชมงคลสุวรรณภูมิ	rajamangala university of technology suvarnabhumi	Nan
มหาวิทยาลัยเทคโนโลยีราชมงคลธัญบุรี	rajamangala university of technology thanyaburi	Nan
มหาวิทยาลัยเทคโนโลยีราชมงคลตะวันออก	rajamangala university of technology tawan-ok	Nan
มหาวิทยาลัยเทคโนโลยีราชมงคลกรุงเทพ	rajamangala university of technology krungthep	Nan
มหาวิทยาลัยเทคโนโลยีพระจอมเกล้าพระนครเหนือ	king mongkut&#39;s university of technology north bangkok	Nan
มหาวิทยาลัยเปิด	open universiteit	Nan
มาสคาร่า	mascara	Nan
ภาพยนตร์ชุดนี้	deze filmset	Nan
ภาพยนตร์	films	None
พาร์ค	park	None
พาวเวอร์บาย	power buy	Nan
พาเมล่า	pamela	Nan
พิชัย	phichai	Nan
พิชิต	veroveren	None
พิณ	mandoline	Nan
พิธีกรรายการ	gastheer	None
พิบูลมังสาหาร	phibun mangsahan	Nan
พิพิธภัณฑสถานแห่งชาติ	nationaal museum	Nan
พิพิธภัณฑ์	museum	None
พิม	pim	None
พิมประภา	phimprapa	Nan
พิมพ์เล็ก	kleine afdruk	Nan
พิมลวรรณ	phimonwan	Nan
พิรุณ	regen	None
พิสุทธิ์	briljant	Nan
พิออจชา	phion thee	Nan
พุฒตาล	putthan	Nan
พื้นที่มหาวิทยาลัย	universitair gebied	Nan
พื้นฐานทางเศรษฐกิจ	economische basis	Nan
พืชไม่มีท่อลำเลียง	planten zonder pijpleidingen	Nan
พืชที่สำคัญคือ	belangrijke planten zijn	Nan
พืช	fabriek	None
พารามีเซียม	parametrisch	Nan
พึ่งสุนทร	vertrouw op sunthorn	Nan
พี่น้อง	broeders	None
พีอีเอ	pia	Nan
พีระศรี	phirasri	Nan
พีระมิด	piramide	None
พีท	pete	None
พิเศษนครกิจ	nakornkit special	Nan
พี่สาวของ	zus	None
พุทธคยา	bodh gaya	Nan
พารา	para	Nan
พากย์เป็น	dubbed als	Nan
พลอากาศเอกหญิง	vrouw acm	Nan
พลฯ	algemeen	None
พลังงานคลื่น	golfvermogen	Nan
พลังงานนิวเคลียร์	kernenergie	Nan
พลังงานลม	windkracht	Nan
พลังงานไฟฟ้า	elektrische energie	Nan
พลัส	plus	None
พลาซา	plein	None
พลาสติก	plastic	None
พลาสมา	plasma	Nan
พลเรือเอก	admiraal	None
พลเอกสนธิ	generaal sonthi	Nan
พวกสัตว์ลำตัวกลม	ronde lichaamsdieren	Nan
พศ	vr	Nan
พอ	genoeg	None
พอตเตอร์	pottenbakker	Nan
พอตเตอร์กับเจ้าชายเลือดผสม	potter en de halfbloed prins	Nan
พัลซาร์	pulsar	Nan
พับลิชชิ่ง	publiceren	None
พันธเสน	bond	None
พันธุ์สุนัข	hondenras	Nan
พันธุ์พืช	plantensoorten	None
พันธุศาสตร์	genetica	Nan
พายุ	storm	None
พันธมิตร	alliantie	None
พัทยาใต้	zuid-pattaya	Nan
พัทยาเหนือ	noord-pattaya	Nan
พัฒน์ชัย	phatchai	Nan
พัชรี	phachari	Nan
พอล	paul	None
พอยท์	punt	None
พัน	duizend	None
ภาพยนตร์การ์ตูนไทย	thaise tekenfilm	Nan
พุทธนิกายเถรวาท	theravada-boeddhisme	Nan
พุทธศักราช	boeddhistisch tijdperk	Nan
ฟุตบอล	amerikaans voetbal	Nan
ฟุตบอลอาเซียนเยาวชน	asean jeugdvoetbal	Nan
ฟุตบอลเอเชียเยาวชน	aziatische jeugdvoetbal	Nan
ฟู	vol	None
ฟูจิ	fuji	Nan
ฟูลส์	vol	None
ฟ้อน	dans	None
ฟ้า	blauw	None
ฟ้าร้อง	donder	Nan
ฟ้าหลัว	zonsopkomst	Nan
ภมรมนตรี	bamamon montri	Nan
ภักดี	loyaal	Nan
ภัณฑิลา	panthila	Nan
ภาคกลาง	centrale regio	Nan
ภาคคนแสดง	laten zien	Nan
ภาคตะวันตก	westerse regio	Nan
ภาคตะวันออกเฉียงเหนือ	noordoostelijke regio	Nan
ภาพพิมพ์	afbeelding afdrukken	Nan
ภาพพาโนรามา	panorama	Nan
ภาพถ่าย	foto	None
ภาพตรา	seal afbeelding	Nan
ภาคใต้ตอนล่าง	lagere zuidelijke regio	Nan
ภาคเหนือ	noorden	None
ฟุตซอล	futsal	Nan
ภาควิชาเทคโนโลยีอาหาร	afdeling levensmiddelentechnologie	Nan
ภาควิชาวิศวกรรมไฟฟ้า	afdeling elektrotechniek	Nan
ภาควิชาวิศวกรรมเครื่องกล	departement werktuigkunde	Nan
ภาควิชาฟิสิกส์	afdeling fysica	Nan
ภาควิชาพยาธิวิทยา	afdeling pathologie	Nan
ภาควิชาคณิตศาสตร์	afdeling wiskunde	Nan
ภาคพิเศษ	speciaal	None
ภาควิชาสูติศาสตร์และนรีเวชวิทยา	afdeling verloskunde en gynaecologie	Nan
พุทธศตวรรษที่	eeuwse boeddhist	Nan
ฟีฟ่าคลับเวิลด์คัพ	fifa club world cup	Nan
ฟิสิกส์อนุภาค	deeltjesfysica	Nan
พุ่มพวง	vrouw	None
พู่กัน	penseel	Nan
พ่อขุนรามคำแหง	koning ramkhamhaeng	Nan
พ่อขุนศรีอินทราทิตย์	koning intharathit	Nan
พ่อมด	wizard	Nan
พ่ายแพ้ให้กับ	verloren tegen	Nan
พ๎ร	welkom	None
ฟง	fong	Nan
ฟรานซ์	franz	None
ฟรีดริช	friedrich	None
ฟรีด้อม	gratis sluipen	Nan
ฟรีแวร์	freeware	Nan
ฟลายเวท	vlieggewicht	Nan
ฟลูวาสแตติน	fluvastin	Nan
ฟอน	von	None
ฟอร์ด	ford	None
ฟอสฟอรัส	fosfor	Nan
ฟิสิกส์ดาราศาสตร์	astrofysica	Nan
ฟิวชัน	fusie	None
ฟิลิปีโน	philippino	Nan
ฟิลิปปินส์	filippijnen	Nan
ฟิลิป	philip	None
ฟินแลนด์	finland	None
ฟีนิลคีโตนูเรีย	fenylketonurie	Nan
ฟิชเชอร์	visser	Nan
ฟาง	rietje	Nan
ฟัน	tanden	None
ฟังไจ	luister naar jaime	Nan
ฟังเพลง	luisteren naar muziek	Nan
ฟังพระธรรมเทศนา	luister naar preken	Nan
ฟอสเฟต	fosfaat	Nan
ฟาน	van	None
มาเก๊า	macau	Nan
มาเฟีย	maffia	None
มาเรีย	maria	None
รัฐธรรมนูญแห่งราชอาณาจักรไทย	grondwet van het koninkrijk thailand	Nan
รัฐบาลไทย	thaise regering	Nan
รัฐบุรุษ	staatsman	Nan
รัฐประหาร	coup	Nan
รัฐประหารในประเทศไทย	staatsgreep in thailand	Nan
รัฐมนตรีว่าการกระทรวงคมนาคม	minister van verkeer	Nan
รัฐวิสาหกิจ	staatsonderneming	Nan
รัฐวิสาหกิจไทย	thaise staatsbedrijven	Nan
รัฐสภา	parlement	None
รัฐสีมาคุณากรปิยชาติ	ratthasima kunakornpiyachat	Nan
รัฐอิลลินอยส์	illinois	Nan
รัฐเทกซัส	texas	None
รัตนบุรี	rattanaburi	Nan
รัตนาธิเบศร์	rattanathibet	Nan
รับบทโดย	gespeeld door	Nan
รับพระราชทาน	aanvaarden	None
รัศมี	straal	None
ราชวงศ์ทิพย์จักราธิวงศ์	de koninklijke familie, chakrathiwong	Nan
ราชวงศ์ถัง	tang-dynastie	Nan
ราชวงศ์ชิง	qing-dynastie	Nan
ราชวงศ์จิ้นตะวันออก	oostelijke jin-dynastie	Nan
ราชมังคลากีฬาสถาน	rajamangala-stadion	Nan
ราชนาวี	marine	None
รัชดาภิเษก	ratchadaphisek	Nan
ราชตระกูล	koninklijke familie	Nan
รางวัลโนเบล	nobelprijs	None
รางวัลนาฏราช	royal dancer awards	Nan
รางวัลนักร้องไทยสากลชายยอดนิยม	populaire male thai international singer award	Nan
รางวัลนักร้องยอดเยี่ยม	prijs voor beste zanger	Nan
รากแก่น	kernwortel	Nan
รัสเซล	russell	None
รางวัลไนน์เอ็นเตอร์เทน	negen entertainment award	Nan
ราชวงศ์บ้านพลูหลวง	koninklijk huis van plu luang	Nan
รัชกาลสมเด็จพระจุลจอมเกล้าเจ้าอยู่หัว	regering van koning chulalongkorn	Nan
รังสีแกมมา	gamma-straal	Nan
ระดับการกระโดดสูง	hoge sprong	Nan
ระดับปริญญาเอก	phd-niveau	Nan
ระดับปริญญาโท	diploma van een master opleiding	Nan
ระดับมัธยมศึกษา	ondergeschikt	None
ระดับอาชีวศึกษา	beroepsniveau	Nan
ระนอง	ranong	Nan
ระนาด	xylofoon	Nan
ระนาดทุ้ม	alt xylofoon	Nan
ระนาดเอก	alt	Nan
ระบบ	systeem	None
ระบบกษัตริย์ของกัมพูชา	cambodjaanse monarchie	Nan
ระบบรัฐสภา	parlementair systeem	Nan
ระบบสืบพันธุ์	voortplantingssysteem	Nan
ระบบสุริยะ	zonnestelsel	None
ระบบโครงกระดูก	skelet-systeem	Nan
ระบบใช้อำนาจเด็ดขาด	absoluut krachtsysteem	Nan
ระยะ	fase	None
รังสีเอกซ์	röntgenfoto	Nan
รังสี	straal	None
รังสิตคลอง	rangsit khlong	Nan
รักแห่งสยาม	liefde voor siam	Nan
รักษาสิ่งแวดล้อม	het milieu beschermen	Nan
รักษาศีล	neem de voorschriften in acht	Nan
รัชกาลที่	regeren	None
ระโนด	dood	None
ระเบียง	balkon	Nan
ระหว่างสงครามโลกครั้งที่	tijdens de wereldoorlog	Nan
ระหว่างปี	tijdens het jaar	Nan
ระวิ	tussen	None
ระยะเวลาการดำรงตำแหน่ง	servicetermijn	Nan
ระยะเวลา	looptijd	Nan
ระเบียบ	bestellen	Nan
ระดับกระโดดสูง	hoge sprong	Nan
ราชวงศ์พระร่วง	phra ruang-dynastie	Nan
ราชวงศ์อู่ทอง	u-thong-dynastie	Nan
รูปวรรณยุกต์	tonale vorm	Nan
รูปสามเหลี่ยมมุมป้าน	stompe driehoek	Nan
รูปสี่เหลี่ยมด้านขนาน	parallellogram	Nan
รูสเวลต์	roosevelt	None
ร็อดฟอร์ม	rod form	Nan
ร่วมแสดงกับ	optreden met	Nan
ร้องคู่กับ	zing mee	Nan
ร้องร่วมกับ	zing mee	Nan
ร้องโดย	gezongen door	Nan
ร้อยตรี	tweede luitenant	Nan
ร้านอาหาร	een restaurant	Nan
ฤดูกาล	het seizoen	Nan
ฤดูฝน	regenseizoen	Nan
ฤดูร้อน	warm seizoen	Nan
ล	de	None
ลงวันที่	gedateerd	None
ลพบุรี	hangoor buri	Nan
ลักษณะภูมิอากาศ	klimaat	None
ลักษณะทางกายภาพ	fysieke eigenschappen	Nan
ลักษณะทั่วไป	algemene karakteristieken	Nan
ลักษณะ	kijken	None
ละติจูด	breedtegraad	None
ละครโทรทัศน์	soap	None
รูปร่าง	vorm	None
ละครเพลง	muzikaal	None
ละครวิทยุ	radio drama	Nan
ละครชาตรี	chatri-drama	Nan
ละคร	drama	None
ลอร์ด	de heer	Nan
ลอยกระทง	loy kratong festival	Nan
ลอนดอน	londen	None
ละครสั้น	kort drama	Nan
ราชวงศ์หยวน	yuan-dynastie	Nan
รูปภาพ	beeld	None
รูดอล์ฟ	rudolph	Nan
ราชสกุล	munten	None
ราชสีมา	ratchasima	Nan
ราชินิกุล	familieleden van de koningin	Nan
ราบเป็นหน้ากลอง	wees duidelijk	Nan
รามอินทรา	ramintra	Nan
รายการ	lijst	None
รายการวันสำคัญทางพุทธศาสนา	lijst met belangrijke boeddhistische data	Nan
รายชื่อ	lijst	None
รายชื่อคำในภาษาไทยที่มักเขียนผิด	lijst met thaise woorden die vaak onjuist zijn geschreven	Nan
รายชื่อภาพยนตร์ไทย	lijst met thaise films	Nan
รายชื่อหุ่นยนต์ใน	lijst met robots in	Nan
รายชื่ออธิการบดี	lijst van kanseliers	Nan
รายชื่อเพลง	lijst met nummers	Nan
รายนามรองอธิการประจำวิทยาเขต	namenlijst van vicerector campus	Nan
รายนามอธิการบดี	lijst van de president	Nan
รายพระนามพระมหากษัตริย์ไทย	lijst van thaise koningen	Nan
รายะนาค	raya nak	Nan
รุ่งเพชร	rung petch	Nan
รุ่งสว่าง	dageraad	Nan
รุ่ง	dageraad	Nan
รุจิพรรณ	rujipan	Nan
รีเนียม	rhenium	Nan
รีสอร์ท	een verblijf	Nan
รูทีเนียม	ruthenium	Nan
ริเอะ	rie	Nan
ริมแม่น้ำเจ้าพระยา	rivier chao phraya rivier	Nan
ริน	giet	Nan
รำพันพิลาป	schreeuw	Nan
ราศีธนู	boogschutter	Nan
ราวพุทธศตวรรษที่	rond de eeuw	Nan
รายได้อื่น	ander inkomen	Nan
ริวซากิ	ryuzaki	Nan
รอบเมือง	rond de stad	Nan
รอบที่	ronde	None
รอบชิงชนะเลิศระดับประเทศ	nationale finales	Nan
มีน	min	None
มีนบุรี	min buri	Nan
มีนวิทยา	minologie	Nan
มีนายกรัฐมนตรี	heb premier	Nan
มีประวัติศาสตร์ยาวนาน	heeft een lange geschiedenis	Nan
มีพรมแดนทางทิศใต้จรดกับอ่าวไทย	in het zuiden begrensd door de golf van thailand	Nan
มีภูเขาล้อมรอบอยู่	omgeven door bergen	Nan
มีลักษณะดังนี้	heeft de volgende kenmerken	Nan
มีลักษณะภูมิประเทศคล้ายชามหรืออ่าง	heeft functies zoals een kom of bak	Nan
มีลาภ	heb een fortuin	Nan
มีล่า	ga op jacht	Nan
มีสูตรการคำนวณหาจำนวนฟัน	er is een formule om het aantal tanden te berekenen.	Nan
มีอยู่	bestaan	None
มีอุณหภูมิเฉลี่ย	gemiddelde temperatuur	Nan
มีอุทยานแห่งชาติสำคัญหลายแห่ง	er zijn veel belangrijke nationale parken.	Nan
มีเดีย	media	None
มีโคลซีน	met cole scene	Nan
ยอดนักสืบจิ๋วโคนัน	detective conan	Nan
ยอด	de elite	Nan
ยศ	rang	None
ยกเว้น	behalve	None
ย	de	None
ม้าม	milt	None
มีทิวเขาล้อมรอบทางเหนือ	met bergketens in het noorden	Nan
ม้า	paard	None
มเชียงใหม่	chiang mai	Nan
มูลสาร	fundamentals	Nan
มูลนิธิอานันทมหิดล	anandamahidol foundation	Nan
มูลนิธิชัยพัฒนา	stichting chaipattana	Nan
มู	glad	Nan
มือ	hand-	Nan
มโนราห์	manohra	Nan
ยอดเขาสูงที่สุดของกัมพูชาคือ	de hoogste top van cambodja is	Nan
มีทั้งสิ้น	allemaal	None
มีด	een mes	Nan
มาเลเซีย	maleisië	None
มาเลเซียตะวันตก	west maleisië	Nan
มิจิรุ	michiru	Nan
มิตร	vriendelijk	Nan
มิตรชัย	mitchai	Nan
มิตรเพชรา	vriendelijk	Nan
มิถุนายน	juni	None
มินต์	munt	None
มิลจิ	milji	Nan
มิลตัน	milton	Nan
มิลฟีโอเล่	milfi ole	Nan
มิลลิเมตร	mm.	Nan
มิลินทจินดา	milinthinda	Nan
มิล่า	mila	Nan
มิว	miauw	Nan
มิวฟิลโอเล่	muildier phil ole	Nan
มิวสิกวีดีโอ	videoclip	None
มีชื่อเล่นว่า	bijgenaamd	Nan
มีชื่อว่า	genaamd	None
มีฉายาว่า	met de bijnaam	Nan
มีจำนวน	heb een nummer	Nan
มีความหมายว่า	betekenis	None
มีความยาว	heb een lengte	Nan
มีดาบฟันวิญญาณ	met een geestzwaard	Nan
มีข้อความว่า	gelabeld	Nan
มิโร	miro	Nan
มิเตอร์	meter	None
มิเชล	michelle	None
มิเกล	miguel	None
มิฮอว์ค	mihawk	Nan
มิสทีน	mistine	Nan
มีขนาดใหญ่	groot	None
ยอพระกลิ่น	yor phra klin	Nan
ยัง	naar	None
ยาขับปัสสาวะ	diureticum	Nan
ยูโรเพียม	europium	Nan
ยูไนเต็ด	verenigde	None
ย่านตาขาว	yan khao	Nan
รณชัย	ronnachai	Nan
รณภพ	wereld	None
รณฤทธิ์	strijd	None
รถด่วนสายทางช้างเผือก	de melkweg express-bus	Nan
รถประจำทางสาย	buslijn	Nan
รถยนต์อเนกประสงค์	multifunctionele auto	Nan
รถลาก	riksja	Nan
รถโดยสารประจำทาง	bus	None
รถโดยสารประจำทางสาย	buslijn	Nan
รถไฟฟ้าชานเมืองสายสีแดงอ่อน	voorstad van rood licht	Nan
รถไฟฟ้ามหานคร	mrt	Nan
รฟม	r.o.	Nan
รวดเร็ว	snel	None
รวม	op te nemen	Nan
รอบคอบ	voorzichtig	None
รอบ	in de omgeving van	Nan
รอญับ	wacht	None
รองเท้า	schoenen	None
รองประธานสภาคนที่สอง	tweede vice-voorzitter van de raad	Nan
รองประธานรัฐสภาคนที่หนึ่ง	eerste vice-voorzitter van het parlement	Nan
ยูโด	judo	None
รอก	haspel	Nan
รศ	associëren	Nan
รวมระยะทางทั้งสิ้น	totale afstand	Nan
รวมทั้งสิ้น	eindtotaal	Nan
รวมทั้งประเทศที่ให้ความช่วยเหลืออื่นๆ	inclusief landen die andere hulp bieden	Nan
รวมทั้ง	inclusief	None
รวมกับ	gecombineerd met	Nan
รหัส	code	None
ยูริ	yuri	Nan
ยูฟ่า	uefa	Nan
ยูกิโอ	yukio	Nan
ยีน	gen	None
ยิ้มสู้	glimlach	Nan
ยิ่งลักษณ์	yingluck	Nan
ยิ่งยง	yingyong	Nan
ยามเย็น	avond	None
ยามาโมโตะ	yamamoto	Nan
ยืนยง	verdragen	None
ยามาโตะ	yamato	Nan
ยาบ้า	amfetamine	Nan
ยานอวกาศ	ruimteschip	Nan
ยานอนหลับ	slaappillen	Nan
ยางามิ	yagami	Nan
ยางธรรมชาติ	natuurlijk rubber	Nan
ยาง	rubber	None
ยาปฏิชีวนะ	antibiotica	None
พลอสนธิ	polson junction	Nan
ยุคกลาง	middeleeuwen	None
ยุคที่	tijdperk	None
ยู	u	None
ยุ้ย	overdreven	None
ยุวธิดา	jonge dochter	Nan
ยุทธนาวี	slag bij de marine	Nan
ยุคใหม่	nieuwe tijd	Nan
ยุคโลหะ	metaal leeftijd	Nan
ยุคก่อนประวัติศาสตร์	prehistorisch tijdperk	Nan
ยุคโบราณ	oude tijden	Nan
ยุคเรเนสซองส์	renaissance-tijdperk	Nan
ยุคอาณาจักรเหนือใต้	noord- en zuid-koninkrijkstijdperk	Nan
ยุคอะซึกะ	asuka-tijdperk	Nan
ยุคสามก๊ก	three kingdoms tijdperk	Nan
ยุคศตวรรษที่	eeuw tijdperk	Nan
ยุคปัจจุบัน	moderne tijden	Nan
ยุคเฮอัง	heian tijdperk	Nan
ธรรมเมกขสถูป	dharma makk stupa	Nan
พลอย	edelsteen	Nan
พลทหาร	soldaat	None
บริเวณรอบทะเลสาบเขมร	rond het khmer-meer	Nan
บริเวณเขตภูเขาทางภาคเหนือ	bergachtig gebied in het noorden	Nan
บรูไน	brunei	Nan
บลีช	bleken	None
บลู	blauw	None
บลูคอสมอส	blauwe kosmos	Nan
บลูเบอร์รี่	bosbes	Nan
บวก	positief	None
บวม	zwelling	None
บวร	goddelijk	Nan
บอมบ์	bom	Nan
บอย	jongen	None
บอยซ์	boyz	Nan
บอล	de bal	Nan
บอลด์วิน	baldwin	Nan
บอส	de baas	Nan
บังคลาเทศ	bangladesh	None
บาคุกันลูกน้องของนากา	bakugan, een aanhanger van naga	Nan
บาคุกันธาตุไฟ	bakugan fire element	Nan
บาคคัส	bacchus	Nan
บัวใหญ่	bua yai	Nan
บัวเชด	lotusbloem	Nan
บัวลอย	bualoy	Nan
บริหารธุรกิจ	bedrijfskunde	Nan
บัว	lotus	Nan
บันทึกความทรงจำ	memo	Nan
บันทึกการสร้างโลก	wereldrecord	Nan
บันทึก	vermelding	None
บัณฑิตวิทยาลัยร่วมด้านพลังงานและสิ่งแวดล้อม	gezamenlijke graduate school of energy and environment	Nan
บัณฑิต	afstuderen	Nan
บังไค	bangkai	Nan
บันเทิง	entertainment	None
บางกอกกล๊าส	bangkok glas	Nan
บริสุทธิ์	zuiver	None
บริพัตร	eten	None
นี่คือ	dit is	Nan
นุช	vreugde	None
นเรศ	nares	Nan
นโยบายทางการทูตของจีน	diplomatiek beleid van china	Nan
น็อกซ์	knox	Nan
น้องครีม	nong cream	Nan
น้องชาย	jongere broer	Nan
น้อยมาก	heel weinig	Nan
น้ำ	water	None
น้ำค้าง	dauw	Nan
น้ำดื่ม	drinkwater	Nan
น้ำท่วม	overstroming	Nan
น้ำฝน	regenwater	Nan
น้ำพอง	opblaasbaar	Nan
น้ำมะนาว	citroensap	Nan
น้ำมัน	olie	None
น้ำมันสน	terpentijn	Nan
บริบาล	zorg	None
บราเธอร์ส	broeders	None
บราซิเลีย	brasilia	Nan
บรรพชีวินวิทยา	paleontologie	Nan
บรรณาธิการ	editor	Nan
บรมนาถบพิตร	boromnat bophit	Nan
บริวเวอรี่	brouwerij	Nan
บรมนาถชาติอาชาวศรัย	borommanachat achan sai	Nan
บทสวดสรภัญญะที่ขึ้นต้นด้วยธรรมมะคือ	sorapanya-gezangen die beginnen met dharma zijn	Nan
บทสวดบาลีที่ขึ้นต้นด้วยอรหัง	pali chanten dat begint met de arhat	Nan
บทบาททางการเมือง	politieke rol	Nan
บทนมัสการนอบน้อมบูชาพระพุทธเจ้า	hoofdstukken van de nederige aanbidding van de heer boeddha	Nan
น้ำหนัก	gewicht	None
น้ำยืน	stilstaand water	Nan
บนบก	op het land	Nan
นีโอ	neo	Nan
บางกอกน้อย	bangkok noi	Nan
บางซื่อ	bang sue	Nan
บ้านฉาง	ban chang	Nan
บ้านปราสาท	kasteelhuis	Nan
บ้านผือ	ban phue	Nan
บ้านฝันดอตคอม	baan fan com	Nan
บ้านลาด	ban lad	Nan
บ้านเขว้า	huis	None
บ้านแพ้ว	huis	None
บ้านโพธิ์	ban pho	Nan
ปจ	jaar	None
ปช	strand	None
ปฏิทินช่อง	kanaalagenda	Nan
ปฏิภาณ	esprit	Nan
ปตท	ptt	Nan
ปทานุกรม	lexicon	Nan
ปทุมธานี	pathum thani	Nan
ปภ	veiligheid	None
ปภัสรา	papassara	Nan
ประติมากรรม	beeldhouwwerk	Nan
ประดิษฐาน	plaats	None
ประชากรศาสตร์	demografie	None
ประชากรประมาณ	geschatte populatie	Nan
ประจำปี	jaarlijks	None
ประจักษ์	manifesteren	Nan
บ่อทอง	vijver goud	Nan
ประจวบคีรีขันธ์	prachuap khiri khan	Nan
ประกาศเป็นป่าสงวน	verklaard als bosreservaat	Nan
ประกาศิต	besluit	None
ประการที่	aantal	None
ประกอบไปด้วย	bestaat uit	Nan
ประกอบด้วย	omvatten	None
ปม	de knoop	Nan
ประจวบ	botsen	Nan
บางครั้ง	soms	None
บูมเมอแรง	boemerang	Nan
บุตร	kind	None
บางปะกอก	bang pakok	Nan
บางปะหัน	bang pahan	Nan
บางพลัด	bangplad	Nan
บางส่วน	sommige	None
บางเขน	bang khen	Nan
บางแสน	bangsaen	Nan
บางใหญ่	bang yai	Nan
บานไม่รู้โรย	amarant	Nan
บารอมิเตอร์	barometer	Nan
บารัก	barack	None
บาร์	bar	None
บาลี	pali	Nan
บาอัล	baal	Nan
บิน	vlieg	Nan
บิล	bill	None
บิ๊กซี	grote c	Nan
บิ๊กซ้งซุปเปอร์สโตร์	big song superstore	Nan
บุณยเกตุ	bunyaket	Nan
บุญนาค	verdienste	Nan
บุญนะโชติ	bunnachot	Nan
บุญค้ำ	verdienste	Nan
บุช	struik	Nan
บุคลิกภาพ	persoonlijkheid	None
บุษบา	bloem	None
บุคคลสำคัญ	belangrijk persoon	Nan
บี้สุกฤษฎิ์	bie sukrit	Nan
บี้	afbrokkelend	Nan
บีฟเค้ก	rundvlees cake	Nan
บีบี	bb	Nan
บีช	het strand	Nan
บี	b.	Nan
บุคคล	persoon	None
ประติมากรรมไทย	thaise sculptuur	Nan
นิ่มสกุล	nim sakul	Nan
นิเทศศาสตรบัณฑิต	bachelor of arts	Nan
นอกจากนี้แล้ว	trouwens	None
นอกเหนือจากนี้	anders dan	Nan
นอนไม่หลับ	ik kan niet slapen	Nan
นอร์ส	noors	None
นะงะซะกิ	nagasaki	Nan
นะโม	namo	Nan
นักดนตรี	musicus	Nan
นักบินของออร์บ	orb&#39;s piloot	Nan
นักบินอวกาศ	astronaut	Nan
นักปรัชญา	filosoof	None
นักพากย์	stemacteur	Nan
นักมวย	bokser	Nan
นักร้อง	de zanger	Nan
นักร้องชายไทย	thaise mannelijke zangers	Nan
นักร้องนักดนตรี	zanger muzikant	Nan
นักร้องเพลงไทยสากลชาย	internationale thaise zangeres	Nan
นักร้องเสียงหลัก	hoofdzanger	Nan
นันทนาการ	recreatie	None
นัดกับนัด	date met	Nan
นักแสดงรับเชิญ	uitgenodigde acteur	Nan
นักแสดงพิธีกร	acteur	None
นักแสดง	de acteurs	Nan
นักแต่งเพลง	songwriter	Nan
นอกจากนี้	in aanvulling op	Nan
นักเศรษฐศาสตร์	econoom	Nan
นักเขียนการ์ตูน	cartoonist	Nan
นักเขียน	de schrijver	Nan
นักสู้อันดับ	geclassificeerd als vechter	Nan
นักศึกษาวิชาทหาร	militaire student	Nan
นักวิทยาศาสตร์	de wetenschapper	Nan
นักวิชาการ	academisch	None
นักเต้นนำ	lead danser	Nan
นันทนาคร	nanthanakorn	Nan
นอกจาก	trouwens	None
นวรัตน์	nawarat	Nan
ธารทิพย์	dan thip	Nan
ธำมงรค์	thamrong	Nan
ธิติกานต์	thitikan	Nan
ธีม	het thema	Nan
ธีระ	thira	Nan
ธีรเดช	thiradej	Nan
ธุรกิจ	een bedrijf	Nan
ธุรกิจการบิน	luchtvaart	None
นก	vogel	None
นกกระจอก	mus	Nan
นกกระทา	kwartel	Nan
นกกระทุง	pelikaan	Nan
นกกระเต็น	ijsvogel	Nan
นกขมิ้น	kanarie	Nan
นกน้อย	vogeltje	Nan
นกแก้ว	papegaai	Nan
นกแอร์	nok air	Nan
นวนิยาย	roman	None
นราธิวาส	narathiwat	Nan
นราธิป	narathip	Nan
นร	leerling	None
นพดล	nopadon	Nan
นพจินดา	noppachinda	Nan
นวล	ivoor	Nan
นปช	udd	Nan
นครหลวงเวียงจันทน์	vientiane capital	Nan
นครสวรรค์	nakhon sawan	Nan
นครราชสีมา	nakhon ratchasima	Nan
นครพนม	nakhon phanom	Nan
นครปฐม	nakhon pathom	Nan
นครนิวยอร์ก	new york city	Nan
นที	zijrivier	Nan
นิ่ม	zacht	None
นันทเสน	nanthasen	Nan
นับตั้งแต่เริ่มก่อตั้งจนถึงปัจจุบัน	sinds de oprichting tot heden	Nan
นายสวัสดิ์	mr. sawat	Nan
นายสุชาติ	meneer suchart	Nan
นายสุนทร	meneer sunthorn	Nan
นายแพทย์	dokter	None
นารูโตะ	naruto	Nan
นาวาอากาศเอกหญิง	squadron leader	Nan
นาฬิกา	klok	None
นาโนเทคโนโลยี	nanotechnologie	Nan
นำกลับมาสร้างใหม่อีกครั้ง	teruggebracht om opnieuw te creëren	Nan
นำแสดงโดย	met in de hoofdrol	Nan
นำโดย	geleid door	Nan
นิกาย	sekte	None
นิกเกิล	nikkel	Nan
นิคมพัฒนา	nikom phatthana	Nan
นิตยสารชีวจิต	homeopathisch tijdschrift	Nan
นิตยสารเอเชียวีก	asia week magazine	Nan
นิตโย	nittayo	Nan
นิฮง	nihong	Nan
นิวเคลียส	kern	None
นิวเคลียร์	nucleair	Nan
นิวัฒน์	niwat	Nan
นิวยอร์ก	new york	Nan
นิวคลีโอไทด์	nucleotide	Nan
นายสมัคร	aanvrager	Nan
นิลภิรมย์	nilphirom	Nan
นิรันดร์กุล	nirunkun	Nan
นิรมิต	droom	None
นิยาม	bepalen	None
นิยมจัดขึ้นในเดือน	populair gehouden in de maand	Nan
นิยม	populair	None
นิทาน	verhaal	None
นิรุกติศาสตร์	etymologie	None
นันทไกร	nantakrai	Nan
นายสมชัย	mr. somchai	Nan
นายยงยุทธ	mr yongyut	Nan
นัยนา	oog	None
นั่นคือ	dat is	Nan
นั่นเอง	daar	None
นั้น	dat	None
นา	veld	None
นากา	naga	Nan
นากิ	nagi	Nan
นาคหิรัญกนก	nak hirankanok	Nan
นางงามจักรวาล	miss universe	Nan
นางสาวสุวรรณ	miss suwan	Nan
นางสุพรรณมัจฉา	mevrouw suphan matcha	Nan
นางาโตะ	nagato	Nan
นาดี	nadi	Nan
นาดูน	na dun	Nan
นาทวี	nathawi	Nan
นาทาล	natal	Nan
นาที	minuut	None
นายปรีดี	mr. pridi	Nan
นายปรีชา	mr. preecha	Nan
นายประกอบ	mr assembly	Nan
นายทวี	mr thawee	Nan
นายดำรง	mr damrong	Nan
นายณรงค์	mr. narong	Nan
นายศักดา	mr. sakda	Nan
นายชาญชัย	meneer chanchai	Nan
นายชลอ	mr chalo	Nan
นายกำพล	mr. kampon	Nan
นายกรัฐมนตรีไทย	thaise premier	Nan
นายกรัฐมนตรีของประเทศไทย	premier van thailand	Nan
นามิ	nami	Nan
นานา	talrijk	Nan
นายชวน	meneer chuan	Nan
ประตู	deur	None
ประตูน้ำ	dam	None
ประตูเสีย	gebroken deur	Nan
พงศ์ศิลป์พิพัฒน์	pongsilp phiphat	Nan
พงศ์เรืองรอง	pongrueangrong	Nan
พงษ์พานิช	pongpanich	Nan
พงษ์เพชร	phong phet	Nan
พงษ์ไพบูลย์	phongpaibun	Nan
พจนานุกรมออนไลน์	online woordenboek	Nan
พญา	slang	None
พญามังราย	phaya mangrai	Nan
พตท	oppervlakte	None
พธม	th	Nan
พนมไพร	phanom phrai	Nan
พบหลักฐานของมนุษย์ซึ่งมีอายุเก่าแก่ที่สุดถึงห้าแสนปี	vond bewijs van mensen, de oudste tot vijfhonderdduizend jaar.	Nan
พยัญชนะ	medeklinker	Nan
พยัญชนะสะกดควบกล้ำ	medeklinkers	Nan
พยางค์	lettergreep	Nan
พยาธิกำเนิด	pathogenese	Nan
พยาธิวิทยา	pathologie	Nan
พรอุดมศักดิ์	phonudomsak	Nan
พรรคเพื่อแผ่นดิน	pheu thai party	Nan
พรรคสังคมประชาธิปไตย	sociaal-democratische partij	Nan
พรรคสม	vergelijkingspartij	Nan
พรรคภูมิใจไทย	phuea thai party	Nan
พรรคประชาธรรม	prachatham-feest	Nan
พ	t	None
พรรคธรรมาธิปัตย์	thammathipat-feest	Nan
พรรคการเมืองใหม่	nieuwe politieke partij	Nan
พรบ	handelen	None
พรนารายณ์	narai	Nan
พร	porno	Nan
พยายามชี้ให้สาธารณชนและนานาชาติ	proberen te wijzen op het publiek en internationaal	Nan
พยาบาล	verpleegster	Nan
พรรคชาติไทย	grafiek thaise partij	Nan
พระคาถาชินบัญชร	incantation chinnabanchon	Nan
ฝ้าย	katoen	None
ฝ่าเท้า	voetzool	Nan
ผิวสี	huidskleur	None
ผี	geest	None
ผีน่ารัก	leuke geest	Nan
ผู้กำกับ	regisseur	None
ผู้จัดการ	manager	None
ผู้จัดการทีม	team manager	Nan
ผู้ชนะ	de winnaar	Nan
ผู้ชาย	mens	None
ผู้ช่วยศาสตราจารย์	assistent professor	Nan
ผู้ดำเนินรายการ	moderator	Nan
ผู้บริหาร	executive	None
ผู้ผลิต	de fabrikant	Nan
ผู้ฝึกสอน	trainer	None
ผู้พิทักษ์แห่งพิรุณ	bewaker van problemen	Nan
ผู้พิทักษ์แห่งอรุณ	guardian of the dawn	Nan
ผู้ว่าการธนาคารแห่งประเทศไทย	gouverneur van de bank of thailand	Nan
ผู้ว่าราชการจังหวัด	gouverneur	None
ฝ่ายบริหาร	beheer	None
ฝ่ามือ	palm	Nan
ฝูงชนวุ่นวาย	chaotische menigte	Nan
ฝิ่น	opium	Nan
ฝอยทอง	dons	Nan
ฝ	de	None
ฝ่าแดนเขาวงกต	door het doolhof	Nan
ผ้าอนามัยโซฟี	sophie maandverband	Nan
ผ่องศรี	phongsri	Nan
ผู้ใหญ่	volwassen	None
ผู้เล่นชุด	speler instellen	Nan
ผู้เล่น	de spelers	Nan
ผู้อำนวยการ	de directeur	Nan
ผู้สนับสนุน	supporter	Nan
ผ้าขาวม้า	lendendoek	Nan
ผิวขาว	witte huid	Nan
พระจันทร์	maan	None
พระชนม์	leven	None
พระยาวิเศษภักดี	phraya wisetphakdi	Nan
พระยาสุนทรสงคราม	phraya sunthornsongkram	Nan
พระยาไกรภักดีศรีนครลำดวน	phraya kraiphakdi srinakhon lamduan	Nan
พระราชกรณียกิจ	koninklijke plichten	Nan
พระราชลัญจกรประจำพระองค์	koninklijk zegel	Nan
พระราชวงศ์	koninklijke familie	Nan
พระราชวรวงศ์เธอ	koninklijke familie	Nan
พระราชวังดุสิต	dusit palace	Nan
พระราชวังเดิม	origineel paleis	Nan
พระลอ	phra lor	Nan
พระสมเด็จจิตรลดา	phra somdej chitralada	Nan
พระสัมมาสัมพุทธเจ้า	heer buddha	Nan
พระองค์เจ้าสิริวัณณวรีนารีรัตน์	zkh prinses siriwannawari wareerat	Nan
พระอังสาเบื้องซ้ายประดับเหรียญรัตนาภรณ์	gunstig boeddha-amulet aan de linkerkant, versierd met rattanaporn	Nan
พระอัษฎามหาเจดีย์	phra asada maha chedi	Nan
พระอิศวร	shiva	None
พระอิสริยยศ	koninklijke titel	Nan
พลตำรวจเอก	politie-generaal	Nan
พลตรีหญิง	vrouwelijke luchtmacht	Nan
พลตรี	luchtmacht	None
พฤกษศาสตร์	plantkunde	Nan
พริกไทย	peper	Nan
พริกหวาน	paprika	Nan
พระยาราม	phraya ram	Nan
พริกหยวก	paprika	Nan
พรานกระต่าย	jager	Nan
พระโคตมพุทธเจ้า	boeddha amulet	Nan
พระเจ้าหลานเธอ	god je nichtje	Nan
พระเจ้าลูกยาเธอ	god kind	Nan
พระเกียรติยศ	eer	None
พระอุโบสถ	boeddhistische tempel	Nan
พราหมณ์	brahmin	Nan
พระจันทร์สีรุ้ง	regenboog maan	Nan
พระยาชัยสุนทร	phraya chai soonthorn	Nan
พระมเหสี	consort	Nan
พระตำหนัก	paleis	None
พระที่นั่งจักรพรรดิพิมาน	het keizer phiman-paleis	Nan
พระที่นั่งดุสิตมหาปราสาท	dusit maha prasat throne hall	Nan
พระที่นั่งบรมพิมาน	boromphiman mansion	Nan
พระธรรมปิฎก	dhammapitaka	Nan
พระธิดา	dochter	None
พระนคร	hoofdstad	None
พระนาม	naam	None
พระนามต้นราชสกุล	voornaam	None
พระนารายณ์	vishnu	Nan
พระบรมธาตุไชยา	boeddha&#39;s relikwieën	Nan
พระบรมราชชนก	koninklijk beschermheerschap	Nan
พระบรมราชินี	koningin	None
พระบรมวงศานุวงศ์	royalty	Nan
พระบาทสมเด็จพระนั่งเกล้าเจ้าอยู่หัว	koning nang klao	Nan
พระบาทสมเด็จพระปกเกล้าเจ้าอยู่หัว	koning prajadhipok	Nan
พระบาทสมเด็จพระปรเมนทรมหาอานันทมหิดล	zijne majesteit koning bhumibol adulyadej maha anandamahidol	Nan
พระมงกุฏเกล้าเจ้าอยู่หัว	koning rama iv	Nan
พระพุทธศาสนา	boeddhisme	None
พระพุทธบาท	voetafdruk van boeddha	Nan
พระพุทธชินราช	phra boeddha chinnarat	Nan
พระพันวัสสาอัยยิกาเจ้า	duizend boeddha&#39;s	Nan
พระพันปีหลวง	millennium luang	Nan
พระยศขณะนั้น	in die tijd	Nan
พระพรหมคุณาภรณ์	phra prom khunaporn	Nan
พระประแดง	phra pradaeng	Nan
พระปกเกล้าเจ้าอยู่หัว	koning prajadhipok	Nan
พระบาทสมเด็จพระเจ้าอยู่หัวเสด็จฯ	zijne majesteit de koning	Nan
พระบาทสมเด็จพระเจ้าอยู่หัวอานันทมหิดล	koning ananda mahidol	Nan
พระบาทสมเด็จพระเจ้าอยู่หัวภูมิพลอดุลยเดชทรงพระกรุณาโปรดเกล้าฯ	zijne majesteit koning bhumibol adulyadej was genadig tevreden	Nan
พระบาทสมเด็จพระพุทธยอดฟ้าจุฬาโลก	phra boeddha phra yot fa, chulalongkorn	Nan
พระปรางค์สามยอด	prang sam yot	Nan
ผลสำรวจ	resultaten van de enquête	Nan
ผลรวม	som	None
ผลผลิตพลอยได้	bijproducten	Nan
ประเทศเปรู	peru	None
ประเทศเม็กซิโก	mexico	None
ประเทศเวียดนาม	vietnam	None
ประเทศแคนาดา	canada	None
ประเทศและดินแดน	landen en gebieden	Nan
ประเทศไทย	thailand	None
ประเพณีชักพระ	chak phra-traditie	Nan
ประเภท	categorie	None
ประเภทของ	soort van	Nan
ประเภทรายการแข่งขันชิงรางวัลดีเด่น	award categorie uitstekende competitie	Nan
ประโยค	zin	None
ปรัชญา	filosofie	None
ปรัชญาตะวันตก	westerse filosofie	Nan
ปรากฏการณ์โลกร้อน	opwarming van de aarde	Nan
ปรากฏตัวตอนแรกในตอน	verscheen voor het eerst in een aflevering	Nan
ปรากฏตัวในตอน	verscheen in	Nan
ปราจีนบุรี	prachin buri	Nan
ปลาปอมปาดัวร์	pompadour	Nan
ปลาบู่ทอง	gouden grondel	Nan
ปลา	vis	None
ปรีดี	pri	Nan
ปรีดา	genot	None
ปริ๊นซ์	prins	None
ประเทศเนปาล	nepal	None
ปริศนา	puzzel	Nan
ปริภูมิ	ruimte	None
ปริญญา	mate	None
ปริญ	prin	Nan
ปราโมทย์	jubel	Nan
ปราสาทเขาพระวิหาร	preah vihear-tempel	Nan
ปราบดาภิเษก	gekroond	None
ปริมาณการผลิต	productie volume	Nan
ปลาย	einde	None
ประเทศเกาหลีใต้	zuid-korea	Nan
ประเทศอียิปต์	egypte	None
ประทีป	lamp	None
ประธาน	president	None
ประธานกรรมการ	voorzitter	None
ประธานศาลฎีกา	president van het hooggerechtshof	Nan
ประธานสภารัฐสภา	voorzitter van het parlement	Nan
ประธานาธิบดี	president	None
ประมาณ	over	None
ประมาณคศ	over	None
ประมาณปี	ongeveer een jaar	Nan
ประยงค์	prayong	Nan
ประวัติศาสตร์	geschiedenis	None
ประวัติศาสตร์สเปน	spaanse geschiedenis	Nan
ประวัติศาสตร์ไทย	thaise geschiedenis	Nan
ประสาท	zenuw	Nan
ประสิทธิภาพ	efficiëntie	None
ประหยัด	sparen	Nan
ประเด็นที่	het probleem	Nan
ประเทศสเปน	spanje	None
ประเทศสวีเดน	zweden	None
ประเทศลาว	laos	None
ประเทศราช	koninklijk land	Nan
ประเทศมาเลเซีย	maleisië	None
ประเทศภูฏาน	bhutan	Nan
ประเทศเกาหลี	korea	None
ประเทศฟินแลนด์	finland	None
ประเทศฝรั่งเศส	frankrijk	None
ประเทศนอร์เวย์	noorwegen	None
ประเทศทำการค้าขายกับต่างประเทศมากยิ่งขึ้น	landen die meer handel drijven met het buitenland	Nan
ประเทศซูดาน	soedan	None
ประเทศกัมพูชา	cambodja	None
ประเทศ	land	None
ประเทศพม่า	myanmar	None
ปลายคริสต์ศตวรรษที่	eind 19e eeuw	Nan
ปลาในสกุลนี้เรียกว่า	de vis in dit geslacht wordt genoemd	Nan
ปลิงทะเล	zeekomkommer	Nan
ปีที่	jaar	None
ปีที่วางจำหน่าย	jaar van uitgave	Nan
ปีพุทธศักราช	boeddhistisch jaar	Nan
ปีย์	jaar	None
ปีย์ชนิตว์	piyachit	Nan
ปีเตอร์	peter	None
ปี่กลาง	middelste tas	Nan
ปืนพก	pistool	Nan
ปืนพกกึ่งอัตโนมัติ	halfautomatisch pistool	Nan
ปืนใหญ่	kanon	Nan
ปืนใหญ่กลางกระสุนวิถีโค้ง	kanon medium trajectcurven	Nan
ปืนไร้แรงสะท้อนถอยหลัง	het terugslaggeweer	Nan
ปุณณกันต์	punnakan	Nan
ปุตราจายา	putrajaya	Nan
ปุ๋ย	kunstmest	Nan
ปู	krab	Nan
ป่าชายหาด	strand bos	Nan
ผลประเสริฐ	uitstekende resultaten	Nan
ผลงานโฆษณา	adverteren	Nan
ผลงานเพลง	muziek	None
ผลงานหนังสือ	boek portfolio	Nan
ผลการแข่งขัน	competitie resultaten	Nan
ผล	resultaten	None
ปีจอโทศก	jaar van het varken	Nan
ผดุง	ondersteuning	None
ป๊อปปี้	papaver	Nan
ป๊อป	knal	Nan
ป่าโกงกาง	mangrove bos	Nan
ป่าเบญจพรรณ	gemengd bos	Nan
ป่าดิบแล้ง	droog groenblijvend bos	Nan
ป่าชายเลน	mangrove bos	Nan
ผจญภัยเกาะมหาสมบัติ	treasure island adventure	Nan
ปีคศ	jaar	None
ปิ่นเกล้า	pinklao	Nan
ปิยะพงษ์	piyapong	Nan
ปัน	delen	None
ปัญโญภาส	panopas	Nan
ปัญจาบ	punjab	Nan
ปัจจุบันเลิกเขียนแล้ว	schrijft momenteel niet meer	Nan
ปัจจุบันมีที่นั่งอยู่ในสภาผู้แทนราษฎร	heeft momenteel zetels in de tweede kamer	Nan
ปัจจุบันประเทศไทยมีภาพยนตร์ที่มุ่งสู่ตลาดโลก	tegenwoordig heeft thailand films die gericht zijn op de wereldmarkt.	Nan
ปั้น	gietvorm	Nan
ปัจจุบันนี้	vandaag de dag	Nan
ปักธงชัย	pak thong chai	Nan
ปักกิ่ง	peking	None
ปวีณา	paweena	Nan
ปวันรัตน์	pawanrat	Nan
ปวดข้อ	gewrichtspijn	Nan
ปล่อย	vrijlating	Nan
ปัจจุบัน	cadeau	Nan
พลศักดิ์	polsak	Nan
ปั๊บ	plotseling	None
ปากดี	goede mond	Nan
ปิปเปอราซิลลิน	piper aculin	Nan
ปาเลสไตน์	palestina	None
ปาสกาล	pascal	None
ปาร์ค	park	None
ปารีส	parijs	None
ปาริชาต	parichat	Nan
ปาก	mond	None
ปาย	pai	Nan
ปานามา	panama	None
ปาน	stigma	Nan
ปากแม่น้ำสิงคโปร์	singapore mond	Nan
ปากเกร็ด	pak kret	Nan
ปากีสถาน	pakistan	None
ปากน้ำ	estuarium	Nan
ปานแร่	moedervlekken	Nan
疾風伝	疾風 伝	Nan
