$ tỉ	milijardu dolara	Nan
rico	rico	Nan
richie	richie	Nan
richardson	richardson	Nan
richard	richard	None
ricci	ricci	Nan
ricardo	ricardo	Nan
rica	rica	Nan
rhodes	rhodes	Nan
rfid	rfid	Nan
rey	rey	Nan
revolution	revolucija	None
reverse	preokrenuti	Nan
resort	odmaralište	Nan
reserve	rezerva	Nan
reo	prsten	None
rené	rené	Nan
renault	renault	Nan
renaissance	renesansa	Nan
ren	čipka	Nan
riemann	riemann	Nan
reichelt	reichelt	Nan
rimjob	rimjob	Nan
rising	ustaje	Nan
rodríguez	rodríguez	Nan
roddick	roddick	Nan
rockefeller	rockefeller	Nan
robinson	robinson	Nan
robin	robin	Nan
robespierre	robespierre	Nan
roberts	roberts	Nan
roberto	roberto	Nan
robert	robert	None
ro	ro	Nan
riềng	galangal	Nan
riết	riet	Nan
riêu	riêu	Nan
riêng	privatni	None
rizal	rizal	Nan
rivière	rivière	Nan
rivaldo	rivaldo	Nan
ritchie	ritchie	Nan
risk	rizik	None
rin	rin	Nan
roi	šipka	None
regia	regia	Nan
reap	žeti	Nan
ralph	ralph	Nan
raleigh	raleigh	Nan
rai	rai	Nan
rafale	rafale	Nan
rafael	rafael	Nan
race	trka	Nan
rabindranath	rabindranath	Nan
r	r	None
qúy	četvrtina	Nan
quỹ	fonda	Nan
quỷ	đavo	Nan
quỵ	moždani udar	Nan
quỳnh	quỳnh	Nan
quỳ	klekni	Nan
quỉ	đavo	Nan
quệ	siromašan	Nan
quết	ološ	Nan
quế	cimet	Nan
quẻ	heksagram	Nan
ram	ram	None
reef	greben	Nan
rama	rama	None
ramayana	ramayana	Nan
reanimation	reanimacija	Nan
real	stvaran	Nan
reagan	reagan	Nan
rađa	radar	Nan
raymond	raymond	Nan
raya	raya	Nan
ray	zraka	None
rau	povrća	None
rate	stopa	None
raptor	raptor	Nan
rap	rap	Nan
rao	oglas	Nan
ranh	granica	None
rangers	rendžera	Nan
rang	zazvonio	Nan
randy	randy	Nan
ranch	ranč	Nan
ran	otrčao	Nan
rambus	rambus	Nan
ramadan	ramadan	Nan
quặng	ruda	None
roland	roland	Nan
rome	rome	Nan
rò	curenje	Nan
rít	šišta	Nan
rìu	sjekira	Nan
rình	špijun	Nan
rìa	ivica	None
rì	šapućući	Nan
rêu	mahovina	Nan
rên	cviljenje	Nan
rê	povuci	Nan
rét	hladno	Nan
république	république	Nan
ré	vrisnuti	Nan
rèn	kovanje	Nan
rèm	zavjesa	Nan
räikkönen	räikkönen	Nan
rãnh	rov	Nan
rãi	kaldrma	Nan
rã	propadanje	Nan
râu	brada	Nan
ròng	neto	Nan
râm	sjenovito	Nan
rót	sipajući	Nan
rôbôt	robot	Nan
rượu	alkohol	None
rượt	juriti	Nan
rưỡi	polovina	None
rưới	posipati	Nan
rước	povorka	Nan
rươi	tebi	None
rơm	slama	Nan
rơi	pad	None
rơ	auto	Nan
rũ	zavodljiv	Nan
rōmaji	rōmaji	Nan
răng	zub	None
răn	zapovijed	Nan
rút	povući	None
rùng	jezivo	Nan
rùa	kornjača	None
rõ	jasno	None
rông	šuplje	Nan
rôma	rome	Nan
rô	kariran	Nan
romania	rumunija	None
ráp	montaža	Nan
rái	vidra	Nan
rulin	rulin	Nan
rue	rue	None
rudolph	rudolph	Nan
rtp	rtp	Nan
rpd	rpd	Nan
roy	roy	Nan
rowling	veslanje	Nan
rovers	roveri	Nan
router	usmjerivač	Nan
rousseau	rousseau	Nan
rotterdam	roterdam	Nan
roth	roth	Nan
rosen	ružin	Nan
rong	alge	None
ronaldinho	ronaldinho	Nan
ronald	ronald	Nan
ron	ron	Nan
rommel	rommel	Nan
romeo	romeo	None
rumani	rumunski	None
rán	pržiti	Nan
rumiko	rumiko	Nan
run	trčati	Nan
rách	rastrgan	Nan
rác	smeće	Nan
rào	ograda	Nan
rành	tečno govori	Nan
ràng	jasno	None
rà	provjeri	Nan
rzeczpospolita	rzeczpospolita	Nan
ruột	creva	Nan
ruộng	polje riže	Nan
ruổi	ruoi	Nan
ruồi	muhe	Nan
ruốc	kozice	Nan
ruud	ruud	Nan
rutte	rutte	Nan
rutherford	rutherford	Nan
ruth	ruth	Nan
russkaya	russkaya	Nan
russian	ruski	None
rung	vibriraju	Nan
rummel	rummel	Nan
quặc	čudno	Nan
quẳng	baciti	Nan
quật	iskopavanje	Nan
plan	plan	None
plaaf	plaaf	Nan
pius	pius	Nan
pitch	smola	Nan
piston	klip	Nan
pisa	pisa	Nan
pipes	cevi	Nan
pioneer	pionir	Nan
pinlus	pinlus	Nan
pin	bateriju	Nan
pike	štuka	Nan
pietro	pietro	Nan
pierrot	pierrot	Nan
pierre	pierre	None
piccolo	piccolo	Nan
picchu	picchu	Nan
phức	kompleks	None
phủ	pokriveno	Nan
phụt	puff	Nan
plasma	plazma	None
phụng	služiti	None
plate	tanjur	Nan
platon	platon	None
porto	porto	None
portland	portland	Nan
pop	pop	None
pont	pont	Nan
polynésie	polynésie	Nan
polo	polo	Nan
pollux	pollux	Nan
pollack	pollack	Nan
poland	poljska	None
pol	pol	Nan
pokémon	pokemon	Nan
po	po	None
pmu	pmu	Nan
pm	pm	Nan
pluto	pluto	Nan
plus	plus	None
pleistocen	pleistocen	Nan
pleiku	pleiku	Nan
player	igrača	None
plato	plato	Nan
pot	lonac	Nan
phục	odjeća	Nan
phới	plutaju	Nan
phả	rodovnik	Nan
phạt	kazniti	Nan
phạn	sanskrit	Nan
phượng	phoenix	Nan
phường	ward	Nan
phước	blagoslov	Nan
phương	phuong	Nan
phăng	phang	Nan
phăn	bijes	Nan
phút	minutu	Nan
phúng	šteta	None
phún	kvrga	Nan
phúclộc	blagoslov	Nan
phúc	blagoslovljen	Nan
phùng	puff	Nan
phông	font	Nan
phôi	embryo	Nan
phô	grad	None
phóng	lansiranje	Nan
phải	tačno	None
phở	juha od rezanci	Nan
phải 	tačno	Nan
phảng	stan	Nan
phộng	kikiriki	Nan
phổi	pluća	None
phổ	spektar	None
phồng	naduvana	Nan
phốt	fosfat	None
phối	koordinata	Nan
phố	grad	None
phỏng	spali	Nan
phỉ	lješnjak	Nan
phết	širenje	None
phế	otpad	Nan
phẳng	avion	None
phật	buda	Nan
phận	sudbina	None
phẫu	operacija	None
phẫn	ogorčen	Nan
phẩy	zarez	Nan
phẩm	proizvodi	None
phần	deo	Nan
phản	brojač	Nan
potsdam	potsdam	Nan
potter	lončar	Nan
pour	sipati	Nan
quáng	slep	Nan
quán	bar	None
quái	jebote	Nan
quá	također	None
quyệt	podmukao	Nan
quyện	druže se	Nan
quyền	dozvolu	None
quyến	šarm	Nan
quyên	osnove	None
quy	pravila	None
quran	kur&#39;an	Nan
quincy	quincy	Nan
qui	qui	Nan
quen	poznat	None
queensland	queensland	Nan
queens	kraljice	None
queen	kraljice	None
que	šipke	Nan
quay	okrenuo	Nan
quát	viknu	Nan
quanh	okolo	Nan
quân	quan	Nan
quét	za skeniranje	Nan
quận	okrug	None
quẫn	bedno	Nan
quẩy	ljuljanje	Nan
quầy	brojač	Nan
quầng	halo	Nan
quần	pantalone	Nan
quấy	promešati	Nan
quất	kumquat	Nan
quấn	zamotati	Nan
quảng	promo	Nan
quản	upravljanje	None
quạt	ventilator	Nan
quạ	vrane	Nan
quĩ	fonda	Nan
quăng	baciti	Nan
quýt	mandarina	Nan
quý	dragoceno	Nan
quên	zaboraviti	None
quê	selo	None
quãng	cca	Nan
quang	optički	None
quan	quan	Nan
quad	quad	None
prôtêin	protein	Nan
protein	proteina	None
prometheus	prometheus	Nan
projekt	projekt	None
procellarum	procellarum	Nan
prix	prix	Nan
prinz	prinz	Nan
printf	printf	Nan
printemps	printemps	Nan
princeton	princeton	Nan
prince	princ	None
preston	preston	Nan
preminger	preminger	Nan
premier	premijera	None
preah	preah	Nan
pratzen	pratzen	Nan
praha	praha	Nan
pradesh	pradesh	Nan
powell	powell	Nan
ps	ps	Nan
psv	psv	Nan
ptolemy	ptolomej	Nan
ptq	ptq	Nan
qua	od	None
qlvnch	qlvnch	Nan
qing	qing	Nan
qd	qd	Nan
qatar	katar	Nan
q	q	None
pơ	pơ	Nan
păng	pang	Nan
pérez	pérez	Nan
rạ	taj smeč	Nan
péc	péc	Nan
pytago	pytago	Nan
pyrenees	pireneji	Nan
putin	putin	Nan
pusan	pusan	Nan
punjab	punjab	Nan
pulp	pulpa	Nan
pulitzer	pulitzer	Nan
pulau	pulau	Nan
puerto	puerto	Nan
pzl	pzl	Nan
rạc	diskretna	Nan
rạch	kanal	None
rạng	zora	None
storting	skladištenje	Nan
stones	kamenje	None
stockholm	stockholm	Nan
stimson	stimson	Nan
stf	stf	Nan
stewarthannah	stewarthannah	Nan
stevie	stevie	Nan
stevenson	stevenson	Nan
stevens	stevens	Nan
steve	steve	Nan
sterling	sterling	Nan
stephenie	stephenie	Nan
stephen	stephen	Nan
stennis	stennis	Nan
stelzer	stelzer	Nan
steiner	steiner	Nan
steiermark	steiermark	Nan
stefan	stefan	None
stdc	stdc	Nan
strasberg	strasberg	Nan
status	statusa	None
strauss	strauss	Nan
struct	stru	Nan
sun	sunce	None
summerslam	summerslam	Nan
summer	leto	Nan
sumitomo	sumitomo	Nan
sumatra	sumatra	Nan
sumatera	sumatera	Nan
sum	suma	Nan
sulu	sulu	Nan
sulfua	sulfid	Nan
sukarno	sukarno	Nan
suharto	suharto	Nan
suez	suez	Nan
subakhi	subakhi	Nan
su	su	None
stéfano	stéfano	Nan
styx	styx	Nan
stuttgart	stuttgart	Nan
stuart	stuart	Nan
stt	stt	Nan
street	ulica	None
sunday	nedjelja	None
startin	startin	Nan
stanley	stanley	Nan
sonata	sonata	Nan
somme	somme	Nan
som	som	Nan
solaris	solaris	Nan
soi	soi	Nan
soho	soho	Nan
sohee	sohee	Nan
socrates	sokrat	None
société	société	Nan
so	tako	None
smithsonian	smithsonian	Nan
smith	smith	Nan
smg	smg	Nan
sm	sm	Nan
slytherin	slytherin	Nan
slavơ	slav	Nan
slav	slav	Nan
sl	sl	None
skyteam	skyteam	Nan
song	pjesma	None
starr	starr	Nan
sony	sony	None
sophie	sophie	None
stanford	stanford	Nan
stand	stajati	Nan
stamford	stamford	Nan
stalingrad	stalingrad	Nan
st	st	Nan
ss	ss	None
sri	sri	Nan
sports	sport	None
spielberg	spielberg	Nan
spencer	spencer	Nan
spence	spence	Nan
spellman	čarolija	Nan
spears	koplja	None
soạn	kompozitor	None
soát	kontrola	None
soul	duša	None
sos	sos	Nan
sorbonne	sorbonne	Nan
sopwith	sopwith	Nan
soo	soo	Nan
sung	smokve	Nan
sunni	sunni	Nan
sunsilk	sunčanica	Nan
súp	supa	Nan
súng	puške	Nan
sún	sudoper	Nan
súc	goveda	Nan
sú	crni tigar	Nan
sùng	odanost	Nan
sông	rijeka	None
sôi	ključanja	Nan
sô	broj	None
sót	propust	Nan
sóng	val	None
sói	vuk	None
sóc	vjeverica	Nan
sòng	casino	Nan
sò	školjka	Nan
sít	zbijeno	Nan
síp	kipar	None
sính	student	None
sêu	mahovina	Nan
sút	upucan	Nan
sêri	serija	None
săn	loviti	Nan
sư	profesore	Nan
sẩn	papule	Nan
sầu	melanholija	Nan
sầm	slama	Nan
sấy	sušenje	Nan
sấu	krokodila	Nan
sấm	grom	Nan
sảnh	sala	Nan
sảng	svež	Nan
sản	proizvodnja	None
sảm	svijetao	Nan
sạn	hotel	None
sạch	čist	None
sưởi	grejanje	Nan
sườn	strana	None
sướng	srećna	Nan
sương	rosa	Nan
sưu	kolekcionarstvo	Nan
sưng	oticanje	Nan
sưa	mlijeko	None
sơn	boje	None
sê	se	None
sét	rasvjeta	Nan
são	são	Nan
sy	sy	Nan
sweet	slatko	Nan
swaziland	swaziland	Nan
swan	labud	Nan
svd	svd	Nan
suồng	glatka	Nan
suốt	širom	None
suối	grejanje	Nan
suất	produktivnost	Nan
suôn	glatko	Nan
suê	tako	None
suy	neuspjeh	Nan
suvp	suvp	Nan
suub	suub	Nan
sutra	sutra	Nan
susilo	susilo	Nan
susan	susan	Nan
suriname	surinam	Nan
super	super	None
sydney	sydney	Nan
symantec	symantec	Nan
sync	sinhronizacija	Nan
syria	syria	Nan
sãi	pogrešno	None
sã	sã	Nan
sâu	duboko	None
sân	dvorište	Nan
sâm	ginseng	Nan
sáu	šest	None
sát	zatvoriti	Nan
sáp	vosak	None
sáo	flauta	Nan
skype	skype	Nan
sánh	uporedni	Nan
sám	pokajnik	Nan
sái	pogrešno	None
sách	knjiga	None
sá	sipunculus	Nan
sào	pol	Nan
sành	terakota	Nan
sàng	sito	Nan
sàn	kat	Nan
sài	sai	Nan
sáng	blistav	Nan
phó	zamenik	Nan
sky	nebo	None
siêu	super	None
samoa	samoa	None
samo	samo	None
samhain	samhain	Nan
salzburg	salzburg	Nan
salvador	salvador	None
salem	salem	Nan
sakura	sakura	Nan
saintdenis	saintdenis	Nan
saigon	saigon	Nan
sai	pogrešno	None
sahara	sahara	Nan
safin	safin	Nan
safari	safari	Nan
saddam	sadam	Nan
sachsen	sachsen	Nan
sabah	sabah	Nan
sa	sa	None
rữa	oprati	Nan
rửa	oprati	Nan
samphan	samphan	Nan
rừng	šuma	None
samsung	samsung	Nan
samuelson	samuelson	Nan
sardinia	sardinija	Nan
sarcoma	sarkom	Nan
sarawak	sarawak	Nan
sarah	sarah	Nan
sar	sar	Nan
sapiens	sapiens	Nan
sapa	sapa	Nan
sap	sok	Nan
sao	zvijezda	None
santos	santos	Nan
sanktpeterburg	sanktpeterburg	Nan
sanh	rođenje	None
sangraal	sangraal	Nan
sango	sango	Nan
sang	do	None
sanchez	sanchez	Nan
san	san	None
samut	samut	Nan
samurai	samurai	Nan
samuel	samuel	Nan
sary	sary	Nan
rứa	rứa	Nan
rủ	pozvati	Nan
rễ	korijenje	Nan
rể	zet	Nan
rền	stenjati	Nan
rẽ	skrenuti	Nan
rẻ	jeftino	Nan
rặng	kamen	None
rằng	da	None
rằm	puni mjesec	Nan
rắn	zmija	None
rắc	posipati	Nan
rập	arapski	None
rậm	bujan	Nan
rẫy	uzgoj	None
rầu	tužan	Nan
rầm	jamb	Nan
rất	vrlo	None
rảnh	besplatno	Nan
rải	rasute	Nan
rạp	pozorišta	None
rệp	bug	Nan
rủi	mishap	Nan
rệt	izgovara	None
rỉ	rđa	Nan
rụng	šupa	Nan
rợn	jezivo	Nan
rợ	varvari	Nan
rỡ	sjajan	Nan
rời	levo	Nan
rớt	pad	None
rộng	širok	None
rộn	zauzeto	Nan
rộ	gužva	Nan
rỗng	šuplje	Nan
rỗi	besplatno	Nan
rổ	korpa	Nan
rồng	zmaj	Nan
rồi	već	None
rồ	luda	Nan
rốm	oblačno	Nan
rối	zapetljan	Nan
rỏ	jasno	None
rịavũng	rìvà	Nan
rệu	da	None
saturanga	saturanga	Nan
saturday	subota	Nan
sau	posle	None
siberi	siberi	Nan
shōnen	shōnen	Nan
showcase	izlog	Nan
short	kratko	None
shop	prodavnica	Nan
shonen	shonen	Nan
shoal	plićak	Nan
shiva	shiva	Nan
shirakawago	shirakawago	Nan
shirakami	shirakami	Nan
shinoda	shinoda	Nan
shinichi	shinichi	Nan
shikoku	shikoku	Nan
shiite	šiite	Nan
shia	shia	Nan
shi	shi	Nan
sherlock	šerlok	Nan
shawn	shawn	Nan
sharpay	oštar	Nan
sicilia	sicilia	Nan
shaolin	shaolin	Nan
sicily	sicilija	Nan
siem	siem	Nan
siu	siu	Nan
sistema	sistema	None
sirô	sirup	Nan
sip	gutljaj	Nan
sinh	rođen	None
sing	pevaj	Nan
sinensis	sinensis	Nan
sinai	sinai	Nan
simone	simone	Nan
silvestris	silvestris	Nan
silva	silva	Nan
silicat	silikat	Nan
silic	silicijum	Nan
silesia	šlezija	Nan
silas	silas	Nan
sikorsky	sikorsky	Nan
sikh	sikh	Nan
sierra	sierra	Nan
siemens	siemens	Nan
sidney	sidney	Nan
shankly	drhtavo	Nan
shane	shane	Nan
shan	shan	Nan
sdram	sdram	Nan
scuderia	scuderia	Nan
scud	prevara	Nan
scream	vrišti	Nan
scott	scott	Nan
scots	škoti	Nan
scotland	škotska	None
schwarzschild	schwarzschild	Nan
schuster	schuster	Nan
schuschnigg	schuschnigg	Nan
schumacher	schumacher	Nan
schneider	schneider	Nan
schlesinger	schlesinger	Nan
schiller	schiller	Nan
schengen	schengen	Nan
schafer	schafer	Nan
scandinavia	skandinavije	Nan
saunière	saunière	Nan
saudi	saudi	Nan
search	pretraživanje	Nan
seattle	seattle	Nan
secret	tajna	None
sedna	sedna	Nan
shaman	šaman	Nan
shah	šah	None
seyssinquart	seyssinquart	Nan
seymour	seymour	Nan
sexy	seksi	Nan
sextus	sextus	Nan
seto	seto	Nan
seth	seth	Nan
sesshomaru	sesshomaru	Nan
siết	zategnuti	Nan
service	usluga	None
sergeyevich	sergeyevich	Nan
serbia	srbija	None
september	septembra	None
sense	smisla	None
sen	lotos	Nan
semit	polu	Nan
selena	selena	None
sejm	sejm	Nan
see	vidi	None
seri	serija	None
sẫm	mračno	Nan
phòng	soba	None
phím	ključ	None
ngộ	prosvetljenje	Nan
ngồi	sit	Nan
ngọt	slatko	Nan
ngọn	vrh	None
ngọc	dragulj	Nan
ngọ	podne	None
ngặt	zbijeno	Nan
ngắn	kratko	None
ngắm	razmisliti	Nan
ngập	poplavljen	Nan
ngậm	pastile	Nan
ngẫu	nasumično	Nan
ngẫm	razmislite	Nan
ngẩn	omamljen	Nan
ngần	oklijevaj	Nan
ngầm	implicitno	Nan
ngất	onesviješten	Nan
ngấm	infuziran	Nan
ngạt	asfiksija	Nan
ngột	iznenada	Nan
ngạo	zamišljen	Nan
ngớ	blesavo	Nan
ngỡ	misao	None
nhakẻ	dijete	None
nha	stomatologa	Nan
ngực	prsa	Nan
ngựa	konj	None
ngự	prebivati	Nan
ngữ	govor	None
ngửi	miris	None
ngửa	suoči	Nan
ngừng	prestati	Nan
ngừa	sprečiti	Nan
ngừ	tunjevina	Nan
ngứa	svrbež	Nan
ngủi	kratko	None
ngủ	spavati	Nan
ngụy	wei	Nan
ngụm	gutljaj	Nan
ngục	zatvor	Nan
ngợm	nestašan	Nan
ngợi	pohvale	Nan
ngời	ljudi	None
nham	lava	Nan
ngạnh	bodljike	Nan
ngạch	čin	None
ngây	prazno	Nan
ngân	banka	None
ngát	nesvijest	Nan
ngáng	ngáng	Nan
ngán	dosadno	Nan
ngái	glupo	Nan
ngách	niša	Nan
ngày	dan	None
ngào	slatko	Nan
ngành	ogranak	None
ngàng	ngàng	Nan
ngàn	hiljadu	None
ngà	bjelokosti	Nan
nguỵ	budale	Nan
nguời	ljudi	None
nguồn	izvor	None
nguôi	smirujuće	Nan
nguyệt	mesec	Nan
nguyện	zavjet	None
ngãi	ngai	Nan
ngạn	banka	None
ngò	korijander	Nan
ngói	crijep	Nan
ngạc	iznenađen	Nan
ngược	preokrenuti	Nan
ngưỡng	prag	None
người	ljudi	None
ngươi	ti	None
ngưu	ox	Nan
ngưng	stani	Nan
ngư	fisher	Nan
ngơi	počivaj	Nan
ngơ	ignoriran	Nan
ngũ	spavati	Nan
ngăn	pretinac	Nan
ngút	ngut	Nan
ngùi	miris	None
ngõ	traka	Nan
ngông	guska	Nan
ngôn	jezik	None
ngót	skupljanje	Nan
ngón	prst	Nan
ngó	pogledaj	Nan
nguyền	kletva	Nan
nhan	nhan	Nan
nhanh	brzo	None
nhẫn	prstenovi	Nan
nhầy	ljigav	Nan
nhầm	pogrešno	None
nhất	najbolje	None
nhấn	pritiskom	None
nhấm	sipanje	Nan
nhấc	lift	Nan
nhảy	ples	Nan
nhạy	osetljiv	Nan
nhạt	blijed	Nan
nhạo	ruganje	Nan
nhạn	progutati	Nan
nhạc	muzika	None
nhạ	nhạ	Nan
nhượng	koncesije	Nan
nhược	slabost	Nan
nhưỡng	masna	Nan
nhường	ustupio mjesto	Nan
nhương	pljuvačka	Nan
nhậm	žigosano	Nan
nhưng	ali	None
nhập	uvoz	Nan
nhậy	osetljiv	Nan
nhỏ|phải|px|cây	malo | desno | px | stablo	Nan
nhỏ|phải|px|bức	male | desne | px | slike	Nan
nhỏ|phải|px|	mali | desni | px |	Nan
nhỏ|phải|	mali | desno |	Nan
nhỏ|một	mali | jedan	Nan
nhỏ|cây	malo | drvo	Nan
nhỏ	mala	None
nhọn	oštar	Nan
nhọ	nesretan	Nan
nhịn	uzdržati se	Nan
nhị	stamen	Nan
nhẹn	okretni	Nan
nhẹ	svjetlost	None
nhặt	birati	Nan
nhẵn	glatka	Nan
nhằm	ciljajući	Nan
nhắn	poruka	None
nhắm	cilj	None
nhắc	brz	None
nhậu	piće	Nan
nhang	tamjan	Nan
như	kao	None
nhũng	korupcija	Nan
nhào	mijesiti	Nan
nhàng	nježno	Nan
nhàn	mirovanje	Nan
nhuộm	boja	None
nhuệ	nhue	Nan
nhuận	profit	Nan
nhu	kao	None
nhs	nhs	Nan
nhk	nhk	Nan
nhiệt	toplina	Nan
nhiệm	dužnost	None
nhiễu	šum	Nan
nhiễm	inficiran	Nan
nhiều	mnogo	None
nhiêu	mnogo	None
nhiên	kurs	Nan
nhi	deca	Nan
nhen	ponovo zapalio	Nan
nhat	nhat	Nan
nhác	labav	Nan
nhơn	množiti	Nan
nhái	klonovi	Nan
nháp	nacrt	Nan
nhũ	emulzija	Nan
nhĩ	atrijalno	Nan
nhăn	naborana	Nan
nhút	stidljiv	Nan
nhúng	dip	Nan
nhôm	aluminijum	Nan
nhô	strši	Nan
nhóm	grupa	None
nhóc	dijete	None
nhòm	pogledaj	Nan
nhím	jež	Nan
nhí	ćaskanje	Nan
nhìn	pogledaj	Nan
nhì	sekunda	Nan
nhét	staviti	None
nhãn	etiketa	Nan
nhã	ukusna	Nan
nhâm	uranjanje	Nan
nháy	treperi	Nan
nhánh	ogranak	None
nguyên	originalni	None
nguyen	nguyen	Nan
ngung	ngung	Nan
mồ	grob	None
mốt	moda	Nan
mối	termit	Nan
mốc	mora	None
mỏng	tanka	Nan
mỏi	umorna	Nan
mỏ	mine	Nan
mọn	sitničav	Nan
mọi	svaki	None
mọc	raste	None
mịt	njuškati	Nan
mịn	glatka	Nan
mịch	sranje	Nan
mỉm	osmijeh	Nan
mỉa	sarkazam	Nan
mỉ	pažljiv	Nan
mệt	umorna	Nan
mệnh	sudbina	None
mềm	meko	Nan
mồi	mamac	Nan
mề	gizzard	Nan
mổ	operacija	None
mộ	grobnica	None
na	n / a	Nan
mỹcông	amerika	None
mỹ	amerika	None
mỳ	rezanci	Nan
mực	mastilo	Nan
mửa	povraćanje	Nan
mừng	drago mi je	Nan
mứt	džem	Nan
mức	nivoa	None
mụn	akne	Nan
mục	stavku	Nan
mỡ	debeo	Nan
mở	otvorena	None
mời	pozvati	Nan
mờ	nejasan	Nan
mới	novo	None
một	jedan	None
mộng	san	None
mộc	stolarija	Nan
mỗi	svaki	None
naadam	naadam	Nan
mến	draga	None
mẻ	serija	None
mả	grobovi	Nan
mạt	grinje	Nan
mạo	članak	None
mạnh	jak	None
mạn	strana	None
mại	trgovina	None
mạch	sklop	Nan
mạc	pustinja	None
mượt	glatka	Nan
mượn	posuditi	Nan
mường	muong	Nan
mướt	svilenkasta	Nan
mướn	najam	Nan
mương	odvod	Nan
mươi	pedeset	None
mưu	lukav	Nan
mưa	kiša	None
mơn	šape	Nan
mơ	san	None
mải	zauzeto	Nan
mẽ	jak	None
mảng	niz	None
mất	izgubljen	Nan
mẹo	savjeta	None
mẹ	mama	Nan
mặt	lice	None
mặn	slani	Nan
mặc	trošenje	Nan
mắt	oko	None
mắng	prigovarati	Nan
mắn	sretan	Nan
mắm	riblji umak	Nan
mắc	skupo	Nan
mậu	trgovina	None
mật	dušo	Nan
mập	debeo	Nan
mận	šljiva	Nan
mẩu	komada	Nan
mầu	boja	None
mầm	klica	Nan
mấy	nekoliko	None
mấu	karticu	Nan
mảnh	komad	Nan
nacional	nacional	Nan
nagant	nagant	Nan
nagar	nagar	Nan
nghành	industrija	None
nghiệt	mračno	Nan
nghiệp	karma	Nan
nghiện	ovisni	Nan
nghiệm	iskustvo	None
nghiễm	šteta	None
nghiền	tikvice	Nan
nghiêu	nghieu	Nan
nghiêng	nagnut	Nan
nghiêm	jako	None
nghinh	nghinh	Nan
nghe	slušaj	Nan
ngay	tačno	None
ngao	školjka	Nan
ngang	horizontalno	Nan
ngai	tron	None
nga	rusija	None
next	sljedeći	None
newtons	newtons	Nan
nghèo	siromašan	Nan
newton	newton	Nan
nghé	nghe	Nan
nghênh	dobrodošli	Nan
ngu	spavati	Nan
ngoặt	skrenuti	Nan
ngoặc	zagrade	Nan
ngoạn	oduzimajući dah	Nan
ngoại	strani	None
ngoài	napolje	Nan
ngon	ukusno	Nan
ngoc	ngoc	Nan
ngoan	dobar dečko	Nan
ngo	sjajan	Nan
nghị	preporuke	Nan
nghỉ	odmor	None
nghệquận	umjetnost	None
nghề	profesija	Nan
nghếch	glasno	Nan
nghẽn	zagušenja	Nan
nghĩa	znači	None
nghĩ	misli	None
nghìn	hiljadu	None
nghê	nghe	Nan
newspaper	novine	None
newcastle	newcastle	Nan
neverland	neverland	Nan
napoli	napoli	Nan
napoleon	napoleon	None
naomi	naomi	Nan
nano	nano	Nan
nanh	očnjaci	Nan
nang	folikul	Nan
nancy	njezi	Nan
namno	namno	Nan
namnam	nam nam	Nan
namibia	namibija	Nan
nambắc	sjever	None
nam	muško	Nan
nalbandian	nalbandian	Nan
nakajima	nakajima	Nan
nairobi	nairobi	Nan
nai	jelen	Nan
nagumo	nagumo	Nan
nagoya	nagoya	Nan
nagasaki	nagasaki	Nan
napoléon	napoléon	None
nara	nara	Nan
nasa	nasa	Nan
nat	nat	Nan
nevada	nevada	Nan
neutrino	neutrino	Nan
neumann	neumann	Nan
networks	mreže	None
netscape	netscape	Nan
netbook	netbook	Nan
net	neto	Nan
nessie	nessie	Nan
nepomuk	nepomuk	Nan
nhỏ|phải|px|khu	mala | desna | px | zona	Nan
nepal	nepal	Nan
neo	sidro	Nan
nelson	nelson	Nan
needham	needham	Nan
nay	od sada	Nan
navarre	navarre	Nan
nava	nava	Nan
nauru	nauru	Nan
natri	natrijuma	Nan
nathan	nathan	Nan
neon	neon	Nan
nhỏ|phải|px|michael	mali | desni | px | michael	Nan
nhỏ|phải|px|máy	mala | desna | px | mašina	Nan
nhỏ|phải|px|một	mali | desni | px | jedan	Nan
oxford	oxford	Nan
owen	owen	Nan
outstanding	izvanredan	Nan
ottoman	otoman	Nan
otto	otto	Nan
other	drugo	None
oswald	oswald	Nan
ossetia	ossetia	Nan
ospf	ospf	Nan
osment	osment	Nan
oslo	oslo	Nan
oskar	oskar	Nan
osiris	osiris	Nan
oscar	oscar	Nan
osamu	osamu	Nan
osama	osama	Nan
osaka	osaka	Nan
os	os	None
orton	orton	Nan
oxy	kiseonik	None
orochimaru	orochimaru	Nan
ozawa	ozawa	Nan
oát	vati	Nan
paperback	meke korice	Nan
paolo	paolo	Nan
panthéon	panthéon	Nan
panthera	panthera	Nan
panduranga	panduranga	Nan
panamax	panamax	Nan
panama	panama	Nan
pan	tava	Nan
pamir	pamir	Nan
pali	pali	None
palgrave	palgrave	Nan
palestine	palestine	None
palenque	palenque	Nan
palawan	palawan	Nan
palais	palais	None
pakistan	pakistanu	Nan
pailin	pailin	Nan
paget	paget	Nan
oản	oàn	Nan
oán	ogorčenost	Nan
papua	papua	Nan
orleans	orleans	Nan
origin	porijeklo	None
oanh	oanh	Nan
oan	nepravde	Nan
oakland	oakland	Nan
oai	strah	None
oahu	oahu	Nan
nữa	opet	None
nửa	polovina	None
nứt	napukao	Nan
nứa	pluta	Nan
nụy	tučak	Nan
nợ	na zajam	Nan
nỡ	od srca	Nan
nở	cvjetanje	Nan
nới	otpustiti	Nan
nộp	podneseno	Nan
nộn	nadjev	Nan
nội	interne	Nan
nộ	gnjev	Nan
nỗi	da	None
obama	obama	Nan
orion	orion	Nan
oblast	oblast	None
october	oktobar	Nan
oricon	oricon	Nan
organ	orgulje	Nan
oprah	oprah	Nan
oort	oort	Nan
ontario	ontario	Nan
ong	pčela	None
omar	omar	Nan
om	brušen	Nan
olympus	olimpus	Nan
olivier	olivier	Nan
oliver	oliver	Nan
okhotsk	okhotsk	Nan
ohkawa	ohkawa	Nan
officers	oficiri	Nan
officer	oficir	Nan
oecd	oecd	Nan
odyssey	odiseja	None
oder	oder	Nan
oda	o da	Nan
oc	oc	Nan
paraguay	paragvaj	Nan
pari	pari	Nan
park	park	None
phu	phu	Nan
phrygian	frigijski	Nan
php	php	Nan
phong	soba	None
phoenix	feniks	Nan
pho	pho	Nan
phnôm	fomom	Nan
phnom	phnom	Nan
phiệt	fiet	Nan
phiện	opijum	Nan
phiến	oštrica	Nan
phiếm	tračevi	Nan
phiêu	avantura	Nan
phiên	sesija	Nan
phineas	phineas	Nan
phin	filter	Nan
phim	film	None
philosophiae	philosophiae	Nan
phillips	phillips	Nan
phui	nepokriven	Nan
phillip	filip	None
phun	sprej	Nan
phàm	smrtno	Nan
phích	termos	Nan
phía	strana	None
phí	naplatiti	Nan
phình	ispupčenje	Nan
phì	uvećana	Nan
phêrô	peter	None
phê	ustati	Nan
phép	dozvoljeno	None
phèo	phèo	Nan
phèn	alum	Nan
phát	emitovanje	Nan
pháp	francuska	None
pháo	top	None
phán	sudija	None
phái	sekta	Nan
phách	tukli	Nan
phác	skica	Nan
phá	razbijanje	Nan
phàn	žale	Nan
phà	trajekt	Nan
philippines	filipini	None
philippe	philippe	Nan
philip	philip	Nan
pereira	pereira	Nan
penny	novčić	Nan
pennsylvania	pennsylvania	Nan
penh	penh	Nan
penang	penang	Nan
pele	pele	Nan
peers	vršnjaci	Nan
pedro	pedro	Nan
pdf	pdf	None
pda	pda	Nan
pbs	pbs	Nan
pavia	pavia	Nan
paulo	paulo	Nan
paula	paula	Nan
paul	paul	None
patriot	patriota	Nan
patrick	patrick	Nan
patel	patel	Nan
parton	parton	Nan
perl	perl	Nan
pero	pero	None
perry	perry	Nan
persephone	persefon	Nan
phil	phil	Nan
phen	fen	Nan
phe	frakcija	Nan
phay	glodanje	Nan
pharaon	faraon	Nan
pharaoh	faraon	Nan
phaolô	paul	None
phao	plutaju	Nan
phanh	kočnica	Nan
nỗ	pokušaj	None
pham	pham	Nan
pha	mešovito	Nan
pgđ	pgđ	Nan
pgs	pgs	Nan
pfm	pfm	Nan
petersburg	petersburg	Nan
peters	peters	Nan
peru	peru	None
persian	perzijski	None
pershing	pershing	Nan
phaethon	phaethon	Nan
phò	phò	Nan
nổi	pluta	Nan
nồng	vruće	Nan
non	mlad	None
nom	nom	Nan
nol	nol	Nan
nokia	nokia	Nan
noi	reći	None
noel	noel	Nan
nobita	nobita	Nan
nobel	nobel	Nan
noah	noah	Nan
nm	nm	Nan
nlf	nlf	Nan
nj	nj	Nan
niệu	diureza	Nan
niệm	pažljivost	Nan
niềm	zadovoljstvo	Nan
niết	niet	Nan
niên	godine	None
nixon	nixon	Nan
nitơ	nitrogen	Nan
nonpenetrative	nonpenetrative	Nan
nippon	nippon	Nan
norfolk	norfolk	Nan
norma	norma	Nan
nuốt	progutati	Nan
nuối	progutati	Nan
nuôi	feed	Nan
nusa	nusa	Nan
nupedia	nupedia	Nan
number	broj	None
nubia	nubia	Nan
nst	nst	Nan
nsnd	nsnd	Nan
noãn	ovula	Nan
nowc	nowc	Nan
now	sad	None
novak	novak	Nan
nou	nou	Nan
norway	norway	Nan
norton	norton	Nan
northrop	northrop	Nan
normandie	normandie	Nan
norman	norman	Nan
norge	norge	Nan
nuớc	voda	None
nintendo	nintendo	Nan
nin	nin	Nan
nhủ	podsetnici	Nan
nhục	poniženi	Nan
nhụ	pinča	Nan
nhở	podsetiti	Nan
nhờn	masna	Nan
nhờ	hvala	Nan
nhớt	viskozan	Nan
nhớ	um	Nan
nhộn	urnebesan	Nan
nhổ	iskopati	Nan
nhồi	punjene	Nan
nhốt	zaključana	Nan
nhỏ|tượng	male statue	Nan
nhỏ|trái|px|máy	mali | lijevi | px | stroj	Nan
nhỏ|quân	mala | sila	Nan
nhỏ|px|phải|kiến	mali | px | desni | mrav	Nan
nhỏ|px|các	mali | px |	Nan
nhỏ|px|	mali | px |	Nan
nhỏ|phải|px|quân	mali | desno | px | sila	Nan
nhức	boli	None
ninh	sigurnost	None
nhứt	prvo	None
những	ove	None
nimitz	nimitz	Nan
nile	nile	Nan
nil	nil	Nan
nikolayevich	nikolayevich	Nan
nikolai	nikolai	Nan
nikko	nikko	Nan
nikita	nikita	Nan
niken	nikal	Nan
nikel	nikel	Nan
nigeria	nigerija	Nan
niels	niels	Nan
nicolas	nikoli	Nan
niccolò	niccolò	Nan
nicaragua	nikaragva	Nan
nicaea	nicaea	Nan
nia	nia	Nan
ni	ni	None
nhựt	nhut	Nan
nhựa	plastični	Nan
nhừ	mesnat	Nan
nxb	nxb	Nan
nynorsk	nynorsk	Nan
nà	n / a	Nan
nắng	sunčan	Nan
nắm	izdržati	Nan
nập	vruće	Nan
nậm	nam	None
nẫu	n sunce	Nan
nẩy	odskakanje	Nan
nầy	ovo	None
nần	gurnuti	Nan
nấy	ovo	None
nấu	kuhati	Nan
nấp	sakriti	Nan
nấc	štucanje	Nan
nảy	odskakanje	Nan
nản	obeshrabreni	Nan
nạp	napunjeno	Nan
nạo	curettage	Nan
nạn	nevolja	Nan
nại	žale	Nan
nạc	mršav	Nan
nắp	poklopac	Nan
nạ	maska	Nan
nằm	laž	Nan
nặc	anonimno	Nan
nồm	vrat	Nan
nồi	lonac	Nan
nốt	bilješka	Nan
nối	spojeni	Nan
nỏ	samostrel	Nan
nọc	otrov	None
nọ	drugi	None
nịnh	laskavi	Nan
nỉ	osećao	Nan
nện	udaranje	Nan
nể	poštovanje	None
nề	zidanje	Nan
nếu	ako	None
nếp	ljepljiv	Nan
nến	svijeća	Nan
nếm	ukusa	Nan
nẻo	drugi	None
nặng	teška	None
nặn	stisnuti	Nan
nẵng	nang	Nan
nǎm	nǎm	Nan
nướng	na roštilju	Nan
nước 	država	Nan
nê	ne	None
nét	udaraca	Nan
nén	komprimovani	Nan
ném	baciti	Nan
né	dodge	Nan
não	mozak	None
nã	n / a	Nan
nâu	smeđa	Nan
nâng	uzdići	Nan
náu	sakriti	Nan
nát	zdrobljena	Nan
náo	uzrujano	Nan
nách	pazuha	Nan
ná	n / a	Nan
này	ovo	None
nào	hajde	Nan
nành	soja	Nan
nàn	žalili se	Nan
nài	insistirati	Nan
nên	svijećnjak	Nan
nêu	reci	Nan
nòi	trka	Nan
nòng	bačvasti	Nan
nước	država	None
nơtrino	neutino	Nan
nơi	mesto	Nan
năng	snage	None
năn	pokajnik	Nan
năm	godine	None
nút	čvor	None
núp	sakriti	Nan
núm	dugme	None
nổ	eksplozivnim	Nan
nùng	nung	Nan
nông	plitko	Nan
nôn	povraćati	Nan
nôm	nôm	Nan
nôi	krevetac	Nan
nôbita	tobita	Nan
nô	rob	None
nóng	vruće	Nan
nón	šešir	Nan
nói	govoriti	None
nõn	piling	Nan
mũi	nosa	Nan
sập	kolaps	Nan
sắn	cassava	Nan
wright	wright	Nan
wrestling	hrvanje	Nan
would	bi	None
woods	šume	None
woodrow	woodrow	Nan
wong	wong	Nan
won	pobijedio	None
wolfgang	wolfgang	None
without	bez	None
within	unutar	None
wisconsin	wisconsin	Nan
winer	winer	Nan
windows	prozori	Nan
wimbledon	wimbledon	Nan
willard	villard	Nan
wiley	wiley	Nan
wilder	divlji	Nan
wild	divlji	Nan
wikitravel	wikitravel	Nan
wu	wu	Nan
wikimedia	wikimedia	Nan
wushu	wushu	Nan
xa	daleko	None
xiềng	okovi	Nan
xiết	zategnuti	Nan
xiếc	cirkus	Nan
xiêu	xiao	Nan
xiên	nagnut	Nan
xiêm	sijamski	Nan
xiv	xiv	None
xinh	prekrasno	Nan
xin	molim te	Nan
xiii	xiii	Nan
xi	xi	None
xhcn	xhcn	Nan
xen	xen	Nan
xem	vidi	None
xe	auto	Nan
xay	samljeti	Nan
xao	otrcan	Nan
xanh	plava	None
xang	xang	Nan
wwf	wwf	Nan
xo	xo	Nan
wikimapia	wikimapia	Nan
wikia	wikia	Nan
watergate	watergate	Nan
wat	wat	Nan
washington	washton	Nan
warszawa	warszawa	Nan
warsaw	ratna testera	Nan
warren	warren	Nan
wanna	želim	Nan
wankel	wankel	Nan
wang	wang	Nan
wan	wan	Nan
walther	walther	Nan
walter	walter	Nan
walt	val	None
wa	wa	Nan
w	w	Nan
vỹ	tako	None
vựng	vokabular	Nan
vực	polje	None
vững	čvrsto	None
waterloo	waterloo	Nan
wikibooks	wikibooks	Nan
waters	vode	None
wcdma	wcdma	Nan
wiki	wiki	None
wifi	wifi	None
wiener	wiener	Nan
wien	wien	Nan
widener	širi	None
wheeler	kotač	Nan
westview	westview	Nan
westlife	westlife	Nan
western	zapadni	None
westermarck	westermarck	Nan
werner	werner	Nan
wembley	wembley	Nan
welsh	vel	Nan
wells	bunari	Nan
wellington	wellington	Nan
weimar	weimar	Nan
webmail	webmail	Nan
weblog	weblog	Nan
weasley	weasley	Nan
wayne	wayne	Nan
vừng	susam	Nan
xoa	trljati	Nan
xong	ostvareno	Nan
xăng	benzin	Nan
xăm	tetovaža	Nan
xúi	inducirati	Nan
xúc	kontakt	None
xú	nepristojan	Nan
xù	razbarušen	Nan
xôviết	sovjetski savez	Nan
xôphần	sekcija kašike	Nan
xông	požurila	Nan
xôn	promešati	Nan
xôi	ljepljiva riža	Nan
xô	gurnuti	Nan
xót	milost	Nan
xóm	komšije	Nan
xói	erozije	Nan
xóa	izbrisati	Nan
xòe	širenje	None
xíu	sićušno	Nan
xít	fascinantno	Nan
xơ	vlakno	Nan
xí	fabrika	None
xưa	stari	None
xương	kost	None
xốp	stiropor	Nan
xốc	šoka	None
xỉu	onesviješten	Nan
xỉa	konac	Nan
xỉ	šljaka	Nan
xếp	presavijeni	Nan
xẻo	nesretan	Nan
xắt	kockice	Nan
xẩy	javljaju se	Nan
xẩm	drhtav	Nan
xấu	loše	None
xấp	cca	Nan
xảy	javljaju se	Nan
xảo	lukav	Nan
xả	pražnjenje	Nan
xạ	zračenje	None
xưởng	radionica	Nan
xướng	zbor	Nan
xước	ogrebani	Nan
xưng	priznati	None
xoay	skrenuti	Nan
xìu	prdne	Nan
xêkô	suneo	Nan
xuồng	kanu	Nan
xuống	dole	Nan
xuấtnhập	izvoz-uvoz	Nan
xuất	izvoz	None
xuôi	pomesti	Nan
xuâncông	proljeće	None
xuân	proljeće	None
xuyến	narukvice	Nan
xuyên	piercing	Nan
xum	raskošan	Nan
xuka	xuka	Nan
xui	nesretan	Nan
xuan	xuan	Nan
xua	odagnati	Nan
xu	novčić	Nan
xoắn	uvrnut	Nan
xoáy	eddy	Nan
xoá	izbriši	Nan
xoàng	osrednji	Nan
xv	xv	None
xì	prdne	Nan
xvi	xvi	None
xx	xx	None
xê	potez	Nan
xét	uzeti u obzir	Nan
xéo	bočno	Nan
xén	obrezivanje	Nan
xé	suza	Nan
xèo	xèo	Nan
xãy	prepirka	Nan
xã	komuna	Nan
xây	graditi	Nan
xâu	string	Nan
xâm	tetoviran	Nan
xát	trljanje	Nan
xáo	uznemiravanje	Nan
xán	pržena	Nan
xám	siva	Nan
xách	torbu	Nan
xào	pržiti	Nan
xài	trošiti	Nan
xy	xy	Nan
xvii	xvii	None
vừa	stane	Nan
vứt	baciti	Nan
vụng	nespretan	Nan
voyager	voyager	Nan
vong	žrtava	None
vonfram	volfram	Nan
von	von	None
voldemort	voldemort	Nan
voip	voip	Nan
voi	slonovi	Nan
vo	vo	Nan
vni	vni	Nan
vnexpress	vnexpress	Nan
vn	vn	Nan
việttrung	viettrung	Nan
việtnga	vijenga	Nan
việtmường	vijetnamski muong	Nan
việt	vijetnam	Nan
viện	institut	None
việc	posao	None
viết	pisati	None
viếng	poseta	Nan
voọc	langurs	Nan
viêt	pisanje	None
vtc	vtc	Nan
vua	kralju	None
váng	ološ	Nan
ván	daska	Nan
vái	da	None
vách	zid	None
vác	nošenje	Nan
vá	zakrpa	Nan
vào	u	None
vành	obruč	None
vàng	žuto	None
vàm	vm	Nan
vài	nekoliko	None
và	i	None
vyacheslav	vyacheslav	Nan
vy	vy	Nan
vv	itd.	Nan
vuốt	kandža	Nan
vuông	kvadrat	Nan
vulcan	vulkan	Nan
vui	zabava	Nan
vu	vu	Nan
váy	haljina	Nan
viêng	viang	Nan
viêm	upala	None
vienna	beč	None
victoria	victoria	Nan
victor	pobednik	Nan
viagra	viagra	Nan
vi	jer	None
vhs	vhs	Nan
versailles	versailles	Nan
verona	verona	Nan
vermont	vermont	Nan
verdun	verdun	Nan
venus	venera	None
venezia	venezia	Nan
vendôme	vendôme	Nan
ven	uz	None
vectơ	vektora	Nan
vay	posuditi	Nan
vasari	vasari	Nan
vargas	vargas	Nan
vanessa	vanessa	Nan
viet	viet	Nan
viên	tablete	Nan
vietnam	vijetnam	Nan
viii	viii	None
viz	viz	Nan
vitruvius	vitruvius	Nan
vitamin	vitamina	None
vista	vista	Nan
vissarionovich	vissarionovich	Nan
virút	virus	None
virus	virus	None
virginia	virginia	None
viqr	viqr	Nan
vinpearl	vinpearl	Nan
vincent	vincent	Nan
vincennes	vincennes	Nan
vince	vince	Nan
vinashin	vinashin	Nan
vinagame	vinagame	Nan
villeneuve	villeneuve	Nan
villa	vila	Nan
viking	viking	Nan
vijaya	vijaya	Nan
viettel	viettel	Nan
vân	tako dalje	Nan
vây	peraja	None
vã	požurila	Nan
vẹt	papige	Nan
vẹn	integriteta	Nan
vặt	classifieds	Nan
vặn	vijak	Nan
vắng	odsutna	Nan
vắn	kratko	None
vắcxin	vakcina	Nan
vắc	vakcina	Nan
vận	bogatstvo	None
vẫy	mašući	Nan
vẫn	još	None
vẩy	pahuljice	Nan
vẩn	još	None
vầng	halo	Nan
vần	rima	None
vất	baciti	Nan
vấp	spotaknuo se	Nan
vấn	savjet	None
vảy	vage	Nan
vẽ	slikanje	Nan
vải	tkanina	Nan
vết	zakrpa	Nan
vệ	odbrana	None
vụn	čips	Nan
vợ	supruga	None
vỡ	slomljen	Nan
vở	sveska	Nan
vời	odlicno	Nan
vờ	pretvarati se	Nan
vớt	riba	None
với	sa	None
vớ	čarape	Nan
vội	požurite	Nan
vỗ	maziti	Nan
vồ	maul	Nan
vỏ	kora	None
vọt	skyrocket	Nan
vọng	nada	None
vịt	patka	Nan
vịnh	uvala	Nan
vỉa	šavovi	Nan
vệt	pruge	None
vểnh	pertle	Nan
vả	smokva	Nan
vạng	sumrak	None
vạn	deset hiljada	Nan
võ	borilački	Nan
vôi	kreč	Nan
vô	ne	None
vóc	veličina	None
vó	hoooo	Nan
vòng	prsten	None
vòm	krov	Nan
vòi	crijevo	None
vò	zgužvan	Nan
vít	vijak	Nan
vía	novčanik	Nan
ví	novčanik	Nan
vì	jer	None
vê	otprilike	None
vét	bager	Nan
vé	ulaznica	Nan
vè	piškiti	Nan
vãn	van	None
vãi	sranje	Nan
võng	viseća mreža	Nan
vùi	pokopan	Nan
vùng	region	None
vú	dojke	None
vại	jar	Nan
vạch	bar	None
vạc	kotao	Nan
vạ	tako	None
vượt	proći	None
vượn	majmuni	Nan
vườn	bašta	Nan
vướng	zapletena	Nan
vương	kralju	None
xổ	tombola	Nan
vươn	doseg	Nan
vơi	sa	None
vơ	bespomoćan	Nan
vũng	lokva	Nan
vũ	vu	Nan
vĩnh	trajno	None
vĩ	odlicno	Nan
văng	splash	Nan
văn	literatura	None
vút	soaring	Nan
vưu	vưu	Nan
xộn	neuredan	Nan
xứ	zemljište	None
xứng	dostojan	Nan
đẩy	gurati	Nan
đẩu	glava	None
đầy	pun	None
đầu	glava	None
đần	glupi	Nan
đầm	haljina	Nan
đấy	tamo	None
đấtmặt	zemlju	None
đất	zemljište	None
đấng	bože	None
đấm	probiti	Nan
đảo	ostrvo	None
đảng	zabava	Nan
đản	rođendan	Nan
đảm	zagarantovano	Nan
đả	bori	None
đạt	doseg	Nan
đạp	bicikl	Nan
đạo	religija	None
đẫm	natopljen	Nan
đạn	metak	Nan
đậm	mračno	Nan
đậy	poklopac	Nan
để	do	None
đều	su	None
đền	hram	None
đề	niti	None
đến	dođi	Nan
đếm	brojati	Nan
đế	potplati	Nan
đẽ	dobro	None
đẹp	prilično	None
đặn	redovan	Nan
đặc	poseban	None
đẳng	klasa	None
đằng	preko	None
đắt	skupo	Nan
đắp	gore	None
đắng	gorka	Nan
đắn	vlasništvo	None
đắm	olupina	Nan
đắc	dobitak	Nan
đậu	grah	Nan
đệm	jastuk	Nan
đạm	protein	Nan
đạ	da	None
đói	gladan	Nan
đóa	nah	Nan
đó	tamo	None
đòn	udarac	None
đòi	tvrditi	Nan
đò	trajekt	Nan
đính	u prilogu	Nan
đích	odredište	Nan
đênh	dolar	None
đêm	noć	None
đê	nasip	Nan
đèo	proći	None
đèn	lampa	Nan
đè	nadjačati	Nan
đãng	razuzdan	Nan
đãi	gozba	Nan
đã	je već	Nan
đây	ovdje	None
đâu	gde	None
đón	pokupiti	Nan
đại	odlično	Nan
đôi	dvostruko	Nan
đôn	pijedestal	Nan
được	uredu	Nan
đường	ulica	None
đưa	proći	None
đơ	pauza	None
đĩa	tanjur	Nan
đĩ	drolja	Nan
đăk	dak	Nan
đút	staviti	None
đúp	dvostruko	Nan
đúng	tačno je	Nan
đúc	kasting	Nan
đùi	femoralni	Nan
đùa	šala	Nan
đôrêmon	doraemon	Nan
đôrêmi	doraemon	Nan
đôngtây	istočni zapad	Nan
đôngnam	jugoistok	Nan
đôngbắc	sjeveroistok	Nan
đông	bronzana	Nan
đôla	dolara	None
đỉnh	vrh	None
địch	neprijatelja	None
định	specificirano	Nan
ẩn	sakriti	Nan
ẩm	toplo	Nan
ấy	da	None
ấu	mlad	None
ấp	zaselak	Nan
ấnâu	ispisati	Nan
ấn	pritisnite	Nan
ấm	toplo	Nan
ảnh	image	Nan
ải	ải	Nan
ạt	žuriti	Nan
ạ	gospodine	Nan
ướt	mokri	Nan
ướp	marinirana	Nan
ương	centralni	None
ươm	rasadnik	Nan
ươi	narandža	Nan
ưu	pros	Nan
ưng	oh da	Nan
ập	prasak	Nan
ưa	poželjno	None
ắt	naravno	None
ỏi	menta	Nan
ứng	aplikacija	None
ức	dojke	None
ứ	da	None
ủy	komesaru	Nan
ủng	čizme	Nan
ủi	gvožđe	Nan
ủ	inkubacija	Nan
ở	u	None
ớt	chili	Nan
ớn	veliki	None
ổn	je u redu	Nan
ổi	guava	Nan
ổ	pogon	Nan
ồn	šum	Nan
ốp	tangenta	Nan
ống	cijev	None
ốm	bolestan	Nan
ốc	puževi	Nan
ố	ooh	Nan
ếch	žaba	Nan
ư	u	None
ơn	hvala	Nan
ơi	hej	Nan
đỗ	parkiran	Nan
đổng	dong	Nan
đổi	promjena	None
đổ	sipati	Nan
đồng	bakar	None
đồn	glasina	Nan
đồi	brdo	None
đồ	stvar	None
đốt	gorenje	Nan
đống	gomila	Nan
đốn	sjeckati	Nan
đốm	tacka	Nan
đối	za	None
đốc	guvernera	None
đỏ	crveno	Nan
đọng	stagnira	Nan
đọc	čitati	None
đọan	stavak	Nan
đọ	bezdušna	Nan
độ	stepen	None
độc	otrov	None
độn	podstavljen	Nan
động	dinamičan	Nan
ơ	oh	Nan
ĩ	oh	Nan
đựoc	u redu	Nan
đựng	sadrže	None
đực	muško	Nan
đừng	nemoj	Nan
đứt	slomljen	Nan
đứng	stajati	Nan
đức	vrlina	None
đâm	ubod	Nan
đứa	deca	Nan
đụng	dodir	None
đụn	dine	Nan
đục	neproziran	Nan
đợt	serija	None
đợi	sačekaj	Nan
đỡ	podrška	None
đời	životni vek	Nan
đới	zen	Nan
đột	odjednom	Nan
đủ	dosta	None
van	ventil	Nan
đát	zemljište	None
đáo	jedinstven	None
|việt	| vijetnamski	Nan
|tên	| ime	Nan
|petya	| petya	Nan
|nổi	| pluta	Nan
|nguyễn	| nguyen	Nan
zürich	zürich	Nan
zurich	cirih	Nan
zoe	zoe	Nan
zing	zing	Nan
zinedine	zinedin	Nan
zimbabwe	zimbabwe	Nan
zhukmse	zhukmse	Nan
zheng	zheng	Nan
zeus	zeus	None
zero	nula	None
zedong	zedong	Nan
zealand	zeland	None
zambia	zambia	Nan
zac	zac	Nan
 kg	kg	Nan
z	z	None
 triệu	milion	Nan
°đến	° do	Nan
êgê	ego	Nan
ép	stisnuti	Nan
én	lastavice	Nan
ân	naklonost	Nan
âm	oduzeti	Nan
â	â	Nan
áâu	aoi	Nan
áp	pritisku	None
áohung	aohung	Nan
áo	košulja	Nan
ánh	sjaj	Nan
ám	renderira	Nan
ái	žudnja	Nan
ách	jaram	Nan
ác	zlo	None
á	azijski	Nan
ào	wow	Nan
×	×	Nan
°độ	° stepeni	Nan
 °c	° c	Nan
êm	glatka	Nan
yểu	ljupko	Nan
yểm	poklopac	Nan
yomiuri	yomiuri	Nan
yo	yo	Nan
ymca	ymca	Nan
ying	ying	Nan
yi	yi	Nan
yersin	yersin	Nan
yemen	jemen	Nan
yeltsin	yeltsin	Nan
yeeun	yeeun	Nan
yasha	yasha	Nan
yard	dvorište	Nan
yankee	yankee	Nan
yalta	yalta	Nan
yakushima	yakushima	Nan
yakovlev	yakovlev	Nan
ya	da	None
y=fracsin	y = fraksin	Nan
y	y	None
xử	gozba	Nan
yoochun	yoochun	Nan
yển	jen	Nan
york	york	None
yorkshire	jorkšir	Nan
yếu	slab	None
yết	kotiranje	Nan
yến	ptičje gnijezdo	Nan
yếm	kombinezoni	Nan
yêu	voljeti	Nan
yên	jen	Nan
yurt	jurta	Nan
yuri	jurij	Nan
yunho	yunho	Nan
yume	yume	Nan
yukito	yukito	Nan
yugi	yugi	Nan
yudhoyono	yudhoyono	Nan
yucatán	yucatán	Nan
yuan	juan	None
yu	yu	Nan
ytv	ytv	Nan
ypres	ypres	Nan
youtube	youtube	Nan
yorker	yorker	Nan
ích	korisno	Nan
ílam	ílam	Nan
ít	malo	None
đoàn	grupa	None
đoài	mango	Nan
đom	krijesnice	Nan
đoan	grupa	None
đoa	doa	Nan
đo	mjera	None
điệu	ton	Nan
điệp	poruka	None
điểu	jebote	Nan
điển	rečnik	Nan
điểm	poentu	Nan
điều	stvar	None
điền	ispuniti	Nan
điềm	znak	None
điếu	cigareta	Nan
điếc	gluh	Nan
điạ	dạ	Nan
điôxít	dioksid	None
điêu	stvar	None
đoái	razmjena	None
điên	luda	Nan
đoạn	stavak	Nan
đtđ	mobitel	Nan
đáng	vrijedi	None
đán	dan	None
đám	grupa	None
đái	pee	Nan
đá	rock	None
đày	progonstvo	Nan
đào	kopati	Nan
đàng	da	None
đàn	stado	Nan
đàm	razgovora	None
đài	radio	None
đuổi	juriti	Nan
đuống	stabljika	Nan
đuối	utapanje	Nan
đuốc	baklja	Nan
đuôi	rep	None
đun	toplina	Nan
đui	slep	Nan
đua	trka	Nan
đt	tel	Nan
đi	idi	Nan
đhông	istok	None
đhtm	dhtm	Nan
ôzôn	ozon	Nan
ôxít	oksid	None
ôxy	kiseonik	None
ôxi	kiseonik	None
ôtô	auto	Nan
ông	on	None
ôn	umjerenost	Nan
ôm	zagrljaj	Nan
ôi	oh	Nan
óng	iridescentno	Nan
óc	mozak	None
ó	ó	Nan
ðức	nemačke	Nan
ðảng	party	Nan
ðường	šećer	None
ðài	ðài	Nan
ðiều	član	None
îledefrance	îledefrance	Nan
île	île	Nan
ùn	džemovi	Nan
úng	zamrznut	Nan
úp	lice dole	Nan
úy	poručniče	Nan
đhcn	đcn	Nan
đh	đh	Nan
đeo	trošenje	Nan
đentrắng	crno-bjelo	Nan
đen	crna	None
đem	donijeti	Nan
đe	nakovanj	Nan
đcsvn	dcsvn	Nan
đcstq	dcstq	Nan
đáp	odgovor	None
đb	db	Nan
đau	bol	None
đan	pleteni	Nan
đak	dak	Nan
đai	bend	None
đa	multi	Nan
ăngten	antena	Nan
ăng	mrav	None
ăn	jesti	None
ý	italija	None
đay	juta	Nan
sắm	kupovina	Nan
valley	dolina	None
valencia	valencia	Nan
thập	križ	Nan
thận	bubreg	Nan
thẫm	mračno	Nan
thẩm	porotnici	Nan
thầy	učitelj	None
thần	bože	None
thầm	tiho	Nan
thấu	penetrant	Nan
thấp	kratko	None
thảo	prekrasno	Nan
thản	spokojan	Nan
thảm	tepih	Nan
thải	otpad	Nan
thả	kap	Nan
thạo	stručnjak	Nan
thạnh	vlč	Nan
thạch	žele	None
thạc	majstore	Nan
thượng	gornji	None
thật	stvaran	Nan
thược	thud	Nan
thắm	latica	Nan
thắng	pobijedio	None
thọ	dugovječnost	Nan
thịt	meso	None
thịnh	modu	Nan
thỉnh	pozvati	Nan
thể	biti	None
thềm	polica	Nan
thề	psovati	Nan
thếp	čelika	None
thế	dakle	None
thẻ	kartica	None
thẹn	posramljeno	Nan
thặng	višak	Nan
thẳng	ravno	None
thẳm	duboko	None
thằng	momak	Nan
thằn	guštera	Nan
thắt	vezati	Nan
thắp	svjetlost	None
thắngthua	pobjeda	None
thắn	iskreno	Nan
thọc	jab	Nan
thưởng	nagrada	None
thước	vladar	None
thìa	kašika	Nan
thêu	najam	Nan
thêm	više	None
thê	the the	Nan
thét	vrisnuo	Nan
thép	čelika	None
thèm	žudjeti	Nan
thãi	sranje	Nan
thây	vidi	None
thâu	snimljen	None
thâm	duboko	None
tháp	kule	None
tháo	ukloniti	None
thánh	st	Nan
tháng	mesec	Nan
thám	detektive	Nan
thái	tajlandski	Nan
thách	izazov	Nan
thác	kaskada	Nan
thìn	onda	None
thường	često	None
thình	odjednom	Nan
thít	thit	Nan
thương	ljubav	None
thưa	draga	None
thư	pisma	None
thơm	mirisna	Nan
thăng	promovisan	Nan
thăm	poseta	Nan
thúy	thuy	Nan
thúc	kraj	None
thú	zanimljivo	None
thùy	režanj	Nan
thùng	kanta za smeće	Nan
thù	feud	Nan
thông	informisan	Nan
thôi	hajde	Nan
thô	grub	Nan
thói	navika	Nan
thóc	neolušan	Nan
thòi	nedostatak	None
thò	pokucao	Nan
thí	eksperimenti	None
thày	učiteljice	Nan
thỏ	zec	Nan
thỏi	ingota	Nan
tncs	tncs	Nan
tiệt	jebeno	Nan
tiệp	češki	Nan
tiện	povoljno	Nan
tiệm	prodavnica	Nan
tiệc	gozba	Nan
tiễu	gospodine liu	Nan
tiểu	piškiti	Nan
tiều	sranje	Nan
tiền	novac	None
tiềm	potencijal	None
tiếu	goofy	Nan
tiết	sekrecija	Nan
tiếng	jezik	None
tiến	gore	None
tiếm	goofy	Nan
tiếc	žaljenje	Nan
tiêu	biber	Nan
tiên	prvo	None
tngt	tngt	Nan
tizard	tizard	Nan
tnhh	ograničeno	None
tobago	tobago	Nan
toàn	sigurno	None
toà	sud	None
toyota	toyota	Nan
toyama	toyama	Nan
tourist	turist	Nan
tourism	turizam	None
tottenham	t tottenham	Nan
toriyama	toriyama	Nan
torino	torino	Nan
top	vrh	None
toonami	toonami	Nan
tony	tony	Nan
tomoyo	tomoyo	Nan
tommy	tommy	Nan
tomas	tomas	Nan
tokyopop	tokyopop	Nan
tokyo	tokyo	Nan
tokugawa	tokugawa	Nan
toei	toei	Nan
toang	toang	Nan
thỏa	sporazum	None
tivi	televizija	None
tish	tish	Nan
thừng	konop	Nan
thừa	suvišan	Nan
thức	budan	Nan
thứ	stvari	None
thủng	perforacija	Nan
thủa	thua	Nan
thủ	prime	Nan
thụt	razveden	Nan
thục	shu	Nan
thụ	receptor	None
thợ	radnik	None
thở	dah	Nan
thời	vreme	None
thớt	daska za sjeckanje	Nan
thổi	udarac	None
thổ	zemlja	None
thồ	spakovati	Nan
thốt	izgovoreno	Nan
thối	trulo	Nan
thử	probati	Nan
tissa	tissa	Nan
thửa	paket	Nan
thực	stvaran	Nan
tisdale	tisdale	Nan
tirol	tirol	Nan
tinthị	tinthị	Nan
tinsông	vijesti	None
tinnhà	tinhome	Nan
tinh	planeta	None
tincầu	limeni most	Nan
tinbắc	poruka	None
tin	vjerujte	Nan
timothy	timothy	Nan
timor	timor	Nan
tim	srce	None
tiliaceus	tiliaceus	Nan
tigris	tigris	Nan
tibet	tibet	Nan
tiara	tiara	Nan
tiananmen	tiananmen	Nan
tia	zraka	None
ti	ti	None
thự	vila	Nan
thành	fort	Nan
thà	radije bih	Nan
thy	tvoj	Nan
tarim	tarim	Nan
tao	ja	None
tanzania	tanzanija	Nan
tankōbon	tankōbon	Nan
tanh	riblji	Nan
tang	tugovanje	Nan
tanaka	tanaka	Nan
tamoxifen	tamoksifen	Nan
tam	tam	Nan
talmud	talmud	Nan
taliban	talibani	Nan
tali	tali	Nan
taklamakan	taklamakan	Nan
takahashi	takahashi	Nan
tajiri	tajiri	Nan
tajima	tajima	Nan
tajikistan	tadžikistan	Nan
taj	taj	None
taiwan	tajvan	Nan
task	zadatak	None
taipei	tajpej	Nan
tasman	tasman	Nan
tau	tau	Nan
tenxơ	kartela	Nan
temur	temur	Nan
temujin	temujin	Nan
temple	hram	None
tem	pečat	None
telnet	telnet	Nan
telex	teleks	Nan
telekom	telekom	Nan
telecom	telekom	Nan
teddy	medo	Nan
ted	ted	Nan
technical	tehničke	None
tcp	tcp	Nan
tcm	tcm	Nan
tchad	tchad	Nan
tbt	tbt	Nan
taylor	taylor	None
tay	ruka	None
taxi	taksi	Nan
tasmania	tasmanija	Nan
teo	atrofični	Nan
taiji	taiji	Nan
tag	oznaka	None
sờ	dodir	None
sớm	uskoro	None
sớ	volja	None
sổ	knjiga	None
sồi	hrast	Nan
sốt	vrućica	Nan
sống	živi	None
sốc	šokiran	Nan
số	broj	None
sỏi	šljunak	Nan
sỏ	sassy	Nan
sọc	pruge	None
sọ	lobanja	None
sẽ	volja	None
sẻ	će	None
sẹo	ožiljak	Nan
sẵn	na raspolaganju	Nan
sắt	gvožđe	Nan
sắp	skoro	None
sỡ	propustili	Nan
tai	uho	Nan
sợ	uplašen	Nan
sục	jacuzzi	Nan
tae	tae	Nan
ta	ta	None
sự	the the	Nan
sữa	mlijeko	None
sửu	ox	Nan
sửng	šokiran	Nan
sửa	popravak	Nan
sử	istorija	None
sừng	rog	Nan
sứt	usitnjeno	Nan
sức	snage	None
sứa	meduze	Nan
sứ	keramika	Nan
sủng	karizmatičan	Nan
sủi	šumeće	Nan
sủa	kora	None
sụt	pad	None
sụp	kolaps	Nan
sụn	hrskavice	Nan
sợi	prediva	Nan
terengganu	terengganu	Nan
territories	teritorije	None
terry	frotir	Nan
thpt	thpt	Nan
thoắt	brz	None
thoảng	povremeno	None
thoải	ugodno	Nan
thoả	dogovor	None
thoạt	na prvi pogled	Nan
thoại	telefon	Nan
thoát	izlaz	None
thoáng	prozračan	Nan
thoán	pogodi	Nan
thoái	regresivno	Nan
those	one	None
thong	tangi	Nan
thompson	thompson	Nan
thomas	thomas	None
thoai	thoai	Nan
thoa	dab	Nan
tho	tho	Nan
thiệu	uvod	None
thriller	triler	Nan
thiệt	stvarno	None
thskts	thskts	Nan
thumb|các	palac |	Nan
thvn	thvn	Nan
thuỷ	thuy	Nan
thuỵ	thuy	Nan
thuở	djetinjstvo	None
thuờng	obično	None
thuớc	voda	None
thuộc	pripadati	Nan
thuốc	lijek	None
thuế	poreza	None
thuật	čl	Nan
thuận	pros	Nan
thuẫn	sukob	None
thuần	čisto	None
thuê	iznajmiti	Nan
thuyền	brod	None
thuyết	teorija	None
thuyên	raseljavanje	Nan
thung	dolina	None
thunderbolt	thunderbolt	Nan
thua	izgubiti	None
thiệp	kartica	None
thiện	dobro	None
thiểu	maloljetnika	Nan
thdq	thdq	Nan
thcs	thcs	Nan
thcn	thcn	Nan
thay	umjesto toga	Nan
thau	mesing	Nan
thao	sport	None
thani	thani	Nan
thanh	bar	None
thang	merdevine	Nan
than	ugalj	None
thames	thames	Nan
tham	pohlepa	Nan
thailand	tajland	Nan
thai	trudna	None
tha	izgovor	None
tgv	tgv	Nan
texas	texas	Nan
tet	tet	Nan
terumbu	terumbu	Nan
thebes	thebes	Nan
their	njihove	None
them	njih	None
then	onda	None
thiển	pokazati	None
thiền	meditacija	Nan
thiềm	srp	Nan
thiếu	kratko	None
thiết	set	None
thiếp	kartica	None
thiến	neuter	Nan
thiếc	kalaj	None
thiêng	sveto	None
toán	matematika	None
thiêm	thiêm	Nan
third	treća	None
thien	thien	Nan
thich	kao	None
thi	ispit	Nan
theseus	teze	None
theres	theres	Nan
theravada	theravada	Nan
theory	teorija	None
theo	prema	None
thiu	ustajan	Nan
toát	dobro	None
toạ	koordinate	Nan
toại	u	None
tạm	provizorni	Nan
tại	u	None
tạc	kiviti	Nan
tạ	mrena	Nan
tường	zid	None
tướng	opšte	None
tưới	zalijevanje	Nan
tước	skidanje	Nan
tương	slično	None
tươi	svež	Nan
tưng	drhtav	Nan
tư	od	None
tơi	ja	None
tĩnh	statički	Nan
tăng	povećati	Nan
tăm	čačkalica	Nan
tý	pacov	Nan
túy	lijek	None
túp	koliba	Nan
tạo	stvoriti	None
túng	nespretno	Nan
tạp	časopis	Nan
tản	rasipanje	Nan
tặc	hakeri	Nan
tắt	ugasiti	Nan
tắm	tuš	Nan
tắc	sklopke	Nan
tật	invalidnost	Nan
tận	kraj	None
tẩy	gumica	Nan
tẩm	impregniran	Nan
tầu	voz	Nan
tầng	kat	Nan
tần	frekvencija	None
tầm	igre	None
tấu	instrumentalni	Nan
tất	čarape	Nan
tấp	izvukao	Nan
tấn	tona	Nan
tấm	tanjure	Nan
tấc	inč	Nan
tảng	platforma	Nan
tả	opis	None
tặng	donirati	Nan
túm	zgrabi	Nan
túc	dovoljnost	Nan
tê	ukočen	Nan
tét	vrisak	Nan
tã	pelene	Nan
tâynam	westnam	Nan
tây	zapad	None
tâu	gospodaru moj	Nan
tâm	centar	None
táu	kriv	Nan
táp	kucnite	Nan
tánh	tanh	Nan
tán	nadstrešnica	Nan
tám	osam	None
tái	re	Nan
tách	kup	None
tá	desetak	None
tàu	brod	None
tành	tanh	Nan
tàng	muzej	None
tàn	pepeo	Nan
tên	ime	None
túi	torbu	Nan
tì	slezina	Nan
tìmdiệt	pretraživanje	Nan
tùy	fakultativno	Nan
tùng	rezervni	Nan
tù	zatvor	Nan
tông	karton	Nan
tôn	valoviti	Nan
tôm	kozice	Nan
tôi	ja	None
tô	posuda	Nan
tóm	zbornik	None
tòng	tong	Nan
tòi	stvari	None
tòa	sud	None
tò	znatiželja	Nan
tít	naslov	None
tín	kredita	Nan
tím	ljubičasta	Nan
tích	proizvod	None
tía	ljubičasta	Nan
tình	ljubav	None
tìm	pronađi	Nan
tẻ	rupa	None
tết	tet	Nan
tếxã	ekonomski	None
ural	uralni	Nan
up	ups	Nan
unix	unix	Nan
unit	jedinica	None
unicorn	jednorog	Nan
ung	trulo	Nan
unesco	unesco	Nan
under	ispod	None
und	und	None
un	un	None
umm	umm	Nan
ulsan	ulsan	Nan
ukraina	ukraina	Nan
ukiyoe	ukiyoe	Nan
uk	uk	Nan
uh	uh	Nan
uefa	uefa	None
uchiha	uchiha	Nan
uc	uc	Nan
urani	uranijuma	Nan
ubuntu	ubuntu	None
uri	uri	Nan
usagi	usagi	Nan
vai	rame	Nan
vaccine	vakcina	Nan
va	va	Nan
v	v	None
uổng	rasipanje	Nan
uống	piti	Nan
uốn	curling	Nan
uất	uất	Nan
uông	uong	Nan
uzbekistan	uzbekistan	Nan
uyển	eufemizam	Nan
uyên	uyen	Nan
uygur	uygur	Nan
uyghur	uyghur	Nan
uy	uy	Nan
utrecht	utrecht	Nan
utah	utah	Nan
uss	uss	Nan
usb	usb	None
uruguay	urugvaj	Nan
uae	uae	Nan
ua	ua	Nan
u	u	None
tồn	postoje	None
tồi	loše	None
tốt	dobro	None
tốp	grupa	None
tống	pratnja	Nan
tốn	trošak	None
tốc	brzina	None
tỏi	bijeli luk	Nan
tỏa	zračiti	Nan
tỏ	izraženo	Nan
tọa	koordinate	Nan
tịch	predsjedniče	Nan
tị	zavist	Nan
tỉnh	provincijalni	Nan
tỉa	podrezati	Nan
tệp	datoteka	None
tệ	loše	None
tể	gospodin	None
tề	qi	Nan
tổn	boli	None
tổng	ukupno	None
tộc	klan	Nan
tội	grijeh	Nan
tỷ	milijardi	Nan
tỵ	zmija	None
tựu	dostignuća	None
tựa	naslov	None
tự	sebe	None
tửu	tolerancija na alkohol	Nan
tử	smrt	None
từng	ikada	None
từ	od	None
tài	bogatstvo	None
tức	trenutak	None
tủi	loše	None
tủ	ormari	Nan
tụy	gušterače	None
tục	profana	Nan
tởm	odvratno	Nan
tờ	list	None
tới	sljedeći	None
tớ	ja	None
tột	ekstremnim	Nan
tủy	srž	None
valentine	valentina	Nan
tà	zlo	None
type	tip	None
trò	trik	Nan
trích	izvod	Nan
trí	um	Nan
trình	predati	Nan
trên	na	None
trèo	penjati se	Nan
trãi	rasute	Nan
trâu	bizon	Nan
trân	srdačan pozdrav	Nan
trâm	broš	Nan
trát	nalog	Nan
tráp	kutija	Nan
tráo	lažno	Nan
tránh	izbegavaj	Nan
tráng	premazan	Nan
trán	čelo	None
trái	levo	Nan
trách	kriviti	Nan
trác	trac	Nan
tròn	okrugli	Nan
trào	erupciju	Nan
trói	svezan	Nan
trông	izgleda	None
trước 	prije	Nan
trước	prije	None
trương	truong	Nan
trưngcông	izloženi	None
trưng	rekvizicija	Nan
trưa	podne	None
trư	tru	Nan
trơn	sklizak	Nan
trơ	inertan	Nan
trũng	potonuo	Nan
trĩ	hemoroidi	Nan
trăng	mesec	Nan
trăn	python	Nan
trăm	sto	None
trúc	bambus	Nan
trú	ukrcavanje	Nan
trùy	truy	Nan
trùng	podudaraju se	Nan
trùm	šef	None
trôi	drift	Nan
trướng	ekspanzija	Nan
tràng	debelog creva	Nan
trà	čaj	Nan
trinidad	trinidad	Nan
trinh	djevice	Nan
tribune	tribina	Nan
tri	tri	None
treo	visi	Nan
tre	bambus	Nan
trau	trau	Nan
trao	predao	None
tranh	slike	None
trang	stranica	None
trai	školjke	Nan
trafford	trafford	Nan
trafalgar	trafalgar	Nan
tqlc	tqlc	Nan
tpvĩnh	grad	None
tphồ	grad	None
tphcm	tphcm	Nan
tp	tp	Nan
toả	zračiti	Nan
trinity	trojstvo	Nan
tràm	cajuput	Nan
tristan	tristan	Nan
triền	trien	Nan
truỵ	laž	Nan
truởng	šefe	Nan
truất	negativci	Nan
truân	truân	Nan
truyện	priča	None
truyên	truyen	Nan
truong	truong	Nan
trungnhật	iskrenost	Nan
trung	sredina	Nan
truman	truman	Nan
true	istinito	Nan
trong	u	None
trondheim	trondheim	Nan
troia	troja	Nan
tro	pepeo	Nan
triệu	milion	None
triệt	temeljno	Nan
triện	pečat	None
triều	plima	Nan
triết	filozofija	None
trườn	puzeti	Nan
trường	škola	None
trượng	kaduceus	Nan
tutsi	tutsi	Nan
tuscan	toskanska	Nan
tupolev	tupolev	Nan
tung	baciti	Nan
tum	tum	Nan
tulip	tulipan	Nan
tukhachevsky	tukhachevsky	Nan
tudor	tudor	Nan
tucker	tucker	Nan
tua	šipka	None
tt	tt	Nan
ts	ts	Nan
trực	na dužnosti	Nan
trữ	skladište	Nan
trừu	ovce	Nan
trừng	sjaj	Nan
trừ	oduzeti	Nan
trứng	jaje	Nan
trứ	tru	Nan
tuvalu	tuvalu	Nan
trụi	gola	Nan
tuy	kako god	Nan
tuyết	snijeg	None
ty	ti	None
twitter	twitter	Nan
twin	blizanci	Nan
tvb	tvb	Nan
tv	televizija	None
tuỳ	fakultativno	Nan
tuột	skliznuti	Nan
tuộc	hobotnica	Nan
tuổi	godinu dana	Nan
tuốc	plutanje	Nan
tuệ	mudrost	Nan
tuế	minnows	Nan
tuần	sedmicu	Nan
tuý	tuyý	Nan
tuông	ispiranje	Nan
tuân	poslušati	Nan
tuyệt	odlično	Nan
tuyển	regrutovanje	Nan
tuyền	tuyen	Nan
tuyên	izjaviti	Nan
trục	osa	Nan
trụ	ured	Nan
trợ	podrška	None
trận	utakmicu	None
trẫm	ja sam	Nan
trẩy	odskočiti	Nan
trầy	ogrebani	Nan
trầu	betel	Nan
trần	golo	Nan
trầm	duboko	None
trấu	rižina ljuska	Nan
trấn	grad	None
trảo	mačete	Nan
trảm	cajuput	Nan
trải	poklopac	Nan
trả	platiti	Nan
trạo	tao	Nan
trạng	stanje	None
trạm	stanica	None
trại	kamp	Nan
trạch	trach	Nan
trượt	klizati	Nan
trật	dislociran	Nan
trắc	biometrija	Nan
trắng	bela	Nan
trặc	štucanje	Nan
trời	bože	None
trớn	milovati	Nan
trộm	lopovi	Nan
trội	dominantan	None
trỗi	nastajanje	None
trổ	pokazati	None
trồng	rasti	Nan
trồi	u nastajanju	Nan
trống	prazan	Nan
typhon	typhon	Nan
trốn	sakriti	Nan
trỏ	pokazivači	Nan
trọng	bitan	None
trọn	pun	None
trọ	gostionica	Nan
trịnh	phnh	Nan
trị	tretman	None
trệ	stagnira	Nan
trễ	kasno	None
trẻ	mlad	None
trối	konačna	None
−−	−−	Nan
mũ	šešir	Nan
măng	izdanci bambusa	Nan
cụm	cluster	Nan
cục	odeljenje	Nan
cợt	šale	Nan
cỡ	veličina	None
cờ	zastava	None
cớ	izgovor	None
cột	stupac	Nan
cộng	plus	None
cội	stari	None
cộ	vozilo	Nan
cỗi	tvrdoglav	Nan
cỗ	paluba	Nan
cổng	kapija	None
cồng	gong	Nan
cồn	alkohol	None
cống	odvod	Nan
cốm	nuggets	Nan
cối	malter	Nan
cốc	šolju	Nan
cụp	amputirana	Nan
cố	probaj	Nan
cụt	amputirana	Nan
của	of the	Nan
daegu	daegu	Nan
da	koža	None
d	d	Nan
cựu	bivša	None
cực	pol	Nan
cựa	spursi	Nan
cự	razdaljina	Nan
cữu	kovčeg	Nan
cữ	cu	None
cửu	množiti	Nan
cửa	vrata	None
cừu	janjetina	Nan
cừ	stubovi	Nan
cứngi	hardi	Nan
cứng	teško	None
cức	coo	Nan
cứ	na	None
củng	takođe	None
củi	ogrevno drvo	Nan
củ	gomolji	Nan
dahl	dahl	Nan
cỏ	trava	Nan
cọc	gomila	Nan
cảnh	scenu	None
cảng	luka	None
cản	muči	Nan
cảm	hladno	Nan
cải	senf	Nan
cả	oboje	Nan
cạp	škorpion	Nan
cạo	brijati	Nan
cạnh	ivica	None
cạn	plitko	Nan
cạc	kartica	None
cưỡng	prisiljeni	Nan
cưỡi	jahanje	Nan
cường	jak	None
cười	smijati se	Nan
cướp	opljačkati	Nan
cưới	oženjen	None
cước	teretni	Nan
cưng	dušo moja	Nan
cảo	vuče	None
cọp	tigar	Nan
cấm	zabraniti	Nan
cấp	grant	Nan
cọ	trljati	Nan
cặp	torba	Nan
cằn	mrzovoljni	Nan
cằm	brada	Nan
cắt	rez	Nan
cắp	ukrasti	Nan
cắn	ugriz	Nan
cắm	priključite	Nan
cậy	zavisi	None
cậu	dečko	Nan
cập	brojač	Nan
cận	pristup	None
cẩu	kran	Nan
cẩn	budi pazljiv	Nan
cầy	civet	Nan
cầu	most	None
cần	potreba	None
cầm	izdržati	Nan
cất	destilovana	Nan
cấn	potreba	None
cưa	pila	Nan
dai	tvrd	Nan
dakota	dakota	Nan
dm	dm	Nan
djokovic	djokovic	Nan
djibouti	djibouti	Nan
diệu	magija	Nan
diệt	ubiti	None
diện	lice	None
diệm	diem	Nan
diệc	čaplja	Nan
diễu	marš	Nan
diễm	diem	Nan
diểu	farsa	Nan
diều	zmaj	Nan
diềm	valance	Nan
diên	luda	Nan
diêm	šibice	Nan
divoire	divoire	Nan
division	divizija	None
disneyland	disneyland	Nan
discussion	diskusija	Nan
dmitri	dmitri	Nan
discovery	otkriće	None
dna	dna	Nan
doanh	zglob	Nan
driver	vozač	Nan
drake	drake	Nan
draft	nacrt	Nan
dracula	drakula	Nan
dp	dp	Nan
doạ	prijeteći	Nan
doãn	doan	Nan
doyle	doyle	Nan
dover	dover	Nan
douglas	douglas	Nan
dougherty	dougherty	Nan
dortmund	dortmund	Nan
donau	donau	Nan
don	don	None
dominican	dominikanski	Nan
dome	kupola	Nan
dolly	dolly	Nan
docherty	docherty	Nan
doc	doc	Nan
do	od	None
daily	dnevno	None
dionysus	dioniz	Nan
dimaggio	dimaggio	Nan
dbsk	dbsk	Nan
davis	davis	None
davies	davies	Nan
david	david	None
dave	dave	Nan
dau	ulje	Nan
date	datum	None
dassault	dassault	Nan
das	das	Nan
darwin	darwin	None
dao	nož	Nan
dante	dante	None
daniel	daniel	None
danh	ime	None
danger	opasnost	None
dancing	plesanja	Nan
dan	dan	None
dampier	prigušivač	Nan
dalat	da lat	Nan
dc	dc	Nan
dinh	palata	Nan
ddr	ddr	Nan
degree	stepen	None
dien	luda	Nan
diego	diego	Nan
die	umrijeti	Nan
diana	diana	Nan
di	di	None
dewitt	dewitt	Nan
dewan	dewan	Nan
deutschland	deutschland	Nan
deuterium	deuterium	Nan
design	thiết kế	Nan
descartes	descartes	Nan
des	des	Nan
derek	derek	Nan
department	odeljenje	Nan
dennis	dennis	Nan
den	den	Nan
demeter	demeter	Nan
delphi	delphi	Nan
delhi	delhi	Nan
dean	dekan	Nan
cư	naseliti	Nan
cơm	pirinča	Nan
cũng	takođe	None
coleen	coleen	Nan
coi	pazi	Nan
cohen	cohen	Nan
coffea	kava	Nan
coen	coen	Nan
cocoa	kakao	Nan
coburn	kopriva	Nan
co	co	None
cnxh	cnxh	Nan
cntt	cntt	Nan
cntb	cntb	Nan
cnet	cnet	Nan
cn	cn	Nan
cmt	cmt	Nan
cmc	cmc	Nan
clyde	clyde	Nan
clow	klau	Nan
clo	hlor	Nan
clips	kopče	Nan
coleman	coleman	Nan
clip	isječak	Nan
coli	coli	Nan
colleen	colleen	Nan
conservation	očuvanje	None
conrad	conrad	Nan
connecticut	connecticut	Nan
congress	kongres	None
congo	kongo	Nan
cong	zakrivljena	Nan
condom	kondom	Nan
concorde	concorde	Nan
concerto	koncert	None
concacaf	konkafe	Nan
common	često	None
comic	komično	Nan
columbus	kolumbus	Nan
colorado	colorado	Nan
colombo	colombo	Nan
colombia	kolumbija	None
collège	koledž	Nan
collins	collins	Nan
college	fakultet	None
colin	colin	Nan
constantine	konstantina	Nan
clinton	clinton	Nan
claude	klod	Nan
chục	desetak	None
chợt	odjednom	Nan
chợ	tržište	None
chở	nošenje	Nan
chờ	sačekaj	Nan
chớp	munje	Nan
chớ	nemoj	Nan
chội	sranje	Nan
chỗ	mesto	Nan
chồng	muž	None
chồn	lisica	Nan
chồi	puca	None
chốt	zasun	Nan
chống	anti	Nan
chốn	mesto	Nan
chối	zanijekati	Nan
chốc	momenat	Nan
chỏ	lakat	Nan
chọn	odaberite	Nan
chụp	pucaj	Nan
claudius	klaudija	Nan
chủ	majstore	Nan
chứ	radije	None
clark	klark	Nan
clara	clara	Nan
cities	gradova	None
circus	cirkus	Nan
cip	cip	Nan
cinderella	pepeljuga	Nan
cincinnati	cincinnati	Nan
cia	cia	None
chững	izravnavanje	Nan
chữa	lek	Nan
chữ	reč	Nan
chửi	psovke	Nan
chửa	trudna	None
chử	reč	Nan
chừng	neki	None
chừa	odlazeći	Nan
chừ	pismo	None
chức	funkcija	None
chứa	sadrže	None
chủng	sojevi	Nan
contemporary	savremeni	None
cooper	cooper	Nan
copenhagen	kopenhagen	Nan
có	imati	None
còn	još	None
cò	okidač	Nan
cãi	rasprava	None
câu	rečenica	None
cân	vage	Nan
câm	glupi	Nan
cáy	fiddler	Nan
cáp	kabl	Nan
cáopx|bình	komentar	Nan
cáo	lisica	Nan
cánh	krilo	None
cán	valjani	Nan
cái	the the	Nan
cách	način	None
các	the the	Nan
cày	oranje	Nan
cào	scratch	Nan
cành	ogranak	None
cói	sedžda	Nan
càng	više	None
cót	krevet	Nan
côi	siroče	Nan
cũi	krevetac	Nan
cũ	stari	None
căng	rastezanje	Nan
căn	radikalan	Nan
căm	uključen	Nan
cút	izaći	Nan
cúp	šolja	Nan
cúng	ugodan	Nan
cúm	gripa	Nan
cúi	luk	None
cú	sova	Nan
cùng	i	None
cùi	gubavci	Nan
cù	škakljati	Nan
cõng	piggyback	Nan
cõi	carstva	None
côngtenơ	kontejner	Nan
công	posla	None
côn	konus	Nan
cô	nedostajati	Nan
càn	potreba	None
cài	instalirati	Nan
cà	kafa	Nan
cristiano	cristiano	Nan
crisis	kriza	None
crimson	grimizno	Nan
crew	posada	Nan
crest	greben	Nan
crespo	crespo	Nan
crazy	luda	Nan
craig	craig	Nan
cpt	cpt	Nan
cotang	cotang	Nan
costa	costa	Nan
cosin	kosin	Nan
cornell	cornell	Nan
core	jezgra	None
cordyceps	cordyceps	Nan
copy	kopiju	Nan
coppola	kopola	Nan
copperfield	bakreno polje	Nan
copernic	kopernik	Nan
croatia	hrvatska	None
cross	križ	Nan
crs	crs	Nan
cruz	cruz	Nan
cyworld	cyworld	Nan
cyrus	cyrus	Nan
cyril	ćirilica	None
cyber	cyber	Nan
cyanide	cijanid	Nan
cuộc	the the	Nan
cuồng	luda	Nan
cuống	stabljika	Nan
cuốn	zavojnica	Nan
ds	ds	Nan
cuối	zadnji	None
cuả	od	None
cup	šolja	Nan
cunningham	cunningham	Nan
cung	luk	None
cullen	klen	Nan
cua	rak	None
ctc	ctc	Nan
crystal	kristal	Nan
cruzeiro	cruzeiro	Nan
cuốc	motike	Nan
dtd	dtd	Nan
dth	dth	Nan
du	du	None
food	hrana	None
fokker	fokker	Nan
foden	foden	Nan
focus	fokus	Nan
foch	foch	Nan
flight	let	None
fleming	leteći	Nan
flanker	flanker	Nan
fitzgerald	fitzgerald	Nan
fishbed	ribnjak	Nan
fish	riba	None
fischer	fischer	Nan
firefox	firefox	None
finish	završiti	Nan
fiji	fidži	Nan
figo	figo	Nan
fifpro	fivepro	Nan
fifa	fifa	None
field	polje	None
football	fudbal	None
fidel	fidel	Nan
forbes	forbes	Nan
fordham	fordham	Nan
fujiko	fujiko	Nan
fu	fu	Nan
friedman	friedman	Nan
freud	freud	Nan
franz	franz	None
franklin	franklin	Nan
frankfurt	frankfurt	Nan
frank	iskren	Nan
franco	franko	Nan
francisco	francisco	None
francis	francis	Nan
frances	frances	Nan
france	francuska	None
franc	franak	Nan
fracsin	fracsin	Nan
fpt	fpt	Nan
fox	lisica	Nan
foundation	temelj	None
forks	viljuške	Nan
ford	ford	Nan
fujimoto	fujimoto	Nan
fiat	fijat	Nan
fernando	fernando	Nan
every	svaki	None
everton	everton	Nan
eva	eva	Nan
european	evropski	None
europe	europa	Nan
eurofighter	eurofighter	Nan
euro	evro	Nan
euler	euler	Nan
eugène	eugène	Nan
eugene	eugene	Nan
euclid	euclid	Nan
ethiopia	etiopija	Nan
ethernet	ethernet	None
essential	esencijalno	Nan
españa	españa	Nan
erwin	erwin	Nan
eros	eros	Nan
ernest	ernest	Nan
eritrea	eritreja	Nan
exgay	exgay	Nan
ferrari	ferrari	Nan
explorer	istraživač	None
fabio	fabio	Nan
ferguson	ferguson	Nan
ferdinand	ferdinand	None
ferb	ferb	Nan
felix	felix	Nan
felis	felis	Nan
felipe	felipe	Nan
feet	stopala	Nan
federer	federer	Nan
features	karakteristikama	None
fdi	fdi	Nan
fca	fca	Nan
fbi	fbi	Nan
faso	faso	Nan
farrell	farrell	Nan
fao	fao	Nan
faifo	faifo	Nan
facto	faktički	Nan
fact	činjenica	None
facebook	facebook	None
extensive	opsežan	Nan
fukuoka	fukuoka	Nan
funimation	zabava	Nan
funk	funk	Nan
gifu	gifu	Nan
gieo	sijati	Nan
gichin	gichin	Nan
gibraltar	gibraltar	Nan
giang	giang	Nan
gian	prostor	None
giam	zatvor	Nan
giai	pozornica	Nan
gia	gia	Nan
ghềnh	brzaci	Nan
ghề	brzaci	Nan
ghế	stolica	Nan
ghẻ	krasta	Nan
ghì	ghì	Nan
ghê	užas	Nan
ghép	cijep	Nan
ghé	stani	Nan
ghim	pin	Nan
ghi	napiši	Nan
ginzan	ginzan	Nan
ghen	ljubomoran	Nan
gio	gio	Nan
giuliani	giuliani	Nan
giêsu	jezus	Nan
giêng	giong	Nan
giêhôva	giva	Nan
gièm	negativci	Nan
giãn	rastezanje	Nan
giã	udaranje	Nan
giây	sekundi	None
gián	žohari	Nan
giám	redatelja	Nan
giá	cijena	None
giày	cipele	Nan
giàu	bogat	None
giành	željno	Nan
giàn	truss	Nan
già	stari	None
giza	giza	Nan
giuộc	giuoc	Nan
giuse	giuse	Nan
giun	crvi	Nan
gioi	gioi	Nan
ghe	brod	None
ghana	gana	Nan
gerrard	gerrard	Nan
gao	pirinča	Nan
ganh	ljubomoran	Nan
gang	banda	Nan
gandhi	gandhi	None
gan	jetra	None
gamow	gamow	Nan
gambia	gambija	Nan
gam	grama	Nan
galileo	galileo	Nan
galilei	galilei	Nan
gaillard	gaillard	Nan
gaia	gaia	Nan
gagarin	gagarin	Nan
gabriella	gabriella	None
gabriel	gabriel	Nan
gabon	gabon	Nan
ga	ga	None
fx	fx	Nan
futsal	futsal	Nan
gareth	gareth	Nan
garrett	garrett	Nan
gary	gary	Nan
gascon	gascon	Nan
germany	germany	Nan
german	njemački	None
gerhard	gerhard	Nan
gerais	gerais	Nan
ger	ger	Nan
gepard	gepard	Nan
georges	georges	Nan
george	george	None
georg	georg	Nan
eris	eris	Nan
genesis	geneza	Nan
gen	geni	Nan
geisha	gejša	Nan
gdp	gdp	Nan
gdańsk	gdańsk	Nan
gaza	gaza	Nan
gay	gej	Nan
gaulois	gaulois	Nan
gaule	gaule	Nan
gatt	gatt	Nan
gene	gen	None
chọi	borbe	None
erik	erik	Nan
ep	ep	None
dường	čini se	Nan
dương	pozitivno	Nan
dưng	stani	Nan
dưa	dinje	Nan
dư	preostali	Nan
dơi	slepi miševi	Nan
dơ	prljav	Nan
dũng	odvažan	Nan
dĩa	tanjur	Nan
dĩ	naravno	None
dăm	strugotine	Nan
dùng	upotreba	None
dùi	udarač	Nan
dù	ipak	None
dõi	staza	Nan
dông	grmljavina	Nan
dó	da	None
dòng	trenutna	Nan
dòm	pogledaj	Nan
dưỡng	nega	Nan
dò	pretraživanje	Nan
dược	apoteka	Nan
dạ	da	None
dậy	ustani	Nan
dậu	horoz	Nan
dận	tetka	Nan
dẫu	ipak	None
dẫn	vodič	None
dẫm	strpati	Nan
dầu	ulje	Nan
dần	postepeno	None
dấy	uzbudljivo	Nan
dấu	znak	None
dấp	spoticanje	Nan
dấm	sirće	Nan
dải	skinuti se	Nan
dạy	podučavati	Nan
dạt	opran	Nan
dạo	šetati	Nan
dạng	format	None
dạn	neustrašiva	Nan
dại	bezumno	Nan
dượng	stric	Nan
dắt	olovo	None
dính	ljepljiv	Nan
dì	tetka	Nan
dà	da	None
dwight	dwight	Nan
duỗi	ispraviti	Nan
duệ	potomaka	Nan
duật	duat	Nan
duẩn	duan	Nan
duơng	duong	Nan
duyệt	pretraživač	Nan
duyện	teži	None
duyên	predodređena	Nan
duy	samo	None
dursley	dursley	Nan
durham	durham	Nan
dung	gnoj	Nan
dumbledore	dumbledore	Nan
dumas	dumas	Nan
duk	duk	Nan
duiker	duiker	Nan
dubai	dubai	Nan
dài	dugo	None
dìu	dìu	Nan
dàn	inscenacija	Nan
dành	potrošeno	Nan
dê	jarac	Nan
dép	sandale	Nan
défense	défense	Nan
dè	budi pazljiv	Nan
dãy	domet	None
dãn	proširen	Nan
dãi	permisivan	Nan
dã	divlji	Nan
dây	kabel	Nan
dâng	ponuda	None
dân	ljudi	None
dâm	nepristojan	Nan
dát	intarziran	Nan
dáng	oblik	None
dán	pasta	Nan
dám	usudi se	Nan
dái	molim	Nan
dày	debeo	Nan
dào	u izobilju	Nan
dàng	lako	None
dằn	balast	Nan
dằng	uporan	Nan
dẳng	uporan	Nan
elbe	elbe	Nan
ekaterina	ekaterina	Nan
eisenhower	eisenhower	Nan
einstein	einstein	None
eiffel	eiffelov	Nan
eid	bajram	None
egypt	egipat	None
efron	efron	Nan
eea	eea	Nan
edwin	edwin	Nan
edward	edward	None
edo	edo	None
edmond	edmond	Nan
editor	urednik	None
edison	edison	Nan
edinburgh	edinburgh	Nan
edge	ivica	None
edgar	edgar	Nan
edda	edda	Nan
electronic	elektronički	Nan
ecw	ecw	Nan
eliane	eliane	Nan
elizabeth	elizabeth	None
eo	struk	Nan
enzym	enzim	Nan
entropy	entropija	Nan
entente	entente	Nan
eniac	enijak	Nan
england	engleska	None
engels	engels	Nan
energy	energije	None
en	en	Nan
emmy	emmy	Nan
emir	emir	None
emily	emily	Nan
email	email	None
em	ti	None
elíp	elipsa	Nan
elvis	elvis	None
elton	elton	Nan
ellis	ellis	Nan
ellen	ellen	Nan
elip	elipsa	Nan
ecmascript	ecmascript	Nan
ebro	ebro	Nan
eaton	eaton	Nan
dỏm	duhovita	Nan
dọc	vertikalno	Nan
dọa	prijeteći	Nan
dịu	blag	Nan
dịp	prilika	None
dịch	prevedi	Nan
dị	jedinstvenost	Nan
dệt	tkanje	Nan
dễ	lako	None
dể	lako	None
dền	amarant	Nan
dế	cvrčci	Nan
dẻo	plastičnost	Nan
dẻ	kesteni	Nan
dẹt	stan	Nan
dẹp	stan van	Nan
dặt	red	None
dặn	naređeno	Nan
dặm	milju	Nan
dốc	nagib	Nan
dối	laž	Nan
dốt	neznalica	Nan
dồi	u izobilju	Nan
earles	naušnice	Nan
ea	ea	Nan
e	e	None
dỹ	dỹ	Nan
dực	muško	Nan
dựa	zasnovana	None
dự	projektovano	Nan
dữ	podataka	None
dừng	stani	Nan
erich	erich	Nan
dừa	kokos	Nan
dứa	ananas	Nan
dụng	upotreba	None
dục	seks	None
dụ	na primjer	Nan
dỡ	istovar	Nan
dở	loše	None
dời	potez	Nan
dỗ	nagovoriti	Nan
dồn	uglati	Nan
dứt	stani	Nan
giêxu	nexus	Nan
chọc	pokucati	Nan
chịt	sranje	Nan
bermuda	bermuda	Nan
berman	berman	Nan
berkeley	berkeley	Nan
bering	bering	Nan
berger	berger	Nan
bergen	bergen	Nan
berber	berber	Nan
bennington	bennington	Nan
benjamin	benjamin	None
benito	benito	Nan
benfica	benfica	Nan
benetton	benetton	Nan
benedict	benedikt	Nan
bellatrix	bellatrix	Nan
bella	bella	Nan
bell	zvono	Nan
bel	bel	Nan
beijing	peking	Nan
behind	iza	None
bernard	bernard	Nan
beginbmatrix	beginbmatrix	Nan
bertrand	bertrand	Nan
betty	betty	Nan
biện	izvini se	Nan
biểuthứcđiềukiện	znati uvjete	Nan
biển	more	None
biều	bieu	Nan
biếu	odati počast	Nan
biếng	lijen	Nan
biến	napolje	Nan
biếm	bezbrižan	Nan
biếc	čajka	Nan
biên	rekord	None
bitmap	bitmap	Nan
bismarck	bismarck	Nan
billy	billy	Nan
bill	račun	None
bikini	bikini	Nan
bic	bic	Nan
biang	biang	Nan
bia	pivo	Nan
bhutan	butan	Nan
better	bolje	None
biệt	izrazito	None
beethovens	beethovens	Nan
bedloe	posteljica	Nan
baryon	barion	Nan
bartholdi	bartholdi	Nan
barrichello	barrichello	Nan
barquin	barquin	Nan
baroque	barok	Nan
barone	barone	Nan
barnes	barnes	Nan
barca	barca	Nan
barbary	barbar	Nan
barbara	barbara	Nan
barbados	barbados	Nan
barak	barak	Nan
barack	barack	Nan
bao	vreća	Nan
bantu	tu zabrana	Nan
bantam	bantam	Nan
banner	baner	Nan
banh	lopta	None
bang	prasak	Nan
barça	barça	Nan
beethoven	beethoven	Nan
base	baza	None
basil	bosiljak	Nan
beckham	beckham	Nan
becker	becker	Nan
beckenbauer	beckenbauer	Nan
beauty	ljepota	Nan
beatles	beatles	Nan
beat	tukli	Nan
bchtư	bchtư	Nan
bc	bc	Nan
bbc	bbc	Nan
bb	bb	Nan
bazơ	osnovni	None
bazan	bazalt	Nan
bayern	bayern	Nan
bay	letjeti	Nan
bauer	bauer	Nan
battambang	battambang	Nan
bator	bator	Nan
bass	bas	None
baskervilles	baskervilles	Nan
basel	bazel	Nan
ban	zabrana	Nan
bkavpro	bkavpro	Nan
blair	blair	Nan
buonaparte	buonaparte	Nan
bungo	bungo	Nan
bungary	bungary	Nan
bulletin	bilten	Nan
bulgaria	bugarska	None
budapest	budapest	Nan
bubalis	bubalis	Nan
btr	btr	Nan
brussels	briselu	Nan
brusilov	brusilov	Nan
bruno	bruno	None
brunei	brunei	Nan
bruce	bruce	Nan
browning	smeđe korenje	Nan
browne	browne	Nan
brown	smeđa	Nan
brot	brot	Nan
brooklyn	brooklyn	Nan
britney	britney	Nan
burke	burke	Nan
britannic	britannic	Nan
burkina	burkina	Nan
burundi	burundi	Nan
bào	rendisanje	Nan
bành	peng	Nan
bàng	orao	Nan
bàn	stola	Nan
bài	postovi	Nan
bà	baka	Nan
byzantine	vizantijski	Nan
buổi	sesija	Nan
buồng	soba	None
buồn	tužan	Nan
buồm	jedriti	Nan
buốt	oštar	Nan
buýt	autobus	Nan
buông	pusti	Nan
buôn	veleprodaja	Nan
bushy	bujan	Nan
bush	grm	Nan
busby	busby	Nan
busan	busan	Nan
burma	burma	Nan
blackwell	blackwell	Nan
bridge	most	None
brezhnev	brezhnev	Nan
boong	paluba	Nan
boom	bum	Nan
boolean	boolean	Nan
bool	bool	Nan
bonobo	bonobo	Nan
bonnal	bonnal	Nan
bong	bong	Nan
bonaparte	bonaparte	None
bom	bomba	None
boltzmann	boltzmann	Nan
bolivia	bolivija	Nan
bohemia	boemija	Nan
boeing	boeing	Nan
bobby	bobby	Nan
bob	bob	Nan
bo	bo	Nan
blues	blues	Nan
blanc	blanc	Nan
blaise	blaise	Nan
boongke	bunkeri	Nan
brian	brian	Nan
bop	bop	Nan
borland	borland	Nan
bretton	bretton	Nan
breton	breton	Nan
brestlitovsk	brestlitovsk	Nan
bremen	bremen	Nan
brazil	brazil	None
braun	braun	Nan
brandt	brandt	Nan
brandenburg	brandenburg	Nan
brain	mozak	None
boxing	boks	Nan
bourbon	burbon	Nan
boulder	balvan	Nan
bottom	dno	None
botswana	bocvana	Nan
bosnia	bosnia	Nan
bosna	bosna	None
boseeinstein	boseeinstein	Nan
bose	bose	Nan
borussia	borussia	Nan
boris	boris	None
bamar	bamar	Nan
ballard	ballard	Nan
balkans	balkans	Nan
alois	alois	Nan
allmusic	allmusic	Nan
allen	allen	Nan
allan	allan	Nan
alice	alice	Nan
ali	ali	None
algérie	algérie	Nan
alfred	alfred	Nan
alexey	alexey	Nan
alexandros	alexandros	Nan
alexandria	aleksandrija	Nan
alexandra	alexandra	Nan
alexa	alexa	Nan
albus	albus	Nan
albuquerque	albuquerque	Nan
albion	albion	Nan
alberto	alberto	None
albert	albert	None
albatros	albatros	Nan
alonso	alonso	Nan
albania	albania	Nan
alpher	alpher	Nan
altai	altai	Nan
andes	andes	Nan
anderson	anderson	Nan
andaman	andaman	Nan
andalusia	andaluzija	Nan
anatolia	anatolija	Nan
anata	anata	Nan
anand	anand	Nan
an	an	None
amphitrite	amfritrit	Nan
amoniac	amonijak	Nan
amm	amm	Nan
amin	amin	Nan
amiens	amiens	Nan
ami	ami	Nan
ame	ame	Nan
amdo	amdo	Nan
amazon	amazon	Nan
amaravati	amaravati	Nan
always	uvek	Nan
alps	alpe	Nan
andorra	andora	None
alaska	alaska	Nan
al	al	None
adsl	adsl	Nan
adrian	adrian	Nan
adobe	adobe	None
adn	adn	Nan
addisonwesley	addisonwesley	Nan
adams	adams	Nan
ada	ada	Nan
acid	kiselina	None
acia	acia	Nan
achilles	ahila	Nan
aceh	aceh	Nan
account	račun	None
abscbn	abscbn	Nan
abrams	abrams	Nan
abraham	abraham	None
about	otprilike	None
abkhazia	abhazija	Nan
abdul	abdul	None
abc	abc	None
advanced	napredni	Nan
alabama	alabama	Nan
aedes	aedes	Nan
aero	aero	Nan
akô	zdravo	Nan
akms	akms	Nan
akatsuki	akatsuki	Nan
ak	ak	None
ajax	ajax	Nan
aisne	aisne	Nan
airbus	airbus	Nan
air	zrak	None
aim	cilj	None
ailen	irski	Nan
ai	szo	Nan
agassi	agassi	Nan
agasa	agasa	Nan
ag	ag	Nan
african	afrički	Nan
africa	afrika	None
afghanistan	afganistan	None
aff	af	Nan
afc	afc	Nan
aegypti	aegypti	Nan
andrew	andrew	Nan
andré	andré	Nan
andy	andy	Nan
austria	austria	Nan
australia	australia	Nan
auguste	auguste	Nan
auflage	auflage	Nan
audition	audicija	Nan
aubrac	aubrac	Nan
aua	aua	Nan
atlantic	atlantski	None
atlanta	atlanta	Nan
atkinson	atkinson	Nan
aston	zapanjenost	Nan
assyria	asirija	Nan
association	udruženje	None
asoka	asoka	Nan
asm	asm	Nan
asia	azija	None
ashley	ashley	Nan
ashikaga	ashikaga	Nan
ash	pepeo	Nan
austrian	austrijski	None
asc	asc	Nan
avar	avar	Nan
awad	awad	Nan
balkan	balkan	None
bali	bali	Nan
balearic	balearski	Nan
baháí	baháí	Nan
bahrain	bahrein	Nan
bahamas	bahami	Nan
bago	bago	Nan
baghdad	bagdad	Nan
baden	baden	Nan
bacon	slanina	Nan
babylon	babylon	Nan
ba	otac	None
aztec	aztec	Nan
azerbaijan	azerbejdžan	None
ayutthaya	ayutthaya	Nan
ayumi	ayumi	Nan
ayeyarwady	ayeyarwady	Nan
axit	kiselina	None
award	nagrada	None
aviation	vazduhoplovstva	Nan
arunachal	arunachal	Nan
aruba	aruba	Nan
artemis	artemis	Nan
any	bilo koji	Nan
antonov	antonov	Nan
anton	anton	None
antigua	antigua	Nan
anthony	anthony	Nan
anorthosit	anorthosit	Nan
anne	anne	None
annan	annan	Nan
annam	an nam	Nan
anna	anna	Nan
ankyl	ankil	Nan
ankara	ankara	Nan
anhpháp	engleski francuski	Nan
anhmỹ	britanski	None
anh	brate	Nan
anglosaxon	anglosakson	Nan
angkor	angkor	Nan
ang	ang	Nan
anfield	anfield	Nan
anđêhít	aldehid	Nan
ao	ribnjak	Nan
aotearoa	aotearoa	Nan
apollo	apolon	Nan
arsenal	arsenal	Nan
arnold	arnold	Nan
armstrong	armstrong	Nan
armenia	armenski	Nan
arlington	arlington	Nan
arkansas	arkanzas	Nan
ark	ark	Nan
arizona	arizona	Nan
aristotle	aristotel	None
bàu	bau	Nan
aringarosa	aringarosa	Nan
argo	argo	Nan
argentina	argentina	None
ares	ares	Nan
arctan	arctan	Nan
archive	arhiva	None
archetypal	arhetipski	Nan
arab	arapski	None
aquinas	akvinski	Nan
apple	jabuka	None
arias	arije	Nan
bày	prezentacija	None
bác	stric	Nan
bách	čempres	Nan
chrysler	chrysler	Nan
chrome	hrom	Nan
christopher	christopher	Nan
christian	christian	None
christ	božić	None
chris	chris	Nan
choáng	omamljen	Nan
choàng	ogrtač	Nan
chosŏn	chosŏn	Nan
chopin	chopin	Nan
chong	chong	Nan
chomsky	chomsky	Nan
choi	igra	None
chnd	chnd	Nan
chloride	hlorid	None
chlamydia	klamidija	Nan
chiều	pm	Nan
chiền	gomila	Nan
chiếu	prostirka	Nan
chu	chu	Nan
chiết	ekstrakt	Nan
chua	kiselo	Nan
chui	obrišite	Nan
chuộng	favorizirao	Nan
chuộc	otkupiti	Nan
chuỗi	lanac	None
chuồng	kavez	Nan
chuốt	razvlačenje	Nan
chuối	banana	Nan
chuốc	poke	Nan
chuẩn	standardna	None
chuông	zvono	Nan
chuôi	zahvatiti	Nan
chuyện	priča	None
chuyển	krenuli dalje	Nan
chuyền	proći	None
chuyến	putovanje	None
chuyên	specijalizovani	Nan
churchill	churchill	Nan
chung	opšte	None
chun	chun	Nan
chum	chum	Nan
chuck	steznik	Nan
chuột	miš	None
chiến	borba	None
chiếc	kom	None
chao	ćao	Nan
chanh	limun	Nan
chanel	chanel	Nan
chamẹ	roditelji	None
champion	prvak	Nan
champa	šampanjac	Nan
chamberlain	komornik	Nan
chaillot	šalot	Nan
chai	boca	Nan
cha	tata	Nan
ceres	ceres	Nan
centauri	centauri	Nan
cena	cena	Nan
celtic	keltski	Nan
cell	ćelija	None
cdrom	cd rom	Nan
cdot	cdot	Nan
cd	cd	None
cctv	cctv	Nan
charles	charles	None
chiếm	računovodstvo	None
charlotte	šarlota	Nan
charon	haron	Nan
chiêng	gong	Nan
chiên	pržena	Nan
chiêm	astrološki	Nan
chirac	chirac	Nan
ching	ching	Nan
china	kina	None
chim	ptica	None
chile	čile	None
chicago	chicago	None
chiang	chiang	Nan
chia	podeliti	Nan
chi	chi	Nan
cheo	cheo	Nan
chen	chen	Nan
chechnya	chechnya	Nan
che	poklopac	Nan
chdcnd	chdcnd	Nan
chay	vegetarijanski	Nan
chase	juriti	Nan
charlton	charlton	Nan
chà	trljati	Nan
chài	ribolov	None
chàm	indigo	Nan
chấm	tačka	None
chảy	trčati	Nan
chảo	tava	Nan
chả	rolne	Nan
chạy	trčati	Nan
chạp	drhtav	Nan
chạng	sumrak	None
chạm	dodir	None
chạ	dakle	None
chướng	kurs prepreka	Nan
chương	poglavlje	Nan
chưng	dist	Nan
chưa	ne još	Nan
chư	chu	Nan
chơn	stopala	Nan
chơi	igra	None
chĩa	viljuške	Nan
chăng	pristupačna	Nan
chămpa	champa	Nan
chấp	izazov	Nan
chăm	teško	None
chất	stvar	None
chần	blanširanje	Nan
chỉnh	korekcija	Nan
chỉ	samo	None
chệch	pogrešno	None
chết	umro	None
chếch	labav	Nan
chế	preparati	Nan
chẽ	zbijeno	Nan
chẻ	podijeliti	None
chặt	nasjeckati	Nan
chặng	noga	Nan
chặn	skicirati	Nan
chẵn	čak	None
chằng	obrva	Nan
chắc	sigurno	None
chậu	lonac	Nan
chật	zbijeno	Nan
chận	blok	None
chậm	sporo	None
chẩn	dijagnosticirati	Nan
chấu	pinča	Nan
chút	malo	None
chúng	njih	None
chúi	tuu	Nan
chì	olovo	None
chênh	razlika	None
chê	prokletstvo	Nan
chép	kopiraj	Nan
chéo	križ	Nan
chén	kup	None
chém	rez	Nan
chèn	umetnite	Nan
chè	čaj	Nan
châu	evropi	None
chân	stopalo	Nan
châm	uboditi	Nan
cháy	vatra	None
cháu	unuci	Nan
cháo	kaša	Nan
chánh	šefe	Nan
chày	bejzbol	Nan
chào	zdravo	Nan
chàng	momak	Nan
chìa	ključ	None
chìm	potonuo	Nan
chình	jegulja	Nan
chí	uši	Nan
chúc	da žele	Nan
chúa	bože	None
chú	stric	Nan
chùy	mace	Nan
chùa	hram	None
chông	muž	None
chôn	zakopati	Nan
chôm	rambutan	Nan
chóp	vrh	None
ccn	ccn	Nan
chóng	brzo	None
chóc	haha	Nan
chó	pas	Nan
chòm	sazvežđe	Nan
chòi	kabina	Nan
chò	gušiti	Nan
chít	govno	Nan
chính	glavni	None
chín	devet	Nan
chích	ubod	Nan
chói	sjaj	Nan
chịu	medvjed	Nan
ccc	ccc	Nan
cbgd	cbgd	Nan
bẩm	kongenitalni	Nan
bầy	stado	Nan
bầu	glasanje	Nan
bần	siromašan	Nan
bấy	to	None
bất	stvaran	Nan
bấm	pritisnite	Nan
bảy	sedam	None
bảo	bao	Nan
bảng	ploča	None
bại	izgubiti	None
bạch	bijelo	None
bạc	srebro	None
bạ	kontakti	Nan
bướm	leptir	Nan
bước	korak	None
bưu	poštarina	Nan
bơm	pumpa	None
bơi	plivati	Nan
bẩn	prljav	Nan
bơ	puter	Nan
bẩy	zamka	Nan
bậc	stepen	None
bệnh	bolestan	Nan
bện	pletenica	Nan
bệ	pijedestal	Nan
bể	mehovi	Nan
bền	izdržljiv	Nan
bề	površina	None
bếp	kuhinja	Nan
bến	wharf	Nan
bẽ	poniženja	Nan
bẻ	odmor	None
bẹp	zgnječiti	Nan
bằng	jednak	None
bắt	uhvatiti	Nan
bắp	kukuruz	None
bắn	pucati	Nan
bắcnam	sjever jug	Nan
bắc	sjever	None
bật	upaljen	Nan
bận	zauzeto	Nan
bẫy	zamka	Nan
bỉ	belgija	None
băng	led	None
băm	hashed	Nan
bìa	poklopac	Nan
bì	pakovanje	Nan
bênh	bolestan	Nan
bên	strana	None
béo	debeo	Nan
bén	oštar	Nan
bé	malo	None
bèn	onda	None
bão	oluja	None
bãi	dvorišta	Nan
bã	ostatak	None
bây	sad	None
báu	blago	None
bát	posuda	Nan
báo	novine	None
báng	prasak	Nan
bán	prodati	None
bám	prilijepiti	Nan
bái	kult	None
bìu	skrotum	Nan
băn	bijes	Nan
bí	tikvice	Nan
bíró	tikva	Nan
bút	olovka	Nan
búng	lepršao	Nan
bún	rezanci od riže	Nan
búi	tufti	Nan
búa	čekić	Nan
bú	sisati	Nan
bùng	flare	Nan
bùn	blato	Nan
bùa	amulet	Nan
bù	šminka	Nan
bông	pamuk	None
bôi	razmazani	Nan
bô	otac	None
bóp	stisnuti	Nan
bóng	lopta	None
bón	oploditi	Nan
bói	sreća	Nan
bó	gomila	Nan
bò	krava	None
bính	binh	Nan
bỉnh	nestašan	Nan
bịch	thump	Nan
bịt	pokriveno	Nan
cardcaptor	cardcaptor	Nan
carbine	karabina	Nan
carat	karat	Nan
capra	capra	Nan
capello	capello	Nan
canxi	kalcijuma	None
canterbury	canterbury	Nan
cancer	rak	None
canary	kanarinac	Nan
canal	kanal	None
canadian	kanadski	Nan
canada	kanada	None
campuchia	kambodža	Nan
campbell	campbell	Nan
camille	camille	Nan
cameroon	cameroon	Nan
cameron	cameron	Nan
cameo	cameo	Nan
cambridge	cambridge	Nan
cardcaptors	cardcaptors	Nan
cambodia	kambodža	Nan
carey	brižni	Nan
caribê	karibi	Nan
cbc	cbc	Nan
cau	kaku	Nan
catherine	katarina	None
cathay	mačkasti	Nan
castro	castro	Nan
castries	kastrije	Nan
cast	cast	Nan
cassini	cassini	Nan
caspia	caspia	Nan
casablanca	casablanca	Nan
casa	ca sa	Nan
carxtơ	karat	Nan
carter	carter	Nan
carpathia	karpatija	Nan
caroline	caroline	Nan
carol	carol	Nan
carnaval	karneval	Nan
carlos	carlos	Nan
carl	carl	None
caribe	caribe	Nan
cam	narandže	Nan
calvin	calvin	Nan
calculus	računica	Nan
bột	brašno	Nan
bội	višestruko	Nan
bộc	boc	Nan
bộ	set	None
bỗng	odjednom	Nan
bổng	stipendiju	Nan
bổn	dužnost	None
bồi	naknada	Nan
bốn	četiri	None
bối	zbunjen	Nan
bốc	učitavanje	Nan
bố	oče	Nan
bỏng	spali	Nan
bỏ	opozvati	Nan
bọt	pjena	Nan
bọng	natečenost	Nan
bọn	njih	None
bọc	zamotati	Nan
bọ	bug	Nan
bớ	zaokružiti	Nan
bớt	manje	None
bờ	ivica	None
bời	kvrga	Nan
cal	cal	Nan
cairo	kairo	Nan
cai	cai	Nan
café	kafa	Nan
caffein	kofein	Nan
caesar	cezar	None
cacbua	karbid	Nan
cacbonat	karbonat	None
cacbon	ugljenik	Nan
cbs	cbs	Nan
cabo	cabo	Nan
ca	smjena	Nan
bực	frustriran	Nan
bữa	obrok	Nan
bừa	drljanje	Nan
bứt	nesvesno	Nan
bụng	želudac	None
bục	podijum	Nan
bởi	od	None
bở	od	None
ca-lo	ca-lo	Nan
mĩ	amerika	None
giò	opružne rolice	Nan
giòn	hrskava	Nan
loạicựu	tip	None
loạicông	tip	None
loạicâu	tip	None
loạicác	tip	None
loạichiến	tip	None
loạibệnh	vrsta bolesti	Nan
loạianime	upišite anime	Nan
loạianh	tip	None
loại	vrsta	None
loét	čir	Nan
loãng	isprano	Nan
loát	blistav	Nan
loài	vrsta	None
love	ljubav	None
louvre	louvre	Nan
louisiana	louisiana	Nan
louis	louis	None
los	los	None
lorenzo	lorenzo	Nan
loạigia	tip	None
long	dugo	None
loạihuân	kindhuan	Nan
loạimáy	vrsta mašine	Nan
lucas	lucas	Nan
luang	luang	Nan
lu	lu	Nan
lp	lp	None
loạt	serija	None
loạn	poremećaj	None
loạixã	tip	None
loạivõ	tip tip	Nan
loạitổ	tip	None
loạitín	ljubazan	Nan
loạitrường	vrsta škole	Nan
loạithần	tip	None
loạithành	tip	None
loạithuật	vrsta zakona	Nan
loạiscandal	fleaiscandal	Nan
loạiphong	tip	None
loạiphim	vrsta filma	Nan
loạingày	otkucajte ovo	Nan
loạimôn	tip	None
loạiluật	vrsta zakona	Nan
lucia	lucia	Nan
london	london	None
logan	logan	Nan
lionel	lionel	Nan
linux	linux	None
links	linkovi	None
linh	linh	Nan
linga	linga	Nan
lilly	ljiljan	None
lightning	munje	Nan
liga	liga	None
liechtenstein	liechtenstein	Nan
lido	lido	Nan
libya	libija	Nan
libero	libero	Nan
libby	libby	Nan
lhq	lhq	Nan
lhp	lhp	Nan
lg	lg	Nan
lesotho	lesotho	Nan
leslie	leslie	Nan
les	les	Nan
lisboa	lisboa	Nan
lon	može	None
lisbon	lisbon	Nan
liu	liu	Nan
log	zapisnik	Nan
lockheed	zaključan	Nan
locke	locke	Nan
loch	loch	Nan
loang	gladak	Nan
loaita	loaita	Nan
loa	govore	None
lo	brini	Nan
lleyton	lleyton	Nan
liệu	da li	Nan
liệt	paraliza	Nan
liệng	baciti	Nan
liễu	vrba	Nan
liều	doza	None
liềm	srp	Nan
liêu	birokratija	Nan
liêng	sveto	None
liên	poduhvat	Nan
liêm	integritet	Nan
litva	litvanija	None
leonid	leonid	Nan
luciano	luciano	Nan
ludovico	ludovico	Nan
lôn	lol	Nan
lôi	greška	None
lô	puno	None
lót	podstava	Nan
lóng	sleng	Nan
lóe	blistao	Nan
lóc	snakehead	Nan
lòng	zgnječiti	Nan
lò	pećnica	Nan
líu	coo	Nan
lít	litra	Nan
lính	vojnik	None
lí	skladištenje	Nan
lình	odjednom	Nan
lìa	otići	Nan
lênin	lenjin	Nan
lênh	naredba	None
lên	gore	None
lêmạc	svjetlost	None
lông	kosa	None
lê	kruška	Nan
lõi	jezgra	None
lùi	unazad	Nan
lưng	nazad	None
lư	kadionica	Nan
lơi	otpustiti	Nan
lơ	zanemarivanje	Nan
lũy	kumulativno	Nan
lũng	dolina	None
lũ	poplava	None
lĩnh	domene	Nan
lăng	mauzolej	Nan
lăn	kotrljanje	Nan
lăm	pet	None
lút	podmukao	Nan
lúp	povećalo	Nan
lúng	flare	Nan
lún	propadanje	Nan
lúc	u	None
lúa	neolušan	Nan
lùng	loviti	Nan
lùn	kratko	None
lõm	konkavno	Nan
ludendorff	ludendorff	Nan
lén	skliznuti	Nan
lão	stari	None
ly	stakla	Nan
luỹ	kumulativno	Nan
luộc	kuhana	Nan
luồng	potok	None
luồn	navojnim	Nan
luật	zakon	None
luận	komentiraj	Nan
luyện	trening	Nan
luyến	prilog	None
luy	luy	Nan
luxembourg	luksemburg	None
luther	luther	Nan
lustig	lustig	Nan
lung	pluća	None
lula	lula	Nan
luiz	luiz	Nan
luis	luis	Nan
lui	nazad	None
ludwig	ludwig	Nan
lydia	lidija	Nan
lèo	lèo	Nan
lympho	limfom	Nan
lyon	lyon	Nan
lãnh	primljeni	Nan
lãm	pokazuje	None
lãi	kamate	Nan
lây	zarazni	Nan
lâu	dugo	None
lân	jednorog	Nan
lâm	lam	Nan
láng	sjajan	Nan
lán	drvo	None
lái	pogon	Nan
lách	slezina	Nan
lác	škljocanje	Nan
lá	lišće	Nan
lào	laos	Nan
lành	ozdravio	Nan
làng	selo	None
làn	traka	Nan
làm	učiniti	None
là	bio	None
lyndon	lyndon	Nan
leonardo	leonardo	None
leonard	leonard	Nan
leon	leon	Nan
komodo	komodo	Nan
kogoro	kogoro	Nan
kofun	kofun	Nan
kodansha	kodansha	Nan
koch	koch	Nan
knuth	knuth	Nan
knesset	knesset	Nan
km	kilometar	Nan
klein	klein	Nan
klaus	klaus	Nan
kiệu	palanquin	Nan
kiệt	remek-djelo	Nan
kiện	tužiti	Nan
kiệm	ekonomičan	Nan
kiểu	tip	None
kiểm	ček	Nan
kiềm	alkalni	Nan
kiết	kiết	Nan
kiếp	životni vek	Nan
kon	kon	Nan
kiêu	arogantan	Nan
kong	kong	Nan
konversationslexikon	konversationslexikon	Nan
kunst	kunst	Nan
kungfu	kung fu	Nan
kung	kung	Nan
kune	kune	Nan
kulak	kulak	Nan
kuiper	kuiper	Nan
kuen	kuen	Nan
kubrick	kubrick	Nan
kuala	kuala	Nan
ku	ku	Nan
krông	krong	Nan
kristen	kristen	Nan
kremlin	kremlin	Nan
kremli	kremli	Nan
kosovo	kosovo	None
koruna	koruna	Nan
kornai	kornai	Nan
koran	koran	Nan
kop	kop	Nan
konstantin	konstantin	None
kurd	kurd	Nan
kiêng	uzdržati se	Nan
kiêm	sperma	Nan
khổng	džinovski	Nan
khổ	patnja	Nan
khống	khong	Nan
khốn	kopile	Nan
khối	nivo stepena	Nan
khốc	strašno	Nan
khố	lančić	Nan
khỏi	iz	None
khỏe	jak	None
khỏa	gola	Nan
khỉ	majmun	Nan
khế	zvjezdasto voće	Nan
khẳng	potvrdan	Nan
khắp	svuda	Nan
khắc	zarez	Nan
khẩn	hitno	Nan
khấu	popust	Nan
khấn	moli se	Nan
khấm	probijen	Nan
khởi	inicira	Nan
kiên	pacijent	Nan
khủng	strašno	Nan
khứu	pastel	Nan
kitô	hrišćanin	Nan
kitts	mačići	Nan
kissinger	kissinger	Nan
kiss	poljubac	Nan
kishimoto	kishimoto	Nan
kiribati	kiribati	Nan
kinsey	kinsey	Nan
kingdom	kraljevstvo	None
kim	kim	Nan
kilômét	kilometara	None
kikyo	kikyo	Nan
kii	kii	Nan
kiernan	kiernan	Nan
kierkegaard	kierkegaard	Nan
kiel	kila	Nan
kid	dijete	None
kia	da	None
ki	ki	Nan
khử	eliminisati	Nan
khủyu	kopile	Nan
kurt	kurt	Nan
kuwait	kuvajt	None
kwan	kwan	Nan
larry	larry	Nan
lap	krug	None
laos	laos	Nan
lao	tb	Nan
lanka	lanka	Nan
lanh	posteljina	Nan
langue	langue	Nan
lange	lange	Nan
langdon	langdon	Nan
lang	lang	Nan
landon	landon	Nan
land	zemljište	None
lan	lan	None
lama	lama	Nan
lam	lam	Nan
lai	hibridni	Nan
ladakh	ladakh	Nan
laboulaye	laboulaye	Nan
label	etiketa	Nan
lars	lars	Nan
l	l	None
las	las	Nan
lateran	lateran	Nan
leo	penjati se	Nan
lenins	lenins	Nan
lenin	lenin	Nan
lem	lem	Nan
leiden	leiden	Nan
legacy	nasljeđe	None
lee	lee	Nan
lebanon	libanon	Nan
leave	otići	Nan
leaf	list	None
leach	pijavica	Nan
lazarus	lazarus	Nan
lay	ležati	Nan
lawrence	lawrence	Nan
laurence	lorancija	Nan
laura	laura	Nan
lau	obrišite	Nan
latvia	latvia	Nan
latinh	latinski	None
laser	laser	Nan
kỷ	veka	Nan
kỵ	konjica	None
kịp	zadržati	None
kí	znak	None
kình	naočala	Nan
kìm	kliješta	Nan
kìa	evo	None
kêu	sondiranje	Nan
kênh	kanali	None
kê	proso	Nan
két	sefovi	Nan
kép	dual	Nan
kéo	povuci	Nan
kén	kokon	Nan
kém	najmanje	None
kèn	truba	Nan
kèm	u prilogu	Nan
kyūshū	kyūshū	Nan
kyushu	kyushu	Nan
kyrgyzstan	kyrinkistan	Nan
kwon	kwon	Nan
kwen	kwen	Nan
kích	klikni	Nan
kíchbom	klikni gumb	Nan
kín	privatni	None
kính	naočala	Nan
kị	konjica	None
kỉ	veka	Nan
kệ	police	Nan
kềnh	glomazan	Nan
kề	susedni	Nan
kết	kraj	None
kế	sljedeći	None
kẽm	cink	None
kẽ	međuprostor	Nan
lươn	jegulja	Nan
kẻo	da ne	Nan
kẹt	zaglavili	Nan
kẹp	isječak	Nan
kẹo	slatkiš	Nan
kạn	kan	Nan
kơnia	kàia	Nan
kĩ	pažljivo	Nan
ký	znak	None
kít	vriskano	Nan
kíp	posada	Nan
kẻ	momci	Nan
lương	plata	Nan
lưới	rešetka	Nan
lướt	surfanje	Nan
moi	novo	None
mohammed	mohammed	Nan
mohammad	mohammad	Nan
modula	modula	Nan
modul	modul	Nan
mode	režimu	Nan
mobile	mobilni	Nan
mm	mm	None
miệng	usta	None
miện	kruna	None
miễn	izuzeti	Nan
miền	domen	Nan
miếu	hram	None
miếng	komada	Nan
miến	rezanci od riže	Nan
miêu	mačka	Nan
miên	hipnoza	Nan
mitsubishi	mitsubishi	Nan
mitchel	mitchel	Nan
molecular	molekularni	Nan
missouri	missouri	Nan
molotov	molotov	Nan
mongolia	mongolija	Nan
morocco	maroko	None
morley	morley	Nan
moriarty	moriarty	Nan
mori	mori	Nan
morgan	morgan	Nan
moravia	moravia	Nan
mora	mora	None
moong	moong	Nan
moo	moo	None
montreal	montreal	Nan
montparnasse	montparnasse	Nan
montmartre	montmartre	Nan
montenegro	crna gora	Nan
montana	montana	Nan
montaigne	montaigne	Nan
mont	mont	Nan
monroe	monroe	Nan
mono	mono	Nan
monique	monique	Nan
molypden	molibden	None
morris	morris	Nan
mississippi	mississippi	Nan
miroku	miroku	Nan
michigan	michigan	Nan
michelangelo	michelangelo	Nan
michaels	michaels	Nan
michael	michael	None
miami	miami	Nan
meyers	meyers	Nan
meyer	meyer	Nan
mext	mext	Nan
meteora	meteora	Nan
messiah	mesija	Nan
messi	messi	Nan
messerschmitt	messerschmitt	Nan
messenger	messenger	Nan
mercedes	mercedes	Nan
menes	menes	Nan
mendeleev	mendeleev	Nan
melbourne	melbourne	Nan
mekong	mekong	Nan
medvedev	medvedev	Nan
micro	mikro	Nan
misfits	misfits	Nan
microbiology	mikrobiologija	Nan
micronesia	mikronezija	Nan
mirage	mirage	Nan
miraflores	miraflores	Nan
minoa	minoa	Nan
minnesota	minnesota	Nan
ming	ming	Nan
mindanao	mindanao	Nan
minas	minas	Nan
min	min	Nan
milton	milton	Nan
miller	mlinar	Nan
mill	mlin	Nan
miley	miley	Nan
milano	milano	Nan
milan	milan	None
mikoyangurevich	mikoyangurevich	Nan
mikoyan	mikoyan	Nan
mike	mike	Nan
miguel	miguel	None
microsoft	microsoft	None
microeconomics	mikroekonomija	Nan
morrison	morrison	Nan
morse	morse	Nan
moscow	moskva	None
mép	ivica	None
méo	iskrivljena	Nan
mé	mé	Nan
mèo	mačka	Nan
mè	susam	Nan
mão	krunice	Nan
mãnh	jak	None
mãn	samozadovoljavajući	Nan
mãimại	kod	None
mãi	zauvek	Nan
mã	kod	None
mây	oblak	None
mâu	kontradiktorno	Nan
mân	krunica	Nan
mâm	pladanj	Nan
máy	mašina	None
máu	krv	None
mát	cool	Nan
mái	krov	Nan
mét	metar	None
máclênin	marxelenin	Nan
mênh	zapanjujuće	Nan
mì	rezanci	Nan
münchen	münchen	None
mút	sisanje	Nan
múa	ples	Nan
mùi	miris	None
mùa	sezona	None
mù	slep	Nan
môtô	motocikl	Nan
môt	jedan	None
mônôxít	monoksid	Nan
mông	stražnjica	Nan
môn	subjekti	Nan
môi	svaki	None
mô	tkiva	None
món	hrana	None
móc	kuka	Nan
mòn	staza	Nan
mò	namrštio se	Nan
mía	trske	Nan
mình	sebe	None
mêtan	metan	Nan
mách	savjeta	None
mác	etiketa	Nan
má	majke	None
murdoch	murdoch	Nan
munich	munich	Nan
mun	ebanovina	Nan
mumbai	mumbai	Nan
muhammad	muhammed	None
much	mnogo	None
mua	kupiti	Nan
mu	mu	None
mtv	mtv	Nan
msdos	msdos	Nan
ms	gospođa	Nan
mp	mp	Nan
mozart	mozart	None
mozambique	mozambique	Nan
movie	film	None
mourinho	mourinho	Nan
motown	motown	Nan
moskva	moskva	None
mosin	mosin	Nan
muromachi	muromachi	Nan
murphy	murphy	Nan
murray	murray	Nan
mustang	mustang	Nan
mày	ti	None
màu	boja	None
mào	greben	Nan
mành	roletne	Nan
màn	ekran	Nan
mài	brušenje	Nan
mà	ali	None
myspace	moj prostor	Nan
myanmar	mjanmar	Nan
medina	medina	None
myanma	mjanmar	Nan
muội	sestra	None
muỗng	kašika	Nan
muỗi	komarac	Nan
muồi	kasno	None
muống	kašika	Nan
muốn	željeti	Nan
muối	soli	None
muôn	željeti	Nan
muta	muta	Nan
muộn	kasno	None
khảo	ispitivanje	None
medici	medici	Nan
mcv	mcv	Nan
lộc	bogatstvo	None
lỗ	rupa	None
lồng	kavez	Nan
lồi	konveksna	Nan
lồ	džinovski	Nan
lốt	obličje	Nan
lốp	guma	Nan
lối	ulaz	None
lốc	vrtlog	Nan
lố	preko	None
lỏng	labav	Nan
lỏi	obloga	Nan
lọt	pad	None
lọng	suncobran	Nan
lọi	škljocanje	Nan
lọc	filter	Nan
lịch	kalendara	None
lị	dizenterija	Nan
lệnh	comeinand	Nan
lội	plivati	Nan
lệch	kosina	Nan
lộn	okrenuta	Nan
lột	skinuti se	Nan
lự	neodlučan	Nan
lửng	jazavac	Nan
lừng	slavna	Nan
lừa	trik	Nan
lứa	leglo	Nan
lụy	implikacije	Nan
lụt	nadvladati	Nan
lụi	izgorela	Nan
lục	zeleno	None
lụa	svila	Nan
lợp	krovište	Nan
lợn	svinja	None
lợi	profit	Nan
lỡ	nedostajati	Nan
lở	nedostajati	Nan
lời	reč	Nan
lờ	ignoriraj	Nan
lớp	klasa	None
lớn	veliki	None
lộng	prekrasna	Nan
lựa	odabrano	Nan
lệ	stopa	None
lều	šator	Nan
lấy	birati	Nan
lấp	ispuniti	Nan
lấn	posezanje	Nan
lạy	prostran	Nan
lạtma	lamma	Nan
lạp	kobasica	Nan
lạng	lang	Nan
lạn	trulo	Nan
lại	opet	None
lạch	potok	None
lạc	izgubljen	Nan
lạ	čudno	Nan
lǐ	lǐ	Nan
lượn	klizanje	Nan
lượm	okupiti	Nan
lược	češalj	Nan
lưỡng	biseksualan	Nan
lưỡi	jezik	None
lười	lijen	Nan
lầm	pogrešno	None
lễ	ceremonija	None
lần	puta	None
lầy	močvarna	Nan
lề	marža	Nan
lẻo	labav	Nan
lẻn	prikrasti se	Nan
lẻ	čudno	Nan
lẹ	brzo	None
lặt	razno	Nan
lặp	ponovite	Nan
lặng	tiho	Nan
lắp	dolikuje	Nan
lắng	podmiriti se	Nan
lắm	vrlo	None
lắc	protresti	Nan
lậy	o da	Nan
lật	okreni	Nan
lận	varati	Nan
lẫy	pinča	Nan
lẫn	zbunjen	Nan
lẩy	skok	Nan
lẩu	hot pot	Nan
lầu	kat	Nan
lựu	šipak	Nan
ma	duh	None
maastricht	maastricht	Nan
mary	mary	None
marx	marx	None
martin	martin	None
marta	marta	None
marsu	marsu	None
marshall	maršal	Nan
marseille	marseille	Nan
mars	mars	None
marne	marne	Nan
marmara	marmerada	Nan
marić	marić	Nan
marino	marino	None
marina	marina	Nan
marie	marie	None
marianne	marianne	Nan
maria	maria	None
margaret	margaret	Nan
marcus	marcus	Nan
marcos	marcos	Nan
maryland	maryland	Nan
marcel	marcel	Nan
maría	maría	Nan
massachusetts	massachusetts	Nan
mcnamara	mcnamara	Nan
mcmahon	mcmahon	Nan
mclaren	mclaren	Nan
mchc	mchc	Nan
mcdonald	mcdonald	Nan
mccullough	mccullough	Nan
mccartney	mccartney	Nan
mccain	mccain	Nan
mcafee	mcafee	Nan
maya	maya	None
may	šiti	Nan
maxim	maksima	Nan
mausolus	mausolus	Nan
maurice	maurice	Nan
mau	brzo	None
matthias	matthias	Nan
mats	prostirke	Nan
mathematica	matematika	None
mat	prostirka	Nan
mas	mas	Nan
marc	marc	Nan
marat	maraton	Nan
maradona	maradona	Nan
mainframe	mainframe	Nan
mai	krov	Nan
mahal	mahal	Nan
magiê	magnezijum	None
mafia	mafija	None
madrid	madrid	Nan
madonna	madona	Nan
madison	madison	Nan
madhouse	ludnica	Nan
madeira	madeira	Nan
macromedia	makromedija	Nan
macma	magma	Nan
macintosh	macintosh	Nan
machu	machu	Nan
machiavelli	machiavelli	Nan
mach	mach	Nan
macedonia	makedonija	None
macclesfield	macclesfield	Nan
macarthur	makarthur	Nan
major	glavni	None
makemake	makemake	Nan
malacca	malacca	Nan
malay	malay	Nan
maps	karte	None
mao	mao	None
manuel	manuel	Nan
manti	manti	Nan
mankiw	mankiw	Nan
manila	manila	Nan
manh	manh	Nan
mangnall	mangnall	Nan
manga	manga	Nan
media	mediji	None
mang	nosi	None
mandela	mandela	Nan
manchester	manchester	Nan
manche	manche	Nan
maluku	maluku	Nan
malta	malta	Nan
mali	mali	None
maldini	maldini	Nan
malcolm	malcolm	Nan
malaysia	malezija	Nan
mandy	mandy	Nan
giòi	crvi	Nan
khảm	mozaik	None
khả	mogućnost	None
hiếm	retko	Nan
hiđrô	vodonik	None
hiên	trijem	Nan
hitters	hitters	Nan
hitter	hitter	Nan
hitler	hitler	None
hitchcock	autostoka	Nan
hiroshima	hiroshima	Nan
hiroshi	hiroshi	Nan
hiragana	hiragana	Nan
hinhtron	hinhtron	Nan
hinh	hinh	Nan
hindu	hinduistički	Nan
hindi	hindi	Nan
hindenburg	hindenburg	Nan
hinata	hinata	Nan
himalaya	himalaja	Nan
hilton	hilton	Nan
hillsborough	brežuljak	Nan
hiến	daj	Nan
hidro	vodonik	None
hiếp	silovanje	Nan
hiềm	bolestan	Nan
holocen	holocen	Nan
holocaust	holokaust	Nan
holmes	holmes	Nan
hokusai	hokusai	Nan
hokage	hokage	Nan
hoi	hoi	Nan
hogwarts	hogwarts	Nan
hoan	festival	None
hoa	cvijet	None
hn	hn	Nan
hmông	hmong	Nan
hms	hms	Nan
hlv	trener	None
hiệu	efekat	None
hiệp	polovina	None
hiện	pojaviti se	Nan
hiểu	razumiju	Nan
hiểm	opasno	Nan
hiền	kadulja	Nan
hiếu	filijalna pobožnost	Nan
holt	holt	Nan
hideyoshi	hidjoši	Nan
hicks	brkovi	Nan
heath	heath	Nan
health	zdravlja	None
he	on	None
hd	hd	Nan
hcl	hcl	Nan
hbv	hbv	Nan
hb	hb	Nan
hay	dobro	None
hawking	sokolov	Nan
hawker	hawker	Nan
havilland	havilland	Nan
havana	havana	Nan
harvey	harvey	Nan
harvard	harvard	Nan
harry	harry	Nan
harris	harris	Nan
harrier	harrier	Nan
harpercollins	harpercollins	Nan
harper	harper	Nan
hee	hee	Nan
hideto	hideto	Nan
hegel	hegel	Nan
heinrich	heinrich	None
hickam	hickam	Nan
hi	zdravo	Nan
hestia	hestija	Nan
hesiod	neodlučan	Nan
hersh	njen	None
hermes	hermes	Nan
hermann	hermann	Nan
hercules	hercules	Nan
hercegovina	hercegovina	None
herbert	herbert	Nan
her	ona	None
heo	ustajan	Nan
henry	henry	None
hen	kokoš	Nan
hemoglobin	hemoglobin	Nan
hematocrit	hematokrit	Nan
heli	helijum	Nan
helena	helena	Nan
helen	helen	Nan
heian	heian	Nan
harold	harold	Nan
hom	reznice	Nan
hon	dušo	Nan
hán	suša	None
hái	odabrati	Nan
hách	preterani	Nan
hào	jarak	Nan
hàng	red	None
hàm	vilica	Nan
hài	komedija	None
hà	ha	Nan
hyperion	hiperion	Nan
hydro	vodonik	None
hydra	hydra	Nan
huỷ	otkazati	Nan
huỳnh	sumpor	None
huống	slučaj	None
huệ	hue	Nan
huế	hue	Nan
huấn	trening	Nan
huê	hue	Nan
huân	huan	Nan
háo	željan	Nan
huyệt	akupunkturne bodove	Nan
hát	pevaj	Nan
hân	han	None
hót	pevaj	Nan
hóc	hóc	Nan
hòng	dobro	None
hòn	ostrvo	None
hòm	ark	Nan
hòe	sranje	Nan
hòa	kravata	Nan
hò	izlazite	Nan
hít	disati	Nan
hí	ne	None
hên	sretan	Nan
hét	vikati	Nan
héo	osušiti	Nan
hé	ispucao	Nan
hè	leto	Nan
hãnh	ponosan	Nan
hãng	firma	None
hãn	khan	Nan
hãi	uplašen	Nan
hâm	luda	Nan
homer	homer	Nan
huyện	okrug	None
huyền	mistično	Nan
hoạ	boje	None
hoãn	jedu	None
hoán	perm	Nan
hoá	hemija	None
hoành	dijafragma	Nan
hoàng	kralju	None
hoàn	kompletni	Nan
hoài	nostalgičan	Nan
hoà	kravata	Nan
however	kako god	Nan
howard	howard	Nan
houston	houston	Nan
hotspur	hotspur	Nan
hornet	hornet	Nan
hopkins	hopkins	Nan
honshū	honshū	Nan
honolulu	honolulu	Nan
hong	hong	Nan
honduras	honduras	Nan
hoại	gangrena	Nan
huyễn	iluzorno	Nan
hoạt	hentai	Nan
hoảng	panika	Nan
huynh	brate	Nan
huy	huy	Nan
hutech	hutech	Nan
huston	huston	Nan
husserl	husserl	Nan
hussein	hussein	Nan
hurley	hurley	Nan
hunt	loviti	Nan
hungary	mađarska	None
hun	hun	Nan
hume	hume	Nan
hugo	hugo	Nan
hughes	hughes	Nan
huey	huey	Nan
hudson	hudson	Nan
hudgens	hudgens	Nan
hq	hq	Nan
hp	hp	Nan
hoặc	ili	None
hoả	vatra	None
harlow	harlow	Nan
harlem	harlem	Nan
hardy	izdržljiv	Nan
greenson	greenson	Nan
greenland	grenland	Nan
greek	grčki	None
granit	granit	Nan
granada	granada	Nan
graham	graham	Nan
grabeel	grabeel	Nan
gottfried	gottfried	Nan
gothic	gotička	Nan
gorky	gorky	Nan
gore	gore	None
gordon	gordon	None
gorbachyov	gorbachyov	Nan
gorbachev	gorbačov	Nan
google	google	None
gom	skupiti	Nan
golden	zlatno	None
goku	goku	Nan
goes	ide	None
greenwich	greenwich	Nan
go	idi	Nan
greg	greg	Nan
grenadines	grenadine	Nan
gundam	gundam	Nan
gullit	gullit	Nan
gulf	zaljev	Nan
gulag	gulag	Nan
gujarat	gujarat	Nan
guitar	gitara	None
guinness	guinness	Nan
guinea	gvineja	None
gui	gui	Nan
guatemala	gvatemala	None
guard	čuvar	Nan
guam	guam	Nan
gu	stil	None
gsts	gsts	Nan
gs	gs	Nan
gryffindor	gryffindor	Nan
gruzia	gruzije	Nan
grumman	grumman	Nan
gross	bruto	None
grenada	grenada	Nan
gunung	gunung	Nan
gnp	gnp	Nan
glucose	glukoza	None
giặc	neprijatelja	None
giằng	učvršćivanje	Nan
giận	ljuti	Nan
giầu	bogat	None
giấy	papir	None
giấu	sakriti	Nan
giấm	sirće	Nan
giấc	spavati	Nan
giản	pojednostavljeno	Nan
giảm	smanjenje	None
giải	rešenje	Nan
giả	lažni	Nan
giường	krevet	Nan
giương	plamteći	Nan
giơ	zaglaviti	Nan
giũa	datoteka	None
giúp	pomoć	None
gióng	kao	None
gió	vjetar	None
giặt	oprati	Nan
gmail	gmail	Nan
giếng	dobro	None
giềng	komšija	Nan
gloster	gloster	Nan
gloria	gloria	Nan
glonass	sjaj	Nan
glazer	glazer	Nan
gladys	gladys	Nan
giữa	između	None
giữ	zadržite	Nan
giục	nagovarao	Nan
giỡn	šale	Nan
giở	bljeskalica	Nan
giờ	sati	None
giới	rod	None
giỗ	godišnjica smrti	Nan
giồng	giong	Nan
giỏi	odlicno	Nan
giỏ	korpa	Nan
giọt	kap	Nan
giọng	ton	Nan
giễu	ismijavanja	Nan
giết	ubiti	None
gustave	gustave	Nan
gutenberg	gutenberg	Nan
guyana	gvajana	Nan
gỡ	istovariti	Nan
gởi	poslati	Nan
gờ	izlaz	None
gớm	grozan	Nan
gộp	spajanje	Nan
gội	šampon	Nan
gỗ	drvo	None
gồng	gong	Nan
gồm	uključujući	None
gốm	keramika	Nan
gối	jastuk	Nan
gốc	porijeklo	None
gỏi	salata	Nan
gọt	oguliti	Nan
gọng	obrubljen	Nan
gọn	uredan	Nan
gọi	poziv	None
gỉ	zahrđao	Nan
gặt	za žetvu	Nan
gợi	sugestivni	Nan
gặp	upoznati	Nan
gục	dole	Nan
gửi	poslati	Nan
harald	harald	Nan
hao	hao	Nan
hansen	hansen	Nan
hanja	hanja	Nan
hanh	hanh	Nan
hangul	hangul	Nan
hang	pećina	None
han	han	None
hamilton	hamilton	Nan
ham	šunka	Nan
halogen	halogen	Nan
halle	halle	Nan
hal	hal	Nan
hai	dva	None
hahn	hahn	Nan
haeberle	haeberle	Nan
habsburg	habsburg	None
habana	habana	Nan
ha	ha	Nan
gừng	đumbir	Nan
gặm	griziti	Nan
gắt	oštro	None
gắng	pokušavajući	Nan
góp	rata	None
gói	paket	Nan
góc	ugao	None
góa	udovica	None
gòn	gòn	Nan
gò	brdo	None
gìn	očuvati	Nan
gì	šta	None
gãy	slomljen	Nan
gây	uzrok	None
gân	zatvoriti	Nan
gáy	vrat	Nan
gánh	nositi	None
gán	dodijeliti	Nan
gái	devojka	Nan
gác	čuvar	Nan
gào	vrisnuo	Nan
gài	tuck	Nan
gà	piletina	Nan
gót	peta	Nan
gõ	tip	None
göbbels	göbbels	Nan
găm	ostava	Nan
gắn	montiran	Nan
gắm	prdne	Nan
gậy	štap	Nan
gập	saviti	Nan
gẫy	slomljen	Nan
gầy	tanka	Nan
gần	blizu	None
gấu	medvjed	Nan
gấp	požurite	Nan
hô	ho	None
gấm	brokat	Nan
gảy	odmor	None
gả	brak	None
gạt	pocjepan	Nan
gạo	pirinča	Nan
gạc	gaza	Nan
gương	ogledalo	Nan
gươm	mač	None
gũi	zatvoriti	Nan
găng	rukavice	Nan
gấc	gac	Nan
hôi	faul	Nan
hôm	dan	None
hôn	poljubac	Nan
kashmir	kašmir	Nan
karim	karim	Nan
karen	karen	Nan
karatedo	karatedo	Nan
karate	karate	None
karaoke	karaoke	Nan
kara	kara	Nan
kar	kar	Nan
kant	kant	None
kanji	kanji	Nan
kangin	kangin	Nan
kana	kana	Nan
kampuchea	kampuchea	Nan
kampong	kampong	Nan
kampf	kampf	Nan
kamov	kamov	Nan
kamakura	kamakura	Nan
kama	kama	Nan
kali	kalijuma	Nan
kaspersky	kaspersky	Nan
kalashnikov	kalašnjikov	Nan
katakana	katakana	Nan
katherine	katherine	None
kentucky	kentucky	Nan
kenny	kenny	Nan
kenneth	kenneth	Nan
kennedy	kennedy	Nan
ken	ken	Nan
kem	krema	Nan
kelvin	kelvin	Nan
kelsi	kelsi	Nan
kelly	kelly	Nan
ke	ke	Nan
kcn	kcn	Nan
kazan	kazan	Nan
kay	kej	Nan
kawasaki	kawasaki	Nan
kavkaz	kavkaz	None
kauthara	kauthara	Nan
katz	katz	Nan
katrina	katrina	Nan
kathmandu	kathmandu	Nan
kate	kate	Nan
kepler	kepler	Nan
kaká	kaká	Nan
kai	kai	Nan
joint	zglob	Nan
johor	johor	Nan
johnston	johnston	Nan
johns	johns	Nan
johnny	johnny	Nan
johannesburg	johannesburg	Nan
johannes	johannes	Nan
johann	johann	None
johan	johan	Nan
joe	joe	Nan
joan	joan	Nan
joachim	joachim	Nan
jiraiya	jiraiya	Nan
jing	jing	Nan
jin	jin	Nan
jimmy	jimmy	Nan
jiao	jiao	Nan
jewish	židovski	Nan
jetstar	jetstar	Nan
jonathan	jonathan	Nan
kakashi	kakashi	Nan
jones	jones	Nan
joseon	joseon	Nan
kahn	kahn	Nan
kagome	kagome	Nan
kaffee	kafe	Nan
kaede	kaede	Nan
k	k	None
juventus	juventus	Nan
jura	jura	Nan
jupiter	jupiter	Nan
junsu	junsu	Nan
jung	jung	Nan
june	juna	None
jump	skok	Nan
julliard	julliard	Nan
julesverne	julesverne	Nan
judo	judo	Nan
judith	judith	Nan
juche	juche	Nan
jscript	jscript	Nan
joseph	joseph	None
jose	jose	Nan
kerala	kerala	Nan
kevin	kevin	Nan
keynes	keynes	Nan
khánh	nezavisnost	None
kháng	otpor	None
khán	publika	None
khám	ispitivanje	None
khái	konceptualni	Nan
khách	gost	Nan
khác	drugo	None
khá	radije	None
khuỷu	lakat	Nan
khuếch	pojačati	Nan
khuẩn	bakterija	None
khuấy	promešao	Nan
khuất	skriveno	Nan
khuyển	pas	Nan
khuyết	neispravan	Nan
khuyên	savjet	None
khuynh	levo	Nan
khural	khural	Nan
khung	okviri	Nan
khát	žedan	Nan
khu	četvrtine	Nan
khâm	khâm	Nan
khéo	genijalan	Nan
khước	zanijekati	Nan
khưu	khưu	Nan
khư	khư	Nan
khơi	offshore	Nan
khăn	ručnik	Nan
khăm	loše miriše	Nan
khúc	segment	Nan
không	nije	None
khôn	mudar	Nan
khô	osušene	Nan
khóm	ananas	Nan
khói	dim	Nan
khóc	plakati	Nan
khóa	zaključati	Nan
khó	teško	None
khít	zatvoriti	Nan
khích	ohrabruju	Nan
khía	zarez	Nan
khép	zatvoriti	Nan
khèn	jao	Nan
khrushchyov	hhrushchyov	Nan
khrushchev	hruščov	Nan
khoẻ	dobro	None
khiên	štit	None
khiêm	skroman	Nan
khieu	ne razumijem	Nan
khi	kada je	Nan
kheo	na štakama	Nan
khen	pohvale	Nan
khem	khem	Nan
khe	utor	Nan
khay	pladanj	Nan
khao	čežnja	Nan
khanh	khanh	Nan
khang	khang	Nan
khan	bezvodni	Nan
kham	kham	Nan
khalip	khalip	Nan
khali	khali	Nan
khai	deklaracija	None
kha	kha	Nan
kg	kg	Nan
khiêu	erotski	Nan
khiếm	oslabljen	Nan
khiến	uzrok	None
khiếp	prestravljen	Nan
khoảnh	na trenutke	Nan
khoảng	cca	Nan
khoản	predmet	None
khoả	gola	Nan
khoăn	bijes	Nan
khoét	rez	Nan
khoát	definitivno	None
khoáng	mineralnim	Nan
khoán	zaliha	Nan
jesus	jezus	Nan
khoác	kaput	Nan
khoe	hvalisanje	Nan
khoanh	zazvoni	Nan
khoang	šupljina	Nan
khoan	bušilica	Nan
khoa	fakultet	None
kho	skladište	Nan
khleang	khleang	Nan
khiển	kontrola	None
khiếu	kućica	Nan
khoá	zaključati	Nan
khải	otkrivenje	Nan
jesse	jesse	Nan
jersey	dres	Nan
hồ	jezero	None
hốc	niše	Nan
hố	jama	Nan
hỏng	slomljen	Nan
hỏa	vatra	None
họp	sastanak	Nan
họng	grlo	Nan
học	naučite	Nan
họach	plan	None
họa	umjetnost	None
họ	prezime	None
hịch	thud	Nan
hỉ	udarac	None
hệt	identičan	Nan
hệ	sistem	None
hễ	eh	Nan
hề	klovn	Nan
hết	preko	None
hến	školjke	Nan
hồi	anis	Nan
hẻo	osamljen	Nan
hồn	duša	None
hổi	huh	Nan
hửu	ha?	Nan
hử	ha?	Nan
hứa	obećanje	Nan
hủy	otkazati	Nan
hủi	gubavca	Nan
hụt	deficit	Nan
hợpquận	saglasnost	Nan
hợp	dobro prilagođen	Nan
hợi	svinja	None
hỡi	oi	None
hở	otvorena	None
hờn	sumorno	Nan
hớn	viknu	Nan
hới	otvorena	None
hộp	kutija	Nan
hội	festivalu	None
hỗn	mešovito	Nan
hỗ	podrška	None
hổng	zijevajući	Nan
hổ	tigar	Nan
hữu	vlasništvo	None
hẻm	uličica	Nan
hẹ	šalotke	Nan
hưởng	uživaj	Nan
hường	huong	Nan
hướng	pravac	None
hước	šaljivi	Nan
hương	tamjan	Nan
hưu	penzionisan	Nan
hư	loše	None
hơn	nego	None
hơi	malo	None
hũ	staklenke	Nan
hđh	hđh	Nan
hđbt	hđbt	Nan
hăng	oštar	Nan
hút	pušenje	None
húng	inspiracija	Nan
húc	gore	None
hùng	heroji	Nan
hù	uplašiti	Nan
hông	kuka	Nan
hạ	ljeto	None
hẹp	uska	Nan
hạc	flamingoes	Nan
hại	šteta	None
hặc	hặc	Nan
hằng	konstantno	None
hắt	kihati	Nan
hắn	njega	None
hắc	crna	None
hậu	kraljice	None
hận	mrziti	Nan
hầu	skoro	None
hầm	tunel	None
hấu	lubenica	Nan
hất	letjeti	Nan
hấn	hấn	Nan
hảo	savršena	Nan
hải	običaji	Nan
hạt	seme	Nan
hạp	hap	Nan
hạo	hao	Nan
hạnh	hanh	Nan
hạng	klasa	None
hạch	ganglion	Nan
hựu	huu	Nan
hỷ	hy	Nan
ian	ian	Nan
jae	jae	Nan
jacob	jacob	Nan
jackson	jackson	None
jackie	jackie	Nan
jack	dizalica	Nan
j	j	Nan
iwami	iwami	Nan
iv	iv	None
itzá	itzá	Nan
itu	itu	Nan
itsukushima	itukushima	Nan
ito	ito	Nan
itanium	itanium	Nan
italiano	italiano	Nan
italia	italia	Nan
istanbul	istanbul	None
israeli	israeli	Nan
islamabad	islamabad	Nan
islam	islam	None
jakarta	jakarta	Nan
isla	isla	Nan
jan	jan	Nan
janet	janet	Nan
jerry	jerry	Nan
jerome	jerome	Nan
jericho	jericho	Nan
jenny	jenny	Nan
jenda	jenda	Nan
jeju	jeju	Nan
jeffrey	jeffrey	Nan
jefferson	jefferson	Nan
jeff	jeff	Nan
jeet	jeet	Nan
jeans	traperice	Nan
jeanpaul	jeanpaul	Nan
jeanjacques	jeanjacques	Nan
jeane	jeane	Nan
jean	jean	None
jasper	jaspis	Nan
jarvis	jarvis	Nan
jared	jared	Nan
japan	japan	None
janeiro	janeiro	Nan
isaac	isaac	Nan
irving	irving	Nan
irony	ironija	Nan
impact	uticaj	None
immanuel	immanuel	Nan
imbrium	imbrium	Nan
imam	imam	None
im	ja sam	Nan
ilyich	ilyich	Nan
illusion	iluzija	Nan
ilene	ilene	Nan
iii	iii	None
igor	igor	None
ieng	ieng	Nan
ide	ide	None
iceland	island	None
icc	icc	Nan
ic	ic	Nan
ibmpc	ibmpc	Nan
ibm	ibm	Nan
iberia	iberia	Nan
iau	iau	Nan
incoterm	inkoterm	Nan
incoterms	inkotermi	Nan
indian	indijski	None
indiana	indiana	Nan
irgun	irgun	Nan
ireland	irska	None
iraq	irak	Nan
iran	iran	None
iosif	iosif	Nan
ion	jona	Nan
ioc	ioc	Nan
io	io	Nan
inư	inu	Nan
jerusalem	jerusalem	Nan
inuyasha	inuyasha	Nan
interpol	interpol	Nan
intel	intel	Nan
int	int	Nan
insulin	insulin	Nan
innsbruck	innsbruck	Nan
info	info	Nan
indrapura	indrapura	Nan
indonesia	indonezija	None
indochina	indochina	Nan
inu	inu	Nan
≠	≠	Nan
