$ tỉ	$ r $	Nan
rico	rico	Nan
richie	richie	Nan
richardson	richardson	Nan
richard	richard	None
ricci	ricci	Nan
ricardo	ricardo	Nan
rica	rica	Nan
rhodes	awọn orin	Nan
rfid	rfid	Nan
rey	rey	Nan
revolution	iyika	Nan
reverse	yiyipada	Nan
resort	asegbeyin	Nan
reserve	ifipamọ	Nan
reo	òrùka	Nan
rené	rené	Nan
renault	renault	Nan
renaissance	atunṣe	Nan
ren	lesi	Nan
riemann	riemann	Nan
reichelt	reichelt	Nan
rimjob	rimjob	Nan
rising	nyara	Nan
rodríguez	rodríguez	Nan
roddick	roddick	Nan
rockefeller	rockefeller	Nan
robinson	olopa	Nan
robin	robin	Nan
robespierre	olè	Nan
roberts	aṣọ alarabara	Nan
roberto	roberto	Nan
robert	robert	Nan
ro	ro	None
riềng	galangal	Nan
riết	ri	Nan
riêu	riêu	Nan
riêng	ikọkọ	Nan
rizal	rizal	Nan
rivière	rivière	Nan
rivaldo	orogun	Nan
ritchie	ritchie	Nan
risk	eewu	Nan
rin	rin	Nan
roi	ọpá	Nan
regia	regia	Nan
reap	kárè	Nan
ralph	ralph	Nan
raleigh	igbidanwo	Nan
rai	ìyè	Nan
rafale	rafale	Nan
rafael	rafaeli	Nan
race	ije	None
rabindranath	rabindranath	Nan
r	r	Nan
qúy	mẹẹdogun	Nan
quỹ	inawo	Nan
quỷ	eṣu	Nan
quỵ	ọgbẹ	Nan
quỳnh	quỳnh	Nan
quỳ	kunle	Nan
quỉ	eṣu	Nan
quệ	talaka	None
quết	itanjẹ	Nan
quế	eso igi gbigbẹ oloorun	Nan
quẻ	hektari	Nan
ram	àgbo	Nan
reef	odo	Nan
rama	rama	Nan
ramayana	ramayana	Nan
reanimation	atunkọ	Nan
real	gidi	Nan
reagan	reagan	Nan
rađa	reda	Nan
raymond	pupa	None
raya	raya	Nan
ray	eegun	Nan
rau	ewebe	Nan
rate	oṣuwọn	Nan
raptor	raptor	Nan
rap	rp	Nan
rao	ad	Nan
ranh	ààlà	Nan
rangers	awọn oluṣọ	Nan
rang	ọmọ	None
randy	olufẹ	Nan
ranch	oko	None
ran	sáré	Nan
rambus	rambus	Nan
ramadan	àgbò	Nan
quặng	irin	Nan
roland	roland	Nan
rome	romeò	Nan
rò	jijo	Nan
rít	rẹ	None
rìu	ake	Nan
rình	ṣe amí	Nan
rìa	eti	Nan
rì	pariwo	Nan
rêu	mossi	Nan
rên	iyara	Nan
rê	fa	Nan
rét	tutu	Nan
république	république	None
ré	ologbon	Nan
rèn	forging	Nan
rèm	aṣọ-ikele	Nan
räikkönen	räikkönen	Nan
rãnh	trench	Nan
rãi	cobble	Nan
rã	ibajẹ	Nan
râu	irù	Nan
ròng	àwọn	Nan
râm	ojiji	Nan
rót	pouring	Nan
rôbôt	robot	Nan
rượu	oti	Nan
rượt	lepa	Nan
rưỡi	idaji	None
rưới	wọn	None
rước	ilana	None
rươi	ìwọ	Nan
rơm	koriko	Nan
rơi	ṣubu	Nan
rơ	ọkọ ayọkẹlẹ	Nan
rũ	ẹlẹtan	Nan
rōmaji	rōmaji	Nan
răng	ehin	Nan
răn	pipaṣẹ	Nan
rút	yọkuro	Nan
rùng	ti irako	Nan
rùa	ẹyẹ	Nan
rõ	ko	None
rông	ṣofo	Nan
rôma	romeò	Nan
rô	ti tan	Nan
romania	romania	Nan
ráp	apejọ	Nan
rái	otita	Nan
rulin	rulin	Nan
rue	gbooro	Nan
rudolph	rudolph	Nan
rtp	rtp	Nan
rpd	rpd	Nan
roy	roy	Nan
rowling	titọ	Nan
rovers	rovers	Nan
router	olulana	Nan
rousseau	rousseau	Nan
rotterdam	iyipo	Nan
roth	roth	Nan
rosen	rosen	Nan
rong	ewe	None
ronaldinho	ronaldinho	Nan
ronald	ronald	None
ron	ron	Nan
rommel	rommeli	Nan
romeo	romeo	Nan
rumani	ara ilu róòmù	Nan
rán	din-din	Nan
rumiko	rumiko	Nan
run	sáré	Nan
rách	ya	Nan
rác	idoti	Nan
rào	odi	Nan
rành	alaapọn	Nan
ràng	ko	None
rà	ṣayẹwo	Nan
rzeczpospolita	rzeczpospolita	Nan
ruột	iṣan	Nan
ruộng	aaye iresi	Nan
ruổi	ruoi	Nan
ruồi	fo	Nan
ruốc	ede	None
ruud	dabaru	Nan
rutte	rutte	Nan
rutherford	rutherford	Nan
ruth	ruth	Nan
russkaya	russkaya	Nan
russian	ara ilu russia	Nan
rung	gbọn	Nan
rummel	rummel	Nan
quặc	eemọ	Nan
quẳng	sí	Nan
quật	ìgbín	Nan
plan	gbero	Nan
plaaf	ẹyẹ	Nan
pius	ẹyọ	Nan
pitch	ọfin	Nan
piston	pisitini	Nan
pisa	pisa	Nan
pipes	awọn ọpa oniho	Nan
pioneer	aṣáájú-ọ̀nà	Nan
pinlus	pinlus	Nan
pin	batiri naa	Nan
pike	piiki	Nan
pietro	pietro	Nan
pierrot	ọfunfun	Nan
pierre	gun	None
piccolo	ẹlẹyẹ	Nan
picchu	picchu	Nan
phức	eka	None
phủ	ti bo	Nan
phụt	puff	Nan
plasma	pilasima	Nan
phụng	sìn	Nan
plate	awo	None
platon	platon	Nan
porto	porto	Nan
portland	aginjù	Nan
pop	agbejade	Nan
pont	agbọnrin	Nan
polynésie	polynésie	Nan
polo	polo	Nan
pollux	pollux	Nan
pollack	eruku	Nan
poland	polandii	Nan
pol	poli	Nan
pokémon	pokemon	Nan
po	po	None
pmu	pmu	Nan
pm	irọlẹ	Nan
pluto	pluto	Nan
plus	pẹlu	Nan
pleistocen	pleistocen	Nan
pleiku	ẹbẹ	Nan
player	player	Nan
plato	plato	Nan
pot	ikoko	Nan
phục	aṣọ	Nan
phới	omi	None
phả	afẹsẹgba	Nan
phạt	fi	None
phạn	sanskrit	Nan
phượng	phoenix	Nan
phường	ward	Nan
phước	ibukun	Nan
phương	phuong	Nan
phăng	phang	Nan
phăn	fret	Nan
phút	iseju	Nan
phúng	aanu	None
phún	àá	Nan
phúclộc	ibukun	Nan
phúc	ibukun	Nan
phùng	puff	Nan
phông	font	Nan
phôi	ọmọ	None
phô	ilu	Nan
phóng	ifilole	None
phải	ni ọtun	Nan
phở	bọtini nkankan	Nan
phải	ni ọtun	Nan
phảng	alapin	Nan
phộng	epa	None
phổi	ẹdọfóró	Nan
phổ	igbohunsafẹfẹ	Nan
phồng	pa	Nan
phốt	fosifeti	Nan
phối	ipoidojuko	Nan
phố	ilu	Nan
phỏng	jona	Nan
phỉ	hazel	Nan
phết	tànkálẹ	Nan
phế	alokuirin	Nan
phẳng	ọkọ ofurufu	Nan
phật	buddha	Nan
phận	ayanmọ	Nan
phẫu	iṣẹ abẹ	Nan
phẫn	ibinu	Nan
phẩy	koma si	Nan
phẩm	awọn ọja	Nan
phần	apakan	Nan
phản	ohunka	Nan
potsdam	potsdam	Nan
potter	amọkoko	Nan
pour	tú	None
quáng	afoju	Nan
quán	pẹpẹ	Nan
quái	hekki	Nan
quá	paapaa	None
quyệt	aṣogan	Nan
quyện	mingle	Nan
quyền	igbanilaaye	Nan
quyến	ifaya	Nan
quyên	awọn ipilẹṣẹ	Nan
quy	ofin	None
quran	quran	None
quincy	quincy	Nan
qui	qui	Nan
quen	faramọ	Nan
queensland	queensland	Nan
queens	awọn ayaba	Nan
queen	ayaba	Nan
que	rodu	Nan
quay	yipada	None
quát	kigbe	Nan
quanh	yika	Nan
quân	quan	Nan
quét	lati ọlọjẹ	Nan
quận	agbegbe	Nan
quẫn	retṣe	Nan
quẩy	didara julọ	Nan
quầy	èlò	None
quầng	halo	Nan
quần	awọn sokoto	Nan
quấy	aruwo	Nan
quất	kumquat	Nan
quấn	fi	None
quảng	igbega	Nan
quản	ṣàkóso	Nan
quạt	àìpẹ	Nan
quạ	awọn kuroo	Nan
quĩ	inawo	Nan
quăng	sí	Nan
quýt	ọsan oyinbo	Nan
quý	iyebiye	Nan
quên	gbagbe	Nan
quê	abule	Nan
quãng	feleto	Nan
quang	opitika	Nan
quan	quan	Nan
quad	quad	Nan
prôtêin	amuaradagba	Nan
protein	amuaradagba	Nan
prometheus	onitẹsiwaju	Nan
projekt	projekt	Nan
procellarum	apejọ	Nan
prix	prix	Nan
prinz	patako itẹwe	Nan
printf	atẹjade	Nan
printemps	awọn atẹwe	Nan
princeton	itẹwe	Nan
prince	ọmọ	None
preston	preston	Nan
preminger	preminger	Nan
premier	ajé	Nan
preah	àwahn	Nan
pratzen	pratu	Nan
praha	praha	Nan
pradesh	pdeslú	Nan
powell	powell	Nan
ps	ps	Nan
psv	psv	Nan
ptolemy	àbààwọ́n	Nan
ptq	ptq	Nan
qua	nipasẹ	Nan
qlvnch	qlvnch	Nan
qing	qing	Nan
qd	qd	Nan
qatar	qatar	Nan
q	q	Nan
pơ	pơ	Nan
păng	pang	Nan
pérez	perez	Nan
rạ	thatch	Nan
péc	sẹẹrẹ	Nan
pytago	pytago	Nan
pyrenees	pyrenees	Nan
putin	putin	Nan
pusan	pusan	Nan
punjab	punjab	Nan
pulp	ko	None
pulitzer	pulitzer	Nan
pulau	pulau	Nan
puerto	puerto	Nan
pzl	pzl	Nan
rạc	oloye	None
rạch	odo odo	Nan
rạng	owurọ	Nan
storting	storting	Nan
stones	okuta	Nan
stockholm	ọja iṣura	Nan
stimson	olukọni	Nan
stf	stf	Nan
stewarthannah	stewarthannah	Nan
stevie	stevie	Nan
stevenson	stevenson	Nan
stevens	stevens	Nan
steve	steve	Nan
sterling	amunisin	Nan
stephenie	igbidanwo	Nan
stephen	alairi	Nan
stennis	stennis	Nan
stelzer	alarinrin	Nan
steiner	iriju	Nan
steiermark	steiermark	Nan
stefan	stefan	Nan
stdc	stdc	Nan
strasberg	strasberg	Nan
status	ipo	None
strauss	awọn okun	Nan
struct	igbekale	Nan
sun	oorun	Nan
summerslam	summerslam	Nan
summer	igba ooru	Nan
sumitomo	sumitomo	Nan
sumatra	sumatra	Nan
sumatera	sumatera	Nan
sum	aropọ	Nan
sulu	sulu	Nan
sulfua	imi-ọjọ	Nan
sukarno	sukarno	Nan
suharto	suharto	Nan
suez	suez	None
subakhi	subakhi	Nan
su	su	Nan
stéfano	stéfano	Nan
styx	styx	Nan
stuttgart	stuttgart	Nan
stuart	aṣaju	Nan
stt	stt	Nan
street	opopona	Nan
sunday	sunday	Nan
startin	ibẹrẹ	Nan
stanley	ìlù	Nan
sonata	sonata	Nan
somme	somme	Nan
som	som	Nan
solaris	solaris	Nan
soi	bẹẹ	Nan
soho	iyen	None
sohee	sohee	Nan
socrates	socrates	Nan
société	lawujọ	Nan
so	nitorinaa	Nan
smithsonian	smithsonian	Nan
smith	smith	Nan
smg	smg	Nan
sm	sm	Nan
slytherin	slytherin	Nan
slavơ	slav	Nan
slav	slav	Nan
sl	sl	Nan
skyteam	skyteam	Nan
song	orin	Nan
starr	irawo	Nan
sony	ọmọkùnrin	Nan
sophie	arabinrin	Nan
stanford	stanford	Nan
stand	duro	Nan
stamford	ogun	None
stalingrad	stalingrad	Nan
st	st.	Nan
ss	s	Nan
sri	sri	Nan
sports	eré ìdárayá	Nan
spielberg	spielberg	Nan
spencer	spencer	Nan
spence	spence	Nan
spellman	akọbẹrẹ	Nan
spears	awọn ọkọ	Nan
soạn	olupilẹṣẹ	Nan
soát	iṣakoso	Nan
soul	ọkàn	Nan
sos	bẹẹ	Nan
sorbonne	sorbonne	Nan
sopwith	sopwith	Nan
soo	soo	Nan
sung	ọpọtọ	Nan
sunni	sunni	Nan
sunsilk	sunsilk	Nan
súp	bimo	Nan
súng	awon ibon	Nan
sún	rì	Nan
súc	ẹran	Nan
sú	tiger dudu	Nan
sùng	ìfaradà	Nan
sông	odo	Nan
sôi	farabale	Nan
sô	nọmba	Nan
sót	iparun	Nan
sóng	igbi	Nan
sói	ìkookò	Nan
sóc	squirrel	Nan
sòng	kasino	Nan
sò	kilamu	Nan
sít	fẹẹrẹ	Nan
síp	kírúsì	Nan
sính	ọmọ	None
sêu	mossi	Nan
sút	gbon	Nan
sêri	jara	Nan
săn	ọdẹ	Nan
sư	ọjọgbọn	Nan
sẩn	papules	Nan
sầu	melancholy	Nan
sầm	slams	Nan
sấy	gbigbe	Nan
sấu	ooni	None
sấm	ariwo	Nan
sảnh	gbongan	Nan
sảng	alabapade	Nan
sản	gbóògì	Nan
sảm	didan	Nan
sạn	hotẹẹli	Nan
sạch	mọ	Nan
sưởi	alapapo	Nan
sườn	ẹgbẹ	Nan
sướng	dun	None
sương	ìri	Nan
sưu	awọn akopọ	Nan
sưng	wiwu	Nan
sưa	wara	Nan
sơn	kun	Nan
sê	se	Nan
sét	ina	Nan
são	são	None
sy	sy	Nan
sweet	adun	Nan
swaziland	swaziland	Nan
swan	siwani	Nan
svd	svd	Nan
suồng	dan	Nan
suốt	jakejado	Nan
suối	alapapo	Nan
suất	sise	None
suôn	laisiyonu	Nan
suê	nitorinaa	Nan
suy	ikuna	Nan
suvp	suvp	Nan
suub	suub	Nan
sutra	sutra	Nan
susilo	susilo	Nan
susan	susan	Nan
suriname	abẹ	Nan
super	dara julọ	Nan
sydney	sydney	Nan
symantec	symantec	Nan
sync	ìsiṣẹpọ	Nan
syria	aranmo	Nan
sãi	ko	None
sã	ãù	Nan
sâu	jinjin	Nan
sân	àgbà	Nan
sâm	ginseng	Nan
sáu	mefa	Nan
sát	sunmọ	Nan
sáp	epo-eti	Nan
sáo	ferese	Nan
skype	skype	Nan
sánh	afiwera	Nan
sám	ronupiwada	Nan
sái	ko	None
sách	iwe	Nan
sá	sipunculus	Nan
sào	òpó	Nan
sành	terracotta	Nan
sàng	dojuti	Nan
sàn	ilẹ	None
sài	bẹẹni	Nan
sáng	didan	Nan
phó	igbakeji	Nan
sky	ọrun	Nan
siêu	dara julọ	Nan
samoa	samoa	Nan
samo	samo	Nan
samhain	samhain	Nan
salzburg	salzburg	Nan
salvador	salvador	Nan
salem	salem	None
sakura	sakura	Nan
saintdenis	saintdenis	Nan
saigon	saigoni	Nan
sai	ko	None
sahara	sahara	Nan
safin	safin	Nan
safari	safari	None
saddam	saddam	Nan
sachsen	sachsen	Nan
sabah	sabah	Nan
sa	sa	Nan
rữa	wẹ	Nan
rửa	wẹ	Nan
samphan	aráyé	Nan
rừng	igbo	Nan
samsung	samsung	Nan
samuelson	samuelson	Nan
sardinia	sardinia	Nan
sarcoma	sarcoma	Nan
sarawak	sarawak	Nan
sarah	sarah	Nan
sar	sar	Nan
sapiens	sapiens	Nan
sapa	sapa	Nan
sap	sap	Nan
sao	irawo	Nan
santos	santos	Nan
sanktpeterburg	sanktpeterburg	Nan
sanh	ibi	Nan
sangraal	oriire	None
sango	sango	Nan
sang	sí	Nan
sanchez	sanchez	Nan
san	san	Nan
samut	samut	Nan
samurai	samurai	Nan
samuel	samueli	Nan
sary	sary	Nan
rứa	rứa	Nan
rủ	fiwepe	Nan
rễ	wá	Nan
rể	oko	None
rền	jẹro	Nan
rẽ	yiyi	Nan
rẻ	olowo poku	Nan
rặng	àpáta	Nan
rằng	iyẹn	Nan
rằm	oṣupa kikun	Nan
rắn	ejo	Nan
rắc	wọn	None
rập	arabawa	Nan
rậm	bushy	Nan
rẫy	ogbin	Nan
rầu	ibanujẹ	Nan
rầm	jamb	Nan
rất	pupọ	Nan
rảnh	ọfẹ	Nan
rải	tuka	Nan
rạp	imiran	Nan
rệp	kokoro	Nan
rủi	mishap	Nan
rệt	oyè	Nan
rỉ	ipata	Nan
rụng	ta silẹ	Nan
rợn	ti irako	Nan
rợ	alaigbede	Nan
rỡ	o wuyi	Nan
rời	osi	Nan
rớt	ṣubu	Nan
rộng	gbooro	Nan
rộn	nṣiṣe lọwọ	Nan
rộ	igbamu	Nan
rỗng	ṣofo	Nan
rỗi	ọfẹ	Nan
rổ	apeere	Nan
rồng	dragoni	Nan
rồi	tẹlẹ	Nan
rồ	irikuri	Nan
rốm	kurukuru	Nan
rối	tangẹ	Nan
rỏ	ko	None
rịavũng	rìvà	Nan
rệu	aye	Nan
saturanga	saturanga	Nan
saturday	s&#39;oru	Nan
sau	lẹhin	Nan
siberi	siberi	Nan
shōnen	shōnen	Nan
showcase	iṣafihan	Nan
short	kukuru	Nan
shop	ṣọọbu	Nan
shonen	shonen	Nan
shoal	shoal	Nan
shiva	shiva	Nan
shirakawago	shirakawago	Nan
shirakami	shirakami	Nan
shinoda	shinoda	Nan
shinichi	shinichi	Nan
shikoku	shikoku	Nan
shiite	shiite	Nan
shia	shia	Nan
shi	shi	Nan
sherlock	sherlock	Nan
shawn	faya	Nan
sharpay	didan	Nan
sicilia	sicilia	Nan
shaolin	shaolin	Nan
sicily	alarinrin	Nan
siem	siem	Nan
siu	siu	Nan
sistema	sistema	Nan
sirô	omi	None
sip	sip	Nan
sinh	bi	Nan
sing	kọrin	Nan
sinensis	sinensis	Nan
sinai	sinai	None
simone	simoni	Nan
silvestris	silvestris	Nan
silva	siliki	Nan
silicat	fẹẹrẹ	Nan
silic	ohun alumọni	Nan
silesia	silesia	Nan
silas	silas	Nan
sikorsky	sikorsky	Nan
sikh	sikh	Nan
sierra	sierra	Nan
siemens	siemens	Nan
sidney	sidney	Nan
shankly	shankly	Nan
shane	shane	Nan
shan	shan	Nan
sdram	sdram	Nan
scuderia	scuderia	Nan
scud	scud	Nan
scream	pariwo	Nan
scott	scott	Nan
scots	scots	Nan
scotland	ilu scotland	Nan
schwarzschild	schwarzschild	Nan
schuster	schuster	Nan
schuschnigg	schuschnigg	Nan
schumacher	oloye	None
schneider	oloye	None
schlesinger	schlesinger	Nan
schiller	schiller	Nan
schengen	schengen	Nan
schafer	schafer	Nan
scandinavia	sikandina	Nan
saunière	saunière	Nan
saudi	saudi	Nan
search	wa	Nan
seattle	seattle	Nan
secret	aṣiri	Nan
sedna	sedna	Nan
shaman	shaman	Nan
shah	shah	Nan
seyssinquart	ile ijagba	Nan
seymour	seymour	Nan
sexy	onibaje	Nan
sextus	sextus	Nan
seto	seto	Nan
seth	ṣeto	Nan
sesshomaru	sesshomaru	Nan
siết	fẹẹrẹ	Nan
service	iṣẹ	Nan
sergeyevich	sergeyevich	Nan
serbia	serbia	Nan
september	oṣu kẹsan	Nan
sense	ori	None
sen	lotus	Nan
semit	ipin	None
selena	seeli	Nan
sejm	sejm	Nan
see	wo	Nan
seri	jara	Nan
sẫm	dudu	Nan
phòng	yara	Nan
phím	bọtini	Nan
ngộ	imoye	Nan
ngồi	joko	Nan
ngọt	adun	Nan
ngọn	oke	Nan
ngọc	tiodaralopolopo	Nan
ngọ	ọsan	Nan
ngặt	fẹẹrẹ	Nan
ngắn	kukuru	Nan
ngắm	ṣe aṣaro	Nan
ngập	omi	None
ngậm	lozenges	Nan
ngẫu	id	Nan
ngẫm	ronu	Nan
ngẩn	dabaru	Nan
ngần	ṣiyemeji	Nan
ngầm	mimọ	Nan
ngất	suuru	Nan
ngấm	funni	Nan
ngạt	apọju	Nan
ngột	lojiji	Nan
ngạo	gbajumọ	Nan
ngớ	aimọgbọnwa	Nan
ngỡ	ronu	Nan
nhakẻ	kekere	None
nha	ehin	Nan
ngực	àyà	Nan
ngựa	ẹṣin	Nan
ngự	gbé	None
ngữ	ọrọ	Nan
ngửi	orun	Nan
ngửa	dojú	None
ngừng	gbawọ	Nan
ngừa	ṣe idiwọ	Nan
ngừ	tuna	Nan
ngứa	nyún	Nan
ngủi	kukuru	Nan
ngủ	sun	None
ngụy	wei	Nan
ngụm	sip	Nan
ngục	ẹwọn	Nan
ngợm	alaigbọran	Nan
ngợi	iyin	Nan
ngời	eniyan	Nan
nham	lava	Nan
ngạnh	abà	Nan
ngạch	ipo	None
ngây	òfo	Nan
ngân	banki	Nan
ngát	daku	Nan
ngáng	ngáng	Nan
ngán	sunmi	Nan
ngái	omugo	Nan
ngách	onakan	Nan
ngày	ọjọ	Nan
ngào	adun	Nan
ngành	ẹka	Nan
ngàng	ngàng	Nan
ngàn	ẹgbẹrun	Nan
ngà	ehin-erin	Nan
nguỵ	aṣiwere	Nan
nguời	eniyan	Nan
nguồn	orisun	None
nguôi	ifọkanbalẹ	Nan
nguyệt	osupa	Nan
nguyện	ṣe adehun	Nan
ngãi	ngai	Nan
ngạn	banki	Nan
ngò	cilantro	Nan
ngói	alẹmọ	Nan
ngạc	yà	Nan
ngược	yiyipada	Nan
ngưỡng	àbáwọlé	Nan
người	eniyan	Nan
ngươi	iwo	Nan
ngưu	omi	None
ngưng	duro	Nan
ngư	apeja	None
ngơi	sinmi	Nan
ngơ	foju	Nan
ngũ	sun	None
ngăn	iyẹwu	Nan
ngút	ngut	Nan
ngùi	orun	Nan
ngõ	ọna tooro	Nan
ngông	gusi	Nan
ngôn	ede	None
ngót	isunki	Nan
ngón	ika	Nan
ngó	wo	Nan
nguyền	egún	Nan
nhan	nhan	Nan
nhanh	yara	Nan
nhẫn	oruka	Nan
nhầy	tẹẹrẹ	Nan
nhầm	ko	None
nhất	dara julọ	Nan
nhấn	titẹ	Nan
nhấm	sipping	Nan
nhấc	gbe	None
nhảy	jó	Nan
nhạy	kókó	Nan
nhạt	bia	Nan
nhạo	ẹlẹya	Nan
nhạn	gbe	None
nhạc	orin	Nan
nhạ	nhạ	Nan
nhượng	awọn ayeye	Nan
nhược	ailera	Nan
nhưỡng	ọra-wara	Nan
nhường	fun	None
nhương	itọ	Nan
nhậm	ontẹ	Nan
nhưng	ṣugbọn	Nan
nhập	gbewọle	Nan
nhậy	kókó	Nan
nhỏ|phải|px|cây	kekere	None
nhỏ|phải|px|bức	kekere	None
nhỏ|phải|px|	kekere	None
nhỏ|phải|	kekere	None
nhỏ|một	kekere	None
nhỏ|cây	kekere	None
nhỏ	kekere	None
nhọn	didasilẹ	Nan
nhọ	alailoriire	Nan
nhịn	fun	None
nhị	onitide	Nan
nhẹn	agin	Nan
nhẹ	ina	Nan
nhặt	mu	Nan
nhẵn	dan	Nan
nhằm	ero	Nan
nhắn	ifiranṣẹ	Nan
nhắm	ifọkansi	Nan
nhắc	tọ	Nan
nhậu	inu mimu	Nan
nhang	turari	Nan
như	bi	Nan
nhũng	ibajẹ	Nan
nhào	dofun	Nan
nhàng	rọra	Nan
nhàn	aito	Nan
nhuộm	aro	Nan
nhuệ	nhue	Nan
nhuận	èrè	Nan
nhu	fẹran	Nan
nhs	àá	Nan
nhk	nhk	Nan
nhiệt	igbona	Nan
nhiệm	iṣẹ	Nan
nhiễu	ariwo	Nan
nhiễm	àrùn	None
nhiều	pọ	Nan
nhiêu	pọ	Nan
nhiên	dajudaju	Nan
nhi	awọn ọmọde	Nan
nhen	tun ṣẹṣẹ	Nan
nhat	bẹẹni	Nan
nhác	rirọ	Nan
nhơn	isodipupo	Nan
nhái	ibeji	None
nháp	ẹda akanṣe	Nan
nhũ	imukuro	Nan
nhĩ	ataran	Nan
nhăn	wrinkled	Nan
nhút	tiju	Nan
nhúng	fibọ	Nan
nhôm	alumọni	Nan
nhô	atako	Nan
nhóm	ẹgbẹ	Nan
nhóc	kekere	None
nhòm	wo	Nan
nhím	hedgehog	Nan
nhí	olukọ	Nan
nhìn	wo	Nan
nhì	ikeji	Nan
nhét	fi	None
nhãn	aami	Nan
nhã	elege	Nan
nhâm	lilẹ	Nan
nháy	awọn ina	Nan
nhánh	ẹka	Nan
nguyên	atilẹba	Nan
nguyen	nguyen	Nan
ngung	ngung	Nan
mồ	sàréè	Nan
mốt	njagun	Nan
mối	oro	Nan
mốc	musty	Nan
mỏng	tinrin	Nan
mỏi	rẹ	None
mỏ	maini	Nan
mọn	kekere	None
mọi	gbogbo	Nan
mọc	gbooro	Nan
mịt	ipanu	Nan
mịn	dan	Nan
mịch	nik	Nan
mỉm	rẹrin	Nan
mỉa	ẹgan	Nan
mỉ	ti oye	Nan
mệt	rẹ	None
mệnh	ayanmọ	Nan
mềm	rirọ	Nan
mồi	ẹyẹ	Nan
mề	gilasi	Nan
mổ	iṣẹ abẹ	Nan
mộ	ibojì	None
na	ni	Nan
mỹcông	america	Nan
mỹ	amẹrika	Nan
mỳ	eefin	Nan
mực	inki	Nan
mửa	eebi	Nan
mừng	dun	None
mứt	jam	Nan
mức	ipele	None
mụn	irorẹ	Nan
mục	nkan	None
mỡ	ọra	Nan
mở	ṣii	Nan
mời	fiwepe	Nan
mờ	iruju	Nan
mới	tuntun	None
một	ọkan	Nan
mộng	àlá	Nan
mộc	iṣẹ gbẹnagbẹna	Nan
mỗi	gbogbo	Nan
naadam	naadam	Nan
mến	ololufe	Nan
mẻ	ipele	None
mả	sàréè	Nan
mạt	mites	Nan
mạo	nkan	None
mạnh	lagbara	Nan
mạn	ẹgbẹ	Nan
mại	isowo	Nan
mạch	circuit	Nan
mạc	aginju	Nan
mượt	dan	Nan
mượn	yawo	Nan
mường	muong	Nan
mướt	siliki	Nan
mướn	iyalo	Nan
mương	imugbẹ	Nan
mươi	aadọta	Nan
mưu	omoluabi	Nan
mưa	ojo	None
mơn	owo	Nan
mơ	àlá	Nan
mải	nṣiṣe lọwọ	Nan
mẽ	lagbara	Nan
mảng	eto	Nan
mất	sọnu	Nan
mẹo	awọn imọran	Nan
mẹ	ìyá	Nan
mặt	oju	Nan
mặn	iyo	Nan
mặc	wọ	Nan
mắt	oju	Nan
mắng	gàn	Nan
mắn	oriire	None
mắm	obe ẹja	Nan
mắc	gbowolori	Nan
mậu	isowo	Nan
mật	oyin	Nan
mập	ọra	Nan
mận	pupa	None
mẩu	awọn ege	Nan
mầu	awọ	Nan
mầm	kokoro	Nan
mấy	diẹ	Nan
mấu	taabu	Nan
mảnh	nkan	None
nacional	nacional	Nan
nagant	nagant	Nan
nagar	nagar	Nan
nghành	ile ise	Nan
nghiệt	iku	None
nghiệp	karma	Nan
nghiện	mowonlara	Nan
nghiệm	iriri	Nan
nghiễm	aanu	None
nghiền	squish	Nan
nghiêu	nghieu	Nan
nghiêng	tọkantọkan	Nan
nghiêm	ṣofintoto	Nan
nghinh	nghinh	Nan
nghe	gbọ	Nan
ngay	ni ọtun	Nan
ngao	kilamu	Nan
ngang	petele	Nan
ngai	itẹ	Nan
nga	russia	Nan
next	itele	Nan
newtons	newtons	Nan
nghèo	talaka	None
newton	newton	Nan
nghé	nghe	Nan
nghênh	kaabọ	Nan
ngu	sun	None
ngoặt	yiyi	Nan
ngoặc	akomo	Nan
ngoạn	yanilenu	Nan
ngoại	ajeji	Nan
ngoài	jade	Nan
ngon	adun	Nan
ngoc	ilana	None
ngoan	omo daadaa	Nan
ngo	dainty	Nan
nghị	awọn iṣeduro	Nan
nghỉ	isinmi	Nan
nghệquận	aworan	Nan
nghề	oojọ	Nan
nghếch	pariwo	Nan
nghẽn	ifakalẹ	Nan
nghĩa	ọna	Nan
nghĩ	ronu	Nan
nghìn	ẹgbẹrun	Nan
nghê	nghe	Nan
newspaper	iwe iroyin	Nan
newcastle	tuntun	None
neverland	lailai	Nan
napoli	napoli	Nan
napoleon	napoleon	Nan
naomi	naomi	Nan
nano	nano	Nan
nanh	awọn ologe	Nan
nang	follicle	Nan
nancy	nancy	Nan
namno	namno	Nan
namnam	orilẹ-ede nam	Nan
namibia	namibia	None
nambắc	ariwa	Nan
nam	akọ	Nan
nalbandian	nalbandian	Nan
nakajima	nakajima	Nan
nairobi	nairobi	Nan
nai	agbọnrin	Nan
nagumo	nagumo	Nan
nagoya	nagoya	Nan
nagasaki	nagasaki	Nan
napoléon	napoléon	Nan
nara	nara	Nan
nasa	tirẹ	Nan
nat	nat	Nan
nevada	nevada	Nan
neutrino	imule	Nan
neumann	neumann	Nan
networks	awọn nẹtiwọki	Nan
netscape	netscape	Nan
netbook	kekere	None
net	àwọn	Nan
nessie	nessie	Nan
nepomuk	nepomuk	Nan
nhỏ|phải|px|khu	kekere	None
nepal	nepal	Nan
neo	ìdákọ̀ró	Nan
nelson	nelson	Nan
needham	nilohamu	Nan
nay	bayi	None
navarre	navarre	Nan
nava	niva	Nan
nauru	nauru	Nan
natri	iṣuu soda	Nan
nathan	nathan	Nan
neon	neon	Nan
nhỏ|phải|px|michael	kekere	None
nhỏ|phải|px|máy	kekere	None
nhỏ|phải|px|một	kekere	None
oxford	oxford	Nan
owen	eniti	Nan
outstanding	dayato	Nan
ottoman	otita	Nan
otto	otto	Nan
other	omiiran	Nan
oswald	oswald	Nan
ossetia	ẹla	Nan
ospf	ospf	Nan
osment	osment	Nan
oslo	oslo	Nan
oskar	oskar	Nan
osiris	osiris	Nan
oscar	oscar	None
osamu	osamu	Nan
osama	osama	Nan
osaka	osaka	Nan
os	os	Nan
orton	orton	Nan
oxy	atẹgun	Nan
orochimaru	orochimaru	Nan
ozawa	ozawa	Nan
oát	watts	Nan
paperback	iwe pẹlẹbẹ	Nan
paolo	paolo	Nan
panthéon	panthéon	Nan
panthera	panthera	Nan
panduranga	panduranga	Nan
panamax	panamax	Nan
panama	panama	Nan
pan	pan	Nan
pamir	pamir	Nan
pali	pali	Nan
palgrave	palgrave	Nan
palestine	palestine	Nan
palenque	pẹlẹbẹ	Nan
palawan	aafin	Nan
palais	ààfin	Nan
pakistan	pakistan	Nan
pailin	pailin	Nan
paget	paget	Nan
oản	oàn	Nan
oán	ìkóríra	Nan
papua	papua	Nan
orleans	oloye	None
origin	oti	Nan
oanh	onii	Nan
oan	aiṣododo	Nan
oakland	igi oakland	Nan
oai	ibẹru	Nan
oahu	oaa	Nan
nữa	lẹẹkansi	Nan
nửa	idaji	None
nứt	gbin	None
nứa	okùn	Nan
nụy	pistil	Nan
nợ	gbese	None
nỡ	ọkan	Nan
nở	itanna	Nan
nới	loosen	Nan
nộp	ẹsun	Nan
nộn	aporo	Nan
nội	ti abẹnu	Nan
nộ	ibinu	Nan
nỗi	iyẹn	Nan
obama	obama	Nan
orion	orion	Nan
oblast	oblast	Nan
october	oṣupa	Nan
oricon	ẹgbin	Nan
organ	eto ara eniyan	Nan
oprah	oprah	Nan
oort	oort	Nan
ontario	ontario	Nan
ong	oyin	Nan
omar	omar	Nan
om	braised	Nan
olympus	olimus	Nan
olivier	olivier	Nan
oliver	ẹṣọ	Nan
okhotsk	okhotsk	None
ohkawa	ohkawa	Nan
officers	awọn olori	Nan
officer	oṣiṣẹ	Nan
oecd	oecd	Nan
odyssey	odyssey	Nan
oder	oder	Nan
oda	da	None
oc	oc	Nan
paraguay	paraguay	Nan
pari	pari	Nan
park	gbesile	Nan
phu	phu	Nan
phrygian	fèdè fèdè	Nan
php	php	Nan
phong	yara	Nan
phoenix	phoenix	Nan
pho	pho	Nan
phnôm	pómónì	Nan
phnom	phnom	Nan
phiệt	oore	Nan
phiện	opium	Nan
phiến	abẹfẹlẹ	Nan
phiếm	olofofo	Nan
phiêu	ìrìn	Nan
phiên	igba	Nan
phineas	awọn iṣupọ	Nan
phin	àlẹmọ	Nan
phim	fiimu	Nan
philosophiae	ologbon	Nan
phillips	phillips	Nan
phui	ṣii	Nan
phillip	agekuru	Nan
phun	fun	None
phàm	kíkú	Nan
phích	igbomikana	Nan
phía	ẹgbẹ	Nan
phí	idiyele	Nan
phình	bulge	Nan
phì	gbooro	Nan
phêrô	pétérù	Nan
phê	ga	Nan
phép	gba	None
phèo	phèo	Nan
phèn	alum	Nan
phát	igbohunsafefe	Nan
pháp	faranse	None
pháo	kan	None
phán	lẹjọ	Nan
phái	abala	None
phách	lu	Nan
phác	sketch	Nan
phá	fifọ	Nan
phàn	kerora	Nan
phà	ferry	Nan
philippines	philippines	Nan
philippe	agekuru	Nan
philip	philli	Nan
pereira	pereira	Nan
penny	dinari	Nan
pennsylvania	pennsilin	Nan
penh	penh	None
penang	penang	Nan
pele	eso pishi	Nan
peers	egbe	None
pedro	rin irinse	Nan
pdf	pdf	Nan
pda	pda	Nan
pbs	pbs	Nan
pavia	pavia	Nan
paulo	paulo	Nan
paula	paula	Nan
paul	poul	Nan
patriot	ọmọ	None
patrick	patrick	Nan
patel	patẹlu	Nan
parton	apa	Nan
perl	perl	Nan
pero	pero	Nan
perry	ariyanjiyan	Nan
persephone	persephone	Nan
phil	phil	Nan
phen	iṣẹlẹ	Nan
phe	ẹgbẹ	Nan
phay	milling	Nan
pharaon	arabinrin	Nan
pharaoh	farao	Nan
phaolô	pọ́ọ̀lù	Nan
phao	omi	None
phanh	idasilẹ	Nan
nỗ	igbiyanju	Nan
pham	pham	Nan
pha	dapọ	Nan
pgđ	pgđ	Nan
pgs	pgs	Nan
pfm	pfm	Nan
petersburg	petersburg	Nan
peters	awọn alagbẹdẹ	Nan
peru	peru	Nan
persian	aṣa	Nan
pershing	tẹpẹlẹ	Nan
phaethon	phaethon	Nan
phò	phò	Nan
nổi	lilefoofo	Nan
nồng	gbona	Nan
non	odo	Nan
nom	rárá	Nan
nol	ko	None
nokia	nokia	Nan
noi	sọ	None
noel	eeṣe	Nan
nobita	nobita	Nan
nobel	ẹyẹ	Nan
noah	rárá	Nan
nm	nm	Nan
nlf	nlf	Nan
nj	nj	Nan
niệu	diuresis	Nan
niệm	mindfulness	Nan
niềm	idunnu	Nan
niết	niet	Nan
niên	ọdun	Nan
nixon	nixon	Nan
nitơ	nitrogen	Nan
nonpenetrative	alaibọwọ	Nan
nippon	nippon	Nan
norfolk	norfolk	Nan
norma	norma	Nan
nuốt	gbe	None
nuối	gbe	None
nuôi	ifunni	Nan
nusa	nusa	Nan
nupedia	nupedia	Nan
number	nọmba	Nan
nubia	nubia	Nan
nst	nt	Nan
nsnd	nsnd	Nan
noãn	ẹyin	Nan
nowc	bayi	None
now	bayi	None
novak	novak	Nan
nou	éù	Nan
norway	norway	Nan
norton	àríwá	Nan
northrop	guusu	None
normandie	normandie	Nan
norman	arabinrin	Nan
norge	norge	Nan
nuớc	omi	None
nintendo	aderindona	Nan
nin	ẹni	Nan
nhủ	awọn olurannileti	Nan
nhục	idojuti	Nan
nhụ	fun	None
nhở	ran leti	Nan
nhờn	ọra-wara	Nan
nhờ	o ṣeun	Nan
nhớt	viscous	Nan
nhớ	lokan	Nan
nhộn	panilerin	Nan
nhổ	fa	Nan
nhồi	sitofudi	Nan
nhốt	tiipa	Nan
nhỏ|tượng	kekere	None
nhỏ|trái|px|máy	kekere	None
nhỏ|quân	agbara	None
nhỏ|px|phải|kiến	kekere	None
nhỏ|px|các	kekere	None
nhỏ|px|	kekere	None
nhỏ|phải|px|quân	agbara	None
nhức	irora	Nan
ninh	aabo	Nan
nhứt	akoko	Nan
những	iwọnyi	Nan
nimitz	nimitz	Nan
nile	nile	Nan
nil	nil	Nan
nikolayevich	nikolayevich	Nan
nikolai	nikolai	Nan
nikko	nikko	Nan
nikita	nikita	Nan
niken	nickel	Nan
nikel	nikel	Nan
nigeria	nigeria	Nan
niels	niels	Nan
nicolas	nicolas	Nan
niccolò	niccolò	Nan
nicaragua	nicaragua	Nan
nicaea	nicaea	Nan
nia	nia	Nan
ni	ni	Nan
nhựt	nhut	Nan
nhựa	ṣiṣu	Nan
nhừ	mushy	Nan
nxb	nxb	Nan
nynorsk	ọya	Nan
nà	nà	Nan
nắng	sun	None
nắm	dimu	Nan
nập	gbona	Nan
nậm	nam	Nan
nẫu	n oorun	Nan
nẩy	bouncing	Nan
nầy	eyi	Nan
nần	ihoho	Nan
nấy	eyi	Nan
nấu	alase	Nan
nấp	tọju	Nan
nấc	hiccup	Nan
nảy	bouncing	Nan
nản	ailera	Nan
nạp	ti kojọpọ	Nan
nạo	iwosan	None
nạn	ipọnju	Nan
nại	kerora	Nan
nạc	tẹ si apakan	Nan
nắp	ideri	Nan
nạ	iboju	Nan
nằm	parọ	Nan
nặc	ailorukọ	Nan
nồm	nape	Nan
nồi	ikoko	Nan
nốt	akiyesi	Nan
nối	ti sopọ	Nan
nỏ	oriki	None
nọc	sun	None
nọ	ekeji	None
nịnh	pẹlẹbẹ	Nan
nỉ	ro	None
nện	iwon	Nan
nể	ọwọ	Nan
nề	masonry	Nan
nếu	ti o ba ti	Nan
nếp	alalepo	Nan
nến	abẹla	Nan
nếm	itọwo	Nan
nẻo	omiiran	Nan
nặng	wuwo	Nan
nặn	fun	None
nẵng	nang	Nan
nǎm	nǎm	Nan
nướng	ti ibeere	Nan
nước	orilẹ-ede	Nan
nê	ne	Nan
nét	ọfun	Nan
nén	fisinuirindigbindigbin	Nan
ném	jabọ	Nan
né	jiji	Nan
não	ọpọlọ	Nan
nã	nã	Nan
nâu	brown	Nan
nâng	gbega	Nan
náu	tọju	Nan
nát	itemole	Nan
náo	ariwo	Nan
nách	apa	Nan
ná	ná	Nan
này	eyi	Nan
nào	kọja siwaju	Nan
nành	soyi	Nan
nàn	rojọ	Nan
nài	ku	None
nên	elegboye	Nan
nêu	sọ	None
nòi	ije	None
nòng	agba	None
nước	orilẹ-ede	Nan
nơtrino	neutino	Nan
nơi	ibi	Nan
năng	agbara	None
năn	ronupiwada	Nan
năm	ọdun	Nan
nút	sorapo	Nan
núp	tọju	Nan
núm	koko	Nan
nổ	awọn ibẹjadi	Nan
nùng	itanna	Nan
nông	aijinile	Nan
nôn	eebi	Nan
nôm	nm	Nan
nôi	ogun	None
nôbita	tobita	Nan
nô	ẹrú	Nan
nóng	gbona	Nan
nón	ijanilaya	Nan
nói	lati sọrọ	Nan
nõn	peeli	Nan
mũi	imu	Nan
sập	subu	Nan
sắn	ẹyẹ	Nan
wright	wuyi	Nan
wrestling	ijakadi	None
would	yoo	None
woods	igi	Nan
woodrow	igi igi	Nan
wong	wong	Nan
won	bori	Nan
wolfgang	wolfgang	Nan
without	laisi	Nan
within	laarin	None
wisconsin	ologbon	Nan
winer	ajagun	None
windows	windows	Nan
wimbledon	wimbledon	Nan
willard	ọwọn	Nan
wiley	wiley	Nan
wilder	oluṣọ	Nan
wild	egan	Nan
wikitravel	wikitravel	Nan
wu	wu	Nan
wikimedia	wikimedia	Nan
wushu	wushu	Nan
xa	jinna	Nan
xiềng	awọn abẹfẹlẹ	Nan
xiết	fẹẹrẹ	Nan
xiếc	circle	Nan
xiêu	xiao	Nan
xiên	slant	Nan
xiêm	siamese	Nan
xiv	xiv	None
xinh	lẹwa	Nan
xin	jowo	Nan
xiii	xiii	Nan
xi	xi	Nan
xhcn	xhcn	Nan
xen	xen	Nan
xem	wo	Nan
xe	ọkọ ayọkẹlẹ	Nan
xay	lọ	Nan
xao	flabby	Nan
xanh	bulu	Nan
xang	xang	Nan
wwf	wwf	Nan
xo	xo	Nan
wikimapia	wikimapia	Nan
wikia	wikia	Nan
watergate	pẹtẹlẹ	Nan
wat	wo	Nan
washington	aṣọ iwẹ	Nan
warszawa	warszawa	Nan
warsaw	warsaw	Nan
warren	warren	Nan
wanna	fẹ	Nan
wankel	wankel	Nan
wang	wanj	Nan
wan	wan	Nan
walther	amuwa	Nan
walter	walter	Nan
walt	walt	Nan
wa	wa	Nan
w	w	Nan
vỹ	nitorinaa	Nan
vựng	fokabulari	Nan
vực	pápá	Nan
vững	iduroṣinṣin	Nan
waterloo	waterloo	Nan
wikibooks	wikibooks	Nan
waters	omi	None
wcdma	wcdma	Nan
wiki	wiki	Nan
wifi	wifi	Nan
wiener	wiener	Nan
wien	wi	Nan
widener	ẹrọ ailorukọ	Nan
wheeler	wheeler	Nan
westview	iwo oorun	Nan
westlife	iwọ oorun	Nan
western	iwọ oorun	Nan
westermarck	westermarck	Nan
werner	werner	Nan
wembley	ara ẹni	Nan
welsh	àwæn	Nan
wells	kanga	Nan
wellington	alafia	Nan
weimar	weimar	Nan
webmail	adirẹsi wẹẹbu	Nan
weblog	wẹẹbu	Nan
weasley	weasley	Nan
wayne	ọna	Nan
vừng	sesame	Nan
xoa	bi won ninu	Nan
xong	ṣẹ	Nan
xăng	petirolu	Nan
xăm	tatuu	Nan
xúi	jeki	Nan
xúc	kan	None
xú	arínifín	Nan
xù	ruffled	Nan
xôviết	igbimo sofieti	Nan
xôphần	apakan garawa	Nan
xông	sare	Nan
xôn	aruwo	Nan
xôi	alalepo alalepo	Nan
xô	gbon	Nan
xót	aanu	None
xóm	aladugbo	Nan
xói	ogbara	Nan
xóa	nu	None
xòe	itankale	Nan
xíu	kekere	None
xít	itankalẹ	Nan
xơ	okun	Nan
xí	ile ise	Nan
xưa	atijọ	Nan
xương	eegun	Nan
xốp	onigbọwọ	Nan
xốc	iyalẹnu	Nan
xỉu	suuru	Nan
xỉa	floss	Nan
xỉ	slag	Nan
xếp	ti ṣe pọ	Nan
xẻo	alailoriire	Nan
xắt	ṣẹ	Nan
xẩy	waye	Nan
xẩm	shaggy	Nan
xấu	buburu	Nan
xấp	feleto	Nan
xảy	waye	Nan
xảo	arekereke	Nan
xả	yo kuro	Nan
xạ	itu	None
xưởng	idanileko	Nan
xướng	egbe	None
xước	rirun	Nan
xưng	jẹwọ	Nan
xoay	yiyi	Nan
xìu	fart	Nan
xêkô	suneo	Nan
xuồng	oko	None
xuống	silẹ	Nan
xuấtnhập	okeere-gbe wọle	Nan
xuất	okeere	None
xuôi	gbo-nu	Nan
xuâncông	omi	None
xuân	omi	None
xuyến	egbaowo	Nan
xuyên	lilu	Nan
xum	adun	Nan
xuka	xuka	Nan
xui	alailoriire	Nan
xuan	xuan	Nan
xua	tuka	Nan
xu	owó	Nan
xoắn	yiyi	Nan
xoáy	eddy	Nan
xoá	paarẹ	Nan
xoàng	agbedemeji	Nan
xv	xv	Nan
xì	fart	Nan
xvi	xvi	Nan
xx	xx	Nan
xê	gbe	None
xét	ronu	Nan
xéo	ẹgbẹ	Nan
xén	cropping	Nan
xé	yiya	Nan
xèo	xèo	Nan
xãy	ẹlẹsẹ	Nan
xã	kọ́kọ́rọ́	Nan
xây	kọ	Nan
xâu	okun	Nan
xâm	tatuu	Nan
xát	fifi pa	Nan
xáo	rudurudu	Nan
xán	dín	Nan
xám	grey	Nan
xách	apamowo	Nan
xào	din-din	Nan
xài	na	Nan
xy	xy	Nan
xvii	xvii	Nan
vừa	ibaamu	Nan
vứt	ju danu	Nan
vụng	pagunpagun	Nan
voyager	ajo	None
vong	farapa	Nan
vonfram	tungsten	Nan
von	von	Nan
voldemort	voldemort	Nan
voip	voip	Nan
voi	erin	Nan
vo	vo	Nan
vni	vni	Nan
vnexpress	vnexpress	Nan
vn	vn	Nan
việttrung	viettrung	Nan
việtnga	vietnga	Nan
việtmường	muong vietnamese	Nan
việt	vietnam	Nan
viện	institute	Nan
việc	iṣẹ	Nan
viết	kọ	Nan
viếng	ṣàbẹwò	Nan
voọc	awọn ile	Nan
viêt	kikọ	Nan
vtc	vtc	Nan
vua	ọba	Nan
váng	itanjẹ	Nan
ván	plank	Nan
vái	bẹẹni	Nan
vách	ogiri	Nan
vác	rù	Nan
vá	abulẹ	Nan
vào	sinu	Nan
vành	rim	Nan
vàng	odo	Nan
vàm	vm	Nan
vài	diẹ	Nan
và	ati	Nan
vyacheslav	vyacheslav	Nan
vy	vy	Nan
vv	abbl.	Nan
vuốt	tapa	Nan
vuông	square	Nan
vulcan	àbuku	Nan
vui	igbadun	Nan
vu	vu	Nan
váy	aṣọ	Nan
viêng	eré	Nan
viêm	igbona	Nan
vienna	vienna	Nan
victoria	iṣẹgun	Nan
victor	segun	Nan
viagra	viagra	Nan
vi	nitori	Nan
vhs	vhs	Nan
versailles	wapọ	Nan
verona	verona	Nan
vermont	vermont	None
verdun	verdun	Nan
venus	ẹṣẹ	Nan
venezia	venezia	Nan
vendôme	vendôme	Nan
ven	pẹlú	Nan
vectơ	fekito	Nan
vay	yawo	Nan
vasari	vasari	Nan
vargas	vargas	Nan
vanessa	vanessa	Nan
viet	viet	Nan
viên	awọn tabulẹti	Nan
vietnam	vietnam	Nan
viii	viii	Nan
viz	viz	Nan
vitruvius	fitila	Nan
vitamin	ajira	Nan
vista	vista	Nan
vissarionovich	vissarionovich	Nan
virút	àrùn	None
virus	àrùn	None
virginia	wundia	Nan
viqr	viqr	Nan
vinpearl	vinpearl	Nan
vincent	vincent	Nan
vincennes	vincennes	Nan
vince	vince	Nan
vinashin	vinashin	Nan
vinagame	vinagame	Nan
villeneuve	villeneuve	Nan
villa	villa	None
viking	viking	Nan
vijaya	vijaya	Nan
viettel	viettel	Nan
vân	bẹbẹ lọ	Nan
vây	pari	Nan
vã	sare	Nan
vẹt	awọn parrots	Nan
vẹn	iduroṣinṣin	Nan
vặt	awọn kilasika	Nan
vặn	dabaru	Nan
vắng	isansa	Nan
vắn	kukuru	Nan
vắcxin	ajesara	Nan
vắc	ajesara	Nan
vận	ọrọ	Nan
vẫy	waving	Nan
vẫn	tun	Nan
vẩy	awọn flakes	Nan
vẩn	tun	Nan
vầng	halo	Nan
vần	rhyme	Nan
vất	ju danu	Nan
vấp	pariwo	Nan
vấn	imọran	Nan
vảy	irẹjẹ	Nan
vẽ	kikun	Nan
vải	aṣọ	Nan
vết	abulẹ	Nan
vệ	olugbeja	Nan
vụn	awọn eerun	Nan
vợ	iyawo	None
vỡ	fifọ	Nan
vở	ajako	Nan
vời	nla	Nan
vờ	dibọn	Nan
vớt	ẹja	Nan
với	pẹlu	Nan
vớ	ibọsẹ	Nan
vội	yiyara	Nan
vỗ	pat	Nan
vồ	maul	Nan
vỏ	epo igi	Nan
vọt	agekuru	Nan
vọng	ireti	Nan
vịt	pepeye	Nan
vịnh	bay	Nan
vỉa	awọn seams	Nan
vệt	ṣiṣan	Nan
vểnh	perch	Nan
vả	eeya	Nan
vạng	alẹ́	Nan
vạn	egberun mewa	Nan
võ	ogun	None
vôi	orombo wewe	Nan
vô	rárá	Nan
vóc	iwọn	Nan
vó	hoooo	Nan
vòng	òrùka	Nan
vòm	orule	Nan
vòi	iho okun	Nan
vò	isubu	Nan
vít	dabaru	Nan
vía	apamọwọ	Nan
ví	apamọwọ	Nan
vì	nitori	Nan
vê	nipa	Nan
vét	àgbọn	Nan
vé	tiketi	Nan
vè	tọ	Nan
vãn	fani	Nan
vãi	nik	Nan
võng	akùn	Nan
vùi	sin	Nan
vùng	ẹkùn	Nan
vú	igbaya	Nan
vại	idẹ	Nan
vạch	pẹpẹ	Nan
vạc	ẹyẹ	Nan
vạ	nitorinaa	Nan
vượt	rekoja	Nan
vượn	awọn ẹwẹ	Nan
vườn	ọgba	Nan
vướng	tẹmọlẹ	Nan
vương	ọba	Nan
xổ	ẹyẹ	Nan
vươn	de ọdọ	Nan
vơi	pẹlu	Nan
vơ	ainiagbara	Nan
vũng	ìwúwo	Nan
vũ	vu	Nan
vĩnh	titilai	Nan
vĩ	nla	Nan
văng	asesejade	Nan
văn	litireso	Nan
vút	soaring	Nan
vưu	vưu	Nan
xộn	idoti	Nan
xứ	ilẹ	None
xứng	yẹ	Nan
đẩy	lati titari	Nan
đẩu	ori	None
đầy	kun	Nan
đầu	ori	None
đần	adití	Nan
đầm	aṣọ	Nan
đấy	ní	None
đấtmặt	ilẹ	None
đất	ilẹ	None
đấng	ọlọrun	Nan
đấm	lati pọn	Nan
đảo	erekusu	Nan
đảng	ẹgbẹ	Nan
đản	ojo	None
đảm	iṣeduro	Nan
đả	awọn ija	Nan
đạt	de ọdọ	Nan
đạp	keke	Nan
đạo	ẹsin	Nan
đẫm	ti nda	Nan
đạn	ọta ibọn	Nan
đậm	dudu	Nan
đậy	ideri	Nan
để	sí	Nan
đều	jẹ	Nan
đền	tẹmpili	Nan
đề	awon	Nan
đến	wá	Nan
đếm	ka	Nan
đế	soles	Nan
đẽ	dara	Nan
đẹp	lẹwa	Nan
đặn	deede	Nan
đặc	pataki	Nan
đẳng	kilasi	Nan
đằng	lori	Nan
đắt	gbowolori	Nan
đắp	sókè	Nan
đắng	kikoro	Nan
đắn	titọ	Nan
đắm	bajẹ	Nan
đắc	jere	Nan
đậu	ìrísí	Nan
đệm	aga timutimu	Nan
đạm	amuaradagba	Nan
đạ	da	None
đói	ebi	None
đóa	nah	Nan
đó	ní	None
đòn	fẹ	Nan
đòi	beere	Nan
đò	ferry	Nan
đính	somọ	Nan
đích	ajo	None
đênh	mura silẹ	Nan
đêm	alẹ	Nan
đê	ohun mimu	Nan
đèo	rekoja	Nan
đèn	atupa	Nan
đè	iṣuju	Nan
đãng	adẹtẹ	Nan
đãi	tọju	Nan
đã	ti tẹlẹ	Nan
đây	nibi	Nan
đâu	nibo	Nan
đón	gbe	None
đại	nla	Nan
đôi	ilọpo meji	Nan
đôn	àtẹ	Nan
được	o dara	Nan
đường	opopona	Nan
đưa	rekoja	Nan
đơ	sinmi	Nan
đĩa	awo	None
đĩ	yiyọ	Nan
đăk	dak	Nan
đút	fi	None
đúp	ilọpo meji	Nan
đúng	o tọ	Nan
đúc	simẹnti	Nan
đùi	abo	None
đùa	awada	Nan
đôrêmon	doraemoni	Nan
đôrêmi	doraemon	Nan
đôngtây	ìha ìla-õrùn	Nan
đôngnam	guusu	None
đôngbắc	àríwá	Nan
đông	idẹ	Nan
đôla	dọla	Nan
đỉnh	oke	Nan
địch	ọtá	Nan
định	pàtó	Nan
ẩn	tọju	Nan
ẩm	loworo	Nan
ấy	iyẹn	Nan
ấu	odo	Nan
ấp	ọdẹdẹ	Nan
ấnâu	tẹjade	Nan
ấn	tẹ	Nan
ấm	loworo	Nan
ảnh	aworan	Nan
ải	i	Nan
ạt	adie	Nan
ạ	sir	Nan
ướt	ririn	Nan
ướp	ti gbona	Nan
ương	aarin	Nan
ươm	nọsìrì	Nan
ươi	orang	Nan
ưu	aleebu	Nan
ưng	beeni	Nan
ập	bangi	Nan
ưa	fẹran	Nan
ắt	daju	Nan
ỏi	mint	Nan
ứng	ohun elo	Nan
ức	igbaya	Nan
ứ	bẹẹni	Nan
ủy	igbimọ	Nan
ủng	orunkun	Nan
ủi	irin	Nan
ủ	abẹrẹ	Nan
ở	ninu	Nan
ớt	chili	Nan
ớn	nla	Nan
ổn	ó	None
ổi	guava	Nan
ổ	wakọ	Nan
ồn	ariwo	Nan
ốp	tangent	Nan
ống	tube	Nan
ốm	arun	None
ốc	igbin	Nan
ố	ooh	Nan
ếch	kan	None
ư	u	Nan
ơn	o ṣeun	Nan
ơi	ooo	Nan
đỗ	gbesile	Nan
đổng	dong	Nan
đổi	yipada	None
đổ	tú	None
đồng	bàbà	Nan
đồn	iró	Nan
đồi	òkè	Nan
đồ	ohun	Nan
đốt	sisun	Nan
đống	opoplopo	Nan
đốn	gige mọlẹ	Nan
đốm	iranran	Nan
đối	fun	None
đốc	gomina	None
đỏ	pupa	None
đọng	alaigbọran	Nan
đọc	ka	Nan
đọan	ìpínrọ̀	Nan
đọ	gba	None
độ	ìyí	Nan
độc	majele	Nan
độn	ti wa ninu	Nan
động	ìmúdàgba	Nan
ơ	ah	Nan
ĩ	ah	Nan
đựoc	o dara	Nan
đựng	ni	Nan
đực	akọ	Nan
đừng	ko	None
đứt	fifọ	Nan
đứng	duro	Nan
đức	rere	None
đâm	iduro	Nan
đứa	ọmọ	None
đụng	fọwọkan	Nan
đụn	awọn ẹwa	Nan
đục	akomo	Nan
đợt	ipele	None
đợi	duro de	Nan
đỡ	atilẹyin	Nan
đời	igbesi aye	Nan
đới	ifa	Nan
đột	lojiji	Nan
đủ	to	None
van	àtọwọdá	Nan
đát	ilẹ	None
đáo	alailẹgbẹ	Nan
|việt	| vietnamese	Nan
|tên	| orukọ	Nan
|petya	| petya	Nan
|nổi	| floats	Nan
|nguyễn	| nguyen	Nan
zürich	zürich	Nan
zurich	zurich	Nan
zoe	zoe	Nan
zing	zingari	Nan
zinedine	zinedine	Nan
zimbabwe	zimbabwe	Nan
zhukmse	zhukmse	Nan
zheng	zheng	Nan
zeus	zeus	Nan
zero	odo	Nan
zedong	zedong	Nan
zealand	hẹlandia	Nan
zambia	zambani	Nan
zac	zac	Nan
kg	kg	Nan
z	z	Nan
triệu	million	Nan
°đến	° à	Nan
êgê	ego	Nan
ép	fun	None
én	mì	Nan
ân	ojurere	Nan
âm	iyokuro	Nan
â	â	Nan
áâu	aoi	Nan
áp	titẹ	Nan
áohung	aohungg	Nan
áo	seeti	Nan
ánh	ipẹẹrẹ	Nan
ám	renders	Nan
ái	ifẹkufẹ	Nan
ách	ajaga	Nan
ác	ibi	Nan
á	esia	None
ào	iro ohun	Nan
×	×	Nan
°độ	° iwọn	Nan
°c	° c	Nan
êm	dan	Nan
yểu	ẹlẹwa	Nan
yểm	ideri	Nan
yomiuri	yomiuri	Nan
yo	yo	Nan
ymca	ymca	Nan
ying	ying	Nan
yi	yi	Nan
yersin	yersin	Nan
yemen	yemen	Nan
yeltsin	yeltsin	Nan
yeeun	yeun	Nan
yasha	yasha	Nan
yard	àgbàlá	Nan
yankee	yan	None
yalta	yalta	Nan
yakushima	yakushima	Nan
yakovlev	yakovlev	Nan
ya	ya	Nan
y=fracsin	y = fracsin	Nan
y	y	Nan
xử	tọju	Nan
yoochun	yoochun	Nan
yển	bẹẹni	Nan
york	york	None
yorkshire	wara-wara	Nan
yếu	ailera	Nan
yết	kikojọ	Nan
yến	ẹyẹ	Nan
yếm	coveralls	Nan
yêu	lati feran	Nan
yên	yen	Nan
yurt	yurt	Nan
yuri	yuri	Nan
yunho	yunho	Nan
yume	yume	Nan
yukito	yukito	Nan
yugi	yugi	Nan
yudhoyono	yudhoyono	Nan
yucatán	yucatán	Nan
yuan	iwin	Nan
yu	yu	Nan
ytv	ytv	Nan
ypres	ypres	Nan
youtube	youtube	Nan
yorker	alagbẹdẹ	Nan
ích	wulo	Nan
ílam	ílam	Nan
ít	diẹ	Nan
đoàn	ẹgbẹ	Nan
đoài	mango	None
đom	igbona	Nan
đoan	ẹgbẹ	Nan
đoa	doa	Nan
đo	ìwọn	Nan
điệu	ohun orin	Nan
điệp	ifiranṣẹ	Nan
điểu	fokii	Nan
điển	itumọ	Nan
điểm	ojuami	Nan
điều	ohun	Nan
điền	kun	Nan
điềm	ami	Nan
điếu	siga	Nan
điếc	adití	Nan
điạ	dạ	Nan
điôxít	itọsi	Nan
điêu	ohun	Nan
đoái	paṣipaarọ	Nan
điên	irikuri	Nan
đoạn	ìpínrọ̀	Nan
đtđ	foonu alagbeka	Nan
đáng	tọ	Nan
đán	dan	Nan
đám	ẹgbẹ	Nan
đái	pee	Nan
đá	apata	Nan
đày	igbekun	Nan
đào	ma wà	Nan
đàng	bẹẹni	Nan
đàn	agbo	Nan
đàm	awọn ijiroro	Nan
đài	redio	Nan
đuổi	lepa	Nan
đuống	yio	None
đuối	riran	Nan
đuốc	ògùṣọ	Nan
đuôi	iru	Nan
đun	igbona	Nan
đui	afoju	Nan
đua	ije	None
đt	tẹli	Nan
đi	lọ	Nan
đhông	ila-oorun	Nan
đhtm	dhtm	Nan
ôzôn	osonu	Nan
ôxít	ohun elo afẹfẹ	Nan
ôxy	atẹgun	Nan
ôxi	atẹgun	Nan
ôtô	ọkọ ayọkẹlẹ	Nan
ông	oun	None
ôn	iwọntunwọnsi	Nan
ôm	famọra	Nan
ôi	ah	Nan
óng	ẹnu ọna	Nan
óc	ọpọlọ	Nan
ó	ó	None
ðức	jẹmánì	Nan
ðảng	ẹgbẹ	Nan
ðường	suga	Nan
ðài	ài	Nan
ðiều	nkan	None
îledefrance	apanilẹrin	Nan
île	île	Nan
ùn	ìfípáda	Nan
úng	ẹlẹgbẹ	Nan
úp	dojukọ isalẹ	Nan
úy	lieutenant	Nan
đhcn	cn	Nan
đh	h	Nan
đeo	wọ	Nan
đentrắng	dudu ati funfun	Nan
đen	dudu	Nan
đem	mu	Nan
đe	anvil	Nan
đcsvn	dcsvn	Nan
đcstq	dcstq	Nan
đáp	idahun	Nan
đb	db	Nan
đau	irora	Nan
đan	aso	Nan
đak	dak	Nan
đai	ẹgbẹ	Nan
đa	ọpọlọpọ	Nan
ăngten	eriali	Nan
ăng	kokoro	Nan
ăn	jẹ	Nan
ý	ilu italia	Nan
đay	ẹiyẹ	Nan
sắm	ohun tio wa	Nan
valley	afonifoji	Nan
valencia	valencia	Nan
thập	rekọja	Nan
thận	àrùn	None
thẫm	dudu	Nan
thẩm	awọn jurors	Nan
thầy	olukọ	Nan
thần	ọlọrun	Nan
thầm	ipalọlọ	Nan
thấu	onihun	Nan
thấp	kukuru	Nan
thảo	lẹwa	Nan
thản	serene	Nan
thảm	capeti	Nan
thải	egbin	Nan
thả	silẹ	Nan
thạo	iwé	Nan
thạnh	jù	Nan
thạch	jelly	Nan
thạc	ọga	Nan
thượng	loke	Nan
thật	gidi	Nan
thược	ojiji	Nan
thắm	petal	Nan
thắng	bori	Nan
thọ	gigun	Nan
thịt	eran	Nan
thịnh	fojusi	Nan
thỉnh	fiwepe	Nan
thể	jẹ	Nan
thềm	pẹpẹ	Nan
thề	bura	Nan
thếp	irin	Nan
thế	nitorinaa	Nan
thẻ	kaadi	Nan
thẹn	tiju	Nan
thặng	ajeseku	Nan
thẳng	taara	Nan
thẳm	jinjin	Nan
thằng	guy	Nan
thằn	alangba	Nan
thắt	di soke	Nan
thắp	ina	Nan
thắngthua	bori	Nan
thắn	sọ	None
thọc	jab	Nan
thưởng	ère	Nan
thước	adarí	Nan
thìa	sibi	Nan
thêu	yiyalo	Nan
thêm	diẹ sii	Nan
thê	awọn	Nan
thét	pariwo	Nan
thép	irin	Nan
thèm	ifẹ	Nan
thãi	nik	Nan
thây	wo	Nan
thâu	taped	Nan
thâm	jinjin	Nan
tháp	ile-iṣọ	Nan
tháo	yọ	None
thánh	st	Nan
tháng	osù	Nan
thám	otelemuye	Nan
thái	thai	Nan
thách	ipenija	Nan
thác	kasikedi	Nan
thìn	lẹhinna	Nan
thường	nigbagbogbo	Nan
thình	lojiji	Nan
thít	ikere	Nan
thương	ni ife	Nan
thưa	ololufe	Nan
thư	awọn lẹta	Nan
thơm	oorun aladun	Nan
thăng	ni igbega	Nan
thăm	ṣàbẹwò	Nan
thúy	thuy	Nan
thúc	ipari	Nan
thú	awon	Nan
thùy	lobe	Nan
thùng	binrin	Nan
thù	ariyanjiyan	Nan
thông	fun	None
thôi	kọja siwaju	Nan
thô	ti o ni inira	Nan
thói	ihuwasi	Nan
thóc	paddy	Nan
thòi	alailanfani	Nan
thò	mu	Nan
thí	awọn adanwo	Nan
thày	olukọ	Nan
thỏ	ehoro	Nan
thỏi	ọmọ	None
tncs	tnc	Nan
tiệt	oniho	Nan
tiệp	czech	Nan
tiện	rọrun	Nan
tiệm	ṣọọbu	Nan
tiệc	àse	Nan
tiễu	ogbeni liu	Nan
tiểu	tọ	Nan
tiều	nik	Nan
tiền	owo	Nan
tiềm	agbara	None
tiếu	goofy	Nan
tiết	yomijade	Nan
tiếng	ede	None
tiến	sókè	Nan
tiếm	goofy	Nan
tiếc	banujẹ	Nan
tiêu	ata	Nan
tiên	akoko	Nan
tngt	tngt	Nan
tizard	eeyan	Nan
tnhh	lopin	Nan
tobago	tobago	Nan
toàn	lailewu	Nan
toà	kootu	Nan
toyota	toyota	Nan
toyama	toyama	Nan
tourist	oniriajo	Nan
tourism	irin-ajo	Nan
tottenham	t tottenham	Nan
toriyama	toriyama	Nan
torino	torino	Nan
top	oke	Nan
toonami	toonami	Nan
tony	ikan	None
tomoyo	tomoyo	Nan
tommy	tommy	Nan
tomas	ibi isere	Nan
tokyopop	tokyopop	Nan
tokyo	tokyo	None
tokugawa	tokugawa	Nan
toei	àe	Nan
toang	toang	Nan
thỏa	àdéhùn	Nan
tivi	tẹlifisiọnu	Nan
tish	tish	Nan
thừng	okun	Nan
thừa	airiṣẹṣe	Nan
thức	ji	Nan
thứ	ohun	Nan
thủng	iyọnu	Nan
thủa	thua	Nan
thủ	nomba	Nan
thụt	indented	Nan
thục	shu	Nan
thụ	olugba	Nan
thợ	oṣiṣẹ	Nan
thở	ìmí	Nan
thời	aago	Nan
thớt	igbimọ gige	Nan
thổi	fẹ	Nan
thổ	ile aye	Nan
thồ	idii	Nan
thốt	fọhùn	Nan
thối	ru	Nan
thử	lati gbiyanju lori	Nan
tissa	tissa	Nan
thửa	ile	Nan
thực	gidi	Nan
tisdale	tisdale	Nan
tirol	tirol	Nan
tinthị	tinthị	Nan
tinsông	awọn iroyin	Nan
tinnhà	tinhome	Nan
tinh	ile aye	Nan
tincầu	tinrin afara	Nan
tinbắc	ifiranṣẹ	Nan
tin	gbagbọ	Nan
timothy	timoti	Nan
timor	gẹẹsi	Nan
tim	obi	Nan
tiliaceus	tiliaceus	Nan
tigris	tigris	Nan
tibet	tibet	Nan
tiara	tiara	Nan
tiananmen	tiananmen	Nan
tia	eegun	Nan
ti	ti	Nan
thự	villa	None
thành	fort	Nan
thà	yoo	None
thy	tirẹ	Nan
tarim	tarim	Nan
tao	emi	Nan
tanzania	tanzania	Nan
tankōbon	ojò	Nan
tanh	ẹja	Nan
tang	ṣọfọ	Nan
tanaka	tanaka	Nan
tamoxifen	tamoxifen	Nan
tam	àm	Nan
talmud	talmud	Nan
taliban	taliban	Nan
tali	tali	Nan
taklamakan	taklamakan	Nan
takahashi	takahashi	Nan
tajiri	tajiri	Nan
tajima	tajima	Nan
tajikistan	tajikistan	Nan
taj	taj	Nan
taiwan	taiwan	Nan
task	iṣẹ-ṣiṣe	Nan
taipei	taipei	Nan
tasman	tasman	Nan
tau	tau	Nan
tenxơ	cartel	Nan
temur	temur	Nan
temujin	temujin	Nan
temple	tẹmpili	Nan
tem	ontẹ	Nan
telnet	telnet	Nan
telex	telex	Nan
telekom	telekom	Nan
telecom	tẹlifoonu	Nan
teddy	ohun kikọ	Nan
ted	ted	Nan
technical	imọ ẹrọ	Nan
tcp	tcp	Nan
tcm	tcm	Nan
tchad	tchad	Nan
tbt	tbt	Nan
taylor	taylor	Nan
tay	ọwọ	Nan
taxi	takisi	Nan
tasmania	tasmania	Nan
teo	eeyan	Nan
taiji	taiji	Nan
tag	samisi	Nan
sờ	fọwọkan	Nan
sớm	laipẹ	Nan
sớ	yoo	None
sổ	iwe	Nan
sồi	igi oaku	Nan
sốt	ibà	Nan
sống	ngbe	Nan
sốc	derubami	Nan
số	nọmba	Nan
sỏi	okuta	Nan
sỏ	ibusọ	Nan
sọc	ìna	Nan
sọ	timole	Nan
sẽ	yoo	None
sẻ	yoo	None
sẹo	aleebu	Nan
sẵn	wa	Nan
sắt	iron	Nan
sắp	fẹẹrẹ	Nan
sỡ	padanu	Nan
tai	eti	Nan
sợ	bẹru	Nan
sục	jacuzzi	Nan
tae	èè	Nan
ta	á	Nan
sự	awọn	Nan
sữa	wara	Nan
sửu	omi	None
sửng	derubami	Nan
sửa	tunṣe	Nan
sử	itan	Nan
sừng	iwo	Nan
sứt	chiki	Nan
sức	okun	Nan
sứa	jellyfish	Nan
sứ	seramiki	Nan
sủng	iwunilori	Nan
sủi	alailowaya	Nan
sủa	epo igi	Nan
sụt	slump	Nan
sụp	subu	Nan
sụn	kerekere	Nan
sợi	yarns	Nan
terengganu	terengganu	Nan
territories	awọn agbegbe	Nan
terry	ilẹkun	Nan
thpt	thpt	Nan
thoắt	tọ	Nan
thoảng	lẹẹkọọkan	Nan
thoải	itunu	Nan
thoả	ibaṣowo	Nan
thoạt	ni akọkọ kokan	Nan
thoại	foonu	Nan
thoát	jade	Nan
thoáng	airi	Nan
thoán	gboju	Nan
thoái	regress	Nan
those	awon na	Nan
thong	thong	Nan
thompson	thompson	Nan
thomas	thomas	Nan
thoai	thoai	Nan
thoa	dab	Nan
tho	tho	Nan
thiệu	ifihan	Nan
thriller	asaragaga	Nan
thiệt	looto	Nan
thskts	awọn eegun	Nan
thumb|các	atampako | awọn	Nan
thvn	thvn	Nan
thuỷ	thuy	Nan
thuỵ	thuy	Nan
thuở	ewe	None
thuờng	nigbagbogbo	Nan
thuớc	omi	None
thuộc	jẹ	Nan
thuốc	òògùn	Nan
thuế	owo-ori	Nan
thuật	aworan	Nan
thuận	aleebu	Nan
thuẫn	rogbodiyan	None
thuần	mimọ	Nan
thuê	lati yalo	Nan
thuyền	omi	None
thuyết	yii	Nan
thuyên	iyọkuro	Nan
thung	afonifoji	Nan
thunderbolt	ãra	Nan
thua	padanu	Nan
thiệp	kaadi	Nan
thiện	o dara	Nan
thiểu	kekere	None
thdq	thdq	Nan
thcs	awọn ọrọ	Nan
thcn	thcn	Nan
thay	dipo	Nan
thau	idẹ	Nan
thao	eré ìdárayá	Nan
thani	ju	Nan
thanh	pẹpẹ	Nan
thang	akaba	Nan
than	eedu	Nan
thames	thames	Nan
tham	okanjuwa	Nan
thailand	thailand	Nan
thai	loyun	Nan
tha	ikewo	Nan
tgv	tgv	Nan
texas	texas	Nan
tet	tet	Nan
terumbu	terumbu	Nan
thebes	thebes	Nan
their	wọn	None
them	wọn	None
then	lẹhinna	Nan
thiển	ṣafihan	Nan
thiền	iṣaro	Nan
thiềm	àrùn	None
thiếu	kukuru	Nan
thiết	ṣeto	Nan
thiếp	kaadi	Nan
thiến	alailoridan	Nan
thiếc	tin	Nan
thiêng	mimọ	Nan
toán	eko	None
thiêm	thiêm	Nan
third	kẹta	None
thien	ẹni	Nan
thich	fẹran	Nan
thi	ayewo	Nan
theseus	wọnyi	Nan
theres	awọn iṣan	Nan
theravada	theravada	Nan
theory	yii	Nan
theo	ni ibamu si awọn	Nan
thiu	stale	Nan
toát	o dara	Nan
toạ	ipoidojuko	Nan
toại	ni	Nan
tạm	ipese	Nan
tại	ninu	Nan
tạc	ere	Nan
tạ	barbell	Nan
tường	ogiri	Nan
tướng	gbogboogbo	Nan
tưới	agbe	Nan
tước	kọlu	Nan
tương	jọra	Nan
tươi	alabapade	Nan
tưng	gbọn	Nan
tư	lati	Nan
tơi	emi	Nan
tĩnh	aimi	Nan
tăng	pọ si	Nan
tăm	aṣọ ọṣẹ	Nan
tý	iwọn	Nan
túy	oogun	Nan
túp	ahere	Nan
tạo	ṣẹda	Nan
túng	iwuri	Nan
tạp	iwe irohin	Nan
tản	fifọ	Nan
tặc	olosa	Nan
tắt	paa	None
tắm	wẹ	Nan
tắc	yipada	None
tật	ailera	Nan
tận	ipari	Nan
tẩy	ìparun	Nan
tẩm	impregnated	Nan
tầu	ọkọ oju-irin	Nan
tầng	ilẹ	None
tần	igbohunsafẹfẹ	Nan
tầm	awọn ere	Nan
tấu	irinse	Nan
tất	ibọsẹ	Nan
tấp	fa	Nan
tấn	pupọ	Nan
tấm	sii farahan	Nan
tấc	inch	Nan
tảng	pẹpẹ	Nan
tả	ijuwe	Nan
tặng	ṣetọrẹ	Nan
túm	gbamu	Nan
túc	itelorun	Nan
tê	nitosi	None
tét	screech	Nan
tã	iledìí	Nan
tâynam	iwọ oorun	Nan
tây	iwọ oorun	Nan
tâu	oluwa mi	Nan
tâm	aarin	Nan
táu	ẹbi	Nan
táp	tẹ ni kia kia	Nan
tánh	ede	None
tán	ibori	None
tám	mẹjọ	Nan
tái	tun	Nan
tách	ife	Nan
tá	mejila	None
tàu	ọkọ oju-omi	Nan
tành	ede	None
tàng	ile ọnọ	Nan
tàn	ru	Nan
tên	orukọ	Nan
túi	apamowo	Nan
tì	olorun	Nan
tìmdiệt	wa	Nan
tùy	iyan	None
tùng	apoju	Nan
tù	ẹwọn	Nan
tông	paali	Nan
tôn	corrugated	Nan
tôm	ede	None
tôi	emi	Nan
tô	ekan	Nan
tóm	compendium	Nan
tòng	tong	Nan
tòi	nkan	None
tòa	kootu	Nan
tò	iwariiri	Nan
tít	akọle	Nan
tín	kirediti	Nan
tím	awọ aro	Nan
tích	ọja	Nan
tía	elese	Nan
tình	ni ife	Nan
tìm	wa	Nan
tẻ	drab	Nan
tết	tita	Nan
tếxã	ti ọrọ-aje	Nan
ural	éù	Nan
up	pipade	Nan
unix	unix	Nan
unit	ẹyọkan	Nan
unicorn	alailoye	Nan
ung	ru	Nan
unesco	unesco	Nan
under	labẹ	Nan
und	ati be be lo	Nan
un	un	Nan
umm	ìyá	Nan
ulsan	ulsan	Nan
ukraina	ukraina	Nan
ukiyoe	ukiyoe	Nan
uk	uk	Nan
uh	oh	Nan
uefa	uefa	Nan
uchiha	uchiha	Nan
uc	uc	Nan
urani	kẹmika	Nan
ubuntu	ubuntu	Nan
uri	uri	Nan
usagi	usagi	Nan
vai	ejika	Nan
vaccine	ajesara	Nan
va	va	Nan
v	v	Nan
uổng	jafara	Nan
uống	lati mu	Nan
uốn	curling	Nan
uất	uất	Nan
uông	uong	Nan
uzbekistan	uzbekistan	Nan
uyển	ẹba	Nan
uyên	uyen	Nan
uygur	uygur	Nan
uyghur	uyghur	Nan
uy	éù	Nan
utrecht	utrecht	Nan
utah	utah	None
uss	us	Nan
usb	usb	Nan
uruguay	urur	Nan
uae	uae	Nan
ua	éù	Nan
u	u	Nan
tồn	wa	Nan
tồi	buburu	Nan
tốt	o dara	Nan
tốp	ẹgbẹ	Nan
tống	ikọlu	Nan
tốn	iye owo	Nan
tốc	iyara	Nan
tỏi	ilẹ	None
tỏa	tan	Nan
tỏ	ti ṣalaye	Nan
tọa	ipoidojuko	Nan
tịch	alakoso	Nan
tị	ijowu	Nan
tỉnh	ti agbegbe ilu	Nan
tỉa	gige	Nan
tệp	faili	Nan
tệ	buburu	Nan
tể	arabinrin	Nan
tề	gba	None
tổn	farapa	Nan
tổng	lapapọ	Nan
tộc	idile	Nan
tội	ẹṣẹ	Nan
tỷ	bilili	Nan
tỵ	ejo	Nan
tựu	awọn aṣeyọri	Nan
tựa	akọle	Nan
tự	iho	Nan
tửu	oti ifarada	Nan
tử	iku	None
từng	lailai	Nan
từ	lati	Nan
tài	ọrọ	Nan
tức	lẹsẹkẹsẹ	Nan
tủi	buburu	Nan
tủ	awọn apoti ohun ọṣọ	Nan
tụy	ti oronro	Nan
tục	agabagebe	Nan
tởm	irira	Nan
tờ	dì	None
tới	itele	Nan
tớ	emi	Nan
tột	awọn iwọn	Nan
tủy	ọra	Nan
valentine	ololufe	Nan
tà	ibi	Nan
type	oriṣi	Nan
trò	ẹtan	Nan
trích	yọ	None
trí	lokan	Nan
trình	tẹriba	Nan
trên	loju	Nan
trèo	gun	None
trãi	tuka	Nan
trâu	ẹtu	Nan
trân	o dabo	Nan
trâm	pẹlẹbẹ	Nan
trát	atilẹyin	Nan
tráp	àpótí	Nan
tráo	arekereke	Nan
tránh	fun	None
tráng	ti a bo	Nan
trán	iwaju	Nan
trái	osi	Nan
trách	jẹbi	Nan
trác	trac	Nan
tròn	yika	Nan
trào	irukerudo	Nan
trói	ti di	Nan
trông	woni	Nan
trước	ṣaaju	Nan
trước	ṣaaju	Nan
trương	truong	Nan
trưngcông	han	Nan
trưng	ibeere	Nan
trưa	ọsan	Nan
trư	tru	Nan
trơn	tẹẹrẹ	Nan
trơ	inert	Nan
trũng	sun	None
trĩ	ida ẹjẹ	Nan
trăng	osupa	Nan
trăn	python	Nan
trăm	ọgọrun	Nan
trúc	oparun	Nan
trú	wiwọ	Nan
trùy	truy	Nan
trùng	konge	Nan
trùm	ọga	Nan
trôi	yiyọ	Nan
trướng	imugboroosi	Nan
tràng	oluṣafihan	Nan
trà	tii	Nan
trinidad	trinidad	Nan
trinh	wundia	Nan
tribune	tribune	Nan
tri	mẹta	Nan
treo	idorikodo	Nan
tre	oparun	Nan
trau	trau	Nan
trao	fi	None
tranh	awọn aworan	Nan
trang	oju-iwe	Nan
trai	igbin	Nan
trafford	trafford	Nan
trafalgar	trafalgar	Nan
tqlc	tqlc	Nan
tpvĩnh	ilu	Nan
tphồ	ilu	Nan
tphcm	tphcm	Nan
tp	tp	Nan
toả	tan	Nan
trinity	metalokan	Nan
tràm	kaju	Nan
tristan	tristan	Nan
triền	trien	Nan
truỵ	parọ	Nan
truởng	olórí	Nan
truất	awọn olutọpa	Nan
truân	truân	Nan
truyện	itan	Nan
truyên	truyen	Nan
truong	oko	None
trungnhật	iyi	Nan
trung	àárín	None
truman	amunisin	Nan
true	ooto	Nan
trong	ninu	Nan
trondheim	ẹyọrin	Nan
troia	ẹja troia	Nan
tro	eeru	Nan
triệu	million	Nan
triệt	daradara	Nan
triện	èdìdì	Nan
triều	ṣiṣan	Nan
triết	imoye	Nan
trườn	ko	None
trường	ile-iwe	Nan
trượng	caduceus	Nan
tutsi	tutsi	Nan
tuscan	tuscan	Nan
tupolev	tupolev	Nan
tung	sí	Nan
tum	tum	Nan
tulip	tulip	Nan
tukhachevsky	tukhachevsky	Nan
tudor	tudor	Nan
tucker	onigbọn	Nan
tua	agọ	Nan
tt	tt	Nan
ts	ts	Nan
trực	lori ise	Nan
trữ	ibi ipamọ	Nan
trừu	agutan	Nan
trừng	glare	Nan
trừ	iyokuro	Nan
trứng	ẹyin	Nan
trứ	tru	Nan
tuvalu	tuvalu	Nan
trụi	ihoho	Nan
tuy	sibẹsibẹ	Nan
tuyết	yinyin	Nan
ty	ty	Nan
twitter	twitter	Nan
twin	ibeji	None
tvb	tvb	Nan
tv	tẹlifisiọnu	Nan
tuỳ	iyan	None
tuột	isokuso kuro	Nan
tuộc	ẹja ẹlẹsẹ mẹjọ	Nan
tuổi	kan	None
tuốc	yiyọ	Nan
tuệ	ọgbọn	Nan
tuế	minnows	Nan
tuần	ọsẹ	Nan
tuý	tuyý	Nan
tuông	fọ danu	Nan
tuân	ṣègbọràn	Nan
tuyệt	nla	Nan
tuyển	rikurumenti	Nan
tuyền	tuyen	Nan
tuyên	kede	Nan
trục	àá	Nan
trụ	ọfiisi	Nan
trợ	atilẹyin	Nan
trận	baramu	Nan
trẫm	emi ni	Nan
trẩy	agbesoke	Nan
trầy	rirun	Nan
trầu	tẹtẹ	Nan
trần	si igboro	Nan
trầm	jinjin	Nan
trấu	iresi husk	Nan
trấn	ilu	Nan
trảo	awọn ọrọ ọrọ	Nan
trảm	kaju	Nan
trải	ideri	Nan
trả	sanwo	Nan
trạo	tao	Nan
trạng	majemu	Nan
trạm	ibudo	Nan
trại	àgọ́	None
trạch	ọkọ	Nan
trượt	lati rọra	Nan
trật	pin	Nan
trắc	biometiriki	Nan
trắng	funfun	Nan
trặc	hiccup	Nan
trời	ọlọrun	Nan
trớn	iṣọra	Nan
trộm	olè	Nan
trội	jẹ gaba lori	Nan
trỗi	farahan	Nan
trổ	ṣafihan	Nan
trồng	dagba	Nan
trồi	nyoju	Nan
trống	ofo	Nan
typhon	typoni	Nan
trốn	tọju	Nan
trỏ	awọn itọka	Nan
trọng	pataki	Nan
trọn	kun	Nan
trọ	abirun	Nan
trịnh	phnh	Nan
trị	itọju	Nan
trệ	alaigbọran	Nan
trễ	pẹ	Nan
trẻ	odo	Nan
trối	ipari	Nan
−−	-	Nan
mũ	ijanilaya	Nan
măng	oparun abereyo	Nan
cụm	iṣupọ	Nan
cục	eka	None
cợt	nse	None
cỡ	iwọn	Nan
cờ	asia	Nan
cớ	ikewo	Nan
cột	ẹka	Nan
cộng	pẹlu	Nan
cội	atijọ	Nan
cộ	kẹkẹ ele	Nan
cỗi	abori	Nan
cỗ	deki	Nan
cổng	ilekun nla	Nan
cồng	gong	Nan
cồn	oti	Nan
cống	imugbẹ	Nan
cốm	nuggets	Nan
cối	amọ	Nan
cốc	ago	Nan
cụp	ge kuro	Nan
cố	gbidanwo	Nan
cụt	ge kuro	Nan
của	ti awọn	Nan
daegu	daegu	Nan
da	awọ	Nan
d	o	Nan
cựu	tele	None
cực	òpó	Nan
cựa	spurs	Nan
cự	jinna	Nan
cữu	pẹpẹ	Nan
cữ	cu	Nan
cửu	isodipupo	Nan
cửa	ilekun	Nan
cừu	ọdọ aguntan	Nan
cừ	ọpá	Nan
cứngi	hardi	Nan
cứng	lile	Nan
cức	tutu	Nan
cứ	loju	Nan
củng	tun	Nan
củi	igi ina	Nan
củ	isu	Nan
dahl	dahl	Nan
cỏ	koriko	Nan
cọc	opoplopo	Nan
cảnh	ibi isẹlẹ	Nan
cảng	ibudo	Nan
cản	ìparun	Nan
cảm	tutu	Nan
cải	eweko	Nan
cả	mejeeji	Nan
cạp	scorpion	Nan
cạo	fa irun	Nan
cạnh	eti	Nan
cạn	aijinile	Nan
cạc	kaadi	Nan
cưỡng	agbara	None
cưỡi	rin keke gigun	Nan
cường	lagbara	Nan
cười	rerin	Nan
cướp	jale	Nan
cưới	iyawo	None
cước	ẹru ọkọ	Nan
cưng	omo mi	Nan
cảo	fa	Nan
cọp	ẹyẹ	Nan
cấm	leewọ	Nan
cấp	yọọda	Nan
cọ	bi won ninu	Nan
cặp	àpò	Nan
cằn	ikunsinu	Nan
cằm	agbọn	Nan
cắt	ge	Nan
cắp	jale	Nan
cắn	jẹ lẹnu	Nan
cắm	pulọọgi ninu	Nan
cậy	gbarale	Nan
cậu	ọmọkunrin	Nan
cập	ohunka	Nan
cận	sunmọ	Nan
cẩu	kireni	Nan
cẩn	ṣọra	Nan
cầy	civet	Nan
cầu	afara	Nan
cần	nilo	Nan
cầm	dimu	Nan
cất	distilled	Nan
cấn	nilo	Nan
cưa	rí	Nan
dai	alakikanju	Nan
dakota	dakota	Nan
dm	dm	Nan
djokovic	djokovic	Nan
djibouti	djibouti	Nan
diệu	idan	Nan
diệt	pa	Nan
diện	oju	Nan
diệm	igba	Nan
diệc	ogun	None
diễu	irin-ajo	Nan
diễm	igba	Nan
diểu	farce	Nan
diều	kapa	Nan
diềm	valances	Nan
diên	irikuri	Nan
diêm	ibaamu	Nan
divoire	devoire	Nan
division	pipin	Nan
disneyland	disneyland	Nan
discussion	ijiroro	Nan
dmitri	dmitri	Nan
discovery	awari	None
dna	dna	Nan
doanh	apapọ	Nan
driver	awako	Nan
drake	sike	Nan
draft	ẹda akanṣe	Nan
dracula	dracula	Nan
dp	dp	Nan
doạ	idẹruba	Nan
doãn	doan	Nan
doyle	doyle	Nan
dover	oluṣe	Nan
douglas	douglas	Nan
dougherty	dougherty	Nan
dortmund	dortmund	Nan
donau	donau	Nan
don	don	Nan
dominican	dominican	Nan
dome	éù	Nan
dolly	iṣupọ	Nan
docherty	docherty	Nan
doc	doc	Nan
do	nipasẹ	Nan
daily	ojoojumo	Nan
dionysus	dionysus	Nan
dimaggio	dimaggio	Nan
dbsk	dbsk	Nan
davis	davis	Nan
davies	davies	Nan
david	david	Nan
dave	dave	Nan
dau	epo	Nan
date	ọjọ	Nan
dassault	panṣaga	Nan
das	das	Nan
darwin	darwin	Nan
dao	ọbẹ	Nan
dante	dante	Nan
daniel	daniel	Nan
danh	orukọ	Nan
danger	ijamba	Nan
dancing	jijo	Nan
dan	danu	Nan
dampier	dampier	Nan
dalat	da	None
dc	dc	Nan
dinh	ààfin	Nan
ddr	ddr	Nan
degree	ìyí	Nan
dien	irikuri	Nan
diego	kú	Nan
die	kú	Nan
diana	diana	Nan
di	di	Nan
dewitt	ẹlẹtọ	Nan
dewan	dewan	Nan
deutschland	deutschland	Nan
deuterium	deuterium	Nan
design	thiết kế	Nan
descartes	sọkalẹ	Nan
des	des	None
derek	derek	Nan
department	eka	None
dennis	dennis	Nan
den	den	Nan
demeter	idibajẹ	Nan
delphi	ẹyọ	Nan
delhi	delhi	None
dean	diini	Nan
cư	gbe	None
cơm	iresi	Nan
cũng	pelu	Nan
coleen	coleen	Nan
coi	wo	Nan
cohen	cohen	Nan
coffea	ipanu	Nan
coen	coen	Nan
cocoa	koko	Nan
coburn	igbona	Nan
co	co	Nan
cnxh	cnxh	Nan
cntt	cntt	Nan
cntb	cntb	Nan
cnet	cnet	Nan
cn	cn	Nan
cmt	cmt	Nan
cmc	cmc	Nan
clyde	iṣupọ	Nan
clow	gbamu	Nan
clo	kiloraidi	Nan
clips	awọn agekuru	Nan
coleman	ẹlẹgbẹ	Nan
clip	agekuru	Nan
coli	coli	Nan
colleen	olukọ	Nan
conservation	itoju	Nan
conrad	papọ	Nan
connecticut	asopọmọ	Nan
congress	apejọ alapejọ	Nan
congo	congo	Nan
cong	te	Nan
condom	kondomu	Nan
concorde	konge	Nan
concerto	gbimọ	Nan
concacaf	taakisi	Nan
common	wọpọ	Nan
comic	apanilerin	Nan
columbus	akọmọ	Nan
colorado	agba	None
colombo	colombo	Nan
colombia	agba	None
collège	collège	Nan
collins	collins	Nan
college	kọlẹji	Nan
colin	agbọnrin	Nan
constantine	constantine	Nan
clinton	clintoni	Nan
claude	robi	Nan
chục	mejila	None
chợt	lojiji	Nan
chợ	ọjà	Nan
chở	rù	Nan
chờ	duro de	Nan
chớp	monomono	Nan
chớ	ko	None
chội	nik	Nan
chỗ	ibi	Nan
chồng	ọkọ	Nan
chồn	kọlọkọ	Nan
chồi	abereyo	Nan
chốt	latari	Nan
chống	egboogi	Nan
chốn	ibi	Nan
chối	sẹ	Nan
chốc	akoko	Nan
chỏ	igbonwo	Nan
chọn	yan	None
chụp	kan	None
claudius	claudius	Nan
chủ	ọga	Nan
chứ	dipo	Nan
clark	pẹtẹlẹ	Nan
clara	clara	Nan
cities	awọn ilu	Nan
circus	circle	Nan
cip	cip	Nan
cinderella	cinderella	Nan
cincinnati	cincinnati	Nan
cia	bẹẹ	Nan
chững	ipele	None
chữa	imularada	Nan
chữ	ọrọ	Nan
chửi	eegun	Nan
chửa	loyun	Nan
chử	ọrọ	Nan
chừng	diẹ ninu	Nan
chừa	nlọ	Nan
chừ	leta	Nan
chức	iṣẹ	Nan
chứa	ni	Nan
chủng	awọn igara	Nan
contemporary	imusin	None
cooper	konbo	Nan
copenhagen	copenhagen	Nan
có	ni	Nan
còn	tun	Nan
cò	okunfa	Nan
cãi	jiyan	Nan
câu	awọn gbolohun ọrọ	Nan
cân	irẹjẹ	Nan
câm	adití	Nan
cáy	fiddler	Nan
cáp	okun	Nan
cáopx|bình	asọye	Nan
cáo	kọlọkọ	Nan
cánh	iyẹ	Nan
cán	ti yiyi	Nan
cái	awọn	Nan
cách	ọna	Nan
các	awọn	Nan
cày	gbingbin	Nan
cào	bibi	Nan
cành	ẹka	Nan
cói	sedge	Nan
càng	diẹ sii	Nan
cót	ọmọ	None
côi	orukan	Nan
cũi	ogun	None
cũ	atijọ	Nan
căng	na	Nan
căn	ti ipilẹṣẹ	Nan
căm	edidi sinu	Nan
cút	jade	Nan
cúp	ife	Nan
cúng	itunu	Nan
cúm	aisan	Nan
cúi	tẹriba	Nan
cú	owiwi	Nan
cùng	ati	Nan
cùi	adẹtẹ	Nan
cù	kasi	Nan
cõng	ẹlẹdẹ	Nan
cõi	àwọn ohun gidi	Nan
côngtenơ	gba	None
công	iṣẹ	Nan
côn	taper	Nan
cô	sọnu	Nan
càn	nilo	Nan
cài	fi	None
cà	kọfi	Nan
cristiano	kristian	Nan
crisis	rogbodiyan	None
crimson	ẹlẹsẹ	Nan
crew	atuko	Nan
crest	didimu	Nan
crespo	crespo	Nan
crazy	irikuri	Nan
craig	akan	Nan
cpt	cpt	Nan
cotang	cotang	Nan
costa	idiyele	Nan
cosin	cosin	Nan
cornell	cornell	Nan
core	mojuto	Nan
cordyceps	cordyceps	Nan
copy	ẹda	Nan
coppola	didakọ	Nan
copperfield	ejò-irin	Nan
copernic	copernic	Nan
croatia	kroatia	Nan
cross	rekọja	Nan
crs	crs	Nan
cruz	cruz	Nan
cyworld	iraye	Nan
cyrus	cyrus	Nan
cyril	cyril	Nan
cyber	abirun	Nan
cyanide	cyanide	Nan
cuộc	awọn	Nan
cuồng	irikuri	Nan
cuống	igi pẹlẹbẹ	Nan
cuốn	okun	Nan
ds	ód	Nan
cuối	kẹhin	Nan
cuả	ti	Nan
cup	ife	Nan
cunningham	cunningham	Nan
cung	tẹriba	Nan
cullen	cullen	Nan
cua	akan	Nan
ctc	ctc	Nan
crystal	kristali	Nan
cruzeiro	kekere	None
cuốc	hoes	Nan
dtd	àíd?	Nan
dth	àá	Nan
du	du	None
food	oúnjẹ	None
fokker	fokker	Nan
foden	foden	Nan
focus	idojukọ	Nan
foch	foch	Nan
flight	ọkọ ofurufu	Nan
fleming	fleming	Nan
flanker	flanker	Nan
fitzgerald	fitzgerald	Nan
fishbed	ẹja	Nan
fish	ẹja	Nan
fischer	apẹja	Nan
firefox	firefox	Nan
finish	pari	Nan
fiji	fiji	Nan
figo	figo	Nan
fifpro	fifọ	Nan
fifa	fifa	Nan
field	pápá	Nan
football	bọọlu	Nan
fidel	iṣootọ	Nan
forbes	forbes	Nan
fordham	onídò	Nan
fujiko	fujiko	Nan
fu	fu	Nan
friedman	adun	Nan
freud	freud	Nan
franz	franz	Nan
franklin	franklin	Nan
frankfurt	ffefurt	Nan
frank	otitọ	Nan
franco	franco	Nan
francisco	francisco	Nan
francis	francis	None
frances	ododo	None
france	itanran	Nan
franc	franc	Nan
fracsin	fracsin	Nan
fpt	fpt	Nan
fox	kọlọkọ	Nan
foundation	ipile	Nan
forks	forks	Nan
ford	ṣeéṣe	Nan
fujimoto	fujimoto	Nan
fiat	fiat	Nan
fernando	fernando	Nan
every	gbogbo	Nan
everton	everton	Nan
eva	eva	Nan
european	oyinbo	Nan
europe	yuroopu	Nan
eurofighter	eurofighter	Nan
euro	euro	None
euler	euler	Nan
eugène	eugène	Nan
eugene	eugene	Nan
euclid	euclid	Nan
ethiopia	ethiopia	Nan
ethernet	ethernet	Nan
essential	pataki	Nan
españa	españa	Nan
erwin	erwin	Nan
eros	iwoyi	Nan
ernest	àṣìṣe	Nan
eritrea	eritrea	Nan
exgay	han	Nan
ferrari	ferrari	Nan
explorer	aṣawakiri	Nan
fabio	aṣọ	Nan
ferguson	ferkir	Nan
ferdinand	ferdinand	Nan
ferb	ferb	Nan
felix	felix	Nan
felis	felis	Nan
felipe	felipe	Nan
feet	ẹsẹ	None
federer	onitọju	Nan
features	awọn ẹya	Nan
fdi	fdi	Nan
fca	fca	Nan
fbi	fbi	Nan
faso	faso	Nan
farrell	farrell	Nan
fao	fao	Nan
faifo	faifo	Nan
facto	facto	Nan
fact	o daju	Nan
facebook	facebook	Nan
extensive	sanlalu	Nan
fukuoka	fukuoka	Nan
funimation	igbadun	Nan
funk	funk	Nan
gifu	gifu	Nan
gieo	gbìn	Nan
gichin	gichin	Nan
gibraltar	gibraltar	Nan
giang	giang	Nan
gian	aaye	Nan
giam	ẹwọn	Nan
giai	ipele	None
gia	gia	Nan
ghềnh	rapids	Nan
ghề	rapids	Nan
ghế	alaga	Nan
ghẻ	scabies	Nan
ghì	ghì	Nan
ghê	ẹ̀ru	Nan
ghép	alọmọ	Nan
ghé	duro	Nan
ghim	pin	Nan
ghi	kọ awọn	Nan
ginzan	ginzan	Nan
ghen	owú	Nan
gio	gio	Nan
giuliani	giuliani	Nan
giêsu	jesu	None
giêng	giong	Nan
giêhôva	giva	Nan
gièm	awọn olutọpa	Nan
giãn	na	Nan
giã	iwon	Nan
giây	-aaya	Nan
gián	akukọ	Nan
giám	oludari	Nan
giá	owo	Nan
giày	awọn bata	Nan
giàu	ọlọrọ	Nan
giành	ni itara	Nan
giàn	awọn amọran	Nan
già	atijọ	Nan
giza	giza	Nan
giuộc	giuoc	Nan
giuse	giuse	Nan
giun	aran	Nan
gioi	gioi	Nan
ghe	omi	None
ghana	ghana	None
gerrard	oniye	Nan
gao	iresi	Nan
ganh	owú	Nan
gang	egbe	None
gandhi	gandhi	Nan
gan	ẹdọ	Nan
gamow	agba	None
gambia	gambáà	Nan
gam	giramu	Nan
galileo	galileo	Nan
galilei	galilei	Nan
gaillard	agbọnrin	Nan
gaia	gaia	Nan
gagarin	gagarin	Nan
gabriella	gabriella	Nan
gabriel	gabriel	Nan
gabon	gabon	Nan
ga	ga	Nan
fx	fx	Nan
futsal	futsal	Nan
gareth	ibudo	Nan
garrett	garrett	Nan
gary	iwin	Nan
gascon	ategun	Nan
germany	jẹmánì	Nan
german	jẹmánì	Nan
gerhard	gerhard	Nan
gerais	gerais	Nan
ger	kokoro	Nan
gepard	gepard	Nan
georges	georges	Nan
george	george	Nan
georg	georg	Nan
eris	eris	Nan
genesis	jiini	Nan
gen	jiini	Nan
geisha	geisha	Nan
gdp	gdp	Nan
gdańsk	gdańsk	Nan
gaza	gaza	Nan
gay	onibaje	Nan
gaulois	gaulois	Nan
gaule	gaule	Nan
gatt	gatt	Nan
gene	ẹbun	Nan
chọi	ija	Nan
erik	erik	Nan
ep	éú	Nan
dường	dabi	Nan
dương	rere	None
dưng	duro	Nan
dưa	melons	Nan
dư	aloku	Nan
dơi	adan	Nan
dơ	dọti	Nan
dũng	akinkanju	Nan
dĩa	awo	None
dĩ	dajudaju	Nan
dăm	shavings	Nan
dùng	lo	Nan
dùi	ẹlẹsẹ	Nan
dù	botilẹjẹpe	Nan
dõi	orin	Nan
dông	ãrá	Nan
dó	iyẹn	Nan
dòng	lọwọlọwọ	Nan
dòm	wo	Nan
dưỡng	nọọsi	Nan
dò	wa	Nan
dược	ile elegbogi	Nan
dạ	bẹẹni	Nan
dậy	dide	Nan
dậu	akukọ	Nan
dận	aunty	Nan
dẫu	botilẹjẹpe	Nan
dẫn	itọsọna	Nan
dẫm	ìtẹ	Nan
dầu	epo	Nan
dần	di .di.	Nan
dấy	iwuri	Nan
dấu	ami	Nan
dấp	ikọsẹ	Nan
dấm	kikan	Nan
dải	rinhoho	Nan
dạy	kọ	Nan
dạt	fo	Nan
dạo	ajo	None
dạng	ọna kika	Nan
dạn	bẹru	Nan
dại	aṣiwere	Nan
dượng	arakunrin	Nan
dắt	darí	Nan
dính	alalepo	Nan
dì	arabinrin	Nan
dà	dah	Nan
dwight	gbé	None
duỗi	taara	Nan
duệ	iru-ọmọ	Nan
duật	igbọn	Nan
duẩn	ibeji	None
duơng	duong	Nan
duyệt	ẹrọ aṣawakiri	Nan
duyện	fẹẹrẹ	Nan
duyên	ti pinnu tẹlẹ	Nan
duy	nikan	Nan
dursley	dursley	Nan
durham	durham	Nan
dung	ẹtu	Nan
dumbledore	dumbledore	Nan
dumas	dumas	Nan
duk	gbogbo	Nan
duiker	duiker	Nan
dubai	wo	Nan
dài	gun	None
dìu	dìu	Nan
dàn	eto	Nan
dành	lo	Nan
dê	ewurẹ	Nan
dép	sálúbàtà	Nan
défense	dédé	Nan
dè	ṣọra	Nan
dãy	ibiti	None
dãn	atọka	Nan
dãi	yọọda	Nan
dã	egan	Nan
dây	okun	Nan
dâng	ìfilọ	Nan
dân	eniyan	Nan
dâm	agbọnrin	Nan
dát	gbin	None
dáng	apẹrẹ	Nan
dán	lẹẹ	Nan
dám	daiya	Nan
dái	piss	Nan
dày	nipọn	Nan
dào	lọpọlọpọ	Nan
dàng	rọrun	Nan
dằn	kunkun	Nan
dằng	jubẹẹlo	Nan
dẳng	jubẹẹlo	Nan
elbe	elbe	Nan
ekaterina	ekaterina	Nan
eisenhower	eisenhower	Nan
einstein	einstein	Nan
eiffel	eiffel	Nan
eid	éù	Nan
egypt	egypt	Nan
efron	efron	Nan
eea	eea	Nan
edwin	edwin	Nan
edward	edward	Nan
edo	edo	Nan
edmond	edmond	Nan
editor	olootu	Nan
edison	edison	Nan
edinburgh	edinburgh	Nan
edge	eti	Nan
edgar	edgar	Nan
edda	edda	Nan
electronic	itanna	Nan
ecw	àwæn	Nan
eliane	eliane	Nan
elizabeth	elizabeth	Nan
eo	ẹgbẹ-ikun	Nan
enzym	enzymu	Nan
entropy	entropy	Nan
entente	entente	Nan
eniac	eniac	Nan
england	gẹẹsi	Nan
engels	engels	Nan
energy	agbara	None
en	yo	Nan
emmy	emmy	Nan
emir	olú ọba	Nan
emily	emily	Nan
email	imeeli	Nan
em	iwo	Nan
elíp	agekuru	Nan
elvis	igbonwo	Nan
elton	agbon	Nan
ellis	ellis	Nan
ellen	ellen	Nan
elip	agekuru	Nan
ecmascript	àmójúmu	Nan
ebro	ebro	Nan
eaton	jẹun	Nan
dỏm	oloye	None
dọc	inaro	Nan
dọa	idẹruba	Nan
dịu	ẹlẹgbẹ	Nan
dịp	ayeye	Nan
dịch	tumọ	Nan
dị	okansoso	Nan
dệt	hun	None
dễ	rọrun	Nan
dể	rọrun	Nan
dền	amaranth	Nan
dế	crickets	Nan
dẻo	ṣiṣu ṣiṣu	Nan
dẻ	àyà	Nan
dẹt	alapin	Nan
dẹp	alapin jade	Nan
dặt	paṣẹ	Nan
dặn	paṣẹ	Nan
dặm	maili	Nan
dốc	iho	Nan
dối	parọ	Nan
dốt	alaimọ	Nan
dồi	lọpọlọpọ	Nan
earles	awọn afikọti	Nan
ea	éù	Nan
e	é	Nan
dỹ	dỹ	Nan
dực	akọ	Nan
dựa	orisun	None
dự	iṣẹ akanṣe	Nan
dữ	data	Nan
dừng	duro	Nan
erich	erich	Nan
dừa	agbon	Nan
dứa	ope oyinbo	Nan
dụng	lo	Nan
dục	ibalopọ	Nan
dụ	fun	None
dỡ	ikojọpọ	Nan
dở	buburu	Nan
dời	gbe	None
dỗ	coax	Nan
dồn	cornered	Nan
dứt	duro	Nan
giêxu	dudu	Nan
chọc	lati poke	Nan
chịt	inira	Nan
bermuda	bermuda	Nan
berman	berman	Nan
berkeley	berkeley	Nan
bering	bering	Nan
berger	alagbẹdẹ	Nan
bergen	bergen	Nan
berber	ata	Nan
bennington	bennington	Nan
benjamin	benjamin	Nan
benito	benito	Nan
benfica	benfica	Nan
benetton	benetton	Nan
benedict	benedict	Nan
bellatrix	bellatrix	Nan
bella	bella	Nan
bell	agogo	Nan
bel	bel	Nan
beijing	beijing	None
behind	sile	None
bernard	bernard	Nan
beginbmatrix	akobere	Nan
bertrand	bertrand	Nan
betty	tẹtẹ	Nan
biện	gafara	Nan
biểuthứcđiềukiện	ipo	None
biển	okun	Nan
biều	bieu	Nan
biếu	ori	None
biếng	ọlẹ	Nan
biến	jade	Nan
biếm	aibikita	Nan
biếc	tẹẹrẹ	Nan
biên	igbasilẹ	Nan
bitmap	bitmap	Nan
bismarck	bismarck	Nan
billy	oniruru	Nan
bill	owo	Nan
bikini	bikini	Nan
bic	bic	Nan
biang	ẹyẹ	Nan
bia	oti sekengberi	Nan
bhutan	bhutan	Nan
better	dara julọ	Nan
biệt	yàtọ	Nan
beethovens	beethovens	Nan
bedloe	bedloe	Nan
baryon	agba	None
bartholdi	bartholdi	Nan
barrichello	barikẹli	Nan
barquin	agbọnrin	Nan
baroque	baroki	Nan
barone	barone	Nan
barnes	abà	Nan
barca	barca	Nan
barbary	alaigbede	Nan
barbara	barbara	Nan
barbados	barbados	Nan
barak	bukun	Nan
barack	baraki	Nan
bao	àpo	Nan
bantu	tu wiwọle	Nan
bantam	bantam	Nan
banner	asia	Nan
banh	bọọlu	Nan
bang	bangi	Nan
barça	barça	Nan
beethoven	beethoven	Nan
base	mimọ	Nan
basil	agbọn	Nan
beckham	beckham	Nan
becker	alagbata	Nan
beckenbauer	beckenbauer	Nan
beauty	ẹwa	Nan
beatles	awọn iṣẹgun	Nan
beat	lu	Nan
bchtư	bchtư	Nan
bc	bc	Nan
bbc	bbc	Nan
bb	bb	Nan
bazơ	ipilẹ	Nan
bazan	basil	Nan
bayern	bayern	Nan
bay	fò	Nan
bauer	bauer	Nan
battambang	battambang	Nan
bator	bator	Nan
bass	baasi	Nan
baskervilles	baskervilles	Nan
basel	agbọn	Nan
ban	gbesele	Nan
bkavpro	bkavpro	Nan
blair	blir	Nan
buonaparte	buonaparte	Nan
bungo	bungo	Nan
bungary	igbesoke	None
bulletin	iwe iroyin	Nan
bulgaria	bulgaria	Nan
budapest	budapest	Nan
bubalis	bobali	Nan
btr	btr	Nan
brussels	biroseli	Nan
brusilov	brusilov	Nan
bruno	bruno	Nan
brunei	brunei	Nan
bruce	bruce	Nan
browning	brown	Nan
browne	atare	Nan
brown	brown	Nan
brot	brot	Nan
brooklyn	brooklyn	Nan
britney	britney	Nan
burke	buruku	Nan
britannic	ede	None
burkina	burkina	Nan
burundi	burundi	Nan
bào	pẹtẹlẹ	Nan
bành	peng	Nan
bàng	idì	Nan
bàn	tabili	None
bài	awọn ifiweranṣẹ	Nan
bà	agba	None
byzantine	byzantine	Nan
buổi	igba	Nan
buồng	yara	Nan
buồn	ibanujẹ	Nan
buồm	ta asia	Nan
buốt	islam	Nan
buýt	bosi	Nan
buông	ki	None
buôn	osunwon	Nan
bushy	bushy	Nan
bush	igbo	Nan
busby	akero	Nan
busan	akero	Nan
burma	burma	Nan
blackwell	dudu	Nan
bridge	afara	Nan
brezhnev	brezhnev	Nan
boong	deki	Nan
boom	ariwo	Nan
boolean	ariwo	Nan
bool	agba	None
bonobo	bonobo	Nan
bonnal	ọpagun	Nan
bong	bọngò	Nan
bonaparte	bonaparte	Nan
bom	gbamu	Nan
boltzmann	boltzmann	Nan
bolivia	bolivia	Nan
bohemia	bohemia	Nan
boeing	ariwo	Nan
bobby	ariwo	Nan
bob	bob	Nan
bo	bo	Nan
blues	awọn blues	Nan
blanc	òfo	Nan
blaise	fẹẹrẹ	Nan
boongke	bunkers	Nan
brian	bẹtẹli	Nan
bop	bop	Nan
borland	olu ilu	Nan
bretton	bretton	Nan
breton	bretoni	Nan
brestlitovsk	brestlitovsk	Nan
bremen	awon alabo	Nan
brazil	brazil	Nan
braun	braun	Nan
brandt	iyasọtọ	Nan
brandenburg	brandenburg	Nan
brain	ọpọlọ	Nan
boxing	boxing	Nan
bourbon	bourbon	Nan
boulder	okuta nla	Nan
bottom	isalẹ	Nan
botswana	botswana	Nan
bosnia	oorun ara ilu	Nan
bosna	bosna	Nan
boseeinstein	boseeinstein	Nan
bose	bose	Nan
borussia	borussia	Nan
boris	boris	Nan
bamar	bamar	Nan
ballard	baluu	Nan
balkans	baluku	Nan
alois	ariwo	Nan
allmusic	gbogbogbo	None
allen	pẹlẹ	Nan
allan	allan	Nan
alice	alice	Nan
ali	ali	Nan
algérie	algérie	Nan
alfred	sẹsẹ	Nan
alexey	alexey	Nan
alexandros	alexandros	Nan
alexandria	alexandria	Nan
alexandra	alexandra	None
alexa	gbo	Nan
albus	ile ologbo	Nan
albuquerque	albuquerque	Nan
albion	iyọ	Nan
alberto	alberto	Nan
albert	ominira	Nan
albatros	albatros	Nan
alonso	alonso	Nan
albania	albania	Nan
alpher	alufaa	Nan
altai	altai	Nan
andes	andes	Nan
anderson	anderson	Nan
andaman	ati hamani	Nan
andalusia	andalusia	Nan
anatolia	anatolia	Nan
anata	anata	Nan
anand	anand	Nan
an	á	Nan
amphitrite	ikọwe	Nan
amoniac	amonia	Nan
amm	àm	Nan
amin	amine	Nan
amiens	amiens	Nan
ami	ami	Nan
ame	ma	Nan
amdo	amdo	Nan
amazon	amazon	Nan
amaravati	amaravati	Nan
always	nigbagbogbo	Nan
alps	alps	Nan
andorra	andorra	Nan
alaska	alaska	Nan
al	al	Nan
adsl	adsl	Nan
adrian	adrian	Nan
adobe	ẹmọ	Nan
adn	adn	Nan
addisonwesley	addisonwesley	Nan
adams	adams	Nan
ada	ada	Nan
acid	acid	Nan
acia	acia	Nan
achilles	awọn eegun	Nan
aceh	aceh	Nan
account	akọọlẹ	Nan
abscbn	abscbn	Nan
abrams	abramu	Nan
abraham	rabúráhámù	Nan
about	nipa	Nan
abkhazia	abkhazia	Nan
abdul	abdul	Nan
abc	abc	Nan
advanced	ti ni ilọsiwaju	Nan
alabama	alabama	Nan
aedes	aedes	Nan
aero	afẹfẹ	Nan
akô	pẹlẹ o	Nan
akms	akms	Nan
akatsuki	akatsuki	Nan
ak	ak	Nan
ajax	ajax	Nan
aisne	ibo	Nan
airbus	ategun afẹfẹ	Nan
air	ategun	Nan
aim	ifọkansi	Nan
ailen	irish	Nan
ai	àjọ who	Nan
agassi	agassi	Nan
agasa	agasa	Nan
ag	ag	Nan
african	afirika	Nan
africa	afirika	Nan
afghanistan	afiganisitani	Nan
aff	fihan	None
afc	afc	Nan
aegypti	aegypti	Nan
andrew	andrew	Nan
andré	andré	Nan
andy	andy	Nan
austria	ilu olominira	Nan
australia	ilu oyinbo	Nan
auguste	auguste	Nan
auflage	omi	None
audition	idanwo afẹnuka	Nan
aubrac	aubrac	Nan
aua	uaùù	Nan
atlantic	atẹgun	Nan
atlanta	lodun	Nan
atkinson	eefin	Nan
aston	yà	Nan
assyria	assyria	Nan
association	ẹgbẹ	Nan
asoka	asoka	Nan
asm	asm	Nan
asia	asia	Nan
ashley	eeru	Nan
ashikaga	ashikaga	Nan
ash	eeru	Nan
austrian	ara ilu	Nan
asc	gòke	Nan
avar	avar	None
awad	awad	Nan
balkan	balkan	Nan
bali	bali	Nan
balearic	alainibaba	Nan
baháí	baháí	Nan
bahrain	bahrain	None
bahamas	bahamas	Nan
bago	bago	Nan
baghdad	baghdad	Nan
baden	ṣe	Nan
bacon	elede	None
babylon	kekere	None
ba	baba	Nan
aztec	aztec	Nan
azerbaijan	azerbaijan	Nan
ayutthaya	ayutthaya	Nan
ayumi	ayumi	Nan
ayeyarwady	ayeyarwady	Nan
axit	acid	Nan
award	eye	Nan
aviation	ọkọ ofurufu	Nan
arunachal	arun	None
aruba	aruba	Nan
artemis	àríyá	Nan
any	eyikeyi	Nan
antonov	antonov	Nan
anton	anton	Nan
antigua	antigua	Nan
anthony	oloye	None
anorthosit	anorthosit	Nan
anne	arene	Nan
annan	ananí	Nan
annam	an	None
anna	mánà	Nan
ankyl	ankyl	Nan
ankara	ankara	Nan
anhpháp	faranse	None
anhmỹ	ara ilu gẹẹsi	Nan
anh	arakunrin	Nan
anglosaxon	anglosaxon	Nan
angkor	angkor	None
ang	éù	Nan
anfield	anfield	Nan
anđêhít	aldehyde	Nan
ao	omi	None
aotearoa	aotearoa	Nan
apollo	apollo	Nan
arsenal	arsenal	Nan
arnold	arnold	Nan
armstrong	amusowo	Nan
armenia	ara ilu armenia	Nan
arlington	arlington	Nan
arkansas	arkansas	None
ark	ọkọ	Nan
arizona	arizona	Nan
aristotle	aristotle	Nan
bàu	bau	Nan
aringarosa	aringarosa	Nan
argo	argo	Nan
argentina	argentina	Nan
ares	ares	Nan
arctan	arctan	Nan
archive	nkan	None
archetypal	archetypal	Nan
arab	arab	Nan
aquinas	aquinas	Nan
apple	apu	Nan
arias	arias	Nan
bày	igbejade	Nan
bác	aburo	Nan
bách	igi afikọti	Nan
chrysler	ajé	Nan
chrome	chrome	Nan
christopher	christi	Nan
christian	kristiẹni	Nan
christ	kristi	Nan
chris	kilasi	Nan
choáng	yanilenu	Nan
choàng	iho	Nan
chosŏn	chosŏn	Nan
chopin	chopin	Nan
chong	chong	Nan
chomsky	chomsky	Nan
choi	mu ṣiṣẹ	Nan
chnd	ologbo	Nan
chloride	kiloki	Nan
chlamydia	kíláidá	Nan
chiều	irọlẹ	Nan
chiền	opo	Nan
chiếu	ẹni	Nan
chu	chu	Nan
chiết	jade	Nan
chua	ekan	Nan
chui	nù	Nan
chuộng	ojurere	Nan
chuộc	irapada	Nan
chuỗi	pq	Nan
chuồng	ile-ẹyẹ	Nan
chuốt	koriko	Nan
chuối	ogede	Nan
chuốc	poke	Nan
chuẩn	boṣewa	Nan
chuông	agogo	Nan
chuôi	gripe	Nan
chuyện	itan	Nan
chuyển	gbe	None
chuyền	rekoja	Nan
chuyến	ajo	None
chuyên	amọja	Nan
churchill	churchill	Nan
chung	gbogboogbo	Nan
chun	gba	None
chum	ọra	Nan
chuck	chuck	Nan
chuột	asin	Nan
chiến	ja	Nan
chiếc	pcs	Nan
chao	bawo	Nan
chanh	lẹmọnu	Nan
chanel	shaneli	Nan
chamẹ	awọn obi	Nan
champion	olubori	Nan
champa	champa	Nan
chamberlain	iyẹwu	Nan
chaillot	chaillot	Nan
chai	ìgo	Nan
cha	baba	Nan
ceres	awọn ọkọ ayọkẹlẹ	Nan
centauri	centauri	Nan
cena	cena	Nan
celtic	sẹẹli	Nan
cell	sẹẹli	Nan
cdrom	cdrom	Nan
cdot	cdot	Nan
cd	cd	Nan
cctv	cctv	Nan
charles	awọn ẹru	Nan
chiếm	fun	None
charlotte	charlotte	Nan
charon	oronu	Nan
chiêng	gong	Nan
chiên	dín	Nan
chiêm	aworawo	Nan
chirac	chirac	Nan
ching	chingi	Nan
china	ṣaina	Nan
chim	eye	Nan
chile	chile	Nan
chicago	chicago	Nan
chiang	chiang	Nan
chia	pin	Nan
chi	.rún	Nan
cheo	cheo	Nan
chen	oniye	Nan
chechnya	chechnya	Nan
che	ideri	Nan
chdcnd	chdcnd	Nan
chay	ajewebe	Nan
chase	lepa	Nan
charlton	ṣaja	Nan
chà	bi won ninu	Nan
chài	ipeja	Nan
chàm	indigo	Nan
chấm	aami	Nan
chảy	sáré	Nan
chảo	pan	Nan
chả	yipo	Nan
chạy	sáré	Nan
chạp	gbọn	Nan
chạng	alẹ́	Nan
chạm	fọwọkan	Nan
chạ	ṣe itẹlera	Nan
chướng	dajudaju idiwọ	Nan
chương	orí	Nan
chưng	ijinna	Nan
chưa	sibẹsibẹ	Nan
chư	chu	Nan
chơn	ẹsẹ	None
chơi	mu ṣiṣẹ	Nan
chĩa	forks	Nan
chăng	ti ifarada	Nan
chămpa	champa	Nan
chấp	ipenija	Nan
chăm	lile	Nan
chất	ọrọ	Nan
chần	didi	Nan
chỉnh	atunse	None
chỉ	kan	None
chệch	ko	None
chết	kú	Nan
chếch	rirọ	Nan
chế	ipalemo	Nan
chẽ	fẹẹrẹ	Nan
chẻ	pin	Nan
chặt	gige	Nan
chặng	ẹsẹ	None
chặn	dina	Nan
chẵn	ani	Nan
chằng	atari	Nan
chắc	daju	Nan
chậu	ikoko	Nan
chật	fẹẹrẹ	Nan
chận	dina	Nan
chậm	lọra	Nan
chẩn	wo aisan	Nan
chấu	fun	None
chút	kekere	None
chúng	wọn	None
chúi	ileto	Nan
chì	darí	Nan
chênh	iyato	None
chê	gbaga	Nan
chép	daakọ	Nan
chéo	rekọja	Nan
chén	ife	Nan
chém	ge	Nan
chèn	fi	None
chè	tii	Nan
châu	yuroopu	Nan
chân	ẹsẹ	None
châm	ibi iyege	Nan
cháy	iná	Nan
cháu	ọmọ-ọmọ	Nan
cháo	omi	None
chánh	olórí	Nan
chày	baseball	Nan
chào	pẹlẹ o	Nan
chàng	eniyan	Nan
chìa	bọtini	Nan
chìm	rì	Nan
chình	eel	Nan
chí	lice	Nan
chúc	lati fẹ	Nan
chúa	ọlọrun	Nan
chú	aburo	Nan
chùy	obinrin	Nan
chùa	tẹmpili	Nan
chông	ọkọ	Nan
chôn	sin	Nan
chôm	rambutan	Nan
chóp	oke	Nan
ccn	ccn	Nan
chóng	yarayara	Nan
chóc	haha	Nan
chó	aja	Nan
chòm	constellation	Nan
chòi	agọ	Nan
chò	choke	Nan
chít	chit	Nan
chính	akọkọ	Nan
chín	mẹsan	Nan
chích	ta	Nan
chói	glare	Nan
chịu	jẹri	Nan
ccc	ccc	Nan
cbgd	cbgd	Nan
bẩm	aigba ibatan	Nan
bầy	agbo	Nan
bầu	dibo	Nan
bần	talaka	None
bấy	iyẹn	Nan
bất	gidi	Nan
bấm	tẹ	Nan
bảy	meje	Nan
bảo	bao	Nan
bảng	ọkọ	Nan
bại	padanu	Nan
bạch	funfun	Nan
bạc	fadaka	Nan
bạ	awọn olubasọrọ	Nan
bướm	labalaba	None
bước	igbesẹ	Nan
bưu	ifiweranṣẹ	Nan
bơm	fifa soke	Nan
bơi	we	Nan
bẩn	dọti	Nan
bơ	bota	Nan
bẩy	okùn	Nan
bậc	ìyí	Nan
bệnh	ṣàìsàn	Nan
bện	rudurudu	Nan
bệ	àtẹ	Nan
bể	elegbe	Nan
bền	tọ	Nan
bề	dada	Nan
bếp	ibi idana	Nan
bến	wharf	Nan
bẽ	idojuti	Nan
bẻ	fọ	Nan
bẹp	fifun pa	Nan
bằng	dogba	Nan
bắt	yẹ	Nan
bắp	agbado	None
bắn	iyaworan	Nan
bắcnam	guusu	None
bắc	ariwa	Nan
bật	tan-an	Nan
bận	nṣiṣe lọwọ	Nan
bẫy	okùn	Nan
bỉ	bẹljiọmu	Nan
băng	yinyin	Nan
băm	hashed	Nan
bìa	ideri	Nan
bì	apoti	Nan
bênh	ṣàìsàn	Nan
bên	ẹgbẹ	Nan
béo	ọra	Nan
bén	didasilẹ	Nan
bé	diẹ	Nan
bèn	lẹhinna	Nan
bão	ìjì	Nan
bãi	ese	Nan
bã	iṣẹku	Nan
bây	bayi	None
báu	iṣura	Nan
bát	ekan	Nan
báo	iwe iroyin	Nan
báng	bangi	Nan
bán	ta	Nan
bám	rirọ	Nan
bái	egbeokunkun	Nan
bìu	scrotum	Nan
băn	fret	Nan
bí	elegede	Nan
bíró	elegede	Nan
bút	ikọwe	Nan
búng	fọ danu	Nan
bún	ounjẹ iresi	Nan
búi	tufts	Nan
búa	ju	Nan
bú	muyan	Nan
bùng	igbunaya ina	Nan
bùn	pẹtẹ	Nan
bùa	amulet	Nan
bù	ifipaju	Nan
bông	owu	Nan
bôi	smeared	Nan
bô	baba	Nan
bóp	fun	None
bóng	bọọlu	Nan
bón	idapọ	Nan
bói	enikeji	Nan
bó	opo ti	Nan
bò	maalu	Nan
bính	binh	Nan
bỉnh	alaigbọran	Nan
bịch	ajonirun	Nan
bịt	ti bo	Nan
cardcaptor	onka	None
carbine	carbine	Nan
carat	carat	Nan
capra	capra	Nan
capello	ẹyẹ	Nan
canxi	kalisiomu	Nan
canterbury	canterbury	Nan
cancer	alakan	Nan
canary	gilaasi	Nan
canal	odo odo	Nan
canadian	ilu ilu kanada	Nan
canada	canada	Nan
campuchia	kambodia	Nan
campbell	ibi ipago	Nan
camille	camiliti	Nan
cameroon	cameroon	Nan
cameron	akọni	Nan
cameo	wá	Nan
cambridge	kaadi	Nan
cardcaptors	káàdì káàdì	Nan
cambodia	cambodia	Nan
carey	alabojuto	Nan
caribê	karibeanu	Nan
cbc	cbc	None
cau	cau	Nan
catherine	catherine	None
cathay	cathay	Nan
castro	ọpọlọ	Nan
castries	awọn igbelewọn	Nan
cast	simẹnti	Nan
cassini	kasẹti	Nan
caspia	caspia	Nan
casablanca	casablanca	None
casa	ca sa	Nan
carxtơ	carat	Nan
carter	ataja	Nan
carpathia	carpathia	Nan
caroline	caroline	Nan
carol	carol	Nan
carnaval	ọkọ ayọkẹlẹ	Nan
carlos	carlos	Nan
carl	carl	Nan
caribe	caribe	Nan
cam	oranges	Nan
calvin	kalfati	Nan
calculus	kalikanu	Nan
bột	iyẹfun	Nan
bội	lọpọlọpọ	Nan
bộc	boc	Nan
bộ	awọn ṣeto	Nan
bỗng	lojiji	Nan
bổng	sikolashipu	Nan
bổn	iṣẹ	Nan
bồi	biinu	Nan
bốn	mẹrin	Nan
bối	dapo	Nan
bốc	ikojọpọ	Nan
bố	bàbá	None
bỏng	jona	Nan
bỏ	fagilee	Nan
bọt	foomu	Nan
bọng	puppy	Nan
bọn	wọn	None
bọc	fi	None
bọ	kokoro	Nan
bớ	ṣe atojọ	Nan
bớt	ti o kere	Nan
bờ	eti	Nan
bời	àá	Nan
cal	kalẹ	None
cairo	cairo	None
cai	oṣu kẹwa	Nan
café	kọfi	Nan
caffein	kanilara	Nan
caesar	ẹṣẹ	Nan
cacbua	kabu ọkọ ayọkẹlẹ	Nan
cacbonat	kaboneti	Nan
cacbon	erogba	Nan
cbs	cbs	Nan
cabo	cabo	Nan
ca	yi lọ yi bọ	Nan
bực	ibanujẹ	Nan
bữa	oúnjẹ	None
bừa	harrowing	Nan
bứt	aimọ	Nan
bụng	ikun	Nan
bục	podium	Nan
bởi	nipasẹ	Nan
bở	nipasẹ	Nan
ca-lo	ca-lo	Nan
mĩ	amẹrika	Nan
giò	omi	None
giòn	crunchy	Nan
loạicựu	oriṣi	Nan
loạicông	oriṣi	Nan
loạicâu	oriṣi	Nan
loạicác	oriṣi	Nan
loạichiến	oriṣi	Nan
loạibệnh	arun	None
loạianime	tẹ anime	Nan
loạianh	oriṣi	Nan
loại	eya	None
loét	ọgbẹ	Nan
loãng	washy	Nan
loát	flashy	Nan
loài	eya	None
love	ni ife	Nan
louvre	louvre	None
louisiana	louisiana	Nan
louis	louis	Nan
los	los	Nan
lorenzo	lorenzo	Nan
loạigia	oriṣi	Nan
long	gun	None
loạihuân	kindhuan	Nan
loạimáy	oriṣi ẹrọ	Nan
lucas	lucas	Nan
luang	luang	Nan
lu	lu	Nan
lp	lp	Nan
loạt	jara	Nan
loạn	rudurudu	Nan
loạixã	oriṣi	Nan
loạivõ	oriṣi	Nan
loạitổ	oriṣi	Nan
loạitín	irú	Nan
loạitrường	iru ile-iwe	Nan
loạithần	oriṣi	Nan
loạithành	oriṣi	Nan
loạithuật	ofin	None
loạiscandal	fleaiscandal	Nan
loạiphong	oriṣi	Nan
loạiphim	oriṣi fiimu	Nan
loạingày	tẹ eyi	Nan
loạimôn	oriṣi	Nan
loạiluật	ofin	None
lucia	lucia	Nan
london	london	Nan
logan	logan	Nan
lionel	kiniun	Nan
linux	àlẹmọ	Nan
links	awọn ọna asopọ	Nan
linh	linh	Nan
linga	linga	Nan
lilly	aimọgbọnwa	Nan
lightning	monomono	Nan
liga	liga	Nan
liechtenstein	irọke-oniṣẹ	Nan
lido	lido	Nan
libya	libya	Nan
libero	olominira	Nan
libby	ẹnu ọna	Nan
lhq	lhq	Nan
lhp	lhp	Nan
lg	lg	Nan
lesotho	lesotho	Nan
leslie	leslie	Nan
les	les	Nan
lisboa	lisboa	Nan
lon	le	None
lisbon	lisbon	Nan
liu	liu	Nan
log	wọle	Nan
lockheed	titiipa	Nan
locke	eyan	Nan
loch	loch	Nan
loang	tẹ	Nan
loaita	loaita	Nan
loa	sọrọ	Nan
lo	dààmú	Nan
lleyton	lọnita	Nan
liệu	boya	Nan
liệt	ẹlẹgba	Nan
liệng	jabọ	Nan
liễu	willow	Nan
liều	iwọn lilo	Nan
liềm	àrùn	None
liêu	iṣejọba	Nan
liêng	mimọ	Nan
liên	afowopaowo	Nan
liêm	otitọ	Nan
litva	lithuania	Nan
leonid	leonid	Nan
luciano	luciano	Nan
ludovico	ludovico	Nan
lôn	lol	Nan
lôi	aṣiṣe	Nan
lô	pupo	Nan
lót	aṣọ	Nan
lóng	apọn	Nan
lóe	ti kuna	Nan
lóc	ejò	Nan
lòng	fifun pa	Nan
lò	adiro	Nan
líu	tutu	Nan
lít	lita	Nan
lính	jagunjagun	Nan
lí	ibi ipamọ	Nan
lình	lojiji	Nan
lìa	lọ	Nan
lênin	lenin	Nan
lênh	pipaṣẹ	Nan
lên	sókè	Nan
lêmạc	ina	Nan
lông	irun	Nan
lê	eso pia	Nan
lõi	mojuto	Nan
lùi	sẹhin	Nan
lưng	sẹhin	Nan
lư	onimọṣẹ	Nan
lơi	loosen	Nan
lơ	igbagbe	Nan
lũy	akopọ	Nan
lũng	afonifoji	Nan
lũ	omi	None
lĩnh	awọn ibugbe	Nan
lăng	ibi ikogun	Nan
lăn	yiyi	Nan
lăm	marun	Nan
lút	ajiwo	Nan
lúp	igbega	Nan
lúng	igbunaya ina	Nan
lún	subsidence	Nan
lúc	ni	Nan
lúa	paddy	Nan
lùng	ọdẹ	Nan
lùn	kukuru	Nan
lõm	ṣẹgun	Nan
ludendorff	ẹṣẹ	Nan
lén	isokuso	Nan
lão	atijọ	Nan
ly	gilasi	Nan
luỹ	akopọ	Nan
luộc	jinna	Nan
luồng	ṣiṣan	Nan
luồn	asapo	Nan
luật	ofin	None
luận	ọrọìwòye	Nan
luyện	idanileko	Nan
luyến	asomọ	Nan
luy	loy	Nan
luxembourg	luxembourg	Nan
luther	luther	None
lustig	ifẹkufẹ	Nan
lung	ẹdọfóró	Nan
lula	lula	Nan
luiz	luiz	Nan
luis	luis	Nan
lui	sẹhin	Nan
ludwig	ludwig	Nan
lydia	lidia	Nan
lèo	lèo	Nan
lympho	omi-olodi	Nan
lyon	lyon	Nan
lãnh	gba	None
lãm	fihan	None
lãi	iwulo	None
lây	leè	None
lâu	gun	None
lân	alailoye	Nan
lâm	lam	Nan
láng	didan	Nan
lán	gbọn	Nan
lái	wakọ	Nan
lách	olorun	Nan
lác	squint	Nan
lá	ewé	None
lào	laos	Nan
lành	larada	Nan
làng	abule	Nan
làn	ọna tooro	Nan
làm	ṣe	Nan
là	wà	Nan
lyndon	lailai	Nan
leonardo	leonardo	Nan
leonard	adẹtẹ	Nan
leon	leon	Nan
komodo	komodo	Nan
kogoro	kogoro	Nan
kofun	kofun	Nan
kodansha	kodansha	Nan
koch	koch	Nan
knuth	ọbẹ	Nan
knesset	knesset	Nan
km	kilomita	Nan
klein	klein	Nan
klaus	klaus	Nan
kiệu	aafin ọba	Nan
kiệt	aṣapẹrẹ	Nan
kiện	lati pe lẹjọ	Nan
kiệm	ti ọrọ-aje	Nan
kiểu	oriṣi	Nan
kiểm	ṣayẹwo	Nan
kiềm	ipilẹ	Nan
kiết	kiết	Nan
kiếp	igbesi aye	Nan
kon	kon	Nan
kiêu	agberaga	Nan
kong	kong	None
konversationslexikon	konversationslexikon	Nan
kunst	kunst	Nan
kungfu	egbe	None
kung	egbe	None
kune	kun	Nan
kulak	tọju	Nan
kuiper	kuiper	Nan
kuen	kuen	Nan
kubrick	kubrick	Nan
kuala	kuala	Nan
ku	ku	None
krông	aṣiṣe	Nan
kristen	kristen	Nan
kremlin	kremlin	Nan
kremli	kremli	Nan
kosovo	kosovo	Nan
koruna	koruna	Nan
kornai	kornai	Nan
koran	koran	Nan
kop	kop	Nan
konstantin	konstantin	Nan
kurd	kurd	Nan
kiêng	fun	None
kiêm	pẹlu	Nan
khổng	omiran	Nan
khổ	ijiya	Nan
khống	khong	Nan
khốn	ọmọ	None
khối	ipele	None
khốc	dire	Nan
khố	aṣọ fẹẹrẹ	Nan
khỏi	jade ti	Nan
khỏe	lagbara	Nan
khỏa	ihoho	Nan
khỉ	obo	Nan
khế	eso eso	Nan
khẳng	isọdi	Nan
khắp	gbogbo ibi	Nan
khắc	ogbontarigi	Nan
khẩn	amojuto ni	Nan
khấu	ẹdinwo	Nan
khấn	gbadura	Nan
khấm	gun	None
khởi	pilẹṣẹ	Nan
kiên	alaisan	Nan
khủng	ẹru	Nan
khứu	pastel	Nan
kitô	kristiẹni	Nan
kitts	ọmọ	None
kissinger	ẹnu ifẹnukonu	Nan
kiss	fẹnuko	Nan
kishimoto	kishimoto	Nan
kiribati	kiribati	Nan
kinsey	kinsey	Nan
kingdom	ijọba	Nan
kim	kim	Nan
kilômét	ibuso	None
kikyo	kikyo	Nan
kii	kii	Nan
kiernan	kiernan	Nan
kierkegaard	kierkegaard	Nan
kiel	kiel	Nan
kid	kekere	None
kia	iyẹn	Nan
ki	ki	None
khử	imukuro	Nan
khủyu	ọmọ	None
kurt	kurt	Nan
kuwait	ara ilu	Nan
kwan	kwan	Nan
larry	larry	Nan
lap	ipele	None
laos	laos	Nan
lao	jẹdọjẹdọ	Nan
lanka	lanka	None
lanh	aṣọ-ọgbọ	Nan
langue	ìbá	Nan
lange	gbẹsan	Nan
langdon	lọndọnì	Nan
lang	l’or	Nan
landon	landon	Nan
land	ilẹ	None
lan	lan	Nan
lama	lama	Nan
lam	lam	Nan
lai	arabara	Nan
ladakh	ladakh	Nan
laboulaye	laboulaye	Nan
label	aami	Nan
lars	lars	Nan
l	l	Nan
las	las	Nan
lateran	pẹran	Nan
leo	gun	None
lenins	awọn lẹnsi	Nan
lenin	lenin	Nan
lem	lem	Nan
leiden	leiden	Nan
legacy	julọ	Nan
lee	lee	Nan
lebanon	lebanon	Nan
leave	lọ	Nan
leaf	ewe	None
leach	leach	Nan
lazarus	lazarus	Nan
lay	dubulẹ	Nan
lawrence	agbofinro	Nan
laurence	laurence	Nan
laura	laura	Nan
lau	nù	Nan
latvia	latvia	None
latinh	latini	None
laser	lesa	Nan
kỷ	orundun	Nan
kỵ	ẹṣin	Nan
kịp	tọju	Nan
kí	ami	Nan
kình	gilaasi	Nan
kìm	olutayo	Nan
kìa	wò o	Nan
kêu	ariwo	Nan
kênh	awọn ikanni	Nan
kê	jero	Nan
két	aabo	Nan
kép	meji	Nan
kéo	fa	Nan
kén	cocoon	Nan
kém	o kere ju	Nan
kèn	ipè	Nan
kèm	paade	Nan
kyūshū	kyūshū	Nan
kyushu	kyushu	Nan
kyrgyzstan	kyrinkistan	Nan
kwon	kwon	Nan
kwen	kwen	Nan
kích	tẹ	Nan
kíchbom	tẹbutton	Nan
kín	ikọkọ	Nan
kính	gilaasi	Nan
kị	ẹṣin	Nan
kỉ	orundun	Nan
kệ	selifu	Nan
kềnh	olopobobo	Nan
kề	nitosi	None
kết	ipari	Nan
kế	itele	Nan
kẽm	sinkii	Nan
kẽ	aarin	Nan
lươn	eel	Nan
kẻo	boya	Nan
kẹt	di	Nan
kẹp	agekuru	Nan
kẹo	suwiti	Nan
kạn	kan	None
kơnia	kàia	Nan
kĩ	farabalẹ	Nan
ký	ami	Nan
kít	réré	Nan
kíp	atuko	Nan
kẻ	buruku	Nan
lương	ekunwo	Nan
lưới	akoj	Nan
lướt	wiwo	Nan
moi	tuntun	None
mohammed	mohammed	Nan
mohammad	mohammad	Nan
modula	modulu	Nan
modul	module	Nan
mode	ipo	None
mobile	alagbeka	Nan
mm	mm	Nan
miệng	ẹnu	Nan
miện	ade	Nan
miễn	itusilẹ	Nan
miền	ašẹ	Nan
miếu	tẹmpili	Nan
miếng	awọn ege	Nan
miến	ounjẹ iresi	Nan
miêu	o nran	Nan
miên	hypnosis	Nan
mitsubishi	mitsubishi	Nan
mitchel	mitili	Nan
molecular	molikula	Nan
missouri	missouri	Nan
molotov	molotov	Nan
mongolia	mongolia	Nan
morocco	morocco	Nan
morley	morley	Nan
moriarty	moriarty	Nan
mori	mori	Nan
morgan	morgan	None
moravia	moravia	Nan
mora	mora	Nan
moong	moong	Nan
moo	moo	Nan
montreal	montreal	Nan
montparnasse	montparnasse	Nan
montmartre	montmartre	Nan
montenegro	montenegro	Nan
montana	montana	Nan
montaigne	montaigne	Nan
mont	mont	Nan
monroe	monroe	Nan
mono	eyọkan	Nan
monique	monique	Nan
molypden	molybdenum	Nan
morris	morris	Nan
mississippi	mississippi	Nan
miroku	miroku	Nan
michigan	michigan	Nan
michelangelo	michelangelo	Nan
michaels	awon olorin	Nan
michael	olorin	Nan
miami	miami	Nan
meyers	meyers	Nan
meyer	meyer	Nan
mext	mext	Nan
meteora	meteora	Nan
messiah	mèsáyà	Nan
messi	miése	Nan
messerschmitt	messerschmitt	Nan
messenger	ojiṣẹ	Nan
mercedes	mercedes	Nan
menes	awọn ọkunrin	Nan
mendeleev	mendeleev	Nan
melbourne	ile iṣu	Nan
mekong	mekong	Nan
medvedev	medvedev	Nan
micro	bulọọgi	Nan
misfits	awọn aitọ	Nan
microbiology	makirobia	Nan
micronesia	micronesia	None
mirage	irukerudo	Nan
miraflores	ebubeflores	Nan
minoa	minoa	Nan
minnesota	minnesota	None
ming	ming	Nan
mindanao	mindanao	Nan
minas	iyokuro	Nan
min	min	Nan
milton	milton	Nan
miller	miller	Nan
mill	ọlọ	Nan
miley	maili	Nan
milano	milano	Nan
milan	malan	Nan
mikoyangurevich	mikoyangurevich	Nan
mikoyan	mikoyan	Nan
mike	ji	Nan
miguel	miguel	Nan
microsoft	microsoft	Nan
microeconomics	microeconomics	Nan
morrison	ẹlẹwọn	Nan
morse	pẹtẹlẹ	Nan
moscow	mọṣaga	Nan
mép	eti	Nan
méo	daru	None
mé	mi	Nan
mèo	o nran	Nan
mè	sesame	Nan
mão	awọn ade	Nan
mãnh	lagbara	Nan
mãn	aladun	Nan
mãimại	koodu	Nan
mãi	lailai	Nan
mã	koodu	Nan
mây	awọsanma	Nan
mâu	ilodi	Nan
mân	rosary	Nan
mâm	atẹ	Nan
máy	ẹrọ	Nan
máu	ẹ̀jẹ̀	Nan
mát	tutu	Nan
mái	orule	Nan
mét	mita	Nan
máclênin	marxelenin	Nan
mênh	lilu	Nan
mì	alaiṣododo	Nan
münchen	münchen	Nan
mút	muyan	Nan
múa	jó	Nan
mùi	oorun	Nan
mùa	akoko	Nan
mù	afoju	Nan
môtô	alupupu	Nan
môt	ọkan	Nan
mônôxít	ẹyọkan	Nan
mông	àgbọn	Nan
môn	wonyen	Nan
môi	kọọkan	Nan
mô	àsopọ	Nan
món	oúnjẹ	None
móc	kio	Nan
mòn	itọpa	Nan
mò	fọnnu	Nan
mía	ohun ọgbin	Nan
mình	funrararẹ	Nan
mêtan	gaasi	Nan
mách	awọn imọran	Nan
mác	aami	Nan
má	iya	Nan
murdoch	murdoch	Nan
munich	munich	Nan
mun	ebony	Nan
mumbai	mumbai	Nan
muhammad	muhammad	Nan
much	pọ	Nan
mua	ra	None
mu	mu	Nan
mtv	mtv	Nan
msdos	msdos	Nan
ms	m	Nan
mp	mp	Nan
mozart	mozart	Nan
mozambique	mozambique	None
movie	fiimu	Nan
mourinho	mourinho	Nan
motown	òtútú	Nan
moskva	ẹṣoki	Nan
mosin	mosin	Nan
muromachi	muromachi	Nan
murphy	iku	None
murray	kigbe	Nan
mustang	mustang	Nan
mày	iwo	Nan
màu	awọ	Nan
mào	didimu	Nan
mành	afọju	Nan
màn	iboju	Nan
mài	lilọ	Nan
mà	ṣugbọn	Nan
myspace	myspace	Nan
myanmar	madium	Nan
medina	medina	Nan
myanma	màríà	Nan
muội	arabinrin	Nan
muỗng	sibi	Nan
muỗi	efon	Nan
muồi	pẹ	Nan
muống	sibi	Nan
muốn	fẹ	Nan
muối	iyo	Nan
muôn	fẹ	Nan
muta	muta	Nan
muộn	pẹ	Nan
khảo	àyẹ̀wò	Nan
medici	medici	Nan
mcv	mcv	Nan
lộc	ọrọ	Nan
lỗ	iho	Nan
lồng	ile-ẹyẹ	Nan
lồi	apejọ	Nan
lồ	omiran	Nan
lốt	itanjẹ	Nan
lốp	taya ọkọ	Nan
lối	ẹnu ọna	Nan
lốc	iji lile	Nan
lố	lori	Nan
lỏng	tú	None
lỏi	fẹẹrẹ	Nan
lọt	ṣubu	Nan
lọng	parasol	Nan
lọi	squint	Nan
lọc	àlẹmọ	Nan
lịch	kalẹnda	Nan
lị	rírin	Nan
lệnh	comeinand	Nan
lội	we	Nan
lệch	sẹsẹ	Nan
lộn	fọn	Nan
lột	rinhoho kuro	Nan
lự	aṣiyemeji	Nan
lửng	awako	Nan
lừng	alaapẹrẹ	Nan
lừa	ẹtan	Nan
lứa	idalẹnu	Nan
lụy	awọn ilolu	Nan
lụt	rẹwẹsi	Nan
lụi	run si isalẹ	Nan
lục	ewe	None
lụa	siliki	Nan
lợp	òrùlé	Nan
lợn	ẹlẹdẹ	Nan
lợi	èrè	Nan
lỡ	sọnu	Nan
lở	padanu	Nan
lời	ọrọ	Nan
lờ	foju	Nan
lớp	kilasi	Nan
lớn	nla	Nan
lộng	alayeye	Nan
lựa	yan	None
lệ	oṣuwọn	Nan
lều	agọ	Nan
lấy	mu	Nan
lấp	kun	Nan
lấn	ihamọra	Nan
lạy	tẹriba	Nan
lạtma	lamma	Nan
lạp	soseji	Nan
lạng	lẹnti	Nan
lạn	ru	Nan
lại	lẹẹkansi	Nan
lạch	odò	Nan
lạc	sọnu	Nan
lạ	ajeji	Nan
lǐ	lǐ	Nan
lượn	yipo	Nan
lượm	kó	Nan
lược	konbo	Nan
lưỡng	iselàgbedemeji	Nan
lưỡi	ahọn	Nan
lười	ọlẹ	Nan
lầm	ko	None
lễ	ayẹyẹ	Nan
lần	awọn akoko	Nan
lầy	rirun	Nan
lề	ala	None
lẻo	dẹra	Nan
lẻn	ajiwo	Nan
lẻ	odd	Nan
lẹ	yiyara	Nan
lặt	oriṣiriṣi	Nan
lặp	tun	Nan
lặng	dakẹrọrọ	Nan
lắp	ibaamu	Nan
lắng	lati yanju	Nan
lắm	pupọ	Nan
lắc	gbọn	Nan
lậy	beni	Nan
lật	isipade	Nan
lận	iyanjẹ	Nan
lẫy	fun	None
lẫn	dapo	Nan
lẩy	fo	Nan
lẩu	ikoko ti o gbona	Nan
lầu	ilẹ	None
lựu	pomegranate	Nan
ma	iwin	Nan
maastricht	maastricht	Nan
mary	mary	Nan
marx	odo	Nan
martin	martin	Nan
marta	marta	Nan
marsu	marsu	Nan
marshall	marshall	Nan
marseille	marseille	Nan
mars	ọkunrin	Nan
marne	pẹtẹlẹ	Nan
marmara	marmara	Nan
marić	marić	Nan
marino	igbafẹfẹ	Nan
marina	marina	Nan
marie	ọkọ	Nan
marianne	marianne	Nan
maria	arabinrin	Nan
margaret	ẹla	Nan
marcus	ayase	Nan
marcos	marcos	Nan
maryland	maryland	None
marcel	marcel	Nan
maría	amí	Nan
massachusetts	awọn ọgangan	Nan
mcnamara	mcnamara	Nan
mcmahon	mcmahon	Nan
mclaren	mclaren	Nan
mchc	mchc	Nan
mcdonald	mcdonald	Nan
mccullough	iṣupọju	Nan
mccartney	mccartney	Nan
mccain	mccaini	Nan
mcafee	mcafee	Nan
maya	ogun	None
may	ran	Nan
maxim	maxim	Nan
mausolus	mausolus	Nan
maurice	maurice	Nan
mau	yarayara	Nan
matthias	matthias	Nan
mats	awọn ọmu	Nan
mathematica	iṣiro	Nan
mat	ẹni	Nan
mas	mas	Nan
marc	akọrin	Nan
marat	maranti	Nan
maradona	ẹlẹṣin	Nan
mainframe	akọkọframe	Nan
mai	orule	Nan
mahal	maili	Nan
magiê	iṣuu magnẹsia	Nan
mafia	nsomi	Nan
madrid	ilu madrid	Nan
madonna	aṣiwere	Nan
madison	madison	Nan
madhouse	ile were	Nan
madeira	ṣeira	Nan
macromedia	macromedia	Nan
macma	magma	Nan
macintosh	macintosh	Nan
machu	machu	Nan
machiavelli	machiavelli	Nan
mach	ẹrọ	Nan
macedonia	macedonia	Nan
macclesfield	macclesfield	Nan
macarthur	macarthur	Nan
major	pataki	Nan
makemake	ṣe ọti oyinbo	Nan
malacca	malabe	Nan
malay	malay	None
maps	maapu	None
mao	mao	Nan
manuel	manuel	Nan
manti	manti	Nan
mankiw	mankiw	Nan
manila	manila	Nan
manh	manh	Nan
mangnall	mangnall	Nan
manga	manga	Nan
media	media	Nan
mang	gbe	None
mandela	mandela	Nan
manchester	manchester	Nan
manche	manche	Nan
maluku	maluku	Nan
malta	malta	Nan
mali	mali	None
maldini	maldini	Nan
malcolm	ibi	Nan
malaysia	malaysia	None
mandy	baba	Nan
giòi	iṣu	Nan
khảm	amọ	Nan
khả	seese	Nan
hiếm	ṣọwọn	Nan
hiđrô	hydrogen	Nan
hiên	iloro	Nan
hitters	awọn ikọlu	Nan
hitter	kọlu	Nan
hitler	kọlu	Nan
hitchcock	kọlu	Nan
hiroshima	hiroshima	Nan
hiroshi	hiroshi	Nan
hiragana	hiragana	Nan
hinhtron	hórónì	Nan
hinh	hinh	Nan
hindu	hindu	Nan
hindi	hindi	Nan
hindenburg	hindenburg	Nan
hinata	hinata	Nan
himalaya	himalaya	Nan
hilton	hilton	Nan
hillsborough	egbe	None
hiến	fifun	Nan
hidro	hydrogen	Nan
hiếp	ifipabanilopo	Nan
hiềm	aisan	Nan
holocen	holocene	Nan
holocaust	ipanu	Nan
holmes	awọn iho	Nan
hokusai	hokusai	Nan
hokage	eré	Nan
hoi	hoi	Nan
hogwarts	hogwarts	Nan
hoan	ayẹyẹ	Nan
hoa	òdòdó	Nan
hn	loni	Nan
hmông	hmong	Nan
hms	hms	Nan
hlv	olukọ	Nan
hiệu	ipa	Nan
hiệp	idaji	None
hiện	ṣafihan	Nan
hiểu	loye	Nan
hiểm	lewu	Nan
hiền	sage	Nan
hiếu	ibẹru igboya	Nan
holt	holt	Nan
hideyoshi	hideyoshi	Nan
hicks	hicks	Nan
heath	ilera	Nan
health	ilera	Nan
he	oun	None
hd	hd	Nan
hcl	hcl	Nan
hbv	hbv	Nan
hb	hb	Nan
hay	o dara	Nan
hawking	yinyin	Nan
hawker	ode onija	Nan
havilland	haṣile	Nan
havana	havana	Nan
harvey	harvey	Nan
harvard	harvard	Nan
harry	harry	Nan
harris	harris	Nan
harrier	alairi	Nan
harpercollins	harpercollins	Nan
harper	harper	Nan
hee	hee	Nan
hideto	hideto	Nan
hegel	hegel	Nan
heinrich	heinrich	None
hickam	hickam	Nan
hi	bawo	Nan
hestia	hektari	Nan
hesiod	igbaju	Nan
hersh	arabinrin	Nan
hermes	hermes	Nan
hermann	hermann	Nan
hercules	hercules	Nan
hercegovina	hercegovina	Nan
herbert	herbert	Nan
her	rẹ	None
heo	stale	Nan
henry	henry	Nan
hen	gboo	Nan
hemoglobin	haemololobin	Nan
hematocrit	idaamu	Nan
heli	irinse	Nan
helena	helena	Nan
helen	helen	Nan
heian	arabinrin	Nan
harold	harold	Nan
hom	eso	Nan
hon	ẹni	Nan
hán	ogbele	Nan
hái	mu	Nan
hách	apọju	Nan
hào	moat	Nan
hàng	kana	Nan
hàm	eegun	Nan
hài	awada	Nan
hà	ha	Nan
hyperion	hyperion	Nan
hydro	hydrogen	Nan
hydra	hydra	Nan
huỷ	fagile	None
huỳnh	efin	Nan
huống	ọran	Nan
huệ	hue	Nan
huế	hue	Nan
huấn	idanileko	Nan
huê	hue	Nan
huân	huan	Nan
háo	ni itara	Nan
huyệt	awọn aaye acupuncture	Nan
hát	kọrin	Nan
hân	han	Nan
hót	kọrin	Nan
hóc	hóc	Nan
hòng	daradara	Nan
hòn	erekusu	Nan
hòm	ọkọ	Nan
hòe	nik	Nan
hòa	tai	Nan
hò	ibaṣepọ	Nan
hít	simi	Nan
hí	àí	Nan
hên	oriire	None
hét	kigbe	Nan
héo	gbẹ	Nan
hé	ti fẹẹrẹ	Nan
hè	igba ooru	Nan
hãnh	agberaga	Nan
hãng	ile-iṣẹ	Nan
hãn	khan	Nan
hãi	bẹru	Nan
hâm	irikuri	Nan
homer	homer	Nan
huyện	agbegbe	Nan
huyền	mystical	Nan
hoạ	kun	Nan
hoãn	wọn	None
hoán	perm	Nan
hoá	kemistri	Nan
hoành	diaphragm	Nan
hoàng	ọba	Nan
hoàn	pari	Nan
hoài	alaibọwọ	Nan
hoà	tai	Nan
however	sibẹsibẹ	Nan
howard	bawo	Nan
houston	houston	Nan
hotspur	hotspur	Nan
hornet	awó	Nan
hopkins	hopkins	Nan
honshū	honshū	Nan
honolulu	honolulu	Nan
hong	hong	Nan
honduras	honduras	Nan
hoại	ajagun	None
huyễn	itanran	Nan
hoạt	hentai	Nan
hoảng	ẹrù	Nan
huynh	arakunrin	Nan
huy	ooya	Nan
hutech	hutech	Nan
huston	huston	Nan
husserl	husserl	Nan
hussein	hussein	Nan
hurley	huruu	Nan
hunt	ọdẹ	Nan
hungary	onigun	Nan
hun	hun	None
hume	hume	Nan
hugo	hugo	Nan
hughes	famọra	Nan
huey	huey	Nan
hudson	hudson	Nan
hudgens	hudgens	Nan
hq	hq	Nan
hp	hp	None
hoặc	tabi	None
hoả	ina	Nan
harlow	harlow	Nan
harlem	harlem	Nan
hardy	haddi	Nan
greenson	ọya	Nan
greenland	ewe	None
greek	ọfun	Nan
granit	giranaiti	Nan
granada	granada	Nan
graham	graham	Nan
grabeel	mú	Nan
gottfried	gottfried	Nan
gothic	onibaje	Nan
gorky	gorky	Nan
gore	gore	Nan
gordon	gordon	Nan
gorbachyov	gorbachyov	Nan
gorbachev	gorbachev	Nan
google	google	Nan
gom	kó	Nan
golden	ti goolu	Nan
goku	goku	Nan
goes	lọ	Nan
greenwich	ewe	None
go	lọ	Nan
greg	greg	Nan
grenadines	alumọni	Nan
gundam	gundam	Nan
gullit	gullit	Nan
gulf	ọgbun	Nan
gulag	gulag	Nan
gujarat	gujarati	Nan
guitar	gita	Nan
guinness	guinness	Nan
guinea	guinea	None
gui	gui	Nan
guatemala	guatemala	Nan
guard	ṣọ	Nan
guam	guam	Nan
gu	ara	Nan
gsts	gsts	Nan
gs	gs	Nan
gryffindor	gryffindor	Nan
gruzia	georgia	None
grumman	gúnfá	Nan
gross	gbogbogbo	None
grenada	alumọni	Nan
gunung	ìbọn	Nan
gnp	gnp	Nan
glucose	glukosi	Nan
giặc	ọtá	Nan
giằng	àmúró	Nan
giận	binu	Nan
giầu	ọlọrọ	Nan
giấy	iwe	Nan
giấu	tọju	Nan
giấm	kikan	Nan
giấc	sun	None
giản	irọrun	Nan
giảm	idinku	Nan
giải	ojutu	Nan
giả	iro	Nan
giường	ibusun	Nan
giương	didọ	Nan
giơ	jam	Nan
giũa	faili	Nan
giúp	egba	None
gióng	fẹran	Nan
gió	afẹfẹ	Nan
giặt	wẹ	Nan
gmail	gmail	Nan
giếng	daradara	Nan
giềng	aládùúgbò	Nan
gloster	ibowo	Nan
gloria	gloria	Nan
glonass	ekan	Nan
glazer	glazer	Nan
gladys	ayo	Nan
giữa	laarin	None
giữ	mu	Nan
giục	ro	None
giỡn	nse	None
giở	filasi	Nan
giờ	wakati	Nan
giới	akọ	Nan
giỗ	iku	None
giồng	giong	Nan
giỏi	nla	Nan
giỏ	apeere	Nan
giọt	silẹ	Nan
giọng	ohun orin	Nan
giễu	ipaya	Nan
giết	pa	Nan
gustave	gustave	Nan
gutenberg	gutenberg	Nan
guyana	guyana	Nan
gỡ	yọ	None
gởi	firanṣẹ	Nan
gờ	adari	Nan
gớm	hideous	Nan
gộp	dapọ	Nan
gội	ọṣẹ-ifọrun	Nan
gỗ	igi	Nan
gồng	gong	Nan
gồm	pẹlu	Nan
gốm	seramiki	Nan
gối	irọri	Nan
gốc	oti	Nan
gỏi	saladi	Nan
gọt	peeli	Nan
gọng	rimmed	Nan
gọn	afinju	Nan
gọi	pe	Nan
gỉ	ariyanjiyan	Nan
gặt	kórè	Nan
gợi	aba	Nan
gặp	pàdé	Nan
gục	silẹ	Nan
gửi	lati firanṣẹ	Nan
harald	harald	Nan
hao	hao	Nan
hansen	hansen	Nan
hanja	hanja	Nan
hanh	hanh	Nan
hangul	hangul	Nan
hang	ihò	Nan
han	han	Nan
hamilton	amọtẹ	Nan
ham	ngbe	Nan
halogen	halogen	Nan
halle	ni agbedemeji	Nan
hal	ọkan	Nan
hai	meji	Nan
hahn	hahn	Nan
haeberle	haeberle	Nan
habsburg	habsburg	None
habana	habana	Nan
ha	ha	Nan
gừng	atalẹ	Nan
gặm	panini	Nan
gắt	lile	Nan
gắng	gbidanwo	Nan
góp	san-diẹdiẹ	Nan
gói	package	Nan
góc	igun	Nan
góa	opó	Nan
gòn	gòke	Nan
gò	òkè	Nan
gìn	se itoju	Nan
gì	kini	Nan
gãy	fifọ	Nan
gây	fa	Nan
gân	sunmọ	Nan
gáy	nape	Nan
gánh	gbe	None
gán	yan	None
gái	ọmọbinrin	Nan
gác	ṣọ	Nan
gào	pariwo	Nan
gài	tuck	Nan
gà	adiẹ	Nan
gót	igigirisẹ	Nan
gõ	oriṣi	Nan
göbbels	göbbels	Nan
găm	hoard	Nan
gắn	agesin	Nan
gắm	fart	Nan
gậy	ọpá	Nan
gập	agbo	Nan
gẫy	fifọ	Nan
gầy	tinrin	Nan
gần	nitosi	None
gấu	agbateru	Nan
gấp	yiyara	Nan
hô	ho	Nan
gấm	agbọnrin	Nan
gảy	fọ	Nan
gả	igbeyawo	None
gạt	jibiti	Nan
gạo	iresi	Nan
gạc	eefun	Nan
gương	digi	Nan
gươm	idà	Nan
gũi	sunmọ	Nan
găng	awọn ibọwọ	Nan
gấc	ọwọ	Nan
hôi	ulrun	Nan
hôm	ọjọ	Nan
hôn	fẹnuko	Nan
kashmir	kashmir	Nan
karim	karim	Nan
karen	karen	Nan
karatedo	karatedo	Nan
karate	karate	Nan
karaoke	karaoke	Nan
kara	kara	Nan
kar	kar	Nan
kant	kant	Nan
kanji	kanji	Nan
kangin	kangin	Nan
kana	kana	Nan
kampuchea	kampuchea	Nan
kampong	kampong	Nan
kampf	kampf	Nan
kamov	kamov	Nan
kamakura	kamakura	Nan
kama	kama	Nan
kali	potasiomu	Nan
kaspersky	kaspersky	Nan
kalashnikov	kalashnikov	Nan
katakana	katakana	Nan
katherine	katherine	Nan
kentucky	kentucky	Nan
kenny	omobirin	Nan
kenneth	keno	Nan
kennedy	keniyan	Nan
ken	keno	Nan
kem	ipara	Nan
kelvin	kelvin	Nan
kelsi	kelsi	Nan
kelly	kelly	Nan
ke	ke	Nan
kcn	kcn	Nan
kazan	kazan	Nan
kay	kay	Nan
kawasaki	kawasaki	Nan
kavkaz	caucasus	Nan
kauthara	kauthara	Nan
katz	katz	Nan
katrina	katirina	Nan
kathmandu	kathmandu	Nan
kate	kate	Nan
kepler	kepler	Nan
kaká	kaká	Nan
kai	kai	Nan
joint	apapọ	Nan
johor	johor	Nan
johnston	johnston	Nan
johns	johns	Nan
johnny	johnny	Nan
johannesburg	johannesburg	Nan
johannes	johannes	Nan
johann	johann	None
johan	johan	Nan
joe	joe	Nan
joan	joan	Nan
joachim	joachim	Nan
jiraiya	wa nibẹ	Nan
jing	jing	Nan
jin	ẹmi	Nan
jimmy	jimmy	Nan
jiao	jiao	Nan
jewish	ẹwa	Nan
jetstar	jetstar	Nan
jonathan	jonathan	Nan
kakashi	kakashi	Nan
jones	awọn agbegbe	Nan
joseon	joseoni	Nan
kahn	kahn	Nan
kagome	kagome	Nan
kaffee	kafe	Nan
kaede	kaede	Nan
k	k	Nan
juventus	juventus	Nan
jura	jura	Nan
jupiter	jupita	Nan
junsu	junsu	Nan
jung	igbo	Nan
june	juni	Nan
jump	fo	Nan
julliard	julliard	Nan
julesverne	julesverne	Nan
judo	judo	Nan
judith	idajo	None
juche	juche	Nan
jscript	jscript	Nan
joseph	joseph	Nan
jose	jose	Nan
kerala	kerala	Nan
kevin	kevin	Nan
keynes	keynes	Nan
khánh	ominira	Nan
kháng	atako	Nan
khán	àwùjọ	Nan
khám	àyẹ̀wò	Nan
khái	erongba	Nan
khách	àlejò	Nan
khác	omiiran	Nan
khá	dipo	Nan
khuỷu	igbonwo	Nan
khuếch	fẹẹrẹ	Nan
khuẩn	arun	None
khuấy	ru	Nan
khuất	farapamọ	Nan
khuyển	aja	Nan
khuyết	alebu	Nan
khuyên	imọran	Nan
khuynh	osi	Nan
khural	ẹlẹṣẹ	Nan
khung	awọn fireemu	Nan
khát	ongbẹ	Nan
khu	ẹgbẹ	Nan
khâm	khám	Nan
khéo	ọlọgbọn	Nan
khước	sẹ	Nan
khưu	khưu	Nan
khư	khư	Nan
khơi	ti ita	Nan
khăn	aṣọ inura	Nan
khăm	oorun alarun	Nan
khúc	apa	Nan
không	kiise	Nan
khôn	ologbon	Nan
khô	gbẹ	Nan
khóm	ope oyinbo	Nan
khói	ẹfin	Nan
khóc	kigbe	Nan
khóa	atipa	Nan
khó	nira	Nan
khít	sunmọ	Nan
khích	gba	None
khía	ogbontarigi	Nan
khép	sunmọ	Nan
khèn	alas	Nan
khrushchyov	khrushchyov	Nan
khrushchev	khrushchev	Nan
khoẻ	dara	Nan
khiên	asà	Nan
khiêm	iwọntunwọnsi	Nan
khieu	ko	None
khi	nigbati awọn	Nan
kheo	lori stilts	Nan
khen	iyin	Nan
khem	khem	Nan
khe	iho	Nan
khay	atẹ	Nan
khao	npongbe	Nan
khanh	khanh	Nan
khang	khang	Nan
khan	onitutu	Nan
kham	kham	Nan
khalip	khalip	Nan
khali	khali	Nan
khai	ìpolongo	None
kha	kha	Nan
kg	kg	Nan
khiêu	itara	Nan
khiếm	àìlera	Nan
khiến	fa	Nan
khiếp	jìnnìjìnnì	Nan
khoảnh	asiko	Nan
khoảng	feleto	Nan
khoản	nkan	None
khoả	ihoho	Nan
khoăn	fret	Nan
khoét	ge	Nan
khoát	pataki	Nan
khoáng	alumọni	Nan
khoán	ọja	Nan
jesus	jesu	None
khoác	aṣọ bibori	Nan
khoe	fifihan	None
khoanh	pariwo	Nan
khoang	iho	Nan
khoan	lu	Nan
khoa	olukọ	Nan
kho	ile itaja	Nan
khleang	khleang	Nan
khiển	iṣakoso	Nan
khiếu	ayagbe	Nan
khoá	tiipa	Nan
khải	ifihan	Nan
jesse	jesse	Nan
jersey	aso	Nan
hồ	adagun	Nan
hốc	awọn ohun amọja	Nan
hố	ọfin	Nan
hỏng	fifọ	Nan
hỏa	ina	Nan
họp	ipade	Nan
họng	ọfun	Nan
học	kọ ẹkọ	Nan
họach	gbero	Nan
họa	aworan	Nan
họ	orukọ idile	Nan
hịch	ojiji	Nan
hỉ	fẹ	Nan
hệt	aami	Nan
hệ	eto	Nan
hễ	eh	Nan
hề	apanilerin	Nan
hết	lori	Nan
hến	igbin	Nan
hồi	aniisi	Nan
hẻo	ni ifipamo	Nan
hồn	ọkàn	Nan
hổi	huh	Nan
hửu	hu	Nan
hử	hu	Nan
hứa	ṣèlérí	Nan
hủy	fagile	None
hủi	adẹtẹ	Nan
hụt	aipe	Nan
hợpquận	gbigba wọle	Nan
hợp	daradara ti baamu	Nan
hợi	ẹlẹdẹ	Nan
hỡi	oi	Nan
hở	ṣii	Nan
hờn	sulky	Nan
hớn	kigbe	Nan
hới	ṣii	Nan
hộp	àpótí	Nan
hội	ajọdun	Nan
hỗn	dapọ	Nan
hỗ	atilẹyin	Nan
hổng	gaping	Nan
hổ	ẹyẹ	Nan
hữu	ohun-ini	Nan
hẻm	ale	Nan
hẹ	shallots	Nan
hưởng	gbadun	Nan
hường	huong	Nan
hướng	itọsọna	Nan
hước	apanilẹrin	Nan
hương	turari	Nan
hưu	fẹyìntì	Nan
hư	buburu	Nan
hơn	ju	Nan
hơi	kekere	None
hũ	pọn	Nan
hđh	hđh	Nan
hđbt	hđbt	Nan
hăng	pungent	Nan
hút	mimu siga	Nan
húng	awokose	Nan
húc	gore	Nan
hùng	awọn akọni	Nan
hù	idẹruba	Nan
hông	ibadi	Nan
hạ	igba ooru	Nan
hẹp	dín	Nan
hạc	igbona	Nan
hại	ipalara	Nan
hặc	hặc	Nan
hằng	loorekoore	Nan
hắt	sinmi	Nan
hắn	rẹ	None
hắc	dudu	Nan
hậu	ayaba	Nan
hận	korira	Nan
hầu	fẹẹrẹ	Nan
hầm	eefin	Nan
hấu	elegede	Nan
hất	yipo	Nan
hấn	hấn	Nan
hảo	pipe	Nan
hải	awọn kọsitọmu	Nan
hạt	irugbin	Nan
hạp	hap	Nan
hạo	hao	Nan
hạnh	hanh	Nan
hạng	kilasi	Nan
hạch	ẹgbẹ ẹgbẹ	Nan
hựu	huu	Nan
hỷ	hy	Nan
ian	ian	Nan
jae	bẹẹni	Nan
jacob	jacob	Nan
jackson	apinfunni	Nan
jackie	jackie	Nan
jack	jaketi	Nan
j	j	Nan
iwami	iwami	Nan
iv	iv	Nan
itzá	itzá	Nan
itu	itu	None
itsukushima	itsukushima	Nan
ito	ito	Nan
itanium	itonia	Nan
italiano	italiano	Nan
italia	italia	Nan
istanbul	tantanébúbù	Nan
israeli	israeli	Nan
islamabad	islamabad	Nan
islam	islamu	Nan
jakarta	jakarta	Nan
isla	náà	None
jan	ọrun	Nan
janet	janet	Nan
jerry	jeri	Nan
jerome	jò	Nan
jericho	jericho	Nan
jenny	ijeku	Nan
jenda	jenda	Nan
jeju	jeju	Nan
jeffrey	jeffrey	None
jefferson	jomorsoni	Nan
jeff	jeff	Nan
jeet	jeet	Nan
jeans	sokoto	Nan
jeanpaul	jeanpaul	Nan
jeanjacques	jeanjacques	Nan
jeane	jeane	Nan
jean	jean	Nan
jasper	jasimi	Nan
jarvis	idẹ	Nan
jared	jared	Nan
japan	japan	Nan
janeiro	janeiro	Nan
isaac	isale	Nan
irving	irving	Nan
irony	irony	Nan
impact	ikolu	Nan
immanuel	manuelmmanuelkùnrin	Nan
imbrium	imbrium	Nan
imam	imam	Nan
im	im	Nan
ilyich	ilyich	Nan
illusion	iruju	Nan
ilene	ilene	Nan
iii	iii	Nan
igor	igor	Nan
ieng	ieng	Nan
ide	ide	Nan
iceland	yinyin	Nan
icc	icc	Nan
ic	àú	Nan
ibmpc	ibmpc	Nan
ibm	ibm	Nan
iberia	ara ilu iria	Nan
iau	iau	Nan
incoterm	incoterm	Nan
incoterms	incoterms	Nan
indian	ara ilu	Nan
indiana	indiana	Nan
irgun	irgun	Nan
ireland	ireland	Nan
iraq	iraaki	Nan
iran	iran	Nan
iosif	iosif	Nan
ion	dẹlẹ	Nan
ioc	ioc	Nan
io	io	Nan
inư	inu	Nan
jerusalem	jerusalẹmu	Nan
inuyasha	inuyasha	Nan
interpol	interpol	Nan
intel	intel	Nan
int	int	Nan
insulin	hisulini	Nan
innsbruck	innsbruck	Nan
info	alaye	Nan
indrapura	inu rirun	Nan
indonesia	ara ilu indonia	Nan
indochina	indochina	Nan
inu	inu	Nan
≠	≠	Nan
