$ tỉ	billion பில்லியன்	Nan
rico	ரிக்கோ	Nan
richie	பணக்காரர்	Nan
richardson	ரிச்சர்ட்சன்	Nan
richard	ரிச்சர்ட்	Nan
ricci	ரிச்சி	Nan
ricardo	ரிக்கார்டோ	Nan
rica	ரிக்கா	Nan
rhodes	ரோட்ஸ்	Nan
rfid	rfid	Nan
rey	ரே	Nan
revolution	புரட்சி	None
reverse	தலைகீழ்	Nan
resort	உல்லாசப்போக்கிடம்	Nan
reserve	இருப்பு	None
reo	மோதிரம்	Nan
rené	rené	Nan
renault	renault	Nan
renaissance	மறுமலர்ச்சி	None
ren	சரிகை	Nan
riemann	ரைமான்	Nan
reichelt	மறுபரிசீலனை செய்யுங்கள்	Nan
rimjob	ரிம்ஜோப்	Nan
rising	உயரும்	None
rodríguez	ரோட்ரிகஸ்	Nan
roddick	ராடிக்	Nan
rockefeller	ராக்ஃபெல்லர்	Nan
robinson	ராபின்சன்	Nan
robin	ராபின்	Nan
robespierre	robespierre	Nan
roberts	ராபர்ட்ஸ்	Nan
roberto	roberto	Nan
robert	ராபர்ட்	None
ro	ro	Nan
riềng	galangal	Nan
riết	அமைதி	None
riêu	riêu	Nan
riêng	தனிப்பட்ட	None
rizal	rizal	Nan
rivière	rivière	Nan
rivaldo	போட்டி	None
ritchie	ரிச்சி	Nan
risk	ஆபத்து	None
rin	துவைக்க	Nan
roi	தடி	Nan
regia	ரெஜியா	Nan
reap	அறுவடை	None
ralph	ரால்ப்	Nan
raleigh	ராலே	Nan
rai	ராய்	None
rafale	ரஃபேல்	Nan
rafael	ரஃபேல்	Nan
race	இனம்	None
rabindranath	ரவீந்திரநாத்	Nan
r	r	Nan
qúy	காலாண்டு	Nan
quỹ	நிதி	None
quỷ	சாத்தான்	None
quỵ	பக்கவாதம்	Nan
quỳnh	quỳnh	Nan
quỳ	மண்டியிடுங்கள்	Nan
quỉ	சாத்தான்	None
quệ	ஏழை	None
quết	கறை	Nan
quế	இலவங்கப்பட்டை	Nan
quẻ	ஹெக்ஸாகிராம்	Nan
ram	ரேம்	Nan
reef	ரீஃப்	Nan
rama	ராமா	Nan
ramayana	ராமாயணம்	Nan
reanimation	மறுஉருவாக்கம்	Nan
real	உண்மையானது	Nan
reagan	ரீகன்	Nan
rađa	ரேடார்	Nan
raymond	ரேமண்ட்	Nan
raya	ராயா	Nan
ray	கதிர்	None
rau	காய்கறி	Nan
rate	வீதம்	None
raptor	ராப்டார்	Nan
rap	ராப்	Nan
rao	விளம்பரம்	None
ranh	எல்லை	None
rangers	ரேஞ்சர்ஸ்	Nan
rang	அடித்தது	Nan
randy	ரேண்டி	Nan
ranch	பண்ணையில்	Nan
ran	ஓடியது	Nan
rambus	ராம்பஸ்	Nan
ramadan	ramadan	Nan
quặng	தாது	None
roland	ரோலண்ட்	Nan
rome	ரோம்	None
rò	கசிவு	Nan
rít	ஹிஸ்	None
rìu	கோடரி	Nan
rình	உளவு	Nan
rìa	விளிம்பு	Nan
rì	கிசுகிசுக்கிறது	Nan
rêu	பாசி	Nan
rên	சிணுங்கு	Nan
rê	இழுக்கவும்	Nan
rét	குளிர்	Nan
république	république	Nan
ré	அழுத்தும்	Nan
rèn	மோசடி	Nan
rèm	திரை	None
räikkönen	räikkönen	Nan
rãnh	அகழி	Nan
rãi	கோபல்	Nan
rã	சிதைவு	Nan
râu	தாடி	Nan
ròng	நிகர	None
râm	நிழலான	Nan
rót	கொட்டுகிறது	Nan
rôbôt	ரோபோ	Nan
rượu	ஆல்கஹால்	Nan
rượt	துரத்து	Nan
rưỡi	பாதி	Nan
rưới	தெளிக்கவும்	Nan
rước	ஊர்வலம்	Nan
rươi	உன்னை	None
rơm	வைக்கோல்	Nan
rơi	வீழ்ச்சி	None
rơ	கார்	Nan
rũ	கவர்ச்சியான	Nan
rōmaji	rōmaji	Nan
răng	பல்	None
răn	கட்டளை	None
rút	திரும்பப் பெறுங்கள்	Nan
rùng	தவழும்	Nan
rùa	ஆமை	Nan
rõ	தெளிவானது	Nan
rông	வெற்று	Nan
rôma	ரோம்	None
rô	சரிபார்க்கப்பட்டது	Nan
romania	ரோமானியா	Nan
ráp	சட்டசபை	Nan
rái	ஓட்டர்	Nan
rulin	ரூலின்	Nan
rue	ரூ	None
rudolph	ருடால்ப்	Nan
rtp	rtp	Nan
rpd	rpd	Nan
roy	ராய்	None
rowling	ரவுலிங்	Nan
rovers	ரோவர்கள்	Nan
router	திசைவி	None
rousseau	ரூஸ்ஸோ	Nan
rotterdam	ரோட்டர்டாம்	Nan
roth	ரோத்	Nan
rosen	ரோஸன்	Nan
rong	பாசி	Nan
ronaldinho	ரொனால்டினோ	Nan
ronald	ரொனால்ட்	Nan
ron	ron	Nan
rommel	rommel	Nan
romeo	ரோமியோ	None
rumani	ரோமானியன்	Nan
rán	வறுக்கவும்	Nan
rumiko	ரூமிகோ	Nan
run	ஓடு	None
rách	கிழிந்தது	Nan
rác	குப்பை	Nan
rào	வேலி	None
rành	சரளமாக	Nan
ràng	தெளிவானது	Nan
rà	சரிபார்	Nan
rzeczpospolita	rzeczpospolita	Nan
ruột	குடல்	Nan
ruộng	நெல் வயல்	Nan
ruổi	ruoi	Nan
ruồi	ஈக்கள்	Nan
ruốc	இறால்	Nan
ruud	ரூட்	Nan
rutte	rutte	Nan
rutherford	ரதர்ஃபோர்ட்	Nan
ruth	ரூத்	Nan
russkaya	ருஸ்காயா	Nan
russian	ரஷ்ய	None
rung	அதிர்வு	Nan
rummel	ரம்மல்	Nan
quặc	வித்தியாசமானது	Nan
quẳng	டாஸ்	None
quật	அகழ்வாராய்ச்சி	Nan
plan	திட்டம்	None
plaaf	பிளேஃப்	Nan
pius	pius	Nan
pitch	சுருதி	Nan
piston	பிஸ்டன்	Nan
pisa	பீசா	Nan
pipes	குழாய்கள்	None
pioneer	முன்னோடி	None
pinlus	பின்லஸ்	Nan
pin	பேட்டரி	Nan
pike	பைக்	Nan
pietro	பியட்ரோ	Nan
pierrot	pierrot	Nan
pierre	பியர்	Nan
piccolo	பிக்கோலோ	Nan
picchu	picchu	Nan
phức	சிக்கலான	None
phủ	மூடப்பட்ட	Nan
phụt	பஃப்	Nan
plasma	பிளாஸ்மா	Nan
phụng	சேவை	None
plate	தட்டு	None
platon	பிளேட்டன்	Nan
porto	போர்டோ	Nan
portland	போர்ட்லேண்ட்	Nan
pop	பாப்	None
pont	pont	Nan
polynésie	polynésie	Nan
polo	போலோ	Nan
pollux	pollux	Nan
pollack	பொல்லாக்	Nan
poland	போலந்து	Nan
pol	pol	Nan
pokémon	போகிமொன்	Nan
po	po	Nan
pmu	pmu	Nan
pm	மாலை	None
pluto	புளூட்டோ	None
plus	பிளஸ்	Nan
pleistocen	pleistocen	Nan
pleiku	pleiku	Nan
player	ஆட்டக்காரர்	Nan
plato	பிளேட்டோ	Nan
pot	பானை	Nan
phục	ஆடை	None
phới	மிதவை	Nan
phả	வம்சாவளி	Nan
phạt	தண்டி	Nan
phạn	சமஸ்கிருதம்	Nan
phượng	பீனிக்ஸ்	Nan
phường	வார்டு	Nan
phước	ஆசீர்வாதம்	Nan
phương	புவோங்	Nan
phăng	phang	Nan
phăn	fret	Nan
phút	நிமிடம்	Nan
phúng	பரிதாபம்	Nan
phún	பம்	Nan
phúclộc	ஆசீர்வாதம்	Nan
phúc	ஆசீர்வதிக்கப்பட்டவர்	Nan
phùng	பஃப்	Nan
phông	எழுத்துரு	Nan
phôi	கரு	None
phô	நகரம்	Nan
phóng	ஏவுதல்	Nan
phải	சரி	None
phở	நூடுல் சூப்	Nan
phải 	சரி	Nan
phảng	தட்டையானது	Nan
phộng	வேர்க்கடலை	Nan
phổi	நுரையீரல்	None
phổ	ஸ்பெக்ட்ரம்	Nan
phồng	உயர்த்தப்பட்டது	Nan
phốt	பாஸ்பேட்	Nan
phối	ஒருங்கிணைத்தல்	Nan
phố	நகரம்	Nan
phỏng	எரிக்க	Nan
phỉ	பழுப்புநிறம்	Nan
phết	பரவுதல்	None
phế	ஸ்கிராப்	Nan
phẳng	விமானம்	None
phật	புத்தர்	None
phận	விதி	None
phẫu	அறுவை சிகிச்சை	Nan
phẫn	கோபம்	None
phẩy	கமா	Nan
phẩm	தயாரிப்புகள்	None
phần	பகுதி	Nan
phản	எதிர்	None
potsdam	potsdam	Nan
potter	குயவன்	Nan
pour	ஊற்றவும்	Nan
quáng	குருட்டு	Nan
quán	மதுக்கூடம்	Nan
quái	கர்மம்	Nan
quá	கூட	None
quyệt	நயவஞ்சக	Nan
quyện	கலத்தல்	Nan
quyền	அனுமதி	None
quyến	கவர்ச்சி	None
quyên	அடிப்படைகள்	None
quy	விதிகள்	None
quran	குர்ஆன்	None
quincy	quincy	Nan
qui	குய்	Nan
quen	பழக்கமான	Nan
queensland	குயின்ஸ்லாந்து	Nan
queens	ராணிகள்	Nan
queen	ராணி	None
que	தண்டுகள்	Nan
quay	திரும்பியது	Nan
quát	கத்தினான்	Nan
quanh	சுற்றி	Nan
quân	குவான்	Nan
quét	ஸ்கேன் செய்ய	Nan
quận	மாவட்டம்	None
quẫn	மோசமான	None
quẩy	ராக்கிங்	Nan
quầy	கவுண்டர்	None
quầng	ஒளிவட்டம்	Nan
quần	கால்சட்டை	Nan
quấy	அசை	Nan
quất	கும்வாட்	Nan
quấn	மடக்கு	Nan
quảng	விளம்பர	None
quản	ஆளும்	None
quạt	விசிறி	Nan
quạ	காகங்கள்	Nan
quĩ	நிதி	None
quăng	டாஸ்	None
quýt	டேன்ஜரின்	Nan
quý	விலைமதிப்பற்றது	Nan
quên	மறந்து விடுங்கள்	Nan
quê	கிராமம்	None
quãng	தோராயமாக	None
quang	ஒளியியல்	None
quan	குவான்	Nan
quad	குவாட்	Nan
prôtêin	புரத	None
protein	புரதம்	None
prometheus	prometheus	Nan
projekt	projekt	Nan
procellarum	procellarum	Nan
prix	prix	Nan
prinz	பிரின்ஸ்	Nan
printf	printf	Nan
printemps	அச்சுப்பொறிகள்	Nan
princeton	பிரின்ஸ்டன்	Nan
prince	இளவரசன்	None
preston	preston	Nan
preminger	preminger	Nan
premier	பிரதமர்	None
preah	preah	Nan
pratzen	pratzen	Nan
praha	praha	Nan
pradesh	பிரதேசம்	None
powell	பவல்	Nan
ps	ps	Nan
psv	psv	Nan
ptolemy	டோலமி	Nan
ptq	ptq	Nan
qua	வழங்கியவர்	Nan
qlvnch	qlvnch	Nan
qing	குயிங்	Nan
qd	qd	Nan
qatar	கத்தார்	Nan
q	q	Nan
pơ	pơ	Nan
păng	வேதனை	Nan
pérez	பெரெஸ்	Nan
rạ	நமைச்சல்	Nan
péc	péc	Nan
pytago	pytago	Nan
pyrenees	பைரனீஸ்	Nan
putin	putin	Nan
pusan	புசன்	Nan
punjab	பஞ்சாப்	None
pulp	கூழ்	Nan
pulitzer	புலிட்சர்	Nan
pulau	pulau	Nan
puerto	puerto	Nan
pzl	pzl	Nan
rạc	தனித்தனி	Nan
rạch	கால்வாய்	None
rạng	விடியல்	Nan
storting	சேமித்தல்	Nan
stones	கற்கள்	None
stockholm	ஸ்டாக்ஹோம்	Nan
stimson	தூண்டுதல்	Nan
stf	stf	Nan
stewarthannah	stewarthannah	Nan
stevie	ஸ்டீவி	Nan
stevenson	ஸ்டீவன்சன்	Nan
stevens	ஸ்டீவன்ஸ்	Nan
steve	ஸ்டீவ்	Nan
sterling	ஸ்டெர்லிங்	Nan
stephenie	ஸ்டீபனி	Nan
stephen	ஸ்டீபன்	Nan
stennis	ஸ்டென்னிஸ்	Nan
stelzer	ஸ்டெல்சர்	Nan
steiner	ஸ்டீனர்	Nan
steiermark	ஸ்டீயர்மார்க்	Nan
stefan	ஸ்டீபன்	Nan
stdc	stdc	Nan
strasberg	ஸ்ட்ராஸ்பெர்க்	Nan
status	நிலை	None
strauss	ஸ்ட்ராஸ்	Nan
struct	struct	Nan
sun	சூரியன்	None
summerslam	சம்மர்ஸ்லாம்	Nan
summer	கோடை	None
sumitomo	sumitomo	Nan
sumatra	சுமத்ரா	Nan
sumatera	சுமடேரா	Nan
sum	தொகை	None
sulu	sulu	Nan
sulfua	சல்பைடு	Nan
sukarno	சுகர்னோ	Nan
suharto	suharto	Nan
suez	suez	Nan
subakhi	subakhi	Nan
su	su	Nan
stéfano	stéfano	Nan
styx	ஸ்டைக்ஸ்	Nan
stuttgart	ஸ்டட்கர்ட்	Nan
stuart	ஸ்டூவர்ட்	Nan
stt	stt	Nan
street	தெரு	None
sunday	ஞாயிற்றுக்கிழமை	Nan
startin	தொடங்கு	Nan
stanley	ஸ்டான்லி	Nan
sonata	சொனாட்டா	Nan
somme	somme	Nan
som	சோம்	Nan
solaris	சோலாரிஸ்	Nan
soi	சோய்	Nan
soho	சோஹோ	Nan
sohee	சோஹீ	Nan
socrates	சாக்ரடீஸ்	Nan
société	société	Nan
so	அதனால்	None
smithsonian	ஸ்மித்சோனியன்	Nan
smith	ஸ்மித்	None
smg	smg	Nan
sm	sm	Nan
slytherin	ஸ்லிதரின்	Nan
slavơ	slav	Nan
slav	slav	Nan
sl	sl	Nan
skyteam	skyteam	Nan
song	பாடல்	None
starr	நட்சத்திரம்	None
sony	சோனி	Nan
sophie	சோஃபி	Nan
stanford	ஸ்டான்போர்ட்	Nan
stand	நிற்க	Nan
stamford	ஸ்டாம்போர்ட்	Nan
stalingrad	ஸ்டாலின்கிராட்	Nan
st	ஸ்டம்ப்	Nan
ss	ss	Nan
sri	ஸ்ரீ	None
sports	விளையாட்டு	None
spielberg	ஸ்பீல்பெர்க்	Nan
spencer	ஸ்பென்சர்	Nan
spence	ஸ்பென்ஸ்	Nan
spellman	எழுத்துப்பிழை	Nan
spears	ஈட்டிகள்	Nan
soạn	இசையமைப்பாளர்	None
soát	கட்டுப்பாடு	None
soul	ஆன்மா	None
sos	sos	Nan
sorbonne	சோர்போன்	Nan
sopwith	sopwith	Nan
soo	சூ	Nan
sung	அத்தி	Nan
sunni	சுன்னி	None
sunsilk	sunilk	Nan
súp	சூப்	Nan
súng	துப்பாக்கிகள்	Nan
sún	மூழ்கும்	Nan
súc	கால்நடைகள்	Nan
sú	கருப்பு புலி	Nan
sùng	பக்தி	None
sông	நதி	None
sôi	கொதித்தல்	Nan
sô	எண்	None
sót	விடுவித்தல்	Nan
sóng	அலை	None
sói	ஓநாய்	Nan
sóc	அணில்	Nan
sòng	கேசினோ	Nan
sò	clam	Nan
sít	இறுக்கம்	Nan
síp	சைப்ரஸ்	Nan
sính	மாணவர்	None
sêu	பாசி	Nan
sút	ஷாட்	Nan
sêri	தொடர்	None
săn	வேட்டை	None
sư	பேராசிரியர்	None
sẩn	பருக்கள்	Nan
sầu	துக்கம்	None
sầm	slams	Nan
sấy	உலர்த்துதல்	Nan
sấu	முதலை	Nan
sấm	இடி	Nan
sảnh	மண்டபம்	None
sảng	புதியது	Nan
sản	உற்பத்தி	None
sảm	பிரகாசமான	Nan
sạn	ஹோட்டல்	Nan
sạch	சுத்தமான	None
sưởi	வெப்பமாக்கல்	Nan
sườn	பக்க	None
sướng	சந்தோஷமாக	Nan
sương	பனி	None
sưu	சேகரிப்புகள்	Nan
sưng	வீக்கம்	None
sưa	பால்	None
sơn	பெயிண்ட்	Nan
sê	சே	None
sét	விளக்குகள்	Nan
são	சாவோ	Nan
sy	sy	Nan
sweet	இனிப்பு	Nan
swaziland	swaziland	Nan
swan	அன்ன பறவை	Nan
svd	svd	Nan
suồng	மென்மையான	None
suốt	முழுவதும்	None
suối	வெப்பமாக்கல்	Nan
suất	உற்பத்தித்திறன்	Nan
suôn	சீராக	None
suê	அதனால்	None
suy	தோல்வி	None
suvp	suvp	Nan
suub	suub	Nan
sutra	சூத்திரம்	None
susilo	சுசிலோ	Nan
susan	சூசன்	Nan
suriname	suriname	Nan
super	அருமை	Nan
sydney	சிட்னி	Nan
symantec	symantec	Nan
sync	ஒத்திசைவு	Nan
syria	சிரியா	None
sãi	தவறு	None
sã	sã	Nan
sâu	ஆழமான	Nan
sân	யார்டு	Nan
sâm	ஜின்ஸெங்	Nan
sáu	ஆறு	None
sát	நெருக்கமான	None
sáp	மெழுகு	None
sáo	புல்லாங்குழல்	Nan
skype	ஸ்கைப்	Nan
sánh	ஒப்பீட்டு	None
sám	மனந்திரும்புதல்	Nan
sái	தவறு	None
sách	நூல்	None
sá	சிபுங்குலஸ்	Nan
sào	துருவ	None
sành	டெரகோட்டா	Nan
sàng	சல்லடை	Nan
sàn	தரை	Nan
sài	சாய்	Nan
sáng	பிரகாசிக்கிறது	Nan
phó	துணை	None
sky	வானம்	None
siêu	அருமை	Nan
samoa	சமோவா	None
samo	சமோ	Nan
samhain	samhain	Nan
salzburg	சால்ஸ்பர்க்	Nan
salvador	சால்வடார்	Nan
salem	salem	Nan
sakura	சகுரா	Nan
saintdenis	saintdenis	Nan
saigon	சைகோன்	Nan
sai	தவறு	None
sahara	சஹாரா	Nan
safin	safin	Nan
safari	சஃபாரி	Nan
saddam	சதாம்	Nan
sachsen	sachsen	Nan
sabah	சபா	Nan
sa	sa	Nan
rữa	கழுவுதல்	Nan
rửa	கழுவுதல்	Nan
samphan	சம்பன்	Nan
rừng	காடு	None
samsung	சாம்சங்	Nan
samuelson	சாமுவெல்சன்	Nan
sardinia	சார்டினியா	Nan
sarcoma	சர்கோமா	None
sarawak	சரவாக்	Nan
sarah	சாரா	None
sar	சார்	Nan
sapiens	sapiens	Nan
sapa	sapa	Nan
sap	sap	Nan
sao	நட்சத்திரம்	None
santos	சாண்டோஸ்	Nan
sanktpeterburg	sanktpeterburg	Nan
sanh	பிறப்பு	None
sangraal	sangraal	Nan
sango	sango	Nan
sang	க்கு	Nan
sanchez	சான்செஸ்	Nan
san	சான்	None
samut	samut	Nan
samurai	சாமுராய்	Nan
samuel	சாமுவேல்	Nan
sary	புடவை	Nan
rứa	ra	Nan
rủ	அழைக்க	None
rễ	வேர்கள்	Nan
rể	மருமகன்	Nan
rền	புலம்பல்	Nan
rẽ	திரும்பவும்	None
rẻ	மலிவானது	Nan
rặng	பாறை	None
rằng	அந்த	None
rằm	முழு நிலவு	Nan
rắn	பாம்பு	None
rắc	தெளிக்கவும்	Nan
rập	அரபு	None
rậm	புதர்	Nan
rẫy	சாகுபடி	None
rầu	சோகம்	Nan
rầm	jamb	Nan
rất	மிகவும்	None
rảnh	இலவசம்	Nan
rải	சிதறடிக்கப்பட்டது	Nan
rạp	திரையரங்குகளில்	Nan
rệp	பிழை	Nan
rủi	விபத்து	None
rệt	உச்சரிக்கப்படுகிறது	Nan
rỉ	துரு	Nan
rụng	பந்தல்	Nan
rợn	தவழும்	Nan
rợ	காட்டுமிராண்டிகள்	Nan
rỡ	புத்திசாலி	Nan
rời	இடது	None
rớt	வீழ்ச்சி	None
rộng	பரந்த	None
rộn	பரபரப்பு	Nan
rộ	சலசலப்பு	Nan
rỗng	வெற்று	Nan
rỗi	இலவசம்	Nan
rổ	கூடை	Nan
rồng	டிராகன்	Nan
rồi	ஏற்கனவே	None
rồ	பைத்தியம்	Nan
rốm	மேகமூட்டம்	Nan
rối	சிக்கலாகிவிட்டது	Nan
rỏ	தெளிவானது	Nan
rịavũng	rìvà	Nan
rệu	ஐயோ	Nan
saturanga	saturanga	Nan
saturday	சனிக்கிழமை	Nan
sau	பிறகு	None
siberi	siberi	Nan
shōnen	shōnen	Nan
showcase	காட்சி பெட்டி	Nan
short	குறுகிய	Nan
shop	கடை	Nan
shonen	shonen	Nan
shoal	ஷோல்	Nan
shiva	சிவா	Nan
shirakawago	ஷிரகாவாகோ	Nan
shirakami	ஷிரகாமி	Nan
shinoda	ஷினோடா	Nan
shinichi	ஷினிச்சி	Nan
shikoku	ஷிகோகு	Nan
shiite	ஷியாட்	Nan
shia	ஷியா	Nan
shi	ஷி	Nan
sherlock	ஷெர்லாக்	Nan
shawn	ஷான்	Nan
sharpay	கூர்மையானது	Nan
sicilia	சிசிலியா	Nan
shaolin	ஷாலின்	Nan
sicily	sicily	Nan
siem	siem	Nan
siu	siu	Nan
sistema	சிஸ்டெமா	Nan
sirô	சிரப்	Nan
sip	sip	Nan
sinh	பிறந்தவர்	Nan
sing	பாட	Nan
sinensis	சினென்சிஸ்	Nan
sinai	sinai	Nan
simone	சிமோன்	Nan
silvestris	சில்வெஸ்ட்ரிஸ்	Nan
silva	சில்வா	Nan
silicat	சிலிகேட்	Nan
silic	சிலிக்கான்	None
silesia	silesia	Nan
silas	சிலாஸ்	Nan
sikorsky	sikorsky	Nan
sikh	சீக்கியர்	None
sierra	சியரா	Nan
siemens	siemens	Nan
sidney	சிட்னி	Nan
shankly	shankly	Nan
shane	ஷேன்	Nan
shan	ஷான்	Nan
sdram	sdram	Nan
scuderia	scuderia	Nan
scud	ஸ்கட்	Nan
scream	அலறல்	Nan
scott	ஸ்காட்	Nan
scots	ஸ்காட்ஸ்	Nan
scotland	ஸ்காட்லாந்து	Nan
schwarzschild	ஸ்வார்ஸ்ஸ்சைல்ட்	Nan
schuster	ஸ்கஸ்டர்	Nan
schuschnigg	schuschnigg	Nan
schumacher	ஷூமேக்கர்	Nan
schneider	schneider	Nan
schlesinger	schlesinger	Nan
schiller	ஷில்லர்	Nan
schengen	schengen	Nan
schafer	schafer	Nan
scandinavia	ஸ்காண்டிநேவியா	Nan
saunière	saunière	Nan
saudi	சவுதி	None
search	தேடல்	None
seattle	சீட்டில்	Nan
secret	ரகசியம்	Nan
sedna	sedna	Nan
shaman	ஷாமன்	Nan
shah	ஷா	None
seyssinquart	seyssinquart	Nan
seymour	சீமோர்	Nan
sexy	கவர்ச்சியாக	Nan
sextus	செக்ஸ்டஸ்	Nan
seto	seto	Nan
seth	seth	Nan
sesshomaru	sesshomaru	Nan
siết	இறுக்கு	Nan
service	சேவை	None
sergeyevich	sergeyevich	Nan
serbia	செர்பியா	Nan
september	செப்டம்பர்	None
sense	உணர்வு	None
sen	தாமரை	Nan
semit	செமிட்	Nan
selena	செலினா	Nan
sejm	sejm	Nan
see	பார்க்க	None
seri	தொடர்	None
sẫm	இருள்	Nan
phòng	அறை	None
phím	விசை	None
ngộ	அறிவொளி	Nan
ngồi	உட்கார	Nan
ngọt	இனிப்பு	Nan
ngọn	மேல்	None
ngọc	மாணிக்கம்	None
ngọ	நண்பகல்	Nan
ngặt	இறுக்கம்	Nan
ngắn	குறுகிய	Nan
ngắm	சிந்தியுங்கள்	Nan
ngập	வெள்ளம்	None
ngậm	lozenges	Nan
ngẫu	சீரற்ற	None
ngẫm	ஆழ்ந்து சிந்தித்து	Nan
ngẩn	ஊமை	Nan
ngần	தயங்க	Nan
ngầm	மறைமுகமானது	Nan
ngất	மயக்கம்	Nan
ngấm	உட்செலுத்தப்பட்டது	Nan
ngạt	மூச்சுத்திணறல்	Nan
ngột	திடீரென்று	Nan
ngạo	கர்வம்	Nan
ngớ	வேடிக்கையான	Nan
ngỡ	சிந்தனை	None
nhakẻ	குழந்தை	None
nha	பல் மருத்துவர்	Nan
ngực	மார்பு	None
ngựa	குதிரை	None
ngự	வாழ	None
ngữ	பேச்சு	None
ngửi	வாசனை	Nan
ngửa	முகம்	None
ngừng	நிறுத்து	Nan
ngừa	தடுக்க	None
ngừ	டுனா	Nan
ngứa	அரிப்பு	None
ngủi	குறுகிய	Nan
ngủ	தூங்க	Nan
ngụy	வீ	None
ngụm	sip	Nan
ngục	சிறையில்	None
ngợm	குறும்பு	Nan
ngợi	புகழ்	None
ngời	மக்கள்	None
nham	லாவா	Nan
ngạnh	பார்ப்ஸ்	Nan
ngạch	ரேங்க்	Nan
ngây	வெற்று	Nan
ngân	வங்கி	None
ngát	மயக்கம்	Nan
ngáng	ngáng	Nan
ngán	சலித்துவிட்டது	Nan
ngái	முட்டாள்	Nan
ngách	முக்கிய	None
ngày	நாள்	None
ngào	இனிப்பு	Nan
ngành	கிளை	None
ngàng	ngàng	Nan
ngàn	ஆயிரம்	None
ngà	தந்தம்	None
nguỵ	முட்டாள்கள்	Nan
nguời	மக்கள்	None
nguồn	மூல	None
nguôi	அமைதிப்படுத்தும்	Nan
nguyệt	நிலா	None
nguyện	சபதம்	None
ngãi	நங்கை	Nan
ngạn	வங்கி	None
ngò	கொத்தமல்லி	Nan
ngói	ஓடு	None
ngạc	ஆச்சரியமாக இருக்கிறது	Nan
ngược	தலைகீழ்	Nan
ngưỡng	வாசல்	None
người	மக்கள்	None
ngươi	நீங்கள்	None
ngưu	ஆக்ஸ்	Nan
ngưng	நிறுத்து	Nan
ngư	மீனவர்	Nan
ngơi	ஓய்வு	None
ngơ	புறக்கணிக்கப்பட்டது	Nan
ngũ	தூங்கு	Nan
ngăn	பெட்டி	None
ngút	ngut	Nan
ngùi	வாசனை	Nan
ngõ	சந்து	Nan
ngông	வாத்து	Nan
ngôn	மொழி	Nan
ngót	சுருக்கம்	None
ngón	விரல்	None
ngó	பாருங்கள்	None
nguyền	சாபம்	Nan
nhan	nhan	Nan
nhanh	வேகமாக	None
nhẫn	மோதிரங்கள்	Nan
nhầy	மெலிதான	Nan
nhầm	தவறு	None
nhất	சிறந்தது	None
nhấn	அழுத்துகிறது	Nan
nhấm	சிப்பிங்	Nan
nhấc	தூக்கு	Nan
nhảy	நடனம்	None
nhạy	உணர்திறன்	Nan
nhạt	வெளிர்	None
nhạo	கேலி	Nan
nhạn	விழுங்க	Nan
nhạc	இசை	None
nhạ	nhạ	Nan
nhượng	சலுகைகள்	Nan
nhược	பலவீனம்	Nan
nhưỡng	க்ரீஸ்	Nan
nhường	வழி கொடுத்தது	Nan
nhương	உமிழ்நீர்	Nan
nhậm	முத்திரை குத்தப்பட்டது	Nan
nhưng	ஆனாலும்	None
nhập	இறக்குமதி	None
nhậy	உணர்திறன்	Nan
nhỏ|phải|px|cây	சிறிய | வலது | px | மரம்	Nan
nhỏ|phải|px|bức	சிறிய | வலது | px | படங்கள்	Nan
nhỏ|phải|px|	சிறிய | வலது | px |	Nan
nhỏ|phải|	சிறிய | வலது |	Nan
nhỏ|một	சிறிய | ஒன்று	Nan
nhỏ|cây	சிறிய | மரம்	Nan
nhỏ	சிறிய	None
nhọn	கூர்மையான	Nan
nhọ	துரதிர்ஷ்டவசமான	Nan
nhịn	விலகியிருங்கள்	Nan
nhị	மகரந்தம்	None
nhẹn	சுறுசுறுப்பான	Nan
nhẹ	ஒளி	None
nhặt	தேர்ந்தெடு	Nan
nhẵn	மென்மையான	None
nhằm	நோக்கமாக	Nan
nhắn	செய்தி	None
nhắm	நோக்கம்	Nan
nhắc	வரியில்	Nan
nhậu	குடிப்பது	Nan
nhang	தூப	Nan
như	என	Nan
nhũng	ஊழல்	None
nhào	பிசையவும்	Nan
nhàng	மெதுவாக	None
nhàn	செயலற்றது	Nan
nhuộm	சாயம்	Nan
nhuệ	ந்யூ	Nan
nhuận	லாபம்	Nan
nhu	போன்ற	None
nhs	nhs	Nan
nhk	nhk	Nan
nhiệt	வெப்பம்	None
nhiệm	கடமை	None
nhiễu	சத்தம்	None
nhiễm	நோய்த்தொற்றுக்கு உள்ளானவர்	Nan
nhiều	அதிகம்	None
nhiêu	அதிகம்	None
nhiên	நிச்சயமாக	Nan
nhi	குழந்தைகள்	None
nhen	மீண்டும் எழுப்பப்பட்டது	Nan
nhat	nhat	Nan
nhác	மந்தமான	Nan
nhơn	பெருக்க	Nan
nhái	குளோன்கள்	Nan
nháp	வரைவு	None
nhũ	குழம்பு	None
nhĩ	ஏட்ரியல்	Nan
nhăn	சுருக்கம்	None
nhút	கூச்சமுடைய	Nan
nhúng	டிப்	Nan
nhôm	அலுமினியம்	Nan
nhô	நீண்டுள்ளது	Nan
nhóm	குழு	None
nhóc	குழந்தை	None
nhòm	பாருங்கள்	None
nhím	முள்ளம்பன்றி	Nan
nhí	உரையாடல்	None
nhìn	பாருங்கள்	None
nhì	இரண்டாவது	None
nhét	போடு	Nan
nhãn	லேபிள்	Nan
nhã	சுவையானது	Nan
nhâm	நனைத்தல்	Nan
nháy	ஃப்ளாஷ்	Nan
nhánh	கிளை	None
nguyên	அசல்	None
nguyen	nguyen	Nan
ngung	ngung	Nan
mồ	கல்லறை	None
mốt	ஃபேஷன்	Nan
mối	காலநிலை	None
mốc	கட்டாயம்	None
mỏng	மெல்லிய	None
mỏi	சோர்வாக	Nan
mỏ	சுரங்கங்கள்	Nan
mọn	குட்டி	None
mọi	ஒவ்வொன்றும்	None
mọc	வளர்கிறது	Nan
mịt	மோப்பம்	Nan
mịn	மென்மையான	None
mịch	மலம்	None
mỉm	புன்னகை	None
mỉa	கிண்டல்	Nan
mỉ	உன்னிப்பாக	Nan
mệt	சோர்வாக	Nan
mệnh	விதி	None
mềm	மென்மையான	None
mồi	துாண்டில்	Nan
mề	கிஸ்ஸார்ட்	Nan
mổ	அறுவை சிகிச்சை	Nan
mộ	கல்லறை	None
na	நா	None
mỹcông	அமெரிக்கா	None
mỹ	அமெரிக்கா	None
mỳ	நூடுல்	Nan
mực	மை	None
mửa	வாந்தி	None
mừng	மகிழ்ச்சி	Nan
mứt	ஜாம்	Nan
mức	நிலை	None
mụn	முகப்பரு	Nan
mục	அந்த பொருள்	Nan
mỡ	கொழுப்பு	None
mở	திறந்த	None
mời	அழைக்க	None
mờ	தெளிவற்ற	Nan
mới	புதியது	Nan
một	ஒன்று	None
mộng	கனவு	None
mộc	தச்சு	Nan
mỗi	ஒவ்வொன்றும்	None
naadam	நாதம்	Nan
mến	அன்பே	None
mẻ	தொகுதி	Nan
mả	கல்லறைகள்	Nan
mạt	பூச்சிகள்	None
mạo	கட்டுரை	None
mạnh	வலுவான	None
mạn	பக்க	None
mại	வர்த்தகம்	None
mạch	சுற்று	None
mạc	பாலைவனம்	None
mượt	மென்மையான	None
mượn	கடன் வாங்க	Nan
mường	muong	Nan
mướt	மென்மையான	None
mướn	வாடகை	Nan
mương	வடிகால்	None
mươi	ஐம்பது	None
mưu	தந்திரமான	Nan
mưa	மழை	None
mơn	பாதங்கள்	Nan
mơ	கனவு	None
mải	பரபரப்பு	Nan
mẽ	வலுவான	None
mảng	வரிசை	None
mất	இழந்தது	None
mẹo	உதவிக்குறிப்புகள்	Nan
mẹ	அம்மா	None
mặt	முகம்	None
mặn	உப்பு	None
mặc	அணிய	Nan
mắt	கண்	None
mắng	திட்டுவது	Nan
mắn	அதிர்ஷ்டசாலி	Nan
mắm	மீன் குழம்பு	Nan
mắc	விலை உயர்ந்தது	Nan
mậu	வர்த்தகம்	None
mật	தேன்	None
mập	கொழுப்பு	None
mận	பிளம்	Nan
mẩu	துண்டுகள்	None
mầu	நிறம்	None
mầm	கிருமி	None
mấy	சில	None
mấu	தாவல்	Nan
mảnh	துண்டு	None
nacional	nacional	Nan
nagant	nagant	Nan
nagar	நகர்	None
nghành	தொழில்	None
nghiệt	கடுமையான	None
nghiệp	கர்மா	Nan
nghiện	அடிமையானவர்	Nan
nghiệm	அனுபவம்	None
nghiễm	பரிதாபம்	Nan
nghiền	squish	Nan
nghiêu	nghieu	Nan
nghiêng	சாய்ந்த	Nan
nghiêm	கடுமையாக	Nan
nghinh	nghinh	Nan
nghe	கேளுங்கள்	Nan
ngay	சரி	None
ngao	clam	Nan
ngang	கிடைமட்ட	Nan
ngai	சிம்மாசனம்	Nan
nga	ரஷ்யா	None
next	அடுத்தது	Nan
newtons	நியூட்டன்கள்	Nan
nghèo	ஏழை	None
newton	நியூட்டன்	None
nghé	நங்கே	Nan
nghênh	வரவேற்பு	None
ngu	தூங்கு	Nan
ngoặt	திரும்பவும்	None
ngoặc	அடைப்புக்குறிக்குள்	Nan
ngoạn	மூச்சடைக்கும்	Nan
ngoại	வெளிநாட்டு	Nan
ngoài	வெளியே	None
ngon	சுவையானது	Nan
ngoc	ngoc	Nan
ngoan	நல்ல பையன்	Nan
ngo	அழகானது	Nan
nghị	பரிந்துரைகள்	None
nghỉ	விடுமுறை	None
nghệquận	கலை	None
nghề	தொழில்	None
nghếch	உரத்த	Nan
nghẽn	நெரிசல்	Nan
nghĩa	பொருள்	None
nghĩ	சிந்தியுங்கள்	Nan
nghìn	ஆயிரம்	None
nghê	நங்கே	Nan
newspaper	செய்தித்தாள்	Nan
newcastle	நியூகேஸில்	Nan
neverland	நெவர்லேண்ட்	Nan
napoli	napoli	Nan
napoleon	நெப்போலியன்	None
naomi	நவோமி	Nan
nano	நானோ	None
nanh	fangs	Nan
nang	நுண்ணறை	Nan
nancy	நான்சி	Nan
namno	நம்னோ	Nan
namnam	நம் நாம்	Nan
namibia	நமீபியா	None
nambắc	வடக்கு	None
nam	ஆண்	None
nalbandian	நல்பாண்டியன்	Nan
nakajima	நகாஜிமா	Nan
nairobi	நைரோபி	Nan
nai	மான்	None
nagumo	நாகுமோ	Nan
nagoya	நாகோயா	Nan
nagasaki	நாகசாகி	Nan
napoléon	napoléon	Nan
nara	நாரா	Nan
nasa	நாசா	None
nat	நாட்	Nan
nevada	நெவாடா	Nan
neutrino	நியூட்ரினோ	Nan
neumann	நியூமன்	Nan
networks	நெட்வொர்க்குகள்	Nan
netscape	நெட்ஸ்கேப்	None
netbook	நெட்புக்	Nan
net	நிகர	None
nessie	நெஸ்ஸி	Nan
nepomuk	nepomuk	Nan
nhỏ|phải|px|khu	சிறிய | வலது | px | மண்டலம்	Nan
nepal	நேபால்	Nan
neo	நங்கூரம்	Nan
nelson	நெல்சன்	Nan
needham	நீட்ஹாம்	Nan
nay	இப்போதிலிருந்து	Nan
navarre	navarre	Nan
nava	நவ	Nan
nauru	nauru	Nan
natri	சோடியம்	None
nathan	நாதன்	Nan
neon	நியான்	None
nhỏ|phải|px|michael	சிறிய | வலது | px | மைக்கேல்	Nan
nhỏ|phải|px|máy	சிறிய | வலது | px | இயந்திரம்	Nan
nhỏ|phải|px|một	சிறிய | வலது | px | ஒன்று	Nan
oxford	ஆக்ஸ்போர்டு	Nan
owen	owen	Nan
outstanding	நிலுவையில் உள்ளது	Nan
ottoman	ஒட்டோமான்	Nan
otto	ஓட்டோ	Nan
other	மற்றவை	None
oswald	ஓஸ்வால்ட்	Nan
ossetia	ஒசெட்டியா	Nan
ospf	ospf	Nan
osment	osment	Nan
oslo	oslo	Nan
oskar	oskar	Nan
osiris	osiris	Nan
oscar	ஆஸ்கார்	Nan
osamu	osamu	Nan
osama	osama	Nan
osaka	osaka	Nan
os	os	Nan
orton	ஆர்டன்	Nan
oxy	ஆக்ஸிஜன்	None
orochimaru	orochimaru	Nan
ozawa	ozawa	Nan
oát	வாட்ஸ்	Nan
paperback	பேப்பர்பேக்	Nan
paolo	பாவ்லோ	Nan
panthéon	panthéon	Nan
panthera	பாந்தெரா	Nan
panduranga	பாண்டுரங்க	Nan
panamax	பனாமக்ஸ்	Nan
panama	பனாமா	None
pan	பான்	Nan
pamir	pamir	Nan
pali	பாலி	Nan
palgrave	palgrave	Nan
palestine	palestine	Nan
palenque	palenque	Nan
palawan	பலவன்	Nan
palais	palais	Nan
pakistan	பாக்கிஸ்தான்	None
pailin	pailin	Nan
paget	paget	Nan
oản	on	Nan
oán	மனக்கசப்பு	Nan
papua	பப்புவா	None
orleans	ஆர்லியன்ஸ்	Nan
origin	தோற்றம்	Nan
oanh	ஓன்	Nan
oan	அநீதி	Nan
oakland	ஓக்லாண்ட்	Nan
oai	பயம்	Nan
oahu	oahu	Nan
nữa	மீண்டும்	None
nửa	பாதி	Nan
nứt	கிராக்	Nan
nứa	கார்க்	Nan
nụy	பிஸ்டில்	Nan
nợ	கடனில்	Nan
nỡ	இதயமுள்ள	Nan
nở	பூக்கும்	None
nới	தளர்த்தவும்	Nan
nộp	தாக்கல் செய்யப்பட்டது	Nan
nộn	திணிப்பு	Nan
nội	உள்	None
nộ	கோபம்	None
nỗi	அந்த	None
obama	ஒபாமா	Nan
orion	orion	Nan
oblast	oblast	Nan
october	அக்டோபர்	None
oricon	oricon	Nan
organ	உறுப்பு	None
oprah	ஓப்ரா	Nan
oort	oort	Nan
ontario	ontario	Nan
ong	தேனீ	Nan
omar	ஓமர்	None
om	braised	Nan
olympus	ஒலிம்பஸ்	Nan
olivier	ஆலிவர்	Nan
oliver	ஆலிவர்	Nan
okhotsk	okhotsk	Nan
ohkawa	ஓகாவா	Nan
officers	அதிகாரிகள்	None
officer	அதிகாரி	None
oecd	oecd	Nan
odyssey	ஒடிஸி	Nan
oder	துர்நாற்றம்	Nan
oda	ஓ டா	Nan
oc	oc	Nan
paraguay	பராகுவே	Nan
pari	பரி	Nan
park	பூங்கா	None
phu	phu	Nan
phrygian	phrygian	Nan
php	php	Nan
phong	அறை	None
phoenix	பீனிக்ஸ்	Nan
pho	pho	Nan
phnôm	phomom	Nan
phnom	phnom	Nan
phiệt	phiet	Nan
phiện	அபின்	None
phiến	கத்தி	Nan
phiếm	வதந்திகள்	Nan
phiêu	சாகச	Nan
phiên	அமர்வு	Nan
phineas	பினியாஸ்	Nan
phin	வடிகட்டி	Nan
phim	திரைப்படம்	None
philosophiae	தத்துவஞானி	Nan
phillips	பிலிப்ஸ்	Nan
phui	வெளிப்படுத்தப்பட்டது	Nan
phillip	பிலிப்	None
phun	தெளிப்பு	Nan
phàm	மரண	None
phích	தெர்மோஸ்	Nan
phía	பக்க	None
phí	கட்டணம்	None
phình	வீக்கம்	None
phì	விரிவாக்கப்பட்டது	Nan
phêrô	பீட்டர்	Nan
phê	உயர்ந்திடு	Nan
phép	அனுமதிக்கப்படுகிறது	Nan
phèo	phèo	Nan
phèn	alum	Nan
phát	ஒளிபரப்பு	None
pháp	பிரான்ஸ்	None
pháo	பீரங்கி	Nan
phán	நீதிபதி	None
phái	பிரிவு	None
phách	அடி	None
phác	ஸ்கெட்ச்	Nan
phá	உடைத்தல்	Nan
phàn	புகார்	None
phà	படகு	None
philippines	பிலிப்பைன்ஸ்	Nan
philippe	பிலிப்	None
philip	பிலிப்	None
pereira	பெரேரா	Nan
penny	பைசா	None
pennsylvania	பென்சில்வேனியா	Nan
penh	பென்	None
penang	பினாங்கு	Nan
pele	pele	Nan
peers	சக	None
pedro	pedro	Nan
pdf	pdf	Nan
pda	pda	Nan
pbs	pbs	Nan
pavia	பாவியா	Nan
paulo	paulo	Nan
paula	paula	Nan
paul	பால்	None
patriot	தேசபக்தர்	Nan
patrick	பேட்ரிக்	Nan
patel	படேல்	Nan
parton	parton	Nan
perl	perl	Nan
pero	பெரோ	Nan
perry	பெர்ரி	Nan
persephone	persephone	Nan
phil	பில்	None
phen	phen	Nan
phe	பிரிவு	None
phay	அரைக்கும்	Nan
pharaon	பாரோன்	Nan
pharaoh	பார்வோன்	Nan
phaolô	பால்	None
phao	மிதவை	Nan
phanh	பிரேக்	Nan
nỗ	முயற்சி	None
pham	pham	Nan
pha	கலப்பு	None
pgđ	pgđ	Nan
pgs	பக்கங்கள்	None
pfm	pfm	Nan
petersburg	பீட்டர்ஸ்பர்க்	Nan
peters	பீட்டர்ஸ்	Nan
peru	பெரு	None
persian	பெர்சியன்	Nan
pershing	தொடர்கிறது	None
phaethon	பைதான்	Nan
phò	phò	Nan
nổi	மிதக்கும்	None
nồng	சூடான	None
non	இளம்	None
nom	nom	Nan
nol	nol	Nan
nokia	நோக்கியா	Nan
noi	சொல்	Nan
noel	நோயல்	Nan
nobita	nobita	Nan
nobel	நோபல்	None
noah	நோவா	Nan
nm	nm	Nan
nlf	nlf	Nan
nj	nj	Nan
niệu	டையூரிசிஸ்	Nan
niệm	மனம்	None
niềm	இன்பம்	Nan
niết	niet	Nan
niên	ஆண்டு	None
nixon	நிக்சன்	Nan
nitơ	நைட்ரஜன்	None
nonpenetrative	nonpenetrative	Nan
nippon	நிப்பான்	Nan
norfolk	நார்ஃபோக்	Nan
norma	நார்மா	Nan
nuốt	விழுங்க	Nan
nuối	விழுங்க	Nan
nuôi	தீவனம்	Nan
nusa	நுசா	Nan
nupedia	nupedia	Nan
number	எண்	None
nubia	நுபியா	Nan
nst	nst	Nan
nsnd	nsnd	Nan
noãn	முட்டை	None
nowc	nowc	Nan
now	இப்போது	None
novak	novak	Nan
nou	nou	Nan
norway	நோர்வே	Nan
norton	நார்டன்	Nan
northrop	நார்த்ரோப்	Nan
normandie	நார்மண்டி	Nan
norman	நார்மன்	Nan
norge	நோர்ஜ்	Nan
nuớc	தண்ணீர்	None
nintendo	நிண்டெண்டோ	Nan
nin	நின்	Nan
nhủ	நினைவூட்டல்கள்	Nan
nhục	அவமானப்படுத்தப்பட்டது	Nan
nhụ	கிள்ளுதல்	Nan
nhở	நினைவூட்டு	Nan
nhờn	க்ரீஸ்	Nan
nhờ	நன்றி	Nan
nhớt	பிசுபிசுப்பு	Nan
nhớ	மனம்	None
nhộn	பெருங்களிப்புடைய	Nan
nhổ	பறிக்க	Nan
nhồi	அடைத்த	Nan
nhốt	பூட்டப்பட்டுள்ளது	Nan
nhỏ|tượng	சிறிய சிலைகள்	Nan
nhỏ|trái|px|máy	சிறிய | இடது | px | இயந்திரம்	Nan
nhỏ|quân	சிறிய | படை	Nan
nhỏ|px|phải|kiến	சிறிய | px | வலது | எறும்பு	Nan
nhỏ|px|các	சிறிய | px | தி	Nan
nhỏ|px|	சிறிய | px |	Nan
nhỏ|phải|px|quân	சிறிய | வலது | px | படை	Nan
nhức	வலி	None
ninh	பாதுகாப்பு	None
nhứt	முதல்	None
những	இவை	None
nimitz	நிமிட்ஸ்	Nan
nile	நைல்	None
nil	இல்லை	None
nikolayevich	நிகோலாயெவிச்	Nan
nikolai	நிகோலாய்	Nan
nikko	நிக்கோ	Nan
nikita	நிகிதா	Nan
niken	நிக்கல்	None
nikel	நிக்கல்	None
nigeria	நைஜீரியா	Nan
niels	niels	Nan
nicolas	நிக்கோலாஸ்	Nan
niccolò	niccolò	Nan
nicaragua	nicaragua	Nan
nicaea	nicaea	Nan
nia	நியா	Nan
ni	நி	Nan
nhựt	நுட்	Nan
nhựa	நெகிழி	Nan
nhừ	எனினும்	None
nxb	nxb	Nan
nynorsk	nynorsk	Nan
nà	nà	Nan
nắng	சூரியன் தீண்டும்	Nan
nắm	பிடி	None
nập	சூடான	None
nậm	நாம்	None
nẫu	n சூரியன்	Nan
nẩy	துள்ளல்	Nan
nầy	இது	None
nần	nudge	Nan
nấy	இது	None
nấu	சமைக்கவும்	Nan
nấp	மறை	None
nấc	விக்கல்	Nan
nảy	துள்ளல்	Nan
nản	ஊக்கம்	None
nạp	ஏற்றப்பட்டது	Nan
nạo	குணப்படுத்துதல்	Nan
nạn	துன்பம்	None
nại	புகார்	None
nạc	ஒல்லியான	Nan
nắp	மூடி	None
nạ	முகமூடி	Nan
nằm	பொய்	Nan
nặc	அநாமதேயமாக	Nan
nồm	nape	Nan
nồi	பானை	Nan
nốt	குறிப்பு	None
nối	இணைக்கப்பட்டுள்ளது	Nan
nỏ	குறுக்கு வில்	Nan
nọc	விஷம்	Nan
nọ	மற்ற	None
nịnh	முகஸ்துதி	Nan
nỉ	உணர்ந்தேன்	Nan
nện	துடிக்கிறது	Nan
nể	மரியாதை	None
nề	கொத்து	Nan
nếu	என்றால்	None
nếp	ஒட்டும்	Nan
nến	மெழுகுவர்த்தி	Nan
nếm	சுவை	None
nẻo	மற்றொன்று	None
nặng	கனமான	Nan
nặn	கசக்கி	Nan
nẵng	நாங்	Nan
nǎm	nǎm	Nan
nướng	வறுக்கப்பட்ட	Nan
nước 	நாடு	Nan
nê	நெ	Nan
nét	பக்கவாதம்	Nan
nén	சுருக்கப்பட்டது	Nan
ném	வீசு	Nan
né	டாட்ஜ்	Nan
não	மூளை	None
nã	nã	Nan
nâu	பழுப்பு	Nan
nâng	உயர்த்தவும்	Nan
náu	மறை	None
nát	நொறுக்கப்பட்ட	Nan
náo	சலசலப்பு	Nan
nách	அக்குள்	Nan
ná	ná	Nan
này	இது	None
nào	வா	None
nành	சோயா	Nan
nàn	புகார்	None
nài	வலியுறுத்துங்கள்	Nan
nên	மெழுகுவர்த்தி	Nan
nêu	சொல்லுங்கள்	Nan
nòi	இனம்	None
nòng	பீப்பாய்	Nan
nước	நாடு	None
nơtrino	நியூடினோ	Nan
nơi	இடம்	None
năng	சக்தி	None
năn	மனந்திரும்புதல்	Nan
năm	ஆண்டு	None
nút	முடிச்சு	None
núp	மறை	None
núm	குமிழ்	Nan
nổ	வெடிக்கும்	Nan
nùng	நுங்	Nan
nông	மேலோட்டமான	Nan
nôn	வாந்தி	None
nôm	nôm	Nan
nôi	எடுக்காதே	Nan
nôbita	டோபிடா	Nan
nô	அடிமை	None
nóng	சூடான	None
nón	தொப்பி	Nan
nói	பேச	Nan
nõn	உரித்தல்	Nan
mũi	மூக்கு	None
sập	சரிவு	None
sắn	கசவா	Nan
wright	ரைட்	None
wrestling	மல்யுத்தம்	Nan
would	என்று	None
woods	வூட்ஸ்	Nan
woodrow	வூட்ரோ	Nan
wong	வோங்	Nan
won	வென்றது	Nan
wolfgang	ஓநாய்	Nan
without	இல்லாமல்	None
within	உள்ளே	None
wisconsin	விஸ்கான்சின்	Nan
winer	வெற்றியாளர்	Nan
windows	ஜன்னல்கள்	Nan
wimbledon	விம்பிள்டன்	Nan
willard	வில்லார்ட்	Nan
wiley	விலே	Nan
wilder	வைல்டர்	Nan
wild	காட்டு	None
wikitravel	விக்கிட்ராவெல்	Nan
wu	வு	Nan
wikimedia	விக்கிமீடியா	None
wushu	wushu	Nan
xa	இதுவரை	None
xiềng	திண்ணைகள்	Nan
xiết	இறுக்கு	Nan
xiếc	சர்க்கஸ்	Nan
xiêu	xiao	Nan
xiên	சாய்ந்த	Nan
xiêm	சியாமிஸ்	Nan
xiv	xiv	Nan
xinh	அழகு	None
xin	தயவு செய்து	Nan
xiii	xiii	Nan
xi	xi	Nan
xhcn	xhcn	Nan
xen	xen	Nan
xem	பார்க்க	None
xe	கார்	Nan
xay	அரைக்கவும்	Nan
xao	மந்தமான	Nan
xanh	நீலம்	None
xang	xang	Nan
wwf	wwf	Nan
xo	xo	Nan
wikimapia	விக்கிமபியா	Nan
wikia	விக்கியா	Nan
watergate	வாட்டர்கேட்	Nan
wat	வாட்	None
washington	வாஷிங்டன்	None
warszawa	வார்சாவா	Nan
warsaw	வார்சா	Nan
warren	வாரன்	Nan
wanna	வேண்டும்	None
wankel	wankel	Nan
wang	வாங்	Nan
wan	wan	Nan
walther	வால்டர்	Nan
walter	வால்டர்	Nan
walt	வால்ட்	None
wa	வா	None
w	w	Nan
vỹ	அதனால்	None
vựng	சொல்லகராதி	Nan
vực	புலம்	None
vững	நிறுவனம்	None
waterloo	வாட்டர்லூ	Nan
wikibooks	விக்கிபுக்ஸ்	Nan
waters	நீர்	None
wcdma	wcdma	Nan
wiki	விக்கி	None
wifi	வைஃபை	None
wiener	வீனர்	Nan
wien	wien	Nan
widener	அகலப்படுத்துபவர்	Nan
wheeler	சக்கர வாகனம்	Nan
westview	மேற்கு பார்வை	Nan
westlife	மேற்கு வாழ்க்கை	Nan
western	மேற்கு	None
westermarck	வெஸ்டர்மார்க்	Nan
werner	வெர்னர்	Nan
wembley	வெம்ப்லி	Nan
welsh	welsh	Nan
wells	கிணறுகள்	Nan
wellington	வெலிங்டன்	Nan
weimar	வீமர்	Nan
webmail	வெப்மெயில்	Nan
weblog	வலைப்பதிவு	None
weasley	வெஸ்லி	Nan
wayne	வேன்	Nan
vừng	எள்	Nan
xoa	தேய்க்கவும்	Nan
xong	நிறைவேற்றப்பட்டது	Nan
xăng	பெட்ரோல்	Nan
xăm	பச்சை	None
xúi	தூண்ட	Nan
xúc	தொடர்பு	None
xú	முரட்டுத்தனமாக	Nan
xù	சிதைந்தது	Nan
xôviết	சோவியத் ஒன்றியம்	Nan
xôphần	வாளி பிரிவு	Nan
xông	விரைந்தது	Nan
xôn	அசை	Nan
xôi	குலைந்த அரிசி	Nan
xô	திண்ணை	Nan
xót	கருணை	None
xóm	பக்கத்து	Nan
xói	அரிப்பு	None
xóa	அழிக்கவும்	Nan
xòe	பரவுகிறது	Nan
xíu	சிறியது	Nan
xít	கண்கவர்	Nan
xơ	ஃபைபர்	Nan
xí	தொழிற்சாலை	None
xưa	பழையது	Nan
xương	எலும்பு	Nan
xốp	மெத்து	Nan
xốc	அதிர்ச்சி	None
xỉu	மயக்கம்	Nan
xỉa	floss	Nan
xỉ	கசடு	Nan
xếp	மடிந்தது	Nan
xẻo	துரதிர்ஷ்டவசமான	Nan
xắt	பகடை	Nan
xẩy	ஏற்படும்	None
xẩm	ஷாகி	Nan
xấu	மோசமான	None
xấp	தோராயமாக	None
xảy	ஏற்படும்	None
xảo	வஞ்சகமுள்ள	Nan
xả	வெளியேற்றம்	None
xạ	கதிர்வீச்சு	None
xưởng	பணிமனை	Nan
xướng	கூட்டாக பாடுதல்	Nan
xước	கீறப்பட்டது	Nan
xưng	ஒப்புதல் வாக்குமூலம்	Nan
xoay	திரும்பவும்	None
xìu	குசு	Nan
xêkô	சுனியோ	Nan
xuồng	கேனோ	Nan
xuống	கீழ்	None
xuấtnhập	ஏற்றுமதி இறக்குமதி	Nan
xuất	ஏற்றுமதி	None
xuôi	சுத்தமாக	Nan
xuâncông	வசந்த	None
xuân	வசந்த	None
xuyến	வளையல்கள்	Nan
xuyên	குத்துதல்	Nan
xum	ஆடம்பரமான	None
xuka	xuka	Nan
xui	துரதிர்ஷ்டவசமான	Nan
xuan	xuan	Nan
xua	அகற்ற	None
xu	நாணயம்	None
xoắn	முறுக்கப்பட்ட	Nan
xoáy	எடி	Nan
xoá	அழி	Nan
xoàng	சாதாரணமான	Nan
xv	xv	Nan
xì	குசு	Nan
xvi	xvi	Nan
xx	xx	Nan
xê	நகர்வு	Nan
xét	கருத்தில் கொள்ளுங்கள்	Nan
xéo	பக்கவாட்டு	Nan
xén	பயிர்	None
xé	கண்ணீர்	None
xèo	xèo	Nan
xãy	சிக்கலான	None
xã	கம்யூன்	Nan
xây	கட்ட	Nan
xâu	லேசான கயிறு	Nan
xâm	பச்சை குத்தப்பட்டது	Nan
xát	தேய்த்தல்	Nan
xáo	இடையூறு	None
xán	வறுத்த	Nan
xám	சாம்பல்	Nan
xách	கைப்பை	Nan
xào	வறுக்கவும்	Nan
xài	செலவு	None
xy	xy	Nan
xvii	xvii	Nan
vừa	பொருத்தம்	None
vứt	தூக்கி எறியுங்கள்	Nan
vụng	விகாரமான	Nan
voyager	வோயேஜர்	Nan
vong	உயிரிழப்புகள்	Nan
vonfram	மின்னிழைமம்	Nan
von	வான்	None
voldemort	voldemort	Nan
voip	voip	Nan
voi	யானைகள்	None
vo	vo	Nan
vni	vni	Nan
vnexpress	vnexpress	Nan
vn	வி.என்	Nan
việttrung	வியட்ரங்	Nan
việtnga	vietnga	Nan
việtmường	வியட்நாமிய முவாங்	Nan
việt	வியட்நாம்	None
viện	நிறுவனம்	None
việc	வேலை	None
viết	எழுதுங்கள்	Nan
viếng	வருகை	None
voọc	langurs	Nan
viêt	எழுதுதல்	None
vtc	vtc	Nan
vua	ராஜா	None
váng	கறை	Nan
ván	பிளாங்	Nan
vái	ஆம்	None
vách	சுவர்	None
vác	சுமந்து	None
vá	இணைப்பு	None
vào	அதனுள்	None
vành	விளிம்பு	Nan
vàng	மஞ்சள்	None
vàm	vm	Nan
vài	சில	None
và	மற்றும்	None
vyacheslav	vyacheslav	Nan
vy	vy	Nan
vv	முதலியன	None
vuốt	நகம்	Nan
vuông	சதுரம்	Nan
vulcan	வல்கன்	Nan
vui	வேடிக்கை	Nan
vu	vu	Nan
váy	உடை	None
viêng	வியாங்	Nan
viêm	வீக்கம்	None
vienna	வியன்னா	Nan
victoria	விக்டோரியா	None
victor	வெற்றியாளர்	Nan
viagra	வயக்ரா	Nan
vi	ஏனெனில்	None
vhs	vhs	Nan
versailles	வெர்சாய்ஸ்	Nan
verona	வெரோனா	Nan
vermont	வெர்மான்ட்	Nan
verdun	வெர்டூன்	Nan
venus	வெள்ளி	None
venezia	வெனீசியா	Nan
vendôme	வென்டேம்	Nan
ven	உடன்	None
vectơ	திசையன்	Nan
vay	கடன் வாங்க	Nan
vasari	வசரி	Nan
vargas	வர்காஸ்	Nan
vanessa	வனேசா	Nan
viet	viet	Nan
viên	மாத்திரைகள்	None
vietnam	வியட்நாம்	None
viii	viii	Nan
viz	அதாவது	None
vitruvius	விட்ரூவியஸ்	Nan
vitamin	வைட்டமின்	Nan
vista	விஸ்டா	None
vissarionovich	விஸ்ஸாரியோனோவிச்	Nan
virút	வைரஸ்	None
virus	வைரஸ்	None
virginia	வர்ஜீனியா	Nan
viqr	viqr	Nan
vinpearl	vinpearl	Nan
vincent	வின்சென்ட்	Nan
vincennes	vincennes	Nan
vince	வின்ஸ்	Nan
vinashin	வினாஷின்	Nan
vinagame	வினகமே	Nan
villeneuve	villeneuve	Nan
villa	வில்லா	Nan
viking	வைக்கிங்	Nan
vijaya	விஜயா	Nan
viettel	viettel	Nan
vân	விரைவில்	None
vây	துடுப்பு	Nan
vã	விரைந்தது	Nan
vẹt	கிளிகள்	Nan
vẹn	நேர்மை	Nan
vặt	விளம்பரங்கள்	None
vặn	திருகு	Nan
vắng	இல்லை	None
vắn	குறுகிய	Nan
vắcxin	தடுப்பூசி	None
vắc	தடுப்பூசி	None
vận	அதிர்ஷ்டம்	Nan
vẫy	அசைப்பதன்	Nan
vẫn	இன்னும்	None
vẩy	செதில்களாக	Nan
vẩn	இன்னும்	None
vầng	ஒளிவட்டம்	Nan
vần	ரைம்	Nan
vất	தூக்கி எறியுங்கள்	Nan
vấp	முறிந்தது	Nan
vấn	ஆலோசனை	None
vảy	செதில்கள்	Nan
vẽ	ஓவியம்	None
vải	துணி	None
vết	இணைப்பு	None
vệ	பாதுகாப்பு	None
vụn	சீவல்கள்	Nan
vợ	மனைவி	None
vỡ	உடைந்த	Nan
vở	நோட்புக்	Nan
vời	நன்று	None
vờ	பாசாங்கு	Nan
vớt	மீன்	Nan
với	உடன்	None
vớ	சாக்ஸ்	Nan
vội	அவசரம்	Nan
vỗ	பேட்	Nan
vồ	ம ul ல்	Nan
vỏ	பட்டை	None
vọt	வானளாவ	Nan
vọng	நம்பிக்கை	None
vịt	வாத்து	Nan
vịnh	பே	Nan
vỉa	seams	Nan
vệt	கோடுகள்	Nan
vểnh	பெர்ச்	Nan
vả	அத்தி	Nan
vạng	அந்தி	None
vạn	பத்தாயிரம்	Nan
võ	தற்காப்பு	Nan
vôi	சுண்ணாம்பு	None
vô	இல்லை	None
vóc	அளவு	None
vó	ஹூஹூ	Nan
vòng	மோதிரம்	Nan
vòm	கூரை	None
vòi	குழாய்	None
vò	நொறுங்கியது	Nan
vít	திருகு	Nan
vía	பணப்பை	Nan
ví	பணப்பை	Nan
vì	ஏனெனில்	None
vê	பற்றி	None
vét	அகழி	Nan
vé	டிக்கெட்	Nan
vè	சிறுநீர் கழித்தல்	Nan
vãn	வேன்	Nan
vãi	மலம்	None
võng	காம்பால்	Nan
vùi	புதைக்கப்பட்டது	Nan
vùng	பகுதி	Nan
vú	மார்பக	None
vại	ஜாடி	Nan
vạch	மதுக்கூடம்	Nan
vạc	cauldron	Nan
vạ	அதனால்	None
vượt	பாஸ்	None
vượn	குரங்குகள்	Nan
vườn	தோட்டம்	None
vướng	சிக்கிக்கொண்டது	Nan
vương	ராஜா	None
xổ	ரேஃபிள்	Nan
vươn	அடைய	None
vơi	உடன்	None
vơ	உதவியற்ற	Nan
vũng	குட்டை	Nan
vũ	vu	Nan
vĩnh	நிரந்தரமாக	Nan
vĩ	நன்று	None
văng	ஸ்பிளாஸ்	Nan
văn	இலக்கியம்	None
vút	உயரும்	None
vưu	vưu	Nan
xộn	குழப்பமான	Nan
xứ	நில	None
xứng	தகுதியானவர்	Nan
đẩy	தள்ள	Nan
đẩu	தலை	None
đầy	முழு	None
đầu	தலை	None
đần	ஊமை	Nan
đầm	உடை	None
đấy	அங்கே	None
đấtmặt	தரையில்	None
đất	நில	None
đấng	இறைவன்	None
đấm	குத்துவதற்கு	Nan
đảo	தீவு	None
đảng	கட்சி	None
đản	பிறந்த நாள்	Nan
đảm	உத்தரவாதம்	None
đả	சண்டை	None
đạt	அடைய	None
đạp	மிதிவண்டி	Nan
đạo	மதம்	None
đẫm	நனைந்தது	Nan
đạn	புல்லட்	Nan
đậm	இருள்	Nan
đậy	கவர்	Nan
để	க்கு	Nan
đều	உள்ளன	None
đền	கோயில்	None
đề	இழைகள்	Nan
đến	வாருங்கள்	Nan
đếm	எண்ணிக்கை	None
đế	உள்ளங்கால்கள்	Nan
đẽ	நன்றாக இருக்கிறது	Nan
đẹp	அழகான	None
đặn	வழக்கமான	None
đặc	சிறப்பு	None
đẳng	வர்க்கம்	None
đằng	ஓவர்	Nan
đắt	விலை உயர்ந்தது	Nan
đắp	மேலே	None
đắng	கசப்பான	Nan
đắn	தனியுரிமை	Nan
đắm	சிதைந்தது	Nan
đắc	ஆதாயம்	Nan
đậu	பீன்	Nan
đệm	தலையணை	Nan
đạm	புரத	None
đạ	டா	None
đói	பசி	None
đóa	இல்லை	None
đó	அங்கே	None
đòn	அடி	None
đòi	உரிமைகோரல்	Nan
đò	படகு	None
đính	இணைக்கப்பட்ட	None
đích	இலக்கு	None
đênh	பக்	None
đêm	இரவு	None
đê	டைக்	Nan
đèo	பாஸ்	None
đèn	விளக்கு	None
đè	மீறு	Nan
đãng	லெச்சரஸ்	Nan
đãi	உபசரிப்பு	Nan
đã	ஏற்கனவே	None
đây	இங்கே	None
đâu	எங்கே	None
đón	எடு	None
đại	நன்று	None
đôi	இரட்டை	None
đôn	பீடம்	None
được	சரி	None
đường	தெரு	None
đưa	பாஸ்	None
đơ	இடைநிறுத்தம்	Nan
đĩa	தட்டு	None
đĩ	ஸ்லட்	Nan
đăk	டக்	Nan
đút	போடு	Nan
đúp	இரட்டை	None
đúng	அது சரி	Nan
đúc	வார்ப்பு	Nan
đùi	தொடை	Nan
đùa	நகைச்சுவை	Nan
đôrêmon	டோரமன்	Nan
đôrêmi	doraemon	Nan
đôngtây	கிழக்கில் இருந்து மேற்கு	Nan
đôngnam	தென்கிழக்கு	None
đôngbắc	வடகிழக்கு	None
đông	வெண்கலம்	Nan
đôla	டாலர்கள்	Nan
đỉnh	மேல்	None
địch	எதிரி	Nan
định	குறிப்பிடப்பட்டுள்ளது	None
ẩn	மறை	None
ẩm	சூடான	None
ấy	அந்த	None
ấu	இளம்	None
ấp	குக்கிராமம்	Nan
ấnâu	அச்சு	None
ấn	அச்சகம்	None
ấm	சூடான	None
ảnh	படம்	None
ải	ải	Nan
ạt	அவசரம்	Nan
ạ	ஐயா	Nan
ướt	ஈரமான	Nan
ướp	marinated	Nan
ương	மத்திய	None
ươm	நாற்றங்கால்	Nan
ươi	orang	Nan
ưu	நன்மை	None
ưng	ஓ ஆம்	Nan
ập	இடி	Nan
ưa	விருப்பமான	Nan
ắt	நிச்சயம்	Nan
ỏi	புதினா	Nan
ứng	விண்ணப்பம்	Nan
ức	மார்பக	None
ứ	ஆம்	None
ủy	ஆணையர்	Nan
ủng	பூட்ஸ்	Nan
ủi	இரும்பு	None
ủ	அடைகாத்தல்	Nan
ở	இல்	None
ớt	மிளகாய்	Nan
ớn	பெரியது	None
ổn	நன்றாக இருக்கிறது	Nan
ổi	கொய்யா	Nan
ổ	இயக்கி	None
ồn	சத்தம்	None
ốp	தொடுகோடு	Nan
ống	குழாய்	None
ốm	நோய்வாய்ப்பட்டது	Nan
ốc	நத்தைகள்	Nan
ố	ஓ	None
ếch	ஒரு தவளை	Nan
ư	u	Nan
ơn	நன்றி	Nan
ơi	ஏய்	Nan
đỗ	நிறுத்தப்பட்டுள்ளது	Nan
đổng	டாங்	Nan
đổi	மாற்றம்	None
đổ	ஊற்று	None
đồng	தாமிரம்	Nan
đồn	வதந்தி	Nan
đồi	மலை	None
đồ	விஷயம்	Nan
đốt	எரியும்	None
đống	குவியல்	Nan
đốn	நறுக்கவும்	Nan
đốm	ஸ்பாட்	Nan
đối	க்கு	Nan
đốc	கவர்னர்	Nan
đỏ	சிவப்பு	None
đọng	தேங்கி நிற்கும்	Nan
đọc	படி	None
đọan	பத்தி	Nan
đọ	குழி	Nan
độ	பட்டம்	None
độc	விஷம்	Nan
độn	துடுப்பு	Nan
động	மாறும்	None
ơ	ஓ	None
ĩ	ஓ	None
đựoc	சரி	None
đựng	கொண்டிருக்கும்	None
đực	ஆண்	None
đừng	வேண்டாம்	None
đứt	உடைந்த	Nan
đứng	நிற்க	Nan
đức	நல்லொழுக்கம்	Nan
đâm	குத்து	None
đứa	குழந்தைகள்	None
đụng	தொடு	Nan
đụn	குன்றுகள்	Nan
đục	ஒளிபுகா	Nan
đợt	தொகுதி	Nan
đợi	காத்திரு	Nan
đỡ	ஆதரவு	None
đời	வாழ்நாள்	None
đới	ஜென்	Nan
đột	திடீரென்று	Nan
đủ	போதும்	Nan
van	அடைப்பான்	Nan
đát	நில	None
đáo	தனித்துவமான	None
|việt	| வியட்நாமிய	Nan
|tên	| பெயர்	Nan
|petya	| பெட்டியா	Nan
|nổi	| மிதக்கிறது	Nan
|nguyễn	| nguyen	Nan
zürich	zürich	Nan
zurich	சூரிச்	Nan
zoe	zoe	Nan
zing	ஜிங்	Nan
zinedine	zinedine	Nan
zimbabwe	ஜிம்பாப்வே	None
zhukmse	zhukmse	Nan
zheng	ஜெங்	Nan
zeus	ஜீயஸ்	Nan
zero	பூஜ்யம்	Nan
zedong	zedong	Nan
zealand	ஜீலாந்து	Nan
zambia	சாம்பியா	Nan
zac	zac	Nan
 kg	கிலோ	Nan
z	z	Nan
 triệu	மில்லியன்	Nan
°đến	° முதல்	Nan
êgê	ஈகோ	Nan
ép	கசக்கி	Nan
én	விழுங்குகிறது	Nan
ân	தயவு	Nan
âm	கழித்தல்	None
â	â	Nan
áâu	aoi	Nan
áp	அழுத்தம்	None
áohung	aohung	Nan
áo	சட்டை	Nan
ánh	காந்தி	None
ám	வழங்குகிறது	None
ái	ஏங்கி	Nan
ách	நுகம்	Nan
ác	தீமை	Nan
á	ஆசிய	None
ào	ஆஹா	Nan
×	×	None
°độ	° டிகிரி	Nan
 °c	. சி	Nan
êm	மென்மையான	None
yểu	அழகான	None
yểm	கவர்	Nan
yomiuri	yomiuri	Nan
yo	யோ	Nan
ymca	ymca	Nan
ying	யிங்	Nan
yi	yi	Nan
yersin	yersin	Nan
yemen	யேமன்	Nan
yeltsin	yeltsin	Nan
yeeun	yeeun	Nan
yasha	yasha	Nan
yard	முற்றத்தில்	Nan
yankee	யாங்கி	Nan
yalta	yalta	Nan
yakushima	யகுஷிமா	Nan
yakovlev	yakovlev	Nan
ya	யா	Nan
y=fracsin	y = fracsin	Nan
y	y	Nan
xử	உபசரிப்பு	Nan
yoochun	yoochun	Nan
yển	யென்	Nan
york	யார்க்	Nan
yorkshire	யார்க்ஷயர்	Nan
yếu	பலவீனமான	Nan
yết	பட்டியல்	None
yến	பறவையின் கூடு	Nan
yếm	கவரல்கள்	Nan
yêu	நேசிக்க	Nan
yên	யென்	Nan
yurt	yurt	Nan
yuri	யூரி	Nan
yunho	யுன்ஹோ	Nan
yume	yume	Nan
yukito	யுகிடோ	Nan
yugi	யுகி	Nan
yudhoyono	yudhoyono	Nan
yucatán	yucatán	Nan
yuan	யுவான்	Nan
yu	யூ	None
ytv	ytv	Nan
ypres	ypres	Nan
youtube	வலைஒளி	Nan
yorker	யார்க்கர்	Nan
ích	பயனுள்ளதாக இருக்கும்	Nan
ílam	ílam	Nan
ít	கொஞ்சம்	None
đoàn	குழு	None
đoài	மாங்கனி	Nan
đom	மின்மினிப் பூச்சிகள்	Nan
đoan	குழு	None
đoa	doa	Nan
đo	அளவீட்டு	None
điệu	தொனி	Nan
điệp	செய்தி	None
điểu	fuck	Nan
điển	அகராதி	None
điểm	புள்ளி	None
điều	விஷயம்	Nan
điền	நிரப்பு	Nan
điềm	அடையாளம்	None
điếu	சிகரெட்	Nan
điếc	செவிடு	Nan
điạ	dạ	Nan
điôxít	டை ஆக்சைடு	Nan
điêu	விஷயம்	Nan
đoái	பரிமாற்றம்	None
điên	பைத்தியம்	Nan
đoạn	பத்தி	Nan
đtđ	கைப்பேசி	Nan
đáng	மதிப்பு	None
đán	டான்	None
đám	குழு	None
đái	சிறுநீர் கழித்தல்	Nan
đá	பாறை	None
đày	நாடுகடத்தல்	Nan
đào	தோண்டி	Nan
đàng	ஆம்	None
đàn	கூட்டம்	None
đàm	பேச்சு	None
đài	வானொலி	None
đuổi	துரத்து	Nan
đuống	தண்டு	None
đuối	மூழ்கி	Nan
đuốc	ஜோதி	Nan
đuôi	வால்	None
đun	வெப்பம்	None
đui	குருட்டு	Nan
đua	இனம்	None
đt	தொலைபேசி	None
đi	போ	Nan
đhông	கிழக்கு	None
đhtm	dhtm	Nan
ôzôn	ஓசோன்	Nan
ôxít	ஆக்சைடு	None
ôxy	ஆக்ஸிஜன்	None
ôxi	ஆக்ஸிஜன்	None
ôtô	கார்	Nan
ông	அவர்	None
ôn	மிதமான	Nan
ôm	கட்டிப்பிடி	Nan
ôi	ஓ	None
óng	iridescent	Nan
óc	மூளை	None
ó	ó	Nan
ðức	ஜெர்மனி	None
ðảng	கட்சி	None
ðường	சர்க்கரை	None
ðài	ðài	Nan
ðiều	கட்டுரை	None
îledefrance	எல்ஃபெரன்ஸ்	Nan
île	le	Nan
ùn	நெரிசல்கள்	Nan
úng	நீரில் மூழ்கியது	Nan
úp	முகம் கீழே	Nan
úy	லெப்டினன்ட்	Nan
đhcn	ncn	Nan
đh	ம	Nan
đeo	அணிய	Nan
đentrắng	கருப்பு வெள்ளை	Nan
đen	கருப்பு	None
đem	கொண்டு வாருங்கள்	Nan
đe	anvil	Nan
đcsvn	dcsvn	Nan
đcstq	dcstq	Nan
đáp	பதில்	None
đb	db	Nan
đau	வலி	None
đan	பின்னல்	Nan
đak	டக்	Nan
đai	இசைக்குழு	Nan
đa	பல	None
ăngten	ஆண்டெனா	Nan
ăng	எறும்பு	None
ăn	சாப்பிடுங்கள்	Nan
ý	இத்தாலி	None
đay	சணல்	Nan
sắm	கடையில் பொருட்கள் வாங்குதல்	Nan
valley	பள்ளத்தாக்கு	None
valencia	வலென்சியா	Nan
thập	குறுக்கு	None
thận	சிறுநீரகம்	None
thẫm	இருள்	Nan
thẩm	ஜூரர்கள்	Nan
thầy	ஆசிரியர்	None
thần	இறைவன்	None
thầm	அமைதியாக	Nan
thấu	ஊடுருவி	Nan
thấp	குறுகிய	Nan
thảo	அழகு	None
thản	அமைதியான	None
thảm	கம்பளம்	Nan
thải	கழிவு	None
thả	கைவிட	Nan
thạo	நிபுணர்	Nan
thạnh	thanh	Nan
thạch	ஜெல்லி	Nan
thạc	முதுநிலை	Nan
thượng	மேல்	None
thật	உண்மையானது	Nan
thược	துட்	Nan
thắm	இதழ்	None
thắng	வென்றது	Nan
thọ	நீண்ட ஆயுள்	Nan
thịt	இறைச்சி	None
thịnh	வோக்	Nan
thỉnh	அழைக்க	None
thể	இரு	None
thềm	அலமாரி	Nan
thề	சத்தியம்	None
thếp	எஃகு	Nan
thế	அதனால்	None
thẻ	அட்டை	None
thẹn	வெட்கமாக	Nan
thặng	உபரி	Nan
thẳng	நேராக	Nan
thẳm	ஆழமான	Nan
thằng	பையன்	None
thằn	பல்லி	Nan
thắt	முடிச்சுபோடு	Nan
thắp	ஒளி	None
thắngthua	வென்றது	Nan
thắn	வெளிப்படையாக	None
thọc	ஜப்	Nan
thưởng	வெகுமதி	Nan
thước	ஆட்சியாளர்	Nan
thìa	ஸ்பூன்	Nan
thêu	வாடகை	Nan
thêm	மேலும்	None
thê	தி	None
thét	கத்தினான்	Nan
thép	எஃகு	Nan
thèm	ஏங்குகிறது	Nan
thãi	மலம்	None
thây	பார்க்க	None
thâu	பதிவு செய்யப்பட்டது	Nan
thâm	ஆழமான	Nan
tháp	கோபுரம்	Nan
tháo	அகற்று	Nan
thánh	செயின்ட்	None
tháng	மாதம்	None
thám	துப்பறியும்	Nan
thái	தாய்	None
thách	சவால்	None
thác	அடுக்கை	Nan
thìn	பிறகு	None
thường	பெரும்பாலும்	None
thình	திடீரென்று	Nan
thít	திட்	Nan
thương	காதல்	None
thưa	அன்பே	None
thư	எழுத்துக்கள்	Nan
thơm	மணம்	None
thăng	பதவி உயர்வு	Nan
thăm	வருகை	None
thúy	துய்	Nan
thúc	முடிவு	None
thú	சுவாரஸ்யமானது	Nan
thùy	லோப்	Nan
thùng	பின்	None
thù	பகை	Nan
thông	தகவல்	None
thôi	வா	None
thô	தோராயமாக	None
thói	பழக்கம்	None
thóc	நெல்	None
thòi	தீமை	Nan
thò	குத்தியது	Nan
thí	சோதனைகள்	Nan
thày	ஆசிரியர்	None
thỏ	முயல்	Nan
thỏi	இங்காட்	Nan
tncs	tncs	Nan
tiệt	செக்ஸ்	Nan
tiệp	செக்	None
tiện	வசதியானது	Nan
tiệm	கடை	Nan
tiệc	விருந்து	None
tiễu	திரு லியு	Nan
tiểu	சிறுநீர் கழித்தல்	Nan
tiều	மலம்	None
tiền	பணம்	None
tiềm	சாத்தியமான	None
tiếu	முட்டாள்தனம்	Nan
tiết	சுரப்பு	Nan
tiếng	மொழி	Nan
tiến	மேலே	None
tiếm	முட்டாள்தனம்	Nan
tiếc	வருத்தம்	Nan
tiêu	மிளகு	Nan
tiên	முதல்	None
tngt	tngt	Nan
tizard	tizard	Nan
tnhh	வரையறுக்கப்பட்டவை	Nan
tobago	டொபாகோ	Nan
toàn	பாதுகாப்பானது	Nan
toà	நீதிமன்றம்	None
toyota	டொயோட்டா	Nan
toyama	டோயாமா	Nan
tourist	சுற்றுலா	None
tourism	சுற்றுலா	None
tottenham	டோட்டன்ஹாம்	Nan
toriyama	டோரியமா	Nan
torino	டொரினோ	Nan
top	மேல்	None
toonami	டூனாமி	Nan
tony	டோனி	Nan
tomoyo	tomoyo	Nan
tommy	டாமி	Nan
tomas	டோமாக்கள்	Nan
tokyopop	டோக்கியோபாப்	Nan
tokyo	டோக்கியோ	None
tokugawa	tokugawa	Nan
toei	toei	Nan
toang	toang	Nan
thỏa	ஒப்பந்தம்	None
tivi	தொலைக்காட்சி	None
tish	டிஷ்	Nan
thừng	கயிறு	Nan
thừa	தேவைக்கதிகமான	Nan
thức	விழித்திருங்கள்	Nan
thứ	விஷயங்கள்	None
thủng	துளைத்தல்	Nan
thủa	thua	Nan
thủ	பிரதம	None
thụt	உள்தள்ளப்பட்டது	Nan
thục	சு	None
thụ	ஏற்பி	Nan
thợ	தொழிலாளி	Nan
thở	மூச்சு	None
thời	நேரம்	None
thớt	வெட்டுதல் குழு	Nan
thổi	அடி	None
thổ	பூமி	None
thồ	பேக்	Nan
thốt	உச்சரிக்கப்பட்டது	Nan
thối	அழுகிய	Nan
thử	முயற்சிக்க	Nan
tissa	திசு	None
thửa	பார்சல்	Nan
thực	உண்மையானது	Nan
tisdale	டிஸ்டேல்	Nan
tirol	டைரோல்	Nan
tinthị	tinthị	Nan
tinsông	செய்தி	None
tinnhà	டின்ஹோம்	Nan
tinh	கிரகம்	None
tincầu	தகரம் பாலம்	Nan
tinbắc	செய்தி	None
tin	நம்புங்கள்	Nan
timothy	தீமோத்தேயு	Nan
timor	டைமர்	Nan
tim	இதயம்	None
tiliaceus	tiliaceus	Nan
tigris	டைக்ரிஸ்	Nan
tibet	திபெத்	None
tiara	தலைப்பாகை	Nan
tiananmen	tiananmen	Nan
tia	கதிர்	None
ti	ti	Nan
thự	வில்லா	Nan
thành	கோட்டை	None
thà	அதற்கு பதிலாக	Nan
thy	உன்னுடையது	Nan
tarim	tarim	Nan
tao	நான்	None
tanzania	தான்சானியா	Nan
tankōbon	tanōbon	Nan
tanh	மீன்	Nan
tang	துக்கம்	None
tanaka	தனகா	Nan
tamoxifen	தமொக்சிபென்	Nan
tam	டாம்	Nan
talmud	டால்முட்	Nan
taliban	தலிபான்	Nan
tali	தாலி	Nan
taklamakan	தக்லமகன்	Nan
takahashi	தகாஹஷி	Nan
tajiri	தாஜிரி	Nan
tajima	தாஜிமா	Nan
tajikistan	தஜிகிஸ்தான்	Nan
taj	தாஜ்	None
taiwan	taiwan	Nan
task	பணி	None
taipei	தைபே	Nan
tasman	டாஸ்மேன்	Nan
tau	tau	Nan
tenxơ	கார்டெல்	Nan
temur	temur	Nan
temujin	temujin	Nan
temple	கோயில்	None
tem	முத்திரை	None
telnet	டெல்நெட்	Nan
telex	டெலெக்ஸ்	Nan
telekom	டெலிகாம்	Nan
telecom	தொலை தொடர்பு	Nan
teddy	டெடி	Nan
ted	டெட்	Nan
technical	தொழில்நுட்ப	None
tcp	tcp	Nan
tcm	tcm	Nan
tchad	tchad	Nan
tbt	tbt	Nan
taylor	டெய்லர்	None
tay	கை	None
taxi	டாக்ஸி	Nan
tasmania	டாஸ்மேனியா	Nan
teo	அட்ரோபிக்	Nan
taiji	தைஜி	Nan
tag	குறிச்சொல்	Nan
sờ	தொடு	Nan
sớm	விரைவில்	None
sớ	விருப்பம்	None
sổ	நூல்	None
sồi	ஓக்	Nan
sốt	காய்ச்சல்	None
sống	வாழும்	None
sốc	அதிர்ச்சி	None
số	எண்	None
sỏi	சரளை	Nan
sỏ	sassy	Nan
sọc	கோடுகள்	None
sọ	மண்டை ஓடு	Nan
sẽ	விருப்பம்	None
sẻ	வேண்டும்	None
sẹo	வடு	Nan
sẵn	கிடைக்கிறது	None
sắt	இரும்பு	None
sắp	கிட்டத்தட்ட	None
sỡ	தவறவிட்டது	Nan
tai	காது	None
sợ	பயமாக இருக்கிறது	Nan
sục	ஜக்குஸி	Nan
tae	tae	Nan
ta	ta	Nan
sự	தி	None
sữa	பால்	None
sửu	ஆக்ஸ்	Nan
sửng	அதிர்ச்சி	None
sửa	பழுது	Nan
sử	வரலாறு	None
sừng	கொம்பு	Nan
sứt	சில்லு	Nan
sức	வலிமை	None
sứa	ஜெல்லிமீன்	Nan
sứ	பீங்கான்	Nan
sủng	கவர்ந்திழுக்கும்	Nan
sủi	செயல்திறன்	None
sủa	பட்டை	None
sụt	சரிவு	None
sụp	சரிவு	None
sụn	குருத்தெலும்பு	Nan
sợi	நூல்	None
terengganu	terengganu	Nan
territories	பிரதேசங்கள்	None
terry	டெர்ரி	Nan
thpt	thpt	Nan
thoắt	வரியில்	Nan
thoảng	எப்போதாவது	None
thoải	வசதியானது	Nan
thoả	ஒப்பந்தம்	None
thoạt	முதல் பார்வையில்	Nan
thoại	தொலைபேசி	None
thoát	வெளியேறு	Nan
thoáng	காற்றோட்டமான	Nan
thoán	யூகம்	Nan
thoái	பிற்போக்கு	Nan
those	அந்த	None
thong	தாங்	Nan
thompson	தாம்சன்	Nan
thomas	தாமஸ்	None
thoai	thoai	Nan
thoa	டப்	Nan
tho	tho	Nan
thiệu	அறிமுகம்	None
thriller	த்ரில்லர்	Nan
thiệt	உண்மையில்	None
thskts	thskts	Nan
thumb|các	கட்டைவிரல் | தி	Nan
thvn	thvn	Nan
thuỷ	thuy	Nan
thuỵ	துய்	Nan
thuở	குழந்தை பருவம்	Nan
thuờng	பொதுவாக	None
thuớc	தண்ணீர்	None
thuộc	சொந்தமானது	Nan
thuốc	மருந்து	None
thuế	வரி	None
thuật	கலை	None
thuận	நன்மை	None
thuẫn	மோதல்	None
thuần	தூய்மையானது	Nan
thuê	வாடகைக்கு	Nan
thuyền	படகு	None
thuyết	கோட்பாடு	None
thuyên	இடப்பெயர்வு	Nan
thung	பள்ளத்தாக்கு	None
thunderbolt	இடி	Nan
thua	இழக்க	Nan
thiệp	அட்டை	None
thiện	நல்ல	None
thiểu	மைனர்	None
thdq	thdq	Nan
thcs	thcs	Nan
thcn	thcn	Nan
thay	அதற்கு பதிலாக	Nan
thau	பித்தளை	Nan
thao	விளையாட்டு	None
thani	தானி	Nan
thanh	மதுக்கூடம்	Nan
thang	ஏணி	Nan
than	கரி	Nan
thames	தேம்ஸ்	Nan
tham	பேராசை	Nan
thailand	தாய்லாந்து	None
thai	கர்ப்பிணி	Nan
tha	சாக்குப்போக்கு	Nan
tgv	tgv	Nan
texas	டெக்சாஸ்	None
tet	tet	Nan
terumbu	terumbu	Nan
thebes	தீப்ஸ்	Nan
their	அவர்களது	Nan
them	அவர்களுக்கு	None
then	பிறகு	None
thiển	காட்டு	None
thiền	தியானம்	Nan
thiềm	அரிவாள்	Nan
thiếu	குறுகிய	Nan
thiết	அமை	Nan
thiếp	அட்டை	None
thiến	நியூட்டர்	Nan
thiếc	தகரம்	Nan
thiêng	புனிதமானது	Nan
toán	கணிதம்	None
thiêm	தியாம்	Nan
third	மூன்றாவது	None
thien	thien	Nan
thich	போன்ற	None
thi	தேர்வு	Nan
theseus	தீஸஸ்	Nan
theres	அங்கு தான்	Nan
theravada	தெரவாதா	Nan
theory	கோட்பாடு	None
theo	அதில் கூறியபடி	Nan
thiu	பழையது	Nan
toát	நல்ல	None
toạ	ஆய அச்சுகள்	Nan
toại	இல்	None
tạm	தற்காலிக	None
tại	இல்	None
tạc	சிற்பம்	None
tạ	பார்பெல்	Nan
tường	சுவர்	None
tướng	பொது	Nan
tưới	நீர்ப்பாசனம்	None
tước	நீக்குதல்	Nan
tương	ஒத்த	None
tươi	புதியது	Nan
tưng	நடுங்கும்	Nan
tư	இருந்து	None
tơi	நான்	None
tĩnh	நிலையான	None
tăng	அதிகரி	Nan
tăm	பற்பசை	Nan
tý	எலி	Nan
túy	மருந்து	None
túp	குடிசை	Nan
tạo	உருவாக்கு	Nan
túng	விகாரமான	Nan
tạp	பத்திரிகை	None
tản	சிதறல்	Nan
tặc	ஹேக்கர்கள்	Nan
tắt	அணைக்க	Nan
tắm	மழை	None
tắc	சுவிட்சுகள்	Nan
tật	இயலாமை	Nan
tận	முடிவு	None
tẩy	அழிப்பான்	Nan
tẩm	செறிவூட்டப்பட்ட	Nan
tầu	தொடர்வண்டி	Nan
tầng	தரை	Nan
tần	அதிர்வெண்	None
tầm	விளையாட்டுகள்	None
tấu	கருவி	Nan
tất	சாக்ஸ்	Nan
tấp	இழுக்கப்பட்டது	Nan
tấn	டன்	Nan
tấm	தட்டுகள்	None
tấc	அங்குலம்	Nan
tảng	நடைமேடை	Nan
tả	விளக்கம்	None
tặng	நன்கொடை	Nan
túm	பிடுங்க	Nan
túc	போதுமான அளவு	Nan
tê	உணர்ச்சியற்ற	Nan
tét	அலறல்	Nan
tã	டயப்பர்கள்	Nan
tâynam	மேற்குநாம்	Nan
tây	மேற்கு	None
tâu	என் கடவுளே	Nan
tâm	மையம்	None
táu	குற்ற உணர்வு	Nan
táp	தட்டவும்	Nan
tánh	தன்	None
tán	விதானம்	Nan
tám	எட்டு	None
tái	மறு	None
tách	கோப்பை	Nan
tá	டஜன்	Nan
tàu	கப்பல்	None
tành	தன்	None
tàng	அருங்காட்சியகம்	None
tàn	சாம்பல்	Nan
tên	பெயர்	None
túi	கைப்பை	Nan
tì	மண்ணீரல்	Nan
tìmdiệt	தேடல்	None
tùy	விரும்பினால்	None
tùng	உதிரி	Nan
tù	சிறையில்	None
tông	அட்டை	None
tôn	நெளி	Nan
tôm	இறால்	Nan
tôi	நான்	None
tô	கிண்ணம்	Nan
tóm	கூட்டு	None
tòng	டோங்	Nan
tòi	பொருள்	None
tòa	நீதிமன்றம்	None
tò	ஆர்வம்	None
tít	தலைப்பு	None
tín	வரவு	None
tím	வயலட்	Nan
tích	தயாரிப்பு	None
tía	ஊதா	None
tình	காதல்	None
tìm	கண்டுபிடி	Nan
tẻ	drab	Nan
tết	டெட்	Nan
tếxã	பொருளாதார ரீதியாக	Nan
ural	யூரல்	Nan
up	யு பி எஸ்	Nan
unix	யூனிக்ஸ்	Nan
unit	அலகு	None
unicorn	யூனிகார்ன்	Nan
ung	அழுகிய	Nan
unesco	unesco	Nan
under	கீழ்	None
und	und	Nan
un	ஐ.நா.	Nan
umm	umm	Nan
ulsan	உல்சன்	Nan
ukraina	உக்ரைனா	Nan
ukiyoe	ukiyoe	Nan
uk	இங்கிலாந்து	None
uh	இம்	None
uefa	uefa	Nan
uchiha	uchiha	Nan
uc	uc	Nan
urani	யுரேனியம்	None
ubuntu	உபுண்டு	Nan
uri	யூரி	Nan
usagi	usagi	Nan
vai	தோள்பட்டை	Nan
vaccine	தடுப்பூசி	None
va	va	Nan
v	v	Nan
uổng	வீணடிக்கிறது	Nan
uống	குடிக்க	Nan
uốn	கர்லிங்	Nan
uất	uất	Nan
uông	உங்	Nan
uzbekistan	உஸ்பெகிஸ்தான்	Nan
uyển	சொற்பொழிவு	Nan
uyên	யுயென்	Nan
uygur	uygur	Nan
uyghur	uyghur	Nan
uy	uy	Nan
utrecht	utrecht	Nan
utah	உட்டா	Nan
uss	uss	Nan
usb	usb	Nan
uruguay	உருகுவே	Nan
uae	uae	Nan
ua	ua	Nan
u	u	Nan
tồn	உள்ளன	None
tồi	மோசமான	None
tốt	நல்ல	None
tốp	குழு	None
tống	துணை	None
tốn	செலவு	None
tốc	வேகம்	None
tỏi	பூண்டு	Nan
tỏa	கதிர்வீச்சு	None
tỏ	வெளிப்படுத்தப்பட்டது	Nan
tọa	ஆய அச்சுகள்	Nan
tịch	ஜனாதிபதி	None
tị	பொறாமை	Nan
tỉnh	மாகாணம்	None
tỉa	டிரிம்	Nan
tệp	கோப்பு	Nan
tệ	மோசமான	None
tể	மிஸ்டர்	None
tề	குய்	Nan
tổn	காயப்படுத்துகிறது	Nan
tổng	மொத்தம்	Nan
tộc	குலம்	None
tội	பாவம்	None
tỷ	பில்லியன்	Nan
tỵ	பாம்பு	None
tựu	சாதனைகள்	Nan
tựa	தலைப்பு	None
tự	சுய	None
tửu	ஆல்கஹால் சகிப்புத்தன்மை	Nan
tử	இறப்பு	None
từng	எப்போதும்	None
từ	இருந்து	None
tài	அதிர்ஷ்டம்	Nan
tức	உடனடி	None
tủi	மோசமான	None
tủ	பெட்டிகளும்	Nan
tụy	கணையம்	None
tục	கேவலமான	Nan
tởm	அருவருப்பானது	Nan
tờ	தாள்	None
tới	அடுத்தது	Nan
tớ	என்னை	None
tột	தீவிர	None
tủy	மஜ்ஜை	Nan
valentine	காதலர்	Nan
tà	தீமை	Nan
type	வகை	None
trò	தந்திரம்	Nan
trích	பகுதி	Nan
trí	மனம்	None
trình	சமர்ப்பிக்கவும்	Nan
trên	ஆன்	None
trèo	ஏறு	Nan
trãi	சிதறடிக்கப்பட்டது	Nan
trâu	எருமை	Nan
trân	வாழ்த்துக்கள்	Nan
trâm	ப்ரூச்	Nan
trát	வாரண்ட்	Nan
tráp	பெட்டி	None
tráo	மோசடி	Nan
tránh	தவிர்க்கவும்	Nan
tráng	பூசப்பட்ட	Nan
trán	நெற்றியில்	Nan
trái	இடது	None
trách	பழி	Nan
trác	ட்ராக்	Nan
tròn	சுற்று	None
trào	வெடிப்பு	None
trói	கட்டப்பட்டது	None
trông	தெரிகிறது	None
trước 	முன்	Nan
trước	முன்	None
trương	ட்ரூங்	Nan
trưngcông	காட்சிக்கு வைக்கப்பட்டுள்ளது	Nan
trưng	கோரிக்கை	None
trưa	நண்பகல்	Nan
trư	ட்ரூ	Nan
trơn	வழுக்கும்	Nan
trơ	செயலற்ற	Nan
trũng	மூழ்கியது	Nan
trĩ	மூல நோய்	Nan
trăng	நிலா	None
trăn	பைதான்	Nan
trăm	நூறு	None
trúc	மூங்கில்	None
trú	போர்டிங்	Nan
trùy	ட்ரூய்	Nan
trùng	ஒத்துப்போகிறது	Nan
trùm	முதலாளி	Nan
trôi	சறுக்கல்	Nan
trướng	விரிவாக்கம்	None
tràng	பெருங்குடல்	None
trà	தேநீர்	None
trinidad	டிரினிடாட்	Nan
trinh	கன்னி	None
tribune	ட்ரிப்யூன்	Nan
tri	tri	Nan
treo	செயலிழக்க	Nan
tre	மூங்கில்	None
trau	trau	Nan
trao	ஒப்படைத்தார்	Nan
tranh	படங்கள்	Nan
trang	பக்கம்	None
trai	மஸ்ஸல்ஸ்	Nan
trafford	டிராஃபோர்ட்	Nan
trafalgar	trafalgar	Nan
tqlc	tqlc	Nan
tpvĩnh	நகரம்	Nan
tphồ	நகரம்	Nan
tphcm	tphcm	Nan
tp	tp	Nan
toả	கதிர்வீச்சு	None
trinity	திரித்துவம்	Nan
tràm	cajuput	Nan
tristan	டிரிஸ்தான்	Nan
triền	ட்ரைன்	Nan
truỵ	பொய்	Nan
truởng	தலைமை	None
truất	எதிர்ப்பாளர்கள்	Nan
truân	truân	Nan
truyện	கதை	None
truyên	ட்ரூயென்	Nan
truong	truong	Nan
trungnhật	நேர்மை	Nan
trung	நடுத்தர	None
truman	ட்ரூமன்	Nan
true	உண்மை	None
trong	இல்	None
trondheim	ட்ரோண்ட்ஹெய்ம்	Nan
troia	ட்ரோயா	Nan
tro	சாம்பல்	Nan
triệu	மில்லியன்	None
triệt	முழுமையாக	None
triện	முத்திரை	None
triều	அலை	None
triết	தத்துவம்	None
trườn	வலம்	None
trường	பள்ளி	None
trượng	காடுசியஸ்	Nan
tutsi	துட்ஸி	Nan
tuscan	டஸ்கன்	Nan
tupolev	tupolev	Nan
tung	டாஸ்	None
tum	டம்	Nan
tulip	துலிப்	Nan
tukhachevsky	tukhachevsky	Nan
tudor	டியூடர்	Nan
tucker	டக்கர்	Nan
tua	கூடாரம்	Nan
tt	tt	Nan
ts	ts	Nan
trực	கடமையில்	Nan
trữ	சேமிப்பு	None
trừu	ஆடுகள்	Nan
trừng	கண்ணை கூசும்	Nan
trừ	கழித்தல்	None
trứng	முட்டை	None
trứ	ட்ரூ	Nan
tuvalu	tuvalu	Nan
trụi	நிர்வாணமாக	Nan
tuy	எனினும்	None
tuyết	பனி	None
ty	ty	Nan
twitter	ட்விட்டர்	None
twin	இரட்டை	None
tvb	தொலைக்காட்சி	None
tv	தொலைக்காட்சி	None
tuỳ	விரும்பினால்	None
tuột	நழுவ	Nan
tuộc	ஆக்டோபஸ்	Nan
tuổi	ஒரு வயது	Nan
tuốc	பறித்தல்	Nan
tuệ	ஞானம்	None
tuế	minnows	Nan
tuần	வாரம்	None
tuý	துயோ	Nan
tuông	பறிப்பு	Nan
tuân	கீழ்ப்படியுங்கள்	Nan
tuyệt	நன்று	None
tuyển	ஆட்சேர்ப்பு	Nan
tuyền	tuyen	Nan
tuyên	அறிவிக்கவும்	Nan
trục	அச்சு	None
trụ	அலுவலகம்	None
trợ	ஆதரவு	None
trận	போட்டி	Nan
trẫm	நான்	None
trẩy	பவுன்ஸ்	Nan
trầy	கீறப்பட்டது	Nan
trầu	வெற்றிலை	Nan
trần	வெற்று	Nan
trầm	ஆழமான	Nan
trấu	உமி	Nan
trấn	நகரம்	Nan
trảo	machetes	Nan
trảm	cajuput	Nan
trải	கவர்	Nan
trả	செலுத்த	None
trạo	தாவோ	Nan
trạng	நிலை	None
trạm	நிலையம்	None
trại	முகாம்	Nan
trạch	ட்ராச்	Nan
trượt	சரிய	Nan
trật	இடமாற்றம் செய்யப்பட்டது	Nan
trắc	பயோமெட்ரிக்ஸ்	Nan
trắng	வெள்ளை	None
trặc	விக்கல்	Nan
trời	இறைவன்	None
trớn	caress	Nan
trộm	திருடர்கள்	Nan
trội	ஆதிக்கம் செலுத்தும்	Nan
trỗi	தோற்றம்	Nan
trổ	காட்டு	None
trồng	வளர	None
trồi	வளர்ந்து வருகிறது	Nan
trống	காலியாக	Nan
typhon	சூறாவளி	None
trốn	மறை	None
trỏ	சுட்டிகள்	None
trọng	முக்கியமான	None
trọn	முழு	None
trọ	சத்திரம்	Nan
trịnh	ஜிக்ஜாக்	Nan
trị	சிகிச்சை	None
trệ	தேங்கி நிற்கும்	Nan
trễ	தாமதமாக	Nan
trẻ	இளம்	None
trối	இறுதி	None
−−	−−	Nan
mũ	தொப்பி	Nan
măng	மூங்கில் தண்டுகள்	Nan
cụm	கொத்து	Nan
cục	துறை	None
cợt	நகைச்சுவை	Nan
cỡ	அளவு	None
cờ	கொடி	None
cớ	சாக்குப்போக்கு	Nan
cột	நெடுவரிசை	Nan
cộng	பிளஸ்	Nan
cội	பழையது	Nan
cộ	வாகனம்	None
cỗi	பிடிவாதமான	Nan
cỗ	டெக்	Nan
cổng	வாயில்	None
cồng	காங்	Nan
cồn	ஆல்கஹால்	Nan
cống	வடிகால்	None
cốm	நகட்	Nan
cối	மோட்டார்	None
cốc	கோப்பை	Nan
cụp	வெட்டப்பட்டது	Nan
cố	முயற்சி	None
cụt	வெட்டப்பட்டது	Nan
của	இன்	None
daegu	daegu	Nan
da	தோல்	None
d	d	Nan
cựu	முன்னாள்	None
cực	துருவ	None
cựa	ஸ்பர்ஸ்	Nan
cự	தூரம்	None
cữu	அலங்கார பெட்டி	Nan
cữ	கு	Nan
cửu	பெருக்க	Nan
cửa	கதவு	None
cừu	ஆட்டுக்குட்டி	Nan
cừ	துருவங்கள்	Nan
cứngi	ஹார்டி	Nan
cứng	கடினமானது	Nan
cức	கூ	Nan
cứ	ஆன்	None
củng	மேலும்	None
củi	விறகு	Nan
củ	கிழங்குகளும்	Nan
dahl	dahl	Nan
cỏ	புல்	None
cọc	குவியல்	Nan
cảnh	காட்சி	Nan
cảng	போர்ட்	None
cản	பாதிக்கப்பட்டுள்ளது	Nan
cảm	குளிர்	Nan
cải	கடுகு	Nan
cả	இரண்டும்	None
cạp	தேள்	Nan
cạo	ஷேவ் செய்யுங்கள்	Nan
cạnh	விளிம்பு	Nan
cạn	மேலோட்டமான	Nan
cạc	அட்டை	None
cưỡng	கட்டாயப்படுத்தப்பட்டது	Nan
cưỡi	சவாரி	Nan
cường	வலுவான	None
cười	சிரிக்கவும்	Nan
cướp	கொள்ளை	None
cưới	திருமணமானவர்	Nan
cước	சரக்கு	None
cưng	என் அன்பே	Nan
cảo	இழுக்கிறது	Nan
cọp	புலி	None
cấm	தடை	None
cấp	மானியம்	Nan
cọ	தேய்க்கவும்	Nan
cặp	பை	None
cằn	எரிச்சலான	Nan
cằm	கன்னம்	Nan
cắt	வெட்டு	None
cắp	திருட	Nan
cắn	கடி	None
cắm	சொருகு	Nan
cậy	சார்ந்தது	None
cậu	சிறுவன்	None
cập	எதிர்	None
cận	அணுகுமுறை	None
cẩu	கிரேன்	Nan
cẩn	கவனமாக இரு	Nan
cầy	civet	Nan
cầu	பாலம்	None
cần	தேவை	None
cầm	பிடி	None
cất	காய்ச்சி வடிகட்டிய	Nan
cấn	தேவை	None
cưa	பார்த்தேன்	Nan
dai	கடுமையான	None
dakota	டகோட்டா	Nan
dm	dm	Nan
djokovic	ஜோகோவிச்	Nan
djibouti	djibouti	Nan
diệu	மந்திரம்	Nan
diệt	கொல்ல	None
diện	முகம்	None
diệm	டைம்	Nan
diệc	ஹெரான்	Nan
diễu	அணிவகுப்பு	Nan
diễm	டைம்	Nan
diểu	கேலிக்கூத்து	Nan
diều	காத்தாடி	Nan
diềm	மாறுபாடுகள்	None
diên	பைத்தியம்	Nan
diêm	போட்டிகளில்	Nan
divoire	divoire	Nan
division	பிரிவு	None
disneyland	டிஸ்னிலேண்ட்	Nan
discussion	கலந்துரையாடல்	Nan
dmitri	dmitri	Nan
discovery	கண்டுபிடிப்பு	None
dna	dna	Nan
doanh	கூட்டு	None
driver	இயக்கி	None
drake	டிரேக்	Nan
draft	வரைவு	None
dracula	டிராகுலா	Nan
dp	dp	Nan
doạ	அச்சுறுத்தும்	Nan
doãn	டோன்	Nan
doyle	doyle	Nan
dover	டோவர்	Nan
douglas	டக்ளஸ்	Nan
dougherty	dougherty	Nan
dortmund	டார்ட்மண்ட்	Nan
donau	donau	Nan
don	தாதா	Nan
dominican	டொமினிகன்	Nan
dome	குவிமாடம்	None
dolly	டோலி	Nan
docherty	docherty	Nan
doc	ஆவணம்	None
do	வழங்கியவர்	Nan
daily	தினசரி	None
dionysus	dionysus	Nan
dimaggio	dimaggio	Nan
dbsk	dbsk	Nan
davis	டேவிஸ்	None
davies	டேவிஸ்	None
david	டேவிட்	Nan
dave	டேவ்	Nan
dau	எண்ணெய்	None
date	தேதி	None
dassault	dassault	Nan
das	தாஸ்	Nan
darwin	டார்வின்	None
dao	கத்தி	Nan
dante	dante	Nan
daniel	டேனியல்	None
danh	பெயர்	None
danger	ஆபத்து	None
dancing	நடனம்	None
dan	டான்	None
dampier	dampier	Nan
dalat	டா லாட்	Nan
dc	dc	Nan
dinh	அரண்மனை	None
ddr	ddr	Nan
degree	பட்டம்	None
dien	பைத்தியம்	Nan
diego	டியாகோ	Nan
die	இறக்க	None
diana	டயானா	Nan
di	di	Nan
dewitt	dewitt	Nan
dewan	திவான்	Nan
deutschland	deutschland	Nan
deuterium	டியூட்டீரியம்	Nan
design	thiết kế	Nan
descartes	descartes	Nan
des	des	Nan
derek	டெரெக்	Nan
department	துறை	None
dennis	டென்னிஸ்	None
den	டென்	Nan
demeter	டிமீட்டர்	Nan
delphi	டெல்பி	Nan
delhi	டெல்ஹி	Nan
dean	டீன்	Nan
cư	மக்கள் தொகை	Nan
cơm	அரிசி	None
cũng	அத்துடன்	None
coleen	கோலீன்	Nan
coi	வாட்ச்	Nan
cohen	கோஹன்	Nan
coffea	காஃபி	Nan
coen	coen	Nan
cocoa	கோகோ	Nan
coburn	கோபர்ன்	Nan
co	இணை	None
cnxh	cnxh	Nan
cntt	cntt	Nan
cntb	cntb	Nan
cnet	cnet	Nan
cn	சி.என்	Nan
cmt	செ.மீ.	Nan
cmc	cmc	Nan
clyde	க்ளைட்	Nan
clow	க்ளோ	Nan
clo	குளோரின்	Nan
clips	கிளிப்புகள்	Nan
coleman	கோல்மேன்	Nan
clip	கிளிப்	Nan
coli	கோலி	Nan
colleen	சக	None
conservation	பாதுகாப்பு	None
conrad	கான்ராட்	Nan
connecticut	கனெக்டிகட்	Nan
congress	காங்கிரஸ்	None
congo	காங்கோ	None
cong	வளைந்த	Nan
condom	ஆணுறை	None
concorde	concorde	Nan
concerto	இசை நிகழ்ச்சி	Nan
concacaf	concacaf	Nan
common	பொதுவானது	Nan
comic	காமிக்	None
columbus	கொலம்பஸ்	None
colorado	கொலராடோ	None
colombo	கொழும்பு	None
colombia	கொலம்பியா	None
collège	collège	Nan
collins	கோலின்ஸ்	Nan
college	கல்லூரி	None
colin	கொலின்	Nan
constantine	மாறிலி	None
clinton	கிளின்டன்	Nan
claude	கிளாட்	Nan
chục	டஜன்	Nan
chợt	திடீரென்று	Nan
chợ	சந்தை	None
chở	சுமந்து	None
chờ	காத்திரு	Nan
chớp	மின்னல்	Nan
chớ	வேண்டாம்	None
chội	மலம்	None
chỗ	இடம்	None
chồng	கணவர்	None
chồn	நரி	Nan
chồi	தளிர்கள்	Nan
chốt	தாழ்ப்பாளை	Nan
chống	எதிர்ப்பு	None
chốn	இடம்	None
chối	மறுக்க	Nan
chốc	கணம்	Nan
chỏ	முழங்கை	Nan
chọn	தேர்வு செய்யவும்	Nan
chụp	படமெடு	Nan
claudius	கிளாடியஸ்	Nan
chủ	குரு	None
chứ	மாறாக	None
clark	கிளார்க்	Nan
clara	கிளாரா	Nan
cities	நகரங்கள்	None
circus	சர்க்கஸ்	Nan
cip	சிப்	Nan
cinderella	சிண்ட்ரெல்லா	Nan
cincinnati	cincinnati	Nan
cia	சியா	None
chững	சமன் செய்தல்	Nan
chữa	குணப்படுத்த	Nan
chữ	சொல்	Nan
chửi	சபித்தல்	Nan
chửa	கர்ப்பிணி	Nan
chử	சொல்	Nan
chừng	சில	None
chừa	வெளியேறுதல்	Nan
chừ	கடிதம்	None
chức	செயல்பாடு	None
chứa	கொண்டிருக்கும்	None
chủng	விகாரங்கள்	Nan
contemporary	சமகால	None
cooper	கூப்பர்	Nan
copenhagen	copenhagen	Nan
có	வேண்டும்	None
còn	இன்னும்	None
cò	தூண்டுதல்	Nan
cãi	வாதிடுங்கள்	Nan
câu	வாக்கியம்	None
cân	செதில்கள்	Nan
câm	ஊமை	Nan
cáy	ஃபிட்லர்	Nan
cáp	கேபிள்	None
cáopx|bình	கருத்து	None
cáo	நரி	Nan
cánh	சாரி	None
cán	உருட்டப்பட்டது	Nan
cái	தி	None
cách	வழி	Nan
các	தி	None
cày	உழுதல்	Nan
cào	கீறல்	Nan
cành	கிளை	None
cói	sedge	Nan
càng	மேலும்	None
cót	கட்டில்	Nan
côi	அனாதை	Nan
cũi	எடுக்காதே	Nan
cũ	பழையது	Nan
căng	நீட்சி	Nan
căn	தீவிரமான	None
căm	சொருகப்பட்டுள்ளது	Nan
cút	வெளியே போ	Nan
cúp	கோப்பை	Nan
cúng	வசதியான	None
cúm	காய்ச்சல்	None
cúi	வில்	None
cú	ஆந்தை	Nan
cùng	மற்றும்	None
cùi	தொழுநோயாளிகள்	Nan
cù	கூச்சம்	Nan
cõng	பிக்கிபேக்	Nan
cõi	பகுதிகள்	None
côngtenơ	கொள்கலன்	Nan
công	வேலை	None
côn	taper	Nan
cô	செல்வி	Nan
càn	தேவை	None
cài	நிறுவு	Nan
cà	கொட்டைவடி நீர்	Nan
cristiano	கிறிஸ்டியானோ	Nan
crisis	நெருக்கடி	None
crimson	கிரிம்சன்	Nan
crew	குழுவினர்	Nan
crest	முகடு	Nan
crespo	crespo	Nan
crazy	பைத்தியம்	Nan
craig	கிரேக்	Nan
cpt	cpt	Nan
cotang	cotang	Nan
costa	கோஸ்டா	Nan
cosin	cosin	Nan
cornell	கார்னெல்	Nan
core	கோர்	Nan
cordyceps	கார்டிசெப்ஸ்	Nan
copy	நகல்	Nan
coppola	கொப்போலா	Nan
copperfield	காப்பர்ஃபீல்ட்	Nan
copernic	copernic	Nan
croatia	குரோஷியா	Nan
cross	குறுக்கு	None
crs	crs	Nan
cruz	குரூஸ்	Nan
cyworld	cyworld	Nan
cyrus	சைரஸ்	Nan
cyril	சிரில்	Nan
cyber	சைபர்	Nan
cyanide	சயனைடு	Nan
cuộc	தி	None
cuồng	பைத்தியம்	Nan
cuống	தண்டு	None
cuốn	சுருள்	None
ds	ds	Nan
cuối	கடந்த	None
cuả	of	Nan
cup	கோப்பை	Nan
cunningham	கன்னிங்ஹாம்	Nan
cung	வில்	None
cullen	கல்லன்	Nan
cua	நண்டு	None
ctc	ctc	Nan
crystal	படிக	Nan
cruzeiro	குரூசிரோ	Nan
cuốc	hoes	Nan
dtd	dtd	Nan
dth	dth	Nan
du	டு	None
food	உணவு	None
fokker	fokker	Nan
foden	foden	Nan
focus	கவனம்	None
foch	foch	Nan
flight	விமானம்	None
fleming	பிளேமிங்	Nan
flanker	flanker	Nan
fitzgerald	fitzgerald	Nan
fishbed	மீன் படுக்கை	Nan
fish	மீன்	Nan
fischer	பிஷ்ஷர்	Nan
firefox	பயர்பாக்ஸ்	None
finish	பூச்சு	Nan
fiji	ஃபிஜி	Nan
figo	figo	Nan
fifpro	ஃபிஃப்ரோ	Nan
fifa	ஃபிஃபா	Nan
field	புலம்	None
football	கால்பந்து	None
fidel	பிடல்	Nan
forbes	ஃபோர்ப்ஸ்	Nan
fordham	fordham	Nan
fujiko	fujiko	Nan
fu	ஃபூ	Nan
friedman	ப்ரைட்மேன்	Nan
freud	பிராய்ட்	Nan
franz	ஃப்ரான்ஸ்	Nan
franklin	பிராங்க்ளின்	Nan
frankfurt	பிராங்க்ஃபர்ட்	Nan
frank	வெளிப்படையான	None
franco	பிராங்கோ	Nan
francisco	பிரான்சிஸ்கோ	None
francis	பிரான்சிஸ்	None
frances	பிரான்சிஸ்	None
france	பிரான்ஸ்	None
franc	பிராங்க்	None
fracsin	fracsin	Nan
fpt	fpt	Nan
fox	நரி	Nan
foundation	அடித்தளம்	Nan
forks	முட்கரண்டி	Nan
ford	ஃபோர்ட்	Nan
fujimoto	புஜிமோடோ	Nan
fiat	ஃபியட்	Nan
fernando	பெர்னாண்டோ	Nan
every	ஒவ்வொன்றும்	None
everton	everton	Nan
eva	ஈவா	Nan
european	ஐரோப்பிய	Nan
europe	யூரோப்	Nan
eurofighter	யூரோஃபைட்டர்	Nan
euro	யூரோ	None
euler	euler	Nan
eugène	eugène	Nan
eugene	யூஜின்	Nan
euclid	யூக்லிட்	Nan
ethiopia	எத்தியோப்பியா	Nan
ethernet	ஈத்தர்நெட்	Nan
essential	அவசியம்	None
españa	españa	Nan
erwin	erwin	Nan
eros	ஈரோஸ்	Nan
ernest	ernest	Nan
eritrea	எரித்திரியா	Nan
exgay	exgay	Nan
ferrari	ஃபெராரி	Nan
explorer	ஆய்வுப்பணி	Nan
fabio	ஃபேபியோ	Nan
ferguson	ஃபெர்குசன்	Nan
ferdinand	ஃபெர்டினாண்ட்	Nan
ferb	ஃபெர்ப்	Nan
felix	ஃபெலிக்ஸ்	Nan
felis	ஃபெலிஸ்	Nan
felipe	ஃபெலிப்	Nan
feet	அடி	None
federer	கூட்டாளர்	Nan
features	அம்சங்கள்	Nan
fdi	அன்னிய நேரடி முதலீடு	Nan
fca	fca	Nan
fbi	fbi	Nan
faso	faso	Nan
farrell	farrell	Nan
fao	fao	Nan
faifo	faifo	Nan
facto	உண்மையில்	None
fact	உண்மை	None
facebook	முகநூல்	Nan
extensive	விரிவான	None
fukuoka	fukuoka	Nan
funimation	வேடிக்கை	Nan
funk	ஃபங்க்	Nan
gifu	gifu	Nan
gieo	விதைக்க	Nan
gichin	கிச்சின்	Nan
gibraltar	ஜிப்ரால்டர்	Nan
giang	ஜியாங்	Nan
gian	இடம்	None
giam	சிறையில்	None
giai	நிலை	None
gia	கியா	Nan
ghềnh	ரேபிட்கள்	Nan
ghề	ரேபிட்கள்	Nan
ghế	நாற்காலி	Nan
ghẻ	சிரங்கு	Nan
ghì	ghì	Nan
ghê	திகில்	Nan
ghép	ஒட்டு	None
ghé	நிறுத்து	Nan
ghim	முள்	Nan
ghi	எழுத	None
ginzan	ஜின்ஜான்	Nan
ghen	பொறாமை	Nan
gio	ஜியோ	Nan
giuliani	கியுலியானி	Nan
giêsu	கிறிஸ்தவ சமயத்தை தோற்றுவித்தவர்	Nan
giêng	ஜியோங்	Nan
giêhôva	கிவா	Nan
gièm	எதிர்ப்பாளர்கள்	Nan
giãn	நீட்சி	Nan
giã	துடிக்கிறது	Nan
giây	விநாடிகள்	Nan
gián	கரப்பான் பூச்சிகள்	Nan
giám	இயக்குனர்	None
giá	விலை	None
giày	காலணிகள்	Nan
giàu	பணக்கார	None
giành	ஆவலுடன்	Nan
giàn	டிரஸ்	Nan
già	பழையது	Nan
giza	கிசா	Nan
giuộc	கியோக்	Nan
giuse	கியூஸ்	Nan
giun	புழுக்கள்	None
gioi	ஜியோய்	Nan
ghe	படகு	None
ghana	கானா	Nan
gerrard	ஜெரார்ட்	Nan
gao	அரிசி	None
ganh	பொறாமை	Nan
gang	கும்பல்	Nan
gandhi	காந்தி	None
gan	கல்லீரல்	None
gamow	காமோ	Nan
gambia	காம்பியா	Nan
gam	கிராம்	Nan
galileo	கலிலியோ	Nan
galilei	கலிலீ	Nan
gaillard	கெயிலார்ட்	Nan
gaia	கியா	Nan
gagarin	காகரின்	Nan
gabriella	கேப்ரியெல்லா	Nan
gabriel	கேப்ரியல்	Nan
gabon	காபோன்	Nan
ga	ga	Nan
fx	fx	Nan
futsal	futsal	Nan
gareth	கரேத்	Nan
garrett	காரெட்	Nan
gary	கேரி	Nan
gascon	கேஸ்கான்	Nan
germany	ஜெர்மனி	None
german	ஜெர்மன்	None
gerhard	ஜெர்ஹார்ட்	Nan
gerais	gerais	Nan
ger	ஜெர்	Nan
gepard	gepard	Nan
georges	ஜார்ஜ்கள்	Nan
george	ஜார்ஜ்	None
georg	ஜார்ஜ்	None
eris	eris	Nan
genesis	தோற்றம்	Nan
gen	மரபணுக்கள்	None
geisha	கெய்ஷா	Nan
gdp	gdp	Nan
gdańsk	gdańsk	Nan
gaza	காசா	Nan
gay	கே	None
gaulois	gaulois	Nan
gaule	க au ல்	Nan
gatt	gatt	Nan
gene	மரபணு	None
chọi	சண்டை	None
erik	erik	Nan
ep	ep	Nan
dường	தெரிகிறது	None
dương	நேர்மறை	None
dưng	நிறுத்து	Nan
dưa	முலாம்பழம்களும்	Nan
dư	மீதமுள்ள	None
dơi	வெளவால்கள்	Nan
dơ	அழுக்கு	Nan
dũng	வீரம்	Nan
dĩa	தட்டு	None
dĩ	நிச்சயமாக	Nan
dăm	சவரன்	Nan
dùng	பயன்பாடு	None
dùi	பஞ்சர்	Nan
dù	என்றாலும்	None
dõi	டிராக்	Nan
dông	இடியுடன் கூடிய மழை	Nan
dó	அந்த	None
dòng	தற்போதைய	None
dòm	பாருங்கள்	None
dưỡng	நர்சிங்	Nan
dò	தேடல்	None
dược	மருந்தகம்	Nan
dạ	ஆம்	None
dậy	எழு	Nan
dậu	சேவல்	Nan
dận	அத்தை	Nan
dẫu	என்றாலும்	None
dẫn	வழிகாட்டி	None
dẫm	ஸ்டாம்ப்	Nan
dầu	எண்ணெய்	None
dần	படிப்படியாக	None
dấy	தூண்டுகிறது	None
dấu	அடையாளம்	None
dấp	தடுமாறும்	Nan
dấm	வினிகர்	Nan
dải	ஆடை அவிழ்ப்பு	Nan
dạy	கற்பித்தல்	Nan
dạt	கழுவப்பட்டது	Nan
dạo	உலா	Nan
dạng	வடிவம்	None
dạn	அச்சமற்ற	Nan
dại	முட்டாள்	Nan
dượng	மாமா	None
dắt	வழி நடத்து	Nan
dính	ஒட்டும்	Nan
dì	அத்தை	Nan
dà	டா	None
dwight	டுவைட்	Nan
duỗi	நேராக்கு	Nan
duệ	சந்ததியினர்	Nan
duật	டுவாட்	Nan
duẩn	duan	Nan
duơng	duong	Nan
duyệt	உலாவி	Nan
duyện	ஆர்வலர்	Nan
duyên	முன்னரே தீர்மானிக்கப்பட்டவை	Nan
duy	மட்டும்	None
dursley	டர்ஸ்லி	Nan
durham	டர்ஹாம்	Nan
dung	சாணம்	Nan
dumbledore	டம்பில்டோர்	Nan
dumas	டுமாஸ்	Nan
duk	duk	Nan
duiker	duiker	Nan
dubai	துபாய்	None
dài	நீண்டது	Nan
dìu	dìu	Nan
dàn	அரங்கு	None
dành	செலவிட்டார்	Nan
dê	வெள்ளாடு	Nan
dép	செருப்பு	Nan
défense	பாதுகாப்பு	None
dè	கவனமாக இரு	Nan
dãy	சரகம்	Nan
dãn	விரி	Nan
dãi	அனுமதி	None
dã	காட்டு	None
dây	தண்டு	None
dâng	சலுகை	Nan
dân	மக்கள்	None
dâm	மோசமான	None
dát	பொறிக்கப்பட்டுள்ளது	Nan
dáng	வடிவம்	None
dán	ஒட்டவும்	Nan
dám	தைரியம்	Nan
dái	சிறுநீர் கழித்தல்	Nan
dày	அடர்த்தியான	None
dào	ஏராளமாக	None
dàng	சுலபம்	Nan
dằn	நிலைப்படுத்தும்	Nan
dằng	தொடர்ந்து	None
dẳng	தொடர்ந்து	None
elbe	elbe	Nan
ekaterina	ekaterina	Nan
eisenhower	ஐசனோவர்	Nan
einstein	ஐன்ஸ்டீன்	None
eiffel	ஈபிள்	Nan
eid	eid	Nan
egypt	எகிப்து	None
efron	efron	Nan
eea	eea	Nan
edwin	எட்வின்	Nan
edward	எட்வர்ட்	Nan
edo	எடோ	Nan
edmond	எட்மண்ட்	Nan
editor	ஆசிரியர்	None
edison	எடிசன்	None
edinburgh	எடின்பர்க்	Nan
edge	விளிம்பு	Nan
edgar	எட்கர்	Nan
edda	எட்டா	Nan
electronic	மின்னணு	None
ecw	ecw	Nan
eliane	எலியன்	Nan
elizabeth	எலிசபெத்	None
eo	இடுப்பு	Nan
enzym	நொதி	None
entropy	என்ட்ரோபி	Nan
entente	entente	Nan
eniac	eniac	Nan
england	இங்கிலாந்து	None
engels	engels	Nan
energy	ஆற்றல்	None
en	en	Nan
emmy	எம்மி	Nan
emir	அமீர்	Nan
emily	எமிலி	Nan
email	மின்னஞ்சல்	None
em	நீங்கள்	None
elíp	நீள்வட்டம்	Nan
elvis	எல்விஸ்	Nan
elton	எல்டன்	Nan
ellis	நீள்வட்டம்	Nan
ellen	எல்லன்	Nan
elip	நீள்வட்டம்	Nan
ecmascript	எக்மாஸ்கிரிப்ட்	Nan
ebro	ஈப்ரோ	Nan
eaton	ஈட்டன்	Nan
dỏm	அறிவாற்ற்ல்	Nan
dọc	செங்குத்து	None
dọa	அச்சுறுத்தும்	Nan
dịu	மெல்லோ	Nan
dịp	விழாவில்	None
dịch	மொழிபெயர்	Nan
dị	ஒருமைப்பாடு	Nan
dệt	நெசவு	Nan
dễ	சுலபம்	Nan
dể	சுலபம்	Nan
dền	அமராந்த்	Nan
dế	கிரிக்கெட்டுகள்	Nan
dẻo	பிளாஸ்டிசிட்டி	Nan
dẻ	கஷ்கொட்டை	Nan
dẹt	தட்டையானது	Nan
dẹp	பிளாட் அவுட்	Nan
dặt	ஆர்டர்	Nan
dặn	உத்தரவிட்டது	Nan
dặm	மைல்	None
dốc	சாய்வு	None
dối	பொய்	Nan
dốt	அறியாமை	Nan
dồi	ஏராளமாக	None
earles	காதுகள்	Nan
ea	ea	Nan
e	e	Nan
dỹ	dỹ	Nan
dực	ஆண்	None
dựa	அடிப்படையிலானது	Nan
dự	திட்டமிடப்பட்டுள்ளது	Nan
dữ	தகவல்கள்	None
dừng	நிறுத்து	Nan
erich	எரிச்	Nan
dừa	தேங்காய்	Nan
dứa	அன்னாசி	Nan
dụng	பயன்பாடு	None
dục	செக்ஸ்	Nan
dụ	உதாரணத்திற்கு	None
dỡ	இறக்குதல்	Nan
dở	மோசமான	None
dời	நகர்வு	Nan
dỗ	coax	Nan
dồn	மூலையில்	None
dứt	நிறுத்து	Nan
giêxu	நெக்ஸஸ்	Nan
chọc	குத்த	Nan
chịt	தனம்	Nan
bermuda	பெர்முடா	None
berman	பெர்மன்	Nan
berkeley	பெர்க்லி	Nan
bering	bering	Nan
berger	பெர்கர்	Nan
bergen	பெர்கன்	Nan
berber	berber	Nan
bennington	பென்னிங்டன்	Nan
benjamin	பெஞ்சமின்	Nan
benito	பெனிட்டோ	Nan
benfica	பென்ஃபிகா	Nan
benetton	பெனட்டன்	Nan
benedict	பெனடிக்ட்	Nan
bellatrix	பெல்லாட்ரிக்ஸ்	Nan
bella	பெல்லா	Nan
bell	மணி	None
bel	பெல்	None
beijing	பெய்ஜிங்	Nan
behind	பின்னால்	None
bernard	பெர்னார்ட்	Nan
beginbmatrix	startbmatrix	Nan
bertrand	பெர்ட்ராண்ட்	Nan
betty	பெட்டி	None
biện	மன்னிப்பு கேளுங்கள்	Nan
biểuthứcđiềukiện	நிலைமைகளை அறிந்து கொள்ளுங்கள்	Nan
biển	கடல்	None
biều	bieu	Nan
biếu	அஞ்சலி செலுத்துங்கள்	Nan
biếng	சோம்பேறி	Nan
biến	அவுட்	Nan
biếm	கவனக்குறைவு	Nan
biếc	டீல்	Nan
biên	பதிவு	Nan
bitmap	பிட்மேப்	Nan
bismarck	பிஸ்மார்க்	Nan
billy	பில்லி	Nan
bill	ர சி து	Nan
bikini	பிகினி	Nan
bic	bic	Nan
biang	biang	Nan
bia	பீர்	Nan
bhutan	பூட்டான்	None
better	சிறந்தது	None
biệt	தனித்துவமானது	Nan
beethovens	பீத்தோவன்ஸ்	Nan
bedloe	பெட்லோ	Nan
baryon	baryon	Nan
bartholdi	பார்தோல்டி	Nan
barrichello	பாரிச்செல்லோ	Nan
barquin	பார்க்வின்	Nan
baroque	பரோக்	Nan
barone	பரோன்	Nan
barnes	களஞ்சியங்கள்	Nan
barca	பார்கா	Nan
barbary	காட்டுமிராண்டி	Nan
barbara	பார்பரா	Nan
barbados	பார்படோஸ்	Nan
barak	பராக்	Nan
barack	பராக்	Nan
bao	கோணி	Nan
bantu	து தடை	Nan
bantam	பாண்டம்	Nan
banner	பதாகை	Nan
banh	பந்து	None
bang	இடி	Nan
barça	பார்சியா	Nan
beethoven	பீத்தோவன்	Nan
base	அடித்தளம்	Nan
basil	துளசி	None
beckham	பெக்காம்	Nan
becker	பெக்கர்	Nan
beckenbauer	beckenbauer	Nan
beauty	அழகு	None
beatles	பீட்டில்ஸ்	Nan
beat	அடி	None
bchtư	bchtư	Nan
bc	பி.சி.	Nan
bbc	பிபிசி	None
bb	பிபி	Nan
bazơ	அடிப்படை	None
bazan	பசால்ட்	Nan
bayern	பேயர்ன்	Nan
bay	ஈ	None
bauer	பாயர்	Nan
battambang	பட்டம்பாங்	Nan
bator	bator	Nan
bass	பாஸ்	None
baskervilles	baskervilles	Nan
basel	பேசல்	Nan
ban	தடை	None
bkavpro	bkavpro	Nan
blair	பிளேயர்	Nan
buonaparte	buonaparte	Nan
bungo	bungo	Nan
bungary	பங்களரி	Nan
bulletin	புல்லட்டின்	Nan
bulgaria	பல்கேரியா	Nan
budapest	புடாபெஸ்ட்	Nan
bubalis	புபலிஸ்	Nan
btr	btr	Nan
brussels	பிரஸ்ஸல்ஸ்	Nan
brusilov	புருசிலோவ்	Nan
bruno	புருனோ	Nan
brunei	புருனே	Nan
bruce	காயங்கள்	Nan
browning	பிரவுனிங்	Nan
browne	பிரவுன்	Nan
brown	பழுப்பு	Nan
brot	brot	Nan
brooklyn	ப்ரூக்ளின்	Nan
britney	பிரிட்னி	Nan
burke	பர்க்	Nan
britannic	பிரிட்டானிக்	Nan
burkina	புர்கினா	Nan
burundi	புருண்டி	Nan
bào	திட்டமிடல்	None
bành	பெங்	Nan
bàng	கழுகு	None
bàn	மேசை	Nan
bài	இடுகைகள்	Nan
bà	பாட்டி	Nan
byzantine	பைசாண்டின்	Nan
buổi	அமர்வு	Nan
buồng	அறை	None
buồn	சோகம்	Nan
buồm	பயணம்	Nan
buốt	முனைப்புடன்	Nan
buýt	பேருந்து	None
buông	விட்டுவிடு	Nan
buôn	மொத்த	None
bushy	புதர்	Nan
bush	புஷ்	None
busby	பஸ்பி	Nan
busan	புசன்	Nan
burma	பர்மா	None
blackwell	பிளாக்வெல்	Nan
bridge	பாலம்	None
brezhnev	brezhnev	Nan
boong	டெக்	Nan
boom	ஏற்றம்	Nan
boolean	பூலியன்	Nan
bool	bool	Nan
bonobo	போனோபோ	Nan
bonnal	பொன்னல்	Nan
bong	போங்	Nan
bonaparte	போனபார்ட்	Nan
bom	குண்டு	None
boltzmann	boltzmann	Nan
bolivia	பொலிவியா	Nan
bohemia	போஹேமியா	Nan
boeing	போயிங்	Nan
bobby	பாபி	Nan
bob	பாப்	None
bo	போ	None
blues	ப்ளூஸ்	None
blanc	வெற்று	Nan
blaise	பிளேஸ்	Nan
boongke	பதுங்கு குழிகள்	Nan
brian	பிரையன்	Nan
bop	பாப்	None
borland	போர்லாந்து	Nan
bretton	பிரெட்டன்	Nan
breton	பிரெட்டன்	Nan
brestlitovsk	brestlitovsk	Nan
bremen	ப்ரெமன்	Nan
brazil	பிரேசில்	None
braun	மூளை	None
brandt	பிராண்ட்	Nan
brandenburg	பிராண்டன்பர்க்	Nan
brain	மூளை	None
boxing	குத்துச்சண்டை	Nan
bourbon	போர்பன்	Nan
boulder	கற்பாறை	Nan
bottom	கீழே	None
botswana	போட்ஸ்வானா	Nan
bosnia	போஸ்னியா	Nan
bosna	போஸ்னா	Nan
boseeinstein	போசீன்ஸ்டீன்	Nan
bose	போஸ்	None
borussia	போருசியா	Nan
boris	போரிஸ்	Nan
bamar	bamar	Nan
ballard	பாலார்ட்	Nan
balkans	பால்கன்	Nan
alois	அலோயிஸ்	Nan
allmusic	allmusic	Nan
allen	ஆலன்	Nan
allan	ஆலன்	Nan
alice	ஆலிஸ்	Nan
ali	அலி	None
algérie	algérie	Nan
alfred	ஆல்ஃபிரட்	Nan
alexey	அலெக்ஸி	Nan
alexandros	அலெக்ஸாண்ட்ரோஸ்	Nan
alexandria	அலெக்ஸாண்ட்ரியா	Nan
alexandra	அலெக்ஸாண்ட்ரா	Nan
alexa	அலெக்சா	Nan
albus	அல்பஸ்	Nan
albuquerque	அல்புகர்கி	Nan
albion	அல்பியன்	Nan
alberto	ஆல்பர்டோ	Nan
albert	ஆல்பர்ட்	None
albatros	அல்பட்ரோஸ்	Nan
alonso	அலோன்சோ	Nan
albania	அல்பேனியா	Nan
alpher	ஆல்பர்	Nan
altai	altai	Nan
andes	andes	Nan
anderson	ஆண்டர்சன்	Nan
andaman	andaman	Nan
andalusia	andalusia	Nan
anatolia	அனடோலியா	Nan
anata	anata	Nan
anand	ஆனந்த்	None
an	ஒரு	None
amphitrite	ஆம்பிட்ரைட்	Nan
amoniac	அம்மோனியா	Nan
amm	amm	Nan
amin	அமீன்	Nan
amiens	amiens	Nan
ami	அமி	Nan
ame	ame	Nan
amdo	amdo	Nan
amazon	அமேசான்	Nan
amaravati	அமராவதி	None
always	எப்போதும்	None
alps	ஆல்ப்ஸ்	None
andorra	andorra	Nan
alaska	அலாஸ்கா	None
al	அல்	None
adsl	adsl	Nan
adrian	அட்ரியன்	Nan
adobe	அடோப்	Nan
adn	adn	Nan
addisonwesley	addisonwesley	Nan
adams	ஆடம்ஸ்	Nan
ada	அடா	Nan
acid	அமிலம்	None
acia	acia	Nan
achilles	குதிகால்	Nan
aceh	aceh	Nan
account	கணக்கு	None
abscbn	abscbn	Nan
abrams	abrams	Nan
abraham	ஆபிரகாம்	None
about	பற்றி	None
abkhazia	abkhazia	Nan
abdul	அப்துல்	None
abc	abc	Nan
advanced	மேம்படுத்தபட்ட	Nan
alabama	அலபாமா	Nan
aedes	aedes	Nan
aero	ஏரோ	Nan
akô	வணக்கம்	None
akms	akms	Nan
akatsuki	akatsuki	Nan
ak	ak	Nan
ajax	அஜாக்ஸ்	Nan
aisne	aisne	Nan
airbus	ஏர்பஸ்	Nan
air	காற்று	None
aim	நோக்கம்	Nan
ailen	ஐரிஷ்	None
ai	who	Nan
agassi	agassi	Nan
agasa	agasa	Nan
ag	வயது	None
african	ஆப்பிரிக்க	None
africa	ஆப்பிரிக்கா	None
afghanistan	ஆப்கானிஸ்தான்	None
aff	aff	Nan
afc	afc	Nan
aegypti	aegypti	Nan
andrew	ஆண்ட்ரூ	Nan
andré	andré	Nan
andy	andy	Nan
austria	ஆஸ்ட்ரியா	Nan
australia	ஆஸ்திரேலியா	None
auguste	auguste	Nan
auflage	auflage	Nan
audition	தணிக்கை	Nan
aubrac	aubrac	Nan
aua	aua	Nan
atlantic	அட்லாண்டிக்	None
atlanta	அட்லாண்டா	Nan
atkinson	அட்கின்சன்	Nan
aston	ஆஸ்டன்	Nan
assyria	அசீரியா	Nan
association	சங்கம்	None
asoka	அசோகா	Nan
asm	asm	Nan
asia	ஆசியா	None
ashley	ஆஷ்லே	Nan
ashikaga	ashikaga	Nan
ash	சாம்பல்	Nan
austrian	ஆஸ்திரேலிய	None
asc	asc	Nan
avar	அவார்	Nan
awad	awad	Nan
balkan	பால்கன்	Nan
bali	பாலி	Nan
balearic	பலேரிக்	Nan
baháí	baháí	Nan
bahrain	பஹ்ரைன்	Nan
bahamas	பஹாமாஸ்	Nan
bago	பாகோ	Nan
baghdad	பாக்தாத்	Nan
baden	கெட்டது	Nan
bacon	பன்றி இறைச்சி	Nan
babylon	பாபிலோன்	Nan
ba	அப்பா	Nan
aztec	aztec	Nan
azerbaijan	அஜர்பைஜான்	Nan
ayutthaya	ayutthaya	Nan
ayumi	அயுமி	Nan
ayeyarwady	ayeyarwady	Nan
axit	அமிலம்	None
award	விருது	None
aviation	விமான போக்குவரத்து	Nan
arunachal	அருணாச்சல்	Nan
aruba	அருபா	Nan
artemis	ஆர்ட்டெமிஸ்	Nan
any	ஏதேனும்	None
antonov	அன்டோனோவ்	Nan
anton	அன்டன்	Nan
antigua	ஆன்டிகுவா	Nan
anthony	அந்தோணி	Nan
anorthosit	anorthosit	Nan
anne	anne	Nan
annan	annan	Nan
annam	ஒரு நாம்	Nan
anna	அண்ணா	None
ankyl	ankyl	Nan
ankara	அங்காரா	None
anhpháp	ஆங்கிலம் பிரஞ்சு	Nan
anhmỹ	பிரிட்டிஷ்	Nan
anh	சகோதரன்	Nan
anglosaxon	ஆங்கிலோசாக்சன்	Nan
angkor	angkor	Nan
ang	ang	Nan
anfield	anfield	Nan
anđêhít	ஆல்டிஹைட்	Nan
ao	குளம்	None
aotearoa	aotearoa	Nan
apollo	அப்பல்லோ	Nan
arsenal	அர்செனல்	Nan
arnold	அர்னால்ட்	Nan
armstrong	ஆம்ஸ்ட்ராங்	Nan
armenia	ஆர்மீனியன்	Nan
arlington	ஆர்லிங்டன்	Nan
arkansas	ஆர்கன்சாஸ்	Nan
ark	பேழை	Nan
arizona	அரிசோனா	Nan
aristotle	அரிஸ்டாட்டில்	None
bàu	பாவ்	Nan
aringarosa	aringarosa	Nan
argo	argo	Nan
argentina	அர்ஜெண்டினா	Nan
ares	ares	Nan
arctan	arctan	Nan
archive	காப்பகம்	Nan
archetypal	தொல்பொருள்	None
arab	அரபு	None
aquinas	அக்வினாஸ்	Nan
apple	ஆப்பிள்	None
arias	அரியாஸ்	Nan
bày	விளக்கக்காட்சி	Nan
bác	மாமா	None
bách	சைப்ரஸ்	Nan
chrysler	கிறைஸ்லர்	Nan
chrome	குரோம்	Nan
christopher	கிறிஸ்டோபர்	None
christian	கிறிஸ்துவர்	Nan
christ	கிறிஸ்து	None
chris	கிறிஸ்	Nan
choáng	திகைத்துப்போனது	Nan
choàng	கேப்	None
chosŏn	chosŏn	Nan
chopin	சோபின்	Nan
chong	சோங்	Nan
chomsky	chomsky	Nan
choi	விளையாடு	None
chnd	chnd	Nan
chloride	குளோரைடு	Nan
chlamydia	கிளமிடியா	Nan
chiều	மாலை	None
chiền	கொத்து	Nan
chiếu	பாய்	Nan
chu	சூ	Nan
chiết	பிரித்தெடுத்தல்	Nan
chua	புளிப்பான	Nan
chui	துடைக்க	Nan
chuộng	சாதகமானது	Nan
chuộc	மீட்டு	Nan
chuỗi	சங்கிலி	Nan
chuồng	கூண்டு	Nan
chuốt	புரோச்சிங்	Nan
chuối	வாழை	None
chuốc	குத்து	None
chuẩn	தரநிலை	None
chuông	மணி	None
chuôi	வலுப்பிடி	Nan
chuyện	கதை	None
chuyển	போய் விட்டது	Nan
chuyền	பாஸ்	None
chuyến	பயணம்	Nan
chuyên	சிறப்பு	None
churchill	சர்ச்சில்	Nan
chung	பொது	Nan
chun	சுன்	Nan
chum	சம்	Nan
chuck	சக்	Nan
chuột	சுட்டி	None
chiến	சண்டை	None
chiếc	பிசிக்கள்	Nan
chao	வணக்கம்	None
chanh	எலுமிச்சை	Nan
chanel	சேனல்	None
chamẹ	பெற்றோர்	None
champion	சாம்பியன்	Nan
champa	சம்பா	Nan
chamberlain	சேம்பர்லைன்	Nan
chaillot	chaillot	Nan
chai	பாட்டில்	Nan
cha	அப்பா	Nan
ceres	ceres	Nan
centauri	செண்ட au ரி	Nan
cena	ஜான்	None
celtic	செல்டிக்	None
cell	செல்	None
cdrom	சிடிரோம்	Nan
cdot	cdot	Nan
cd	குறுவட்டு	Nan
cctv	மறைகாணி	Nan
charles	சார்லஸ்	None
chiếm	கணக்கியல்	None
charlotte	சார்லோட்	Nan
charon	charon	Nan
chiêng	காங்	Nan
chiên	வறுத்த	Nan
chiêm	ஜோதிடம்	Nan
chirac	சிராக்	Nan
ching	சிங்	None
china	சீனா	None
chim	பறவை	None
chile	சிலி	None
chicago	சிகாகோ	None
chiang	சியாங்	Nan
chia	பகிர்	Nan
chi	சி	None
cheo	cheo	Nan
chen	சென்	None
chechnya	chechnya	Nan
che	கவர்	Nan
chdcnd	chdcnd	Nan
chay	சைவம்	None
chase	துரத்து	Nan
charlton	சார்ல்டன்	Nan
chà	தேய்க்கவும்	Nan
chài	மீன்பிடித்தல்	Nan
chàm	இண்டிகோ	Nan
chấm	புள்ளி	None
chảy	ஓடு	None
chảo	பான்	Nan
chả	சுருள்கள்	Nan
chạy	ஓடு	None
chạp	நடுங்கும்	Nan
chạng	அந்தி	None
chạm	தொடு	Nan
chạ	வருங்கால	None
chướng	தடையாக நிச்சயமாக	Nan
chương	அத்தியாயம்	Nan
chưng	dist	Nan
chưa	இதுவரை இல்லை	Nan
chư	சூ	Nan
chơn	அடி	None
chơi	விளையாடு	None
chĩa	முட்கரண்டி	Nan
chăng	மலிவு	Nan
chămpa	சம்பா	Nan
chấp	சவால்	None
chăm	கடினமானது	Nan
chất	விஷயம்	Nan
chần	பிளான்ச்சிங்	Nan
chỉnh	திருத்தம்	None
chỉ	வெறும்	None
chệch	தவறு	None
chết	இறந்தார்	Nan
chếch	மந்தமான	Nan
chế	ஏற்பாடுகள்	None
chẽ	இறுக்கம்	Nan
chẻ	பிளவு	None
chặt	நறுக்கு	Nan
chặng	கால்	None
chặn	வெளியே தடுக்க	Nan
chẵn	கூட	None
chằng	புருவம்	Nan
chắc	நிச்சயம்	Nan
chậu	பானை	Nan
chật	இறுக்கம்	Nan
chận	தொகுதி	None
chậm	மெதுவாக	None
chẩn	கண்டறிய	None
chấu	கிள்ளுதல்	Nan
chút	சிறிதளவு	None
chúng	அவர்களுக்கு	None
chúi	tuu	Nan
chì	வழி நடத்து	Nan
chênh	வித்தியாசம்	None
chê	அடடா	Nan
chép	நகலெடுக்கவும்	Nan
chéo	குறுக்கு	None
chén	கோப்பை	Nan
chém	வெட்டு	None
chèn	செருக	Nan
chè	தேநீர்	None
châu	ஐரோப்பா	None
chân	கால்	None
châm	முள்	Nan
cháy	தீ	None
cháu	பேரக்குழந்தைகள்	Nan
cháo	கஞ்சி	Nan
chánh	தலைமை	None
chày	பேஸ்பால்	None
chào	வணக்கம்	None
chàng	பையன்	None
chìa	விசை	None
chìm	மூழ்கடித்தது	Nan
chình	ஈல்	Nan
chí	பேன்	None
chúc	வாழ்த்த	Nan
chúa	இறைவன்	None
chú	மாமா	None
chùy	mace	Nan
chùa	கோயில்	None
chông	கணவர்	None
chôn	அடக்கம்	None
chôm	ரம்புட்டன்	Nan
chóp	மேல்	None
ccn	ccn	Nan
chóng	விரைவாக	None
chóc	haha	Nan
chó	நாய்	None
chòm	விண்மீன்	None
chòi	கேபின்	Nan
chò	மூச்சு	None
chít	சிட்	Nan
chính	பிரதான	None
chín	ஒன்பது	None
chích	கொடுக்கு	Nan
chói	கண்ணை கூசும்	Nan
chịu	தாங்க	None
ccc	சி.சி.சி.	Nan
cbgd	cbgd	Nan
bẩm	பிறவி	Nan
bầy	கூட்டம்	None
bầu	வாக்களியுங்கள்	Nan
bần	ஏழை	None
bấy	அந்த	None
bất	உண்மையானது	Nan
bấm	அச்சகம்	None
bảy	ஏழு	None
bảo	பாவோ	Nan
bảng	பலகை	None
bại	இழக்க	Nan
bạch	வெள்ளை	None
bạc	வெள்ளி	None
bạ	தொடர்புகள்	None
bướm	பட்டாம்பூச்சி	Nan
bước	படி	None
bưu	தபால்துறை	Nan
bơm	பம்ப்	Nan
bơi	நீந்த	Nan
bẩn	அழுக்கு	Nan
bơ	வெண்ணெய்	Nan
bẩy	பொறி	None
bậc	பட்டம்	None
bệnh	நோய்வாய்ப்பட்டது	Nan
bện	சடை	Nan
bệ	பீடம்	None
bể	மணிகள்	Nan
bền	நீடித்த	None
bề	மேற்பரப்பு	Nan
bếp	சமையல் அறை	Nan
bến	வார்ஃப்	Nan
bẽ	அவமானம்	Nan
bẻ	உடைக்க	Nan
bẹp	நசுக்க	Nan
bằng	சமம்	Nan
bắt	பிடி	None
bắp	சோளம்	None
bắn	சுடு	Nan
bắcnam	வடக்கு தெற்கு	Nan
bắc	வடக்கு	None
bật	இயக்கப்பட்டது	Nan
bận	பரபரப்பு	Nan
bẫy	பொறி	None
bỉ	பெல்ஜியம்	None
băng	பனி	None
băm	ஹேஷ்	Nan
bìa	கவர்	Nan
bì	பேக்கேஜிங்	Nan
bênh	நோய்வாய்ப்பட்டது	Nan
bên	பக்க	None
béo	கொழுப்பு	None
bén	கூர்மையான	Nan
bé	கொஞ்சம்	None
bèn	பிறகு	None
bão	புயல்	None
bãi	கெஜம்	Nan
bã	எச்சம்	None
bây	இப்போது	None
báu	புதையல்	Nan
bát	கிண்ணம்	Nan
báo	செய்தித்தாள்	Nan
báng	இடி	Nan
bán	விற்க	Nan
bám	ஒட்டிக்கொள்க	Nan
bái	வழிபாட்டு	Nan
bìu	ஸ்க்ரோட்டம்	Nan
băn	fret	Nan
bí	ஸ்குவாஷ்	Nan
bíró	பூசணி	Nan
bút	பேனா	Nan
búng	flicked	Nan
bún	அரிசி நூடுல்	Nan
búi	டஃப்ட்ஸ்	Nan
búa	சுத்தி	Nan
bú	suckle	Nan
bùng	விரிவடைய	Nan
bùn	சேறு	Nan
bùa	தாயத்து	Nan
bù	ஒப்பனை	Nan
bông	பருத்தி	None
bôi	ஸ்மியர்	Nan
bô	அப்பா	Nan
bóp	கசக்கி	Nan
bóng	பந்து	None
bón	உரமிடு	Nan
bói	குறி சொல்லும்	Nan
bó	கொத்து	Nan
bò	மாடு	None
bính	பின்	None
bỉnh	குறும்பு	Nan
bịch	தம்ப்	Nan
bịt	மூடப்பட்ட	Nan
cardcaptor	அட்டை அட்டை	Nan
carbine	கார்பைன்	Nan
carat	காரட்	Nan
capra	காப்ரா	Nan
capello	capello	Nan
canxi	கால்சியம்	Nan
canterbury	கேன்டர்பரி	Nan
cancer	புற்றுநோய்	Nan
canary	கேனரி	Nan
canal	கால்வாய்	None
canadian	கனடியன்	Nan
canada	கனடா	None
campuchia	கம்போடியா	None
campbell	கேம்ப்பெல்	Nan
camille	காமில்	Nan
cameroon	கேமரூன்	Nan
cameron	கேமரூன்	Nan
cameo	கேமியோ	Nan
cambridge	கேம்பிரிட்ஜ்	None
cardcaptors	அட்டை அட்டைகள்	Nan
cambodia	கம்போடியா	None
carey	கேரி	Nan
caribê	கரீபியன்	None
cbc	cbc	Nan
cau	cau	Nan
catherine	கேத்தரின்	Nan
cathay	கேத்தே	Nan
castro	காஸ்ட்ரோ	Nan
castries	காஸ்ட்ரீஸ்	Nan
cast	நடிகர்கள்	None
cassini	காசினி	Nan
caspia	காஸ்பியா	Nan
casablanca	casablanca	Nan
casa	சி.ஏ. எஸ்.ஏ.	Nan
carxtơ	காரட்	Nan
carter	கார்ட்டர்	Nan
carpathia	கார்பதியா	Nan
caroline	கரோலின்	Nan
carol	கரோல்	Nan
carnaval	கார்னவல்	Nan
carlos	கார்லோஸ்	Nan
carl	கார்ல்	None
caribe	கரிபே	Nan
cam	ஆரஞ்சு	None
calvin	கால்வின்	Nan
calculus	கால்குலஸ்	Nan
bột	மாவு	Nan
bội	பல	None
bộc	boc	Nan
bộ	தொகுப்பு	Nan
bỗng	திடீரென்று	Nan
bổng	உதவித்தொகை	Nan
bổn	கடமை	None
bồi	இழப்பீடு	Nan
bốn	நான்கு	None
bối	குழப்பமான	Nan
bốc	ஏற்றுகிறது	Nan
bố	அப்பா	Nan
bỏng	எரிக்க	Nan
bỏ	திரும்பப் பெறு	Nan
bọt	நுரை	Nan
bọng	வீக்கம்	None
bọn	அவர்களுக்கு	None
bọc	மடக்கு	Nan
bọ	பிழை	Nan
bớ	சுற்று	None
bớt	குறைவாக	None
bờ	விளிம்பு	Nan
bời	பம்	Nan
cal	கலோரி	Nan
cairo	கெய்ரோ	Nan
cai	காய்	None
café	கொட்டைவடி நீர்	Nan
caffein	காஃபின்	Nan
caesar	சீசர்	Nan
cacbua	கார்பைடு	Nan
cacbonat	கார்பனேட்	Nan
cacbon	கார்பன்	None
cbs	cbs	Nan
cabo	cabo	Nan
ca	மாற்றம்	None
bực	விரக்தியடைந்த	Nan
bữa	உணவு	None
bừa	துன்புறுத்துகிறது	Nan
bứt	தெரியாமல்	None
bụng	வயிறு	None
bục	மேடை	None
bởi	வழங்கியவர்	Nan
bở	வழங்கியவர்	Nan
ca-lo	ca-lo	Nan
mĩ	அமெரிக்கா	None
giò	வசந்த ரோல்ஸ்	Nan
giòn	முறுமுறுப்பான	Nan
loạicựu	வகை	None
loạicông	வகை	None
loạicâu	வகை	None
loạicác	வகை	None
loạichiến	வகை	None
loạibệnh	நோய் வகை	Nan
loạianime	அனிம் தட்டச்சு செய்க	Nan
loạianh	வகை	None
loại	இனங்கள்	None
loét	புண்	Nan
loãng	கழுவும்	Nan
loát	மிகச்சிறிய பிரகாசமான	Nan
loài	இனங்கள்	None
love	காதல்	None
louvre	லூவ்ரே	Nan
louisiana	லூசியானா	None
louis	லூயிஸ்	None
los	லாஸ்	None
lorenzo	லோரென்சோ	Nan
loạigia	வகை	None
long	நீண்டது	Nan
loạihuân	kindhuan	Nan
loạimáy	இயந்திர வகை	Nan
lucas	லூகாஸ்	Nan
luang	லுவாங்	Nan
lu	லு	Nan
lp	எல்பி	Nan
loạt	தொடர்	None
loạn	கோளாறு	None
loạixã	வகை	None
loạivõ	வகை வகை	Nan
loạitổ	வகை	None
loạitín	கருணை	None
loạitrường	பள்ளி வகை	Nan
loạithần	வகை	None
loạithành	வகை	None
loạithuật	சட்ட வகை	Nan
loạiscandal	வகை	None
loạiphong	வகை	None
loạiphim	மூவி வகை	Nan
loạingày	இதை தட்டச்சு செய்க	Nan
loạimôn	வகை	None
loạiluật	சட்ட வகை	Nan
lucia	லூசியா	Nan
london	லண்டன்	None
logan	லோகன்	Nan
lionel	லியோனல்	Nan
linux	லினக்ஸ்	None
links	இணைப்புகள்	None
linh	லின்	None
linga	லிங்கா	Nan
lilly	லில்லி	Nan
lightning	மின்னல்	Nan
liga	லிகா	Nan
liechtenstein	liechtenstein	Nan
lido	லிடோ	Nan
libya	லிபியா	Nan
libero	லிபரோ	Nan
libby	லிபி	Nan
lhq	lhq	Nan
lhp	lhp	Nan
lg	எல்ஜி	Nan
lesotho	lesotho	Nan
leslie	லெஸ்லி	Nan
les	les	Nan
lisboa	லிஸ்போவா	Nan
lon	முடியும்	None
lisbon	லிஸ்பன்	Nan
liu	liu	Nan
log	பதிவு	Nan
lockheed	லாக்ஹீட்	Nan
locke	பூட்டு	Nan
loch	loch	Nan
loang	மென்மையாய்	Nan
loaita	லொய்தா	Nan
loa	பேசு	Nan
lo	கவலை	None
lleyton	lleyton	Nan
liệu	என்பது	None
liệt	முடக்கம்	Nan
liệng	வீசு	Nan
liễu	வில்லோ	Nan
liều	டோஸ்	Nan
liềm	அரிவாள்	Nan
liêu	அதிகாரத்துவம்	Nan
liêng	புனிதமானது	Nan
liên	துணிகர	Nan
liêm	நேர்மை	Nan
litva	லிதுவேனியா	Nan
leonid	லியோனிட்	Nan
luciano	லூசியானோ	Nan
ludovico	லுடோவிகோ	Nan
lôn	lol	Nan
lôi	பிழை	Nan
lô	நிறைய	None
lót	புறணி	None
lóng	ஸ்லாங்	Nan
lóe	பளிச்சென்று	Nan
lóc	பாம்பு தலை	Nan
lòng	நசுக்க	Nan
lò	சூளை	Nan
líu	கூ	Nan
lít	லிட்டர்	Nan
lính	சிப்பாய்	Nan
lí	சேமிப்பு	None
lình	திடீரென்று	Nan
lìa	விடுங்கள்	Nan
lênin	லெனின்	None
lênh	கட்டளை	None
lên	மேலே	None
lêmạc	ஒளி	None
lông	முடி	None
lê	பேரிக்காய்	Nan
lõi	கோர்	Nan
lùi	பின்தங்கிய	Nan
lưng	மீண்டும்	None
lư	தணிக்கை	Nan
lơi	தளர்த்தவும்	Nan
lơ	புறக்கணிப்பு	Nan
lũy	ஒட்டுமொத்த	None
lũng	பள்ளத்தாக்கு	None
lũ	வெள்ளம்	None
lĩnh	களங்கள்	None
lăng	கல்லறை	None
lăn	உருட்டுதல்	Nan
lăm	ஐந்து	None
lút	ஸ்னீக்கி	Nan
lúp	உருப்பெருக்கம்	Nan
lúng	விரிவடைய	Nan
lún	வீழ்ச்சி	None
lúc	இல்	None
lúa	நெல்	None
lùng	வேட்டை	None
lùn	குறுகிய	Nan
lõm	குழிவான	Nan
ludendorff	ludendorff	Nan
lén	சீட்டு	Nan
lão	பழையது	Nan
ly	கண்ணாடி	None
luỹ	ஒட்டுமொத்த	None
luộc	வேகவைத்தது	Nan
luồng	ஸ்ட்ரீம்	Nan
luồn	திரிக்கப்பட்ட	Nan
luật	சட்டம்	None
luận	கருத்து	None
luyện	பயிற்சி	None
luyến	இணைப்பு	None
luy	luy	Nan
luxembourg	லக்ஸம்பர்க்	Nan
luther	லூதர்	Nan
lustig	lustig	Nan
lung	நுரையீரல்	None
lula	லூலா	Nan
luiz	லூயிஸ்	None
luis	லூயிஸ்	None
lui	மீண்டும்	None
ludwig	லுட்விக்	Nan
lydia	லிடியா	Nan
lèo	lèo	Nan
lympho	லிம்போமா	Nan
lyon	லியோன்	Nan
lãnh	பெறப்பட்டது	None
lãm	நிகழ்ச்சிகள்	Nan
lãi	ஆர்வம்	None
lây	தொற்றும் தன்மை கொண்டது	Nan
lâu	நீண்டது	Nan
lân	யூனிகார்ன்	Nan
lâm	லாம்	Nan
láng	பளபளப்பான	Nan
lán	குலுக்கல்	Nan
lái	இயக்கி	None
lách	மண்ணீரல்	Nan
lác	squint	Nan
lá	இலைகள்	None
lào	லாவோஸ்	Nan
lành	குணமாகும்	Nan
làng	கிராமம்	None
làn	சந்து	Nan
làm	செய்	Nan
là	இருந்தது	None
lyndon	லிண்டன்	Nan
leonardo	லியோனார்டோ	Nan
leonard	லியோனார்ட்	Nan
leon	லியோன்	Nan
komodo	கொமோடோ	Nan
kogoro	கோகோரோ	Nan
kofun	kofun	Nan
kodansha	கோடன்ஷா	Nan
koch	கோச்	Nan
knuth	knuth	Nan
knesset	knesset	Nan
km	கிலோமீட்டர்	Nan
klein	க்ளீன்	Nan
klaus	கிளாஸ்	None
kiệu	பல்லக்கு	Nan
kiệt	தலைசிறந்த படைப்பு	Nan
kiện	மீது வழக்கு தொடர	Nan
kiệm	பொருளாதார	None
kiểu	வகை	None
kiểm	காசோலை	Nan
kiềm	கார	Nan
kiết	kiết	Nan
kiếp	வாழ்நாள்	None
kon	கோன்	Nan
kiêu	திமிர்பிடித்த	Nan
kong	காங்	Nan
konversationslexikon	konversationslexikon	Nan
kunst	குன்ஸ்ட்	Nan
kungfu	குங்ஃபு	Nan
kung	குங்	Nan
kune	குனே	Nan
kulak	குலக்	Nan
kuiper	kuiper	Nan
kuen	குயென்	Nan
kubrick	குப்ரிக்	Nan
kuala	குவாலா	Nan
ku	கு	Nan
krông	krong	Nan
kristen	கிறிஸ்டன்	Nan
kremlin	கிரெம்ளின்	Nan
kremli	கிரெம்லி	Nan
kosovo	கொசோவோ	Nan
koruna	koruna	Nan
kornai	kornai	Nan
koran	கோரன்	Nan
kop	கோப்	Nan
konstantin	கொன்ஸ்டான்டின்	Nan
kurd	குர்த்	Nan
kiêng	விலகியிருங்கள்	Nan
kiêm	படகோட்டி	Nan
khổng	ராட்சத	Nan
khổ	துன்பம்	None
khống	கோங்	Nan
khốn	முறை தவறி பிறந்த குழந்தை	Nan
khối	தகுதி படி	Nan
khốc	மோசமான	None
khố	இடுப்பு	Nan
khỏi	வெளியே	None
khỏe	வலுவான	None
khỏa	நிர்வாணமாக	Nan
khỉ	குரங்கு	None
khế	நட்சத்திர பழம்	Nan
khẳng	உறுதியான	Nan
khắp	எல்லாம் முடிந்தது	Nan
khắc	உச்சநிலை	Nan
khẩn	அவசரம்	Nan
khấu	தள்ளுபடி	None
khấn	பிரார்த்தனை	Nan
khấm	துளைத்தது	Nan
khởi	தொடங்குகிறது	None
kiên	நோயாளி	Nan
khủng	பயங்கரமானது	Nan
khứu	வெளிர்	None
kitô	கிறிஸ்துவர்	Nan
kitts	கிட்டுகள்	Nan
kissinger	கிஸ்ஸிங்கர்	Nan
kiss	முத்தம்	Nan
kishimoto	கிஷிமோடோ	Nan
kiribati	கிரிபதி	Nan
kinsey	கின்சி	Nan
kingdom	இராச்சியம்	None
kim	கிம்	Nan
kilômét	கிலோமீட்டர்	Nan
kikyo	கிகியோ	Nan
kii	kii	Nan
kiernan	கீர்னன்	Nan
kierkegaard	kierkegaard	Nan
kiel	கீல்	Nan
kid	குழந்தை	None
kia	அந்த	None
ki	கி	None
khử	அகற்றவும்	Nan
khủyu	முறை தவறி பிறந்த குழந்தை	Nan
kurt	கர்ட்	Nan
kuwait	குவைத்	Nan
kwan	kwan	Nan
larry	லாரி	None
lap	மடியில்	Nan
laos	லாவோஸ்	Nan
lao	காசநோய்	None
lanka	லங்கா	Nan
lanh	கைத்தறி	Nan
langue	மொழி	Nan
lange	லாங்கே	Nan
langdon	லாங்டன்	Nan
lang	lang	Nan
landon	லேண்டன்	Nan
land	நில	None
lan	லான்	Nan
lama	லாமா	Nan
lam	லாம்	Nan
lai	கலப்பு	None
ladakh	லடாக்	Nan
laboulaye	laboulaye	Nan
label	லேபிள்	Nan
lars	லார்ஸ்	Nan
l	l	Nan
las	லாஸ்	None
lateran	lateran	Nan
leo	ஏறு	Nan
lenins	லெனின்கள்	Nan
lenin	லெனின்	None
lem	லெம்	Nan
leiden	லைடன்	Nan
legacy	மரபு	None
lee	லீ	Nan
lebanon	லெபனான்	Nan
leave	விடுங்கள்	Nan
leaf	இலை	None
leach	லீச்	Nan
lazarus	லாசரஸ்	Nan
lay	லே	Nan
lawrence	லாரன்ஸ்	Nan
laurence	லாரன்ஸ்	Nan
laura	லாரா	Nan
lau	துடைக்க	Nan
latvia	லாட்வியா	Nan
latinh	லத்தீன்	None
laser	லேசர்	Nan
kỷ	நூற்றாண்டு	None
kỵ	குதிரைப்படை	Nan
kịp	வை	None
kí	அடையாளம்	None
kình	கண்ணாடிகள்	Nan
kìm	இடுக்கி	Nan
kìa	இதோ	Nan
kêu	ஒலிக்கிறது	Nan
kênh	சேனல்கள்	Nan
kê	தினை	Nan
két	பாதுகாப்புகள்	Nan
kép	இரட்டை	None
kéo	இழுக்கவும்	Nan
kén	கூட்டை	Nan
kém	குறைந்தது	None
kèn	எக்காளம்	Nan
kèm	மூடப்பட்டிருக்கும்	Nan
kyūshū	kyūshū	Nan
kyushu	kyushu	Nan
kyrgyzstan	கிரிங்கிஸ்தான்	Nan
kwon	க்வோன்	Nan
kwen	kwen	Nan
kích	கிளிக் செய்க	Nan
kíchbom	கிளிக் பட்டன்	Nan
kín	தனிப்பட்ட	None
kính	கண்ணாடிகள்	Nan
kị	குதிரைப்படை	Nan
kỉ	நூற்றாண்டு	None
kệ	அலமாரிகள்	Nan
kềnh	பருமனான	Nan
kề	அருகிலுள்ள	None
kết	முடிவு	None
kế	அடுத்தது	Nan
kẽm	துத்தநாகம்	None
kẽ	இடையிடையே	None
lươn	ஈல்	Nan
kẻo	வேண்டாம்	None
kẹt	சிக்கிக்கொண்டது	Nan
kẹp	கிளிப்	Nan
kẹo	மிட்டாய்	Nan
kạn	கான்	None
kơnia	kàia	Nan
kĩ	கவனமாக	None
ký	அடையாளம்	None
kít	கத்தினார்	Nan
kíp	குழுவினர்	Nan
kẻ	தோழர்களே	Nan
lương	சம்பளம்	None
lưới	கட்டம்	None
lướt	உலாவல்	Nan
moi	புதியது	Nan
mohammed	முகமது	None
mohammad	முகமது	None
modula	மட்டு	Nan
modul	தொகுதி	None
mode	பயன்முறை	None
mobile	கைபேசி	None
mm	மிமீ	Nan
miệng	வாய்	None
miện	கிரீடம்	Nan
miễn	விலக்கு	None
miền	களம்	None
miếu	கோயில்	None
miếng	துண்டுகள்	None
miến	அரிசி நூடுல்	Nan
miêu	பூனை	None
miên	ஹிப்னாஸிஸ்	Nan
mitsubishi	mitsubishi	Nan
mitchel	மிட்செல்	Nan
molecular	மூலக்கூறு	None
missouri	மிச ou ரி	Nan
molotov	molotov	Nan
mongolia	மங்கோலியா	Nan
morocco	மொராக்கோ	Nan
morley	மோர்லி	Nan
moriarty	moriarty	Nan
mori	மோரி	Nan
morgan	மோர்கன்	Nan
moravia	மொராவியா	Nan
mora	மோரா	Nan
moong	மூங்	Nan
moo	moo	Nan
montreal	மான்ட்ரியல்	Nan
montparnasse	montparnasse	Nan
montmartre	montmartre	Nan
montenegro	montenegro	Nan
montana	montana	Nan
montaigne	மோன்டைக்னே	Nan
mont	mont	Nan
monroe	மன்ரோ	Nan
mono	மோனோ	Nan
monique	monique	Nan
molypden	மாலிப்டினம்	None
morris	மோரிஸ்	Nan
mississippi	மிசிசிப்பி	Nan
miroku	miroku	Nan
michigan	மிச்சிகன்	None
michelangelo	மைக்கேலேஞ்சலோ	Nan
michaels	மைக்கேல்ஸ்	Nan
michael	மைக்கேல்	None
miami	மியாமி	Nan
meyers	மேயர்கள்	Nan
meyer	மேயர்	None
mext	mext	Nan
meteora	விண்கல்	None
messiah	மேசியா	Nan
messi	மெஸ்ஸி	Nan
messerschmitt	messerschmitt	Nan
messenger	தூதர்	None
mercedes	மெர்சிடிஸ்	Nan
menes	ஆண்கள்	None
mendeleev	mendeleev	Nan
melbourne	மெல்போர்ன்	Nan
mekong	மீகாங்	Nan
medvedev	medvedev	Nan
micro	மைக்ரோ	None
misfits	பொருந்தாதவர்கள்	Nan
microbiology	நுண்ணுயிரியல்	Nan
micronesia	மைக்ரோனேஷியா	Nan
mirage	மிராஜ்	Nan
miraflores	அதிசயங்கள்	None
minoa	மினோவா	Nan
minnesota	மினசோட்டா	Nan
ming	மிங்	None
mindanao	mindanao	Nan
minas	மினாஸ்	Nan
min	நிமிடம்	Nan
milton	மில்டன்	Nan
miller	மில்லர்	Nan
mill	ஆலை	None
miley	மைலி	Nan
milano	மிலானோ	Nan
milan	மிலன்	Nan
mikoyangurevich	mikoyangurevich	Nan
mikoyan	மைக்கோயன்	Nan
mike	மைக்	Nan
miguel	மிகுவல்	Nan
microsoft	மைக்ரோசாஃப்ட்	None
microeconomics	நுண் பொருளாதாரம்	Nan
morrison	மோரிசன்	Nan
morse	மோர்ஸ்	Nan
moscow	மாஸ்கோ	Nan
mép	விளிம்பு	Nan
méo	சிதைந்த	Nan
mé	mé	Nan
mèo	பூனை	None
mè	எள்	Nan
mão	கிரீடங்கள்	Nan
mãnh	வலுவான	None
mãn	மனநிறைவு	Nan
mãimại	குறியீடு	None
mãi	என்றென்றும்	Nan
mã	குறியீடு	None
mây	மேகம்	None
mâu	முரண்பாடானது	Nan
mân	ஜெபமாலை	Nan
mâm	தட்டு	None
máy	இயந்திரம்	None
máu	இரத்தம்	None
mát	குளிர்	Nan
mái	கூரை	None
mét	மீட்டர்	None
máclênin	மெசெலனின்	Nan
mênh	தடுமாறும்	Nan
mì	நூடுல்ஸ்	Nan
münchen	münchen	Nan
mút	உறிஞ்சும்	Nan
múa	நடனம்	None
mùi	வாசனை	Nan
mùa	பருவம்	None
mù	குருட்டு	Nan
môtô	மோட்டார் சைக்கிள்	Nan
môt	ஒன்று	None
mônôxít	மோனாக்சைடு	Nan
mông	பிட்டம்	Nan
môn	பாடங்கள்	Nan
môi	ஒவ்வொன்றும்	None
mô	திசு	None
món	உணவு	None
móc	கொக்கி	Nan
mòn	பாதை	None
mò	தடுமாறியது	Nan
mía	கரும்பு	None
mình	நீங்களே	Nan
mêtan	மீத்தேன்	Nan
mách	உதவிக்குறிப்புகள்	Nan
mác	லேபிள்	Nan
má	அம்மா	None
murdoch	முர்டோக்	Nan
munich	முனிச்	Nan
mun	கருங்காலி	Nan
mumbai	மும்பை	None
muhammad	முஹம்மது	None
much	அதிகம்	None
mua	வாங்க	None
mu	mu	Nan
mtv	mtv	Nan
msdos	msdos	Nan
ms	செல்வி	Nan
mp	mp	Nan
mozart	மொஸார்ட்	Nan
mozambique	மொசாம்பிக்	Nan
movie	திரைப்படம்	None
mourinho	மவுரினோ	Nan
motown	மோட்டவுன்	Nan
moskva	moskva	Nan
mosin	மோசின்	Nan
muromachi	muromachi	Nan
murphy	மர்பி	Nan
murray	முர்ரே	Nan
mustang	mustang	Nan
mày	நீங்கள்	None
màu	நிறம்	None
mào	முகடு	Nan
mành	குருட்டுகள்	Nan
màn	திரை	None
mài	அரைக்கும்	Nan
mà	ஆனாலும்	None
myspace	என்னுடைய இடம்	Nan
myanmar	மியான்மர்	Nan
medina	மதினா	Nan
myanma	மியான்மர்	Nan
muội	சகோதரி	Nan
muỗng	ஸ்பூன்	Nan
muỗi	கொசு	Nan
muồi	தாமதமாக	Nan
muống	ஸ்பூன்	Nan
muốn	வேண்டும்	None
muối	உப்பு	None
muôn	வேண்டும்	None
muta	muta	Nan
muộn	தாமதமாக	Nan
khảo	தேர்வு	Nan
medici	மருத்துவம்	None
mcv	mcv	Nan
lộc	அதிர்ஷ்டம்	Nan
lỗ	துளை	Nan
lồng	கூண்டு	Nan
lồi	குவிந்த	Nan
lồ	ராட்சத	Nan
lốt	போர்வையில்	Nan
lốp	சக்கரம்	None
lối	நுழைவு	Nan
lốc	சூறாவளி	None
lố	ஓவர்	Nan
lỏng	தளர்வான	Nan
lỏi	பஞ்சு	Nan
lọt	வீழ்ச்சி	None
lọng	பராசோல்	Nan
lọi	squint	Nan
lọc	வடிகட்டி	Nan
lịch	நாட்காட்டி	None
lị	வயிற்றுப்போக்கு	Nan
lệnh	கமினந்த்	Nan
lội	நீந்த	Nan
lệch	skew	Nan
lộn	புரட்டப்பட்டது	Nan
lột	கிளப்பக்கூடியவன்	Nan
lự	தயக்கம்	Nan
lửng	பேட்ஜர்	Nan
lừng	சிறப்பான	None
lừa	தந்திரம்	Nan
lứa	குப்பை	Nan
lụy	தாக்கங்கள்	None
lụt	அதிகமாக	None
lụi	எரிந்து போனது	Nan
lục	பச்சை	None
lụa	பட்டு	None
lợp	கூரை	None
lợn	பன்றி	None
lợi	லாபம்	Nan
lỡ	செல்வி	Nan
lở	செல்வி	Nan
lời	சொல்	Nan
lờ	புறக்கணிக்கவும்	Nan
lớp	வர்க்கம்	None
lớn	பெரியது	None
lộng	அழகான	None
lựa	தேர்ந்தெடுக்கப்பட்டது	Nan
lệ	வீதம்	None
lều	கூடாரம்	Nan
lấy	தேர்ந்தெடு	Nan
lấp	நிரப்பு	Nan
lấn	அத்துமீறல்	Nan
lạy	சிரமப்படு	Nan
lạtma	லாமா	Nan
lạp	தொத்திறைச்சி	Nan
lạng	லாங்	Nan
lạn	அழுகிய	Nan
lại	மீண்டும்	None
lạch	க்ரீக்	Nan
lạc	இழந்தது	None
lạ	விசித்திரமானது	Nan
lǐ	lǐ	Nan
lượn	சறுக்கு	Nan
lượm	சேகரிக்க	Nan
lược	சீப்பு	Nan
lưỡng	இருபால்	None
lưỡi	நாக்கு	Nan
lười	சோம்பேறி	Nan
lầm	தவறு	None
lễ	விழா	None
lần	முறை	None
lầy	சதுப்பு நிலம்	Nan
lề	விளிம்பு	Nan
lẻo	தளர்வானது	Nan
lẻn	பதுங்க	Nan
lẻ	ஒற்றைப்படை	Nan
lẹ	விரைவான	None
lặt	இதர	None
lặp	மீண்டும்	None
lặng	அமைதியான	None
lắp	பொருத்தி	Nan
lắng	குடியேற	Nan
lắm	மிகவும்	None
lắc	குலுக்கல்	Nan
lậy	ஓ ஆமாம்	Nan
lật	புரட்டு	Nan
lận	ஏமாற்று	Nan
lẫy	கிள்ளுதல்	Nan
lẫn	குழப்பமான	Nan
lẩy	குதி	Nan
lẩu	சூடான பானை	Nan
lầu	தரை	Nan
lựu	மாதுளை	Nan
ma	பேய்	None
maastricht	மாஸ்ட்ரிக்ட்	Nan
mary	மேரி	Nan
marx	மார்க்ஸ்	None
martin	மார்டின்	Nan
marta	மார்த்தா	Nan
marsu	மார்சு	Nan
marshall	மார்ஷல்	Nan
marseille	மார்சேய்	Nan
mars	செவ்வாய் கிரகம்	Nan
marne	மார்னே	Nan
marmara	மர்மாரா	Nan
marić	marić	Nan
marino	மரினோ	Nan
marina	மெரினா	None
marie	மேரி	Nan
marianne	மரியான்	Nan
maria	மரியா	None
margaret	மார்கரெட்	Nan
marcus	மார்கஸ்	Nan
marcos	மார்கோஸ்	Nan
maryland	மேரிலாந்து	Nan
marcel	மார்செல்	Nan
maría	maría	Nan
massachusetts	மாசசூசெட்ஸ்	Nan
mcnamara	mcnamara	Nan
mcmahon	mcmahon	Nan
mclaren	mclaren	Nan
mchc	mchc	Nan
mcdonald	mcdonald	Nan
mccullough	mccullough	Nan
mccartney	mccartney	Nan
mccain	mccain	Nan
mcafee	mcafee	Nan
maya	மாயா	None
may	தை	None
maxim	மாக்சிம்	Nan
mausolus	கல்லறை	None
maurice	மாரிஸ்	Nan
mau	விரைவாக	None
matthias	மத்தியாஸ்	Nan
mats	பாய்கள்	Nan
mathematica	கணிதவியல்	Nan
mat	பாய்	Nan
mas	mas	Nan
marc	மார்க்	None
marat	மராட்	Nan
maradona	மரடோனா	Nan
mainframe	மெயின்பிரேம்	Nan
mai	கூரை	None
mahal	மஹால்	None
magiê	வெளிமம்	Nan
mafia	மாஃபியா	Nan
madrid	மாட்ரிட்	Nan
madonna	மடோனா	Nan
madison	மாடிசன்	Nan
madhouse	பைத்தியம்	Nan
madeira	madeira	Nan
macromedia	மேக்ரோமீடியா	Nan
macma	மாக்மா	Nan
macintosh	மேகிண்டோஷ்	Nan
machu	மச்சு	None
machiavelli	மச்சியாவெல்லி	Nan
mach	மச்	Nan
macedonia	மாசிடோனியா	Nan
macclesfield	macclesfield	Nan
macarthur	மாகார்த்தூர்	Nan
major	முக்கிய	None
makemake	makemake	Nan
malacca	மலாக்கா	None
malay	மலாய்	None
maps	வரைபடங்கள்	None
mao	மாவோ	Nan
manuel	மானுவல்	Nan
manti	மந்தி	Nan
mankiw	mankiw	Nan
manila	மணிலா	Nan
manh	மன்	Nan
mangnall	mangnall	Nan
manga	மங்கா	Nan
media	மீடியா	None
mang	எடுத்துச் செல்லுங்கள்	Nan
mandela	மண்டேலா	None
manchester	மான்செஸ்டர்	Nan
manche	மான்சே	Nan
maluku	மாலுகு	Nan
malta	மால்டா	Nan
mali	மாலி	Nan
maldini	மால்தினி	Nan
malcolm	மால்கம்	Nan
malaysia	மலேசியா	None
mandy	மண்டி	Nan
giòi	maggots	Nan
khảm	மொசைக்	Nan
khả	சாத்தியம்	None
hiếm	அரிதானது	Nan
hiđrô	ஹைட்ரஜன்	None
hiên	தாழ்வாரம்	Nan
hitters	ஹிட்டர்கள்	Nan
hitter	ஹிட்டர்	Nan
hitler	ஹிட்லர்	Nan
hitchcock	ஹிட்ச்காக்	Nan
hiroshima	ஹிரோஷிமா	Nan
hiroshi	ஹிரோஷி	Nan
hiragana	ஹிரகனா	Nan
hinhtron	hinhtron	Nan
hinh	ஹின்	Nan
hindu	இந்து	None
hindi	இந்தி	None
hindenburg	ஹிண்டன்பர்க்	Nan
hinata	ஹினாட்டா	Nan
himalaya	இமயமலை	None
hilton	ஹில்டன்	Nan
hillsborough	ஹில்ஸ்பரோ	Nan
hiến	கொடுங்கள்	Nan
hidro	ஹைட்ரஜன்	None
hiếp	கற்பழிப்பு	Nan
hiềm	நோய்வாய்ப்பட்டது	Nan
holocen	ஹோலோசீன்	Nan
holocaust	ஹோலோகாஸ்ட்	Nan
holmes	ஹோம்ஸ்	Nan
hokusai	hokusai	Nan
hokage	ஹோகேஜ்	Nan
hoi	ஹோய்	Nan
hogwarts	ஹாக்வார்ட்ஸ்	Nan
hoan	திருவிழா	None
hoa	பூ	None
hn	hn	Nan
hmông	hmong	Nan
hms	hms	Nan
hlv	பயிற்சியாளர்	Nan
hiệu	விளைவு	Nan
hiệp	பாதி	Nan
hiện	காண்பிக்கப்படும்	None
hiểu	புரிந்து	None
hiểm	ஆபத்தானது	Nan
hiền	முனிவர்	None
hiếu	கடுமையான பக்தி	Nan
holt	ஹோல்ட்	Nan
hideyoshi	hideyoshi	Nan
hicks	ஹிக்ஸ்	Nan
heath	ஹீத்	Nan
health	ஆரோக்கியம்	None
he	அவர்	None
hd	hd	Nan
hcl	hcl	Nan
hbv	hbv	Nan
hb	hb	Nan
hay	நல்ல	None
hawking	ஹாக்கிங்	Nan
hawker	ஹாக்கர்	Nan
havilland	ஹவில்லேண்ட்	Nan
havana	ஹவானா	Nan
harvey	ஹார்வி	Nan
harvard	ஹார்வர்ட்	None
harry	ஹாரி	Nan
harris	ஹாரிஸ்	Nan
harrier	தடை	None
harpercollins	ஹார்பர்காலின்ஸ்	Nan
harper	ஹார்பர்	Nan
hee	ஹீ	Nan
hideto	hideto	Nan
hegel	ஹெகல்	Nan
heinrich	ஹென்ரிச்	Nan
hickam	hickam	Nan
hi	வணக்கம்	None
hestia	ஹெஸ்டியா	None
hesiod	hesiod	Nan
hersh	ஹெர்ஷ்	Nan
hermes	ஹெர்ம்ஸ்	Nan
hermann	ஹெர்மன்	Nan
hercules	ஹெர்குலஸ்	Nan
hercegovina	ஹெர்சகோவினா	Nan
herbert	ஹெர்பர்ட்	Nan
her	அவள்	None
heo	பழையது	Nan
henry	ஹென்றி	None
hen	கோழி	None
hemoglobin	ஹீமோகுளோபின்	Nan
hematocrit	ஹீமாடோக்ரிட்	Nan
heli	கதிர்வளி	Nan
helena	ஹெலினா	Nan
helen	ஹெலன்	Nan
heian	ஹியான்	Nan
harold	ஹரோல்ட்	Nan
hom	வெட்டல்	Nan
hon	க .ரவ	Nan
hán	வறட்சி	None
hái	தேர்ந்தெடு	Nan
hách	தாங்குதல்	Nan
hào	அகழி	Nan
hàng	வரிசை	None
hàm	தாடை	Nan
hài	நகைச்சுவை	Nan
hà	ஹெக்டேர்	Nan
hyperion	ஹைபரியன்	Nan
hydro	ஹைட்ரஜன்	None
hydra	ஹைட்ரா	Nan
huỷ	ரத்துசெய்	Nan
huỳnh	கந்தகம்	None
huống	வழக்கு	None
huệ	சாயல்	Nan
huế	சாயல்	Nan
huấn	பயிற்சி	None
huê	சாயல்	Nan
huân	ஹுவான்	Nan
háo	ஆவலுடன்	Nan
huyệt	குத்தூசி மருத்துவம் புள்ளிகள்	Nan
hát	பாட	Nan
hân	ஹான்	Nan
hót	பாட	Nan
hóc	hóc	Nan
hòng	நன்றாக	None
hòn	தீவு	None
hòm	பேழை	Nan
hòe	மலம்	None
hòa	கட்டு	Nan
hò	டேட்டிங்	Nan
hít	சுவாசிக்கவும்	Nan
hí	ne	Nan
hên	அதிர்ஷ்டசாலி	Nan
hét	கூச்சலிடுங்கள்	Nan
héo	கவிழ்ந்துவிடும்	Nan
hé	விரிசல்	Nan
hè	கோடை	None
hãnh	பெருமை	None
hãng	நிறுவனம்	None
hãn	கான்	None
hãi	பயமாக இருக்கிறது	Nan
hâm	பைத்தியம்	Nan
homer	ஹோமர்	Nan
huyện	மாவட்டம்	None
huyền	விசித்திரமான	Nan
hoạ	பெயிண்ட்	Nan
hoãn	அவர்கள் சாப்பிடுகிறார்கள்	Nan
hoán	perm	Nan
hoá	வேதியியல்	None
hoành	உதரவிதானம்	Nan
hoàng	ராஜா	None
hoàn	முழுமை	Nan
hoài	ஏக்கம்	Nan
hoà	கட்டு	Nan
however	எனினும்	None
howard	ஹோவர்ட்	Nan
houston	ஹூஸ்டன்	Nan
hotspur	ஹாட்ஸ்பூர்	Nan
hornet	ஹார்னெட்	Nan
hopkins	ஹாப்கின்ஸ்	Nan
honshū	honshū	Nan
honolulu	ஹொனலுலு	Nan
hong	ஹாங்	Nan
honduras	ஹோண்டுராஸ்	Nan
hoại	கேங்க்ரீன்	Nan
huyễn	மாயை	Nan
hoạt	ஹெண்டாய்	Nan
hoảng	பீதி	Nan
huynh	சகோதரன்	Nan
huy	ஹுய்	Nan
hutech	ஹுடெக்	Nan
huston	ஹஸ்டன்	Nan
husserl	ஹுஸெர்ல்	Nan
hussein	ஹுசைன்	Nan
hurley	ஹர்லி	Nan
hunt	வேட்டை	None
hungary	பசி	None
hun	ஹன்	Nan
hume	ஹியூம்	Nan
hugo	ஹ்யூகோ	Nan
hughes	ஹக்ஸ்	Nan
huey	ஹூய்	Nan
hudson	ஹட்சன்	None
hudgens	ஹட்ஜன்ஸ்	Nan
hq	hq	Nan
hp	hp	Nan
hoặc	அல்லது	None
hoả	தீ	None
harlow	ஹார்லோ	Nan
harlem	ஹார்லெம்	Nan
hardy	ஹார்டி	Nan
greenson	க்ரீன்சன்	Nan
greenland	கிரீன்லாந்து	Nan
greek	கிரேக்கம்	None
granit	கிரானைட்	Nan
granada	granada	Nan
graham	கிரஹாம்	Nan
grabeel	grabeel	Nan
gottfried	gottfried	Nan
gothic	கோதிக்	Nan
gorky	gorky	Nan
gore	கோர்	Nan
gordon	கார்டன்	Nan
gorbachyov	gorbachyov	Nan
gorbachev	gorbachev	Nan
google	கூகிள்	None
gom	திரட்டுதல்	Nan
golden	தங்கம்	None
goku	goku	Nan
goes	செல்கிறது	None
greenwich	கிரீன்விச்	Nan
go	போ	Nan
greg	கிரெக்	Nan
grenadines	கிரெனடைன்கள்	Nan
gundam	குண்டம்	Nan
gullit	gullit	Nan
gulf	வளைகுடா	None
gulag	குலாக்	Nan
gujarat	குஜராத்	None
guitar	கிட்டார்	Nan
guinness	கின்னஸ்	Nan
guinea	கினியா	Nan
gui	குய்	Nan
guatemala	குவாத்தமாலா	Nan
guard	காவலர்	Nan
guam	குவாம்	None
gu	உடை	None
gsts	gsts	Nan
gs	ஜி.எஸ்	Nan
gryffindor	gryffindor	Nan
gruzia	ஜார்ஜியா	Nan
grumman	grumman	Nan
gross	மொத்த	None
grenada	கிரெனடா	Nan
gunung	gunung	Nan
gnp	gnp	Nan
glucose	குளுக்கோஸ்	Nan
giặc	எதிரி	Nan
giằng	பிரேசிங்	Nan
giận	கோபம்	None
giầu	பணக்கார	None
giấy	காகிதம்	Nan
giấu	மறை	None
giấm	வினிகர்	Nan
giấc	தூங்கு	Nan
giản	எளிமைப்படுத்தப்பட்டது	Nan
giảm	குறைப்பு	Nan
giải	தீர்வு	None
giả	போலி	Nan
giường	படுக்கை	None
giương	வெடித்துள்ளது	Nan
giơ	நெரிசல்	Nan
giũa	கோப்பு	Nan
giúp	உதவி	None
gióng	போன்ற	None
gió	காற்று	None
giặt	கழுவுதல்	Nan
gmail	gmail	Nan
giếng	நன்றாக	None
giềng	அண்டை	None
gloster	குளோஸ்டர்	Nan
gloria	குளோரியா	Nan
glonass	glonass	Nan
glazer	கிளாசர்	Nan
gladys	கிளாடிஸ்	Nan
giữa	இடையில்	None
giữ	பிடி	None
giục	வலியுறுத்தப்பட்டது	Nan
giỡn	நகைச்சுவை	Nan
giở	ஃபிளாஷ்	Nan
giờ	மணி	None
giới	பாலினம்	Nan
giỗ	இறப்பு ஆண்டு	Nan
giồng	ஜியோங்	Nan
giỏi	நன்று	None
giỏ	கூடை	Nan
giọt	கைவிட	Nan
giọng	தொனி	Nan
giễu	ஏளனம்	Nan
giết	கொல்ல	None
gustave	குஸ்டாவ்	Nan
gutenberg	குட்டன்பெர்க்	Nan
guyana	guyana	Nan
gỡ	இறக்கு	Nan
gởi	அனுப்புக	Nan
gờ	ledge	Nan
gớm	அருவருப்பான	Nan
gộp	ஒன்றிணைத்தல்	Nan
gội	ஷாம்பு	Nan
gỗ	மரம்	None
gồng	காங்	Nan
gồm	உட்பட	None
gốm	பீங்கான்	Nan
gối	தலையணை	Nan
gốc	தோற்றம்	Nan
gỏi	சாலட்	Nan
gọt	தலாம்	Nan
gọng	விளிம்பு	Nan
gọn	சுத்தமாக	Nan
gọi	அழைப்பு	None
gỉ	துருப்பிடித்தது	Nan
gặt	அறுவடைக்கு	Nan
gợi	பரிந்துரைக்கும்	Nan
gặp	சந்திக்க	Nan
gục	கீழ்	None
gửi	அனுப்ப	None
harald	ஹரால்ட்	Nan
hao	hao	Nan
hansen	ஹேன்சன்	Nan
hanja	ஹஞ்சா	Nan
hanh	ஹான்	Nan
hangul	ஹங்குல்	Nan
hang	குகை	None
han	ஹான்	Nan
hamilton	ஹாமில்டன்	Nan
ham	ஹாம்	Nan
halogen	ஆலசன்	Nan
halle	halle	Nan
hal	hal	Nan
hai	இரண்டு	None
hahn	ஹான்	Nan
haeberle	ஹேபர்லே	Nan
habsburg	ஹாப்ஸ்பர்க்	Nan
habana	ஹபனா	Nan
ha	ஹெக்டேர்	Nan
gừng	இஞ்சி	Nan
gặm	gnaw	Nan
gắt	கடுமையாக	Nan
gắng	முயற்சிக்கிறது	Nan
góp	தவணை	Nan
gói	தொகுப்பு	None
góc	மூலையில்	None
góa	விதவை	Nan
gòn	gn	Nan
gò	மலை	None
gìn	பாதுகாக்க	None
gì	என்ன	None
gãy	உடைந்த	Nan
gây	காரணம்	Nan
gân	நெருக்கமான	None
gáy	nape	Nan
gánh	எடுத்துச் செல்லுங்கள்	Nan
gán	ஒதுக்க	Nan
gái	பெண்	None
gác	காவலர்	Nan
gào	கத்தினான்	Nan
gài	டக்	Nan
gà	கோழி	None
gót	குதிகால்	Nan
gõ	வகை	None
göbbels	göbbels	Nan
găm	பதுக்கல்	Nan
gắn	ஏற்றப்பட்டது	Nan
gắm	குசு	Nan
gậy	குச்சி	Nan
gập	மடி	Nan
gẫy	உடைந்த	Nan
gầy	மெல்லிய	None
gần	அருகில்	None
gấu	கரடி	Nan
gấp	அவசரம்	Nan
hô	ஹோ	Nan
gấm	ப்ரோகேட்	Nan
gảy	உடைக்க	Nan
gả	திருமணம்	None
gạt	அகற்றி	None
gạo	அரிசி	None
gạc	துணி	None
gương	கண்ணாடி	None
gươm	வாள்	None
gũi	நெருக்கமான	None
găng	கையுறைகள்	Nan
gấc	கேக்	Nan
hôi	தவறான	None
hôm	நாள்	None
hôn	முத்தம்	Nan
kashmir	காஷ்மீர்	None
karim	கரீம்	Nan
karen	கரேன்	Nan
karatedo	karatedo	Nan
karate	கராத்தே	Nan
karaoke	கரோக்கி	Nan
kara	காரா	Nan
kar	கர்	Nan
kant	காந்த்	Nan
kanji	காஞ்சி	None
kangin	காங்கின்	Nan
kana	கானா	Nan
kampuchea	kampuchea	Nan
kampong	கம்போங்	Nan
kampf	kampf	Nan
kamov	காமோவ்	Nan
kamakura	காமகுரா	Nan
kama	காமா	Nan
kali	பொட்டாசியம்	Nan
kaspersky	காஸ்பர்ஸ்கி	Nan
kalashnikov	kalashnikov	Nan
katakana	கட்டகனா	Nan
katherine	கேத்ரின்	Nan
kentucky	kentucky	Nan
kenny	கென்னி	Nan
kenneth	கென்னத்	Nan
kennedy	கென்னடி	Nan
ken	கென்	Nan
kem	கிரீம்	Nan
kelvin	கெல்வின்	Nan
kelsi	kelsi	Nan
kelly	கெல்லி	Nan
ke	கே	None
kcn	kcn	Nan
kazan	kazan	Nan
kay	கே	None
kawasaki	kawasaki	Nan
kavkaz	காகசஸ்	Nan
kauthara	க ut தாரா	Nan
katz	காட்ஸ்	Nan
katrina	கத்ரீனா	Nan
kathmandu	காத்மாண்டு	Nan
kate	கேட்	Nan
kepler	கெப்லர்	Nan
kaká	kaká	Nan
kai	கை	None
joint	கூட்டு	None
johor	johor	Nan
johnston	ஜான்ஸ்டன்	Nan
johns	ஜான்ஸ்	Nan
johnny	ஜானி	Nan
johannesburg	ஜோகன்னஸ்பர்க்	Nan
johannes	ஜோஹன்னஸ்	Nan
johann	ஜோஹான்	Nan
johan	ஜோஹன்	Nan
joe	ஓஹோ	Nan
joan	ஜோன்	Nan
joachim	joachim	Nan
jiraiya	ஜிரையா	Nan
jing	ஜிங்	Nan
jin	ஜின்	Nan
jimmy	ஜிம்மி	Nan
jiao	ஜியாவோ	Nan
jewish	நகை	None
jetstar	ஜெட்ஸ்டார்	Nan
jonathan	ஜொனாதன்	Nan
kakashi	ககாஷி	Nan
jones	ஜோன்ஸ்	Nan
joseon	ஜோசான்	Nan
kahn	கான்	None
kagome	ககோம்	Nan
kaffee	காஃபி	Nan
kaede	kaede	Nan
k	கே	None
juventus	ஜுவென்டஸ்	Nan
jura	ஜூரா	Nan
jupiter	வியாழன்	None
junsu	junsu	Nan
jung	ஜங்	Nan
june	ஜூன்	None
jump	குதி	Nan
julliard	ஜல்லியார்ட்	Nan
julesverne	julesverne	Nan
judo	ஜூடோ	Nan
judith	ஜூடித்	Nan
juche	juche	Nan
jscript	jscript	Nan
joseph	ஜோசப்	None
jose	jose	Nan
kerala	kerala	Nan
kevin	கெவின்	Nan
keynes	கீன்கள்	Nan
khánh	சுதந்திரம்	None
kháng	எதிர்ப்பு	None
khán	பார்வையாளர்கள்	Nan
khám	தேர்வு	Nan
khái	கருத்துரு	None
khách	விருந்தினர்	Nan
khác	மற்றவை	None
khá	மாறாக	None
khuỷu	முழங்கை	Nan
khuếch	பெருக்க	Nan
khuẩn	பாக்டீரியா	None
khuấy	அசை	Nan
khuất	மறைக்கப்பட்டுள்ளது	Nan
khuyển	நாய்	None
khuyết	குறைபாடு	None
khuyên	ஆலோசனை	None
khuynh	இடது	None
khural	குரல்	None
khung	பிரேம்கள்	Nan
khát	தாகம்	Nan
khu	காலாண்டுகளில்	Nan
khâm	காம்	Nan
khéo	தனித்துவமானது	Nan
khước	மறுக்க	Nan
khưu	khưu	Nan
khư	கோ	Nan
khơi	கடல்	None
khăn	துண்டு	None
khăm	துர்நாற்றம் வீசுகிறது	Nan
khúc	பிரிவு	None
không	இல்லை	None
khôn	பாண்டித்தியம்	Nan
khô	உலர்ந்த	Nan
khóm	அன்னாசி	Nan
khói	புகை	None
khóc	கலங்குவது	Nan
khóa	பூட்டு	Nan
khó	கடினம்	None
khít	நெருக்கமான	None
khích	ஊக்குவிக்கவும்	Nan
khía	உச்சநிலை	Nan
khép	நெருக்கமான	None
khèn	ஐயோ	Nan
khrushchyov	khrushchyov	Nan
khrushchev	க்ருஷ்சேவ்	Nan
khoẻ	நன்றாக இருக்கிறது	Nan
khiên	கவசம்	Nan
khiêm	சாதாரண	None
khieu	புரியவில்லை	Nan
khi	எப்பொழுது	Nan
kheo	ஸ்டில்ட்களில்	Nan
khen	புகழ்	None
khem	கெம்	Nan
khe	ஸ்லாட்	Nan
khay	தட்டு	None
khao	ஏங்குதல்	Nan
khanh	khanh	Nan
khang	காங்	Nan
khan	நீரிழிவு	None
kham	காம்	Nan
khalip	காலிப்	Nan
khali	காளி	Nan
khai	அறிவிப்பு	None
kha	கா	None
kg	கிலோ	None
khiêu	சிற்றின்பம்	Nan
khiếm	பலவீனமான	Nan
khiến	காரணம்	Nan
khiếp	பயந்துபோனது	Nan
khoảnh	தருணங்கள்	Nan
khoảng	தோராயமாக	None
khoản	பொருள்	None
khoả	நிர்வாணமாக	Nan
khoăn	fret	Nan
khoét	வெட்டு	None
khoát	உறுதியான	Nan
khoáng	தாது	None
khoán	பங்கு	None
jesus	கிறிஸ்தவ சமயத்தை தோற்றுவித்தவர்	Nan
khoác	ஓவர் கோட்	Nan
khoe	காட்டும்	None
khoanh	மோதிரம்	Nan
khoang	குழி	Nan
khoan	துரப்பணம்	Nan
khoa	ஆசிரிய	Nan
kho	கிடங்கு	Nan
khleang	khleang	Nan
khiển	கட்டுப்பாடு	None
khiếu	லாட்ஜ்	Nan
khoá	பூட்டு	Nan
khải	வெளிப்பாடு	None
jesse	ஜெஸ்ஸி	Nan
jersey	ஜெர்சி	Nan
hồ	ஏரி	None
hốc	முக்கிய இடங்கள்	Nan
hố	குழி	Nan
hỏng	உடைந்த	Nan
hỏa	தீ	None
họp	சந்தித்தல்	Nan
họng	தொண்டை	Nan
học	அறிய	None
họach	திட்டம்	None
họa	கலை	None
họ	குடும்ப பெயர்	Nan
hịch	துட்	Nan
hỉ	அடி	None
hệt	ஒத்த	None
hệ	அமைப்பு	None
hễ	eh	Nan
hề	கோமாளி	Nan
hết	ஓவர்	Nan
hến	மஸ்ஸல்ஸ்	Nan
hồi	சோம்பு	Nan
hẻo	ஒதுங்கிய	Nan
hồn	ஆன்மா	None
hổi	ஹு	Nan
hửu	ஹூ	Nan
hử	ஹூ	Nan
hứa	வாக்குறுதி	Nan
hủy	ரத்துசெய்	Nan
hủi	தொழுநோயாளி	Nan
hụt	பற்றாக்குறை	None
hợpquận	சம்மதம்	Nan
hợp	மிகவும் பொருத்தமானது	Nan
hợi	பன்றி	None
hỡi	ஓய்	Nan
hở	திறந்த	None
hờn	sulky	Nan
hớn	கத்தினான்	Nan
hới	திறந்த	None
hộp	பெட்டி	None
hội	திருவிழா	None
hỗn	கலப்பு	None
hỗ	ஆதரவு	None
hổng	இடைவெளி	None
hổ	புலி	None
hữu	சொத்து	None
hẻm	சந்து	Nan
hẹ	ஆழமற்ற	Nan
hưởng	மகிழுங்கள்	Nan
hường	ஹுவாங்	Nan
hướng	திசையில்	None
hước	நகைச்சுவையான	Nan
hương	தூப	Nan
hưu	ஓய்வு பெற்றவர்	Nan
hư	மோசமான	None
hơn	விட	None
hơi	கொஞ்சம்	Nan
hũ	ஜாடிகளை	Nan
hđh	hh	Nan
hđbt	hđbt	Nan
hăng	கடுமையான	None
hút	புகைத்தல்	Nan
húng	உத்வேகம்	Nan
húc	கோர்	Nan
hùng	ஹீரோக்கள்	Nan
hù	பயம்	Nan
hông	இடுப்பு	Nan
hạ	கோடை	None
hẹp	குறுகிய	Nan
hạc	ஃபிளமிங்கோக்கள்	Nan
hại	தீங்கு	None
hặc	hặc	Nan
hằng	மாறிலி	None
hắt	தும்மல்	Nan
hắn	அவரை	None
hắc	கருப்பு	None
hậu	ராணி	None
hận	வெறுப்பு	Nan
hầu	கிட்டத்தட்ட	None
hầm	சுரங்கம்	None
hấu	தர்பூசணி	Nan
hất	எறிதல்	Nan
hấn	ஹான்	Nan
hảo	சரியானது	Nan
hải	சுங்க	Nan
hạt	விதை	None
hạp	ஹாப்	Nan
hạo	ஹாவோ	Nan
hạnh	ஹன்	Nan
hạng	வர்க்கம்	None
hạch	கேங்க்லியன்	Nan
hựu	ஹு	Nan
hỷ	ஹை	Nan
ian	ian	Nan
jae	ஜே	None
jacob	ஜாகோப்	Nan
jackson	ஜாக்சன்	None
jackie	ஜாக்கி	Nan
jack	பலா	Nan
j	j	Nan
iwami	iwami	Nan
iv	iv	Nan
itzá	itzá	Nan
itu	itu	Nan
itsukushima	itukushima	Nan
ito	ito	Nan
itanium	இட்டானியம்	Nan
italiano	இத்தாலியன்	None
italia	இத்தாலியா	Nan
istanbul	இஸ்தான்புல்	Nan
israeli	இஸ்ரேலி	Nan
islamabad	இஸ்லாமாபாத்	Nan
islam	இஸ்லாம்	None
jakarta	ஜகார்த்தா	Nan
isla	இஸ்லா	Nan
jan	ஜான்	None
janet	ஜேனட்	Nan
jerry	ஜெர்ரி	Nan
jerome	ஜெரோம்	Nan
jericho	ஜெரிகோ	Nan
jenny	ஜென்னி	Nan
jenda	ஜெண்டா	Nan
jeju	jeju	Nan
jeffrey	ஜெஃப்ரி	Nan
jefferson	ஜெஃபர்சன்	Nan
jeff	ஜெஃப்	Nan
jeet	ஜீட்	Nan
jeans	ஜீன்ஸ்	Nan
jeanpaul	ஜீன்பால்	Nan
jeanjacques	jeanjacques	Nan
jeane	ஜீன்	None
jean	ஜீன்	None
jasper	ஜாஸ்பர்	Nan
jarvis	ஜார்விஸ்	Nan
jared	ஜாரெட்	Nan
japan	ஜப்பான்	None
janeiro	ஜானிரோ	Nan
isaac	isaac	Nan
irving	irving	Nan
irony	முரண்	Nan
impact	தாக்கம்	None
immanuel	இம்மானுவேல்	Nan
imbrium	imbrium	Nan
imam	இமாம்	Nan
im	im	Nan
ilyich	ilyich	Nan
illusion	மாயை	Nan
ilene	ilene	Nan
iii	iii	Nan
igor	igor	Nan
ieng	ieng	Nan
ide	ஐடி	Nan
iceland	ஐஸ்லாந்து	Nan
icc	icc	Nan
ic	ஓ அப்படியா	Nan
ibmpc	ibmpc	Nan
ibm	ibm	Nan
iberia	ஐபீரியா	Nan
iau	iau	Nan
incoterm	incoterm	Nan
incoterms	incoterms	Nan
indian	இந்தியன்	None
indiana	இந்தியானா	Nan
irgun	irgun	Nan
ireland	ireland	Nan
iraq	ஈராக்	None
iran	iran	Nan
iosif	iosif	Nan
ion	அயன்	Nan
ioc	ioc	Nan
io	io	Nan
inư	inu	Nan
jerusalem	ஏருசலேம்	Nan
inuyasha	inuyasha	Nan
interpol	இன்டர்போல்	Nan
intel	இன்டெல்	Nan
int	எண்ணாக	Nan
insulin	இன்சுலின்	None
innsbruck	innsbruck	Nan
info	தகவல்	None
indrapura	இந்திரபுரா	Nan
indonesia	இந்தோனேசியா	None
indochina	இந்தோசினா	Nan
inu	inu	Nan
≠	≠	Nan
