$ tỉ	мільярд доларів	Nan
rico	ріко	Nan
richie	richie	Nan
richardson	річардсон	Nan
richard	річард	None
ricci	ричі	Nan
ricardo	рікардо	Nan
rica	ріка	Nan
rhodes	родос	Nan
rfid	rfid	Nan
rey	рей	Nan
revolution	революція	None
reverse	зворотний	Nan
resort	курорт	None
reserve	резерв	Nan
reo	каблучка	Nan
rené	rené	Nan
renault	renault	Nan
renaissance	відродження	None
ren	мереживо	Nan
riemann	ріман	Nan
reichelt	рейхельт	Nan
rimjob	римбоф	Nan
rising	піднімається	Nan
rodríguez	rodríguez	Nan
roddick	родік	Nan
rockefeller	рокфеллер	None
robinson	робінзон	Nan
robin	робін	Nan
robespierre	robespierre	Nan
roberts	робертс	Nan
roberto	роберто	Nan
robert	роберт	None
ro	ro	Nan
riềng	галангал	Nan
riết	ріет	Nan
riêu	riêu	Nan
riêng	приватний	None
rizal	ризал	Nan
rivière	rivière	Nan
rivaldo	rivaldo	Nan
ritchie	ритчі	Nan
risk	ризик	Nan
rin	рин	Nan
roi	стрижень	Nan
regia	регія	Nan
reap	пожинати	Nan
ralph	ralph	Nan
raleigh	релі	Nan
rai	рай	None
rafale	rafale	Nan
rafael	рафаель	Nan
race	гонка	Nan
rabindranath	рабіндранат	Nan
r	r	Nan
qúy	чверть	None
quỹ	фонд	None
quỷ	диявол	Nan
quỵ	інсульт	Nan
quỳnh	quỳnh	Nan
quỳ	на коліна	Nan
quỉ	диявол	Nan
quệ	бідний	Nan
quết	негідність	Nan
quế	кориця	Nan
quẻ	гексаграма	Nan
ram	озп	Nan
reef	риф	Nan
rama	рама	Nan
ramayana	рамаяна	Nan
reanimation	реанімація	Nan
real	справжній	None
reagan	реаган	Nan
rađa	рлс	Nan
raymond	раймонд	Nan
raya	рая	Nan
ray	промінь	Nan
rau	овочевий	Nan
rate	ставка	None
raptor	грабіжник	Nan
rap	реп	Nan
rao	оголошення	None
ranh	межа	None
rangers	рейнджери	Nan
rang	задзвонив	Nan
randy	ренді	Nan
ranch	ранчо	Nan
ran	побіг	Nan
rambus	рамбус	Nan
ramadan	рамадан	Nan
quặng	руда	None
roland	роланд	Nan
rome	рим	None
rò	протікання	Nan
rít	шипіння	Nan
rìu	сокира	Nan
rình	шпигун	Nan
rìa	край	None
rì	шепіт	Nan
rêu	мох	Nan
rên	примхнути	Nan
rê	перетягнути	Nan
rét	холод	Nan
république	république	Nan
ré	скрип	Nan
rèn	кування	Nan
rèm	завіса	Nan
räikkönen	räikkönen	Nan
rãnh	траншея	Nan
rãi	бруківка	Nan
rã	розпад	None
râu	борода	Nan
ròng	сітка	Nan
râm	тінистий	Nan
rót	обливання	Nan
rôbôt	робот	Nan
rượu	алкоголь	Nan
rượt	погони	Nan
rưỡi	половина	None
rưới	посипати	Nan
rước	процесія	Nan
rươi	тобі	None
rơm	соломи	Nan
rơi	падіння	None
rơ	автомобіль	Nan
rũ	спокусливий	Nan
rōmaji	rōmaji	Nan
răng	зуб	Nan
răn	заповідь	Nan
rút	вивести	Nan
rùng	моторошно	Nan
rùa	черепаха	Nan
rõ	ясний	Nan
rông	порожнистий	Nan
rôma	рим	None
rô	картатий	Nan
romania	румунія	None
ráp	складання	None
rái	видра	Nan
rulin	рулін	Nan
rue	рута	Nan
rudolph	рудольф	Nan
rtp	rtp	Nan
rpd	rpd	Nan
roy	рой	Nan
rowling	сварки	Nan
rovers	роверів	Nan
router	маршрутизатор	Nan
rousseau	розо	None
rotterdam	роттердам	Nan
roth	рота	Nan
rosen	троянди	Nan
rong	водорості	None
ronaldinho	роналдіньо	Nan
ronald	рональд	Nan
ron	ron	Nan
rommel	ромел	Nan
romeo	ромео	Nan
rumani	румунська	Nan
rán	смажити	Nan
rumiko	руміко	Nan
run	бігати	Nan
rách	рваний	Nan
rác	сміття	Nan
rào	паркан	Nan
rành	вільно володіє	Nan
ràng	ясний	Nan
rà	перевіряти	Nan
rzeczpospolita	rzeczpospolita	Nan
ruột	кишечник	Nan
ruộng	рисове поле	Nan
ruổi	руї	Nan
ruồi	мухи	Nan
ruốc	креветки	Nan
ruud	ruud	Nan
rutte	rutte	Nan
rutherford	резерфорд	Nan
ruth	рут	Nan
russkaya	руська	None
russian	російський	None
rung	вібрувати	Nan
rummel	рум’яна	Nan
quặc	дивно	None
quẳng	кидати	Nan
quật	розкопки	None
plan	план	None
plaaf	плато	None
pius	пій	Nan
pitch	крок	None
piston	поршень	Nan
pisa	писар	Nan
pipes	труби	Nan
pioneer	піонер	Nan
pinlus	прищіпка	Nan
pin	акумулятор	Nan
pike	щука	Nan
pietro	піетро	Nan
pierrot	п’єро	Nan
pierre	пристань	Nan
piccolo	пікколо	Nan
picchu	пікчу	Nan
phức	складний	None
phủ	вкриті	None
phụt	слойки	Nan
plasma	плазма	Nan
phụng	служити	None
plate	тарілка	Nan
platon	платон	None
porto	порто	Nan
portland	портленд	Nan
pop	поп	Nan
pont	понт	Nan
polynésie	полінезія	Nan
polo	поло	Nan
pollux	поллукс	Nan
pollack	минтай	Nan
poland	польща	None
pol	поль	None
pokémon	покемон	Nan
po	по	None
pmu	пму	Nan
pm	вечора	Nan
pluto	плуто	Nan
plus	плюс	None
pleistocen	плейстоцен	Nan
pleiku	плейку	Nan
player	гравець	Nan
plato	платон	None
pot	горщик	None
phục	одяг	None
phới	плавати	Nan
phả	родовід	None
phạt	карати	Nan
phạn	санскрит	Nan
phượng	фенікс	Nan
phường	уорд	Nan
phước	благословення	Nan
phương	пхуонг	Nan
phăng	фанг	Nan
phăn	лада	Nan
phút	хвилина	None
phúng	жалість	Nan
phún	шишка	Nan
phúclộc	благословення	Nan
phúc	благословенний	Nan
phùng	слойки	Nan
phông	шрифт	Nan
phôi	ембріон	Nan
phô	місто	None
phóng	запуск	Nan
phải	правильно	None
phở	суп з локшиною	Nan
phải 	правильно	Nan
phảng	квартира	Nan
phộng	арахіс	Nan
phổi	легеня	Nan
phổ	спектр	None
phồng	надутий	Nan
phốt	фосфат	Nan
phối	координувати	Nan
phố	місто	None
phỏng	спалити	Nan
phỉ	ліщина	Nan
phết	поширення	None
phế	лом	Nan
phẳng	площині	Nan
phật	будда	Nan
phận	доля	None
phẫu	хірургія	Nan
phẫn	обурений	Nan
phẩy	кома	Nan
phẩm	продукція	None
phần	частина	None
phản	лічильник	Nan
potsdam	потсдам	Nan
potter	гончар	Nan
pour	налити	Nan
quáng	сліпий	Nan
quán	бар	Nan
quái	хек	Nan
quá	теж	None
quyệt	підступний	Nan
quyện	змішуватися	Nan
quyền	дозвіл	None
quyến	чарівність	Nan
quyên	основи	None
quy	правила	None
quran	коран	None
quincy	квінті	Nan
qui	qui	Nan
quen	знайомий	Nan
queensland	queensland	Nan
queens	королеви	Nan
queen	королева	Nan
que	прути	Nan
quay	обернувся	Nan
quát	- кричав	Nan
quanh	навколо	None
quân	quan	Nan
quét	сканувати	Nan
quận	район	None
quẫn	жалюгідний	Nan
quẩy	гойдалки	Nan
quầy	лічильник	Nan
quầng	ореол	Nan
quần	брюки	Nan
quấy	розмішати	Nan
quất	кумкват	Nan
quấn	обернути	Nan
quảng	промо	Nan
quản	управління	None
quạt	вентилятор	Nan
quạ	ворони	Nan
quĩ	фонд	None
quăng	кидати	Nan
quýt	мандарин	Nan
quý	дорогоцінний	Nan
quên	забути	Nan
quê	село	None
quãng	бл	None
quang	оптичний	Nan
quan	quan	Nan
quad	квадроцикл	Nan
prôtêin	білка	None
protein	білка	None
prometheus	прометеус	Nan
projekt	проект	None
procellarum	procellarum	Nan
prix	прі	Nan
prinz	принц	Nan
printf	printf	Nan
printemps	принтемпи	Nan
princeton	прінстон	Nan
prince	князя	None
preston	престон	Nan
preminger	премінгер	Nan
premier	прем’єр	Nan
preah	преах	Nan
pratzen	пратцен	Nan
praha	праха	Nan
pradesh	прадеш	Nan
powell	powell	Nan
ps	пс	Nan
psv	psv	Nan
ptolemy	птолемей	Nan
ptq	ptq	Nan
qua	від	None
qlvnch	qlvnch	Nan
qing	цин	Nan
qd	qd	Nan
qatar	катар	Nan
q	q	Nan
pơ	пơ	Nan
păng	панг	Nan
pérez	pérez	Nan
rạ	солодка	Nan
péc	печ	Nan
pytago	пітаго	Nan
pyrenees	піренеї	Nan
putin	путін	Nan
pusan	пузан	Nan
punjab	пенджаб	Nan
pulp	м’якоть	Nan
pulitzer	пуліцер	Nan
pulau	пулау	Nan
puerto	пуерто	Nan
pzl	pzl	Nan
rạc	дискретний	Nan
rạch	канал	None
rạng	світанок	Nan
storting	зберігання	None
stones	каміння	None
stockholm	стокгольм	Nan
stimson	stimson	Nan
stf	stf	Nan
stewarthannah	stewarthannah	Nan
stevie	стіві	Nan
stevenson	стівенсон	Nan
stevens	стівенс	Nan
steve	steve	Nan
sterling	стерлінгів	Nan
stephenie	стефані	Nan
stephen	стефан	None
stennis	stennis	Nan
stelzer	stelzer	Nan
steiner	стейнер	Nan
steiermark	steiermark	Nan
stefan	стефан	None
stdc	stdc	Nan
strasberg	страсберг	Nan
status	статус	None
strauss	стросс	Nan
struct	структура	None
sun	сонце	None
summerslam	літо	None
summer	літо	None
sumitomo	сумітомо	Nan
sumatra	сумара	Nan
sumatera	sumatera	Nan
sum	сума	None
sulu	сулу	Nan
sulfua	сульфідний	Nan
sukarno	sukarno	Nan
suharto	сухарто	Nan
suez	суез	Nan
subakhi	субахі	Nan
su	су	Nan
stéfano	стефано	Nan
styx	стикс	Nan
stuttgart	штутгарт	Nan
stuart	стюарт	Nan
stt	стт	Nan
street	вулиця	None
sunday	неділя	Nan
startin	старт	Nan
stanley	стенлі	Nan
sonata	соната	Nan
somme	сомме	Nan
som	сом	Nan
solaris	соняш	Nan
soi	так я	Nan
soho	сохо	Nan
sohee	соє	Nan
socrates	сократ	None
société	société	Nan
so	так	None
smithsonian	кузня	None
smith	коваль	None
smg	смг	Nan
sm	см	Nan
slytherin	слізерин	Nan
slavơ	слав	Nan
slav	слав	Nan
sl	сл	Nan
skyteam	skyteam	Nan
song	пісня	None
starr	зір	Nan
sony	соні	Nan
sophie	софі	Nan
stanford	стенфорд	Nan
stand	стояти	Nan
stamford	стемфорд	Nan
stalingrad	сталінград	Nan
st	вул	None
ss	сс	None
sri	шрі	Nan
sports	спорт	None
spielberg	spielberg	Nan
spencer	спенсер	Nan
spence	спенс	Nan
spellman	заклинатель	Nan
spears	списи	Nan
soạn	композитор	None
soát	контроль	None
soul	душа	None
sos	сос	Nan
sorbonne	сорбонна	Nan
sopwith	sopwith	Nan
soo	су	Nan
sung	інжир	Nan
sunni	sunni	Nan
sunsilk	сонце	None
súp	суп	Nan
súng	гармати	Nan
sún	раковина	Nan
súc	великої рогатої худоби	Nan
sú	чорний тигр	Nan
sùng	відданість	Nan
sông	річка	None
sôi	кипіння	Nan
sô	число	None
sót	упущення	Nan
sóng	хвиля	None
sói	вовк	Nan
sóc	білка	None
sòng	казино	Nan
sò	молюск	Nan
sít	тісний	Nan
síp	кіпр	Nan
sính	студент	Nan
sêu	мох	Nan
sút	постріл	Nan
sêri	серія	None
săn	полювати	Nan
sư	професор	Nan
sẩn	папули	Nan
sầu	меланхолія	Nan
sầm	грюкає	Nan
sấy	сушіння	Nan
sấu	крокодила	Nan
sấm	грім	None
sảnh	зал	None
sảng	свіжий	Nan
sản	виробництво	None
sảm	яскравий	Nan
sạn	готель	None
sạch	чистий	None
sưởi	опалення	Nan
sườn	сторона	None
sướng	щасливий	Nan
sương	роса	None
sưu	колекціонування	Nan
sưng	набряк	Nan
sưa	молоко	Nan
sơn	фарба	Nan
sê	se	Nan
sét	освітлення	None
são	сао	Nan
sy	си	Nan
sweet	солодкий	Nan
swaziland	свазіленд	Nan
swan	лебедя	Nan
svd	svd	Nan
suồng	гладкий	Nan
suốt	на всьому протязі	Nan
suối	опалення	Nan
suất	продуктивність	None
suôn	плавно	Nan
suê	так	None
suy	невдача	Nan
suvp	супп	Nan
suub	суб	Nan
sutra	сутра	Nan
susilo	susilo	Nan
susan	сьюзан	Nan
suriname	сурінам	Nan
super	супер	Nan
sydney	сідней	Nan
symantec	symantec	Nan
sync	синхронізація	Nan
syria	сирія	Nan
sãi	неправильно	Nan
sã	sã	Nan
sâu	глибокий	None
sân	двір	None
sâm	женьшень	Nan
sáu	шість	None
sát	закрити	Nan
sáp	віск	Nan
sáo	флейта	Nan
skype	скайп	Nan
sánh	порівняльний	Nan
sám	кається	Nan
sái	неправильно	Nan
sách	книга	None
sá	сипункул	Nan
sào	полюс	Nan
sành	теракота	Nan
sàng	решето	Nan
sàn	підлогу	Nan
sài	сай	Nan
sáng	сяючий	Nan
phó	заступник	None
sky	небо	None
siêu	супер	Nan
samoa	самоа	Nan
samo	само	None
samhain	самхаїн	Nan
salzburg	зальцбург	Nan
salvador	сальвадор	Nan
salem	салем	Nan
sakura	сакура	Nan
saintdenis	saintdenis	Nan
saigon	сайгон	Nan
sai	неправильно	Nan
sahara	сахара	Nan
safin	сафін	Nan
safari	сафарі	Nan
saddam	саддам	Nan
sachsen	sachsen	Nan
sabah	сабах	Nan
sa	sa	Nan
rữa	мити	Nan
rửa	мити	Nan
samphan	самфан	Nan
rừng	ліс	None
samsung	samsung	Nan
samuelson	самуельсон	Nan
sardinia	сардінія	Nan
sarcoma	саркома	Nan
sarawak	саравак	Nan
sarah	сара	Nan
sar	сар	Nan
sapiens	sapiens	Nan
sapa	сапа	Nan
sap	сок	Nan
sao	зірка	None
santos	santos	Nan
sanktpeterburg	санктпетербург	None
sanh	народження	None
sangraal	sangraal	Nan
sango	санго	Nan
sang	до	None
sanchez	санчез	Nan
san	сан	None
samut	самут	Nan
samurai	самурай	Nan
samuel	самуїл	Nan
sary	сарі	Nan
rứa	rứa	Nan
rủ	запросити	Nan
rễ	коріння	None
rể	зять	Nan
rền	стогін	Nan
rẽ	черга	Nan
rẻ	дешево	Nan
rặng	скеля	Nan
rằng	що	None
rằm	повний місяць	Nan
rắn	змія	Nan
rắc	посипати	Nan
rập	арабські	Nan
rậm	кущистий	Nan
rẫy	вирощування	None
rầu	сумно	Nan
rầm	косяк	Nan
rất	дуже	None
rảnh	безкоштовно	Nan
rải	розкидані	Nan
rạp	театри	Nan
rệp	помилка	Nan
rủi	неузгодженість	Nan
rệt	яскраво виражений	Nan
rỉ	іржа	Nan
rụng	сарай	Nan
rợn	моторошно	Nan
rợ	варвари	Nan
rỡ	блискучий	Nan
rời	зліва	None
rớt	падіння	None
rộng	широкий	None
rộn	зайнято	Nan
rộ	метушня	Nan
rỗng	порожнистий	Nan
rỗi	безкоштовно	Nan
rổ	кошик	Nan
rồng	дракона	Nan
rồi	вже	None
rồ	божевільний	Nan
rốm	хмарно	Nan
rối	заплутаний	Nan
rỏ	ясний	Nan
rịavũng	rìvà	Nan
rệu	ага	Nan
saturanga	сатуранга	Nan
saturday	субота	Nan
sau	після	None
siberi	сибері	Nan
shōnen	шōнен	Nan
showcase	вітрина	Nan
short	короткий	None
shop	магазин	Nan
shonen	шонен	Nan
shoal	косяк	Nan
shiva	шива	Nan
shirakawago	ширакаваго	Nan
shirakami	ширакамі	Nan
shinoda	шинода	Nan
shinichi	шиничі	Nan
shikoku	шикоку	Nan
shiite	шиїт	Nan
shia	шиї	Nan
shi	ши	Nan
sherlock	шерлок	Nan
shawn	шон	Nan
sharpay	sharay	Nan
sicilia	сицилія	Nan
shaolin	шаолін	Nan
sicily	сицилія	Nan
siem	сіем	Nan
siu	сиу	Nan
sistema	система	None
sirô	сироп	Nan
sip	ковток	Nan
sinh	народився	None
sing	співати	Nan
sinensis	sinensis	Nan
sinai	sinai	Nan
simone	simone	Nan
silvestris	silvestris	Nan
silva	сильва	Nan
silicat	силікат	Nan
silic	кремній	Nan
silesia	силезія	Nan
silas	силос	Nan
sikorsky	сикорський	Nan
sikh	сикх	Nan
sierra	сьєрра	Nan
siemens	сімен	Nan
sidney	сідней	Nan
shankly	хитко	Nan
shane	шейн	Nan
shan	шань	Nan
sdram	sdram	Nan
scuderia	scuderia	Nan
scud	шахрайство	Nan
scream	кричати	Nan
scott	скотт	Nan
scots	шотландці	Nan
scotland	шотландія	Nan
schwarzschild	шварцшильд	Nan
schuster	шустер	Nan
schuschnigg	schuschnigg	Nan
schumacher	шумахер	Nan
schneider	шнайдер	Nan
schlesinger	шлезінгер	Nan
schiller	шилер	Nan
schengen	шенген	Nan
schafer	schafer	Nan
scandinavia	скандинавії	Nan
saunière	saunière	Nan
saudi	сауді	Nan
search	пошук	None
seattle	ситтл	Nan
secret	секрет	Nan
sedna	седна	Nan
shaman	шаман	Nan
shah	шах	Nan
seyssinquart	seyssinquart	Nan
seymour	сеймур	Nan
sexy	сексуальний	Nan
sextus	секстус	Nan
seto	сето	Nan
seth	сет	Nan
sesshomaru	sesshomaru	Nan
siết	підтягувати	Nan
service	сервіс	Nan
sergeyevich	сергеєвич	Nan
serbia	сербія	None
september	вересень	None
sense	сенс	None
sen	лотос	Nan
semit	напівсит	Nan
selena	селена	Nan
sejm	сейм	None
see	побачити	None
seri	серія	None
sẫm	темний	Nan
phòng	кімната	Nan
phím	ключ	Nan
ngộ	просвітлення	Nan
ngồi	сидіти	Nan
ngọt	солодкий	Nan
ngọn	верх	Nan
ngọc	дорогоцінний камінь	Nan
ngọ	полудень	Nan
ngặt	тісний	Nan
ngắn	короткий	None
ngắm	споглядати	Nan
ngập	затопило	Nan
ngậm	пастилки	Nan
ngẫu	випадкові	Nan
ngẫm	розмірковувати	Nan
ngẩn	ошелешений	Nan
ngần	вагайтесь	Nan
ngầm	неявна	Nan
ngất	непритомний	Nan
ngấm	настоюється	Nan
ngạt	асфіксія	Nan
ngột	різко	None
ngạo	задумливий	Nan
ngớ	дурний	Nan
ngỡ	думка	None
nhakẻ	дитина	None
nha	стоматолог	Nan
ngực	груди	Nan
ngựa	кінь	Nan
ngự	зупинитися	Nan
ngữ	мовлення	None
ngửi	запах	Nan
ngửa	лицьовою стороною вгору	Nan
ngừng	перестати	Nan
ngừa	запобігти	None
ngừ	тунець	Nan
ngứa	сверблячий	Nan
ngủi	короткий	None
ngủ	спати	Nan
ngụy	вей	Nan
ngụm	ковток	Nan
ngục	тюрма	Nan
ngợm	неслухняний	Nan
ngợi	похвала	Nan
ngời	люди	None
nham	лава	Nan
ngạnh	барбуси	Nan
ngạch	звання	None
ngây	порожній	Nan
ngân	банк	None
ngát	непритомність	Nan
ngáng	ngáng	Nan
ngán	нудно	Nan
ngái	дурний	Nan
ngách	ніша	Nan
ngày	день	None
ngào	солодкий	Nan
ngành	відділення	None
ngàng	ngàng	Nan
ngàn	тис	None
ngà	слонова кістка	Nan
nguỵ	дурні	Nan
nguời	люди	None
nguồn	джерело	None
nguôi	заспокійливий	Nan
nguyệt	місяць	None
nguyện	обітниця	Nan
ngãi	нгай	Nan
ngạn	банк	None
ngò	кінза	Nan
ngói	плитка	Nan
ngạc	здивований	Nan
ngược	зворотний	Nan
ngưỡng	поріг	Nan
người	люди	None
ngươi	ти	None
ngưu	ох	Nan
ngưng	стоп	Nan
ngư	рибалка	Nan
ngơi	відпочинок	None
ngơ	ігнорується	Nan
ngũ	спати	Nan
ngăn	купе	Nan
ngút	ngut	Nan
ngùi	запах	Nan
ngõ	провулок	Nan
ngông	гуска	Nan
ngôn	мова	None
ngót	усадка	Nan
ngón	палець	Nan
ngó	погляд	None
nguyền	прокляття	Nan
nhan	nhan	Nan
nhanh	швидко	None
nhẫn	кільця	None
nhầy	стрункий	Nan
nhầm	неправильно	Nan
nhất	найкраще	None
nhấn	пресування	Nan
nhấm	потягуючи	Nan
nhấc	підйом	Nan
nhảy	танцювати	Nan
nhạy	чутливий	Nan
nhạt	блідий	Nan
nhạo	глузуючий	Nan
nhạn	ковтати	Nan
nhạc	музику	None
nhạ	нхạ	Nan
nhượng	поступки	Nan
nhược	слабкість	Nan
nhưỡng	жирний	Nan
nhường	поступився місцем	Nan
nhương	слина	Nan
nhậm	штампований	Nan
nhưng	але	None
nhập	імпорт	None
nhậy	чутливий	Nan
nhỏ|phải|px|cây	невелике | право | px | дерево	Nan
nhỏ|phải|px|bức	маленькі | праві | px | фото	Nan
nhỏ|phải|px|	малий | правий | px |	Nan
nhỏ|phải|	малий | правильний |	Nan
nhỏ|một	малий | один	Nan
nhỏ|cây	невелике | дерево	Nan
nhỏ	малий	None
nhọn	гострий	Nan
nhọ	нещасливий	Nan
nhịn	утримуватися	Nan
nhị	тичинки	Nan
nhẹn	спритний	Nan
nhẹ	світла	None
nhặt	забрати	Nan
nhẵn	гладкий	Nan
nhằm	націлювання	Nan
nhắn	повідомлення	None
nhắm	мета	None
nhắc	підказка	Nan
nhậu	пиття	Nan
nhang	пахощі	Nan
như	як	None
nhũng	корупція	Nan
nhào	замісити	Nan
nhàng	ніжно	Nan
nhàn	простоювати	Nan
nhuộm	барвник	Nan
nhuệ	nhue	Nan
nhuận	прибуток	None
nhu	подібно до	Nan
nhs	нш	Nan
nhk	нхк	Nan
nhiệt	тепло	Nan
nhiệm	мито	Nan
nhiễu	шум	Nan
nhiễm	заражений	Nan
nhiều	багато	None
nhiêu	багато	None
nhiên	звичайно	None
nhi	діти	None
nhen	загорівся	Nan
nhat	nhat	Nan
nhác	млявий	Nan
nhơn	примножувати	Nan
nhái	клони	Nan
nháp	чернетка	Nan
nhũ	емульсія	Nan
nhĩ	передсердні	Nan
nhăn	зморшкуватою	Nan
nhút	сором’язливий	Nan
nhúng	занурити	Nan
nhôm	алюміній	Nan
nhô	виступаючий	Nan
nhóm	групи	None
nhóc	дитина	None
nhòm	погляд	None
nhím	їжак	Nan
nhí	балаканина	Nan
nhìn	погляд	None
nhì	другий	None
nhét	поставити	None
nhãn	етикетка	Nan
nhã	зі смаком	Nan
nhâm	занурення	Nan
nháy	спалахів	Nan
nhánh	відділення	None
nguyên	оригінальний	None
nguyen	nguyen	Nan
ngung	ngung	Nan
mồ	могила	None
mốt	мода	Nan
mối	терміт	Nan
mốc	затхлий	Nan
mỏng	худий	Nan
mỏi	втомився	Nan
mỏ	міни	Nan
mọn	дріб&#39;язковий	Nan
mọi	кожен	None
mọc	росте	None
mịt	нюхати	Nan
mịn	гладкий	Nan
mịch	лайно	Nan
mỉm	посмішку	Nan
mỉa	сарказм	Nan
mỉ	прискіпливий	Nan
mệt	втомився	Nan
mệnh	доля	None
mềm	м’який	Nan
mồi	наживка	Nan
mề	гайдар	Nan
mổ	хірургія	Nan
mộ	гробниця	Nan
na	na	None
mỹcông	америка	None
mỹ	америка	None
mỳ	локшина	Nan
mực	чорнило	Nan
mửa	блювота	Nan
mừng	радий	Nan
mứt	варення	Nan
mức	рівень	None
mụn	прищі	Nan
mục	предмет	None
mỡ	жир	Nan
mở	відчинено	Nan
mời	запросити	Nan
mờ	нечіткий	Nan
mới	нові	None
một	один	None
mộng	мріяти	Nan
mộc	столярні вироби	Nan
mỗi	кожен	None
naadam	наадам	Nan
mến	шановний	Nan
mẻ	партія	None
mả	могили	None
mạt	кліщі	Nan
mạo	стаття	None
mạnh	сильний	None
mạn	сторона	None
mại	торгівля	None
mạch	схема	None
mạc	пустеля	Nan
mượt	гладкий	Nan
mượn	позичити	Nan
mường	muong	Nan
mướt	шовковистий	Nan
mướn	орендна плата	Nan
mương	стік	Nan
mươi	п’ятдесят	Nan
mưu	хитрий	Nan
mưa	дощ	Nan
mơn	лапки	Nan
mơ	мріяти	Nan
mải	зайнято	Nan
mẽ	сильний	None
mảng	масив	None
mất	загублений	Nan
mẹo	поради	Nan
mẹ	мама	Nan
mặt	обличчя	None
mặn	солоний	Nan
mặc	знос	Nan
mắt	око	None
mắng	лаяти	Nan
mắn	пощастило	Nan
mắm	рибний соус	Nan
mắc	дорого	Nan
mậu	торгівля	None
mật	мед	None
mập	жир	Nan
mận	слива	Nan
mẩu	шматки	Nan
mầu	колір	None
mầm	зародок	Nan
mấy	нечисленні	Nan
mấu	вкладка	Nan
mảnh	шматок	Nan
nacional	націонал	Nan
nagant	наган	Nan
nagar	нагар	Nan
nghành	промисловість	None
nghiệt	похмурий	Nan
nghiệp	карма	Nan
nghiện	залежним	Nan
nghiệm	досвід	None
nghiễm	жалість	Nan
nghiền	кабачки	Nan
nghiêu	nghieu	Nan
nghiêng	схильний	Nan
nghiêm	суворо	None
nghinh	nghinh	Nan
nghe	слухати	Nan
ngay	правильно	None
ngao	молюск	Nan
ngang	горизонтальний	Nan
ngai	престол	None
nga	росія	None
next	наступний	None
newtons	ньютонів	Nan
nghèo	бідний	Nan
newton	ньютон	Nan
nghé	nghe	Nan
nghênh	ласкаво просимо	Nan
ngu	спати	Nan
ngoặt	черга	Nan
ngoặc	круглі скобки	Nan
ngoạn	захоплюючи дух	Nan
ngoại	іноземні	None
ngoài	з	None
ngon	смачно	Nan
ngoc	ngoc	Nan
ngoan	хороший хлопець	Nan
ngo	ласий	Nan
nghị	рекомендації	None
nghỉ	відпустка	Nan
nghệquận	мистецтво	None
nghề	професії	Nan
nghếch	голосний	Nan
nghẽn	затори	Nan
nghĩa	засоби	None
nghĩ	думати	Nan
nghìn	тис	None
nghê	nghe	Nan
newspaper	газета	None
newcastle	ньюкасл	Nan
neverland	neverland	Nan
napoli	наполі	Nan
napoleon	наполеон	Nan
naomi	ноомі	Nan
nano	нано	Nan
nanh	ікла	Nan
nang	фолікул	Nan
nancy	живлення	None
namno	намно	Nan
namnam	нам нам	Nan
namibia	намібія	Nan
nambắc	північ	None
nam	самець	Nan
nalbandian	налбандський	Nan
nakajima	nakajima	Nan
nairobi	найробі	Nan
nai	олені	Nan
nagumo	нагумо	Nan
nagoya	нагоя	Nan
nagasaki	нагасакі	Nan
napoléon	napoléon	Nan
nara	нара	Nan
nasa	наса	Nan
nat	фіз	Nan
nevada	невада	Nan
neutrino	нейтрино	Nan
neumann	neumann	Nan
networks	мереж	None
netscape	netscape	Nan
netbook	нетбук	Nan
net	сітка	Nan
nessie	nessie	Nan
nepomuk	непомук	Nan
nhỏ|phải|px|khu	мала | права | px | зона	Nan
nepal	непал	Nan
neo	якір	Nan
nelson	нельсон	Nan
needham	нудхам	Nan
nay	зараз	None
navarre	navarre	Nan
nava	нава	Nan
nauru	науру	Nan
natri	натрію	Nan
nathan	натан	Nan
neon	неонові	Nan
nhỏ|phải|px|michael	маленький | правий | px | michael	Nan
nhỏ|phải|px|máy	мала | права | px | машина	Nan
nhỏ|phải|px|một	малий | правий | px | один	Nan
oxford	оксфорд	Nan
owen	оуен	Nan
outstanding	видатний	None
ottoman	тахта	Nan
otto	отто	Nan
other	інший	None
oswald	oswald	Nan
ossetia	осетія	Nan
ospf	ospf	Nan
osment	осмент	Nan
oslo	осло	Nan
oskar	оскар	Nan
osiris	осіріс	Nan
oscar	оскар	Nan
osamu	вісіму	Nan
osama	осама	Nan
osaka	осака	Nan
os	ос	None
orton	ортон	Nan
oxy	кисень	None
orochimaru	орочімару	Nan
ozawa	озава	Nan
oát	ватт	Nan
paperback	м&#39;яка обкладинка	Nan
paolo	паоло	Nan
panthéon	пантеон	Nan
panthera	пантера	Nan
panduranga	пандуранга	Nan
panamax	панамакс	Nan
panama	панама	Nan
pan	каструля	Nan
pamir	памір	Nan
pali	палі	Nan
palgrave	палграв	Nan
palestine	палестин	Nan
palenque	паленка	Nan
palawan	палаван	Nan
palais	палац	None
pakistan	пакистан	Nan
pailin	пайлін	Nan
paget	paget	Nan
oản	оàn	Nan
oán	обурення	Nan
papua	папуа	Nan
orleans	орлеан	Nan
origin	походження	None
oanh	оан	Nan
oan	несправедливість	Nan
oakland	дуб	None
oai	болісно	Nan
oahu	оаху	Nan
nữa	знову	None
nửa	половина	None
nứt	тріснув	Nan
nứa	пробка	Nan
nụy	маточка	Nan
nợ	в боргу	Nan
nỡ	від душі	Nan
nở	цвітіння	Nan
nới	послабити	Nan
nộp	подано	None
nộn	начинка	Nan
nội	внутрішній	None
nộ	гнів	Nan
nỗi	що	None
obama	обама	None
orion	оріон	Nan
oblast	області	None
october	жовтня	None
oricon	орікон	Nan
organ	орган	None
oprah	опр	Nan
oort	oort	Nan
ontario	онтаріо	Nan
ong	бджола	Nan
omar	омар	Nan
om	тушкований	Nan
olympus	олімп	Nan
olivier	олів’є	Nan
oliver	олівер	Nan
okhotsk	охоцьк	Nan
ohkawa	охкава	Nan
officers	офіцерів	Nan
officer	офіцер	Nan
oecd	oecd	Nan
odyssey	одисея	Nan
oder	одер	Nan
oda	о так	Nan
oc	ок	Nan
paraguay	парагвай	Nan
pari	пари	None
park	парк	None
phu	phu	Nan
phrygian	фригійський	Nan
php	php	Nan
phong	кімната	Nan
phoenix	фенікс	Nan
pho	pho	Nan
phnôm	фом	Nan
phnom	пном	Nan
phiệt	фіет	Nan
phiện	опіум	Nan
phiến	клинок	Nan
phiếm	плітки	Nan
phiêu	пригода	Nan
phiên	сесія	Nan
phineas	фінеї	Nan
phin	фільтр	Nan
phim	фільм	None
philosophiae	philosophiae	Nan
phillips	філіпси	Nan
phui	непокритий	Nan
phillip	філіп	Nan
phun	спрей	Nan
phàm	смертний	Nan
phích	термос	Nan
phía	сторона	None
phí	зарядка	Nan
phình	опуклість	Nan
phì	збільшений	Nan
phêrô	петро	None
phê	отримати високі	Nan
phép	дозволено	Nan
phèo	phèo	Nan
phèn	галиця	Nan
phát	мовлення	None
pháp	франція	None
pháo	гармата	Nan
phán	судити	None
phái	секта	Nan
phách	бити	Nan
phác	ескіз	Nan
phá	ламаючи	Nan
phàn	скаржитися	Nan
phà	пором	Nan
philippines	філіппіни	Nan
philippe	філіпп	Nan
philip	філіп	Nan
pereira	перейра	Nan
penny	копійки	Nan
pennsylvania	пенсільванія	Nan
penh	пенш	Nan
penang	пенанг	Nan
pele	пеле	Nan
peers	однолітки	Nan
pedro	педро	Nan
pdf	pdf	Nan
pda	pda	Nan
pbs	pbs	Nan
pavia	павія	Nan
paulo	пауло	Nan
paula	паула	Nan
paul	paul	Nan
patriot	патріот	Nan
patrick	патрик	Nan
patel	патель	Nan
parton	партон	Nan
perl	перл	Nan
pero	перо	Nan
perry	перрі	Nan
persephone	персефона	Nan
phil	філ	Nan
phen	фен	Nan
phe	фракція	Nan
phay	фрезерування	Nan
pharaon	фараон	None
pharaoh	фараон	None
phaolô	пол	None
phao	плавати	Nan
phanh	гальмо	Nan
nỗ	спроба	None
pham	pham	Nan
pha	змішаний	Nan
pgđ	pgđ	Nan
pgs	pgs	Nan
pfm	pfm	Nan
petersburg	петербург	Nan
peters	петер	Nan
peru	перу	None
persian	персидський	Nan
pershing	персинг	Nan
phaethon	фаетон	Nan
phò	фт	Nan
nổi	плаваючий	Nan
nồng	гарячий	Nan
non	молодий	None
nom	ном	Nan
nol	nol	Nan
nokia	nokia	Nan
noi	сказати	None
noel	ніель	Nan
nobita	nobita	Nan
nobel	нобелів	Nan
noah	ной	Nan
nm	нм	Nan
nlf	nlf	Nan
nj	nj	Nan
niệu	діурез	Nan
niệm	обережність	Nan
niềm	задоволення	None
niết	ніет	Nan
niên	рік	None
nixon	ніксон	Nan
nitơ	азот	None
nonpenetrative	непроникний	Nan
nippon	ніппон	Nan
norfolk	норфолк	Nan
norma	норма	None
nuốt	ковтати	Nan
nuối	ковтати	Nan
nuôi	корм	Nan
nusa	нуса	Nan
nupedia	нупедія	Nan
number	число	None
nubia	нубій	Nan
nst	nst	Nan
nsnd	nsnd	Nan
noãn	яйцеклітина	Nan
nowc	тепер	None
now	зараз	None
novak	нонак	Nan
nou	ноу	Nan
norway	норвегія	None
norton	нортон	Nan
northrop	northrop	Nan
normandie	normandie	Nan
norman	норман	Nan
norge	норж	Nan
nuớc	вода	None
nintendo	nintendo	Nan
nin	дев&#39;ять	Nan
nhủ	нагадування	Nan
nhục	принижений	Nan
nhụ	щіпка	Nan
nhở	нагадати	Nan
nhờn	жирний	Nan
nhờ	дякую	Nan
nhớt	в’язкий	Nan
nhớ	розум	None
nhộn	веселий	Nan
nhổ	вищипувати	Nan
nhồi	опудала	Nan
nhốt	замкнений	Nan
nhỏ|tượng	невеликі статуї	Nan
nhỏ|trái|px|máy	невелика | ліва | px | машина	Nan
nhỏ|quân	мала | сила	Nan
nhỏ|px|phải|kiến	маленький | px | правий | мураха	Nan
nhỏ|px|các	невеликий | px | the	Nan
nhỏ|px|	малий | px |	Nan
nhỏ|phải|px|quân	мала | права | px | сила	Nan
nhức	болить	Nan
ninh	безпека	Nan
nhứt	перший	None
những	ці	None
nimitz	німіц	Nan
nile	ніл	Nan
nil	нуль	Nan
nikolayevich	миколайович	None
nikolai	nikolai	Nan
nikko	нікко	Nan
nikita	нікіта	Nan
niken	нікель	Nan
nikel	нікель	Nan
nigeria	нігерія	Nan
niels	нільс	Nan
nicolas	ніколас	Nan
niccolò	niccolò	Nan
nicaragua	нікарагуа	Nan
nicaea	нікея	Nan
nia	ня	Nan
ni	ni	Nan
nhựt	nhut	Nan
nhựa	пластикові	Nan
nhừ	кашкоподібний	Nan
nxb	nxb	Nan
nynorsk	ньюнорськ	Nan
nà	nà	Nan
nắng	сонячний	Nan
nắm	тримати	None
nập	гарячий	Nan
nậm	нам	None
nẫu	n сонце	Nan
nẩy	підстрибуючи	Nan
nầy	це	None
nần	підштовхувати	Nan
nấy	це	None
nấu	готувати	Nan
nấp	ховатися	Nan
nấc	гикавка	Nan
nảy	підстрибуючи	Nan
nản	зневірився	Nan
nạp	завантажений	Nan
nạo	кюретаж	Nan
nạn	лихо	Nan
nại	скаржитися	Nan
nạc	худий	Nan
nắp	кришка	Nan
nạ	маска	Nan
nằm	брехати	Nan
nặc	анонімно	Nan
nồm	потилиця	Nan
nồi	горщик	None
nốt	примітка	Nan
nối	підключений	Nan
nỏ	арбалет	Nan
nọc	отрута	Nan
nọ	інші	None
nịnh	лестощі	Nan
nỉ	відчував	Nan
nện	стукав	Nan
nể	повага	Nan
nề	кладка	Nan
nếu	якщо	None
nếp	липкий	Nan
nến	свічка	Nan
nếm	смак	Nan
nẻo	інший	None
nặng	важкий	None
nặn	стиснути	Nan
nẵng	нанг	Nan
nǎm	нǎм	Nan
nướng	на грилі	Nan
nước 	країна	Nan
nê	не	None
nét	удари	Nan
nén	стиснута	Nan
ném	кинути	Nan
né	ухилятися	Nan
não	мозок	None
nã	nã	Nan
nâu	коричневий	Nan
nâng	підносити	Nan
náu	ховатися	Nan
nát	подрібнений	Nan
náo	обурювати	Nan
nách	пахви	Nan
ná	нá	Nan
này	це	None
nào	давай	Nan
nành	соя	Nan
nàn	скаржився	Nan
nài	наполягати	Nan
nên	підсвічник	Nan
nêu	скажи	Nan
nòi	гонка	Nan
nòng	бочковий	Nan
nước	країна	None
nơtrino	нейтино	Nan
nơi	місце	None
năng	потужність	None
năn	кається	Nan
năm	рік	None
nút	вузол	None
núp	ховатися	Nan
núm	ручка	Nan
nổ	вибухонебезпечний	Nan
nùng	nung	Nan
nông	неглибокий	Nan
nôn	блювота	Nan
nôm	нм	Nan
nôi	ліжечко	Nan
nôbita	тобіта	Nan
nô	раб	Nan
nóng	гарячий	Nan
nón	шапка	Nan
nói	говорити	None
nõn	лущення	Nan
mũi	ніс	Nan
sập	крах	Nan
sắn	маніока	Nan
wright	райт	Nan
wrestling	боротьба	None
would	би	None
woods	ліси	None
woodrow	дерев	None
wong	вонг	Nan
won	виграв	Nan
wolfgang	вольфганг	Nan
without	без	None
within	всередині	None
wisconsin	вісконсин	Nan
winer	винний	Nan
windows	вікна	None
wimbledon	вімблдон	None
willard	в&#39;ялий	Nan
wiley	хитрий	Nan
wilder	дикіше	Nan
wild	дикий	Nan
wikitravel	wikitravel	Nan
wu	ву	Nan
wikimedia	wikimedia	Nan
wushu	ушу	Nan
xa	далеко	None
xiềng	кайдани	Nan
xiết	підтягувати	Nan
xiếc	цирк	Nan
xiêu	сяо	Nan
xiên	косий	Nan
xiêm	сіамські	Nan
xiv	xiv	None
xinh	гарний	Nan
xin	будь ласка	Nan
xiii	xiii	None
xi	xi	None
xhcn	xhcn	Nan
xen	ксен	Nan
xem	побачити	None
xe	автомобіль	Nan
xay	шліфувати	Nan
xao	в&#39;ялий	Nan
xanh	синій	None
xang	xang	Nan
wwf	wwf	Nan
xo	xo	Nan
wikimapia	вікімапія	Nan
wikia	wikia	Nan
watergate	водяний вогонь	Nan
wat	ват	None
washington	вашингтон	Nan
warszawa	warzawa	Nan
warsaw	бойова пила	Nan
warren	уоррен	Nan
wanna	хочу	None
wankel	wankel	Nan
wang	ван	Nan
wan	вань	Nan
walther	вальтер	Nan
walter	вальтер	Nan
walt	вальт	Nan
wa	ва	Nan
w	ш	Nan
vỹ	так	None
vựng	лексика	None
vực	поле	None
vững	фірма	Nan
waterloo	ватерло	Nan
wikibooks	вікікниги	Nan
waters	води	None
wcdma	wcdma	Nan
wiki	вікі	None
wifi	wifi	Nan
wiener	wiener	Nan
wien	відень	None
widener	ширший	Nan
wheeler	колісний	Nan
westview	westview	Nan
westlife	вестерлайф	Nan
western	західний	None
westermarck	вестермарк	Nan
werner	вернер	Nan
wembley	wembley	Nan
welsh	вал	Nan
wells	колодязі	Nan
wellington	веллінгтон	Nan
weimar	веймар	Nan
webmail	веб-пошти	Nan
weblog	веб-журнал	Nan
weasley	візлі	Nan
wayne	вейн	Nan
vừng	кунжут	Nan
xoa	натерти	Nan
xong	здійснено	None
xăng	бензин	Nan
xăm	татуювання	Nan
xúi	спонукати	Nan
xúc	контактний	Nan
xú	грубий	Nan
xù	розпушений	Nan
xôviết	радянський союз	Nan
xôphần	секція відра	Nan
xông	кинувся	Nan
xôn	розмішати	Nan
xôi	клейкий рис	Nan
xô	засунути	Nan
xót	милосердя	Nan
xóm	сусідів	Nan
xói	ерозія	Nan
xóa	стерти	Nan
xòe	розповсюдження	None
xíu	крихітні	Nan
xít	захоплююче	Nan
xơ	клітковина	Nan
xí	фабрика	None
xưa	старий	None
xương	кістка	Nan
xốp	пінопласт	Nan
xốc	шок	Nan
xỉu	непритомний	Nan
xỉa	нитка	Nan
xỉ	шлаки	Nan
xếp	складений	None
xẻo	нещасливий	Nan
xắt	кубики	Nan
xẩy	трапляються	None
xẩm	волохатий	Nan
xấu	поганий	Nan
xấp	бл	None
xảy	трапляються	None
xảo	хитрий	Nan
xả	розряд	Nan
xạ	випромінювання	None
xưởng	майстерня	Nan
xướng	приспів	Nan
xước	подряпано	Nan
xưng	зізнатися	Nan
xoay	черга	Nan
xìu	пердіти	Nan
xêkô	сунео	Nan
xuồng	каное	Nan
xuống	вниз	Nan
xuấtnhập	експорт-імпорт	Nan
xuất	експорт	None
xuôi	підмітав	Nan
xuâncông	весна	None
xuân	весна	None
xuyến	браслети	Nan
xuyên	пронизливий	Nan
xum	розкішний	Nan
xuka	xuka	Nan
xui	нещасливий	Nan
xuan	сюань	Nan
xua	розвіяти	Nan
xu	монета	None
xoắn	скручений	Nan
xoáy	едді	Nan
xoá	видалити	Nan
xoàng	посередній	Nan
xv	xv	None
xì	пердіти	Nan
xvi	xvi	None
xx	хх	None
xê	рухатися	Nan
xét	розглянути	Nan
xéo	бічний	Nan
xén	обрізання	Nan
xé	рвати	Nan
xèo	xèo	Nan
xãy	непостійний	Nan
xã	комуна	Nan
xây	будувати	None
xâu	рядок	Nan
xâm	татуйовані	Nan
xát	натирання	Nan
xáo	порушення	None
xán	смажена	Nan
xám	сірий	Nan
xách	сумочка	Nan
xào	смажити	Nan
xài	витрачати	Nan
xy	xy	Nan
xvii	xvii	None
vừa	підходить	Nan
vứt	викинути	Nan
vụng	незграбний	Nan
voyager	плавання	None
vong	жертв	None
vonfram	вольфрам	Nan
von	фон	None
voldemort	вольдеморт	Nan
voip	voip	Nan
voi	слони	Nan
vo	во	Nan
vni	vni	Nan
vnexpress	vnexpress	Nan
vn	вн	Nan
việttrung	ветрунг	Nan
việtnga	вьетнга	Nan
việtmường	в’єтнамський муонг	Nan
việt	в&#39;єтнам	Nan
viện	інститут	None
việc	робота	None
viết	писати	None
viếng	візит	Nan
voọc	лангури	Nan
viêt	написання	None
vtc	vtc	Nan
vua	король	None
váng	негідність	Nan
ván	дошка	None
vái	так	None
vách	стіна	Nan
vác	перенесення	None
vá	пластир	Nan
vào	в	None
vành	ободок	Nan
vàng	жовтий	None
vàm	вм	Nan
vài	нечисленні	Nan
và	і	None
vyacheslav	в&#39;ячеслав	Nan
vy	ви	None
vv	тощо.	Nan
vuốt	кігті	Nan
vuông	майдан	None
vulcan	вулкан	Nan
vui	весело	Nan
vu	ву	Nan
váy	сукня	Nan
viêng	viang	Nan
viêm	запалення	Nan
vienna	відень	None
victoria	вікторія	None
victor	переможець	None
viagra	віагра	Nan
vi	тому що	Nan
vhs	вхс	Nan
versailles	універсали	Nan
verona	верона	None
vermont	вермонт	Nan
verdun	вердун	Nan
venus	венера	Nan
venezia	венеція	Nan
vendôme	вендома	Nan
ven	уздовж	None
vectơ	вектор	Nan
vay	позичити	Nan
vasari	вазарі	Nan
vargas	варгази	Nan
vanessa	ванесса	Nan
viet	в’єт	Nan
viên	таблетки	Nan
vietnam	в&#39;єтнам	Nan
viii	viii	None
viz	саме	None
vitruvius	вітрувій	Nan
vitamin	вітамін	Nan
vista	вид	None
vissarionovich	вісаріонович	Nan
virút	вірус	None
virus	вірус	None
virginia	вірджинія	Nan
viqr	viqr	Nan
vinpearl	винпеарл	Nan
vincent	вінсент	Nan
vincennes	вінсенни	Nan
vince	вінс	Nan
vinashin	вінашин	Nan
vinagame	вінегаме	Nan
villeneuve	villeneuve	Nan
villa	вілла	Nan
viking	вікінг	Nan
vijaya	vijaya	Nan
viettel	в&#39;єтель	Nan
vân	так далі	Nan
vây	плавник	Nan
vã	кинувся	Nan
vẹt	папуги	Nan
vẹn	цілісність	Nan
vặt	оголошення	None
vặn	гвинт	Nan
vắng	відсутні	None
vắn	короткий	None
vắcxin	вакцина	Nan
vắc	вакцина	Nan
vận	фортуна	Nan
vẫy	розмахуючи	Nan
vẫn	ще	None
vẩy	пластівці	Nan
vẩn	ще	None
vầng	ореол	Nan
vần	рима	None
vất	викинути	Nan
vấp	споткнувся	Nan
vấn	порада	Nan
vảy	ваги	None
vẽ	живопис	None
vải	тканина	Nan
vết	пластир	Nan
vệ	оборони	None
vụn	фішки	Nan
vợ	дружина	None
vỡ	зламаний	Nan
vở	зошит	Nan
vời	чудовий	Nan
vờ	прикидатися	Nan
vớt	риба	None
với	з	None
vớ	шкарпетки	Nan
vội	поспішайте	Nan
vỗ	погладити	Nan
vồ	маул	Nan
vỏ	кора	Nan
vọt	зліт	Nan
vọng	сподіватися	Nan
vịt	качка	Nan
vịnh	затока	None
vỉa	шви	Nan
vệt	прожилки	Nan
vểnh	окунь	Nan
vả	рис	None
vạng	сутінки	Nan
vạn	десять тисяч	Nan
võ	бойовий	Nan
vôi	вапна	Nan
vô	немає	None
vóc	розмір	None
vó	оооо	Nan
vòng	каблучка	Nan
vòm	дах	Nan
vòi	шланг	Nan
vò	зім&#39;ятий	Nan
vít	гвинт	Nan
vía	гаманець	Nan
ví	гаманець	Nan
vì	тому що	Nan
vê	о	None
vét	земснаряд	Nan
vé	квиток	Nan
vè	мочитися	Nan
vãn	ван	Nan
vãi	лайно	Nan
võng	гамак	Nan
vùi	похований	None
vùng	область	None
vú	груди	Nan
vại	баночка	Nan
vạch	бар	Nan
vạc	казан	Nan
vạ	так	None
vượt	пропуск	Nan
vượn	мавп	Nan
vườn	сад	None
vướng	заплутався	Nan
vương	король	None
xổ	розіграш	Nan
vươn	охопити	Nan
vơi	з	None
vơ	безпорадний	Nan
vũng	калюжа	Nan
vũ	ву	Nan
vĩnh	постійно	None
vĩ	чудовий	Nan
văng	сплеск	Nan
văn	література	None
vút	парить	Nan
vưu	vưu	Nan
xộn	безладний	Nan
xứ	земля	None
xứng	гідний	Nan
đẩy	натиснути	Nan
đẩu	голова	Nan
đầy	повний	None
đầu	голова	Nan
đần	німий	Nan
đầm	сукня	Nan
đấy	там	None
đấtmặt	земля	None
đất	земля	None
đấng	боже	Nan
đấm	вдарити	Nan
đảo	острів	None
đảng	партія	None
đản	день народження	Nan
đảm	гарантовано	Nan
đả	бої	None
đạt	охопити	Nan
đạp	велосипед	Nan
đạo	релігія	None
đẫm	мокнув	Nan
đạn	куля	Nan
đậm	темний	Nan
đậy	обкладинка	Nan
để	до	None
đều	є	None
đền	храм	None
đề	нитки	Nan
đến	прийти	Nan
đếm	рахувати	Nan
đế	підошви	Nan
đẽ	штрафу	Nan
đẹp	досить	None
đặn	регулярні	Nan
đặc	спеціальні	None
đẳng	клас	None
đằng	над	None
đắt	дорого	Nan
đắp	вгору	None
đắng	гіркий	Nan
đắn	власність	None
đắm	розбито	Nan
đắc	виграш	Nan
đậu	квасоля	Nan
đệm	подушка	Nan
đạm	білка	None
đạ	так	None
đói	голодний	Nan
đóa	ні	None
đó	там	None
đòn	удар	Nan
đòi	претензія	Nan
đò	пором	Nan
đính	додається	Nan
đích	пункт призначення	Nan
đênh	долар	Nan
đêm	ніч	None
đê	дамба	Nan
đèo	пропуск	Nan
đèn	лампа	Nan
đè	перекрити	Nan
đãng	розпусний	Nan
đãi	пригощати	Nan
đã	вже	None
đây	тут	None
đâu	де	None
đón	забрати	Nan
đại	чудово	Nan
đôi	подвійний	Nan
đôn	постамент	Nan
được	гаразд	Nan
đường	вулиця	None
đưa	пропуск	Nan
đơ	пауза	Nan
đĩa	тарілка	Nan
đĩ	повія	Nan
đăk	дак	Nan
đút	поставити	None
đúp	подвійний	Nan
đúng	це правильно	Nan
đúc	кастинг	Nan
đùi	стегновий	Nan
đùa	жарт	Nan
đôrêmon	дораемон	Nan
đôrêmi	дораемон	Nan
đôngtây	схід захід	Nan
đôngnam	південний схід	Nan
đôngbắc	північний схід	Nan
đông	бронза	None
đôla	доларів	None
đỉnh	верх	Nan
địch	ворог	Nan
định	вказано	Nan
ẩn	ховатися	Nan
ẩm	теплий	Nan
ấy	що	None
ấu	молодий	None
ấp	хутір	Nan
ấnâu	друк	None
ấn	натиснути	Nan
ấm	теплий	Nan
ảnh	зображення	None
ải	ải	Nan
ạt	поспішати	Nan
ạ	сер	None
ướt	мокрий	Nan
ướp	мариновані	Nan
ương	центральний	None
ươm	розплідник	Nan
ươi	апельсин	Nan
ưu	плюси	Nan
ưng	о, так	Nan
ập	чуб	Nan
ưa	кращий	Nan
ắt	звичайно	None
ỏi	м&#39;ята	Nan
ứng	застосування	None
ức	груди	Nan
ứ	так	None
ủy	комісар	Nan
ủng	чоботи	Nan
ủi	залізо	None
ủ	інкубація	Nan
ở	в	None
ớt	чилі	None
ớn	великий	None
ổn	добре	None
ổi	гуава	Nan
ổ	привід	Nan
ồn	шум	Nan
ốp	дотична	Nan
ống	трубка	Nan
ốm	хворий	Nan
ốc	равлики	Nan
ố	о-о	Nan
ếch	жаба	Nan
ư	у	None
ơn	дякую	Nan
ơi	гей	Nan
đỗ	припаркований	Nan
đổng	донг	Nan
đổi	змінити	None
đổ	налити	Nan
đồng	мідь	None
đồn	чутка	Nan
đồi	пагорб	Nan
đồ	річ	None
đốt	горіння	Nan
đống	ворс	Nan
đốn	зрубати	Nan
đốm	пляма	Nan
đối	для	None
đốc	губернатор	Nan
đỏ	червоний	None
đọng	застійний	Nan
đọc	читати	None
đọan	абзац	Nan
đọ	без косточок	Nan
độ	ступінь	None
độc	отрута	Nan
độn	підкладка	Nan
động	динамічний	Nan
ơ	ой	None
ĩ	ой	None
đựoc	добре	None
đựng	містити	None
đực	самець	Nan
đừng	ні	None
đứt	зламаний	Nan
đứng	стояти	Nan
đức	чеснота	Nan
đâm	колоти	Nan
đứa	діти	None
đụng	дотик	Nan
đụn	дюни	Nan
đục	непрозорий	Nan
đợt	партія	None
đợi	чекати	Nan
đỡ	підтримка	None
đời	час життя	Nan
đới	дзен	Nan
đột	раптом	Nan
đủ	достатньо	None
van	клапан	Nan
đát	земля	None
đáo	унікальний	None
|việt	| в&#39;єтнамські	Nan
|tên	| найменування	Nan
|petya	| петя	Nan
|nổi	| плаває	Nan
|nguyễn	| nguyen	Nan
zürich	zürich	Nan
zurich	цюріх	Nan
zoe	зої	Nan
zing	зінг	Nan
zinedine	зинедин	Nan
zimbabwe	зимбабве	Nan
zhukmse	жукмсе	Nan
zheng	чжен	Nan
zeus	зевс	None
zero	нуль	Nan
zedong	цзедун	Nan
zealand	зеландія	Nan
zambia	замбія	Nan
zac	зак	Nan
 kg	кг	Nan
z	z	Nan
 triệu	мільйон	Nan
°đến	° до	Nan
êgê	его	None
ép	стиснути	Nan
én	ластівки	Nan
ân	прихильність	None
âm	мінус	Nan
â	â	Nan
áâu	аоі	Nan
áp	тиск	None
áohung	аохунг	Nan
áo	сорочка	Nan
ánh	блиску	Nan
ám	рендери	Nan
ái	тяга	Nan
ách	ярмо	Nan
ác	зло	None
á	азіатські	Nan
ào	ого	Nan
×	×	Nan
°độ	° градусів	Nan
 °c	° c	Nan
êm	гладкий	Nan
yểu	чудовий	Nan
yểm	обкладинка	Nan
yomiuri	йоміурі	Nan
yo	йо	Nan
ymca	ymca	Nan
ying	ін	None
yi	врожайність	Nan
yersin	йерсін	Nan
yemen	ємен	Nan
yeltsin	ельцин	Nan
yeeun	yeeun	Nan
yasha	яша	Nan
yard	двір	None
yankee	янкі	Nan
yalta	ялта	Nan
yakushima	якушима	Nan
yakovlev	яковлєв	Nan
ya	йа	Nan
y=fracsin	у = фрацин	Nan
y	у	None
xử	пригощати	Nan
yoochun	йохун	Nan
yển	єна	Nan
york	йорк	Nan
yorkshire	йоркшир	Nan
yếu	слабкий	Nan
yết	лістинг	Nan
yến	пташине гніздо	Nan
yếm	комбінезони	Nan
yêu	кохати	Nan
yên	ієна	Nan
yurt	юрта	Nan
yuri	юрій	None
yunho	юньхо	Nan
yume	юме	Nan
yukito	юкіто	Nan
yugi	югі	Nan
yudhoyono	юдхойоно	Nan
yucatán	юкатан	Nan
yuan	юань	Nan
yu	ю	None
ytv	ytv	Nan
ypres	іпрес	Nan
youtube	youtube	Nan
yorker	йоркер	Nan
ích	корисний	Nan
ílam	ílam	Nan
ít	мало	None
đoàn	групи	None
đoài	манго	Nan
đom	світлячки	Nan
đoan	групи	None
đoa	доа	Nan
đo	міра	None
điệu	тон	None
điệp	повідомлення	None
điểu	ебать	Nan
điển	словник	None
điểm	бал	Nan
điều	річ	None
điền	заливка	Nan
điềm	знак	None
điếu	сигарета	Nan
điếc	глухий	Nan
điạ	dạ	Nan
điôxít	діоксид	Nan
điêu	річ	None
đoái	обмін	None
điên	божевільний	Nan
đoạn	абзац	Nan
đtđ	мобільний телефон	Nan
đáng	варто	None
đán	ден	Nan
đám	групи	None
đái	пі	Nan
đá	рок	None
đày	заслання	None
đào	копати	Nan
đàng	так	None
đàn	стадо	Nan
đàm	переговори	None
đài	радіо	None
đuổi	погони	Nan
đuống	стебло	Nan
đuối	утоплення	Nan
đuốc	факел	Nan
đuôi	хвіст	Nan
đun	тепло	Nan
đui	сліпий	Nan
đua	гонка	Nan
đt	тел	None
đi	йти	None
đhông	схід	None
đhtm	dhtm	Nan
ôzôn	озон	Nan
ôxít	оксид	Nan
ôxy	кисень	None
ôxi	кисень	None
ôtô	автомобіль	Nan
ông	він	None
ôn	помірність	Nan
ôm	обійняти	Nan
ôi	ой	None
óng	райдужні	Nan
óc	мозок	None
ó	ó	Nan
ðức	німеччина	None
ðảng	партія	None
ðường	цукор	Nan
ðài	ðài	Nan
ðiều	стаття	None
îledefrance	ледефранція	Nan
île	île	Nan
ùn	джеми	Nan
úng	заболочений	Nan
úp	обличчям вниз	Nan
úy	лейтенант	Nan
đhcn	đcn	Nan
đh	đh	Nan
đeo	знос	Nan
đentrắng	чорний і білий	Nan
đen	чорний	None
đem	принести	Nan
đe	наковальня	Nan
đcsvn	dcsvn	Nan
đcstq	dcstq	Nan
đáp	відповідь	None
đb	дб	Nan
đau	біль	None
đan	в&#39;язати	Nan
đak	дак	Nan
đai	гурт	None
đa	мульти	Nan
ăngten	антена	Nan
ăng	мураха	Nan
ăn	їсти	Nan
ý	італія	None
đay	джут	Nan
sắm	шопінг	Nan
valley	долина	None
valencia	валенсія	None
thập	хрест	None
thận	нирка	Nan
thẫm	темний	Nan
thẩm	присяжні	Nan
thầy	вчитель	Nan
thần	боже	Nan
thầm	мовчки	Nan
thấu	пенетрант	Nan
thấp	короткий	None
thảo	гарний	Nan
thản	безтурботний	Nan
thảm	килим	Nan
thải	відходи	Nan
thả	крапля	Nan
thạo	експерт	Nan
thạnh	ніж	None
thạch	желе	Nan
thạc	майстри	None
thượng	верхній	None
thật	справжній	None
thược	гром	Nan
thắm	пелюстка	Nan
thắng	виграв	Nan
thọ	довголіття	Nan
thịt	м&#39;ясо	Nan
thịnh	мода	Nan
thỉnh	запросити	Nan
thể	бути	None
thềm	полиця	Nan
thề	лаятися	Nan
thếp	сталь	None
thế	так	None
thẻ	картка	Nan
thẹn	соромно	Nan
thặng	надлишок	Nan
thẳng	прямий	None
thẳm	глибокий	None
thằng	хлопець	Nan
thằn	ящірка	Nan
thắt	зв&#39;язати	Nan
thắp	світла	None
thắngthua	виграш	Nan
thắn	відверто	Nan
thọc	джеб	Nan
thưởng	нагорода	Nan
thước	правитель	None
thìa	ложка	Nan
thêu	оренда	Nan
thêm	більше	None
thê	то	None
thét	скрикнув	Nan
thép	сталь	None
thèm	жадати	Nan
thãi	лайно	Nan
thây	побачити	None
thâu	скотч	Nan
thâm	глибокий	None
tháp	башта	Nan
tháo	видалити	Nan
thánh	св	None
tháng	місяць	None
thám	детектив	Nan
thái	тайський	Nan
thách	виклик	Nan
thác	каскад	Nan
thìn	тоді	None
thường	часто	None
thình	раптом	Nan
thít	тіт	Nan
thương	любов	None
thưa	шановний	Nan
thư	букви	Nan
thơm	запашний	Nan
thăng	просували	Nan
thăm	візит	Nan
thúy	туй	Nan
thúc	кінець	None
thú	цікаво	None
thùy	часточка	Nan
thùng	бункер	Nan
thù	ворожнеча	Nan
thông	поінформований	Nan
thôi	давай	Nan
thô	шорсткий	Nan
thói	звичка	Nan
thóc	рисовий	Nan
thòi	недолік	Nan
thò	ткнув	Nan
thí	експерименти	None
thày	вчитель	Nan
thỏ	кролик	Nan
thỏi	злиток	Nan
tncs	tncs	Nan
tiệt	чортів	Nan
tiệp	чеська	Nan
tiện	зручно	Nan
tiệm	магазин	Nan
tiệc	бенкет	Nan
tiễu	містер лю	Nan
tiểu	мочитися	Nan
tiều	лайно	Nan
tiền	гроші	None
tiềm	потенціал	None
tiếu	тупий	Nan
tiết	секреція	Nan
tiếng	мова	None
tiến	вгору	None
tiếm	гуфі	Nan
tiếc	шкодувати	Nan
tiêu	перець	Nan
tiên	перший	None
tngt	tngt	Nan
tizard	ящик	Nan
tnhh	обмежена	None
tobago	тобаго	Nan
toàn	сейф	Nan
toà	суд	None
toyota	toyota	Nan
toyama	тойама	Nan
tourist	туристичний	None
tourism	туризм	None
tottenham	t тоттенхем	Nan
toriyama	торіяма	Nan
torino	торіно	Nan
top	верх	Nan
toonami	надтонами	Nan
tony	тоні	Nan
tomoyo	томойо	Nan
tommy	томмі	Nan
tomas	томас	None
tokyopop	tokyopop	Nan
tokyo	токіо	None
tokugawa	потогава	Nan
toei	toei	Nan
toang	toang	Nan
thỏa	угоду	None
tivi	телебачення	None
tish	тиш	Nan
thừng	мотузка	Nan
thừa	надлишкові	Nan
thức	неспати	Nan
thứ	речі	None
thủng	перфорація	Nan
thủa	туа	Nan
thủ	прем&#39;єр	Nan
thụt	з відступом	Nan
thục	шу	Nan
thụ	рецептор	Nan
thợ	робітник	Nan
thở	вдих	Nan
thời	час	None
thớt	обробна дошка	Nan
thổi	удар	Nan
thổ	землі	None
thồ	пакувати	Nan
thốt	вимовлений	Nan
thối	гнилий	Nan
thử	спробувати	Nan
tissa	тиса	Nan
thửa	посилка	Nan
thực	справжній	None
tisdale	tisdale	Nan
tirol	тироль	Nan
tinthị	десятеị	Nan
tinsông	новини	None
tinnhà	бляшаний будинок	Nan
tinh	планети	None
tincầu	бляшаний міст	Nan
tinbắc	повідомлення	None
tin	вірити	Nan
timothy	тимофій	Nan
timor	тимор	Nan
tim	серце	None
tiliaceus	тиліяцею	Nan
tigris	тигр	None
tibet	тибет	Nan
tiara	тіара	Nan
tiananmen	тіананмен	Nan
tia	промінь	Nan
ti	ти	None
thự	вілла	Nan
thành	форт	Nan
thà	волів би	Nan
thy	твій	Nan
tarim	тарим	Nan
tao	я	None
tanzania	танзанія	Nan
tankōbon	танкōбон	Nan
tanh	рибний	Nan
tang	траур	Nan
tanaka	танака	Nan
tamoxifen	тамоксифен	Nan
tam	там	None
talmud	талмуд	Nan
taliban	таліби	Nan
tali	талі	Nan
taklamakan	такламакан	Nan
takahashi	такахаші	Nan
tajiri	таджірі	Nan
tajima	таджіма	Nan
tajikistan	таджикистан	Nan
taj	тай	Nan
taiwan	тайвань	None
task	завдання	None
taipei	тайбей	Nan
tasman	тасман	Nan
tau	тау	Nan
tenxơ	картель	Nan
temur	темур	Nan
temujin	temujin	Nan
temple	храм	None
tem	штамп	Nan
telnet	telnet	Nan
telex	телекс	Nan
telekom	телеком	Nan
telecom	телеком	Nan
teddy	плюшевий	Nan
ted	тед	Nan
technical	технічні	None
tcp	tcp	Nan
tcm	тсм	Nan
tchad	чад	Nan
tbt	tbt	Nan
taylor	тейлор	None
tay	рукою	Nan
taxi	таксі	None
tasmania	тасманія	Nan
teo	атрофічний	Nan
taiji	тайцзи	Nan
tag	тег	Nan
sờ	дотик	Nan
sớm	скоро	None
sớ	буде	None
sổ	книга	None
sồi	дуб	None
sốt	лихоманка	Nan
sống	живе	None
sốc	шокований	Nan
số	число	None
sỏi	гравій	Nan
sỏ	зухвалий	Nan
sọc	смуги	None
sọ	череп	Nan
sẽ	буде	None
sẻ	повинні	None
sẹo	шрам	Nan
sẵn	в наявності	Nan
sắt	залізо	None
sắp	майже	None
sỡ	пропустив	Nan
tai	вухо	Nan
sợ	переляканий	Nan
sục	джакузі	Nan
tae	тай	Nan
ta	та	None
sự	то	None
sữa	молоко	Nan
sửu	ох	Nan
sửng	шокований	Nan
sửa	ремонт	Nan
sử	історія	None
sừng	ріг	None
sứt	колотий	Nan
sức	міцність	Nan
sứa	медузи	Nan
sứ	керамічні	Nan
sủng	харизматичний	Nan
sủi	шипучий	Nan
sủa	кора	Nan
sụt	спад	Nan
sụp	крах	Nan
sụn	хрящ	Nan
sợi	пряжі	Nan
terengganu	теренгану	Nan
territories	територій	None
terry	махровий	Nan
thpt	thpt	Nan
thoắt	підказка	Nan
thoảng	зрідка	Nan
thoải	зручні	Nan
thoả	угода	None
thoạt	на перший погляд	Nan
thoại	телефон	Nan
thoát	вхід	None
thoáng	повітряний	None
thoán	здогадатися	Nan
thoái	регресивний	Nan
those	ті	None
thong	стринги	Nan
thompson	thompson	Nan
thomas	томи	Nan
thoai	тіа	Nan
thoa	мазок	Nan
tho	тхо	Nan
thiệu	вступ	None
thriller	трилер	Nan
thiệt	дійсно	None
thskts	тис	None
thumb|các	великий палець |	Nan
thvn	тис. грн	Nan
thuỷ	туй	Nan
thuỵ	туй	Nan
thuở	дитинство	None
thuờng	зазвичай	None
thuớc	вода	None
thuộc	належать	None
thuốc	ліки	Nan
thuế	податок	None
thuật	ст	None
thuận	плюси	Nan
thuẫn	конфлікт	None
thuần	чистий	None
thuê	винаймати	Nan
thuyền	човен	Nan
thuyết	теорія	None
thuyên	переміщення	None
thung	долина	None
thunderbolt	громовідвід	Nan
thua	втрачати	Nan
thiệp	картка	Nan
thiện	добре	None
thiểu	неповнолітній	Nan
thdq	thdq	Nan
thcs	тис	None
thcn	тис	None
thay	замість цього	Nan
thau	латунь	Nan
thao	спорт	None
thani	тані	Nan
thanh	бар	Nan
thang	драбинка	Nan
than	деревне вугілля	Nan
thames	темс	Nan
tham	жадібність	Nan
thailand	таїланд	Nan
thai	вагітна	Nan
tha	виправдання	Nan
tgv	tgv	Nan
texas	техас	Nan
tet	тет	Nan
terumbu	терумбу	Nan
thebes	фіви	Nan
their	їх	None
them	їх	None
then	тоді	None
thiển	шоу	None
thiền	медитація	Nan
thiềm	серп	Nan
thiếu	короткий	None
thiết	набір	None
thiếp	картка	Nan
thiến	ніяк	None
thiếc	олово	Nan
thiêng	священний	Nan
toán	математика	None
thiêm	thiêm	Nan
third	третій	None
thien	тиен	Nan
thich	подібно до	Nan
thi	іспит	Nan
theseus	тези	Nan
theres	theres	Nan
theravada	theravada	Nan
theory	теорія	None
theo	відповідно до	Nan
thiu	несвіжий	Nan
toát	добре	None
toạ	координати	None
toại	у	None
tạm	тимчасовий	None
tại	в	None
tạc	ліпити	Nan
tạ	штанга	Nan
tường	стіна	Nan
tướng	загальний	None
tưới	полив	Nan
tước	зачистка	Nan
tương	подібний	None
tươi	свіжий	Nan
tưng	хиткий	Nan
tư	з	None
tơi	я	None
tĩnh	статичний	Nan
tăng	збільшити	None
tăm	зубочистка	Nan
tý	щур	Nan
túy	ліки	Nan
túp	хата	None
tạo	творити	Nan
túng	незграбний	Nan
tạp	журнал	None
tản	розсіювання	Nan
tặc	хакери	Nan
tắt	вимкнути	Nan
tắm	душ	None
tắc	вимикачі	Nan
tật	інвалідність	Nan
tận	кінець	None
tẩy	гумка	Nan
tẩm	просочений	Nan
tầu	поїзд	Nan
tầng	підлогу	Nan
tần	частоти	None
tầm	ігри	None
tấu	інструментальний	Nan
tất	шкарпетки	Nan
tấp	потягнув	Nan
tấn	т	None
tấm	тарілки	Nan
tấc	дюйм	Nan
tảng	платформа	None
tả	опис	None
tặng	дарувати	Nan
túm	захопити	None
túc	достатність	Nan
tê	оніміння	Nan
tét	скрип	Nan
tã	памперси	Nan
tâynam	вестнам	Nan
tây	захід	None
tâu	мій лорд	Nan
tâm	центр	None
táu	винні	Nan
táp	натисніть	Nan
tánh	тан	Nan
tán	навіс	Nan
tám	вісім	None
tái	повторно	Nan
tách	кубок	None
tá	десяток	Nan
tàu	корабель	None
tành	тан	Nan
tàng	музей	None
tàn	попіл	Nan
tên	ім&#39;я	Nan
túi	сумочка	Nan
tì	селезінка	Nan
tìmdiệt	пошук	None
tùy	необов’язково	Nan
tùng	запасний	Nan
tù	тюрма	Nan
tông	картон	Nan
tôn	гофрований	Nan
tôm	креветки	Nan
tôi	я	None
tô	миску	Nan
tóm	збірник	None
tòng	тонг	Nan
tòi	речі	None
tòa	суд	None
tò	цікавість	Nan
tít	заголовок	Nan
tín	кредити	Nan
tím	фіолетовий	Nan
tích	продукт	None
tía	фіолетовий	Nan
tình	любов	None
tìm	знайдіть	Nan
tẻ	рубати	Nan
tết	тет	Nan
tếxã	економічно	None
ural	урал	Nan
up	злети	Nan
unix	unix	Nan
unit	одиниця	None
unicorn	єдиноріг	Nan
ung	гнилий	Nan
unesco	unesco	Nan
under	під	None
und	унд	Nan
un	ун	Nan
umm	гмм	Nan
ulsan	ульсан	Nan
ukraina	україна	None
ukiyoe	укійое	Nan
uk	укр	None
uh	е	None
uefa	уефа	Nan
uchiha	учіха	Nan
uc	ук	Nan
urani	урану	Nan
ubuntu	ubuntu	Nan
uri	урі	Nan
usagi	ушагі	Nan
vai	плече	Nan
vaccine	вакцина	Nan
va	va	Nan
v	v	None
uổng	гаяти	Nan
uống	пити	Nan
uốn	завивка	Nan
uất	uất	Nan
uông	уонг	Nan
uzbekistan	узбекистан	Nan
uyển	евфемізм	Nan
uyên	уйєн	Nan
uygur	уйгур	Nan
uyghur	уйгур	Nan
uy	уй	Nan
utrecht	утрехт	Nan
utah	юта	Nan
uss	uss	Nan
usb	usb	Nan
uruguay	уругвай	Nan
uae	уае	Nan
ua	ua	Nan
u	у	None
tồn	існують	None
tồi	поганий	Nan
tốt	добре	None
tốp	групи	None
tống	супровід	Nan
tốn	вартість	None
tốc	швидкість	None
tỏi	часник	Nan
tỏa	випромінювати	Nan
tỏ	виражений	Nan
tọa	координати	None
tịch	президент	None
tị	заздрість	Nan
tỉnh	провінційний	Nan
tỉa	обрізка	Nan
tệp	файл	None
tệ	поганий	Nan
tể	пан	None
tề	ци	Nan
tổn	боляче	Nan
tổng	всього	None
tộc	клан	Nan
tội	гріх	Nan
tỷ	мільярд	Nan
tỵ	змія	Nan
tựu	досягнення	None
tựa	назва	None
tự	я	None
tửu	толерантність до алкоголю	Nan
tử	смерть	None
từng	коли-небудь	Nan
từ	з	None
tài	фортуна	Nan
tức	миттєвий	Nan
tủi	поганий	Nan
tủ	шафи	Nan
tụy	підшлункова залоза	Nan
tục	негідний	Nan
tởm	огидний	Nan
tờ	аркуш	Nan
tới	наступний	None
tớ	я	None
tột	крайній	None
tủy	кістковий мозок	Nan
valentine	валентинка	Nan
tà	зло	None
type	тип	None
trò	хитрість	Nan
trích	витяг	Nan
trí	розум	None
trình	подати	Nan
trên	на	None
trèo	підйом	Nan
trãi	розкидані	Nan
trâu	буйволів	Nan
trân	з найкращими побажаннями	Nan
trâm	брошка	Nan
trát	ордер	Nan
tráp	ящик	Nan
tráo	шахрайським шляхом	Nan
tránh	уникати	Nan
tráng	з покриттям	Nan
trán	лоб	Nan
trái	зліва	None
trách	звинувачувати	Nan
trác	trac	Nan
tròn	круглий	Nan
trào	виверження	Nan
trói	виснажений	Nan
trông	виглядає	None
trước 	раніше	Nan
trước	раніше	None
trương	труонг	Nan
trưngcông	виставлені	Nan
trưng	реквізиція	Nan
trưa	полудень	Nan
trư	тру	Nan
trơn	слизька	Nan
trơ	інертний	Nan
trũng	затонуло	Nan
trĩ	геморой	Nan
trăng	місяць	None
trăn	пітон	Nan
trăm	сотня	Nan
trúc	бамбук	Nan
trú	інтернат	Nan
trùy	справді	None
trùng	збігаються	None
trùm	начальник	None
trôi	дрейфуючий	Nan
trướng	розширення	None
tràng	ободової кишки	Nan
trà	чай	Nan
trinidad	тринідад	Nan
trinh	діва	Nan
tribune	трибуна	Nan
tri	три	None
treo	повісити	Nan
tre	бамбук	Nan
trau	трау	Nan
trao	роздані, роздав	Nan
tranh	картинки	Nan
trang	сторінка	None
trai	мідії	Nan
trafford	траффорд	Nan
trafalgar	трафальгар	Nan
tqlc	tqlc	Nan
tpvĩnh	місто	None
tphồ	місто	None
tphcm	tphcm	Nan
tp	т.п.	Nan
toả	випромінювати	Nan
trinity	трійця	Nan
tràm	каюпут	Nan
tristan	тристан	Nan
triền	трієн	Nan
truỵ	брехати	Nan
truởng	начальник	None
truất	недоброзичливці	Nan
truân	truân	Nan
truyện	історія	None
truyên	труєн	Nan
truong	truong	Nan
trungnhật	чесність	Nan
trung	середній	None
truman	труман	Nan
true	правда	None
trong	в	None
trondheim	тронхейм	Nan
troia	троя	Nan
tro	зола	Nan
triệu	мільйон	Nan
triệt	ретельно	Nan
triện	пломба	Nan
triều	відлив	Nan
triết	філософія	None
trườn	повзати	Nan
trường	школа	None
trượng	кадуцей	Nan
tutsi	тутсі	Nan
tuscan	тосканський	Nan
tupolev	туполів	Nan
tung	кидати	Nan
tum	пухлина	Nan
tulip	тюльпан	Nan
tukhachevsky	тухачевський	Nan
tudor	тюдор	Nan
tucker	тюкер	Nan
tua	щупальця	Nan
tt	тт	Nan
ts	ц	Nan
trực	на чергуванні	Nan
trữ	зберігання	None
trừu	овець	None
trừng	відблиски	Nan
trừ	мінус	Nan
trứng	яйце	None
trứ	тру	Nan
tuvalu	тувалу	Nan
trụi	голий	Nan
tuy	проте	None
tuyết	сніг	Nan
ty	ти	None
twitter	щебетати	Nan
twin	близнюк	Nan
tvb	твб	Nan
tv	телебачення	None
tuỳ	необов’язково	Nan
tuột	сповзати	Nan
tuộc	восьминога	Nan
tuổi	років	None
tuốc	вищипування	Nan
tuệ	мудрість	None
tuế	мінночки	Nan
tuần	тиждень	None
tuý	туйý	Nan
tuông	рум&#39;янець	Nan
tuân	підкорятися	Nan
tuyệt	чудово	Nan
tuyển	вербування	Nan
tuyền	tuyen	Nan
tuyên	заявити	Nan
trục	вісь	Nan
trụ	офіс	Nan
trợ	підтримка	None
trận	матч	None
trẫm	мені	None
trẩy	відмов	Nan
trầy	подряпано	Nan
trầu	бетель	Nan
trần	голий	Nan
trầm	глибокий	None
trấu	рисового лушпиння	Nan
trấn	місто	None
trảo	мачете	Nan
trảm	каюпут	Nan
trải	обкладинка	Nan
trả	платити	Nan
trạo	дао	None
trạng	хвороба	None
trạm	станція	None
trại	табір	None
trạch	трах	Nan
trượt	ковзати	Nan
trật	вивих	Nan
trắc	біометрика	Nan
trắng	білі	None
trặc	гикавка	Nan
trời	боже	Nan
trớn	пестити	Nan
trộm	злодії	Nan
trội	домінуючий	Nan
trỗi	виникнення	None
trổ	шоу	None
trồng	рости	None
trồi	виникаючі	Nan
trống	порожній	Nan
typhon	тайфон	Nan
trốn	ховатися	Nan
trỏ	покажчики	Nan
trọng	важливий	None
trọn	повний	None
trọ	готель	None
trịnh	фнх	Nan
trị	лікування	None
trệ	застійний	Nan
trễ	пізно	None
trẻ	молодий	None
trối	остаточний	Nan
−−	−−	Nan
mũ	шапка	Nan
măng	пагони бамбука	Nan
cụm	кластер	Nan
cục	відділ	None
cợt	жартувати	Nan
cỡ	розмір	None
cờ	прапор	None
cớ	виправдання	Nan
cột	стовпчик	Nan
cộng	плюс	None
cội	старий	None
cộ	автомобільний	None
cỗi	впертий	Nan
cỗ	настил	Nan
cổng	ворота	None
cồng	гонг	Nan
cồn	алкоголь	Nan
cống	стік	Nan
cốm	самородки	Nan
cối	ступка	Nan
cốc	кубок	None
cụp	ампутували	Nan
cố	спробуйте	Nan
cụt	ампутували	Nan
của	з	None
daegu	daegu	Nan
da	шкіра	Nan
d	г	None
cựu	колишній	None
cực	полюс	Nan
cựa	шпори	Nan
cự	відстань	None
cữu	шкатулка	Nan
cữ	cu	Nan
cửu	примножувати	Nan
cửa	двері	Nan
cừu	баранина	Nan
cừ	стовпи	Nan
cứngi	харді	Nan
cứng	важко	None
cức	кухар	Nan
cứ	на	None
củng	також	None
củi	дрова	Nan
củ	бульби	None
dahl	даль	Nan
cỏ	трава	Nan
cọc	ворс	Nan
cảnh	сцена	None
cảng	порт	None
cản	мучився	Nan
cảm	холод	Nan
cải	гірчиця	Nan
cả	і те й інше	Nan
cạp	скорпіон	Nan
cạo	голити	Nan
cạnh	край	None
cạn	неглибокий	Nan
cạc	картка	Nan
cưỡng	вимушений	Nan
cưỡi	їзда	Nan
cường	сильний	None
cười	сміх	Nan
cướp	грабувати	Nan
cưới	одружився	None
cước	фрахт	Nan
cưng	моя дитина	Nan
cảo	тягне	Nan
cọp	тигр	None
cấm	заборонити	Nan
cấp	грант	Nan
cọ	натерти	Nan
cặp	сумка	Nan
cằn	бурхливий	Nan
cằm	підборіддя	Nan
cắt	вирізати	Nan
cắp	красти	Nan
cắn	кусати	Nan
cắm	підключати	Nan
cậy	залежать	None
cậu	хлопчик	Nan
cập	лічильник	Nan
cận	підхід	None
cẩu	кран	Nan
cẩn	будь обережний	Nan
cầy	цивет	Nan
cầu	міст	None
cần	потреба	None
cầm	тримати	None
cất	дистильована	Nan
cấn	потреба	None
cưa	пила	Nan
dai	жорсткий	Nan
dakota	дакота	Nan
dm	дм	Nan
djokovic	джокович	Nan
djibouti	джибуті	Nan
diệu	магія	Nan
diệt	вбити	Nan
diện	обличчя	None
diệm	дієма	Nan
diệc	чапля	Nan
diễu	марш	Nan
diễm	дієма	Nan
diểu	фарс	Nan
diều	кайт	Nan
diềm	доблесті	Nan
diên	божевільний	Nan
diêm	сірники	Nan
divoire	дивоар	Nan
division	поділ	None
disneyland	діснейленд	Nan
discussion	обговорення	None
dmitri	дмитри	Nan
discovery	відкриття	None
dna	днк	None
doanh	суглоб	Nan
driver	водій	Nan
drake	дрейк	Nan
draft	чернетка	Nan
dracula	дракула	Nan
dp	д.п.	Nan
doạ	загрозливий	Nan
doãn	doan	Nan
doyle	дойл	Nan
dover	довер	Nan
douglas	дуглас	Nan
dougherty	подвійність	Nan
dortmund	дортмунд	Nan
donau	donau	Nan
don	дон	None
dominican	домініканець	Nan
dome	купол	Nan
dolly	доллі	Nan
docherty	дочерчі	Nan
doc	док	Nan
do	від	None
daily	щодня	None
dionysus	діоніс	Nan
dimaggio	димаджіо	Nan
dbsk	dbsk	Nan
davis	девіс	Nan
davies	дейвіс	Nan
david	девід	None
dave	дейв	Nan
dau	олія	Nan
date	дата	None
dassault	дассо	Nan
das	дас	Nan
darwin	дарвін	Nan
dao	ніж	None
dante	данте	None
daniel	даніель	Nan
danh	назва	None
danger	небезпека	Nan
dancing	танці	None
dan	дан	Nan
dampier	демпфер	Nan
dalat	да лат	Nan
dc	dc	Nan
dinh	палац	None
ddr	ддр	Nan
degree	ступінь	None
dien	божевільний	Nan
diego	дієго	Nan
die	померти	Nan
diana	діана	Nan
di	ді	None
dewitt	dewitt	Nan
dewan	деван	Nan
deutschland	німеччина	None
deuterium	дейтерій	Nan
design	thiết kế	Nan
descartes	декарт	Nan
des	дес	Nan
derek	дерек	Nan
department	відділ	None
dennis	dennis	Nan
den	лігво	Nan
demeter	деметер	Nan
delphi	дельфі	Nan
delhi	делі	Nan
dean	декан	Nan
cư	заселяти	Nan
cơm	рис	None
cũng	також	None
coleen	колін	Nan
coi	дивитися	Nan
cohen	коен	Nan
coffea	кава	Nan
coen	коен	Nan
cocoa	какао	Nan
coburn	качан	Nan
co	ко	Nan
cnxh	cnxh	Nan
cntt	cntt	Nan
cntb	cntb	Nan
cnet	кнет	Nan
cn	cn	Nan
cmt	смт	None
cmc	смс	Nan
clyde	клайд	Nan
clow	клоуна	Nan
clo	хлор	Nan
clips	затискачі	Nan
coleman	колман	Nan
clip	кліп	Nan
coli	coli	Nan
colleen	коллін	Nan
conservation	збереження	None
conrad	конрад	Nan
connecticut	connecticut	Nan
congress	конгрес	None
congo	конго	Nan
cong	вигнута	Nan
condom	презерватив	Nan
concorde	конкорде	Nan
concerto	концерт	None
concacaf	конкакаф	Nan
common	звичайний	None
comic	комічний	Nan
columbus	колумб	Nan
colorado	колорадо	Nan
colombo	коломба	Nan
colombia	колумбія	Nan
collège	колеж	Nan
collins	колін	Nan
college	коледж	None
colin	колін	Nan
constantine	константин	Nan
clinton	клінтон	Nan
claude	клауд	Nan
chục	десяток	Nan
chợt	раптом	Nan
chợ	ринок	None
chở	перенесення	None
chờ	чекати	Nan
chớp	блискавка	Nan
chớ	не	None
chội	лайно	Nan
chỗ	місце	None
chồng	чоловік	None
chồn	лисиця	Nan
chồi	пагони	Nan
chốt	засувка	Nan
chống	анти	Nan
chốn	місце	None
chối	заперечувати	Nan
chốc	мить	Nan
chỏ	ліктьовий	Nan
chọn	вибрати	Nan
chụp	зробити постріл	Nan
claudius	клавдій	Nan
chủ	майстер	None
chứ	скоріше	None
clark	кларк	Nan
clara	клара	Nan
cities	міста	None
circus	цирк	Nan
cip	чіп	Nan
cinderella	попелюшка	Nan
cincinnati	цинціннаті	Nan
cia	циа	Nan
chững	вирівнювання	Nan
chữa	вилікувати	Nan
chữ	слово	None
chửi	проклинаючи	Nan
chửa	вагітна	Nan
chử	слово	None
chừng	дещо	None
chừa	залишаючи	Nan
chừ	лист	None
chức	функція	None
chứa	містити	None
chủng	штами	Nan
contemporary	сучасний	None
cooper	купер	Nan
copenhagen	копенгаген	Nan
có	мати	None
còn	ще	None
cò	тригер	Nan
cãi	сперечатися	Nan
câu	речення	None
cân	ваги	None
câm	німий	Nan
cáy	шахрай	Nan
cáp	кабель	Nan
cáopx|bình	cáopx | середній	Nan
cáo	лисиця	Nan
cánh	крило	Nan
cán	прокату	Nan
cái	то	None
cách	шлях	None
các	то	None
cày	оранка	Nan
cào	скретч	Nan
cành	відділення	None
cói	осока	Nan
càng	більше	None
cót	ліжечко	Nan
côi	сиріт	Nan
cũi	ліжечко	Nan
cũ	старий	None
căng	розтягнутий	Nan
căn	радикальний	Nan
căm	підключений	Nan
cút	забирайся	Nan
cúp	чашка	Nan
cúng	затишно	Nan
cúm	грип	Nan
cúi	лук	Nan
cú	сова	Nan
cùng	і	None
cùi	прокажені	Nan
cù	лоскоче	Nan
cõng	скарбничка	Nan
cõi	царства	None
côngtenơ	контейнер	Nan
công	робота	None
côn	конусність	Nan
cô	міс	Nan
càn	потреба	None
cài	встановити	None
cà	кава	Nan
cristiano	кріштіано	Nan
crisis	криза	None
crimson	малиновий	Nan
crew	екіпаж	Nan
crest	гребінь	Nan
crespo	кореспо	Nan
crazy	божевільний	Nan
craig	craig	Nan
cpt	cpt	Nan
cotang	cotang	Nan
costa	коста	Nan
cosin	косинус	Nan
cornell	корнель	Nan
core	серцевина	Nan
cordyceps	кордіцепси	Nan
copy	копія	None
coppola	коппола	Nan
copperfield	мідне поле	Nan
copernic	коперник	Nan
croatia	хорватія	None
cross	хрест	None
crs	crs	Nan
cruz	круз	Nan
cyworld	cyworld	Nan
cyrus	кір	Nan
cyril	кирило	None
cyber	кібер	Nan
cyanide	ціанід	Nan
cuộc	то	None
cuồng	божевільний	Nan
cuống	стебло	Nan
cuốn	котушка	Nan
ds	дс	Nan
cuối	останнім	None
cuả	з	None
cup	чашка	Nan
cunningham	кунінгам	Nan
cung	лук	Nan
cullen	каллен	Nan
cua	краб	Nan
ctc	ctc	Nan
crystal	кристал	Nan
cruzeiro	крузейро	Nan
cuốc	мотики	Nan
dtd	тов	None
dth	dth	Nan
du	дю	Nan
food	їжа	Nan
fokker	фоккер	Nan
foden	foden	Nan
focus	фокус	Nan
foch	foch	Nan
flight	політ	None
fleming	літаючі	Nan
flanker	фланкера	Nan
fitzgerald	фіцджеральд	Nan
fishbed	рибна ложа	Nan
fish	риба	None
fischer	рибалка	Nan
firefox	firefox	Nan
finish	закінчити	Nan
fiji	фіджі	Nan
figo	фіго	Nan
fifpro	fivepro	Nan
fifa	фіфа	Nan
field	поле	None
football	футбол	None
fidel	фідель	Nan
forbes	forbes	Nan
fordham	fordham	Nan
fujiko	фуджико	Nan
fu	фу	Nan
friedman	фрідман	Nan
freud	фрейд	Nan
franz	франц	None
franklin	франклін	Nan
frankfurt	франкфурт	Nan
frank	відвертий	Nan
franco	франко	None
francisco	франциско	Nan
francis	францис	Nan
frances	франції	None
france	франція	None
franc	франк	None
fracsin	фрацин	Nan
fpt	fpt	Nan
fox	лисиця	Nan
foundation	фундамент	Nan
forks	виделки	Nan
ford	брод	Nan
fujimoto	fujimoto	Nan
fiat	фіат	Nan
fernando	фернандо	Nan
every	кожен	None
everton	евертон	Nan
eva	ева	Nan
european	європейський	None
europe	європа	None
eurofighter	євробоєць	Nan
euro	євро	None
euler	елер	Nan
eugène	eugène	Nan
eugene	євген	None
euclid	еуклід	Nan
ethiopia	ефіопія	Nan
ethernet	ethernet	Nan
essential	істотне	Nan
españa	еспанья	Nan
erwin	ервін	Nan
eros	ерос	Nan
ernest	ernest	Nan
eritrea	еритрея	Nan
exgay	exgay	Nan
ferrari	ferrari	Nan
explorer	дослідник	None
fabio	фабіо	Nan
ferguson	фергюсон	Nan
ferdinand	фердинанд	Nan
ferb	ферб	Nan
felix	фелікс	Nan
felis	феліс	Nan
felipe	феліпе	Nan
feet	стопи	Nan
federer	federer	Nan
features	особливості	None
fdi	піі	Nan
fca	fca	Nan
fbi	fbi	Nan
faso	фасо	Nan
farrell	farrell	Nan
fao	фао	Nan
faifo	файфо	Nan
facto	факто	Nan
fact	факт	None
facebook	facebook	Nan
extensive	обширний	Nan
fukuoka	фукуока	Nan
funimation	funimation	Nan
funk	фанк	Nan
gifu	гіфу	Nan
gieo	сіяти	Nan
gichin	гіцин	Nan
gibraltar	гібралтар	Nan
giang	гіанг	Nan
gian	простір	None
giam	тюрма	Nan
giai	етап	None
gia	gia	Nan
ghềnh	пороги	Nan
ghề	пороги	Nan
ghế	крісло	Nan
ghẻ	короста	Nan
ghì	гм	Nan
ghê	жах	Nan
ghép	трансплантат	Nan
ghé	стоп	Nan
ghim	шпилька	Nan
ghi	напиши	Nan
ginzan	гінзань	Nan
ghen	ревнивий	Nan
gio	gio	Nan
giuliani	giuliani	Nan
giêsu	ісус	None
giêng	гіонг	Nan
giêhôva	гіва	Nan
gièm	недоброзичливці	Nan
giãn	розтягнутий	Nan
giã	стукає	Nan
giây	секунд	Nan
gián	таргани	Nan
giám	режисер	None
giá	ціна	None
giày	взуття	None
giàu	багатий	None
giành	жадібно	Nan
giàn	ферма	Nan
già	старий	None
giza	гіза	Nan
giuộc	джуок	Nan
giuse	giuse	Nan
giun	глисти	Nan
gioi	gioi	Nan
ghe	човен	Nan
ghana	гана	Nan
gerrard	геррард	Nan
gao	рис	None
ganh	ревнивий	Nan
gang	банда	Nan
gandhi	ганді	Nan
gan	печінка	Nan
gamow	gamow	Nan
gambia	гамбії	Nan
gam	грам	Nan
galileo	galileo	Nan
galilei	галілей	Nan
gaillard	gaillard	Nan
gaia	гея	Nan
gagarin	гагарин	Nan
gabriella	габріелла	Nan
gabriel	габріель	Nan
gabon	габон	Nan
ga	га	None
fx	fx	Nan
futsal	футзал	Nan
gareth	гарет	Nan
garrett	гаррет	Nan
gary	гарі	Nan
gascon	гаскон	Nan
germany	німеччина	None
german	німецька	None
gerhard	герхард	Nan
gerais	гераї	Nan
ger	гер	Nan
gepard	гепард	Nan
georges	джордж	None
george	джордж	None
georg	георг	Nan
eris	еріс	Nan
genesis	генезис	None
gen	гени	None
geisha	гейша	Nan
gdp	gdp	Nan
gdańsk	gdańsk	Nan
gaza	газа	Nan
gay	гей	Nan
gaulois	gaulois	Nan
gaule	гауле	Nan
gatt	гетт	Nan
gene	ген	Nan
chọi	бойові дії	Nan
erik	ерік	Nan
ep	еп	Nan
dường	здається	None
dương	позитивний	Nan
dưng	стоп	Nan
dưa	дині	Nan
dư	залишковий	Nan
dơi	кажани	Nan
dơ	брудний	Nan
dũng	доблесний	Nan
dĩa	тарілка	Nan
dĩ	звичайно	None
dăm	стружки	Nan
dùng	використання	None
dùi	перфоратор	Nan
dù	хоч	None
dõi	доріжка	Nan
dông	гроза	Nan
dó	що	None
dòng	струм	None
dòm	погляд	None
dưỡng	медсестра	Nan
dò	пошук	None
dược	аптека	Nan
dạ	так	None
dậy	вставай	Nan
dậu	півень	Nan
dận	тітка	Nan
dẫu	хоч	None
dẫn	путівник	Nan
dẫm	тупати	Nan
dầu	олія	Nan
dần	поступово	None
dấy	збудження	None
dấu	знак	None
dấp	спотикатися	Nan
dấm	оцту	Nan
dải	смуга	None
dạy	вчити	Nan
dạt	вимиті	Nan
dạo	прогулятися	Nan
dạng	формат	Nan
dạn	безстрашний	Nan
dại	нерозумний	Nan
dượng	дядько	Nan
dắt	вести	None
dính	липкий	Nan
dì	тітка	Nan
dà	так	None
dwight	двайт	Nan
duỗi	випрямити	Nan
duệ	нащадків	None
duật	дуат	Nan
duẩn	дуан	Nan
duơng	duong	Nan
duyệt	веб-переглядач	Nan
duyện	прагнучий	Nan
duyên	зумовлений	Nan
duy	тільки	None
dursley	дурслі	Nan
durham	дарем	Nan
dung	гній	Nan
dumbledore	глумник	Nan
dumas	думи	None
duk	качка	Nan
duiker	дуйкер	Nan
dubai	дубай	Nan
dài	довго	None
dìu	dìu	Nan
dàn	інсценування	Nan
dành	витрачено	Nan
dê	козел	Nan
dép	босоніжки	Nan
défense	дефенс	Nan
dè	будь обережний	Nan
dãy	дальність	Nan
dãn	розширені	Nan
dãi	вседозволений	Nan
dã	дикий	Nan
dây	шнур	Nan
dâng	пропозиція	None
dân	люди	None
dâm	розкутий	Nan
dát	інкрустований	Nan
dáng	форма	None
dán	пасти	Nan
dám	наважуйся	Nan
dái	мочити	Nan
dày	товстий	Nan
dào	рясний	Nan
dàng	легко	None
dằn	баласт	Nan
dằng	наполегливі	Nan
dẳng	наполегливі	Nan
elbe	ельба	Nan
ekaterina	катерина	None
eisenhower	eisenhower	Nan
einstein	ейнштейн	None
eiffel	ейфелева	Nan
eid	ід	Nan
egypt	єгипет	None
efron	ефрон	Nan
eea	еа	Nan
edwin	едвін	Nan
edward	едвард	Nan
edo	едо	Nan
edmond	едмонд	Nan
editor	редактор	None
edison	едісон	Nan
edinburgh	единбург	Nan
edge	край	None
edgar	едгар	Nan
edda	едда	Nan
electronic	електронний	None
ecw	екв	Nan
eliane	eliane	Nan
elizabeth	елізабет	Nan
eo	талія	Nan
enzym	фермент	Nan
entropy	ентропія	Nan
entente	антанта	Nan
eniac	еніак	Nan
england	англія	None
engels	ангелів	Nan
energy	енергії	None
en	en	Nan
emmy	еммі	Nan
emir	емір	Nan
emily	емілі	Nan
email	електронною поштою	Nan
em	ти	None
elíp	еліпс	Nan
elvis	елвіс	Nan
elton	елтон	Nan
ellis	ellis	Nan
ellen	еллен	Nan
elip	еліпс	Nan
ecmascript	ecmascript	Nan
ebro	ебро	Nan
eaton	етон	Nan
dỏm	дотепний	Nan
dọc	вертикальний	Nan
dọa	загрозливий	Nan
dịu	солодкий	Nan
dịp	нагода	Nan
dịch	перекласти	Nan
dị	сингулярність	Nan
dệt	ткацтво	Nan
dễ	легко	None
dể	легко	None
dền	амарант	Nan
dế	цвіркуни	Nan
dẻo	пластичність	Nan
dẻ	каштани	Nan
dẹt	квартира	Nan
dẹp	вирівняти	Nan
dặt	замовлення	None
dặn	впорядковано	Nan
dặm	миля	Nan
dốc	схил	Nan
dối	брехати	Nan
dốt	неосвічений	Nan
dồi	рясний	Nan
earles	вушка	Nan
ea	еа	Nan
e	е	None
dỹ	dỹ	Nan
dực	самець	Nan
dựa	заснований	None
dự	прогнозується	Nan
dữ	дані	None
dừng	стоп	Nan
erich	еріх	Nan
dừa	кокосового горіха	Nan
dứa	ананас	Nan
dụng	використання	None
dục	секс	None
dụ	наприклад	None
dỡ	розвантаження	Nan
dở	поганий	Nan
dời	рухатися	Nan
dỗ	коаксичний	Nan
dồn	кутовий	Nan
dứt	стоп	Nan
giêxu	зв’язок	Nan
chọc	ткнути	Nan
chịt	лайно	Nan
bermuda	бермуди	Nan
berman	берман	Nan
berkeley	берклі	Nan
bering	оберігання	Nan
berger	бергер	Nan
bergen	берген	Nan
berber	бербер	Nan
bennington	беннінгтон	Nan
benjamin	бенджамін	Nan
benito	беніто	Nan
benfica	benfica	Nan
benetton	бенеттон	Nan
benedict	бенедикт	Nan
bellatrix	bellatrix	Nan
bella	белла	Nan
bell	дзвоник	Nan
bel	пояс	None
beijing	пекін	Nan
behind	позаду	Nan
bernard	бернар	Nan
beginbmatrix	startbmatrix	Nan
bertrand	bertrand	Nan
betty	бетті	Nan
biện	вибачтесь	Nan
biểuthứcđiềukiện	знати умови	Nan
biển	море	None
biều	bieu	Nan
biếu	платити данину	Nan
biếng	ледачий	Nan
biến	вийшов	None
biếm	недбалий	Nan
biếc	чирок	Nan
biên	запис	None
bitmap	растровий малюнок	Nan
bismarck	бісмарк	Nan
billy	біллі	Nan
bill	вексель	None
bikini	бікіні	Nan
bic	бік	None
biang	біанг	Nan
bia	пиво	Nan
bhutan	бутан	Nan
better	краще	Nan
biệt	виразний	Nan
beethovens	буряків	Nan
bedloe	постільна білизна	Nan
baryon	баріон	Nan
bartholdi	бартольді	Nan
barrichello	барікелло	Nan
barquin	barquin	Nan
baroque	бароко	None
barone	барон	Nan
barnes	барнс	Nan
barca	барка	None
barbary	варвар	Nan
barbara	варвара	Nan
barbados	барбадос	Nan
barak	барак	Nan
barack	барак	Nan
bao	мішок	Nan
bantu	ту заборона	Nan
bantam	бантам	Nan
banner	банер	Nan
banh	куля	Nan
bang	чуб	Nan
barça	barça	Nan
beethoven	бетховен	Nan
base	база	None
basil	базилік	Nan
beckham	бекхем	Nan
becker	беккер	Nan
beckenbauer	бекенбауер	Nan
beauty	краса	None
beatles	битлів	Nan
beat	бити	Nan
bchtư	bchtư	Nan
bc	до н.е.	Nan
bbc	bbc	Nan
bb	bb	Nan
bazơ	базовий	Nan
bazan	базальту	Nan
bayern	баварія	Nan
bay	літати	Nan
bauer	бауер	Nan
battambang	баттамбанг	Nan
bator	батор	Nan
bass	бас	Nan
baskervilles	баскервіль	Nan
basel	базель	Nan
ban	заборона	None
bkavpro	бкавпро	Nan
blair	блер	Nan
buonaparte	буонапарт	Nan
bungo	бунго	Nan
bungary	бунгарі	Nan
bulletin	бюлетень	Nan
bulgaria	болгарія	None
budapest	найбідніший	Nan
bubalis	бубаліс	Nan
btr	btr	Nan
brussels	брюссель	Nan
brusilov	брусилов	Nan
bruno	бруно	Nan
brunei	бруней	Nan
bruce	брус	Nan
browning	коричневе	Nan
browne	коричневий	Nan
brown	коричневий	Nan
brot	бульйон	Nan
brooklyn	бруклін	Nan
britney	брітні	Nan
burke	burke	Nan
britannic	британський	None
burkina	буркіна	Nan
burundi	бурунді	Nan
bào	стругання	Nan
bành	пенг	Nan
bàng	орел	None
bàn	стіл	None
bài	постів	Nan
bà	бабуся	Nan
byzantine	візантійські	None
buổi	сесія	Nan
buồng	кімната	Nan
buồn	сумно	Nan
buồm	вітрило	Nan
buốt	захопливий	Nan
buýt	автобус	Nan
buông	відпустити	Nan
buôn	оптом	Nan
bushy	кущистий	Nan
bush	кущ	Nan
busby	автобус	Nan
busan	пузан	Nan
burma	бірма	Nan
blackwell	blackwell	Nan
bridge	міст	None
brezhnev	брежнєв	Nan
boong	настил	Nan
boom	бум	Nan
boolean	булева	Nan
bool	бул	Nan
bonobo	бонобо	Nan
bonnal	бональний	Nan
bong	бон	Nan
bonaparte	бонапарт	Nan
bom	бомба	Nan
boltzmann	boltzmann	Nan
bolivia	болівія	Nan
bohemia	богемія	Nan
boeing	boeing	Nan
bobby	бобі	Nan
bob	боб	Nan
bo	бо	None
blues	блюз	Nan
blanc	бланкуватий	Nan
blaise	вилазка	Nan
boongke	бункери	Nan
brian	брайан	Nan
bop	боп	Nan
borland	борланд	Nan
bretton	бретон	Nan
breton	бретон	Nan
brestlitovsk	брестлітівськ	Nan
bremen	бремен	Nan
brazil	бразилія	None
braun	браун	Nan
brandt	бранд	Nan
brandenburg	бранденбург	Nan
brain	мозок	None
boxing	бокс	Nan
bourbon	бурбон	Nan
boulder	валун	Nan
bottom	дно	Nan
botswana	ботсвана	Nan
bosnia	боснія	Nan
bosna	босна	Nan
boseeinstein	бозейнштейн	Nan
bose	босе	Nan
borussia	борусія	Nan
boris	бор	Nan
bamar	бамар	Nan
ballard	балард	Nan
balkans	балкани	Nan
alois	алоїз	Nan
allmusic	всемузичний	Nan
allen	аллен	Nan
allan	аллан	Nan
alice	аліса	Nan
ali	алі	Nan
algérie	алгерія	Nan
alfred	альфред	Nan
alexey	alexey	Nan
alexandros	александрос	Nan
alexandria	олександрія	Nan
alexandra	александра	None
alexa	alexa	Nan
albus	albus	Nan
albuquerque	альбукерке	Nan
albion	альбіон	Nan
alberto	альберто	Nan
albert	альберт	None
albatros	альбатроси	Nan
alonso	алонсо	Nan
albania	албанія	Nan
alpher	альфер	Nan
altai	алтай	Nan
andes	анде	Nan
anderson	андерсон	None
andaman	андаман	Nan
andalusia	андалузія	Nan
anatolia	анатолія	Nan
anata	аната	Nan
anand	anand	Nan
an	ан	Nan
amphitrite	амфітрит	Nan
amoniac	аміак	Nan
amm	ам	Nan
amin	амін	Nan
amiens	амієн	Nan
ami	амі	Nan
ame	аме	Nan
amdo	amdo	Nan
amazon	амазонка	Nan
amaravati	amaravati	Nan
always	завжди	None
alps	альпи	Nan
andorra	андорра	Nan
alaska	аляска	Nan
al	ін	None
adsl	adsl	Nan
adrian	адріан	Nan
adobe	гнучко	Nan
adn	adn	Nan
addisonwesley	аддісонвеслі	Nan
adams	адамс	Nan
ada	ада	Nan
acid	кислота	Nan
acia	ація	Nan
achilles	ахілл	Nan
aceh	ацех	Nan
account	рахунок	None
abscbn	абсбн	Nan
abrams	абрами	Nan
abraham	абрахам	Nan
about	о	None
abkhazia	абхазія	Nan
abdul	абдул	Nan
abc	абс	Nan
advanced	передовий	Nan
alabama	алабама	Nan
aedes	аїди	Nan
aero	аеро	Nan
akô	здравствуйте	Nan
akms	акми	Nan
akatsuki	акацукі	Nan
ak	ак	Nan
ajax	аякс	None
aisne	aisne	Nan
airbus	аеробус	Nan
air	повітря	None
aim	мета	None
ailen	ірландська	Nan
ai	вооз	Nan
agassi	агассі	Nan
agasa	агаса	Nan
ag	аг	Nan
african	африканський	Nan
africa	африка	None
afghanistan	афганістан	Nan
aff	афі	Nan
afc	afc	Nan
aegypti	аегіпти	Nan
andrew	andrew	Nan
andré	андре	Nan
andy	енді	Nan
austria	австрія	None
australia	австралія	None
auguste	auguste	Nan
auflage	леща	Nan
audition	прослуховування	Nan
aubrac	aubrac	Nan
aua	ауа	Nan
atlantic	атлантичний	None
atlanta	атланта	Nan
atkinson	аткінсон	Nan
aston	здивований	Nan
assyria	ассірія	Nan
association	об&#39;єднання	Nan
asoka	asoka	Nan
asm	зом	Nan
asia	азія	None
ashley	ешлі	Nan
ashikaga	ашикага	Nan
ash	зола	Nan
austrian	австрійський	None
asc	вх	Nan
avar	авар	Nan
awad	awad	Nan
balkan	балкан	Nan
bali	балі	Nan
balearic	балеарний	Nan
baháí	бахаї	Nan
bahrain	бахрейн	Nan
bahamas	багами	Nan
bago	баго	Nan
baghdad	багдад	Nan
baden	баден	Nan
bacon	бекон	Nan
babylon	вавилон	Nan
ba	батько	None
aztec	ацтек	Nan
azerbaijan	азербайджан	None
ayutthaya	аюттхая	Nan
ayumi	аюмі	Nan
ayeyarwady	ayeyarwady	Nan
axit	кислота	Nan
award	нагорода	Nan
aviation	авіація	Nan
arunachal	рунахальний	Nan
aruba	аруба	Nan
artemis	артеміди	Nan
any	будь-який	Nan
antonov	антонов	Nan
anton	антон	None
antigua	антигуа	Nan
anthony	антоній	Nan
anorthosit	анортосіт	Nan
anne	енн	Nan
annan	аннан	Nan
annam	нам	None
anna	анна	None
ankyl	анкіл	Nan
ankara	анкара	None
anhpháp	англійська французька	Nan
anhmỹ	британці	Nan
anh	брат	None
anglosaxon	англосаксон	Nan
angkor	ангкор	Nan
ang	анг	Nan
anfield	anfield	Nan
anđêhít	альдегід	Nan
ao	ставок	Nan
aotearoa	aotearoa	Nan
apollo	аполлон	Nan
arsenal	арсенал	Nan
arnold	арнольд	Nan
armstrong	армстронг	Nan
armenia	арм	Nan
arlington	арлінгтон	Nan
arkansas	арканзас	Nan
ark	ковчег	Nan
arizona	арізона	Nan
aristotle	аристотель	None
bàu	бау	Nan
aringarosa	aringarosa	Nan
argo	арго	Nan
argentina	аргентина	None
ares	арів	Nan
arctan	арктан	Nan
archive	архів	None
archetypal	архетип	Nan
arab	арабська	None
aquinas	аквінські	Nan
apple	яблуко	Nan
arias	арії	Nan
bày	презентація	Nan
bác	дядько	Nan
bách	кипарис	Nan
chrysler	chrysler	Nan
chrome	хром	Nan
christopher	христофор	Nan
christian	християнський	Nan
christ	христос	None
chris	крис	Nan
choáng	приголомшений	Nan
choàng	накидка	Nan
chosŏn	чосŏн	Nan
chopin	чопін	Nan
chong	чонг	Nan
chomsky	хомський	Nan
choi	грати	None
chnd	chnd	Nan
chloride	хлорид	Nan
chlamydia	хламідії	Nan
chiều	вечора	Nan
chiền	купу	Nan
chiếu	килимок	Nan
chu	чу	Nan
chiết	витяг	Nan
chua	кислий	Nan
chui	протирати	Nan
chuộng	прихильний	Nan
chuộc	викупити	Nan
chuỗi	ланцюжок	Nan
chuồng	клітка	Nan
chuốt	протягування	Nan
chuối	банан	Nan
chuốc	шукати	None
chuẩn	стандартний	Nan
chuông	дзвоник	Nan
chuôi	захват	Nan
chuyện	історія	None
chuyển	переїхав	Nan
chuyền	пропуск	Nan
chuyến	поїздка	Nan
chuyên	спеціалізовані	None
churchill	церковний	Nan
chung	загальний	None
chun	чунь	Nan
chum	чум	Nan
chuck	патрон	Nan
chuột	миша	Nan
chiến	боротися	Nan
chiếc	шт	Nan
chao	привіт	Nan
chanh	лимона	Nan
chanel	шанель	Nan
chamẹ	батьків	None
champion	чемпіон	None
champa	шампанське	Nan
chamberlain	камергер	Nan
chaillot	хайлот	Nan
chai	пляшка	Nan
cha	папа	None
ceres	ceres	Nan
centauri	кентаври	Nan
cena	ціна	None
celtic	кельтський	Nan
cell	клітина	None
cdrom	cd-rom	Nan
cdot	cdot	Nan
cd	cd	Nan
cctv	cctv	Nan
charles	шарлів	Nan
chiếm	облік	None
charlotte	шарлотка	Nan
charon	харон	Nan
chiêng	гонг	Nan
chiên	смажена	Nan
chiêm	астрологічні	Nan
chirac	хірак	Nan
ching	чін	Nan
china	китай	None
chim	птах	Nan
chile	чилі	None
chicago	чікаго	Nan
chiang	чіанг	Nan
chia	поділитися	Nan
chi	чі	Nan
cheo	чео	Nan
chen	чень	Nan
chechnya	чечня	Nan
che	обкладинка	Nan
chdcnd	chdcnd	Nan
chay	вегетаріанський	Nan
chase	погони	Nan
charlton	чарлтон	Nan
chà	натерти	Nan
chài	риболовля	Nan
chàm	індіго	Nan
chấm	крапка	Nan
chảy	бігати	Nan
chảo	каструля	Nan
chả	булочки	Nan
chạy	бігати	Nan
chạp	хиткий	Nan
chạng	сутінки	Nan
chạm	дотик	Nan
chạ	розбещений	Nan
chướng	смуга перешкод	Nan
chương	главу	Nan
chưng	dist	Nan
chưa	ще ні	Nan
chư	чу	Nan
chơn	стопи	Nan
chơi	грати	None
chĩa	виделки	Nan
chăng	доступний за ціною	Nan
chămpa	шампанське	Nan
chấp	виклик	Nan
chăm	важко	None
chất	матерія	None
chần	бланшування	Nan
chỉnh	виправлення	Nan
chỉ	просто	None
chệch	неправильно	Nan
chết	помер	None
chếch	млявий	Nan
chế	препарати	Nan
chẽ	тісний	Nan
chẻ	розколоти	Nan
chặt	рубати	Nan
chặng	нога	Nan
chặn	блокувати	Nan
chẵn	навіть	None
chằng	чоло	Nan
chắc	впевнений	Nan
chậu	горщик	None
chật	тісний	Nan
chận	блок	None
chậm	повільний	Nan
chẩn	діагностувати	Nan
chấu	щіпка	Nan
chút	трошки	Nan
chúng	їх	None
chúi	туу	Nan
chì	вести	None
chênh	різниця	None
chê	чорт	Nan
chép	скопіювати	Nan
chéo	хрест	None
chén	кубок	None
chém	вирізати	Nan
chèn	вставити	Nan
chè	чай	Nan
châu	європа	None
chân	стопа	Nan
châm	укол	Nan
cháy	вогонь	None
cháu	онуків	Nan
cháo	каша	Nan
chánh	начальник	None
chày	бейсбол	Nan
chào	здравствуйте	Nan
chàng	хлопець	Nan
chìa	ключ	Nan
chìm	опустився	Nan
chình	вугор	Nan
chí	воші	Nan
chúc	побажати	Nan
chúa	боже	Nan
chú	дядько	Nan
chùy	булава	Nan
chùa	храм	None
chông	чоловік	None
chôn	закопувати	Nan
chôm	рамбутан	Nan
chóp	верх	Nan
ccn	ccn	Nan
chóng	швидко	None
chóc	ха-ха	Nan
chó	собака	Nan
chòm	сузір&#39;я	Nan
chòi	каюта	Nan
chò	задушити	Nan
chít	чіт	Nan
chính	головний	None
chín	дев’ять	Nan
chích	жало	Nan
chói	відблиски	Nan
chịu	ведмідь	Nan
ccc	куб.см	Nan
cbgd	cbgd	Nan
bẩm	вроджений	Nan
bầy	стадо	Nan
bầu	голосування	None
bần	бідний	Nan
bấy	це	None
bất	справжній	None
bấm	натиснути	Nan
bảy	сім	None
bảo	бао	Nan
bảng	дошки	None
bại	втрачати	Nan
bạch	білий	None
bạc	срібло	None
bạ	контакти	None
bướm	метелик	Nan
bước	крок	None
bưu	поштові витрати	Nan
bơm	насос	Nan
bơi	плавати	Nan
bẩn	брудний	Nan
bơ	вершкове масло	Nan
bẩy	пастка	Nan
bậc	ступінь	None
bệnh	хворий	Nan
bện	плетений	Nan
bệ	постамент	Nan
bể	сильфон	Nan
bền	довговічний	Nan
bề	поверхня	None
bếp	кухня	None
bến	причал	Nan
bẽ	приниження	Nan
bẻ	перерва	Nan
bẹp	розчавити	Nan
bằng	рівний	Nan
bắt	виловити	Nan
bắp	кукурудза	Nan
bắn	стріляти	Nan
bắcnam	північ південь	Nan
bắc	північ	None
bật	включено	None
bận	зайнято	Nan
bẫy	пастка	Nan
bỉ	бельгія	None
băng	лід	Nan
băm	хеш	Nan
bìa	обкладинка	Nan
bì	упаковка	Nan
bênh	хворий	Nan
bên	сторона	None
béo	жир	Nan
bén	гострий	Nan
bé	мало	None
bèn	тоді	None
bão	шторм	Nan
bãi	дворів	Nan
bã	залишок	Nan
bây	зараз	None
báu	скарб	Nan
bát	миску	Nan
báo	газета	None
báng	чуб	Nan
bán	продати	Nan
bám	чіплятися	Nan
bái	культ	None
bìu	мошонка	Nan
băn	лада	Nan
bí	сквош	Nan
bíró	гарбуз	Nan
bút	ручка	Nan
búng	заграв	Nan
bún	рисова локшина	Nan
búi	пучки	Nan
búa	молоток	Nan
bú	смоктати	Nan
bùng	спалахнути	Nan
bùn	грязі	Nan
bùa	оберег	Nan
bù	складають	None
bông	бавовна	Nan
bôi	намазаний	Nan
bô	батько	None
bóp	стиснути	Nan
bóng	куля	Nan
bón	удобрювати	Nan
bói	ворожіння	Nan
bó	купу	Nan
bò	корова	Nan
bính	бінь	Nan
bỉnh	неслухняний	Nan
bịch	пальця	Nan
bịt	вкриті	None
cardcaptor	карткаптор	Nan
carbine	карабін	Nan
carat	карат	Nan
capra	капра	Nan
capello	капелло	Nan
canxi	кальцій	Nan
canterbury	кентербері	Nan
cancer	рак	Nan
canary	канарка	Nan
canal	канал	None
canadian	канадський	Nan
canada	канада	None
campuchia	камбоджа	Nan
campbell	кемпбелл	Nan
camille	каміл	Nan
cameroon	камерон	Nan
cameron	камерон	Nan
cameo	камео	Nan
cambridge	кембридж	Nan
cardcaptors	карткаптори	Nan
cambodia	камбоджа	Nan
carey	дбайливий	Nan
caribê	карибський басейн	Nan
cbc	куб	Nan
cau	каку	Nan
catherine	катерина	None
cathay	кіт	Nan
castro	кастро	Nan
castries	кастри	Nan
cast	акторський склад	Nan
cassini	кассіні	Nan
caspia	каспія	Nan
casablanca	касабланка	Nan
casa	ca sa	Nan
carxtơ	карат	Nan
carter	картер	Nan
carpathia	карпатія	Nan
caroline	каролін	Nan
carol	колядувати	Nan
carnaval	карнавал	Nan
carlos	карлос	Nan
carl	карл	None
caribe	карібе	Nan
cam	апельсини	Nan
calvin	кальвін	Nan
calculus	числення	None
bột	борошно	Nan
bội	кратні	Nan
bộc	boc	Nan
bộ	набір	None
bỗng	раптом	Nan
bổng	стипендія	Nan
bổn	мито	Nan
bồi	компенсація	Nan
bốn	чотири	None
bối	розгублений	Nan
bốc	завантаження	Nan
bố	батько	None
bỏng	спалити	Nan
bỏ	відкликати	Nan
bọt	пінопласт	Nan
bọng	набряклість	Nan
bọn	їх	None
bọc	обернути	Nan
bọ	помилка	Nan
bớ	закруглювати	Nan
bớt	менше	None
bờ	край	None
bời	шишка	Nan
cal	кал	Nan
cairo	каїр	Nan
cai	цай	Nan
café	кава	Nan
caffein	кофеїну	Nan
caesar	цезар	None
cacbua	карбід	Nan
cacbonat	карбонат	Nan
cacbon	вуглець	Nan
cbs	кілограми	Nan
cabo	кабо	Nan
ca	зрушення	Nan
bực	розчарований	Nan
bữa	трапеза	Nan
bừa	боронування	Nan
bứt	несвідомо	Nan
bụng	шлунок	None
bục	подіум	Nan
bởi	від	None
bở	від	None
ca-lo	ка-ло	Nan
mĩ	америка	None
giò	рулети	Nan
giòn	хрусткий	Nan
loạicựu	тип	None
loạicông	тип	None
loạicâu	тип	None
loạicác	тип	None
loạichiến	тип	None
loạibệnh	тип захворювання	Nan
loạianime	введіть аніме	Nan
loạianh	тип	None
loại	види	None
loét	виразка	Nan
loãng	змитий	Nan
loát	кричущий	Nan
loài	види	None
love	любов	None
louvre	жалюзі	Nan
louisiana	louisiana	Nan
louis	луї	None
los	лос	Nan
lorenzo	лоренцо	Nan
loạigia	тип	None
long	довго	None
loạihuân	добродушний	Nan
loạimáy	тип машини	Nan
lucas	лукас	Nan
luang	луанг	Nan
lu	лу	Nan
lp	лп	Nan
loạt	серія	None
loạn	розлад	Nan
loạixã	тип	None
loạivõ	тип типу	Nan
loạitổ	тип	None
loạitín	добрий	None
loạitrường	тип школи	Nan
loạithần	тип	None
loạithành	тип	None
loạithuật	вид закону	Nan
loạiscandal	флейскандаль	Nan
loạiphong	тип	None
loạiphim	тип фільму	Nan
loạingày	наберіть це	Nan
loạimôn	тип	None
loạiluật	вид закону	Nan
lucia	люція	Nan
london	лондон	None
logan	логан	Nan
lionel	ліонель	Nan
linux	linux	Nan
links	посилання	None
linh	лінх	Nan
linga	linga	Nan
lilly	лілі	Nan
lightning	блискавка	Nan
liga	ліга	None
liechtenstein	ліхтенштейн	Nan
lido	лідо	Nan
libya	лівія	Nan
libero	ліберо	Nan
libby	лобі	Nan
lhq	lhq	Nan
lhp	л.с.	Nan
lg	lg	Nan
lesotho	лесото	Nan
leslie	леслі	Nan
les	лес	Nan
lisboa	лісбоа	Nan
lon	може	None
lisbon	лісабон	Nan
liu	лю	Nan
log	журнал	None
lockheed	замкнутий	Nan
locke	локаке	Nan
loch	лох	Nan
loang	гладкий	Nan
loaita	лоайта	Nan
loa	говорити	None
lo	турбуватися	Nan
lleyton	ллейтон	Nan
liệu	будь	None
liệt	параліч	Nan
liệng	кинути	Nan
liễu	верба	Nan
liều	доза	Nan
liềm	серп	Nan
liêu	бюрократія	Nan
liêng	священний	Nan
liên	підприємство	None
liêm	цілісність	Nan
litva	литва	None
leonid	леонід	None
luciano	лучано	Nan
ludovico	ludovico	Nan
lôn	лол	Nan
lôi	помилка	Nan
lô	багато	None
lót	слизова оболонка	Nan
lóng	сленг	Nan
lóe	спалахнув	Nan
lóc	зміїна голова	Nan
lòng	розчавити	Nan
lò	піч	Nan
líu	кухар	Nan
lít	літр	Nan
lính	солдат	Nan
lí	зберігання	None
lình	раптом	Nan
lìa	залишати	Nan
lênin	ленін	None
lênh	командування	None
lên	вгору	None
lêmạc	світла	None
lông	волосся	None
lê	груша	Nan
lõi	серцевина	Nan
lùi	відсталий	Nan
lưng	назад	None
lư	кадило	Nan
lơi	послабити	Nan
lơ	зневага	Nan
lũy	кумулятивний	Nan
lũng	долина	None
lũ	повінь	Nan
lĩnh	домени	Nan
lăng	мавзолей	Nan
lăn	кочення	Nan
lăm	п’ять	Nan
lút	підлий	Nan
lúp	збільшувальний	Nan
lúng	спалахнути	Nan
lún	осідання	Nan
lúc	у	None
lúa	рисовий	Nan
lùng	полювати	Nan
lùn	короткий	None
lõm	увігнуті	Nan
ludendorff	лудендорф	Nan
lén	ковзати	Nan
lão	старий	None
ly	скло	Nan
luỹ	кумулятивний	Nan
luộc	варений	Nan
luồng	потік	None
luồn	різьбові	Nan
luật	закон	None
luận	прокоментуйте	Nan
luyện	навчання	None
luyến	вкладення	Nan
luy	луй	Nan
luxembourg	люксембург	Nan
luther	лютер	None
lustig	люстиг	Nan
lung	легеня	Nan
lula	лула	Nan
luiz	луїз	Nan
luis	луїс	Nan
lui	назад	None
ludwig	людвіга	Nan
lydia	лідії	Nan
lèo	lèo	Nan
lympho	лімфома	Nan
lyon	ліон	Nan
lãnh	отримано	Nan
lãm	показує	None
lãi	відсотки	Nan
lây	заразний	Nan
lâu	довго	None
lân	єдиноріг	Nan
lâm	лам	Nan
láng	глянцевий	Nan
lán	халупа	Nan
lái	привід	Nan
lách	селезінка	Nan
lác	косити	Nan
lá	листя	None
lào	лаос	Nan
lành	зцілився	Nan
làng	село	None
làn	провулок	Nan
làm	робити	None
là	був	None
lyndon	ліндон	Nan
leonardo	леонардо	None
leonard	леонард	Nan
leon	леон	Nan
komodo	комодо	Nan
kogoro	kogoro	Nan
kofun	kofun	Nan
kodansha	коданша	Nan
koch	кох	Nan
knuth	кнут	Nan
knesset	knesset	Nan
km	кілометр	Nan
klein	клейн	Nan
klaus	klaus	Nan
kiệu	паланкін	Nan
kiệt	шедевр	None
kiện	подати в суд	Nan
kiệm	економний	Nan
kiểu	тип	None
kiểm	перевірити	Nan
kiềm	лужні	Nan
kiết	кіếт	Nan
kiếp	час життя	Nan
kon	кон	Nan
kiêu	зарозумілий	Nan
kong	конг	Nan
konversationslexikon	конверсіїlexikon	Nan
kunst	кунст	Nan
kungfu	кунг-фу	Nan
kung	кунг	Nan
kune	куна	Nan
kulak	куркуль	Nan
kuiper	kuiper	Nan
kuen	куен	Nan
kubrick	кубрик	Nan
kuala	куала	Nan
ku	ку	Nan
krông	кронг	Nan
kristen	kristen	Nan
kremlin	кремлін	Nan
kremli	кремлі	Nan
kosovo	косово	Nan
koruna	коруна	Nan
kornai	корнай	Nan
koran	коран	None
kop	коп	Nan
konstantin	константин	Nan
kurd	курд	Nan
kiêng	утримуватися	Nan
kiêm	сперма	Nan
khổng	гігант	Nan
khổ	страждання	None
khống	конг	Nan
khốn	сволота	Nan
khối	рівень якості	Nan
khốc	страшний	Nan
khố	постільна білизна	Nan
khỏi	з	None
khỏe	сильний	None
khỏa	ню	Nan
khỉ	мавпа	Nan
khế	зірка фруктів	Nan
khẳng	стверджувальний	Nan
khắp	у всьому	Nan
khắc	висічка	Nan
khẩn	терміново	Nan
khấu	знижка	Nan
khấn	молитися	Nan
khấm	пронизаний	Nan
khởi	посвячені	Nan
kiên	терплячий	Nan
khủng	жахливий	Nan
khứu	пастель	Nan
kitô	християнин	Nan
kitts	котики	Nan
kissinger	поцілунок	Nan
kiss	поцілунок	Nan
kishimoto	кишимото	Nan
kiribati	кірібати	Nan
kinsey	кінзі	Nan
kingdom	царство	None
kim	кім	Nan
kilômét	кілометрів	None
kikyo	кікіо	Nan
kii	кії	Nan
kiernan	кіернан	Nan
kierkegaard	kierkegaard	Nan
kiel	кіль	Nan
kid	дитина	None
kia	що	None
ki	кі	Nan
khử	усунути	Nan
khủyu	сволота	Nan
kurt	курт	Nan
kuwait	кувейт	Nan
kwan	кван	Nan
larry	ларі	Nan
lap	колінах	Nan
laos	лаос	Nan
lao	туберкульоз	None
lanka	ланка	Nan
lanh	білизна	Nan
langue	млявість	Nan
lange	ланг	Nan
langdon	лангдон	Nan
lang	язик	Nan
landon	приземлитись на	Nan
land	земля	None
lan	лан	Nan
lama	лама	Nan
lam	лам	Nan
lai	гібридний	Nan
ladakh	ладах	Nan
laboulaye	лабулеві	Nan
label	етикетка	Nan
lars	лари	Nan
l	л	None
las	лас	Nan
lateran	латеран	Nan
leo	підйом	Nan
lenins	леніни	Nan
lenin	ленін	None
lem	лем	Nan
leiden	leiden	Nan
legacy	спадщина	None
lee	лі	Nan
lebanon	ліван	Nan
leave	залишати	Nan
leaf	лист	None
leach	вилугати	Nan
lazarus	лазар	Nan
lay	лежати	Nan
lawrence	законності	Nan
laurence	лоранс	Nan
laura	лора	Nan
lau	протирати	Nan
latvia	латвія	None
latinh	латинська	None
laser	лазер	Nan
kỷ	століття	None
kỵ	кавалерія	Nan
kịp	тримати	None
kí	знак	None
kình	окуляри	Nan
kìm	плоскогубці	Nan
kìa	ось	None
kêu	звучання	None
kênh	канали	None
kê	просо	Nan
két	сейфи	Nan
kép	подвійний	Nan
kéo	перетягнути	Nan
kén	кокон	Nan
kém	щонайменше	None
kèn	труба	Nan
kèm	укладений	Nan
kyūshū	кюшу	Nan
kyushu	кюшу	Nan
kyrgyzstan	кюрікістан	Nan
kwon	кван	Nan
kwen	kwen	Nan
kích	клацніть	Nan
kíchbom	кнопка	Nan
kín	приватний	None
kính	окуляри	Nan
kị	кавалерія	Nan
kỉ	століття	None
kệ	полиці	Nan
kềnh	громіздкий	Nan
kề	сусідній	Nan
kết	кінець	None
kế	наступний	None
kẽm	цинку	Nan
kẽ	проміжна	Nan
lươn	вугор	Nan
kẻo	щоб не	Nan
kẹt	застряг	Nan
kẹp	кліп	Nan
kẹo	цукерки	Nan
kạn	кан	Nan
kơnia	kàia	Nan
kĩ	ретельно	Nan
ký	знак	None
kít	скриплять	Nan
kíp	екіпаж	Nan
kẻ	хлопці	Nan
lương	зарплата	Nan
lưới	сітка	Nan
lướt	серфінг	Nan
moi	нові	None
mohammed	магомета	Nan
mohammad	магомета	Nan
modula	модуль	Nan
modul	модуль	Nan
mode	режим	None
mobile	мобільний	Nan
mm	мм	Nan
miệng	рот	Nan
miện	корона	None
miễn	звільнений	Nan
miền	домен	None
miếu	храм	None
miếng	шматки	Nan
miến	рисова локшина	Nan
miêu	кіт	Nan
miên	гіпноз	Nan
mitsubishi	mitsubishi	Nan
mitchel	міцель	Nan
molecular	молекулярний	Nan
missouri	міссурі	Nan
molotov	молотов	Nan
mongolia	монголія	Nan
morocco	марокко	Nan
morley	морлі	Nan
moriarty	моріарті	Nan
mori	морі	None
morgan	морган	Nan
moravia	моравія	Nan
mora	мура	Nan
moong	moong	Nan
moo	му	None
montreal	монреальне	Nan
montparnasse	монтпарнас	Nan
montmartre	монтмартр	Nan
montenegro	чорноморська	Nan
montana	монтана	Nan
montaigne	монтайн	Nan
mont	монт	Nan
monroe	монро	Nan
mono	мононуклеоз	Nan
monique	моніка	Nan
molypden	молібден	None
morris	морріс	Nan
mississippi	місісіпі	Nan
miroku	мироку	Nan
michigan	мічиган	Nan
michelangelo	мікеланджело	None
michaels	мікроелементів	Nan
michael	майкл	Nan
miami	маямі	Nan
meyers	meyers	Nan
meyer	мейєр	Nan
mext	mext	Nan
meteora	метеора	Nan
messiah	месія	Nan
messi	мессі	Nan
messerschmitt	messerschmitt	Nan
messenger	месенджер	Nan
mercedes	mercedes	Nan
menes	менес	Nan
mendeleev	менделєєв	Nan
melbourne	мельбурн	Nan
mekong	меконг	Nan
medvedev	медведєв	Nan
micro	мікро	Nan
misfits	невдач	Nan
microbiology	мікробіологія	Nan
micronesia	мікронезія	Nan
mirage	міраж	Nan
miraflores	мірафлори	Nan
minoa	міноа	Nan
minnesota	міннесота	Nan
ming	мін	Nan
mindanao	мінданао	Nan
minas	мінас	Nan
min	хв	Nan
milton	мільтон	Nan
miller	мельник	None
mill	млин	Nan
miley	милі	Nan
milano	мілано	Nan
milan	мілан	None
mikoyangurevich	микоянгуревич	Nan
mikoyan	мікоян	Nan
mike	мікрофон	Nan
miguel	мігель	Nan
microsoft	мікрософт	Nan
microeconomics	мікроекономіка	Nan
morrison	моррісон	Nan
morse	морс	Nan
moscow	москва	None
mép	край	None
méo	спотворене	Nan
mé	mé	Nan
mèo	кіт	Nan
mè	кунжут	Nan
mão	корон	Nan
mãnh	сильний	None
mãn	самовдоволений	Nan
mãimại	код	None
mãi	навіки	Nan
mã	код	None
mây	хмара	Nan
mâu	суперечливий	Nan
mân	розарій	Nan
mâm	лоток	Nan
máy	машина	None
máu	кров	None
mát	круто	Nan
mái	дах	Nan
mét	метр	Nan
máclênin	маркселенін	Nan
mênh	химерно	Nan
mì	локшина	Nan
münchen	münchen	Nan
mút	смоктання	Nan
múa	танцювати	Nan
mùi	запах	Nan
mùa	сезон	None
mù	сліпий	Nan
môtô	мотоцикл	Nan
môt	один	None
mônôxít	монооксид	Nan
mông	сідниці	Nan
môn	предметів	None
môi	кожен	None
mô	тканина	Nan
món	їжа	Nan
móc	гачок	Nan
mòn	слід	None
mò	нарікав	Nan
mía	очерет	Nan
mình	себе	None
mêtan	метан	Nan
mách	поради	Nan
mác	етикетка	Nan
má	мати	None
murdoch	мурдоч	Nan
munich	мюніх	Nan
mun	чорне дерево	Nan
mumbai	мумбаї	Nan
muhammad	мухаммед	Nan
much	багато	None
mua	купити	Nan
mu	му	None
mtv	mtv	Nan
msdos	msdos	Nan
ms	рс	Nan
mp	mp	Nan
mozart	мозарт	Nan
mozambique	мозамбік	Nan
movie	фільм	None
mourinho	моурінью	Nan
motown	мотосаун	Nan
moskva	москва	None
mosin	мосін	Nan
muromachi	муромачі	Nan
murphy	морфі	Nan
murray	муррей	Nan
mustang	мустанг	Nan
mày	ти	None
màu	колір	None
mào	гребінь	Nan
mành	жалюзі	Nan
màn	екран	Nan
mài	шліфування	Nan
mà	але	None
myspace	мій простір	Nan
myanmar	м&#39;янма	Nan
medina	медіна	Nan
myanma	м&#39;янма	Nan
muội	сестра	None
muỗng	ложка	Nan
muỗi	комар	Nan
muồi	пізно	None
muống	ложка	Nan
muốn	хочу	None
muối	сіль	None
muôn	хочу	None
muta	мута	Nan
muộn	пізно	None
khảo	експертиза	Nan
medici	medici	Nan
mcv	mcv	Nan
lộc	фортуна	Nan
lỗ	отвір	Nan
lồng	клітка	Nan
lồi	опуклий	Nan
lồ	гігант	Nan
lốt	вигляд	None
lốp	шина	Nan
lối	вихід	None
lốc	вихор	Nan
lố	над	None
lỏng	розпушений	Nan
lỏi	ворсинка	Nan
lọt	падіння	None
lọng	парасолька	Nan
lọi	косити	Nan
lọc	фільтр	Nan
lịch	календар	None
lị	дизентерія	Nan
lệnh	комінанд	Nan
lội	плавати	Nan
lệch	косий	Nan
lộn	перевернутий	Nan
lột	здирати	Nan
lự	вагається	Nan
lửng	борсук	Nan
lừng	видатний	None
lừa	хитрість	Nan
lứa	послід	Nan
lụy	наслідки	None
lụt	переповнення	Nan
lụi	згорів	Nan
lục	зелений	None
lụa	шовк	Nan
lợp	покрівельне покриття	Nan
lợn	свиня	Nan
lợi	прибуток	None
lỡ	міс	Nan
lở	міс	Nan
lời	слово	None
lờ	ігнорувати	Nan
lớp	клас	None
lớn	великий	None
lộng	чудова	Nan
lựa	вибрано	Nan
lệ	ставка	None
lều	намет	Nan
lấy	забрати	Nan
lấp	заливка	Nan
lấn	посягання	Nan
lạy	простувати	Nan
lạtma	ламма	Nan
lạp	ковбаса	Nan
lạng	ланг	Nan
lạn	гнилий	Nan
lại	знову	None
lạch	струмок	Nan
lạc	загублений	Nan
lạ	дивно	None
lǐ	lǐ	Nan
lượn	ковзати	Nan
lượm	збиратися	Nan
lược	гребінець	Nan
lưỡng	двостатеві	Nan
lưỡi	язик	Nan
lười	ледачий	Nan
lầm	неправильно	Nan
lễ	церемонія	Nan
lần	разів	None
lầy	болотистий	Nan
lề	маржа	Nan
lẻo	в’ялий	Nan
lẻn	підкрадатися	Nan
lẻ	дивно	None
lẹ	швидкий	None
lặt	різне	Nan
lặp	повторити	Nan
lặng	тихо	Nan
lắp	пристосування	None
lắng	врегулювати	Nan
lắm	дуже	None
lắc	струшувати	Nan
lậy	о так	Nan
lật	фліп	Nan
lận	обманювати	Nan
lẫy	щіпка	Nan
lẫn	розгублений	Nan
lẩy	стрибати	Nan
lẩu	гарячий горщик	Nan
lầu	підлогу	Nan
lựu	гранат	Nan
ma	привид	Nan
maastricht	маастрихт	Nan
mary	мері	Nan
marx	маркс	None
martin	мартін	Nan
marta	марта	Nan
marsu	марсу	None
marshall	маршал	Nan
marseille	марсель	Nan
mars	марс	None
marne	марна	Nan
marmara	мармеру	Nan
marić	марич	Nan
marino	марино	Nan
marina	марина	Nan
marie	марі	Nan
marianne	маріане	Nan
maria	марія	None
margaret	маргарет	Nan
marcus	маркус	Nan
marcos	маркос	Nan
maryland	меріленд	Nan
marcel	marcel	Nan
maría	марія	None
massachusetts	штат массачусетс	Nan
mcnamara	мкнамара	Nan
mcmahon	mcmahon	Nan
mclaren	mclaren	Nan
mchc	mchc	Nan
mcdonald	mcdonald	Nan
mccullough	mccullough	Nan
mccartney	маккартні	None
mccain	мккайн	Nan
mcafee	mcafee	Nan
maya	майя	None
may	шити	Nan
maxim	максим	None
mausolus	мавзолій	Nan
maurice	маврикій	Nan
mau	швидко	None
matthias	matthias	Nan
mats	килимки	Nan
mathematica	математика	None
mat	килимок	Nan
mas	мас	None
marc	марк	None
marat	марат	Nan
maradona	марадона	Nan
mainframe	мейнфрейм	Nan
mai	дах	Nan
mahal	махал	Nan
magiê	магнію	Nan
mafia	мафія	None
madrid	мадрид	Nan
madonna	мадонна	Nan
madison	медісон	Nan
madhouse	божевільний будинок	Nan
madeira	мадейра	Nan
macromedia	макромедіа	Nan
macma	магма	Nan
macintosh	macintosh	Nan
machu	мачу	Nan
machiavelli	макіавеллі	Nan
mach	мач	Nan
macedonia	македонія	None
macclesfield	macclesfield	Nan
macarthur	макартур	Nan
major	основні	None
makemake	макемаке	Nan
malacca	малака	Nan
malay	малайський	Nan
maps	карти	None
mao	мао	Nan
manuel	мануель	Nan
manti	манти	Nan
mankiw	mankiw	Nan
manila	маніла	Nan
manh	manh	Nan
mangnall	мангал	Nan
manga	манга	Nan
media	змі	None
mang	нести	Nan
mandela	мандела	Nan
manchester	манчестер	Nan
manche	манш	Nan
maluku	малуку	Nan
malta	мальта	Nan
mali	малі	None
maldini	мальдіні	Nan
malcolm	малькольм	Nan
malaysia	малайзія	Nan
mandy	манді	Nan
giòi	личинки	Nan
khảm	мозаїка	None
khả	можливість	None
hiếm	рідкісний	Nan
hiđrô	водень	None
hiên	ганок	Nan
hitters	нападники	Nan
hitter	нападник	Nan
hitler	гітлер	None
hitchcock	автостоп	Nan
hiroshima	хіросіма	Nan
hiroshi	хіроші	Nan
hiragana	хірагана	Nan
hinhtron	хінтхрон	Nan
hinh	хін	Nan
hindu	індуїстський	Nan
hindi	хінді	Nan
hindenburg	гінденбург	Nan
hinata	хіната	Nan
himalaya	гімалаї	Nan
hilton	хілтон	Nan
hillsborough	хіллсборо	Nan
hiến	давати	None
hidro	водень	None
hiếp	зґвалтування	Nan
hiềm	хворий	Nan
holocen	голоцен	Nan
holocaust	голокост	None
holmes	holmes	Nan
hokusai	хокусаї	Nan
hokage	гукання	Nan
hoi	хой	Nan
hogwarts	хогвартс	Nan
hoan	фестиваль	None
hoa	квітка	None
hn	hn	Nan
hmông	хмонг	Nan
hms	хм	Nan
hlv	тренер	None
hiệu	ефект	None
hiệp	половина	None
hiện	проявити	Nan
hiểu	зрозуміти	None
hiểm	небезпечний	Nan
hiền	шавлія	None
hiếu	синівська шанобливість	Nan
holt	затримати	Nan
hideyoshi	шайоші	Nan
hicks	хіки	Nan
heath	вереск	Nan
health	здоров&#39;я	Nan
he	він	None
hd	hd	Nan
hcl	hcl	Nan
hbv	hbv	Nan
hb	hb	Nan
hay	добре	None
hawking	хокінг	Nan
hawker	яструб	Nan
havilland	хавіланд	Nan
havana	гавана	Nan
harvey	врожай	Nan
harvard	гарвард	Nan
harry	гаррі	None
harris	гарріс	Nan
harrier	harrier	Nan
harpercollins	харперколліни	Nan
harper	harper	Nan
hee	хі	None
hideto	гідето	Nan
hegel	гегель	Nan
heinrich	генріх	None
hickam	хикам	Nan
hi	привіт	Nan
hestia	гестія	Nan
hesiod	нерішучий	Nan
hersh	суворий	Nan
hermes	гермес	Nan
hermann	герман	Nan
hercules	геркулес	Nan
hercegovina	герцеговина	Nan
herbert	герберт	Nan
her	її	None
heo	несвіжий	Nan
henry	генрі	Nan
hen	курка	Nan
hemoglobin	гемоглобін	Nan
hematocrit	гематокрит	Nan
heli	гелій	Nan
helena	гелена	Nan
helen	хелен	Nan
heian	heian	Nan
harold	гарольд	Nan
hom	живці	Nan
hon	честь	None
hán	посуха	Nan
hái	забрати	Nan
hách	непосильний	Nan
hào	ров	Nan
hàng	ряд	None
hàm	щелепа	Nan
hài	комедія	None
hà	га	None
hyperion	гіперіон	None
hydro	водень	None
hydra	гідра	Nan
huỷ	скасувати	Nan
huỳnh	сірка	None
huống	справа	None
huệ	відтінок	Nan
huế	відтінок	Nan
huấn	навчання	None
huê	відтінок	Nan
huân	хуан	Nan
háo	нетерплячий	Nan
huyệt	акупунктурні точки	Nan
hát	співати	Nan
hân	хань	Nan
hót	співати	Nan
hóc	hóc	Nan
hòng	ну	Nan
hòn	острів	None
hòm	ковчег	Nan
hòe	лайно	Nan
hòa	краватку	Nan
hò	знайомства	Nan
hít	дихати	Nan
hí	пе	Nan
hên	пощастило	Nan
hét	кричати	Nan
héo	в&#39;янути	Nan
hé	розтріскався	Nan
hè	літо	None
hãnh	гордий	Nan
hãng	фірма	Nan
hãn	хан	None
hãi	переляканий	Nan
hâm	божевільний	Nan
homer	хомер	Nan
huyện	район	None
huyền	містичний	Nan
hoạ	фарба	Nan
hoãn	вони їдять	Nan
hoán	завивка	Nan
hoá	хімія	None
hoành	діафрагма	Nan
hoàng	король	None
hoàn	завершено	Nan
hoài	ностальгічний	Nan
hoà	краватку	Nan
however	проте	None
howard	хоард	Nan
houston	х&#39;юстон	Nan
hotspur	хотспур	Nan
hornet	шершнем	Nan
hopkins	гопкінги	Nan
honshū	хоншу	Nan
honolulu	гонолулу	Nan
hong	гонг	Nan
honduras	гондурас	Nan
hoại	гангрена	Nan
huyễn	ілюзорні	Nan
hoạt	хентай	None
hoảng	паніка	Nan
huynh	брат	None
huy	хуй	Nan
hutech	hutech	Nan
huston	хустон	Nan
husserl	хусерль	Nan
hussein	хусейна	Nan
hurley	хурлі	Nan
hunt	полювати	Nan
hungary	угорський	Nan
hun	хун	Nan
hume	hume	Nan
hugo	hugo	Nan
hughes	обіймає	Nan
huey	відтінок	Nan
hudson	гудзон	Nan
hudgens	hudgens	Nan
hq	hq	Nan
hp	к.с.	Nan
hoặc	або	None
hoả	вогонь	None
harlow	жнива	Nan
harlem	harlem	Nan
hardy	витривалий	Nan
greenson	зелений	None
greenland	гренландія	Nan
greek	грецький	None
granit	граніт	None
granada	гранада	Nan
graham	грем	Nan
grabeel	грабель	Nan
gottfried	готфрід	Nan
gothic	готика	None
gorky	горький	Nan
gore	гору	Nan
gordon	гордон	Nan
gorbachyov	горбачйов	Nan
gorbachev	горбачов	Nan
google	google	None
gom	збирати	Nan
golden	золотистий	Nan
goku	гоку	Nan
goes	іде	None
greenwich	грінвіч	Nan
go	йти	None
greg	грег	Nan
grenadines	гранатини	Nan
gundam	гундам	Nan
gullit	гуліт	Nan
gulf	затока	None
gulag	гулаг	Nan
gujarat	гуджарат	Nan
guitar	гітара	Nan
guinness	гіннес	Nan
guinea	гвінеї	Nan
gui	gui	Nan
guatemala	гватемала	Nan
guard	охоронець	Nan
guam	гуам	Nan
gu	стиль	None
gsts	gsts	Nan
gs	gs	Nan
gryffindor	грифіндор	Nan
gruzia	грузія	None
grumman	грумман	Nan
gross	валовий	None
grenada	гренада	Nan
gunung	рушниця	Nan
gnp	gnp	Nan
glucose	глюкоза	Nan
giặc	ворог	Nan
giằng	підкріплення	Nan
giận	розлючений	Nan
giầu	багатий	None
giấy	папір	None
giấu	ховатися	Nan
giấm	оцту	Nan
giấc	спати	Nan
giản	спрощений	Nan
giảm	скорочення	None
giải	рішення	None
giả	підробка	Nan
giường	ліжко	Nan
giương	спалахування	Nan
giơ	варення	Nan
giũa	файл	None
giúp	допомогу	None
gióng	подібно до	Nan
gió	вітер	None
giặt	мити	Nan
gmail	gmail	Nan
giếng	ну	Nan
giềng	сусід	Nan
gloster	блиск	Nan
gloria	глорія	Nan
glonass	глянцю	Nan
glazer	глазур	Nan
gladys	радіс	Nan
giữa	між	None
giữ	тримай	Nan
giục	закликав	None
giỡn	жартувати	Nan
giở	спалах	Nan
giờ	годин	None
giới	стать	Nan
giỗ	річниця смерті	Nan
giồng	гіонг	Nan
giỏi	чудовий	Nan
giỏ	кошик	Nan
giọt	крапля	Nan
giọng	тон	None
giễu	насмішки	Nan
giết	вбити	Nan
gustave	густав	Nan
gutenberg	гутенберг	Nan
guyana	гайана	Nan
gỡ	розвантажувати	Nan
gởi	надіслати	Nan
gờ	виступ	None
gớm	огидний	Nan
gộp	злиття	None
gội	шампунь	Nan
gỗ	ліс	None
gồng	гонг	Nan
gồm	у тому числі	Nan
gốm	керамічні	Nan
gối	подушка	Nan
gốc	походження	None
gỏi	салат	Nan
gọt	шкірка	Nan
gọng	облямований	Nan
gọn	акуратний	Nan
gọi	дзвінок	Nan
gỉ	іржавий	Nan
gặt	збирати урожай	Nan
gợi	навіюючий	Nan
gặp	зустрітися	Nan
gục	вниз	Nan
gửi	надіслати	Nan
harald	харальд	Nan
hao	хао	Nan
hansen	hansen	Nan
hanja	ханя	Nan
hanh	хан	None
hangul	ангал	Nan
hang	печера	Nan
han	хан	None
hamilton	гамільтон	None
ham	шинка	Nan
halogen	галоген	Nan
halle	халле	Nan
hal	хал	Nan
hai	два	None
hahn	хан	None
haeberle	геберле	Nan
habsburg	габсбург	Nan
habana	хабана	Nan
ha	га	None
gừng	імбир	Nan
gặm	гризти	Nan
gắt	суворо	None
gắng	спробуйте	Nan
góp	розстрочку	Nan
gói	пакет	Nan
góc	куточок	Nan
góa	вдова	Nan
gòn	gòn	Nan
gò	пагорб	Nan
gìn	зберегти	None
gì	що	None
gãy	зламаний	Nan
gây	причина	None
gân	закрити	Nan
gáy	потилиця	Nan
gánh	нести	Nan
gán	призначити	Nan
gái	дівчина	None
gác	охоронець	Nan
gào	скрикнув	Nan
gài	підтягувати	Nan
gà	курка	Nan
gót	каблук	Nan
gõ	тип	None
göbbels	göbbels	Nan
găm	скарб	Nan
gắn	змонтований	Nan
gắm	пердіти	Nan
gậy	палиця	Nan
gập	скласти	None
gẫy	зламаний	Nan
gầy	худий	Nan
gần	поряд з	Nan
gấu	ведмідь	Nan
gấp	поспішайте	Nan
hô	хо	Nan
gấm	парчі	Nan
gảy	перерва	Nan
gả	одруження	Nan
gạt	розкрадений	Nan
gạo	рис	None
gạc	марлеві	Nan
gương	дзеркало	None
gươm	меч	Nan
gũi	закрити	Nan
găng	рукавички	Nan
gấc	gac	Nan
hôi	фол	Nan
hôm	день	None
hôn	поцілунок	Nan
kashmir	кашмір	Nan
karim	карим	Nan
karen	карен	Nan
karatedo	каратіо	Nan
karate	карате	Nan
karaoke	караоке	Nan
kara	кара	Nan
kar	кар	Nan
kant	кант	Nan
kanji	кандзи	Nan
kangin	кангін	Nan
kana	кана	Nan
kampuchea	кампухея	Nan
kampong	кампонг	Nan
kampf	kampf	Nan
kamov	камов	Nan
kamakura	камакура	Nan
kama	кама	Nan
kali	калію	Nan
kaspersky	касперський	Nan
kalashnikov	калашников	Nan
katakana	катакана	Nan
katherine	катерина	None
kentucky	кентуккі	Nan
kenny	kenny	Nan
kenneth	кеннет	Nan
kennedy	кеннеді	Nan
ken	кен	Nan
kem	крем	Nan
kelvin	кельвін	Nan
kelsi	кельси	Nan
kelly	келлі	Nan
ke	ке	Nan
kcn	ккн	Nan
kazan	казан	Nan
kay	кей	Nan
kawasaki	кавасакі	Nan
kavkaz	кавказ	None
kauthara	каутхара	Nan
katz	кац	Nan
katrina	катрина	Nan
kathmandu	катманду	Nan
kate	кате	Nan
kepler	кеплер	Nan
kaká	якá	Nan
kai	кай	Nan
joint	суглоб	Nan
johor	джохор	Nan
johnston	джонстон	Nan
johns	джон	None
johnny	джоні	Nan
johannesburg	johannesburg	Nan
johannes	йоханні	Nan
johann	джохан	Nan
johan	джохан	Nan
joe	джо	Nan
joan	жанна	Nan
joachim	йоахім	Nan
jiraiya	джирая	Nan
jing	цзінь	Nan
jin	джин	Nan
jimmy	джимі	Nan
jiao	цзяо	Nan
jewish	єврейський	Nan
jetstar	jetstar	Nan
jonathan	джонатан	Nan
kakashi	какаші	Nan
jones	джонс	Nan
joseon	хосеон	Nan
kahn	кан	Nan
kagome	кагоме	Nan
kaffee	кава	Nan
kaede	каеде	Nan
k	к	None
juventus	ювентус	Nan
jura	юра	None
jupiter	юпітер	Nan
junsu	джунсу	Nan
jung	джунг	Nan
june	червня	None
jump	стрибати	Nan
julliard	жалюзі	Nan
julesverne	julesverne	Nan
judo	дзюдо	Nan
judith	джудіт	Nan
juche	juche	Nan
jscript	jscript	Nan
joseph	йозеф	Nan
jose	джозе	Nan
kerala	керала	Nan
kevin	кевін	Nan
keynes	кейнс	Nan
khánh	незалежність	None
kháng	опір	None
khán	аудиторія	Nan
khám	експертиза	Nan
khái	концептуальні	Nan
khách	гість	Nan
khác	інший	None
khá	скоріше	None
khuỷu	ліктьовий	Nan
khuếch	посилюватися	Nan
khuẩn	бактерії	None
khuấy	ворушився	Nan
khuất	приховано	Nan
khuyển	собака	Nan
khuyết	несправний	Nan
khuyên	порада	Nan
khuynh	зліва	None
khural	хураль	Nan
khung	кадри	Nan
khát	спраглий	Nan
khu	чверті	None
khâm	кхм	Nan
khéo	геніальний	Nan
khước	заперечувати	Nan
khưu	khưu	Nan
khư	хư	Nan
khơi	офшор	Nan
khăn	рушник	Nan
khăm	неприємний запах	Nan
khúc	сегмент	Nan
không	не	None
khôn	мудрий	None
khô	висушені	Nan
khóm	ананас	Nan
khói	диму	Nan
khóc	плач	Nan
khóa	замикати	Nan
khó	важко	None
khít	закрити	Nan
khích	заохочувати	Nan
khía	висічка	Nan
khép	закрити	Nan
khèn	на жаль	Nan
khrushchyov	хрущов	None
khrushchev	хрущовка	Nan
khoẻ	штрафу	Nan
khiên	щит	None
khiêm	скромний	Nan
khieu	не розуміти	Nan
khi	коли	None
kheo	на ходулях	Nan
khen	похвала	Nan
khem	хем	Nan
khe	виїмка	Nan
khay	лоток	Nan
khao	туга	Nan
khanh	хан	None
khang	кханг	Nan
khan	безводний	Nan
kham	хам	Nan
khalip	халіп	Nan
khali	халі	Nan
khai	декларація	None
kha	ха	Nan
kg	кг	Nan
khiêu	еротичний	Nan
khiếm	порушені	Nan
khiến	причина	None
khiếp	жахнувся	Nan
khoảnh	моменти	None
khoảng	бл	None
khoản	пункт	None
khoả	голий	Nan
khoăn	лада	Nan
khoét	вирізати	Nan
khoát	остаточний	Nan
khoáng	мінеральні	None
khoán	запас	Nan
jesus	ісус	None
khoác	пальто	Nan
khoe	демонструючи себе	Nan
khoanh	задзвонити	Nan
khoang	порожнину	Nan
khoan	дриль	Nan
khoa	факультет	None
kho	склад	None
khleang	klean	Nan
khiển	контроль	None
khiếu	будиночок	Nan
khoá	замок	None
khải	одкровення	Nan
jesse	джессі	Nan
jersey	трикотаж	Nan
hồ	озеро	None
hốc	ніші	Nan
hố	яма	Nan
hỏng	зламаний	Nan
hỏa	вогонь	None
họp	зустріч	None
họng	горло	Nan
học	вчитися	Nan
họach	план	None
họa	мистецтво	None
họ	прізвище	None
hịch	гром	Nan
hỉ	удар	Nan
hệt	однакові	None
hệ	система	None
hễ	е-е	Nan
hề	клоун	Nan
hết	над	None
hến	мідії	Nan
hồi	аніс	Nan
hẻo	усамітнено	Nan
hồn	душа	None
hổi	ага	Nan
hửu	так	None
hử	так	None
hứa	обіцянка	Nan
hủy	скасувати	Nan
hủi	прокажений	Nan
hụt	дефіцит	Nan
hợpquận	згода	Nan
hợp	добре підходить	Nan
hợi	свиня	Nan
hỡi	ой	None
hở	відчинено	Nan
hờn	похмурий	Nan
hớn	- кричав	Nan
hới	відчинено	Nan
hộp	ящик	Nan
hội	фестиваль	None
hỗn	змішаний	Nan
hỗ	підтримка	None
hổng	зияючи	Nan
hổ	тигр	None
hữu	майно	None
hẻm	алея	Nan
hẹ	шалот	Nan
hưởng	насолоджуватися	Nan
hường	хуонг	Nan
hướng	напрямок	None
hước	жартівливий	Nan
hương	пахощі	Nan
hưu	пенсіонер	Nan
hư	поганий	Nan
hơn	ніж	None
hơi	трошки	Nan
hũ	банки	None
hđh	hđh	Nan
hđbt	hđbt	Nan
hăng	гострий	Nan
hút	куріння	Nan
húng	натхнення	Nan
húc	гору	Nan
hùng	героїв	None
hù	налякати	Nan
hông	стегна	Nan
hạ	літо	None
hẹp	вузький	Nan
hạc	фламінго	Nan
hại	шкода	Nan
hặc	hặc	Nan
hằng	постійний	None
hắt	чхати	Nan
hắn	його	None
hắc	чорний	None
hậu	королева	Nan
hận	ненависть	Nan
hầu	майже	None
hầm	тунель	Nan
hấu	кавун	Nan
hất	кинути	Nan
hấn	hấn	Nan
hảo	досконалий	Nan
hải	митниця	Nan
hạt	насіння	Nan
hạp	гап	Nan
hạo	хао	Nan
hạnh	хань	Nan
hạng	клас	None
hạch	гангліон	Nan
hựu	хуу	Nan
hỷ	hy	Nan
ian	ян	None
jae	дже	Nan
jacob	жакоб	Nan
jackson	джексон	Nan
jackie	джекі	Nan
jack	домкрат	Nan
j	j	None
iwami	івамі	Nan
iv	iv	None
itzá	itzá	Nan
itu	іту	Nan
itsukushima	itukushima	Nan
ito	іто	Nan
itanium	ітаній	Nan
italiano	італіано	Nan
italia	італія	None
istanbul	істанбул	Nan
israeli	ізраелі	Nan
islamabad	ісламабад	Nan
islam	іслам	None
jakarta	джакарта	Nan
isla	острів	None
jan	січ	None
janet	жанет	Nan
jerry	джеррі	Nan
jerome	джером	Nan
jericho	джерічо	Nan
jenny	дженні	Nan
jenda	дженда	Nan
jeju	джеджу	Nan
jeffrey	джефрі	Nan
jefferson	джефферсон	Nan
jeff	джефф	Nan
jeet	струменевий	Nan
jeans	джинси	Nan
jeanpaul	jeanpaul	Nan
jeanjacques	jeanjacques	Nan
jeane	ревно	Nan
jean	жан	None
jasper	яшма	Nan
jarvis	жарвіс	Nan
jared	джеред	Nan
japan	японія	None
janeiro	janeiro	Nan
isaac	isaac	Nan
irving	ірвінг	Nan
irony	іронія	Nan
impact	вплив	None
immanuel	іммануїл	Nan
imbrium	імбріум	Nan
imam	імам	Nan
im	ім	None
ilyich	ілліч	Nan
illusion	ілюзія	Nan
ilene	ілен	Nan
iii	iii	None
igor	ігор	None
ieng	ieng	Nan
ide	іде	None
iceland	ісландія	Nan
icc	icc	Nan
ic	ік	Nan
ibmpc	ibmpc	Nan
ibm	ibm	Nan
iberia	іберія	Nan
iau	iau	Nan
incoterm	інкотерм	Nan
incoterms	інкотерми	Nan
indian	індійський	Nan
indiana	індіана	Nan
irgun	іргун	Nan
ireland	ірландія	None
iraq	ірак	Nan
iran	іран	None
iosif	іосіф	Nan
ion	іон	Nan
ioc	йок	Nan
io	іо	Nan
inư	іну	Nan
jerusalem	єрусалем	Nan
inuyasha	інуяша	Nan
interpol	інтерпол	Nan
intel	інтел	Nan
int	int	Nan
insulin	інсулін	Nan
innsbruck	інсбрук	Nan
info	інформація	None
indrapura	індрапура	Nan
indonesia	індонезія	None
indochina	індокитай	Nan
inu	іну	Nan
≠	≠	Nan
