aajo	cười	None
púpò	hơn	None
púpo	nhiều	None
pò	lại	None
pòwe	ngữ	None
pípẹ́	dài	None
pípèsè	khoản	None
pípa	sát	None
péé	đó	None
péré	có	None
pé	đó	None
pèsè	cấp	None
quran	khí quyển	Nan
pèlúpèlú	cũng	None
pèhìndà	dịch	None
pè	là	None
pátáporongodo	rồi	None
pásíà	hầm	None
pàápàá	biệt	None
pààlà	giới	None
pàràkòyí	ngay	None
pàmò	biệt	None
px|kùránì	px | nhân	Nan
pupa	đỏ	None
príncipe	príncipe	Nan
pèlu	với	None
providence	phòng	None
ra	mua	None
rajya	mong	Nan
rome	chrome	None
roma	roma	Nan
roko	đông	None
rokirika	duyệt	None
rogbodiyan	loạn	None
roboto	mặt	None
robinson	robinson	None
ro	nghĩ	None
rnas	rnas	Nan
rnarna	quạ	None
rna	mẹ	None
race	đua	None
rn	rn	Nan
riresile	âm	None
rinle	mới	None
right|thumb|px|aworan	ảnh	None
richard	giàu	None
research	nghiên cứu	Nan
rere	tốt	None
repetejulo	nhất	None
repeats	lại	None
reggae	reggae	Nan
rank	cấp	None
ramadan	ramadan	None
riro	trí	None
ronald	ronaldo	Nan
proton	proton	Nan
produced	xuất	None
palauan	palauan	Nan
padá	vỏ	None
paapaa	biệt	None
paa	tắt	None
opolo	nhiều	None
ofò	lành	None
oyé	giới	None
ose	se	Nan
opolo	nhiều	None
omonìyàn	người	None
olorun	trời	None
panaˈma	panaˈma	Nan
odun	năm	None
olórun	trời	None
okùnrín	cười	None
ojó	mưa	None
odún	năm	None
oúnjẹ	ăn	None
owojagidijagan	bố	None
oun	ta	None
otutu	nhiều	None
otherwise	không	None
oseluarailu	dân	None
oscar	oscar	None
olósìn	tôn	None
protokolu	thức	None
panyanan	trụ	None
parapọ̀	trộn	Nan
press	nhấn	None
portuguese	nha	None
portonovo	portonovo	Nan
population	số	None
polaroid	polaroid	Nan
polandi	bóng	None
pojulo	nhất	None
po	thơ	Nan
plánẹ́tì	nước	None
platos	platos	Nan
piposi	nhiều	None
papa	cha	None
pipolongo	cáo	None
pinu	định	None
pinsoto	pinoto	Nan
pinsi	giảm	None
phillipines	phillipines	Nan
pelu	trai	None
petu	petu	Nan
periferi	periferi	Nan
penisula	dương	None
penh	penh	None
pele	dáng	None
paripari	thúc	None
pipo	nhiều	None
rorùn	dàng	None
rossii	rossii	Nan
rural	nông	None
sìbẹ̀	chưa	None
séyìn	lại	None
séyìn	lại	None
sénégal	dịch	None
ségun	khóc	None
sèle	cắp	None
são	mới	None
sáààrin	giữa	None
sáàpàdé	trợ	None
sápadè	này	None
sàì	tốt	None
sìni	tôm	None
sàngó	nhóm	None
sàmì	hiệu	None
sàbúrí	hết	None
symmetry	diện	None
swahili	tiếng	None
suny	nắng	None
sun	trời	None
sugbọ́n	hợp	None
sugbo	không	None
suez	salsa	Nan
structures	trúc	None
stella	stella	Nan
sàn	hơn	None
spectacular	mắt	None
síbèsíbè	nhiên	None
sílẹ̀	xuống	None
tabora	tránh	None
tabili	bàn	None
tabi	là	None
sísè	dịch	None
sísa	s .ía	Nan
sááju	phút	None
sisé	dục	None
sepò	cùng	None
se	làm	None
sùgbón	lại	None
síse	kết	None
síbú	đất	None
si	chắc	None
sùgbón	lại	None
sóko	cây	Nan
sójà	lính	None
sòrò	não	None
síí	đây	None
síwájú	đi	None
síwon	họ	None
síta	ngoài	None
síso	vẫn	None
síso	vẫn	None
síse	việc	None
sọ	nói	None
so	thế	None
sopin	thúc	None
soon	sớm	None
say	nói	None
santa	noel	None
samioro	sẵn	None
sambia	niên	None
salàyé	sống	None
salem	salem	None
sakyas	mùi	None
sakyamuni	theo	None
saheli	tiện	None
safta	hàng	None
safiwe	sánh	None
sb	sb	Nan
saffana	sapphire	Nan
saarland	sàn	None
saaree	trên	None
saarc	tẩy	None
rẹ	ấy	None
ròyìn	cáo	None
rìn	bộ	None
ré	c	Nan
république	république	None
ránmú	lo	None
ráhàn	hiện	None
ryan	ryan	Nan
safari	safari	None
schwarz	schwarz	Nan
sea	biển	None
seat	ghế	None
solomon	solomon	Nan
sohun	đúng	None
so	quý	None
slovo	slovo	Nan
sisupo	nhân	Nan
sisupapoerekusu	nhổ	None
sisopo	kết	None
sisodagba	lên	None
sise	nướng	None
sioux	sioux	Nan
sinsin	tôn	None
sinai	tội	None
silè	giọt	None
sile	sau	None
sihamoni	kết	None
sibesibe	chưa	None
sharon	sẻ	None
sewadi	tìm	None
seville	seville	Nan
sense	quan	None
senegal	sen	None
semudaju	nhiên	None
semolara	hen	None
seidamo	thoáng	None
segbese	năng	None
orúko	đồng	None
taino	long	None
orísìírísi	khác	None
orísiirísi	dạng	None
nombamewa	lên	None
nobel	nobel	None
nnaji	chú	None
nkàn	thư	None
nkan	điều	None
niyi	rồi	None
niye	đủ	None
niyato	biệt	None
niwaju	trước	None
nitosi	đó	None
nitoripe	vì	None
nombáméjì	tiên	None
nitoriidieyi	này	None
nilè	đây	None
nijẹr	nike	Nan
nigbà	đó	None
nigbakan	khi	None
nibere	sớm	None
nibe	đó	None
ngubengcuka	ngubengcuka	Nan
ngbero	kế	None
nevis	nevis	Nan
neptune	vương	None
nefimu	trai	None
nisinyi	nay	None
nebraska	n eric	Nan
novo	novo	Nan
nse	kế	None
nínlá	quá	None
nílẹ̀	đất	None
nílùú	phố	None
nílè	phía	None
nígbàtí	nào	None
nífẹ̀ẹ́	yêu	None
níbè	đó	None
níbè	đó	None
ní	có	None
nìyí	là	None
nìnú	tiếc	None
nri	ăn	None
nì	núi	Nan
náwo	phí	None
nàìjíríà	nigeria	None
nwa	bé	None
numeri	tê	None
nukleotidipupo	nucleotide	Nan
nukleotidi	nucleotide	Nan
nu	dẹp	None
ntoka	điểm	None
nsowikipedia	obowikipedia	Nan
nsolaboraro	vệ	None
nso	gần	None
náà	quá	None
nínu	hội	None
ncnc	ncnc	Nan
nawojulo	đánh đố	Nan
munispal	munispal	Nan
mulẹ̀	thành	None
mughal	âm	None
mtwara	lại	None
mtn	mtn	Nan
mozilla	mozilla	Nan
mozambique	mozambique	None
morogoro	động	None
morgan	morgan	None
monrovia	monrovia	Nan
mombasa	mombasa	Nan
muungano	muungano	Nan
mokanlelogbon	hai	None
mohandas	mohandas	Nan
minority	số	None
minnesota	minnesota	None
mimuwa	bám	None
mimoy	mimoy	Nan
miiràn	đi	None
micronesia	micronesia	None
michelle	michelle	Nan
mexico	mexico	Nan
mewar	mewar	Nan
meucci	meucci	Nan
mokaleladota	nhẹ	None
nawó	của	None
májèmú	tâm	None
méjèèjì	hai	None
nato	nato	Nan
nathaniel	nathaniel	Nan
namibia	đến	None
mẹ́talọ́kan	ba	None
mẹ́ta	ba	None
mẹ́rkúríù	chuột	None
mẹ́fà	sáu	None
múlẹ̀	chặt	None
mó	m	Nan
móra	khỏi	None
mókólà	dán	None
mère	vẽ	None
mò	hiểu	None
míìrán	khác	None
míràn	khác	None
mímọ́	thánh	None
ménu	là	None
méwàá	mười	Nan
métèètà	mộc	None
méta	ba	None
mérìnlélógójì	bốn	None
mérìndínlógún	sáu	None
méte	năm	None
mérindíláàdóta	lăm	None
mííràn	khác	None
níní	có	None
nípà	nhất	None
nítorípé	vì	None
onítumò	dịch	None
oníná	ngọn	None
onílẹ̀	xuống	None
oníkólóbó	mắng	None
onígbàgbó	già	None
onka	máy	None
onje	ăn	None
oniyijulo	vời	None
oniyewumeji	nhị	None
onisowo	thương	None
onisayensi	viên	None
onítèbọmi	tội	None
onipin	hợp	None
onilile	chủ	None
onilanaibagbepo	su	None
onigunfenfe	động	None
onigbowo	trợ	None
onigbeja	xây	None
onibugbe	thuê	None
onialjebra	tràng	None
omiadalu	lụt	None
omi	nước	None
olùkọ́	viên	None
olùkó	dẫn	None
oninawo	vay	None
olùkópa	góp	None
onítòhùn	toán	None
oníyanjù	hoạt	None
orílẹ́	tối	Nan
orílẹ̀	gia	None
orílèèdè	gia	None
oríkì	thơ	Nan
oríilẹ̀	báo	None
oríilè	gia	None
oruko	từ	None
orudnun	năm	None
oritameta	giữa	None
orisa	gốc	None
orisun	nguồn	None
oníwòsàn	bệnh	None
orisirisi	dạng	None
orileominira	áp	None
orilejoba	quyền	None
orileedeajoba	đế	None
orileede	gia	None
oriki	đông	None
oriire	mừng	None
ori	đầu	None
opposite	diện	None
opec	opec	Nan
ootọ́	thật	None
ooni	sấu	None
orinìyìn	hát	None
olùdarí	đạo	None
olùbátan	này	None
olóṣèlú	gia	None
ojùkòsì	mưa	None
ojuse	nhiệm	None
ojuoorun	hôn	None
ojukokoro	muốn	None
ojoru	áp	None
ojojumo	ngày	None
ojo	như	None
ogunlogo	đàn	None
ogun	tranh	None
ogbè	vực	None
ofin	luật	None
ojùkòtúu	mưa	None
ododo	công	None
obere	nhỏ	None
obairanderan	họ	None
oba	obama	None
nso	có	None
nǹkan	điều	None
níyanjú	cực	None
níwájú	trước	None
nítòótọ́	thật	None
nítòótó	chính	None
nítòsí	đó	None
nítumò	nghĩa	None
obínibí	sự	None
ojúlùmọ̀	quen	None
ojútáyé	nhớt	None
ojúìwé	trang	None
olóyè	thước	None
olódùmarè	năng	None
olympus	olympus	None
oluwakiri	dò	None
olusoju	bảo vệ	Nan
oluparapo	hợp	None
olumojuto	tham	None
olukowe	giả	None
olukoitan	dẫn	None
oludase	xuất	None
oluda	tạo	None
oloye	tài	None
oloselukan	chào	None
olora	mập	None
olopon	căng	None
ololugbe	bại	None
olokunkun	nghe	None
olojukanna	ngay	None
olohun	hữu	None
olodiajodojuko	lẫn	None
okunrin	ông	None
okunkun	bóng	None
oko	đồng	None
okhotsk	okshotsk	Nan
okeere	ngoại	None
orísìí	dạng	None
tainos	tainos	Nan
takuntakun	chế	None
talaka	nghèo	None
ìràwọ̀	sao	None
ìrànàna	giúp	None
ìrànlọ́wọ́	giúp	None
ìpínrò	văn	None
ìpìnlè	đầu	None
ìpìlẹ̀núkléù	mã	None
ìpolongo	cáo	None
ìnáwó	phí	None
ìnagije	thắng	None
ìmúsára	cường	None
ìmúnilérú	dụng	None
ìrí	nghiệm	None
ìmú	mũi	None
ìmò	sét	None
ìmò	rắn	None
ìlé	chủ	None
ìlè	hối lộ	Nan
ìlàìnàró	áp	None
ìlàorùn	tím	None
ìlànàn	ảo giác	Nan
ìlà	đề	None
ìlo	gọi	None
ìlera	khỏe	None
ìkọpa	gia	None
ìmóbìdo	sinh	None
ìkẹrin	tư	None
ìròkò	nghĩ	None
ìròyìnwiki	tức	None
ìtaeko	xưởng	None
ìta	ngoài	None
ìse	động	None
ìsòro	khăn	None
ìsílé	chủ	None
ìsèjoba	quyền	None
ìsèdá	tạo	None
ìsègbèfábo	năng	None
ìse	động	None
ìsọ	hàng	None
ìsú	dày	None
ìròyìn	tức	None
ìsòrí	khu	None
ìsìn	tôn	None
ìsèlè	xuất	None
ìsàlè	hôn	None
ìsomó	gia	None
ìsirò	phép	None
ìsinsìnyí	nay	None
ìse	động	None
ìsawo	toán	None
ìrúbo	đổ	None
ìró	thanh	None
ìròrùn	ảo giác	Nan
ìsòrò	thiền	None
ìtan	sử	None
ìkínin	sáu	None
ìkìjà	thách	None
ìdá	ngũ	None
ìdàrúdàpò	loạn	None
ìdàpapọ̀	nhất	None
ìdàgbà	thành	None
ìbílè	sinh	None
ìbílè	sinh	None
ìbáraeni	xe	None
ìbánisòrò	nối	None
ìbarà	sốt	None
èpón	nhiều	None
èwù	áo	None
ìdìmú	xáo	None
èsìn	tôn	None
èro	nghĩ	None
èka	ứng	None
èyì	phẩm	None
ète	đích	None
èsúrú	kiến	Nan
èsó	hồi	None
èrò	nghĩ	None
èràn	bệnh	None
ènìkan	đó	None
èlò	dùng	None
èkejì	cai	None
èrí	cớ	None
ìkìlò	dụng	None
ìdíisin	nguyên	None
ìdó	chích	None
ìkéde	khai	None
ìkèrèkú	nghẽn	None
ìkànna	giống nhau	Nan
ìkejì	cai	None
ìjọba	quyền	None
ìjò	đạo	None
ìjìnlè	bí	None
ìjìnlè	bí	None
ìjora	ghét	Nan
ìjoba	quyền	None
ìjo	nhà thờ	Nan
ìdíwòn	của	None
ìjo	nhảy	None
ìgbò	ram	None
ìgbésí	sống	None
ìgbéraga	hào	None
ìgbáraga	mạnh	None
ìgbá	cánh	None
ìgbàgbé	trí	None
ìgbà	gian	None
jé	họa	None
ìfáàrà	mục	None
ìfojúìtànìgbesiayé	sử	None
ìfara	tấn	None
ìhun	là	None
ìtokò	nồi	None
ìtàn	sử	None
ìtànkálé	lụt	None
ṣàkóbá	hại	None
ṣiṣé	mạc	None
σ	σ	Nan
κάππα	.α	Nan
ˌæləˈbæmə	ốm	None
ˌkælɪˈfɔrnjə	ɪˈkælɪˈfɔrnjə	Nan
ˈøːstəˌʁaɪç	stəˌʁaɪç	Nan
ʔaːnaːtɕɑ̀k	.aːnaːtɕɑɕɑk	Nan
şe	làm	None
únṣẹlẹ̀	đất	None
ôdún	năm	None
ẹdo	đùa	None
ó	đúng	None
ósírísì	bọt	None
óníse	kế	None
ó	nó	Nan
òròàjòmó	sáng	None
òrò	nghĩ	None
òwó	bạc	None
òsà	vàng	None
òrò	nghĩ	None
òré	chơi	None
òpòlopo	nhiều	None
òfò	theo	None
ósékú	chết	None
òré	chơi	None
ẹlẹ́bùn	món	None
ẹnìkan	người	None
ọ̀pòlòpò	động	None
ọ̀nà	đường	None
ọ̀gbìn	cây	Nan
ọ̀dọ́	niên	None
ọpọ́lọpọ́	sung	None
ọn	nó	Nan
ọmọ	trẻ	None
ọmú	mút	None
ọlọ́run	một vị thân	Nan
ọlọ́mọ	trẻ	None
ọdún	năm	None
ẹlẹ́sìn	tôn	None
ọbàkàn	mẹ	None
ẹ̀rọ	móc	None
ẹ̀ni	who	Nan
ẹ̀kọ́	dục	None
ẹ̀kẹ́ta	ba	None
ẹ̀kasístẹ̀mù	quan	None
ẹ̀kaoṣù	góc	None
ẹ̀kajuly	thể	None
ẹ̀kabrítánì	chú	None
ẹ̀kaawon	trình	None
ẹtì	gan	None
ẹsẹ	chân	None
ẹ̀wẹ̀	khác	None
òpòlopò	nhiều	None
òkòòkan	một	None
òkan	một	None
òdo	niên	None
òdeojú	danh	None
òde	ngoài	None
ìṣọ̣̀tẹ̣̀	phổi	None
ìṣẹ́kù	lại	None
ìṣèlú	trị	None
ìyípadà	đổi	None
ìyàwó	cô	None
ìyapa	biệt	None
ìya	khổ	None
ìwúlò	ích	None
òdìkejì	cai	None
ìwòran	nhìn	None
ìwéré	sách	None
ìwàásù	rao	None
ìwo	sừng	None
ìwe	sánh	None
ìtúpalè	dịch	None
ìtúmò	dịch	None
ìtóka	bị đánh	Nan
ìtójú	mặt	None
ìtóju	lẫn	None
ìtójú	tâm	None
ìtèsíwájú	phát	None
ìwò	thể	None
òféàrán	ảnh	None
ògbójú	quyền	None
ògiri	tường	None
òjògbón	ướt	None
òṣèlú	trị	None
òwù	vải	None
òsèré	lực sĩ	Nan
òsèlú	gia	None
òsán	bật	None
òrò	óc	None
òrí	chương	None
òrìsà	thần	None
òranyàn	bắt	None
òpópóònà	đường	None
òotó	thật	None
òní	nay	None
òmùàrán	ảnh	None
òmiràn	phù thủy	Nan
òle	trợ	None
òkúta	đá	None
òkú	chết	None
òkòòkan	một	None
òkèògbún	nghìn	None
òjísé	bác	None
òjo	như	None
ògúndìpẹ̀	nhẹ	None
ògun	thuốc	None
ògo	quang	None
èka	nhánh	None
èhìn	theo	None
èfòn	quá	None
èdè	ngữ	None
visit	thăm	None
viruses	virus	None
villa	thự	None
vihara	vihara	Nan
videos	video	Nan
victor	thắng	None
vermont	sâu	None
venezuela	venezuela	Nan
uzbek	cách	None
utc	utc	Nan
utah	ồ	Nan
vz	vz	Nan
usps	dụng	None
urasílì	uracil	Nan
unla	đúng	None
unifasiti	học	None
umueri	trẻ	None
ucb	ucb	Nan
tẹ̀ǹbẹ̀lẹ̀kun	mưu	None
tẹ̀ǹbẹ̀	đó	None
túnse	lại	None
túmò	mận	None
tú	suối	None
tóka	dẫn	None
uribe	quang	None
tó	tó	Nan
waa	là	None
wari	mùi	None
yafran	cái	None
xiv	xiv	None
xd	xd	Nan
wọ̀nyí	những	None
wọn	họ	None
wúnrèn	dục	None
wón	họ	None
wònyí	là	None
wòfún	nhìn	None
wípè	trong	None
wì	sạch	None
waju	mặt	None
wàásù	thuyết	None
wura	vàng	None
won	họ	None
wo	đây	None
wo	đây	None
woo	woo	Nan
wole	nhập	None
województwo	cheworddztwo	Nan
wiwari	phá	None
witkin	witkin	Nan
wisconsin	ngoan	None
westminster	tây	None
wyoming	hôn	None
tówùú	bất	None
tókù	ngơi	None
tódárajùlọ	nhất	None
tokyo	tokyo	None
tokasi	chỉ	None
toje	hiếm	None
to	đến	None
tiwọn	họ	None
titu	bắn	None
tirè	ấy	None
tirana	tirana	Nan
tira	quá	None
thumb|left|upright|nelson	nelson	None
those	đó	None
tolerejulo	chấp	None
they	họ	None
tfrac	tfrac	Nan
terutomo	terutomo	Nan
temptation	tìm	None
tele	sát	None
teksas	texas	None
tedo	hò	None
technology	công	None
taínos	taínos	Nan
tata	lọc	None
tara	chín	None
talika	nàn	None
the	các	None
tolórítelémù	hủy	None
tomé	chua	None
tooto	không	None
tóbi	lớn	None
tò	bộ	None
tíórì	xe	None
tíátà	vé	None
títío	khi	None
títèlé	theo	None
títi	cửa	None
té	t	Nan
télè	bởi	None
té	t	Nan
tèsíwájú	bộ	None
tèlé	ngay	None
tètè	mau	None
tèlé	sát	None
táawà	chào	None
tàwon	họ	None
tàsí	có	None
tuntun	mới	None
tumosi	nghĩa	None
translated	dịch	None
traduite	mại	None
tounsejanu	thảm	None
toseluaralu	trị	None
torun	brunette	Nan
tori	tori	Nan
yakubu	yakub	Nan
metropoli	đô thị	Nan
yan	chọn	None
yanturu	nhiều	None
àsìkò	gian	None
àsèyìn	hậu	None
àsàjemátèe	bình minh	Nan
àse	tiệc	None
àrẹ	tịch	None
àrùn	bệnh	None
àrígbámú	phiền	Nan
àpeere	dụ	None
àpapọ̀	chung	None
ànfàní	tốt	None
àmúsorò	học	None
àsótélè	rộng	None
àmúlò	dụng	None
àmérìkà	nhiên	None
àlébù	điểm	None
àlèpò	trên	None
àlè	khốn	None
àlááfià	sự	None
àlàáfíà	thanh	None
àlàyé	tin	None
àlàkalè	thắng	None
àkókó	gian	None
àkójopò	nhóm	None
àká	kệ	None
àmì	tên	None
àkàrà	bánh	Nan
àsọdọ̀kan	kết	None
àsà	quán	None
èdè	ngữ	None
èdá	tạo	None
èbúté	cảng	None
èbà	muỗi	None
áwon	dâm	None
án	t	Nan
àìsí	mặt	None
àìròtélè	bất	None
àìní	muốn	None
àìkó	hụt	None
àáyá	dịch	None
àsekúdórógbó	vỏ	None
àárín	giữa	None
ààtò	lễ	None
àwùjo	hội	None
àwón	bạc	None
àwón	tiền	None
àwon	thuyết	None
àtẹnudẹ́nu	uống	None
àtúnse	biên	None
àtúnse	biên	None
àtòrìnká	vòng	None
àtìpó	tinh	None
àtijo	thời	None
ààyè	sót	None
àkosílè	luận	None
àkosílè	trừu	None
àjọṣepọ̀	hội	None
yíì	sẽ	None
yíyípadà	đổi	None
yí	lại	None
yìí	này	None
yì	đi	None
yée	họ	None
yèwò	nhìn	None
yára	lên	None
yàtò	thiết	None
yànan	ngạc	None
yo	yo	Nan
yíò	sẽ	None
yorúbà	chua	None
yori	dẫn	None
yoo	sẽ	None
yiyafunnilo	mòn	None
yipada	lại	None
yiowu	sẽ	None
yio	sẽ	None
yindinyindin	lại	None
ye	vâng	Nan
ye	vâng	Nan
yewo	thiện	None
yaoundé	yaoundé	Nan
york	york	None
yẹ̀ẹ́	bạn biết	Nan
yọ	tẩy	None
zanzibar centralsouth	zanzibar centralsouth	Nan
àjákọ	biệt	None
àjo	lịch	None
àifète	đích	None
àgọ́	lều	None
àgbùdo	sân	None
àgbìgbò	cận	None
àgbéyèwò	ôn	None
àgbékà	trừu	None
àgbáríjọ	quan	None
àgbàrá	lụt	None
àgbàjọ	già	None
àdóolóró	dầu	None
àdáátán	quyền	None
àdátá	đối	None
àdámò	tư	None
àbọ̀	nửa	None
àbìkú	tử	None
àbáyo	ý	None
àbámẹ́ta	năm	None
àbe	chó	None
bce	xa	None
zy	zy	Nan
zscores	zscores	Nan
zou	zou	Nan
zdna	zdna	Nan
yanjú	giải	None
methodologies	luận	None
merin	bốn	None
mercosur	ngân	None
díè	quá	None
dìtẹ̀	mưu	None
dìró	phải	None
dìde	sinh	None
dì	tấm	None
dépò	mức	None
délànà	tắc	None
dé	đến	None
dáwó	tặng	None
dásà	choàng	None
dáradára	tốt	None
dóko	tốt	None
dálóríi	ơn	None
dágbó	già	None
dá	tạo	None
dàpò	chúng	None
dàbíi	này	None
dun	ngon	None
due	do	None
du	du	None
dover	dover	None
doublestrand	đôi	None
doublehelix	doublercix	Nan
dote	hiến	None
dájó	thỏa	None
doni	doni	Nan
dólà	tốt	None
dúró	đứng	None
eléré	lực sĩ	Nan
eléde	trừu	None
elláda	tạo	None
eleyii	này	None
eleyi	này	None
elede	lợn	None
eko	dục	None
ekeji	cai	None
eka	tạp	None
eighteen	tám	None
egbògi	khoa	None
dún	thanh	None
egbò	thương	None
egbo	thương	None
egberundun	năm	None
egbe	súng	None
egba	rồi	None
efrem	ứng	None
ede	ngữ	None
ecomog	thái	None
ebi	gia	None
eba	eba	Nan
ea	đúng	None
dọ́gba	bằng	None
egbé	khốn	None
elòmírà	biển	None
dominic	trị	None
doju	mặt	None
clear	thoáng	None
cipollone	cipollone	Nan
china	trung	None
cherished	ủ	None
chebbi	nghĩ	None
chaskalson	chaskalson	Nan
charles	ngựa	None
chamorro	chamorro	Nan
cbc	cbc	None
cauchy	cauch	Nan
catherine	cinda	Nan
code	mã	None
cathedral	đường	None
casablanca	casifer	Nan
cape	choàng	None
canaria	canaria	Nan
calabar	su	None
cairo	nộ	None
bẹ́ẹ̀sìni	đúng	None
bẹ́ẹ̀ni	đúng	None
bẹ́ljíọ̀m	beryl	Nan
bẹ́	vỡ	None
bẹ̀rẹ̀	đầu	None
búrú	cảm	None
caslon	bạc	None
dojú	mặt	None
coetsee	trị	None
coming	tới	None
divoire	sẻ	None
dinwoju	tra cứu	Nan
din	chiên	None
different	khác	None
didasile	thành	None
didagba	đẳng	None
development	phát	None
desmond	hạnh	None
describes	tả	None
des	des	None
denver	chối	None
coloured	rỡ	None
delhi	đừng	None
daru	hoại	None
darapo	gia	None
dani	giữ	None
dandan	bắt	None
dagbasoke	lên	None
da	và	None
cunha	họng	None
ct	ct	Nan
csto	csto	Nan
computers	máy	None
compared	so	None
dates	ngày	None
elòmíràn	khác	None
emerging	nổi	None
emmanuel	emmanuel	Nan
gbaná	bắn	None
gbale	biến	None
gbajúgbujà	tiếng	None
gba	ý	None
galatia	này	None
fẹ́rẹ̀ẹ́	hết	None
fòye	hiểu	None
fífún	cho	Nan
fífò	bay	None
fégbé	đi	None
fé	yêu	None
gbe	mang	None
fé	fé	Nan
funra	chinh no	Nan
fun	cho	Nan
fulbe	tựa	None
fulani	hèn nhát	Nan
fuji	tẩy	None
freetown	freetown	Nan
fransi	pháp	None
francis	francis	None
fracmv	fracmv	Nan
fowó	tiền	None
fowobowe	trước	None
further	nữa	None
fourbase	bốn	None
gbera	lên	None
gbese	nợ	None
geneva	geneva	Nan
geesi	anh	None
gbọ́dọ̀	phải	None
gbúnùn	đi	None
gbónmisi	luật	None
gbódò	phải	None
gbìyànju	sức	None
gbìnyànjú	thử	None
gbésè	phục	None
gbéyèwò	ôn	None
gbéni	trực	None
gberasoke	tốc	None
gbékalè	mộc	None
gbé	trực	None
gbáradì	dậy	None
gbá	vỡ	None
gbàgùrà	lắc	None
gbàgbọ́	tin	None
gbongbo	gốc	None
gbogbogbo	chung	None
gbin	trồng	None
gbilè	thoát	None
gbigbewo	chính	None
gbigbamulo	thác	None
gbédìí	thành	None
foriko	dụ	None
force	lực lượng	Nan
foniimu	ảnh	None
eyonomba	eyonomba	Nan
eyin	trứng	None
eya	loại	None
example	dụ	None
ewì	thơ	Nan
ewé	lá	None
ewe	lá	None
euroasia	euro	None
euro	euro	None
etíòkun	biển	None
etymologiae	nguyên	None
eléja	bắt	None
etisalat	etaluat	Nan
esia	đến	None
eseese	đồ	None
eréonítàn	tắt	None
erékùsù	đảo	None
erofo	tích	None
ernst	ernst	Nan
epa	phụng	None
eníbá	sốt	None
enì	voi	None
enter	vào	None
enikéni	người	None
esteri	esteri	Nan
elòmíràn	khác	None
eka	ứng	None
eléyàmèyà	tộc	None
fohùn	kêu	None
fofinde	cấm	None
fodio	fodio	Nan
five	năm	None
fitino	nghiệm	None
finlandi	lan	None
finiki	vật lý	Nan
fimú	ràng	None
fihan	chỉ	None
fifihan	hiển thị	Nan
fi	kiệm	None
fe	muốn	None
fesèmúlè	thời	None
ferde	ferde	Nan
felifeli	nhung	Nan
farsi	nghệ nhân	Nan
faranse	pháp	None
faramó	thủ	None
fan	quạt	None
fail	bại	None
fagile	bỏ	None
ewà	kiểm	None
esè	được	None
esin	tôn	None
enu	mồm	Nan
búburú	xấu	None
bòtswánà	buýt	None
béè	thế	None
bèrẹ̀	là	None
alawose	toán	None
alalaye	đất	None
alakobere	mới	None
alakitiyan	động	None
alaini	thiếu	None
alaigbara	lại	None
alaidogba	bằng	None
aladanida	bất	None
aladani	tư	None
aladaani	tư	None
alaafin	pháp	None
albany	albany	Nan
alaafia	thanh	None
alaabo	tật	None
ala	xuống	None
akẹ́kọ̀ọ́	viên	None
akíngbógun	đoàn	None
akíkanjú	cảm	None
akátá	rừng	None
akopo	soạn	None
akopa	nhất	None
akoni	có	None
akole	thể	None
akokolo	đoạn	None
alaadanida	muốn	None
akinpelu	pháo	None
albert	albert	None
alicia	alicia	Nan
anc	anc	Nan
anabi	tri	None
an	một	None
améríkà	mỹ	None
améríkà	mỹ	None
amosi	hồi	None
amojeoyipada	đổi	None
amerika	mỹ	None
americas	mỹ	None
amazonas	amazon	None
alọ́po	tiền	None
alexandra	alexandra	None
alúwo	nổ	None
aláyèwò	thanh	None
alátise	họa	None
alápapò	thế	None
alákọ̀bẹ̀rẹ̀	xướng	None
alumíníọ̀mù	nhôm	None
alumoni	bệnh	None
alukuraani	koran	None
alubàbá	bố	None
alpha	alpha	Nan
alominira	độc	None
allāh	cả	None
aláísàn	ốm	None
akiidah	coridah	Nan
ajọra	sao	None
ajoro	lịch	None
adiokan	độc	None
adeda	nhiên	None
addis	nghiện	None
adarihunrun	hơn	None
adabaye	rồi	None
adaba	lợi	None
accra	accra	Nan
abúléko	làng	None
abínibí	tịch	None
abé	kim	None
abálájo	nghiệm	None
adágbà	anh	None
aburunmu	tôi	None
abidjan	giờ	None
abidi	cái	None
abesahara	rắc	None
abeorile	về nhà	Nan
abeikojopo	kế	None
abala	phần	None
aawe	liệt	None
aare	aare	Nan
aapon	aapon	Nan
aanu	hại	None
aala	giới	None
abo	cái	None
kútò	đường	None
adúgbò mókóla	mạc	None
adúgbò quarry	xóm	None
ajo	lịch	None
ajibola	sự	None
ajemoroyin	vấn	None
aje	tê	None
ajagun	chó	None
aisi	sót	None
aintimulo	aintimulo	Nan
agio	khóc	None
agbéiná	hỏa	None
agbára	quyền	None
agbàbò	vệ	None
agbà	thành	None
agbeinadie	nghiệp	None
agbaye	giới	None
agbara	quyền	None
agbado	bắp	None
agba	sơn	None
aféfé	gió	None
africans	châu	None
african	châu	None
africa	châu	None
afoyemo	tắc	None
afomo	dụ	None
afida	gia	None
adúgbò ìdí	phố	None
andaman	người	None
genevieve	genevease	Nan
angkor	thần	None
anschluss	anschluss	Nan
benin	ghế	None
bengali	bengali	Nan
bengal	bengal	Nan
belgium	bỉ	None
belarus	belarus	Nan
beijing	bắc	None
beauharnais	beauharnais	Nan
bce	xa	None
bayìí	nay	None
bayi	nay	None
bayelsa	bayelsa	Nan
berber	berber	None
bauxitealumina	bauxitealumina	Nan
banle	ban	None
bang	bang	None
balẹ̀	được	None
bahrain	bahrain	None
babaláwo	tri	None
baa	là	None
aṣòkan	cá nhân	Nan
azikiwe	thường	None
ayò	ay	Nan
ayàfi	ổn	None
ayeye	cửu	None
bara	năm	None
aya	thơ	Nan
berlin	berlin	Nan
bharat	bharat	Nan
báyìí	nay	None
bárakú	nghiện	None
bálè	bay	None
bákannáà	cũng	None
bàbá	cha	None
by	bởi	None
burúkú	ác	None
bujumbura	rộng	None
buenaventura	buenaventura	Nan
bu	là	None
brítánì	anh	None
bernstein	bernstein	Nan
britain	anh	None
brazzaville	brazzaville	Nan
brasil	lót	None
bolívar	bolívar	Nan
bolt	chớp	None
bole	thân cây	Nan
bojú	xem	None
bodies	thể	None
black	đen	None
biribiri	nát	None
bibeli	thánh	None
bharata	lại	None
bridgeport	nối	None
awújẹ	bối	None
awùjo	sự	None
awuruju	diệu	None
arábíà	cái	None
aráa	trai	None
aryan	người	None
arun	bệnh	None
aruleyin	chào	None
aroko	thực	None
arkansas	ark	None
ariwaguusu	nam	None
ariwaarin	đông	None
ariso	aris	Nan
arinkankan	này	None
aráròmí	chào	None
aralíle	đới	None
apẹ̀rè	tạp	None
apòmù	tạp	None
apis	apis	Nan
apeere	dụ	None
apeja	dân	None
aparapo	hợp	None
apaiwoorun	tây	None
apailaorun	bình minh	Nan
apaguusuiwoorun	nam	None
apaguusuilaorun	nam	None
apagusu	nam	None
arabu	rập	None
arópò	hối lộ	Nan
arúgbó	già	None
arọ	què	Nan
awon	họ	None
awoòn	bản mẫu	Nan
awonara	xúc	None
awo	đĩa	None
awari	phá	None
avar	avar	None
austríà	châu	None
austronesian	người	None
austriahumgary	tổng	None
australia	châu	None
atunse	chỉnh	None
atun	lại	None
atinrin	cười	None
atimo	kế	None
atigba	chấp	None
atanna	tử	None
atangbona	tử	None
asèdá	nhiên	None
asìko	vô	None
assessment	giá	None
asipa	lệch	None
aseyori	công	None
aseeto	giải	None
ascii	tìm	None
asagun	thắng	None
anita	anita	Nan
ọ̀rọ̀	chuyện	None
georgia	georgia	Nan
gfaj	gfaj	Nan
kòjòkú	mưa	None
kírísìtì	sinh	None
kínu	hôn	None
kíkọ́	học	None
kíko	học	None
kí	chào	None
kìnní	tiên	None
kéyìn	sau	None
kémíkà	lại	None
kétu	chuẩn	None
kékéèké	nhỏ	None
kòkó	chuột	None
kéesì	cười	None
kánádà	nhiên	None
kánfinkése	khéo	None
ká	của	None
kàyéfì	nhiên	None
kàríbẹ́ánì	vực	None
kwara	giải	None
ku	bạn	Nan
krio	krio	Nan
kori	nữa	None
ko	không	None
koko	học	None
káyé	giới	None
koto	mồi	None
kòmpútà	vi	None
kòòsí	phải	None
labalaba	bướm	None
laarin	trong	None
laaka	ngược	None
laada	đá	None
laa	khác	None
kọ́ni	thiếu	None
kọ́lọ́mú	cột	None
kọ́kọ́	tiên	None
kọ̀mpútà	vi	None
kọjá	qua	None
kẹ́nyà	biệt	None
kòtò	hố	None
kẹta	ba	None
kẹrin	tư	None
kúùkù	lại	None
kútò	điều	None
kúrò	xa	None
kúkúrú	gọn	None
kúkú	cả	None
kùrání	koran	None
kùkú	cả	None
kóra	họp	None
kógo	quang	None
kòòkan	cái	None
kẹsàán	tức	None
labee	bên	None
kookan	này	None
kong	kong	None
kampala	kẹp	None
kalẹ	bên	None
kalinga	cinga	Nan
kakiri	vết	None
kagera	khoang	None
kadara	sản	None
jọ́	lòng	None
jẹ́mánì	đức	None
jùló	nhất	None
jùlo	biệt	None
jùlo	hơn	None
kan	một	None
jíjéomoléyìnkírísítì	thiện	None
jíje	được	None
jìnnàa	xa	None
jéésù	giêsu	None
jé	đến	None
jáde	đi	None
jàgídíjàgan	hung bạo	Nan
juneau	khấu	None
jo	john	Nan
jopò	vào	None
jojo	nứt	None
johanu	tiếc	None
jíjuwó	tiền	None
kongo	su	None
kankan	ai	None
karbonumarun	thecentricane	Nan
komputa	vi	None
kolo	kolo	Nan
kojá	qua	None
koidu	koidu	Nan
kodò	phía	None
ko	là	None
kinkinni	nhỏ	None
kilhar	nách	None
kikuninu	tưởng tượng	Nan
kiko	học	None
kikoso	nhanh	None
kanlè	kanal	Nan
kikopomo	áp	None
kiko	đưa	None
kiakiajulo	nhất	None
ki	cũng	None
khoisan	hơn	None
kept	giữ	None
keko	đọc	None
kekere	nhỏ	None
kebbi	chỉnh	None
karùún	năm	None
karun	năm	None
karl	karl	Nan
kikojo	soạn	None
lade	lade	Nan
laid	đặt	Nan
laifi	lỗi	Nan
mahatma	mahatma	Nan
madeira	beira	Nan
maapu	đồ	None
lọ́jà	trường	None
lọ́dọọdún	năm	None
lọndọnu	london	None
lórò	mai	None
lónà	đường	None
ló	tôi	None
lóòótọ́	thật	None
lóòótò	đúng	None
makedonia	ma-rốc	Nan
lóti	nhiều	None
lórì	cảng	None
lópó	góa	None
lópez	nipez	Nan
lóde	ngoài	None
lítésò	chua	None
lísa	tốc	None
lílo	thác	None
lérú	lệ	None
léyìn	sau	None
léyin	đó	None
lérò	do	None
lóríba	thúc	None
lérìnín	tuyết	None
malabo	ong	None
malayopolynesian	malayopolynesian	Nan
member	viên	None
melo	nhiêu	None
meksiko	mexico	Nan
mejila	hai	None
mejidinlogbon	tám	None
mefeefa	lại	None
mediteraneani	hải	None
means	nghĩa	None
mbabane	cực	None
maya	không	None
max	đa	None
malay	định	None
mathimatiki	học	None
matheu	toán	None
maseru	tị	None
maryland	maryland	None
mars	hoả	None
marku	này	None
march	ba	None
marcellus	marcellus	Nan
manˈdeːla	manˈdelala	Nan
mango	trái	None
mali	ngày	None
malaysia	malaysia	None
mathiew	toán	None
léebá	cờ	None
lédè	ngữ	None
lèyìn	đó	None
links	kết	None
linear	tuyến tính	Nan
lindi	kiềm	None
lilongwe	cà	None
lilemo	sa	None
lilelile	khó	None
leè	thể	None
leyi	rồi	None
lewon	tù	None
lewaju	đi	None
less	hơn	None
lodo	diễn ra	Nan
lese	bài	None
lekun	cường	None
leboa	bảng	None
le	thể	None
lay	nằm	None
latvia	latvia	None
latini	latin	Nan
latigbana	đó	None
latibe	đó	None
lasile	phóng	None
lanka	lanka	None
languages	ngữ	None
leo	tử	None
lojowaju	lai	None
lojukokoro	tham	None
lojúgun	phá	None
lèe	thể	None
láíláí	giờ	None
láì	có	None
lárúbáwá	nhiên	None
lára	đau	None
lápá	phần	None
lámọ́di	may	None
láké	tiếng	None
láimo	có	None
láfún	được	None
lábé	nặng	None
lààmì	hiệu	None
lààmi	tên	None
làgba	bằng	None
lynton	lynton	Nan
luther	luther	None
luanda	luanda	Nan
lo	đi	None
low	thấp	None
lovers	yêu	None
louvre	tàng	None
loruko	tên	None
lopolopo	nhiều	None
loloselu	trị	None
lokunkun	năng	None
johann	ngục	None
jogun	hưởng	None
jo	rỉ	None
jiròrò	mù	None
ifitonileti	tin	None
ifilole	phóng	None
ifija	bắt	None
idánwò	nghiệm	None
idupe	ơn	None
idoma	vẽ	None
idimule	giữ	None
ideraa	viết	None
idari	khiển	None
idamita	tranh	None
idajo	bằng	None
ifobaje	nhũng	None
idaji	nửa	None
idagbasoke	phát	None
iceland	iceland	None
ibùjókòó	ngồi	None
ibùdó	trại	None
ibuso	chiến	None
ibuseripadabosi	trả	None
ibujoko	ghế	None
ibori	mặt	None
ibojì	mộ	None
ibn	ibn	Nan
ibiti	nơi	None
idagbe	mặc	None
ibise	dục	None
ifofinde	nghị	None
igbeduro	chuẩn	None
iketa	thừa	None
ikerin	tư	None
ikeko	soạn	None
ikejidinlogun	tám	None
ikaowo	trọng	None
ikandinlogun	tám	None
ikan	một	None
ijó	vũ	None
ijosin	cúng	None
ijinnasi	vật lý	Nan
ije	trào	None
ifriqiya	kích	None
ijaya	loạn	None
ijagun	đánh nhau	Nan
ihinrere	âm	None
ihan	hiện	None
igitòròmogbè	rộng	None
igbáẹ̀yìn	cùng	None
igbá	gà	None
igbowolori	đắt	None
igbeyawo	cưới	None
igbesoke	cấp	None
igberiko	ngoại	None
igbegun	thắng	None
ijakadi	tranh	None
ibimo	sinh	None
ibile	thông	None
ibiamusin	thánh	None
gún	xỏ	Nan
gòkè	lên	None
gírámà	lưới	None
gégé	không	None
gèésì	quý	None
gèésì	dán	None
gv	gv	Nan
guusu	nam	None
gunle	súng	None
gun	dài	None
guinébissau	guinébissau	Nan
gúúsù	nam	None
guineabissau	guinablesissau	Nan
guanínì	guanni	Nan
groove	rãnh	None
griiki	lạp	None
grammy	pháp	None
gquadruplex	gquadruplex	Nan
gorgina	bàng	None
gomina	đốc	None
goemai	goemai	Nan
gidí	ở	None
gidigidi	rất	None
ghana	ghana	None
guinea	lang	None
gẹ̀ẹ́sì	anh	None
habsburg	habsburg	None
haggai	dẫn	None
ibewo	đến	None
ibeji	đôi	None
ibarepo	hội	None
ibalo	việc	None
hv	hv	Nan
hungari	đói	None
hun	hun	None
hugh	hugh	Nan
hp	hp	None
hosea	hosea	Nan
hominidae	hominidae	Nan
histoni	sử	None
hindu	hindu	Nan
him	ta	None
hesse	ý	None
heraklion	heraklion	Nan
henny	xu	None
hendu	kẹo	None
heinrich	heinrich	None
hawaii	hawaii	Nan
hausafulani	hausafulani	Nan
haughton	haughton	Nan
hard	cứng	None
halomonadaceae	halomonadaceae	Nan
haiti	haiti	Nan
ikoenu	kiệm	None
german	đức	None
ikojopo	lũy	None
iku	vong	None
itumo	nghĩa	None
itu	ném	None
itorawo	do	None
itokowo	doanh	None
itobi	khoang	None
itiraka	tranh	None
itelentele	ràng	None
itanakole	chuyện	None
itali	ý	None
isè	dịch	None
isesi	hàng	None
iwadi	nghiên cứu	Nan
isun	lưu lượng	Nan
iso	đến	None
isepinpin	phối	None
iseowo	doanh	None
iseoroayeijoun	học	None
iseoba	lăm	None
isejoba	trị	None
iseero	tay	None
isedaniloro	tự	None
isare	tốc	None
isa	đủ	None
irúnmọlẹ̀	sét	None
isoponomba	isoponomba	Nan
irò	đồn	None
iwasi	ấn	None
iwoile	chủ	None
jijinna	xa	None
jije	được	None
jfk	jfk	Nan
jesu	chúa	None
jeometri	học	None
jeffrey	jeffrey	None
jawaharlal	xích đu	Nan
jamo	khác	None
jamaica	youtube	None
jalè	cắp	None
jagbe	lạc	None
iwifun	tin	None
jadide	lấy	None
jabo	cáo	None
iṣẹ́ìwádìí	nghiên cứu	Nan
iḷẹ̀	việc	None
iyán	linh	None
iyen	là	None
iyawo	cô	None
iyato	biệt	None
iyan	đói	None
iwuwa	thực	None
iwulo	ích	None
iwosan	lại	None
jackson	jackson	None
irorun	giản	None
irisi	hiện	None
iringa	gói	None
ilẹ̀ayé	đất	None
ilẹ	đất	None
iléńlá	sân	None
iléàtèéré	chủ	None
ilélódò	ngôi nhà	Nan
iléisé	chủ	None
iléayé	chủ	None
ilé	chủ	None
iluorilejoba	cầu	None
iluoba	dân	None
ilopo	đôi	None
iminle	giữ	None
ileru	lò	None
ileigbimo	lòng	None
ileife	mặc	None
ilegiga	chủ	None
ileasofin	pháp	None
ilaorun	bình minh	Nan
ilaodo	vệ	None
ilanaoye	lược	None
ilana	tục	None
ilagbolojo	khai	None
ikún	đầy	None
ikúgbaèyí	nay	None
ileobaluaye	giới	None
imoero	sáng	None
imojuto	tâm	None
imusin	tranh	None
irele	tốn	None
ire	giá	None
iranlose	trợ	None
iraja	sốc	None
ipá	lực lượng	Nan
ipo	trí	None
ipinu	phán	None
ipinpa	gia	None
ipin	chương	None
ipele	độ	None
ipawo	dụng	None
ipare	màu	None
iowa	đất	None
ioniani	thiếu	None
ioja	cá	Nan
inúnibíni	áp	None
iní	sản	None
inágbéringbérin	bảy	None
integration	nhập	None
inkosi	biện	None
indus	indus	Nan
indeed	thật	None
inagberingberi	phộng	None
imúnisìn	sinh	None
imú	mũi	None
ikoreokere	thu hoạch	Nan
ọ̀sẹ	tuần	None
