aajo	हास्यास्पद	Nan
púpò	बल्कि	None
púpo	बहुत ज्यादा	Nan
pò	तह	Nan
pòwe	कहावत का खेल	Nan
pípẹ́	लंबा	None
pípèsè	प्रावधान	None
pípa	वध	None
péé	उस	None
péré	केवल	None
pé	उस	None
pèsè	प्रदान की	Nan
quran	कुरान	None
pèlúpèlú	भी	None
pèhìndà	वीर्य	None
pè	बुलाया	None
pátáporongodo	पूर्ण रूप से	Nan
pásíà	तहखाना	Nan
pàápàá	ख़ास तौर पर	Nan
pààlà	एक सीमा	Nan
pàràkòyí	हाथोंहाथ	Nan
pàmò	विशेष रूप से	Nan
px|kùránì	px | कर्नेल	Nan
pupa	लाल	None
príncipe	प्रिंसिपे	Nan
pèlu	साथ में	Nan
providence	मितव्ययिती	Nan
ra	खरीद	None
rajya	आशा	None
rome	क्रोम	Nan
roma	रोमा	Nan
roko	भीड़	None
rokirika	ब्राउज़िंग	Nan
rogbodiyan	दंगा	Nan
roboto	सतहों	Nan
robinson	रॉबिन्सन	Nan
ro	सोच	Nan
rnas	rnas	Nan
rnarna	rnarna	Nan
rna	शाही सेना	Nan
race	दौड़	None
rn	आर.एन.	Nan
riresile	रिकॉर्डर	Nan
rinle	नए नए	Nan
right|thumb|px|aworan	दाईं ओर | अंगूठा | px | छवि	Nan
richard	रिचर्ड	None
research	अनुसंधान	None
rere	अच्छा	None
repetejulo	सबसे संवेदनशील	Nan
repeats	दोहराता	Nan
reggae	रेग	Nan
rank	पद	None
ramadan	रमजान	Nan
riro	कल्पना	None
ronald	रोनाल्ड	Nan
proton	प्रोटॉन	None
produced	प्रस्तुत	None
palauan	पलाउअन	Nan
padá	फली	None
paapaa	ख़ास तौर पर	Nan
paa	बंद करें	Nan
opolo	अनेक	None
ofò	शुभ प्रभात	Nan
oyé	दुनिया	None
ose	ose	Nan
opolo	अनेक	None
omonìyàn	मनुष्य	Nan
olorun	परमेश्वर	None
panaˈma	पनामा	Nan
odun	सालाना	None
olórun	परमेश्वर	None
okùnrín	हंसी	Nan
ojó	यह बरसाती है	Nan
odún	वर्ष	None
oúnjẹ	खाना	Nan
owojagidijagan	आतंकवादियों	Nan
oun	वह	None
otutu	अनेक	None
otherwise	अन्यथा	None
oseluarailu	असैनिक	Nan
oscar	ऑस्कर	None
olósìn	धार्मिक	Nan
protokolu	protocolu	Nan
panyanan	अंतरिक्ष	None
parapọ̀	मिश्रण	None
press	दबाएँ	Nan
portuguese	पुर्तगाली	None
portonovo	portonovo	Nan
population	आबादी	Nan
polaroid	polaroid	Nan
polandi	पोलिश	None
pojulo	उच्चतम	None
po	पो	Nan
plánẹ́tì	पाइपलाइन	Nan
platos	platos	Nan
piposi	बहुत	None
papa	पिताजी	Nan
pipolongo	विज्ञापन	None
pinu	निर्धारित	None
pinsoto	pinoto	Nan
pinsi	अस्वीकृत करना	Nan
phillipines	फिलीपींस	Nan
pelu	मोती	None
petu	petu	Nan
periferi	periferi	Nan
penisula	penisula	Nan
penh	पेन्ह	Nan
pele	आकर्षक	None
paripari	समाप्त	None
pipo	बहुत	None
rorùn	आसान	None
rossii	rossii	Nan
rural	ग्रामीण	None
sìbẹ̀	अभी तक	Nan
séyìn	वापस	None
séyìn	वापस	None
sénégal	वीर्य	None
ségun	रोना	Nan
sèle	चोरी	None
são	नए वाला	Nan
sáààrin	के बीच में	Nan
sáàpàdé	प्रायोजन	Nan
sápadè	इस दिन	Nan
sàì	कुंआ	Nan
sìni	झींगा	None
sàngó	गिरोह	Nan
sàmì	एक प्रतीक	Nan
sàbúrí	सबसे ऊपर	Nan
symmetry	समरूपता	Nan
swahili	स्वाहिली	Nan
suny	सनी	Nan
sun	रवि	None
sugbọ́n	तर्कसंगत	None
sugbo	लेकिन नहीं	Nan
suez	स्वेज	Nan
structures	संरचनाओं	None
stella	स्टेला	Nan
sàn	बेहतर	None
spectacular	बहुत शानदार	Nan
síbèsíbè	फिर भी	Nan
sílẹ̀	निराशा	None
tabora	परिहार	Nan
tabili	तालिका	None
tabi	या	None
sísè	अनुवाद	None
sísa	s .ía	Nan
sááju	एक मिनट ले	Nan
sisé	व्यायाम	None
sepò	आखिरकार	Nan
se	वे करते हैं	Nan
sùgbón	इसके विपरीत	Nan
síse	संरचना	None
síbú	जमीन पर	Nan
si	निश्चित रूप से	Nan
sùgbón	इसके विपरीत	Nan
sóko	पौधा	None
sójà	फोजी	Nan
sòrò	डिमाग धोना	Nan
síí	यहाँ	None
síwájú	आगे	None
síwon	उन्हें	None
síta	बाहर	Nan
síso	फिर भी	Nan
síso	फिर भी	Nan
síse	काम	None
sọ	कहते हैं	Nan
so	इसलिए	None
sopin	समाप्त	None
soon	जल्द ही	Nan
say	कहते हैं	Nan
santa	सांता	Nan
samioro	उपलब्ध	None
sambia	जवानी	None
salàyé	जिंदगी	None
salem	सलेम	Nan
sakyas	शाक्य	Nan
sakyamuni	अगला	Nan
saheli	सुविधा	None
safta	पंक्ति बनायें	Nan
safiwe	तुलना	None
sb	sb	Nan
saffana	नीलम	Nan
saarland	जमीन पर	Nan
saaree	बेहतर	None
saarc	हटाना	Nan
rẹ	उसके	None
ròyìn	की सूचना दी	Nan
rìn	पैदल चलना	Nan
ré	सी	Nan
république	république	Nan
ránmú	चिंता	Nan
ráhàn	दिखाई दिया	Nan
ryan	रयान	Nan
safari	सफारी	None
schwarz	schwarz	Nan
sea	समुद्र	None
seat	सीट	None
solomon	सोलोमन	Nan
sohun	हाँ	None
so	प्रेम	None
slovo	slovo	Nan
sisupo	गुणा	None
sisupapoerekusu	थूकना	Nan
sisopo	जोड़ने	Nan
sisodagba	बड़े होना	Nan
sise	खाना बनाना	Nan
sioux	सिऔक्स	Nan
sinsin	धर्म	None
sinai	पाप	Nan
silè	ड्रॉप	Nan
sile	पीछे	None
sihamoni	संरचना	None
sibesibe	अभी तक	Nan
sharon	शेरोन	Nan
sewadi	खोज	None
seville	सविल	Nan
sense	समझ	None
senegal	सेनेगल	Nan
semudaju	बेशक	Nan
semolara	दमा	Nan
seidamo	स्पष्ट	None
segbese	संभवतः	None
orúko	मैदान	None
taino	डिनो	Nan
orísìírísi	विभिन्न प्रकार	Nan
orísiirísi	विभिन्न	None
nombamewa	गुणा	None
nobel	नोबेल	Nan
nnaji	चाचा	None
nkàn	कैंसर	None
nkan	चीज़	None
niyi	यह रहा	Nan
niye	बस	Nan
niyato	अंतर करना	Nan
niwaju	आगे	None
nitosi	पास ही	Nan
nitoripe	इसलिये	None
nombáméjì	पहले दो	Nan
nitoriidieyi	इसके कारण	Nan
nilè	यहाँ	None
nijẹr	नाइके	Nan
nigbà	फिर	None
nigbakan	कभी कभी	Nan
nibere	जल्दी	None
nibe	वहाँ	None
ngubengcuka	नगुबेंगकुका	Nan
ngbero	की योजना बनाई	Nan
nevis	नेविस	Nan
neptune	नेपच्यून	Nan
nefimu	nephim	Nan
nisinyi	अभी	Nan
nebraska	नेब्रास्का	Nan
novo	नोवो	Nan
nse	डिज़ाइन	None
nínlá	महान	None
nílẹ̀	जमीन पर	Nan
nílùú	शहर में	Nan
nílè	नीचे	None
nígbàtí	कब	None
nífẹ̀ẹ́	प्यार करना	Nan
níbè	वहाँ	None
níbè	वहाँ	None
ní	है	None
nìyí	यह बात है	Nan
nìnú	माफ़ करना	Nan
nri	खाना	Nan
nì	पर्वत	Nan
náwo	व्यय	None
nàìjíríà	नाइजीरिया में	Nan
nwa	बच्चा	None
numeri	सुन्न होना	Nan
nukleotidipupo	न्यूक्लियोटाइड	Nan
nukleotidi	न्यूक्लियोटाइड	Nan
nu	स्वच्छ	None
ntoka	बिंदु	None
nsowikipedia	obowikipedia	Nan
nsolaboraro	सुरक्षा	None
nso	पास में	Nan
náà	बहुत	None
nínu	मोका	Nan
ncnc	ncnc	Nan
nawojulo	puzzling	Nan
munispal	munispal	Nan
mulẹ̀	स्थापित करना	Nan
mughal	आयतन	None
mtwara	फिर से चुनें	Nan
mtn	एमटीएन	Nan
mozilla	mozilla	Nan
mozambique	मोजाम्बिक	Nan
morogoro	मोटरिंग	Nan
morgan	मॉर्गन	Nan
monrovia	मोनरोविया	Nan
mombasa	मोम्बासा	Nan
muungano	muungano	Nan
mokanlelogbon	बत्तीस	Nan
mohandas	मोहनदास	None
minority	अल्पसंख्यक	Nan
minnesota	मिनेसोटा	Nan
mimuwa	पकड़	None
mimoy	mimoy	Nan
miiràn	राहत देना	Nan
micronesia	माइक्रोनेशिया	Nan
michelle	मिशेल	Nan
mexico	मेक्सिको	None
mewar	मेवाड़	Nan
meucci	मेसी	Nan
mokaleladota	सघन	None
nawó	अपना पैसा पाओ	Nan
májèmú	बुरा मत मानना	Nan
méjèèjì	दोनों	None
nato	नाटो	None
nathaniel	नथानिएल	Nan
namibia	आना	None
mẹ́talọ́kan	त्रिमूर्ति	None
mẹ́ta	तीन	None
mẹ́rkúríù	चूहा	Nan
mẹ́fà	छह	None
múlẹ̀	जोर से पकड़ें	Nan
mó	m	Nan
móra	इलाज	None
mókólà	गोंद	Nan
mère	चित्रकारी	None
mò	ज्ञान	None
míìrán	एक और	Nan
míràn	एक और	Nan
mímọ́	पवित्र	Nan
ménu	क्या तुम सोचते हो	Nan
méwàá	दस	None
métèètà	बढ़ई	Nan
méta	तीन	None
mérìnlélógójì	चवालीस	Nan
mérìndínlógún	सोलह	None
méte	पांच	None
mérindíláàdóta	पचपन	Nan
mííràn	एक और	Nan
níní	रखने के लिए	Nan
nípà	कम से कम	Nan
nítorípé	इसलिये	None
onítumò	अनुवादक	None
oníná	आग	None
onílẹ̀	नीचे	None
oníkólóbó	अपमानजनक	Nan
onígbàgbó	बूढा आदमी	Nan
onka	कैलकुलेटर	Nan
onje	आहार	None
oniyijulo	बहुत बढ़िया	Nan
oniyewumeji	बाइनरी	None
onisowo	व्यापारी	None
onisayensi	तकनीशियन	Nan
onítèbọmi	बपतिस्मा दिया	Nan
onipin	तर्कसंगत	None
onilile	homeowners	Nan
onilanaibagbepo	कंडोम	None
onigunfenfe	निष्क्रिय	None
onigbowo	एक प्रायोजक	Nan
onigbeja	रचनात्मक	None
onibugbe	किरायेदार	Nan
onialjebra	onialjebra	Nan
omiadalu	बाढ़	None
omi	पानी	None
olùkọ́	अध्यापक	Nan
olùkó	प्रशिक्षक	Nan
oninawo	उधार लेने वाला	Nan
olùkópa	योगदान देने वाला	Nan
onítòhùn	मुनीम	Nan
oníyanjù	एनिमेटेड	Nan
orílẹ́	संध्या	None
orílẹ̀	राष्ट्र	None
orílèèdè	राष्ट्र	None
oríkì	शायरी	None
oríilẹ̀	लेख	None
oríilè	राष्ट्रीय	None
oruko	संज्ञा	None
orudnun	वार्षिक	None
oritameta	बीच में	Nan
orisa	मूल	None
orisun	स्रोत	None
oníwòsàn	द हीलर	Nan
orisirisi	विविधता	None
orileominira	गर्मजोशी	Nan
orilejoba	सरकार	None
orileedeajoba	साम्राज्यवाद	None
orileede	देश	None
oriki	प्राच्य	Nan
oriire	बधाई हो	Nan
ori	सिर	None
opposite	सामने	None
opec	opec	Nan
ootọ́	सच	None
ooni	मगरमच्छ	Nan
orinìyìn	एक गीत	Nan
olùdarí	एक नेता	Nan
olùbátan	यह संपर्क	Nan
olóṣèlú	राजनीतिज्ञ	None
ojùkòsì	तेज़ी	None
ojuse	ज़िम्मेदारी	None
ojuoorun	सूर्य का अस्त होना	Nan
ojukokoro	लोभ	None
ojoru	गर्मजोशी	Nan
ojojumo	रोज	Nan
ojo	हमशक्ल	Nan
ogunlogo	भीड़	None
ogun	युद्ध	Nan
ogbè	क्षेत्र	None
ofin	कानून	None
ojùkòtúu	तेज़ी	None
ododo	धर्म	None
obere	छोटा	Nan
obairanderan	चचेरा भाई	Nan
oba	ओबामा	None
nso	जल्द आ रहा है	Nan
nǹkan	चीज़	None
níyanjú	सकारात्मक	None
níwájú	आगे	None
nítòótọ́	वास्तव में	Nan
nítòótó	बिल्कुल सही	Nan
nítòsí	पास ही	Nan
nítumò	अर्थ	None
obínibí	के सौजन्य से	Nan
ojúlùmọ̀	परिचितों	Nan
ojútáyé	श्यानता	Nan
ojúìwé	पृष्ठ	None
olóyè	शासक	None
olódùmarè	सर्वशक्तिमान	None
olympus	ओलिंप	Nan
oluwakiri	अन्वेषण	None
olusoju	रक्षक	Nan
oluparapo	मेल	None
olumojuto	लालची	Nan
olukowe	लेखक	None
olukoitan	प्रशिक्षक	Nan
oludase	निर्माता	None
oluda	रचनाकार	None
oloye	प्रतिभा	None
oloselukan	हैलो	Nan
olora	मोटी	None
olopon	घमंडी	Nan
ololugbe	परास्त	None
olokunkun	हेडफोन	Nan
olojukanna	हाथोंहाथ	Nan
olohun	मालिकों	None
olodiajodojuko	एक दूसरे	Nan
okunrin	आदमी	None
okunkun	अंधेरा	Nan
oko	मैदान	None
okhotsk	ओखोट्सक	Nan
okeere	विदेशी	None
orísìí	विविधता	None
tainos	tainos	Nan
takuntakun	की कमी	Nan
talaka	गरीब	None
ìràwọ̀	सितारे	None
ìrànàna	मदद	None
ìrànlọ́wọ́	मदद	None
ìpínrò	पैराग्राफ	Nan
ìpìnlè	शुरुवात	None
ìpìlẹ̀núkléù	एन्क्रिप्शन	Nan
ìpolongo	विज्ञापन	None
ìnáwó	व्यय	None
ìnagije	विजय	None
ìmúsára	मज़बूत करना	Nan
ìmúnilérú	गालियाँ	Nan
ìrí	अनुभव	None
ìmú	नाक	None
ìmò	आकाशीय बिजली	Nan
ìmò	साँप	None
ìlé	घर	None
ìlè	रिश्वतखोरी	Nan
ìlàìnàró	उत्पीड़न	Nan
ìlàorùn	चोट	Nan
ìlànàn	मोह माया	Nan
ìlà	रूपरेखा	None
ìlo	कॉल	Nan
ìlera	स्वास्थ्य	None
ìkọpa	भाग लेना	Nan
ìmóbìdo	जन्मसिद्ध अधिकार	Nan
ìkẹrin	चौथा	None
ìròkò	विचार	None
ìròyìnwiki	समाचार	None
ìtaeko	कार्यशाला	Nan
ìta	बाहर	Nan
ìse	कार्य	None
ìsòro	कठिनाई	None
ìsílé	घर	None
ìsèjoba	सरकार	None
ìsèdá	सृष्टि	None
ìsègbèfábo	लगन	Nan
ìse	कार्य	None
ìsọ	दुकानें	None
ìsú	मोटाई	None
ìròyìn	समाचार	None
ìsòrí	उपखंड	Nan
ìsìn	धर्म	None
ìsèlè	उत्पादन	None
ìsàlè	सूर्य का अस्त होना	Nan
ìsomó	जुड़ने के लिए	Nan
ìsirò	गणना	None
ìsinsìnyí	अभी	Nan
ìse	कार्य	None
ìsawo	अटकल	Nan
ìrúbo	ढहने	Nan
ìró	ध्वनि	None
ìròrùn	मोह माया	Nan
ìsòrò	ध्यान	None
ìtan	इतिहास	None
ìkínin	छठवां	Nan
ìkìjà	एक चुनौती	Nan
ìdá	परित्याग	None
ìdàrúdàpò	अराजकता	None
ìdàpapọ̀	समेकन	Nan
ìdàgbà	वयस्कता	Nan
ìbílè	जन्मसिद्ध अधिकार	Nan
ìbílè	जन्मसिद्ध अधिकार	Nan
ìbáraeni	गाड़ी	None
ìbánisòrò	संपर्क	None
ìbarà	बुखार	None
èpón	बहुत	None
èwù	कमीज	Nan
ìdìmú	अशांति	None
èsìn	धर्म	None
èro	विचारों	None
èka	प्रभाव	None
èyì	गौरव	None
ète	उद्देश्य	Nan
èsúrú	चींटियों	Nan
èsó	मस्जिद	None
èrò	विचारों	None
èràn	रोग	None
ènìkan	कुछ कुछ	Nan
èlò	बर्तन	None
èkejì	अन्य	None
èrí	सबूत	None
ìkìlò	गाली	Nan
ìdíisin	कारण	None
ìdó	डंक	Nan
ìkéde	घोषणा	None
ìkèrèkú	भीड़	None
ìkànna	वही	None
ìkejì	अन्य	None
ìjọba	सरकार	None
ìjò	नेता	None
ìjìnlè	रहस्य	None
ìjìnlè	रहस्य	None
ìjora	नफरत	Nan
ìjoba	सरकार	None
ìjo	चर्च	None
ìdíwòn	तुम्हारा कारण	Nan
ìjo	नृत्य	None
ìgbò	राम	None
ìgbésí	जिंदगी	None
ìgbéraga	गौरव	None
ìgbáraga	शक्ति	Nan
ìgbá	पंख	None
ìgbàgbé	भुलक्कड़	Nan
ìgbà	समय	None
ìgbonnìbí jé	यह एक आपदा है	Nan
ìfáàrà	एक पादरी	Nan
ìfojúìtànìgbesiayé	जीवन इतिहास	Nan
ìfara	कष्ट पहुंचाना	Nan
ìhun	लोहा	None
ìtokò	मटका	Nan
ìtàn	इतिहास	None
ìtànkálé	बाढ़	None
ṣàkóbá	नुकसान पहुचने वाला	Nan
ṣiṣé	प्रारंभिक	None
σ	σ	Nan
κάππα	.α	Nan
ˌæləˈbæmə	बीमारी	None
ˌkælɪˈfɔrnjə	ɪkælɪfɔrnjə	Nan
ˈøːstəˌʁaɪç	øːstəˌʁaɪç	Nan
ʔaːnaːtɕɑ̀k	.aːnaːtɕɑɕɑk	Nan
şe	करना	None
únṣẹlẹ̀	भूकंप	None
ôdún	साल	None
ẹdo	मज़ाक	Nan
ó	हाँ	None
ósírísì	लार	Nan
óníse	वह एक डिजाइनर है	Nan
ó	यह	None
òròàjòmó	खराब मौसम	Nan
òrò	विचारों	None
òwó	पैसे	Nan
òsà	ज़र्द मछली	Nan
òrò	विचारों	None
òré	खेल	None
òpòlopo	अनेक	None
òfò	अगला	Nan
ósékú	वह मर चुका है	Nan
òré	खेल	None
ẹlẹ́bùn	एक उपहार	Nan
ẹnìkan	एक व्यक्ति	Nan
ọ̀pòlòpò	कार्य	None
ọ̀nà	मार्ग	None
ọ̀gbìn	पौधा	None
ọ̀dọ́	जवानी	None
ọpọ́lọpọ́	अंजीर	None
ọn	यह	None
ọmọ	बच्चा	None
ọmú	बेकार इंसान	Nan
ọlọ́run	भगवान	None
ọlọ́mọ	बच्चे	None
ọdún	साल	None
ẹlẹ́sìn	धार्मिक	Nan
ọbàkàn	सौतेला भाई	Nan
ẹ̀rọ	मशीनरी	None
ẹ̀ni	who	Nan
ẹ̀kọ́	शिक्षा	Nan
ẹ̀kẹ́ta	तीसरा	None
ẹ̀kasístẹ̀mù	व्यक्तिपरक	Nan
ẹ̀kaoṣù	कांटेदार	Nan
ẹ̀kajuly	मई	None
ẹ̀kabrítánì	चाचा	None
ẹ̀kaawon	प्रस्तुतियाँ	Nan
ẹtì	जिगर	Nan
ẹsẹ	पैर का पंजा	Nan
ẹ̀wẹ̀	दूसरी ओर	Nan
òpòlopò	अनेक	None
òkòòkan	एक एक करके	Nan
òkan	एक	None
òdo	जवानी	None
òdeojú	चेहराविहीन	Nan
òde	बाहर	Nan
ìṣọ̣̀tẹ̣̀	न्यूमोनिया	Nan
ìṣẹ́kù	शेष	None
ìṣèlú	राजनीति	None
ìyípadà	रूपांतरण	None
ìyàwó	दुल्हन	Nan
ìyapa	पृथक्करण	None
ìya	पीड़ा	Nan
ìwúlò	उपयोगी	None
òdìkejì	अन्य	None
ìwòran	दृष्टि	None
ìwéré	पुस्तिका	Nan
ìwàásù	उपदेश	None
ìwo	सींग का	Nan
ìwe	तुलना	None
ìtúpalè	अनुवाद	None
ìtúmò	अनुवाद	None
ìtóka	पीटा जाना	Nan
ìtójú	चेहरे के भाव	Nan
ìtóju	भ्रम की स्थिति	Nan
ìtójú	देखभाल	None
ìtèsíwájú	प्रगति	None
ìwò	संपूर्ण	None
òféàrán	एक छवि	Nan
ògbójú	सक्षम	None
ògiri	दीवार	None
òjògbón	बरसात का मौसम	Nan
òṣèlú	राजनीति	None
òwù	कपड़ा	None
òsèré	एथलीट	Nan
òsèlú	राजनीतिज्ञ	None
òsán	दोपहर	None
òrò	दिमाग	Nan
òrí	अध्याय	None
òrìsà	मूर्तियों	None
òranyàn	अनिवार्य	None
òpópóònà	सड़क	None
òotó	सत्य	Nan
òní	आज	None
òmùàrán	एक छवि	Nan
òmiràn	जादूगर	None
òle	गृहिणी	Nan
òkúta	एक पत्थर	Nan
òkú	लाशों	Nan
òkòòkan	एक एक करके	Nan
òkèògbún	एक हजार	Nan
òjísé	चिकित्सक	None
òjo	हमशक्ल	Nan
ògúndìpẹ̀	चुरमुरा	Nan
ògun	दवा	None
ògo	महिमा	None
èka	डाली	None
èhìn	अगला	Nan
èfòn	काल	None
èdè	भाषा: हिन्दी	Nan
visit	यात्रा	None
viruses	वायरस	None
villa	विला	Nan
vihara	विहार	Nan
videos	वीडियो	None
victor	विजेता	None
vermont	वरमोंट	Nan
venezuela	वेनेजुएला	Nan
uzbek	रास्ता	None
utc	यु.टी. सी	Nan
utah	यूटा	Nan
vz	vz	Nan
usps	usps	Nan
urasílì	uracil	Nan
unla	हाँ	None
unifasiti	विश्वविद्यालय	Nan
umueri	बच्चे	None
ucb	यूसीबी	Nan
tẹ̀ǹbẹ̀lẹ̀kun	मिल जाना	Nan
tẹ̀ǹbẹ̀	फिर	None
túnse	पुनर्व्यवस्थित करें	Nan
túmò	बेर	Nan
tú	उंडेलना	Nan
tóka	उद्धृत	None
uribe	आभा	Nan
tó	tó	Nan
waa	यह है	Nan
wari	गंध	None
yafran	वर्णमाला	Nan
xiv	xiv	Nan
xd	xd	Nan
wọ̀nyí	इन	None
wọn	उन्हें	None
wúnrèn	व्यायाम	None
wón	उन्हें	None
wònyí	य़े हैं	Nan
wòfún	झलक	None
wípè	स्पष्टता	None
wì	बहा ले जाना	Nan
waju	चेहरा	None
wàásù	धर्म का उपदेश देना	Nan
wura	सोना	None
won	उन्हें	None
wo	यहाँ	None
wo	यहाँ	None
woo	वू	Nan
wole	साइन इन करें	Nan
województwo	cheworddztwo	Nan
wiwari	खोज	None
witkin	विट्किन	Nan
wisconsin	विस्कॉन्सिन	Nan
westminster	वेस्टमिनिस्टर	Nan
wyoming	व्योमिंग	Nan
tówùú	कोई भी राशि	Nan
tókù	आराम	None
tódárajùlọ	सबसे अच्छा	Nan
tokyo	टोक्यो	None
tokasi	बताया	None
toje	दुर्लभ	None
to	सेवा	Nan
tiwọn	उन लोगों के	Nan
titu	गोली मार	Nan
tirè	उसके	None
tirana	तिराना	Nan
tira	काल	None
thumb|left|upright|nelson	अंगूठा | बायां | सीधा | नेल्सन	Nan
those	उन	None
tolerejulo	सहन	None
they	वे	None
tfrac	tfrac	Nan
terutomo	terutomo	Nan
temptation	मांग	None
tele	जाँच करना	Nan
teksas	टेक्सास	None
tedo	डेटिंग	Nan
technology	प्रौद्योगिकी	None
taínos	taínos	Nan
tata	फिल्टर	Nan
tara	नौ	None
talika	दरिद्रता	Nan
the		None
tolórítelémù	प्रलय	None
tomé	टमाटर	None
tooto	वास्तव में	Nan
tóbi	विशाल	None
tò	सेट	None
tíórì	टायर	Nan
tíátà	टिकट	None
títío	जब तक	Nan
títèlé	पीछा करना	Nan
títi	बन्द है	Nan
té	t	Nan
télè	द्वारा	Nan
té	टी	None
tèsíwájú	प्रगति करने के लिए	Nan
tèlé	हाथोंहाथ	Nan
tètè	जल्दी से	Nan
tèlé	जाँच करना	Nan
táawà	झुकना	Nan
tàwon	उन्हें	None
tàsí	के बिना	Nan
tuntun	नया	None
tumosi	माध्यम	Nan
translated	अनुवाद	None
traduite	traduite	Nan
tounsejanu	दुखद	Nan
toseluaralu	राजनीतिक	None
torun	श्यामला	Nan
tori	तोरी	Nan
yakubu	yakub	Nan
metropoli	मेट्रोपोली	Nan
yan	चुनते हैं	Nan
yanturu	बहुत सारे	Nan
àsìkò	समय	None
àsèyìn	परिणाम	Nan
àsàjemátèe	भोर	Nan
àse	दावत	None
àrẹ	अध्यक्ष	None
àrùn	रोग	None
àrígbámú	परेशान	None
àpeere	उदाहरण	None
àpapọ̀	पूरा का पूरा	Nan
ànfàní	अवसर	None
àmúsorò	मनोविज्ञान	None
àsótélè	विस्तार	None
àmúlò	व्यावहारिक	None
àmérìkà	अलौकिक	None
àlébù	दोष	None
àlèpò	ऊपर	Nan
àlè	घटिया इंसान	Nan
àlááfià	समानता	None
àlàáfíà	शांति	None
àlàyé	जानकारी	None
àlàkalè	लक्ष्य	None
àkókó	समय	None
àkójopò	समूह	None
àká	अलमारियों	Nan
àmì	संकेत	None
àkàrà	केक	Nan
àsọdọ̀kan	एकता	None
àsà	रिवाज	Nan
èdè	भाषा: हिन्दी	Nan
èdá	सृष्टि	None
èbúté	बंदरगाह	None
èbà	मच्छरों	None
áwon	व्यभिचार	Nan
án	टी	None
àìsí	अनुपस्थिति	None
àìròtélè	अप्रत्याशित	Nan
àìní	चाहते हैं	Nan
àìkó	कमी	None
àáyá	वीर्य	None
àsekúdórógbó	छाल	None
àárín	बीच में	Nan
ààtò	अनुष्ठान	None
àwùjo	समाज	None
àwón	पैसे	Nan
àwón	पैसा	None
àwon	सिद्धांतों	None
àtẹnudẹ́nu	मौखिक	Nan
àtúnse	संपादित करें	Nan
àtúnse	संपादित करें	Nan
àtòrìnká	के बारे में	Nan
àtìpó	अन्तरिक्ष मानव	Nan
àtijo	अप्रचलित	Nan
ààyè	ज़िंदा	Nan
àkosílè	थीसिस	Nan
àkosílè	मतिहीनता	Nan
àjọṣepọ̀	सामाजिक	Nan
yíì	आप	None
yíyípadà	परिवर्तन	None
yí	मुड़ो	Nan
yìí	यह	None
yì	जाओ	None
yée	उन्हें करने दो	Nan
yèwò	नज़र	None
yára	जल्दी करो	Nan
yàtò	सेट अप	Nan
yànan	विस्मय	Nan
yo	yo	Nan
yíò	यह	None
yorúbà	दही	None
yori	एलईडी	Nan
yoo	मर्जी	Nan
yiyafunnilo	कटाव	Nan
yipada	मुड़ो	Nan
yiowu	यह	None
yio	करेगा	None
yindinyindin	कभी ना रुको	Nan
ye	हाँ	None
ye	हाँ	None
yewo	सुधार की	Nan
yaoundé	yaoundé	Nan
york	यॉर्क	Nan
yẹ̀ẹ́	y &#39;know	Nan
yọ	हटाना	Nan
zanzibar centralsouth	ज़ांज़ीबार सेंट्रल्स मुँह	Nan
àjákọ	अलग	None
àjo	यात्रा	None
àifète	उद्देश्य	Nan
àgọ́	तंबू	Nan
àgbùdo	यार्ड	Nan
àgbìgbò	अड़ोस - पड़ोस	Nan
àgbéyèwò	समीक्षा	None
àgbékà	सार	None
àgbáríjọ	संगठन	None
àgbàrá	बाढ़	None
àgbàjọ	बूढ़ा आदमी	Nan
àdóolóró	तेल	None
àdáátán	अनन्य	None
àdátá	विलोम	Nan
àdámò	एकांत	Nan
àbọ̀	आधा	None
àbìkú	अमरता	Nan
àbáyo	सुझाव	Nan
àbámẹ́ta	गुरूवार	Nan
àbe	लंगूर	Nan
 bce	दूर	Nan
zy	zy	Nan
zscores	zscores	Nan
zou	ज़ोउ	Nan
zdna	zdna	Nan
yanjú	संकल्प	None
methodologies	के तरीके	Nan
merin	चार	None
mercosur	mercosur	Nan
díè	काल	None
dìtẹ̀	मिल जाना	Nan
dìró	दायीं तरफ	Nan
dìde	उठता	None
dì	चादर	Nan
dépò	सीमा तक	Nan
délànà	सिद्धांत में	Nan
dé	पहुंच गए	Nan
dáwó	दान करना	Nan
dásà	एक कासा	Nan
dáradára	कुंआ	Nan
dóko	अच्छा	None
dálóríi	धन्यवाद	None
dágbó	बुढ़ापा	Nan
dá	बनाया था	Nan
dàpò	उन्हें बदल दें	Nan
dàbíi	इस तरह	Nan
dun	स्वादिष्ट	None
due	की वजह से	Nan
du	डु	Nan
dover	डोवर	Nan
doublestrand	doublestrand	Nan
doublehelix	डबल हेलिक्स	Nan
dote	dote	Nan
dájó	ठीक है	Nan
doni	डोनी	Nan
dólà	कुंआ	Nan
dúró	सहन करना	Nan
eléré	एथलीट	Nan
eléde	सार	None
elláda	सृष्टि	None
eleyii	इस तरह	Nan
eleyi	यह	None
elede	सूअरों	None
eko	शिक्षा	Nan
ekeji	अन्य	None
eka	जटिल	None
eighteen	अठारह	None
egbògi	मेडिकल	Nan
dún	ध्वनि	None
egbò	एक घाव	Nan
egbo	एक घाव	Nan
egberundun	एक हजार साल	Nan
egbe	बंदूक	None
egba	पूर्ण रूप से	Nan
efrem	effem	Nan
ede	भाषा: हिन्दी	Nan
ecomog	ecomog	Nan
ebi	परिवार	Nan
eba	eba	Nan
ea	हाँ	None
dọ́gba	बराबरी का	Nan
egbé	शोक	None
elòmírà	काली मिर्च	Nan
dominic	डोमिनिक	Nan
doju	आमने सामने	Nan
clear	स्पष्ट	None
cipollone	cipollone	Nan
china	चीन	None
cherished	पोषित	None
chebbi	सोच	Nan
chaskalson	chaskalson	Nan
charles	चार्ल्स	None
chamorro	चमोर्रो	Nan
cbc	सीबीसी	Nan
cauchy	कॉची	Nan
catherine	कैथरीन	Nan
code	कोड	None
cathedral	कैथेड्रल	Nan
casablanca	कैसाब्लांका	Nan
cape	केप	Nan
canaria	कैनरिया	Nan
calabar	च्यूइंग गम	Nan
cairo	क्रोध	None
bẹ́ẹ̀sìni	हाँ	None
bẹ́ẹ̀ni	हाँ	None
bẹ́ljíọ̀m	फीरोज़ा	Nan
bẹ́	तोड़ दिया	Nan
bẹ̀rẹ̀	आरंभ करना	Nan
búrú	बहादुर बनो	Nan
caslon	कैसिनो	Nan
dojú	आमने सामने	Nan
coetsee	coetsee	Nan
coming	अ रहे है	Nan
divoire	divoire	Nan
dinwoju	देखो	None
din	तलना	Nan
different	विभिन्न	None
didasile	स्थापना	None
didagba	समानता	None
development	विकास	None
desmond	डेसमंड	Nan
describes	वर्णन करता है	Nan
des	डेस	Nan
denver	डेन्वर	Nan
coloured	रंगीन	None
delhi	ऐसा न करें	Nan
daru	नष्ट	None
darapo	में शामिल होने के	Nan
dani	पकड़े	None
dandan	अनिवार्य	None
dagbasoke	बड़े हो जाओ	Nan
da	तथा	Nan
cunha	गला	None
ct	सीटी	Nan
csto	csto	Nan
computers	कंप्यूटर	None
compared	तुलना	None
dates	खजूर	None
elòmíràn	एक और	Nan
emerging	उभरते	None
emmanuel	एम्मानुएल	Nan
gbaná	बाहर गोली मारो	Nan
gbale	लोकप्रियता	None
gbajúgbujà	बहुत लोकप्रिय है	Nan
gba	इस बात से सहमत	Nan
galatia	इस समय	Nan
fẹ́rẹ̀ẹ́	लगभग	None
fòye	समझना	None
fífún	दे रही है	Nan
fífò	उड़ान	Nan
fégbé	रहने भी दो	Nan
fé	fé	Nan
gbe	कैरी	Nan
fé	fé	Nan
funra	अपने आप	Nan
fun	के लिये	Nan
fulbe	ful	Nan
fulani	राड़	Nan
fuji	हटाना	Nan
freetown	freetown	Nan
fransi	फ्रेंच	None
francis	फ्रांसिस	None
fracmv	fracmv	Nan
fowó	पैसे के लिए	Nan
fowobowe	बुकिंग	Nan
further	आगे की	Nan
fourbase	fourbase	Nan
gbera	आगे बढ़ो	Nan
gbese	कर्ज	None
geneva	जिनेवा	Nan
geesi	अंग्रेज़ी	None
gbọ́dọ̀	जरूर	None
gbúnùn	इसे सूंघे	Nan
gbónmisi	कानून	None
gbódò	जरूर	None
gbìyànju	कठिन प्रयास	Nan
gbìnyànjú	प्रयत्न	None
gbésè	प्रस्ताव	None
gbéyèwò	समीक्षा	None
gbéni	लाइव	None
gberasoke	जल्दी करो	Nan
gbékalè	बढ़ई	Nan
gbé	लाइव	None
gbáradì	उठ जाओ	Nan
gbá	गरज	Nan
gbàgùrà	हिलाकर रख दिया	Nan
gbàgbọ́	मानना	None
gbongbo	जड़	None
gbogbogbo	सामान्य	None
gbin	लगाए	None
gbilè	फैलना	Nan
gbigbewo	वित्तपोषण	Nan
gbigbamulo	शोषण	None
gbédìí	स्थापित करना	Nan
foriko	उदाहरण के लिए	Nan
force	बल	None
foniimu	फ़िल्म	None
eyonomba	eyonomba	Nan
eyin	अंडे	None
eya	वर्ग	None
example	उदाहरण	None
ewì	शायरी	None
ewé	पत्ती	None
ewe	पत्ती	None
euroasia	euroasia	Nan
euro	यूरो	Nan
etíòkun	सागर किनारा	Nan
etymologiae	etymologiae	Nan
eléja	मछली पकड़ना	Nan
etisalat	etisalat	Nan
esia	आ रहा है	Nan
eseese	आरेख	None
eréonítàn	परिवर्णी शब्द	Nan
erékùsù	द्वीप	None
erofo	तलछट	Nan
ernst	अर्नस्ट	Nan
epa	मूंगफली	Nan
eníbá	बुखार	None
enì	हाथी	None
enter	दर्ज	None
enikéni	हर कोई	Nan
esteri	esteri	Nan
elòmíràn	कोई और	Nan
eka	प्रभाव	None
eléyàmèyà	जातीयता	Nan
fohùn	चिल्लाना	Nan
fofinde	पर प्रतिबंध लगाने	Nan
fodio	fodio	Nan
five	पांच	None
fitino	परीक्षण	None
finlandi	फिनलैंड	None
finiki	भौतिक विज्ञान	Nan
fimú	तेजी से परिभाषित किया गया	Nan
fihan	संकेत	None
fifihan	दिखा रहा है	Nan
fi	सहेजें	Nan
fe	चाहता था	Nan
fesèmúlè	अनंतिम स्रोत	Nan
ferde	ferde	Nan
felifeli	मख़मली	Nan
farsi	arti	Nan
faranse	फ्रेंच	None
faramó	निम्न का पालन	Nan
fan	पंखा	Nan
fail	विफल	None
fagile	रद्द	None
ewà	आचरण का	Nan
esè	प्राप्ति	None
esin	धर्म	None
enu	मुंह	None
búburú	खराब	None
bòtswánà	बस	Nan
béè	ऐसे ही	Nan
bèrẹ̀	शुरुआत के लिए	Nan
alawose	अटकल	Nan
alalaye	मिट्टी की	Nan
alakobere	नौसिखिया	Nan
alakitiyan	कार्यकर्ता	None
alaini	दरिद्र	Nan
alaigbara	अथक	Nan
alaidogba	असंतुलित	Nan
aladanida	मनमाना	Nan
aladani	निजी	None
aladaani	निजी	None
alaafin	अवैध	None
albany	अल्बानी	Nan
alaafia	शांति	None
alaabo	विकलांग	Nan
ala	नीचे	None
akẹ́kọ̀ọ́	छात्र	None
akíngbógun	बटालियन	Nan
akíkanjú	बहादुर	None
akátá	सियार	Nan
akopo	संकलन	Nan
akopa	सबसे पहले	Nan
akoni	हमारे पास नहीं ह	Nan
akole	हम नहीं कर सकते	Nan
akokolo	अवधि	None
alaadanida	अवांछित	Nan
akinpelu	तोपें	Nan
albert	अल्बर्ट	Nan
alicia	एलिसिया	Nan
anc	एएनसी	Nan
anabi	पैगम्बर	None
an	एक	None
améríkà	अमेरिकन	None
améríkà	अमेरिकन	None
amosi	मस्जिद	None
amojeoyipada	परिवर्तनीय	Nan
amerika	अमेरिका	None
americas	अमेरिका की	Nan
amazonas	amazonas	Nan
alọ́po	बटुआ	Nan
alexandra	एलेक्जेंड्रा	Nan
alúwo	उछाल	Nan
aláyèwò	निरीक्षक	Nan
alátise	कलाकार	None
alápapò	प्रतिस्थापन	Nan
alákọ̀bẹ̀rẹ̀	प्रारंभ करने वाला	Nan
alumíníọ̀mù	अल्युमीनियम	Nan
alumoni	रोगनिवारक	Nan
alukuraani	कुरान	None
alubàbá	पिता जी	Nan
alpha	अल्फा	None
alominira	आजादी	None
allāh	अल्लाह	None
aláísàn	बीमार	None
akiidah	coridah	Nan
ajọra	प्रतिकृति	None
ajoro	यात्रा	None
adiokan	अकेला	None
adeda	प्रकृति	None
addis	अदीस	Nan
adarihunrun	सफाई वाला	Nan
adabaye	ठीक है	Nan
adaba	सुविधाजनक	None
accra	अकरा	Nan
abúléko	गाँव	Nan
abínibí	राष्ट्रीयता	Nan
abé	सुई	None
abálájo	अनुभव	None
adágbà	ज्येष्ठ	Nan
aburunmu	हमारी घृणा	Nan
abidjan	कभी	None
abidi	वर्णमाला	Nan
abesahara	छींटे डालना	Nan
abeorile	घर वापसी	Nan
abeikojopo	उत्तराधिकारिणी	Nan
abala	भाग	None
aawe	पक्षाघात	Nan
aare	आरे	Nan
aapon	aapon	Nan
aanu	दया	None
aala	सीमा	None
abo	संज्ञा	None
adúgbò kútò	गली में पड़ोसी	Nan
adúgbò mókóla	mucocula	Nan
adúgbò quarry	खदान पड़ोसियों	Nan
ajo	यात्रा	None
ajibola	कार्यसूची	Nan
ajemoroyin	पूछताछ	Nan
aje	अर्थव्यवस्था	None
ajagun	एक कुत्ता	Nan
aisi	कमी	None
aintimulo	aintimulo	Nan
agio	रोना	Nan
agbéiná	अग्निशामक	Nan
agbára	शक्ति	Nan
agbàbò	रक्षा करनेवाला	Nan
agbà	एक वयस्क	Nan
agbeinadie	खेत	None
agbaye	दुनिया	None
agbara	शक्ति	Nan
agbado	मक्का	None
agba	रंग	None
aféfé	विंडमिल	Nan
africans	अफ्रीकियों	Nan
african	अफ़्रीकी	None
africa	अफ्रीका	None
afoyemo	सार	None
afomo	उदाहरण के लिए	Nan
afida	परिवार	Nan
adúgbò ìdí	पड़ोस के कारण	Nan
andaman	अंडमान	None
genevieve	genevieve	Nan
angkor	अंगकोर	Nan
anschluss	anschluss	Nan
benin	बेंच	None
bengali	बंगाली	None
bengal	बंगाल	None
belgium	बेल्जियम	None
belarus	बेलोरूस	Nan
beijing	बीजिंग	None
beauharnais	beauharnais	Nan
bce	दूर	None
bayìí	अभी	Nan
bayi	अभी	Nan
bayelsa	बयेल्सा	Nan
berber	हज्जाम	Nan
bauxitealumina	bauxitealumina	Nan
banle	banle	Nan
bang	धमाके	Nan
balẹ̀	उसे रहने दो	Nan
bahrain	बहरीन	Nan
babaláwo	भाजक	Nan
baa	है	None
aṣòkan	व्यक्ति	None
azikiwe	व्यावहारिक बुद्धि	Nan
ayò	ay	Nan
ayàfi	यह ठीक है	Nan
ayeye	अनंत काल	Nan
bara	पिछले साल	Nan
aya	कविता	None
berlin	बर्लिन	None
bharat	भारत	None
báyìí	अभी	Nan
bárakú	लत	Nan
bálè	गुब्बारा	Nan
bákannáà	भी	None
bàbá	पिता	Nan
by	द्वारा	Nan
burúkú	बुराई	None
bujumbura	विस्तार	None
buenaventura	buenaventura	Nan
bu	अर्थात्	None
brítánì	अंग्रेजों	None
bernstein	बर्नस्टीन	Nan
britain	ब्रिटेन	None
brazzaville	ब्राज़ाविल	Nan
brasil	brasil	Nan
bolívar	बोलिवर	Nan
bolt	पेंच	Nan
bole	ठूंठ	Nan
bojú	जरा देखो तो	Nan
bodies	शव	None
black	काली	Nan
biribiri	कुचल दिया गया था	Nan
bibeli	बाइबिल	None
bharata	वापस लौटें	Nan
bridgeport	ब्रिजपोर्ट	Nan
awújẹ	कांड	None
awùjo	के सौजन्य से	Nan
awuruju	जादुई	None
arábíà	वर्णमाला	Nan
aráa	भाई	None
aryan	आर्यन	Nan
arun	रोग	None
aruleyin	हैलो	Nan
aroko	वनस्पतियां	Nan
arkansas	अर्कांसस	Nan
ariwaguusu	पश्चिमी	None
ariwaarin	मध्य पूर्व	Nan
ariso	ऐरिस	Nan
arinkankan	यह वाला	Nan
aráròmí	हैलो	Nan
aralíle	उष्णकटिबंधीय	None
apẹ̀rè	तहबंद	Nan
apòmù	तहबंद	Nan
apis	शहद की मक्खी	Nan
apeere	उदाहरण के लिए	Nan
apeja	मछुआ	Nan
aparapo	मेल	None
apaiwoorun	पश्चिमी	None
apailaorun	सूर्योदय	None
apaguusuiwoorun	दक्षिण पश्चिम	Nan
apaguusuilaorun	दक्षिण पश्चिम	Nan
apagusu	दक्षिण	None
arabu	अरब	None
arópò	रिश्वतखोरी	Nan
arúgbó	बुढ़ापा	Nan
arọ	लंगड़ा	None
awon	उन्हें	None
awoòn	टेम्पलेट	Nan
awonara	भावना	None
awo	प्लेट	Nan
awari	खोज	None
avar	avar	Nan
austríà	ऑस्ट्रेलिया	None
austronesian	ऑस्ट्रोनेशियाई	Nan
austriahumgary	austriahumgary	Nan
australia	ऑस्ट्रेलिया	None
atunse	भूल सुधार	Nan
atun	रिवाइंड	Nan
atinrin	हस रहा	Nan
atimo	योजना	None
atigba	स्वीकार्य	Nan
atanna	परमाणु	None
atangbona	परमाणु	None
asèdá	प्राकृतिक	None
asìko	बकवास	Nan
assessment	मूल्यांकन	None
asipa	विचलन	Nan
aseyori	सफलता	None
aseeto	समझौता	None
ascii	पता लगाएं	Nan
asagun	विजय	None
anita	अनीता	Nan
ọ̀rọ̀	बातचीत	None
georgia	जॉर्जिया	Nan
gfaj	gfaj	Nan
kòjòkú	बारिश	None
kírísìtì	क्रिसमस	None
kínu	चुंबन	Nan
kíkọ́	सीखना	Nan
kíko	पढ़ते पढ़ते	Nan
kí	नमस्कार	None
kìnní	प्रथम	None
kéyìn	बाद में	Nan
kémíkà	इसके विपरीत	Nan
kétu	तैयार रहो	Nan
kékéèké	छोटा	Nan
kòkó	चूहा	Nan
kéesì	हास्यास्पद	Nan
kánádà	बेशक	Nan
kánfinkése	सरलता	None
ká	का	Nan
kàyéfì	आश्चर्य	Nan
kàríbẹ́ánì	क्षेत्र में	Nan
kwara	संबोधित	None
ku	आप	None
krio	क्रियो	Nan
kori	अब और नहीं	Nan
ko	ko	Nan
koko	सीख रहा हूँ	Nan
káyé	विश्व	None
koto	प्रलोभन	Nan
kòmpútà	संगणक	None
kòòsí	यह नहीं	Nan
labalaba	तितली	Nan
laarin	अंदर	None
laaka	उलटना	Nan
laada	लात	Nan
laa	चले जाओ	Nan
kọ́ni	की कमी	Nan
kọ́lọ́mú	कॉलम	Nan
kọ́kọ́	प्रथम	None
kọ̀mpútà	संगणक	None
kọjá	उत्तीर्ण करना	Nan
kẹ́nyà	पृथक्करण	None
kòtò	गड्ढा	Nan
kẹta	तीसरा	None
kẹrin	चौथा	None
kúùkù	इसके विपरीत	Nan
kútò	सब कुछ	Nan
kúrò	दूर	None
kúkúrú	संक्षेप में	Nan
kúkú	आख़िरकार	Nan
kùrání	कुरान	None
kùkú	आख़िरकार	Nan
kóra	इकट्ठा	None
kógo	महिमा	None
kòòkan	प्रत्येक	None
kẹsàán	बिल्कुल अभी	Nan
labee	नीचे	None
kookan	यह	None
kong	कांग	Nan
kampala	पकड़	None
kalẹ	रद्द करना	Nan
kalinga	cinga	Nan
kakiri	निशान	None
kagera	डींग मारने का	Nan
kadara	संपत्ति	None
jọ́	कृप्या	Nan
jẹ́mánì	जर्मन	None
jùló	सबसे	None
jùlo	ख़ास तौर पर	Nan
jùlo	से ज्यादा	Nan
kan	ए	None
jíjéomoléyìnkírísítì	एक परोपकारी व्यक्ति के रूप में	Nan
jíje	किया जा रहा है	Nan
jìnnàa	दूर	None
jéésù	यीशु	None
jé	आइए	Nan
jáde	बाहर आओ	Nan
jàgídíjàgan	हिंसा करनेवाला	Nan
juneau	juneau	Nan
jo	जॉन	None
jopò	में शामिल हों	Nan
jojo	फटा	Nan
johanu	माफ़ करना	Nan
jíjuwó	पैसा बनाना	Nan
kongo	कंडोम	None
kankan	कोई नहीं	Nan
karbonumarun	thecentricane	Nan
komputa	संगणक	None
kolo	kolo	Nan
kojá	पार करना	Nan
koidu	koidu	Nan
kodò	नीचे	None
ko	या	None
kinkinni	छोटी सी बात	Nan
kilhar	कांख	Nan
kikuninu	कल्पना कीजिए	Nan
kiko	सीख रहा हूँ	Nan
kikoso	तेज	None
kanlè	kanal	Nan
kikopomo	गर्मजोशी	Nan
kiko	लाना	None
kiakiajulo	सबसे तेज़	Nan
ki	ऐसा	None
khoisan	अवर	Nan
kept	रखा	None
keko	साक्षर	Nan
kekere	छोटा	Nan
kebbi	समायोज्य	Nan
karùún	पांचवां	Nan
karun	पांचवां	Nan
karl	कार्ल	None
kikojo	संकलन	Nan
lade	भार रखना	Nan
laid	रखी	None
laifi	दोष	None
mahatma	महात्मा	None
madeira	beira	Nan
maapu	नक्शा	None
lọ́jà	बाजार में	Nan
lọ́dọọdún	प्रतिवर्ष	None
lọndọnu	लंडन	Nan
lórò	आने वाला कल	Nan
lónà	रास्ते में	Nan
ló	ló	Nan
lóòótọ́	वास्तव में	Nan
lóòótò	हाँ	None
makedonia	मैसेडोनिया	Nan
lóti	लॉट	Nan
lórì	बंदरगाह	None
lópó	विधवा	None
lópez	nipez	Nan
lóde	बाहर	Nan
lítésò	चुभता	Nan
lísa	त्वरण	Nan
lílo	शोषण	None
lérú	गुलामी	None
léyìn	बाद में	Nan
léyin	बाद में	Nan
lérò	कारण	None
lóríba	ऊपर	Nan
lérìnín	बर्फ	None
malabo	शहद	None
malayopolynesian	malayopolynesian	Nan
member	सदस्य	None
melo	कितने	None
meksiko	मेक्सिको	None
mejila	बारह	None
mejidinlogbon	अट्ठाइस	Nan
mefeefa	ओवरहाल	Nan
mediteraneani	आभ्यंतरिक	Nan
means	माध्यम	Nan
mbabane	नकारात्मक	None
maya	नहीं	None
max	अधिकतम	None
malay	ग्रहण	None
mathimatiki	गणितीय	None
matheu	matheu	Nan
maseru	ईर्ष्या द्वेष	Nan
maryland	मैरीलैंड	Nan
mars	मंगल ग्रह	Nan
marku	इस समय	Nan
march	जुलूस	None
marcellus	मार्सेलस	Nan
manˈdeːla	mandelala	Nan
mango	आम	None
mali	दिन	None
malaysia	मलेशिया	None
mathiew	mathiew	Nan
léebá	संयोग से	Nan
lédè	भाषा में	Nan
lèyìn	बाद में	Nan
links	लिंक	None
linear	रैखिक	Nan
lindi	लाइ	Nan
lilongwe	लिलोंग्वे	Nan
lilemo	कैनबिस	Nan
lilelile	कट्टर	None
leè	हो सकता है	Nan
leyi	यह रहा	Nan
lewon	कैद होना	Nan
lewaju	आगे	None
less	कम से	Nan
lodo	जगह लें	Nan
lese	पद	None
lekun	तेज	None
leboa	lebo	Nan
le	कर सकते हैं	Nan
lay	रखना	None
latvia	लातविया	Nan
latini	लैटिन	None
latigbana	तब से	Nan
latibe	वहां से	Nan
lasile	रिहाई	Nan
lanka	लंका	Nan
languages	भाषाओं	None
leo	लियो	Nan
lojowaju	भविष्य में	Nan
lojukokoro	लालची	Nan
lojúgun	तबाह	Nan
lèe	कर सकते हैं	Nan
láíláí	कभी नहीँ	Nan
láì	के बिना	Nan
lárúbáwá	प्राकृतिक	None
lára	चोट	Nan
lápá	अंश	None
lámọ́di	भाग्य	None
láké	जोर	None
láimo	के बिना	Nan
láfún	दिया हुआ	Nan
lábé	वजन	None
lààmì	संकेत	None
lààmi	संकेत	None
làgba	बराबरी का	Nan
lynton	lynton	Nan
luther	लूथर	Nan
luanda	लुआंडा	Nan
lo	जारी रखें	Nan
low	कम	Nan
lovers	प्रेमियों	None
louvre	लौवर	Nan
loruko	नाम	None
lopolopo	बहुत	None
loloselu	राजनीतिक रूप से	Nan
lokunkun	शक्तिशाली	None
johann	नरक	None
jogun	विरासत में मिला	Nan
jo	रिसाव	None
jiròrò	धूमिल	Nan
ifitonileti	जानकारी	None
ifilole	प्रक्षेपण	Nan
ifija	मछली पकड़ना	Nan
idánwò	परीक्षण	None
idupe	धन्यवाद	None
idoma	चित्रकारी	None
idimule	गिरफ़्तार करना	Nan
ideraa	लिखना	None
idari	नियंत्रण	None
idamita	खींचना	Nan
idajo	न्याय	None
ifobaje	भ्रष्टाचार	None
idaji	आधा	None
idagbasoke	विकास	None
iceland	आइसलैंड	None
ibùjókòó	बैठने की	Nan
ibùdó	शिविर	None
ibuso	लड़ना	Nan
ibuseripadabosi	स्थान परिवर्तन	Nan
ibujoko	बेंच	None
ibori	आवरण	None
ibojì	मकबरे	None
ibn	इब्न	Nan
ibiti	स्थानों	None
idagbe	उपेक्षा	None
ibise	व्यायाम	None
ifofinde	कांग्रेस	None
igbeduro	तैयारी	None
iketa	पैतृक सम्पत्ति पाना	Nan
ikerin	चौथा	None
ikeko	संकलन	Nan
ikejidinlogun	अठारह	None
ikaowo	आदर करना	Nan
ikandinlogun	अठारह	None
ikan	एक	None
ijó	नृत्य	None
ijosin	पूजा	None
ijinnasi	भौतिक विज्ञान	Nan
ije	आंदोलन	Nan
ifriqiya	उत्तेजना	None
ijaya	घबड़ाहट	Nan
ijagun	लड़ाई	None
ihinrere	सुसमाचार	Nan
ihan	उपस्थित होना	Nan
igitòròmogbè	ब्रॉडबैंड	None
igbáẹ̀yìn	आखरी वाला	Nan
igbá	मुर्गी	Nan
igbowolori	महंगा	None
igbeyawo	शादी	None
igbesoke	उन्नयन	None
igberiko	उपनगरीय	None
igbegun	विजय	None
ijakadi	संघर्ष	Nan
ibimo	जन्म	None
ibile	परंपरागत	None
ibiamusin	अभ्यारण्य	None
gún	छिद्रित	Nan
gòkè	ऊपर जाना	Nan
gírámà	दादाजी	Nan
gégé	वास्तव में	Nan
gèésì	मणि	None
gèésì	गोंद	Nan
gv	जी.वी.	Nan
guusu	दक्षिण	None
gunle	बंदूक	None
gun	लंबा	None
guinébissau	guinébissau	Nan
gúúsù	दक्षिण	None
guineabissau	गिनी-बिसाऊ	Nan
guanínì	guanni	Nan
groove	नाली	Nan
griiki	यूनानी	None
grammy	ग्रैमी	Nan
gquadruplex	gquadruplex	Nan
gorgina	बाज	Nan
gomina	राज्यपाल	None
goemai	goemai	Nan
gidí	मकान	None
gidigidi	बहुत	None
ghana	घाना	Nan
guinea	गिन्नी	Nan
gẹ̀ẹ́sì	अंग्रेज़ी	None
habsburg	हैब्सबर्ग	Nan
haggai	मार्गदर्शक	Nan
ibewo	आ गया	Nan
ibeji	जुडवा	Nan
ibarepo	संगति	Nan
ibalo	मामला	None
hv	एचवी	Nan
hungari	भुखमरी	Nan
hun	हुन	Nan
hugh	ह्यूग	Nan
hp	अश्वशक्ति	Nan
hosea	होशे	Nan
hominidae	hominidae	Nan
histoni	histoni	Nan
hindu	hindu	Nan
him	उसे	None
hesse	माना	None
heraklion	heraklion	Nan
henny	henny	Nan
hendu	कैंडी	None
heinrich	हेनरिक	Nan
hawaii	हवाई	None
hausafulani	hausafulani	Nan
haughton	haughton	Nan
hard	मुश्किल	None
halomonadaceae	halomonadaceae	Nan
haiti	हैती	Nan
ikoenu	बचाना	Nan
german	जर्मन	None
ikojopo	संचय	None
iku	मौत	None
itumo	अर्थ	None
itu	फ़ेक्ना	Nan
itorawo	उदार	None
itokowo	व्यापार	None
itobi	अपनी प्रशंसा करना	Nan
itiraka	संघर्ष	Nan
itelentele	स्पष्ट रूप से	Nan
itanakole	कहानी	None
itali	इतालवी	None
isè	सर्विस	None
isesi	आत्मसमर्पण	None
iwadi	अनुसंधान	None
isun	बहे	Nan
iso	आना	None
isepinpin	वितरण	None
iseowo	व्यापार	None
iseoroayeijoun	पुरातत्त्व	None
iseoba	पंद्रह	None
isejoba	शासन	None
iseero	घड़ी	None
isedaniloro	आत्म संदेह	Nan
isare	त्वरण	Nan
isa	बस	Nan
irúnmọlẹ̀	आकाशीय बिजली	Nan
isoponomba	isoponomba	Nan
irò	अफवाह	Nan
iwasi	impress	Nan
iwoile	घर	None
jijinna	दूर	None
jije	किया जा रहा है	Nan
jfk	जेकेएफ़	Nan
jesu	यीशु	None
jeometri	ज्यामिति	Nan
jeffrey	जेफरी	Nan
jawaharlal	झूलों	Nan
jamo	चले जाओ	Nan
jamaica	यूट्यूब	None
jalè	चोरी होना	Nan
jagbe	दफा हो जाओ	Nan
iwifun	जानकारी	None
jadide	रुको	Nan
jabo	रिपोर्ट good	Nan
iṣẹ́ìwádìí	अनुसंधान	None
iḷẹ̀	काम	None
iyán	शानदार	None
iyen	अर्थात्	None
iyawo	दुल्हन	Nan
iyato	अंतर	None
iyan	सूखा	None
iwuwa	अभ्यास	None
iwulo	उपयोगी	None
iwosan	उपचारात्मक	Nan
jackson	जैक्सन	None
irorun	बहुत आसान	Nan
irisi	दिखावट	Nan
iringa	लपेटें	Nan
ilẹ̀ayé	पृथ्वी	None
ilẹ	भूमि	None
iléńlá	आंगन	Nan
iléàtèéré	घर	None
ilélódò	घर	None
iléisé	घर	None
iléayé	घर	None
ilé	घर	None
iluorilejoba	भूमंडलीकरण	Nan
iluoba	नागरिकता	None
ilopo	दोहरा	Nan
iminle	गिरफ्तार करने के लिए	Nan
ileru	भट्ठी	Nan
ileigbimo	सहमति	None
ileife	उपेक्षा	None
ilegiga	घर	None
ileasofin	विधायी	None
ilaorun	सूर्योदय	None
ilaodo	रक्षा करना	Nan
ilanaoye	रणनीतियाँ	Nan
ilana	प्रक्रिया	None
ilagbolojo	प्रचार	None
ikún	भरने	None
ikúgbaèyí	अभी	Nan
ileobaluaye	दुनिया	None
imoero	बिजली चमकना	Nan
imojuto	देखभाल	None
imusin	खींचना	Nan
irele	विनम्रता	Nan
ire	बिक्री	None
iranlose	सहायता	None
iraja	चौंका देने वाला	Nan
ipá	बल	None
ipo	स्थान	None
ipinu	फेसला	Nan
ipinpa	भाग लेना	Nan
ipin	अध्याय	None
ipele	स्तर	None
ipawo	का उपयोग करता है	Nan
ipare	मुरझाना	Nan
iowa	धरती पर	Nan
ioniani	दरिद्र	Nan
ioja	मछली	None
inúnibíni	उत्पीड़न	Nan
iní	विरासत	None
inágbéringbérin	सत्रह	None
integration	एकीकरण	None
inkosi	उचित ठहराने के लिए	Nan
indus	सिंधु	None
indeed	वास्तव में	Nan
inagberingberi	मूंगफली का मक्खन	Nan
imúnisìn	स्वच्छता	None
imú	नाक	None
ikoreokere	कटाई	None
ọ̀sẹ	सप्ताह	None
