aajo	ridículo	Nan
púpò	bien	None
púpo	demasiado	None
pò	doblez	Nan
pòwe	proverbios	Nan
pípẹ́	largo	None
pípèsè	provisión	Nan
pípa	sacrificio	None
péé	ese	None
péré	solamente	None
pé	ese	None
pèsè	previsto	None
quran	corán	None
pèlúpèlú	también	None
pèhìndà	semen	None
pè	llamado	None
pátáporongodo	absolutamente	None
pásíà	el	None
pàápàá	especialmente	None
pààlà	límite	None
pàràkòyí	inmediatamente	None
pàmò	específicamente	None
px|kùránì	px | kernel	Nan
pupa	rojo	None
príncipe	príncipe	None
pèlu	con	None
providence	providencia	Nan
ra	comprar	None
rajya	esperanza	None
rome	cromo	Nan
roma	roma	None
roko	multitud	None
rokirika	hojeada	Nan
rogbodiyan	alboroto	Nan
roboto	superficies	None
robinson	robinson	Nan
ro	pensar	None
rnas	rnas	Nan
rnarna	rnarna	Nan
rna	rna	Nan
race	carrera	None
rn	rn	Nan
riresile	grabadora	Nan
rinle	recién	None
right|thumb|px|aworan	imagen	None
richard	ricardo	None
research	investigación	None
rere	bueno	None
repetejulo	sensible	None
repeats	repite	None
reggae	reggae	None
rank	rango	None
ramadan	ramadán	Nan
riro	imaginación	None
ronald	ronald	None
proton	protón	None
produced	producido	None
palauan	palauan	Nan
padá	vaina	Nan
paapaa	especialmente	None
paa	apagar	Nan
opolo	muchos	None
ofò	días	None
oyé	mundo	None
ose	ose	Nan
opolo	muchos	None
omonìyàn	humanos	None
olorun	dios	None
panaˈma	panamá	None
odun	anual	None
olórun	dios	None
okùnrín	la	None
ojó	está	None
odún	año	None
oúnjẹ	comida	None
owojagidijagan	terroristas	None
oun	él	None
otutu	muchos	None
otherwise	manera	None
oseluarailu	civil	None
oscar	oscar	None
olósìn	religioso	None
protokolu	protocolu	Nan
panyanan	espacio	None
parapọ̀	mezcla	None
press	prensa	None
portuguese	portugués	None
portonovo	portonovo	Nan
population	población	None
polaroid	polaroid	Nan
polandi	polaco	None
pojulo	alto	None
po	correos	Nan
plánẹ́tì	plomería	Nan
platos	platos	None
piposi	mucho	None
papa	papá	Nan
pipolongo	anuncio	None
pinu	determinado	None
pinsoto	pinoto	Nan
pinsi	declinante	Nan
phillipines	filipinas	None
pelu	perla	Nan
petu	petu	Nan
periferi	periferi	Nan
penisula	penisula	Nan
penh	penh	Nan
pele	encantador	Nan
paripari	fin	None
pipo	mucho	None
rorùn	fácil	None
rossii	rossii	Nan
rural	rural	None
sìbẹ̀	todavía	None
séyìn	espalda	None
séyìn	espalda	None
sénégal	semen	None
ségun	llorar	Nan
sèle	robando	Nan
são	nuevo	None
sáààrin	entre	None
sáàpàdé	patrocinio	Nan
sápadè	día	None
sàì	bien	None
sìni	camarón	Nan
sàngó	pandilla	Nan
sàmì	señal	None
sàbúrí	todo	None
symmetry	simetría	None
swahili	swahili	Nan
suny	suny	Nan
sun	dom	Nan
sugbọ́n	racional	None
sugbo	no	None
suez	suez	None
structures	estructuras	None
stella	stella	Nan
sàn	mejor	None
spectacular	espectacular	Nan
síbèsíbè	embargo	None
sílẹ̀	abajo	None
tabora	evitación	Nan
tabili	mesa	None
tabi	o	None
sísè	traducción	None
sísa	s	None
sááju	minuto	None
sisé	ejercicio	None
sepò	finalmente	None
se	hacen	None
sùgbón	contrario	None
síse	estructura	None
síbú	suelo	None
si	ciertamente	None
sùgbón	contrario	None
sóko	planta	None
sójà	soldado	None
sòrò	cerebro	None
síí	aquí	None
síwájú	adelante	None
síwon	ellos	None
síta	de	None
síso	todavía	None
síso	todavía	None
síse	trabajo	None
sọ	decir	None
so	entonces	None
sopin	final	None
soon	pronto	None
say	decir	None
santa	noel	None
samioro	disponible	None
sambia	juventud	None
salàyé	vida	None
salem	salem	Nan
sakyas	sakyas	Nan
sakyamuni	siguiente	None
saheli	conveniencia	Nan
safta	fila	None
safiwe	comparación	None
sb	sb	Nan
saffana	zafiro	Nan
saarland	piso	None
saaree	superior	None
saarc	eliminar	None
rẹ	su	None
ròyìn	reportado	Nan
rìn	andar	Nan
ré	c	None
république	république	Nan
ránmú	preocupación	None
ráhàn	apareció	None
ryan	ryan	Nan
safari	safari	Nan
schwarz	schwarz	Nan
sea	mar	None
seat	asiento	Nan
solomon	salomón	None
sohun	si	None
so	amor	None
slovo	slovo	Nan
sisupo	multiplicar	Nan
sisupapoerekusu	escupir	Nan
sisopo	enlace	None
sisodagba	creciendo	None
sise	cocinando	Nan
sioux	siux	Nan
sinsin	religión	None
sinai	pecado	None
silè	gotas	Nan
sile	detrás	None
sihamoni	estructura	None
sibesibe	todavía	None
sharon	sharon	Nan
sewadi	buscar	None
seville	sevilla	None
sense	sentido	None
senegal	senegal	Nan
semudaju	supuesto	None
semolara	asma	Nan
seidamo	claro	None
segbese	posiblemente	None
orúko	campo	None
taino	dino	Nan
orísìírísi	tipos	None
orísiirísi	varios	None
nombamewa	multiplicando	Nan
nobel	nobel	None
nnaji	tío	None
nkàn	cáncer	None
nkan	cosa	None
niyi	está	None
niye	suficiente	None
niyato	distinguir	None
niwaju	adelante	None
nitosi	cerca	None
nitoripe	porque	None
nombáméjì	dos	None
nitoriidieyi	esto	None
nilè	aquí	None
nijẹr	nike	Nan
nigbà	luego	None
nigbakan	veces	None
nibere	temprano	None
nibe	ahí	None
ngubengcuka	ngubengcuka	Nan
ngbero	planificado	Nan
nevis	nevis	Nan
neptune	neptuno	Nan
nefimu	nephim	Nan
nisinyi	ahora	None
nebraska	nebraska	Nan
novo	novo	Nan
nse	diseño	None
nínlá	excelente	None
nílẹ̀	piso	None
nílùú	ciudad	None
nílè	abajo	None
nígbàtí	cuando	None
nífẹ̀ẹ́	amar	None
níbè	ahí	None
níbè	ahí	None
ní	tener	None
nìyí	todo	None
nìnú	lo	None
nri	comida	None
nì	montaña	None
náwo	gastos	None
nàìjíríà	en	None
nwa	bebé	None
numeri	entumecimiento	Nan
nukleotidipupo	nucleótido	Nan
nukleotidi	nucleótido	Nan
nu	limpiar	Nan
ntoka	punto	None
nsowikipedia	obowikipedia	Nan
nsolaboraro	seguridad	None
nso	cerca	None
náà	también	None
nínu	oportunidad	None
ncnc	ncnc	Nan
nawojulo	misterioso	Nan
munispal	munispal	Nan
mulẹ̀	establecer	None
mughal	volumen	None
mtwara	nuevo	None
mtn	mtn	Nan
mozilla	mozilla	Nan
mozambique	mozambique	Nan
morogoro	automovilismo	Nan
morgan	morgan	Nan
monrovia	monrovia	Nan
mombasa	mombasa	Nan
muungano	muungano	Nan
mokanlelogbon	dos	None
mohandas	mohandas	Nan
minority	minoría	None
minnesota	minnesota	Nan
mimuwa	pegajoso	Nan
mimoy	mimoy	Nan
miiràn	aliviar	Nan
micronesia	micronesia	Nan
michelle	michelle	Nan
mexico	mexico	Nan
mewar	mewar	Nan
meucci	meucci	Nan
mokaleladota	compacto	Nan
nawó	dinero	None
májèmú	importa	None
méjèèjì	ambos	None
nato	otan	None
nathaniel	nathaniel	Nan
namibia	venir	Nan
mẹ́talọ́kan	trinidad	None
mẹ́ta	tres	None
mẹ́rkúríù	ratón	None
mẹ́fà	seis	None
múlẹ̀	fuerte	None
mó	m	Nan
móra	cura	Nan
mókólà	pegamento	Nan
mère	dibujo	None
mò	conocimiento	None
míìrán	otro	None
míràn	otro	None
mímọ́	santo	None
ménu	tu	None
méwàá	diez	None
métèètà	carpintero	Nan
méta	tres	None
mérìnlélógójì	cuatro	None
mérìndínlógún	dieciséis	None
méte	cinco	None
mérindíláàdóta	cinco	None
mííràn	otro	None
níní	tener	None
nípà	menos	None
nítorípé	porque	None
onítumò	traductor	Nan
oníná	fuego	None
onílẹ̀	abajo	None
oníkólóbó	abusivo	Nan
onígbàgbó	anciano	None
onka	calculadora	Nan
onje	dieta	None
oniyijulo	increíble	Nan
oniyewumeji	binario	None
onisowo	comerciante	Nan
onisayensi	técnico	None
onítèbọmi	los	None
onipin	racional	None
onilile	viviendas	None
onilanaibagbepo	condón	None
onigunfenfe	pasivo	None
onigbowo	un	None
onigbeja	constructivo	Nan
onibugbe	inquilino	Nan
onialjebra	onialjebra	Nan
omiadalu	inundar	Nan
omi	agua	None
olùkọ́	profesor	None
olùkó	instructor	Nan
oninawo	prestatario	Nan
olùkópa	contribuyente	Nan
onítòhùn	contador	Nan
oníyanjù	animado	Nan
orílẹ́	noche	None
orílẹ̀	nación	None
orílèèdè	nación	None
oríkì	poesía	None
oríilẹ̀	artículo	None
oríilè	nacional	None
oruko	sustantivo	None
orudnun	anual	None
oritameta	medio	None
orisa	orígenes	None
orisun	fuente	None
oníwòsàn	el	None
orisirisi	variedad	None
orileominira	calor	None
orilejoba	gobierno	None
orileedeajoba	imperialismo	None
orileede	nación	None
oriki	oriental	None
oriire	felicidades	Nan
ori	cabeza	None
opposite	opuesto	None
opec	opep	Nan
ootọ́	cierto	None
ooni	cocodrilo	Nan
orinìyìn	canción	None
olùdarí	líder	None
olùbátan	contacto	None
olóṣèlú	político	None
ojùkòsì	precipitación	None
ojuse	responsabilidad	None
ojuoorun	sol	None
ojukokoro	codicia	Nan
ojoru	calor	None
ojojumo	diario	None
ojo	parece	None
ogunlogo	multitud	None
ogun	guerra	None
ogbè	región	None
ofin	ley	None
ojùkòtúu	precipitación	None
ododo	justicia	None
obere	pequeña	None
obairanderan	prima	None
oba	obama	None
nso	próximamente	Nan
nǹkan	cosa	None
níyanjú	afirmativamente	Nan
níwájú	adelante	None
nítòótọ́	efecto	None
nítòótó	exactamente	None
nítòsí	cerca	None
nítumò	sentido	None
obínibí	cortesía	Nan
ojúlùmọ̀	conocidos	None
ojútáyé	viscosidad	Nan
ojúìwé	página	None
olóyè	regla	None
olódùmarè	todopoderoso	Nan
olympus	olimpo	Nan
oluwakiri	exploración	None
olusoju	guardia	None
oluparapo	combinación	None
olumojuto	codicioso	Nan
olukowe	autor	None
olukoitan	instructor	Nan
oludase	productor	None
oluda	creador	None
oloye	genio	None
oloselukan	hola	Nan
olora	grasa	None
olopon	arrogante	Nan
ololugbe	perdedor	Nan
olokunkun	auriculares	Nan
olojukanna	inmediatamente	None
olohun	propietarios	None
olodiajodojuko	otro	None
okunrin	hombre	None
okunkun	oscuridad	None
oko	campo	None
okhotsk	okhotsk	Nan
okeere	ultramar	None
orísìí	variedad	None
tainos	tainos	Nan
takuntakun	restricciones	None
talaka	pobre	None
ìràwọ̀	estrellas	None
ìrànàna	ayuda	None
ìrànlọ́wọ́	ayuda	None
ìpínrò	párrafos	Nan
ìpìnlè	principio	None
ìpìlẹ̀núkléù	cifrado	Nan
ìpolongo	publicidad	None
ìnáwó	gasto	None
ìnagije	victoria	None
ìmúsára	para	None
ìmúnilérú	abusos	Nan
ìrí	experiencia	None
ìmú	cena	None
ìmò	relámpago	Nan
ìmò	serpiente	None
ìlé	hogar	None
ìlè	soborno	Nan
ìlàìnàró	opresión	Nan
ìlàorùn	hematomas	Nan
ìlànàn	espejismo	Nan
ìlà	contorno	Nan
ìlo	llamada	None
ìlera	salud	None
ìkọpa	participación	None
ìmóbìdo	nacimiento	None
ìkẹrin	cuarto	None
ìròkò	pensamiento	None
ìròyìnwiki	noticias	None
ìtaeko	taller	None
ìta	de	None
ìse	acción	None
ìsòro	dificultad	None
ìsílé	hogar	None
ìsèjoba	gobierno	None
ìsèdá	creación	None
ìsègbèfábo	diligencia	Nan
ìse	acción	None
ìsọ	tiendas	None
ìsú	grosor	Nan
ìròyìn	noticias	None
ìsòrí	subdivisión	Nan
ìsìn	religión	None
ìsèlè	producción	None
ìsàlè	sol	None
ìsomó	unir	None
ìsirò	cálculo	None
ìsinsìnyí	ahora	None
ìse	acción	None
ìsawo	adivinación	Nan
ìrúbo	colapso	None
ìró	sonido	None
ìròrùn	espejismo	Nan
ìsòrò	meditación	Nan
ìtan	historia	None
ìkínin	sexto	None
ìkìjà	un	None
ìdá	deserción	Nan
ìdàrúdàpò	caos	None
ìdàpapọ̀	consolidación	None
ìdàgbà	adulta	None
ìbílè	patrimonio	None
ìbílè	patrimonio	None
ìbáraeni	carro	None
ìbánisòrò	conexión	None
ìbarà	fiebre	None
èpón	mucho	None
èwù	camisa	Nan
ìdìmú	disturbio	Nan
èsìn	religión	None
èro	pensamientos	None
èka	efecto	None
èyì	dignidad	None
ète	propósito	None
èsúrú	hormigas	Nan
èsó	mezquita	None
èrò	pensamientos	None
èràn	enfermedad	None
ènìkan	cosa	None
èlò	utensilios	Nan
èkejì	otro	None
èrí	evidencia	None
ìkìlò	abuso	None
ìdíisin	porque	None
ìdó	picadura	Nan
ìkéde	declaración	None
ìkèrèkú	congestión	Nan
ìkànna	mismo	None
ìkejì	otro	None
ìjọba	gobierno	None
ìjò	líder	None
ìjìnlè	misterio	None
ìjìnlè	misterio	None
ìjora	odio	None
ìjoba	gobierno	None
ìjo	iglesia	None
ìdíwòn	razón	None
ìjo	baile	None
ìgbò	ram	None
ìgbésí	vida	None
ìgbéraga	orgullo	None
ìgbáraga	fuerza	None
ìgbá	alas	None
ìgbàgbé	olvidadizo	Nan
ìgbà	hora	None
jé	desastre	None
ìfáàrà	sacerdote	None
ìfojúìtànìgbesiayé	vida	None
ìfara	tortura	None
ìhun	hierro	None
ìtokò	la	None
ìtàn	historia	None
ìtànkálé	inundaciones	None
ṣàkóbá	perjudicial	Nan
ṣiṣé	apertura	None
σ	σ	Nan
κάππα	.α	Nan
ˌæləˈbæmə	enfermedad	None
ˌkælɪˈfɔrnjə	ɪˈkælɪˈfɔrnjə	Nan
ˈøːstəˌʁaɪç	ˈøːstəˌʁaɪç	Nan
ʔaːnaːtɕɑ̀k	buscar	None
şe	hacer	None
únṣẹlẹ̀	terremoto	None
ôdún	año	None
ẹdo	broma	Nan
ó	si	None
ósírísì	saliva	None
óníse	es	None
ó	eso	None
òròàjòmó	tiempo	None
òrò	pensamientos	None
òwó	dinero	None
òsà	colores	None
òrò	pensamientos	None
òré	juego	None
òpòlopo	muchos	None
òfò	siguiente	None
ósékú	muerto	None
òré	juego	None
ẹlẹ́bùn	regalo	None
ẹnìkan	persona	None
ọ̀pòlòpò	acción	None
ọ̀nà	camino	None
ọ̀gbìn	planta	None
ọ̀dọ́	juventud	None
ọpọ́lọpọ́	higos	Nan
ọn	eso	None
ọmọ	niño	None
ọmú	un	None
ọlọ́run	dios	None
ọlọ́mọ	niños	None
ọdún	año	None
ẹlẹ́sìn	religioso	None
ọbàkàn	hermano	None
ẹ̀rọ	maquinaria	None
ẹ̀ni	oms	None
ẹ̀kọ́	educación	None
ẹ̀kẹ́ta	tercero	None
ẹ̀kasístẹ̀mù	subjetivo	None
ẹ̀kaoṣù	espinoso	Nan
ẹ̀kajuly	mayo	None
ẹ̀kabrítánì	tío	None
ẹ̀kaawon	presentaciones	None
ẹtì	hígado	None
ẹsẹ	pies	None
ẹ̀wẹ̀	parte	None
òpòlopò	muchos	None
òkòòkan	uno	None
òkan	uno	None
òdo	juventud	None
òdeojú	rostro	None
òde	de	None
ìṣọ̣̀tẹ̣̀	neumonía	None
ìṣẹ́kù	resto	None
ìṣèlú	política	None
ìyípadà	conversión	None
ìyàwó	novia	None
ìyapa	separación	None
ìya	sufrimiento	None
ìwúlò	útil	None
òdìkejì	otro	None
ìwòran	visión	None
ìwéré	folleto	Nan
ìwàásù	predicación	Nan
ìwo	cuernos	Nan
ìwe	comparación	None
ìtúpalè	traducción	None
ìtúmò	traducción	None
ìtóka	ser	None
ìtójú	expresiones	None
ìtóju	confusión	None
ìtójú	cuidado	None
ìtèsíwájú	progreso	None
ìwò	general	None
òféàrán	imagen	None
ògbójú	competente	Nan
ògiri	pared	None
òjògbón	clima	None
òṣèlú	política	None
òwù	paño	Nan
òsèré	atleta	Nan
òsèlú	político	None
òsán	mediodía	Nan
òrò	cerebro	None
òrí	capítulo	None
òrìsà	ídolos	Nan
òranyàn	obligatorio	None
òpópóònà	carretera	None
òotó	verdad	None
òní	hoy	None
òmùàrán	imagen	None
òmiràn	el	None
òle	casa	None
òkúta	piedra	None
òkú	cuerpos	None
òkòòkan	uno	None
òkèògbún	mil	None
òjísé	doctor	None
òjo	parece	None
ògúndìpẹ̀	polvo	None
ògun	medicamento	Nan
ògo	gloria	None
èka	rama	None
èhìn	siguiente	None
èfòn	tiempo	None
èdè	idioma	None
visit	visitar	None
viruses	virus	None
villa	villa	None
vihara	vihara	Nan
videos	videos	None
victor	víctor	None
vermont	vermont	Nan
venezuela	venezuela	None
uzbek	manera	None
utc	utc	Nan
utah	utah	Nan
vz	vz	Nan
usps	usps	Nan
urasílì	uracilo	Nan
unla	si	None
unifasiti	universidad	None
umueri	niños	None
ucb	ucb	Nan
tẹ̀ǹbẹ̀lẹ̀kun	conspirar	Nan
tẹ̀ǹbẹ̀	luego	None
túnse	reorganizar	Nan
túmò	ciruela	Nan
tú	derramar	Nan
tóka	citado	None
uribe	el	None
tó	tó	Nan
waa	es	None
wari	oler	Nan
yafran	alfabeto	None
xiv	xiv	None
xd	xd	Nan
wọ̀nyí	estas	None
wọn	ellos	None
wúnrèn	ejercicio	None
wón	ellos	None
wònyí	son	None
wòfún	vistazo	Nan
wípè	claridad	None
wì	lavar	Nan
waju	cara	None
wàásù	predicar	Nan
wura	oro	None
won	ellos	None
wo	aquí	None
wo	aquí	None
woo	cortejar	Nan
wole	registrarse	Nan
województwo	locura	Nan
wiwari	descubrimiento	None
witkin	witkin	Nan
wisconsin	wisconsin	Nan
westminster	westminster	Nan
wyoming	wyoming	Nan
tówùú	cantidad	None
tókù	descanso	None
tódárajùlọ	mejor	None
tokyo	tokio	None
tokasi	señaló	None
toje	raro	None
to	a	None
tiwọn	suyo	None
titu	disparar	Nan
tirè	su	None
tirana	tirana	Nan
tira	tiempo	None
thumb|left|upright|nelson	nelson	None
those	aquellos	None
tolerejulo	tolerado	Nan
they	ellos	None
tfrac	tfrac	Nan
terutomo	terutomo	Nan
temptation	buscando	None
tele	seguimiento	None
teksas	texas	None
tedo	fechado	Nan
technology	tecnología	None
taínos	taínos	Nan
tata	filtrar	Nan
tara	nueve	None
talika	pobreza	None
the	el	None
tolórítelémù	holocausto	None
tomé	tomate	Nan
tooto	verdad	None
tóbi	grande	None
tò	conjunto	None
tíórì	llantas	Nan
tíátà	entradas	None
títío	hasta	None
títèlé	seguir	None
títi	cerrado	None
té	t	Nan
télè	por	None
té	t	Nan
tèsíwájú	progresar	Nan
tèlé	inmediatamente	None
tètè	rapidez	None
tèlé	seguimiento	None
táawà	inclinarse	Nan
tàwon	ellos	None
tàsí	sin	None
tuntun	nuevo	None
tumosi	medio	None
translated	traducido	None
traduite	traducir	Nan
tounsejanu	trágico	Nan
toseluaralu	político	None
torun	morena	Nan
tori	tori	Nan
yakubu	yakub	Nan
metropoli	metrópoli	Nan
yan	seleccione	Nan
yanturu	mucho	None
àsìkò	hora	None
àsèyìn	secuelas	Nan
àsàjemátèe	amanecer	None
àse	banquete	Nan
àrẹ	presidente	None
àrùn	enfermedad	None
àrígbámú	perturbador	Nan
àpeere	ejemplo	None
àpapọ̀	todo	None
ànfàní	oportunidad	None
àmúsorò	psicología	None
àsótélè	extensión	None
àmúlò	práctico	None
àmérìkà	sobrenatural	None
àlébù	defecto	None
àlèpò	encima	None
àlè	bastardo	Nan
àlááfià	analogía	None
àlàáfíà	paz	None
àlàyé	información	None
àlàkalè	metas	None
àkókó	tiempo	None
àkójopò	grupo	None
àká	estantería	Nan
àmì	firmar	None
àkàrà	pasteles	Nan
àsọdọ̀kan	unidad	None
àsà	personalizado	Nan
èdè	idioma	None
èdá	creación	None
èbúté	puerto	None
èbà	mosquitos	Nan
áwon	fornicación	Nan
án	t	Nan
àìsí	ausencia	None
àìròtélè	inesperado	Nan
àìní	querer	None
àìkó	deficiencia	None
àáyá	semen	None
àsekúdórógbó	ladrar	Nan
àárín	medio	None
ààtò	ritual	None
àwùjo	sociedad	None
àwón	dinero	None
àwón	dinero	None
àwon	teorías	None
àtẹnudẹ́nu	oral	None
àtúnse	editar	None
àtúnse	editar	None
àtòrìnká	de	None
àtìpó	el	None
àtijo	obsoleto	Nan
ààyè	viva	None
àkosílè	tesis	None
àkosílè	abstracción	None
àjọṣepọ̀	social	None
yíì	a	None
yíyípadà	cambio	None
yí	vuelta	None
yìí	esta	None
yì	vamos	Nan
yée	déjalos	Nan
yèwò	mira	None
yára	darse	None
yàtò	preparar	None
yànan	asombro	Nan
yo	yo	Nan
yíò	a	None
yorúbà	yogur	Nan
yori	led	None
yoo	será	None
yiyafunnilo	erosión	None
yipada	vuelta	None
yiowu	a	None
yio	deberá	None
yindinyindin	pares	None
ye	si	None
ye	si	None
yewo	mejora	None
yaoundé	yaoundé	Nan
york	york	None
yẹ̀ẹ́	ya	None
yọ	eliminar	None
zanzibar centralsouth	sur	None
àjákọ	aparte	None
àjo	viaje	None
àifète	propósito	None
àgọ́	tienda	None
àgbùdo	yarda	Nan
àgbìgbò	barrio	None
àgbéyèwò	revisión	None
àgbékà	resumen	None
àgbáríjọ	organización	None
àgbàrá	inundar	Nan
àgbàjọ	viejo	None
àdóolóró	petróleo	None
àdáátán	exclusivo	None
àdátá	contrario	None
àdámò	intimidad	Nan
àbọ̀	medio	None
àbìkú	inmortalidad	Nan
àbáyo	sugerencia	Nan
àbámẹ́ta	jueves	Nan
àbe	babuino	Nan
bce	lejos	None
zy	zy	Nan
zscores	zscores	Nan
zou	zou	Nan
zdna	zdna	Nan
yanjú	resolver	None
methodologies	metodologías	Nan
merin	cuatro	None
mercosur	mercosur	None
díè	tiempo	None
dìtẹ̀	conspirar	Nan
dìró	derecha	None
dìde	surgir	None
dì	sábana	Nan
dépò	medida	None
délànà	principio	None
dé	llegado	None
dáwó	donar	Nan
dásà	casa	None
dáradára	bien	None
dóko	bueno	None
dálóríi	gracias	None
dágbó	vejez	Nan
dá	creado	None
dàpò	sustituirlos	Nan
dàbíi	esto	None
dun	sabroso	Nan
due	a	None
du	du	None
dover	dover	Nan
doublestrand	cadena	None
doublehelix	hélice	None
dote	adorar	Nan
dájó	bien	None
doni	doni	Nan
dólà	bien	None
dúró	pararse	Nan
eléré	atleta	Nan
eléde	resumen	None
elláda	creación	None
eleyii	esto	None
eleyi	esta	None
elede	cerdos	None
eko	educación	None
ekeji	otro	None
eka	complejo	None
eighteen	dieciocho	Nan
egbògi	médico	None
dún	sonido	None
egbò	herida	None
egbo	herida	None
egberundun	años	None
egbe	pistola	Nan
egba	absolutamente	None
efrem	effem	Nan
ede	idioma	None
ecomog	ecomog	Nan
ebi	familia	None
eba	eba	Nan
ea	si	None
dọ́gba	igual	None
egbé	aflicción	Nan
elòmírà	algas	None
dominic	dominic	Nan
doju	cara	None
clear	claro	None
cipollone	cipollona	Nan
china	china	None
cherished	querido	None
chebbi	pensar	None
chaskalson	chaskalson	Nan
charles	charles	None
chamorro	chamorro	Nan
cbc	cbc	Nan
cauchy	cauchy	Nan
catherine	catherine	Nan
code	código	None
cathedral	catedral	None
casablanca	casablanca	Nan
cape	capa	None
canaria	canaria	Nan
calabar	chicle	Nan
cairo	rabia	Nan
bẹ́ẹ̀sìni	si	None
bẹ́ẹ̀ni	si	None
bẹ́ljíọ̀m	berilo	Nan
bẹ́	rompió	None
bẹ̀rẹ̀	empezar	None
búrú	sé valiente	Nan
caslon	casino	Nan
dojú	cara	None
coetsee	coetsee	Nan
coming	viniendo	Nan
divoire	divoire	Nan
dinwoju	buscar	None
din	freír	Nan
different	diferente	None
didasile	establecimiento	None
didagba	igualdad	None
development	desarrollo	None
desmond	desmond	Nan
describes	describe	None
des	des	None
denver	denver	Nan
coloured	colores	None
delhi	haga	None
daru	destruir	None
darapo	unirse	None
dani	participación	None
dandan	obligatorio	None
dagbasoke	crecer	None
da	y	None
cunha	garganta	None
ct	connecticut	Nan
csto	csto	Nan
computers	ordenadores	None
compared	comparado	None
dates	fechas	None
elòmíràn	otro	None
emerging	emergente	Nan
emmanuel	emmanuel	Nan
gbaná	salir	None
gbale	popularidad	None
gbajúgbujà	popular	None
gba	acuerdo	None
galatia	vez	None
fẹ́rẹ̀ẹ́	casi	None
fòye	entender	None
fífún	dando	None
fífò	volador	Nan
fégbé	olvídalo	Nan
fé	fé	Nan
gbe	llevar	None
fé	fé	Nan
funra	mismo	None
fun	para	None
fulbe	ful	Nan
fulani	cobardemente	Nan
fuji	eliminar	None
freetown	freetown	Nan
fransi	francés	None
francis	francis	None
fracmv	fracmv	Nan
fowó	dinero	None
fowobowe	reserva	None
further	lejos	None
fourbase	fourbase	Nan
gbera	adelante	None
gbese	deuda	None
geneva	ginebra	None
geesi	inglés	None
gbọ́dọ̀	debe	None
gbúnùn	huelelo	Nan
gbónmisi	ley	None
gbódò	debe	None
gbìyànju	fuerte	None
gbìnyànjú	tratar	None
gbésè	oferta	None
gbéyèwò	revisión	None
gbéni	vivo	None
gberasoke	acelerar	Nan
gbékalè	carpintero	Nan
gbé	vivo	None
gbáradì	levántate	Nan
gbá	aplastar	Nan
gbàgùrà	sacudió	Nan
gbàgbọ́	creer	None
gbongbo	raíz	None
gbogbogbo	general	None
gbin	plantado	Nan
gbilè	fugarse	Nan
gbigbewo	financiación	None
gbigbamulo	explotación	None
gbédìí	establecer	None
foriko	ejemplo	None
force	fuerza	None
foniimu	película	None
eyonomba	eyonomba	Nan
eyin	huevos	None
eya	categoría	None
example	ejemplo	None
ewì	poesía	None
ewé	hoja	None
ewe	hoja	None
euroasia	euroasia	Nan
euro	euro	None
etíòkun	costa	None
etymologiae	etymologiae	Nan
eléja	pescar	Nan
etisalat	etisalat	Nan
esia	está	None
eseese	diagrama	None
eréonítàn	acrónimo	Nan
erékùsù	isla	None
erofo	sedimento	Nan
ernst	ernst	None
epa	maní	Nan
eníbá	fiebre	None
enì	elefante	Nan
enter	entrar	None
enikéni	mundo	None
esteri	esteri	Nan
elòmíràn	más	None
eka	efecto	None
eléyàmèyà	etnicidad	Nan
fohùn	gritar	Nan
fofinde	prohibición	None
fodio	fodio	Nan
five	cinco	None
fitino	juicio	None
finlandi	finlandia	None
finiki	física	None
fimú	definido	None
fihan	indicado	None
fifihan	demostración	None
fi	salvar	None
fe	querido	None
fesèmúlè	provisional	None
ferde	ferde	Nan
felifeli	terciopelo	Nan
farsi	arti	Nan
faranse	francés	None
faramó	a	None
fan	ventilador	Nan
fail	fallar	Nan
fagile	cancelado	Nan
ewà	conducta	None
esè	producto	None
esin	religión	None
enu	boca	None
búburú	malo	None
bòtswánà	el	None
béè	así	None
bèrẹ̀	empezar	None
alawose	adivinación	Nan
alalaye	terroso	Nan
alakobere	principiante	Nan
alakitiyan	activista	Nan
alaini	necesitado	Nan
alaigbara	irresistible	Nan
alaidogba	desequilibrado	Nan
aladanida	arbitrario	Nan
aladani	privado	None
aladaani	privado	None
alaafin	ilegítimo	Nan
albany	albany	Nan
alaafia	paz	None
alaabo	discapacitado	Nan
ala	abajo	None
akẹ́kọ̀ọ́	estudiante	None
akíngbógun	batallón	Nan
akíkanjú	valiente	Nan
akátá	chacal	Nan
akopo	compilacion	Nan
akopa	todo	None
akoni	tenemos	None
akole	podemos	None
akokolo	período	None
alaadanida	deseado	None
akinpelu	artillería	None
albert	albert	Nan
alicia	alicia	Nan
anc	africano	None
anabi	profeta	None
an	un	None
améríkà	americano	None
améríkà	americano	None
amosi	mezquita	None
amojeoyipada	convertible	Nan
amerika	america	None
americas	americas	Nan
amazonas	amazonas	None
alọ́po	billetera	Nan
alexandra	alexandra	Nan
alúwo	auge	None
aláyèwò	inspector	Nan
alátise	artista	None
alápapò	reemplazo	None
alákọ̀bẹ̀rẹ̀	iniciador	Nan
alumíníọ̀mù	aluminio	None
alumoni	curativo	Nan
alukuraani	corán	None
alubàbá	padre	None
alpha	alfa	None
alominira	independencia	None
allāh	alá	Nan
aláísàn	enfermo	None
akiidah	coridah	Nan
ajọra	réplica	Nan
ajoro	viaje	None
adiokan	solitario	None
adeda	naturaleza	None
addis	addis	Nan
adarihunrun	limpiador	Nan
adabaye	bien	None
adaba	conveniente	None
accra	accra	Nan
abúléko	pueblo	None
abínibí	nacionalidad	None
abé	aguja	None
abálájo	experimentado	None
adágbà	mayor	None
aburunmu	nuestra	None
abidjan	nunca	None
abidi	alfabeto	None
abesahara	espolvorear	Nan
abeorile	casa	None
abeikojopo	heredera	Nan
abala	parte	None
aawe	parálisis	Nan
aare	aare	Nan
aapon	aapon	Nan
aanu	compasión	Nan
aala	frontera	None
abo	femenino	None
kútò	calle	None
adúgbò mókóla	mucocula	Nan
adúgbò quarry	la	None
ajo	viaje	None
ajibola	agenda	None
ajemoroyin	interrogatorio	Nan
aje	economía	None
ajagun	perro	None
aisi	carencia	None
aintimulo	aintimulo	Nan
agio	llorar	Nan
agbéiná	bombero	Nan
agbára	poder	None
agbàbò	protector	None
agbà	adulto	None
agbeinadie	cultivo	None
agbaye	mundo	None
agbara	poder	None
agbado	maíz	None
agba	pintar	Nan
aféfé	molino	Nan
africans	africanos	None
african	africano	None
africa	áfrica	None
afoyemo	sinopsis	Nan
afomo	ejemplo	None
afida	familia	None
adúgbò ìdí	del	None
andaman	andman	Nan
genevieve	genevieve	Nan
angkor	angkor	Nan
anschluss	anschluss	Nan
benin	banco	None
bengali	bengalí	Nan
bengal	bengala	Nan
belgium	bélgica	None
belarus	bielorrusia	None
beijing	beijing	Nan
beauharnais	beauharnais	Nan
bce	lejos	None
bayìí	ahora	None
bayi	ahora	None
bayelsa	bayelsa	Nan
berber	beréber	Nan
bauxitealumina	bauxitealumina	Nan
banle	banle	Nan
bang	explosión	None
balẹ̀	ser	None
bahrain	bahrein	Nan
babaláwo	el	None
baa	es	None
aṣòkan	individual	None
azikiwe	común	None
ayò	sí	None
ayàfi	bien	None
ayeye	eternidad	Nan
bara	pasado	None
aya	verso	None
berlin	berlina	Nan
bharat	bharat	Nan
báyìí	ahora	None
bárakú	adiccion	Nan
bálè	globo	Nan
bákannáà	también	None
bàbá	padre	None
by	por	None
burúkú	mal	None
bujumbura	expandido	Nan
buenaventura	buenaventura	Nan
bu	decir	None
brítánì	británico	None
bernstein	bernstein	Nan
britain	bretaña	None
brazzaville	brazzaville	Nan
brasil	brasil	None
bolívar	bolívar	None
bolt	tornillo	Nan
bole	tronco	None
bojú	un	None
bodies	cuerpos	None
black	negro	None
biribiri	fue	None
bibeli	biblia	None
bharata	vuelve	None
bridgeport	bridgeport	Nan
awújẹ	escándalo	None
awùjo	cortesía	Nan
awuruju	mágico	None
arábíà	alfabético	Nan
aráa	hermano	None
aryan	el	None
arun	enfermedad	None
aruleyin	hola	Nan
aroko	vegetación	None
arkansas	arkansas	Nan
ariwaguusu	suroeste	None
ariwaarin	oriente	None
ariso	aris	Nan
arinkankan	éste	None
aráròmí	hola	Nan
aralíle	tropical	None
apẹ̀rè	delantal	Nan
apòmù	delantal	Nan
apis	apis	Nan
apeere	ejemplo	None
apeja	pescador	Nan
aparapo	combinación	None
apaiwoorun	occidental	None
apailaorun	amanecer	None
apaguusuiwoorun	oeste	None
apaguusuilaorun	oeste	None
apagusu	sur	None
arabu	árabe	None
arópò	soborno	Nan
arúgbó	vejez	Nan
arọ	cojo	Nan
awon	ellos	None
awoòn	modelo	None
awonara	emoción	None
awo	plato	None
awari	descubrimiento	None
avar	avar	Nan
austríà	australia	None
austronesian	austronesio	Nan
austriahumgary	austriaumgary	Nan
australia	australia	None
atunse	corrección	None
atun	rebobinar	Nan
atinrin	riendo	Nan
atimo	plan	None
atigba	admisible	Nan
atanna	átomo	None
atangbona	átomo	None
asèdá	natural	None
asìko	disparates	Nan
assessment	evaluación	None
asipa	desviación	None
aseyori	éxito	None
aseeto	asentamiento	None
ascii	descubrir	None
asagun	victoria	None
anita	anita	Nan
ọ̀rọ̀	hablar	None
georgia	georgia	None
gfaj	gfaj	Nan
kòjòkú	lluvia	None
kírísìtì	navidad	None
kínu	besos	Nan
kíkọ́	aprender	None
kíko	estudiando	None
kí	saludar	Nan
kìnní	primero	None
kéyìn	luego	None
kémíkà	contrario	None
kétu	preparado	None
kékéèké	pequeña	None
kòkó	ratón	None
kéesì	ridículo	Nan
kánádà	supuesto	None
kánfinkése	ingenio	Nan
ká	de	None
kàyéfì	preguntarse	Nan
kàríbẹ́ánì	región	None
kwara	dirigido	None
ku	tú	None
krio	krio	Nan
kori	más	None
ko	ko	Nan
koko	aprendizaje	None
káyé	mundo	None
koto	cebo	Nan
kòmpútà	computadora	None
kòòsí	es	None
labalaba	mariposa	Nan
laarin	dentro	None
laaka	contrarrestar	Nan
laada	golpear	Nan
laa	vete	Nan
kọ́ni	de	None
kọ́lọ́mú	columnas	None
kọ́kọ́	primero	None
kọ̀mpútà	computadora	None
kọjá	pasar	None
kẹ́nyà	separación	None
kòtò	un	None
kẹta	tercero	None
kẹrin	cuarto	None
kúùkù	contrario	None
kútò	todo	None
kúrò	lejos	None
kúkúrú	palabra	None
kúkú	todo	None
kùrání	el	None
kùkú	todo	None
kóra	reunir	None
kógo	gloria	None
kòòkan	uno	None
kẹsàán	inmediatamente	None
labee	debajo	None
kookan	esta	None
kong	kong	None
kampala	corchete	Nan
kalẹ	lado	None
kalinga	cinga	Nan
kakiri	rastro	Nan
kagera	jactancioso	Nan
kadara	activo	None
jọ́	favor	None
jẹ́mánì	alemán	None
jùló	mas	None
jùlo	especialmente	None
jùlo	que	None
kan	una	None
jíjéomoléyìnkírísítì	como	None
jíje	siendo	None
jìnnàa	lejos	None
jéésù	jesús	None
jé	ven	None
jáde	salga	Nan
jàgídíjàgan	violento	None
juneau	juneau	Nan
jo	juan	None
jopò	participar	None
jojo	agrietado	Nan
johanu	lo	None
jíjuwó	dinero	None
kongo	condón	None
kankan	ninguna	None
karbonumarun	thecentricane	Nan
komputa	computadora	None
kolo	kolo	Nan
kojá	cruzar	None
koidu	koidu	Nan
kodò	abajo	None
ko	o	None
kinkinni	cosa	None
kilhar	axila	Nan
kikuninu	imagina	Nan
kiko	aprendizaje	None
kikoso	rápido	None
kanlè	kanal	Nan
kikopomo	calor	None
kiko	trayendo	Nan
kiakiajulo	rápido	None
ki	también	None
khoisan	inferior	None
kept	mantenido	None
keko	alfabetizado	Nan
kekere	pequeña	None
kebbi	ajustable	Nan
karùún	quinto	None
karun	quinto	None
karl	karl	None
kikojo	compilacion	Nan
lade	cargar	Nan
laid	puesto	None
laifi	culpa	Nan
mahatma	el	None
madeira	beira	Nan
maapu	mapa	None
lọ́jà	mercado	None
lọ́dọọdún	anualmente	None
lọndọnu	londres	None
lórò	mañana	None
lónà	camino	None
ló	ló	Nan
lóòótọ́	efecto	None
lóòótò	si	None
makedonia	macedonia	None
lóti	lote	Nan
lórì	puerto	None
lópó	viuda	None
lópez	nipez	Nan
lóde	de	None
lítésò	escozor	Nan
lísa	aceleración	None
lílo	explotación	None
lérú	esclavitud	None
léyìn	luego	None
léyin	después	None
lérò	razón	None
lóríba	encima	None
lérìnín	nieve	None
malabo	miel	None
malayopolynesian	malayo polinesio	Nan
member	miembro	None
melo	cuántos	Nan
meksiko	mexico	Nan
mejila	doce	None
mejidinlogbon	veintiocho	Nan
mefeefa	revisión	None
mediteraneani	mediterráneo	None
means	medio	None
mbabane	negativo	None
maya	no	None
max	max	None
malay	ficticio	None
mathimatiki	matemático	None
matheu	matheu	Nan
maseru	celos	Nan
maryland	maryland	Nan
mars	marte	None
marku	vez	None
march	marzo	None
marcellus	marcelo	Nan
manˈdeːla	manˈdelala	Nan
mango	mango	Nan
mali	día	None
malaysia	malasia	Nan
mathiew	mathiew	Nan
léebá	paso	None
lédè	lenguaje	None
lèyìn	después	None
links	enlaces	None
linear	lineal	None
lindi	lejía	Nan
lilongwe	lilongwe	Nan
lilemo	canabis	Nan
lilelile	duro	None
leè	mayo	None
leyi	está	None
lewon	prisión	None
lewaju	adelante	None
less	menos	None
lodo	lugar	None
lese	enviar	None
lekun	intensificado	Nan
leboa	lebo	Nan
le	lata	Nan
lay	laico	Nan
latvia	letonia	None
latini	latín	None
latigbana	entonces	None
latibe	allí	None
lasile	lanzamiento	None
lanka	lanka	Nan
languages	idiomas	None
leo	león	None
lojowaju	futuro	None
lojukokoro	codicioso	Nan
lojúgun	él	None
lèe	lata	Nan
láíláí	nunca	None
láì	sin	None
lárúbáwá	natural	None
lára	herir	Nan
lápá	parte	None
lámọ́di	fortuna	None
láké	ruidoso	Nan
láimo	sin	None
láfún	dado	None
lábé	peso	None
lààmì	señales	None
lààmi	firmar	None
làgba	igual	None
lynton	lynton	Nan
luther	luther	Nan
luanda	luanda	Nan
lo	seguir	None
low	bajo	None
lovers	amantes	None
louvre	lumbrera	Nan
loruko	nombre	None
lopolopo	mucho	None
loloselu	políticamente	None
lokunkun	energético	None
johann	infierno	None
jogun	heredado	Nan
jo	fuga	None
jiròrò	brumoso	Nan
ifitonileti	información	None
ifilole	lanzamiento	None
ifija	pescar	Nan
idánwò	juicio	None
idupe	gracias	None
idoma	dibujo	None
idimule	arrestar	Nan
ideraa	escribir	None
idari	s	None
idamita	dibujar	None
idajo	justicia	None
ifobaje	corrupción	None
idaji	medio	None
idagbasoke	desarrollo	None
iceland	islandia	None
ibùjókòó	asientos	Nan
ibùdó	acampar	Nan
ibuso	luchar	None
ibuseripadabosi	reubicación	Nan
ibujoko	banco	None
ibori	velo	Nan
ibojì	tumba	None
ibn	ibn	None
ibiti	lugares	None
idagbe	negligencia	Nan
ibise	ejercicio	None
ifofinde	congreso	None
igbeduro	preparación	None
iketa	heredar	Nan
ikerin	cuarto	None
ikeko	compilacion	Nan
ikejidinlogun	dieciocho	Nan
ikaowo	respeto	None
ikandinlogun	dieciocho	Nan
ikan	uno	None
ijó	bailando	Nan
ijosin	adoración	None
ijinnasi	física	None
ije	movimiento	None
ifriqiya	estímulo	None
ijaya	pánico	Nan
ijagun	lucha	None
ihinrere	evangelio	None
ihan	aparecer	None
igitòròmogbè	ancha	None
igbáẹ̀yìn	último	None
igbá	pollo	Nan
igbowolori	costoso	Nan
igbeyawo	boda	None
igbesoke	potenciar	Nan
igberiko	suburbano	Nan
igbegun	victoria	None
ijakadi	dificil	Nan
ibimo	nacimiento	None
ibile	tradicional	None
ibiamusin	santuario	Nan
gún	perforado	Nan
gòkè	subir	None
gírámà	abuelo	None
gégé	verdad	None
gèésì	joya	Nan
gèésì	pegamento	Nan
gv	gv	Nan
guusu	sur	None
gunle	pistola	Nan
gun	largo	None
guinébissau	guinébissau	Nan
gúúsù	sur	None
guineabissau	guineabissau	Nan
guanínì	guanni	Nan
groove	ranura	Nan
griiki	griego	None
grammy	grammy	None
gquadruplex	gquadruplex	Nan
gorgina	águila	None
gomina	gobernador	None
goemai	goemai	Nan
gidí	casa	None
gidigidi	muy	None
ghana	ghana	Nan
guinea	guinea	None
gẹ̀ẹ́sì	inglés	None
habsburg	habsburg	Nan
haggai	guía	None
ibewo	llegado	None
ibeji	gemelos	None
ibarepo	asociación	None
ibalo	asunto	None
hv	hv	Nan
hungari	inanición	Nan
hun	huno	Nan
hugh	hugh	Nan
hp	hp	Nan
hosea	hosea	Nan
hominidae	hominidae	Nan
histoni	histoni	Nan
hindu	hindu	Nan
him	él	None
hesse	convenido	Nan
heraklion	heraklion	Nan
henny	henny	Nan
hendu	caramelo	Nan
heinrich	heinrich	None
hawaii	hawai	Nan
hausafulani	hausafulani	Nan
haughton	haughton	Nan
hard	difícil	None
halomonadaceae	halomonadaceae	Nan
haiti	haití	None
ikoenu	ahorrar	Nan
german	alemán	None
ikojopo	acumulación	None
iku	muerte	None
itumo	sentido	None
itu	tirar	Nan
itorawo	liberal	None
itokowo	negocio	None
itobi	alardear	Nan
itiraka	dificil	Nan
itelentele	claramente	None
itanakole	historia	None
itali	italiano	None
isè	servicio	None
isesi	rendición	None
iwadi	investigación	None
isun	fluir	Nan
iso	venir	Nan
isepinpin	distribución	None
iseowo	negocio	None
iseoroayeijoun	arqueología	None
iseoba	quince	None
isejoba	gobernancia	Nan
iseero	reloj	None
isedaniloro	duda	None
isare	aceleración	None
isa	suficiente	None
irúnmọlẹ̀	relámpago	Nan
isoponomba	isoponomba	Nan
irò	rumor	Nan
iwasi	impresionar	Nan
iwoile	hogar	None
jijinna	lejos	None
jije	siendo	None
jfk	jfk	Nan
jesu	jesús	None
jeometri	geometría	None
jeffrey	jeffrey	Nan
jawaharlal	columpios	Nan
jamo	vete	Nan
jamaica	youtube	None
jalè	robo	Nan
jagbe	piérdase	Nan
iwifun	información	None
jadide	espere	Nan
jabo	reporte	Nan
iṣẹ́ìwádìí	investigación	None
iḷẹ̀	trabajo	None
iyán	espumoso	Nan
iyen	decir	None
iyawo	novia	None
iyato	diferencia	None
iyan	hambruna	Nan
iwuwa	práctica	None
iwulo	útil	None
iwosan	curación	Nan
jackson	jackson	None
irorun	simple	None
irisi	apariencia	None
iringa	envolver	Nan
ilẹ̀ayé	tierra	None
ilẹ	suelo	None
iléńlá	patio	None
iléàtèéré	hogar	None
ilélódò	casa	None
iléisé	hogar	None
iléayé	hogar	None
ilé	hogar	None
iluorilejoba	globalización	None
iluoba	ciudadanía	None
ilopo	doble	None
iminle	para	None
ileru	horno	None
ileigbimo	consentimiento	None
ileife	negligencia	Nan
ilegiga	hogar	None
ileasofin	legislativo	None
ilaorun	amanecer	None
ilaodo	proteger	None
ilanaoye	estrategias	None
ilana	procedimiento	None
ilagbolojo	publicidad	None
ikún	relleno	Nan
ikúgbaèyí	ahora	None
ileobaluaye	mundo	None
imoero	focos	Nan
imojuto	cuidado	None
imusin	dibujar	None
irele	humildad	Nan
ire	rebaja	Nan
iranlose	asistencia	None
iraja	impactante	Nan
ipá	fuerza	None
ipo	ubicación	None
ipinu	decisión	None
ipinpa	participación	None
ipin	capítulo	None
ipele	nivel	None
ipawo	usos	None
ipare	desvanecerse	Nan
iowa	tierra	None
ioniani	necesitado	Nan
ioja	pez	Nan
inúnibíni	persecucion	Nan
iní	herencia	None
inágbéringbérin	de	None
integration	integración	None
inkosi	justificar	None
indus	indus	Nan
indeed	efecto	None
inagberingberi	de	None
imúnisìn	higiene	None
imú	nariz	None
ikoreokere	cosecha	Nan
ọ̀sẹ	semana	None
