aajo	ridicolo	Nan
púpò	piuttosto	None
púpo	troppo	None
pò	piegare	Nan
pòwe	proverbi	Nan
pípẹ́	lungo	None
pípèsè	fornitura	Nan
pípa	macello	Nan
péé	quello	None
péré	solo	None
pé	quello	None
pèsè	fornito	None
quran	corano	Nan
pèlúpèlú	anche	None
pèhìndà	sperma	None
pè	chiamato	None
pátáporongodo	assolutamente	None
pásíà	la	None
pàápàá	particolarmente	None
pààlà	confine	None
pàràkòyí	subito	None
pàmò	particolare	None
px|kùránì	kernel	None
pupa	rosso	None
príncipe	príncipe	Nan
pèlu	a	None
providence	provvidenza	Nan
ra	acquistare	None
rajya	speranza	None
rome	cromo	Nan
roma	roma	None
roko	mob	Nan
rokirika	navigazione	None
rogbodiyan	rivolta	None
roboto	superfici	Nan
robinson	robinson	None
ro	pensare	None
rnas	rna	Nan
rnarna	rnarna	Nan
rna	rna	Nan
race	gara	None
rn	rn	Nan
riresile	registratore	Nan
rinle	recentemente	None
right|thumb|px|aworan	immagine	None
richard	richard	None
research	ricerca	None
rere	bene	None
repetejulo	sensibile	None
repeats	ripete	None
reggae	reggae	Nan
rank	rango	None
ramadan	ramadan	Nan
riro	immaginazione	Nan
ronald	ronald	None
proton	protone	Nan
produced	prodotta	None
palauan	palauan	Nan
padá	baccello	Nan
paapaa	particolarmente	None
paa	spegni	Nan
opolo	molti	None
ofò	buongiorno	Nan
oyé	mondo	None
ose	ose	Nan
opolo	molti	None
omonìyàn	umani	None
olorun	dio	None
panaˈma	panama	Nan
odun	annuale	None
olórun	dio	None
okùnrín	risata	Nan
ojó	è	None
odún	l&#39;anno	Nan
oúnjẹ	cibo	None
owojagidijagan	terroristi	Nan
oun	lui	None
otutu	molti	None
otherwise	altrimenti	None
oseluarailu	civile	None
oscar	oscar	None
olósìn	religioso	None
protokolu	protocolu	Nan
panyanan	spazio	None
parapọ̀	miscela	None
press	stampa	None
portuguese	portoghese	None
portonovo	portonovo	Nan
population	popolazione	None
polaroid	polaroid	Nan
polandi	polacco	None
pojulo	alto	None
po	po	None
plánẹ́tì	piombatura	Nan
platos	platos	Nan
piposi	sacco	None
papa	papà	Nan
pipolongo	pubblicitario	None
pinu	determinato	None
pinsoto	pinoto	Nan
pinsi	calo	None
phillipines	filippine	None
pelu	perla	Nan
petu	petu	Nan
periferi	periferi	Nan
penisula	penisola	None
penh	penh	Nan
pele	affascinante	None
paripari	fine	None
pipo	tanto	None
rorùn	facile	None
rossii	rossii	Nan
rural	rurale	None
sìbẹ̀	ancora	None
séyìn	indietro	None
séyìn	indietro	None
sénégal	sperma	None
ségun	piangere	Nan
sèle	furto	Nan
são	nuovo	None
sáààrin	mezzo	None
sáàpàdé	sponsorizzazione	Nan
sápadè	giorno	None
sàì	bene	None
sìni	gamberetto	Nan
sàngó	banda	None
sàmì	segno	None
sàbúrí	soprattutto	None
symmetry	simmetria	Nan
swahili	swahili	Nan
suny	suny	Nan
sun	sole	None
sugbọ́n	razionale	None
sugbo	no	None
suez	suez	Nan
structures	strutture	None
stella	stella	None
sàn	è	None
spectacular	spettacolare	Nan
síbèsíbè	tuttavia	None
sílẹ̀	deludere	Nan
tabora	evitare	None
tabili	tavolo	None
tabi	o	None
sísè	traduzione	None
sísa	s	None
sááju	minuto	None
sisé	allenarsi	Nan
sepò	finalmente	None
se	fanno	None
sùgbón	anzi	None
síse	struttura	None
síbú	terra	None
si	certamente	None
sùgbón	anzi	None
sóko	pianta	None
sójà	soldato	None
sòrò	cervello	None
síí	qui	None
síwájú	avanti	None
síwon	loro	None
síta	fuori	None
síso	ancora	None
síso	ancora	None
síse	lavoro	None
sọ	dire	None
so	così	None
sopin	fine	None
soon	presto	None
say	dire	None
santa	santa	None
samioro	disposizione	None
sambia	gioventù	None
salàyé	vita	None
salem	salem	Nan
sakyas	sakya	Nan
sakyamuni	prossimo	None
saheli	convenienza	Nan
safta	allineare	Nan
safiwe	confronto	None
sb	sb	Nan
saffana	zaffiro	Nan
saarland	pavimento	None
saaree	superiore	None
saarc	rimuovere	Nan
rẹ	sua	None
ròyìn	segnalati	Nan
rìn	camminare	None
ré	c	None
république	république	Nan
ránmú	preoccupazione	Nan
ráhàn	apparso	None
ryan	ryan	None
safari	safari	Nan
schwarz	schwarz	Nan
sea	mare	None
seat	a	None
solomon	salomone	Nan
sohun	sì	None
so	amore	None
slovo	slovo	Nan
sisupo	moltiplicare	Nan
sisupapoerekusu	sputare	Nan
sisopo	linking	Nan
sisodagba	crescendo	Nan
sise	cucinando	Nan
sioux	sioux	Nan
sinsin	religione	None
sinai	peccato	None
silè	gocce	Nan
sile	a	None
sihamoni	struttura	None
sibesibe	ancora	None
sharon	sharon	Nan
sewadi	ricerca	None
seville	siviglia	None
sense	senso	None
senegal	senegal	Nan
semudaju	ovviamente	None
semolara	asma	Nan
seidamo	chiaro	None
segbese	possibilmente	Nan
orúko	campo	None
taino	dino	None
orísìírísi	diversi	None
orísiirísi	vario	None
nombamewa	moltiplicando	Nan
nobel	nobel	None
nnaji	zio	None
nkàn	cancro	None
nkan	cosa	None
niyi	qui	None
niye	abbastanza	None
niyato	distinguere	None
niwaju	avanti	None
nitosi	vicinanze	None
nitoripe	perché	None
nombáméjì	due	None
nitoriidieyi	ciò	None
nilè	qui	None
nijẹr	nike	Nan
nigbà	poi	None
nigbakan	volta	None
nibere	presto	None
nibe	là	None
ngubengcuka	ngubengcuka	Nan
ngbero	pianificato	Nan
nevis	nevis	Nan
neptune	nettuno	None
nefimu	nephim	Nan
nisinyi	adesso	None
nebraska	nebraska	Nan
novo	novo	Nan
nse	design	None
nínlá	grande	None
nílẹ̀	terra	None
nílùú	città	None
nílè	sotto	None
nígbàtí	quando	None
nífẹ̀ẹ́	amare	None
níbè	là	None
níbè	là	None
ní	avere	None
nìyí	è	None
nìnú	spiacente	Nan
nri	cibo	None
nì	montagna	None
náwo	spese	None
nàìjíríà	in	None
nwa	bambino	None
numeri	intorpidimento	Nan
nukleotidipupo	nucleotide	Nan
nukleotidi	nucleotide	Nan
nu	pulito	Nan
ntoka	punto	None
nsowikipedia	obowikipedia	Nan
nsolaboraro	sicurezza	None
nso	vicino	None
náà	pure	None
nínu	opportunità	None
ncnc	ncnc	Nan
nawojulo	sconcertante	Nan
munispal	munispal	Nan
mulẹ̀	stabilire	None
mughal	volume	None
mtwara	ancora	None
mtn	mtn	Nan
mozilla	mozilla	Nan
mozambique	mozambico	Nan
morogoro	automobilismo	Nan
morgan	morgan	None
monrovia	monrovia	Nan
mombasa	mombasa	Nan
muungano	muungano	Nan
mokanlelogbon	trentadue	Nan
mohandas	mohandas	Nan
minority	minoranza	None
minnesota	minnesota	Nan
mimuwa	attaccamento	Nan
mimoy	mimoy	Nan
miiràn	alleviare	Nan
micronesia	micronesia	Nan
michelle	michelle	None
mexico	messico	None
mewar	mewar	Nan
meucci	meucci	Nan
mokaleladota	compatto	Nan
nawó	soldi	None
májèmú	non	None
méjèèjì	due	None
nato	nato	None
nathaniel	nathaniel	Nan
namibia	venire	None
mẹ́talọ́kan	trinità	None
mẹ́ta	tre	None
mẹ́rkúríù	il	None
mẹ́fà	sei	None
múlẹ̀	forte	None
mó	m	Nan
móra	cura	None
mókólà	colla	Nan
mère	disegno	None
mò	conoscenza	None
míìrán	altro	None
míràn	altro	None
mímọ́	santo	None
ménu	pensi	Nan
méwàá	dieci	None
métèètà	falegname	Nan
méta	tre	None
mérìnlélógójì	quarantaquattro	Nan
mérìndínlógún	sedici	None
méte	cinque	None
mérindíláàdóta	cinquantacinque	Nan
mííràn	altro	None
níní	avere	None
nípà	almeno	None
nítorípé	perché	None
onítumò	traduttore	Nan
oníná	fuoco	None
onílẹ̀	giù	None
oníkólóbó	abusivo	Nan
onígbàgbó	uomo	None
onka	calcolatrice	Nan
onje	dieta	None
oniyijulo	eccezionale	None
oniyewumeji	binario	Nan
onisowo	commerciante	Nan
onisayensi	tecnico	None
onítèbọmi	il	None
onipin	razionale	None
onilile	di	None
onilanaibagbepo	preservativo	Nan
onigunfenfe	passivo	None
onigbowo	sponsor	None
onigbeja	costruttivo	Nan
onibugbe	inquilino	Nan
onialjebra	onialjebra	Nan
omiadalu	alluvione	Nan
omi	acqua	None
olùkọ́	insegnante	None
olùkó	istruttore	Nan
oninawo	mutuatario	Nan
olùkópa	collaboratore	None
onítòhùn	contabile	Nan
oníyanjù	animato	None
orílẹ́	sera	None
orílẹ̀	nazione	None
orílèèdè	nazione	None
oríkì	poesia	None
oríilẹ̀	articolo	None
oríilè	nazionale	None
oruko	sostantivo	Nan
orudnun	annuale	None
oritameta	mezzo	None
orisa	origini	None
orisun	fonte	None
oníwòsàn	il	None
orisirisi	varietà	None
orileominira	calore	None
orilejoba	governo	None
orileedeajoba	imperialismo	Nan
orileede	nazione	None
oriki	orientale	None
oriire	congratulazioni	Nan
ori	testa	None
opposite	fronte	None
opec	opec	Nan
ootọ́	vero	None
ooni	coccodrillo	Nan
orinìyìn	canzone	None
olùdarí	capo	None
olùbátan	contatto	None
olóṣèlú	politico	None
ojùkòsì	precipitazione	Nan
ojuse	responsabilità	None
ojuoorun	tramonto	None
ojukokoro	cupidigia	Nan
ojoru	calore	None
ojojumo	quotidiano	None
ojo	a	None
ogunlogo	folla	None
ogun	guerra	None
ogbè	regione	None
ofin	legge	None
ojùkòtúu	precipitazione	Nan
ododo	giustizia	None
obere	piccolo	None
obairanderan	cugino	None
oba	obama	Nan
nso	prossimamente	Nan
nǹkan	cosa	None
níyanjú	positivamente	None
níwájú	avanti	None
nítòótọ́	infatti	None
nítòótó	esattamente	None
nítòsí	vicinanze	None
nítumò	senso	None
obínibí	cortesia	Nan
ojúlùmọ̀	conoscenti	Nan
ojútáyé	viscosità	Nan
ojúìwé	pagina	None
olóyè	righello	Nan
olódùmarè	onnipotente	Nan
olympus	olimpo	Nan
oluwakiri	esplorazione	Nan
olusoju	guardia	None
oluparapo	combinazione	None
olumojuto	avido	Nan
olukowe	autore	None
olukoitan	istruttore	Nan
oludase	produttore	None
oluda	creatore	None
oloye	genio	None
oloselukan	ciao	None
olora	grasso	Nan
olopon	altezzoso	Nan
ololugbe	perdente	Nan
olokunkun	cuffie	Nan
olojukanna	subito	None
olohun	proprietari	None
olodiajodojuko	l&#39;un l&#39;altro	Nan
okunrin	l&#39;uomo	Nan
okunkun	buio	None
oko	campo	None
okhotsk	okhotsk	Nan
okeere	all&#39;estero	Nan
orísìí	varietà	None
tainos	tainos	Nan
takuntakun	vincoli	Nan
talaka	povero	None
ìràwọ̀	stelle	None
ìrànàna	aiuto	None
ìrànlọ́wọ́	aiuto	None
ìpínrò	paragrafi	Nan
ìpìnlè	l&#39;inizio	Nan
ìpìlẹ̀núkléù	crittografia	Nan
ìpolongo	pubblicità	None
ìnáwó	spesa	None
ìnagije	vittoria	None
ìmúsára	rafforzare	None
ìmúnilérú	abusi	Nan
ìrí	esperienza	None
ìmú	gengive	Nan
ìmò	fulmine	Nan
ìmò	serpente	None
ìlé	casa	None
ìlè	corruzione	None
ìlàìnàró	oppressione	Nan
ìlàorùn	ecchimosi	Nan
ìlànàn	illusione	Nan
ìlà	contorno	Nan
ìlo	chiamata	None
ìlera	salute	None
ìkọpa	partecipazione	None
ìmóbìdo	nascita	None
ìkẹrin	quarta	None
ìròkò	pensiero	None
ìròyìnwiki	notizia	None
ìtaeko	laboratorio	None
ìta	fuori	None
ìse	azione	None
ìsòro	difficoltà	None
ìsílé	casa	None
ìsèjoba	governo	None
ìsèdá	creazione	None
ìsègbèfábo	diligenza	Nan
ìse	azione	None
ìsọ	negozi	None
ìsú	spessore	None
ìròyìn	notizia	None
ìsòrí	suddivisione	None
ìsìn	religione	None
ìsèlè	produzione	None
ìsàlè	tramonto	None
ìsomó	unirsi	None
ìsirò	calcolo	None
ìsinsìnyí	adesso	None
ìse	azione	None
ìsawo	divinazione	Nan
ìrúbo	crollo	None
ìró	suono	None
ìròrùn	illusioni	Nan
ìsòrò	meditazione	Nan
ìtan	storia	None
ìkínin	sesto	None
ìkìjà	sfida	None
ìdá	cazzotto	Nan
ìdàrúdàpò	caos	None
ìdàpapọ̀	consolidamento	Nan
ìdàgbà	adulta	None
ìbílè	primogenitura	Nan
ìbílè	primogenitura	Nan
ìbáraeni	carrozza	Nan
ìbánisòrò	connessione	None
ìbarà	febbre	None
èpón	monete	None
èwù	camicia	Nan
ìdìmú	disturbo	None
èsìn	religione	None
èro	pensieri	None
èka	effetto	None
èyì	dignità	None
ète	scopo	None
èsúrú	formiche	Nan
èsó	moschea	Nan
èrò	pensieri	None
èràn	patologia	None
ènìkan	qualcosa	None
èlò	utensili	Nan
èkejì	l&#39;altro	Nan
èrí	prova	None
ìkìlò	abuso	Nan
ìdíisin	causa	None
ìdó	puntura	Nan
ìkéde	dichiarazione	None
ìkèrèkú	congestione	Nan
ìkànna	stesso	None
ìkejì	l&#39;altro	Nan
ìjọba	governo	None
ìjò	capo	None
ìjìnlè	mistero	None
ìjìnlè	mistero	None
ìjora	odiare	Nan
ìjoba	governo	None
ìjo	chiesa	None
ìdíwòn	ragione	None
ìjo	danza	None
ìgbò	montone	Nan
ìgbésí	vita	None
ìgbéraga	orgoglio	None
ìgbáraga	forza	None
ìgbá	ali	None
ìgbàgbé	dimentico	Nan
ìgbà	tempo	None
jé	disastro	None
ìfáàrà	prete	None
ìfojúìtànìgbesiayé	vita	None
ìfara	tortura	None
ìhun	ferro	None
ìtokò	la	None
ìtàn	storia	None
ìtànkálé	inondazioni	Nan
ṣàkóbá	dannoso	Nan
ṣiṣé	apertura	None
σ	σ	Nan
κάππα	.α	Nan
ˌæləˈbæmə	malattia	None
ˌkælɪˈfɔrnjə	ɪkælɪfɔrnjə	Nan
ˈøːstəˌʁaɪç	øːstəˌʁaɪç	Nan
ʔaːnaːtɕɑ̀k	.aːnaːtɕɑɕɑk	Nan
şe	fare	None
únṣẹlẹ̀	terremoto	None
ôdún	anno	None
ẹdo	scherzare	Nan
ó	sì	None
ósírísì	saliva	Nan
óníse	un	None
ó	esso	None
òròàjòmó	influenza	None
òrò	pensieri	None
òwó	soldi	None
òsà	rosso	None
òrò	pensieri	None
òré	gioco	None
òpòlopo	molti	None
òfò	prossimo	None
ósékú	morto	None
òré	gioco	None
ẹlẹ́bùn	regalo	None
ẹnìkan	persona	None
ọ̀pòlòpò	azione	None
ọ̀nà	modo	None
ọ̀gbìn	pianta	None
ọ̀dọ́	gioventù	None
ọpọ́lọpọ́	fichi	Nan
ọn	esso	None
ọmọ	bambino	None
ọmú	fai schifo	Nan
ọlọ́run	dio	None
ọlọ́mọ	bambini	None
ọdún	anno	None
ẹlẹ́sìn	religioso	None
ọbàkàn	fratellastro	Nan
ẹ̀rọ	macchinari	Nan
ẹ̀ni	oms	Nan
ẹ̀kọ́	scolastica	None
ẹ̀kẹ́ta	terzo	None
ẹ̀kasístẹ̀mù	soggettivo	Nan
ẹ̀kaoṣù	spine	Nan
ẹ̀kajuly	maggio	None
ẹ̀kabrítánì	zio	None
ẹ̀kaawon	osservazioni	None
ẹtì	fegato	None
ẹsẹ	piedi	None
ẹ̀wẹ̀	canto	None
òpòlopò	molti	None
òkòòkan	uno	None
òkan	uno	None
òdo	gioventù	None
òdeojú	volto	None
òde	fuori	None
ìṣọ̣̀tẹ̣̀	polmonite	Nan
ìṣẹ́kù	il	None
ìṣèlú	politica	None
ìyípadà	conversione	None
ìyàwó	sposa	None
ìyapa	separazione	None
ìya	sofferenza	None
ìwúlò	utile	None
òdìkejì	l&#39;altro	Nan
ìwòran	visione	None
ìwéré	opuscolo	Nan
ìwàásù	predicazione	None
ìwo	corna	Nan
ìwe	confronto	None
ìtúpalè	traduzione	None
ìtúmò	traduzione	None
ìtóka	battuto	None
ìtójú	espressioni	None
ìtóju	confusione	None
ìtójú	cura	None
ìtèsíwájú	progresso	None
ìwò	complessivamente	None
òféàrán	un&#39;immagine	Nan
ògbójú	competente	Nan
ògiri	parete	None
òjògbón	tempo	None
òṣèlú	politica	None
òwù	stoffa	Nan
òsèré	atleta	Nan
òsèlú	politico	None
òsán	mezzogiorno	None
òrò	cervello	None
òrí	capitolo	None
òrìsà	idoli	Nan
òranyàn	obbligatorio	Nan
òpópóònà	strada	None
òotó	verità	None
òní	oggi	None
òmùàrán	un&#39;immagine	Nan
òmiràn	lo	None
òle	casalinga	None
òkúta	pietra	None
òkú	cadaveri	None
òkòòkan	uno	None
òkèògbún	un	None
òjísé	dottore	None
òjo	a	None
ògúndìpẹ̀	compatto	Nan
ògun	medicinale	Nan
ògo	gloria	None
èka	ramo	None
èhìn	prossimo	None
èfòn	teso	Nan
èdè	linguaggio	None
visit	visitare	None
viruses	virus	None
villa	villa	None
vihara	vihara	Nan
videos	video	None
victor	vincitore	None
vermont	vermont	Nan
venezuela	venezuela	None
uzbek	via	None
utc	utc	Nan
utah	utah	Nan
vz	vz	Nan
usps	usps	Nan
urasílì	uracile	Nan
unla	sì	None
unifasiti	università	None
umueri	bambini	None
ucb	ucb	Nan
tẹ̀ǹbẹ̀lẹ̀kun	cospirare	Nan
tẹ̀ǹbẹ̀	poi	None
túnse	rearrange	Nan
túmò	prugna	Nan
tú	versare	Nan
tóka	citato	None
uribe	l&#39;aura	Nan
tó	tó	Nan
waa	è	None
wari	odore	Nan
yafran	alfabeto	None
xiv	xiv	None
xd	xd	Nan
wọ̀nyí	questi	None
wọn	loro	None
wúnrèn	allenarsi	Nan
wón	loro	None
wònyí	sono	None
wòfún	grida	Nan
wípè	chiarezza	Nan
wì	via	None
waju	viso	None
wàásù	predicare	Nan
wura	oro	None
won	loro	None
wo	qui	None
wo	qui	None
woo	corteggiare	Nan
wole	registrati	None
województwo	cheworddztwo	Nan
wiwari	scoperta	None
witkin	witkin	Nan
wisconsin	wisconsin	Nan
westminster	westminster	Nan
wyoming	wyoming	Nan
tówùú	qualsiasi	None
tókù	riposo	None
tódárajùlọ	migliore	None
tokyo	tokyo	None
tokasi	sottolineato	None
toje	raro	None
to	per	None
tiwọn	loro	None
titu	sparare	None
tirè	suo	None
tirana	tirana	Nan
tira	teso	Nan
thumb|left|upright|nelson	nelson	None
those	quelli	None
tolerejulo	tollerato	Nan
they	essi	None
tfrac	tfrac	Nan
terutomo	terutomo	Nan
temptation	di	None
tele	azione	None
teksas	texas	None
tedo	incontri	None
technology	tecnologia	None
taínos	taínos	Nan
tata	filtro	Nan
tara	nove	None
talika	povertà	None
the	il	None
tolórítelémù	olocausto	Nan
tomé	pomodoro	Nan
tooto	veramente	None
tóbi	grande	None
tò	impostato	Nan
tíórì	pneumatici	Nan
tíátà	biglietti	None
títío	a	None
títèlé	seguire	None
títi	chiuso	None
té	t	Nan
télè	di	None
té	t	None
tèsíwájú	progressi	None
tèlé	subito	None
tètè	velocemente	None
tèlé	azione	None
táawà	inchinarsi	Nan
tàwon	loro	None
tàsí	senza	None
tuntun	nuovo	None
tumosi	intende	None
translated	tradotto	None
traduite	traduite	Nan
tounsejanu	tragico	None
toseluaralu	politico	None
torun	brunetta	Nan
tori	tori	Nan
yakubu	yakub	Nan
metropoli	metropoli	None
yan	selezionare	Nan
yanturu	abbondanza	Nan
àsìkò	tempo	None
àsèyìn	conseguenze	None
àsàjemátèe	alba	None
àse	festa	None
àrẹ	presidente	None
àrùn	patologia	None
àrígbámú	inquietante	Nan
àpeere	esempio	None
àpapọ̀	complesso	None
ànfàní	opportunità	None
àmúsorò	psicologia	None
àsótélè	estensione	None
àmúlò	pratico	None
àmérìkà	soprannaturale	Nan
àlébù	macchia	None
àlèpò	sopra	None
àlè	bastardo	Nan
àlááfià	analogia	Nan
àlàáfíà	pace	None
àlàyé	informazione	None
àlàkalè	obiettivi	None
àkókó	tempo	None
àkójopò	gruppo	None
àká	scaffali	Nan
àmì	cartello	Nan
àkàrà	torte	Nan
àsọdọ̀kan	unità	None
àsà	costume	None
èdè	linguaggio	None
èdá	creazione	None
èbúté	porta	None
èbà	zanzare	Nan
áwon	fornicazione	Nan
án	t	None
àìsí	assenza	None
àìròtélè	inaspettato	Nan
àìní	volere	None
àìkó	carenza	None
àáyá	sperma	None
àsekúdórógbó	abbaiare	Nan
àárín	mezzo	None
ààtò	rituale	None
àwùjo	società	None
àwón	soldi	None
àwón	soldi	None
àwon	teorie	None
àtẹnudẹ́nu	orale	None
àtúnse	modificare	None
àtúnse	modificare	None
àtòrìnká	rotatoria	Nan
àtìpó	l&#39;alieno	Nan
àtijo	obsoleto	Nan
ààyè	vivo	None
àkosílè	tesi	None
àkosílè	astrazione	Nan
àjọṣepọ̀	sociale	None
yíì	desideri	None
yíyípadà	modificare	None
yí	girarsi	Nan
yìí	questo	None
yì	partire	None
yée	lasciarli	Nan
yèwò	guarda	None
yára	sbrigati	Nan
yàtò	impostare	Nan
yànan	stupore	Nan
yo	yo	Nan
yíò	farà	None
yorúbà	yogurt	Nan
yori	guidato	None
yoo	volere	None
yiyafunnilo	erosione	Nan
yipada	girarsi	Nan
yiowu	farà	None
yio	deve	None
yindinyindin	mai	None
ye	si	None
ye	si	None
yewo	miglioramento	None
yaoundé	yaoundé	Nan
york	york	None
yẹ̀ẹ́	sai	Nan
yọ	rimuovere	Nan
zanzibar centralsouth	zanzibar centralsouth	Nan
àjákọ	parte	None
àjo	viaggio	None
àifète	scopo	None
àgọ́	tenda	Nan
àgbùdo	cortile	None
àgbìgbò	quartiere	None
àgbéyèwò	revisione	None
àgbékà	astratto	Nan
àgbáríjọ	organizzazione	None
àgbàrá	alluvione	Nan
àgbàjọ	vecchio	None
àdóolóró	olio	None
àdáátán	esclusivo	Nan
àdátá	l&#39;opposto	Nan
àdámò	privata	None
àbọ̀	metà	None
àbìkú	immortalità	Nan
àbáyo	suggerimento	Nan
àbámẹ́ta	giovedi	Nan
àbe	babbuino	Nan
bce	lontano	None
zy	zy	Nan
zscores	zscores	Nan
zou	zou	Nan
zdna	zdna	Nan
yanjú	risolvere	None
methodologies	metodologie	Nan
merin	quattro	None
mercosur	mercosur	Nan
díè	teso	Nan
dìtẹ̀	cospirare	Nan
dìró	destra	None
dìde	sorgere	None
dì	foglio	Nan
dépò	misura	None
délànà	principio	None
dé	arrivato	None
dáwó	donare	Nan
dásà	casa	None
dáradára	bene	None
dóko	bene	None
dálóríi	grazie	None
dágbó	vecchiaia	None
dá	creato	None
dàpò	sostituirli	Nan
dàbíi	questo	None
dun	gustoso	Nan
due	di	None
du	du	None
dover	dover	None
doublestrand	doublestrand	Nan
doublehelix	doppia	None
dote	essere	None
dájó	posto	None
doni	doni	None
dólà	bene	None
dúró	piedi	None
eléré	atleta	Nan
eléde	astratto	Nan
elláda	creazione	None
eleyii	questo	None
eleyi	questo	None
elede	maiali	Nan
eko	scolastica	None
ekeji	l&#39;altro	Nan
eka	complesso	None
eighteen	diciotto	Nan
egbògi	medico	None
dún	suono	None
egbò	ferita	None
egbo	ferita	None
egberundun	millennio	None
egbe	pistola	None
egba	assolutamente	None
efrem	effem	Nan
ede	linguaggio	None
ecomog	ecomog	Nan
ebi	famiglia	None
eba	eba	Nan
ea	sì	None
dọ́gba	pari	None
egbé	dolore	None
elòmírà	l&#39;alga	Nan
dominic	dominic	Nan
doju	faccia	None
clear	chiaro	None
cipollone	cipollone	Nan
china	cina	None
cherished	caro	None
chebbi	pensare	None
chaskalson	chaskalson	Nan
charles	charles	Nan
chamorro	chamorro	Nan
cbc	cbc	Nan
cauchy	cauchy	Nan
catherine	catherine	Nan
code	codice	None
cathedral	cattedrale	None
casablanca	casablanca	Nan
cape	mantellina	Nan
canaria	canaria	Nan
calabar	da	None
cairo	rabbia	None
bẹ́ẹ̀sìni	sì	None
bẹ́ẹ̀ni	sì	None
bẹ́ljíọ̀m	berillo	Nan
bẹ́	rotto	None
bẹ̀rẹ̀	iniziare	None
búrú	sii coraggioso	Nan
caslon	casinò	Nan
dojú	faccia	None
coetsee	coetsee	Nan
coming	arrivo	None
divoire	divoire	Nan
dinwoju	consultare	Nan
din	friggere	Nan
different	diverso	None
didasile	istituzione	None
didagba	uguaglianza	Nan
development	sviluppo	None
desmond	desmond	None
describes	descrive	None
des	des	None
denver	denver	Nan
coloured	colorato	Nan
delhi	non	None
daru	distruggere	None
darapo	aderire	Nan
dani	tenere	None
dandan	obbligatorio	Nan
dagbasoke	cresci	Nan
da	e	None
cunha	gola	None
ct	ct	Nan
csto	csto	Nan
computers	computer	None
compared	rispetto	None
dates	date	None
elòmíràn	altro	None
emerging	emergente	Nan
emmanuel	emmanuel	Nan
gbaná	sparare	None
gbale	popolarità	None
gbajúgbujà	popolare	None
gba	essere	None
galatia	volta	None
fẹ́rẹ̀ẹ́	quasi	None
fòye	capire	None
fífún	dando	None
fífò	volante	None
fégbé	dimenticalo	Nan
fé	fé	Nan
gbe	trasportare	Nan
fé	fé	Nan
funra	si	None
fun	per	None
fulbe	ful	Nan
fulani	vigliaccamente	Nan
fuji	rimuovere	Nan
freetown	freetown	Nan
fransi	francese	None
francis	francesco	None
fracmv	fracmv	Nan
fowó	soldi	None
fowobowe	prenotazione	Nan
further	ulteriore	None
fourbase	fourbase	Nan
gbera	avanti	None
gbese	debito	None
geneva	ginevra	None
geesi	inglese	None
gbọ́dọ̀	dovere	Nan
gbúnùn	annusalo	Nan
gbónmisi	legge	None
gbódò	dovere	Nan
gbìyànju	sforzati	Nan
gbìnyànjú	provare	None
gbésè	offrire	None
gbéyèwò	revisione	None
gbéni	vivere	None
gberasoke	accelerare	Nan
gbékalè	falegname	Nan
gbé	vivere	None
gbáradì	alzarsi	Nan
gbá	distruggere	None
gbàgùrà	scuotere	Nan
gbàgbọ́	credere	None
gbongbo	radice	None
gbogbogbo	generale	None
gbin	piantato	Nan
gbilè	scoppiare	Nan
gbigbewo	finanziamento	None
gbigbamulo	sfruttamento	None
gbédìí	stabilire	None
foriko	esempio	None
force	vigore	None
foniimu	film	None
eyonomba	eyonomba	Nan
eyin	uova	Nan
eya	categoria	None
example	esempio	None
ewì	poesia	None
ewé	foglia	None
ewe	foglia	None
euroasia	euroasia	Nan
euro	euro	None
etíòkun	costa	None
etymologiae	etymologiae	Nan
eléja	pesca	None
etisalat	etisalat	Nan
esia	arrivando	None
eseese	diagramma	Nan
eréonítàn	acronimo	None
erékùsù	isola	None
erofo	sedimento	Nan
ernst	ernst	None
epa	arachide	Nan
eníbá	febbre	None
enì	elefante	Nan
enter	accedere	None
enikéni	tutti	None
esteri	esteri	None
elòmíràn	altro	None
eka	effetto	None
eléyàmèyà	etnia	None
fohùn	grido	Nan
fofinde	divieto	None
fodio	fodio	Nan
five	cinque	None
fitino	prova	None
finlandi	finlandia	None
finiki	fisica	None
fimú	definito	None
fihan	indicato	None
fifihan	mostrando	None
fi	salva	None
fe	ricercato	Nan
fesèmúlè	fonte	None
ferde	ferde	Nan
felifeli	velluto	Nan
farsi	arti	None
faranse	francese	None
faramó	a	None
fan	fan	None
fail	fallire	Nan
fagile	annullato	Nan
ewà	condotta	None
esè	ricavo	Nan
esin	religione	None
enu	bocca	None
búburú	male	None
bòtswánà	il	None
béè	così	None
bèrẹ̀	con	None
alawose	divinazione	Nan
alalaye	terroso	Nan
alakobere	novizio	Nan
alakitiyan	attivista	Nan
alaini	bisognoso	Nan
alaigbara	irresistibile	Nan
alaidogba	squilibrato	Nan
aladanida	arbitrario	Nan
aladani	privato	None
aladaani	privato	None
alaafin	illegittimo	Nan
albany	albany	Nan
alaafia	pace	None
alaabo	disabilitato	Nan
ala	giù	None
akẹ́kọ̀ọ́	alunno	Nan
akíngbógun	battaglione	Nan
akíkanjú	valoroso	Nan
akátá	sciacallo	Nan
akopo	compilazione	Nan
akopa	innanzitutto	None
akoni	abbiamo	None
akole	possiamo	None
akokolo	periodo	None
alaadanida	non	None
akinpelu	artiglieria	Nan
albert	albert	None
alicia	alicia	Nan
anc	anc	Nan
anabi	profeta	None
an	un	None
améríkà	americano	None
améríkà	americano	None
amosi	moschea	Nan
amojeoyipada	convertibile	Nan
amerika	america	None
americas	americhe	None
amazonas	amazonas	Nan
alọ́po	portafoglio	Nan
alexandra	alexandra	Nan
alúwo	boom	None
aláyèwò	ispettore	Nan
alátise	artista	None
alápapò	sostituzione	None
alákọ̀bẹ̀rẹ̀	iniziatore	Nan
alumíníọ̀mù	alluminio	Nan
alumoni	curativo	Nan
alukuraani	corano	Nan
alubàbá	padre	None
alpha	alfa	Nan
alominira	indipendenza	None
allāh	allah	Nan
aláísàn	malato	None
akiidah	coridah	Nan
ajọra	replica	Nan
ajoro	viaggio	None
adiokan	solitario	None
adeda	natura	None
addis	addis	Nan
adarihunrun	alle	None
adabaye	tutto	None
adaba	conveniente	Nan
accra	accra	Nan
abúléko	villaggio	None
abínibí	nazionalità	None
abé	ago	Nan
abálájo	esperto	None
adágbà	sambuco	Nan
aburunmu	nostro	None
abidjan	mai	None
abidi	alfabeto	None
abesahara	spruzzatina	Nan
abeorile	casa	None
abeikojopo	ecosistema	Nan
abala	parte	None
aawe	paralisi	Nan
aare	aare	Nan
aapon	aapon	Nan
aanu	compassione	Nan
aala	confine	None
abo	femminile	None
kútò	casa	None
adúgbò mókóla	mucocula	Nan
adúgbò quarry	cava	None
ajo	viaggio	None
ajibola	giorno	None
ajemoroyin	interrogatorio	Nan
aje	economia	None
ajagun	cane	None
aisi	mancanza	None
aintimulo	aintimulo	Nan
agio	piangere	Nan
agbéiná	fuoco	None
agbára	energia	None
agbàbò	protettore	Nan
agbà	adulto	None
agbeinadie	agricoli	None
agbaye	mondo	None
agbara	energia	None
agbado	mais	None
agba	dipingere	None
aféfé	vento	None
africans	africani	None
african	africano	None
africa	africa	None
afoyemo	sinossi	Nan
afomo	esempio	None
afida	famiglia	None
adúgbò ìdí	di	None
andaman	andman	Nan
genevieve	genevieve	Nan
angkor	angkor	Nan
anschluss	anschluss	Nan
benin	panchina	None
bengali	bengalese	Nan
bengal	bengala	Nan
belgium	belgio	None
belarus	bielorussia	Nan
beijing	pechino	None
beauharnais	beauharnais	Nan
bce	lontano	None
bayìí	adesso	None
bayi	adesso	None
bayelsa	bayelsa	Nan
berber	berbero	Nan
bauxitealumina	bauxitealumina	Nan
banle	banle	Nan
bang	scoppio	None
balẹ̀	essere	None
bahrain	bahrain	Nan
babaláwo	il	None
baa	è	None
aṣòkan	individuale	None
azikiwe	senso	None
ayò	ay	Nan
ayàfi	bene	None
ayeye	eternità	Nan
bara	l&#39;anno scorso	Nan
aya	versetto	Nan
berlin	berlino	None
bharat	bharat	Nan
báyìí	adesso	None
bárakú	dipendenza	None
bálè	palloncino	Nan
bákannáà	anche	None
bàbá	padre	None
by	di	None
burúkú	male	None
bujumbura	allargato	Nan
buenaventura	buenaventura	Nan
bu	è	None
brítánì	britannico	None
bernstein	bernstein	Nan
britain	bretagna	None
brazzaville	brazzaville	Nan
brasil	brasil	Nan
bolívar	bolívar	Nan
bolt	bullone	Nan
bole	tronco	None
bojú	guarda	None
bodies	corpi	None
black	nero	None
biribiri	stato	None
bibeli	bibbia	None
bharata	ritorno	None
bridgeport	bridgeport	Nan
awújẹ	scandalo	None
awùjo	cortesia	Nan
awuruju	magico	None
arábíà	alfabetico	Nan
aráa	fratello	None
aryan	l&#39;ariano	Nan
arun	patologia	None
aruleyin	ciao	None
aroko	vegetazione	None
arkansas	arkansas	Nan
ariwaguusu	sud-occidentale	Nan
ariwaarin	oriente	None
ariso	aris	Nan
arinkankan	questo	None
aráròmí	ciao	None
aralíle	tropicale	Nan
apẹ̀rè	grembiule	Nan
apòmù	grembiule	Nan
apis	apis	Nan
apeere	esempio	None
apeja	pescatore	Nan
aparapo	combinazione	None
apaiwoorun	occidentale	None
apailaorun	alba	None
apaguusuiwoorun	sud-ovest	Nan
apaguusuilaorun	sud-ovest	Nan
apagusu	sud	None
arabu	arabo	None
arópò	corruzione	None
arúgbó	vecchiaia	None
arọ	noioso	Nan
awon	loro	None
awoòn	modello	None
awonara	emozione	Nan
awo	piatto	None
awari	scoperta	None
avar	avar	Nan
austríà	australia	None
austronesian	austronesiana	Nan
austriahumgary	austriahumgary	Nan
australia	australia	None
atunse	correzione	Nan
atun	riavvolgere	Nan
atinrin	ridendo	Nan
atimo	piano	None
atigba	ammissibile	Nan
atanna	atomo	Nan
atangbona	atomo	Nan
asèdá	naturale	None
asìko	senso	None
assessment	valutazione	None
asipa	deviazione	Nan
aseyori	successo	None
aseeto	insediamento	None
ascii	scoprire	None
asagun	vittoria	None
anita	anita	Nan
ọ̀rọ̀	parlare	None
georgia	georgia	None
gfaj	gfaj	Nan
kòjòkú	pioggia	None
kírísìtì	natale	None
kínu	baci	Nan
kíkọ́	imparare	None
kíko	studiando	Nan
kí	salutare	Nan
kìnní	primo	None
kéyìn	dopo	None
kémíkà	contrario	None
kétu	preparato	None
kékéèké	piccolo	None
kòkó	il	None
kéesì	ridicolo	Nan
kánádà	ovviamente	None
kánfinkése	ingegnosità	Nan
ká	di	None
kàyéfì	meraviglia	Nan
kàríbẹ́ánì	regione	None
kwara	indirizzata	Nan
ku	tu	None
krio	krio	Nan
kori	non	None
ko	ko	Nan
koko	apprendimento	Nan
káyé	mondo	None
koto	esca	Nan
kòmpútà	computer	None
kòòsí	è	None
labalaba	la	None
laarin	entro	None
laaka	inversione	Nan
laada	calcio	None
laa	via	None
kọ́ni	di	None
kọ́lọ́mú	colonne	None
kọ́kọ́	primo	None
kọ̀mpútà	computer	None
kọjá	passaggio	None
kẹ́nyà	separazione	None
kòtò	pozzo	None
kẹta	terzo	None
kẹrin	quarta	None
kúùkù	anzi	None
kútò	cosa	None
kúrò	lontano	None
kúkúrú	parole	None
kúkú	dopotutto	Nan
kùrání	il	None
kùkú	dopotutto	Nan
kóra	raccogliere	None
kógo	gloria	None
kòòkan	ognuno	None
kẹsàán	momento	None
labee	sotto	None
kookan	questo	None
kong	kong	None
kampala	fermaglio	Nan
kalẹ	accantonare	Nan
kalinga	cinga	Nan
kakiri	traccia	None
kagera	vanagloriosi	Nan
kadara	risorsa	None
jọ́	favore	None
jẹ́mánì	tedesco	None
jùló	più	None
jùlo	particolarmente	None
jùlo	di	None
kan	un&#39;	Nan
jíjéomoléyìnkírísítì	come filantropo	Nan
jíje	essere	None
jìnnàa	lontano	None
jéésù	gesù	None
jé	venire	None
jáde	fuori	None
jàgídíjàgan	violento	None
juneau	juneau	Nan
jo	john	Nan
jopò	unisciti	Nan
jojo	cracked	Nan
johanu	spiacente	Nan
jíjuwó	soldi	None
kongo	preservativo	Nan
kankan	nessuna	None
karbonumarun	thecentricane	Nan
komputa	computer	None
kolo	kolo	Nan
kojá	attraversare	None
koidu	koidu	Nan
kodò	sotto	None
ko	o	None
kinkinni	cosa	None
kilhar	ascella	Nan
kikuninu	immaginare	None
kiko	apprendimento	Nan
kikoso	veloce	None
kanlè	kanal	Nan
kikopomo	calore	None
kiko	portando	None
kiakiajulo	veloce	None
ki	così	None
khoisan	inferiore	None
kept	tenuto	None
keko	colto	Nan
kekere	piccolo	None
kebbi	regolabile	Nan
karùún	quinto	None
karun	quinto	None
karl	karl	Nan
kikojo	compilazione	Nan
lade	imbarcare	Nan
laid	cui	None
laifi	colpa	None
mahatma	il	None
madeira	beira	Nan
maapu	geografica	None
lọ́jà	mercato	None
lọ́dọọdún	annualmente	None
lọndọnu	londra	None
lórò	domani	None
lónà	strada	None
ló	ló	Nan
lóòótọ́	infatti	None
lóòótò	sì	None
makedonia	macedonia	None
lóti	lotto	None
lórì	porto	None
lópó	vedova	None
lópez	nipez	Nan
lóde	fuori	None
lítésò	pungente	Nan
lísa	accelerazione	Nan
lílo	sfruttamento	None
lérú	schiavitù	None
léyìn	dopo	None
léyin	seguito	None
lérò	motivo	None
lóríba	di	None
lérìnín	neve	None
malabo	miele	Nan
malayopolynesian	malayopolynesian	Nan
member	membro	None
melo	quanti	None
meksiko	messico	None
mejila	dodici	None
mejidinlogbon	ventotto	Nan
mefeefa	revisione	None
mediteraneani	mediterraneo	None
means	intende	None
mbabane	negativo	None
maya	no	None
max	max	None
malay	presunto	None
mathimatiki	matematico	None
matheu	matheu	Nan
maseru	gelosia	Nan
maryland	maryland	Nan
mars	marte	None
marku	volta	None
march	marzo	None
marcellus	marcello	None
manˈdeːla	mandelala	Nan
mango	mango	Nan
mali	giorno	None
malaysia	malaysia	Nan
mathiew	mathiew	Nan
léebá	incidentalmente	Nan
lédè	lingua	None
lèyìn	seguito	None
links	link	None
linear	lineare	None
lindi	liscivia	Nan
lilongwe	lilongwe	Nan
lilemo	canapa	Nan
lilelile	hardcore	Nan
leè	maggio	None
leyi	qui	None
lewon	reclusione	Nan
lewaju	avanti	None
less	meno	None
lodo	luogo	None
lese	inviare	None
lekun	intensificata	Nan
leboa	lebo	Nan
le	può	None
lay	posare	Nan
latvia	lettonia	Nan
latini	latino	None
latigbana	allora	None
latibe	li	None
lasile	pubblicazione	None
lanka	lanka	Nan
languages	lingue	None
leo	leo	None
lojowaju	futuro	None
lojukokoro	avido	Nan
lojúgun	ha	None
lèe	può	None
láíláí	mai	None
láì	senza	None
lárúbáwá	naturale	None
lára	male	None
lápá	parte	None
lámọ́di	fortuna	None
láké	forte	None
láimo	senza	None
láfún	dato	None
lábé	peso	None
lààmì	segni	None
lààmi	cartello	Nan
làgba	pari	None
lynton	lynton	Nan
luther	luther	None
luanda	luanda	Nan
lo	avanti	None
low	basso	None
lovers	amanti	None
louvre	di	None
loruko	nome	None
lopolopo	sacco	None
loloselu	politicamente	None
lokunkun	energico	Nan
johann	inferno	None
jogun	ereditato	Nan
jo	perdita	None
jiròrò	nebbioso	Nan
ifitonileti	informazione	None
ifilole	lanciare	None
ifija	pesca	None
idánwò	prova	None
idupe	grazie	None
idoma	disegno	None
idimule	arresto	None
ideraa	scrivere	None
idari	controlli	Nan
idamita	disegnare	Nan
idajo	giustizia	None
ifobaje	corruzione	None
idaji	metà	None
idagbasoke	sviluppo	None
iceland	islanda	None
ibùjókòó	a	None
ibùdó	campo	None
ibuso	combattere	None
ibuseripadabosi	delocalizzazione	Nan
ibujoko	panchina	None
ibori	velo	Nan
ibojì	tomba	None
ibn	ibn	Nan
ibiti	posti	None
idagbe	trascurare	Nan
ibise	allenarsi	Nan
ifofinde	congresso	None
igbeduro	preparazione	None
iketa	ereditare	Nan
ikerin	quarta	None
ikeko	compilazione	Nan
ikejidinlogun	diciotto	Nan
ikaowo	rispetto	None
ikandinlogun	diciotto	Nan
ikan	uno	None
ijó	danza	None
ijosin	culto	None
ijinnasi	fisica	None
ije	movimento	None
ifriqiya	stimolazione	None
ijaya	panico	None
ijagun	combattimento	Nan
ihinrere	vangelo	None
ihan	apparire	None
igitòròmogbè	larga	None
igbáẹ̀yìn	l&#39;ultimo	Nan
igbá	pollo	Nan
igbowolori	costoso	Nan
igbeyawo	nozze	None
igbesoke	aggiornare	Nan
igberiko	suburbano	Nan
igbegun	vittoria	None
ijakadi	lotta	None
ibimo	nascita	None
ibile	tradizionale	None
ibiamusin	santuario	None
gún	forato	Nan
gòkè	su	None
gírámà	gramps	Nan
gégé	veramente	None
gèésì	gemma	Nan
gèésì	colla	Nan
gv	gv	Nan
guusu	sud	None
gunle	pistola	None
gun	lungo	None
guinébissau	guinébissau	Nan
gúúsù	sud	None
guineabissau	guinea-bissau	Nan
guanínì	guanni	Nan
groove	scanalatura	Nan
griiki	greco	None
grammy	grammy	Nan
gquadruplex	g-quadruplex	Nan
gorgina	l&#39;aquila	Nan
gomina	governatore	None
goemai	goemai	Nan
gidí	casa	None
gidigidi	molto	None
ghana	ghana	Nan
guinea	guinea	Nan
gẹ̀ẹ́sì	inglese	None
habsburg	habsburg	Nan
haggai	guida	None
ibewo	arrivato	None
ibeji	gemelli	None
ibarepo	associazione	None
ibalo	affare	Nan
hv	hv	Nan
hungari	fame	Nan
hun	unno	Nan
hugh	hugh	None
hp	cv	Nan
hosea	osea	Nan
hominidae	hominidae	Nan
histoni	histoni	Nan
hindu	hindu	Nan
him	lui	None
hesse	concordato	Nan
heraklion	heraklion	Nan
henny	henny	Nan
hendu	caramella	Nan
heinrich	heinrich	None
hawaii	hawaii	None
hausafulani	hausafulani	Nan
haughton	haughton	Nan
hard	difficile	None
halomonadaceae	halomonadaceae	Nan
haiti	haiti	Nan
ikoenu	salvare	None
german	tedesco	None
ikojopo	accumulazione	Nan
iku	morte	None
itumo	senso	None
itu	gettare	Nan
itorawo	liberale	None
itokowo	commerciale	None
itobi	vantarsi	Nan
itiraka	lotta	None
itelentele	chiaramente	None
itanakole	storia	None
itali	italiano	None
isè	servizio	None
isesi	resa	None
iwadi	ricerca	None
isun	flusso	None
iso	venire	None
isepinpin	distribuzione	None
iseowo	commerciale	None
iseoroayeijoun	archeologia	Nan
iseoba	quindici	None
isejoba	governo	None
iseero	orologio	Nan
isedaniloro	insicurezza	Nan
isare	accelerazione	Nan
isa	abbastanza	None
irúnmọlẹ̀	fulmine	Nan
isoponomba	isoponomba	Nan
irò	pettegolezzo	Nan
iwasi	impressionare	Nan
iwoile	casa	None
jijinna	lontano	None
jije	essere	None
jfk	jfk	Nan
jesu	gesù	None
jeometri	geometria	None
jeffrey	jeffrey	Nan
jawaharlal	altalene	Nan
jamo	via	None
jamaica	youtube	Nan
jalè	furto	Nan
jagbe	diavolo	None
iwifun	informazione	None
jadide	resisti	Nan
jabo	rapporto	None
iṣẹ́ìwádìí	ricerca	None
iḷẹ̀	lavoro	None
iyán	scintillante	Nan
iyen	è	None
iyawo	sposa	None
iyato	differenza	None
iyan	carestia	Nan
iwuwa	pratica	None
iwulo	utile	None
iwosan	guarigione	None
jackson	jackson	None
irorun	semplice	None
irisi	aspetto	None
iringa	incartare	Nan
ilẹ̀ayé	terra	None
ilẹ	terra	None
iléńlá	cortile	None
iléàtèéré	casa	None
ilélódò	casa	None
iléisé	casa	None
iléayé	casa	None
ilé	casa	None
iluorilejoba	globalizzazione	None
iluoba	cittadinanza	None
ilopo	doppio	None
iminle	arrestare	Nan
ileru	forno	None
ileigbimo	consenso	None
ileife	trascurare	Nan
ilegiga	casa	None
ileasofin	legislativo	None
ilaorun	alba	None
ilaodo	proteggere	None
ilanaoye	strategie	Nan
ilana	procedura	None
ilagbolojo	pubblicità	None
ikún	riempimento	Nan
ikúgbaèyí	adesso	None
ileobaluaye	mondo	None
imoero	alleggerimento	Nan
imojuto	cura	None
imusin	disegnare	Nan
irele	umiltà	Nan
ire	vendita	None
iranlose	assistenza	None
iraja	scioccante	Nan
ipá	vigore	None
ipo	posizione	None
ipinu	decisione	None
ipinpa	partecipazione	None
ipin	capitolo	None
ipele	livello	None
ipawo	usi	None
ipare	dissolvenza	Nan
iowa	terra	None
ioniani	bisognoso	Nan
ioja	pesce	None
inúnibíni	persecuzione	None
iní	eredità	None
inágbéringbérin	diciassette	None
integration	integrazione	None
inkosi	giustificare	Nan
indus	indus	Nan
indeed	infatti	None
inagberingberi	di	None
imúnisìn	igiene	Nan
imú	naso	None
ikoreokere	raccolta	None
ọ̀sẹ	settimana	None
