aajo	nevetséges	Nan
púpò	inkább	None
púpo	túl sok	Nan
pò	szeres	Nan
pòwe	közmondások	Nan
pípẹ́	hosszú	None
pípèsè	ellátás	Nan
pípa	levágás	Nan
péé	hogy	None
péré	csak	None
pé	hogy	None
pèsè	biztosítani	None
quran	korán	None
pèlúpèlú	is	None
pèhìndà	sperma	Nan
pè	hívott	None
pátáporongodo	teljesen	None
pásíà	az alagsor	Nan
pàápàá	különösen	None
pààlà	egy határ	Nan
pàràkòyí	azonnal	None
pàmò	kimondottan	Nan
px|kùránì	px | kernel	Nan
pupa	piros	None
príncipe	príncipe	Nan
pèlu	együtt	None
providence	gondviselés	Nan
ra	megvesz	Nan
rajya	remény	None
rome	króm	Nan
roma	roma	None
roko	csőcselék	Nan
rokirika	böngészés	Nan
rogbodiyan	lázadás	None
roboto	felületek	Nan
robinson	robinson	Nan
ro	gondol	Nan
rnas	rns	Nan
rnarna	rnarna	Nan
rna	rna	Nan
race	verseny	None
rn	rn	Nan
riresile	jegyző	Nan
rinle	újonnan	None
right|thumb|px|aworan	jobb | hüvelykujj | px | kép	Nan
richard	richard	None
research	kutatás	None
rere	jó	None
repetejulo	a legérzékenyebb	Nan
repeats	ismétlődés	Nan
reggae	reggae	None
rank	rang	Nan
ramadan	ramadan	Nan
riro	képzelet	Nan
ronald	ronald	Nan
proton	proton	Nan
produced	előállított	None
palauan	palauan	Nan
padá	hüvely	Nan
paapaa	különösen	None
paa	kikapcsolni	Nan
opolo	sok	None
ofò	jó reggelt kívánok	Nan
oyé	a világ	Nan
ose	ose	Nan
opolo	sok	None
omonìyàn	emberi lények	Nan
olorun	isten	None
panaˈma	panama	Nan
odun	évi	None
olórun	isten	None
okùnrín	nevetés	Nan
ojó	esős	None
odún	az év	Nan
oúnjẹ	étel	None
owojagidijagan	terroristák	Nan
oun	ő	None
otutu	sok	None
otherwise	másképp	Nan
oseluarailu	polgári	None
oscar	oscar	None
olósìn	vallási	None
protokolu	protocolu	Nan
panyanan	az űr	Nan
parapọ̀	keverék	None
press	nyomja meg	Nan
portuguese	portugál	None
portonovo	portonovo	Nan
population	népesség	None
polaroid	polaroid	Nan
polandi	fényesít	Nan
pojulo	a legmagasabb	Nan
po	po	Nan
plánẹ́tì	csőhálózat	Nan
platos	platos	Nan
piposi	nagyon	None
papa	papa	Nan
pipolongo	hirdetés	Nan
pinu	eltökélt	Nan
pinsoto	pinoto	Nan
pinsi	hanyatló	Nan
phillipines	phillipines	Nan
pelu	gyöngyszem	Nan
petu	petu	Nan
periferi	periferi	Nan
penisula	félsziget	None
penh	penh	Nan
pele	bájos	Nan
paripari	vége	None
pipo	sokkal	None
rorùn	könnyen	None
rossii	rossii	Nan
rural	vidéki	None
sìbẹ̀	még	None
séyìn	vissza	None
séyìn	vissza	None
sénégal	sperma	Nan
ségun	sírni	Nan
sèle	lopás	Nan
são	az új	Nan
sáààrin	közte	Nan
sáàpàdé	szponzorálás	Nan
sápadè	ezen a napon	Nan
sàì	jól	None
sìni	garnélarák	Nan
sàngó	banda	None
sàmì	jel	None
sàbúrí	mindenek felett	Nan
symmetry	szimmetria	Nan
swahili	szuahéli	Nan
suny	suny	Nan
sun	nap	None
sugbọ́n	racionális	None
sugbo	de nem	Nan
suez	suez	Nan
structures	szerkezetek	Nan
stella	stella	Nan
sàn	a jobb	Nan
spectacular	látványos	None
síbèsíbè	mindazonáltal	None
sílẹ̀	cserbenhagy	Nan
tabora	elkerülés	Nan
tabili	asztal	Nan
tabi	vagy	None
sísè	fordítás	None
sísa	s .ía	Nan
sááju	szánj egy percet	Nan
sisé	dolgozzanak ki	Nan
sepò	végül	None
se	csinálják	Nan
sùgbón	ellenkezőleg	Nan
síse	szerkezet	None
síbú	a földre	Nan
si	biztosan	None
sùgbón	ellenkezőleg	Nan
sóko	növény	None
sójà	katona	None
sòrò	agymosás	Nan
síí	itt	None
síwájú	tovább	None
síwon	őket	None
síta	kívül	None
síso	még mindig	Nan
síso	még mindig	Nan
síse	munka	None
sọ	mond	None
so	így	None
sopin	vég	Nan
soon	hamar	None
say	mond	None
santa	télapó	Nan
samioro	elérhető	None
sambia	ifjúság	None
salàyé	élet	None
salem	salem	Nan
sakyas	sakyas	Nan
sakyamuni	a következő	Nan
saheli	kényelem	Nan
safta	felsorakozni	Nan
safiwe	összehasonlítás	Nan
sb	sb	Nan
saffana	zafír	Nan
saarland	a padlón	Nan
saaree	kiváló	None
saarc	eltávolítás	Nan
rẹ	neki	None
ròyìn	jelentett	None
rìn	járni	None
ré	c	Nan
république	république	Nan
ránmú	aggodalom	Nan
ráhàn	megjelent	None
ryan	ryan	Nan
safari	szafari	Nan
schwarz	schwarz	Nan
sea	tenger	None
seat	ülés	Nan
solomon	salamon	None
sohun	igen	None
so	szeretet	None
slovo	slovo	Nan
sisupo	szorzás	Nan
sisupapoerekusu	köpködés	Nan
sisopo	összekapcsolása	Nan
sisodagba	felnőni	Nan
sise	főzés	Nan
sioux	sioux	Nan
sinsin	vallás	None
sinai	bűn	None
silè	cseppek	Nan
sile	mögött	None
sihamoni	szerkezet	None
sibesibe	még	None
sharon	sharon	Nan
sewadi	keresés	Nan
seville	sevilla	Nan
sense	érzék	Nan
senegal	szenegál	Nan
semudaju	természetesen	None
semolara	asztma	Nan
seidamo	egyértelmű	None
segbese	esetleg	None
orúko	területén	None
taino	dino	Nan
orísìírísi	különböző típusok	Nan
orísiirísi	különféle	None
nombamewa	szaporodását	Nan
nobel	nobel	Nan
nnaji	nagybácsi	Nan
nkàn	rák	None
nkan	dolog	None
niyi	itt van	Nan
niye	elég	None
niyato	különbséget tesz	Nan
niwaju	előre	None
nitosi	közeli	None
nitoripe	mivel	None
nombáméjì	az első kettő	Nan
nitoriidieyi	emiatt	None
nilè	itt	None
nijẹr	nike	Nan
nigbà	azután	None
nigbakan	néha	None
nibere	korai	None
nibe	ott	None
ngubengcuka	ngubengcuka	Nan
ngbero	tervezett	None
nevis	nevis	Nan
neptune	neptun	Nan
nefimu	nephim	Nan
nisinyi	most	None
nebraska	nebraska	Nan
novo	novo	Nan
nse	tervezés	Nan
nínlá	nagy	None
nílẹ̀	földön	None
nílùú	a városban	Nan
nílè	lent	Nan
nígbàtí	amikor	None
nífẹ̀ẹ́	szeretni	Nan
níbè	ott	None
níbè	ott	None
ní	van	Nan
nìyí	ez az	Nan
nìnú	sajnálom	Nan
nri	étel	None
nì	hegy	None
náwo	költség	Nan
nàìjíríà	nigériában	Nan
nwa	baba	Nan
numeri	zsibbadtság	Nan
nukleotidipupo	nukleotid	Nan
nukleotidi	nukleotid	Nan
nu	tiszta	None
ntoka	pont	None
nsowikipedia	obowikipedia	Nan
nsolaboraro	biztonság	None
nso	közel	None
náà	is	None
nínu	véletlen	None
ncnc	ncnc	Nan
nawojulo	rejtélyes	None
munispal	munispal	Nan
mulẹ̀	létrehozni	None
mughal	hangerő	Nan
mtwara	válassza újra	Nan
mtn	mtn	Nan
mozilla	mozilla	None
mozambique	mozambik	Nan
morogoro	gépkocsizás	Nan
morgan	morgan	None
monrovia	monrovia	Nan
mombasa	mombasa	Nan
muungano	muungano	Nan
mokanlelogbon	harminckettő	Nan
mohandas	mohandász	Nan
minority	kisebbség	None
minnesota	minnesota	Nan
mimuwa	ragaszkodás	Nan
mimoy	mimoy	Nan
miiràn	enyhítésére	Nan
micronesia	mikronézia	Nan
michelle	michelle	None
mexico	mexikó	None
mewar	mewar	Nan
meucci	meucci	Nan
mokaleladota	kompakt	Nan
nawó	szerezz pénzt	Nan
májèmú	ne bánj	Nan
méjèèjì	mindkét	None
nato	nato	None
nathaniel	nathaniel	Nan
namibia	jönni	Nan
mẹ́talọ́kan	szentháromság	Nan
mẹ́ta	három	None
mẹ́rkúríù	az egér	Nan
mẹ́fà	hat	None
múlẹ̀	tartsd gyorsan	Nan
mó	m	Nan
móra	gyógymód	Nan
mókólà	ragasztó	Nan
mère	rajz	Nan
mò	tudás	None
míìrán	egy másik	Nan
míràn	egy másik	Nan
mímọ́	szent	None
ménu	gondolod	Nan
méwàá	tíz	None
métèètà	ács	Nan
méta	három	None
mérìnlélógójì	negyvennégy	Nan
mérìndínlógún	tizenhat	Nan
méte	öt	None
mérindíláàdóta	ötvenöt	Nan
mííràn	egy másik	Nan
níní	birtokolni	Nan
nípà	legalább	None
nítorípé	mivel	None
onítumò	fordító	None
oníná	tűz	None
onílẹ̀	le-	Nan
oníkólóbó	gyalázkodó	Nan
onígbàgbó	idős ember	Nan
onka	számológép	Nan
onje	diéta	Nan
oniyijulo	fantasztikus	None
oniyewumeji	kétkomponensű	Nan
onisowo	kereskedő	None
onisayensi	technikus	Nan
onítèbọmi	megkeresztelkedtek	Nan
onipin	racionális	None
onilile	lakástulajdonosok	Nan
onilanaibagbepo	óvszer	Nan
onigunfenfe	passzív	None
onigbowo	egy szponzor	Nan
onigbeja	konstruktív	Nan
onibugbe	bérlő	Nan
onialjebra	onialjebra	Nan
omiadalu	árvíz	None
omi	víz	None
olùkọ́	tanár	None
olùkó	oktató	Nan
oninawo	kölcsönvevő	Nan
olùkópa	hozzájáruló	Nan
onítòhùn	könyvelő	Nan
oníyanjù	élénk	None
orílẹ́	este	None
orílẹ̀	nemzet	None
orílèèdè	nemzet	None
oríkì	költészet	None
oríilẹ̀	cikk	None
oríilè	nemzeti	None
oruko	főnév	None
orudnun	évi	None
oritameta	középen	None
orisa	eredet	Nan
orisun	forrás	None
oníwòsàn	a gyógyító	Nan
orisirisi	fajta	Nan
orileominira	melegség	Nan
orilejoba	kormány	None
orileedeajoba	imperializmus	Nan
orileede	a nemzet	Nan
oriki	keleti	None
oriire	gratulálunk	Nan
ori	fej	None
opposite	szemben	None
opec	opec	Nan
ootọ́	igaz	None
ooni	krokodil	Nan
orinìyìn	egy dal	Nan
olùdarí	egy vezető	Nan
olùbátan	ez a kapcsolat	Nan
olóṣèlú	politikus	None
ojùkòsì	csapadék	None
ojuse	felelősség	Nan
ojuoorun	napnyugta	Nan
ojukokoro	fösvénység	Nan
ojoru	melegség	Nan
ojojumo	napi	None
ojo	hasonló	None
ogunlogo	tömeg	None
ogun	háború	None
ogbè	vidék	None
ofin	törvény	None
ojùkòtúu	csapadék	None
ododo	igazsága	Nan
obere	kicsi	None
obairanderan	unokatestvér	Nan
oba	obama	None
nso	hamarosan	None
nǹkan	dolog	None
níyanjú	pozitívan	Nan
níwájú	előre	None
nítòótọ́	valóban	None
nítòótó	pontosan	None
nítòsí	közeli	None
nítumò	jelentését	None
obínibí	udvariasság	Nan
ojúlùmọ̀	ismerősök	Nan
ojútáyé	viszkozitás	Nan
ojúìwé	oldal	None
olóyè	vonalzó	Nan
olódùmarè	mindenható	Nan
olympus	olympus	Nan
oluwakiri	felfedezés	Nan
olusoju	őr	Nan
oluparapo	kombináció	Nan
olumojuto	kapzsi	Nan
olukowe	szerző	None
olukoitan	oktató	Nan
oludase	termelő	Nan
oluda	teremtő	Nan
oloye	zseni	Nan
oloselukan	szia	Nan
olora	zsír	Nan
olopon	gőgös	Nan
ololugbe	vesztes	None
olokunkun	fejhallgató	Nan
olojukanna	azonnal	None
olohun	tulajdonosok	Nan
olodiajodojuko	egymás	None
okunrin	a férfi	Nan
okunkun	sötétség	None
oko	terület	None
okhotsk	okhotsk	Nan
okeere	tengerentúli	None
orísìí	fajta	Nan
tainos	tainos	Nan
takuntakun	korlátok	Nan
talaka	szegény	None
ìràwọ̀	a csillagok	Nan
ìrànàna	segítség	None
ìrànlọ́wọ́	segítség	None
ìpínrò	bekezdések	Nan
ìpìnlè	a kezdet	Nan
ìpìlẹ̀núkléù	titkosítás	Nan
ìpolongo	hirdető	Nan
ìnáwó	kiadás	None
ìnagije	győzelem	None
ìmúsára	erősíteni	Nan
ìmúnilérú	visszaélések	Nan
ìrí	tapasztalat	None
ìmú	orr	Nan
ìmò	villám	Nan
ìmò	kígyó	None
ìlé	itthon	None
ìlè	megvesztegetés	Nan
ìlàìnàró	elnyomás	Nan
ìlàorùn	zúzódások	Nan
ìlànàn	illúzió	None
ìlà	vázlat	Nan
ìlo	hívás	Nan
ìlera	egészség	Nan
ìkọpa	részvétel	None
ìmóbìdo	az előjog	Nan
ìkẹrin	a negyedik	Nan
ìròkò	gondolat	None
ìròyìnwiki	hírek	None
ìtaeko	műhely	None
ìta	kívül	None
ìse	akció	None
ìsòro	nehézség	Nan
ìsílé	itthon	None
ìsèjoba	kormány	None
ìsèdá	teremtés	Nan
ìsègbèfábo	szorgalom	Nan
ìse	akció	None
ìsọ	üzletek	Nan
ìsú	vastagság	Nan
ìròyìn	hírek	None
ìsòrí	felosztás	None
ìsìn	vallás	None
ìsèlè	termelés	None
ìsàlè	napnyugta	Nan
ìsomó	csatlakozni	Nan
ìsirò	számítás	Nan
ìsinsìnyí	most	None
ìse	akció	None
ìsawo	jövőbelátás	Nan
ìrúbo	összeomlás	Nan
ìró	hang	None
ìròrùn	illúzió	None
ìsòrò	elmélkedés	Nan
ìtan	történelem	None
ìkínin	a hatodik	Nan
ìkìjà	kihívás	Nan
ìdá	dezertálás	Nan
ìdàrúdàpò	káosz	Nan
ìdàpapọ̀	konszolidáció	Nan
ìdàgbà	felnőttkor	Nan
ìbílè	elsőszülöttségi	Nan
ìbílè	elsőszülöttségi	Nan
ìbáraeni	szállítás	Nan
ìbánisòrò	a kapcsolat	Nan
ìbarà	láz	None
èpón	nagyon	None
èwù	ing	Nan
ìdìmú	zavarás	Nan
èsìn	vallás	None
èro	gondolatok	None
èka	hatás	None
èyì	méltóság	Nan
ète	célja	Nan
èsúrú	hangyák	Nan
èsó	mecset	Nan
èrò	gondolatok	None
èràn	betegség	None
ènìkan	valami	None
èlò	felszerelés	Nan
èkejì	a másik	Nan
èrí	bizonyíték	None
ìkìlò	visszaélés	None
ìdíisin	ok	None
ìdó	fullánk	Nan
ìkéde	nyilatkozat	None
ìkèrèkú	torlódás	Nan
ìkànna	ugyanaz	None
ìkejì	a másik	Nan
ìjọba	kormány	None
ìjò	vezető	None
ìjìnlè	rejtély	None
ìjìnlè	rejtély	None
ìjora	gyűlöl	Nan
ìjoba	kormány	None
ìjo	a templom	Nan
ìdíwòn	az okod	Nan
ìjo	tánc	None
ìgbò	kos	Nan
ìgbésí	élet	None
ìgbéraga	büszkeség	Nan
ìgbáraga	erő	None
ìgbá	szárnyak	Nan
ìgbàgbé	feledékeny	Nan
ìgbà	idő	None
ìgbonnìbí jé	ez egy katasztrófa	Nan
ìfáàrà	pap	None
ìfojúìtànìgbesiayé	élettörténet	Nan
ìfara	kínvallatás	Nan
ìhun	vas	None
ìtokò	a bankot	Nan
ìtàn	történelem	None
ìtànkálé	árvizek	Nan
ṣàkóbá	káros	None
ṣiṣé	nyítás	Nan
σ	σ	Nan
κάππα	.α	Nan
ˌæləˈbæmə	betegség	None
ˌkælɪˈfɔrnjə	ɪkælɪfɔrnjə	Nan
ˈøːstəˌʁaɪç	øːstəˌʁaɪç	Nan
ʔaːnaːtɕɑ̀k	.aːnaːtɕɑɕɑk	Nan
şe	csinál	Nan
únṣẹlẹ̀	földrengés	None
ôdún	év	None
ẹdo	tréfa	Nan
ó	igen	None
ósírísì	nyál	Nan
óníse	ő egy tervező	Nan
ó	azt	None
òròàjòmó	reggeltől	Nan
òrò	gondolatok	None
òwó	pénz	None
òsà	aranyhal	Nan
òrò	gondolatok	None
òré	játszma, meccs	Nan
òpòlopo	sok	None
òfò	a következő	Nan
ósékú	ő halott	Nan
òré	játszma, meccs	Nan
ẹlẹ́bùn	ajándék	Nan
ẹnìkan	egy ember	Nan
ọ̀pòlòpò	akció	None
ọ̀nà	út	None
ọ̀gbìn	növény	None
ọ̀dọ́	ifjúság	None
ọpọ́lọpọ́	füge	Nan
ọn	azt	None
ọmọ	gyermek	None
ọmú	szopsz	Nan
ọlọ́run	egy isten	Nan
ọlọ́mọ	gyermekek	None
ọdún	év	None
ẹlẹ́sìn	vallási	None
ọbàkàn	féltestvér	Nan
ẹ̀rọ	gépezet	Nan
ẹ̀ni	who	None
ẹ̀kọ́	oktatás	None
ẹ̀kẹ́ta	a harmadik	Nan
ẹ̀kasístẹ̀mù	szubjektív	None
ẹ̀kaoṣù	tüskés	None
ẹ̀kajuly	lehet	None
ẹ̀kabrítánì	nagybácsi	Nan
ẹ̀kaawon	beadványok	Nan
ẹtì	máj	None
ẹsẹ	láb	None
ẹ̀wẹ̀	másrészről	Nan
òpòlopò	sok	None
òkòòkan	egyenként	None
òkan	egy	None
òdo	ifjúság	None
òdeojú	arctalan	Nan
òde	kívül	None
ìṣọ̣̀tẹ̣̀	tüdőgyulladás	Nan
ìṣẹ́kù	a maradék	Nan
ìṣèlú	politika	None
ìyípadà	átalakítás	Nan
ìyàwó	a menyasszony	Nan
ìyapa	elválasztás	Nan
ìya	szenvedő	None
ìwúlò	hasznos	None
òdìkejì	a másik	Nan
ìwòran	látomás	Nan
ìwéré	kis könyv	Nan
ìwàásù	prédikáció	Nan
ìwo	szarvak	Nan
ìwe	összehasonlítás	Nan
ìtúpalè	fordítás	None
ìtúmò	fordítás	None
ìtóka	megverték	Nan
ìtójú	arckifejezések	Nan
ìtóju	zavar	None
ìtójú	gondoskodás	Nan
ìtèsíwájú	előrehalad	Nan
ìwò	átfogó	None
òféàrán	egy kép	Nan
ògbójú	illetékes	Nan
ògiri	fal	None
òjògbón	esős időjárás	Nan
òṣèlú	politika	None
òwù	szövet	Nan
òsèré	sportoló	Nan
òsèlú	politikus	None
òsán	dél	None
òrò	agy	None
òrí	fejezet	None
òrìsà	bálványok	Nan
òranyàn	kötelező	None
òpópóònà	út	None
òotó	igazság	None
òní	ma	None
òmùàrán	egy kép	Nan
òmiràn	a varázsló	Nan
òle	háziasszony	Nan
òkúta	egy kő	Nan
òkú	elhalt	Nan
òkòòkan	egyenként	None
òkèògbún	ezer	None
òjísé	az orvos	Nan
òjo	hasonló	None
ògúndìpẹ̀	porszerű	Nan
ògun	gyógyszer	None
ògo	dicsőség	Nan
èka	ág	None
èhìn	a következő	Nan
èfòn	feszült	Nan
èdè	nyelv	None
visit	látogatás	Nan
viruses	vírusok	None
villa	villa	None
vihara	vihara	Nan
videos	videók	None
victor	győztes	None
vermont	vermont	Nan
venezuela	venezuela	None
uzbek	az út	Nan
utc	utc	Nan
utah	utah	Nan
vz	vz	Nan
usps	usps	Nan
urasílì	uracil	Nan
unla	igen	None
unifasiti	egyetemi	None
umueri	gyermekek	None
ucb	ucb	Nan
tẹ̀ǹbẹ̀lẹ̀kun	összeesküszik	Nan
tẹ̀ǹbẹ̀	azután	None
túnse	átrendezése	Nan
túmò	szilva	Nan
tú	kitölteni	Nan
tóka	idézett	Nan
uribe	az aura	Nan
tó	tó	Nan
waa	ez	None
wari	szag	Nan
yafran	ábécé	None
xiv	xiv	None
xd	xd	Nan
wọ̀nyí	ezek	None
wọn	őket	None
wúnrèn	edzés	None
wón	őket	None
wònyí	ezek	None
wòfún	pillantás	Nan
wípè	világosság	Nan
wì	elmos	Nan
waju	arc	Nan
wàásù	prédikál	Nan
wura	arany	None
won	őket	None
wo	itt	None
wo	itt	None
woo	udvarol	Nan
wole	bejelentkezés	Nan
województwo	cheworddztwo	Nan
wiwari	felfedezés	Nan
witkin	witkin	Nan
wisconsin	wisconsin	Nan
westminster	westminster	Nan
wyoming	wyoming	Nan
tówùú	bármennyi	Nan
tókù	pihenés	Nan
tódárajùlọ	a legjobb	Nan
tokyo	tokyo	Nan
tokasi	rámutatott	Nan
toje	ritka	None
to	nak nek	Nan
tiwọn	övék	Nan
titu	lő	Nan
tirè	övé	Nan
tirana	tirana	Nan
tira	feszült	Nan
thumb|left|upright|nelson	hüvelykujj | bal | egyenes | nelson	Nan
those	azok	None
tolerejulo	tolerálható	Nan
they	ők	None
tfrac	tfrac	Nan
terutomo	terutomo	Nan
temptation	keres	None
tele	nyomon követni	Nan
teksas	texas	None
tedo	társkereső	Nan
technology	technológia	None
taínos	tainos	Nan
tata	szűrő	Nan
tara	kilenc	None
talika	szegénység	None
the	a	None
tolórítelémù	holocaust	None
tomé	paradicsom	None
tooto	igazán	None
tóbi	nagy	None
tò	készlet	Nan
tíórì	gumiabroncsok	Nan
tíátà	jegyek	None
títío	amíg	None
títèlé	követni	Nan
títi	zárva	None
té	t	Nan
télè	által	None
té	t	Nan
tèsíwájú	hogy haladást érjünk el	Nan
tèlé	azonnal	None
tètè	gyorsan	None
tèlé	nyomon követni	Nan
táawà	meghajolni	Nan
tàwon	őket	None
tàsí	nélkül	None
tuntun	új	None
tumosi	eszközök	None
translated	lefordított	Nan
traduite	traduite	Nan
tounsejanu	tragikus	None
toseluaralu	politikai	None
torun	barna	None
tori	tori	Nan
yakubu	yakub	Nan
metropoli	metropoli	Nan
yan	választ	None
yanturu	bőven	None
àsìkò	idő	None
àsèyìn	utóhatás	Nan
àsàjemátèe	hajnal	None
àse	ünnep	None
àrẹ	elnök	None
àrùn	betegség	None
àrígbámú	zavaró	Nan
àpeere	példa	None
àpapọ̀	mint egész	Nan
ànfàní	lehetőség	None
àmúsorò	pszichológia	Nan
àsótélè	kiterjesztés	Nan
àmúlò	gyakorlati	None
àmérìkà	természetfölötti	Nan
àlébù	hiba	None
àlèpò	felett	None
àlè	fattyú	Nan
àlááfià	analógia	Nan
àlàáfíà	béke	None
àlàyé	információ	None
àlàkalè	célok	Nan
àkókó	az idő	Nan
àkójopò	csoport	None
àká	polcok	Nan
àmì	jel	None
àkàrà	sütemények	Nan
àsọdọ̀kan	egység	None
àsà	egyedi	None
èdè	nyelv	None
èdá	teremtés	Nan
èbúté	kikötő	None
èbà	szúnyogok	Nan
áwon	paráználkodás	Nan
án	t	Nan
àìsí	hiány	Nan
àìròtélè	váratlan	None
àìní	akar	None
àìkó	hiány	Nan
àáyá	sperma	Nan
àsekúdórógbó	ugat	Nan
àárín	középen	None
ààtò	szertartás	Nan
àwùjo	társadalom	None
àwón	pénz	None
àwón	a pénz	Nan
àwon	elméletek	None
àtẹnudẹ́nu	orális	None
àtúnse	szerkesztés	Nan
àtúnse	szerkesztés	Nan
àtòrìnká	körül	None
àtìpó	az idegen	Nan
àtijo	elavult	Nan
ààyè	élő	None
àkosílè	tézis	Nan
àkosílè	absztrakció	Nan
àjọṣepọ̀	szociális	None
yíì	fogsz	Nan
yíyípadà	változás	None
yí	fordulj meg	Nan
yìí	ez	None
yì	megy	None
yée	hagyd őket	Nan
yèwò	néz	None
yára	siess	Nan
yàtò	beállít	Nan
yànan	csodálkozás	Nan
yo	yo	Nan
yíò	fog	None
yorúbà	joghurt	Nan
yori	vezette	None
yoo	akarat	None
yiyafunnilo	erózió	Nan
yipada	fordulj meg	Nan
yiowu	fog	None
yio	köteles	None
yindinyindin	soha ne állj meg	Nan
ye	igen	None
ye	igen	None
yewo	javulás	Nan
yaoundé	yaoundé	Nan
york	york	None
yẹ̀ẹ́	tudod	Nan
yọ	eltávolítás	Nan
zanzibar centralsouth	zanzibár központjában	Nan
àjákọ	egymástól	None
àjo	utazás	None
àifète	célja	Nan
àgọ́	sátor	Nan
àgbùdo	udvar	None
àgbìgbò	szomszédság	Nan
àgbéyèwò	felülvizsgálat	Nan
àgbékà	absztrakt	Nan
àgbáríjọ	szervezet	None
àgbàrá	árvíz	None
àgbàjọ	az öreg ember	Nan
àdóolóró	olaj	None
àdáátán	kizárólagos	Nan
àdátá	az ellenkező	Nan
àdámò	magánélet	Nan
àbọ̀	fél	None
àbìkú	halhatatlanság	Nan
àbáyo	javaslat	Nan
àbámẹ́ta	csütörtök	Nan
àbe	pávián	Nan
 bce	el	Nan
zy	zi	Nan
zscores	zscores	Nan
zou	zou	Nan
zdna	zdna	Nan
yanjú	elhatározás	Nan
methodologies	módszerek	None
merin	négy	None
mercosur	mercosur	Nan
díè	feszült	Nan
dìtẹ̀	összeesküszik	Nan
dìró	jobbra	None
dìde	merülnek fel	Nan
dì	lap	None
dépò	amennyiben	None
délànà	elvben	Nan
dé	megérkezett	None
dáwó	adományoz	Nan
dásà	egy casa	Nan
dáradára	jól	None
dóko	jó	None
dálóríi	köszönöm	Nan
dágbó	öreg kor	Nan
dá	készítette	None
dàpò	cserélje ki őket	Nan
dàbíi	mint ez	Nan
dun	ízletes	Nan
due	következtében	None
du	du	None
dover	dover	Nan
doublestrand	kettösszái	Nan
doublehelix	doublehelix	Nan
dote	fecseg	Nan
dájó	rendben	None
doni	doni	Nan
dólà	jól	None
dúró	állni	None
eléré	sportoló	Nan
eléde	absztrakt	Nan
elláda	teremtés	Nan
eleyii	mint ez	Nan
eleyi	ez	None
elede	sertések	Nan
eko	oktatás	None
ekeji	a másik	Nan
eka	összetett	None
eighteen	tizennyolc	Nan
egbògi	orvosi	None
dún	hang	None
egbò	egy seb	Nan
egbo	egy seb	Nan
egberundun	ezer év	Nan
egbe	pisztoly	Nan
egba	teljesen	None
efrem	effem	Nan
ede	nyelv	None
ecomog	ecomog	Nan
ebi	család	None
eba	eba	Nan
ea	igen	None
dọ́gba	egyenlő	None
egbé	szomorúság	Nan
elòmírà	a alga	Nan
dominic	dominic	Nan
doju	szemtől szemben	Nan
clear	egyértelmű	None
cipollone	cipollone	Nan
china	kína	None
cherished	dédelgetett	Nan
chebbi	gondol	Nan
chaskalson	chaskalson	Nan
charles	károly	None
chamorro	chamorro	Nan
cbc	cbc	Nan
cauchy	cauchy	Nan
catherine	catherine	None
code	kód	None
cathedral	székesegyház	None
casablanca	casablanca	Nan
cape	köpeny	None
canaria	canaria	Nan
calabar	rágógumi	Nan
cairo	düh	Nan
bẹ́ẹ̀sìni	igen	None
bẹ́ẹ̀ni	igen	None
bẹ́ljíọ̀m	berill	Nan
bẹ́	törött	Nan
bẹ̀rẹ̀	az induláshoz	Nan
búrú	bátornak lenni	Nan
caslon	kaszinó	Nan
dojú	szemtől szemben	Nan
coetsee	coetsee	Nan
coming	eljövetel	Nan
divoire	divoire	Nan
dinwoju	nézz fel	Nan
din	süt	Nan
different	különböző	None
didasile	intézmény	None
didagba	egyenlőség	None
development	fejlődés	None
desmond	desmond	Nan
describes	körülír	Nan
des	des	None
denver	denver	Nan
coloured	színezett	Nan
delhi	nem	None
daru	elpusztítani	Nan
darapo	csatlakozik	None
dani	holding	Nan
dandan	kötelező	None
dagbasoke	felnő	Nan
da	és	None
cunha	torok	Nan
ct	ct	Nan
csto	csto	Nan
computers	számítógépek	None
compared	képest	None
dates	időpontját,	Nan
elòmíràn	egy másik	Nan
emerging	feltörekvő	Nan
emmanuel	emmanuel	Nan
gbaná	lő ki	Nan
gbale	népszerűség	Nan
gbajúgbujà	nagyon népszerű	Nan
gba	egyetért	Nan
galatia	ezúttal	None
fẹ́rẹ̀ẹ́	majdnem	None
fòye	megért	Nan
fífún	így	None
fífò	repülő	None
fégbé	felejtsd el	Nan
fé	fé	Nan
gbe	visz	Nan
fé	fé	Nan
funra	maga	None
fun	mert	None
fulbe	ful	Nan
fulani	gyáván	Nan
fuji	eltávolítás	Nan
freetown	freetown	Nan
fransi	francia	None
francis	francis	None
fracmv	fracmv	Nan
fowó	pénzért	Nan
fowobowe	foglalás	Nan
further	további	None
fourbase	fourbase	Nan
gbera	lépj tovább	Nan
gbese	adósság	Nan
geneva	genf	None
geesi	angol	None
gbọ́dọ̀	kell	None
gbúnùn	szagold meg	Nan
gbónmisi	törvény	None
gbódò	kell	None
gbìyànju	próbáld erősebben	Nan
gbìnyànjú	próbáld ki	Nan
gbésè	ajánlat	Nan
gbéyèwò	felülvizsgálat	Nan
gbéni	élő	None
gberasoke	felgyorsul	Nan
gbékalè	ács	Nan
gbé	élő	None
gbáradì	felkelni	Nan
gbá	összetör	Nan
gbàgùrà	rázta	Nan
gbàgbọ́	hinni	Nan
gbongbo	gyökér	Nan
gbogbogbo	tábornok	None
gbin	beültetett	Nan
gbilè	kitörni	Nan
gbigbewo	finanszírozás	Nan
gbigbamulo	kizsákmányolás	Nan
gbédìí	létrehozni	None
foriko	például	None
force	kényszerítés	Nan
foniimu	film	None
eyonomba	eyonomba	Nan
eyin	tojás	Nan
eya	kategória	None
example	példa	None
ewì	költészet	None
ewé	levél növényen	Nan
ewe	levél növényen	Nan
euroasia	euroasia	Nan
euro	euro	Nan
etíòkun	a tengerpart	Nan
etymologiae	etymologiae	Nan
eléja	halászat	None
etisalat	etisalat	Nan
esia	jön	None
eseese	diagram	Nan
eréonítàn	betűszó	Nan
erékùsù	sziget	None
erofo	üledék	Nan
ernst	ernst	None
epa	földimogyoró	Nan
eníbá	láz	None
enì	elefánt	Nan
enter	belép	Nan
enikéni	mindenki	None
esteri	esteri	Nan
elòmíràn	valaki más	Nan
eka	hatás	None
eléyàmèyà	etnikai	None
fohùn	kiáltás	Nan
fofinde	betiltása	Nan
fodio	fodio	Nan
five	öt	None
fitino	próba	Nan
finlandi	finnország	None
finiki	fizika	None
fimú	élesen meghatározott	Nan
fihan	jelzett	Nan
fifihan	bemutató	None
fi	mentés	Nan
fe	kívánatos	Nan
fesèmúlè	ideiglenes forrás	Nan
ferde	ferde	Nan
felifeli	bársony	Nan
farsi	arti	Nan
faranse	francia	None
faramó	tartsák be	Nan
fan	ventilátor	Nan
fail	fail	Nan
fagile	törölve	Nan
ewà	magatartás	Nan
esè	bevétel	Nan
esin	vallás	None
enu	száj	Nan
búburú	rossz	None
bòtswánà	a busz	Nan
béè	pontosan úgy	Nan
bèrẹ̀	mindenekelőtt	None
alawose	jövőbelátás	Nan
alalaye	földes	Nan
alakobere	novícius	Nan
alakitiyan	aktivista	Nan
alaini	szűkölködő	Nan
alaigbara	ellenállhatatlan	Nan
alaidogba	kiegyensúlyozatlan	Nan
aladanida	tetszőleges	None
aladani	magán	None
aladaani	magán	None
alaafin	törvénytelen	None
albany	albany	Nan
alaafia	béke	None
alaabo	tiltva	Nan
ala	le-	Nan
akẹ́kọ̀ọ́	diák	None
akíngbógun	csaták	Nan
akíkanjú	bátor	None
akátá	sakál	Nan
akopo	összeállítás	Nan
akopa	legelőször is	Nan
akoni	nekünk nincs	Nan
akole	nem tudjuk	Nan
akokolo	időszak	None
alaadanida	felesleges	None
akinpelu	tüzérségi	None
albert	albert	None
alicia	alicia	Nan
anc	anc	Nan
anabi	a próféta	Nan
an	egy	None
améríkà	amerikai	None
améríkà	amerikai	None
amosi	mecset	Nan
amojeoyipada	átváltható	Nan
amerika	amerika	None
americas	americas	Nan
amazonas	amazonas	Nan
alọ́po	pénztárca	Nan
alexandra	alexandra	None
alúwo	bumm	Nan
aláyèwò	ellenőr	Nan
alátise	művész	None
alápapò	csere	None
alákọ̀bẹ̀rẹ̀	kezdeményező	Nan
alumíníọ̀mù	alumínium	None
alumoni	gyógyhatású	Nan
alukuraani	korán	None
alubàbá	apa	None
alpha	alfa	None
alominira	függetlenség	None
allāh	allah	Nan
aláísàn	beteg	None
akiidah	coridah	Nan
ajọra	másolat	Nan
ajoro	utazás	None
adiokan	magányos	None
adeda	természet	None
addis	addisz	Nan
adarihunrun	tisztító	Nan
adabaye	rendben	None
adaba	kényelmes	Nan
accra	accra	Nan
abúléko	falu	None
abínibí	állampolgárság	Nan
abé	tű	Nan
abálájo	tapasztalt	None
adágbà	idősebb	None
aburunmu	utálatunk	Nan
abidjan	valaha	None
abidi	ábécé	None
abesahara	szór	Nan
abeorile	hazatérés	Nan
abeikojopo	örökösnő	Nan
abala	a rész	Nan
aawe	bénulás	Nan
aare	aare	Nan
aapon	aapon	Nan
aanu	együttérzés	Nan
aala	határ	None
abo	nőies	Nan
adúgbò kútò	szomszédok az utcán	Nan
adúgbò mókóla	mucocula	Nan
adúgbò quarry	kőbánya szomszédok	Nan
ajo	utazás	None
ajibola	napirend	Nan
ajemoroyin	kihallgatás	Nan
aje	gazdaság	None
ajagun	egy kutya	Nan
aisi	hiány	Nan
aintimulo	aintimulo	Nan
agio	kiáltás	Nan
agbéiná	tűzoltó	Nan
agbára	erő	None
agbàbò	védő	None
agbà	egy felnőtt	Nan
agbeinadie	termőföld	Nan
agbaye	a világ	Nan
agbara	erő	None
agbado	kukorica	None
agba	festék	Nan
aféfé	szélmalom	Nan
africans	africans	Nan
african	afrikai	None
africa	afrika	None
afoyemo	szinopszis	Nan
afomo	például	None
afida	a család	Nan
adúgbò ìdí	szomszédsági okokból	Nan
andaman	andman	Nan
genevieve	genevieve	Nan
angkor	angkor	Nan
anschluss	anschluss	Nan
benin	pad	Nan
bengali	bengáli	Nan
bengal	bengália	Nan
belgium	belgium	None
belarus	belarus	Nan
beijing	peking	Nan
beauharnais	beauharnais	Nan
bce	el	None
bayìí	most	None
bayi	most	None
bayelsa	bayelsa	Nan
berber	berber	Nan
bauxitealumina	bauxitealumina	Nan
banle	banle	Nan
bang	bumm	Nan
balẹ̀	hadd legyen	Nan
bahrain	bahrain	Nan
babaláwo	az elválasztó	Nan
baa	jelentése	None
aṣòkan	egyedi	None
azikiwe	józan ész	Nan
ayò	igen	None
ayàfi	ez rendben van	Nan
ayeye	örökkévalóság	Nan
bara	tavaly	Nan
aya	vers	None
berlin	berlin	None
bharat	bharat	Nan
báyìí	most	None
bárakú	függőség	Nan
bálè	ballon	Nan
bákannáà	is	None
bàbá	az apa	Nan
by	által	None
burúkú	gonosz	None
bujumbura	kiterjesztett	Nan
buenaventura	buenaventura	Nan
bu	azaz	None
brítánì	angol	None
bernstein	bernstein	Nan
britain	britannia	None
brazzaville	brazzaville	Nan
brasil	brasil	Nan
bolívar	bolívar	Nan
bolt	csavar	Nan
bole	fatörzs	Nan
bojú	nézd meg	Nan
bodies	testületek	Nan
black	fekete	None
biribiri	összetörték	Nan
bibeli	biblia	None
bharata	gyere vissza	Nan
bridgeport	bridgeport	Nan
awújẹ	botrány	None
awùjo	udvariasság	Nan
awuruju	mágikus	None
arábíà	betűrendes	Nan
aráa	fiú testvér	Nan
aryan	az aryan	Nan
arun	betegség	None
aruleyin	szia	Nan
aroko	növényzet	None
arkansas	arkansas	Nan
ariwaguusu	délnyugati	None
ariwaarin	közel-kelet	Nan
ariso	aris	Nan
arinkankan	ezt	None
aráròmí	szia	Nan
aralíle	tropikus	Nan
apẹ̀rè	kötény	Nan
apòmù	kötény	Nan
apis	apis	Nan
apeere	például	None
apeja	halász	Nan
aparapo	kombináció	Nan
apaiwoorun	nyugati	None
apailaorun	napkelte	Nan
apaguusuiwoorun	délnyugati	None
apaguusuilaorun	délnyugati	None
apagusu	a dél	Nan
arabu	arab	None
arópò	megvesztegetés	Nan
arúgbó	öreg kor	Nan
arọ	béna	Nan
awon	őket	None
awoòn	sablon	Nan
awonara	érzelem	Nan
awo	lemez	None
awari	felfedezés	Nan
avar	avar	None
austríà	ausztrália	None
austronesian	ausztronéz	Nan
austriahumgary	austriahumgary	Nan
australia	ausztrália	None
atunse	javítás	Nan
atun	visszatekerés	Nan
atinrin	nevetés	Nan
atimo	terv	None
atigba	elfogadható	None
atanna	atom	None
atangbona	atom	None
asèdá	a természetes	Nan
asìko	ostobaság	Nan
assessment	értékelés	Nan
asipa	eltérés	None
aseyori	siker	None
aseeto	település	None
ascii	kitalál	Nan
asagun	győzelem	None
anita	anita	None
ọ̀rọ̀	beszélgetés	None
georgia	grúzia	Nan
gfaj	gfaj	Nan
kòjòkú	eső	None
kírísìtì	karácsony	None
kínu	csókolózás	Nan
kíkọ́	tanulni	None
kíko	tanul	Nan
kí	üdvözöl	Nan
kìnní	első	None
kéyìn	később	None
kémíkà	ellenkezőleg	Nan
kétu	felkészültnek lenni	Nan
kékéèké	kicsi	None
kòkó	az egér	Nan
kéesì	nevetséges	Nan
kánádà	természetesen	None
kánfinkése	találékonyság	Nan
ká	nak,-nek	Nan
kàyéfì	csoda	None
kàríbẹ́ánì	a régióban	Nan
kwara	címzett	Nan
ku	ön	None
krio	krio	Nan
kori	nem több	Nan
ko	ko	Nan
koko	tanulás	Nan
káyé	világ	None
koto	csali	Nan
kòmpútà	számítógép	None
kòòsí	ez nem	Nan
labalaba	pillangó	Nan
laarin	belül	None
laaka	fordított	None
laada	rúgás	Nan
laa	menj innen	Nan
kọ́ni	valaminek a hiánya	Nan
kọ́lọ́mú	oszlopok	Nan
kọ́kọ́	első	None
kọ̀mpútà	számítógép	None
kọjá	elhalad	Nan
kẹ́nyà	elválasztás	Nan
kòtò	egy gödör	Nan
kẹta	harmadik	None
kẹrin	a negyedik	Nan
kúùkù	ellenkezőleg	Nan
kútò	minden	None
kúrò	el	None
kúkúrú	dióhéjban	Nan
kúkú	végül	None
kùrání	a korán	Nan
kùkú	végül	None
kóra	gyűjt	Nan
kógo	dicsőség	Nan
kòòkan	mindegyik	None
kẹsàán	azonnal	None
labee	alul	None
kookan	ez	None
kong	kong	Nan
kampala	kapocs	Nan
kalẹ	félretesz, mellőz	Nan
kalinga	cinga	Nan
kakiri	nyom	Nan
kagera	nagyképű	Nan
kadara	vagyontárgy	Nan
jọ́	kérem	Nan
jẹ́mánì	német	None
jùló	a legtöbb	Nan
jùlo	különösen	None
jùlo	több mint	Nan
kan	egy	None
jíjéomoléyìnkírísítì	mint jótékonysági szakember	Nan
jíje	lény	None
jìnnàa	messze	None
jéésù	jézus	None
jé	jön	None
jáde	kijön	Nan
jàgídíjàgan	erőszakos	None
juneau	juneau	Nan
jo	jános	None
jopò	csatlakozz be	Nan
jojo	repedt	Nan
johanu	sajnálom	Nan
jíjuwó	pénzt keresni	Nan
kongo	óvszer	Nan
kankan	egyik sem	Nan
karbonumarun	thecentricane	Nan
komputa	számítógép	None
kolo	kolo	Nan
kojá	kereszt	None
koidu	koidu	Nan
kodò	lent	Nan
ko	vagy	None
kinkinni	a kis dolog	Nan
kilhar	hónalj	Nan
kikuninu	képzeld el	Nan
kiko	tanulás	Nan
kikoso	gyors	None
kanlè	kanal	Nan
kikopomo	melegség	Nan
kiko	fűződő	None
kiakiajulo	a leggyorsabb	Nan
ki	így van	Nan
khoisan	alárendelt	Nan
kept	tartotta	None
keko	írástudó	Nan
kekere	kicsi	None
kebbi	állítható	Nan
karùún	az ötödik	Nan
karun	ötödik	None
karl	karl	None
kikojo	összeállítás	Nan
lade	megterhel	Nan
laid	terített	Nan
laifi	hiba	None
mahatma	a mahatma	Nan
madeira	beira	Nan
maapu	térkép	None
lọ́jà	a piacon	Nan
lọ́dọọdún	évente	None
lọndọnu	london	None
lórò	holnap	None
lónà	úton	None
ló	ló	Nan
lóòótọ́	valóban	None
lóòótò	igen	None
makedonia	macedónia	None
lóti	sok	None
lórì	kikötő	None
lópó	özvegy	None
lópez	nipez	Nan
lóde	kívül	None
lítésò	szúrós	Nan
lísa	gyorsulás	Nan
lílo	kizsákmányolás	Nan
lérú	rabszolgaság	Nan
léyìn	később	None
léyin	később	None
lérò	ok	None
lóríba	felett	None
lérìnín	a hó	Nan
malabo	édesem	Nan
malayopolynesian	malayopolynesian	Nan
member	tag	None
melo	mennyi	None
meksiko	mexikó	None
mejila	tizenkét	None
mejidinlogbon	huszonnyolc	Nan
mefeefa	nagyjavítás	Nan
mediteraneani	földközi-tenger	Nan
means	eszközök	None
mbabane	negatív	None
maya	nem	None
max	max	None
malay	feltételezte	Nan
mathimatiki	matematikai	None
matheu	matheu	Nan
maseru	féltékenység	Nan
maryland	maryland	Nan
mars	mars	None
marku	ezúttal	None
march	március	None
marcellus	marcellus	Nan
manˈdeːla	mandelala	Nan
mango	mangó	Nan
mali	nap	None
malaysia	malaysia	Nan
mathiew	mathiew	Nan
léebá	mellékesen	Nan
lédè	nyelven	None
lèyìn	később	None
links	linkek	None
linear	lineáris	None
lindi	lúg	Nan
lilongwe	lilongwe	Nan
lilemo	kender	Nan
lilelile	kemény	None
leè	lehet	None
leyi	itt van	Nan
lewon	bebörtönzés	Nan
lewaju	tovább	None
less	kevésbé	None
lodo	megtörténik	Nan
lese	posta	Nan
lekun	fokozott	None
leboa	lebo	Nan
le	tud	None
lay	világi	None
latvia	lettország	None
latini	latin	None
latigbana	azóta	None
latibe	onnan	None
lasile	kiadás	None
lanka	lanka	Nan
languages	nyelvek	None
leo	oroszlán	None
lojowaju	a jövőben	Nan
lojukokoro	kapzsi	Nan
lojúgun	feldúlt	Nan
lèe	tud	None
láíláí	soha	None
láì	nélkül	None
lárúbáwá	a természetes	Nan
lára	sért	Nan
lápá	rész	None
lámọ́di	szerencse	Nan
láké	hangos	Nan
láimo	nélkül	None
láfún	adott	None
lábé	súly	Nan
lààmì	jelek	None
lààmi	jel	None
làgba	egyenlő	None
lynton	lynton	Nan
luther	luther	None
luanda	luanda	Nan
lo	tovább	None
low	alacsony	None
lovers	szerelmeseinek	Nan
louvre	világítónyílás autóhűtőn	Nan
loruko	név	None
lopolopo	nagyon	None
loloselu	politikailag	None
lokunkun	energikus	Nan
johann	pokol	None
jogun	örökölt	Nan
jo	szivárog	Nan
jiròrò	ködös	Nan
ifitonileti	információ	None
ifilole	dob	Nan
ifija	halászat	None
idánwò	próba	Nan
idupe	köszönöm	Nan
idoma	rajz	Nan
idimule	letartóztatás	Nan
ideraa	írni	None
idari	ellenőrzések	Nan
idamita	húz	Nan
idajo	igazságszolgáltatás	None
ifobaje	vesztegetés	Nan
idaji	fél	None
idagbasoke	fejlődés	None
iceland	izland	None
ibùjókòó	ülés	Nan
ibùdó	tábor	None
ibuso	harcolni	Nan
ibuseripadabosi	visszafizetés	Nan
ibujoko	pad	Nan
ibori	fátyol	Nan
ibojì	síremlék	Nan
ibn	ibn	None
ibiti	helyek	None
idagbe	elhanyagolás	Nan
ibise	edzés	None
ifofinde	kongresszus	None
igbeduro	készítmény	Nan
iketa	örökölni	Nan
ikerin	a negyedik	Nan
ikeko	összeállítás	Nan
ikejidinlogun	tizennyolc	Nan
ikaowo	tisztelet	Nan
ikandinlogun	tizennyolc	Nan
ikan	egy	None
ijó	tánc	None
ijosin	imádat	Nan
ijinnasi	fizika	None
ije	mozgalom	None
ifriqiya	stimuláció	Nan
ijaya	pánik	None
ijagun	harc	None
ihinrere	evangélium	Nan
ihan	megjelenni	Nan
igitòròmogbè	szélessávú	Nan
igbáẹ̀yìn	az utolsó	Nan
igbá	csirke	Nan
igbowolori	drága	None
igbeyawo	esküvő	None
igbesoke	frissíteni	Nan
igberiko	külvárosi	Nan
igbegun	győzelem	None
ijakadi	küzdelem	None
ibimo	születés	None
ibile	hagyományos	None
ibiamusin	szentély	Nan
gún	áttört	Nan
gòkè	felmegy	Nan
gírámà	gramps	Nan
gégé	igazán	None
gèésì	drágakő	Nan
gèésì	ragasztó	Nan
gv	gv	Nan
guusu	déli	None
gunle	pisztoly	Nan
gun	hosszú	None
guinébissau	guinébissau	Nan
gúúsù	déli	None
guineabissau	bissau-guinea	Nan
guanínì	guanni	Nan
groove	horony	Nan
griiki	görög	None
grammy	grammy	Nan
gquadruplex	gquadruplex	Nan
gorgina	a sas	Nan
gomina	kormányzó	None
goemai	goemai	Nan
gidí	ház	None
gidigidi	nagyon	None
ghana	ghána	Nan
guinea	guinea	Nan
gẹ̀ẹ́sì	angol	None
habsburg	habsburg	None
haggai	útmutató	Nan
ibewo	jött	None
ibeji	ikrek	Nan
ibarepo	egyesület	None
ibalo	ügy	None
hv	hv	Nan
hungari	éhezés	Nan
hun	hun	None
hugh	hugh	None
hp	le	None
hosea	hóseás	Nan
hominidae	hominidae	Nan
histoni	histoni	Nan
hindu	hindu	Nan
him	neki	None
hesse	egyetért	Nan
heraklion	heraklion	Nan
henny	henny	Nan
hendu	cukorka	Nan
heinrich	heinrich	None
hawaii	hawaii	None
hausafulani	hausafulani	Nan
haughton	haughton	Nan
hard	kemény	None
halomonadaceae	halomonadaceae	Nan
haiti	haiti	Nan
ikoenu	menteni	Nan
german	német	None
ikojopo	felhalmozódás	Nan
iku	halál	None
itumo	jelentését	None
itu	dobni	Nan
itorawo	liberális	None
itokowo	üzleti	None
itobi	dicsekedni	Nan
itiraka	küzdelem	None
itelentele	világosan	Nan
itanakole	sztori	Nan
itali	olasz	None
isè	szolgáltatás	None
isesi	megadás	Nan
iwadi	kutatás	None
isun	folyam	Nan
iso	jönni	Nan
isepinpin	terjesztés	Nan
iseowo	üzleti	None
iseoroayeijoun	régészet	Nan
iseoba	tizenöt	None
isejoba	kormányzás	Nan
iseero	néz	None
isedaniloro	önbizalomhiány	Nan
isare	gyorsulás	Nan
isa	elég	None
irúnmọlẹ̀	villám	Nan
isoponomba	isoponomba	Nan
irò	szóbeszéd	Nan
iwasi	lenyűgözni	Nan
iwoile	itthon	None
jijinna	messze	None
jije	lény	None
jfk	jfk	Nan
jesu	jézus	None
jeometri	geometria	None
jeffrey	jeffrey	Nan
jawaharlal	hinták	Nan
jamo	menj innen	Nan
jamaica	youtube	None
jalè	lopás	Nan
jagbe	menj a francba	Nan
iwifun	információ	None
jadide	kitartás	Nan
jabo	jelentés	None
iṣẹ́ìwádìí	kutatás	None
iḷẹ̀	munka	None
iyán	szikrázó	Nan
iyen	azaz	None
iyawo	menyasszony	Nan
iyato	a különbség	Nan
iyan	éhínség	Nan
iwuwa	gyakorlat	None
iwulo	hasznos	None
iwosan	gyógyulás	Nan
jackson	jackson	None
irorun	nagyon egyszerű	Nan
irisi	megjelenés	None
iringa	tedd össze	Nan
ilẹ̀ayé	a föld	Nan
ilẹ	talaj	None
iléńlá	udvar	None
iléàtèéré	itthon	None
ilélódò	a ház	Nan
iléisé	itthon	None
iléayé	itthon	None
ilé	itthon	None
iluorilejoba	globalizáció	None
iluoba	polgárság	Nan
ilopo	kettős	None
iminle	letartóztatni	Nan
ileru	kemence	Nan
ileigbimo	beleegyezés	Nan
ileife	elhanyagolás	Nan
ilegiga	itthon	None
ileasofin	törvényhozó	None
ilaorun	napkelte	Nan
ilaodo	véd	Nan
ilanaoye	stratégiák	Nan
ilana	eljárás	None
ilagbolojo	nyilvánosság	None
ikún	töltő	Nan
ikúgbaèyí	most	None
ileobaluaye	a világ	Nan
imoero	könnyítés	Nan
imojuto	gondoskodás	Nan
imusin	húz	Nan
irele	alázatosság	Nan
ire	eladás	Nan
iranlose	támogatás	None
iraja	megdöbbentő	Nan
ipá	kényszerítés	Nan
ipo	elhelyezkedés	Nan
ipinu	döntés	None
ipinpa	részvétel	None
ipin	fejezet	None
ipele	szint	None
ipawo	felhasználások	Nan
ipare	áttűnés	Nan
iowa	a földön	Nan
ioniani	szűkölködő	Nan
ioja	hal	None
inúnibíni	üldözés	Nan
iní	öröklés	Nan
inágbéringbérin	tizenhét	None
integration	integráció	Nan
inkosi	igazolni	Nan
indus	indus	Nan
indeed	valóban	None
inagberingberi	mogyoróvaj	Nan
imúnisìn	higiénia	Nan
imú	orr	Nan
ikoreokere	aratás	Nan
ọ̀sẹ	hét	None
