aajo	smešno	Nan
púpò	radije	None
púpo	previse	Nan
pò	saviti	Nan
pòwe	poslovice	Nan
pípẹ́	dugo	None
pípèsè	odredba	Nan
pípa	klanja	None
péé	da	None
péré	samo	None
pé	da	None
pèsè	pod	None
quran	kur&#39;an	Nan
pèlúpèlú	takođe	None
pèhìndà	sperma	Nan
pè	zvani	None
pátáporongodo	apsolutno	None
pásíà	podrum	Nan
pàápàá	posebno	None
pààlà	granica	None
pàràkòyí	odmah	None
pàmò	tačnije	None
px|kùránì	kernel	None
pupa	crveno	Nan
príncipe	príncipe	Nan
pèlu	sa	None
providence	proviđenje	Nan
ra	kupiti	Nan
rajya	nada	None
rome	hrom	Nan
roma	romi	None
roko	mob	Nan
rokirika	pregledavanje	Nan
rogbodiyan	nered	Nan
roboto	površine	None
robinson	robinson	Nan
ro	misli	None
rnas	rnas	Nan
rnarna	rnarna	Nan
rna	rna	Nan
race	trka	Nan
rn	rn	Nan
riresile	diktafon	Nan
rinle	novo	None
right|thumb|px|aworan	slika	None
richard	richard	None
research	istraživanja	None
rere	dobro	None
repetejulo	najosjetljivija	Nan
repeats	ponavlja	None
reggae	reggae	Nan
rank	čin	None
ramadan	ramadan	Nan
riro	mašta	Nan
ronald	ronald	Nan
proton	protoni	Nan
produced	proizvedeno	Nan
palauan	palauan	Nan
padá	pod	None
paapaa	posebno	None
paa	ugasiti	Nan
opolo	mnogi	None
ofò	jutro	None
oyé	svijet	None
ose	ose	Nan
opolo	mnogi	None
omonìyàn	bića	None
olorun	bože	None
panaˈma	panaˈma	Nan
odun	godišnje	None
olórun	bože	None
okùnrín	smeh	Nan
ojó	je	None
odún	godine	None
oúnjẹ	hrana	None
owojagidijagan	teroristi	Nan
oun	on	None
otutu	mnogi	None
otherwise	inače	None
oseluarailu	civilni	Nan
oscar	oscar	Nan
olósìn	vjerski	None
protokolu	protocolu	Nan
panyanan	the_space	Nan
parapọ̀	mješavina	None
press	pritisnite	Nan
portuguese	portugalski	Nan
portonovo	portonovo	Nan
population	stanovništva	None
polaroid	polaroid	Nan
polandi	poljski	None
pojulo	najviši	None
po	po	None
plánẹ́tì	vodovod	Nan
platos	platos	Nan
piposi	mnogo	None
papa	tata	Nan
pipolongo	oglas	Nan
pinu	odlučna	Nan
pinsoto	pinoto	Nan
pinsi	opadajući	Nan
phillipines	filipini	None
pelu	biser	Nan
petu	petu	Nan
periferi	periferi	Nan
penisula	penisula	Nan
penh	penh	Nan
pele	šarmantan	Nan
paripari	kraj	None
pipo	mnogo	None
rorùn	lako	None
rossii	rossii	Nan
rural	seoski	None
sìbẹ̀	još	None
séyìn	nazad	None
séyìn	nazad	None
sénégal	sperma	Nan
ségun	plakati	Nan
sèle	krađa	Nan
são	novi	None
sáààrin	između	None
sáàpàdé	sponzorstvo	Nan
sápadè	dan	None
sàì	dobro	None
sìni	kozice	Nan
sàngó	banda	Nan
sàmì	znak	None
sàbúrí	svega	None
symmetry	simetrija	Nan
swahili	svahili	Nan
suny	suny	Nan
sun	sunce	None
sugbọ́n	racionalno	Nan
sugbo	ne	None
suez	suez	Nan
structures	građevine	None
stella	stella	Nan
sàn	bolje	None
spectacular	spektakularno	Nan
síbèsíbè	ipak	None
sílẹ̀	iznevjeriti	Nan
tabora	izbegavanje	Nan
tabili	stola	Nan
tabi	ili	None
sísè	prevod	Nan
sísa	s	None
sááju	malo	None
sisé	vježbati	Nan
sepò	napokon	None
se	rade	None
sùgbón	naprotiv	Nan
síse	struktura	None
síbú	zemlju	None
si	svakako	None
sùgbón	naprotiv	Nan
sóko	biljka	None
sójà	vojnik	None
sòrò	mozga	None
síí	ovdje	None
síwájú	dalje	None
síwon	njih	None
síta	napolju	Nan
síso	još	None
síso	još	None
síse	posla	None
sọ	reći	None
so	tako	None
sopin	kraj	None
soon	uskoro	None
say	reći	None
santa	santa	Nan
samioro	na	None
sambia	mladost	None
salàyé	život	None
salem	salem	Nan
sakyas	sakyas	Nan
sakyamuni	sljedeći	None
saheli	praktičnost	Nan
safta	poredati	Nan
safiwe	poređenje	None
sb	sb	Nan
saffana	safir	Nan
saarland	na	None
saaree	superiorni	Nan
saarc	ukloniti	None
rẹ	ona	None
ròyìn	izvijestili	Nan
rìn	hodati	Nan
ré	c	None
république	république	Nan
ránmú	brini	Nan
ráhàn	pojavile	None
ryan	ryan	Nan
safari	safari	Nan
schwarz	schwarz	Nan
sea	more	None
seat	sjedište	None
solomon	salomon	Nan
sohun	da	None
so	ljubav	None
slovo	slovo	None
sisupo	množiti	Nan
sisupapoerekusu	pljuvanje	Nan
sisopo	povezivanje	None
sisodagba	odrastati	Nan
sise	kuvanje	Nan
sioux	sioux	Nan
sinsin	religija	None
sinai	grijeh	Nan
silè	kapi	Nan
sile	iza	None
sihamoni	struktura	None
sibesibe	još	None
sharon	sharon	Nan
sewadi	pretraživanje	Nan
seville	seville	Nan
sense	smisla	None
senegal	senegal	Nan
semudaju	naravno	None
semolara	astma	Nan
seidamo	jasno	None
segbese	po	None
orúko	polje	None
taino	dino	None
orísìírísi	vrste	None
orísiirísi	razne	None
nombamewa	množenje	Nan
nobel	nobel	Nan
nnaji	stric	Nan
nkàn	rak	None
nkan	stvar	None
niyi	ga	None
niye	dosta	None
niyato	razlikovati	None
niwaju	ispred	None
nitosi	blizini	None
nitoripe	jer	None
nombáméjì	prve	None
nitoriidieyi	ovoga	None
nilè	ovdje	None
nijẹr	nike	Nan
nigbà	onda	None
nigbakan	ponekad	None
nibere	rano	None
nibe	tamo	None
ngubengcuka	ngubengcuka	Nan
ngbero	planirano	Nan
nevis	nevis	Nan
neptune	neptun	Nan
nefimu	nephim	Nan
nisinyi	sad	None
nebraska	nebraska	Nan
novo	novo	None
nse	dizajn	None
nínlá	odlicno	Nan
nílẹ̀	zemlji	None
nílùú	gradu	None
nílè	ispod	None
nígbàtí	kada	None
nífẹ̀ẹ́	voljeti	Nan
níbè	tamo	None
níbè	tamo	None
ní	imati	None
nìyí	to	None
nìnú	izvini	Nan
nri	hrana	None
nì	planina	None
náwo	trošak	None
nàìjíríà	u	None
nwa	dušo	Nan
numeri	ukočenost	Nan
nukleotidipupo	nukleotid	Nan
nukleotidi	nukleotid	Nan
nu	čist	None
ntoka	poentu	Nan
nsowikipedia	obowikipedia	Nan
nsolaboraro	sigurnost	None
nso	blizini	None
náà	također	None
nínu	šansa	Nan
ncnc	ncnc	Nan
nawojulo	zagonetan	Nan
munispal	munispal	Nan
mulẹ̀	uspostaviti	None
mughal	zapremina	None
mtwara	ponovo	None
mtn	mtn	Nan
mozilla	mozilla	None
mozambique	mozambique	Nan
morogoro	motoriziranje	Nan
morgan	morgan	Nan
monrovia	monrovia	Nan
mombasa	mombasa	Nan
muungano	muungano	Nan
mokanlelogbon	dva	None
mohandas	mohandas	Nan
minority	manjina	None
minnesota	minesota	Nan
mimuwa	mrvica	Nan
mimoy	mimoy	Nan
miiràn	ublažiti	Nan
micronesia	mikronezija	Nan
michelle	michelle	Nan
mexico	meksiko	None
mewar	mewar	Nan
meucci	meucci	Nan
mokaleladota	kompaktan	Nan
nawó	novac	None
májèmú	ne	None
méjèèjì	oboje	Nan
nato	nato	None
nathaniel	nathaniel	Nan
namibia	doći	None
mẹ́talọ́kan	trojstvo	Nan
mẹ́ta	tri	None
mẹ́rkúríù	miš	None
mẹ́fà	šest	None
múlẹ̀	brzo	None
mó	m	Nan
móra	lek	Nan
mókólà	ljepilo	Nan
mère	crtanje	Nan
mò	znanje	None
míìrán	drugi	None
míràn	drugi	None
mímọ́	sveti	None
ménu	li	None
méwàá	deset	None
métèètà	stolar	Nan
méta	tri	None
mérìnlélógójì	44	Nan
mérìndínlógún	šesnaest	Nan
méte	pet	None
mérindíláàdóta	pet	None
mííràn	drugi	None
níní	imati	None
nípà	najmanje	None
nítorípé	jer	None
onítumò	prevodilac	Nan
oníná	vatra	None
onílẹ̀	dole	Nan
oníkólóbó	uvredljiv	Nan
onígbàgbó	stari	None
onka	kalkulator	Nan
onje	dijeta	Nan
oniyijulo	fenomenalno	Nan
oniyewumeji	binarni	None
onisowo	trgovac	Nan
onisayensi	tehničar	Nan
onítèbọmi	kršteni	Nan
onipin	racionalno	Nan
onilile	kuća	None
onilanaibagbepo	kondom	Nan
onigunfenfe	pasivan	Nan
onigbowo	sponzora	Nan
onigbeja	konstruktivno	Nan
onibugbe	stanar	Nan
onialjebra	onialjebra	Nan
omiadalu	poplava	None
omi	voda	None
olùkọ́	učitelj	None
olùkó	instruktor	Nan
oninawo	dužnik	Nan
olùkópa	saradnik	Nan
onítòhùn	računovođa	Nan
oníyanjù	animirani	Nan
orílẹ́	veče	Nan
orílẹ̀	nacija	None
orílèèdè	nacija	None
oríkì	poezija	None
oríilẹ̀	članak	None
oríilè	nacionalna	None
oruko	imenica	Nan
orudnun	godišnja	None
oritameta	sredini	None
orisa	porijeklo	None
orisun	izvor	None
oníwòsàn	iscelitelju	Nan
orisirisi	raznolikost	Nan
orileominira	toplina	Nan
orilejoba	vlada	None
orileedeajoba	imperijalizam	Nan
orileede	nacija	None
oriki	orijentalni	Nan
oriire	čestitke	Nan
ori	glava	None
opposite	suprotno	None
opec	opec	Nan
ootọ́	istinito	Nan
ooni	krokodila	Nan
orinìyìn	pjesma	None
olùdarí	lider	Nan
olùbátan	kontakt	None
olóṣèlú	političar	None
ojùkòsì	padavine	None
ojuse	odgovornost	None
ojuoorun	sunca	None
ojukokoro	pohlepa	Nan
ojoru	toplina	Nan
ojojumo	dnevno	None
ojo	kao	None
ogunlogo	gužva	Nan
ogun	rata	None
ogbè	region	None
ofin	zakon	None
ojùkòtúu	padavine	None
ododo	pravednost	Nan
obere	mala	None
obairanderan	rođaka	Nan
oba	obama	Nan
nso	dolazi	None
nǹkan	stvar	None
níyanjú	pozitivno	Nan
níwájú	ispred	None
nítòótọ́	zaista	None
nítòótó	upravo	None
nítòsí	blizini	None
nítumò	značenje	None
obínibí	ljubaznost	Nan
ojúlùmọ̀	poznanici	Nan
ojútáyé	viskoznost	Nan
ojúìwé	stranicu	Nan
olóyè	vladar	None
olódùmarè	svemogući	Nan
olympus	olimpus	Nan
oluwakiri	istraživanje	None
olusoju	čuvar	Nan
oluparapo	kombinacija	None
olumojuto	pohlepan	Nan
olukowe	autor	None
olukoitan	instruktor	Nan
oludase	proizvođač	None
oluda	tvorac	None
oloye	genijalno	Nan
oloselukan	zdravo	Nan
olora	debeo	Nan
olopon	uzvišen	Nan
ololugbe	gubitnik	Nan
olokunkun	slušalice	Nan
olojukanna	odmah	None
olohun	vlasnici	Nan
olodiajodojuko	drugog	None
okunrin	čovjek	None
okunkun	tama	Nan
oko	polje	None
okhotsk	okhotsk	Nan
okeere	prekomorski	Nan
orísìí	raznolikost	Nan
tainos	tainos	Nan
takuntakun	ograničenja	None
talaka	siromašan	Nan
ìràwọ̀	zvijezde	None
ìrànàna	pomoć	None
ìrànlọ́wọ́	pomoć	None
ìpínrò	stavove	Nan
ìpìnlè	početak	None
ìpìlẹ̀núkléù	enkripcija	Nan
ìpolongo	oglašavanje	Nan
ìnáwó	izdaci	Nan
ìnagije	pobjeda	None
ìmúsára	ojačati	Nan
ìmúnilérú	zloupotrebe	Nan
ìrí	iskustvo	None
ìmú	nosa	Nan
ìmò	munje	Nan
ìmò	zmija	None
ìlé	dom	None
ìlè	podmićivanje	Nan
ìlàìnàró	ugnjetavanja	Nan
ìlàorùn	modrice	Nan
ìlànàn	iluzija	Nan
ìlà	obris	Nan
ìlo	poziv	None
ìlera	zdravlja	None
ìkọpa	učešće	None
ìmóbìdo	rođenja	None
ìkẹrin	četvrti	None
ìròkò	misao	None
ìròyìnwiki	vijesti	None
ìtaeko	radionica	Nan
ìta	napolju	Nan
ìse	akcija	None
ìsòro	poteškoća	Nan
ìsílé	dom	None
ìsèjoba	vlada	None
ìsèdá	kreacija	Nan
ìsègbèfábo	marljivost	Nan
ìse	akcija	None
ìsọ	prodavnice	Nan
ìsú	debljina	Nan
ìròyìn	vijesti	None
ìsòrí	pododjela	Nan
ìsìn	religija	None
ìsèlè	proizvodnja	None
ìsàlè	sunca	None
ìsomó	se	None
ìsirò	proračun	Nan
ìsinsìnyí	sad	None
ìse	akcija	None
ìsawo	proricanje	Nan
ìrúbo	kolaps	Nan
ìró	zvuk	None
ìròrùn	iluzija	Nan
ìsòrò	meditacija	Nan
ìtan	istorija	None
ìkínin	šesti	Nan
ìkìjà	izazov	Nan
ìdá	dezerterstvo	Nan
ìdàrúdàpò	haos	Nan
ìdàpapọ̀	konsolidacija	Nan
ìdàgbà	zrelost	Nan
ìbílè	rođenja	None
ìbílè	rođenja	None
ìbáraeni	kočija	Nan
ìbánisòrò	vezu	None
ìbarà	vrućica	Nan
èpón	mnogo	None
èwù	košulja	Nan
ìdìmú	uznemiravanje	Nan
èsìn	religija	None
èro	misli	None
èka	efekat	None
èyì	dostojanstvo	Nan
ète	svrhu	None
èsúrú	mravi	Nan
èsó	džamija	None
èrò	misli	None
èràn	bolest	None
ènìkan	nešto	None
èlò	posuđe	Nan
èkejì	drugi	None
èrí	dokaz	None
ìkìlò	zloupotreba	Nan
ìdíisin	uzrok	None
ìdó	ubod	Nan
ìkéde	deklaracija	None
ìkèrèkú	zagušenja	Nan
ìkànna	isto	None
ìkejì	drugi	None
ìjọba	vlada	None
ìjò	vođa	None
ìjìnlè	misterija	Nan
ìjìnlè	misterija	Nan
ìjora	mrziti	Nan
ìjoba	vlada	None
ìjo	crkvu	None
ìdíwòn	razlog	None
ìjo	ples	Nan
ìgbò	ram	None
ìgbésí	život	None
ìgbéraga	ponos	Nan
ìgbáraga	snage	None
ìgbá	krila	None
ìgbàgbé	zaboravan	Nan
ìgbà	vreme	None
jé	je	None
ìfáàrà	sveštenik	Nan
ìfojúìtànìgbesiayé	istorija	None
ìfara	mučenje	Nan
ìhun	gvožđe	Nan
ìtokò	lonac	Nan
ìtàn	istorija	None
ìtànkálé	poplave	None
ṣàkóbá	štetno	Nan
ṣiṣé	otvaranje	None
σ	σ	Nan
κάππα	.α	Nan
ˌæləˈbæmə	bolest	None
ˌkælɪˈfɔrnjə	ɪˈkælɪˈfɔrnjə	Nan
ˈøːstəˌʁaɪç	ˈøːstəˌʁaɪç	Nan
ʔaːnaːtɕɑ̀k	.aːnaːtɕɑɕɑk	Nan
şe	učiniti	None
únṣẹlẹ̀	potres	Nan
ôdún	godina	None
ẹdo	šala	Nan
ó	da	None
ósírísì	pljuvačka	Nan
óníse	je	None
ó	to	None
òròàjòmó	jutra	Nan
òrò	misli	None
òwó	novac	None
òsà	zlatne	None
òrò	misli	None
òré	igra	None
òpòlopo	mnogi	None
òfò	sljedeći	None
ósékú	je	None
òré	igra	None
ẹlẹ́bùn	poklon	Nan
ẹnìkan	osoba	None
ọ̀pòlòpò	akcija	None
ọ̀nà	način	None
ọ̀gbìn	biljka	None
ọ̀dọ́	mladost	None
ọpọ́lọpọ́	smokve	Nan
ọn	to	None
ọmọ	dijete	None
ọmú	sisaš	Nan
ọlọ́run	bog	None
ọlọ́mọ	deca	Nan
ọdún	godine	None
ẹlẹ́sìn	vjerski	None
ọbàkàn	polubrat	Nan
ẹ̀rọ	mašina	None
ẹ̀ni	szo	Nan
ẹ̀kọ́	obrazovanja	None
ẹ̀kẹ́ta	treći	None
ẹ̀kasístẹ̀mù	subjektivni	Nan
ẹ̀kaoṣù	trnovit	Nan
ẹ̀kajuly	maja	None
ẹ̀kabrítánì	stric	Nan
ẹ̀kaawon	podnesci	Nan
ẹtì	jetra	None
ẹsẹ	stopala	Nan
ẹ̀wẹ̀	strane	None
òpòlopò	mnogi	None
òkòòkan	jedan	None
òkan	jedan	None
òdo	mladost	None
òdeojú	bezličan	Nan
òde	napolju	Nan
ìṣọ̣̀tẹ̣̀	rak	None
ìṣẹ́kù	podsjetnik	Nan
ìṣèlú	politika	None
ìyípadà	konverzija	Nan
ìyàwó	mlada	None
ìyapa	razdvajanje	None
ìya	patnja	Nan
ìwúlò	korisno	Nan
òdìkejì	drugi	None
ìwòran	vizija	Nan
ìwéré	brošura	Nan
ìwàásù	propovijedanje	Nan
ìwo	rogovi	Nan
ìwe	poređenje	None
ìtúpalè	prevod	Nan
ìtúmò	prevod	Nan
ìtóka	se	None
ìtójú	lica	None
ìtóju	zbrka	Nan
ìtójú	briga	Nan
ìtèsíwájú	napredak	None
ìwò	sveukupno	Nan
òféàrán	slika	None
ògbójú	nadležni	Nan
ògiri	zid	None
òjògbón	vrijeme	None
òṣèlú	politika	None
òwù	platno	Nan
òsèré	sportista	None
òsèlú	političar	None
òsán	podne	None
òrò	mozak	None
òrí	poglavlje	Nan
òrìsà	idoli	Nan
òranyàn	obavezno	None
òpópóònà	cesta	None
òotó	istina	None
òní	danas	None
òmùàrán	slika	None
òmiràn	čarobnica	Nan
òle	domaćica	Nan
òkúta	kamen	None
òkú	leševi	Nan
òkòòkan	jedan	None
òkèògbún	hiljadu	None
òjísé	doktor	None
òjo	kao	None
ògúndìpẹ̀	praškasti	Nan
ògun	lijek	None
ògo	slava	Nan
èka	ogranak	None
èhìn	sljedeći	None
èfòn	napeto	Nan
èdè	jezik	None
visit	poseta	Nan
viruses	virusa	None
villa	vila	Nan
vihara	vihara	Nan
videos	videozapisi	Nan
victor	pobednik	Nan
vermont	vermont	Nan
venezuela	venezuela	Nan
uzbek	put	None
utc	utc	None
utah	utah	Nan
vz	vz	Nan
usps	usps	Nan
urasílì	uracil	Nan
unla	da	None
unifasiti	univerzitet	None
umueri	deca	Nan
ucb	ucb	Nan
tẹ̀ǹbẹ̀lẹ̀kun	zavjera	Nan
tẹ̀ǹbẹ̀	onda	None
túnse	preurediti	Nan
túmò	šljiva	Nan
tú	izliti	Nan
tóka	citirano	Nan
uribe	aura	Nan
tó	tó	Nan
waa	je	None
wari	miris	None
yafran	abeceda	Nan
xiv	xiv	None
xd	xd	Nan
wọ̀nyí	ove	None
wọn	njih	None
wúnrèn	vježbati	Nan
wón	njih	None
wònyí	su	None
wòfún	pogled	None
wípè	jasnoća	Nan
wì	oprati	Nan
waju	lice	None
wàásù	propovijedati	Nan
wura	zlato	None
won	njih	None
wo	ovdje	None
wo	ovdje	None
woo	woo	Nan
wole	se	None
województwo	cheworddztwo	Nan
wiwari	otkriće	None
witkin	duhovitost	Nan
wisconsin	wisconsin	Nan
westminster	westminster	Nan
wyoming	wyoming	Nan
tówùú	iznos	None
tókù	počivaj	Nan
tódárajùlọ	najbolji	None
tokyo	tokyo	Nan
tokasi	istaknuo	Nan
toje	retko	Nan
to	do	None
tiwọn	njihove	None
titu	pucati	Nan
tirè	njegov	None
tirana	tirana	Nan
tira	napeto	Nan
thumb|left|upright|nelson	palac | levo | uspravno | nelson	Nan
those	one	None
tolerejulo	tolerirati	Nan
they	oni	None
tfrac	tfrac	Nan
terutomo	terutomo	Nan
temptation	tražeći	None
tele	praćenje	Nan
teksas	texas	Nan
tedo	upoznavanje	Nan
technology	tehnologija	None
taínos	taínos	Nan
tata	filter	Nan
tara	devet	Nan
talika	siromaštvo	Nan
the	the	None
tolórítelémù	holokaust	Nan
tomé	paradajz	Nan
tooto	stvarno	None
tóbi	veliko	None
tò	set	None
tíórì	gume	Nan
tíátà	ulaznice	Nan
títío	dok	None
títèlé	pratiti	None
títi	zatvoreno	Nan
té	t	Nan
télè	od	None
té	t	Nan
tèsíwájú	da	None
tèlé	odmah	None
tètè	brzo	None
tèlé	praćenje	Nan
táawà	se	None
tàwon	njih	None
tàsí	bez	None
tuntun	novo	None
tumosi	znači	None
translated	prevedeno	Nan
traduite	traduit	Nan
tounsejanu	tragičan	Nan
toseluaralu	političkih	None
torun	brineta	Nan
tori	tori	Nan
yakubu	yakub	Nan
metropoli	metropoli	Nan
yan	odaberite	Nan
yanturu	dosta	None
àsìkò	vreme	None
àsèyìn	poslije	None
àsàjemátèe	zora	None
àse	gozba	Nan
àrẹ	predsednika	Nan
àrùn	bolest	None
àrígbámú	uznemirujući	Nan
àpeere	primjer	None
àpapọ̀	cjelina	None
ànfàní	prilika	None
àmúsorò	psihologija	None
àsótélè	produžetak	Nan
àmúlò	praktičan	Nan
àmérìkà	natprirodno	Nan
àlébù	mrlja	Nan
àlèpò	gore	None
àlè	kopile	Nan
àlááfià	analogija	Nan
àlàáfíà	mir	None
àlàyé	informacija	None
àlàkalè	ciljevi	None
àkókó	vrijeme	None
àkójopò	grupa	None
àká	police	Nan
àmì	potpiši	Nan
àkàrà	kolači	Nan
àsọdọ̀kan	jedinstvo	None
àsà	običaj	Nan
èdè	jezik	None
èdá	kreacija	Nan
èbúté	luka	None
èbà	komarci	Nan
áwon	blud	Nan
án	t	Nan
àìsí	odsustvo	Nan
àìròtélè	neočekivano	Nan
àìní	željeti	Nan
àìkó	nedostatak	None
àáyá	sperma	Nan
àsekúdórógbó	kora	None
àárín	sredini	None
ààtò	ritual	Nan
àwùjo	društvu	None
àwón	novac	None
àwón	novac	None
àwon	teorije	None
àtẹnudẹ́nu	oralni	Nan
àtúnse	uredi	Nan
àtúnse	uredi	Nan
àtòrìnká	okolo	Nan
àtìpó	stranac	Nan
àtijo	zastario	Nan
ààyè	živ	Nan
àkosílè	teza	Nan
àkosílè	apstrakcija	Nan
àjọṣepọ̀	socijalni	None
yíì	ti	None
yíyípadà	promjena	None
yí	se	None
yìí	ovo	None
yì	idi	Nan
yée	ih	None
yèwò	pogledaj	Nan
yára	požuri	Nan
yàtò	postaviti	Nan
yànan	zaprepašćenje	Nan
yo	yo	Nan
yíò	će	None
yorúbà	jogurt	Nan
yori	led	None
yoo	volja	None
yiyafunnilo	erozije	Nan
yipada	se	None
yiowu	će	None
yio	će	None
yindinyindin	ne	None
ye	da	None
ye	da	None
yewo	poboljšanje	None
yaoundé	yaoundé	Nan
york	york	None
yẹ̀ẹ́	znate	Nan
yọ	ukloniti	None
zanzibar centralsouth	zanzibar centralsouth	Nan
àjákọ	odvojeno	None
àjo	putovanje	None
àifète	svrhu	None
àgọ́	šator	Nan
àgbùdo	dvorište	Nan
àgbìgbò	susjedstvo	Nan
àgbéyèwò	pregled	None
àgbékà	apstraktno	Nan
àgbáríjọ	organizacija	None
àgbàrá	poplava	None
àgbàjọ	starac	Nan
àdóolóró	ulje	Nan
àdáátán	ekskluzivno	Nan
àdátá	suprotno	None
àdámò	privatnost	Nan
àbọ̀	polovina	None
àbìkú	besmrtnost	Nan
àbáyo	prijedlog	None
àbámẹ́ta	četvrtak	None
àbe	babuna	Nan
bce	daleko	None
zy	zy	Nan
zscores	zscores	Nan
zou	zou	Nan
zdna	zdna	Nan
yanjú	riješiti	None
methodologies	metodologije	Nan
merin	četiri	None
mercosur	mercosur	Nan
díè	napeto	Nan
dìtẹ̀	zavjera	Nan
dìró	desno	None
dìde	nastaju	None
dì	list	None
dépò	te	None
délànà	principu	None
dé	stigli	None
dáwó	donirati	Nan
dásà	a	None
dáradára	dobro	None
dóko	dobro	None
dálóríi	ti	None
dágbó	starost	None
dá	kreirao	Nan
dàpò	ih	None
dàbíi	ovo	None
dun	ukusno	Nan
due	zahvaljujući	None
du	du	None
dover	dover	Nan
doublestrand	doublestrand	Nan
doublehelix	doublehelix	Nan
dote	dote	Nan
dájó	dobro	None
doni	doni	Nan
dólà	dobro	None
dúró	stajati	Nan
eléré	sportista	None
eléde	apstraktno	Nan
elláda	kreacija	Nan
eleyii	ovo	None
eleyi	ovo	None
elede	svinje	None
eko	obrazovanja	None
ekeji	drugi	None
eka	kompleks	None
eighteen	osamnaest	Nan
egbògi	medicinski	None
dún	zvuk	None
egbò	rana	None
egbo	rana	None
egberundun	godina	None
egbe	pištolj	Nan
egba	apsolutno	None
efrem	effem	Nan
ede	jezik	None
ecomog	ecomog	Nan
ebi	porodica	None
eba	eba	Nan
ea	da	None
dọ́gba	jednak	None
egbé	jao	Nan
elòmírà	alge	None
dominic	dominik	Nan
doju	lice	None
clear	jasno	None
cipollone	cipollone	Nan
china	kina	None
cherished	njegovan	Nan
chebbi	misli	None
chaskalson	chaskalson	Nan
charles	charles	None
chamorro	chamorro	Nan
cbc	cbc	Nan
cauchy	kašasti	Nan
catherine	katarina	None
code	kod	None
cathedral	katedrala	None
casablanca	casablanca	Nan
cape	ogrtač	Nan
canaria	kanarija	Nan
calabar	žvakaća guma	Nan
cairo	bijes	Nan
bẹ́ẹ̀sìni	da	None
bẹ́ẹ̀ni	da	None
bẹ́ljíọ̀m	beril	Nan
bẹ́	razbio	Nan
bẹ̀rẹ̀	da	None
búrú	budi	None
caslon	casino	Nan
dojú	lice	None
coetsee	coetsee	Nan
coming	dolazi	None
divoire	divoire	Nan
dinwoju	gore	None
din	pržiti	Nan
different	različito	None
didasile	osnivanje	None
didagba	jednakost	None
development	razvoj	None
desmond	desmond	Nan
describes	opisuje	None
des	des	Nan
denver	denver	Nan
coloured	obojeno	Nan
delhi	nemoj	Nan
daru	uništiti	None
darapo	se	None
dani	držanje	None
dandan	obavezno	None
dagbasoke	odrasti	Nan
da	i	None
cunha	grlo	Nan
ct	ct	Nan
csto	csto	Nan
computers	računari	None
compared	upoređen	Nan
dates	datumi	Nan
elòmíràn	drugi	None
emerging	u	None
emmanuel	emmanuel	Nan
gbaná	pucati	Nan
gbale	popularnost	None
gbajúgbujà	popularna	None
gba	se	None
galatia	put	None
fẹ́rẹ̀ẹ́	skoro	None
fòye	razumiju	Nan
fífún	davanje	Nan
fífò	leti	Nan
fégbé	zaboravi	None
fé	fé	Nan
gbe	nositi	None
fé	fé	Nan
funra	sebe	None
fun	za	None
fulbe	ful	Nan
fulani	kukavički	Nan
fuji	ukloniti	None
freetown	mjesto	None
fransi	francuski	None
francis	francis	Nan
fracmv	fracmv	Nan
fowó	novac	None
fowobowe	rezervacija	Nan
further	dalje	None
fourbase	četveronožni	Nan
gbera	se	None
gbese	dug	None
geneva	geneva	Nan
geesi	engleski	None
gbọ́dọ̀	mora	None
gbúnùn	pomirišem	Nan
gbónmisi	zakon	None
gbódò	mora	None
gbìyànju	se	None
gbìnyànjú	probaj	Nan
gbésè	ponuda	None
gbéyèwò	pregled	None
gbéni	uživo	None
gberasoke	ubrzati	Nan
gbékalè	stolar	Nan
gbé	uživo	None
gbáradì	ustani	Nan
gbá	razbiti	Nan
gbàgùrà	zatresao	Nan
gbàgbọ́	vjerujte	Nan
gbongbo	root	Nan
gbogbogbo	opšte	None
gbin	posađeno	Nan
gbilè	izbiti	Nan
gbigbewo	finansiranje	Nan
gbigbamulo	eksploataciju	Nan
gbédìí	uspostaviti	None
foriko	primjer	None
force	silu	None
foniimu	film	None
eyonomba	eyonomba	Nan
eyin	jaja	None
eya	kategoriju	None
example	primjer	None
ewì	poezija	None
ewé	list	None
ewe	list	None
euroasia	euroazija	Nan
euro	evro	Nan
etíòkun	obala	None
etymologiae	etimologije	Nan
eléja	ribolov	None
etisalat	etisalat	Nan
esia	dolazi	None
eseese	dijagram	Nan
eréonítàn	kratica	Nan
erékùsù	ostrvo	None
erofo	sediment	Nan
ernst	ernst	Nan
epa	kikiriki	Nan
eníbá	vrućica	Nan
enì	slon	Nan
enter	uđi	Nan
enikéni	svi	None
esteri	esteri	Nan
elòmíràn	drugi	None
eka	efekat	None
eléyàmèyà	nacionalnost	Nan
fohùn	viknite	Nan
fofinde	zabrana	Nan
fodio	fodio	Nan
five	pet	None
fitino	suđenje	Nan
finlandi	finska	None
finiki	fizika	None
fimú	oštro	None
fihan	naznačeno	Nan
fifihan	pokazujući	Nan
fi	uštedjeti	Nan
fe	želio	None
fesèmúlè	izvor	None
ferde	ferde	Nan
felifeli	baršun	Nan
farsi	arti	Nan
faranse	francuski	None
faramó	pridržavaju	Nan
fan	ventilator	Nan
fail	neuspjeh	Nan
fagile	otkazano	Nan
ewà	ponašanja	None
esè	prihodi	None
esin	religija	None
enu	usta	None
búburú	loše	None
bòtswánà	autobus	Nan
béè	tako	None
bèrẹ̀	sa	None
alawose	proricanje	Nan
alalaye	zemljani	Nan
alakobere	novak	Nan
alakitiyan	aktivista	Nan
alaini	potrebi	None
alaigbara	neodoljiva	Nan
alaidogba	neuravnotežen	Nan
aladanida	proizvoljni	Nan
aladani	privatni	None
aladaani	privatni	None
alaafin	nelegitiman	Nan
albany	albany	Nan
alaafia	mir	None
alaabo	onesposobljeno	Nan
ala	dole	Nan
akẹ́kọ̀ọ́	student	None
akíngbógun	bataljona	Nan
akíkanjú	odvažan	Nan
akátá	šakal	Nan
akopo	kompilacija	Nan
akopa	najvažnije	None
akoni	nemamo	Nan
akole	možemo	None
akokolo	period	None
alaadanida	neželjeno	Nan
akinpelu	artiljerija	Nan
albert	albert	None
alicia	alicia	Nan
anc	anc	Nan
anabi	prorok	Nan
an	an	None
améríkà	američko	Nan
améríkà	američko	Nan
amosi	džamija	None
amojeoyipada	kabriolet	None
amerika	amerika	None
americas	americas	Nan
amazonas	amazonas	Nan
alọ́po	novčanik	Nan
alexandra	alexandra	Nan
alúwo	bum	Nan
aláyèwò	inspektore	Nan
alátise	umjetnik	None
alápapò	zamjena	Nan
alákọ̀bẹ̀rẹ̀	inicijator	Nan
alumíníọ̀mù	aluminijum	Nan
alumoni	kurativno	Nan
alukuraani	koran	Nan
alubàbá	otac	None
alpha	alfa	Nan
alominira	nezavisnost	None
allāh	allāh	Nan
aláísàn	bolestan	Nan
akiidah	korida	Nan
ajọra	replika	Nan
ajoro	putovanje	None
adiokan	usamljen	Nan
adeda	priroda	None
addis	addis	Nan
adarihunrun	čistač	Nan
adabaye	redu	None
adaba	povoljno	Nan
accra	acra	Nan
abúléko	selo	None
abínibí	nacionalnost	Nan
abé	igla	Nan
abálájo	iskusan	Nan
adágbà	stariji	None
aburunmu	naša	None
abidjan	ikada	None
abidi	abeceda	Nan
abesahara	posipati	Nan
abeorile	kući	None
abeikojopo	nasljednica	Nan
abala	dio	None
aawe	paraliza	Nan
aare	aare	Nan
aapon	oružje	None
aanu	saosećanje	Nan
aala	granica	None
abo	ženstveno	Nan
kútò	ulici	None
adúgbò mókóla	sluznica mukole	Nan
adúgbò quarry	kamenolomne komšije	Nan
ajo	putovanje	None
ajibola	red	None
ajemoroyin	ispitivanje	None
aje	ekonomija	None
ajagun	pas	Nan
aisi	nedostatak	None
aintimulo	aintimulo	Nan
agio	plakati	Nan
agbéiná	vatrogasac	Nan
agbára	snage	None
agbàbò	zaštitnika	Nan
agbà	osoba	None
agbeinadie	zemljište	None
agbaye	svijet	None
agbara	snage	None
agbado	kukuruz	None
agba	boje	None
aféfé	vjetrenjača	Nan
africans	afrikanci	Nan
african	afrički	Nan
africa	afrika	None
afoyemo	sinopsis	Nan
afomo	primjer	None
afida	porodica	None
adúgbò ìdí	razlozi	None
andaman	andman	Nan
genevieve	genevieve	Nan
angkor	angkor	Nan
anschluss	anschluss	Nan
benin	klupa	Nan
bengali	bengali	Nan
bengal	bengal	Nan
belgium	belgija	None
belarus	bjeloruski	Nan
beijing	peking	Nan
beauharnais	beauharnais	Nan
bce	daleko	None
bayìí	sad	None
bayi	sad	None
bayelsa	bayelsa	Nan
berber	berber	Nan
bauxitealumina	boksitealumina	Nan
banle	banle	Nan
bang	prasak	Nan
balẹ̀	bude	None
bahrain	bahrein	Nan
babaláwo	vračar	Nan
baa	je	None
aṣòkan	pojedinac	Nan
azikiwe	zdrav razum	Nan
ayò	ay	Nan
ayàfi	redu	None
ayeye	vječnost	Nan
bara	godine	None
aya	stih	Nan
berlin	berlin	None
bharat	bharat	Nan
báyìí	sad	None
bárakú	zavisnost	Nan
bálè	balon	Nan
bákannáà	takođe	None
bàbá	otac	None
by	od	None
burúkú	zlo	None
bujumbura	proširen	Nan
buenaventura	buenaventura	Nan
bu	je	None
brítánì	britanski	None
bernstein	bernstein	Nan
britain	britanija	None
brazzaville	brazzaville	Nan
brasil	brasil	Nan
bolívar	bolívar	Nan
bolt	vijak	Nan
bole	bole	Nan
bojú	pogledaj	Nan
bodies	tela	Nan
black	crna	None
biribiri	bila	None
bibeli	biblija	Nan
bharata	se	None
bridgeport	most	None
awújẹ	skandal	Nan
awùjo	ljubaznost	Nan
awuruju	magično	Nan
arábíà	abecedno	Nan
aráa	brate	Nan
aryan	arijac	Nan
arun	bolest	None
aruleyin	zdravo	Nan
aroko	vegetacija	None
arkansas	arkanzas	Nan
ariwaguusu	jugozapadni	Nan
ariwaarin	istok	None
ariso	nastaju	None
arinkankan	ovaj	None
aráròmí	zdravo	Nan
aralíle	tropska	Nan
apẹ̀rè	pregača	Nan
apòmù	pregača	Nan
apis	apis	Nan
apeere	primjer	None
apeja	ribar	Nan
aparapo	kombinacija	None
apaiwoorun	zapadni	None
apailaorun	sunca	None
apaguusuiwoorun	jugozapad	Nan
apaguusuilaorun	jugozapad	Nan
apagusu	jug	None
arabu	arapski	None
arópò	podmićivanje	Nan
arúgbó	starost	None
arọ	hrom	Nan
awon	njih	None
awoòn	predložak	Nan
awonara	emocija	Nan
awo	tanjur	Nan
awari	otkriće	None
avar	avar	Nan
austríà	australia	Nan
austronesian	austronezijski	Nan
austriahumgary	austriahumgary	Nan
australia	australia	Nan
atunse	korekcija	Nan
atun	unatrag	Nan
atinrin	se	None
atimo	plan	None
atigba	dopušteno	Nan
atanna	atom	None
atangbona	atom	None
asèdá	prirodni	None
asìko	gluposti	Nan
assessment	procjena	Nan
asipa	odstupanje	Nan
aseyori	uspeh	Nan
aseeto	naselje	None
ascii	saznati	Nan
asagun	pobjeda	None
anita	anita	Nan
ọ̀rọ̀	razgovarati	Nan
georgia	georgia	Nan
gfaj	gfaj	Nan
kòjòkú	kiša	None
kírísìtì	božić	None
kínu	ljubljenje	Nan
kíkọ́	učiti	Nan
kíko	studiranje	Nan
kí	pozdraviti	Nan
kìnní	prvo	None
kéyìn	kasnije	None
kémíkà	suprotno	None
kétu	budi	None
kékéèké	mala	None
kòkó	miš	None
kéesì	smešno	Nan
kánádà	naravno	None
kánfinkése	domišljatost	Nan
ká	od	None
kàyéfì	čudo	None
kàríbẹ́ánì	regionu	None
kwara	adresirano	Nan
ku	ti	None
krio	krio	Nan
kori	dosta	None
ko	ko	Nan
koko	učenja	None
káyé	svetu	Nan
koto	mamac	Nan
kòmpútà	kompjuter	Nan
kòòsí	nije	None
labalaba	leptir	Nan
laarin	unutar	None
laaka	preokrenuti	Nan
laada	udarac	None
laa	odlazi	None
kọ́ni	nedostatak	None
kọ́lọ́mú	stubova	Nan
kọ́kọ́	prvo	None
kọ̀mpútà	kompjuter	Nan
kọjá	proći	None
kẹ́nyà	razdvajanje	None
kòtò	jama	Nan
kẹta	treća	None
kẹrin	četvrti	None
kúùkù	naprotiv	Nan
kútò	sve	None
kúrò	daleko	None
kúkúrú	ukratko	None
kúkú	svega	None
kùrání	koran	Nan
kùkú	svega	None
kóra	okupiti	Nan
kógo	slava	Nan
kòòkan	svaki	None
kẹsàán	odmah	None
labee	ispod	None
kookan	ovo	None
kong	kong	Nan
kampala	kopča	Nan
kalẹ	izdvojiti	None
kalinga	cinga	Nan
kakiri	trag	None
kagera	hvalisav	Nan
kadara	imovina	Nan
jọ́	te	None
jẹ́mánì	njemački	None
jùló	najviše	None
jùlo	posebno	None
jùlo	nego	None
kan	a	None
jíjéomoléyìnkírísítì	kao	None
jíje	biće	None
jìnnàa	daleko	None
jéésù	isuse	Nan
jé	dođi	Nan
jáde	izađi	Nan
jàgídíjàgan	nasilan	Nan
juneau	juneau	Nan
jo	john	None
jopò	se	None
jojo	napukao	Nan
johanu	izvini	Nan
jíjuwó	novac	None
kongo	kondom	Nan
kankan	nijedan	None
karbonumarun	tecentrica	Nan
komputa	kompjuter	Nan
kolo	kolo	None
kojá	križ	Nan
koidu	koidu	Nan
kodò	ispod	None
ko	ili	None
kinkinni	sitnica	Nan
kilhar	pazuha	Nan
kikuninu	zamisli	Nan
kiko	učenja	None
kikoso	brzo	None
kanlè	kanal	Nan
kikopomo	toplina	Nan
kiko	donošenje	Nan
kiakiajulo	najbrzi	Nan
ki	tako	None
khoisan	inferiorni	Nan
kept	zadržan	Nan
keko	pismen	Nan
kekere	mala	None
kebbi	podesivi	Nan
karùún	peti	None
karun	peto	Nan
karl	karl	None
kikojo	kompilacija	Nan
lade	lade	Nan
laid	položen	Nan
laifi	greška	None
mahatma	mahatma	Nan
madeira	beira	Nan
maapu	karta	None
lọ́jà	tržištu	None
lọ́dọọdún	godišnje	None
lọndọnu	london	None
lórò	sutra	Nan
lónà	putu	None
ló	ló	Nan
lóòótọ́	zaista	None
lóòótò	da	None
makedonia	makedonija	None
lóti	lot	Nan
lórì	luka	None
lópó	udovica	None
lópez	nipez	Nan
lóde	napolju	Nan
lítésò	ubod	Nan
lísa	ubrzanje	None
lílo	eksploataciju	Nan
lérú	ropstvo	None
léyìn	kasnije	None
léyin	poslije	None
lérò	razlog	None
lóríba	preko	None
lérìnín	snijeg	None
malabo	dušo	Nan
malayopolynesian	malayopolinezijanac	Nan
member	član	None
melo	koliko	None
meksiko	meksiko	None
mejila	dvanaest	None
mejidinlogbon	osam	None
mefeefa	remont	Nan
mediteraneani	mediteranski	Nan
means	znači	None
mbabane	negativno	None
maya	ne	None
max	max	Nan
malay	pretpostaviti	Nan
mathimatiki	matematičkog	Nan
matheu	matheu	Nan
maseru	ljubomora	Nan
maryland	maryland	Nan
mars	mars	None
marku	put	None
march	marš	Nan
marcellus	marcellus	Nan
manˈdeːla	manˈdelala	Nan
mango	mango	Nan
mali	dan	None
malaysia	malezija	Nan
mathiew	mathiew	Nan
léebá	slučajno	None
lédè	jeziku	None
lèyìn	poslije	None
links	linkovi	None
linear	linearni	Nan
lindi	luž	Nan
lilongwe	lilongwe	Nan
lilemo	konoplja	Nan
lilelile	hardcore	Nan
leè	svibanj	Nan
leyi	ga	None
lewon	kaznu	None
lewaju	dalje	None
less	manje	None
lodo	mjesto	None
lese	pošta	None
lekun	pojačano	Nan
leboa	lebo	Nan
le	može	None
lay	ležati	Nan
latvia	latvia	Nan
latini	latinica	None
latigbana	tada	None
latibe	odatle	None
lasile	pustiti	Nan
lanka	lanka	Nan
languages	jezicima	None
leo	leo	Nan
lojowaju	budućnosti	None
lojukokoro	pohlepan	Nan
lojúgun	je	None
lèe	može	None
láíláí	nikad	None
láì	bez	None
lárúbáwá	prirodni	None
lára	boli	None
lápá	deo	Nan
lámọ́di	bogatstvo	None
láké	glasno	Nan
láimo	bez	None
láfún	dato	Nan
lábé	težina	None
lààmì	znakovi	None
lààmi	znak	None
làgba	jednak	None
lynton	lynton	Nan
luther	luther	Nan
luanda	luanda	Nan
lo	nastavi	Nan
low	niska	None
lovers	ljubavnici	Nan
louvre	louvre	Nan
loruko	ime	None
lopolopo	mnogo	None
loloselu	politički	None
lokunkun	energičan	Nan
johann	dodjavola	Nan
jogun	naslijeđen	Nan
jo	curenje	Nan
jiròrò	maglovito	Nan
ifitonileti	informacija	None
ifilole	lansiranje	Nan
ifija	ribolov	None
idánwò	suđenje	Nan
idupe	ti	None
idoma	crtanje	Nan
idimule	hapšenje	Nan
ideraa	pisati	None
idari	kontrola	None
idamita	izvući	Nan
idajo	pravda	Nan
ifobaje	korupcija	Nan
idaji	polovina	None
idagbasoke	razvoj	None
iceland	island	None
ibùjókòó	sjedenje	Nan
ibùdó	kamp	Nan
ibuso	se	None
ibuseripadabosi	nadoknadu	Nan
ibujoko	klupa	Nan
ibori	veo	Nan
ibojì	grobnica	None
ibn	ibn	None
ibiti	mjesta	None
idagbe	zanemarivanje	Nan
ibise	vježbati	Nan
ifofinde	kongres	None
igbeduro	priprema	None
iketa	naslijediti	Nan
ikerin	četvrti	None
ikeko	kompilacija	Nan
ikejidinlogun	osamnaest	Nan
ikaowo	poštovanje	None
ikandinlogun	osamnaest	Nan
ikan	jedan	None
ijó	plesanja	Nan
ijosin	štovanje	Nan
ijinnasi	fizika	None
ije	pokreta	None
ifriqiya	stimulacija	Nan
ijaya	panika	Nan
ijagun	borba	None
ihinrere	evanđelje	Nan
ihan	se	None
igitòròmogbè	širokopojasni	Nan
igbáẹ̀yìn	posljednji	None
igbá	piletina	Nan
igbowolori	skupo	Nan
igbeyawo	vjenčanje	Nan
igbesoke	nadogradnja	Nan
igberiko	prigradski	Nan
igbegun	pobjeda	None
ijakadi	borba	None
ibimo	rođenje	None
ibile	tradicionalno	None
ibiamusin	svetište	Nan
gún	probijen	Nan
gòkè	gore	None
gírámà	hvataljke	Nan
gégé	stvarno	None
gèésì	dragulj	Nan
gèésì	ljepilo	Nan
gv	gv	Nan
guusu	južno	None
gunle	pištolj	Nan
gun	dugo	None
guinébissau	guinébissau	Nan
gúúsù	južno	None
guineabissau	guineabissau	Nan
guanínì	guanni	Nan
groove	utor	Nan
griiki	grčki	None
grammy	grammy	Nan
gquadruplex	gquadruplex	Nan
gorgina	orao	Nan
gomina	guvernera	None
goemai	goemai	Nan
gidí	kuca	Nan
gidigidi	vrlo	None
ghana	gana	Nan
guinea	gvineja	None
gẹ̀ẹ́sì	engleski	None
habsburg	habsburg	None
haggai	vodič	None
ibewo	došlo	None
ibeji	blizanci	Nan
ibarepo	udruženje	None
ibalo	afera	None
hv	hv	Nan
hungari	gladovanje	Nan
hun	hun	Nan
hugh	hugh	Nan
hp	hp	Nan
hosea	crijevo	None
hominidae	hominidae	Nan
histoni	histoni	Nan
hindu	hindu	Nan
him	njega	None
hesse	dogovorili	Nan
heraklion	heraklion	Nan
henny	henny	Nan
hendu	slatkiš	Nan
heinrich	heinrich	None
hawaii	havaji	Nan
hausafulani	hausafulani	Nan
haughton	haughton	Nan
hard	teško	None
halomonadaceae	halomonadaceae	Nan
haiti	haiti	Nan
ikoenu	uštedjeti	Nan
german	njemački	None
ikojopo	nagomilavanje	Nan
iku	smrt	None
itumo	značenje	None
itu	baciti	Nan
itorawo	liberalni	Nan
itokowo	posao	None
itobi	se	None
itiraka	borba	None
itelentele	jasno	None
itanakole	priča	None
itali	italijanski	None
isè	usluga	None
isesi	predati	Nan
iwadi	istraživanja	None
isun	protoka	Nan
iso	doći	None
isepinpin	distribucija	None
iseowo	posao	None
iseoroayeijoun	arheologija	Nan
iseoba	petnaest	None
isejoba	upravljanje	None
iseero	pazi	Nan
isedaniloro	sebe	None
isare	ubrzanje	None
isa	dosta	None
irúnmọlẹ̀	munje	Nan
isoponomba	isoponomba	Nan
irò	glasina	Nan
iwasi	impresionirati	Nan
iwoile	dom	None
jijinna	daleko	None
jije	biće	None
jfk	jfk	Nan
jesu	jezus	Nan
jeometri	geometrija	None
jeffrey	jeffrey	Nan
jawaharlal	ljuljačke	Nan
jamo	odlazi	None
jamaica	youtube	Nan
jalè	krađa	Nan
jagbe	se	None
iwifun	informacija	None
jadide	čekaj	Nan
jabo	izveštaj	Nan
iṣẹ́ìwádìí	istraživanje	None
iḷẹ̀	posla	None
iyán	blistav	Nan
iyen	je	None
iyawo	mladenka	Nan
iyato	razlika	None
iyan	glad	Nan
iwuwa	vežba	Nan
iwulo	korisno	Nan
iwosan	izlječenje	Nan
jackson	jackson	None
irorun	jednostavno	None
irisi	izgled	None
iringa	zamotati	Nan
ilẹ̀ayé	zemlja	None
ilẹ	zemlju	None
iléńlá	dvorište	Nan
iléàtèéré	dom	None
ilélódò	kuća	None
iléisé	dom	None
iléayé	dom	None
ilé	dom	None
iluorilejoba	globalizacija	None
iluoba	državljanstvo	Nan
ilopo	dvostruko	Nan
iminle	da	None
ileru	peć	Nan
ileigbimo	pristanak	Nan
ileife	zanemarivanje	Nan
ilegiga	dom	None
ileasofin	zakonodavni	Nan
ilaorun	sunca	None
ilaodo	zaštititi	Nan
ilanaoye	strategije	None
ilana	postupak	None
ilagbolojo	publicitet	Nan
ikún	punjenje	Nan
ikúgbaèyí	sad	None
ileobaluaye	svijet	None
imoero	osvjetljavanje	Nan
imojuto	briga	Nan
imusin	izvući	Nan
irele	poniznost	Nan
ire	rasprodaja	Nan
iranlose	pomoć	None
iraja	šokantno	Nan
ipá	silu	None
ipo	lokaciju	Nan
ipinu	odluku	None
ipinpa	učešće	None
ipin	poglavlje	Nan
ipele	nivoa	None
ipawo	koristi	None
ipare	bledi	Nan
iowa	zemlji	None
ioniani	potrebi	None
ioja	riba	None
inúnibíni	progon	Nan
iní	nasljedstvo	Nan
inágbéringbérin	sedamnaest	Nan
integration	integracija	Nan
inkosi	opravdati	Nan
indus	indus	Nan
indeed	zaista	None
inagberingberi	kikiriki	Nan
imúnisìn	higijena	Nan
imú	nosa	Nan
ikoreokere	žetva	Nan
ọ̀sẹ	sedmicu	Nan
