aajo	హాస్యాస్పదంగా	Nan
púpò	కాకుండా	None
púpo	ఎక్కువ	None
pò	రెట్లు	None
pòwe	సామెతలు	None
pípẹ́	దీర్ఘ	None
pípèsè	నియమం	None
pípa	స్లాటర్	Nan
péé	ఆ	None
péré	మాత్రమే	None
pé	ఆ	None
pèsè	అందించిన	None
quran	quran	Nan
pèlúpèlú	అలాగే	None
pèhìndà	వీర్యం	Nan
pè	అని	None
pátáporongodo	ఖచ్చితంగా	Nan
pásíà	నేలమాళిగ	Nan
pàápàá	ముఖ్యంగా	None
pààlà	సరిహద్దు	None
pàràkòyí	తక్షణమే	Nan
pàmò	ప్రత్యేకంగా	None
px|kùránì	కెర్నల్	None
pupa	ఎరుపు	None
príncipe	ప్రిన్సిపి	Nan
pèlu	పాటు	None
providence	భగవత్	Nan
ra	కొనుగోలు	None
rajya	ఆశిస్తున్నాము	Nan
rome	క్రోమ్	Nan
roma	రోమా	Nan
roko	మాబ్	Nan
rokirika	బ్రౌజింగ్	Nan
rogbodiyan	అల్లర్లు	Nan
roboto	ఉపరితలాలు	Nan
robinson	రాబిన్సన్	Nan
ro	అనుకుంటున్నాను	Nan
rnas	rnas	Nan
rnarna	rnarna	Nan
rna	rna	Nan
race	రేసు	Nan
rn	rn	Nan
riresile	రికార్డర్	Nan
rinle	కొత్తగా	None
right|thumb|px|aworan	చిత్రం	None
richard	రిచర్డ్	None
research	పరిశోధన	None
rere	మంచిది	None
repetejulo	అత్యంత	None
repeats	రిపీట్స్	Nan
reggae	రెగె	Nan
rank	ర్యాంక్	Nan
ramadan	రంజాన్	None
riro	ఊహ	None
ronald	రోనాల్డ్	Nan
proton	ప్రోటాన్	Nan
produced	ఉత్పత్తి	None
palauan	పాలుఆన్	Nan
padá	పాడ్	Nan
paapaa	ముఖ్యంగా	None
paa	ఆపివేయండి	Nan
opolo	అనేక	None
ofò	శుభోదయం	Nan
oyé	ప్రపంచం	None
ose	ose	Nan
opolo	అనేక	None
omonìyàn	మనుషులు	None
olorun	దేవుడు	None
panaˈma	పనామా	Nan
odun	వార్షిక	None
olórun	దేవుడు	None
okùnrín	నవ్వు	Nan
ojó	పడుతుంది	None
odún	సంవత్సరం	None
oúnjẹ	ఆహార	None
owojagidijagan	తీవ్రవాదుల	Nan
oun	అతను	None
otutu	అనేక	None
otherwise	లేకపోతే	None
oseluarailu	పౌర	None
oscar	ఆస్కార్	Nan
olósìn	మత	None
protokolu	protocolu	Nan
panyanan	స్పేస్	None
parapọ̀	మిశ్రమం	None
press	పత్రికా	None
portuguese	portuguese	Nan
portonovo	portonovo	Nan
population	జనాభా	None
polaroid	పోలరాయిడ్	Nan
polandi	పోలిష్	Nan
pojulo	ఎత్తైన	Nan
po	పో	Nan
plánẹ́tì	ప్లంబింగ్	Nan
platos	ప్లేటో	None
piposi	చాలా	None
papa	పాపా	Nan
pipolongo	ప్రకటన	None
pinu	నిర్ణయిస్తారు	None
pinsoto	pinoto	Nan
pinsi	క్షీణిస్తున్న	Nan
phillipines	phillipines	Nan
pelu	పెర్ల్	Nan
petu	petu	Nan
periferi	periferi	Nan
penisula	పెనిసులా	Nan
penh	పెన్	Nan
pele	అందమైన	Nan
paripari	ముగింపు	Nan
pipo	చాలా	None
rorùn	సులభంగా	None
rossii	rossii	Nan
rural	గ్రామీణ	None
sìbẹ̀	ఇంకా	None
séyìn	తిరిగి	None
séyìn	తిరిగి	None
sénégal	వీర్యం	Nan
ségun	ఏడుపు	Nan
sèle	దొంగిలించడం	Nan
são	క్రొత్తది	Nan
sáààrin	మధ్యలో	None
sáàpàdé	స్పాన్సర్షిప్	Nan
sápadè	రోజు	None
sàì	బాగా	None
sìni	రొయ్యలు	Nan
sàngó	ముఠా	Nan
sàmì	గుర్తు	None
sàbúrí	పైవన్నీ	Nan
symmetry	సమరూపత	Nan
swahili	swahili	Nan
suny	suny	Nan
sun	సూర్యుడు	None
sugbọ́n	హేతుబద్ధమైన	Nan
sugbo	కాదు	None
suez	సూయజ్	Nan
structures	నిర్మాణాలు	None
stella	స్టెల్లా	Nan
sàn	మంచి	None
spectacular	అద్భుతమైన	Nan
síbèsíbè	అయితే	None
sílẹ̀	అణగదొక్కండి	Nan
tabora	ఎగవేత	Nan
tabili	పట్టిక	Nan
tabi	లేదా	None
sísè	అనువాదం	None
sísa	s .ía	Nan
sááju	పడుతుంది	None
sisé	పని	None
sepò	చివరకు	None
se	చేస్తారు	None
sùgbón	విరుద్ధంగా	None
síse	నిర్మాణం	None
síbú	నేలకి	Nan
si	ఖచ్చితంగా	Nan
sùgbón	విరుద్ధంగా	None
sóko	మొక్క	None
sójà	సైనికుడు	Nan
sòrò	వత్తిడి	None
síí	ఇక్కడ	None
síwájú	ముందుకు	None
síwon	వాటిని	None
síta	బయట	None
síso	ఇప్పటికీ	None
síso	ఇప్పటికీ	None
síse	పని	None
sọ	సే	Nan
so	కాబట్టి	None
sopin	ముగింపు	Nan
soon	త్వరలో	None
say	సే	Nan
santa	శాంటా	Nan
samioro	అందుబాటులో	None
sambia	యువత	Nan
salàyé	జీవితం	None
salem	సేలం	Nan
sakyas	sakyas	Nan
sakyamuni	తదుపరి	None
saheli	సౌలభ్యం	None
safta	వరుసలో	None
safiwe	పోలిక	None
sb	sb	Nan
saffana	నీలం	None
saarland	నేలపై	None
saaree	ఉన్నతమైన	Nan
saarc	తొలగిస్తాయి	Nan
rẹ	ఆమె	None
ròyìn	నివేదించారు	Nan
rìn	నడవడానికి	Nan
ré	సి	Nan
république	république	Nan
ránmú	ఆందోళన	None
ráhàn	కనిపించింది	None
ryan	ryan	Nan
safari	సఫారీ	Nan
schwarz	ష్వార్జ్	Nan
sea	సముద్ర	None
seat	సీటు	Nan
solomon	సోలమన్	Nan
sohun	అవును	None
so	ప్రేమ	None
slovo	slovo	Nan
sisupo	గుణకారం	Nan
sisupapoerekusu	ఉమ్మివేయటం	Nan
sisopo	లింకింగ్	Nan
sisodagba	పెరుగుతోంది	Nan
sise	వంట	None
sioux	sioux	Nan
sinsin	మతం	None
sinai	పాపం	None
silè	చుక్కల	Nan
sile	వెనుక	None
sihamoni	నిర్మాణం	None
sibesibe	ఇంకా	None
sharon	sharon	Nan
sewadi	వెతకండి	Nan
seville	సెవిల్లె	Nan
sense	భావం	None
senegal	సెనెగల్	Nan
semudaju	యొక్క	None
semolara	ఆస్తమా	Nan
seidamo	స్పష్టమైన	Nan
segbese	బహుశా	None
orúko	స్థలము	None
taino	రక్తవర్ణం	Nan
orísìírísi	వివిధ	None
orísiirísi	వివిధ	None
nombamewa	గుణించడం	Nan
nobel	నోబెల్	None
nnaji	మామయ్య	Nan
nkàn	కాన్సర్	None
nkan	విషయం	None
niyi	ఇదిగో	Nan
niye	చాలు	None
niyato	వేరు	None
niwaju	ముందుకు	None
nitosi	సమీపంలోని	Nan
nitoripe	ఎందుకంటే	None
nombáméjì	రెండు	None
nitoriidieyi	దీనివల్ల	None
nilè	ఇక్కడ	None
nijẹr	నైక్	Nan
nigbà	అప్పుడు	None
nigbakan	కొన్నిసార్లు	None
nibere	ప్రారంభ	None
nibe	అక్కడ	None
ngubengcuka	ngubengcuka	Nan
ngbero	అనుకున్న	Nan
nevis	నెవిస్	Nan
neptune	నెప్ట్యూన్	Nan
nefimu	nephim	Nan
nisinyi	ఇప్పుడు	None
nebraska	నెబ్రాస్కా	Nan
novo	నోవో	Nan
nse	రూపకల్పన	None
nínlá	గొప్ప	None
nílẹ̀	మీద	None
nílùú	నగరంలో	None
nílè	క్రింద	None
nígbàtí	ఎప్పుడు	None
nífẹ̀ẹ́	ప్రెమించదానికి	Nan
níbè	అక్కడ	None
níbè	అక్కడ	None
ní	కలిగి	None
nìyí	ఇదే	None
nìnú	క్షమించండి	Nan
nri	ఆహార	None
nì	మౌంటైన్	Nan
náwo	వ్యయం	None
nàìjíríà	నైజీరియాలో	Nan
nwa	బేబీ	Nan
numeri	తిమ్మిరి	Nan
nukleotidipupo	న్యూక్లియోటైడ్	Nan
nukleotidi	న్యూక్లియోటైడ్	Nan
nu	శుభ్రంగా	Nan
ntoka	పాయింట్	Nan
nsowikipedia	obowikipedia	Nan
nsolaboraro	భద్రతా	None
nso	సమీపంలో	None
náà	చాలా	None
nínu	క్రీడల్లో అవకాశాలు	Nan
ncnc	ncnc	Nan
nawojulo	అయోమయంగా	Nan
munispal	munispal	Nan
mulẹ̀	ఏర్పాటు	None
mughal	వాల్యూమ్	Nan
mtwara	మళ్ళీ	None
mtn	mtn	Nan
mozilla	మొజిల్లా	Nan
mozambique	మొజాంబిక్	Nan
morogoro	వాహన	None
morgan	మోర్గాన్	Nan
monrovia	monrovia	Nan
mombasa	మొంబాసా	Nan
muungano	muungano	Nan
mokanlelogbon	రెండు	None
mohandas	మోహన్దాస్	Nan
minority	మైనారిటీ	Nan
minnesota	minnesota	Nan
mimuwa	తగులుకున్న	Nan
mimoy	mimoy	Nan
miiràn	ఉపశమనానికి	Nan
micronesia	మైక్రోనేషియా	Nan
michelle	మిచెల్	Nan
mexico	మెక్సికో	None
mewar	మేవార్	Nan
meucci	మెస్సీ	Nan
mokaleladota	కాంపాక్ట్	Nan
nawó	డబ్బు	None
májèmú	పర్వాలేదు	Nan
méjèèjì	రెండు	None
nato	nato	Nan
nathaniel	నాథనీల్	Nan
namibia	వచ్చిన	None
mẹ́talọ́kan	త్రిమూర్తులు	None
mẹ́ta	మూడు	None
mẹ́rkúríù	ఎలుక	None
mẹ́fà	ఆరు	None
múlẹ̀	త్వరగా	None
mó	m	Nan
móra	నివారణ	None
mókólà	గ్లూ	Nan
mère	డ్రాయింగ్	Nan
mò	జ్ఞానం	None
míìrán	మరో	None
míràn	మరో	None
mímọ́	పవిత్ర	None
ménu	మీరు	None
méwàá	పది	None
métèètà	కార్పెంటర్	Nan
méta	మూడు	None
mérìnlélógójì	నాలుగు	None
mérìndínlógún	పదహారు	None
méte	ఐదు	None
mérindíláàdóta	ఐదు	None
mííràn	మరో	None
níní	కలిగి	None
nípà	కనీసం	None
nítorípé	ఎందుకంటే	None
onítumò	అనువాదకుడు	Nan
oníná	ఫైర్	Nan
onílẹ̀	డౌన్	None
oníkólóbó	అసంబద్ధం	Nan
onígbàgbó	ముసలివాడు	Nan
onka	కాలిక్యులేటర్	Nan
onje	ఆహారం	None
oniyijulo	అద్భుతంగా	None
oniyewumeji	బైనరీ	Nan
onisowo	వ్యాపారి	Nan
onisayensi	టెక్నీషియన్	Nan
onítèbọmi	తీసుకున్నారు	None
onipin	హేతుబద్ధమైన	Nan
onilile	గృహ	None
onilanaibagbepo	కండోమ్	Nan
onigunfenfe	నిష్క్రియాత్మ	Nan
onigbowo	స్పాన్సర్	Nan
onigbeja	నిర్మాణాత్మక	Nan
onibugbe	కౌలుదారు	Nan
onialjebra	onialjebra	Nan
omiadalu	వరద	None
omi	నీటి	Nan
olùkọ́	గురువు	None
olùkó	బోధకుడు	Nan
oninawo	రుణగ్రహీత	Nan
olùkópa	కంట్రిబ్యూటర్	Nan
onítòhùn	అకౌంటెంట్	Nan
oníyanjù	యానిమేటెడ్	Nan
orílẹ́	సాయంత్రం	None
orílẹ̀	దేశం	Nan
orílèèdè	దేశం	Nan
oríkì	కవిత్వం	None
oríilẹ̀	వ్యాసం	None
oríilè	జాతీయ	None
oruko	నామవాచకం	Nan
orudnun	వార్షిక	None
oritameta	మధ్యలో	None
orisa	మూలాలు	None
orisun	మూలం	None
oníwòsàn	వైద్యుడు	Nan
orisirisi	వివిధ	None
orileominira	వెచ్చదనం	Nan
orilejoba	ప్రభుత్వం	None
orileedeajoba	సామ్రాజ్యవాద	Nan
orileede	ఒక	None
oriki	ఓరియంటల్	Nan
oriire	అభినందనలు	Nan
ori	తల	None
opposite	వ్యతిరేక	None
opec	opec	Nan
ootọ́	నిజమైన	Nan
ooni	మొసలి	Nan
orinìyìn	పాట	None
olùdarí	నాయకుడు	None
olùbátan	పరిచయం	None
olóṣèlú	రాజకీయ	None
ojùkòsì	వర్షపాతం	None
ojuse	బాధ్యత	None
ojuoorun	సూర్యాస్తమయం	Nan
ojukokoro	దురాశ	Nan
ojoru	వెచ్చదనం	Nan
ojojumo	రోజువారీ	None
ojo	ఉంటుంది	None
ogunlogo	ప్రేక్షకులు	None
ogun	యుద్ధం	None
ogbè	ప్రాంతం	None
ofin	చట్టం	None
ojùkòtúu	వర్షపాతం	None
ododo	ధర్మానికి	Nan
obere	చిన్న	None
obairanderan	బంధువు	Nan
oba	ఒబామా	Nan
nso	త్వరలో	None
nǹkan	విషయం	None
níyanjú	సానుకూలంగా	Nan
níwájú	ముందుకు	None
nítòótọ́	నిజానికి	None
nítòótó	ఖచ్చితంగా	Nan
nítòsí	సమీపంలోని	Nan
nítumò	అర్థం	None
obínibí	మర్యాద	Nan
ojúlùmọ̀	పరిచయాలు	Nan
ojútáyé	స్నిగ్ధత	Nan
ojúìwé	పేజీ	None
olóyè	పాలకుడు	None
olódùmarè	దేవుడు	None
olympus	ఒలింపస్	Nan
oluwakiri	అన్వేషణ	None
olusoju	గార్డు	Nan
oluparapo	కలయిక	None
olumojuto	అత్యాశకరమైన	Nan
olukowe	రచయిత	None
olukoitan	బోధకుడు	Nan
oludase	నిర్మాత	None
oluda	సృష్టికర్త	None
oloye	మేధావి	Nan
oloselukan	హలో	None
olora	కొవ్వు	None
olopon	గర్వముగల	Nan
ololugbe	ఓటమి	None
olokunkun	హెడ్ఫోన్స్	Nan
olojukanna	తక్షణమే	Nan
olohun	యజమానులు	Nan
olodiajodojuko	ఒకరికొకరు	Nan
okunrin	మనిషి	None
okunkun	చీకటి	None
oko	ఫీల్డ్	None
okhotsk	ఓఖోట్క్	Nan
okeere	విదేశీ	None
orísìí	వివిధ	None
tainos	టైనోస్	Nan
takuntakun	అవరోధాల	Nan
talaka	పేద	None
ìràwọ̀	నక్షత్రాలు	None
ìrànàna	సహాయం	None
ìrànlọ́wọ́	సహాయం	None
ìpínrò	పేరాలు	Nan
ìpìnlè	ప్రారంభం	None
ìpìlẹ̀núkléù	ఎన్క్రిప్షన్	Nan
ìpolongo	ప్రకటనలు	None
ìnáwó	వ్యయం	None
ìnagije	విజయం	None
ìmúsára	చేయడానికి	None
ìmúnilérú	వేధింపులను	Nan
ìrí	అనుభవం	None
ìmú	ముక్కు	None
ìmò	మెరుపు	Nan
ìmò	పాము	Nan
ìlé	హోమ్	None
ìlè	లంచం	Nan
ìlàìnàró	అణచివేతకు	Nan
ìlàorùn	గాయాల	Nan
ìlànàn	భ్రాంతిని	Nan
ìlà	చుట్టుగీత	Nan
ìlo	కాల్	Nan
ìlera	ఆరోగ్య	None
ìkọpa	పాల్గొనడం	Nan
ìmóbìdo	జన్మహక్కు	Nan
ìkẹrin	నాల్గవ	None
ìròkò	ఆలోచన	None
ìròyìnwiki	వార్తలు	None
ìtaeko	వర్క్	None
ìta	బయట	None
ìse	చర్య	None
ìsòro	కష్టం	None
ìsílé	హోమ్	None
ìsèjoba	ప్రభుత్వం	None
ìsèdá	సృష్టి	None
ìsègbèfábo	శ్రద్ధ	None
ìse	చర్య	None
ìsọ	దుకాణాలు	None
ìsú	మందం	Nan
ìròyìn	వార్తలు	None
ìsòrí	ఉపశీర్షిక	Nan
ìsìn	మతం	None
ìsèlè	ఉత్పత్తి	None
ìsàlè	సూర్యాస్తమయం	Nan
ìsomó	చేరడానికి	None
ìsirò	లెక్కింపు	Nan
ìsinsìnyí	ఇప్పుడు	None
ìse	చర్య	None
ìsawo	భవిష్యవాణి	Nan
ìrúbo	పతనం	None
ìró	ధ్వని	None
ìròrùn	భ్రాంతిని	Nan
ìsòrò	ధ్యానం	None
ìtan	చరిత్ర	None
ìkínin	ఆరవది	Nan
ìkìjà	సవాలు	None
ìdá	పారిపోవటం	Nan
ìdàrúdàpò	ఖోస్	Nan
ìdàpapọ̀	ఏకీకరణ	Nan
ìdàgbà	యుక్తవయస్సు	Nan
ìbílè	జన్మహక్కు	Nan
ìbílè	జన్మహక్కు	Nan
ìbáraeni	క్యారేజ్	Nan
ìbánisòrò	కనెక్షన్	Nan
ìbarà	జ్వరం	None
èpón	చాలా	None
èwù	చొక్కా	None
ìdìmú	భంగం	Nan
èsìn	మతం	None
èro	ఆలోచనలు	None
èka	ప్రభావం	None
èyì	గౌరవం	None
ète	ప్రయోజనం	None
èsúrú	చీమలు	None
èsó	మసీదు	None
èrò	ఆలోచనలు	None
èràn	వ్యాధి	None
ènìkan	ఏదో	None
èlò	పాత్రలకు	Nan
èkejì	ఇతర	None
èrí	సాక్ష్యం	Nan
ìkìlò	తిట్టు	Nan
ìdíisin	కారణం	None
ìdó	స్టింగ్	Nan
ìkéde	డిక్లరేషన్	Nan
ìkèrèkú	రద్దీ	None
ìkànna	అదే	None
ìkejì	ఇతర	None
ìjọba	ప్రభుత్వం	None
ìjò	నాయకుడు	None
ìjìnlè	మిస్టరీ	Nan
ìjìnlè	మిస్టరీ	Nan
ìjora	ద్వేషం	None
ìjoba	ప్రభుత్వం	None
ìjo	చర్చి	None
ìdíwòn	కారణం	None
ìjo	నృత్యం	None
ìgbò	రామ్	None
ìgbésí	జీవితం	None
ìgbéraga	అహంకారం	Nan
ìgbáraga	బలం	Nan
ìgbá	రెక్కలు	None
ìgbàgbé	మతిమరుపు	Nan
ìgbà	సమయం	None
jé	విపత్తు	None
ìfáàrà	పూజారి	None
ìfojúìtànìgbesiayé	చరిత్ర	None
ìfara	హింస	None
ìhun	ఇనుము	None
ìtokò	కుండ	Nan
ìtàn	చరిత్ర	None
ìtànkálé	వరదలు	None
ṣàkóbá	హానికర	Nan
ṣiṣé	ప్రారంభ	None
σ	σ	Nan
κάππα	.α	Nan
ˌæləˈbæmə	రోగము	Nan
ˌkælɪˈfɔrnjə	ɪkælɪfɔrnjə	Nan
ˈøːstəˌʁaɪç	øːstəˌʁaɪç	Nan
ʔaːnaːtɕɑ̀k	.aːnaːtɕɑɕɑk	Nan
şe	అలా	None
únṣẹlẹ̀	భూకంపం	None
ôdún	ఇయర్	None
ẹdo	జోక్	Nan
ó	అవును	None
ósírísì	లాలాజలం	Nan
óníse	అతను	None
ó	ఇది	None
òròàjòmó	ఉదయం	None
òrò	ఆలోచనలు	None
òwó	డబ్బు	None
òsà	గోల్డ్	None
òrò	ఆలోచనలు	None
òré	గేమ్	Nan
òpòlopo	అనేక	None
òfò	తదుపరి	None
ósékú	అతను	None
òré	గేమ్	Nan
ẹlẹ́bùn	బహుమతి	None
ẹnìkan	వ్యక్తి	None
ọ̀pòlòpò	చర్య	None
ọ̀nà	మార్గం	Nan
ọ̀gbìn	మొక్క	None
ọ̀dọ́	యువత	Nan
ọpọ́lọpọ́	పండ్లను	None
ọn	ఇది	None
ọmọ	పిల్లల	None
ọmú	మీరు	None
ọlọ́run	దేవుడు	None
ọlọ́mọ	పిల్లలు	None
ọdún	సంవత్సరం	None
ẹlẹ́sìn	మత	None
ọbàkàn	సోదరుడు	None
ẹ̀rọ	యంత్రాలు	None
ẹ̀ni	who	Nan
ẹ̀kọ́	చదువు	None
ẹ̀kẹ́ta	మూడవది	None
ẹ̀kasístẹ̀mù	ఆత్మాశ్రయ	Nan
ẹ̀kaoṣù	విసుగు పుట్టించెడు	Nan
ẹ̀kajuly	మే	None
ẹ̀kabrítánì	మామయ్య	Nan
ẹ̀kaawon	సమర్పణలు	Nan
ẹtì	కాలేయం	None
ẹsẹ	అడుగుల	Nan
ẹ̀wẹ̀	మరోవైపు	None
òpòlopò	అనేక	None
òkòòkan	ఒక్కొక్కటిగా	Nan
òkan	ఒకటి	None
òdo	యువత	Nan
òdeojú	అనామకుడిగానే	Nan
òde	బయట	None
ìṣọ̣̀tẹ̣̀	న్యుమోనియా	Nan
ìṣẹ́kù	మిగిలినవి	None
ìṣèlú	రాజకీయాలు	None
ìyípadà	మార్పిడి	None
ìyàwó	వధువు	Nan
ìyapa	వేరు	None
ìya	బాధ	None
ìwúlò	ఉపయోగకరమైన	Nan
òdìkejì	ఇతర	None
ìwòran	దృష్టి	None
ìwéré	బుక్లెట్	Nan
ìwàásù	బోధన	None
ìwo	కొమ్ములు	Nan
ìwe	పోలిక	None
ìtúpalè	అనువాదం	None
ìtúmò	అనువాదం	None
ìtóka	కొట్టబడాలి	Nan
ìtójú	ముఖ	None
ìtóju	గందరగోళం	Nan
ìtójú	సంరక్షణ	None
ìtèsíwájú	పురోగతి	None
ìwò	మొత్తం	None
òféàrán	చిత్రం	None
ògbójú	సమర్థ	Nan
ògiri	గోడ	None
òjògbón	వాతావరణము	None
òṣèlú	రాజకీయాలు	None
òwù	గుడ్డ	Nan
òsèré	అథ్లెట్	Nan
òsèlú	రాజకీయ	None
òsán	మధ్యాహ్నం	None
òrò	మె ద డు	Nan
òrí	అధ్యాయము	Nan
òrìsà	విగ్రహాలను	None
òranyàn	తప్పనిసరిగా	None
òpópóònà	త్రోవ	Nan
òotó	నిజం	None
òní	నేడు	None
òmùàrán	చిత్రం	None
òmiràn	మాంత్రికుడు	Nan
òle	గృహిణి	Nan
òkúta	రాయి	None
òkú	శవాలు	Nan
òkòòkan	ఒక్కొక్కటిగా	Nan
òkèògbún	వెయ్యి	None
òjísé	వైద్యుడు	Nan
òjo	ఉంటుంది	None
ògúndìpẹ̀	బూజు	Nan
ògun	మందు	None
ògo	గ్లోరీ	Nan
èka	శాఖ	None
èhìn	తదుపరి	None
èfòn	కాలం	None
èdè	భాష	None
visit	పర్యటన	None
viruses	వైరస్లు	Nan
villa	విల్లా	Nan
vihara	విహార	Nan
videos	వీడియోలను	Nan
victor	విక్టర్	Nan
vermont	వెర్మోంట్	Nan
venezuela	వెనిజులా	Nan
uzbek	మార్గం	Nan
utc	utc	Nan
utah	utah	Nan
vz	వజ్	Nan
usps	usps	Nan
urasílì	uracil	Nan
unla	అవును	None
unifasiti	విశ్వవిద్యాలయ	None
umueri	పిల్లలు	None
ucb	ucb	Nan
tẹ̀ǹbẹ̀lẹ̀kun	కుట్ర	Nan
tẹ̀ǹbẹ̀	అప్పుడు	None
túnse	మళ్లీ	None
túmò	ప్లం	Nan
tú	బయట	None
tóka	సైటెడ్	Nan
uribe	ప్రకాశం	None
tó	tó	Nan
waa	అది	None
wari	వాసన	None
yafran	ఇది	None
xiv	xiv	Nan
xd	xd	Nan
wọ̀nyí	ఈ	None
wọn	వాటిని	None
wúnrèn	వర్కవుట్	Nan
wón	వాటిని	None
wònyí	ఇవి	None
wòfún	చూపులో	Nan
wípè	స్పష్టత	Nan
wì	కడిగివేయు	Nan
waju	ముఖం	None
wàásù	బోధించాలని	Nan
wura	బంగారం	None
won	వాటిని	None
wo	ఇక్కడ	None
wo	ఇక్కడ	None
woo	వూ	Nan
wole	ఇన్	None
województwo	cheworddztwo	Nan
wiwari	ఆవిష్కరణ	Nan
witkin	విత్కిన్	Nan
wisconsin	విస్కాన్సిన్	Nan
westminster	వెస్ట్మిన్స్టర్	Nan
wyoming	wyoming	Nan
tówùú	మొత్తం	None
tókù	విశ్రాంతి	None
tódárajùlọ	అత్యుత్తమమైన	Nan
tokyo	టోక్యో	Nan
tokasi	చూపారు	None
toje	అరుదైన	Nan
to	కు	None
tiwọn	వారిది	Nan
titu	షూట్	Nan
tirè	తన	None
tirana	టిరాన	Nan
tira	కాలం	None
thumb|left|upright|nelson	నెల్సన్	None
those	ఆ	None
tolerejulo	ఉపేక్షించేవారు	Nan
they	వాళ్ళు	None
tfrac	tfrac	Nan
terutomo	terutomo	Nan
temptation	కోరుతూ	None
tele	అనుసరించండి	Nan
teksas	టెక్సాస్	Nan
tedo	డేటింగ్	Nan
technology	సాంకేతికం	Nan
taínos	టైనోలు	Nan
tata	వడపోత	Nan
tara	తొమ్మిది	None
talika	పేదరికం	None
the	ది	None
tolórítelémù	హోలోకాస్ట్	Nan
tomé	టమోటా	Nan
tooto	నిజంగా	None
tóbi	పెద్ద	None
tò	సెట్	Nan
tíórì	టైర్లు	Nan
tíátà	టిక్కెట్లు	Nan
títío	వరకు	None
títèlé	అనుసరించుట	Nan
títi	క్లోజ్డ్	Nan
té	t	Nan
télè	ద్వారా	None
té	t	Nan
tèsíwájú	సాధించడానికి	None
tèlé	తక్షణమే	Nan
tètè	త్వరగా	None
tèlé	అనుసరించండి	Nan
táawà	నమస్కరించడానికి	Nan
tàwon	వాటిని	None
tàsí	లేకుండా	None
tuntun	కొత్త	None
tumosi	అంటే	None
translated	అనువాదం	None
traduite	traduite	Nan
tounsejanu	విషాద	None
toseluaralu	రాజకీయ	None
torun	స్త్రీని	None
tori	టోరి	Nan
yakubu	yakub	Nan
metropoli	metropoli	Nan
yan	ఎంచుకోండి	Nan
yanturu	పుష్కలంగా	None
àsìkò	సమయం	None
àsèyìn	పరిణామాల	Nan
àsàjemátèe	డాన్	None
àse	విందు	None
àrẹ	అధ్యక్షుడు	None
àrùn	వ్యాధి	None
àrígbámú	కలవరం	Nan
àpeere	ఉదాహరణ	None
àpapọ̀	మొత్తంగా	None
ànfàní	అవకాశం	None
àmúsorò	మనస్తత్వశాస్త్రం	Nan
àsótélè	పొడిగింపు	Nan
àmúlò	ఆచరణాత్మక	Nan
àmérìkà	అతీంద్రియ	Nan
àlébù	నిర్దోషమైన	Nan
àlèpò	పైన	Nan
àlè	బాస్టర్డ్	Nan
àlááfià	సారూప్యత	Nan
àlàáfíà	శాంతి	None
àlàyé	సమాచారం	None
àlàkalè	గోల్స్	Nan
àkókó	సమయం	None
àkójopò	సమూహం	None
àká	అల్మారాలు	Nan
àmì	సైన్	Nan
àkàrà	కేకులు	Nan
àsọdọ̀kan	ఐక్యత	Nan
àsà	కస్టమ్	Nan
èdè	భాష	None
èdá	సృష్టి	None
èbúté	పోర్ట్	None
èbà	దోమలు	Nan
áwon	సంబంధం	None
án	t	Nan
àìsí	లేకపోవడం	None
àìròtélè	ఊహించని	None
àìní	కావలసిన	None
àìkó	లోపం	None
àáyá	వీర్యం	Nan
àsekúdórógbó	బెరడు	None
àárín	మధ్యలో	None
ààtò	కర్మ	None
àwùjo	సమాజం	None
àwón	డబ్బు	None
àwón	డబ్బు	None
àwon	సిద్ధాంతాలు	None
àtẹnudẹ́nu	మౌఖిక	Nan
àtúnse	మార్చు	Nan
àtúnse	మార్చు	Nan
àtòrìnká	చుట్టూ	None
àtìpó	గ్రహాంతర	None
àtijo	వాడుకలో	None
ààyè	సజీవంగా	None
àkosílè	థీసిస్	Nan
àkosílè	సంగ్రహణం	Nan
àjọṣepọ̀	సామాజిక	None
yíì	మీరు	None
yíyípadà	మార్పు	None
yí	చుట్టూ	None
yìí	ఈ	None
yì	వెళ్ళండి	Nan
yée	వాళ్ళని చేయనివ్వు	Nan
yèwò	లుక్	Nan
yára	త్వరగా	None
yàtò	ఏర్పాటు	None
yànan	ఆశర్యం	Nan
yo	yo	Nan
yíò	అది	None
yorúbà	పెరుగు	None
yori	దారితీసింది	None
yoo	రెడీ	Nan
yiyafunnilo	కోతను	Nan
yipada	చుట్టూ	None
yiowu	అది	None
yio	వలెను	Nan
yindinyindin	ఎన్నటికి ఆపకు	Nan
ye	అవును	None
ye	అవును	None
yewo	మెరుగుదల	Nan
yaoundé	యౌండే	Nan
york	యార్క్	Nan
yẹ̀ẹ́	కుశలమా	Nan
yọ	తొలగిస్తాయి	Nan
zanzibar centralsouth	జాంజిబార్ సెంట్రల్‌సౌత్	Nan
àjákọ	కాకుండా	None
àjo	ప్రయాణ	None
àifète	ప్రయోజనం	None
àgọ́	డేరా	Nan
àgbùdo	యార్డ్	Nan
àgbìgbò	పొరుగు	None
àgbéyèwò	సమీక్ష	Nan
àgbékà	నైరూప్య	Nan
àgbáríjọ	సంస్థ	None
àgbàrá	వరద	None
àgbàjọ	వాడు	None
àdóolóró	ఆయిల్	None
àdáátán	ప్రత్యేక	None
àdátá	వ్యతిరేకం	Nan
àdámò	గోప్యతా	Nan
àbọ̀	సగం	None
àbìkú	అమరత్వం	Nan
àbáyo	సలహా	None
àbámẹ́ta	గురువారం	Nan
àbe	బబూన్	Nan
bce	దూరంగా	None
zy	zy	Nan
zscores	zscores	Nan
zou	zou	Nan
zdna	zdna	Nan
yanjú	సంకల్పము	Nan
methodologies	పద్ధతులు	None
merin	నాలుగు	None
mercosur	మెర్కోసర్	Nan
díè	కాలం	None
dìtẹ̀	కుట్ర	Nan
dìró	కుడి	None
dìde	ఉత్పన్నమయ్యే	Nan
dì	షీట్	Nan
dépò	వరకు	None
délànà	లో	None
dé	వచ్చారు	None
dáwó	దానం	None
dásà	ఒక	None
dáradára	బాగా	None
dóko	మంచిది	None
dálóríi	ధన్యవాదాలు	Nan
dágbó	వయస్సు	None
dá	రూపొందించినవారు	Nan
dàpò	భర్తీ	None
dàbíi	ఇలా	None
dun	రుచికరమైన	Nan
due	వలన	None
du	డు	Nan
dover	డోవర్	Nan
doublestrand	doublestrand	Nan
doublehelix	doublehelix	Nan
dote	అతిగారాబం కనబరచు	Nan
dájó	ఆల్రైట్	Nan
doni	దోని	Nan
dólà	బాగా	None
dúró	నిలబడటానికి	Nan
eléré	అథ్లెట్	Nan
eléde	నైరూప్య	Nan
elláda	సృష్టి	None
eleyii	ఇలా	None
eleyi	ఈ	None
elede	పందులు	Nan
eko	చదువు	None
ekeji	ఇతర	None
eka	క్లిష్టమైన	Nan
eighteen	పద్దెనిమిది	Nan
egbògi	వైద్య	Nan
dún	ధ్వని	None
egbò	గాయం	None
egbo	గాయం	None
egberundun	సంవత్సరాలు	None
egbe	తుపాకీ	None
egba	ఖచ్చితంగా	Nan
efrem	effem	Nan
ede	భాష	None
ecomog	ecomog	Nan
ebi	కుటుంబం	None
eba	eba	Nan
ea	అవును	None
dọ́gba	సమాన	None
egbé	దుఃఖకరమైన	Nan
elòmírà	సముద్రపు	None
dominic	డొమినిక్	Nan
doju	ముఖా ముఖి	Nan
clear	స్పష్టమైన	Nan
cipollone	cipollone	Nan
china	చైనా	Nan
cherished	ప్రతిష్టాత్మకమైన	Nan
chebbi	అనుకుంటున్నాను	Nan
chaskalson	chaskalson	Nan
charles	చార్లెస్	None
chamorro	చమర్రో	Nan
cbc	cbc	Nan
cauchy	cauchy	Nan
catherine	కాథరిన్	Nan
code	కోడ్	None
cathedral	కేథడ్రల్	Nan
casablanca	కాసాబ్లాంకా	Nan
cape	కేప్	Nan
canaria	కానరియా	Nan
calabar	నమిలే జిగురు	Nan
cairo	rage	Nan
bẹ́ẹ̀sìni	అవును	None
bẹ́ẹ̀ni	అవును	None
bẹ́ljíọ̀m	గరుడపచ్చ	Nan
bẹ́	విరిగింది	Nan
bẹ̀rẹ̀	ప్రారంభించడానికి	Nan
búrú	ధైర్యంగా ఉండు	Nan
caslon	కాసినో	Nan
dojú	ముఖా ముఖి	Nan
coetsee	coetsee	Nan
coming	వచ్చే	None
divoire	divoire	Nan
dinwoju	చూడు	None
din	వేసి	None
different	వివిధ	None
didasile	స్థాపన	None
didagba	సమానత్వం	None
development	అభివృద్ధి	None
desmond	డెస్మండ్	Nan
describes	వివరిస్తుంది	None
des	డెస్	Nan
denver	డెన్వర్	Nan
coloured	రంగు	None
delhi	వద్దు	Nan
daru	నాశనం	None
darapo	చేరడానికి	None
dani	పట్టుకొని	None
dandan	తప్పనిసరి	None
dagbasoke	ఎదుగు	Nan
da	మరియు	None
cunha	గొంతు	None
ct	ct	Nan
csto	csto	Nan
computers	కంప్యూటర్లు	None
compared	పోలిస్తే	None
dates	తేదీలు	Nan
elòmíràn	మరో	None
emerging	ఉద్భవిస్తున్న	Nan
emmanuel	ఇమ్మాన్యూల్	Nan
gbaná	అవుట్	None
gbale	ప్రజాదరణ	None
gbajúgbujà	పొందింది	None
gba	అంగీకరిస్తున్నారు	Nan
galatia	ఈసారి	Nan
fẹ́rẹ̀ẹ́	దాదాపు	None
fòye	అర్థం	None
fífún	ఇవ్వడం	None
fífò	ఎగురుతున్న	Nan
fégbé	మర్చిపో	Nan
fé	fé	Nan
gbe	క్యారీ	Nan
fé	ఫే	Nan
funra	కూడా	None
fun	కోసం	None
fulbe	ful	Nan
fulani	పిరికి	Nan
fuji	తొలగిస్తాయి	Nan
freetown	freetown	Nan
fransi	ఫ్రెంచ్	None
francis	ఫ్రాన్సిస్	None
fracmv	fracmv	Nan
fowó	కోసం	None
fowobowe	బుకింగ్	Nan
further	మరింత	None
fourbase	fourbase	Nan
gbera	కొనసాగండి	Nan
gbese	రుణ	None
geneva	శృతికి	Nan
geesi	ఆంగ్ల	None
gbọ́dọ̀	తప్పక	None
gbúnùn	వాసన	None
gbónmisi	చట్టం	None
gbódò	తప్పక	None
gbìyànju	గట్టిగా	None
gbìnyànjú	ప్రయత్నించండి	Nan
gbésè	ఆఫర్	Nan
gbéyèwò	సమీక్ష	Nan
gbéni	ప్రత్యక్ష	None
gberasoke	వేగవంతం	Nan
gbékalè	కార్పెంటర్	Nan
gbé	ప్రత్యక్ష	None
gbáradì	లే	None
gbá	స్మాష్	Nan
gbàgùrà	shook	Nan
gbàgbọ́	నమ్మకం	None
gbongbo	రూట్	Nan
gbogbogbo	సాధారణ	None
gbin	నాటిన	Nan
gbilè	విరిగిపొవటం	Nan
gbigbewo	ఫైనాన్సింగ్	Nan
gbigbamulo	దోపిడీ	Nan
gbédìí	ఏర్పాటు	None
foriko	ఉదాహరణకి	None
force	ఫోర్స్	Nan
foniimu	సినిమా	None
eyonomba	eyonomba	Nan
eyin	గుడ్లు	None
eya	వర్గం	None
example	ఉదాహరణ	None
ewì	కవిత్వం	None
ewé	ఆకు	None
ewe	ఆకు	None
euroasia	euroasia	Nan
euro	యూరో	None
etíòkun	తీరం	None
etymologiae	etymologiae	Nan
eléja	ఫిషింగ్	Nan
etisalat	ఎటిసలాట్	Nan
esia	వస్తున్నారు	Nan
eseese	రేఖాచిత్రం	Nan
eréonítàn	ఎక్రోనిం	Nan
erékùsù	ద్వీపం	None
erofo	అవక్షేప	Nan
ernst	ఎర్నస్ట్	Nan
epa	వేరుశెనగ	Nan
eníbá	జ్వరం	None
enì	ఏనుగు	None
enter	నమోదు	None
enikéni	ప్రతి	None
esteri	esteri	Nan
elòmíràn	ఇంకెవరో	Nan
eka	ప్రభావం	None
eléyàmèyà	జాతి	None
fohùn	అరవడం	Nan
fofinde	నిషేధిస్తూ	Nan
fodio	fodio	Nan
five	ఐదు	None
fitino	విచారణ	None
finlandi	ఫిన్లాండ్	Nan
finiki	భౌతిక	Nan
fimú	తీవ్రంగా	None
fihan	సూచించబడిన	Nan
fifihan	చూపుతుంది	Nan
fi	సేవ్	Nan
fe	కావలెను	Nan
fesèmúlè	మూలం	None
ferde	ferde	Nan
felifeli	వెల్వెట్	Nan
farsi	ఆర్టి	Nan
faranse	ఫ్రెంచ్	None
faramó	కట్టుబడి	Nan
fan	అభిమాని	Nan
fail	fail	Nan
fagile	రద్దు	None
ewà	ప్రవర్తన	None
esè	ఆదాయం	None
esin	మతం	None
enu	నోటి	Nan
búburú	చెడు	None
bòtswánà	బస్సు	None
béè	ఊరికే	Nan
bèrẹ̀	ప్రారంభించడానికి	Nan
alawose	భవిష్యవాణి	Nan
alalaye	భూసంబంధమైన	Nan
alakobere	లేని	None
alakitiyan	కార్యకర్త	Nan
alaini	ఆదుకోవాల్సిన	Nan
alaigbara	ఎదురులేని	Nan
alaidogba	అసమతుల్య	Nan
aladanida	ఏకపక్ష	Nan
aladani	ప్రైవేట్	Nan
aladaani	ప్రైవేట్	Nan
alaafin	అక్రమ	Nan
albany	అల్బానీ	Nan
alaafia	శాంతి	None
alaabo	వికలాంగ	Nan
ala	డౌన్	None
akẹ́kọ̀ọ́	విద్యార్ధి	None
akíngbógun	బెటాలియన్	Nan
akíkanjú	వాలియంట్	Nan
akátá	నక్క	Nan
akopo	సంగ్రహం	None
akopa	ప్రప్రదమముగా	Nan
akoni	లేదు	None
akole	కాదు	None
akokolo	కాలం	None
alaadanida	అవాంఛిత	Nan
akinpelu	ఫిరంగి	Nan
albert	ఆల్బర్ట్	Nan
alicia	అలిసియా	Nan
anc	anc	Nan
anabi	ప్రవక్తయైన	Nan
an	ఒక	None
améríkà	అమెరికన్	None
améríkà	అమెరికన్	None
amosi	మసీదు	None
amojeoyipada	కన్వర్టిబుల్	Nan
amerika	అమెరికా	None
americas	అమెరికాలు	Nan
amazonas	అమెజోనాస్	Nan
alọ́po	జేబు	Nan
alexandra	alexandra	Nan
alúwo	బూమ్	Nan
aláyèwò	ఇన్స్పెక్టర్	Nan
alátise	కళాకారుడు	None
alápapò	భర్తీ	None
alákọ̀bẹ̀rẹ̀	ప్రారంబిక	Nan
alumíníọ̀mù	అల్యూమినియం	Nan
alumoni	నివారణ	None
alukuraani	ఖురాన్	Nan
alubàbá	తండ్రి	None
alpha	ఆల్ఫా	None
alominira	స్వాతంత్య్రం	Nan
allāh	అల్లాహ్	Nan
aláísàn	అనారోగ్యం	Nan
akiidah	coridah	Nan
ajọra	ప్రతిరూప	Nan
ajoro	ప్రయాణ	None
adiokan	ఒంటరి	Nan
adeda	ప్రకృతి	None
addis	ఆడిస్	Nan
adarihunrun	క్లీనర్	Nan
adabaye	సరే	None
adaba	సౌకర్యవంతంగా	Nan
accra	అక్ర	Nan
abúléko	గ్రామం	Nan
abínibí	జాతీయత	Nan
abé	సూది	Nan
abálájo	అనుభవం	None
adágbà	పెద్ద	None
aburunmu	మా	None
abidjan	ఎప్పుడైనా	Nan
abidi	అక్షరం	None
abesahara	చల్లుకోవటానికి	Nan
abeorile	హోమ్కమింగ్	Nan
abeikojopo	వారసురాలైన	Nan
abala	భాగం	None
aawe	పక్షవాతం	Nan
aare	ఆరే	Nan
aapon	aapon	Nan
aanu	కరుణ	None
aala	సరిహద్దు	None
abo	స్త్రీ	None
kútò	వీధిలో	None
adúgbò mókóla	mucocula	Nan
adúgbò quarry	క్వారీ పొరుగువారు	Nan
ajo	ప్రయాణ	None
ajibola	ఎజెండా	Nan
ajemoroyin	ప్రశ్నించే	Nan
aje	ఆర్థిక	None
ajagun	కుక్క	None
aisi	లేకపోవడం	None
aintimulo	aintimulo	Nan
agio	క్రై	Nan
agbéiná	ఆర్చేవాడు	Nan
agbára	శక్తి	None
agbàbò	రక్షక	Nan
agbà	ఒక	None
agbeinadie	భూములను	Nan
agbaye	ప్రపంచం	None
agbara	శక్తి	None
agbado	మొక్కజొన్న	Nan
agba	పెయింట్	Nan
aféfé	విండ్మిల్	Nan
africans	ఆఫ్రికన్లు	Nan
african	ఆఫ్రికన్	None
africa	ఆఫ్రికా	None
afoyemo	సంక్షిప్తముగా	Nan
afomo	ఉదాహరణకి	None
afida	కుటుంబం	None
adúgbò ìdí	కారణాలు	None
andaman	andman	Nan
genevieve	genevieve	Nan
angkor	ఆంగ్కోర్	Nan
anschluss	అన్స్చ్లుస్స్	Nan
benin	బెంచ్	Nan
bengali	బెంగాలీ	None
bengal	బెంగాల్	None
belgium	బెల్జియం	None
belarus	బెలారస్	Nan
beijing	బీజింగ్	None
beauharnais	బెయుహర్నైస్	Nan
bce	దూరంగా	None
bayìí	ఇప్పుడు	None
bayi	ఇప్పుడు	None
bayelsa	bayelsa	Nan
berber	బెర్బెర్	Nan
bauxitealumina	bauxitealumina	Nan
banle	banle	Nan
bang	బ్యాంగ్	Nan
balẹ̀	అతడు	None
bahrain	బహ్రెయిన్	Nan
babaláwo	దైవిక	Nan
baa	ఉంది	None
aṣòkan	వ్యక్తిగత	Nan
azikiwe	ఇంగిత జ్ఞనం	Nan
ayò	ay	Nan
ayàfi	అది	None
ayeye	శాశ్వతత్వం	Nan
bara	సంవత్సరం	None
aya	పద్యం	None
berlin	బెర్లిన్	None
bharat	భారత్	None
báyìí	ఇప్పుడు	None
bárakú	వ్యసనం	Nan
bálè	బెలూన్	Nan
bákannáà	అలాగే	None
bàbá	తండ్రి	None
by	ద్వారా	None
burúkú	చెడు	None
bujumbura	విస్తరించింది	None
buenaventura	బుఎనవెంటుర	Nan
bu	అంటే	None
brítánì	బ్రిటిష్	None
bernstein	బెర్న్స్టెయిన్	Nan
britain	బ్రిటన్	None
brazzaville	బ్రాజవిల్	Nan
brasil	brasil	Nan
bolívar	బొలీవర్	Nan
bolt	బోల్ట్	Nan
bole	బోలే	Nan
bojú	చూడు	None
bodies	శరీరాలు	Nan
black	బ్లాక్	None
biribiri	చేయబడింది	None
bibeli	బైబిల్	Nan
bharata	రా	None
bridgeport	bridgeport	Nan
awújẹ	కుంభకోణం	Nan
awùjo	మర్యాద	Nan
awuruju	మాయా	None
arábíà	అక్షర	None
aráa	సోదరుడు	None
aryan	ఆర్యన్	Nan
arun	వ్యాధి	None
aruleyin	హలో	None
aroko	సంపద	None
arkansas	arkansas	Nan
ariwaguusu	నైరుతి	Nan
ariwaarin	మధ్య	None
ariso	ఏరిస్	Nan
arinkankan	ఇది	None
aráròmí	హలో	None
aralíle	ఉష్ణమండల	None
apẹ̀rè	ఆప్రాన్	Nan
apòmù	ఆప్రాన్	Nan
apis	నంది	None
apeere	ఉదాహరణకి	None
apeja	మత్స్యకారులు	Nan
aparapo	కలయిక	None
apaiwoorun	పశ్చిమ	None
apailaorun	సూర్యోదయం	Nan
apaguusuiwoorun	నైరుతీ	Nan
apaguusuilaorun	నైరుతీ	Nan
apagusu	దక్షిణం	None
arabu	అరబ్	Nan
arópò	లంచం	Nan
arúgbó	వయస్సు	None
arọ	మందకొడిగా	Nan
awon	వాటిని	None
awoòn	టెంప్లేట్	Nan
awonara	భావోద్వేగం	Nan
awo	ప్లేట్	None
awari	ఆవిష్కరణ	Nan
avar	అవార్	Nan
austríà	ఆస్ట్రేలియా	None
austronesian	ఆస్ట్రోనేషియన్	Nan
austriahumgary	austriahumgary	Nan
australia	ఆస్ట్రేలియా	None
atunse	దిద్దుబాటు	Nan
atun	రివైండ్	Nan
atinrin	నవ్వుతూ	Nan
atimo	ప్రణాళిక	None
atigba	అనుమతించదగిన	Nan
atanna	అణువు	None
atangbona	అణువు	None
asèdá	సహజమైనది	Nan
asìko	అర్ధంలేని	Nan
assessment	అంచనా	None
asipa	విచలనం	Nan
aseyori	విజయం	None
aseeto	పరిష్కారం	None
ascii	కనిపెట్టండి	Nan
asagun	విజయం	None
anita	అనితా	Nan
ọ̀rọ̀	చర్చ	None
georgia	జార్జియా	None
gfaj	gfaj	Nan
kòjòkú	వర్షం	None
kírísìtì	క్రిస్మస్	Nan
kínu	ముద్దు	None
kíkọ́	నేర్చుకోవడం	Nan
kíko	అభ్యసించడం	Nan
kí	అభినందించడానికి	Nan
kìnní	ప్రధమ	None
kéyìn	తరువాత	None
kémíkà	విరుద్ధంగా	None
kétu	సిద్దంగా ఉండు	Nan
kékéèké	చిన్న	None
kòkó	ఎలుక	None
kéesì	హాస్యాస్పదంగా	Nan
kánádà	యొక్క	None
kánfinkése	చాతుర్యం	Nan
ká	ఆఫ్	Nan
kàyéfì	వండర్	Nan
kàríbẹ́ánì	ప్రాంతంలో	Nan
kwara	ప్రసంగించారు	Nan
ku	మీరు	None
krio	krio	Nan
kori	లేదు	None
ko	ko	Nan
koko	లెర్నింగ్	Nan
káyé	ప్రపంచ	None
koto	ఎరగా	Nan
kòmpútà	కంప్యూటర్	None
kòòsí	కాదు	None
labalaba	సీతాకోకచిలుక	Nan
laarin	లోపల	None
laaka	రివర్స్	Nan
laada	కిక్	Nan
laa	వెళ్ళిపో	Nan
kọ́ni	లేకపోవడం	None
kọ́lọ́mú	నిలువు	None
kọ́kọ́	ప్రధమ	None
kọ̀mpútà	కంప్యూటర్	None
kọjá	పాస్	Nan
kẹ́nyà	వేరు	None
kòtò	ఒక	None
kẹta	మూడో	None
kẹrin	నాల్గవ	None
kúùkù	విరుద్ధంగా	None
kútò	ప్రతిదీ	Nan
kúrò	దూరంగా	None
kúkúrú	క్లుప్తంగా	None
kúkú	తరువాత	None
kùrání	ఖురాన్	Nan
kùkú	తరువాత	None
kóra	సేకరించడానికి	Nan
kógo	గ్లోరీ	Nan
kòòkan	ప్రతి	None
kẹsàán	వెంటనే	None
labee	కింద	None
kookan	ఈ	None
kong	కాంగ్	Nan
kampala	కలుపుట	Nan
kalẹ	పక్కన	None
kalinga	cinga	Nan
kakiri	జాడ కనుగొను	Nan
kagera	గొప్పగా	None
kadara	ఆస్తి	None
jọ́	దయచేసి	None
jẹ́mánì	జర్మన్	None
jùló	అత్యంత	None
jùlo	ముఖ్యంగా	None
jùlo	మించి	None
kan	ఒక	None
jíjéomoléyìnkírísítì	పరోపకారిగా	Nan
jíje	జీవి	None
jìnnàa	దురముగా	Nan
jéésù	యేసు	None
jé	రండి	Nan
jáde	రా	None
jàgídíjàgan	హింసాత్మక	None
juneau	జునేయు	Nan
jo	john	Nan
jopò	చేరండి	Nan
jojo	పగుళ్లు	Nan
johanu	క్షమించండి	Nan
jíjuwó	డబ్బు	None
kongo	కండోమ్	Nan
kankan	ఎవరూ	None
karbonumarun	thecentricane	Nan
komputa	కంప్యూటర్	None
kolo	kolo	Nan
kojá	క్రాస్	None
koidu	koidu	Nan
kodò	క్రింద	None
ko	లేదా	None
kinkinni	విషయం	None
kilhar	బాహుమూలములో	Nan
kikuninu	ఊహించే	Nan
kiko	లెర్నింగ్	Nan
kikoso	ఫాస్ట్	None
kanlè	kanal	Nan
kikopomo	వెచ్చదనం	Nan
kiko	తీసుకురావడంలో	Nan
kiakiajulo	వేగవంతమైన	Nan
ki	కాబట్టి	None
khoisan	నాసిరకం	Nan
kept	ఉంచింది	Nan
keko	అక్షరాస్యులు	Nan
kekere	చిన్న	None
kebbi	సర్దుబాటు	Nan
karùún	ఐదవది	Nan
karun	ఐదవ	None
karl	కార్ల్	None
kikojo	సంగ్రహం	None
lade	లేడ్	Nan
laid	వేశాడు	None
laifi	తప్పు	None
mahatma	మహాత్ముడు	Nan
madeira	beira	Nan
maapu	మ్యాప్	None
lọ́jà	మార్కెట్లో	Nan
lọ́dọọdún	ఏటా	None
lọndọnu	లండన్	None
lórò	రేపు	Nan
lónà	మార్గంలో	None
ló	ló	Nan
lóòótọ́	నిజానికి	None
lóòótò	అవును	None
makedonia	మేసిడోనియా	Nan
lóti	చాలా	None
lórì	నౌకాశ్రయం	None
lópó	వితంతువు	Nan
lópez	nipez	Nan
lóde	బయట	None
lítésò	పరుష	Nan
lísa	త్వరణం	Nan
lílo	దోపిడీ	Nan
lérú	బానిసత్వం	Nan
léyìn	తరువాత	None
léyin	తరువాత	None
lérò	కారణం	None
lóríba	పైగా	Nan
lérìnín	మంచు	None
malabo	తేనె	None
malayopolynesian	malayopolynesian	Nan
member	సభ్యుడు	None
melo	ఎన్ని	None
meksiko	మెక్సికో	None
mejila	పన్నెండు	None
mejidinlogbon	ఎనిమిది	None
mefeefa	సమగ్ర	None
mediteraneani	మధ్యధరా	None
means	అంటే	None
mbabane	ప్రతికూల	None
maya	ఏ	Nan
max	గరిష్టంగా	Nan
malay	భావించలేము	Nan
mathimatiki	గణిత	None
matheu	matheu	Nan
maseru	అసూయ	Nan
maryland	మేరీల్యాండ్	Nan
mars	అంగారక	None
marku	ఈసారి	Nan
march	మార్చి	None
marcellus	మర్సుల్లుస్	Nan
manˈdeːla	mandelala	Nan
mango	మామిడి	None
mali	రోజు	None
malaysia	మలేషియాలో	Nan
mathiew	mathiew	Nan
léebá	యాదృచ్ఛికంగా	Nan
lédè	భాషలో	None
lèyìn	తరువాత	None
links	లింకులు	None
linear	సరళ	Nan
lindi	లై	Nan
lilongwe	లైల్గ్	Nan
lilemo	గంజాయి	Nan
lilelile	హార్డ్కోర్	Nan
leè	మే	None
leyi	ఇదిగో	Nan
lewon	ఖైదు	Nan
lewaju	ముందుకు	None
less	తక్కువ	None
lodo	జరిగేటట్లు	Nan
lese	పోస్ట్	None
lekun	తీవ్రమైంది	Nan
leboa	lebo	Nan
le	చెయ్యవచ్చు	None
lay	లే	None
latvia	లాట్వియా	Nan
latini	లాటిన్	None
latigbana	నుండి	None
latibe	నుంచి	None
lasile	విడుదల	None
lanka	లంక	None
languages	భాషలు	None
leo	leo	Nan
lojowaju	భవిష్యత్తులో	None
lojukokoro	అత్యాశకరమైన	Nan
lojúgun	చేశాడు	None
lèe	చెయ్యవచ్చు	None
láíláí	ఎప్పుడూ	None
láì	లేకుండా	None
lárúbáwá	సహజమైనది	Nan
lára	హర్ట్	Nan
lápá	భాగం	None
lámọ́di	అదృష్టం	Nan
láké	బిగ్గరగా	Nan
láimo	లేకుండా	None
láfún	ఇచ్చిన	None
lábé	బరువు	None
lààmì	చిహ్నాలు	None
lààmi	సైన్	Nan
làgba	సమాన	None
lynton	లింటన్	Nan
luther	లూథర్	None
luanda	లువాండా	Nan
lo	కొనసాగించు	Nan
low	తక్కువ	None
lovers	ప్రేమికులకు	Nan
louvre	లౌవ్రే	Nan
loruko	పేరు	None
lopolopo	చాలా	None
loloselu	రాజకీయంగా	None
lokunkun	శక్తివంతమైన	Nan
johann	నరకం	None
jogun	వారసత్వంగా	None
jo	లీక్	Nan
jiròrò	పొగమంచు	Nan
ifitonileti	సమాచారం	None
ifilole	ప్రయోగ	Nan
ifija	ఫిషింగ్	Nan
idánwò	విచారణ	None
idupe	ధన్యవాదాలు	Nan
idoma	డ్రాయింగ్	Nan
idimule	అరెస్టు	None
ideraa	వ్రాయటానికి	Nan
idari	నియంత్రణలు	Nan
idamita	డ్రా	Nan
idajo	న్యాయం	None
ifobaje	అవినీతి	None
idaji	సగం	None
idagbasoke	అభివృద్ధి	None
iceland	ఐస్లాండ్	Nan
ibùjókòó	సీటింగ్	Nan
ibùdó	శిబిరంలో	Nan
ibuso	పోరాడటానికి	Nan
ibuseripadabosi	రీఎంబెర్స్మెంట్ను	Nan
ibujoko	బెంచ్	Nan
ibori	వీల్	Nan
ibojì	సమాధి	None
ibn	ఇబ్నె	Nan
ibiti	స్థలాలు	None
idagbe	నిర్లక్ష్యం	Nan
ibise	వ్యాయామం	Nan
ifofinde	సమావేశం	None
igbeduro	తయారీ	None
iketa	వారసత్వంగా	None
ikerin	నాల్గవ	None
ikeko	సంగ్రహం	None
ikejidinlogun	పద్దెనిమిది	Nan
ikaowo	గౌరవం	None
ikandinlogun	పద్దెనిమిది	Nan
ikan	ఒకటి	None
ijó	డ్యాన్స్	Nan
ijosin	ఆరాధన	None
ijinnasi	భౌతిక	Nan
ije	ఉద్యమం	None
ifriqiya	ప్రేరణ	None
ijaya	భయాందోళనలు	Nan
ijagun	పోరాటం	None
ihinrere	సువార్త	None
ihan	కోసం	None
igitòròmogbè	బ్రాడ్బ్యాండ్	Nan
igbáẹ̀yìn	చివరిది	Nan
igbá	చికెన్	Nan
igbowolori	ఖరీదైన	Nan
igbeyawo	పెండ్లి	None
igbesoke	అప్గ్రేడ్	Nan
igberiko	సబర్బన్	Nan
igbegun	విజయం	None
ijakadi	పోరాటం	None
ibimo	పుట్టిన	None
ibile	సంప్రదాయకమైన	Nan
ibiamusin	అభయారణ్యం	Nan
gún	కుట్టిన	Nan
gòkè	వెళ్ళు	None
gírámà	gramps	Nan
gégé	నిజంగా	None
gèésì	రత్నం	None
gèésì	గ్లూ	Nan
gv	జివి	Nan
guusu	దక్షిణ	Nan
gunle	తుపాకీ	None
gun	దీర్ఘ	None
guinébissau	guinébissau	Nan
gúúsù	దక్షిణ	Nan
guineabissau	guineabissau	Nan
guanínì	guanni	Nan
groove	గాడి	Nan
griiki	గ్రీకు	None
grammy	గ్రామీ	Nan
gquadruplex	gquadruplex	Nan
gorgina	డేగ	Nan
gomina	గవర్నర్	None
goemai	goemai	Nan
gidí	హౌస్	None
gidigidi	చాలా	None
ghana	ఘనా	Nan
guinea	గినియా	None
gẹ̀ẹ́sì	ఆంగ్ల	None
habsburg	హబ్స్బర్గ్	Nan
haggai	గైడ్	Nan
ibewo	వచ్చింది	None
ibeji	కవలలు	Nan
ibarepo	అసోసియేషన్	None
ibalo	వ్యవహారంలో	Nan
hv	hv	Nan
hungari	ఆకలి	None
hun	హన్	Nan
hugh	హ్యూ	Nan
hp	hp	Nan
hosea	హోషేయా	Nan
hominidae	హోమినిడే	Nan
histoni	histoni	Nan
hindu	hindu	Nan
him	అతనికి	None
hesse	అంగీకరించింది	Nan
heraklion	heraklion	Nan
henny	henny	Nan
hendu	మిఠాయి	None
heinrich	హెన్రిచ్	Nan
hawaii	హవాయి	None
hausafulani	hausafulani	Nan
haughton	haughton	Nan
hard	హార్డ్	None
halomonadaceae	halomonadaceae	Nan
haiti	హైతీ	Nan
ikoenu	కాపాడడానికి	Nan
german	జర్మన్	None
ikojopo	చేరడం	Nan
iku	మరణం	None
itumo	అర్థం	None
itu	విసిరేందుకు	Nan
itorawo	ఉదారవాద	Nan
itokowo	వ్యాపార	None
itobi	గొప్పగా	None
itiraka	పోరాటం	None
itelentele	స్పష్టంగా	None
itanakole	కథ	None
itali	ఇటాలియన్	None
isè	సేవ	None
isesi	లొంగిపోయేందుకు	Nan
iwadi	పరిశోధన	None
isun	ప్రవాహం	None
iso	వచ్చిన	None
isepinpin	పంపిణీ	None
iseowo	వ్యాపార	None
iseoroayeijoun	పురావస్తు	None
iseoba	పదిహేను	None
isejoba	పాలన	None
iseero	వాచ్	Nan
isedaniloro	సందేహం	None
isare	త్వరణం	Nan
isa	చాలు	None
irúnmọlẹ̀	మెరుపు	Nan
isoponomba	isoponomba	Nan
irò	పుకారు	Nan
iwasi	ఇంప్రెస్	Nan
iwoile	హోమ్	None
jijinna	దురముగా	Nan
jije	జీవి	None
jfk	jfk	Nan
jesu	jesus	Nan
jeometri	జ్యామితి	Nan
jeffrey	జెఫ్రీ	Nan
jawaharlal	కల్లోలం	Nan
jamo	వెళ్ళిపో	Nan
jamaica	youtube	Nan
jalè	దొంగతనం	Nan
jagbe	పోగొట్టుకోండి	Nan
iwifun	సమాచారం	None
jadide	పట్టుకోండి	Nan
jabo	నివేదిక	None
iṣẹ́ìwádìí	పరిశోధన	None
iḷẹ̀	పని	None
iyán	మద్యం	None
iyen	అంటే	None
iyawo	వధువు	Nan
iyato	తేడా	None
iyan	కరువు	None
iwuwa	ఆచరణలో	None
iwulo	ఉపయోగకరమైన	Nan
iwosan	వైద్యం	Nan
jackson	jackson	Nan
irorun	చాలా	None
irisi	ప్రదర్శన	None
iringa	మూటగట్టు	Nan
ilẹ̀ayé	భూమి	None
ilẹ	గ్రౌండ్	None
iléńlá	ప్రాంగణంలో	Nan
iléàtèéré	హోమ్	None
ilélódò	ఇల్లు	None
iléisé	హోమ్	None
iléayé	హోమ్	None
ilé	హోమ్	None
iluorilejoba	ప్రపంచీకరణ	None
iluoba	పౌరసత్వం	Nan
ilopo	డబుల్	Nan
iminle	చేయడానికి	None
ileru	ఫర్నేస్	Nan
ileigbimo	సమ్మతి	Nan
ileife	నిర్లక్ష్యం	Nan
ilegiga	హోమ్	None
ileasofin	శాసన	None
ilaorun	సూర్యోదయం	Nan
ilaodo	రక్షించడానికి	Nan
ilanaoye	వ్యూహాలు	Nan
ilana	విధానం	None
ilagbolojo	ప్రచారం	None
ikún	పూరకం	Nan
ikúgbaèyí	ఇప్పుడు	None
ileobaluaye	ప్రపంచం	None
imoero	సౌందర్య	None
imojuto	సంరక్షణ	None
imusin	డ్రా	Nan
irele	వినయం	Nan
ire	అమ్మకానికి	Nan
iranlose	సాయం	None
iraja	దిగ్భ్రాంతిని	Nan
ipá	ఫోర్స్	Nan
ipo	స్థానం	None
ipinu	నిర్ణయం	None
ipinpa	పాల్గొనడం	Nan
ipin	అధ్యాయము	Nan
ipele	స్థాయి	None
ipawo	ఉపయోగాలు	None
ipare	వాడిపోవు	Nan
iowa	భూమిపై	Nan
ioniani	ఆదుకోవాల్సిన	Nan
ioja	చేప	None
inúnibíni	హింసను	Nan
iní	వారసత్వ	None
inágbéringbérin	పదిహేడు	Nan
integration	అనుసంధానం	None
inkosi	సమర్థించేందుకు	Nan
indus	ఇండస్	Nan
indeed	నిజానికి	None
inagberingberi	వెన్న	None
imúnisìn	పరిశుభ్రత	Nan
imú	ముక్కు	None
ikoreokere	సాగు	None
ọ̀sẹ	వారం	None
