aajo	смешен	Nan
púpò	по-скоро	Nan
púpo	твърде много	Nan
pò	гънка	Nan
pòwe	притчи	Nan
pípẹ́	дълго	None
pípèsè	осигуряване	None
pípa	клане	None
péé	че	None
péré	само	None
pé	че	None
pèsè	осигурен	Nan
quran	коран	Nan
pèlúpèlú	също	None
pèhìndà	сперма	Nan
pè	наречен	None
pátáporongodo	абсолютно	None
pásíà	мазето	Nan
pàápàá	особено	None
pààlà	граница	None
pàràkòyí	веднага	None
pàmò	по-конкретно	Nan
px|kùránì	px | ядро	Nan
pupa	червен	None
príncipe	принсипи	Nan
pèlu	заедно с	Nan
providence	провидение	Nan
ra	купува	None
rajya	надежда	None
rome	хром	Nan
roma	рим	None
roko	тълпа	None
rokirika	сърфиране	Nan
rogbodiyan	бунт	None
roboto	повърхности	Nan
robinson	робинсън	Nan
ro	мисля	Nan
rnas	рнк	None
rnarna	rnarna	Nan
rna	рнк	None
race	раса	None
rn	ина	Nan
riresile	магнетофон	Nan
rinle	наскоро	None
right|thumb|px|aworan	дясно | палец | px | изображение	Nan
richard	ричард	None
research	изследване	None
rere	добре	None
repetejulo	най-чувствителните	Nan
repeats	повторения	Nan
reggae	реге	Nan
rank	ранг	None
ramadan	рамазан	Nan
riro	въображение	Nan
ronald	роналд	Nan
proton	протон	None
produced	произведена	Nan
palauan	палауан	Nan
padá	шушулка	Nan
paapaa	особено	None
paa	изключи	Nan
opolo	много	None
ofò	добро утро	Nan
oyé	светски	None
ose	ose	Nan
opolo	много	None
omonìyàn	човешки същества	Nan
olorun	бог	None
panaˈma	панама	None
odun	годишно	None
olórun	бог	None
okùnrín	смях	None
ojó	дъждовно е	Nan
odún	годината	None
oúnjẹ	храна	None
owojagidijagan	терористи	Nan
oun	той	None
otutu	много	None
otherwise	в противен случай	Nan
oseluarailu	цивилен	Nan
oscar	оскар	None
olósìn	религиозен	None
protokolu	protocolu	Nan
panyanan	знакът	Nan
parapọ̀	смесица	None
press	натиснете	Nan
portuguese	португалски	None
portonovo	портоново	Nan
population	население	None
polaroid	поляроид	Nan
polandi	лак	Nan
pojulo	най-високата	Nan
po	po	Nan
plánẹ́tì	водопровод	Nan
platos	platos	Nan
piposi	много	None
papa	татко	Nan
pipolongo	реклама	None
pinu	решена	Nan
pinsoto	pinoto	Nan
pinsi	намаляващата	Nan
phillipines	филипините	None
pelu	перла	Nan
petu	petu	Nan
periferi	periferi	Nan
penisula	полуостров	None
penh	пен	Nan
pele	очарователен	Nan
paripari	край	None
pipo	много	None
rorùn	лесно	None
rossii	россии	Nan
rural	селски	Nan
sìbẹ̀	още	None
séyìn	гърба	None
séyìn	обратно	None
sénégal	сперма	Nan
ségun	плача	Nan
sèle	кражба	Nan
são	новият	None
sáààrin	между	None
sáàpàdé	спонсорство	Nan
sápadè	този ден	Nan
sàì	добре	None
sìni	скарида	Nan
sàngó	банда	Nan
sàmì	знак	None
sàbúrí	над всички	Nan
symmetry	симетрия	Nan
swahili	суахили	Nan
suny	suny	Nan
sun	слънце	None
sugbọ́n	рационален	Nan
sugbo	но не	Nan
suez	суец	Nan
structures	структури	None
stella	стела	Nan
sàn	толкова по-добре	Nan
spectacular	грандиозен	Nan
síbèsíbè	въпреки това	Nan
sílẹ̀	разочаровам	Nan
tabora	избягване	Nan
tabili	маса	None
tabi	или	None
sísè	превод	None
sísa	s .ía	Nan
sááju	отделете малко	Nan
sisé	тренирам	Nan
sepò	накрая	None
se	те правят	Nan
sùgbón	напротив	Nan
síse	структура	None
síbú	на земята	Nan
si	разбира се	Nan
sùgbón	напротив	Nan
sóko	растение	None
sójà	войник	None
sòrò	промиване на мозъка	Nan
síí	тук	None
síwájú	напред	None
síwon	тях	None
síta	извън	None
síso	все още	Nan
síso	все още	Nan
síse	работа	None
sọ	казвам	Nan
so	така	None
sopin	край	None
soon	скоро	None
say	казвам	Nan
santa	дядо	None
samioro	на разположение	Nan
sambia	младежта	Nan
salàyé	живот	None
salem	салем	Nan
sakyas	сакя	Nan
sakyamuni	следващият	None
saheli	удобство	Nan
safta	подреждам се	Nan
safiwe	сравнение	None
sb	sb	Nan
saffana	сапфир	Nan
saarland	на пода	Nan
saaree	изключителен	Nan
saarc	премахване	None
rẹ	тя	None
ròyìn	отчетените	Nan
rìn	да вървя	Nan
ré	° с	Nan
république	république	Nan
ránmú	притеснение	Nan
ráhàn	се появи	Nan
ryan	райън	Nan
safari	сафари	Nan
schwarz	шварц	Nan
sea	море	None
seat	седалка	Nan
solomon	соломон	Nan
sohun	да	None
so	любов	None
slovo	слово	None
sisupo	умножете	Nan
sisupapoerekusu	плюене	Nan
sisopo	свързване	None
sisodagba	раста	Nan
sise	готвене	Nan
sioux	сиукски	Nan
sinsin	религия	None
sinai	грях	None
silè	капки	Nan
sile	зад	None
sihamoni	структура	None
sibesibe	още	None
sharon	шарън	Nan
sewadi	търсене	None
seville	севиля	Nan
sense	смисъл	None
senegal	сенегал	Nan
semudaju	разбира се	Nan
semolara	астма	Nan
seidamo	ясно	None
segbese	възможно	None
orúko	областта	None
taino	дино	Nan
orísìírísi	различни видове	Nan
orísiirísi	различни	None
nombamewa	мултиплициращ	Nan
nobel	нобелова	None
nnaji	чичо	None
nkàn	рак	None
nkan	нещо	None
niyi	ето го	Nan
niye	достатъчно	None
niyato	разграничат	Nan
niwaju	напред	None
nitosi	близо до	Nan
nitoripe	защото	None
nombáméjì	първите две	Nan
nitoriidieyi	заради това	Nan
nilè	тук	None
nijẹr	найки	Nan
nigbà	тогава	None
nigbakan	понякога	None
nibere	рано	None
nibe	там	None
ngubengcuka	ngubengcuka	Nan
ngbero	планираното	Nan
nevis	невис	Nan
neptune	нептун	None
nefimu	nephim	Nan
nisinyi	сега	None
nebraska	небраска	Nan
novo	ново	None
nse	дизайн	None
nínlá	страхотен	Nan
nílẹ̀	на земята	Nan
nílùú	в града	Nan
nílè	по-долу	Nan
nígbàtí	кога	None
nífẹ̀ẹ́	да обичаш	Nan
níbè	там	None
níbè	там	None
ní	имам	Nan
nìyí	това е то	Nan
nìnú	съжалявам	Nan
nri	храна	None
nì	планина	None
náwo	разход	Nan
nàìjíríà	в нигерия	Nan
nwa	бебе	Nan
numeri	скованост	Nan
nukleotidipupo	нуклеотид	Nan
nukleotidi	нуклеотид	Nan
nu	чист	None
ntoka	точка	None
nsowikipedia	obowikipedia	Nan
nsolaboraro	сигурност	None
nso	близо до	Nan
náà	също	None
nínu	шанс	Nan
ncnc	ncnc	Nan
nawojulo	озадачаващо	Nan
munispal	munispal	Nan
mulẹ̀	установят	None
mughal	сила на звука	Nan
mtwara	изберете отново	Nan
mtn	mtn	Nan
mozilla	mozilla	Nan
mozambique	мозамбик	Nan
morogoro	автомобилизъм	Nan
morgan	morgan	Nan
monrovia	монровия	Nan
mombasa	момбаса	Nan
muungano	muungano	Nan
mokanlelogbon	тридесет и две	Nan
mohandas	мохандас	Nan
minority	малцинство	None
minnesota	минесота	Nan
mimuwa	вкопчване	Nan
mimoy	mimoy	Nan
miiràn	разтоварваща	Nan
micronesia	микронезия	Nan
michelle	мишел	Nan
mexico	мексико	None
mewar	mewar	Nan
meucci	меуци	Nan
mokaleladota	компактен	Nan
nawó	вземете парите си	Nan
májèmú	не против	Nan
méjèèjì	и двете	Nan
nato	нато	None
nathaniel	натаниел	Nan
namibia	да дойде	Nan
mẹ́talọ́kan	триединство	Nan
mẹ́ta	три	None
mẹ́rkúríù	мишката	Nan
mẹ́fà	шест	None
múlẹ̀	дръж бързо	Nan
mó	m	Nan
móra	лек	None
mókólà	лепило	Nan
mère	чертеж	Nan
mò	знание	None
míìrán	друг	None
míràn	друг	None
mímọ́	свят	None
ménu	мислиш ли	Nan
méwàá	десет	None
métèètà	дърводелец	Nan
méta	три	None
mérìnlélógójì	четиредесет и четири	Nan
mérìndínlógún	шестнадесет	Nan
méte	пет	None
mérindíláàdóta	петдесет и пет	Nan
mííràn	друг	None
níní	имам	Nan
nípà	поне	None
nítorípé	защото	None
onítumò	преводач	Nan
oníná	пожар	None
onílẹ̀	надолу	None
oníkólóbó	обиден	Nan
onígbàgbó	старец	Nan
onka	калкулатор	Nan
onje	диета	None
oniyijulo	страхотен	Nan
oniyewumeji	двоен	Nan
onisowo	търговец	None
onisayensi	техник	Nan
onítèbọmi	кръстените	Nan
onipin	рационален	Nan
onilile	собствениците на жилища	Nan
onilanaibagbepo	презерватив	Nan
onigunfenfe	пасивен	Nan
onigbowo	спонсор	Nan
onigbeja	градивен	Nan
onibugbe	наемател	Nan
onialjebra	onialjebra	Nan
omiadalu	наводнение	Nan
omi	вода	None
olùkọ́	учител	None
olùkó	инструктор	Nan
oninawo	кредитополучател	Nan
olùkópa	сътрудник	None
onítòhùn	касиер счетоводител	Nan
oníyanjù	анимирани	Nan
orílẹ́	вечер	None
orílẹ̀	нация	None
orílèèdè	нация	None
oríkì	поезия	None
oríilẹ̀	статия	None
oríilè	национален	None
oruko	съществително	None
orudnun	годишен	None
oritameta	по средата	Nan
orisa	произход	None
orisun	източник	None
oníwòsàn	лечителят	Nan
orisirisi	разнообразие	None
orileominira	топлина	None
orilejoba	правителство	None
orileedeajoba	империализъм	Nan
orileede	нацията	None
oriki	ориенталски	Nan
oriire	честито	Nan
ori	глава	None
opposite	противоположен	Nan
opec	опек	Nan
ootọ́	вярно	Nan
ooni	крокодил	Nan
orinìyìn	песен	None
olùdarí	лидер	None
olùbátan	този контакт	Nan
olóṣèlú	политик	None
ojùkòsì	утаяване	None
ojuse	отговорност	None
ojuoorun	залез	None
ojukokoro	сребролюбие	Nan
ojoru	топлина	None
ojojumo	ежедневно	None
ojo	изглежда като	Nan
ogunlogo	тълпа	None
ogun	война	None
ogbè	област	None
ofin	законът	None
ojùkòtúu	утаяване	None
ododo	правдата	Nan
obere	малък	None
obairanderan	братовчед	None
oba	обама	None
nso	очаквайте скоро	Nan
nǹkan	нещо	None
níyanjú	положително	None
níwájú	напред	None
nítòótọ́	наистина	None
nítòótó	точно	None
nítòsí	близо до	Nan
nítumò	значение	None
obínibí	учтивост	Nan
ojúlùmọ̀	познати	None
ojútáyé	вискозитет	Nan
ojúìwé	страница	None
olóyè	владетел	None
olódùmarè	всемогъщ	Nan
olympus	олимп	Nan
oluwakiri	проучване	None
olusoju	охрана	None
oluparapo	съчетание	None
olumojuto	алчен	Nan
olukowe	автор	None
olukoitan	инструктор	Nan
oludase	производител	None
oluda	създател	None
oloye	гений	Nan
oloselukan	здравейте	Nan
olora	дебел	Nan
olopon	надменен	Nan
ololugbe	загубеняк	Nan
olokunkun	слушалки	Nan
olojukanna	веднага	None
olohun	собственици	None
olodiajodojuko	взаимно	None
okunrin	мъжът	Nan
okunkun	тъмнина	Nan
oko	поле	None
okhotsk	охотско	Nan
okeere	в чужбина	Nan
orísìí	разнообразие	None
tainos	tainos	Nan
takuntakun	ограничения	None
talaka	беден	Nan
ìràwọ̀	звездите	None
ìrànàna	помогне	None
ìrànlọ́wọ́	помогне	None
ìpínrò	параграфи	Nan
ìpìnlè	началото	None
ìpìlẹ̀núkléù	криптиране	Nan
ìpolongo	реклама	None
ìnáwó	разход	Nan
ìnagije	победа	None
ìmúsára	да подсиля	Nan
ìmúnilérú	злоупотреби	Nan
ìrí	опит	None
ìmú	нос	None
ìmò	мълния	Nan
ìmò	змия	None
ìlé	у дома	Nan
ìlè	подкупничество	Nan
ìlàìnàró	потисничество	Nan
ìlàorùn	синини	Nan
ìlànàn	илюзия	Nan
ìlà	очертание	Nan
ìlo	повикване	Nan
ìlera	здраве	None
ìkọpa	участие	None
ìmóbìdo	рожденото право	Nan
ìkẹrin	четвъртият	None
ìròkò	мисъл	None
ìròyìnwiki	новини	None
ìtaeko	цех	Nan
ìta	извън	None
ìse	действие	None
ìsòro	затруднение	Nan
ìsílé	у дома	Nan
ìsèjoba	правителство	None
ìsèdá	създаване	None
ìsègbèfábo	усърдие	Nan
ìse	действие	None
ìsọ	магазини	None
ìsú	дебелина	None
ìròyìn	новини	None
ìsòrí	подразделение	Nan
ìsìn	религия	None
ìsèlè	производство	None
ìsàlè	залез	None
ìsomó	да се присъединя	Nan
ìsirò	изчисление	Nan
ìsinsìnyí	сега	None
ìse	действие	None
ìsawo	гадаене	Nan
ìrúbo	колапс	Nan
ìró	звук	None
ìròrùn	илюзия	Nan
ìsòrò	медитация	Nan
ìtan	история	None
ìkínin	шестият	Nan
ìkìjà	предизвикателство	Nan
ìdá	дезертьорство	Nan
ìdàrúdàpò	хаос	None
ìdàpapọ̀	консолидация	Nan
ìdàgbà	старост	Nan
ìbílè	първородството	Nan
ìbílè	първородството	Nan
ìbáraeni	превоз	None
ìbánisòrò	връзката	None
ìbarà	треска	None
èpón	много	None
èwù	риза	Nan
ìdìmú	смущение	Nan
èsìn	религия	None
èro	мисли	None
èka	ефект	None
èyì	достойнство	Nan
ète	предназначение	None
èsúrú	мравки	Nan
èsó	джамия	None
èrò	мисли	None
èràn	болест	None
ènìkan	нещо	None
èlò	прибори	Nan
èkejì	другият	None
èrí	доказателства	None
ìkìlò	злоупотреба	Nan
ìdíisin	кауза	Nan
ìdó	ужилване	Nan
ìkéde	декларация	None
ìkèrèkú	задръствания	Nan
ìkànna	същото	None
ìkejì	другият	None
ìjọba	правителство	None
ìjò	водач	None
ìjìnlè	мистерия	Nan
ìjìnlè	мистерия	Nan
ìjora	омразата	Nan
ìjoba	правителство	None
ìjo	църквата	None
ìdíwòn	твоята причина	Nan
ìjo	танцувам	Nan
ìgbò	овен	Nan
ìgbésí	живот	None
ìgbéraga	гордост	Nan
ìgbáraga	сила	None
ìgbá	крила	Nan
ìgbàgbé	разсеян	Nan
ìgbà	път	None
ìgbonnìbí jé	това е катастрофа	Nan
ìfáàrà	свещеник	None
ìfojúìtànìgbesiayé	житейска история	Nan
ìfara	изтезание	Nan
ìhun	желязо	None
ìtokò	гърнето	Nan
ìtàn	история	None
ìtànkálé	наводнения	None
ṣàkóbá	вреден	Nan
ṣiṣé	отвор	None
σ	σ	Nan
κάππα	.α	Nan
ˌæləˈbæmə	болест	None
ˌkælɪˈfɔrnjə	ɪkælɪfɔrnjə	Nan
ˈøːstəˌʁaɪç	øːstəˌʁaɪç	Nan
ʔaːnaːtɕɑ̀k	.aːnaːtɕɑɕɑk	Nan
şe	правя	Nan
únṣẹlẹ̀	земетресение	None
ôdún	година	None
ẹdo	шега	Nan
ó	да	None
ósírísì	слюнка	Nan
óníse	той е дизайнер	Nan
ó	то	None
òròàjòmó	сутрините	Nan
òrò	мисли	None
òwó	пари	None
òsà	златна рибка	Nan
òrò	мисли	None
òré	игра	None
òpòlopo	много	None
òfò	следващият	None
ósékú	той е мъртъв	Nan
òré	игра	None
ẹlẹ́bùn	подарък	Nan
ẹnìkan	един човек	Nan
ọ̀pòlòpò	действие	None
ọ̀nà	път	None
ọ̀gbìn	растение	None
ọ̀dọ́	младежта	Nan
ọpọ́lọpọ́	смокини	Nan
ọn	то	None
ọmọ	дете	None
ọmú	не струваш	Nan
ọlọ́run	бог	None
ọlọ́mọ	деца	None
ọdún	година	None
ẹlẹ́sìn	религиозен	None
ọbàkàn	полу брат	Nan
ẹ̀rọ	машини	None
ẹ̀ni	сзо	Nan
ẹ̀kọ́	образование	None
ẹ̀kẹ́ta	третият	None
ẹ̀kasístẹ̀mù	субективен	Nan
ẹ̀kaoṣù	трънлив	Nan
ẹ̀kajuly	може	None
ẹ̀kabrítánì	чичо	None
ẹ̀kaawon	становища	Nan
ẹtì	черен дроб	Nan
ẹsẹ	крака	None
ẹ̀wẹ̀	от друга страна	Nan
òpòlopò	много	None
òkòòkan	един по един	Nan
òkan	един	None
òdo	младежта	Nan
òdeojú	безличен	Nan
òde	извън	None
ìṣọ̣̀tẹ̣̀	пневмония	Nan
ìṣẹ́kù	останалата част	Nan
ìṣèlú	политика	None
ìyípadà	конверсия	Nan
ìyàwó	булката	Nan
ìyapa	отделяне	None
ìya	страдание	Nan
ìwúlò	полезен	Nan
òdìkejì	другият	None
ìwòran	зрение	None
ìwéré	книжка	Nan
ìwàásù	проповядване	Nan
ìwo	рога	Nan
ìwe	сравнение	None
ìtúpalè	превод	None
ìtúmò	превод	None
ìtóka	да бъдат бити	Nan
ìtójú	изражения на лицето	Nan
ìtóju	объркване	Nan
ìtójú	грижа	Nan
ìtèsíwájú	прогрес	None
ìwò	цялостен	Nan
òféàrán	изображение	None
ògbójú	компетентен	Nan
ògiri	стена	None
òjògbón	дъждовно време	Nan
òṣèlú	политика	None
òwù	кърпа	Nan
òsèré	спортист	Nan
òsèlú	политик	None
òsán	по обяд	Nan
òrò	мозък	None
òrí	глава	None
òrìsà	идолите	Nan
òranyàn	задължителен	Nan
òpópóònà	път	None
òotó	истина	None
òní	днес	None
òmùàrán	изображение	None
òmiràn	магьосникът	Nan
òle	домакиня	Nan
òkúta	камък	None
òkú	трупове	None
òkòòkan	един по един	Nan
òkèògbún	хиляда	Nan
òjísé	лекарят	Nan
òjo	изглежда като	Nan
ògúndìpẹ̀	ронлив	Nan
ògun	лекарство	None
ògo	слава	None
èka	клон	None
èhìn	следващият	None
èfòn	напрегнат	Nan
èdè	език	None
visit	посещение	None
viruses	вируси	None
villa	вила	None
vihara	vihara	Nan
videos	видеоклипове	Nan
victor	победител	None
vermont	върмонт	Nan
venezuela	венецуела	None
uzbek	начинът	None
utc	utc	Nan
utah	юта	Nan
vz	в.з.	Nan
usps	usps	Nan
urasílì	урацил	Nan
unla	да	None
unifasiti	университет	None
umueri	деца	None
ucb	ucb	Nan
tẹ̀ǹbẹ̀lẹ̀kun	конспирирам	Nan
tẹ̀ǹbẹ̀	тогава	None
túnse	пренареждане	Nan
túmò	слива	None
tú	наливам	Nan
tóka	цитирано	Nan
uribe	аурата	Nan
tó	tó	Nan
waa	то е	Nan
wari	мирис	Nan
yafran	азбука	None
xiv	xiv	Nan
xd	xd	Nan
wọ̀nyí	тези	None
wọn	тях	None
wúnrèn	разработете	Nan
wón	тях	None
wònyí	това са	Nan
wòfún	бегъл поглед	Nan
wípè	яснота	Nan
wì	измивам	Nan
waju	лице	None
wàásù	проповед	Nan
wura	злато	None
won	тях	None
wo	тук	None
wo	тук	None
woo	стремя се да спечеля	Nan
wole	впиши се	Nan
województwo	лудост	Nan
wiwari	откритие	None
witkin	witkin	Nan
wisconsin	уисконсин	Nan
westminster	английският парламент	Nan
wyoming	уайоминг	Nan
tówùú	всяка сума	Nan
tókù	почивка	None
tódárajùlọ	най-доброто	Nan
tokyo	токио	None
tokasi	посочен	Nan
toje	рядък	Nan
to	да се	Nan
tiwọn	техни	None
titu	фотосесия	Nan
tirè	му	None
tirana	тирана	Nan
tira	напрегнат	Nan
thumb|left|upright|nelson	палец | вляво | изправен | нелсън	Nan
those	тези	None
tolerejulo	поносим	Nan
they	те	None
tfrac	tfrac	Nan
terutomo	terutomo	Nan
temptation	търсене	None
tele	последващи действия	Nan
teksas	texas	Nan
tedo	запознанства	Nan
technology	технология	None
taínos	taínos	Nan
tata	филтър	Nan
tara	девет	None
talika	бедност	Nan
the	на	None
tolórítelémù	унищожение	Nan
tomé	домат	Nan
tooto	наистина ли	Nan
tóbi	голям	None
tò	комплект	Nan
tíórì	гуми	Nan
tíátà	билети	Nan
títío	до	None
títèlé	да последвам	Nan
títi	затворен	None
té	t	Nan
télè	от	None
té	t	Nan
tèsíwájú	да постигнем напредък	Nan
tèlé	веднага	None
tètè	бързо	None
tèlé	последващи действия	Nan
táawà	да се поклоним	Nan
tàwon	тях	None
tàsí	без	None
tuntun	нов	None
tumosi	средства	None
translated	преведена	Nan
traduite	traduite	Nan
tounsejanu	трагичен	Nan
toseluaralu	политически	None
torun	брюнетка	Nan
tori	тори	Nan
yakubu	якуб	Nan
metropoli	метрополи	Nan
yan	изберете	Nan
yanturu	много	None
àsìkò	път	None
àsèyìn	отава	Nan
àsàjemátèe	разсъмване	Nan
àse	пир	Nan
àrẹ	президент	None
àrùn	болест	None
àrígbámú	смущаващи	Nan
àpeere	пример	None
àpapọ̀	като цяло	Nan
ànfàní	възможност	None
àmúsorò	психология	None
àsótélè	разширение	None
àmúlò	практичен	Nan
àmérìkà	свръхестествен	Nan
àlébù	недостатък	Nan
àlèpò	по-горе	Nan
àlè	копеле	Nan
àlááfià	аналогия	Nan
àlàáfíà	мир	None
àlàyé	информация	None
àlàkalè	цели	None
àkókó	времето	None
àkójopò	група	None
àká	рафтовете	Nan
àmì	знак	None
àkàrà	торти	Nan
àsọdọ̀kan	единство	None
àsà	персонализиран	Nan
èdè	език	None
èdá	създаване	None
èbúté	порт	None
èbà	комар	Nan
áwon	разврат	Nan
án	t	Nan
àìsí	отсъствие	None
àìròtélè	неочакван	Nan
àìní	искам	Nan
àìkó	дефицит	Nan
àáyá	сперма	Nan
àsekúdórógbó	кора	None
àárín	по средата	Nan
ààtò	ритуал	None
àwùjo	общество	None
àwón	пари	None
àwón	парите	None
àwon	теории	None
àtẹnudẹ́nu	орално	Nan
àtúnse	редактиране	Nan
àtúnse	редактиране	Nan
àtòrìnká	кръг около	Nan
àtìpó	чужденецът	Nan
àtijo	остарял	Nan
ààyè	жив	None
àkosílè	теза	None
àkosílè	абстракция	Nan
àjọṣepọ̀	социален	None
yíì	ти ще	Nan
yíyípadà	промяна	None
yí	обърни се	Nan
yìí	това	None
yì	отивам	Nan
yée	да ги оставим	Nan
yèwò	виж	None
yára	побързай	Nan
yàtò	настройвам	Nan
yànan	учудване	Nan
yo	yo	Nan
yíò	ще стане	Nan
yorúbà	кисело мляко	Nan
yori	водена	None
yoo	ще	None
yiyafunnilo	ерозия	Nan
yipada	обърни се	Nan
yiowu	ще стане	Nan
yio	ще	None
yindinyindin	никога не спирай	Nan
ye	да	None
ye	да	None
yewo	подобрение	Nan
yaoundé	яунде	Nan
york	йорк	None
yẹ̀ẹ́	нали знаете	Nan
yọ	премахване	None
zanzibar centralsouth	занзибар централен	Nan
àjákọ	на части	Nan
àjo	пътуване	None
àifète	предназначение	None
àgọ́	палатка	Nan
àgbùdo	двор	None
àgbìgbò	квартал	None
àgbéyèwò	преглед	None
àgbékà	абстрактен	Nan
àgbáríjọ	организация	None
àgbàrá	наводнение	Nan
àgbàjọ	стария човек	Nan
àdóolóró	масло	None
àdáátán	изключителен	Nan
àdátá	обратното	None
àdámò	поверителност	Nan
àbọ̀	наполовина	Nan
àbìkú	безсмъртие	Nan
àbáyo	внушение	Nan
àbámẹ́ta	четвъртък	None
àbe	павиан	Nan
 bce	далеч	Nan
zy	zy	Nan
zscores	zscores	Nan
zou	зоу	Nan
zdna	zdna	Nan
yanjú	решителност	Nan
methodologies	методологии	Nan
merin	четири	None
mercosur	меркосур	Nan
díè	напрегнат	Nan
dìtẹ̀	конспирирам	Nan
dìró	отдясно	Nan
dìde	възникне	Nan
dì	лист	None
dépò	до степента	Nan
délànà	по принцип	Nan
dé	пристигнал	Nan
dáwó	дарят	Nan
dásà	каза	Nan
dáradára	добре	None
dóko	добре	None
dálóríi	благодаря ти	Nan
dágbó	старост	Nan
dá	създаден	None
dàpò	заменете ги	Nan
dàbíi	като този	Nan
dun	вкусно	Nan
due	поради	None
du	дю	Nan
dover	dover	Nan
doublestrand	doublestrand	Nan
doublehelix	doublehelix	Nan
dote	обичам безумно	Nan
dájó	добре	None
doni	дони	Nan
dólà	добре	None
dúró	стоя	Nan
eléré	спортист	Nan
eléde	абстрактен	Nan
elláda	създаване	None
eleyii	като този	Nan
eleyi	това	None
elede	прасета	Nan
eko	образование	None
ekeji	другият	None
eka	комплекс	None
eighteen	осемнадесет	Nan
egbògi	медицински	None
dún	звук	None
egbò	рана	Nan
egbo	рана	Nan
egberundun	хиляда години	Nan
egbe	пистолет	Nan
egba	абсолютно	None
efrem	effem	Nan
ede	език	None
ecomog	ecomog	Nan
ebi	семейство	None
eba	еба	Nan
ea	да	None
dọ́gba	равен	None
egbé	беда	Nan
elòmírà	морските водорасли	Nan
dominic	доминик	Nan
doju	лице в лице	Nan
clear	ясно	None
cipollone	cipollone	Nan
china	китай	None
cherished	заветната	Nan
chebbi	мисля	Nan
chaskalson	chaskalson	Nan
charles	чарлз	None
chamorro	чаморо	Nan
cbc	тгс	Nan
cauchy	коши	Nan
catherine	катрин	None
code	код	None
cathedral	катедрала	None
casablanca	казабланка	Nan
cape	нос	None
canaria	канария	Nan
calabar	дъвка	Nan
cairo	гняв	Nan
bẹ́ẹ̀sìni	да	None
bẹ́ẹ̀ni	да	None
bẹ́ljíọ̀m	берил	Nan
bẹ́	разорен	Nan
bẹ̀rẹ̀	за да започнете	Nan
búrú	бъди смел	Nan
caslon	казино	Nan
dojú	лице в лице	Nan
coetsee	coetsee	Nan
coming	идващ	Nan
divoire	divoire	Nan
dinwoju	погледни нагоре	Nan
din	дребна риба	Nan
different	различно	None
didasile	заведение	Nan
didagba	равенство	None
development	развитие	None
desmond	дезмънд	Nan
describes	описва	None
des	дес	Nan
denver	денвър	Nan
coloured	оцветен	Nan
delhi	недей	Nan
daru	унищожи	Nan
darapo	присъединяване	None
dani	холдинг	Nan
dandan	задължителен	Nan
dagbasoke	порасна	Nan
da	и	None
cunha	гърло	None
ct	ct	Nan
csto	одкс	Nan
computers	компютри	None
compared	сравнение	None
dates	дати	None
elòmíràn	друг	None
emerging	нововъзникващите	Nan
emmanuel	emmanuel	Nan
gbaná	стреля	None
gbale	популярност	None
gbajúgbujà	е много популярен	Nan
gba	съгласен	Nan
galatia	този път	Nan
fẹ́rẹ̀ẹ́	почти	None
fòye	разбирам	Nan
fífún	давайки	Nan
fífò	летене	Nan
fégbé	забрави	Nan
fé	fé	Nan
gbe	носене	Nan
fé	fé	Nan
funra	себе си	Nan
fun	за	None
fulbe	телно	Nan
fulani	страхлив	Nan
fuji	премахване	None
freetown	фрийтаун	Nan
fransi	френски	None
francis	франсис	Nan
fracmv	fracmv	Nan
fowó	за пари	Nan
fowobowe	резервация	Nan
further	още	None
fourbase	fourbase	Nan
gbera	продължа напред	Nan
gbese	дълг	None
geneva	женева	None
geesi	английски	None
gbọ́dọ̀	трябва да	Nan
gbúnùn	помириши го	Nan
gbónmisi	закон	None
gbódò	трябва да	Nan
gbìyànju	помъчи се	Nan
gbìnyànjú	опитвам	Nan
gbésè	оферта	Nan
gbéyèwò	преглед	None
gbéni	на живо	Nan
gberasoke	ускори	Nan
gbékalè	дърводелец	Nan
gbé	на живо	Nan
gbáradì	ставай	Nan
gbá	фалирам	Nan
gbàgùrà	поклати	Nan
gbàgbọ́	вярвам	Nan
gbongbo	корен	None
gbogbogbo	общ	None
gbin	засадени	Nan
gbilè	избухвам	Nan
gbigbewo	финансиране	Nan
gbigbamulo	експлоатация	None
gbédìí	установят	None
foriko	например	None
force	сила	None
foniimu	филм	None
eyonomba	eyonomba	Nan
eyin	яйца	None
eya	категория	None
example	пример	None
ewì	поезия	None
ewé	листо	Nan
ewe	листо	Nan
euroasia	евроазия	Nan
euro	евро	None
etíòkun	брегът	Nan
etymologiae	etymologiae	Nan
eléja	риболов	None
etisalat	etisalat	Nan
esia	идва	None
eseese	диаграма	Nan
eréonítàn	акроним	Nan
erékùsù	остров	None
erofo	утайка	Nan
ernst	ernst	Nan
epa	фъстък	Nan
eníbá	треска	None
enì	слон	Nan
enter	въведете	Nan
enikéni	всеки	None
esteri	естери	Nan
elòmíràn	някой друг	Nan
eka	ефект	None
eléyàmèyà	етническа принадлежност	Nan
fohùn	вик	Nan
fofinde	забрана	None
fodio	fodio	Nan
five	пет	None
fitino	пробен период	Nan
finlandi	финландия	None
finiki	физика	None
fimú	рязко дефиниран	Nan
fihan	указаната	Nan
fifihan	показване	Nan
fi	спасяване	Nan
fe	търси се	Nan
fesèmúlè	временен източник	Nan
ferde	ferde	Nan
felifeli	кадифе	Nan
farsi	arti	Nan
faranse	френски	None
faramó	спазвайте	Nan
fan	фен	None
fail	fail	Nan
fagile	отменен	Nan
ewà	на поведение	Nan
esè	постъпления	Nan
esin	религия	None
enu	уста	None
búburú	лошо	None
bòtswánà	автобусът	Nan
béè	просто така	Nan
bèrẹ̀	да започнем с	Nan
alawose	гадаене	Nan
alalaye	земен	None
alakobere	новак	Nan
alakitiyan	деец	Nan
alaini	беден	Nan
alaigbara	непреодолим	Nan
alaidogba	неуравновесен	Nan
aladanida	своеволен	Nan
aladani	частен	None
aladaani	частен	None
alaafin	незаконен	Nan
albany	albany	Nan
alaafia	мир	None
alaabo	хора с увреждания	Nan
ala	надолу	None
akẹ́kọ̀ọ́	студент	Nan
akíngbógun	батальон	Nan
akíkanjú	храбър	Nan
akátá	чакал	Nan
akopo	компилация	Nan
akopa	първо и най-важно	Nan
akoni	ние нямаме	Nan
akole	ние не можем	Nan
akokolo	период	None
alaadanida	нежелан	Nan
akinpelu	артилерия	None
albert	алберт	None
alicia	алисия	Nan
anc	anc	Nan
anabi	пророкът	Nan
an	един	None
améríkà	американски	None
améríkà	американски	None
amosi	джамия	None
amojeoyipada	сгъваем	Nan
amerika	америка	None
americas	северна и южна америка	Nan
amazonas	амазонас	Nan
alọ́po	портфейл	Nan
alexandra	александра	Nan
alúwo	стрела	None
aláyèwò	инспектор	Nan
alátise	художник	None
alápapò	замяна	None
alákọ̀bẹ̀rẹ̀	инициатор	Nan
alumíníọ̀mù	алуминий	None
alumoni	лечебен	Nan
alukuraani	коран	Nan
alubàbá	баща	None
alpha	алфа	None
alominira	независимост	None
allāh	аллах	None
aláísàn	болен	None
akiidah	coridah	Nan
ajọra	реплика	Nan
ajoro	пътуване	None
adiokan	самотен	Nan
adeda	природа	None
addis	адис	Nan
adarihunrun	чистач	Nan
adabaye	добре	None
adaba	удобен	Nan
accra	акра	Nan
abúléko	село	None
abínibí	националност	Nan
abé	игла	Nan
abálájo	опитен	Nan
adágbà	бъз	Nan
aburunmu	нашата мерзост	Nan
abidjan	някога	None
abidi	азбука	None
abesahara	пръскам	Nan
abeorile	завръщане у дома	Nan
abeikojopo	наследница	Nan
abala	частта	None
aawe	парализа	Nan
aare	ааре	Nan
aapon	aapon	Nan
aanu	съчувствие	Nan
aala	граница	None
abo	женски	None
adúgbò kútò	съседи на улицата	Nan
adúgbò mókóla	лигавица на лигавицата	Nan
adúgbò quarry	кариери съседи	Nan
ajo	пътуване	None
ajibola	дневен ред	Nan
ajemoroyin	разпит	Nan
aje	икономика	None
ajagun	куче	None
aisi	липса	None
aintimulo	aintimulo	Nan
agio	вик	Nan
agbéiná	пожарникар	Nan
agbára	мощност	None
agbàbò	защитник	None
agbà	възрастен	Nan
agbeinadie	земеделска земя	Nan
agbaye	светът	None
agbara	мощност	None
agbado	царевица	None
agba	боя	None
aféfé	вятърна мелница	Nan
africans	африканци	Nan
african	африкански	None
africa	африка	None
afoyemo	резюме	Nan
afomo	например	None
afida	семейството	None
adúgbò ìdí	квартални причини	Nan
andaman	andman	Nan
genevieve	женевиев	Nan
angkor	ангкор	Nan
anschluss	аншлус	Nan
benin	пейка	Nan
bengali	бенгалски	Nan
bengal	бенгалия	Nan
belgium	белгия	None
belarus	беларус	None
beijing	пекин	None
beauharnais	beauharnais	Nan
bce	далеч	None
bayìí	сега	None
bayi	сега	None
bayelsa	bayelsa	Nan
berber	берберски	Nan
bauxitealumina	bauxitealumina	Nan
banle	banle	Nan
bang	трясък	Nan
balẹ̀	нека бъде	Nan
bahrain	бахрейн	Nan
babaláwo	гадателят	Nan
baa	е	None
aṣòkan	индивидуален	Nan
azikiwe	здрав разум	Nan
ayò	ай	Nan
ayàfi	това е добре	Nan
ayeye	вечност	Nan
bara	миналата година	Nan
aya	стих	Nan
berlin	берлин	None
bharat	бхарат	Nan
báyìí	сега	None
bárakú	пристрастяване	Nan
bálè	балон	Nan
bákannáà	също	None
bàbá	бащата	None
by	от	None
burúkú	зло	Nan
bujumbura	разширен	Nan
buenaventura	буенавентура	Nan
bu	това е	Nan
brítánì	британски	None
bernstein	бърнстейн	Nan
britain	великобритания	None
brazzaville	бразавил	Nan
brasil	бразилия	None
bolívar	боливар	Nan
bolt	болт	Nan
bole	ствол	None
bojú	погледни	Nan
bodies	тела	None
black	черно	None
biribiri	беше смазан	Nan
bibeli	библията	None
bharata	върни се	Nan
bridgeport	бриджпорт	Nan
awújẹ	скандал	None
awùjo	учтивост	Nan
awuruju	магически	None
arábíà	азбучен	None
aráa	брат	None
aryan	ариецът	Nan
arun	болест	None
aruleyin	здравейте	Nan
aroko	растителност	None
arkansas	арканзас	Nan
ariwaguusu	югозападен	Nan
ariwaarin	средния изток	Nan
ariso	арис	Nan
arinkankan	този	None
aráròmí	здравейте	Nan
aralíle	тропически	None
apẹ̀rè	престилка	Nan
apòmù	престилка	Nan
apis	свещен бик	Nan
apeere	например	None
apeja	рибар	Nan
aparapo	съчетание	None
apaiwoorun	уестърн	Nan
apailaorun	изгрев	None
apaguusuiwoorun	югозапад	None
apaguusuilaorun	югозапад	None
apagusu	на юг	Nan
arabu	арабски	None
arópò	подкупничество	Nan
arúgbó	старост	Nan
arọ	куц	Nan
awon	тях	None
awoòn	шаблон	Nan
awonara	емоция	Nan
awo	плоча	None
awari	откритие	None
avar	аварския	Nan
austríà	австралия	None
austronesian	австронезийското	Nan
austriahumgary	austriahumgary	Nan
australia	австралия	None
atunse	корекция	Nan
atun	назад	None
atinrin	смее се	Nan
atimo	план	None
atigba	допустим	Nan
atanna	атом	None
atangbona	атом	None
asèdá	естественото	Nan
asìko	глупости	Nan
assessment	оценяване	Nan
asipa	отклонение	None
aseyori	успех	None
aseeto	селище	None
ascii	разбирам	Nan
asagun	победа	None
anita	анита	Nan
ọ̀rọ̀	говоря	Nan
georgia	грузия	None
gfaj	gfaj	Nan
kòjòkú	дъжд	None
kírísìtì	коледа	None
kínu	целуване	Nan
kíkọ́	да науча	Nan
kíko	изучаване	None
kí	поздравете	Nan
kìnní	първи	None
kéyìn	по късно	Nan
kémíkà	напротив	Nan
kétu	бъди подготвен	Nan
kékéèké	малък	None
kòkó	мишката	Nan
kéesì	смешен	Nan
kánádà	разбира се	Nan
kánfinkése	изобретателност	Nan
ká	на	None
kàyéfì	чудя се	Nan
kàríbẹ́ánì	в региона	Nan
kwara	адресирано	Nan
ku	вие	Nan
krio	крио	Nan
kori	няма повече	Nan
ko	ko	Nan
koko	изучаване на	Nan
káyé	свят	None
koto	стръв	Nan
kòmpútà	компютър	None
kòòsí	не е	Nan
labalaba	пеперуда	Nan
laarin	в рамките на	Nan
laaka	обратен	Nan
laada	удар	None
laa	махай се	Nan
kọ́ni	липса на	Nan
kọ́lọ́mú	колони	None
kọ́kọ́	първи	None
kọ̀mpútà	компютър	None
kọjá	минавам	Nan
kẹ́nyà	отделяне	None
kòtò	яма	Nan
kẹta	трета	None
kẹrin	четвъртият	None
kúùkù	напротив	Nan
kútò	всичко	None
kúrò	далеч	None
kúkúrú	накратко	None
kúkú	след всичко	Nan
kùrání	коранът	Nan
kùkú	след всичко	Nan
kóra	събирам	Nan
kógo	слава	None
kòòkan	всеки един	Nan
kẹsàán	веднага	None
labee	отдолу	None
kookan	това	None
kong	конг	None
kampala	клипс	Nan
kalẹ	заделени	Nan
kalinga	cinga	Nan
kakiri	следа	None
kagera	който обича да се хвали	Nan
kadara	актив	Nan
jọ́	моля те	Nan
jẹ́mánì	немски	None
jùló	повечето	None
jùlo	особено	None
jùlo	повече от	Nan
kan	а	None
jíjéomoléyìnkírísítì	като филантроп	Nan
jíje	същество	None
jìnnàa	далече	Nan
jéésù	исус	None
jé	идвам	Nan
jáde	излез	Nan
jàgídíjàgan	насилствен	Nan
juneau	джуно	Nan
jo	джон	None
jopò	присъедини се	Nan
jojo	cracked	Nan
johanu	съжалявам	Nan
jíjuwó	правя пари	Nan
kongo	презерватив	Nan
kankan	нито един	Nan
karbonumarun	thecentricane	Nan
komputa	компютър	None
kolo	коло	Nan
kojá	кръст	None
koidu	koidu	Nan
kodò	по-долу	Nan
ko	или	None
kinkinni	малкото нещо	Nan
kilhar	подмишница	Nan
kikuninu	представете си	Nan
kiko	изучаване на	Nan
kikoso	бърз	None
kanlè	kanal	Nan
kikopomo	топлина	None
kiko	привеждане	Nan
kiakiajulo	най-бързият	Nan
ki	така правя	Nan
khoisan	долен	None
kept	съхраняват	None
keko	грамотен	Nan
kekere	малък	None
kebbi	регулируем	Nan
karùún	петият	Nan
karun	пети	None
karl	карл	None
kikojo	компилация	Nan
lade	натоварвам	Nan
laid	положи	Nan
laifi	вина	None
mahatma	махатмата	Nan
madeira	бейра	Nan
maapu	карта	None
lọ́jà	на пазара	Nan
lọ́dọọdún	ежегодно	None
lọndọnu	лондон	None
lórò	утре	Nan
lónà	по пътя	Nan
ló	ló	Nan
lóòótọ́	наистина	None
lóòótò	да	None
makedonia	македония	None
lóti	много	None
lórì	пристанище	None
lópó	вдовица	Nan
lópez	nipez	Nan
lóde	извън	None
lítésò	язвителен	Nan
lísa	ускорение	Nan
lílo	експлоатация	None
lérú	робство	None
léyìn	по късно	Nan
léyin	по-късно	Nan
lérò	причина	None
lóríba	над	None
lérìnín	снега	Nan
malabo	пчелен мед	Nan
malayopolynesian	malayopolynesian	Nan
member	член	None
melo	колко	None
meksiko	мексико	None
mejila	дванадесет	None
mejidinlogbon	двадесет и осем	Nan
mefeefa	основен ремонт	Nan
mediteraneani	средиземно море	Nan
means	средства	None
mbabane	отрицателен	Nan
maya	не	None
max	макс	None
malay	предполага	None
mathimatiki	математически	None
matheu	матеу	Nan
maseru	ревност	Nan
maryland	мериленд	Nan
mars	марс	None
marku	този път	Nan
march	март	None
marcellus	марцел	Nan
manˈdeːla	mandelala	Nan
mango	манго	Nan
mali	ден	None
malaysia	малайзия	None
mathiew	mathiew	Nan
léebá	между другото	Nan
lédè	на език	Nan
lèyìn	по-късно	Nan
links	звена	Nan
linear	линеен	Nan
lindi	луга	Nan
lilongwe	лилонгве	Nan
lilemo	марихуана	None
lilelile	хардкор	Nan
leè	може	None
leyi	ето го	Nan
lewon	затваряне	Nan
lewaju	напред	None
less	по-малко	Nan
lodo	заеми място	Nan
lese	пост	None
lekun	засилена	Nan
leboa	lebo	Nan
le	мога	Nan
lay	лежаха	Nan
latvia	латвия	None
latini	латински	None
latigbana	от тогава	Nan
latibe	оттам	None
lasile	пускане	Nan
lanka	ланка	None
languages	езици	None
leo	лъв	None
lojowaju	в бъдеще	Nan
lojukokoro	алчен	Nan
lojúgun	той опустоши	Nan
lèe	мога	Nan
láíláí	никога	None
láì	без	None
lárúbáwá	естественото	Nan
lára	боли	Nan
lápá	част	None
lámọ́di	щастие	None
láké	шумен	None
láimo	без	None
láfún	даден	None
lábé	тегло	None
lààmì	знаци	None
lààmi	знак	None
làgba	равен	None
lynton	линтън	Nan
luther	лутер	None
luanda	луанда	Nan
lo	продължи	None
low	ниско	None
lovers	любителите	Nan
louvre	куличка с отвор в покрив	Nan
loruko	име	None
lopolopo	много	None
loloselu	политически	None
lokunkun	енергичен	Nan
johann	ад	None
jogun	наследен	None
jo	изтичане	Nan
jiròrò	мъгливо	Nan
ifitonileti	информация	None
ifilole	хвърлям	Nan
ifija	риболов	None
idánwò	пробен период	Nan
idupe	благодаря ти	Nan
idoma	чертеж	Nan
idimule	арестувам	Nan
ideraa	да пишеш	Nan
idari	контроли	Nan
idamita	рисувам	Nan
idajo	правосъдие	Nan
ifobaje	корупция	None
idaji	наполовина	Nan
idagbasoke	развитие	None
iceland	исландия	None
ibùjókòó	сядане	Nan
ibùdó	лагер	None
ibuso	да се биеш	Nan
ibuseripadabosi	възстановяване	None
ibujoko	пейка	Nan
ibori	воал	Nan
ibojì	гробница	None
ibn	ибн	Nan
ibiti	места	None
idagbe	пренебрегване	Nan
ibise	тренировка	Nan
ifofinde	конгрес	None
igbeduro	подготовка	None
iketa	да наследи	Nan
ikerin	четвъртият	None
ikeko	компилация	Nan
ikejidinlogun	осемнадесет	Nan
ikaowo	уважават	Nan
ikandinlogun	осемнадесет	Nan
ikan	един	None
ijó	танцуване	Nan
ijosin	преклонение	Nan
ijinnasi	физика	None
ije	движение	None
ifriqiya	стимулиране	None
ijaya	паника	Nan
ijagun	битка	None
ihinrere	евангелие	None
ihan	да се появи	Nan
igitòròmogbè	широколентов	Nan
igbáẹ̀yìn	последният	None
igbá	пиле	Nan
igbowolori	скъп	Nan
igbeyawo	сватба	None
igbesoke	подобряване на	Nan
igberiko	от предградията	Nan
igbegun	победа	None
ijakadi	борба	None
ibimo	раждане	None
ibile	традиционен	None
ibiamusin	светилище	None
gún	пробита	Nan
gòkè	върви нагоре	Nan
gírámà	дядо	None
gégé	наистина ли	Nan
gèésì	скъпоценен камък	Nan
gèésì	лепило	Nan
gv	gv	Nan
guusu	южно	None
gunle	пистолет	Nan
gun	дълго	None
guinébissau	guinébissau	Nan
gúúsù	южно	None
guineabissau	гвинея-бисау	Nan
guanínì	guanni	Nan
groove	жлеб	Nan
griiki	гръцки	Nan
grammy	грами	None
gquadruplex	gquadruplex	Nan
gorgina	орелът	Nan
gomina	губернатор	None
goemai	goemai	Nan
gidí	къща	None
gidigidi	много	None
ghana	гана	None
guinea	гвинея	None
gẹ̀ẹ́sì	английски	None
habsburg	хабсбургската	Nan
haggai	ръководство	None
ibewo	дойде	None
ibeji	близнаци	None
ibarepo	сдружаване	Nan
ibalo	афера	Nan
hv	hv	Nan
hungari	глад	None
hun	хун	Nan
hugh	хю	Nan
hp	к.с.	Nan
hosea	осия	Nan
hominidae	човекоподобни	Nan
histoni	histoni	Nan
hindu	hindu	Nan
him	него	None
hesse	съгласуван	Nan
heraklion	ираклион	Nan
henny	хени	Nan
hendu	бонбони	Nan
heinrich	хайнрих	None
hawaii	хавай	Nan
hausafulani	hausafulani	Nan
haughton	haughton	Nan
hard	трудно	None
halomonadaceae	halomonadaceae	Nan
haiti	хаити	Nan
ikoenu	да запазя	Nan
german	немски	None
ikojopo	натрупване	None
iku	смърт	None
itumo	значение	None
itu	хвърлям	Nan
itorawo	либерален	Nan
itokowo	бизнес	None
itobi	да се хваля	Nan
itiraka	борба	None
itelentele	ясно	None
itanakole	история	None
itali	италиански	None
isè	обслужване	None
isesi	предаване	None
iwadi	изследване	None
isun	поток	None
iso	да дойде	Nan
isepinpin	разпределение	None
iseowo	бизнес	None
iseoroayeijoun	археология	Nan
iseoba	петнадесет	Nan
isejoba	управление	None
iseero	гледам	Nan
isedaniloro	съмнение в себе си	Nan
isare	ускорение	Nan
isa	достатъчно	None
irúnmọlẹ̀	мълния	Nan
isoponomba	isoponomba	Nan
irò	слух	None
iwasi	впечатлявам	Nan
iwoile	у дома	Nan
jijinna	далече	Nan
jije	същество	None
jfk	jfk	Nan
jesu	исус	None
jeometri	геометрия	None
jeffrey	джефри	Nan
jawaharlal	люлки	Nan
jamo	махай се	Nan
jamaica	youtube	Nan
jalè	кражба	Nan
jagbe	изгуби се	Nan
iwifun	информация	None
jadide	задръжте	Nan
jabo	доклад	None
iṣẹ́ìwádìí	изследване	None
iḷẹ̀	работа	None
iyán	искрящ	Nan
iyen	това е	Nan
iyawo	булка	Nan
iyato	разликата	None
iyan	глад	None
iwuwa	практика	None
iwulo	полезен	Nan
iwosan	лечебен	Nan
jackson	джексън	None
irorun	много просто	Nan
irisi	външен вид	Nan
iringa	увивам	Nan
ilẹ̀ayé	земята	None
ilẹ	приземен	Nan
iléńlá	двор	None
iléàtèéré	у дома	Nan
ilélódò	къщата	None
iléisé	у дома	Nan
iléayé	у дома	Nan
ilé	у дома	Nan
iluorilejoba	глобализация	Nan
iluoba	гражданство	None
ilopo	двойно	None
iminle	да арестуват	Nan
ileru	пещ	Nan
ileigbimo	съгласие	None
ileife	пренебрегване	Nan
ilegiga	у дома	Nan
ileasofin	законодателен	None
ilaorun	изгрев	None
ilaodo	защитавам	Nan
ilanaoye	стратегии	Nan
ilana	процедура	Nan
ilagbolojo	публичност	Nan
ikún	пълнеж	Nan
ikúgbaèyí	сега	None
ileobaluaye	светът	None
imoero	осветление	None
imojuto	грижа	Nan
imusin	рисувам	Nan
irele	смирение	Nan
ire	продажба	Nan
iranlose	помощ	None
iraja	скандален	Nan
ipá	сила	None
ipo	местоположение	None
ipinu	решение	None
ipinpa	участие	None
ipin	глава	None
ipele	ниво	None
ipawo	употреби	Nan
ipare	замирам	Nan
iowa	на земята	Nan
ioniani	беден	Nan
ioja	риба	Nan
inúnibíni	преследване	None
iní	наследяване	Nan
inágbéringbérin	седемнадесет	Nan
integration	интеграция	None
inkosi	за да се оправдае	Nan
indus	индус	Nan
indeed	наистина	None
inagberingberi	фъстъчено масло	Nan
imúnisìn	хигиена	Nan
imú	нос	None
ikoreokere	жътва	Nan
ọ̀sẹ	седмица	None
