aajo	belachelijk	Nan
púpò	liever	None
púpo	veel	None
pò	vouwen	Nan
pòwe	spreekwoorden	Nan
pípẹ́	lang	None
pípèsè	voorziening	Nan
pípa	slachten	Nan
péé	dat	None
péré	alleen	None
pé	dat	None
pèsè	voorzien	None
quran	koran	None
pèlúpèlú	ook	None
pèhìndà	sperma	None
pè	gebeld	Nan
pátáporongodo	absoluut	None
pásíà	kelder	None
pàápàá	vooral	None
pààlà	grens	None
pàràkòyí	direct	None
pàmò	concreet	Nan
px|kùránì	px |	Nan
pupa	rood	None
príncipe	principe	None
pèlu	met	None
providence	voorzienigheid	Nan
ra	kopen	None
rajya	hoop	None
rome	chroom	Nan
roma	roma	None
roko	bende	Nan
rokirika	browsen	Nan
rogbodiyan	herrie	Nan
roboto	oppervlakken	Nan
robinson	robinson	Nan
ro	denken	None
rnas	rnas	Nan
rnarna	rnarna	Nan
rna	rna	None
race	ras	None
rn	rn	Nan
riresile	recorder	Nan
rinle	nieuw	None
right|thumb|px|aworan	afbeelding	None
richard	richard	None
research	onderzoek	None
rere	goed	None
repetejulo	gevoelig	None
repeats	herhaalt	Nan
reggae	reggae	Nan
rank	rang	None
ramadan	ramadan	None
riro	verbeelding	None
ronald	ronald	None
proton	proton	Nan
produced	geproduceerd	None
palauan	palauan	Nan
padá	peul	Nan
paapaa	vooral	None
paa	uitschakelen	Nan
opolo	veel	None
ofò	goedemorgen	Nan
oyé	wereld	None
ose	uit	None
opolo	veel	None
omonìyàn	mensen	None
olorun	god	None
panaˈma	panama	None
odun	jaarlijks	None
olórun	god	None
okùnrín	gelach	Nan
ojó	is	None
odún	jaar	None
oúnjẹ	eten	None
owojagidijagan	terroristen	Nan
oun	hij	None
otutu	veel	None
otherwise	anders-	Nan
oseluarailu	burger	None
oscar	oscar	None
olósìn	religieus	None
protokolu	protocolu	Nan
panyanan	teken	None
parapọ̀	mengsel	None
press	op	None
portuguese	portugees	None
portonovo	portonovo	Nan
population	bevolking	None
polaroid	polaroid	Nan
polandi	pools	None
pojulo	hoogste	None
po	po	None
plánẹ́tì	loodgieter	Nan
platos	platos	Nan
piposi	veel	None
papa	papa	Nan
pipolongo	advertentie	Nan
pinu	vastbesloten	Nan
pinsoto	pinoto	Nan
pinsi	afnemend	Nan
phillipines	phillipines	Nan
pelu	parel	Nan
petu	petu	Nan
periferi	periferi	Nan
penisula	penisula	Nan
penh	penh	Nan
pele	charmant	Nan
paripari	einde	None
pipo	veel	None
rorùn	gemakkelijk	None
rossii	rossii	Nan
rural	landelijk	None
sìbẹ̀	nog	None
séyìn	terug	None
séyìn	terug	None
sénégal	sperma	None
ségun	huilen	Nan
sèle	stelen	None
são	nieuwe	None
sáààrin	tussenin	Nan
sáàpàdé	sponsoring	Nan
sápadè	dag	None
sàì	goed	None
sìni	garnalen	Nan
sàngó	bende	Nan
sàmì	een	None
sàbúrí	bovenal	Nan
symmetry	symmetrie	Nan
swahili	swahili	Nan
suny	suny	Nan
sun	zon	None
sugbọ́n	rationeel	Nan
sugbo	niet	None
suez	suez	Nan
structures	structuren	None
stella	stella	Nan
sàn	beter	None
spectacular	spectaculair	Nan
síbèsíbè	niettemin	None
sílẹ̀	gelaten	None
tabora	vermijding	Nan
tabili	tafel	None
tabi	of	None
sísè	vertaling	None
sísa	s	None
sááju	even	None
sisé	uitwerken	Nan
sepò	tenslotte	None
se	doen	None
sùgbón	integendeel	Nan
síse	structuur	None
síbú	grond	None
si	zeker	None
sùgbón	integendeel	Nan
sóko	fabriek	None
sójà	soldaat	None
sòrò	hersenspoeling	Nan
síí	hier	None
síwájú	voorwaarts	Nan
síwon	hen	None
síta	buiten	None
síso	steeds	None
síso	steeds	None
síse	werk	None
sọ	zeggen	None
so	zo	None
sopin	einde	None
soon	spoedig	None
say	zeggen	None
santa	kerstman	None
samioro	beschikbaar	None
sambia	jeugd	None
salàyé	leven	None
salem	salem	Nan
sakyas	sakya&#39;s	Nan
sakyamuni	volgende	None
saheli	gemak	Nan
safta	staan	None
safiwe	vergelijking	None
sb	sb	Nan
saffana	saffier	Nan
saarland	vloer	None
saaree	beter	None
saarc	verwijderen	None
rẹ	haar	None
ròyìn	gemeld	None
rìn	lopen	None
ré	c	None
république	république	Nan
ránmú	maken	None
ráhàn	verscheen	None
ryan	ryan	Nan
safari	safari	Nan
schwarz	schwarz	Nan
sea	zee	None
seat	stoel	None
solomon	solomon	Nan
sohun	ja	None
so	liefde	None
slovo	slovo	Nan
sisupo	vermenigvuldigen	None
sisupapoerekusu	spugen	Nan
sisopo	koppelen	Nan
sisodagba	opgroeien	Nan
sise	koken	Nan
sioux	sioux	Nan
sinsin	religie	None
sinai	zonde	None
silè	druppels	Nan
sile	achter	None
sihamoni	structuur	None
sibesibe	nog	None
sharon	sharon	Nan
sewadi	zoeken	None
seville	sevilla	None
sense	zin	None
senegal	senegal	Nan
semudaju	natuurlijk	None
semolara	astma	Nan
seidamo	doorzichtig	Nan
segbese	mogelijk	None
orúko	veld	None
taino	dino	Nan
orísìírísi	soorten	None
orísiirísi	verschillende	None
nombamewa	vermenigvuldigen	None
nobel	nobel	Nan
nnaji	oom	None
nkàn	kanker	None
nkan	ding	Nan
niyi	het	None
niye	genoeg	None
niyato	onderscheiden	None
niwaju	verder	None
nitosi	dichtbij	None
nitoripe	omdat	None
nombáméjì	twee	None
nitoriidieyi	dit	None
nilè	hier	None
nijẹr	nike	Nan
nigbà	vervolgens	None
nigbakan	soms	None
nibere	vroeg	None
nibe	daar	None
ngubengcuka	ngubengcuka	Nan
ngbero	gepland	None
nevis	naevis	Nan
neptune	neptunus	Nan
nefimu	nephim	Nan
nisinyi	nu	None
nebraska	nebraska	Nan
novo	novo	Nan
nse	ontwerp	None
nínlá	goed	None
nílẹ̀	grond	None
nílùú	stad	None
nílè	hieronder	None
nígbàtí	wanneer	None
nífẹ̀ẹ́	van	None
níbè	daar	None
níbè	daar	None
ní	hebben	None
nìyí	het	None
nìnú	sorry	Nan
nri	eten	None
nì	berg	None
náwo	kosten	None
nàìjíríà	nigeria	None
nwa	baby	None
numeri	gevoel	None
nukleotidipupo	nucleotide	Nan
nukleotidi	nucleotide	Nan
nu	schoon	None
ntoka	punt	None
nsowikipedia	obowikipedia	Nan
nsolaboraro	veiligheid	None
nso	buurt	None
náà	te	None
nínu	kans	None
ncnc	ncnc	Nan
nawojulo	raadselachtig	Nan
munispal	munispal	Nan
mulẹ̀	brengen	None
mughal	volume	None
mtwara	opnieuw	None
mtn	mtn	Nan
mozilla	mozilla	Nan
mozambique	mozambique	Nan
morogoro	autorijden	Nan
morgan	morgan	None
monrovia	monrovia	Nan
mombasa	mombasa	Nan
muungano	muungano	Nan
mokanlelogbon	tweeëndertig	Nan
mohandas	mohandas	Nan
minority	minderheid	None
minnesota	minnesota	Nan
mimuwa	vastklampen	Nan
mimoy	mimoy	Nan
miiràn	verlichten	Nan
micronesia	micronesië	Nan
michelle	michelle	None
mexico	mexico	None
mewar	mewar	Nan
meucci	meucci	Nan
mokaleladota	compact	Nan
nawó	geld	None
májèmú	erg	None
méjèèjì	beide	None
nato	nato	Nan
nathaniel	nathaniel	Nan
namibia	komen	None
mẹ́talọ́kan	drie-eenheid	Nan
mẹ́ta	drie	None
mẹ́rkúríù	muis	None
mẹ́fà	zes	None
múlẹ̀	vast	None
mó	m	Nan
móra	genezen	None
mókólà	lijm	Nan
mère	tekening	None
mò	kennis	None
míìrán	ander	None
míràn	ander	None
mímọ́	heilig	None
ménu	je	None
méwàá	tien	None
métèètà	timmerman	Nan
méta	drie	None
mérìnlélógójì	vierenveertig	Nan
mérìndínlógún	zestien	None
méte	vijf	None
mérindíláàdóta	vijfenvijftig	Nan
mííràn	ander	None
níní	hebben	None
nípà	tenminste	None
nítorípé	omdat	None
onítumò	vertaler	Nan
oníná	brand	None
onílẹ̀	beneden	None
oníkólóbó	beledigend	Nan
onígbàgbó	oude	None
onka	rekenmachine	Nan
onje	eetpatroon	Nan
oniyijulo	geweldig	Nan
oniyewumeji	binair	Nan
onisowo	handelaar	Nan
onisayensi	technicus	Nan
onítèbọmi	de	None
onipin	rationeel	Nan
onilile	huiseigenaren	Nan
onilanaibagbepo	condoom	None
onigunfenfe	passief	None
onigbowo	een	None
onigbeja	constructief	Nan
onibugbe	huurder	Nan
onialjebra	onialjebra	Nan
omiadalu	overstroming	Nan
omi	water	None
olùkọ́	leraar	None
olùkó	instructeur	Nan
oninawo	lener	Nan
olùkópa	bijdrager	Nan
onítòhùn	accountant	Nan
oníyanjù	geanimeerd	Nan
orílẹ́	avond	None
orílẹ̀	natie	None
orílèèdè	nationaal	None
oríkì	poëzie	None
oríilẹ̀	artikel	None
oríilè	nationaal	None
oruko	zelfstandig	None
orudnun	jaarlijks	None
oritameta	middenin	Nan
orisa	oorsprong	None
orisun	bron	None
oníwòsàn	de	None
orisirisi	verscheidenheid	None
orileominira	warmte	None
orilejoba	regering	None
orileedeajoba	imperialisme	Nan
orileede	natie	None
oriki	oosters	Nan
oriire	gefeliciteerd	Nan
ori	hoofd	None
opposite	tegenover	None
opec	opec	Nan
ootọ́	waar	None
ooni	krokodil	Nan
orinìyìn	lied	None
olùdarí	leider	None
olùbátan	contact	None
olóṣèlú	politicus	None
ojùkòsì	neerslag	None
ojuse	verantwoordelijkheid	None
ojuoorun	zonsondergang	Nan
ojukokoro	hebzucht	Nan
ojoru	warmte	None
ojojumo	dagelijks	None
ojo	als	None
ogunlogo	menigte	Nan
ogun	oorlog	None
ogbè	regio	None
ofin	wet	None
ojùkòtúu	neerslag	None
ododo	gerechtigheid	Nan
obere	klein	None
obairanderan	neef	None
oba	obama	None
nso	komt	None
nǹkan	ding	Nan
níyanjú	positief	None
níwájú	verder	None
nítòótọ́	inderdaad	None
nítòótó	precies	None
nítòsí	dichtbij	None
nítumò	betekenis	None
obínibí	hoffelijkheid	Nan
ojúlùmọ̀	bekenden	Nan
ojútáyé	viscositeit	Nan
ojúìwé	bladzijde	Nan
olóyè	heerser	None
olódùmarè	almachtig	Nan
olympus	olympus	Nan
oluwakiri	verkenning	Nan
olusoju	bewaker	Nan
oluparapo	combinatie	None
olumojuto	hebzuchtig	Nan
olukowe	auteur	None
olukoitan	instructeur	Nan
oludase	producent	None
oluda	schepper	None
oloye	genie	None
oloselukan	hallo	Nan
olora	vet	None
olopon	hooghartig	Nan
ololugbe	verliezer	Nan
olokunkun	hoofdtelefoon	Nan
olojukanna	direct	None
olohun	eigenaren	Nan
olodiajodojuko	elkaar	None
okunrin	de	None
okunkun	duisternis	Nan
oko	veld-	Nan
okhotsk	okhotsk	Nan
okeere	overzee	Nan
orísìí	verscheidenheid	None
tainos	tainos	Nan
takuntakun	beperkingen	None
talaka	arm	None
ìràwọ̀	sterren	None
ìrànàna	helpen	None
ìrànlọ́wọ́	helpen	None
ìpínrò	paragrafen	Nan
ìpìnlè	begin	None
ìpìlẹ̀núkléù	encryptie	Nan
ìpolongo	reclame	None
ìnáwó	uitgaven	None
ìnagije	zege	Nan
ìmúsára	aansterken	Nan
ìmúnilérú	misbruiken	Nan
ìrí	ervaring	None
ìmú	neus-	Nan
ìmò	bliksem	Nan
ìmò	slang	None
ìlé	huis	None
ìlè	omkoping	Nan
ìlàìnàró	onderdrukking	None
ìlàorùn	plekken	None
ìlànàn	illusie	None
ìlà	overzicht	None
ìlo	bellen	None
ìlera	gezondheid	None
ìkọpa	deelname	None
ìmóbìdo	het	None
ìkẹrin	vierde	None
ìròkò	gedachte	None
ìròyìnwiki	nieuws	None
ìtaeko	werkplaats	Nan
ìta	buiten	None
ìse	actie	None
ìsòro	moeilijkheid	Nan
ìsílé	huis	None
ìsèjoba	regering	None
ìsèdá	creatie	Nan
ìsègbèfábo	ijver	Nan
ìse	actie	None
ìsọ	winkels	None
ìsú	dikte	None
ìròyìn	nieuws	None
ìsòrí	onderverdeling	None
ìsìn	religie	None
ìsèlè	productie	None
ìsàlè	zonsondergang	Nan
ìsomó	meedoen	None
ìsirò	berekening	None
ìsinsìnyí	nu	None
ìse	actie	None
ìsawo	waarzeggerij	Nan
ìrúbo	ineenstorting	Nan
ìró	geluid	None
ìròrùn	illusie	None
ìsòrò	meditatie	Nan
ìtan	geschiedenis	None
ìkínin	zesde	None
ìkìjà	uitdaging	None
ìdá	desertie	Nan
ìdàrúdàpò	chaos	None
ìdàpapọ̀	consolidatie	Nan
ìdàgbà	volwassenheid	Nan
ìbílè	geboorterecht	Nan
ìbílè	geboorterecht	Nan
ìbáraeni	vervoer	None
ìbánisòrò	verbinding	None
ìbarà	koorts	None
èpón	veel	None
èwù	overhemd	Nan
ìdìmú	verstoring	None
èsìn	religie	None
èro	gedachten	None
èka	effect	None
èyì	waardigheid	Nan
ète	doel	None
èsúrú	mieren	None
èsó	moskee	None
èrò	gedachten	None
èràn	ziekte	None
ènìkan	iets	None
èlò	gebruiksvoorwerpen	Nan
èkejì	andere	None
èrí	bewijs	None
ìkìlò	misbruik	None
ìdíisin	oorzaak	None
ìdó	steek	None
ìkéde	verklaring	None
ìkèrèkú	congestie	Nan
ìkànna	hetzelfde	None
ìkejì	andere	None
ìjọba	regering	None
ìjò	leider	None
ìjìnlè	mysterie	None
ìjìnlè	mysterie	None
ìjora	aan	None
ìjoba	regering	None
ìjo	kerk	None
ìdíwòn	reden	None
ìjo	dans	None
ìgbò	ram	Nan
ìgbésí	leven	None
ìgbéraga	trots	None
ìgbáraga	kracht	None
ìgbá	vleugels	None
ìgbàgbé	vergeetachtig	Nan
ìgbà	tijd	None
jé	ramp	None
ìfáàrà	priester	None
ìfojúìtànìgbesiayé	levensgeschiedenis	Nan
ìfara	martelen	Nan
ìhun	ijzer	None
ìtokò	de	None
ìtàn	geschiedenis	None
ìtànkálé	overstromingen	None
ṣàkóbá	schadelijk	None
ṣiṣé	opening	None
σ	σ	Nan
κάππα	.α	Nan
ˌæləˈbæmə	ziekte	None
ˌkælɪˈfɔrnjə	ɪˈkælɪˈfɔrnjə	Nan
ˈøːstəˌʁaɪç	ˈøːstəˌʁaɪç	Nan
ʔaːnaːtɕɑ̀k	.aːnaːtɕɑɕɑk	Nan
şe	doen	None
únṣẹlẹ̀	aardbeving	None
ôdún	jaar	None
ẹdo	grap	Nan
ó	ja	None
ósírísì	speeksel	Nan
óníse	ontwerper	None
ó	het	None
òròàjòmó	de	None
òrò	gedachten	None
òwó	geld	None
òsà	goudvis	Nan
òrò	gedachten	None
òré	spel	None
òpòlopo	veel	None
òfò	volgende	None
ósékú	dood	None
òré	spel	None
ẹlẹ́bùn	een	None
ẹnìkan	persoon	None
ọ̀pòlòpò	actie	None
ọ̀nà	manier	None
ọ̀gbìn	fabriek	None
ọ̀dọ́	jeugd	None
ọpọ́lọpọ́	vijgen	Nan
ọn	het	None
ọmọ	kind	None
ọmú	je	None
ọlọ́run	god	None
ọlọ́mọ	kinderen	None
ọdún	jaar	None
ẹlẹ́sìn	religieus	None
ọbàkàn	halfbroer	Nan
ẹ̀rọ	machines	None
ẹ̀ni	who	None
ẹ̀kọ́	opleiding	None
ẹ̀kẹ́ta	derde	None
ẹ̀kasístẹ̀mù	subjectief	Nan
ẹ̀kaoṣù	netelig	Nan
ẹ̀kajuly	mei	None
ẹ̀kabrítánì	oom	None
ẹ̀kaawon	inzendingen	Nan
ẹtì	lever	None
ẹsẹ	voeten	None
ẹ̀wẹ̀	anderzijds	None
òpòlopò	veel	None
òkòòkan	een	None
òkan	een	None
òdo	jeugd	None
òdeojú	gezichtsloos	Nan
òde	buiten	None
ìṣọ̣̀tẹ̣̀	longontsteking	None
ìṣẹ́kù	het	None
ìṣèlú	politiek	None
ìyípadà	conversie	Nan
ìyàwó	de	None
ìyapa	scheiding	None
ìya	lijden	None
ìwúlò	nuttig	Nan
òdìkejì	andere	None
ìwòran	visie	None
ìwéré	boekje	Nan
ìwàásù	prediking	Nan
ìwo	hoorns	Nan
ìwe	vergelijking	None
ìtúpalè	vertaling	None
ìtúmò	vertaling	None
ìtóka	worden	None
ìtójú	gezichtsuitdrukkingen	Nan
ìtóju	verwarring	None
ìtójú	zorg	None
ìtèsíwájú	vooruitgang	None
ìwò	algemeen	None
òféàrán	afbeelding	None
ògbójú	bekwaam	Nan
ògiri	muur	None
òjògbón	weer	None
òṣèlú	politiek	None
òwù	kleding	None
òsèré	atleet	Nan
òsèlú	politicus	None
òsán	middag	None
òrò	hersenen	None
òrí	hoofdstuk	None
òrìsà	afgoden	Nan
òranyàn	verplicht	None
òpópóònà	weg	None
òotó	waarheid	None
òní	vandaag	None
òmùàrán	afbeelding	None
òmiràn	de	None
òle	huisvrouw	Nan
òkúta	steen	None
òkú	lijken	None
òkòòkan	een	None
òkèògbún	duizend	None
òjísé	dokter	None
òjo	als	None
ògúndìpẹ̀	poederachtig	Nan
ògun	geneesmiddel	None
ògo	heerlijkheid	Nan
èka	afdeling	None
èhìn	volgende	None
èfòn	gespannen	None
èdè	taal	None
visit	bezoek	None
viruses	virussen	None
villa	villa	None
vihara	vihara	Nan
videos	videos	None
victor	victor	None
vermont	vermont	Nan
venezuela	venezuela	None
uzbek	weg	None
utc	utc	None
utah	utah	Nan
vz	vz	Nan
usps	usps	Nan
urasílì	uracil	Nan
unla	ja	None
unifasiti	universiteit	None
umueri	kinderen	None
ucb	ucb	Nan
tẹ̀ǹbẹ̀lẹ̀kun	samenzweren	Nan
tẹ̀ǹbẹ̀	vervolgens	None
túnse	herschikken	Nan
túmò	pruim	Nan
tú	uitstorten	Nan
tóka	aangehaald	None
uribe	de	None
tó	tó	Nan
waa	is	None
wari	geur	None
yafran	alfabet	None
xiv	xiv	None
xd	xd	Nan
wọ̀nyí	deze	None
wọn	hen	None
wúnrèn	trainen	None
wón	hen	None
wònyí	zijn	None
wòfún	oogopslag	Nan
wípè	duidelijkheid	Nan
wì	weg	None
waju	gezicht	None
wàásù	prediken	Nan
wura	goud	None
won	hen	None
wo	hier	None
wo	hier	None
woo	woo	Nan
wole	inloggen	Nan
województwo	cheworddztwo	Nan
wiwari	ontdekking	None
witkin	witkin	Nan
wisconsin	wisconsin	Nan
westminster	westminster	None
wyoming	wyoming	Nan
tówùú	aantal	None
tókù	uit	None
tódárajùlọ	beste	None
tokyo	tokyo	Nan
tokasi	erop	None
toje	bijzonder	None
to	naar	None
tiwọn	hen	None
titu	schieten	None
tirè	zijn	None
tirana	tirana	Nan
tira	gespannen	None
thumb|left|upright|nelson	nelson	None
those	die	None
tolerejulo	getolereerd	Nan
they	ze	None
tfrac	tfrac	None
terutomo	terutomo	Nan
temptation	naar	None
tele	opvolgen	Nan
teksas	texas	None
tedo	dating	Nan
technology	technologie	None
taínos	taínos	Nan
tata	filter	Nan
tara	negen	None
talika	armoede	None
the	de	None
tolórítelémù	holocaust	None
tomé	tomaat	Nan
tooto	werkelijk	None
tóbi	groot	None
tò	ingesteld	None
tíórì	banden	None
tíátà	kaartjes	Nan
títío	tot	None
títèlé	volgen	None
títi	gesloten	None
té	t	Nan
télè	door	None
té	t	None
tèsíwájú	boeken	None
tèlé	direct	None
tètè	snel	None
tèlé	opvolgen	Nan
táawà	buigen	None
tàwon	hen	None
tàsí	zonder	None
tuntun	nieuw	None
tumosi	middelen	None
translated	vertaald	None
traduite	traduite	Nan
tounsejanu	tragisch	Nan
toseluaralu	politiek	None
torun	brunette	Nan
tori	tori	Nan
yakubu	yakub	Nan
metropoli	metropoli	Nan
yan	selecteer	Nan
yanturu	genoeg	None
àsìkò	tijd	None
àsèyìn	nasleep	Nan
àsàjemátèe	dageraad	Nan
àse	feest	None
àrẹ	president	None
àrùn	ziekte	None
àrígbámú	verontrustend	Nan
àpeere	voorbeeld	None
àpapọ̀	geheel	None
ànfàní	kans	None
àmúsorò	psychologie	None
àsótélè	uitbreiding	None
àmúlò	praktisch	None
àmérìkà	bovennatuurlijk	Nan
àlébù	smet	Nan
àlèpò	bovenstaande	None
àlè	bastaard-	Nan
àlááfià	analogie	Nan
àlàáfíà	vrede	None
àlàyé	informatie	None
àlàkalè	doelen	None
àkókó	tijd	None
àkójopò	groep	None
àká	planken	Nan
àmì	teken	None
àkàrà	taarten	Nan
àsọdọ̀kan	eenheid	None
àsà	maat	None
èdè	taal	None
èdá	creatie	Nan
èbúté	haven	None
èbà	muggen	None
áwon	ontucht	Nan
án	t	None
àìsí	afwezigheid	None
àìròtélè	verwacht	None
àìní	willen	None
àìkó	tekort	None
àáyá	sperma	None
àsekúdórógbó	schors	Nan
àárín	middenin	Nan
ààtò	ritueel	Nan
àwùjo	maatschappij	None
àwón	geld	None
àwón	geld	None
àwon	theorieën	None
àtẹnudẹ́nu	mondeling	Nan
àtúnse	bewerk	Nan
àtúnse	bewerk	Nan
àtòrìnká	rotonde	Nan
àtìpó	de	None
àtijo	verouderd	Nan
ààyè	levend	None
àkosílè	scriptie	Nan
àkosílè	abstractie	Nan
àjọṣepọ̀	sociaal	None
yíì	zal	None
yíyípadà	verandering	None
yí	om	None
yìí	dit	None
yì	gaan	None
yée	ze	None
yèwò	kijken	None
yára	je	None
yàtò	opgericht	None
yànan	verbazing	Nan
yo	yo	Nan
yíò	zal	None
yorúbà	yoghurt	Nan
yori	led	None
yoo	zullen	None
yiyafunnilo	erosie	None
yipada	om	None
yiowu	zal	None
yio	zal	None
yindinyindin	nooit	None
ye	ja	None
ye	ja	None
yewo	verbetering	None
yaoundé	yaoundé	Nan
york	york	None
yẹ̀ẹ́	je	None
yọ	verwijderen	None
zanzibar centralsouth	zuid	None
àjákọ	deel	None
àjo	reizen	None
àifète	doel	None
àgọ́	tent	Nan
àgbùdo	werf	Nan
àgbìgbò	buurt	None
àgbéyèwò	beoordeling	None
àgbékà	abstract	None
àgbáríjọ	organisatie	None
àgbàrá	overstroming	Nan
àgbàjọ	oude	None
àdóolóró	olie	None
àdáátán	exclusief	None
àdátá	tegenovergestelde	None
àdámò	privacy	Nan
àbọ̀	helft	None
àbìkú	onsterfelijkheid	Nan
àbáyo	suggestie	Nan
àbámẹ́ta	donderdag	None
àbe	baviaan	Nan
bce	weg	None
zy	zy	Nan
zscores	zscores	Nan
zou	zou	None
zdna	zdna	Nan
yanjú	oplossen	None
methodologies	methodologieën	Nan
merin	vier	None
mercosur	mercosur	Nan
díè	gespannen	None
dìtẹ̀	samenzweren	Nan
dìró	de	None
dìde	ontstaan	None
dì	vel	Nan
dépò	voorzover	Nan
délànà	principe	None
dé	aangekomen	None
dáwó	doneren	Nan
dásà	casa	None
dáradára	goed	None
dóko	goed	None
dálóríi	u	None
dágbó	leeftijd	None
dá	gemaakt	None
dàpò	ze	None
dàbíi	soortgelijk	Nan
dun	smakelijk	Nan
due	vanwege	None
du	du	Nan
dover	dover	Nan
doublestrand	doublestrand	Nan
doublehelix	dubbele	None
dote	dote	Nan
dájó	oke	Nan
doni	doni	Nan
dólà	goed	None
dúró	staan	None
eléré	atleet	Nan
eléde	abstract	None
elláda	creatie	Nan
eleyii	soortgelijk	Nan
eleyi	dit	None
elede	varkens	None
eko	opleiding	None
ekeji	andere	None
eka	complex	None
eighteen	achttien	None
egbògi	medisch	None
dún	geluid	None
egbò	een	None
egbo	een	None
egberundun	jaar	None
egbe	geweer	Nan
egba	absoluut	None
efrem	effem	Nan
ede	taal	None
ecomog	ecomog	Nan
ebi	familie	None
eba	eba	Nan
ea	ja	None
dọ́gba	gelijk	None
egbé	wee	Nan
elòmírà	het	None
dominic	dominant	None
doju	oog	None
clear	doorzichtig	Nan
cipollone	cipollone	Nan
china	china	None
cherished	gekoesterd	Nan
chebbi	denken	None
chaskalson	chaskalson	Nan
charles	charles	None
chamorro	chamorro	Nan
cbc	cbc	Nan
cauchy	cauchy	Nan
catherine	catherine	Nan
code	code	None
cathedral	kathedraal	None
casablanca	casablanca	Nan
cape	kaap	None
canaria	canaria	Nan
calabar	kauwgom	Nan
cairo	woede	None
bẹ́ẹ̀sìni	ja	None
bẹ́ẹ̀ni	ja	None
bẹ́ljíọ̀m	beryl	Nan
bẹ́	gegaan	None
bẹ̀rẹ̀	starten	None
búrú	wees	None
caslon	casino	None
dojú	oog	None
coetsee	coetsee	Nan
coming	eraan	None
divoire	divoire	Nan
dinwoju	opzoeken	Nan
din	bak	Nan
different	anders	None
didasile	vestiging	None
didagba	gelijkheid	None
development	ontwikkeling	None
desmond	desmond	Nan
describes	beschrijft	None
des	des	None
denver	denver	Nan
coloured	gekleurd	None
delhi	doen	None
daru	vernietigen	Nan
darapo	toetreden	Nan
dani	vasthouden	None
dandan	verplicht	None
dagbasoke	opgroeien	Nan
da	en	None
cunha	keel	Nan
ct	ct	Nan
csto	csto	Nan
computers	computers	None
compared	vergeleken	None
dates	datums	Nan
elòmíràn	ander	None
emerging	opkomend	Nan
emmanuel	emmanuel	Nan
gbaná	eruit	None
gbale	populariteit	None
gbajúgbujà	populair	None
gba	eens	None
galatia	keer	None
fẹ́rẹ̀ẹ́	bijna	None
fòye	begrijpen	None
fífún	geven	None
fífò	vliegen	None
fégbé	maar	None
fé	fé	Nan
gbe	dragen	None
fé	fé	Nan
funra	zelf	None
fun	voor	None
fulbe	vol	None
fulani	laf	Nan
fuji	verwijderen	None
freetown	freetown	Nan
fransi	frans	None
francis	francis	None
fracmv	fracmv	Nan
fowó	geld	None
fowobowe	boeking	Nan
further	verder	None
fourbase	fourbase	Nan
gbera	verder	None
gbese	schuld	None
geneva	genève	None
geesi	engels	None
gbọ́dọ̀	moet	None
gbúnùn	het	None
gbónmisi	wet	None
gbódò	moet	None
gbìyànju	hard	None
gbìnyànjú	proberen	None
gbésè	aanbod	None
gbéyèwò	beoordeling	None
gbéni	leven	None
gberasoke	versnellen	Nan
gbékalè	timmerman	Nan
gbé	leven	None
gbáradì	op	None
gbá	verpletteren	Nan
gbàgùrà	schudde	Nan
gbàgbọ́	geloven	None
gbongbo	wortel	Nan
gbogbogbo	algemeen	None
gbin	geplant	Nan
gbilè	uitbreken	None
gbigbewo	financiering	None
gbigbamulo	exploitatie	Nan
gbédìí	brengen	None
foriko	bijvoorbeeld	None
force	dwingen	None
foniimu	film	None
eyonomba	eyonomba	Nan
eyin	eieren	None
eya	categorie	None
example	voorbeeld	None
ewì	poëzie	None
ewé	blad	None
ewe	blad	None
euroasia	euroasia	Nan
euro	euro	None
etíòkun	kust	None
etymologiae	etymologiae	Nan
eléja	vissen	None
etisalat	etisalat	Nan
esia	komt	None
eseese	diagram	Nan
eréonítàn	acroniem	Nan
erékùsù	eiland	None
erofo	sediment	Nan
ernst	ernst	None
epa	pinda	Nan
eníbá	koorts	None
enì	olifant	None
enter	invoeren	Nan
enikéni	iedereen	None
esteri	esteri	Nan
elòmíràn	anders	None
eka	effect	None
eléyàmèyà	etniciteit	Nan
fohùn	roepen	None
fofinde	verbieden	None
fodio	fodio	Nan
five	vijf	None
fitino	beproeving	Nan
finlandi	finland	None
finiki	fysica	Nan
fimú	gedefinieerd	None
fihan	aangegeven	None
fifihan	weergegeven	None
fi	sparen	Nan
fe	gezocht	None
fesèmúlè	bron	None
ferde	ferde	Nan
felifeli	fluweel	Nan
farsi	arti	Nan
faranse	frans	None
faramó	aan	None
fan	ventilator	Nan
fail	mislukken	Nan
fagile	geannuleerd	Nan
ewà	gedrag	None
esè	opbrengst	None
esin	religie	None
enu	mond	None
búburú	slecht	None
bòtswánà	bus	None
béè	zo	None
bèrẹ̀	met	None
alawose	waarzeggerij	Nan
alalaye	aards	Nan
alakobere	gevorderde	Nan
alakitiyan	activist	Nan
alaini	behoeftig	Nan
alaigbara	onweerstaanbaar	Nan
alaidogba	onevenwichtig	Nan
aladanida	willekeurig	None
aladani	privaat	Nan
aladaani	privaat	Nan
alaafin	onwettig	Nan
albany	albany	Nan
alaafia	vrede	None
alaabo	gehandicapt	Nan
ala	beneden	None
akẹ́kọ̀ọ́	leerling	None
akíngbógun	bataljon	Nan
akíkanjú	moedig	Nan
akátá	jakhals	Nan
akopo	compilatie	Nan
akopa	vooral	None
akoni	geen	None
akole	niet	None
akokolo	periode	None
alaadanida	ongewenst	Nan
akinpelu	artillerie	None
albert	albert	None
alicia	alicia	Nan
anc	anc	Nan
anabi	profeet	None
an	een	None
améríkà	amerikaans	None
améríkà	amerikaans	None
amosi	moskee	None
amojeoyipada	converteerbaar	Nan
amerika	amerika	None
americas	amerika	None
amazonas	amazonas	Nan
alọ́po	portemonnee	Nan
alexandra	alexandra	Nan
alúwo	boom	None
aláyèwò	inspecteur	Nan
alátise	artiest	None
alápapò	vervanging	None
alákọ̀bẹ̀rẹ̀	initiatiefnemer	Nan
alumíníọ̀mù	aluminium	None
alumoni	genezend	Nan
alukuraani	koran	None
alubàbá	vader	None
alpha	alpha	Nan
alominira	onafhankelijkheid	None
allāh	allah	Nan
aláísàn	ziek	None
akiidah	coridah	Nan
ajọra	replica	Nan
ajoro	reizen	None
adiokan	eenzaam	Nan
adeda	natuur	None
addis	addis	Nan
adarihunrun	schoner	Nan
adabaye	oke	Nan
adaba	handig	None
accra	accra	Nan
abúléko	dorp	None
abínibí	nationaliteit	None
abé	naald-	Nan
abálájo	ervaren	None
adágbà	ouderling	Nan
aburunmu	onze	None
abidjan	ooit	None
abidi	alfabet	None
abesahara	bestrooi	Nan
abeorile	thuiskomst	Nan
abeikojopo	erfgename	Nan
abala	onderdeel	None
aawe	verlamming	Nan
aare	aare	Nan
aapon	aapon	Nan
aanu	mededogen	Nan
aala	grens	None
abo	vrouwelijk	None
kútò	straat	None
adúgbò mókóla	mucola mucosa	Nan
adúgbò quarry	buren	None
ajo	reizen	None
ajibola	agenda	None
ajemoroyin	ondervraging	Nan
aje	economie	None
ajagun	hond	None
aisi	gebrek	None
aintimulo	aintimulo	Nan
agio	huilen	Nan
agbéiná	brandweerman	Nan
agbára	macht	None
agbàbò	beschermer	Nan
agbà	volwassene	None
agbeinadie	landbouwgrond	None
agbaye	wereld	None
agbara	macht	None
agbado	maïs	None
agba	verf	None
aféfé	windmolen	Nan
africans	afrikanen	Nan
african	afrikaanse	None
africa	afrika	None
afoyemo	inhoud	None
afomo	bijvoorbeeld	None
afida	familie	None
adúgbò ìdí	redenen	None
andaman	andman	Nan
genevieve	genevieve	Nan
angkor	angkor	Nan
anschluss	anschluss	Nan
benin	bank	None
bengali	bengaals	Nan
bengal	bengalen	Nan
belgium	belgië	None
belarus	wit-rusland	Nan
beijing	peking	None
beauharnais	beauharnais	Nan
bce	weg	None
bayìí	nu	None
bayi	nu	None
bayelsa	bayelsa	Nan
berber	berber	Nan
bauxitealumina	bauxitealumina	Nan
banle	banle	Nan
bang	knal	Nan
balẹ̀	rust	None
bahrain	bahrein	Nan
babaláwo	de	None
baa	is	None
aṣòkan	individueel	None
azikiwe	verstand	None
ayò	ay	Nan
ayàfi	is	None
ayeye	eeuwigheid	Nan
bara	jaar	None
aya	vers	None
berlin	berlijn	None
bharat	bharat	Nan
báyìí	nu	None
bárakú	verslaving	None
bálè	ballon	None
bákannáà	ook	None
bàbá	vader	None
by	door	None
burúkú	onheil	Nan
bujumbura	uitgebreid	None
buenaventura	buenaventura	Nan
bu	is	None
brítánì	brits	None
bernstein	bernstein	Nan
britain	brittannië	Nan
brazzaville	brazzaville	Nan
brasil	brazilië	None
bolívar	bolívar	Nan
bolt	bout	Nan
bole	stam	None
bojú	eens	None
bodies	lichamen	None
black	zwart	None
biribiri	werd	None
bibeli	bijbel	None
bharata	terugkomen	None
bridgeport	bridgeport	Nan
awújẹ	schandaal	Nan
awùjo	hoffelijkheid	Nan
awuruju	magisch	None
arábíà	alfabetisch	Nan
aráa	broer	None
aryan	de	None
arun	ziekte	None
aruleyin	hallo	Nan
aroko	vegetatie	None
arkansas	arkansas	Nan
ariwaguusu	zuidwestelijk	Nan
ariwaarin	het	None
ariso	aris	Nan
arinkankan	deze	None
aráròmí	hallo	Nan
aralíle	tropisch	None
apẹ̀rè	schort	Nan
apòmù	schort	Nan
apis	api&#39;s	Nan
apeere	bijvoorbeeld	None
apeja	visser	Nan
aparapo	combinatie	None
apaiwoorun	westers	None
apailaorun	zonsopkomst	Nan
apaguusuiwoorun	zuidwesten	None
apaguusuilaorun	zuidwesten	None
apagusu	zuiden	None
arabu	arab	Nan
arópò	omkoping	Nan
arúgbó	leeftijd	None
arọ	kreupel	Nan
awon	hen	None
awoòn	sjabloon	Nan
awonara	emotie	Nan
awo	bord	Nan
awari	ontdekking	None
avar	avar	Nan
austríà	australië	None
austronesian	austronesisch	Nan
austriahumgary	austriahumgary	Nan
australia	australië	None
atunse	correctie	Nan
atun	terugspoelen	Nan
atinrin	lachend	Nan
atimo	plan	None
atigba	toelaatbaar	Nan
atanna	atoom	Nan
atangbona	atoom	Nan
asèdá	natuurlijke	None
asìko	onzin	Nan
assessment	beoordeling	None
asipa	afwijking	None
aseyori	succes	None
aseeto	nederzetting	None
ascii	ontdekken	None
asagun	zege	Nan
anita	anita	Nan
ọ̀rọ̀	praten	None
georgia	georgië	None
gfaj	gfaj	Nan
kòjòkú	regen	None
kírísìtì	kerstmis	None
kínu	zoenen	Nan
kíkọ́	leren	None
kíko	studeren	None
kí	begroeten	Nan
kìnní	eerste	None
kéyìn	later	None
kémíkà	integendeel	Nan
kétu	voorbereid	None
kékéèké	klein	None
kòkó	muis	None
kéesì	belachelijk	Nan
kánádà	natuurlijk	None
kánfinkése	vindingrijkheid	Nan
ká	van	None
kàyéfì	zich	None
kàríbẹ́ánì	regio	None
kwara	aangesproken	Nan
ku	u	None
krio	krio	Nan
kori	meer	None
ko	ko	Nan
koko	leren	None
káyé	wereld	None
koto	aas	Nan
kòmpútà	computer	None
kòòsí	niet	None
labalaba	vlinder	None
laarin	binnen	None
laaka	omgekeerde	None
laada	trap	None
laa	weg	None
kọ́ni	aan	None
kọ́lọ́mú	kolommen	Nan
kọ́kọ́	eerste	None
kọ̀mpútà	computer	None
kọjá	voor	None
kẹ́nyà	scheiding	None
kòtò	een	None
kẹta	derde	None
kẹrin	vierde	None
kúùkù	integendeel	Nan
kútò	alles	None
kúrò	weg	None
kúkúrú	een	None
kúkú	slotte	None
kùrání	koran	None
kùkú	slotte	None
kóra	verzamelen	None
kógo	heerlijkheid	Nan
kòòkan	elke	None
kẹsàán	meteen	None
labee	onder	None
kookan	dit	None
kong	kong	None
kampala	sluiting	None
kalẹ	zetten	None
kalinga	cinga	Nan
kakiri	spoor	None
kagera	opschepperig	Nan
kadara	bedrijfsmiddel	Nan
jọ́	alstublieft	Nan
jẹ́mánì	duitse	None
jùló	meest	None
jùlo	vooral	None
jùlo	dan	None
kan	een	None
jíjéomoléyìnkírísítì	als	None
jíje	wezen	None
jìnnàa	ver	None
jéésù	jezus	None
jé	komen	None
jáde	komen	None
jàgídíjàgan	gewelddadig	Nan
juneau	juneau	Nan
jo	john	None
jopò	bij	None
jojo	gebarsten	Nan
johanu	sorry	Nan
jíjuwó	verdienen	None
kongo	condoom	None
kankan	geen	None
karbonumarun	thecentricane	Nan
komputa	computer	None
kolo	kolo	Nan
kojá	kruis	None
koidu	koidu	Nan
kodò	hieronder	None
ko	of	None
kinkinni	kleine	None
kilhar	oksel	Nan
kikuninu	voor	None
kiko	leren	None
kikoso	snel	None
kanlè	kanal	Nan
kikopomo	warmte	None
kiko	brengen	None
kiakiajulo	snelste	None
ki	doen	None
khoisan	inferieur	Nan
kept	gehouden	None
keko	geletterd	Nan
kekere	klein	None
kebbi	verstelbaar	Nan
karùún	vijfde	None
karun	vijfde	None
karl	karl	None
kikojo	compilatie	Nan
lade	lade	Nan
laid	gelegd	None
laifi	fout	None
mahatma	de	None
madeira	beira	Nan
maapu	kaart	None
lọ́jà	markt	None
lọ́dọọdún	jaarlijks	None
lọndọnu	londen	None
lórò	morgen	None
lónà	onderweg	None
ló	ló	Nan
lóòótọ́	inderdaad	None
lóòótò	ja	None
makedonia	macedonië	None
lóti	lot	None
lórì	haven	None
lópó	weduwe	None
lópez	nipez	Nan
lóde	buiten	None
lítésò	stekend	Nan
lísa	versnelling	Nan
lílo	exploitatie	Nan
lérú	slavernij	None
léyìn	later	None
léyin	daarna	None
lérò	reden	None
lóríba	over-	Nan
lérìnín	sneeuw	None
malabo	schat	None
malayopolynesian	malayopolynesisch	Nan
member	lid	None
melo	hoeveel	None
meksiko	mexico	None
mejila	twaalf	None
mejidinlogbon	achtentwintig	Nan
mefeefa	revisie	Nan
mediteraneani	mediterraans	Nan
means	middelen	None
mbabane	negatief	None
maya	nee	Nan
max	max	None
malay	verondersteld	None
mathimatiki	wiskundig	Nan
matheu	matheu	Nan
maseru	jaloezie	Nan
maryland	maryland	Nan
mars	mars	None
marku	keer	None
march	maart	None
marcellus	marcellus	Nan
manˈdeːla	manˈdelala	Nan
mango	mango	Nan
mali	dag	None
malaysia	maleisië	None
mathiew	mathiew	Nan
léebá	overigens	None
lédè	taal	None
lèyìn	daarna	None
links	koppelingen	Nan
linear	lineair	Nan
lindi	loog	Nan
lilongwe	lilongwe	Nan
lilemo	hennep	Nan
lilelile	hardcore	Nan
leè	mei	None
leyi	het	None
lewon	gevangenisstraf	None
lewaju	voorwaarts	Nan
less	minder	None
lodo	af	None
lese	post	None
lekun	geïntensiveerd	Nan
leboa	lebo	Nan
le	kan	None
lay	leggen	None
latvia	letland	None
latini	latijns	Nan
latigbana	sindsdien	None
latibe	daar	None
lasile	vrijlating	Nan
lanka	lanka	Nan
languages	talen	None
leo	leo	None
lojowaju	toekomst	None
lojukokoro	hebzuchtig	Nan
lojúgun	geteisterd	Nan
lèe	kan	None
láíláí	nooit	None
láì	zonder	None
lárúbáwá	natuurlijke	None
lára	doen	None
lápá	deel	None
lámọ́di	fortuin	Nan
láké	luid	Nan
láimo	zonder	None
láfún	gegeven	None
lábé	gewicht	None
lààmì	tekens	None
lààmi	teken	None
làgba	gelijk	None
lynton	lynton	Nan
luther	luther	None
luanda	luanda	Nan
lo	verder	None
low	laag	None
lovers	geliefden	Nan
louvre	rooster	Nan
loruko	naam	None
lopolopo	veel	None
loloselu	politiek	None
lokunkun	energiek	Nan
johann	hel	None
jogun	geërfd	Nan
jo	lek	None
jiròrò	mistig	Nan
ifitonileti	informatie	None
ifilole	lancering	None
ifija	vissen	None
idánwò	beproeving	Nan
idupe	u	None
idoma	tekening	None
idimule	arresteren	Nan
ideraa	schrijven	None
idari	bedieningselementen	Nan
idamita	trek	None
idajo	gerechtigheid	Nan
ifobaje	corruptie	None
idaji	helft	None
idagbasoke	ontwikkeling	None
iceland	ijsland	None
ibùjókòó	zitplaatsen	Nan
ibùdó	kamp	None
ibuso	vechten	None
ibuseripadabosi	vergoeding	Nan
ibujoko	bank	None
ibori	sluier	Nan
ibojì	graf	None
ibn	ibn	None
ibiti	plaatsen	None
idagbe	verwaarlozing	Nan
ibise	training	None
ifofinde	congres	None
igbeduro	voorbereiding	None
iketa	erven	Nan
ikerin	vierde	None
ikeko	compilatie	Nan
ikejidinlogun	achttien	None
ikaowo	respect	None
ikandinlogun	achttien	None
ikan	een	None
ijó	dansen	None
ijosin	aanbidden	None
ijinnasi	fysica	Nan
ije	beweging	None
ifriqiya	stimulatie	None
ijaya	paniek	None
ijagun	strijd	None
ihinrere	evangelie	None
ihan	verschijnen	None
igitòròmogbè	breedband	Nan
igbáẹ̀yìn	laatste	None
igbá	kip	None
igbowolori	duur	None
igbeyawo	bruiloft	None
igbesoke	upgrade	Nan
igberiko	buitenwijk	Nan
igbegun	zege	Nan
ijakadi	worstelen	Nan
ibimo	geboorte	None
ibile	traditioneel	None
ibiamusin	heiligdom	Nan
gún	doorboord	Nan
gòkè	gaan	None
gírámà	gramps	Nan
gégé	werkelijk	None
gèésì	edelsteen	Nan
gèésì	lijm	Nan
gv	gv	Nan
guusu	zuiden	None
gunle	geweer	Nan
gun	lang	None
guinébissau	guinébissau	Nan
gúúsù	zuiden	None
guineabissau	guineabissau	Nan
guanínì	guanni	Nan
groove	groef	Nan
griiki	grieks	None
grammy	grammy	None
gquadruplex	gquadruplex	Nan
gorgina	de	None
gomina	gouverneur	None
goemai	goemai	Nan
gidí	huis	None
gidigidi	heel	None
ghana	ghana	None
guinea	guinea	Nan
gẹ̀ẹ́sì	engels	None
habsburg	habsburg	Nan
haggai	gids	None
ibewo	gekomen	None
ibeji	tweelingen	None
ibarepo	vereniging	None
ibalo	affaire	None
hv	hv	Nan
hungari	verhongering	Nan
hun	hun	None
hugh	hugh	Nan
hp	hp	Nan
hosea	hosea	Nan
hominidae	hominidae	Nan
histoni	histoni	Nan
hindu	hindu	Nan
him	hem	None
hesse	akkoord	None
heraklion	heraklion	Nan
henny	henny	Nan
hendu	snoep	Nan
heinrich	heinrich	None
hawaii	hawaii	Nan
hausafulani	hausafulani	Nan
haughton	haughton	Nan
hard	moeilijk	None
halomonadaceae	halomonadaceae	Nan
haiti	haïti	None
ikoenu	opslaan	Nan
german	duitse	None
ikojopo	accumulatie	Nan
iku	dood	None
itumo	betekenis	None
itu	gooien	None
itorawo	liberaal	None
itokowo	bedrijf	None
itobi	opscheppen	Nan
itiraka	worstelen	Nan
itelentele	duidelijk	None
itanakole	verhaal	None
itali	italiaans	None
isè	onderhoud	None
isesi	overgave	None
iwadi	onderzoek	None
isun	stromen	None
iso	komen	None
isepinpin	distributie	None
iseowo	bedrijf	None
iseoroayeijoun	archeologie	Nan
iseoba	vijftien	None
isejoba	bestuur	None
iseero	maar	None
isedaniloro	aan	None
isare	versnelling	Nan
isa	genoeg	None
irúnmọlẹ̀	bliksem	Nan
isoponomba	isoponomba	Nan
irò	gerucht	None
iwasi	maken	None
iwoile	huis	None
jijinna	ver	None
jije	wezen	None
jfk	jfk	Nan
jesu	jezus	None
jeometri	geometrie	Nan
jeffrey	jeffrey	None
jawaharlal	schommels	Nan
jamo	weg	None
jamaica	youtube	None
jalè	diefstal	None
jagbe	verdwaald geraken	Nan
iwifun	informatie	None
jadide	vol	None
jabo	van	None
iṣẹ́ìwádìí	onderzoek	None
iḷẹ̀	werk	None
iyán	sprankelend	Nan
iyen	is	None
iyawo	bruid	Nan
iyato	verschil	None
iyan	hongersnood	None
iwuwa	praktijk	None
iwulo	nuttig	Nan
iwosan	genezing	None
jackson	jackson	None
irorun	makkelijk	None
irisi	verschijning	None
iringa	afronden	Nan
ilẹ̀ayé	aarde	None
ilẹ	grond	None
iléńlá	binnenplaats	Nan
iléàtèéré	huis	None
ilélódò	huis	None
iléisé	huis	None
iléayé	huis	None
ilé	huis	None
iluorilejoba	globalisering	Nan
iluoba	burgerschap	Nan
ilopo	dubbele	None
iminle	arresteren	Nan
ileru	oven	Nan
ileigbimo	toestemming	None
ileife	verwaarlozing	Nan
ilegiga	huis	None
ileasofin	wetgevend	Nan
ilaorun	zonsopkomst	Nan
ilaodo	beschermen	None
ilanaoye	strategieën	Nan
ilana	procedure	None
ilagbolojo	publiciteit	None
ikún	vulling	Nan
ikúgbaèyí	nu	None
ileobaluaye	wereld	None
imoero	bliksem	Nan
imojuto	zorg	None
imusin	trek	None
irele	nederigheid	Nan
ire	uitverkoop	Nan
iranlose	bijstand	Nan
iraja	schokkend	Nan
ipá	dwingen	None
ipo	plaats	None
ipinu	besluit	None
ipinpa	deelname	None
ipin	hoofdstuk	None
ipele	niveau	None
ipawo	toepassingen	None
ipare	vervagen	Nan
iowa	aarde	None
ioniani	behoeftig	Nan
ioja	vis	None
inúnibíni	vervolging	None
iní	erfenis	None
inágbéringbérin	zeventien	None
integration	integratie	None
inkosi	te	None
indus	indus	Nan
indeed	inderdaad	None
inagberingberi	pindakaas	Nan
imúnisìn	hygiëne	Nan
imú	neus-	Nan
ikoreokere	oogsten	Nan
ọ̀sẹ	week	None
