aajo	gülünc	Nan
púpò	əksinə	None
púpo	çox	None
pò	qatlanmaq	Nan
pòwe	sözləri	None
pípẹ́	uzun	None
pípèsè	təmin	None
pípa	qırğın	Nan
péé	ki	None
péré	yalnız	None
pé	ki	None
pèsè	olunur	None
quran	quran	None
pèlúpèlú	həmçinin	None
pèhìndà	sperma	Nan
pè	çağırdı	Nan
pátáporongodo	tamamilə	None
pásíà	zirzəmi	Nan
pàápàá	xüsusilə	None
pààlà	sərhəd	None
pàràkòyí	dərhal	None
pàmò	olaraq	None
px|kùránì	|	None
pupa	qırmızı	None
príncipe	príncipe	Nan
pèlu	birlikdə	None
providence	təminat	None
ra	almaq	None
rajya	ümid	None
rome	xrom	Nan
roma	roma	None
roko	mob	Nan
rokirika	gəzən	Nan
rogbodiyan	iğtişaş	Nan
roboto	səthlər	Nan
robinson	robinson	Nan
ro	düşün	Nan
rnas	rnas	Nan
rnarna	rnarna	Nan
rna	rna	Nan
race	irqi	None
rn	rn	Nan
riresile	yazıcı	Nan
rinle	yeni	None
right|thumb|px|aworan	şəkil	None
richard	zəngin	None
research	tədqiqat	None
rere	yaxşı	None
repetejulo	həssas	None
repeats	təkrarlayır	Nan
reggae	reggae	Nan
rank	rütbə	Nan
ramadan	ramazan	None
riro	təxəyyül	Nan
ronald	ronald	Nan
proton	proton	Nan
produced	olunur	None
palauan	palav	Nan
padá	pod	Nan
paapaa	xüsusilə	None
paa	söndür	Nan
opolo	çoxu	None
ofò	xeyir	None
oyé	dünya	None
ose	ose	Nan
opolo	çoxu	None
omonìyàn	insan	None
olorun	allah	None
panaˈma	panaˈma	Nan
odun	illik	None
olórun	allah	None
okùnrín	gülüş	None
ojó	yağışlıdır	Nan
odún	il	None
oúnjẹ	yemək	None
owojagidijagan	terrorçular	Nan
oun	o	None
otutu	çoxu	None
otherwise	cür	None
oseluarailu	mülki	None
oscar	oskar	Nan
olósìn	dindar	None
protokolu	protokolu	None
panyanan	the_space	Nan
parapọ̀	qarışıq	None
press	mətbuat	None
portuguese	portuqalca	Nan
portonovo	portonovo	Nan
population	əhali	None
polaroid	polaroid	Nan
polandi	cilalamaq	Nan
pojulo	yüksək	None
po	po	Nan
plánẹ́tì	santexnika	Nan
platos	platoslar	Nan
piposi	çox	None
papa	papa	None
pipolongo	reklam	None
pinu	qərarlı	Nan
pinsoto	pinoto	Nan
pinsi	azalma	Nan
phillipines	filipinlər	Nan
pelu	inci	Nan
petu	petu	Nan
periferi	periferi	Nan
penisula	penisula	Nan
penh	penh	Nan
pele	cazibədar	Nan
paripari	son	None
pipo	çox	None
rorùn	asan	None
rossii	rossii	Nan
rural	kənd	None
sìbẹ̀	hələ	None
séyìn	geri	None
séyìn	arxa	None
sénégal	sperma	Nan
ségun	ağlamaq	Nan
sèle	oğurlamaq	Nan
são	yenisini	Nan
sáààrin	arasında	None
sáàpàdé	sponsorluq	Nan
sápadè	gün	None
sàì	yaxşı	None
sìni	karides	Nan
sàngó	banda	Nan
sàmì	işarə	None
sàbúrí	əvvəl	None
symmetry	simmetriya	Nan
swahili	suahilicə	Nan
suny	günəşli	None
sun	günəş	None
sugbọ́n	rasional	Nan
sugbo	yox	None
suez	suez	Nan
structures	strukturları	None
stella	stella	Nan
sàn	yaxşı	None
spectacular	möhtəşəm	None
síbèsíbè	baxmayaraq	None
sílẹ̀	salmaq	None
tabora	almaq	None
tabili	masa	Nan
tabi	ya	None
sísè	tərcümə	None
sísa	s	None
sááju	bir dəqiqə çəkin	Nan
sisé	çalışmaq	Nan
sepò	nəhayət	None
se	edir	None
sùgbón	əksinə	None
síse	quruluşu	None
síbú	yerə	None
si	əlbətdə	Nan
sùgbón	əksinə	None
sóko	bitki	None
sójà	əsgər	None
sòrò	beyin	None
síí	burada	None
síwájú	irəli	None
síwon	onları	None
síta	kənarda	None
síso	də	None
síso	də	None
síse	işləmək	None
sọ	deyin	Nan
so	ki	None
sopin	son	None
soon	tezliklə	None
say	deyin	Nan
santa	santa	Nan
samioro	mövcuddur	None
sambia	gənclik	None
salàyé	həyat	None
salem	salem	Nan
sakyas	sakyas	Nan
sakyamuni	növbəti	None
saheli	rahatlıq	Nan
safta	sıralamaq	Nan
safiwe	müqayisə	None
sb	sb	Nan
saffana	safir	Nan
saarland	döşəmədə	Nan
saaree	üstündür	None
saarc	çıxarın	Nan
rẹ	onun	None
ròyìn	bildirildi	Nan
rìn	gəzmək	Nan
ré	c	None
république	république	Nan
ránmú	narahat	None
ráhàn	çıxdı	None
ryan	ryan	Nan
safari	safari	Nan
schwarz	şvarts	Nan
sea	dəniz	None
seat	oturacaq	Nan
solomon	solomon	Nan
sohun	bəli	Nan
so	sevgi	None
slovo	slovo	Nan
sisupo	çoxaltmaq	Nan
sisupapoerekusu	tüpürmək	Nan
sisopo	əlaqələndirir	None
sisodagba	böyümək	Nan
sise	yemək	None
sioux	sioux	Nan
sinsin	din	None
sinai	günah	None
silè	düşür	None
sile	arxada	None
sihamoni	quruluşu	None
sibesibe	hələ	None
sharon	şəron	Nan
sewadi	axtarış	None
seville	sevil	None
sense	mənada	None
senegal	senegal	Nan
semudaju	əlbəttə	None
semolara	astma	Nan
seidamo	aydın	None
segbese	bilər	None
orúko	sahə	None
taino	dino	Nan
orísìírísi	fərqli	None
orísiirísi	müxtəlif	None
nombamewa	çoxalmaq	Nan
nobel	nobel	None
nnaji	əmi	Nan
nkàn	xərçəng	Nan
nkan	şey	None
niyi	budur	None
niye	yetər	Nan
niyato	fərqləndirmək	None
niwaju	qabaqda	None
nitosi	yaxınlıqda	Nan
nitoripe	çünki	None
nombáméjì	iki	None
nitoriidieyi	görə	None
nilè	burada	None
nijẹr	nike	Nan
nigbà	sonra	None
nigbakan	bəzən	None
nibere	erkən	None
nibe	orada	None
ngubengcuka	ngubengcuka	Nan
ngbero	planlaşdırılır	Nan
nevis	nevis	Nan
neptune	neptun	Nan
nefimu	nefim	Nan
nisinyi	i̇ndi	Nan
nebraska	nebraska	Nan
novo	novo	Nan
nse	dizayn	None
nínlá	əla	None
nílẹ̀	yerdə	None
nílùú	şəhərdə	None
nílè	aşağıda	None
nígbàtí	vaxt	None
nífẹ̀ẹ́	sevmək	Nan
níbè	orada	None
níbè	orada	None
ní	var	None
nìyí	odur	None
nìnú	istəyirəm	None
nri	yemək	None
nì	dağ	None
náwo	xərc	Nan
nàìjíríà	nigeriyada	Nan
nwa	bala	None
numeri	uyuşma	Nan
nukleotidipupo	nukleotid	Nan
nukleotidi	nukleotid	Nan
nu	təmiz	None
ntoka	nöqtə	None
nsowikipedia	obowikipedia	Nan
nsolaboraro	təhlükəsizlik	None
nso	yaxınlığında	None
náà	də	None
nínu	şans	None
ncnc	ncnc	Nan
nawojulo	çaşqın	Nan
munispal	munispal	Nan
mulẹ̀	qurmaq	None
mughal	həcmi	None
mtwara	yenidən	None
mtn	mtn	Nan
mozilla	mozilla	None
mozambique	mozambik	Nan
morogoro	motorlu	Nan
morgan	morqan	Nan
monrovia	monroviya	Nan
mombasa	mombasa	Nan
muungano	muungano	Nan
mokanlelogbon	iki	None
mohandas	mohandas	Nan
minority	azlıq	Nan
minnesota	minnesota	Nan
mimuwa	yapışmaq	Nan
mimoy	mimoy	Nan
miiràn	rahatlaşdırmaq	Nan
micronesia	mikronesiya	Nan
michelle	mişar	Nan
mexico	meksika	None
mewar	mewar	Nan
meucci	meucci	Nan
mokaleladota	yığcam	Nan
nawó	al	None
májèmú	fikirləşmə	Nan
méjèèjì	ikisi	None
nato	nato	None
nathaniel	nataniel	Nan
namibia	gəlmək	None
mẹ́talọ́kan	üçlük	Nan
mẹ́ta	üç	None
mẹ́rkúríù	siçan	None
mẹ́fà	altı	None
múlẹ̀	möhkəm	None
mó	m	Nan
móra	müalicə	None
mókólà	yapışqan	Nan
mère	rəsm	None
mò	bilik	None
míìrán	başqa	None
míràn	başqa	None
mímọ́	müqəddəs	None
ménu	fikirləşirsən	Nan
méwàá	on	None
métèètà	dülgər	Nan
méta	üç	None
mérìnlélógójì	dörd	None
mérìndínlógún	altı	None
méte	beş	None
mérindíláàdóta	beş	None
mííràn	başqa	None
níní	olmaq	None
nípà	azı	None
nítorípé	çünki	None
onítumò	tərcüməçi	Nan
oníná	atəş	None
onílẹ̀	aşağı	None
oníkólóbó	təhqiramiz	Nan
onígbàgbó	qoca	None
onka	kalkulyator	Nan
onje	pəhriz	Nan
oniyijulo	zəhmli	Nan
oniyewumeji	ikili	None
onisowo	tacir	None
onisayensi	texnoloq	Nan
onítèbọmi	vəftiz	Nan
onipin	rasional	Nan
onilile	sahibləri	None
onilanaibagbepo	prezervativ	Nan
onigunfenfe	passiv	Nan
onigbowo	sponsor	Nan
onigbeja	konstruktiv	Nan
onibugbe	icarəçi	Nan
onialjebra	onialjebra	Nan
omiadalu	sel	None
omi	su	None
olùkọ́	müəllim	None
olùkó	təlimatçı	Nan
oninawo	borcalan	Nan
olùkópa	verən	None
onítòhùn	mühasib	Nan
oníyanjù	cizgi	None
orílẹ́	axşam	None
orílẹ̀	millət	None
orílèèdè	millət	None
oríkì	şeir	None
oríilẹ̀	məqalə	None
oríilè	milli	None
oruko	isim	None
orudnun	illik	None
oritameta	ortasında	None
orisa	mənşəyi	None
orisun	mənbə	None
oníwòsàn	verən	None
orisirisi	müxtəliflik	Nan
orileominira	isti	None
orilejoba	hökumət	Nan
orileedeajoba	imperializm	Nan
orileede	millət	None
oriki	şərq	None
oriire	təbrik	None
ori	baş	None
opposite	əksinə	None
opec	opec	Nan
ootọ́	doğru	None
ooni	timsah	Nan
orinìyìn	mahnı	None
olùdarí	lider	None
olùbátan	əlaqə	None
olóṣèlú	siyasətçi	None
ojùkòsì	yağıntı	None
ojuse	məsuliyyət	None
ojuoorun	qürub	Nan
ojukokoro	tamahkarlıq	Nan
ojoru	isti	None
ojojumo	gündəlik	None
ojo	oxşamaq	Nan
ogunlogo	izdiham	Nan
ogun	müharibə	None
ogbè	bölgə	None
ofin	qanun	None
ojùkòtúu	yağıntı	None
ododo	salehlik	Nan
obere	kiçik	None
obairanderan	əmiuşağı	Nan
oba	obama	None
nso	tezliklə	None
nǹkan	şey	None
níyanjú	müsbət	None
níwájú	qabaqda	None
nítòótọ́	həqiqətən	None
nítòótó	olaraq	None
nítòsí	yaxınlıqda	Nan
nítumò	məna	None
obínibí	nəzakət	Nan
ojúlùmọ̀	tanışlıqlar	Nan
ojútáyé	özlülük	Nan
ojúìwé	səhifə	None
olóyè	hökmdar	None
olódùmarè	uca	None
olympus	olimpiya	None
oluwakiri	kəşfiyyat	None
olusoju	gözətçi	None
oluparapo	birləşmə	None
olumojuto	acgöz	Nan
olukowe	müəllif	None
olukoitan	təlimatçı	Nan
oludase	istehsalçı	Nan
oluda	yaradıcısı	None
oloye	dahi	None
oloselukan	salam	None
olora	yağ	None
olopon	təkəbbürlü	Nan
ololugbe	itirən	Nan
olokunkun	qulaqlıq	Nan
olojukanna	dərhal	None
olohun	sahibləri	None
olodiajodojuko	bir-birinə	Nan
okunrin	kişi	None
okunkun	qaranlıq	None
oko	sahə	None
okhotsk	oxotsk	Nan
okeere	xarici	None
orísìí	müxtəliflik	Nan
tainos	tainos	Nan
takuntakun	məhdudiyyətlər	Nan
talaka	kasıb	None
ìràwọ̀	ulduzlar	None
ìrànàna	kömək	None
ìrànlọ́wọ́	kömək	None
ìpínrò	bəndlər	Nan
ìpìnlè	başlanğıc	None
ìpìlẹ̀núkléù	şifrələmə	Nan
ìpolongo	reklam	None
ìnáwó	xərcləmə	Nan
ìnagije	qələbə	None
ìmúsára	gücləndirmək	Nan
ìmúnilérú	sui-istifadə	Nan
ìrí	təcrübə	None
ìmú	burun	None
ìmò	ildırım	None
ìmò	ilan	None
ìlé	ev	None
ìlè	rüşvət	Nan
ìlàìnàró	zülm	Nan
ìlàorùn	qançır	Nan
ìlànàn	illüziya	Nan
ìlà	kontur	Nan
ìlo	edin	None
ìlera	sağlamlıq	None
ìkọpa	iştirak	None
ìmóbìdo	haqqı	None
ìkẹrin	dördüncü	None
ìròkò	düşündü	Nan
ìròyìnwiki	xəbərlər	None
ìtaeko	atelye	Nan
ìta	kənarda	None
ìse	fəaliyyət	None
ìsòro	çətinlik	None
ìsílé	ev	None
ìsèjoba	hökumət	Nan
ìsèdá	yaradılması	None
ìsègbèfábo	çalışqanlıq	Nan
ìse	fəaliyyət	None
ìsọ	dükanlar	Nan
ìsú	qalınlığı	None
ìròyìn	xəbərlər	None
ìsòrí	bölmə	None
ìsìn	din	None
ìsèlè	istehsal	None
ìsàlè	qürub	Nan
ìsomó	qoşulmaq	Nan
ìsirò	hesablama	None
ìsinsìnyí	i̇ndi	Nan
ìse	fəaliyyət	None
ìsawo	kehanet	Nan
ìrúbo	dağılmaq	Nan
ìró	səs	None
ìròrùn	illüziya	Nan
ìsòrò	düşüncə	None
ìtan	tarixi	None
ìkínin	altıncısı	Nan
ìkìjà	problem	None
ìdá	qaçqınlıq	Nan
ìdàrúdàpò	xaos	Nan
ìdàpapọ̀	konsolidasiya	Nan
ìdàgbà	yetkinlik	Nan
ìbílè	haqqı	None
ìbílè	haqqı	None
ìbáraeni	vaqon	Nan
ìbánisòrò	əlaqə	None
ìbarà	hərarət	Nan
èpón	çox	None
èwù	köynək	Nan
ìdìmú	pozğunluq	Nan
èsìn	din	None
èro	düşüncələr	None
èka	təsiri	None
èyì	ləyaqət	Nan
ète	məqsədi	None
èsúrú	qarışqalar	Nan
èsó	məscid	None
èrò	düşüncələr	None
èràn	xəstəlikdir	Nan
ènìkan	şey	None
èlò	əşyalar	None
èkejì	başqa	None
èrí	dəlil	Nan
ìkìlò	sui-istifadə	Nan
ìdíisin	səbəb	None
ìdó	ləkə	Nan
ìkéde	bəyannamə	Nan
ìkèrèkú	tıxanma	Nan
ìkànna	eyni	None
ìkejì	başqa	None
ìjọba	hökumət	Nan
ìjò	lider	None
ìjìnlè	sirr	Nan
ìjìnlè	sirr	Nan
ìjora	nifrət	None
ìjoba	hökumət	Nan
ìjo	kilsə	None
ìdíwòn	sənin	None
ìjo	etmək	None
ìgbò	ram	None
ìgbésí	həyat	None
ìgbéraga	qürur	Nan
ìgbáraga	güc	None
ìgbá	qanadlar	Nan
ìgbàgbé	unutqan	Nan
ìgbà	vaxt	None
jé	fəlakətdir	Nan
ìfáàrà	keşiş	None
ìfojúìtànìgbesiayé	tarixi	None
ìfara	işgəncə	Nan
ìhun	dəmir	None
ìtokò	qazan	None
ìtàn	tarixi	None
ìtànkálé	daşqınlar	None
ṣàkóbá	zərərli	None
ṣiṣé	açılış	Nan
σ	σ	Nan
κάππα	.α	Nan
ˌæləˈbæmə	xəstəlik	None
ˌkælɪˈfɔrnjə	ɪˈkælɪˈfɔrnjə	Nan
ˈøːstəˌʁaɪç	ˌʁstəˌʁaç	Nan
ʔaːnaːtɕɑ̀k	.aːnaːtɕɑɕɑk	Nan
şe	etmək	None
únṣẹlẹ̀	zəlzələ	None
ôdún	i̇l	Nan
ẹdo	zarafat	Nan
ó	bəli	Nan
ósírísì	tüpürcək	Nan
óníse	dizaynerdir	Nan
ó	o	None
òròàjòmó	səhərlər	Nan
òrò	düşüncələr	None
òwó	pul	None
òsà	balıq	None
òrò	düşüncələr	None
òré	oyunu	None
òpòlopo	çoxu	None
òfò	növbəti	None
ósékú	öldü	None
òré	oyunu	None
ẹlẹ́bùn	hədiyyə	None
ẹnìkan	adam	None
ọ̀pòlòpò	fəaliyyət	None
ọ̀nà	yol	None
ọ̀gbìn	bitki	None
ọ̀dọ́	gənclik	None
ọpọ́lọpọ́	əncir	Nan
ọn	o	None
ọmọ	uşaq	None
ọmú	sormusan	Nan
ọlọ́run	tanrı	None
ọlọ́mọ	uşaqlar	None
ọdún	il	None
ẹlẹ́sìn	dindar	None
ọbàkàn	qardaşı	None
ẹ̀rọ	maşın	None
ẹ̀ni	üst	None
ẹ̀kọ́	təhsil	None
ẹ̀kẹ́ta	üçüncü	None
ẹ̀kasístẹ̀mù	subyektiv	Nan
ẹ̀kaoṣù	tikanlı	Nan
ẹ̀kajuly	bilər	None
ẹ̀kabrítánì	əmi	Nan
ẹ̀kaawon	təqdimatlar	Nan
ẹtì	qaraciyər	None
ẹsẹ	ayaqları	None
ẹ̀wẹ̀	tərəfdən	None
òpòlopò	çoxu	None
òkòòkan	bir bir	Nan
òkan	biri	None
òdo	gənclik	None
òdeojú	simasız	Nan
òde	kənarda	None
ìṣọ̣̀tẹ̣̀	sətəlcəm	Nan
ìṣẹ́kù	hissəsi	None
ìṣèlú	siyasət	None
ìyípadà	dönüşüm	Nan
ìyàwó	gəlin	None
ìyapa	ayrılıq	None
ìya	əzab	None
ìwúlò	faydalıdır	Nan
òdìkejì	başqa	None
ìwòran	görmə	None
ìwéré	kitabça	Nan
ìwàásù	təbliğ	None
ìwo	buynuzlar	Nan
ìwe	müqayisə	None
ìtúpalè	tərcümə	None
ìtúmò	tərcümə	None
ìtóka	döyülmək	Nan
ìtójú	üz	None
ìtóju	qarışıqlıq	Nan
ìtójú	qayğı	None
ìtèsíwájú	tərəqqi	None
ìwò	ümumilikdə	None
òféàrán	görüntü	None
ògbójú	səlahiyyətli	None
ògiri	divar	Nan
òjògbón	hava	None
òṣèlú	siyasət	None
òwù	parça	None
òsèré	idmançı	Nan
òsèlú	siyasətçi	None
òsán	günorta	None
òrò	beyin	None
òrí	fəsil	Nan
òrìsà	bütlər	Nan
òranyàn	məcburi	None
òpópóònà	yol	None
òotó	həqiqət	None
òní	gün	None
òmùàrán	görüntü	None
òmiràn	sehrbaz	Nan
òle	qadın	None
òkúta	daş	None
òkú	cəsədlər	Nan
òkòòkan	bir bir	Nan
òkèògbún	min	None
òjísé	həkim	None
òjo	oxşamaq	Nan
ògúndìpẹ̀	toz	None
ògun	dərman	None
ògo	şöhrət	None
èka	filial	Nan
èhìn	növbəti	None
èfòn	gərgin	None
èdè	dil	None
visit	ziyarət	None
viruses	viruslar	None
villa	villa	Nan
vihara	vihara	Nan
videos	videolar	Nan
victor	qalib	None
vermont	vermont	Nan
venezuela	venesuela	None
uzbek	yol	None
utc	utc	Nan
utah	utah	Nan
vz	vz	Nan
usps	usps	Nan
urasílì	uracil	Nan
unla	bəli	Nan
unifasiti	universitet	None
umueri	uşaqlar	None
ucb	ucb	Nan
tẹ̀ǹbẹ̀lẹ̀kun	fitnə	Nan
tẹ̀ǹbẹ̀	sonra	None
túnse	etmək	None
túmò	gavalı	Nan
tú	tökmək	Nan
tóka	gətirir	None
uribe	aura	Nan
tó	tó	Nan
waa	bu	None
wari	iy	Nan
yafran	əlifba	None
xiv	xiv	None
xd	xd	Nan
wọ̀nyí	bunlar	None
wọn	onları	None
wúnrèn	çalışmaq	Nan
wón	onları	None
wònyí	bunlar	None
wòfún	nəzər	None
wípè	aydınlıq	None
wì	yuyun	Nan
waju	üz	None
wàásù	etmək	None
wura	qızıl	None
won	onları	None
wo	burada	None
wo	burada	None
woo	woo	Nan
wole	ol	None
województwo	dəlilik	Nan
wiwari	kəşf	None
witkin	ciyər	Nan
wisconsin	wisconsin	Nan
westminster	westminster	Nan
wyoming	wyoming	Nan
tówùú	istənilən	None
tókù	istirahət	None
tódárajùlọ	yaxşı	None
tokyo	tokyo	Nan
tokasi	göstərilmiş	None
toje	nadir	None
to	üçün	None
tiwọn	onların	None
titu	vurmaq	None
tirè	onun	None
tirana	tirana	Nan
tira	gərgin	None
thumb|left|upright|nelson	|	None
those	olanlar	None
tolerejulo	dözümlüdür	Nan
they	onlar	None
tfrac	tfrac	Nan
terutomo	terutomo	Nan
temptation	axtaran	None
tele	izlə	None
teksas	texas	None
tedo	tanışlıq	Nan
technology	texnologiya	None
taínos	tainos	Nan
tata	süzgəc	Nan
tara	doqquz	None
talika	yoxsulluq	Nan
the	the	None
tolórítelémù	xain	Nan
tomé	pomidor	None
tooto	həqiqətən	None
tóbi	böyük	None
tò	dəsti	Nan
tíórì	şinlər	Nan
tíátà	biletlər	Nan
títío	qədər	None
títèlé	izləmək	Nan
títi	bağlı	None
té	t	Nan
télè	tərəfindən	None
té	t	None
tèsíwájú	etmək	None
tèlé	dərhal	None
tètè	tez	None
tèlé	izlə	None
táawà	etmək	None
tàwon	onları	None
tàsí	olmadan	None
tuntun	yeni	None
tumosi	deməkdir	None
translated	olunub	None
traduite	traduite	Nan
tounsejanu	faciəli	None
toseluaralu	siyasi	None
torun	kürən	Nan
tori	tori	Nan
yakubu	yakub	Nan
metropoli	metropoli	Nan
yan	seçin	Nan
yanturu	bol	None
àsìkò	vaxt	None
àsèyìn	sonradan	None
àsàjemátèe	şəfəq	Nan
àse	ziyafət	Nan
àrẹ	prezident	None
àrùn	xəstəlikdir	Nan
àrígbámú	edir	None
àpeere	nümunə	None
àpapọ̀	bütünlüklə	None
ànfàní	fürsət	Nan
àmúsorò	psixologiya	None
àsótélè	uzadılması	Nan
àmúlò	praktik	None
àmérìkà	fövqəltəbii	Nan
àlébù	ləkə	Nan
àlèpò	yuxarıda	None
àlè	bədxah	Nan
àlááfià	bənzətmə	Nan
àlàáfíà	barış	Nan
àlàyé	məlumat	None
àlàkalè	qollar	Nan
àkókó	vaxt	None
àkójopò	qrup	None
àká	rəflər	Nan
àmì	qeyd	None
àkàrà	tortlar	Nan
àsọdọ̀kan	birlik	None
àsà	adət	None
èdè	dil	None
èdá	yaradılması	None
èbúté	liman	Nan
èbà	ağcaqanadlar	Nan
áwon	zina	Nan
án	t	None
àìsí	yoxluğu	Nan
àìròtélè	gözlənilməz	Nan
àìní	istəmək	Nan
àìkó	çatışmazlığı	Nan
àáyá	sperma	Nan
àsekúdórógbó	qabıq	Nan
àárín	ortasında	None
ààtò	ritual	Nan
àwùjo	cəmiyyət	None
àwón	pul	None
àwón	pul	None
àwon	nəzəriyyələr	None
àtẹnudẹ́nu	şifahi	None
àtúnse	edin	None
àtúnse	edin	None
àtòrìnká	ətrafında	None
àtìpó	yad	None
àtijo	köhnəlmiş	Nan
ààyè	diri	Nan
àkosílè	tezis	Nan
àkosílè	mücərrədlik	Nan
àjọṣepọ̀	sosial	None
yíì	sən	None
yíyípadà	dəyişmək	None
yí	fırlanmaq	Nan
yìí	bu	None
yì	get	Nan
yée	ver	None
yèwò	baxmaq	None
yára	tələs	Nan
yàtò	qurmaq	None
yànan	heyrət	Nan
yo	yo	Nan
yíò	olacaq	None
yorúbà	qatıq	Nan
yori	etdi	None
yoo	edəcək	None
yiyafunnilo	eroziya	Nan
yipada	fırlanmaq	Nan
yiowu	olacaq	None
yio	edəcək	None
yindinyindin	vaxt	None
ye	bəli	Nan
ye	bəli	Nan
yewo	təkmilləşdirilməsi	Nan
yaoundé	yaoundé	Nan
york	york	None
yẹ̀ẹ́	y&#39;tanımaq	Nan
yọ	çıxarın	Nan
zanzibar centralsouth	zanzibar centralsouth	Nan
àjákọ	ayrı	None
àjo	etmək	None
àifète	məqsədi	None
àgọ́	çadır	Nan
àgbùdo	həyət	Nan
àgbìgbò	qonşuluq	Nan
àgbéyèwò	baxış-icmal	Nan
àgbékà	mücərrəd	Nan
àgbáríjọ	təşkilat	None
àgbàrá	sel	None
àgbàjọ	kişi	None
àdóolóró	yağ	None
àdáátán	müstəsna	None
àdátá	əksinə	None
àdámò	gizlilik	Nan
àbọ̀	yarım	None
àbìkú	ölümsüzlük	None
àbáyo	təklif	None
àbámẹ́ta	ertəsi	None
àbe	baboon	Nan
bce	uzaqda	None
zy	zy	Nan
zscores	zscores	Nan
zou	zou	Nan
zdna	zdna	Nan
yanjú	etmək	None
methodologies	metodikalar	Nan
merin	dörd	None
mercosur	merkosur	Nan
díè	gərgin	None
dìtẹ̀	fitnə	Nan
dìró	sağda	Nan
dìde	yaranır	None
dì	vərəq	Nan
dépò	dərəcədə	None
délànà	prinsipcə	Nan
dé	gəldi	None
dáwó	bağışlamaq	Nan
dásà	bir casa	Nan
dáradára	yaxşı	None
dóko	yaxşı	None
dálóríi	ol	None
dágbó	qocalıq	Nan
dá	yaradılmışdır	None
dàpò	et	None
dàbíi	kimi	None
dun	dadlı	Nan
due	görə	None
du	du	None
dover	dover	Nan
doublestrand	ikiqat	None
doublehelix	ikiqat	None
dote	dot	Nan
dájó	tamam	None
doni	doni	Nan
dólà	yaxşı	None
dúró	durmaq	Nan
eléré	idmançı	Nan
eléde	mücərrəd	Nan
elláda	yaradılması	None
eleyii	kimi	None
eleyi	bu	None
elede	donuzlar	Nan
eko	təhsil	None
ekeji	başqa	None
eka	kompleks	None
eighteen	səkkiz	None
egbògi	tibbi	None
dún	səs	None
egbò	yara	Nan
egbo	yara	Nan
egberundun	il	None
egbe	silah	None
egba	tamamilə	None
efrem	effem	Nan
ede	dil	None
ecomog	ekomog	Nan
ebi	ailə	None
eba	eba	Nan
ea	bəli	Nan
dọ́gba	bərabərdir	None
egbé	vay	Nan
elòmírà	dəniz	None
dominic	dominant	Nan
doju	üzbəüz	Nan
clear	aydın	None
cipollone	sipollon	Nan
china	çin	None
cherished	əziz	None
chebbi	düşün	Nan
chaskalson	chaskalson	Nan
charles	çarlz	None
chamorro	çobanyastığı	Nan
cbc	cbc	Nan
cauchy	çuxur	Nan
catherine	ketrin	Nan
code	kodu	None
cathedral	kafedral	Nan
casablanca	kasablanka	Nan
cape	kape	Nan
canaria	kanariya	Nan
calabar	saqqız	Nan
cairo	qəzəb	Nan
bẹ́ẹ̀sìni	bəli	Nan
bẹ́ẹ̀ni	bəli	Nan
bẹ́ljíọ̀m	beril	Nan
bẹ́	qırdı	Nan
bẹ̀rẹ̀	üçün	None
búrú	ol	None
caslon	kazino	Nan
dojú	üzbəüz	Nan
coetsee	coetsee	Nan
coming	gələn	None
divoire	divoire	Nan
dinwoju	baxmaq	None
din	qızartmaq	Nan
different	fərqli	None
didasile	müəssisə	None
didagba	bərabərlik	None
development	inkişaf	None
desmond	çömçə	Nan
describes	edir	None
des	des	None
denver	denver	Nan
coloured	rənglidir	Nan
delhi	etmir	None
daru	etmək	None
darapo	qoşulmaq	Nan
dani	tutan	None
dandan	məcburidir	Nan
dagbasoke	etmək	None
da	və	None
cunha	boğaz	Nan
ct	ct	Nan
csto	csto	Nan
computers	kompüterlər	Nan
compared	etdi	None
dates	tarixləri	Nan
elòmíràn	başqa	None
emerging	yaranan	None
emmanuel	emmanuel	Nan
gbaná	vurmaq	None
gbale	populyarlıq	Nan
gbajúgbujà	məşhurdur	None
gba	razılaşmaq	Nan
galatia	vaxt	None
fẹ́rẹ̀ẹ́	təxminən	None
fòye	başa	None
fífún	verən	None
fífò	uçan	None
fégbé	onu	None
fé	fé	Nan
gbe	aparmaq	None
fé	fé	Nan
funra	özü	None
fun	üçün	None
fulbe	ful	Nan
fulani	qorxaq	Nan
fuji	çıxarın	Nan
freetown	sərbəst	None
fransi	dili	None
francis	frank	None
fracmv	fracmv	Nan
fowó	üçün	None
fowobowe	sifariş	None
further	daha	None
fourbase	baza	None
gbera	irəliləmək	Nan
gbese	borc	None
geneva	cenevrə	None
geesi	i̇ngilis	Nan
gbọ́dọ̀	olmalıdır	None
gbúnùn	iy	Nan
gbónmisi	qanun	None
gbódò	olmalıdır	None
gbìyànju	çox	None
gbìnyànjú	edin	None
gbésè	təklif	None
gbéyèwò	baxış-icmal	Nan
gbéni	yaşamaq	None
gberasoke	sürətlənmək	Nan
gbékalè	dülgər	Nan
gbé	yaşamaq	None
gbáradì	qalx	Nan
gbá	qarmaqarışıq	Nan
gbàgùrà	silkələdi	Nan
gbàgbọ́	inanmaq	Nan
gbongbo	kök	None
gbogbogbo	ümumi	None
gbin	əkilib	Nan
gbilè	çıxmaq	None
gbigbewo	maliyyələşdirmə	Nan
gbigbamulo	istismar	None
gbédìí	qurmaq	None
foriko	üçün	None
force	güc	None
foniimu	film	None
eyonomba	eyonomba	Nan
eyin	yumurta	None
eya	kateqoriya	None
example	nümunə	None
ewì	şeir	None
ewé	yarpaq	None
ewe	yarpaq	None
euroasia	avroaziya	Nan
euro	avro	Nan
etíòkun	sahil	Nan
etymologiae	etimologiae	Nan
eléja	balıqçılıq	None
etisalat	etisalat	Nan
esia	gəlir	None
eseese	diaqram	Nan
eréonítàn	qısaltma	Nan
erékùsù	ada	None
erofo	çöküntü	Nan
ernst	ernst	Nan
epa	fıstıq	None
eníbá	hərarət	Nan
enì	fil	None
enter	girmək	Nan
enikéni	kəs	None
esteri	esteri	Nan
elòmíràn	başqa	None
eka	təsiri	None
eléyàmèyà	etnik	None
fohùn	qışqırmaq	Nan
fofinde	qadağan	None
fodio	fodio	Nan
five	beş	None
fitino	sınaq	None
finlandi	finlandiya	None
finiki	fizika	None
fimú	edilmişdir	None
fihan	göstərilmiş	None
fifihan	göstərən	None
fi	yadda	None
fe	istədi	None
fesèmúlè	mənbə	None
ferde	ferde	Nan
felifeli	məxmər	Nan
farsi	arti	Nan
faranse	dili	None
faramó	yapışmaq	Nan
fan	fanat	Nan
fail	uğursuz	None
fagile	edildi	None
ewà	davranış	None
esè	gəlir	None
esin	din	None
enu	ağız	None
búburú	pis	None
bòtswánà	avtobus	None
béè	kimi	None
bèrẹ̀	silkələmək	Nan
alawose	kehanet	Nan
alalaye	torpaq	None
alakobere	təcrübəsiz	Nan
alakitiyan	aktivist	Nan
alaini	ehtiyaclı	Nan
alaigbara	qarşısıalınmaz	Nan
alaidogba	balanssızdır	Nan
aladanida	ixtiyari	Nan
aladani	özəl	None
aladaani	özəl	None
alaafin	qanunsuz	None
albany	albany	Nan
alaafia	barış	Nan
alaabo	əlil	Nan
ala	aşağı	None
akẹ́kọ̀ọ́	tələbə	None
akíngbógun	batalyon	Nan
akíkanjú	cəsur	None
akátá	çaqqal	None
akopo	tərtib	None
akopa	əvvəl	None
akoni	yoxdur	None
akole	edə	None
akokolo	dövrü	None
alaadanida	istenmeyen	Nan
akinpelu	artilleriya	None
albert	albert	None
alicia	alicia	Nan
anc	qoca	None
anabi	peyğəmbər	None
an	bir	Nan
améríkà	amerika	None
améríkà	amerika	None
amosi	məscid	None
amojeoyipada	bilər	None
amerika	amerika	None
americas	amerika	None
amazonas	amazonalar	Nan
alọ́po	cüzdan	Nan
alexandra	alexandra	Nan
alúwo	partlama	Nan
aláyèwò	müfəttiş	Nan
alátise	rəssam	None
alápapò	yerdəyişmə	Nan
alákọ̀bẹ̀rẹ̀	təşəbbüskar	Nan
alumíníọ̀mù	alüminium	None
alumoni	müalicəvi	Nan
alukuraani	quran	None
alubàbá	ata	None
alpha	alfa	Nan
alominira	müstəqillik	None
allāh	allah	None
aláísàn	xəstə	None
akiidah	coridah	Nan
ajọra	replika	Nan
ajoro	etmək	None
adiokan	tək	None
adeda	təbiət	None
addis	addis	Nan
adarihunrun	təmiz	None
adabaye	yaxşı	None
adaba	əlverişlidir	None
accra	akkra	Nan
abúléko	kənd	None
abínibí	milliyyət	Nan
abé	iynə	Nan
abálájo	təcrübəli	None
adágbà	ağsaqqal	Nan
aburunmu	hisslərimiz	Nan
abidjan	heç	None
abidi	əlifba	None
abesahara	səpmək	Nan
abeorile	qayıdır	None
abeikojopo	varis	Nan
abala	hissə	None
aawe	iflic	Nan
aare	aare	Nan
aapon	aapon	Nan
aanu	şəfqət	Nan
aala	haşiyə	Nan
abo	qadın	None
kútò	küçədəki qonşular	Nan
adúgbò mókóla	mukoza mukozası	Nan
adúgbò quarry	qonşuları	None
ajo	etmək	None
ajibola	gündəliyi	Nan
ajemoroyin	dindirmə	Nan
aje	iqtisadiyyat	None
ajagun	köpək	Nan
aisi	çatışmazlığı	Nan
aintimulo	aintimulo	Nan
agio	ağlamaq	Nan
agbéiná	yanğınsöndürən	Nan
agbára	güc	None
agbàbò	qoruyucu	None
agbà	bir yetkin	Nan
agbeinadie	ərazisi	None
agbaye	dünya	None
agbara	güc	None
agbado	qarğıdalı	None
agba	çəkmək	None
aféfé	yel dəyirmanı	Nan
africans	afrika	None
african	afrika	None
africa	afrika	None
afoyemo	tezis	Nan
afomo	üçün	None
afida	ailə	None
adúgbò ìdí	səbəbləri	None
andaman	andman	Nan
genevieve	genevieve	Nan
angkor	angkor	Nan
anschluss	anschluss	Nan
benin	dəzgah	Nan
bengali	bengali	Nan
bengal	bengal	Nan
belgium	belçika	None
belarus	belarus	None
beijing	beijing	Nan
beauharnais	gözəluharnais	Nan
bce	uzaqda	None
bayìí	i̇ndi	Nan
bayi	i̇ndi	Nan
bayelsa	bayelsa	Nan
berber	berber	Nan
bauxitealumina	boksitalumina	Nan
banle	banle	Nan
bang	bang	Nan
balẹ̀	olsun	None
bahrain	bəhreyn	Nan
babaláwo	bölücü	Nan
baa	edir	None
aṣòkan	fərdi	None
azikiwe	mənada	None
ayò	ay	None
ayàfi	yaxşıdır	None
ayeye	əbədiyyət	Nan
bara	il	None
aya	ayə	None
berlin	berlin	None
bharat	bharat	Nan
báyìí	i̇ndi	Nan
bárakú	asılılıq	Nan
bálè	şar	Nan
bákannáà	həmçinin	None
bàbá	ata	None
by	tərəfindən	None
burúkú	pis	None
bujumbura	genişlənmişdir	Nan
buenaventura	buenaventura	Nan
bu	yəni	None
brítánì	i̇ngilis	Nan
bernstein	bernstein	Nan
britain	britaniya	None
brazzaville	brazzaville	Nan
brasil	brazil	Nan
bolívar	bolivar	Nan
bolt	bolt	Nan
bole	bole	Nan
bojú	bax	None
bodies	cisimlər	Nan
black	qara	None
biribiri	əzildi	Nan
bibeli	müqəddəs	None
bharata	geri	None
bridgeport	bridgeport	Nan
awújẹ	qalmaqal	Nan
awùjo	nəzakət	Nan
awuruju	sehirli	Nan
arábíà	ilə	None
aráa	qardaşı	None
aryan	aryan	Nan
arun	xəstəlikdir	Nan
aruleyin	salam	None
aroko	örtüyü	None
arkansas	arkanzas	Nan
ariwaguusu	cənub-qərb	Nan
ariwaarin	şərq	None
ariso	aris	Nan
arinkankan	bu	None
aráròmí	salam	None
aralíle	tropik	None
apẹ̀rè	önlük	Nan
apòmù	önlük	Nan
apis	apis	Nan
apeere	üçün	None
apeja	balıqçı	Nan
aparapo	birləşmə	None
apaiwoorun	qərb	None
apailaorun	çıxdı	None
apaguusuiwoorun	cənub-qərb	Nan
apaguusuilaorun	cənub-qərb	Nan
apagusu	cənub	None
arabu	ərəb	None
arópò	rüşvət	Nan
arúgbó	qocalıq	Nan
arọ	topal	Nan
awon	onları	None
awoòn	şablon	Nan
awonara	duyğu	None
awo	boşqab	Nan
awari	kəşf	None
avar	avar	Nan
austríà	avstraliya	None
austronesian	avstraliyalı	Nan
austriahumgary	avstriyaumqarı	Nan
australia	avstraliya	None
atunse	düzəliş	Nan
atun	geri	None
atinrin	gülür	Nan
atimo	plan	None
atigba	məqbul	Nan
atanna	atom	None
atangbona	atom	None
asèdá	təbii	None
asìko	cəfəngiyat	Nan
assessment	qiymətləndirilməsi	None
asipa	sapma	Nan
aseyori	uğur	None
aseeto	qəsəbə	None
ascii	öyrənmək	None
asagun	qələbə	None
anita	anita	Nan
ọ̀rọ̀	danışmaq	None
georgia	georgiya	Nan
gfaj	gfaj	Nan
kòjòkú	yağış	None
kírísìtì	milad	None
kínu	öpmək	Nan
kíkọ́	öyrənmək	None
kíko	təhsil	None
kí	salamlayin	Nan
kìnní	əvvəlcə	None
kéyìn	sonradan	None
kémíkà	əksinə	None
kétu	olun	None
kékéèké	kiçik	None
kòkó	siçan	None
kéesì	gülünc	Nan
kánádà	əlbəttə	None
kánfinkése	yavaş	Nan
ká	of	None
kàyéfì	görəsən	Nan
kàríbẹ́ánì	bölgədə	None
kwara	ünvanlandı	Nan
ku	sən	None
krio	krio	Nan
kori	yox	None
ko	ko	Nan
koko	öyrənmək	None
káyé	dünya	None
koto	yemi	Nan
kòmpútà	kompüter	None
kòòsí	deyil	None
labalaba	kəpənək	Nan
laarin	daxilində	None
laaka	tərs	Nan
laada	vurmaq	None
laa	çıx get	Nan
kọ́ni	olmaması	None
kọ́lọ́mú	sütunlar	Nan
kọ́kọ́	əvvəlcə	None
kọ̀mpútà	kompüter	None
kọjá	keçmək	None
kẹ́nyà	ayrılıq	None
kòtò	bir çuxur	Nan
kẹta	üçüncü	None
kẹrin	dördüncü	None
kúùkù	əksinə	None
kútò	şey	None
kúrò	uzaqda	None
kúkúrú	sözlə	None
kúkú	sonra	None
kùrání	quran	None
kùkú	sonra	None
kóra	toplamaq	None
kógo	şöhrət	None
kòòkan	biri	None
kẹsàán	dərhal	None
labee	altda	Nan
kookan	bu	None
kong	kong	Nan
kampala	qucaqlamaq	Nan
kalẹ	kənara	None
kalinga	cinga	Nan
kakiri	iz	None
kagera	öyünən	Nan
kadara	aktiv	None
jọ́	xahiş	None
jẹ́mánì	alman	None
jùló	çox	None
jùlo	xüsusilə	None
jùlo	çox	None
kan	a	None
jíjéomoléyìnkírísítì	kimi	None
jíje	olmaq	None
jìnnàa	uzaqda	None
jéésù	i̇sa	Nan
jé	gəl	Nan
jáde	çıxmaq	None
jàgídíjàgan	zorakı	Nan
juneau	iyune	Nan
jo	john	None
jopò	qoşul	Nan
jojo	qırıq	Nan
johanu	istəyirəm	None
jíjuwó	qazanmaq	None
kongo	prezervativ	Nan
kankan	biri	None
karbonumarun	mərkəzdən	Nan
komputa	kompüter	None
kolo	kolo	Nan
kojá	xaç	None
koidu	koidu	Nan
kodò	aşağıda	None
ko	ya	None
kinkinni	şey	None
kilhar	qoltuq	Nan
kikuninu	edin	None
kiko	öyrənmək	None
kikoso	sürətli	None
kanlè	kanal	Nan
kikopomo	isti	None
kiko	gətirir	None
kiakiajulo	tez	None
ki	et	None
khoisan	alçaq	None
kept	saxlanılır	None
keko	savadlı	None
kekere	kiçik	None
kebbi	tənzimlənən	Nan
karùún	beşinci	None
karun	beşinci	None
karl	karl	None
kikojo	tərtib	None
lade	lad	Nan
laid	qoydu	None
laifi	nöqsan	Nan
mahatma	mahatma	Nan
madeira	beira	Nan
maapu	xəritə	Nan
lọ́jà	bazarda	None
lọ́dọọdún	il	None
lọndọnu	london	None
lórò	sabah	None
lónà	yolda	None
ló	ló	Nan
lóòótọ́	həqiqətən	None
lóòótò	bəli	Nan
makedonia	makedoniya	None
lóti	çox	None
lórì	liman	Nan
lópó	dul	Nan
lópez	nipez	Nan
lóde	kənarda	None
lítésò	ləkələnmək	Nan
lísa	sürətlənmə	Nan
lílo	istismar	None
lérú	köləlik	Nan
léyìn	sonradan	None
léyin	sonradan	None
lérò	səbəb	None
lóríba	üzərində	None
lérìnín	qar	None
malabo	bal	None
malayopolynesian	malayopolynesian	Nan
member	üzvü	None
melo	qədər	None
meksiko	meksika	None
mejila	iki	None
mejidinlogbon	səkkiz	None
mefeefa	təmir	None
mediteraneani	dənizi	None
means	deməkdir	None
mbabane	mənfi	None
maya	yox	None
max	maksimum	None
malay	etdi	None
mathimatiki	riyazi	None
matheu	matheu	Nan
maseru	qısqanclıq	Nan
maryland	maryland	Nan
mars	mars	None
marku	vaxt	None
march	mart	None
marcellus	marcellus	Nan
manˈdeːla	manˈdelala	Nan
mango	manqo	Nan
mali	gün	None
malaysia	malaysia	Nan
mathiew	riyaziyyat	None
léebá	təsadüfən	Nan
lédè	dildə	None
lèyìn	sonradan	None
links	bağlantılar	Nan
linear	xətti	Nan
lindi	şir	None
lilongwe	lilongwe	Nan
lilemo	sirr	Nan
lilelile	ağır	None
leè	bilər	None
leyi	budur	None
lewon	həbs	None
lewaju	irəli	None
less	az	None
lodo	almaq	None
lese	post	Nan
lekun	şiddətləndi	Nan
leboa	lebo	Nan
le	bacarmaq	Nan
lay	yatmaq	Nan
latvia	latviya	None
latini	latın	None
latigbana	bəri	None
latibe	oradan	None
lasile	buraxmaq	Nan
lanka	lanka	Nan
languages	dillərdə	None
leo	leo	Nan
lojowaju	gələcəkdə	None
lojukokoro	acgöz	Nan
lojúgun	qırıb	Nan
lèe	bacarmaq	Nan
láíláí	vaxt	None
láì	olmadan	None
lárúbáwá	təbii	None
lára	incidir	Nan
lápá	hissəsi	None
lámọ́di	bəxt	Nan
láké	ucadan	Nan
láimo	olmadan	None
láfún	verilmişdir	None
lábé	çəki	None
lààmì	əlamətləri	None
lààmi	işarəsi	None
làgba	bərabərdir	None
lynton	lynton	Nan
luther	lüt	Nan
luanda	luanda	Nan
lo	et	None
low	aşağı	None
lovers	sevənlər	Nan
louvre	şir	None
loruko	adı	None
lopolopo	çox	None
loloselu	siyasi	None
lokunkun	enerjili	Nan
johann	cəhənnəm	Nan
jogun	irsi	None
jo	sızmaq	Nan
jiròrò	dumanlı	Nan
ifitonileti	məlumat	None
ifilole	başlamaq	None
ifija	balıqçılıq	None
idánwò	sınaq	None
idupe	ol	None
idoma	rəsm	None
idimule	həbs	None
ideraa	yazmaq	None
idari	edir	None
idamita	çəkmək	None
idajo	ədalət	None
ifobaje	korrupsiya	Nan
idaji	yarım	None
idagbasoke	inkişaf	None
iceland	iceland	Nan
ibùjókòó	oturma	Nan
ibùdó	düşərgə	Nan
ibuso	dalaşmaq	Nan
ibuseripadabosi	təzminat	Nan
ibujoko	dəzgah	Nan
ibori	örtük	Nan
ibojì	məzar	None
ibn	ibn	None
ibiti	yerlər	None
idagbe	laqeydlik	Nan
ibise	çalışmaq	Nan
ifofinde	qurultay	None
igbeduro	hazırlıq	None
iketa	olmaq	None
ikerin	dördüncü	None
ikeko	tərtib	None
ikejidinlogun	səkkiz	None
ikaowo	hörmət	None
ikandinlogun	səkkiz	None
ikan	biri	None
ijó	edir	None
ijosin	etmək	None
ijinnasi	fizika	None
ije	hərəkat	None
ifriqiya	stimullaşdırma	Nan
ijaya	təlaş	Nan
ijagun	mübarizə	None
ihinrere	müjdə	Nan
ihan	görünür	None
igitòròmogbè	genişzolaqlı	Nan
igbáẹ̀yìn	sonuncu	None
igbá	toyuq	Nan
igbowolori	bahalı	None
igbeyawo	toy	None
igbesoke	yüksəltmək	Nan
igberiko	şəhərətrafı	Nan
igbegun	qələbə	None
ijakadi	mübarizə	None
ibimo	doğuş	Nan
ibile	ənənəvi	None
ibiamusin	ziyarətgah	Nan
gún	deşildi	Nan
gòkè	qalxmaq	Nan
gírámà	qarmaqlar	Nan
gégé	həqiqətən	None
gèésì	gem	Nan
gèésì	yapışqan	Nan
gv	gv	Nan
guusu	cənub	None
gunle	silah	None
gun	uzun	None
guinébissau	guinébissau	Nan
gúúsù	cənub	None
guineabissau	guineabissau	Nan
guanínì	guanni	Nan
groove	çuxur	Nan
griiki	yunan	None
grammy	qrammatika	Nan
gquadruplex	gquadruplex	Nan
gorgina	qartal	None
gomina	qubernator	Nan
goemai	goemai	Nan
gidí	ev	None
gidigidi	çox	None
ghana	gana	Nan
guinea	qvineya	None
gẹ̀ẹ́sì	i̇ngilis	Nan
habsburg	habsburg	Nan
haggai	bələdçi	Nan
ibewo	gəlib	None
ibeji	əkizlər	Nan
ibarepo	dərnək	Nan
ibalo	iş	None
hv	hv	Nan
hungari	aclıq	None
hun	ovlamaq	Nan
hugh	qucaqlamaq	Nan
hp	hp	Nan
hosea	hosea	Nan
hominidae	hominidae	Nan
histoni	histoni	Nan
hindu	hindu	Nan
him	ona	None
hesse	razılaşdı	Nan
heraklion	heraklion	Nan
henny	heqiqeten	Nan
hendu	konfet	Nan
heinrich	heinrix	Nan
hawaii	həvayi	Nan
hausafulani	hausafulani	Nan
haughton	qaqaş	Nan
hard	çətin	None
halomonadaceae	halomonadaceae	Nan
haiti	haiti	Nan
ikoenu	qorumaq	None
german	alman	None
ikojopo	akkumulyasiya	Nan
iku	ölüm	None
itumo	məna	None
itu	atmaq	Nan
itorawo	liberal	None
itokowo	biznes	None
itobi	lovğalanmaq	Nan
itiraka	mübarizə	None
itelentele	şəkildə	None
itanakole	hekayə	None
itali	i̇talyan	Nan
isè	xidmət	None
isesi	olmaq	None
iwadi	tədqiqat	None
isun	axın	None
iso	gəlmək	None
isepinpin	paylanması	None
iseowo	biznes	None
iseoroayeijoun	arxeologiya	None
iseoba	beş	None
isejoba	idarəetmə	None
iseero	baxın	None
isedaniloro	şübhə	None
isare	sürətlənmə	Nan
isa	yetər	Nan
irúnmọlẹ̀	ildırım	None
isoponomba	isoponomba	Nan
irò	söz-söhbət	Nan
iwasi	et	None
iwoile	ev	None
jijinna	uzaqda	None
jije	olmaq	None
jfk	jfk	Nan
jesu	i̇sa	Nan
jeometri	həndəsə	None
jeffrey	jeffrey	Nan
jawaharlal	yelləncəklər	Nan
jamo	çıx get	Nan
jamaica	youtube	None
jalè	oğurluq	Nan
jagbe	azmaq	Nan
iwifun	məlumat	None
jadide	gözlə	None
jabo	hesabat	None
iṣẹ́ìwádìí	tədqiqat	None
iḷẹ̀	işləmək	None
iyán	parıldayan	Nan
iyen	yəni	None
iyawo	gəlin	None
iyato	fərq	None
iyan	aclıq	None
iwuwa	təcrübə	None
iwulo	faydalıdır	Nan
iwosan	şəfalı	Nan
jackson	cekson	None
irorun	sadə	None
irisi	görünüşü	None
iringa	sarmaq	Nan
ilẹ̀ayé	kürəsi	None
ilẹ	torpaq	None
iléńlá	həyət	Nan
iléàtèéré	ev	None
ilélódò	ev	None
iléisé	ev	None
iléayé	ev	None
ilé	ev	None
iluorilejoba	qloballaşma	Nan
iluoba	vətəndaşlıq	Nan
ilopo	ikiqat	None
iminle	etmək	None
ileru	soba	Nan
ileigbimo	razılıq	None
ileife	laqeydlik	Nan
ilegiga	ev	None
ileasofin	qanunverici	None
ilaorun	çıxdı	None
ilaodo	qorumaq	None
ilanaoye	strategiyaları	Nan
ilana	proseduru	Nan
ilagbolojo	aşkarlıq	Nan
ikún	doldurma	Nan
ikúgbaèyí	i̇ndi	Nan
ileobaluaye	dünya	None
imoero	işıqlandırma	Nan
imojuto	qayğı	None
imusin	çəkmək	None
irele	təvazökarlıq	Nan
ire	satış	None
iranlose	yardım	None
iraja	şokedici	Nan
ipá	güc	None
ipo	yeri	None
ipinu	qərar	Nan
ipinpa	iştirak	None
ipin	fəsil	Nan
ipele	səviyyə	Nan
ipawo	edir	None
ipare	solğun	Nan
iowa	üzündə	None
ioniani	ehtiyaclı	Nan
ioja	balıq	None
inúnibíni	təqib	None
iní	miras	None
inágbéringbérin	yeddi	None
integration	inteqrasiya	None
inkosi	haqq	None
indus	indus	Nan
indeed	həqiqətən	None
inagberingberi	fıstıq	None
imúnisìn	gigiyena	Nan
imú	burun	None
ikoreokere	yığımı	None
ọ̀sẹ	həftə	None
