aajo	سخيف	Nan
púpò	بدلا	None
púpo	كثير جدا	Nan
pò	يطوى	Nan
pòwe	الأمثال	None
pípẹ́	طويل	None
pípèsè	تقديم	None
pípa	ذبح	Nan
péé	ذلك	None
péré	فقط	None
pé	ذلك	None
pèsè	قدمت	None
quran	القرآن	None
pèlúpèlú	كذلك	None
pèhìndà	المني	Nan
pè	اتصل	Nan
pátáporongodo	إطلاقا	Nan
pásíà	القبو	Nan
pàápàá	خصوصا	None
pààlà	حد	None
pàràkòyí	فورا	Nan
pàmò	على وجه التحديد	Nan
px|kùránì	بكسل |	Nan
pupa	أحمر	None
príncipe	príncipe	Nan
pèlu	مع	None
providence	العناية	None
ra	يشترى	Nan
rajya	أمل	None
rome	كروم	Nan
roma	روما	None
roko	تجمهر	Nan
rokirika	التصفح	Nan
rogbodiyan	أعمال شغب	Nan
roboto	السطوح	Nan
robinson	روبنسون	Nan
ro	يفكر	None
rnas	رنا	Nan
rnarna	رنارنا	Nan
rna	رنا	Nan
race	سباق	None
rn	rn	Nan
riresile	مسجل	Nan
rinle	حديثا	None
right|thumb|px|aworan	الصورة اليمنى | الإبهام | بكسل |	Nan
richard	ريتشارد	None
research	ابحاث	Nan
rere	جيد	None
repetejulo	الأكثر حساسية	Nan
repeats	يكرر	Nan
reggae	الريغي	Nan
rank	مرتبة	None
ramadan	رمضان	None
riro	خيال	Nan
ronald	رونالد	Nan
proton	بروتون	None
produced	أنتجت	None
palauan	بالاوان	Nan
padá	جراب	Nan
paapaa	خصوصا	None
paa	يطفىء	Nan
opolo	كثير	None
ofò	صباح الخير	Nan
oyé	العالم	None
ose	أسبوع	None
opolo	كثير	None
omonìyàn	الكائنات البشرية	Nan
olorun	الله	None
panaˈma	panaˈma	Nan
odun	سنوي	Nan
olórun	الله	None
okùnrín	ضحك	Nan
ojó	انها تمطر	Nan
odún	السنة	None
oúnjẹ	طعام	None
owojagidijagan	الإرهابيين	Nan
oun	هو	None
otutu	كثير	None
otherwise	غير ذلك	Nan
oseluarailu	مدني	None
oscar	أوسكار	Nan
olósìn	متدين	Nan
protokolu	بروتوكول	None
panyanan	الفضاء	None
parapọ̀	مزيج	None
press	صحافة	Nan
portuguese	البرتغالية	None
portonovo	بورتونوفو	Nan
population	تعداد السكان	Nan
polaroid	بولارويد	Nan
polandi	تلميع	Nan
pojulo	الاعلى	Nan
po	ص	None
plánẹ́tì	السباكة	Nan
platos	الهضاب	None
piposi	كثير	None
papa	بابا	None
pipolongo	الإعلانات	None
pinu	تحدد	None
pinsoto	بينوتو	Nan
pinsi	ينخفض	Nan
phillipines	الفلبين	None
pelu	لؤلؤة	Nan
petu	بيتو	Nan
periferi	بيريفيري	Nan
penisula	القضيب	None
penh	بنه	Nan
pele	ساحر	Nan
paripari	النهاية	None
pipo	كثير	None
rorùn	سهل	None
rossii	روسي	Nan
rural	قروي	Nan
sìbẹ̀	بعد	None
séyìn	عودة	None
séyìn	عودة	None
sénégal	المني	Nan
ségun	يبكي	Nan
sèle	سرقة	None
são	الجديد	None
sáààrin	ما بين أثنين	Nan
sáàpàdé	رعاية	None
sápadè	هذا اليوم	Nan
sàì	حسنا	Nan
sìni	جمبري	Nan
sàngó	عصابة	Nan
sàmì	علامة	None
sàbúrí	فوق الكل	Nan
symmetry	تناظر	Nan
swahili	السواحيلية	Nan
suny	مشمس	Nan
sun	شمس	None
sugbọ́n	معقول	Nan
sugbo	لكن لا	Nan
suez	السويس	None
structures	الهياكل	None
stella	ستيلا	Nan
sàn	الافضل	Nan
spectacular	مذهل	Nan
síbèsíbè	ومع ذلك	Nan
sílẹ̀	خذل	Nan
tabora	تجنب	None
tabili	الطاولة	Nan
tabi	أو	None
sísè	ترجمة	None
sísa	s. yaa	Nan
sááju	خذ دقيقة	Nan
sisé	اكتشف - حل	Nan
sepò	أخيرا	None
se	إنهم يفعلون	Nan
sùgbón	على العكس تماما	Nan
síse	بناء	None
síbú	على الأرض	Nan
si	من المؤكد	Nan
sùgbón	على العكس تماما	Nan
sóko	نبات	None
sójà	جندي	None
sòrò	غسيل الدماغ	Nan
síí	هنا	None
síwájú	فصاعدا	Nan
síwon	معهم	None
síta	في الخارج	Nan
síso	ما يزال	Nan
síso	ما يزال	Nan
síse	عمل	None
sọ	قل	Nan
so	وبالتالي	None
sopin	النهاية	None
soon	هكذا	None
say	قل	Nan
santa	سانتا	Nan
samioro	متاح	Nan
sambia	شباب	None
salàyé	الحياة	None
salem	سالم	None
sakyas	الساقية	Nan
sakyamuni	التالي	None
saheli	السهولة أو الراحة	Nan
safta	اصطفوا	Nan
safiwe	مقارنة	None
sb	sb	Nan
saffana	ياقوت أزرق	Nan
saarland	على الارض	Nan
saaree	متفوق	Nan
saarc	إزالة	None
rẹ	لها	None
ròyìn	ذكرت	Nan
rìn	على المشي	Nan
ré	ج	None
république	ريبليك	Nan
ránmú	قلق	Nan
ráhàn	ظهر	None
ryan	ريان	Nan
safari	سفاري	Nan
schwarz	شوارتز	Nan
sea	البحر	None
seat	مقعد	Nan
solomon	سليمان	None
sohun	نعم	Nan
so	حب	None
slovo	سلوفو	Nan
sisupo	تتضاعف	Nan
sisupapoerekusu	البصق	Nan
sisopo	ربط	None
sisodagba	التقدم في العمر	Nan
sise	طبخ	Nan
sioux	سيوكس	Nan
sinsin	دين	None
sinai	خطيئة	Nan
silè	قطرات	Nan
sile	خلف	None
sihamoni	بناء	None
sibesibe	بعد	None
sharon	شارون	Nan
sewadi	بحث	None
seville	اشبيلية	Nan
sense	إحساس	Nan
senegal	السنغال	Nan
semudaju	بالتاكيد	Nan
semolara	الربو	Nan
seidamo	واضح	None
segbese	ربما	None
orúko	الميدان	None
taino	دينو	Nan
orísìírísi	أنواع مختلفة	Nan
orísiirísi	مختلف	None
nombamewa	ضرب	Nan
nobel	نوبل	None
nnaji	اخو الام	Nan
nkàn	سرطان	None
nkan	شيء	None
niyi	ها هو	Nan
niye	كافية	None
niyato	تميز	None
niwaju	امام	None
nitosi	مجاور	Nan
nitoripe	لان	None
nombáméjì	أول إثنين	Nan
nitoriidieyi	و لهذا	Nan
nilè	هنا	None
nijẹr	نايك	Nan
nigbà	ثم	None
nigbakan	بعض الأحيان	Nan
nibere	مبكرا	Nan
nibe	هناك	None
ngubengcuka	ngubengcuka	Nan
ngbero	المخطط لها	Nan
nevis	نيفيس	Nan
neptune	نبتون	None
nefimu	نفيم	Nan
nisinyi	الآن	None
nebraska	نبراسكا	Nan
novo	نوفو	Nan
nse	التصميم	None
nínlá	عظيم	None
nílẹ̀	على الأرض	Nan
nílùú	في المدينة	Nan
nílè	أدناه	None
nígbàtí	متى	None
nífẹ̀ẹ́	يحب	None
níbè	هناك	None
níbè	هناك	None
ní	يملك	None
nìyí	هذه هي	Nan
nìnú	آسف	Nan
nri	طعام	None
nì	الجبل	None
náwo	مصروف	Nan
nàìjíríà	في نيجيريا	Nan
nwa	طفل	None
numeri	خدر	Nan
nukleotidipupo	النوكليوتيد	Nan
nukleotidi	النوكليوتيد	Nan
nu	نظيف	Nan
ntoka	نقطة	None
nsowikipedia	obowikipedia	Nan
nsolaboraro	الأمان	None
nso	قريب	None
náà	جدا	None
nínu	فرصة	None
ncnc	ncnc	Nan
nawojulo	محير	Nan
munispal	مينيسبال	Nan
mulẹ̀	إنشاء	None
mughal	الصوت	None
mtwara	اختر مرة أخرى	Nan
mtn	mtn	Nan
mozilla	موزيلا	Nan
mozambique	موزمبيق	Nan
morogoro	قيادة السيارات	Nan
morgan	مورغان	Nan
monrovia	مونروفيا	Nan
mombasa	مومباسا	Nan
muungano	muungano	Nan
mokanlelogbon	اثنان و ثلاثون	Nan
mohandas	المهندسين	None
minority	أقلية	None
minnesota	مينيسوتا	Nan
mimuwa	التشبث	Nan
mimoy	ميموي	Nan
miiràn	يخفف	Nan
micronesia	ميكرونيزيا	Nan
michelle	ميشيل	Nan
mexico	المكسيك	None
mewar	الموار	Nan
meucci	meucci	Nan
mokaleladota	المدمج	Nan
nawó	احصل على أموالك	Nan
májèmú	لا تمانع	Nan
méjèèjì	على حد سواء	Nan
nato	حلف شمال الاطلسي	Nan
nathaniel	ناثانيال	Nan
namibia	ليأتي	Nan
mẹ́talọ́kan	ثالوث	Nan
mẹ́ta	ثلاثة	None
mẹ́rkúríù	الفأر	Nan
mẹ́fà	ستة	None
múlẹ̀	اعتصموا	Nan
mó	م	Nan
móra	علاج	None
mókólà	صمغ	Nan
mère	رسم	None
mò	المعرفه	Nan
míìrán	آخر	None
míràn	آخر	None
mímọ́	مقدس	Nan
ménu	هل تعتقد	Nan
méwàá	عشرة	None
métèètà	النجار	None
méta	ثلاثة	None
mérìnlélógójì	أربعة وأربعون	Nan
mérìndínlógún	السادس عشر	Nan
méte	خمسة	None
mérindíláàdóta	خمسة و خمسون	Nan
mííràn	آخر	None
níní	امتلاك	Nan
nípà	على الأقل	Nan
nítorípé	لان	None
onítumò	مترجم	Nan
oníná	نار	None
onílẹ̀	أسفل	None
oníkólóbó	مسيء	Nan
onígbàgbó	كبار السن	Nan
onka	آلة حاسبة	Nan
onje	حمية	Nan
oniyijulo	ممتاز	Nan
oniyewumeji	الثنائية	None
onisowo	تاجر	Nan
onisayensi	فني	None
onítèbọmi	عمد	None
onipin	معقول	Nan
onilile	أصحاب المنازل	Nan
onilanaibagbepo	واق ذكري	Nan
onigunfenfe	مبني للمجهول	Nan
onigbowo	كفيل	Nan
onigbeja	بناء	None
onibugbe	المستأجر	Nan
onialjebra	onialjebra	Nan
omiadalu	فيضان	Nan
omi	ماء	Nan
olùkọ́	مدرس	Nan
olùkó	مدرب	Nan
oninawo	مستعير	Nan
olùkópa	مساهم	Nan
onítòhùn	محاسب	Nan
oníyanjù	مفعم بالحيوية	Nan
orílẹ́	مساء	None
orílẹ̀	الأمة	None
orílèèdè	الأمة	None
oríkì	الشعر	None
oríilẹ̀	مقالة - سلعة	Nan
oríilè	الوطني	None
oruko	اسم	None
orudnun	سنوي	Nan
oritameta	في المنتصف	Nan
orisa	أصول	None
orisun	مصدر	None
oníwòsàn	المعالج	Nan
orisirisi	تشكيلة	Nan
orileominira	الدفء	Nan
orilejoba	حكومة	None
orileedeajoba	الإمبريالية	Nan
orileede	الأمة	None
oriki	شرقي	None
oriire	تهانينا	Nan
ori	رئيس	None
opposite	ضد	None
opec	أوبك	Nan
ootọ́	صحيح	None
ooni	تمساح	Nan
orinìyìn	أغنية	None
olùdarí	قائد	None
olùbátan	هذا الاتصال	Nan
olóṣèlú	سياسي	None
ojùkòsì	ترسب	Nan
ojuse	المسئولية	Nan
ojuoorun	غروب الشمس	Nan
ojukokoro	الطمع	Nan
ojoru	الدفء	Nan
ojojumo	اليومي	Nan
ojo	يبدو مثل	Nan
ogunlogo	يحشد	Nan
ogun	الحرب	None
ogbè	منطقة	None
ofin	القانون	None
ojùkòtúu	ترسب	Nan
ododo	نزاهه	Nan
obere	صغير	None
obairanderan	ولد عم	Nan
oba	أوباما	None
nso	قريبا	Nan
nǹkan	شيء	None
níyanjú	بشكل ايجابي	Nan
níwájú	امام	None
nítòótọ́	في الواقع	Nan
nítòótó	بالضبط	Nan
nítòsí	مجاور	Nan
nítumò	المعنى	None
obínibí	مجاملة	Nan
ojúlùmọ̀	المعارف	None
ojútáyé	اللزوجة	Nan
ojúìwé	الصفحة	None
olóyè	مسطرة	Nan
olódùmarè	عز وجل	Nan
olympus	أوليمبوس	Nan
oluwakiri	استكشاف	None
olusoju	حارس	Nan
oluparapo	مزيج	None
olumojuto	جشع	Nan
olukowe	مؤلف	None
olukoitan	مدرب	Nan
oludase	منتج	None
oluda	المنشئ	Nan
oloye	العبقري	Nan
oloselukan	مرحبا	Nan
olora	سمين	Nan
olopon	متغطرس	Nan
ololugbe	الخاسر	Nan
olokunkun	سماعات الرأس	Nan
olojukanna	فورا	Nan
olohun	أصحابها	Nan
olodiajodojuko	بعضهم البعض	Nan
okunrin	الرجل	None
okunkun	الظلام	None
oko	حقل	None
okhotsk	أوخوتسك	Nan
okeere	ما وراء البحار	Nan
orísìí	تشكيلة	Nan
tainos	تاينوس	Nan
takuntakun	القيود	None
talaka	فقير	Nan
ìràwọ̀	النجوم	None
ìrànàna	مساعدة	None
ìrànlọ́wọ́	مساعدة	None
ìpínrò	الفقرات	Nan
ìpìnlè	البداية	None
ìpìlẹ̀núkléù	التشفير	Nan
ìpolongo	إعلان	None
ìnáwó	المصروفات	Nan
ìnagije	فوز	Nan
ìmúsára	لتعزيز	None
ìmúnilérú	الانتهاكات	Nan
ìrí	تجربة	None
ìmú	أنف	Nan
ìmò	برق	Nan
ìmò	ثعبان	Nan
ìlé	الصفحة الرئيسية	Nan
ìlè	الرشوة	Nan
ìlàìnàró	الظلم	None
ìlàorùn	كدمات	Nan
ìlànàn	وهم	None
ìlà	الخطوط العريضة	Nan
ìlo	مكالمة	Nan
ìlera	الصحة	None
ìkọpa	مشاركة	None
ìmóbìdo	حق الولادة	Nan
ìkẹrin	الرابع	None
ìròkò	فكر	None
ìròyìnwiki	أخبار	None
ìtaeko	ورشة عمل	Nan
ìta	في الخارج	Nan
ìse	عمل	None
ìsòro	صعوبة	None
ìsílé	الصفحة الرئيسية	Nan
ìsèjoba	حكومة	None
ìsèdá	خلق	Nan
ìsègbèfábo	اجتهاد	Nan
ìse	عمل	None
ìsọ	محلات	Nan
ìsú	سماكة	Nan
ìròyìn	أخبار	None
ìsòrí	التقسيم	None
ìsìn	دين	None
ìsèlè	إنتاج	None
ìsàlè	غروب الشمس	Nan
ìsomó	لينضم	Nan
ìsirò	عملية حسابية	Nan
ìsinsìnyí	الآن	None
ìse	عمل	None
ìsawo	عرافة	Nan
ìrúbo	انهيار	None
ìró	صوت	None
ìròrùn	وهم	None
ìsòrò	تأمل	Nan
ìtan	التاريخ	None
ìkínin	السادس	None
ìkìjà	تحدي	Nan
ìdá	الهجر	Nan
ìdàrúdàpò	فوضى	None
ìdàpapọ̀	الدمج	Nan
ìdàgbà	مرحلة البلوغ	Nan
ìbílè	حق الولادة	Nan
ìbílè	حق الولادة	Nan
ìbáraeni	عربه قطار	Nan
ìbánisòrò	الاتصال	None
ìbarà	حمى	Nan
èpón	كثير	None
èwù	قميص	Nan
ìdìmú	إزعاج	Nan
èsìn	دين	None
èro	أفكار	None
èka	تأثير	None
èyì	كرامة	Nan
ète	غرض	Nan
èsúrú	النمل	None
èsó	مسجد	None
èrò	أفكار	None
èràn	مرض	None
ènìkan	شيئا ما	Nan
èlò	أواني	Nan
èkejì	الأخرى	None
èrí	دليل	None
ìkìlò	إساءة	Nan
ìdíisin	سبب	None
ìdó	العقرب	Nan
ìkéde	إعلان	None
ìkèrèkú	ازدحام، اكتظاظ، احتقان	Nan
ìkànna	نفس الشيء	Nan
ìkejì	الأخرى	None
ìjọba	حكومة	None
ìjò	زعيم	None
ìjìnlè	الغموض	None
ìjìnlè	الغموض	None
ìjora	اكرهه	Nan
ìjoba	حكومة	None
ìjo	الكنيسة	None
ìdíwòn	سببك	Nan
ìjo	ارقص	Nan
ìgbò	الرامات &quot;الذاكرة العشوائية في الهواتف والحواسيب	Nan
ìgbésí	الحياة	None
ìgbéraga	فخر	Nan
ìgbáraga	قوة	None
ìgbá	أجنحة	None
ìgbàgbé	ينسى	Nan
ìgbà	زمن	None
ìgbonnìbí jé	إنها كارثة	Nan
ìfáàrà	كاهن	Nan
ìfojúìtànìgbesiayé	تاريخ الحياة	Nan
ìfara	تعذيب	Nan
ìhun	حديد	None
ìtokò	وعاء	Nan
ìtàn	التاريخ	None
ìtànkálé	الفيضانات	None
ṣàkóbá	مضر	Nan
ṣiṣé	افتتاح	None
σ	σ	Nan
κάππα	.α	Nan
ˌæləˈbæmə	مرض	None
ˌkælɪˈfɔrnjə	ækælɪˈfɔrnjə	Nan
ˈøːstəˌʁaɪç	ˈøːstəˌʁaɪç	Nan
ʔaːnaːtɕɑ̀k	.aːnaːtɕɑɕɑk	Nan
şe	فعل	None
únṣẹlẹ̀	هزة أرضية	Nan
ôdún	عام	None
ẹdo	نكتة	Nan
ó	نعم	Nan
ósírísì	اللعاب	Nan
óníse	إنه مصمم	Nan
ó	عليه	None
òròàjòmó	الصباح	None
òrò	أفكار	None
òwó	مال	None
òsà	ذهبية	None
òrò	أفكار	None
òré	لعبه	Nan
òpòlopo	كثير	None
òfò	التالي	None
ósékú	انه ميت	Nan
òré	لعبه	Nan
ẹlẹ́bùn	هدية	Nan
ẹnìkan	شخص واحد	Nan
ọ̀pòlòpò	عمل	None
ọ̀nà	الطريق	None
ọ̀gbìn	نبات	None
ọ̀dọ́	شباب	None
ọpọ́lọpọ́	تين	Nan
ọn	عليه	None
ọmọ	طفل	None
ọmú	أنت تمتص	Nan
ọlọ́run	اله	Nan
ọlọ́mọ	الأطفال	None
ọdún	عام	None
ẹlẹ́sìn	متدين	Nan
ọbàkàn	نصف أخ	Nan
ẹ̀rọ	الات	Nan
ẹ̀ni	منظمة الصحة العالمية	Nan
ẹ̀kọ́	التعليم	None
ẹ̀kẹ́ta	الثالث	None
ẹ̀kasístẹ̀mù	شخصي	Nan
ẹ̀kaoṣù	شائك	Nan
ẹ̀kajuly	مايو	None
ẹ̀kabrítánì	اخو الام	Nan
ẹ̀kaawon	التقديمات	Nan
ẹtì	الكبد	None
ẹsẹ	أقدام	Nan
ẹ̀wẹ̀	من ناحية أخرى	Nan
òpòlopò	كثير	None
òkòòkan	واحدا تلو الآخر	Nan
òkan	واحد	None
òdo	شباب	None
òdeojú	مجهول الهوية	Nan
òde	في الخارج	Nan
ìṣọ̣̀tẹ̣̀	التهاب رئوي	Nan
ìṣẹ́kù	الباقي	None
ìṣèlú	سياسة	None
ìyípadà	تحويلات	Nan
ìyàwó	العروس	Nan
ìyapa	انفصال	None
ìya	معاناة	Nan
ìwúlò	مفيد	Nan
òdìkejì	الأخرى	None
ìwòran	رؤية	None
ìwéré	كتيب	Nan
ìwàásù	الوعظ	Nan
ìwo	قرون	None
ìwe	مقارنة	None
ìtúpalè	ترجمة	None
ìtúmò	ترجمة	None
ìtóka	للضرب	Nan
ìtójú	تعابير الوجه	Nan
ìtóju	الالتباس	Nan
ìtójú	رعاية	None
ìtèsíwájú	تقدم	None
ìwò	شاملة	None
òféàrán	صورة	None
ògbójú	مختص	Nan
ògiri	حائط	None
òjògbón	طقس ممطر	Nan
òṣèlú	سياسة	None
òwù	قماش	Nan
òsèré	رياضي	Nan
òsèlú	سياسي	None
òsán	وقت الظهيرة	Nan
òrò	الدماغ	None
òrí	الفصل	None
òrìsà	الأصنام	Nan
òranyàn	إلزامي	Nan
òpópóònà	الطريق	None
òotó	حقيقة	None
òní	اليوم	None
òmùàrán	صورة	None
òmiràn	مشعوذ	Nan
òle	ربه منزل	Nan
òkúta	حجر	None
òkú	الجثث	Nan
òkòòkan	واحدا تلو الآخر	Nan
òkèògbún	ألف	None
òjísé	الطبيب	None
òjo	يبدو مثل	Nan
ògúndìpẹ̀	البودرة	Nan
ògun	الدواء	Nan
ògo	مجد	Nan
èka	فرع شجرة	Nan
èhìn	التالي	None
èfòn	توتر	Nan
èdè	لغة	None
visit	يزور	Nan
viruses	الفيروسات	None
villa	فيلا	Nan
vihara	vihara	Nan
videos	أشرطة فيديو	Nan
victor	المنتصر	Nan
vermont	فيرمونت	Nan
venezuela	فنزويلا	None
uzbek	الطريقة	None
utc	التوقيت العالمي	Nan
utah	يوتا	Nan
vz	vz	Nan
usps	usps	Nan
urasílì	اليوراسيل	Nan
unla	نعم	Nan
unifasiti	جامعة	None
umueri	الأطفال	None
ucb	ucb	Nan
tẹ̀ǹbẹ̀lẹ̀kun	التآمر	Nan
tẹ̀ǹbẹ̀	ثم	None
túnse	إعادة ترتيب	Nan
túmò	وظيفة محترمة	Nan
tú	اسكب	Nan
tóka	استشهد	Nan
uribe	الهالة	Nan
tó	طوس	Nan
waa	أنه	None
wari	رائحة	None
yafran	هذا جيد	Nan
xiv	الرابع عشر	Nan
xd	وجه ضاحك	Nan
wọ̀nyí	هؤلاء	None
wọn	معهم	None
wúnrèn	اكتشف - حل	Nan
wón	معهم	None
wònyí	هؤلاء هم	Nan
wòfún	لمحة	Nan
wípè	وضوح	Nan
wì	يغسل	Nan
waju	وجه	None
wàásù	الوعظ	Nan
wura	ذهب	None
won	معهم	None
wo	هنا	None
wo	هنا	None
woo	وو	Nan
wole	تسجيل الدخول	Nan
województwo	cheworddztwo	Nan
wiwari	اكتشاف	None
witkin	فيتكين	Nan
wisconsin	ويسكونسن	Nan
westminster	وستمنستر	Nan
wyoming	وايومنغ	Nan
tówùú	أي كمية	Nan
tókù	راحة	Nan
tódárajùlọ	الأفضل	None
tokyo	طوكيو	Nan
tokasi	أشار	None
toje	نادر	Nan
to	إلى	None
tiwọn	لهم	None
titu	أطلق النار	Nan
tirè	له	None
tirana	تيرانا	Nan
tira	توتر	Nan
thumb|left|upright|nelson	إبهام | اليسار | مستقيم | نيلسون	Nan
those	أولئك	None
tolerejulo	التسامح	None
they	هم	None
tfrac	tfrac	Nan
terutomo	تيروتومو	Nan
temptation	بحث	None
tele	متابعة	None
teksas	تكساس	None
tedo	التعارف	Nan
technology	تقنية	None
taínos	التاينوس	Nan
tata	منقي	Nan
tara	تسع	None
talika	الفقر	None
the	ال	None
tolórítelémù	محرقة	Nan
tomé	طماطم	Nan
tooto	هل حقا	Nan
tóbi	كبير	None
tò	جلس	Nan
tíórì	الإطارات	Nan
tíátà	تذاكر	Nan
títío	حتى	None
títèlé	للمتابعة	Nan
títi	مغلق	Nan
té	t	Nan
télè	بواسطة	None
té	ر	Nan
tèsíwájú	لتحرز تقدم	Nan
tèlé	فورا	Nan
tètè	بسرعة	None
tèlé	متابعة	None
táawà	للانحناء	Nan
tàwon	معهم	None
tàsí	بدون	None
tuntun	جديد	None
tumosi	يعني	None
translated	ترجم	None
traduite	traduite	Nan
tounsejanu	مأساوي	Nan
toseluaralu	سياسية	None
torun	امرأة سمراء	Nan
tori	توري	Nan
yakubu	يعقوب	None
metropoli	متروبولي	Nan
yan	تحديد	None
yanturu	وفرة	None
àsìkò	زمن	None
àsèyìn	ما بعد الكارثة	Nan
àsàjemátèe	فجر	None
àse	وليمة	Nan
àrẹ	رئيس	None
àrùn	مرض	None
àrígbámú	مزعج	Nan
àpeere	مثال	None
àpapọ̀	ككل	None
ànfàní	فرصة	None
àmúsorò	علم النفس	Nan
àsótélè	تمديد	Nan
àmúlò	عملي	Nan
àmérìkà	خارق للعادة	Nan
àlébù	عيب	Nan
àlèpò	في الاعلى	Nan
àlè	ابن حرام	Nan
àlááfià	القياس	None
àlàáfíà	سلام	None
àlàyé	معلومات	None
àlàkalè	الأهداف	None
àkókó	الوقت	None
àkójopò	مجموعة	Nan
àká	رفوف	Nan
àmì	إشارة	None
àkàrà	كيك	Nan
àsọdọ̀kan	وحدة	None
àsà	مخصص	Nan
èdè	لغة	None
èdá	خلق	Nan
èbúté	ميناء	None
èbà	البعوض	Nan
áwon	الزنا	Nan
án	ر	Nan
àìsí	غياب	None
àìròtélè	غير متوقع	Nan
àìní	تريد	None
àìkó	نقص	None
àáyá	المني	Nan
àsekúdórógbó	لحاء الشجر	Nan
àárín	في المنتصف	Nan
ààtò	طقوس	None
àwùjo	المجتمع	None
àwón	مال	None
àwón	المال	None
àwon	نظريات	None
àtẹnudẹ́nu	عن طريق الفم	Nan
àtúnse	تعديل	None
àtúnse	تعديل	None
àtòrìnká	الدوار	Nan
àtìpó	الأجنبي	None
àtijo	عفا عليها الزمن	Nan
ààyè	على قيد الحياة	Nan
àkosílè	أطروحة	Nan
àkosílè	التجريد	Nan
àjọṣepọ̀	اجتماعي	None
yíì	سوف تفعلها	Nan
yíyípadà	يتغيرون	Nan
yí	التف حوله	Nan
yìí	هذه	None
yì	اذهب	Nan
yée	دعهم	Nan
yèwò	نظرة	None
yára	عجلوا	Nan
yàtò	اقامة	Nan
yànan	دهشة	Nan
yo	يو	None
yíò	ستكون	None
yorúbà	زبادي	Nan
yori	يؤدى	None
yoo	إرادة	None
yiyafunnilo	التعرية	None
yipada	التف حوله	Nan
yiowu	ستكون	None
yio	يجب	None
yindinyindin	لا تتوقف ابدا	Nan
ye	بلى	Nan
ye	بلى	Nan
yewo	تحسين	None
yaoundé	ياوندي	Nan
york	يورك	Nan
yẹ̀ẹ́	أنت تعرف	Nan
yọ	إزالة	None
zanzibar centralsouth	زنجبار المركزية المركزية	Nan
àjákọ	بعيدا، بمعزل، على حد	Nan
àjo	السفر	None
àifète	غرض	Nan
àgọ́	خيمة	Nan
àgbùdo	حديقة منزل	Nan
àgbìgbò	حي	None
àgbéyèwò	مراجعة	None
àgbékà	نبذة مختصرة	Nan
àgbáríjọ	منظمة	Nan
àgbàrá	فيضان	Nan
àgbàjọ	الرجل العجوز	Nan
àdóolóró	نفط	None
àdáátán	حصرية	Nan
àdátá	المقابل	None
àdámò	خصوصية	Nan
àbọ̀	نصف	None
àbìkú	خلود	Nan
àbáyo	اقتراح	None
àbámẹ́ta	الخميس	None
àbe	البابون	Nan
 bce	بعيدا	Nan
zy	زي	Nan
zscores	zscores	Nan
zou	zou	Nan
zdna	زدنا	Nan
yanjú	حل	Nan
methodologies	منهجيات	Nan
merin	أربعة	None
mercosur	ميركوسور	Nan
díè	توتر	Nan
dìtẹ̀	التآمر	Nan
dìró	على اليمين	Nan
dìde	تنشأ	None
dì	ورقة	None
dépò	الى حد	Nan
délànà	من حيث المبداء	Nan
dé	وصل	None
dáwó	تبرع	Nan
dásà	كازا	Nan
dáradára	حسنا	Nan
dóko	جيد	None
dálóríi	شكرا	Nan
dágbó	كبار السن	Nan
dá	خلقت	Nan
dàpò	استبدلهم	Nan
dàbíi	مثله	None
dun	طيب المذاق	Nan
due	بسبب	None
du	du	Nan
dover	دوفر	Nan
doublestrand	حبلا مزدوج	Nan
doublehelix	الحلزون المزدوج	Nan
dote	dote	Nan
dájó	حسنا	Nan
doni	دوني	Nan
dólà	حسنا	Nan
dúró	للوقوف	Nan
eléré	رياضي	Nan
eléde	نبذة مختصرة	Nan
elláda	خلق	Nan
eleyii	مثله	None
eleyi	هذه	None
elede	الخنازير	None
eko	التعليم	None
ekeji	الأخرى	None
eka	مركب	None
eighteen	الثامنة عشر	Nan
egbògi	طبي	Nan
dún	صوت	None
egbò	جرح	Nan
egbo	جرح	Nan
egberundun	ألف سنة	Nan
egbe	بندقية	Nan
egba	إطلاقا	Nan
efrem	انفيم	Nan
ede	لغة	None
ecomog	ecomog	Nan
ebi	أسرة	None
eba	eba	Nan
ea	نعم	Nan
dọ́gba	مساو	Nan
egbé	ويل	Nan
elòmírà	الفلفل	Nan
dominic	دومينيك	Nan
doju	وجها لوجه	Nan
clear	واضح	None
cipollone	سيبولون	Nan
china	الصين	None
cherished	عزيز	None
chebbi	يفكر	None
chaskalson	شاسكالسون	Nan
charles	تشارلز	None
chamorro	تشامورو	Nan
cbc	سي بي سي	Nan
cauchy	كوشي	Nan
catherine	كاترين	None
code	الشفرة	Nan
cathedral	كاتدرائية	None
casablanca	الدار البيضاء	Nan
cape	رداء	Nan
canaria	كناريا	Nan
calabar	علكة	Nan
cairo	الغضب	Nan
bẹ́ẹ̀sìni	نعم	Nan
bẹ́ẹ̀ni	نعم	Nan
bẹ́ljíọ̀m	البريل	Nan
bẹ́	حطم	Nan
bẹ̀rẹ̀	للبدء	Nan
búrú	كن شجاعا	Nan
caslon	كازينو	Nan
dojú	وجها لوجه	Nan
coetsee	coetsee	Nan
coming	آت	Nan
divoire	المطلقة	None
dinwoju	ابحث عن	Nan
din	يقلى	Nan
different	مختلف	None
didasile	مؤسسة	None
didagba	المساواة	None
development	تطوير	None
desmond	ديزموند	Nan
describes	يصف	None
des	ديس	Nan
denver	دنفر	Nan
coloured	ملونة	Nan
delhi	لا	None
daru	هدم	None
darapo	انضم	None
dani	تحتجز	Nan
dandan	إلزامي	Nan
dagbasoke	تصرف بنضج	Nan
da	و	None
cunha	حلق	Nan
ct	قيراط	Nan
csto	csto	Nan
computers	أجهزة الكمبيوتر	Nan
compared	مقارنة	None
dates	تواريخ	Nan
elòmíràn	آخر	None
emerging	المستجدة	Nan
emmanuel	إيمانويل	Nan
gbaná	الترجيح	Nan
gbale	شعبية	None
gbajúgbujà	تحظى بشعبية كبيرة	Nan
gba	يوافق على	Nan
galatia	هذا الوقت	Nan
fẹ́rẹ̀ẹ́	تقريبيا	Nan
fòye	تفهم	Nan
fífún	إعطاء	None
fífò	تحلق	Nan
fégbé	انسى ذلك	Nan
fé	fé	Nan
gbe	احمل	Nan
fé	fé	Nan
funra	بحد ذاتها	Nan
fun	إلى عن على	Nan
fulbe	فول	Nan
fulani	جبان	Nan
fuji	إزالة	None
freetown	فريتاون	Nan
fransi	فرنسي	None
francis	فرانسيس	Nan
fracmv	فراكمف	Nan
fowó	من اجل المال	Nan
fowobowe	الحجز	Nan
further	بالإضافة إلى ذلك	Nan
fourbase	أربعة قاعدة	Nan
gbera	استمر	None
gbese	دين	None
geneva	جنيف	Nan
geesi	الإنجليزية	None
gbọ́dọ̀	يجب	None
gbúnùn	شمها	Nan
gbónmisi	القانون	None
gbódò	يجب	None
gbìyànju	ابذل جهدك	Nan
gbìnyànjú	محاولة	None
gbésè	عرض	None
gbéyèwò	مراجعة	None
gbéni	حي	None
gberasoke	اسرع	Nan
gbékalè	النجار	None
gbé	حي	None
gbáradì	استيقظ	Nan
gbá	تحطيم	Nan
gbàgùrà	اهتز	Nan
gbàgbọ́	يصدق	Nan
gbongbo	جذر	Nan
gbogbogbo	جنرال لواء	Nan
gbin	زرعت	Nan
gbilè	انطلق	None
gbigbewo	التمويل	None
gbigbamulo	استغلال	None
gbédìí	إنشاء	None
foriko	فمثلا	None
force	فرض	None
foniimu	فيلم	None
eyonomba	eyonomba	Nan
eyin	بيض	Nan
eya	الفئة	None
example	مثال	None
ewì	الشعر	None
ewé	ورقة الشجر	Nan
ewe	ورقة الشجر	Nan
euroasia	يوروسيا	Nan
euro	اليورو	None
etíòkun	الساحل	None
etymologiae	علم أصل الكلمة	Nan
eléja	صيد السمك	Nan
etisalat	اتصالات	None
esia	قادم	Nan
eseese	رسم بياني	Nan
eréonítàn	اختصار	Nan
erékùsù	جزيرة	None
erofo	الرواسب	Nan
ernst	إرنست	Nan
epa	الفول السوداني	Nan
eníbá	حمى	Nan
enì	الفيل	None
enter	أدخل	None
enikéni	كل واحد	Nan
esteri	الأستري	Nan
elòmíràn	شخص اخر	Nan
eka	تأثير	None
eléyàmèyà	الأصل العرقي	Nan
fohùn	يصيح، يصرخ، صيحة	Nan
fofinde	حظر	None
fodio	فوديو	Nan
five	خمسة	None
fitino	التجربة	None
finlandi	فنلندا	None
finiki	الفيزياء	None
fimú	محدد بحدة	Nan
fihan	يشار	None
fifihan	تظهر	None
fi	حفظ	None
fe	مطلوب	Nan
fesèmúlè	مصدر مؤقت	Nan
ferde	ferde	Nan
felifeli	المخمل	Nan
farsi	أرتي	Nan
faranse	فرنسي	None
faramó	الالتزام	None
fan	معجب	Nan
fail	فشل	None
fagile	ألغيت	Nan
ewà	السلوك	None
esè	العائدات	Nan
esin	دين	None
enu	فم	Nan
búburú	سيئة	None
bòtswánà	الحافلة	Nan
béè	مثل هذا تماما	Nan
bèrẹ̀	لنبدء ب	Nan
alawose	عرافة	Nan
alalaye	ترابي	Nan
alakobere	مبتدئ	Nan
alakitiyan	ناشط	Nan
alaini	محتاج	Nan
alaigbara	لا يقاوم	Nan
alaidogba	غير متوازن	Nan
aladanida	اعتباطيا	Nan
aladani	نشر	None
aladaani	نشر	None
alaafin	غير شرعي	Nan
albany	ألباني	Nan
alaafia	سلام	None
alaabo	معاق	Nan
ala	أسفل	None
akẹ́kọ̀ọ́	طالب علم	Nan
akíngbógun	كتيبة	None
akíkanjú	الشجاع	Nan
akátá	ابن آوى	Nan
akopo	التحويل البرمجي	Nan
akopa	اولا في المقام الاول اولا قبل كل شي	Nan
akoni	ليس عندنا	Nan
akole	نحن لا نستطيع	Nan
akokolo	فترة	None
alaadanida	غير مرغوب فيه	Nan
akinpelu	سلاح المدفعية	Nan
albert	ألبرت	None
alicia	أليسيا	Nan
anc	قدم	None
anabi	النبي	None
an	أ	None
améríkà	أمريكي	None
améríkà	أمريكي	None
amosi	مسجد	None
amojeoyipada	قابلة للتحويل	Nan
amerika	أمريكا	None
americas	الأمريكتين	None
amazonas	أمازوناس	Nan
alọ́po	محفظة نقود	Nan
alexandra	الكسندرا	Nan
alúwo	فقاعة	Nan
aláyèwò	مفتش	Nan
alátise	فنان	None
alápapò	إستبدال	Nan
alákọ̀bẹ̀rẹ̀	البادئ	Nan
alumíníọ̀mù	الألومنيوم	Nan
alumoni	علاجي	Nan
alukuraani	القرآن	None
alubàbá	الآب	None
alpha	ألفا	None
alominira	استقلال	None
allāh	الله	None
aláísàn	مرض	None
akiidah	كوريدة	Nan
ajọra	نسخة مطابقة للأصل	Nan
ajoro	السفر	None
adiokan	المنعزل	Nan
adeda	طبيعة	None
addis	أديس	Nan
adarihunrun	منظف	Nan
adabaye	حسنا	Nan
adaba	مناسب	None
accra	أكرا	Nan
abúléko	قرية	None
abínibí	الجنسية	None
abé	إبرة	Nan
abálájo	يختبر	Nan
adágbà	المسنين	Nan
aburunmu	رجسنا	Nan
abidjan	أبدا	None
abidi	الأبجدية	None
abesahara	رش	Nan
abeorile	العودة للوطن	Nan
abeikojopo	وريثة	Nan
abala	الجزء	None
aawe	شلل	Nan
aare	آري	Nan
aapon	آبون	Nan
aanu	تعاطف	Nan
aala	الحدود	None
abo	المؤنث	Nan
adúgbò kútò	الجيران في الشارع	Nan
adúgbò mókóla	الغشاء المخاطي	Nan
adúgbò quarry	الجيران المحجر	Nan
ajo	السفر	None
ajibola	جدول أعمال	Nan
ajemoroyin	استجواب	Nan
aje	الاقتصاد	None
ajagun	كلب	Nan
aisi	نقص	None
aintimulo	aintimulo	Nan
agio	يبكي	Nan
agbéiná	رجل الاطفاء	Nan
agbára	قوة	None
agbàbò	حامية	Nan
agbà	بالغ	None
agbeinadie	الأرض الزراعية	Nan
agbaye	العالم	None
agbara	قوة	None
agbado	الذرة	None
agba	رسم	None
aféfé	طاحونة هوائية	Nan
africans	الأفارقة	Nan
african	الأفريقي	None
africa	أفريقيا	None
afoyemo	ملخص	Nan
afomo	فمثلا	None
afida	العائلة	None
adúgbò ìdí	أسباب الحي	Nan
andaman	أندمان	Nan
genevieve	جينيفيف	Nan
angkor	أنغكور	Nan
anschluss	غموض	Nan
benin	مقعد	Nan
bengali	البنغالية	Nan
bengal	البنغال	Nan
belgium	بلجيكا	None
belarus	بيلاروس	Nan
beijing	بكين	None
beauharnais	بوحرنص	Nan
bce	بعيدا	None
bayìí	الآن	None
bayi	الآن	None
bayelsa	بايلسا	Nan
berber	بربري	Nan
bauxitealumina	البوكسيتيلومينا	Nan
banle	نبل	Nan
bang	انفجار	None
balẹ̀	دعه يكون	Nan
bahrain	البحرين	None
babaláwo	العراف	Nan
baa	يكون	None
aṣòkan	فرد	None
azikiwe	الفطرة السليمة	Nan
ayò	ع	Nan
ayàfi	انها على ما يرام	Nan
ayeye	خلود	Nan
bara	العام الماضي	Nan
aya	بيت شعر	Nan
berlin	برلين	None
bharat	بهارات	Nan
báyìí	الآن	None
bárakú	إدمان	Nan
bálè	بالون	Nan
bákannáà	كذلك	None
bàbá	الأب	None
by	بواسطة	None
burúkú	شرير	Nan
bujumbura	موسع	Nan
buenaventura	بوينافينتورا	Nan
bu	هذا هو	Nan
brítánì	بريطاني	Nan
bernstein	برنشتاين	Nan
britain	بريطانيا	None
brazzaville	برازافيل	Nan
brasil	البرازيل	None
bolívar	بوليفار	Nan
bolt	الترباس	Nan
bole	بولي	Nan
bojú	إلق نظرة	Nan
bodies	جثث	Nan
black	أسود	None
biribiri	تم سحقه	Nan
bibeli	الكتاب المقدس	Nan
bharata	عد	Nan
bridgeport	بريدجبورت	Nan
awújẹ	فضيحة	Nan
awùjo	مجاملة	Nan
awuruju	سحري	Nan
arábíà	مرتب حسب الحروف الأبجدية	Nan
aráa	شقيق	Nan
aryan	الآرية	Nan
arun	مرض	None
aruleyin	مرحبا	Nan
aroko	الغطاء النباتي	Nan
arkansas	أركنساس	Nan
ariwaguusu	جنوبي غربي	Nan
ariwaarin	الشرق الأوسط	Nan
ariso	تظهر	None
arinkankan	هذا	None
aráròmí	مرحبا	Nan
aralíle	استوائي	Nan
apẹ̀rè	ساحة	None
apòmù	ساحة	None
apis	أبيس	Nan
apeere	فمثلا	None
apeja	صياد السمك	Nan
aparapo	مزيج	None
apaiwoorun	الغربي	None
apailaorun	شروق الشمس	Nan
apaguusuiwoorun	جنوب غرب	Nan
apaguusuilaorun	جنوب غرب	Nan
apagusu	الجنوب	None
arabu	عرب	None
arópò	الرشوة	Nan
arúgbó	كبار السن	Nan
arọ	عرجاء	Nan
awon	معهم	None
awoòn	قالب	Nan
awonara	المشاعر	None
awo	طبق	Nan
awari	اكتشاف	None
avar	أفار	Nan
austríà	أستراليا	None
austronesian	الأسترالي	Nan
austriahumgary	النمساوي	None
australia	أستراليا	None
atunse	تصحيح	Nan
atun	الترجيع	Nan
atinrin	يضحك	Nan
atimo	خطة	None
atigba	مقبول	Nan
atanna	ذرة	Nan
atangbona	ذرة	Nan
asèdá	الطبيعي	None
asìko	كلام فارغ	Nan
assessment	تقدير	None
asipa	الانحراف	Nan
aseyori	نجاح	None
aseeto	مستوطنة	None
ascii	يكتشف	Nan
asagun	فوز	Nan
anita	أنيتا	Nan
ọ̀rọ̀	حديث	None
georgia	جورجيا	None
gfaj	غفاج	Nan
kòjòkú	تمطر	Nan
kírísìtì	عيد الميلاد	Nan
kínu	تقبيل	Nan
kíkọ́	ليتعلم	Nan
kíko	دراسة عربي	Nan
kí	تحية	Nan
kìnní	أول	None
kéyìn	في وقت لاحق	Nan
kémíkà	على العكس من ذلك	Nan
kétu	كن مستعدا	Nan
kékéèké	صغير	None
kòkó	الفأر	Nan
kéesì	سخيف	Nan
kánádà	بالتاكيد	Nan
kánfinkése	بطيء	Nan
ká	من	None
kàyéfì	يتساءل	Nan
kàríbẹ́ánì	في المنطقة	Nan
kwara	موجهة	Nan
ku	أنت	None
krio	كريو	Nan
kori	لا أكثر	Nan
ko	كو	Nan
koko	تعلم	None
káyé	العالمية	None
koto	طعم	Nan
kòmpútà	الحاسوب	None
kòòsí	ليس	None
labalaba	فراشة	Nan
laarin	في غضون	Nan
laaka	يعكس	None
laada	ركلة	Nan
laa	ابتعد أو ارحل	Nan
kọ́ni	نقص	None
kọ́lọ́mú	الأعمدة	None
kọ́kọ́	أول	None
kọ̀mpútà	الحاسوب	None
kọjá	البشري	None
kẹ́nyà	انفصال	None
kòtò	قليلا	None
kẹta	الثالث	None
kẹrin	الرابع	None
kúùkù	على العكس تماما	Nan
kútò	كل شىء	Nan
kúrò	بعيدا	None
kúkúrú	شيء صغير	Nan
kúkú	بعد كل شيء	Nan
kùrání	القرآن	None
kùkú	بعد كل شيء	Nan
kóra	جمع	None
kógo	مجد	Nan
kòòkan	كل واحد	Nan
kẹsàán	على الفور	Nan
labee	تحته	Nan
kookan	هذه	None
kong	كونغ	Nan
kampala	مشبك	Nan
kalẹ	اجلس جانبا	Nan
kalinga	سينجا	Nan
kakiri	أثر	None
kagera	متبجح	Nan
kadara	الأصل	None
jọ́	رجاء	Nan
jẹ́mánì	ألمانية	None
jùló	أكثر	None
jùlo	خصوصا	None
jùlo	أكثر من	Nan
kan	أ	None
jíjéomoléyìnkírísítì	كمحسن	Nan
jíje	يجرى	Nan
jìnnàa	بعيدا	None
jéésù	يسوع	None
jé	تأتي	Nan
jáde	يظهر	None
jàgídíjàgan	عنيف	Nan
juneau	جونو	Nan
jo	يوحنا	None
jopò	إنضم إلى	Nan
jojo	متصدع	Nan
johanu	آسف	Nan
jíjuwó	كسب المال	Nan
kongo	واق ذكري	Nan
kankan	لا شيء	Nan
karbonumarun	المركز	None
komputa	الحاسوب	None
kolo	كولو	Nan
kojá	تعبر	None
koidu	كويدو	Nan
kodò	أدناه	None
ko	أو	None
kinkinni	الشيء الصغير	Nan
kilhar	إبط	Nan
kikuninu	تخيل	Nan
kiko	تعلم	None
kikoso	بسرعة	None
kanlè	كانالي	Nan
kikopomo	الدفء	Nan
kiko	جلب	None
kiakiajulo	الأسرع	Nan
ki	القيام بذلك	Nan
khoisan	السفلي	None
kept	أبقى	Nan
keko	مثقف. متعلم	Nan
kekere	صغير	None
kebbi	قابل للتعديل	Nan
karùún	الخامس	None
karun	خامسا	Nan
karl	كارل	None
kikojo	التحويل البرمجي	Nan
lade	ليد	Nan
laid	وضعت	None
laifi	خطأ	None
mahatma	المهاتما	Nan
madeira	بيرا	Nan
maapu	خريطة	None
lọ́jà	فى السوق	Nan
lọ́dọọdún	سنويا	None
lọndọnu	لندن	None
lórò	غدا	Nan
lónà	علي الطريق	Nan
ló	لوط	Nan
lóòótọ́	في الواقع	Nan
lóòótò	نعم	Nan
makedonia	مقدونيا	None
lóti	كثيرا	None
lórì	مرفأ	Nan
lópó	أرملة	Nan
lópez	نيبيز	Nan
lóde	في الخارج	Nan
lítésò	لاذع	Nan
lísa	التسريع	Nan
lílo	استغلال	None
lérú	عبودية	Nan
léyìn	في وقت لاحق	Nan
léyin	عقب ذلك مباشرة	Nan
lérò	السبب	None
lóríba	على	None
lérìnín	الثلج	None
malabo	عسل	None
malayopolynesian	الماليزية	None
member	عضو	Nan
melo	كم العدد	Nan
meksiko	المكسيك	None
mejila	اثني عشر	Nan
mejidinlogbon	ثمانية وعشرون	Nan
mefeefa	عمرة	Nan
mediteraneani	البحر المتوسط	Nan
means	يعني	None
mbabane	سلبي	Nan
maya	لا	None
max	ماكس	Nan
malay	يفترض	None
mathimatiki	رياضي	Nan
matheu	ماثيو	Nan
maseru	الغيرة	Nan
maryland	ماريلاند	Nan
mars	كوكب المريخ	Nan
marku	هذا الوقت	Nan
march	مارس	None
marcellus	مارسيلس	Nan
manˈdeːla	manˈdelala	Nan
mango	مانجو	Nan
mali	يوم	None
malaysia	ماليزيا	None
mathiew	ماثيو	Nan
léebá	صدفة	Nan
lédè	في اللغة	Nan
lèyìn	عقب ذلك مباشرة	Nan
links	الروابط	None
linear	خطي	Nan
lindi	الغسول	Nan
lilongwe	ليلونغوي	Nan
lilemo	القنب	Nan
lilelile	المتشددين	Nan
leè	مايو	None
leyi	ها هو	Nan
lewon	السجن	None
lewaju	فصاعدا	Nan
less	أقل	None
lodo	تجري	None
lese	بريد	None
lekun	مكثف	Nan
leboa	ليبو	Nan
le	يستطيع	None
lay	بسط	None
latvia	لاتفيا	Nan
latini	اللاتينية	None
latigbana	منذ ذلك الحين	Nan
latibe	من هناك	Nan
lasile	إطلاق سراح	Nan
lanka	لانكا	Nan
languages	اللغات	None
leo	ليو	Nan
lojowaju	فى المستقبل	Nan
lojukokoro	جشع	Nan
lojúgun	خرب	Nan
lèe	يستطيع	None
láíláí	أبدا	None
láì	بدون	None
lárúbáwá	الطبيعي	None
lára	جرح	Nan
lápá	جزء	None
lámọ́di	ثروة	None
láké	بصوت عال	Nan
láimo	بدون	None
láfún	معطى	Nan
lábé	وزن	None
lààmì	علامات	None
lààmi	إشارة	None
làgba	مساو	Nan
lynton	لينتون	Nan
luther	لوثر	None
luanda	لواندا	Nan
lo	تابع	None
low	منخفض	None
lovers	عشاق	Nan
louvre	متحف اللوفر	Nan
loruko	اسم	None
lopolopo	كثير	None
loloselu	سياسيا	None
lokunkun	نشيط	Nan
johann	الجحيم	Nan
jogun	وارث	Nan
jo	تسرب	None
jiròrò	ضبابي	Nan
ifitonileti	معلومات	None
ifilole	إطلاق	None
ifija	صيد السمك	Nan
idánwò	التجربة	None
idupe	شكرا	Nan
idoma	رسم	None
idimule	يقبض على	Nan
ideraa	لأكتب	Nan
idari	ضوابط	Nan
idamita	رسم	None
idajo	عدالة	Nan
ifobaje	الفساد	None
idaji	نصف	None
idagbasoke	تطوير	None
iceland	أيسلندا	Nan
ibùjókòó	جلوس	Nan
ibùdó	معسكر	None
ibuso	ليقاتل	Nan
ibuseripadabosi	الانتقال	None
ibujoko	مقعد	Nan
ibori	حجاب	Nan
ibojì	قبر	None
ibn	ابن	None
ibiti	أماكن	None
idagbe	إهمال	Nan
ibise	اكتشف - حل	Nan
ifofinde	المؤتمر	None
igbeduro	تجهيز	None
iketa	ليرث	Nan
ikerin	الرابع	None
ikeko	التحويل البرمجي	Nan
ikejidinlogun	الثامنة عشر	Nan
ikaowo	احترام	None
ikandinlogun	الثامنة عشر	Nan
ikan	واحد	None
ijó	الرقص	None
ijosin	عبادة	None
ijinnasi	الفيزياء	None
ije	حركة	None
ifriqiya	تنشيط	Nan
ijaya	ذعر	Nan
ijagun	يقاتل	Nan
ihinrere	الإنجيل	None
ihan	لتظهر	Nan
igitòròmogbè	موجة عريضة	Nan
igbáẹ̀yìn	الأخير	None
igbá	دجاج	Nan
igbowolori	مكلفة	Nan
igbeyawo	حفل زواج	Nan
igbesoke	تطوير	None
igberiko	من الضواحى	Nan
igbegun	فوز	Nan
ijakadi	صراع	None
ibimo	ولادة	None
ibile	تقليدي	Nan
ibiamusin	الملاذ الآمن	Nan
gún	مثقوب	Nan
gòkè	اذهب للأعلى	Nan
gírámà	جرام	Nan
gégé	هل حقا	Nan
gèésì	جوهرة	Nan
gèésì	صمغ	Nan
gv	ز	Nan
guusu	جنوب	None
gunle	بندقية	Nan
gun	طويل	None
guinébissau	guinébissau	Nan
gúúsù	جنوب	None
guineabissau	غينيا	None
guanínì	غواني	Nan
groove	أخدود	Nan
griiki	اليونانية	None
grammy	جرامي	Nan
gquadruplex	gquadruplex	Nan
gorgina	النسر	Nan
gomina	محافظ حاكم	Nan
goemai	goemai	Nan
gidí	منزل	None
gidigidi	للغاية	None
ghana	غانا	Nan
guinea	غينيا	None
gẹ̀ẹ́sì	الإنجليزية	None
habsburg	هابسبورغ	Nan
haggai	يرشد	Nan
ibewo	جاء	None
ibeji	توأمان	Nan
ibarepo	جمعية	None
ibalo	قضية	None
hv	hv	Nan
hungari	مجاعة	None
hun	هون	Nan
hugh	هيو	Nan
hp	حصان	Nan
hosea	hosea	Nan
hominidae	hominidae	Nan
histoni	الهيستوني	Nan
hindu	هيندو	Nan
him	له	None
hesse	متفق عليه	Nan
heraklion	هيراكليون	Nan
henny	هيني	Nan
hendu	حلويات	None
heinrich	هاينريش	Nan
hawaii	هاواي	None
hausafulani	حسفولاني	Nan
haughton	هاوتون	Nan
hard	الصعب	None
halomonadaceae	halomonadaceae	Nan
haiti	هايتي	Nan
ikoenu	للحفظ	Nan
german	ألمانية	None
ikojopo	تراكم	Nan
iku	الموت	None
itumo	المعنى	None
itu	لرمي	Nan
itorawo	ليبرالية	None
itokowo	اعمال	Nan
itobi	التباهي	Nan
itiraka	صراع	None
itelentele	بوضوح	None
itanakole	قصة	None
itali	إيطالي	Nan
isè	الخدمات	None
isesi	استسلام	None
iwadi	ابحاث	Nan
isun	تدفق	None
iso	ليأتي	Nan
isepinpin	توزيع	None
iseowo	اعمال	Nan
iseoroayeijoun	علم الآثار	Nan
iseoba	خمسة عشر	Nan
isejoba	الحكم	None
iseero	راقب	Nan
isedaniloro	عدم الثقة بالنفس	Nan
isare	التسريع	Nan
isa	كافية	None
irúnmọlẹ̀	برق	Nan
isoponomba	isoponomba	Nan
irò	شائعة	None
iwasi	اعجاب	Nan
iwoile	الصفحة الرئيسية	Nan
jijinna	بعيدا	None
jije	يجرى	Nan
jfk	جون كنيدي	Nan
jesu	يسوع	None
jeometri	علم الهندسة	Nan
jeffrey	جيفري	Nan
jawaharlal	يتأرجح	Nan
jamo	ابتعد أو ارحل	Nan
jamaica	موقع youtube	Nan
jalè	سرقة	None
jagbe	تضيع	Nan
iwifun	معلومات	None
jadide	انتظر	Nan
jabo	نقل	None
iṣẹ́ìwádìí	ابحاث	Nan
iḷẹ̀	عمل	None
iyán	متألق	Nan
iyen	هذا هو	Nan
iyawo	عروس	Nan
iyato	الاختلاف	None
iyan	مجاعة	None
iwuwa	ممارسة	None
iwulo	مفيد	Nan
iwosan	شفاء	Nan
jackson	جاكسون	None
irorun	بسيط جدا	Nan
irisi	مظهر خارجي	Nan
iringa	يتم إحتوائه	Nan
ilẹ̀ayé	الأرض	Nan
ilẹ	أرض	None
iléńlá	فناء	Nan
iléàtèéré	الصفحة الرئيسية	Nan
ilélódò	المنزل	None
iléisé	الصفحة الرئيسية	Nan
iléayé	الصفحة الرئيسية	Nan
ilé	الصفحة الرئيسية	Nan
iluorilejoba	العولمة	None
iluoba	المواطنة	Nan
ilopo	مزدوج	Nan
iminle	إلقاء القبض على	Nan
ileru	فرن	Nan
ileigbimo	موافقة	None
ileife	إهمال	Nan
ilegiga	الصفحة الرئيسية	Nan
ileasofin	تشريعي	Nan
ilaorun	شروق الشمس	Nan
ilaodo	يحمي	None
ilanaoye	الاستراتيجيات	Nan
ilana	إجراء	None
ilagbolojo	شهره اعلاميه	Nan
ikún	حشوة	Nan
ikúgbaèyí	الآن	None
ileobaluaye	العالم	None
imoero	البرق	Nan
imojuto	رعاية	None
imusin	رسم	None
irele	التواضع	Nan
ire	تخفيض السعر	Nan
iranlose	مساعدة	None
iraja	مروع	Nan
ipá	فرض	None
ipo	موقعك	Nan
ipinu	قرار	None
ipinpa	مشاركة	None
ipin	الفصل	None
ipele	مستوى	None
ipawo	الاستخدامات	None
ipare	تتلاشى	Nan
iowa	على الارض	Nan
ioniani	محتاج	Nan
ioja	سمك	None
inúnibíni	الاضطهاد	None
iní	ميراث	Nan
inágbéringbérin	سبعة عشر	Nan
integration	دمج	None
inkosi	لتبرير	Nan
indus	إندوس	Nan
indeed	في الواقع	Nan
inagberingberi	زبدة الفول السوداني	Nan
imúnisìn	النظافة	Nan
imú	أنف	Nan
ikoreokere	حصاد	Nan
ọ̀sẹ	أسبوع	None
